PokerStars Hand #150120858276:  Hold'em No Limit ($0.50/$1.00 USD) - 2016/03/10 10:11:47 CET [2016/03/10 4:11:47 ET]
Table 'Liriope II' 9-max Seat #3 is the button
Seat 1: Bron By ($100 in chips) 
Seat 2: vano7777 ($220.11 in chips) 
Seat 3: azzad2007 ($112.30 in chips) 
Seat 4: matiko09 ($115.90 in chips) 
Seat 5: toprmaw ($250 in chips) 
Seat 6: Monsthand ($102.70 in chips) 
Seat 7: mycka86 ($139.90 in chips) 
matiko09: posts small blind $0.50
toprmaw: posts big blind $1
Bron By: posts the ante $0.20
vano7777: posts the ante $0.20
azzad2007: posts the ante $0.20
matiko09: posts the ante $0.20
toprmaw: posts the ante $0.20
Monsthand: posts the ante $0.20
mycka86: posts the ante $0.20
*** HOLE CARDS ***
Dealt to matiko09 [2d 5c]
Monsthand: folds 
mycka86: folds 
Bron By: folds 
vano7777: raises $1 to $2
azzad2007: raises $5.50 to $7.50
matiko09: folds 
toprmaw: folds 
vano7777: folds 
Uncalled bet ($5.50) returned to azzad2007
azzad2007 collected $6.90 from pot
azzad2007: doesn't show hand 
*** SUMMARY ***
Total pot $6.90 | Rake $0 
Seat 1: Bron By folded before Flop (didn't bet)
Seat 2: vano7777 folded before Flop
Seat 3: azzad2007 (button) collected ($6.90)
Seat 4: matiko09 (small blind) folded before Flop
Seat 5: toprmaw (big blind) folded before Flop
Seat 6: Monsthand folded before Flop (didn't bet)
Seat 7: mycka86 folded before Flop (didn't bet)





PokerStars Hand #150120858974:  Hold'em No Limit ($0.50/$1.00 USD) - 2016/03/10 10:11:49 CET [2016/03/10 4:11:49 ET]
Table 'Nereid' 9-max Seat #9 is the button
Seat 1: matiko09 ($100 in chips) 
Seat 2: PHILLY_D_S ($128.14 in chips) 
Seat 3: mycka86 ($100 in chips) 
Seat 4: xiaoxiaoniao ($234 in chips) 
Seat 5: ilaviiitech ($100 in chips) 
Seat 6: thecurv ($102.80 in chips) 
Seat 7: Monsthand ($118.67 in chips) 
Seat 8: Rikti ($29.50 in chips) 
Seat 9: zxp12345 ($89.74 in chips) 
matiko09: posts small blind $0.50
PHILLY_D_S: posts big blind $1
*** HOLE CARDS ***
Dealt to matiko09 [Qs 4d]
mycka86: folds 
xiaoxiaoniao: folds 
ilaviiitech: folds 
thecurv: folds 
zxp12345 said, "国人不内战"
Monsthand: folds 
Rikti: folds 
zxp12345: calls $1
matiko09: folds 
PHILLY_D_S: raises $3 to $4
zxp12345: calls $3
*** FLOP *** [Tc 9c 3s]
PHILLY_D_S: bets $6.17
zxp12345: calls $6.17
*** TURN *** [Tc 9c 3s] [8h]
PHILLY_D_S: bets $15.12
zxp12345: raises $64.45 to $79.57 and is all-in
PHILLY_D_S: calls $64.45
*** RIVER *** [Tc 9c 3s 8h] [5s]
*** SHOW DOWN ***
PHILLY_D_S: shows [Ac Ah] (a pair of Aces)
zxp12345: shows [6c 7c] (a straight, Six to Ten)
zxp12345 collected $177.18 from pot
*** SUMMARY ***
Total pot $179.98 | Rake $2.80 
Board [Tc 9c 3s 8h 5s]
Seat 1: matiko09 (small blind) folded before Flop
Seat 2: PHILLY_D_S (big blind) showed [Ac Ah] and lost with a pair of Aces
Seat 3: mycka86 folded before Flop (didn't bet)
Seat 4: xiaoxiaoniao folded before Flop (didn't bet)
Seat 5: ilaviiitech folded before Flop (didn't bet)
Seat 6: thecurv folded before Flop (didn't bet)
Seat 7: Monsthand folded before Flop (didn't bet)
Seat 8: Rikti folded before Flop (didn't bet)
Seat 9: zxp12345 (button) showed [6c 7c] and won ($177.18) with a straight, Six to Ten





PokerStars Hand #150120859516:  Hold'em No Limit ($0.50/$1.00 USD) - 2016/03/10 10:11:50 CET [2016/03/10 4:11:50 ET]
Table 'Rarahu' 9-max Seat #8 is the button
Seat 1: matiko09 ($100 in chips) 
Seat 2: azzad2007 ($100.17 in chips) 
Seat 3: ka100pka527 ($44.06 in chips) 
Seat 4: vilo1070 ($104 in chips) 
Seat 5: blackw0lf_03 ($107.50 in chips) 
Seat 6: RMilPoker ($100 in chips) 
Seat 7: PHILLY_D_S ($151.22 in chips) 
Seat 8: Rikti ($61.85 in chips) 
Seat 9: Srz7v44 ($114.86 in chips) 
Srz7v44: posts small blind $0.50
matiko09: posts big blind $1
*** HOLE CARDS ***
Dealt to matiko09 [8h Qc]
azzad2007: folds 
ka100pka527: folds 
vilo1070: folds 
blackw0lf_03: raises $2 to $3
RMilPoker: folds 
PHILLY_D_S: folds 
Rikti: folds 
Srz7v44: folds 
matiko09: folds 
Uncalled bet ($2) returned to blackw0lf_03
blackw0lf_03 collected $2.50 from pot
blackw0lf_03: doesn't show hand 
*** SUMMARY ***
Total pot $2.50 | Rake $0 
Seat 1: matiko09 (big blind) folded before Flop
Seat 2: azzad2007 folded before Flop (didn't bet)
Seat 3: ka100pka527 folded before Flop (didn't bet)
Seat 4: vilo1070 folded before Flop (didn't bet)
Seat 5: blackw0lf_03 collected ($2.50)
Seat 6: RMilPoker folded before Flop (didn't bet)
Seat 7: PHILLY_D_S folded before Flop (didn't bet)
Seat 8: Rikti (button) folded before Flop (didn't bet)
Seat 9: Srz7v44 (small blind) folded before Flop





PokerStars Hand #150120859864:  Hold'em No Limit ($1/$2 USD) - 2016/03/10 10:11:51 CET [2016/03/10 4:11:51 ET]
Table 'Sophia II' 9-max Seat #6 is the button
Seat 1: thecurv ($273.68 in chips) 
Seat 2: Sang2015 ($209.80 in chips) 
Seat 3: maxxmeister ($200 in chips) 
Seat 4: hejun0713 ($224.04 in chips) 
Seat 5: matiko09 ($202 in chips) 
Seat 6: WrongButton ($215.83 in chips) 
Seat 7: Monsthand ($208.86 in chips) 
Seat 8: nickreason17 ($207.71 in chips) 
Monsthand: posts small blind $1
nickreason17: posts big blind $2
*** HOLE CARDS ***
Dealt to matiko09 [2d 8c]
thecurv: folds 
Sang2015: folds 
maxxmeister: folds 
hejun0713: folds 
matiko09: folds 
WrongButton: folds 
Monsthand: folds 
Uncalled bet ($1) returned to nickreason17
nickreason17 collected $2 from pot
*** SUMMARY ***
Total pot $2 | Rake $0 
Seat 1: thecurv folded before Flop (didn't bet)
Seat 2: Sang2015 folded before Flop (didn't bet)
Seat 3: maxxmeister folded before Flop (didn't bet)
Seat 4: hejun0713 folded before Flop (didn't bet)
Seat 5: matiko09 folded before Flop (didn't bet)
Seat 6: WrongButton (button) folded before Flop (didn't bet)
Seat 7: Monsthand (small blind) folded before Flop
Seat 8: nickreason17 (big blind) collected ($2)





PokerStars Hand #150120862721:  Hold'em No Limit ($1/$2 USD) - 2016/03/10 10:11:59 CET [2016/03/10 4:11:59 ET]
Table 'Archid' 9-max Seat #7 is the button
Seat 1: AP3221 ($104.22 in chips) 
Seat 2: geiranger011 ($93.64 in chips) 
Seat 3: sarkat104 ($155.55 in chips) 
Seat 4: Monsthand ($211.37 in chips) 
Seat 6: Yaaaazz ($650.51 in chips) 
Seat 7: maxxmeister ($211.24 in chips) 
Seat 8: matiko09 ($303.74 in chips) 
Seat 9: WrongButton ($216.74 in chips) 
matiko09: posts small blind $1
WrongButton: posts big blind $2
*** HOLE CARDS ***
Dealt to matiko09 [Kh Td]
AP3221: folds 
geiranger011: folds 
sarkat104: folds 
chippo boy leaves the table
toprmaw joins the table at seat #5 
Monsthand: folds 
Yaaaazz: folds 
maxxmeister: raises $4 to $6
matiko09: raises $14 to $20
WrongButton: folds 
maxxmeister: folds 
Uncalled bet ($14) returned to matiko09
matiko09 collected $14 from pot
matiko09: doesn't show hand 
*** SUMMARY ***
Total pot $14 | Rake $0 
Seat 1: AP3221 folded before Flop (didn't bet)
Seat 2: geiranger011 folded before Flop (didn't bet)
Seat 3: sarkat104 folded before Flop (didn't bet)
Seat 4: Monsthand folded before Flop (didn't bet)
Seat 6: Yaaaazz folded before Flop (didn't bet)
Seat 7: maxxmeister (button) folded before Flop
Seat 8: matiko09 (small blind) collected ($14)
Seat 9: WrongButton (big blind) folded before Flop





PokerStars Hand #150120863576:  Hold'em No Limit ($1/$2 USD) - 2016/03/10 10:12:02 CET [2016/03/10 4:12:02 ET]
Table 'Tauris II' 9-max Seat #2 is the button
Seat 1: PHILLY_D_S ($207.24 in chips) 
Seat 2: Rycious ($34.45 in chips) 
Seat 3: vano7777 ($301.08 in chips) 
Seat 4: matiko09 ($377.77 in chips) 
Seat 5: Spudly6 ($172.52 in chips) 
Seat 8: WrongButton ($200 in chips) 
Seat 9: darren1031 ($134.19 in chips) 
vano7777: posts small blind $1
matiko09: posts big blind $2
Yaaaazz: sits out 
maxxmeister: sits out 
*** HOLE CARDS ***
Dealt to matiko09 [Ts 3c]
Spudly6: folds 
WrongButton: folds 
darren1031: folds 
PHILLY_D_S: folds 
Rycious: folds 
vano7777: folds 
Uncalled bet ($1) returned to matiko09
matiko09 collected $2 from pot
matiko09: doesn't show hand 
*** SUMMARY ***
Total pot $2 | Rake $0 
Seat 1: PHILLY_D_S folded before Flop (didn't bet)
Seat 2: Rycious (button) folded before Flop (didn't bet)
Seat 3: vano7777 (small blind) folded before Flop
Seat 4: matiko09 (big blind) collected ($2)
Seat 5: Spudly6 folded before Flop (didn't bet)
Seat 8: WrongButton folded before Flop (didn't bet)
Seat 9: darren1031 folded before Flop (didn't bet)





PokerStars Hand #150120864538:  Hold'em No Limit (€0.25/€0.50 EUR) - 2016/03/10 10:12:04 CET [2016/03/10 4:12:04 ET]
Table 'Algorab' 9-max Seat #9 is the button
Seat 1: Rikti (€27.27 in chips) 
Seat 2: IvanUrgant (€50 in chips) 
Seat 3: dididi2000 (€36.90 in chips) 
Seat 4: Dantist1122 (€62.91 in chips) 
Seat 5: priterix (€15.13 in chips) 
Seat 6: Bron By (€51.04 in chips) 
Seat 7: matiko09 (€84.36 in chips) 
Seat 8: fudzi (€51.25 in chips) 
Seat 9: St.LaCoste (€54.17 in chips) 
Rikti: posts small blind €0.25
IvanUrgant: posts big blind €0.50
*** HOLE CARDS ***
Dealt to matiko09 [Jd Qc]
dididi2000: raises €1 to €1.50
Dantist1122: folds 
priterix: calls €1.50
Bron By: calls €1.50
matiko09: folds 
fudzi: folds 
St.LaCoste: folds 
Rikti: folds 
IvanUrgant: folds 
*** FLOP *** [4c 9d 5s]
dididi2000: checks 
priterix: bets €1.50
Bron By: calls €1.50
dididi2000: raises €4 to €5.50
priterix: folds 
Bron By: folds 
Uncalled bet (€4) returned to dididi2000
dididi2000 collected €9.31 from pot
dididi2000: doesn't show hand 
*** SUMMARY ***
Total pot €9.75 | Rake €0.44 
Board [4c 9d 5s]
Seat 1: Rikti (small blind) folded before Flop
Seat 2: IvanUrgant (big blind) folded before Flop
Seat 3: dididi2000 collected (€9.31)
Seat 4: Dantist1122 folded before Flop (didn't bet)
Seat 5: priterix folded on the Flop
Seat 6: Bron By folded on the Flop
Seat 7: matiko09 folded before Flop (didn't bet)
Seat 8: fudzi folded before Flop (didn't bet)
Seat 9: St.LaCoste (button) folded before Flop (didn't bet)





PokerStars Hand #150120867421:  Hold'em No Limit ($0.50/$1.00 USD) - 2016/03/10 10:12:12 CET [2016/03/10 4:12:12 ET]
Table 'Rarahu' 9-max Seat #9 is the button
Seat 1: matiko09 ($100 in chips) 
Seat 2: azzad2007 ($100.17 in chips) 
Seat 3: ka100pka527 ($44.06 in chips) 
Seat 4: vilo1070 ($104 in chips) 
Seat 5: blackw0lf_03 ($109 in chips) 
Seat 6: RMilPoker ($100 in chips) 
Seat 7: PHILLY_D_S ($151.22 in chips) 
Seat 8: Rikti ($61.85 in chips) 
Seat 9: Srz7v44 ($114.36 in chips) 
matiko09: posts small blind $0.50
azzad2007: posts big blind $1
*** HOLE CARDS ***
Dealt to matiko09 [8d Th]
ka100pka527: folds 
vilo1070: folds 
blackw0lf_03: folds 
RMilPoker: folds 
PHILLY_D_S: raises $2 to $3
Rikti: folds 
Srz7v44: folds 
matiko09: folds 
azzad2007: folds 
Uncalled bet ($2) returned to PHILLY_D_S
PHILLY_D_S collected $2.50 from pot
PHILLY_D_S: doesn't show hand 
*** SUMMARY ***
Total pot $2.50 | Rake $0 
Seat 1: matiko09 (small blind) folded before Flop
Seat 2: azzad2007 (big blind) folded before Flop
Seat 3: ka100pka527 folded before Flop (didn't bet)
Seat 4: vilo1070 folded before Flop (didn't bet)
Seat 5: blackw0lf_03 folded before Flop (didn't bet)
Seat 6: RMilPoker folded before Flop (didn't bet)
Seat 7: PHILLY_D_S collected ($2.50)
Seat 8: Rikti folded before Flop (didn't bet)
Seat 9: Srz7v44 (button) folded before Flop (didn't bet)





PokerStars Hand #150120867846:  Hold'em No Limit ($1/$2 USD) - 2016/03/10 10:12:13 CET [2016/03/10 4:12:13 ET]
Table 'Solstice II' 9-max Seat #4 is the button
Seat 1: Rycious ($82.88 in chips) 
Seat 3: vano7777 ($104.41 in chips) 
Seat 4: matiko09 ($200 in chips) 
Seat 5: toprmaw ($200 in chips) 
Seat 6: thecurv ($200 in chips) 
toprmaw: posts small blind $1
thecurv: posts big blind $2
*** HOLE CARDS ***
Dealt to matiko09 [2c Kd]
Rycious: folds 
vano7777: folds 
matiko09: folds 
toprmaw: calls $1
thecurv: checks 
*** FLOP *** [Jc 8h Qh]
toprmaw: checks 
thecurv: bets $3
toprmaw: folds 
Uncalled bet ($3) returned to thecurv
thecurv collected $3.82 from pot
thecurv: doesn't show hand 
*** SUMMARY ***
Total pot $4 | Rake $0.18 
Board [Jc 8h Qh]
Seat 1: Rycious folded before Flop (didn't bet)
Seat 3: vano7777 folded before Flop (didn't bet)
Seat 4: matiko09 (button) folded before Flop (didn't bet)
Seat 5: toprmaw (small blind) folded on the Flop
Seat 6: thecurv (big blind) collected ($3.82)





PokerStars Hand #150120868536:  Hold'em No Limit ($0.25/$0.50 USD) - 2016/03/10 10:12:15 CET [2016/03/10 4:12:15 ET]
Table 'Aegina' 9-max Seat #7 is the button
Seat 1: Wess_1970 ($114.80 in chips) 
Seat 2: el.suertero ($146.15 in chips) 
Seat 3: matiko09 ($50 in chips) 
Seat 4: vlad11122007 ($54.99 in chips) 
Seat 5: lyhtmqh ($90.85 in chips) 
Seat 6: ardo888 ($147.52 in chips) 
Seat 7: Bohne0815 ($71.04 in chips) 
Seat 8: q3storm ($50.45 in chips) 
q3storm: posts small blind $0.25
Wess_1970: posts big blind $0.50
Wess_1970: posts the ante $0.10
el.suertero: posts the ante $0.10
matiko09: posts the ante $0.10
vlad11122007: posts the ante $0.10
lyhtmqh: posts the ante $0.10
ardo888: posts the ante $0.10
Bohne0815: posts the ante $0.10
q3storm: posts the ante $0.10
*** HOLE CARDS ***
Dealt to matiko09 [Qs Ah]
el.suertero: folds 
matiko09: raises $1 to $1.50
vlad11122007: folds 
lyhtmqh: calls $1.50
ardo888: folds 
Bohne0815: calls $1.50
q3storm: folds 
Wess_1970: folds 
*** FLOP *** [5h Th 9c]
matiko09: checks 
lyhtmqh: bets $2.89
Bohne0815: calls $2.89
matiko09: folds 
*** TURN *** [5h Th 9c] [4d]
lyhtmqh: checks 
Bohne0815: bets $3.50
lyhtmqh: folds 
Uncalled bet ($3.50) returned to Bohne0815
Bohne0815 collected $11.30 from pot
*** SUMMARY ***
Total pot $11.83 | Rake $0.53 
Board [5h Th 9c 4d]
Seat 1: Wess_1970 (big blind) folded before Flop
Seat 2: el.suertero folded before Flop (didn't bet)
Seat 3: matiko09 folded on the Flop
Seat 4: vlad11122007 folded before Flop (didn't bet)
Seat 5: lyhtmqh folded on the Turn
Seat 6: ardo888 folded before Flop (didn't bet)
Seat 7: Bohne0815 (button) collected ($11.30)
Seat 8: q3storm (small blind) folded before Flop





PokerStars Hand #150120868537:  Hold'em No Limit ($1/$2 USD) - 2016/03/10 10:12:15 CET [2016/03/10 4:12:15 ET]
Table 'Tauris II' 9-max Seat #3 is the button
Seat 1: PHILLY_D_S ($207.24 in chips) 
Seat 2: Rycious ($34.45 in chips) 
Seat 3: vano7777 ($300.08 in chips) 
Seat 4: matiko09 ($378.77 in chips) 
Seat 5: Spudly6 ($172.52 in chips) 
Seat 8: WrongButton ($200 in chips) 
Seat 9: darren1031 ($134.19 in chips) 
matiko09: posts small blind $1
Spudly6: posts big blind $2
Yaaaazz: sits out 
maxxmeister: sits out 
*** HOLE CARDS ***
Dealt to matiko09 [6d 3c]
WrongButton: folds 
darren1031: folds 
PHILLY_D_S: folds 
Rycious: calls $2
vano7777: folds 
matiko09: folds 
Spudly6: checks 
*** FLOP *** [Js As 7h]
Spudly6: checks 
Rycious: bets $2
Spudly6: folds 
Uncalled bet ($2) returned to Rycious
Rycious collected $4.78 from pot
Rycious: doesn't show hand 
*** SUMMARY ***
Total pot $5 | Rake $0.22 
Board [Js As 7h]
Seat 1: PHILLY_D_S folded before Flop (didn't bet)
Seat 2: Rycious collected ($4.78)
Seat 3: vano7777 (button) folded before Flop (didn't bet)
Seat 4: matiko09 (small blind) folded before Flop
Seat 5: Spudly6 (big blind) folded on the Flop
Seat 8: WrongButton folded before Flop (didn't bet)
Seat 9: darren1031 folded before Flop (didn't bet)





PokerStars Hand #150120870138:  Hold'em No Limit ($0.50/$1.00 USD) - 2016/03/10 10:12:20 CET [2016/03/10 4:12:20 ET]
Table 'Liriope II' 9-max Seat #4 is the button
Seat 1: Bron By ($100 in chips) 
Seat 2: vano7777 ($217.91 in chips) 
Seat 3: azzad2007 ($117 in chips) 
Seat 4: matiko09 ($115.20 in chips) 
Seat 5: toprmaw ($250 in chips) 
Seat 6: Monsthand ($102.50 in chips) 
Seat 7: mycka86 ($139.70 in chips) 
Seat 9: huti429 ($194.29 in chips) 
toprmaw: posts small blind $0.50
Monsthand: posts big blind $1
Bron By: posts the ante $0.20
vano7777: posts the ante $0.20
azzad2007: posts the ante $0.20
matiko09: posts the ante $0.20
toprmaw: posts the ante $0.20
Monsthand: posts the ante $0.20
mycka86: posts the ante $0.20
huti429: posts the ante $0.20
*** HOLE CARDS ***
Dealt to matiko09 [Qc Jc]
mycka86: folds 
huti429: folds 
Bron By: folds 
Sweden_Pound joins the table at seat #8 
vano7777: folds 
azzad2007: folds 
matiko09: raises $1.50 to $2.50
toprmaw: calls $2
Monsthand: folds 
*** FLOP *** [Qd 6d Js]
toprmaw: checks 
matiko09: bets $4.72
toprmaw: calls $4.72
*** TURN *** [Qd 6d Js] [Kh]
toprmaw: checks 
matiko09: bets $10
toprmaw: calls $10
*** RIVER *** [Qd 6d Js Kh] [3h]
toprmaw: checks 
matiko09: bets $19
toprmaw: folds 
Uncalled bet ($19) returned to matiko09
matiko09 collected $35.37 from pot
matiko09: doesn't show hand 
*** SUMMARY ***
Total pot $37.04 | Rake $1.67 
Board [Qd 6d Js Kh 3h]
Seat 1: Bron By folded before Flop (didn't bet)
Seat 2: vano7777 folded before Flop (didn't bet)
Seat 3: azzad2007 folded before Flop (didn't bet)
Seat 4: matiko09 (button) collected ($35.37)
Seat 5: toprmaw (small blind) folded on the River
Seat 6: Monsthand (big blind) folded before Flop
Seat 7: mycka86 folded before Flop (didn't bet)
Seat 9: huti429 folded before Flop (didn't bet)





PokerStars Hand #150120871983:  Hold'em No Limit ($1/$2 USD) - 2016/03/10 10:12:25 CET [2016/03/10 4:12:25 ET]
Table 'Sophia II' 9-max Seat #7 is the button
Seat 1: thecurv ($273.68 in chips) 
Seat 2: Sang2015 ($209.80 in chips) 
Seat 3: maxxmeister ($200 in chips) 
Seat 4: hejun0713 ($224.04 in chips) 
Seat 5: matiko09 ($202 in chips) 
Seat 6: WrongButton ($215.83 in chips) 
Seat 7: Monsthand ($207.86 in chips) 
Seat 8: nickreason17 ($208.71 in chips) 
nickreason17: posts small blind $1
13Ghosts was removed from the table for failing to post
thecurv: posts big blind $2
*** HOLE CARDS ***
Dealt to matiko09 [As 8c]
Sang2015: folds 
maxxmeister: folds 
hejun0713: folds 
matiko09: folds 
WrongButton: folds 
Monsthand: raises $3 to $5
nickreason17: raises $13 to $18
thecurv: folds 
Monsthand: folds 
Uncalled bet ($13) returned to nickreason17
nickreason17 collected $12 from pot
*** SUMMARY ***
Total pot $12 | Rake $0 
Seat 1: thecurv (big blind) folded before Flop
Seat 2: Sang2015 folded before Flop (didn't bet)
Seat 3: maxxmeister folded before Flop (didn't bet)
Seat 4: hejun0713 folded before Flop (didn't bet)
Seat 5: matiko09 folded before Flop (didn't bet)
Seat 6: WrongButton folded before Flop (didn't bet)
Seat 7: Monsthand (button) folded before Flop
Seat 8: nickreason17 (small blind) collected ($12)





PokerStars Hand #150120874444:  Hold'em No Limit ($0.50/$1.00 USD) - 2016/03/10 10:12:31 CET [2016/03/10 4:12:31 ET]
Table 'Rarahu' 9-max Seat #1 is the button
Seat 1: matiko09 ($100 in chips) 
Seat 2: azzad2007 ($100 in chips) 
Seat 3: ka100pka527 ($44.06 in chips) 
Seat 4: vilo1070 ($104 in chips) 
Seat 5: blackw0lf_03 ($109 in chips) 
Seat 6: RMilPoker ($100 in chips) 
Seat 7: PHILLY_D_S ($152.72 in chips) 
Seat 8: Rikti ($61.85 in chips) 
Seat 9: Srz7v44 ($114.36 in chips) 
azzad2007: posts small blind $0.50
ka100pka527: posts big blind $1
*** HOLE CARDS ***
Dealt to matiko09 [9h Th]
vilo1070: folds 
blackw0lf_03: folds 
RMilPoker: raises $2 to $3
PHILLY_D_S: calls $3
Rikti: calls $3
Srz7v44: folds 
matiko09: calls $3
azzad2007: folds 
ka100pka527: folds 
*** FLOP *** [3c Ks Js]
RMilPoker: checks 
PHILLY_D_S: checks 
Rikti: checks 
matiko09: checks 
*** TURN *** [3c Ks Js] [4s]
RMilPoker: bets $9
PHILLY_D_S: folds 
Rikti: folds 
matiko09: folds 
Uncalled bet ($9) returned to RMilPoker
RMilPoker collected $12.89 from pot
RMilPoker: doesn't show hand 
*** SUMMARY ***
Total pot $13.50 | Rake $0.61 
Board [3c Ks Js 4s]
Seat 1: matiko09 (button) folded on the Turn
Seat 2: azzad2007 (small blind) folded before Flop
Seat 3: ka100pka527 (big blind) folded before Flop
Seat 4: vilo1070 folded before Flop (didn't bet)
Seat 5: blackw0lf_03 folded before Flop (didn't bet)
Seat 6: RMilPoker collected ($12.89)
Seat 7: PHILLY_D_S folded on the Turn
Seat 8: Rikti folded on the Turn
Seat 9: Srz7v44 folded before Flop (didn't bet)





PokerStars Hand #150120875263:  Hold'em No Limit ($1/$2 USD) - 2016/03/10 10:12:33 CET [2016/03/10 4:12:33 ET]
Table 'Vesta' 9-max Seat #1 is the button
Seat 1: nickreason17 ($200 in chips) 
Seat 2: Pernilla E A ($122.63 in chips) 
Seat 3: matiko09 ($200.47 in chips) 
Seat 5: PHILLY_D_S ($312.75 in chips) 
Seat 6: djammusic ($566.09 in chips) 
Seat 7: Monsthand ($210.14 in chips) 
Seat 8: 13Ghosts ($266.20 in chips) 
Seat 9: lixiangli ($369.41 in chips) 
Pernilla E A: posts small blind $1
matiko09: posts big blind $2
Yaaaazz: sits out 
*** HOLE CARDS ***
Dealt to matiko09 [5h 6d]
PHILLY_D_S: folds 
djammusic: folds 
Monsthand has timed out
Monsthand: folds 
13Ghosts: folds 
lixiangli: folds 
nickreason17: folds 
Pernilla E A: raises $4 to $6
matiko09: folds 
Uncalled bet ($4) returned to Pernilla E A
Pernilla E A collected $4 from pot
*** SUMMARY ***
Total pot $4 | Rake $0 
Seat 1: nickreason17 (button) folded before Flop (didn't bet)
Seat 2: Pernilla E A (small blind) collected ($4)
Seat 3: matiko09 (big blind) folded before Flop
Seat 5: PHILLY_D_S folded before Flop (didn't bet)
Seat 6: djammusic folded before Flop (didn't bet)
Seat 7: Monsthand folded before Flop (didn't bet)
Seat 8: 13Ghosts folded before Flop (didn't bet)
Seat 9: lixiangli folded before Flop (didn't bet)





PokerStars Hand #150120877055:  Hold'em No Limit ($1/$2 USD) - 2016/03/10 10:12:38 CET [2016/03/10 4:12:38 ET]
Table 'Archid' 9-max Seat #8 is the button
Seat 1: AP3221 ($104.22 in chips) 
Seat 2: geiranger011 ($93.64 in chips) 
Seat 3: sarkat104 ($155.55 in chips) 
Seat 4: Monsthand ($211.37 in chips) 
Seat 6: Yaaaazz ($650.51 in chips) 
Seat 7: maxxmeister ($205.24 in chips) 
Seat 8: matiko09 ($311.74 in chips) 
Seat 9: WrongButton ($214.74 in chips) 
WrongButton: posts small blind $1
AP3221: posts big blind $2
toprmaw: sits out 
*** HOLE CARDS ***
Dealt to matiko09 [Qs Jd]
geiranger011: folds 
sarkat104: folds 
Monsthand: folds 
Yaaaazz: folds 
maxxmeister: folds 
matiko09: raises $2.54 to $4.54
WrongButton: folds 
AP3221: folds 
Uncalled bet ($2.54) returned to matiko09
matiko09 collected $5 from pot
matiko09: doesn't show hand 
*** SUMMARY ***
Total pot $5 | Rake $0 
Seat 1: AP3221 (big blind) folded before Flop
Seat 2: geiranger011 folded before Flop (didn't bet)
Seat 3: sarkat104 folded before Flop (didn't bet)
Seat 4: Monsthand folded before Flop (didn't bet)
Seat 6: Yaaaazz folded before Flop (didn't bet)
Seat 7: maxxmeister folded before Flop (didn't bet)
Seat 8: matiko09 (button) collected ($5)
Seat 9: WrongButton (small blind) folded before Flop





PokerStars Hand #150120883474:  Hold'em No Limit ($1/$2 USD) - 2016/03/10 10:12:56 CET [2016/03/10 4:12:56 ET]
Table 'Tauris II' 9-max Seat #4 is the button
Seat 1: PHILLY_D_S ($207.24 in chips) 
Seat 2: Rycious ($37.23 in chips) 
Seat 3: vano7777 ($300.08 in chips) 
Seat 4: matiko09 ($377.77 in chips) 
Seat 5: Spudly6 ($170.52 in chips) 
Seat 6: Yaaaazz ($200 in chips) 
Seat 8: WrongButton ($200 in chips) 
Seat 9: darren1031 ($134.19 in chips) 
Spudly6: posts small blind $1
Yaaaazz: posts big blind $2
maxxmeister: sits out 
*** HOLE CARDS ***
Dealt to matiko09 [3s Ad]
WrongButton: folds 
darren1031: folds 
PHILLY_D_S: folds 
Rycious: folds 
vano7777: folds 
matiko09: raises $2.54 to $4.54
Spudly6: folds 
Yaaaazz: calls $2.54
*** FLOP *** [As 2s 4d]
Yaaaazz: checks 
matiko09: bets $5
Yaaaazz: folds 
Uncalled bet ($5) returned to matiko09
matiko09 collected $9.63 from pot
matiko09: doesn't show hand 
*** SUMMARY ***
Total pot $10.08 | Rake $0.45 
Board [As 2s 4d]
Seat 1: PHILLY_D_S folded before Flop (didn't bet)
Seat 2: Rycious folded before Flop (didn't bet)
Seat 3: vano7777 folded before Flop (didn't bet)
Seat 4: matiko09 (button) collected ($9.63)
Seat 5: Spudly6 (small blind) folded before Flop
Seat 6: Yaaaazz (big blind) folded on the Flop
Seat 8: WrongButton folded before Flop (didn't bet)
Seat 9: darren1031 folded before Flop (didn't bet)





PokerStars Hand #150120885156:  Hold'em No Limit ($0.50/$1.00 USD) - 2016/03/10 10:13:01 CET [2016/03/10 4:13:01 ET]
Table 'Nereid' 9-max Seat #1 is the button
Seat 1: matiko09 ($100 in chips) 
Seat 2: PHILLY_D_S ($100 in chips) 
Seat 3: mycka86 ($100 in chips) 
Seat 4: xiaoxiaoniao ($234 in chips) 
Seat 5: ilaviiitech ($100 in chips) 
Seat 6: thecurv ($102.80 in chips) 
Seat 7: Monsthand ($118.67 in chips) 
Seat 8: Rikti ($29.50 in chips) 
Seat 9: zxp12345 ($177.18 in chips) 
PHILLY_D_S: posts small blind $0.50
mycka86: posts big blind $1
*** HOLE CARDS ***
Dealt to matiko09 [Qd 8h]
xiaoxiaoniao: raises $1 to $2
ilaviiitech: folds 
thecurv: raises $6 to $8
Monsthand: folds 
Rikti: folds 
zxp12345: folds 
matiko09: folds 
PHILLY_D_S: folds 
mycka86: folds 
xiaoxiaoniao: calls $6
*** FLOP *** [Ts Jc Ks]
xiaoxiaoniao: checks 
thecurv: checks 
*** TURN *** [Ts Jc Ks] [6d]
xiaoxiaoniao: bets $9
thecurv: calls $9
*** RIVER *** [Ts Jc Ks 6d] [Ac]
xiaoxiaoniao: bets $34
thecurv: folds 
Uncalled bet ($34) returned to xiaoxiaoniao
xiaoxiaoniao collected $33.90 from pot
xiaoxiaoniao: doesn't show hand 
*** SUMMARY ***
Total pot $35.50 | Rake $1.60 
Board [Ts Jc Ks 6d Ac]
Seat 1: matiko09 (button) folded before Flop (didn't bet)
Seat 2: PHILLY_D_S (small blind) folded before Flop
Seat 3: mycka86 (big blind) folded before Flop
Seat 4: xiaoxiaoniao collected ($33.90)
Seat 5: ilaviiitech folded before Flop (didn't bet)
Seat 6: thecurv folded on the River
Seat 7: Monsthand folded before Flop (didn't bet)
Seat 8: Rikti folded before Flop (didn't bet)
Seat 9: zxp12345 folded before Flop (didn't bet)





PokerStars Hand #150120885455:  Hold'em No Limit ($1/$2 USD) - 2016/03/10 10:13:01 CET [2016/03/10 4:13:01 ET]
Table 'Archid' 9-max Seat #9 is the button
Seat 1: AP3221 ($102.22 in chips) 
Seat 2: geiranger011 ($93.64 in chips) 
Seat 3: sarkat104 ($155.55 in chips) 
Seat 4: Monsthand ($211.37 in chips) 
Seat 6: Yaaaazz ($650.51 in chips) 
Seat 7: maxxmeister ($205.24 in chips) 
Seat 8: matiko09 ($314.74 in chips) 
Seat 9: WrongButton ($213.74 in chips) 
AP3221: posts small blind $1
geiranger011: posts big blind $2
toprmaw: sits out 
*** HOLE CARDS ***
Dealt to matiko09 [7s As]
sarkat104: folds 
Monsthand: folds 
Yaaaazz: folds 
maxxmeister: folds 
matiko09: raises $3 to $5
WrongButton: folds 
AP3221: calls $4
geiranger011: folds 
*** FLOP *** [Kh Js Jh]
AP3221: checks 
matiko09: checks 
*** TURN *** [Kh Js Jh] [7c]
AP3221: checks 
matiko09: checks 
*** RIVER *** [Kh Js Jh 7c] [4s]
AP3221: checks 
matiko09: checks 
*** SHOW DOWN ***
AP3221: shows [Ah 4h] (two pair, Jacks and Fours)
matiko09: shows [7s As] (two pair, Jacks and Sevens)
matiko09 collected $11.46 from pot
*** SUMMARY ***
Total pot $12 | Rake $0.54 
Board [Kh Js Jh 7c 4s]
Seat 1: AP3221 (small blind) showed [Ah 4h] and lost with two pair, Jacks and Fours
Seat 2: geiranger011 (big blind) folded before Flop
Seat 3: sarkat104 folded before Flop (didn't bet)
Seat 4: Monsthand folded before Flop (didn't bet)
Seat 6: Yaaaazz folded before Flop (didn't bet)
Seat 7: maxxmeister folded before Flop (didn't bet)
Seat 8: matiko09 showed [7s As] and won ($11.46) with two pair, Jacks and Sevens
Seat 9: WrongButton (button) folded before Flop (didn't bet)





PokerStars Hand #150120890694:  Hold'em No Limit ($1/$2 USD) - 2016/03/10 10:13:16 CET [2016/03/10 4:13:16 ET]
Table 'Sophia II' 9-max Seat #8 is the button
Seat 1: thecurv ($271.68 in chips) 
Seat 2: Sang2015 ($209.80 in chips) 
Seat 3: maxxmeister ($200 in chips) 
Seat 4: hejun0713 ($224.04 in chips) 
Seat 5: matiko09 ($202 in chips) 
Seat 6: WrongButton ($215.83 in chips) 
Seat 7: Monsthand ($202.86 in chips) 
Seat 8: nickreason17 ($215.71 in chips) 
thecurv: posts small blind $1
Sang2015: posts big blind $2
*** HOLE CARDS ***
Dealt to matiko09 [Qd 5d]
maxxmeister: raises $5 to $7
hejun0713: calls $7
matiko09: folds 
WrongButton: folds 
Monsthand: folds 
nickreason17: folds 
thecurv: folds 
Sang2015: folds 
*** FLOP *** [8d Ts 4s]
maxxmeister: bets $11
hejun0713: calls $11
*** TURN *** [8d Ts 4s] [2d]
maxxmeister: checks 
hejun0713: checks 
*** RIVER *** [8d Ts 4s 2d] [9d]
maxxmeister: bets $11.62
hejun0713: calls $11.62
*** SHOW DOWN ***
maxxmeister: shows [Qh Ks] (high card King)
hejun0713: shows [6c 6h] (a pair of Sixes)
hejun0713 collected $59.44 from pot
*** SUMMARY ***
Total pot $62.24 | Rake $2.80 
Board [8d Ts 4s 2d 9d]
Seat 1: thecurv (small blind) folded before Flop
Seat 2: Sang2015 (big blind) folded before Flop
Seat 3: maxxmeister showed [Qh Ks] and lost with high card King
Seat 4: hejun0713 showed [6c 6h] and won ($59.44) with a pair of Sixes
Seat 5: matiko09 folded before Flop (didn't bet)
Seat 6: WrongButton folded before Flop (didn't bet)
Seat 7: Monsthand folded before Flop (didn't bet)
Seat 8: nickreason17 (button) folded before Flop (didn't bet)





PokerStars Hand #150120892435:  Hold'em No Limit (€0.25/€0.50 EUR) - 2016/03/10 10:13:21 CET [2016/03/10 4:13:21 ET]
Table 'Algorab' 9-max Seat #1 is the button
Seat 1: Rikti (€27.02 in chips) 
Seat 2: IvanUrgant (€50 in chips) 
Seat 3: dididi2000 (€43.21 in chips) 
Seat 4: Dantist1122 (€62.91 in chips) 
Seat 5: priterix (€12.13 in chips) 
Seat 6: Bron By (€50 in chips) 
Seat 7: matiko09 (€84.36 in chips) 
Seat 8: fudzi (€51.25 in chips) 
Seat 9: St.LaCoste (€54.17 in chips) 
IvanUrgant: posts small blind €0.25
dididi2000: posts big blind €0.50
*** HOLE CARDS ***
Dealt to matiko09 [9d 9c]
Dantist1122: folds 
priterix: calls €0.50
Bron By: folds 
matiko09: raises €1.50 to €2
fudzi: folds 
St.LaCoste: folds 
Rikti: folds 
IvanUrgant: folds 
dididi2000: folds 
priterix: calls €1.50
*** FLOP *** [4c Jd 5c]
priterix: checks 
matiko09: checks 
*** TURN *** [4c Jd 5c] [6h]
priterix: checks 
matiko09: bets €3
priterix: folds 
Uncalled bet (€3) returned to matiko09
matiko09 collected €4.54 from pot
matiko09: doesn't show hand 
*** SUMMARY ***
Total pot €4.75 | Rake €0.21 
Board [4c Jd 5c 6h]
Seat 1: Rikti (button) folded before Flop (didn't bet)
Seat 2: IvanUrgant (small blind) folded before Flop
Seat 3: dididi2000 (big blind) folded before Flop
Seat 4: Dantist1122 folded before Flop (didn't bet)
Seat 5: priterix folded on the Turn
Seat 6: Bron By folded before Flop (didn't bet)
Seat 7: matiko09 collected (€4.54)
Seat 8: fudzi folded before Flop (didn't bet)
Seat 9: St.LaCoste folded before Flop (didn't bet)





PokerStars Hand #150120894291:  Hold'em No Limit ($0.50/$1.00 USD) - 2016/03/10 10:13:26 CET [2016/03/10 4:13:26 ET]
Table 'Alsciaukat' 9-max Seat #3 is the button
Seat 1: Kelvin sai ($51.10 in chips) 
Seat 2: mycka86 ($100 in chips) 
Seat 3: blackw0lf_03 ($100 in chips) 
Seat 4: Rikti ($39 in chips) 
Seat 5: toprmaw ($108.42 in chips) 
Seat 6: ka100pka527 ($77 in chips) 
Seat 8: F1dgeT ($100 in chips) 
Seat 9: matiko09 ($107.38 in chips) 
Rikti: posts small blind $0.50
toprmaw: posts big blind $1
Yaaaazz: sits out 
*** HOLE CARDS ***
Dealt to matiko09 [2s 7s]
ka100pka527: raises $2 to $3
F1dgeT: folds 
matiko09: folds 
Kelvin sai: folds 
mycka86: calls $3
blackw0lf_03: folds 
Rikti: folds 
toprmaw: folds 
*** FLOP *** [6c 3s 6d]
ka100pka527: bets $10.77
mycka86: folds 
Uncalled bet ($10.77) returned to ka100pka527
ka100pka527 collected $7.16 from pot
ka100pka527: doesn't show hand 
*** SUMMARY ***
Total pot $7.50 | Rake $0.34 
Board [6c 3s 6d]
Seat 1: Kelvin sai folded before Flop (didn't bet)
Seat 2: mycka86 folded on the Flop
Seat 3: blackw0lf_03 (button) folded before Flop (didn't bet)
Seat 4: Rikti (small blind) folded before Flop
Seat 5: toprmaw (big blind) folded before Flop
Seat 6: ka100pka527 collected ($7.16)
Seat 8: F1dgeT folded before Flop (didn't bet)
Seat 9: matiko09 folded before Flop (didn't bet)





PokerStars Hand #150120894895:  Hold'em No Limit ($1/$2 USD) - 2016/03/10 10:13:28 CET [2016/03/10 4:13:28 ET]
Table 'Vesta' 9-max Seat #2 is the button
Seat 1: nickreason17 ($200 in chips) 
Seat 2: Pernilla E A ($124.63 in chips) 
Seat 3: matiko09 ($200 in chips) 
Seat 4: Yaaaazz ($249.44 in chips) 
Seat 5: PHILLY_D_S ($312.75 in chips) 
Seat 6: djammusic ($566.09 in chips) 
Seat 7: Monsthand ($210.14 in chips) 
Seat 8: 13Ghosts ($266.20 in chips) 
Seat 9: lixiangli ($369.41 in chips) 
matiko09: posts small blind $1
Yaaaazz: posts big blind $2
*** HOLE CARDS ***
Dealt to matiko09 [Jd 6s]
PHILLY_D_S: folds 
djammusic: folds 
Monsthand: folds 
13Ghosts: folds 
lixiangli: folds 
nickreason17: raises $3 to $5
Pernilla E A: calls $5
matiko09: folds 
Yaaaazz: folds 
*** FLOP *** [6h 3s 2h]
nickreason17: bets $6.50
Pernilla E A: raises $25.42 to $31.92
nickreason17: folds 
Uncalled bet ($25.42) returned to Pernilla E A
Pernilla E A collected $24.83 from pot
*** SUMMARY ***
Total pot $26 | Rake $1.17 
Board [6h 3s 2h]
Seat 1: nickreason17 folded on the Flop
Seat 2: Pernilla E A (button) collected ($24.83)
Seat 3: matiko09 (small blind) folded before Flop
Seat 4: Yaaaazz (big blind) folded before Flop
Seat 5: PHILLY_D_S folded before Flop (didn't bet)
Seat 6: djammusic folded before Flop (didn't bet)
Seat 7: Monsthand folded before Flop (didn't bet)
Seat 8: 13Ghosts folded before Flop (didn't bet)
Seat 9: lixiangli folded before Flop (didn't bet)





PokerStars Hand #150120897246:  Hold'em No Limit ($1/$2 USD) - 2016/03/10 10:13:34 CET [2016/03/10 4:13:34 ET]
Table 'Solstice II' 9-max Seat #5 is the button
Seat 1: Rycious ($82.88 in chips) 
Seat 3: vano7777 ($104.41 in chips) 
Seat 4: matiko09 ($200 in chips) 
Seat 5: toprmaw ($200 in chips) 
Seat 6: thecurv ($201.82 in chips) 
thecurv: posts small blind $1
Rycious: posts big blind $2
*** HOLE CARDS ***
Dealt to matiko09 [6d 3d]
vano7777: folds 
matiko09: folds 
toprmaw: raises $2.06 to $4.06
thecurv: folds 
Rycious: calls $2.06
*** FLOP *** [4d 9c As]
Rycious: checks 
toprmaw: checks 
*** TURN *** [4d 9c As] [4c]
Rycious: bets $4
toprmaw: calls $4
*** RIVER *** [4d 9c As 4c] [Qd]
Rycious: checks 
toprmaw: bets $6
Rycious: folds 
Uncalled bet ($6) returned to toprmaw
toprmaw collected $16.35 from pot
toprmaw: doesn't show hand 
*** SUMMARY ***
Total pot $17.12 | Rake $0.77 
Board [4d 9c As 4c Qd]
Seat 1: Rycious (big blind) folded on the River
Seat 3: vano7777 folded before Flop (didn't bet)
Seat 4: matiko09 folded before Flop (didn't bet)
Seat 5: toprmaw (button) collected ($16.35)
Seat 6: thecurv (small blind) folded before Flop





PokerStars Hand #150120899618:  Hold'em No Limit ($1/$2 USD) - 2016/03/10 10:13:41 CET [2016/03/10 4:13:41 ET]
Table 'Tauris II' 9-max Seat #5 is the button
Seat 1: PHILLY_D_S ($207.24 in chips) 
Seat 2: Rycious ($37.23 in chips) 
Seat 3: vano7777 ($300.08 in chips) 
Seat 4: matiko09 ($382.86 in chips) 
Seat 5: Spudly6 ($169.52 in chips) 
Seat 6: Yaaaazz ($200 in chips) 
Seat 7: maxxmeister ($376.93 in chips) 
Seat 8: WrongButton ($200 in chips) 
Seat 9: darren1031 ($134.19 in chips) 
Yaaaazz: posts small blind $1
maxxmeister: posts big blind $2
*** HOLE CARDS ***
Dealt to matiko09 [5d Ac]
WrongButton: folds 
darren1031: folds 
PHILLY_D_S: folds 
Rycious: calls $2
vano7777: folds 
matiko09: folds 
Spudly6: calls $2
Yaaaazz: folds 
maxxmeister: checks 
*** FLOP *** [9h 5s Ts]
maxxmeister: checks 
Rycious: bets $4
Spudly6: folds 
maxxmeister: folds 
Uncalled bet ($4) returned to Rycious
Rycious collected $6.68 from pot
Rycious: doesn't show hand 
*** SUMMARY ***
Total pot $7 | Rake $0.32 
Board [9h 5s Ts]
Seat 1: PHILLY_D_S folded before Flop (didn't bet)
Seat 2: Rycious collected ($6.68)
Seat 3: vano7777 folded before Flop (didn't bet)
Seat 4: matiko09 folded before Flop (didn't bet)
Seat 5: Spudly6 (button) folded on the Flop
Seat 6: Yaaaazz (small blind) folded before Flop
Seat 7: maxxmeister (big blind) folded on the Flop
Seat 8: WrongButton folded before Flop (didn't bet)
Seat 9: darren1031 folded before Flop (didn't bet)





PokerStars Hand #150120899880:  Hold'em No Limit ($0.25/$0.50 USD) - 2016/03/10 10:13:41 CET [2016/03/10 4:13:41 ET]
Table 'Aegina' 9-max Seat #8 is the button
Seat 1: Wess_1970 ($114.20 in chips) 
Seat 2: el.suertero ($146.05 in chips) 
Seat 3: matiko09 ($50 in chips) 
Seat 4: vlad11122007 ($54.89 in chips) 
Seat 5: lyhtmqh ($86.36 in chips) 
Seat 6: ardo888 ($147.42 in chips) 
Seat 7: Bohne0815 ($77.85 in chips) 
Seat 8: q3storm ($50.10 in chips) 
Wess_1970: posts small blind $0.25
el.suertero: posts big blind $0.50
Wess_1970: posts the ante $0.10
el.suertero: posts the ante $0.10
matiko09: posts the ante $0.10
vlad11122007: posts the ante $0.10
lyhtmqh: posts the ante $0.10
ardo888: posts the ante $0.10
Bohne0815: posts the ante $0.10
q3storm: posts the ante $0.10
*** HOLE CARDS ***
Dealt to matiko09 [9c 4c]
matiko09: folds 
vlad11122007: folds 
lyhtmqh: folds 
ardo888: folds 
Bohne0815: folds 
q3storm: folds 
Wess_1970: raises $0.50 to $1
el.suertero: calls $0.50
*** FLOP *** [7s Kc 3d]
kazu1003 leaves the table
Wess_1970: bets $0.50
el.suertero: raises $1.28 to $1.78
Wess_1970: calls $1.28
*** TURN *** [7s Kc 3d] [7d]
Wess_1970: bets $0.50
el.suertero: calls $0.50
*** RIVER *** [7s Kc 3d 7d] [6d]
Wess_1970: bets $0.50
el.suertero: calls $0.50
*** SHOW DOWN ***
Wess_1970: shows [Ad Kd] (a flush, Ace high)
el.suertero: mucks hand 
Wess_1970 collected $7.98 from pot
*** SUMMARY ***
Total pot $8.36 | Rake $0.38 
Board [7s Kc 3d 7d 6d]
Seat 1: Wess_1970 (small blind) showed [Ad Kd] and won ($7.98) with a flush, Ace high
Seat 2: el.suertero (big blind) mucked [8c Kh]
Seat 3: matiko09 folded before Flop (didn't bet)
Seat 4: vlad11122007 folded before Flop (didn't bet)
Seat 5: lyhtmqh folded before Flop (didn't bet)
Seat 6: ardo888 folded before Flop (didn't bet)
Seat 7: Bohne0815 folded before Flop (didn't bet)
Seat 8: q3storm (button) folded before Flop (didn't bet)





PokerStars Hand #150120905740:  Hold'em No Limit (€0.25/€0.50 EUR) - 2016/03/10 10:13:57 CET [2016/03/10 4:13:57 ET]
Table 'Algorab' 9-max Seat #2 is the button
Seat 1: Rikti (€27.02 in chips) 
Seat 2: IvanUrgant (€50 in chips) 
Seat 3: dididi2000 (€42.71 in chips) 
Seat 4: Dantist1122 (€62.91 in chips) 
Seat 5: priterix (€10.13 in chips) 
Seat 6: Bron By (€50 in chips) 
Seat 7: matiko09 (€86.90 in chips) 
Seat 8: fudzi (€51.25 in chips) 
Seat 9: St.LaCoste (€54.17 in chips) 
dididi2000: posts small blind €0.25
Dantist1122: posts big blind €0.50
*** HOLE CARDS ***
Dealt to matiko09 [8c As]
priterix: raises €1.50 to €2
Bron By: folds 
matiko09: folds 
fudzi: folds 
St.LaCoste: folds 
Rikti: folds 
IvanUrgant: folds 
dididi2000: folds 
Dantist1122: raises €3 to €5
priterix: calls €3
*** FLOP *** [Jh 8d Kh]
Dantist1122: checks 
priterix: bets €5.13 and is all-in
Dantist1122: calls €5.13
*** TURN *** [Jh 8d Kh] [2s]
*** RIVER *** [Jh 8d Kh 2s] [7d]
*** SHOW DOWN ***
Dantist1122: shows [Kc Ac] (a pair of Kings)
priterix: shows [Ad 4d] (high card Ace)
Dantist1122 collected €19.59 from pot
*** SUMMARY ***
Total pot €20.51 | Rake €0.92 
Board [Jh 8d Kh 2s 7d]
Seat 1: Rikti folded before Flop (didn't bet)
Seat 2: IvanUrgant (button) folded before Flop (didn't bet)
Seat 3: dididi2000 (small blind) folded before Flop
Seat 4: Dantist1122 (big blind) showed [Kc Ac] and won (€19.59) with a pair of Kings
Seat 5: priterix showed [Ad 4d] and lost with high card Ace
Seat 6: Bron By folded before Flop (didn't bet)
Seat 7: matiko09 folded before Flop (didn't bet)
Seat 8: fudzi folded before Flop (didn't bet)
Seat 9: St.LaCoste folded before Flop (didn't bet)





PokerStars Hand #150120907800:  Hold'em No Limit ($1/$2 USD) - 2016/03/10 10:14:03 CET [2016/03/10 4:14:03 ET]
Table 'Sophia II' 9-max Seat #1 is the button
Seat 1: thecurv ($270.68 in chips) 
Seat 2: Sang2015 ($207.80 in chips) 
Seat 3: maxxmeister ($200 in chips) 
Seat 4: hejun0713 ($253.86 in chips) 
Seat 5: matiko09 ($202 in chips) 
Seat 6: WrongButton ($215.83 in chips) 
Seat 7: Monsthand ($202.86 in chips) 
Seat 8: nickreason17 ($215.71 in chips) 
Sang2015: posts small blind $1
maxxmeister: posts big blind $2
*** HOLE CARDS ***
Dealt to matiko09 [5h 2h]
hejun0713: folds 
matiko09: folds 
WrongButton: folds 
Monsthand: folds 
nickreason17: folds 
thecurv: raises $3 to $5
Sang2015: folds 
maxxmeister: folds 
Uncalled bet ($3) returned to thecurv
thecurv collected $5 from pot
thecurv: doesn't show hand 
*** SUMMARY ***
Total pot $5 | Rake $0 
Seat 1: thecurv (button) collected ($5)
Seat 2: Sang2015 (small blind) folded before Flop
Seat 3: maxxmeister (big blind) folded before Flop
Seat 4: hejun0713 folded before Flop (didn't bet)
Seat 5: matiko09 folded before Flop (didn't bet)
Seat 6: WrongButton folded before Flop (didn't bet)
Seat 7: Monsthand folded before Flop (didn't bet)
Seat 8: nickreason17 folded before Flop (didn't bet)





PokerStars Hand #150120910652:  Hold'em No Limit ($0.50/$1.00 USD) - 2016/03/10 10:14:11 CET [2016/03/10 4:14:11 ET]
Table 'Nereid' 9-max Seat #2 is the button
Seat 1: matiko09 ($100 in chips) 
Seat 2: PHILLY_D_S ($100 in chips) 
Seat 3: mycka86 ($100 in chips) 
Seat 4: xiaoxiaoniao ($250.90 in chips) 
Seat 5: ilaviiitech ($100 in chips) 
Seat 6: thecurv ($100 in chips) 
Seat 7: Monsthand ($118.67 in chips) 
Seat 8: Rikti ($29.50 in chips) 
Seat 9: zxp12345 ($177.18 in chips) 
mycka86: posts small blind $0.50
xiaoxiaoniao: posts big blind $1
*** HOLE CARDS ***
Dealt to matiko09 [5h 2d]
ilaviiitech: folds 
thecurv: folds 
Monsthand: raises $2 to $3
Rikti: folds 
zxp12345: folds 
matiko09: folds 
PHILLY_D_S: folds 
mycka86: folds 
xiaoxiaoniao: calls $2
*** FLOP *** [7d 9h 3c]
xiaoxiaoniao: checks 
Monsthand: bets $4
xiaoxiaoniao: folds 
Uncalled bet ($4) returned to Monsthand
zxp12345 said, "你那里的"
Monsthand collected $6.21 from pot
Monsthand: doesn't show hand 
*** SUMMARY ***
Total pot $6.50 | Rake $0.29 
Board [7d 9h 3c]
Seat 1: matiko09 folded before Flop (didn't bet)
Seat 2: PHILLY_D_S (button) folded before Flop (didn't bet)
Seat 3: mycka86 (small blind) folded before Flop
Seat 4: xiaoxiaoniao (big blind) folded on the Flop
Seat 5: ilaviiitech folded before Flop (didn't bet)
Seat 6: thecurv folded before Flop (didn't bet)
Seat 7: Monsthand collected ($6.21)
Seat 8: Rikti folded before Flop (didn't bet)
Seat 9: zxp12345 folded before Flop (didn't bet)





PokerStars Hand #150120911085:  Hold'em No Limit ($0.50/$1.00 USD) - 2016/03/10 10:14:12 CET [2016/03/10 4:14:12 ET]
Table 'Tarka' 9-max Seat #1 is the button
Seat 1: Monsthand ($131.74 in chips) 
Seat 2: thecurv ($130.94 in chips) 
Seat 3: matiko09 ($100 in chips) 
Seat 4: toprmaw ($100 in chips) 
Seat 5: WrongButton ($107 in chips) 
Seat 6: blackw0lf_03 ($121.98 in chips) 
Seat 7: ka100pka527 ($88.42 in chips) 
Seat 9: RMilPoker ($100 in chips) 
thecurv: posts small blind $0.50
matiko09: posts big blind $1
*** HOLE CARDS ***
Dealt to matiko09 [Kh 5h]
toprmaw: folds 
WrongButton: folds 
blackw0lf_03: folds 
ka100pka527: folds 
RMilPoker: raises $2 to $3
Monsthand: raises $6 to $9
thecurv: folds 
matiko09: folds 
RMilPoker: folds 
Uncalled bet ($6) returned to Monsthand
Monsthand collected $7.50 from pot
Monsthand: doesn't show hand 
*** SUMMARY ***
Total pot $7.50 | Rake $0 
Seat 1: Monsthand (button) collected ($7.50)
Seat 2: thecurv (small blind) folded before Flop
Seat 3: matiko09 (big blind) folded before Flop
Seat 4: toprmaw folded before Flop (didn't bet)
Seat 5: WrongButton folded before Flop (didn't bet)
Seat 6: blackw0lf_03 folded before Flop (didn't bet)
Seat 7: ka100pka527 folded before Flop (didn't bet)
Seat 9: RMilPoker folded before Flop





PokerStars Hand #150120911770:  Hold'em No Limit ($1/$2 USD) - 2016/03/10 10:14:14 CET [2016/03/10 4:14:14 ET]
Table 'Vesta' 9-max Seat #3 is the button
Seat 1: nickreason17 ($200 in chips) 
Seat 2: Pernilla E A ($137.96 in chips) 
Seat 3: matiko09 ($200 in chips) 
Seat 4: Yaaaazz ($247.44 in chips) 
Seat 5: PHILLY_D_S ($312.75 in chips) 
Seat 6: djammusic ($566.09 in chips) 
Seat 7: Monsthand ($210.14 in chips) 
Seat 8: 13Ghosts ($266.20 in chips) 
Seat 9: lixiangli ($369.41 in chips) 
Yaaaazz: posts small blind $1
PHILLY_D_S: posts big blind $2
*** HOLE CARDS ***
Dealt to matiko09 [7d 5d]
djammusic: folds 
Monsthand: folds 
13Ghosts: raises $2.46 to $4.46
lixiangli: folds 
nickreason17: folds 
Pernilla E A: calls $4.46
matiko09: folds 
Yaaaazz: folds 
PHILLY_D_S: calls $2.46
*** FLOP *** [Th Qh Jc]
PHILLY_D_S: checks 
13Ghosts: checks 
Pernilla E A: checks 
*** TURN *** [Th Qh Jc] [4h]
PHILLY_D_S: checks 
13Ghosts: bets $10.29
Pernilla E A: folds 
PHILLY_D_S: folds 
Uncalled bet ($10.29) returned to 13Ghosts
13Ghosts collected $13.73 from pot
13Ghosts: doesn't show hand 
*** SUMMARY ***
Total pot $14.38 | Rake $0.65 
Board [Th Qh Jc 4h]
Seat 1: nickreason17 folded before Flop (didn't bet)
Seat 2: Pernilla E A folded on the Turn
Seat 3: matiko09 (button) folded before Flop (didn't bet)
Seat 4: Yaaaazz (small blind) folded before Flop
Seat 5: PHILLY_D_S (big blind) folded on the Turn
Seat 6: djammusic folded before Flop (didn't bet)
Seat 7: Monsthand folded before Flop (didn't bet)
Seat 8: 13Ghosts collected ($13.73)
Seat 9: lixiangli folded before Flop (didn't bet)





PokerStars Hand #150120912348:  Hold'em No Limit ($1/$2 USD) - 2016/03/10 10:14:16 CET [2016/03/10 4:14:16 ET]
Table 'Archid' 9-max Seat #1 is the button
Seat 1: AP3221 ($97.22 in chips) 
Seat 2: geiranger011 ($91.64 in chips) 
Seat 3: sarkat104 ($155.55 in chips) 
Seat 4: Monsthand ($211.37 in chips) 
Seat 6: Yaaaazz ($650.51 in chips) 
Seat 7: maxxmeister ($205.24 in chips) 
Seat 8: matiko09 ($321.20 in chips) 
Seat 9: WrongButton ($213.74 in chips) 
geiranger011: posts small blind $1
sarkat104: posts big blind $2
toprmaw: sits out 
*** HOLE CARDS ***
Dealt to matiko09 [Qs 5d]
Monsthand: folds 
Yaaaazz: folds 
maxxmeister: folds 
matiko09: folds 
WrongButton: raises $4 to $6
AP3221: folds 
geiranger011: folds 
sarkat104: folds 
Uncalled bet ($4) returned to WrongButton
WrongButton collected $5 from pot
*** SUMMARY ***
Total pot $5 | Rake $0 
Seat 1: AP3221 (button) folded before Flop (didn't bet)
Seat 2: geiranger011 (small blind) folded before Flop
Seat 3: sarkat104 (big blind) folded before Flop
Seat 4: Monsthand folded before Flop (didn't bet)
Seat 6: Yaaaazz folded before Flop (didn't bet)
Seat 7: maxxmeister folded before Flop (didn't bet)
Seat 8: matiko09 folded before Flop (didn't bet)
Seat 9: WrongButton collected ($5)





PokerStars Hand #150120914647:  Hold'em No Limit ($1/$2 USD) - 2016/03/10 10:14:22 CET [2016/03/10 4:14:22 ET]
Table 'Sophia II' 9-max Seat #2 is the button
Seat 1: thecurv ($273.68 in chips) 
Seat 2: Sang2015 ($206.80 in chips) 
Seat 3: maxxmeister ($200 in chips) 
Seat 4: hejun0713 ($253.86 in chips) 
Seat 5: matiko09 ($202 in chips) 
Seat 6: WrongButton ($215.83 in chips) 
Seat 7: Monsthand ($202.86 in chips) 
Seat 8: nickreason17 ($215.71 in chips) 
maxxmeister: posts small blind $1
hejun0713: posts big blind $2
*** HOLE CARDS ***
Dealt to matiko09 [8c 4h]
matiko09: folds 
WrongButton: folds 
Monsthand: raises $4 to $6
nickreason17: folds 
thecurv: folds 
Sang2015: folds 
maxxmeister: folds 
hejun0713: folds 
Uncalled bet ($4) returned to Monsthand
Monsthand collected $5 from pot
Monsthand: doesn't show hand 
*** SUMMARY ***
Total pot $5 | Rake $0 
Seat 1: thecurv folded before Flop (didn't bet)
Seat 2: Sang2015 (button) folded before Flop (didn't bet)
Seat 3: maxxmeister (small blind) folded before Flop
Seat 4: hejun0713 (big blind) folded before Flop
Seat 5: matiko09 folded before Flop (didn't bet)
Seat 6: WrongButton folded before Flop (didn't bet)
Seat 7: Monsthand collected ($5)
Seat 8: nickreason17 folded before Flop (didn't bet)





PokerStars Hand #150120914683:  Hold'em No Limit ($0.50/$1.00 USD) - 2016/03/10 10:14:22 CET [2016/03/10 4:14:22 ET]
Table 'Alsciaukat' 9-max Seat #4 is the button
Seat 1: Kelvin sai ($51.10 in chips) 
Seat 2: mycka86 ($100 in chips) 
Seat 3: blackw0lf_03 ($100 in chips) 
Seat 4: Rikti ($38.50 in chips) 
Seat 5: toprmaw ($107.42 in chips) 
Seat 7: Yaaaazz ($123.24 in chips) 
Seat 8: F1dgeT ($100 in chips) 
Seat 9: matiko09 ($107.38 in chips) 
toprmaw: posts small blind $0.50
ka100pka527: is sitting out 
Yaaaazz: posts big blind $1
*** HOLE CARDS ***
Dealt to matiko09 [2d 6s]
ka100pka527 leaves the table
F1dgeT: folds 
matiko09: folds 
Kelvin sai: folds 
mycka86: folds 
Sweden_Pound joins the table at seat #6 
blackw0lf_03: folds 
Rikti: raises $1 to $2
toprmaw: raises $4.50 to $6.50
Yaaaazz: folds 
Rikti: folds 
Uncalled bet ($4.50) returned to toprmaw
toprmaw collected $5 from pot
toprmaw: doesn't show hand 
*** SUMMARY ***
Total pot $5 | Rake $0 
Seat 1: Kelvin sai folded before Flop (didn't bet)
Seat 2: mycka86 folded before Flop (didn't bet)
Seat 3: blackw0lf_03 folded before Flop (didn't bet)
Seat 4: Rikti (button) folded before Flop
Seat 5: toprmaw (small blind) collected ($5)
Seat 7: Yaaaazz (big blind) folded before Flop
Seat 8: F1dgeT folded before Flop (didn't bet)
Seat 9: matiko09 folded before Flop (didn't bet)





PokerStars Hand #150120916750:  Hold'em No Limit ($1/$2 USD) - 2016/03/10 10:14:28 CET [2016/03/10 4:14:28 ET]
Table 'Solstice II' 9-max Seat #6 is the button
Seat 1: Rycious ($74.82 in chips) 
Seat 3: vano7777 ($104.41 in chips) 
Seat 4: matiko09 ($200 in chips) 
Seat 5: toprmaw ($208.29 in chips) 
Seat 6: thecurv ($200.82 in chips) 
Rycious: posts small blind $1
vano7777: posts big blind $2
*** HOLE CARDS ***
Dealt to matiko09 [3s 9d]
matiko09: folds 
toprmaw: raises $3 to $5
thecurv: calls $5
Rycious: calls $4
vano7777: calls $3
*** FLOP *** [Qh Js Th]
Rycious: checks 
vano7777: bets $16
toprmaw: folds 
thecurv: calls $16
Rycious: folds 
*** TURN *** [Qh Js Th] [9s]
vano7777: checks 
thecurv: checks 
*** RIVER *** [Qh Js Th 9s] [4c]
vano7777: checks 
thecurv: checks 
*** SHOW DOWN ***
vano7777: shows [Qs Tc] (two pair, Queens and Tens)
thecurv: shows [Qd Qc] (three of a kind, Queens)
thecurv collected $49.66 from pot
*** SUMMARY ***
Total pot $52 | Rake $2.34 
Board [Qh Js Th 9s 4c]
Seat 1: Rycious (small blind) folded on the Flop
Seat 3: vano7777 (big blind) showed [Qs Tc] and lost with two pair, Queens and Tens
Seat 4: matiko09 folded before Flop (didn't bet)
Seat 5: toprmaw folded on the Flop
Seat 6: thecurv (button) showed [Qd Qc] and won ($49.66) with three of a kind, Queens





PokerStars Hand #150120917231:  Hold'em No Limit ($0.50/$1.00 USD) - 2016/03/10 10:14:29 CET [2016/03/10 4:14:29 ET]
Table 'Rarahu' 9-max Seat #2 is the button
Seat 1: matiko09 ($100 in chips) 
Seat 2: azzad2007 ($100 in chips) 
Seat 3: ka100pka527 ($43.06 in chips) 
Seat 4: vilo1070 ($104 in chips) 
Seat 5: blackw0lf_03 ($109 in chips) 
Seat 6: RMilPoker ($109.89 in chips) 
Seat 7: PHILLY_D_S ($149.72 in chips) 
Seat 8: Rikti ($58.85 in chips) 
Seat 9: Srz7v44 ($114.36 in chips) 
ka100pka527: posts small blind $0.50
vilo1070: posts big blind $1
*** HOLE CARDS ***
Dealt to matiko09 [3s As]
blackw0lf_03: folds 
RMilPoker: folds 
PHILLY_D_S: folds 
Rikti: folds 
Srz7v44: raises $2 to $3
matiko09: folds 
azzad2007: folds 
ka100pka527: folds 
vilo1070: folds 
Uncalled bet ($2) returned to Srz7v44
Srz7v44 collected $2.50 from pot
*** SUMMARY ***
Total pot $2.50 | Rake $0 
Seat 1: matiko09 folded before Flop (didn't bet)
Seat 2: azzad2007 (button) folded before Flop (didn't bet)
Seat 3: ka100pka527 (small blind) folded before Flop
Seat 4: vilo1070 (big blind) folded before Flop
Seat 5: blackw0lf_03 folded before Flop (didn't bet)
Seat 6: RMilPoker folded before Flop (didn't bet)
Seat 7: PHILLY_D_S folded before Flop (didn't bet)
Seat 8: Rikti folded before Flop (didn't bet)
Seat 9: Srz7v44 collected ($2.50)





PokerStars Hand #150120918516:  Hold'em No Limit ($1/$2 USD) - 2016/03/10 10:14:32 CET [2016/03/10 4:14:32 ET]
Table 'Tauris II' 9-max Seat #6 is the button
Seat 1: PHILLY_D_S ($207.24 in chips) 
Seat 2: Rycious ($41.91 in chips) 
Seat 3: vano7777 ($300.08 in chips) 
Seat 4: matiko09 ($382.86 in chips) 
Seat 5: Spudly6 ($167.52 in chips) 
Seat 6: Yaaaazz ($200 in chips) 
Seat 7: maxxmeister ($374.93 in chips) 
Seat 8: WrongButton ($200 in chips) 
Seat 9: darren1031 ($134.19 in chips) 
maxxmeister: posts small blind $1
WrongButton: posts big blind $2
*** HOLE CARDS ***
Dealt to matiko09 [9c Jd]
darren1031: calls $2
PHILLY_D_S: folds 
Rycious: calls $2
vano7777 has timed out
vano7777: folds 
matiko09: folds 
Spudly6: folds 
Yaaaazz: raises $10 to $12
maxxmeister: folds 
WrongButton: folds 
darren1031: calls $10
Rycious: calls $10
*** FLOP *** [4h Ah 6d]
darren1031: checks 
Rycious: bets $10
Yaaaazz: calls $10
darren1031: folds 
*** TURN *** [4h Ah 6d] [Kh]
Rycious: bets $19.91 and is all-in
Yaaaazz: calls $19.91
*** FIRST RIVER *** [4h Ah 6d Kh] [Qd]
*** SECOND RIVER *** [4h Ah 6d Kh] [7d]
*** FIRST SHOW DOWN ***
Rycious: shows [Th Ac] (a pair of Aces)
Yaaaazz: shows [As Ks] (two pair, Aces and Kings)
Yaaaazz collected $48.01 from pot
*** SECOND SHOW DOWN ***
Rycious: shows [Th Ac] (a pair of Aces)
Yaaaazz: shows [As Ks] (two pair, Aces and Kings)
Yaaaazz collected $48.01 from pot
*** SUMMARY ***
Total pot $98.82 | Rake $2.80 
Hand was run twice
FIRST Board [4h Ah 6d Kh Qd]
SECOND Board [4h Ah 6d Kh 7d]
Seat 1: PHILLY_D_S folded before Flop (didn't bet)
Seat 2: Rycious showed [Th Ac] and lost with a pair of Aces, and lost with a pair of Aces
Seat 3: vano7777 folded before Flop (didn't bet)
Seat 4: matiko09 folded before Flop (didn't bet)
Seat 5: Spudly6 folded before Flop (didn't bet)
Seat 6: Yaaaazz (button) showed [As Ks] and won ($48.01) with two pair, Aces and Kings, and won ($48.01) with two pair, Aces and Kings
Seat 7: maxxmeister (small blind) folded before Flop
Seat 8: WrongButton (big blind) folded before Flop
Seat 9: darren1031 folded on the Flop





PokerStars Hand #150120919357:  Hold'em No Limit ($0.25/$0.50 USD) - 2016/03/10 10:14:35 CET [2016/03/10 4:14:35 ET]
Table 'Aegina' 9-max Seat #1 is the button
Seat 1: Wess_1970 ($118.30 in chips) 
Seat 2: el.suertero ($142.17 in chips) 
Seat 3: matiko09 ($50 in chips) 
Seat 4: vlad11122007 ($54.79 in chips) 
Seat 5: lyhtmqh ($86.26 in chips) 
Seat 6: ardo888 ($147.32 in chips) 
Seat 7: Bohne0815 ($77.75 in chips) 
Seat 8: q3storm ($50 in chips) 
el.suertero: posts small blind $0.25
matiko09: posts big blind $0.50
Wess_1970: posts the ante $0.10
el.suertero: posts the ante $0.10
matiko09: posts the ante $0.10
vlad11122007: posts the ante $0.10
lyhtmqh: posts the ante $0.10
ardo888: posts the ante $0.10
Bohne0815: posts the ante $0.10
q3storm: posts the ante $0.10
*** HOLE CARDS ***
Dealt to matiko09 [7s 8h]
vlad11122007: raises $1 to $1.50
lyhtmqh: folds 
ardo888: folds 
i L00K great joins the table at seat #9 
Bohne0815: folds 
q3storm: folds 
Wess_1970: calls $1.50
el.suertero: folds 
matiko09: folds 
*** FLOP *** [3h 4d 3d]
vlad11122007: checks 
Wess_1970: checks 
*** TURN *** [3h 4d 3d] [Kd]
vlad11122007: bets $2.95
Wess_1970: folds 
Uncalled bet ($2.95) returned to vlad11122007
vlad11122007 collected $4.35 from pot
vlad11122007: doesn't show hand 
*** SUMMARY ***
Total pot $4.55 | Rake $0.20 
Board [3h 4d 3d Kd]
Seat 1: Wess_1970 (button) folded on the Turn
Seat 2: el.suertero (small blind) folded before Flop
Seat 3: matiko09 (big blind) folded before Flop
Seat 4: vlad11122007 collected ($4.35)
Seat 5: lyhtmqh folded before Flop (didn't bet)
Seat 6: ardo888 folded before Flop (didn't bet)
Seat 7: Bohne0815 folded before Flop (didn't bet)
Seat 8: q3storm folded before Flop (didn't bet)





PokerStars Hand #150120920756:  Hold'em No Limit ($1/$2 USD) - 2016/03/10 10:14:39 CET [2016/03/10 4:14:39 ET]
Table 'Sophia II' 9-max Seat #3 is the button
Seat 1: thecurv ($273.68 in chips) 
Seat 2: Sang2015 ($206.80 in chips) 
Seat 3: maxxmeister ($200 in chips) 
Seat 4: hejun0713 ($251.86 in chips) 
Seat 5: matiko09 ($202 in chips) 
Seat 6: WrongButton ($215.83 in chips) 
Seat 7: Monsthand ($205.86 in chips) 
Seat 8: nickreason17 ($215.71 in chips) 
hejun0713: posts small blind $1
matiko09: posts big blind $2
*** HOLE CARDS ***
Dealt to matiko09 [6d 4c]
WrongButton: folds 
Monsthand: raises $4 to $6
nickreason17: folds 
thecurv: folds 
Sang2015: folds 
maxxmeister: folds 
hejun0713: calls $5
matiko09: folds 
*** FLOP *** [Kh Td 3d]
hejun0713: checks 
Monsthand: bets $8.50
hejun0713: calls $8.50
*** TURN *** [Kh Td 3d] [7d]
hejun0713: checks 
Monsthand: bets $19
hejun0713: calls $19
*** RIVER *** [Kh Td 3d 7d] [6s]
hejun0713: bets $26
Monsthand: calls $26
*** SHOW DOWN ***
hejun0713: shows [As Kd] (a pair of Kings)
Monsthand: shows [Ac Ah] (a pair of Aces)
Monsthand collected $118.20 from pot
*** SUMMARY ***
Total pot $121 | Rake $2.80 
Board [Kh Td 3d 7d 6s]
Seat 1: thecurv folded before Flop (didn't bet)
Seat 2: Sang2015 folded before Flop (didn't bet)
Seat 3: maxxmeister (button) folded before Flop (didn't bet)
Seat 4: hejun0713 (small blind) showed [As Kd] and lost with a pair of Kings
Seat 5: matiko09 (big blind) folded before Flop
Seat 6: WrongButton folded before Flop (didn't bet)
Seat 7: Monsthand showed [Ac Ah] and won ($118.20) with a pair of Aces
Seat 8: nickreason17 folded before Flop (didn't bet)





PokerStars Hand #150120921246:  Hold'em No Limit ($0.50/$1.00 USD) - 2016/03/10 10:14:40 CET [2016/03/10 4:14:40 ET]
Table 'Tarka' 9-max Seat #2 is the button
Seat 1: Monsthand ($136.24 in chips) 
Seat 2: thecurv ($130.44 in chips) 
Seat 3: matiko09 ($100 in chips) 
Seat 6: blackw0lf_03 ($121.98 in chips) 
Seat 7: ka100pka527 ($88.42 in chips) 
Seat 9: RMilPoker ($100 in chips) 
matiko09: posts small blind $0.50
toprmaw: is sitting out 
WrongButton: is sitting out 
blackw0lf_03: posts big blind $1
*** HOLE CARDS ***
Dealt to matiko09 [4d 4s]
WrongButton leaves the table
ka100pka527: folds 
RMilPoker: folds 
Prettyspitz joins the table at seat #5 
Monsthand: raises $1.50 to $2.50
Prettyspitz leaves the table
thecurv: folds 
matiko09: folds 
toprmaw leaves the table
blackw0lf_03: folds 
Uncalled bet ($1.50) returned to Monsthand
Monsthand collected $2.50 from pot
Monsthand: doesn't show hand 
*** SUMMARY ***
Total pot $2.50 | Rake $0 
Seat 1: Monsthand collected ($2.50)
Seat 2: thecurv (button) folded before Flop (didn't bet)
Seat 3: matiko09 (small blind) folded before Flop
Seat 6: blackw0lf_03 (big blind) folded before Flop
Seat 7: ka100pka527 folded before Flop (didn't bet)
Seat 9: RMilPoker folded before Flop (didn't bet)





PokerStars Hand #150120924804:  Hold'em No Limit ($0.50/$1.00 USD) - 2016/03/10 10:14:50 CET [2016/03/10 4:14:50 ET]
Table 'Liriope II' 9-max Seat #5 is the button
Seat 1: Bron By ($100 in chips) 
Seat 2: vano7777 ($217.71 in chips) 
Seat 3: azzad2007 ($116.80 in chips) 
Seat 4: matiko09 ($133.15 in chips) 
Seat 5: toprmaw ($250 in chips) 
Seat 6: Monsthand ($101.30 in chips) 
Seat 7: mycka86 ($139.50 in chips) 
Seat 9: huti429 ($194.09 in chips) 
Monsthand: posts small blind $0.50
mycka86: posts big blind $1
Bron By: posts the ante $0.20
vano7777: posts the ante $0.20
azzad2007: posts the ante $0.20
matiko09: posts the ante $0.20
toprmaw: posts the ante $0.20
Monsthand: posts the ante $0.20
mycka86: posts the ante $0.20
huti429: posts the ante $0.20
*** HOLE CARDS ***
Dealt to matiko09 [8s 4d]
huti429: folds 
Bron By: raises $2 to $3
vano7777: folds 
azzad2007: calls $3
matiko09: folds 
toprmaw: folds 
Monsthand: folds 
mycka86: folds 
*** FLOP *** [4s Jh 3s]
Bron By: bets $6.52
azzad2007: folds 
Uncalled bet ($6.52) returned to Bron By
Bron By collected $8.69 from pot
Bron By: doesn't show hand 
*** SUMMARY ***
Total pot $9.10 | Rake $0.41 
Board [4s Jh 3s]
Seat 1: Bron By collected ($8.69)
Seat 2: vano7777 folded before Flop (didn't bet)
Seat 3: azzad2007 folded on the Flop
Seat 4: matiko09 folded before Flop (didn't bet)
Seat 5: toprmaw (button) folded before Flop (didn't bet)
Seat 6: Monsthand (small blind) folded before Flop
Seat 7: mycka86 (big blind) folded before Flop
Seat 9: huti429 folded before Flop (didn't bet)





PokerStars Hand #150120925437:  Hold'em No Limit ($1/$2 USD) - 2016/03/10 10:14:51 CET [2016/03/10 4:14:51 ET]
Table 'Archid' 9-max Seat #2 is the button
Seat 1: AP3221 ($97.22 in chips) 
Seat 2: geiranger011 ($90.64 in chips) 
Seat 3: sarkat104 ($153.55 in chips) 
Seat 4: Monsthand ($211.37 in chips) 
Seat 6: Yaaaazz ($650.51 in chips) 
Seat 7: maxxmeister ($205.24 in chips) 
Seat 8: matiko09 ($321.20 in chips) 
Seat 9: WrongButton ($216.74 in chips) 
sarkat104: posts small blind $1
Monsthand: posts big blind $2
toprmaw: sits out 
*** HOLE CARDS ***
Dealt to matiko09 [5d Tc]
Yaaaazz: folds 
maxxmeister: folds 
matiko09: folds 
WrongButton: folds 
AP3221: folds 
geiranger011: folds 
sarkat104: folds 
Uncalled bet ($1) returned to Monsthand
Monsthand collected $2 from pot
Monsthand: doesn't show hand 
*** SUMMARY ***
Total pot $2 | Rake $0 
Seat 1: AP3221 folded before Flop (didn't bet)
Seat 2: geiranger011 (button) folded before Flop (didn't bet)
Seat 3: sarkat104 (small blind) folded before Flop
Seat 4: Monsthand (big blind) collected ($2)
Seat 6: Yaaaazz folded before Flop (didn't bet)
Seat 7: maxxmeister folded before Flop (didn't bet)
Seat 8: matiko09 folded before Flop (didn't bet)
Seat 9: WrongButton folded before Flop (didn't bet)





PokerStars Hand #150120927558:  Hold'em No Limit (€0.25/€0.50 EUR) - 2016/03/10 10:14:57 CET [2016/03/10 4:14:57 ET]
Table 'Algorab' 9-max Seat #3 is the button
Seat 1: Rikti (€27.02 in chips) 
Seat 2: IvanUrgant (€50 in chips) 
Seat 3: dididi2000 (€42.46 in chips) 
Seat 4: Dantist1122 (€72.37 in chips) 
Seat 6: Bron By (€50 in chips) 
Seat 7: matiko09 (€86.90 in chips) 
Seat 8: fudzi (€51.25 in chips) 
Seat 9: St.LaCoste (€54.17 in chips) 
Dantist1122: posts small blind €0.25
Bron By: posts big blind €0.50
*** HOLE CARDS ***
Dealt to matiko09 [8d 7h]
matiko09: folds 
fudzi: folds 
St.LaCoste: folds 
Rikti: folds 
IvanUrgant: folds 
dididi2000: folds 
Dantist1122: folds 
Uncalled bet (€0.25) returned to Bron By
Bron By collected €0.50 from pot
Bron By: doesn't show hand 
*** SUMMARY ***
Total pot €0.50 | Rake €0 
Seat 1: Rikti folded before Flop (didn't bet)
Seat 2: IvanUrgant folded before Flop (didn't bet)
Seat 3: dididi2000 (button) folded before Flop (didn't bet)
Seat 4: Dantist1122 (small blind) folded before Flop
Seat 6: Bron By (big blind) collected (€0.50)
Seat 7: matiko09 folded before Flop (didn't bet)
Seat 8: fudzi folded before Flop (didn't bet)
Seat 9: St.LaCoste folded before Flop (didn't bet)





PokerStars Hand #150120929719:  Hold'em No Limit ($0.50/$1.00 USD) - 2016/03/10 10:15:03 CET [2016/03/10 4:15:03 ET]
Table 'Tarka' 9-max Seat #3 is the button
Seat 1: Monsthand ($137.74 in chips) 
Seat 2: thecurv ($130.44 in chips) 
Seat 3: matiko09 ($100 in chips) 
Seat 6: blackw0lf_03 ($120.98 in chips) 
Seat 9: RMilPoker ($100 in chips) 
blackw0lf_03: posts small blind $0.50
ka100pka527: is sitting out 
ka100pka527 leaves the table
RMilPoker: posts big blind $1
*** HOLE CARDS ***
Dealt to matiko09 [2s Kd]
Monsthand: folds 
Monsthand leaves the table
thecurv: raises $1.50 to $2.50
matiko09: folds 
masaytoo joins the table at seat #4 
AlKatrone joins the table at seat #5 
blackw0lf_03: folds 
RMilPoker: folds 
Uncalled bet ($1.50) returned to thecurv
thecurv collected $2.50 from pot
thecurv: doesn't show hand 
*** SUMMARY ***
Total pot $2.50 | Rake $0 
Seat 1: Monsthand folded before Flop (didn't bet)
Seat 2: thecurv collected ($2.50)
Seat 3: matiko09 (button) folded before Flop (didn't bet)
Seat 6: blackw0lf_03 (small blind) folded before Flop
Seat 9: RMilPoker (big blind) folded before Flop





PokerStars Hand #150120930155:  Hold'em No Limit ($0.50/$1.00 USD) - 2016/03/10 10:15:04 CET [2016/03/10 4:15:04 ET]
Table 'Nereid' 9-max Seat #3 is the button
Seat 1: matiko09 ($100 in chips) 
Seat 2: PHILLY_D_S ($100 in chips) 
Seat 3: mycka86 ($100 in chips) 
Seat 4: xiaoxiaoniao ($247.90 in chips) 
Seat 5: ilaviiitech ($100 in chips) 
Seat 6: thecurv ($100 in chips) 
Seat 7: Monsthand ($121.88 in chips) 
Seat 8: Rikti ($29.50 in chips) 
Seat 9: zxp12345 ($177.18 in chips) 
xiaoxiaoniao: posts small blind $0.50
ilaviiitech: posts big blind $1
*** HOLE CARDS ***
Dealt to matiko09 [6d Jh]
thecurv: folds 
Monsthand: folds 
Rikti: folds 
zxp12345: folds 
matiko09: folds 
PHILLY_D_S: folds 
mycka86: raises $1.10 to $2.10
xiaoxiaoniao: folds 
ilaviiitech: folds 
Uncalled bet ($1.10) returned to mycka86
mycka86 collected $2.50 from pot
*** SUMMARY ***
Total pot $2.50 | Rake $0 
Seat 1: matiko09 folded before Flop (didn't bet)
Seat 2: PHILLY_D_S folded before Flop (didn't bet)
Seat 3: mycka86 (button) collected ($2.50)
Seat 4: xiaoxiaoniao (small blind) folded before Flop
Seat 5: ilaviiitech (big blind) folded before Flop
Seat 6: thecurv folded before Flop (didn't bet)
Seat 7: Monsthand folded before Flop (didn't bet)
Seat 8: Rikti folded before Flop (didn't bet)
Seat 9: zxp12345 folded before Flop (didn't bet)





PokerStars Hand #150120929930:  Hold'em No Limit ($1/$2 USD) - 2016/03/10 10:15:04 CET [2016/03/10 4:15:04 ET]
Table 'Vesta' 9-max Seat #4 is the button
Seat 1: nickreason17 ($200 in chips) 
Seat 2: Pernilla E A ($133.50 in chips) 
Seat 3: matiko09 ($200 in chips) 
Seat 4: Yaaaazz ($246.44 in chips) 
Seat 5: PHILLY_D_S ($308.29 in chips) 
Seat 6: djammusic ($566.09 in chips) 
Seat 7: Monsthand ($210.14 in chips) 
Seat 8: 13Ghosts ($275.47 in chips) 
Seat 9: lixiangli ($369.41 in chips) 
PHILLY_D_S: posts small blind $1
djammusic: posts big blind $2
*** HOLE CARDS ***
Dealt to matiko09 [3h 9c]
Monsthand: folds 
13Ghosts: folds 
lixiangli: folds 
nickreason17: folds 
Pernilla E A: folds 
matiko09: folds 
13Ghosts said, "lix"
Yaaaazz: raises $2.40 to $4.40
13Ghosts said, "here have starscoins"
PHILLY_D_S: folds 
djammusic: calls $2.40
*** FLOP *** [5d 2d Qs]
djammusic: checks 
13Ghosts said, "very good"
lixiangli said, "yes"
Yaaaazz: bets $5.05
djammusic: folds 
Uncalled bet ($5.05) returned to Yaaaazz
13Ghosts said, "we can cash out for food"
Yaaaazz collected $9.36 from pot
*** SUMMARY ***
Total pot $9.80 | Rake $0.44 
Board [5d 2d Qs]
Seat 1: nickreason17 folded before Flop (didn't bet)
Seat 2: Pernilla E A folded before Flop (didn't bet)
Seat 3: matiko09 folded before Flop (didn't bet)
Seat 4: Yaaaazz (button) collected ($9.36)
Seat 5: PHILLY_D_S (small blind) folded before Flop
Seat 6: djammusic (big blind) folded on the Flop
Seat 7: Monsthand folded before Flop (didn't bet)
Seat 8: 13Ghosts folded before Flop (didn't bet)
Seat 9: lixiangli folded before Flop (didn't bet)





PokerStars Hand #150120931138:  Hold'em No Limit ($0.50/$1.00 USD) - 2016/03/10 10:15:07 CET [2016/03/10 4:15:07 ET]
Table 'Rarahu' 9-max Seat #3 is the button
Seat 1: matiko09 ($100 in chips) 
Seat 2: azzad2007 ($100 in chips) 
Seat 3: ka100pka527 ($42.56 in chips) 
Seat 4: vilo1070 ($103 in chips) 
Seat 5: blackw0lf_03 ($109 in chips) 
Seat 6: RMilPoker ($109.89 in chips) 
Seat 7: PHILLY_D_S ($149.72 in chips) 
Seat 8: Rikti ($58.85 in chips) 
Seat 9: Srz7v44 ($115.86 in chips) 
vilo1070: posts small blind $0.50
blackw0lf_03: posts big blind $1
*** HOLE CARDS ***
Dealt to matiko09 [Jc Qs]
RMilPoker: folds 
PHILLY_D_S: folds 
Rikti: folds 
Srz7v44: calls $1
matiko09: raises $3 to $4
azzad2007: folds 
ka100pka527: folds 
vilo1070: raises $9 to $13
blackw0lf_03: folds 
Srz7v44: folds 
matiko09: folds 
Uncalled bet ($9) returned to vilo1070
vilo1070 collected $10 from pot
vilo1070: doesn't show hand 
*** SUMMARY ***
Total pot $10 | Rake $0 
Seat 1: matiko09 folded before Flop
Seat 2: azzad2007 folded before Flop (didn't bet)
Seat 3: ka100pka527 (button) folded before Flop (didn't bet)
Seat 4: vilo1070 (small blind) collected ($10)
Seat 5: blackw0lf_03 (big blind) folded before Flop
Seat 6: RMilPoker folded before Flop (didn't bet)
Seat 7: PHILLY_D_S folded before Flop (didn't bet)
Seat 8: Rikti folded before Flop (didn't bet)
Seat 9: Srz7v44 folded before Flop





PokerStars Hand #150120932211:  Hold'em No Limit ($1/$2 USD) - 2016/03/10 10:15:10 CET [2016/03/10 4:15:10 ET]
Table 'Archid' 9-max Seat #3 is the button
Seat 1: AP3221 ($97.22 in chips) 
Seat 2: geiranger011 ($90.64 in chips) 
Seat 3: sarkat104 ($152.55 in chips) 
Seat 4: Monsthand ($212.37 in chips) 
Seat 5: toprmaw ($200 in chips) 
Seat 6: Yaaaazz ($650.51 in chips) 
Seat 7: maxxmeister ($205.24 in chips) 
Seat 8: matiko09 ($321.20 in chips) 
Seat 9: WrongButton ($216.74 in chips) 
Monsthand: posts small blind $1
toprmaw: posts big blind $2
*** HOLE CARDS ***
Dealt to matiko09 [Ad Ts]
Yaaaazz: folds 
maxxmeister: folds 
matiko09: folds 
WrongButton: folds 
AP3221: folds 
geiranger011: folds 
sarkat104: folds 
Monsthand: folds 
Uncalled bet ($1) returned to toprmaw
toprmaw collected $2 from pot
toprmaw: doesn't show hand 
*** SUMMARY ***
Total pot $2 | Rake $0 
Seat 1: AP3221 folded before Flop (didn't bet)
Seat 2: geiranger011 folded before Flop (didn't bet)
Seat 3: sarkat104 (button) folded before Flop (didn't bet)
Seat 4: Monsthand (small blind) folded before Flop
Seat 5: toprmaw (big blind) collected ($2)
Seat 6: Yaaaazz folded before Flop (didn't bet)
Seat 7: maxxmeister folded before Flop (didn't bet)
Seat 8: matiko09 folded before Flop (didn't bet)
Seat 9: WrongButton folded before Flop (didn't bet)





PokerStars Hand #150120935124:  Hold'em No Limit ($0.50/$1.00 USD) - 2016/03/10 10:15:18 CET [2016/03/10 4:15:18 ET]
Table 'Alsciaukat' 9-max Seat #5 is the button
Seat 1: Kelvin sai ($51.10 in chips) 
Seat 2: mycka86 ($100 in chips) 
Seat 3: blackw0lf_03 ($100 in chips) 
Seat 4: Rikti ($36.50 in chips) 
Seat 5: toprmaw ($110.42 in chips) 
Seat 7: Yaaaazz ($122.24 in chips) 
Seat 8: F1dgeT ($100 in chips) 
Seat 9: matiko09 ($107.38 in chips) 
Yaaaazz: posts small blind $0.50
F1dgeT: posts big blind $1
*** HOLE CARDS ***
Dealt to matiko09 [As 3c]
matiko09: folds 
Kelvin sai: raises $2 to $3
mycka86: folds 
blackw0lf_03: raises $5 to $8
Rikti: folds 
toprmaw: folds 
Yaaaazz: folds 
F1dgeT: folds 
Kelvin sai: calls $5
*** FLOP *** [Ah 4h Js]
Kelvin sai: checks 
blackw0lf_03: bets $7.02
Kelvin sai: calls $7.02
*** TURN *** [Ah 4h Js] [9s]
Kelvin sai: checks 
blackw0lf_03: checks 
*** RIVER *** [Ah 4h Js 9s] [3d]
Kelvin sai: bets $36.08 and is all-in
blackw0lf_03: folds 
Uncalled bet ($36.08) returned to Kelvin sai
Kelvin sai collected $30.12 from pot
Kelvin sai: doesn't show hand 
*** SUMMARY ***
Total pot $31.54 | Rake $1.42 
Board [Ah 4h Js 9s 3d]
Seat 1: Kelvin sai collected ($30.12)
Seat 2: mycka86 folded before Flop (didn't bet)
Seat 3: blackw0lf_03 folded on the River
Seat 4: Rikti folded before Flop (didn't bet)
Seat 5: toprmaw (button) folded before Flop (didn't bet)
Seat 7: Yaaaazz (small blind) folded before Flop
Seat 8: F1dgeT (big blind) folded before Flop
Seat 9: matiko09 folded before Flop (didn't bet)





PokerStars Hand #150120936332:  Hold'em No Limit ($0.50/$1.00 USD) - 2016/03/10 10:15:21 CET [2016/03/10 4:15:21 ET]
Table 'Saskia' 9-max Seat #7 is the button
Seat 1: matiko09 ($109 in chips) 
Seat 3: Monsthand ($103.20 in chips) 
Seat 4: blackw0lf_03 ($105.62 in chips) 
Seat 5: Rikti ($52.04 in chips) 
Seat 6: kenheung ($134.54 in chips) 
Seat 7: AlKatrone ($138.59 in chips) 
Seat 9: mycka86 ($117.47 in chips) 
DIMAN_324 will be allowed to play after the button
mycka86: posts small blind $0.50
matiko09: posts big blind $1
nickreason17: sits out 
*** HOLE CARDS ***
Dealt to matiko09 [3d 5c]
Monsthand: folds 
blackw0lf_03: raises $2 to $3
Rikti: folds 
kenheung: folds 
AlKatrone: folds 
mycka86: folds 
matiko09: folds 
Uncalled bet ($2) returned to blackw0lf_03
blackw0lf_03 collected $2.50 from pot
blackw0lf_03: doesn't show hand 
*** SUMMARY ***
Total pot $2.50 | Rake $0 
Seat 1: matiko09 (big blind) folded before Flop
Seat 3: Monsthand folded before Flop (didn't bet)
Seat 4: blackw0lf_03 collected ($2.50)
Seat 5: Rikti folded before Flop (didn't bet)
Seat 6: kenheung folded before Flop (didn't bet)
Seat 7: AlKatrone (button) folded before Flop (didn't bet)
Seat 9: mycka86 (small blind) folded before Flop





PokerStars Hand #150120939146:  Hold'em No Limit (€0.25/€0.50 EUR) - 2016/03/10 10:15:29 CET [2016/03/10 4:15:29 ET]
Table 'Algorab' 9-max Seat #4 is the button
Seat 1: Rikti (€27.02 in chips) 
Seat 2: IvanUrgant (€50 in chips) 
Seat 3: dididi2000 (€42.46 in chips) 
Seat 4: Dantist1122 (€72.12 in chips) 
Seat 6: Bron By (€50.25 in chips) 
Seat 7: matiko09 (€86.90 in chips) 
Seat 8: fudzi (€51.25 in chips) 
Seat 9: St.LaCoste (€54.17 in chips) 
Bron By: posts small blind €0.25
matiko09: posts big blind €0.50
*** HOLE CARDS ***
Dealt to matiko09 [5s Ks]
fudzi: folds 
St.LaCoste: folds 
Rikti: folds 
IvanUrgant: raises €1 to €1.50
dididi2000: folds 
Dantist1122: folds 
Bron By: folds 
matiko09: folds 
Uncalled bet (€1) returned to IvanUrgant
IvanUrgant collected €1.25 from pot
IvanUrgant: doesn't show hand 
*** SUMMARY ***
Total pot €1.25 | Rake €0 
Seat 1: Rikti folded before Flop (didn't bet)
Seat 2: IvanUrgant collected (€1.25)
Seat 3: dididi2000 folded before Flop (didn't bet)
Seat 4: Dantist1122 (button) folded before Flop (didn't bet)
Seat 6: Bron By (small blind) folded before Flop
Seat 7: matiko09 (big blind) folded before Flop
Seat 8: fudzi folded before Flop (didn't bet)
Seat 9: St.LaCoste folded before Flop (didn't bet)





PokerStars Hand #150120940075:  Hold'em No Limit ($1/$2 USD) - 2016/03/10 10:15:31 CET [2016/03/10 4:15:31 ET]
Table 'Archid' 9-max Seat #4 is the button
Seat 1: AP3221 ($97.22 in chips) 
Seat 2: geiranger011 ($90.64 in chips) 
Seat 3: sarkat104 ($152.55 in chips) 
Seat 4: Monsthand ($211.37 in chips) 
Seat 5: toprmaw ($201 in chips) 
Seat 6: Yaaaazz ($650.51 in chips) 
Seat 7: maxxmeister ($205.24 in chips) 
Seat 8: matiko09 ($321.20 in chips) 
Seat 9: WrongButton ($216.74 in chips) 
toprmaw: posts small blind $1
Yaaaazz: posts big blind $2
*** HOLE CARDS ***
Dealt to matiko09 [Qd 4h]
maxxmeister: folds 
matiko09: folds 
WrongButton: folds 
AP3221: folds 
geiranger011: folds 
sarkat104: folds 
Monsthand: folds 
toprmaw: raises $4 to $6
Yaaaazz: folds 
Uncalled bet ($4) returned to toprmaw
toprmaw collected $4 from pot
toprmaw: doesn't show hand 
*** SUMMARY ***
Total pot $4 | Rake $0 
Seat 1: AP3221 folded before Flop (didn't bet)
Seat 2: geiranger011 folded before Flop (didn't bet)
Seat 3: sarkat104 folded before Flop (didn't bet)
Seat 4: Monsthand (button) folded before Flop (didn't bet)
Seat 5: toprmaw (small blind) collected ($4)
Seat 6: Yaaaazz (big blind) folded before Flop
Seat 7: maxxmeister folded before Flop (didn't bet)
Seat 8: matiko09 folded before Flop (didn't bet)
Seat 9: WrongButton folded before Flop (didn't bet)





PokerStars Hand #150120943684:  Hold'em No Limit ($1/$2 USD) - 2016/03/10 10:15:41 CET [2016/03/10 4:15:41 ET]
Table 'Solstice II' 9-max Seat #1 is the button
Seat 1: Rycious ($69.82 in chips) 
Seat 3: vano7777 ($83.41 in chips) 
Seat 4: matiko09 ($200 in chips) 
Seat 5: toprmaw ($203.29 in chips) 
Seat 6: thecurv ($229.48 in chips) 
vano7777: posts small blind $1
matiko09: posts big blind $2
*** HOLE CARDS ***
Dealt to matiko09 [5d 3h]
toprmaw: folds 
thecurv: raises $3 to $5
Rycious: calls $5
vano7777: folds 
matiko09: folds 
*** FLOP *** [Kh 7c 6h]
thecurv: bets $10
Rycious: calls $10
*** TURN *** [Kh 7c 6h] [6d]
thecurv: bets $17
Rycious: calls $17
*** RIVER *** [Kh 7c 6h 6d] [Qs]
thecurv: checks 
Rycious: checks 
*** SHOW DOWN ***
thecurv: shows [8h 9h] (a pair of Sixes)
Rycious: shows [Jc Jh] (two pair, Jacks and Sixes)
Rycious collected $64.20 from pot
*** SUMMARY ***
Total pot $67 | Rake $2.80 
Board [Kh 7c 6h 6d Qs]
Seat 1: Rycious (button) showed [Jc Jh] and won ($64.20) with two pair, Jacks and Sixes
Seat 3: vano7777 (small blind) folded before Flop
Seat 4: matiko09 (big blind) folded before Flop
Seat 5: toprmaw folded before Flop (didn't bet)
Seat 6: thecurv showed [8h 9h] and lost with a pair of Sixes





PokerStars Hand #150120944055:  Hold'em No Limit ($0.50/$1.00 USD) - 2016/03/10 10:15:42 CET [2016/03/10 4:15:42 ET]
Table 'Nereid' 9-max Seat #4 is the button
Seat 1: matiko09 ($100 in chips) 
Seat 2: PHILLY_D_S ($100 in chips) 
Seat 3: mycka86 ($101.50 in chips) 
Seat 4: xiaoxiaoniao ($247.40 in chips) 
Seat 5: ilaviiitech ($100 in chips) 
Seat 6: thecurv ($100 in chips) 
Seat 7: Monsthand ($121.88 in chips) 
Seat 8: Rikti ($29.50 in chips) 
Seat 9: zxp12345 ($177.18 in chips) 
ilaviiitech: posts small blind $0.50
thecurv: posts big blind $1
*** HOLE CARDS ***
Dealt to matiko09 [8d 3h]
Monsthand: folds 
Rikti: folds 
xiaoxiaoniao said, "阿八州"
zxp12345: calls $1
matiko09: folds 
PHILLY_D_S: folds 
mycka86: folds 
xiaoxiaoniao: folds 
ilaviiitech: folds 
thecurv: raises $3 to $4
zxp12345: calls $3
*** FLOP *** [4d 3s 5s]
thecurv: checks 
zxp12345: bets $4.06
thecurv: folds 
Uncalled bet ($4.06) returned to zxp12345
zxp12345 collected $8.12 from pot
*** SUMMARY ***
Total pot $8.50 | Rake $0.38 
Board [4d 3s 5s]
Seat 1: matiko09 folded before Flop (didn't bet)
Seat 2: PHILLY_D_S folded before Flop (didn't bet)
Seat 3: mycka86 folded before Flop (didn't bet)
Seat 4: xiaoxiaoniao (button) folded before Flop (didn't bet)
Seat 5: ilaviiitech (small blind) folded before Flop
Seat 6: thecurv (big blind) folded on the Flop
Seat 7: Monsthand folded before Flop (didn't bet)
Seat 8: Rikti folded before Flop (didn't bet)
Seat 9: zxp12345 collected ($8.12)





PokerStars Hand #150120944566:  Hold'em No Limit ($0.50/$1.00 USD) - 2016/03/10 10:15:44 CET [2016/03/10 4:15:44 ET]
Table 'Saskia' 9-max Seat #9 is the button
Seat 1: matiko09 ($108 in chips) 
Seat 2: nickreason17 ($100 in chips) 
Seat 3: Monsthand ($103.20 in chips) 
Seat 4: blackw0lf_03 ($107.12 in chips) 
Seat 5: Rikti ($52.04 in chips) 
Seat 6: kenheung ($134.54 in chips) 
Seat 7: AlKatrone ($138.59 in chips) 
Seat 9: mycka86 ($116.97 in chips) 
matiko09: posts small blind $0.50
nickreason17: posts big blind $1
DIMAN_324: sits out 
*** HOLE CARDS ***
Dealt to matiko09 [Ah Js]
Monsthand: folds 
blackw0lf_03: folds 
Rikti: folds 
kenheung: raises $1 to $2
AlKatrone: folds 
mycka86: folds 
matiko09: raises $6 to $8
nickreason17: folds 
kenheung: folds 
Uncalled bet ($6) returned to matiko09
matiko09 collected $5 from pot
matiko09: doesn't show hand 
*** SUMMARY ***
Total pot $5 | Rake $0 
Seat 1: matiko09 (small blind) collected ($5)
Seat 2: nickreason17 (big blind) folded before Flop
Seat 3: Monsthand folded before Flop (didn't bet)
Seat 4: blackw0lf_03 folded before Flop (didn't bet)
Seat 5: Rikti folded before Flop (didn't bet)
Seat 6: kenheung folded before Flop
Seat 7: AlKatrone folded before Flop (didn't bet)
Seat 9: mycka86 (button) folded before Flop (didn't bet)





PokerStars Hand #150120947491:  Hold'em No Limit (€0.25/€0.50 EUR) - 2016/03/10 10:15:52 CET [2016/03/10 4:15:52 ET]
Table 'Algorab' 9-max Seat #6 is the button
Seat 1: Rikti (€27.02 in chips) 
Seat 2: IvanUrgant (€50.75 in chips) 
Seat 3: dididi2000 (€42.46 in chips) 
Seat 4: Dantist1122 (€72.12 in chips) 
Seat 6: Bron By (€50 in chips) 
Seat 7: matiko09 (€86.40 in chips) 
Seat 8: fudzi (€51.25 in chips) 
Seat 9: St.LaCoste (€54.17 in chips) 
matiko09: posts small blind €0.25
fudzi: posts big blind €0.50
*** HOLE CARDS ***
Dealt to matiko09 [Qs Js]
St.LaCoste: folds 
St.LaCoste leaves the table
Rikti: raises €0.75 to €1.25
IvanUrgant: folds 
dididi2000: folds 
Dantist1122: folds 
Bron By: raises €2.09 to €3.34
matiko09: folds 
fudzi: folds 
Rikti: raises €2.91 to €6.25
Bron By: folds 
Uncalled bet (€2.91) returned to Rikti
Rikti collected €7.43 from pot
Rikti: doesn't show hand 
*** SUMMARY ***
Total pot €7.43 | Rake €0 
Seat 1: Rikti collected (€7.43)
Seat 2: IvanUrgant folded before Flop (didn't bet)
Seat 3: dididi2000 folded before Flop (didn't bet)
Seat 4: Dantist1122 folded before Flop (didn't bet)
Seat 6: Bron By (button) folded before Flop
Seat 7: matiko09 (small blind) folded before Flop
Seat 8: fudzi (big blind) folded before Flop
Seat 9: St.LaCoste folded before Flop (didn't bet)





PokerStars Hand #150120949109:  Hold'em No Limit ($0.50/$1.00 USD) - 2016/03/10 10:15:56 CET [2016/03/10 4:15:56 ET]
Table 'Liriope II' 9-max Seat #6 is the button
Seat 1: Bron By ($105.49 in chips) 
Seat 2: vano7777 ($217.51 in chips) 
Seat 3: azzad2007 ($113.60 in chips) 
Seat 4: matiko09 ($132.95 in chips) 
Seat 5: toprmaw ($250 in chips) 
Seat 6: Monsthand ($100.60 in chips) 
Seat 7: mycka86 ($138.30 in chips) 
Seat 9: huti429 ($193.89 in chips) 
mycka86: posts small blind $0.50
huti429: posts big blind $1
Bron By: posts the ante $0.20
vano7777: posts the ante $0.20
azzad2007: posts the ante $0.20
matiko09: posts the ante $0.20
toprmaw: posts the ante $0.20
Monsthand: posts the ante $0.20
mycka86: posts the ante $0.20
huti429: posts the ante $0.20
*** HOLE CARDS ***
Dealt to matiko09 [Qh 7h]
Bron By: folds 
vano7777: folds 
azzad2007: folds 
matiko09: folds 
toprmaw: raises $1.50 to $2.50
Monsthand: folds 
mycka86: folds 
huti429: calls $1.50
*** FLOP *** [6d Jd 5h]
huti429: checks 
toprmaw: bets $4.50
huti429: folds 
Uncalled bet ($4.50) returned to toprmaw
toprmaw collected $6.78 from pot
toprmaw: doesn't show hand 
*** SUMMARY ***
Total pot $7.10 | Rake $0.32 
Board [6d Jd 5h]
Seat 1: Bron By folded before Flop (didn't bet)
Seat 2: vano7777 folded before Flop (didn't bet)
Seat 3: azzad2007 folded before Flop (didn't bet)
Seat 4: matiko09 folded before Flop (didn't bet)
Seat 5: toprmaw collected ($6.78)
Seat 6: Monsthand (button) folded before Flop (didn't bet)
Seat 7: mycka86 (small blind) folded before Flop
Seat 9: huti429 (big blind) folded on the Flop





PokerStars Hand #150120949546:  Hold'em No Limit ($0.50/$1.00 USD) - 2016/03/10 10:15:57 CET [2016/03/10 4:15:57 ET]
Table 'Rarahu' 9-max Seat #4 is the button
Seat 1: matiko09 ($100 in chips) 
Seat 2: azzad2007 ($100 in chips) 
Seat 3: ka100pka527 ($42.56 in chips) 
Seat 4: vilo1070 ($109 in chips) 
Seat 5: blackw0lf_03 ($108 in chips) 
Seat 6: RMilPoker ($109.89 in chips) 
Seat 7: PHILLY_D_S ($149.72 in chips) 
Seat 8: Rikti ($58.85 in chips) 
Seat 9: Srz7v44 ($114.86 in chips) 
blackw0lf_03: posts small blind $0.50
RMilPoker: posts big blind $1
*** HOLE CARDS ***
Dealt to matiko09 [2h Jd]
PHILLY_D_S: folds 
Rikti: folds 
Srz7v44: folds 
matiko09: folds 
azzad2007: folds 
ka100pka527: folds 
vilo1070: raises $2 to $3
blackw0lf_03: folds 
RMilPoker: folds 
Uncalled bet ($2) returned to vilo1070
vilo1070 collected $2.50 from pot
vilo1070: doesn't show hand 
*** SUMMARY ***
Total pot $2.50 | Rake $0 
Seat 1: matiko09 folded before Flop (didn't bet)
Seat 2: azzad2007 folded before Flop (didn't bet)
Seat 3: ka100pka527 folded before Flop (didn't bet)
Seat 4: vilo1070 (button) collected ($2.50)
Seat 5: blackw0lf_03 (small blind) folded before Flop
Seat 6: RMilPoker (big blind) folded before Flop
Seat 7: PHILLY_D_S folded before Flop (didn't bet)
Seat 8: Rikti folded before Flop (didn't bet)
Seat 9: Srz7v44 folded before Flop (didn't bet)





PokerStars Hand #150120949740:  Hold'em No Limit ($1/$2 USD) - 2016/03/10 10:15:58 CET [2016/03/10 4:15:58 ET]
Table 'Sophia II' 9-max Seat #4 is the button
Seat 1: thecurv ($273.68 in chips) 
Seat 2: Sang2015 ($206.80 in chips) 
Seat 3: maxxmeister ($200 in chips) 
Seat 4: hejun0713 ($192.36 in chips) 
Seat 5: matiko09 ($200 in chips) 
Seat 6: WrongButton ($215.83 in chips) 
Seat 7: Monsthand ($264.56 in chips) 
Seat 8: nickreason17 ($215.71 in chips) 
matiko09: posts small blind $1
WrongButton: posts big blind $2
*** HOLE CARDS ***
Dealt to matiko09 [5c 3c]
Monsthand: folds 
nickreason17: folds 
thecurv: folds 
Sang2015: folds 
maxxmeister: folds 
hejun0713: folds 
matiko09: folds 
Uncalled bet ($1) returned to WrongButton
WrongButton collected $2 from pot
*** SUMMARY ***
Total pot $2 | Rake $0 
Seat 1: thecurv folded before Flop (didn't bet)
Seat 2: Sang2015 folded before Flop (didn't bet)
Seat 3: maxxmeister folded before Flop (didn't bet)
Seat 4: hejun0713 (button) folded before Flop (didn't bet)
Seat 5: matiko09 (small blind) folded before Flop
Seat 6: WrongButton (big blind) collected ($2)
Seat 7: Monsthand folded before Flop (didn't bet)
Seat 8: nickreason17 folded before Flop (didn't bet)





PokerStars Hand #150120951441:  Hold'em No Limit ($1/$2 USD) - 2016/03/10 10:16:02 CET [2016/03/10 4:16:02 ET]
Table 'Vesta' 9-max Seat #5 is the button
Seat 1: nickreason17 ($200 in chips) 
Seat 2: Pernilla E A ($133.50 in chips) 
Seat 3: matiko09 ($200 in chips) 
Seat 4: Yaaaazz ($251.40 in chips) 
Seat 5: PHILLY_D_S ($307.29 in chips) 
Seat 6: djammusic ($561.69 in chips) 
Seat 7: Monsthand ($210.14 in chips) 
Seat 8: 13Ghosts ($275.47 in chips) 
Seat 9: lixiangli ($369.41 in chips) 
djammusic: posts small blind $1
Monsthand: posts big blind $2
*** HOLE CARDS ***
Dealt to matiko09 [9c 4h]
13Ghosts: folds 
13Ghosts said, "lol"
lixiangli: raises $3 to $5
nickreason17: folds 
Pernilla E A: raises $3 to $8
matiko09: folds 
Yaaaazz: folds 
PHILLY_D_S: folds 
13Ghosts said, "macau food too expensive"
djammusic: folds 
Monsthand: folds 
Pernilla E A said, "bring your own! :)"
lixiangli: calls $3
*** FLOP *** [8c 5c 4d]
lixiangli: checks 
Pernilla E A: bets $9.07
lixiangli: calls $9.07
*** TURN *** [8c 5c 4d] [6h]
lixiangli: checks 
Pernilla E A: checks 
*** RIVER *** [8c 5c 4d 6h] [2h]
lixiangli: checks 
Pernilla E A: checks 
*** SHOW DOWN ***
lixiangli: shows [Qs Qd] (a pair of Queens)
Pernilla E A: mucks hand 
lixiangli collected $35.47 from pot
*** SUMMARY ***
Total pot $37.14 | Rake $1.67 
Board [8c 5c 4d 6h 2h]
Seat 1: nickreason17 folded before Flop (didn't bet)
Seat 2: Pernilla E A mucked [Td Ad]
Seat 3: matiko09 folded before Flop (didn't bet)
Seat 4: Yaaaazz folded before Flop (didn't bet)
Seat 5: PHILLY_D_S (button) folded before Flop (didn't bet)
Seat 6: djammusic (small blind) folded before Flop
Seat 7: Monsthand (big blind) folded before Flop
Seat 8: 13Ghosts folded before Flop (didn't bet)
Seat 9: lixiangli showed [Qs Qd] and won ($35.47) with a pair of Queens





PokerStars Hand #150120952894:  Hold'em No Limit ($1/$2 USD) - 2016/03/10 10:16:06 CET [2016/03/10 4:16:06 ET]
Table 'Tauris II' 9-max Seat #7 is the button
Seat 1: PHILLY_D_S ($207.24 in chips) 
Seat 4: matiko09 ($382.86 in chips) 
Seat 5: Spudly6 ($167.52 in chips) 
Seat 6: Yaaaazz ($254.11 in chips) 
Seat 7: maxxmeister ($373.93 in chips) 
Seat 8: WrongButton ($200 in chips) 
Seat 9: darren1031 ($190 in chips) 
WrongButton: posts small blind $1
darren1031: posts big blind $2
*** HOLE CARDS ***
Dealt to matiko09 [8s 6s]
PHILLY_D_S: raises $4 to $6
Rycious leaves the table
nickreason17 joins the table at seat #2 
matiko09: folds 
Spudly6: folds 
Yaaaazz: folds 
maxxmeister: calls $6
WrongButton: folds 
darren1031: calls $4
*** FLOP *** [5s Qc Kd]
darren1031: checks 
PHILLY_D_S: bets $11.60
maxxmeister: calls $11.60
darren1031: folds 
*** TURN *** [5s Qc Kd] [3c]
PHILLY_D_S: bets $25.79
maxxmeister: calls $25.79
*** RIVER *** [5s Qc Kd 3c] [7d]
PHILLY_D_S: checks 
maxxmeister: checks 
*** SHOW DOWN ***
PHILLY_D_S: shows [9c Ac] (high card Ace)
maxxmeister: shows [Kh Jh] (a pair of Kings)
maxxmeister collected $90.98 from pot
*** SUMMARY ***
Total pot $93.78 | Rake $2.80 
Board [5s Qc Kd 3c 7d]
Seat 1: PHILLY_D_S showed [9c Ac] and lost with high card Ace
Seat 4: matiko09 folded before Flop (didn't bet)
Seat 5: Spudly6 folded before Flop (didn't bet)
Seat 6: Yaaaazz folded before Flop (didn't bet)
Seat 7: maxxmeister (button) showed [Kh Jh] and won ($90.98) with a pair of Kings
Seat 8: WrongButton (small blind) folded before Flop
Seat 9: darren1031 (big blind) folded on the Flop





PokerStars Hand #150120953225:  Hold'em No Limit ($1/$2 USD) - 2016/03/10 10:16:07 CET [2016/03/10 4:16:07 ET]
Table 'Archid' 9-max Seat #5 is the button
Seat 1: AP3221 ($97.22 in chips) 
Seat 2: geiranger011 ($90.64 in chips) 
Seat 3: sarkat104 ($152.55 in chips) 
Seat 4: Monsthand ($211.37 in chips) 
Seat 5: toprmaw ($203 in chips) 
Seat 6: Yaaaazz ($648.51 in chips) 
Seat 7: maxxmeister ($205.24 in chips) 
Seat 8: matiko09 ($321.20 in chips) 
Seat 9: WrongButton ($216.74 in chips) 
Yaaaazz: posts small blind $1
maxxmeister: posts big blind $2
*** HOLE CARDS ***
Dealt to matiko09 [2h Ac]
matiko09: folds 
WrongButton: folds 
AP3221: folds 
geiranger011: folds 
sarkat104: folds 
Monsthand: folds 
toprmaw: folds 
Yaaaazz: raises $3.02 to $5.02
maxxmeister: raises $12.55 to $17.57
Yaaaazz: folds 
Uncalled bet ($12.55) returned to maxxmeister
maxxmeister collected $10.04 from pot
maxxmeister: doesn't show hand 
*** SUMMARY ***
Total pot $10.04 | Rake $0 
Seat 1: AP3221 folded before Flop (didn't bet)
Seat 2: geiranger011 folded before Flop (didn't bet)
Seat 3: sarkat104 folded before Flop (didn't bet)
Seat 4: Monsthand folded before Flop (didn't bet)
Seat 5: toprmaw (button) folded before Flop (didn't bet)
Seat 6: Yaaaazz (small blind) folded before Flop
Seat 7: maxxmeister (big blind) collected ($10.04)
Seat 8: matiko09 folded before Flop (didn't bet)
Seat 9: WrongButton folded before Flop (didn't bet)





PokerStars Hand #150120954222:  Hold'em No Limit ($0.25/$0.50 USD) - 2016/03/10 10:16:10 CET [2016/03/10 4:16:10 ET]
Table 'Aegina' 9-max Seat #2 is the button
Seat 1: Wess_1970 ($116.70 in chips) 
Seat 2: el.suertero ($141.82 in chips) 
Seat 3: matiko09 ($50 in chips) 
Seat 4: vlad11122007 ($57.54 in chips) 
Seat 5: lyhtmqh ($86.16 in chips) 
Seat 6: ardo888 ($147.22 in chips) 
Seat 7: Bohne0815 ($77.65 in chips) 
Seat 8: q3storm ($50 in chips) 
matiko09: posts small blind $0.25
vlad11122007: posts big blind $0.50
i L00K great: sits out 
Wess_1970: posts the ante $0.10
el.suertero: posts the ante $0.10
matiko09: posts the ante $0.10
vlad11122007: posts the ante $0.10
lyhtmqh: posts the ante $0.10
ardo888: posts the ante $0.10
Bohne0815: posts the ante $0.10
q3storm: posts the ante $0.10
*** HOLE CARDS ***
Dealt to matiko09 [6h 2c]
lyhtmqh: folds 
ardo888: folds 
Bohne0815: raises $1 to $1.50
q3storm: folds 
Wess_1970: folds 
el.suertero: folds 
matiko09: folds 
vlad11122007: folds 
Uncalled bet ($1) returned to Bohne0815
Bohne0815 collected $2.05 from pot
*** SUMMARY ***
Total pot $2.05 | Rake $0 
Seat 1: Wess_1970 folded before Flop (didn't bet)
Seat 2: el.suertero (button) folded before Flop (didn't bet)
Seat 3: matiko09 (small blind) folded before Flop
Seat 4: vlad11122007 (big blind) folded before Flop
Seat 5: lyhtmqh folded before Flop (didn't bet)
Seat 6: ardo888 folded before Flop (didn't bet)
Seat 7: Bohne0815 collected ($2.05)
Seat 8: q3storm folded before Flop (didn't bet)





PokerStars Hand #150120956935:  Hold'em No Limit ($0.50/$1.00 USD) - 2016/03/10 10:16:17 CET [2016/03/10 4:16:17 ET]
Table 'Nereid' 9-max Seat #5 is the button
Seat 1: matiko09 ($100 in chips) 
Seat 2: PHILLY_D_S ($100 in chips) 
Seat 3: mycka86 ($101.50 in chips) 
Seat 4: xiaoxiaoniao ($247.40 in chips) 
Seat 5: ilaviiitech ($100 in chips) 
Seat 6: thecurv ($100 in chips) 
Seat 7: Monsthand ($121.88 in chips) 
Seat 8: Rikti ($29.50 in chips) 
Seat 9: zxp12345 ($181.30 in chips) 
thecurv: posts small blind $0.50
Monsthand: posts big blind $1
*** HOLE CARDS ***
Dealt to matiko09 [5h Kc]
Rikti: folds 
zxp12345: folds 
matiko09: folds 
zxp12345 said, "云南"
PHILLY_D_S: folds 
mycka86: folds 
xiaoxiaoniao: folds 
ilaviiitech: folds 
thecurv: folds 
Uncalled bet ($0.50) returned to Monsthand
Monsthand collected $1 from pot
Monsthand: doesn't show hand 
*** SUMMARY ***
Total pot $1 | Rake $0 
Seat 1: matiko09 folded before Flop (didn't bet)
Seat 2: PHILLY_D_S folded before Flop (didn't bet)
Seat 3: mycka86 folded before Flop (didn't bet)
Seat 4: xiaoxiaoniao folded before Flop (didn't bet)
Seat 5: ilaviiitech (button) folded before Flop (didn't bet)
Seat 6: thecurv (small blind) folded before Flop
Seat 7: Monsthand (big blind) collected ($1)
Seat 8: Rikti folded before Flop (didn't bet)
Seat 9: zxp12345 folded before Flop (didn't bet)





PokerStars Hand #150120959674:  Hold'em No Limit ($0.50/$1.00 USD) - 2016/03/10 10:16:25 CET [2016/03/10 4:16:25 ET]
Table 'Rarahu' 9-max Seat #5 is the button
Seat 1: matiko09 ($100 in chips) 
Seat 2: azzad2007 ($100 in chips) 
Seat 3: ka100pka527 ($42.56 in chips) 
Seat 4: vilo1070 ($110.50 in chips) 
Seat 5: blackw0lf_03 ($107.50 in chips) 
Seat 6: RMilPoker ($108.89 in chips) 
Seat 7: PHILLY_D_S ($149.72 in chips) 
Seat 8: Rikti ($58.85 in chips) 
Seat 9: Srz7v44 ($114.86 in chips) 
RMilPoker: posts small blind $0.50
PHILLY_D_S: posts big blind $1
*** HOLE CARDS ***
Dealt to matiko09 [6h 8c]
Rikti: folds 
Srz7v44: folds 
matiko09: folds 
azzad2007: folds 
ka100pka527: folds 
vilo1070: raises $2 to $3
blackw0lf_03: folds 
RMilPoker: folds 
PHILLY_D_S: folds 
Uncalled bet ($2) returned to vilo1070
vilo1070 collected $2.50 from pot
vilo1070: doesn't show hand 
*** SUMMARY ***
Total pot $2.50 | Rake $0 
Seat 1: matiko09 folded before Flop (didn't bet)
Seat 2: azzad2007 folded before Flop (didn't bet)
Seat 3: ka100pka527 folded before Flop (didn't bet)
Seat 4: vilo1070 collected ($2.50)
Seat 5: blackw0lf_03 (button) folded before Flop (didn't bet)
Seat 6: RMilPoker (small blind) folded before Flop
Seat 7: PHILLY_D_S (big blind) folded before Flop
Seat 8: Rikti folded before Flop (didn't bet)
Seat 9: Srz7v44 folded before Flop (didn't bet)





PokerStars Hand #150120960025:  Hold'em No Limit ($1/$2 USD) - 2016/03/10 10:16:25 CET [2016/03/10 4:16:25 ET]
Table 'Sophia II' 9-max Seat #5 is the button
Seat 1: thecurv ($273.68 in chips) 
Seat 2: Sang2015 ($206.80 in chips) 
Seat 3: maxxmeister ($200 in chips) 
Seat 4: hejun0713 ($192.36 in chips) 
Seat 5: matiko09 ($200 in chips) 
Seat 6: WrongButton ($216.83 in chips) 
Seat 7: Monsthand ($264.56 in chips) 
Seat 8: nickreason17 ($215.71 in chips) 
WrongButton: posts small blind $1
Monsthand: posts big blind $2
*** HOLE CARDS ***
Dealt to matiko09 [Tc 2d]
nickreason17: folds 
nickreason17 leaves the table
thecurv: folds 
Sang2015: folds 
maxxmeister: raises $6 to $8
hejun0713: folds 
matiko09: folds 
WrongButton: folds 
Monsthand: folds 
Uncalled bet ($6) returned to maxxmeister
maxxmeister collected $5 from pot
maxxmeister: doesn't show hand 
*** SUMMARY ***
Total pot $5 | Rake $0 
Seat 1: thecurv folded before Flop (didn't bet)
Seat 2: Sang2015 folded before Flop (didn't bet)
Seat 3: maxxmeister collected ($5)
Seat 4: hejun0713 folded before Flop (didn't bet)
Seat 5: matiko09 (button) folded before Flop (didn't bet)
Seat 6: WrongButton (small blind) folded before Flop
Seat 7: Monsthand (big blind) folded before Flop
Seat 8: nickreason17 folded before Flop (didn't bet)





PokerStars Hand #150120961970:  Hold'em No Limit ($0.50/$1.00 USD) - 2016/03/10 10:16:31 CET [2016/03/10 4:16:31 ET]
Table 'Saskia' 9-max Seat #1 is the button
Seat 1: matiko09 ($111 in chips) 
Seat 2: nickreason17 ($100 in chips) 
Seat 3: Monsthand ($103.20 in chips) 
Seat 4: blackw0lf_03 ($107.12 in chips) 
Seat 5: Rikti ($52.04 in chips) 
Seat 6: kenheung ($132.54 in chips) 
Seat 7: AlKatrone ($138.59 in chips) 
Seat 9: mycka86 ($116.97 in chips) 
nickreason17: posts small blind $0.50
Monsthand: posts big blind $1
DIMAN_324: sits out 
*** HOLE CARDS ***
Dealt to matiko09 [Jh 7d]
blackw0lf_03: folds 
Rikti: folds 
kenheung: folds 
AlKatrone: folds 
mycka86: folds 
matiko09: folds 
nickreason17: folds 
Uncalled bet ($0.50) returned to Monsthand
Monsthand collected $1 from pot
Monsthand: doesn't show hand 
*** SUMMARY ***
Total pot $1 | Rake $0 
Seat 1: matiko09 (button) folded before Flop (didn't bet)
Seat 2: nickreason17 (small blind) folded before Flop
Seat 3: Monsthand (big blind) collected ($1)
Seat 4: blackw0lf_03 folded before Flop (didn't bet)
Seat 5: Rikti folded before Flop (didn't bet)
Seat 6: kenheung folded before Flop (didn't bet)
Seat 7: AlKatrone folded before Flop (didn't bet)
Seat 9: mycka86 folded before Flop (didn't bet)





PokerStars Hand #150120963254:  Hold'em No Limit ($0.25/$0.50 USD) - 2016/03/10 10:16:34 CET [2016/03/10 4:16:34 ET]
Table 'Aegina' 9-max Seat #3 is the button
Seat 1: Wess_1970 ($116.60 in chips) 
Seat 2: el.suertero ($141.72 in chips) 
Seat 3: matiko09 ($50 in chips) 
Seat 4: vlad11122007 ($56.94 in chips) 
Seat 5: lyhtmqh ($86.06 in chips) 
Seat 6: ardo888 ($147.12 in chips) 
Seat 7: Bohne0815 ($79.10 in chips) 
Seat 8: q3storm ($50 in chips) 
vlad11122007: posts small blind $0.25
lyhtmqh: posts big blind $0.50
i L00K great: sits out 
Wess_1970: posts the ante $0.10
el.suertero: posts the ante $0.10
matiko09: posts the ante $0.10
vlad11122007: posts the ante $0.10
lyhtmqh: posts the ante $0.10
ardo888: posts the ante $0.10
Bohne0815: posts the ante $0.10
q3storm: posts the ante $0.10
*** HOLE CARDS ***
Dealt to matiko09 [7s 4h]
ardo888: folds 
Bohne0815: folds 
q3storm: folds 
Wess_1970: folds 
el.suertero: raises $1 to $1.50
matiko09: folds 
vlad11122007: folds 
lyhtmqh: folds 
Uncalled bet ($1) returned to el.suertero
el.suertero collected $2.05 from pot
el.suertero: doesn't show hand 
*** SUMMARY ***
Total pot $2.05 | Rake $0 
Seat 1: Wess_1970 folded before Flop (didn't bet)
Seat 2: el.suertero collected ($2.05)
Seat 3: matiko09 (button) folded before Flop (didn't bet)
Seat 4: vlad11122007 (small blind) folded before Flop
Seat 5: lyhtmqh (big blind) folded before Flop
Seat 6: ardo888 folded before Flop (didn't bet)
Seat 7: Bohne0815 folded before Flop (didn't bet)
Seat 8: q3storm folded before Flop (didn't bet)





PokerStars Hand #150120965114:  Hold'em No Limit (€0.25/€0.50 EUR) - 2016/03/10 10:16:39 CET [2016/03/10 4:16:39 ET]
Table 'Algorab' 9-max Seat #7 is the button
Seat 2: IvanUrgant (€50.75 in chips) 
Seat 3: dididi2000 (€42.46 in chips) 
Seat 4: Dantist1122 (€72.12 in chips) 
Seat 6: Bron By (€50 in chips) 
Seat 7: matiko09 (€86.15 in chips) 
Seat 8: fudzi (€50.75 in chips) 
fudzi: posts small blind €0.25
Rikti: is sitting out 
IvanUrgant: posts big blind €0.50
*** HOLE CARDS ***
Dealt to matiko09 [8d 4d]
dididi2000: folds 
Rikti leaves the table
Dantist1122: folds 
Bron By: folds 
vlad11122007 joins the table at seat #9 
nubpoker joins the table at seat #1 
matiko09: folds 
fudzi: folds 
Uncalled bet (€0.25) returned to IvanUrgant
IvanUrgant collected €0.50 from pot
IvanUrgant: doesn't show hand 
*** SUMMARY ***
Total pot €0.50 | Rake €0 
Seat 2: IvanUrgant (big blind) collected (€0.50)
Seat 3: dididi2000 folded before Flop (didn't bet)
Seat 4: Dantist1122 folded before Flop (didn't bet)
Seat 6: Bron By folded before Flop (didn't bet)
Seat 7: matiko09 (button) folded before Flop (didn't bet)
Seat 8: fudzi (small blind) folded before Flop





PokerStars Hand #150120966540:  Hold'em No Limit ($0.50/$1.00 USD) - 2016/03/10 10:16:43 CET [2016/03/10 4:16:43 ET]
Table 'Nereid' 9-max Seat #6 is the button
Seat 1: matiko09 ($100 in chips) 
Seat 2: PHILLY_D_S ($100 in chips) 
Seat 3: mycka86 ($101.50 in chips) 
Seat 4: xiaoxiaoniao ($247.40 in chips) 
Seat 5: ilaviiitech ($100 in chips) 
Seat 6: thecurv ($100 in chips) 
Seat 7: Monsthand ($122.38 in chips) 
Seat 8: Rikti ($29.50 in chips) 
Seat 9: zxp12345 ($181.30 in chips) 
Monsthand: posts small blind $0.50
Rikti: posts big blind $1
*** HOLE CARDS ***
Dealt to matiko09 [Kd Qc]
zxp12345: folds 
matiko09: raises $2 to $3
PHILLY_D_S: folds 
mycka86: folds 
xiaoxiaoniao: calls $3
ilaviiitech: folds 
thecurv: folds 
Monsthand: folds 
Rikti: folds 
*** FLOP *** [Ah Qs Jc]
matiko09: checks 
xiaoxiaoniao: bets $5
matiko09: calls $5
*** TURN *** [Ah Qs Jc] [9c]
matiko09: checks 
xiaoxiaoniao: bets $10
matiko09: folds 
Uncalled bet ($10) returned to xiaoxiaoniao
xiaoxiaoniao collected $16.71 from pot
xiaoxiaoniao: doesn't show hand 
*** SUMMARY ***
Total pot $17.50 | Rake $0.79 
Board [Ah Qs Jc 9c]
Seat 1: matiko09 folded on the Turn
Seat 2: PHILLY_D_S folded before Flop (didn't bet)
Seat 3: mycka86 folded before Flop (didn't bet)
Seat 4: xiaoxiaoniao collected ($16.71)
Seat 5: ilaviiitech folded before Flop (didn't bet)
Seat 6: thecurv (button) folded before Flop (didn't bet)
Seat 7: Monsthand (small blind) folded before Flop
Seat 8: Rikti (big blind) folded before Flop
Seat 9: zxp12345 folded before Flop (didn't bet)





PokerStars Hand #150120966444:  Hold'em No Limit ($1/$2 USD) - 2016/03/10 10:16:43 CET [2016/03/10 4:16:43 ET]
Table 'Solstice II' 9-max Seat #3 is the button
Seat 1: Rycious ($102.02 in chips) 
Seat 3: vano7777 ($82.41 in chips) 
Seat 4: matiko09 ($200 in chips) 
Seat 5: toprmaw ($203.29 in chips) 
Seat 6: thecurv ($200 in chips) 
matiko09: posts small blind $1
toprmaw: posts big blind $2
*** HOLE CARDS ***
Dealt to matiko09 [8s 8d]
thecurv: raises $3 to $5
Rycious: folds 
vano7777: folds 
Monsthand joins the table at seat #9 
matiko09: folds 
toprmaw: calls $3
*** FLOP *** [8c 7c Ks]
toprmaw: checks 
thecurv: bets $6
toprmaw: calls $6
*** TURN *** [8c 7c Ks] [Qd]
toprmaw: checks 
thecurv: checks 
*** RIVER *** [8c 7c Ks Qd] [Ad]
toprmaw: checks 
thecurv: checks 
*** SHOW DOWN ***
toprmaw: shows [9h 9s] (a pair of Nines)
thecurv: mucks hand 
toprmaw collected $21.96 from pot
*** SUMMARY ***
Total pot $23 | Rake $1.04 
Board [8c 7c Ks Qd Ad]
Seat 1: Rycious folded before Flop (didn't bet)
Seat 3: vano7777 (button) folded before Flop (didn't bet)
Seat 4: matiko09 (small blind) folded before Flop
Seat 5: toprmaw (big blind) showed [9h 9s] and won ($21.96) with a pair of Nines
Seat 6: thecurv mucked [4c 4s]





PokerStars Hand #150120968450:  Hold'em No Limit ($1/$2 USD) - 2016/03/10 10:16:48 CET [2016/03/10 4:16:48 ET]
Table 'Sophia II' 9-max Seat #6 is the button
Seat 1: thecurv ($273.68 in chips) 
Seat 2: Sang2015 ($206.80 in chips) 
Seat 3: maxxmeister ($203 in chips) 
Seat 4: hejun0713 ($192.36 in chips) 
Seat 5: matiko09 ($200 in chips) 
Seat 6: WrongButton ($215.83 in chips) 
Seat 7: Monsthand ($262.56 in chips) 
Monsthand: posts small blind $1
thecurv: posts big blind $2
*** HOLE CARDS ***
Dealt to matiko09 [6h 6d]
Sang2015: calls $2
maxxmeister: folds 
hejun0713: folds 
matiko09: raises $6 to $8
WrongButton: folds 
Monsthand: folds 
thecurv: folds 
Sang2015: folds 
Uncalled bet ($6) returned to matiko09
matiko09 collected $7 from pot
matiko09: doesn't show hand 
*** SUMMARY ***
Total pot $7 | Rake $0 
Seat 1: thecurv (big blind) folded before Flop
Seat 2: Sang2015 folded before Flop
Seat 3: maxxmeister folded before Flop (didn't bet)
Seat 4: hejun0713 folded before Flop (didn't bet)
Seat 5: matiko09 collected ($7)
Seat 6: WrongButton (button) folded before Flop (didn't bet)
Seat 7: Monsthand (small blind) folded before Flop





PokerStars Hand #150120969883:  Hold'em No Limit ($0.50/$1.00 USD) - 2016/03/10 10:16:52 CET [2016/03/10 4:16:52 ET]
Table 'Saskia' 9-max Seat #2 is the button
Seat 1: matiko09 ($111 in chips) 
Seat 2: nickreason17 ($100 in chips) 
Seat 3: Monsthand ($103.70 in chips) 
Seat 4: blackw0lf_03 ($107.12 in chips) 
Seat 5: Rikti ($52.04 in chips) 
Seat 6: kenheung ($132.54 in chips) 
Seat 7: AlKatrone ($138.59 in chips) 
Seat 9: mycka86 ($116.97 in chips) 
Monsthand: posts small blind $0.50
blackw0lf_03: posts big blind $1
DIMAN_324: sits out 
*** HOLE CARDS ***
Dealt to matiko09 [7h Kc]
Rikti: folds 
kenheung: raises $1 to $2
AlKatrone: raises $6 to $8
mycka86: folds 
matiko09: folds 
nickreason17: folds 
Monsthand: folds 
blackw0lf_03: calls $7
kenheung: calls $6
*** FLOP *** [Th 5c 9h]
blackw0lf_03: bets $7.96
kenheung: folds 
AlKatrone: raises $21.62 to $29.58
blackw0lf_03: calls $21.62
*** TURN *** [Th 5c 9h] [4d]
blackw0lf_03: checks 
AlKatrone: bets $101.01 and is all-in
blackw0lf_03: calls $69.54 and is all-in
Uncalled bet ($31.47) returned to AlKatrone
*** FIRST RIVER *** [Th 5c 9h 4d] [5d]
*** SECOND RIVER *** [Th 5c 9h 4d] [8s]
*** FIRST SHOW DOWN ***
blackw0lf_03: shows [Ah Ac] (two pair, Aces and Fives)
AlKatrone: shows [Ad As] (two pair, Aces and Fives)
blackw0lf_03 collected $54.99 from pot
AlKatrone collected $54.98 from pot
*** SECOND SHOW DOWN ***
blackw0lf_03: shows [Ah Ac] (a pair of Aces)
AlKatrone: shows [Ad As] (a pair of Aces)
blackw0lf_03 collected $54.99 from pot
AlKatrone collected $54.98 from pot
*** SUMMARY ***
Total pot $222.74 | Rake $2.80 
Hand was run twice
FIRST Board [Th 5c 9h 4d 5d]
SECOND Board [Th 5c 9h 4d 8s]
Seat 1: matiko09 folded before Flop (didn't bet)
Seat 2: nickreason17 (button) folded before Flop (didn't bet)
Seat 3: Monsthand (small blind) folded before Flop
Seat 4: blackw0lf_03 (big blind) showed [Ah Ac] and won ($54.99) with two pair, Aces and Fives, and won ($54.99) with a pair of Aces
Seat 5: Rikti folded before Flop (didn't bet)
Seat 6: kenheung folded on the Flop
Seat 7: AlKatrone showed [Ad As] and won ($54.98) with two pair, Aces and Fives, and won ($54.98) with a pair of Aces
Seat 9: mycka86 folded before Flop (didn't bet)





PokerStars Hand #150120971401:  Hold'em No Limit ($1/$2 USD) - 2016/03/10 10:16:56 CET [2016/03/10 4:16:56 ET]
Table 'Archid' 9-max Seat #6 is the button
Seat 1: AP3221 ($97.22 in chips) 
Seat 2: geiranger011 ($90.64 in chips) 
Seat 3: sarkat104 ($152.55 in chips) 
Seat 4: Monsthand ($211.37 in chips) 
Seat 5: toprmaw ($203 in chips) 
Seat 6: Yaaaazz ($643.49 in chips) 
Seat 7: maxxmeister ($210.26 in chips) 
Seat 8: matiko09 ($321.20 in chips) 
Seat 9: WrongButton ($216.74 in chips) 
maxxmeister: posts small blind $1
matiko09: posts big blind $2
*** HOLE CARDS ***
Dealt to matiko09 [7d 3c]
WrongButton: folds 
AP3221: folds 
geiranger011: folds 
sarkat104: calls $2
Monsthand: folds 
toprmaw: folds 
Yaaaazz: folds 
maxxmeister: folds 
matiko09: checks 
*** FLOP *** [4h 4c Th]
matiko09: checks 
sarkat104: bets $2
matiko09: folds 
Uncalled bet ($2) returned to sarkat104
sarkat104 collected $4.78 from pot
*** SUMMARY ***
Total pot $5 | Rake $0.22 
Board [4h 4c Th]
Seat 1: AP3221 folded before Flop (didn't bet)
Seat 2: geiranger011 folded before Flop (didn't bet)
Seat 3: sarkat104 collected ($4.78)
Seat 4: Monsthand folded before Flop (didn't bet)
Seat 5: toprmaw folded before Flop (didn't bet)
Seat 6: Yaaaazz (button) folded before Flop (didn't bet)
Seat 7: maxxmeister (small blind) folded before Flop
Seat 8: matiko09 (big blind) folded on the Flop
Seat 9: WrongButton folded before Flop (didn't bet)





PokerStars Hand #150120973368:  Hold'em No Limit ($0.50/$1.00 USD) - 2016/03/10 10:17:01 CET [2016/03/10 4:17:01 ET]
Table 'Liriope II' 9-max Seat #7 is the button
Seat 1: Bron By ($105.29 in chips) 
Seat 2: vano7777 ($217.31 in chips) 
Seat 3: azzad2007 ($113.40 in chips) 
Seat 4: matiko09 ($132.75 in chips) 
Seat 5: toprmaw ($254.08 in chips) 
Seat 6: Monsthand ($100.40 in chips) 
Seat 7: mycka86 ($137.60 in chips) 
Seat 9: huti429 ($191.19 in chips) 
huti429: posts small blind $0.50
Bron By: posts big blind $1
Bron By: posts the ante $0.20
vano7777: posts the ante $0.20
azzad2007: posts the ante $0.20
matiko09: posts the ante $0.20
toprmaw: posts the ante $0.20
Monsthand: posts the ante $0.20
mycka86: posts the ante $0.20
huti429: posts the ante $0.20
*** HOLE CARDS ***
Dealt to matiko09 [7h Ac]
vano7777: calls $1
azzad2007: folds 
matiko09: folds 
toprmaw: folds 
Monsthand: folds 
mycka86: folds 
huti429: raises $1 to $2
Bron By: folds 
vano7777: calls $1
*** FLOP *** [Kh Th Jc]
huti429: checks 
vano7777: checks 
*** TURN *** [Kh Th Jc] [Jh]
huti429: bets $27
vano7777: folds 
Uncalled bet ($27) returned to huti429
huti429 collected $6.30 from pot
huti429: doesn't show hand 
*** SUMMARY ***
Total pot $6.60 | Rake $0.30 
Board [Kh Th Jc Jh]
Seat 1: Bron By (big blind) folded before Flop
Seat 2: vano7777 folded on the Turn
Seat 3: azzad2007 folded before Flop (didn't bet)
Seat 4: matiko09 folded before Flop (didn't bet)
Seat 5: toprmaw folded before Flop (didn't bet)
Seat 6: Monsthand folded before Flop (didn't bet)
Seat 7: mycka86 (button) folded before Flop (didn't bet)
Seat 9: huti429 (small blind) collected ($6.30)





PokerStars Hand #150120974793:  Hold'em No Limit ($0.25/$0.50 USD) - 2016/03/10 10:17:05 CET [2016/03/10 4:17:05 ET]
Table 'Aegina' 9-max Seat #4 is the button
Seat 1: Wess_1970 ($116.50 in chips) 
Seat 2: el.suertero ($143.17 in chips) 
Seat 3: matiko09 ($50 in chips) 
Seat 4: vlad11122007 ($56.59 in chips) 
Seat 5: lyhtmqh ($85.46 in chips) 
Seat 6: ardo888 ($147.02 in chips) 
Seat 7: Bohne0815 ($79 in chips) 
Seat 8: q3storm ($50 in chips) 
lyhtmqh: posts small blind $0.25
ardo888: posts big blind $0.50
i L00K great: sits out 
Wess_1970: posts the ante $0.10
el.suertero: posts the ante $0.10
matiko09: posts the ante $0.10
vlad11122007: posts the ante $0.10
lyhtmqh: posts the ante $0.10
ardo888: posts the ante $0.10
Bohne0815: posts the ante $0.10
q3storm: posts the ante $0.10
*** HOLE CARDS ***
Dealt to matiko09 [6h Qc]
Bohne0815: folds 
q3storm: folds 
Wess_1970: folds 
el.suertero: raises $1 to $1.50
matiko09: folds 
vlad11122007: folds 
lyhtmqh: calls $1.25
ardo888: folds 
*** FLOP *** [Qd Jc Kd]
lyhtmqh: checks 
el.suertero: bets $3.50
lyhtmqh: folds 
Uncalled bet ($3.50) returned to el.suertero
el.suertero collected $4.11 from pot
el.suertero: doesn't show hand 
*** SUMMARY ***
Total pot $4.30 | Rake $0.19 
Board [Qd Jc Kd]
Seat 1: Wess_1970 folded before Flop (didn't bet)
Seat 2: el.suertero collected ($4.11)
Seat 3: matiko09 folded before Flop (didn't bet)
Seat 4: vlad11122007 (button) folded before Flop (didn't bet)
Seat 5: lyhtmqh (small blind) folded on the Flop
Seat 6: ardo888 (big blind) folded before Flop
Seat 7: Bohne0815 folded before Flop (didn't bet)
Seat 8: q3storm folded before Flop (didn't bet)





PokerStars Hand #150120975859:  Hold'em No Limit (€0.25/€0.50 EUR) - 2016/03/10 10:17:08 CET [2016/03/10 4:17:08 ET]
Table 'Algorab' 9-max Seat #8 is the button
Seat 2: IvanUrgant (€51 in chips) 
Seat 3: dididi2000 (€42.46 in chips) 
Seat 4: Dantist1122 (€72.12 in chips) 
Seat 6: Bron By (€50 in chips) 
Seat 7: matiko09 (€86.15 in chips) 
Seat 8: fudzi (€50.50 in chips) 
vlad11122007 will be allowed to play after the button
nubpoker will be allowed to play after the button
IvanUrgant: posts small blind €0.25
dididi2000: posts big blind €0.50
*** HOLE CARDS ***
Dealt to matiko09 [Kc 2s]
Dantist1122: folds 
Bron By: folds 
matiko09: folds 
fudzi: raises €1 to €1.50
IvanUrgant: folds 
dididi2000: folds 
Uncalled bet (€1) returned to fudzi
fudzi collected €1.25 from pot
fudzi: doesn't show hand 
*** SUMMARY ***
Total pot €1.25 | Rake €0 
Seat 2: IvanUrgant (small blind) folded before Flop
Seat 3: dididi2000 (big blind) folded before Flop
Seat 4: Dantist1122 folded before Flop (didn't bet)
Seat 6: Bron By folded before Flop (didn't bet)
Seat 7: matiko09 folded before Flop (didn't bet)
Seat 8: fudzi (button) collected (€1.25)





PokerStars Hand #150120977363:  Hold'em No Limit ($1/$2 USD) - 2016/03/10 10:17:12 CET [2016/03/10 4:17:12 ET]
Table 'Tauris II' 9-max Seat #8 is the button
Seat 2: nickreason17 ($200 in chips) 
Seat 4: matiko09 ($382.86 in chips) 
Seat 5: Spudly6 ($167.52 in chips) 
Seat 6: Yaaaazz ($254.11 in chips) 
Seat 7: maxxmeister ($421.52 in chips) 
Seat 8: WrongButton ($200 in chips) 
Seat 9: darren1031 ($184 in chips) 
darren1031: posts small blind $1
PHILLY_D_S: is sitting out 
nickreason17: posts big blind $2
*** HOLE CARDS ***
Dealt to matiko09 [Td Jc]
matiko09: folds 
Spudly6: folds 
Yaaaazz: folds 
maxxmeister: folds 
WrongButton: raises $2 to $4
darren1031: folds 
nickreason17: calls $2
*** FLOP *** [6s Kh 7s]
nickreason17: checks 
WrongButton: bets $5.76
nickreason17: folds 
Uncalled bet ($5.76) returned to WrongButton
WrongButton collected $8.60 from pot
*** SUMMARY ***
Total pot $9 | Rake $0.40 
Board [6s Kh 7s]
Seat 2: nickreason17 (big blind) folded on the Flop
Seat 4: matiko09 folded before Flop (didn't bet)
Seat 5: Spudly6 folded before Flop (didn't bet)
Seat 6: Yaaaazz folded before Flop (didn't bet)
Seat 7: maxxmeister folded before Flop (didn't bet)
Seat 8: WrongButton (button) collected ($8.60)
Seat 9: darren1031 (small blind) folded before Flop





PokerStars Hand #150120977068:  Hold'em No Limit ($0.50/$1.00 USD) - 2016/03/10 10:17:12 CET [2016/03/10 4:17:12 ET]
Table 'Rarahu' 9-max Seat #6 is the button
Seat 1: matiko09 ($100 in chips) 
Seat 2: azzad2007 ($100 in chips) 
Seat 3: ka100pka527 ($42.56 in chips) 
Seat 4: vilo1070 ($112 in chips) 
Seat 5: blackw0lf_03 ($107.50 in chips) 
Seat 6: RMilPoker ($108.39 in chips) 
Seat 7: PHILLY_D_S ($148.72 in chips) 
Seat 8: Rikti ($58.85 in chips) 
Seat 9: Srz7v44 ($114.86 in chips) 
PHILLY_D_S: posts small blind $0.50
Rikti: posts big blind $1
*** HOLE CARDS ***
Dealt to matiko09 [7c 4c]
Srz7v44: folds 
matiko09: folds 
azzad2007: folds 
ka100pka527: folds 
vilo1070: folds 
blackw0lf_03: raises $1 to $2
RMilPoker: folds 
PHILLY_D_S: calls $1.50
Rikti: calls $1
*** FLOP *** [As 3h Th]
PHILLY_D_S: checks 
Rikti: checks 
blackw0lf_03: checks 
*** TURN *** [As 3h Th] [3c]
PHILLY_D_S: checks 
Rikti: bets $3
blackw0lf_03: calls $3
PHILLY_D_S: folds 
*** RIVER *** [As 3h Th 3c] [Kd]
Rikti: checks 
blackw0lf_03: checks 
*** SHOW DOWN ***
Rikti: shows [Ac 9d] (two pair, Aces and Threes)
blackw0lf_03: shows [8d Ad] (two pair, Aces and Threes)
Rikti collected $5.73 from pot
blackw0lf_03 collected $5.73 from pot
*** SUMMARY ***
Total pot $12 | Rake $0.54 
Board [As 3h Th 3c Kd]
Seat 1: matiko09 folded before Flop (didn't bet)
Seat 2: azzad2007 folded before Flop (didn't bet)
Seat 3: ka100pka527 folded before Flop (didn't bet)
Seat 4: vilo1070 folded before Flop (didn't bet)
Seat 5: blackw0lf_03 showed [8d Ad] and won ($5.73) with two pair, Aces and Threes
Seat 6: RMilPoker (button) folded before Flop (didn't bet)
Seat 7: PHILLY_D_S (small blind) folded on the Turn
Seat 8: Rikti (big blind) showed [Ac 9d] and won ($5.73) with two pair, Aces and Threes
Seat 9: Srz7v44 folded before Flop (didn't bet)





PokerStars Hand #150120977130:  Hold'em No Limit ($1/$2 USD) - 2016/03/10 10:17:12 CET [2016/03/10 4:17:12 ET]
Table 'Sophia II' 9-max Seat #7 is the button
Seat 1: thecurv ($271.68 in chips) 
Seat 2: Sang2015 ($204.80 in chips) 
Seat 3: maxxmeister ($203 in chips) 
Seat 4: hejun0713 ($192.36 in chips) 
Seat 5: matiko09 ($205 in chips) 
Seat 6: WrongButton ($215.83 in chips) 
Seat 7: Monsthand ($261.56 in chips) 
thecurv: posts small blind $1
Sang2015: posts big blind $2
*** HOLE CARDS ***
Dealt to matiko09 [Ts Qd]
maxxmeister: folds 
hejun0713: folds 
matiko09: folds 
WrongButton: folds 
Monsthand: folds 
thecurv: raises $2.10 to $4.10
Sang2015: calls $2.10
*** FLOP *** [Jh 6c Jd]
thecurv: bets $4
Sang2015: calls $4
*** TURN *** [Jh 6c Jd] [8s]
thecurv: bets $8
BOAYARSKIY joins the table at seat #8 
Sang2015: raises $8 to $16
thecurv: folds 
Uncalled bet ($8) returned to Sang2015
Sang2015 collected $30.75 from pot
Sang2015: doesn't show hand 
*** SUMMARY ***
Total pot $32.20 | Rake $1.45 
Board [Jh 6c Jd 8s]
Seat 1: thecurv (small blind) folded on the Turn
Seat 2: Sang2015 (big blind) collected ($30.75)
Seat 3: maxxmeister folded before Flop (didn't bet)
Seat 4: hejun0713 folded before Flop (didn't bet)
Seat 5: matiko09 folded before Flop (didn't bet)
Seat 6: WrongButton folded before Flop (didn't bet)
Seat 7: Monsthand (button) folded before Flop (didn't bet)





PokerStars Hand #150120978743:  Hold'em No Limit ($1/$2 USD) - 2016/03/10 10:17:16 CET [2016/03/10 4:17:16 ET]
Table 'Vesta' 9-max Seat #6 is the button
Seat 1: nickreason17 ($200 in chips) 
Seat 2: Pernilla E A ($116.43 in chips) 
Seat 3: matiko09 ($200 in chips) 
Seat 4: Yaaaazz ($251.40 in chips) 
Seat 5: PHILLY_D_S ($307.29 in chips) 
Seat 6: djammusic ($560.69 in chips) 
Seat 7: Monsthand ($208.14 in chips) 
Seat 8: 13Ghosts ($275.47 in chips) 
Seat 9: lixiangli ($387.81 in chips) 
Monsthand: posts small blind $1
13Ghosts: posts big blind $2
*** HOLE CARDS ***
Dealt to matiko09 [9d Jd]
13Ghosts said, "how"
lixiangli: folds 
nickreason17: folds 
Pernilla E A: folds 
13Ghosts said, "I stay in hotel"
matiko09: raises $4 to $6
Yaaaazz: folds 
PHILLY_D_S: folds 
djammusic: folds 
Monsthand: folds 
13Ghosts: folds 
Uncalled bet ($4) returned to matiko09
matiko09 collected $5 from pot
matiko09: doesn't show hand 
*** SUMMARY ***
Total pot $5 | Rake $0 
Seat 1: nickreason17 folded before Flop (didn't bet)
Seat 2: Pernilla E A folded before Flop (didn't bet)
Seat 3: matiko09 collected ($5)
Seat 4: Yaaaazz folded before Flop (didn't bet)
Seat 5: PHILLY_D_S folded before Flop (didn't bet)
Seat 6: djammusic (button) folded before Flop (didn't bet)
Seat 7: Monsthand (small blind) folded before Flop
Seat 8: 13Ghosts (big blind) folded before Flop
Seat 9: lixiangli folded before Flop (didn't bet)





PokerStars Hand #150120984856:  Hold'em No Limit (€0.25/€0.50 EUR) - 2016/03/10 10:17:33 CET [2016/03/10 4:17:33 ET]
Table 'Algorab' 9-max Seat #2 is the button
Seat 2: IvanUrgant (€50.75 in chips) 
Seat 3: dididi2000 (€41.96 in chips) 
Seat 6: Bron By (€50 in chips) 
Seat 7: matiko09 (€86.15 in chips) 
Seat 8: fudzi (€51.25 in chips) 
dididi2000: posts small blind €0.25
Bron By: posts big blind €0.50
vlad11122007: sits out 
nubpoker: sits out 
*** HOLE CARDS ***
Dealt to matiko09 [2c Qs]
matiko09: folds 
fudzi: folds 
IvanUrgant: folds 
dididi2000: folds 
Uncalled bet (€0.25) returned to Bron By
Bron By collected €0.50 from pot
Bron By: doesn't show hand 
*** SUMMARY ***
Total pot €0.50 | Rake €0 
Seat 2: IvanUrgant (button) folded before Flop (didn't bet)
Seat 3: dididi2000 (small blind) folded before Flop
Seat 6: Bron By (big blind) collected (€0.50)
Seat 7: matiko09 folded before Flop (didn't bet)
Seat 8: fudzi folded before Flop (didn't bet)





PokerStars Hand #150120986051:  Hold'em No Limit ($1/$2 USD) - 2016/03/10 10:17:36 CET [2016/03/10 4:17:36 ET]
Table 'Archid' 9-max Seat #7 is the button
Seat 1: AP3221 ($97.22 in chips) 
Seat 2: geiranger011 ($90.64 in chips) 
Seat 3: sarkat104 ($155.33 in chips) 
Seat 4: Monsthand ($211.37 in chips) 
Seat 5: toprmaw ($203 in chips) 
Seat 6: Yaaaazz ($643.49 in chips) 
Seat 7: maxxmeister ($209.26 in chips) 
Seat 8: matiko09 ($319.20 in chips) 
Seat 9: WrongButton ($216.74 in chips) 
matiko09: posts small blind $1
WrongButton: posts big blind $2
*** HOLE CARDS ***
Dealt to matiko09 [4c 5c]
AP3221: folds 
geiranger011: folds 
sarkat104: folds 
Monsthand: folds 
toprmaw: folds 
Yaaaazz: folds 
maxxmeister: folds 
matiko09: raises $3 to $5
WrongButton: calls $3
*** FLOP *** [8s Kh Th]
matiko09: checks 
WrongButton: checks 
*** TURN *** [8s Kh Th] [2d]
matiko09: checks 
WrongButton: bets $5.15
matiko09: folds 
Uncalled bet ($5.15) returned to WrongButton
WrongButton collected $9.55 from pot
*** SUMMARY ***
Total pot $10 | Rake $0.45 
Board [8s Kh Th 2d]
Seat 1: AP3221 folded before Flop (didn't bet)
Seat 2: geiranger011 folded before Flop (didn't bet)
Seat 3: sarkat104 folded before Flop (didn't bet)
Seat 4: Monsthand folded before Flop (didn't bet)
Seat 5: toprmaw folded before Flop (didn't bet)
Seat 6: Yaaaazz folded before Flop (didn't bet)
Seat 7: maxxmeister (button) folded before Flop (didn't bet)
Seat 8: matiko09 (small blind) folded on the Turn
Seat 9: WrongButton (big blind) collected ($9.55)





PokerStars Hand #150120987647:  Hold'em No Limit ($1/$2 USD) - 2016/03/10 10:17:40 CET [2016/03/10 4:17:40 ET]
Table 'Tauris II' 9-max Seat #9 is the button
Seat 2: nickreason17 ($200 in chips) 
Seat 4: matiko09 ($382.86 in chips) 
Seat 5: Spudly6 ($167.52 in chips) 
Seat 6: Yaaaazz ($254.11 in chips) 
Seat 7: maxxmeister ($421.52 in chips) 
Seat 8: WrongButton ($204.60 in chips) 
Seat 9: darren1031 ($183 in chips) 
nickreason17: posts small blind $1
matiko09: posts big blind $2
*** HOLE CARDS ***
Dealt to matiko09 [Kc Js]
Spudly6: folds 
PHILLY_D_S leaves the table
Yaaaazz: raises $4 to $6
maxxmeister: folds 
WrongButton: calls $6
darren1031: folds 
nickreason17: folds 
matiko09: folds 
*** FLOP *** [3h 4h Jc]
toprmaw joins the table at seat #1 
Yaaaazz: bets $7.73
WrongButton: calls $7.73
*** TURN *** [3h 4h Jc] [2h]
Yaaaazz: bets $9.59
WrongButton: calls $9.59
*** RIVER *** [3h 4h Jc 2h] [Ad]
Yaaaazz: checks 
WrongButton: checks 
*** SHOW DOWN ***
Yaaaazz: shows [Td Tc] (a pair of Tens)
WrongButton: shows [Qs Qc] (a pair of Queens)
WrongButton collected $47.41 from pot
*** SUMMARY ***
Total pot $49.64 | Rake $2.23 
Board [3h 4h Jc 2h Ad]
Seat 2: nickreason17 (small blind) folded before Flop
Seat 4: matiko09 (big blind) folded before Flop
Seat 5: Spudly6 folded before Flop (didn't bet)
Seat 6: Yaaaazz showed [Td Tc] and lost with a pair of Tens
Seat 7: maxxmeister folded before Flop (didn't bet)
Seat 8: WrongButton showed [Qs Qc] and won ($47.41) with a pair of Queens
Seat 9: darren1031 (button) folded before Flop (didn't bet)





PokerStars Hand #150120987862:  Hold'em No Limit ($1/$2 USD) - 2016/03/10 10:17:40 CET [2016/03/10 4:17:40 ET]
Table 'Vesta' 9-max Seat #7 is the button
Seat 1: nickreason17 ($200 in chips) 
Seat 2: Pernilla E A ($116.43 in chips) 
Seat 3: matiko09 ($203 in chips) 
Seat 4: Yaaaazz ($251.40 in chips) 
Seat 5: PHILLY_D_S ($307.29 in chips) 
Seat 6: djammusic ($560.69 in chips) 
Seat 7: Monsthand ($207.14 in chips) 
Seat 8: 13Ghosts ($273.47 in chips) 
Seat 9: lixiangli ($387.81 in chips) 
13Ghosts: posts small blind $1
lixiangli: posts big blind $2
*** HOLE CARDS ***
Dealt to matiko09 [Jd 7s]
nickreason17: folds 
Pernilla E A has timed out
Pernilla E A: folds 
matiko09: folds 
Yaaaazz: folds 
13Ghosts said, "every thing cost me every day"
PHILLY_D_S: folds 
djammusic: folds 
Monsthand: raises $3 to $5
13Ghosts: folds 
lixiangli: folds 
Uncalled bet ($3) returned to Monsthand
Monsthand collected $5 from pot
Monsthand: doesn't show hand 
*** SUMMARY ***
Total pot $5 | Rake $0 
Seat 1: nickreason17 folded before Flop (didn't bet)
Seat 2: Pernilla E A folded before Flop (didn't bet)
Seat 3: matiko09 folded before Flop (didn't bet)
Seat 4: Yaaaazz folded before Flop (didn't bet)
Seat 5: PHILLY_D_S folded before Flop (didn't bet)
Seat 6: djammusic folded before Flop (didn't bet)
Seat 7: Monsthand (button) collected ($5)
Seat 8: 13Ghosts (small blind) folded before Flop
Seat 9: lixiangli (big blind) folded before Flop





PokerStars Hand #150120992200:  Hold'em No Limit ($1/$2 USD) - 2016/03/10 10:17:52 CET [2016/03/10 4:17:52 ET]
Table 'Solstice II' 9-max Seat #4 is the button
Seat 1: Rycious ($102.02 in chips) 
Seat 3: vano7777 ($116.41 in chips) 
Seat 4: matiko09 ($200 in chips) 
Seat 5: toprmaw ($214.25 in chips) 
Seat 6: thecurv ($200 in chips) 
toprmaw: posts small blind $1
thecurv: posts big blind $2
Monsthand: sits out 
*** HOLE CARDS ***
Dealt to matiko09 [7c 3h]
Rycious: calls $2
vano7777: raises $8 to $10
matiko09: folds 
toprmaw: folds 
thecurv: folds 
Rycious: calls $8
*** FLOP *** [6s Kd Kc]
Rycious: checks 
vano7777: checks 
*** TURN *** [6s Kd Kc] [Ah]
Rycious: checks 
vano7777: checks 
*** RIVER *** [6s Kd Kc Ah] [Th]
Rycious: checks 
vano7777: bets $17
Rycious: folds 
Uncalled bet ($17) returned to vano7777
vano7777 collected $21.96 from pot
*** SUMMARY ***
Total pot $23 | Rake $1.04 
Board [6s Kd Kc Ah Th]
Seat 1: Rycious folded on the River
Seat 3: vano7777 collected ($21.96)
Seat 4: matiko09 (button) folded before Flop (didn't bet)
Seat 5: toprmaw (small blind) folded before Flop
Seat 6: thecurv (big blind) folded before Flop





PokerStars Hand #150120993829:  Hold'em No Limit (€0.25/€0.50 EUR) - 2016/03/10 10:17:57 CET [2016/03/10 4:17:57 ET]
Table 'Algorab' 9-max Seat #3 is the button
Seat 2: IvanUrgant (€50.75 in chips) 
Seat 3: dididi2000 (€41.71 in chips) 
Seat 6: Bron By (€50.25 in chips) 
Seat 7: matiko09 (€86.15 in chips) 
Seat 8: fudzi (€51.25 in chips) 
Bron By: posts small blind €0.25
matiko09: posts big blind €0.50
vlad11122007: sits out 
nubpoker: sits out 
*** HOLE CARDS ***
Dealt to matiko09 [Jd Qs]
fudzi: folds 
IvanUrgant: raises €0.70 to €1.20
dididi2000: calls €1.20
Bron By: folds 
matiko09: calls €0.70
*** FLOP *** [9d Ks Tc]
matiko09: checks 
IvanUrgant: checks 
dididi2000: bets €2
matiko09: raises €3.50 to €5.50
Dantist1122 leaves the table
IvanUrgant: folds 
Butcher1848 joins the table at seat #4 
dididi2000: calls €3.50
*** TURN *** [9d Ks Tc] [3s]
matiko09: bets €9.50
dididi2000: folds 
Uncalled bet (€9.50) returned to matiko09
matiko09 collected €14.18 from pot
matiko09: doesn't show hand 
*** SUMMARY ***
Total pot €14.85 | Rake €0.67 
Board [9d Ks Tc 3s]
Seat 2: IvanUrgant folded on the Flop
Seat 3: dididi2000 (button) folded on the Turn
Seat 6: Bron By (small blind) folded before Flop
Seat 7: matiko09 (big blind) collected (€14.18)
Seat 8: fudzi folded before Flop (didn't bet)





PokerStars Hand #150120994127:  Hold'em No Limit ($0.50/$1.00 USD) - 2016/03/10 10:17:58 CET [2016/03/10 4:17:58 ET]
Table 'Nereid' 9-max Seat #7 is the button
Seat 1: matiko09 ($100 in chips) 
Seat 2: PHILLY_D_S ($100 in chips) 
Seat 3: mycka86 ($101.50 in chips) 
Seat 4: xiaoxiaoniao ($256.11 in chips) 
Seat 5: ilaviiitech ($100 in chips) 
Seat 6: thecurv ($100 in chips) 
Seat 7: Monsthand ($121.88 in chips) 
Seat 8: Rikti ($28.50 in chips) 
Seat 9: zxp12345 ($181.30 in chips) 
Rikti: posts small blind $0.50
zxp12345: posts big blind $1
*** HOLE CARDS ***
Dealt to matiko09 [3d 4h]
matiko09: folds 
PHILLY_D_S: raises $2 to $3
mycka86: folds 
xiaoxiaoniao: folds 
ilaviiitech: folds 
thecurv: folds 
Monsthand: folds 
Rikti: raises $11 to $14
zxp12345: folds 
PHILLY_D_S: raises $86 to $100 and is all-in
Rikti: calls $14.50 and is all-in
Uncalled bet ($71.50) returned to PHILLY_D_S
*** FIRST FLOP *** [5c 4d Th]
*** FIRST TURN *** [5c 4d Th] [Jd]
*** FIRST RIVER *** [5c 4d Th Jd] [6d]
*** SECOND FLOP *** [Ac 4c 2s]
*** SECOND TURN *** [Ac 4c 2s] [4s]
*** SECOND RIVER *** [Ac 4c 2s 4s] [As]
*** FIRST SHOW DOWN ***
Rikti: shows [Ks Ad] (high card Ace)
PHILLY_D_S: shows [Ah Qc] (high card Ace - lower kicker)
Rikti collected $27.70 from pot
*** SECOND SHOW DOWN ***
Rikti: shows [Ks Ad] (a full house, Aces full of Fours)
PHILLY_D_S: shows [Ah Qc] (a full house, Aces full of Fours)
Rikti collected $13.85 from pot
PHILLY_D_S collected $13.84 from pot
*** SUMMARY ***
Total pot $58 | Rake $2.61 
Hand was run twice
FIRST Board [5c 4d Th Jd 6d]
SECOND Board [Ac 4c 2s 4s As]
Seat 1: matiko09 folded before Flop (didn't bet)
Seat 2: PHILLY_D_S showed [Ah Qc] and lost with high card Ace, and won ($13.84) with a full house, Aces full of Fours
Seat 3: mycka86 folded before Flop (didn't bet)
Seat 4: xiaoxiaoniao folded before Flop (didn't bet)
Seat 5: ilaviiitech folded before Flop (didn't bet)
Seat 6: thecurv folded before Flop (didn't bet)
Seat 7: Monsthand (button) folded before Flop (didn't bet)
Seat 8: Rikti (small blind) showed [Ks Ad] and won ($27.70) with high card Ace, and won ($13.85) with a full house, Aces full of Fours
Seat 9: zxp12345 (big blind) folded before Flop





PokerStars Hand #150120994412:  Hold'em No Limit ($0.25/$0.50 USD) - 2016/03/10 10:17:58 CET [2016/03/10 4:17:58 ET]
Table 'Aegina' 9-max Seat #5 is the button
Seat 1: Wess_1970 ($116.40 in chips) 
Seat 2: el.suertero ($145.68 in chips) 
Seat 3: matiko09 ($50 in chips) 
Seat 4: vlad11122007 ($56.49 in chips) 
Seat 5: lyhtmqh ($83.86 in chips) 
Seat 6: ardo888 ($146.42 in chips) 
Seat 7: Bohne0815 ($78.90 in chips) 
Seat 8: q3storm ($50 in chips) 
ardo888: posts small blind $0.25
Bohne0815: posts big blind $0.50
i L00K great: sits out 
Wess_1970: posts the ante $0.10
el.suertero: posts the ante $0.10
matiko09: posts the ante $0.10
vlad11122007: posts the ante $0.10
lyhtmqh: posts the ante $0.10
ardo888: posts the ante $0.10
Bohne0815: posts the ante $0.10
q3storm: posts the ante $0.10
*** HOLE CARDS ***
Dealt to matiko09 [6c 8h]
q3storm: folds 
Wess_1970: folds 
el.suertero: folds 
matiko09: folds 
vlad11122007: folds 
lyhtmqh: folds 
lyhtmqh leaves the table
ardo888: folds 
Uncalled bet ($0.25) returned to Bohne0815
Bohne0815 collected $1.30 from pot
*** SUMMARY ***
Total pot $1.30 | Rake $0 
Seat 1: Wess_1970 folded before Flop (didn't bet)
Seat 2: el.suertero folded before Flop (didn't bet)
Seat 3: matiko09 folded before Flop (didn't bet)
Seat 4: vlad11122007 folded before Flop (didn't bet)
Seat 5: lyhtmqh (button) folded before Flop (didn't bet)
Seat 6: ardo888 (small blind) folded before Flop
Seat 7: Bohne0815 (big blind) collected ($1.30)
Seat 8: q3storm folded before Flop (didn't bet)





PokerStars Hand #150120995543:  Hold'em No Limit ($1/$2 USD) - 2016/03/10 10:18:02 CET [2016/03/10 4:18:02 ET]
Table 'Sophia II' 9-max Seat #1 is the button
Seat 1: thecurv ($255.58 in chips) 
Seat 2: Sang2015 ($219.45 in chips) 
Seat 3: maxxmeister ($203 in chips) 
Seat 4: hejun0713 ($192.36 in chips) 
Seat 5: matiko09 ($205 in chips) 
Seat 6: WrongButton ($215.83 in chips) 
Seat 7: Monsthand ($261.56 in chips) 
Sang2015: posts small blind $1
maxxmeister: posts big blind $2
BOAYARSKIY: sits out 
*** HOLE CARDS ***
Dealt to matiko09 [9s Kh]
hejun0713: folds 
matiko09: folds 
WrongButton: folds 
Monsthand: folds 
thecurv: folds 
Sang2015: folds 
Uncalled bet ($1) returned to maxxmeister
maxxmeister collected $2 from pot
maxxmeister: doesn't show hand 
*** SUMMARY ***
Total pot $2 | Rake $0 
Seat 1: thecurv (button) folded before Flop (didn't bet)
Seat 2: Sang2015 (small blind) folded before Flop
Seat 3: maxxmeister (big blind) collected ($2)
Seat 4: hejun0713 folded before Flop (didn't bet)
Seat 5: matiko09 folded before Flop (didn't bet)
Seat 6: WrongButton folded before Flop (didn't bet)
Seat 7: Monsthand folded before Flop (didn't bet)





PokerStars Hand #150121001345:  Hold'em No Limit ($1/$2 USD) - 2016/03/10 10:18:17 CET [2016/03/10 4:18:17 ET]
Table 'Sophia II' 9-max Seat #2 is the button
Seat 1: thecurv ($255.58 in chips) 
Seat 2: Sang2015 ($218.45 in chips) 
Seat 3: maxxmeister ($204 in chips) 
Seat 4: hejun0713 ($192.36 in chips) 
Seat 5: matiko09 ($205 in chips) 
Seat 6: WrongButton ($215.83 in chips) 
Seat 7: Monsthand ($261.56 in chips) 
maxxmeister: posts small blind $1
hejun0713: posts big blind $2
BOAYARSKIY: sits out 
*** HOLE CARDS ***
Dealt to matiko09 [4d Qd]
matiko09: folds 
WrongButton: folds 
Monsthand: folds 
thecurv: folds 
Sang2015: calls $2
maxxmeister: calls $1
hejun0713: checks 
*** FLOP *** [Td 2s 6s]
maxxmeister: checks 
hejun0713: checks 
Sang2015: bets $2
maxxmeister: folds 
hejun0713: calls $2
*** TURN *** [Td 2s 6s] [8s]
hejun0713: checks 
Sang2015: bets $6
hejun0713: folds 
Uncalled bet ($6) returned to Sang2015
Sang2015 collected $9.55 from pot
Sang2015: doesn't show hand 
*** SUMMARY ***
Total pot $10 | Rake $0.45 
Board [Td 2s 6s 8s]
Seat 1: thecurv folded before Flop (didn't bet)
Seat 2: Sang2015 (button) collected ($9.55)
Seat 3: maxxmeister (small blind) folded on the Flop
Seat 4: hejun0713 (big blind) folded on the Turn
Seat 5: matiko09 folded before Flop (didn't bet)
Seat 6: WrongButton folded before Flop (didn't bet)
Seat 7: Monsthand folded before Flop (didn't bet)





PokerStars Hand #150121001541:  Hold'em No Limit ($0.50/$1.00 USD) - 2016/03/10 10:18:18 CET [2016/03/10 4:18:18 ET]
Table 'Liriope II' 9-max Seat #9 is the button
Seat 1: Bron By ($104.09 in chips) 
Seat 2: vano7777 ($215.11 in chips) 
Seat 3: azzad2007 ($113.20 in chips) 
Seat 4: matiko09 ($132.55 in chips) 
Seat 5: toprmaw ($253.88 in chips) 
Seat 6: Monsthand ($100.20 in chips) 
Seat 7: mycka86 ($137.40 in chips) 
Seat 9: huti429 ($195.29 in chips) 
Bron By: posts small blind $0.50
vano7777: posts big blind $1
Bron By: posts the ante $0.20
vano7777: posts the ante $0.20
azzad2007: posts the ante $0.20
matiko09: posts the ante $0.20
toprmaw: posts the ante $0.20
Monsthand: posts the ante $0.20
mycka86: posts the ante $0.20
huti429: posts the ante $0.20
*** HOLE CARDS ***
Dealt to matiko09 [8s As]
azzad2007: folds 
matiko09: folds 
toprmaw: folds 
Monsthand: folds 
mycka86: folds 
huti429: folds 
huti429 leaves the table
Bron By: raises $1.07 to $2.07
vano7777: calls $1.07
*** FLOP *** [Js 3d Kc]
Bron By: checks 
vano7777: checks 
*** TURN *** [Js 3d Kc] [5h]
Bron By: checks 
vano7777: checks 
*** RIVER *** [Js 3d Kc 5h] [Jd]
Bron By: checks 
vano7777: checks 
*** SHOW DOWN ***
Bron By: shows [Qh 8c] (a pair of Jacks)
vano7777: mucks hand 
Bron By collected $5.48 from pot
*** SUMMARY ***
Total pot $5.74 | Rake $0.26 
Board [Js 3d Kc 5h Jd]
Seat 1: Bron By (small blind) showed [Qh 8c] and won ($5.48) with a pair of Jacks
Seat 2: vano7777 (big blind) mucked [8d 6d]
Seat 3: azzad2007 folded before Flop (didn't bet)
Seat 4: matiko09 folded before Flop (didn't bet)
Seat 5: toprmaw folded before Flop (didn't bet)
Seat 6: Monsthand folded before Flop (didn't bet)
Seat 7: mycka86 folded before Flop (didn't bet)
Seat 9: huti429 (button) folded before Flop (didn't bet)





PokerStars Hand #150121002803:  Hold'em No Limit ($1/$2 USD) - 2016/03/10 10:18:21 CET [2016/03/10 4:18:21 ET]
Table 'Archid' 9-max Seat #8 is the button
Seat 1: AP3221 ($97.22 in chips) 
Seat 2: geiranger011 ($90.64 in chips) 
Seat 3: sarkat104 ($155.33 in chips) 
Seat 4: Monsthand ($211.37 in chips) 
Seat 5: toprmaw ($203 in chips) 
Seat 6: Yaaaazz ($643.49 in chips) 
Seat 7: maxxmeister ($209.26 in chips) 
Seat 8: matiko09 ($314.20 in chips) 
Seat 9: WrongButton ($221.29 in chips) 
WrongButton: posts small blind $1
AP3221: posts big blind $2
*** HOLE CARDS ***
Dealt to matiko09 [Qs 8s]
geiranger011: folds 
sarkat104: calls $2
Monsthand: folds 
toprmaw: folds 
Yaaaazz: folds 
maxxmeister: raises $6 to $8
matiko09: raises $14 to $22
WrongButton: folds 
AP3221: folds 
sarkat104: calls $20
maxxmeister: calls $14
*** FLOP *** [Qh 9c 6s]
sarkat104: checks 
maxxmeister: checks 
matiko09: bets $32
sarkat104: raises $101.33 to $133.33 and is all-in
maxxmeister: folds 
matiko09: folds 
Uncalled bet ($101.33) returned to sarkat104
sarkat104 collected $130.20 from pot
*** SUMMARY ***
Total pot $133 | Rake $2.80 
Board [Qh 9c 6s]
Seat 1: AP3221 (big blind) folded before Flop
Seat 2: geiranger011 folded before Flop (didn't bet)
Seat 3: sarkat104 collected ($130.20)
Seat 4: Monsthand folded before Flop (didn't bet)
Seat 5: toprmaw folded before Flop (didn't bet)
Seat 6: Yaaaazz folded before Flop (didn't bet)
Seat 7: maxxmeister folded on the Flop
Seat 8: matiko09 (button) folded on the Flop
Seat 9: WrongButton (small blind) folded before Flop





PokerStars Hand #150121005844:  Hold'em No Limit ($1/$2 USD) - 2016/03/10 10:18:29 CET [2016/03/10 4:18:29 ET]
Table 'Vesta' 9-max Seat #8 is the button
Seat 1: nickreason17 ($200 in chips) 
Seat 2: Pernilla E A ($116.43 in chips) 
Seat 3: matiko09 ($203 in chips) 
Seat 4: Yaaaazz ($251.40 in chips) 
Seat 5: PHILLY_D_S ($307.29 in chips) 
Seat 6: djammusic ($560.69 in chips) 
Seat 7: Monsthand ($210.14 in chips) 
Seat 8: 13Ghosts ($272.47 in chips) 
Seat 9: lixiangli ($385.81 in chips) 
lixiangli: posts small blind $1
nickreason17: posts big blind $2
*** HOLE CARDS ***
Dealt to matiko09 [2s 3s]
Pernilla E A: raises $5 to $7
lixiangli said, "life is hard"
matiko09: folds 
Yaaaazz: folds 
PHILLY_D_S: folds 
djammusic: folds 
Monsthand: folds 
13Ghosts: calls $7
13Ghosts said, "yup"
lixiangli: folds 
nickreason17: raises $193 to $200 and is all-in
Pernilla E A: calls $109.43 and is all-in
13Ghosts: folds 
Uncalled bet ($83.57) returned to nickreason17
*** FLOP *** [2h 5s 4s]
*** TURN *** [2h 5s 4s] [Jh]
*** RIVER *** [2h 5s 4s Jh] [Qc]
*** SHOW DOWN ***
nickreason17: shows [Ah Kd] (high card Ace)
Pernilla E A: shows [Kh Qh] (a pair of Queens)
Pernilla E A collected $238.06 from pot
*** SUMMARY ***
Total pot $240.86 | Rake $2.80 
Board [2h 5s 4s Jh Qc]
Seat 1: nickreason17 (big blind) showed [Ah Kd] and lost with high card Ace
Seat 2: Pernilla E A showed [Kh Qh] and won ($238.06) with a pair of Queens
Seat 3: matiko09 folded before Flop (didn't bet)
Seat 4: Yaaaazz folded before Flop (didn't bet)
Seat 5: PHILLY_D_S folded before Flop (didn't bet)
Seat 6: djammusic folded before Flop (didn't bet)
Seat 7: Monsthand folded before Flop (didn't bet)
Seat 8: 13Ghosts (button) folded before Flop
Seat 9: lixiangli (small blind) folded before Flop





PokerStars Hand #150121005655:  Hold'em No Limit ($0.25/$0.50 USD) - 2016/03/10 10:18:29 CET [2016/03/10 4:18:29 ET]
Table 'Aegina' 9-max Seat #6 is the button
Seat 1: Wess_1970 ($116.30 in chips) 
Seat 2: el.suertero ($145.58 in chips) 
Seat 3: matiko09 ($50 in chips) 
Seat 4: vlad11122007 ($56.39 in chips) 
Seat 6: ardo888 ($146.07 in chips) 
Seat 7: Bohne0815 ($79.85 in chips) 
Seat 8: q3storm ($50 in chips) 
Bohne0815: posts small blind $0.25
q3storm: posts big blind $0.50
i L00K great: sits out 
Wess_1970: posts the ante $0.10
el.suertero: posts the ante $0.10
matiko09: posts the ante $0.10
vlad11122007: posts the ante $0.10
ardo888: posts the ante $0.10
Bohne0815: posts the ante $0.10
q3storm: posts the ante $0.10
*** HOLE CARDS ***
Dealt to matiko09 [Jh Kc]
Wess_1970: calls $0.50
depokerlord joins the table at seat #5 
el.suertero: raises $1.50 to $2
matiko09: folds 
vlad11122007: calls $2
ardo888: folds 
Bohne0815: folds 
q3storm: folds 
Wess_1970: calls $1.50
*** FLOP *** [Td 8s 5s]
Wess_1970: checks 
el.suertero: bets $3.91
vlad11122007: calls $3.91
Wess_1970: folds 
*** TURN *** [Td 8s 5s] [2h]
el.suertero: checks 
vlad11122007: checks 
*** RIVER *** [Td 8s 5s 2h] [As]
el.suertero: checks 
vlad11122007: checks 
*** SHOW DOWN ***
el.suertero: shows [Kh Js] (high card Ace)
vlad11122007: shows [6c 6s] (a pair of Sixes)
vlad11122007 collected $14.58 from pot
*** SUMMARY ***
Total pot $15.27 | Rake $0.69 
Board [Td 8s 5s 2h As]
Seat 1: Wess_1970 folded on the Flop
Seat 2: el.suertero showed [Kh Js] and lost with high card Ace
Seat 3: matiko09 folded before Flop (didn't bet)
Seat 4: vlad11122007 showed [6c 6s] and won ($14.58) with a pair of Sixes
Seat 6: ardo888 (button) folded before Flop (didn't bet)
Seat 7: Bohne0815 (small blind) folded before Flop
Seat 8: q3storm (big blind) folded before Flop





PokerStars Hand #150121006071:  Hold'em No Limit ($1/$2 USD) - 2016/03/10 10:18:30 CET [2016/03/10 4:18:30 ET]
Table 'Solstice II' 9-max Seat #5 is the button
Seat 1: Rycious ($92.02 in chips) 
Seat 3: vano7777 ($128.37 in chips) 
Seat 4: matiko09 ($200 in chips) 
Seat 5: toprmaw ($213.25 in chips) 
Seat 6: thecurv ($200 in chips) 
Seat 9: Monsthand ($200 in chips) 
thecurv: posts small blind $1
Monsthand: posts big blind $2
*** HOLE CARDS ***
Dealt to matiko09 [Td 6s]
Rycious: calls $2
vano7777: raises $6 to $8
matiko09: folds 
toprmaw: folds 
thecurv: folds 
Monsthand: folds 
Rycious: calls $6
*** FLOP *** [7h Qh 2h]
Rycious: bets $8
vano7777: calls $8
*** TURN *** [7h Qh 2h] [Qs]
Rycious: checks 
vano7777: checks 
*** RIVER *** [7h Qh 2h Qs] [Ks]
Rycious: checks 
vano7777: checks 
*** SHOW DOWN ***
Rycious: shows [Jd Tc] (a pair of Queens)
vano7777: shows [Js Ah] (a pair of Queens - Ace kicker)
vano7777 collected $33.42 from pot
*** SUMMARY ***
Total pot $35 | Rake $1.58 
Board [7h Qh 2h Qs Ks]
Seat 1: Rycious showed [Jd Tc] and lost with a pair of Queens
Seat 3: vano7777 showed [Js Ah] and won ($33.42) with a pair of Queens
Seat 4: matiko09 folded before Flop (didn't bet)
Seat 5: toprmaw (button) folded before Flop (didn't bet)
Seat 6: thecurv (small blind) folded before Flop
Seat 9: Monsthand (big blind) folded before Flop





PokerStars Hand #150121009014:  Hold'em No Limit ($1/$2 USD) - 2016/03/10 10:18:38 CET [2016/03/10 4:18:38 ET]
Table 'Tauris II' 9-max Seat #2 is the button
Seat 2: nickreason17 ($200 in chips) 
Seat 4: matiko09 ($380.86 in chips) 
Seat 5: Spudly6 ($167.52 in chips) 
Seat 6: Yaaaazz ($230.79 in chips) 
Seat 7: maxxmeister ($421.52 in chips) 
Seat 8: WrongButton ($228.69 in chips) 
Seat 9: darren1031 ($183 in chips) 
matiko09: posts small blind $1
Spudly6: posts big blind $2
toprmaw: sits out 
*** HOLE CARDS ***
Dealt to matiko09 [Jh 4s]
Yaaaazz: folds 
maxxmeister: folds 
WrongButton: folds 
darren1031: folds 
nickreason17: raises $2.08 to $4.08
matiko09: folds 
Spudly6: folds 
Uncalled bet ($2.08) returned to nickreason17
nickreason17 collected $5 from pot
*** SUMMARY ***
Total pot $5 | Rake $0 
Seat 2: nickreason17 (button) collected ($5)
Seat 4: matiko09 (small blind) folded before Flop
Seat 5: Spudly6 (big blind) folded before Flop
Seat 6: Yaaaazz folded before Flop (didn't bet)
Seat 7: maxxmeister folded before Flop (didn't bet)
Seat 8: WrongButton folded before Flop (didn't bet)
Seat 9: darren1031 folded before Flop (didn't bet)





PokerStars Hand #150121012554:  Hold'em No Limit ($0.50/$1.00 USD) - 2016/03/10 10:18:48 CET [2016/03/10 4:18:48 ET]
Table 'Rarahu' 9-max Seat #7 is the button
Seat 1: matiko09 ($100 in chips) 
Seat 2: azzad2007 ($100 in chips) 
Seat 3: ka100pka527 ($42.56 in chips) 
Seat 4: vilo1070 ($112 in chips) 
Seat 5: blackw0lf_03 ($108.23 in chips) 
Seat 6: RMilPoker ($108.39 in chips) 
Seat 7: PHILLY_D_S ($146.72 in chips) 
Seat 8: Rikti ($59.58 in chips) 
Seat 9: Srz7v44 ($114.86 in chips) 
Rikti: posts small blind $0.50
Srz7v44: posts big blind $1
*** HOLE CARDS ***
Dealt to matiko09 [Ks Kh]
matiko09: raises $2 to $3
azzad2007: folds 
ka100pka527: folds 
vilo1070: folds 
blackw0lf_03: folds 
RMilPoker: folds 
PHILLY_D_S: folds 
Rikti: folds 
Srz7v44: calls $2
*** FLOP *** [9h 4d 7h]
Srz7v44: checks 
matiko09: bets $4.04
Srz7v44: folds 
Uncalled bet ($4.04) returned to matiko09
matiko09 collected $6.21 from pot
matiko09: doesn't show hand 
*** SUMMARY ***
Total pot $6.50 | Rake $0.29 
Board [9h 4d 7h]
Seat 1: matiko09 collected ($6.21)
Seat 2: azzad2007 folded before Flop (didn't bet)
Seat 3: ka100pka527 folded before Flop (didn't bet)
Seat 4: vilo1070 folded before Flop (didn't bet)
Seat 5: blackw0lf_03 folded before Flop (didn't bet)
Seat 6: RMilPoker folded before Flop (didn't bet)
Seat 7: PHILLY_D_S (button) folded before Flop (didn't bet)
Seat 8: Rikti (small blind) folded before Flop
Seat 9: Srz7v44 (big blind) folded on the Flop





PokerStars Hand #150121014248:  Hold'em No Limit ($0.50/$1.00 USD) - 2016/03/10 10:18:52 CET [2016/03/10 4:18:52 ET]
Table 'Alsciaukat' 9-max Seat #7 is the button
Seat 1: Kelvin sai ($66.20 in chips) 
Seat 2: mycka86 ($100 in chips) 
Seat 3: blackw0lf_03 ($100 in chips) 
Seat 4: Rikti ($36.50 in chips) 
Seat 5: toprmaw ($110.42 in chips) 
Seat 7: Yaaaazz ($121.74 in chips) 
Seat 8: F1dgeT ($100 in chips) 
Seat 9: matiko09 ($107.38 in chips) 
F1dgeT: posts small blind $0.50
matiko09: posts big blind $1
*** HOLE CARDS ***
Dealt to matiko09 [Kc 9h]
Kelvin sai: folds 
mycka86: folds 
blackw0lf_03: folds 
Rikti: folds 
toprmaw: raises $1.50 to $2.50
Yaaaazz: folds 
F1dgeT: folds 
matiko09: folds 
Uncalled bet ($1.50) returned to toprmaw
toprmaw collected $2.50 from pot
toprmaw: doesn't show hand 
*** SUMMARY ***
Total pot $2.50 | Rake $0 
Seat 1: Kelvin sai folded before Flop (didn't bet)
Seat 2: mycka86 folded before Flop (didn't bet)
Seat 3: blackw0lf_03 folded before Flop (didn't bet)
Seat 4: Rikti folded before Flop (didn't bet)
Seat 5: toprmaw collected ($2.50)
Seat 7: Yaaaazz (button) folded before Flop (didn't bet)
Seat 8: F1dgeT (small blind) folded before Flop
Seat 9: matiko09 (big blind) folded before Flop





PokerStars Hand #150121016495:  Hold'em No Limit ($0.50/$1.00 USD) - 2016/03/10 10:18:58 CET [2016/03/10 4:18:58 ET]
Table 'Nereid' 9-max Seat #8 is the button
Seat 1: matiko09 ($100 in chips) 
Seat 2: PHILLY_D_S ($100 in chips) 
Seat 3: mycka86 ($101.50 in chips) 
Seat 4: xiaoxiaoniao ($256.11 in chips) 
Seat 5: ilaviiitech ($100 in chips) 
Seat 6: thecurv ($100 in chips) 
Seat 7: Monsthand ($121.88 in chips) 
Seat 8: Rikti ($41.55 in chips) 
Seat 9: zxp12345 ($180.30 in chips) 
zxp12345: posts small blind $0.50
matiko09: posts big blind $1
*** HOLE CARDS ***
Dealt to matiko09 [Td Qd]
PHILLY_D_S: folds 
mycka86: folds 
xiaoxiaoniao: raises $1 to $2
ilaviiitech: folds 
thecurv: folds 
Monsthand: folds 
Rikti: calls $2
zxp12345: calls $1.50
matiko09: calls $1
*** FLOP *** [9s 4c 6s]
zxp12345: checks 
matiko09: checks 
xiaoxiaoniao: checks 
Rikti: bets $5
zxp12345: calls $5
matiko09: folds 
xiaoxiaoniao: folds 
*** TURN *** [9s 4c 6s] [3s]
zxp12345: bets $8.59
Rikti: calls $8.59
*** RIVER *** [9s 4c 6s 3s] [Qc]
zxp12345: bets $16.80
Rikti: folds 
Uncalled bet ($16.80) returned to zxp12345
zxp12345 collected $33.60 from pot
zxp12345: doesn't show hand 
*** SUMMARY ***
Total pot $35.18 | Rake $1.58 
Board [9s 4c 6s 3s Qc]
Seat 1: matiko09 (big blind) folded on the Flop
Seat 2: PHILLY_D_S folded before Flop (didn't bet)
Seat 3: mycka86 folded before Flop (didn't bet)
Seat 4: xiaoxiaoniao folded on the Flop
Seat 5: ilaviiitech folded before Flop (didn't bet)
Seat 6: thecurv folded before Flop (didn't bet)
Seat 7: Monsthand folded before Flop (didn't bet)
Seat 8: Rikti (button) folded on the River
Seat 9: zxp12345 (small blind) collected ($33.60)





PokerStars Hand #150121016870:  Hold'em No Limit ($1/$2 USD) - 2016/03/10 10:18:59 CET [2016/03/10 4:18:59 ET]
Table 'Sophia II' 9-max Seat #3 is the button
Seat 1: thecurv ($255.58 in chips) 
Seat 2: Sang2015 ($224 in chips) 
Seat 3: maxxmeister ($202 in chips) 
Seat 4: hejun0713 ($188.36 in chips) 
Seat 5: matiko09 ($205 in chips) 
Seat 6: WrongButton ($215.83 in chips) 
Seat 7: Monsthand ($261.56 in chips) 
hejun0713: posts small blind $1
matiko09: posts big blind $2
BOAYARSKIY: sits out 
*** HOLE CARDS ***
Dealt to matiko09 [Ac 9h]
WrongButton: raises $4 to $6
Monsthand: calls $6
thecurv: folds 
Sang2015: folds 
maxxmeister: calls $6
hejun0713: folds 
matiko09: folds 
*** FLOP *** [9c 5h 7s]
WrongButton: checks 
Monsthand: bets $13.03
maxxmeister: folds 
WrongButton: folds 
Uncalled bet ($13.03) returned to Monsthand
Monsthand collected $20.06 from pot
Monsthand: doesn't show hand 
*** SUMMARY ***
Total pot $21 | Rake $0.94 
Board [9c 5h 7s]
Seat 1: thecurv folded before Flop (didn't bet)
Seat 2: Sang2015 folded before Flop (didn't bet)
Seat 3: maxxmeister (button) folded on the Flop
Seat 4: hejun0713 (small blind) folded before Flop
Seat 5: matiko09 (big blind) folded before Flop
Seat 6: WrongButton folded on the Flop
Seat 7: Monsthand collected ($20.06)





PokerStars Hand #150121017192:  Hold'em No Limit ($0.50/$1.00 USD) - 2016/03/10 10:19:00 CET [2016/03/10 4:19:00 ET]
Table 'Saskia' 9-max Seat #3 is the button
Seat 1: matiko09 ($111 in chips) 
Seat 2: nickreason17 ($100 in chips) 
Seat 3: Monsthand ($103.20 in chips) 
Seat 4: blackw0lf_03 ($109.98 in chips) 
Seat 6: kenheung ($124.54 in chips) 
Seat 7: AlKatrone ($141.43 in chips) 
Seat 9: mycka86 ($116.97 in chips) 
blackw0lf_03: posts small blind $0.50
Rikti: is sitting out 
kenheung: posts big blind $1
DIMAN_324: sits out 
*** HOLE CARDS ***
Dealt to matiko09 [3c 5d]
AlKatrone: folds 
mycka86: folds 
matiko09: folds 
nickreason17: folds 
Monsthand: raises $1.50 to $2.50
blackw0lf_03: folds 
kenheung: folds 
Uncalled bet ($1.50) returned to Monsthand
Monsthand collected $2.50 from pot
Monsthand: doesn't show hand 
*** SUMMARY ***
Total pot $2.50 | Rake $0 
Seat 1: matiko09 folded before Flop (didn't bet)
Seat 2: nickreason17 folded before Flop (didn't bet)
Seat 3: Monsthand (button) collected ($2.50)
Seat 4: blackw0lf_03 (small blind) folded before Flop
Seat 6: kenheung (big blind) folded before Flop
Seat 7: AlKatrone folded before Flop (didn't bet)
Seat 9: mycka86 folded before Flop (didn't bet)





PokerStars Hand #150121017423:  Hold'em No Limit ($1/$2 USD) - 2016/03/10 10:19:01 CET [2016/03/10 4:19:01 ET]
Table 'Vesta' 9-max Seat #9 is the button
Seat 1: nickreason17 ($200 in chips) 
Seat 2: Pernilla E A ($238.06 in chips) 
Seat 3: matiko09 ($203 in chips) 
Seat 4: Yaaaazz ($251.40 in chips) 
Seat 5: PHILLY_D_S ($307.29 in chips) 
Seat 6: djammusic ($560.69 in chips) 
Seat 7: Monsthand ($210.14 in chips) 
Seat 8: 13Ghosts ($265.47 in chips) 
Seat 9: lixiangli ($384.81 in chips) 
nickreason17: posts small blind $1
Pernilla E A: posts big blind $2
*** HOLE CARDS ***
Dealt to matiko09 [8c 2s]
matiko09: folds 
Yaaaazz: folds 
PHILLY_D_S: raises $4 to $6
djammusic: folds 
Monsthand: folds 
13Ghosts: folds 
lixiangli: folds 
nickreason17: folds 
Pernilla E A: calls $4
*** FLOP *** [Ah Kc 5d]
Pernilla E A: checks 
PHILLY_D_S: bets $8.55
13Ghosts said, "nice one dingo dog"
Pernilla E A: folds 
Uncalled bet ($8.55) returned to PHILLY_D_S
PHILLY_D_S collected $12.42 from pot
PHILLY_D_S: doesn't show hand 
*** SUMMARY ***
Total pot $13 | Rake $0.58 
Board [Ah Kc 5d]
Seat 1: nickreason17 (small blind) folded before Flop
Seat 2: Pernilla E A (big blind) folded on the Flop
Seat 3: matiko09 folded before Flop (didn't bet)
Seat 4: Yaaaazz folded before Flop (didn't bet)
Seat 5: PHILLY_D_S collected ($12.42)
Seat 6: djammusic folded before Flop (didn't bet)
Seat 7: Monsthand folded before Flop (didn't bet)
Seat 8: 13Ghosts folded before Flop (didn't bet)
Seat 9: lixiangli (button) folded before Flop (didn't bet)





PokerStars Hand #150121020177:  Hold'em No Limit ($1/$2 USD) - 2016/03/10 10:19:08 CET [2016/03/10 4:19:08 ET]
Table 'Tauris II' 9-max Seat #4 is the button
Seat 2: nickreason17 ($203 in chips) 
Seat 4: matiko09 ($379.86 in chips) 
Seat 5: Spudly6 ($165.52 in chips) 
Seat 6: Yaaaazz ($230.79 in chips) 
Seat 7: maxxmeister ($421.52 in chips) 
Seat 8: WrongButton ($228.69 in chips) 
Seat 9: darren1031 ($183 in chips) 
Spudly6: posts small blind $1
Yaaaazz: posts big blind $2
toprmaw: sits out 
*** HOLE CARDS ***
Dealt to matiko09 [7c 3d]
maxxmeister: folds 
maxxmeister leaves the table
WrongButton: folds 
darren1031: folds 
nickreason17: folds 
Monsthand joins the table at seat #7 
matiko09: folds 
Spudly6: folds 
Uncalled bet ($1) returned to Yaaaazz
Yaaaazz collected $2 from pot
*** SUMMARY ***
Total pot $2 | Rake $0 
Seat 2: nickreason17 folded before Flop (didn't bet)
Seat 4: matiko09 (button) folded before Flop (didn't bet)
Seat 5: Spudly6 (small blind) folded before Flop
Seat 6: Yaaaazz (big blind) collected ($2)
Seat 7: maxxmeister folded before Flop (didn't bet)
Seat 8: WrongButton folded before Flop (didn't bet)
Seat 9: darren1031 folded before Flop (didn't bet)





PokerStars Hand #150121025195:  Hold'em No Limit ($1/$2 USD) - 2016/03/10 10:19:21 CET [2016/03/10 4:19:21 ET]
Table 'Solstice II' 9-max Seat #6 is the button
Seat 1: Rycious ($76.02 in chips) 
Seat 3: vano7777 ($145.79 in chips) 
Seat 4: matiko09 ($200 in chips) 
Seat 5: toprmaw ($213.25 in chips) 
Seat 6: thecurv ($200 in chips) 
Seat 9: Monsthand ($200 in chips) 
Monsthand: posts small blind $1
Rycious: posts big blind $2
*** HOLE CARDS ***
Dealt to matiko09 [Ks 3s]
vano7777: folds 
matiko09: folds 
toprmaw: folds 
thecurv: folds 
Monsthand: raises $3 to $5
Rycious: calls $3
*** FLOP *** [Kd 4h 6d]
Monsthand: bets $5.25
Rycious: calls $5.25
*** TURN *** [Kd 4h 6d] [Ah]
Monsthand: bets $12.72
Rycious: calls $12.72
*** RIVER *** [Kd 4h 6d Ah] [7h]
Monsthand: checks 
Rycious: bets $22
Monsthand: folds 
Uncalled bet ($22) returned to Rycious
Rycious collected $43.87 from pot
Rycious: doesn't show hand 
*** SUMMARY ***
Total pot $45.94 | Rake $2.07 
Board [Kd 4h 6d Ah 7h]
Seat 1: Rycious (big blind) collected ($43.87)
Seat 3: vano7777 folded before Flop (didn't bet)
Seat 4: matiko09 folded before Flop (didn't bet)
Seat 5: toprmaw folded before Flop (didn't bet)
Seat 6: thecurv (button) folded before Flop (didn't bet)
Seat 9: Monsthand (small blind) folded on the River





PokerStars Hand #150121026630:  Hold'em No Limit ($0.50/$1.00 USD) - 2016/03/10 10:19:25 CET [2016/03/10 4:19:25 ET]
Table 'Liriope II' 9-max Seat #1 is the button
Seat 1: Bron By ($107.30 in chips) 
Seat 2: vano7777 ($212.84 in chips) 
Seat 3: azzad2007 ($113 in chips) 
Seat 4: matiko09 ($132.35 in chips) 
Seat 5: toprmaw ($253.68 in chips) 
Seat 6: Monsthand ($100 in chips) 
Seat 7: mycka86 ($137.20 in chips) 
vano7777: posts small blind $0.50
azzad2007: posts big blind $1
Bron By: posts the ante $0.20
vano7777: posts the ante $0.20
azzad2007: posts the ante $0.20
matiko09: posts the ante $0.20
toprmaw: posts the ante $0.20
Monsthand: posts the ante $0.20
mycka86: posts the ante $0.20
*** HOLE CARDS ***
Dealt to matiko09 [4s 6s]
matiko09: folds 
toprmaw: folds 
Monsthand: folds 
mycka86: folds 
Bron By: folds 
vano7777: folds 
Uncalled bet ($0.50) returned to azzad2007
azzad2007 collected $2.40 from pot
azzad2007: doesn't show hand 
*** SUMMARY ***
Total pot $2.40 | Rake $0 
Seat 1: Bron By (button) folded before Flop (didn't bet)
Seat 2: vano7777 (small blind) folded before Flop
Seat 3: azzad2007 (big blind) collected ($2.40)
Seat 4: matiko09 folded before Flop (didn't bet)
Seat 5: toprmaw folded before Flop (didn't bet)
Seat 6: Monsthand folded before Flop (didn't bet)
Seat 7: mycka86 folded before Flop (didn't bet)





PokerStars Hand #150121026860:  Hold'em No Limit ($1/$2 USD) - 2016/03/10 10:19:26 CET [2016/03/10 4:19:26 ET]
Table 'Tauris II' 9-max Seat #5 is the button
Seat 2: nickreason17 ($203 in chips) 
Seat 4: matiko09 ($379.86 in chips) 
Seat 5: Spudly6 ($164.52 in chips) 
Seat 6: Yaaaazz ($231.79 in chips) 
Seat 7: Monsthand ($222.85 in chips) 
Seat 8: WrongButton ($228.69 in chips) 
Seat 9: darren1031 ($183 in chips) 
Yaaaazz: posts small blind $1
Monsthand: posts big blind $2
toprmaw: sits out 
*** HOLE CARDS ***
Dealt to matiko09 [9c 4s]
WrongButton: folds 
darren1031: folds 
nickreason17: folds 
matiko09: folds 
Spudly6: folds 
Yaaaazz: folds 
Uncalled bet ($1) returned to Monsthand
Monsthand collected $2 from pot
Monsthand: doesn't show hand 
*** SUMMARY ***
Total pot $2 | Rake $0 
Seat 2: nickreason17 folded before Flop (didn't bet)
Seat 4: matiko09 folded before Flop (didn't bet)
Seat 5: Spudly6 (button) folded before Flop (didn't bet)
Seat 6: Yaaaazz (small blind) folded before Flop
Seat 7: Monsthand (big blind) collected ($2)
Seat 8: WrongButton folded before Flop (didn't bet)
Seat 9: darren1031 folded before Flop (didn't bet)





PokerStars Hand #150121028736:  Hold'em No Limit ($1/$2 USD) - 2016/03/10 10:19:31 CET [2016/03/10 4:19:31 ET]
Table 'Vesta' 9-max Seat #1 is the button
Seat 1: nickreason17 ($200 in chips) 
Seat 2: Pernilla E A ($232.06 in chips) 
Seat 3: matiko09 ($203 in chips) 
Seat 4: Yaaaazz ($251.40 in chips) 
Seat 5: PHILLY_D_S ($313.71 in chips) 
Seat 6: djammusic ($560.69 in chips) 
Seat 7: Monsthand ($210.14 in chips) 
Seat 8: 13Ghosts ($265.47 in chips) 
Seat 9: lixiangli ($384.81 in chips) 
Pernilla E A: posts small blind $1
matiko09: posts big blind $2
*** HOLE CARDS ***
Dealt to matiko09 [Tc 6d]
Yaaaazz: folds 
PHILLY_D_S: folds 
djammusic: folds 
Pernilla E A said, "it was"
Monsthand: raises $4 to $6
13Ghosts: folds 
lixiangli: calls $6
nickreason17: folds 
Pernilla E A: calls $5
13Ghosts said, "thats dingo dog style"
matiko09: folds 
*** FLOP *** [2d Qs 9d]
Pernilla E A: checks 
13Ghosts said, "lol"
Pernilla E A said, "you know all those I see !"
Pernilla E A said, ":D"
Monsthand: bets $11.50
lixiangli: calls $11.50
Pernilla E A: folds 
*** TURN *** [2d Qs 9d] [Ks]
Monsthand: bets $31.50
lixiangli: raises $335.81 to $367.31 and is all-in
Monsthand: folds 
Uncalled bet ($335.81) returned to lixiangli
lixiangli collected $103.20 from pot
lixiangli: doesn't show hand 
*** SUMMARY ***
Total pot $106 | Rake $2.80 
Board [2d Qs 9d Ks]
Seat 1: nickreason17 (button) folded before Flop (didn't bet)
Seat 2: Pernilla E A (small blind) folded on the Flop
Seat 3: matiko09 (big blind) folded before Flop
Seat 4: Yaaaazz folded before Flop (didn't bet)
Seat 5: PHILLY_D_S folded before Flop (didn't bet)
Seat 6: djammusic folded before Flop (didn't bet)
Seat 7: Monsthand folded on the Turn
Seat 8: 13Ghosts folded before Flop (didn't bet)
Seat 9: lixiangli collected ($103.20)





PokerStars Hand #150121029414:  Hold'em No Limit ($0.50/$1.00 USD) - 2016/03/10 10:19:33 CET [2016/03/10 4:19:33 ET]
Table 'Saskia' 9-max Seat #4 is the button
Seat 1: matiko09 ($111 in chips) 
Seat 2: nickreason17 ($100 in chips) 
Seat 3: Monsthand ($104.70 in chips) 
Seat 4: blackw0lf_03 ($109.48 in chips) 
Seat 6: kenheung ($123.54 in chips) 
Seat 7: AlKatrone ($141.43 in chips) 
Seat 9: mycka86 ($116.97 in chips) 
kenheung: posts small blind $0.50
AlKatrone: posts big blind $1
DIMAN_324: sits out 
*** HOLE CARDS ***
Dealt to matiko09 [6d 3s]
mycka86: folds 
matiko09: folds 
nickreason17: raises $2 to $3
Monsthand: folds 
blackw0lf_03: folds 
kenheung: folds 
AlKatrone: calls $2
*** FLOP *** [Kd Ad 3h]
AlKatrone: checks 
nickreason17: checks 
*** TURN *** [Kd Ad 3h] [Ts]
AlKatrone: checks 
nickreason17: checks 
*** RIVER *** [Kd Ad 3h Ts] [As]
AlKatrone: checks 
nickreason17: bets $4.50
AlKatrone has timed out
AlKatrone: folds 
Uncalled bet ($4.50) returned to nickreason17
nickreason17 collected $6.21 from pot
*** SUMMARY ***
Total pot $6.50 | Rake $0.29 
Board [Kd Ad 3h Ts As]
Seat 1: matiko09 folded before Flop (didn't bet)
Seat 2: nickreason17 collected ($6.21)
Seat 3: Monsthand folded before Flop (didn't bet)
Seat 4: blackw0lf_03 (button) folded before Flop (didn't bet)
Seat 6: kenheung (small blind) folded before Flop
Seat 7: AlKatrone (big blind) folded on the River
Seat 9: mycka86 folded before Flop (didn't bet)





PokerStars Hand #150121030809:  Hold'em No Limit (€0.25/€0.50 EUR) - 2016/03/10 10:19:37 CET [2016/03/10 4:19:37 ET]
Table 'Algorab' 9-max Seat #6 is the button
Seat 2: IvanUrgant (€50 in chips) 
Seat 3: dididi2000 (€35.01 in chips) 
Seat 6: Bron By (€50 in chips) 
Seat 7: matiko09 (€93.63 in chips) 
Seat 8: fudzi (€51.25 in chips) 
matiko09: posts small blind €0.25
fudzi: posts big blind €0.50
vlad11122007: sits out 
nubpoker: sits out 
Butcher1848: sits out 
*** HOLE CARDS ***
Dealt to matiko09 [4c 2c]
IvanUrgant has timed out while being disconnected
IvanUrgant: folds 
dididi2000: folds 
IvanUrgant is disconnected 
Bron By: raises €0.54 to €1.04
matiko09: folds 
fudzi: folds 
Uncalled bet (€0.54) returned to Bron By
Bron By collected €1.25 from pot
Bron By: doesn't show hand 
*** SUMMARY ***
Total pot €1.25 | Rake €0 
Seat 2: IvanUrgant folded before Flop (didn't bet)
Seat 3: dididi2000 folded before Flop (didn't bet)
Seat 6: Bron By (button) collected (€1.25)
Seat 7: matiko09 (small blind) folded before Flop
Seat 8: fudzi (big blind) folded before Flop





PokerStars Hand #150121033579:  Hold'em No Limit ($0.50/$1.00 USD) - 2016/03/10 10:19:44 CET [2016/03/10 4:19:44 ET]
Table 'Alsciaukat' 9-max Seat #8 is the button
Seat 1: Kelvin sai ($66.20 in chips) 
Seat 2: mycka86 ($100 in chips) 
Seat 3: blackw0lf_03 ($100 in chips) 
Seat 4: Rikti ($36.50 in chips) 
Seat 5: toprmaw ($111.92 in chips) 
Seat 7: Yaaaazz ($121.74 in chips) 
Seat 8: F1dgeT ($100 in chips) 
Seat 9: matiko09 ($106.38 in chips) 
matiko09: posts small blind $0.50
Kelvin sai: posts big blind $1
*** HOLE CARDS ***
Dealt to matiko09 [Kh 5d]
mycka86: folds 
blackw0lf_03: folds 
Rikti: raises $1 to $2
toprmaw: folds 
Yaaaazz: folds 
F1dgeT: folds 
matiko09: folds 
Kelvin sai: calls $1
*** FLOP *** [4d 8s 6h]
Kelvin sai: checks 
Rikti: checks 
*** TURN *** [4d 8s 6h] [8c]
Kelvin sai: bets $2
Rikti: folds 
Uncalled bet ($2) returned to Kelvin sai
Kelvin sai collected $4.30 from pot
Kelvin sai: doesn't show hand 
*** SUMMARY ***
Total pot $4.50 | Rake $0.20 
Board [4d 8s 6h 8c]
Seat 1: Kelvin sai (big blind) collected ($4.30)
Seat 2: mycka86 folded before Flop (didn't bet)
Seat 3: blackw0lf_03 folded before Flop (didn't bet)
Seat 4: Rikti folded on the Turn
Seat 5: toprmaw folded before Flop (didn't bet)
Seat 7: Yaaaazz folded before Flop (didn't bet)
Seat 8: F1dgeT (button) folded before Flop (didn't bet)
Seat 9: matiko09 (small blind) folded before Flop





PokerStars Hand #150121036001:  Hold'em No Limit ($0.50/$1.00 USD) - 2016/03/10 10:19:51 CET [2016/03/10 4:19:51 ET]
Table 'Rarahu' 9-max Seat #8 is the button
Seat 1: matiko09 ($103.21 in chips) 
Seat 2: azzad2007 ($100 in chips) 
Seat 3: ka100pka527 ($42.56 in chips) 
Seat 4: vilo1070 ($112 in chips) 
Seat 5: blackw0lf_03 ($108.23 in chips) 
Seat 6: RMilPoker ($108.39 in chips) 
Seat 7: PHILLY_D_S ($146.72 in chips) 
Seat 8: Rikti ($59.08 in chips) 
Seat 9: Srz7v44 ($111.86 in chips) 
Srz7v44: posts small blind $0.50
matiko09: posts big blind $1
*** HOLE CARDS ***
Dealt to matiko09 [As Tc]
azzad2007: folds 
ka100pka527: folds 
vilo1070: folds 
blackw0lf_03: folds 
RMilPoker: folds 
PHILLY_D_S: folds 
Rikti: raises $1 to $2
Srz7v44: calls $1.50
matiko09: raises $7 to $9
Rikti: calls $7
Srz7v44: folds 
*** FLOP *** [Ad 9s 3c]
matiko09: checks 
Rikti: checks 
*** TURN *** [Ad 9s 3c] [3d]
matiko09: checks 
Rikti: bets $10
matiko09: calls $10
*** RIVER *** [Ad 9s 3c 3d] [8c]
matiko09: checks 
Rikti: bets $20
matiko09: calls $20
*** SHOW DOWN ***
Rikti: shows [3s 3h] (four of a kind, Threes)
matiko09: mucks hand 
Rikti collected $77.20 from pot
*** SUMMARY ***
Total pot $80 | Rake $2.80 
Board [Ad 9s 3c 3d 8c]
Seat 1: matiko09 (big blind) mucked [As Tc]
Seat 2: azzad2007 folded before Flop (didn't bet)
Seat 3: ka100pka527 folded before Flop (didn't bet)
Seat 4: vilo1070 folded before Flop (didn't bet)
Seat 5: blackw0lf_03 folded before Flop (didn't bet)
Seat 6: RMilPoker folded before Flop (didn't bet)
Seat 7: PHILLY_D_S folded before Flop (didn't bet)
Seat 8: Rikti (button) showed [3s 3h] and won ($77.20) with four of a kind, Threes
Seat 9: Srz7v44 (small blind) folded before Flop





PokerStars Hand #150121037062:  Hold'em No Limit ($1/$2 USD) - 2016/03/10 10:19:53 CET [2016/03/10 4:19:53 ET]
Table 'Tauris II' 9-max Seat #6 is the button
Seat 2: nickreason17 ($203 in chips) 
Seat 4: matiko09 ($379.86 in chips) 
Seat 5: Spudly6 ($164.52 in chips) 
Seat 6: Yaaaazz ($230.79 in chips) 
Seat 7: Monsthand ($223.85 in chips) 
Seat 8: WrongButton ($228.69 in chips) 
Seat 9: darren1031 ($183 in chips) 
Monsthand: posts small blind $1
WrongButton: posts big blind $2
toprmaw: sits out 
*** HOLE CARDS ***
Dealt to matiko09 [As 8d]
darren1031: calls $2
nickreason17: folds 
vano7777 leaves the table
BOAYARSKIY joins the table at seat #3 
matiko09: folds 
Spudly6: folds 
Yaaaazz: folds 
Monsthand: folds 
WrongButton: checks 
*** FLOP *** [3c 8s Ah]
WrongButton: checks 
darren1031: bets $6
WrongButton: folds 
Uncalled bet ($6) returned to darren1031
darren1031 collected $4.78 from pot
*** SUMMARY ***
Total pot $5 | Rake $0.22 
Board [3c 8s Ah]
Seat 2: nickreason17 folded before Flop (didn't bet)
Seat 4: matiko09 folded before Flop (didn't bet)
Seat 5: Spudly6 folded before Flop (didn't bet)
Seat 6: Yaaaazz (button) folded before Flop (didn't bet)
Seat 7: Monsthand (small blind) folded before Flop
Seat 8: WrongButton (big blind) folded on the Flop
Seat 9: darren1031 collected ($4.78)





PokerStars Hand #150121038630:  Hold'em No Limit ($1/$2 USD) - 2016/03/10 10:19:58 CET [2016/03/10 4:19:58 ET]
Table 'Sophia II' 9-max Seat #4 is the button
Seat 1: thecurv ($255.58 in chips) 
Seat 2: Sang2015 ($224 in chips) 
Seat 3: maxxmeister ($200 in chips) 
Seat 4: hejun0713 ($187.36 in chips) 
Seat 5: matiko09 ($203 in chips) 
Seat 6: WrongButton ($209.83 in chips) 
Seat 7: Monsthand ($275.62 in chips) 
matiko09: posts small blind $1
WrongButton: posts big blind $2
BOAYARSKIY: sits out 
*** HOLE CARDS ***
Dealt to matiko09 [Qs Jh]
Monsthand: folds 
thecurv: folds 
Sang2015: raises $2 to $4
maxxmeister: folds 
hejun0713: folds 
matiko09: folds 
WrongButton: calls $2
*** FLOP *** [6d 2d 5s]
CARDNAPPED joins the table at seat #9 
WrongButton: checks 
Sang2015: bets $4
WrongButton: raises $11.12 to $15.12
Sang2015: calls $11.12
*** TURN *** [6d 2d 5s] [2h]
WrongButton: bets $22.10
Sang2015: raises $182.78 to $204.88 and is all-in
WrongButton: calls $168.61 and is all-in
Uncalled bet ($14.17) returned to Sang2015
*** RIVER *** [6d 2d 5s 2h] [Ad]
*** SHOW DOWN ***
WrongButton: shows [5h 5d] (a full house, Fives full of Deuces)
Sang2015: shows [6s Kh] (two pair, Sixes and Deuces)
WrongButton collected $417.86 from pot
*** SUMMARY ***
Total pot $420.66 | Rake $2.80 
Board [6d 2d 5s 2h Ad]
Seat 1: thecurv folded before Flop (didn't bet)
Seat 2: Sang2015 showed [6s Kh] and lost with two pair, Sixes and Deuces
Seat 3: maxxmeister folded before Flop (didn't bet)
Seat 4: hejun0713 (button) folded before Flop (didn't bet)
Seat 5: matiko09 (small blind) folded before Flop
Seat 6: WrongButton (big blind) showed [5h 5d] and won ($417.86) with a full house, Fives full of Deuces
Seat 7: Monsthand folded before Flop (didn't bet)





PokerStars Hand #150121043859:  Hold'em No Limit ($0.25/$0.50 USD) - 2016/03/10 10:20:12 CET [2016/03/10 4:20:12 ET]
Table 'Aegina' 9-max Seat #7 is the button
Seat 1: Wess_1970 ($114.20 in chips) 
Seat 2: el.suertero ($139.57 in chips) 
Seat 3: matiko09 ($50 in chips) 
Seat 4: vlad11122007 ($64.96 in chips) 
Seat 5: depokerlord ($53.46 in chips) 
Seat 6: ardo888 ($145.97 in chips) 
Seat 7: Bohne0815 ($79.50 in chips) 
Seat 8: q3storm ($50 in chips) 
Seat 9: i L00K great ($50 in chips) 
q3storm: posts small blind $0.25
i L00K great: posts big blind $0.50
depokerlord: posts big blind $0.50
Wess_1970: posts the ante $0.10
el.suertero: posts the ante $0.10
matiko09: posts the ante $0.10
vlad11122007: posts the ante $0.10
depokerlord: posts the ante $0.10
ardo888: posts the ante $0.10
Bohne0815: posts the ante $0.10
q3storm: posts the ante $0.10
i L00K great: posts the ante $0.10
*** HOLE CARDS ***
Dealt to matiko09 [2c Qc]
Wess_1970: folds 
el.suertero: folds 
matiko09: folds 
vlad11122007: folds 
depokerlord: checks 
ardo888: raises $2 to $2.50
Bohne0815: folds 
q3storm: raises $4.25 to $6.75
i L00K great: folds 
depokerlord: folds 
ardo888: folds 
Uncalled bet ($4.25) returned to q3storm
q3storm collected $6.90 from pot
q3storm: doesn't show hand 
*** SUMMARY ***
Total pot $6.90 | Rake $0 
Seat 1: Wess_1970 folded before Flop (didn't bet)
Seat 2: el.suertero folded before Flop (didn't bet)
Seat 3: matiko09 folded before Flop (didn't bet)
Seat 4: vlad11122007 folded before Flop (didn't bet)
Seat 5: depokerlord folded before Flop
Seat 6: ardo888 folded before Flop
Seat 7: Bohne0815 (button) folded before Flop (didn't bet)
Seat 8: q3storm (small blind) collected ($6.90)
Seat 9: i L00K great (big blind) folded before Flop





PokerStars Hand #150121044485:  Hold'em No Limit ($0.50/$1.00 USD) - 2016/03/10 10:20:13 CET [2016/03/10 4:20:13 ET]
Table 'Liriope II' 9-max Seat #2 is the button
Seat 1: Bron By ($107.10 in chips) 
Seat 2: vano7777 ($212.14 in chips) 
Seat 3: azzad2007 ($114.70 in chips) 
Seat 4: matiko09 ($132.15 in chips) 
Seat 5: toprmaw ($253.48 in chips) 
Seat 6: Monsthand ($100 in chips) 
Seat 7: mycka86 ($137 in chips) 
azzad2007: posts small blind $0.50
matiko09: posts big blind $1
Sweden_Pound: sits out 
Bron By: posts the ante $0.20
vano7777: posts the ante $0.20
azzad2007: posts the ante $0.20
matiko09: posts the ante $0.20
toprmaw: posts the ante $0.20
Monsthand: posts the ante $0.20
mycka86: posts the ante $0.20
*** HOLE CARDS ***
Dealt to matiko09 [2c 6h]
toprmaw: raises $2 to $3
Monsthand: folds 
mycka86: folds 
Bron By: folds 
vano7777: folds 
azzad2007: folds 
matiko09: folds 
Uncalled bet ($2) returned to toprmaw
toprmaw collected $3.90 from pot
toprmaw: doesn't show hand 
*** SUMMARY ***
Total pot $3.90 | Rake $0 
Seat 1: Bron By folded before Flop (didn't bet)
Seat 2: vano7777 (button) folded before Flop (didn't bet)
Seat 3: azzad2007 (small blind) folded before Flop
Seat 4: matiko09 (big blind) folded before Flop
Seat 5: toprmaw collected ($3.90)
Seat 6: Monsthand folded before Flop (didn't bet)
Seat 7: mycka86 folded before Flop (didn't bet)





PokerStars Hand #150121046072:  Hold'em No Limit (€0.25/€0.50 EUR) - 2016/03/10 10:20:18 CET [2016/03/10 4:20:18 ET]
Table 'Algorab' 9-max Seat #7 is the button
Seat 3: dididi2000 (€35.01 in chips) 
Seat 6: Bron By (€50.75 in chips) 
Seat 7: matiko09 (€93.38 in chips) 
Seat 8: fudzi (€50.75 in chips) 
Seat 9: vlad11122007 (€50 in chips) 
fudzi: posts small blind €0.25
vlad11122007: posts big blind €0.50
nubpoker: sits out 
Butcher1848: sits out 
*** HOLE CARDS ***
Dealt to matiko09 [6s 5h]
dididi2000: raises €1 to €1.50
Bron By: folds 
matiko09: folds 
fudzi: folds 
vlad11122007: folds 
Uncalled bet (€1) returned to dididi2000
dididi2000 collected €1.25 from pot
dididi2000: doesn't show hand 
*** SUMMARY ***
Total pot €1.25 | Rake €0 
Seat 3: dididi2000 collected (€1.25)
Seat 6: Bron By folded before Flop (didn't bet)
Seat 7: matiko09 (button) folded before Flop (didn't bet)
Seat 8: fudzi (small blind) folded before Flop
Seat 9: vlad11122007 (big blind) folded before Flop





PokerStars Hand #150121050602:  Hold'em No Limit ($1/$2 USD) - 2016/03/10 10:20:30 CET [2016/03/10 4:20:30 ET]
Table 'Archid' 9-max Seat #9 is the button
Seat 1: AP3221 ($95.22 in chips) 
Seat 2: geiranger011 ($90.64 in chips) 
Seat 3: sarkat104 ($231.53 in chips) 
Seat 4: Monsthand ($211.37 in chips) 
Seat 5: toprmaw ($203 in chips) 
Seat 6: Yaaaazz ($643.49 in chips) 
Seat 7: maxxmeister ($200 in chips) 
Seat 8: matiko09 ($260.20 in chips) 
Seat 9: WrongButton ($220.29 in chips) 
AP3221: posts small blind $1
geiranger011: posts big blind $2
*** HOLE CARDS ***
Dealt to matiko09 [2s 4d]
sarkat104: folds 
Monsthand: folds 
toprmaw: folds 
Yaaaazz: folds 
maxxmeister: folds 
matiko09: folds 
WrongButton: folds 
AP3221: raises $3 to $5
geiranger011: folds 
Uncalled bet ($3) returned to AP3221
AP3221 collected $4 from pot
AP3221: doesn't show hand 
*** SUMMARY ***
Total pot $4 | Rake $0 
Seat 1: AP3221 (small blind) collected ($4)
Seat 2: geiranger011 (big blind) folded before Flop
Seat 3: sarkat104 folded before Flop (didn't bet)
Seat 4: Monsthand folded before Flop (didn't bet)
Seat 5: toprmaw folded before Flop (didn't bet)
Seat 6: Yaaaazz folded before Flop (didn't bet)
Seat 7: maxxmeister folded before Flop (didn't bet)
Seat 8: matiko09 folded before Flop (didn't bet)
Seat 9: WrongButton (button) folded before Flop (didn't bet)





PokerStars Hand #150121051789:  Hold'em No Limit ($0.50/$1.00 USD) - 2016/03/10 10:20:33 CET [2016/03/10 4:20:33 ET]
Table 'Liriope II' 9-max Seat #3 is the button
Seat 1: Bron By ($106.90 in chips) 
Seat 2: vano7777 ($211.94 in chips) 
Seat 3: azzad2007 ($114 in chips) 
Seat 4: matiko09 ($130.95 in chips) 
Seat 7: mycka86 ($136.80 in chips) 
matiko09: posts small blind $0.50
toprmaw: is sitting out 
Monsthand: is sitting out 
mycka86: posts big blind $1
Sweden_Pound: sits out 
Bron By: posts the ante $0.20
vano7777: posts the ante $0.20
azzad2007: posts the ante $0.20
matiko09: posts the ante $0.20
mycka86: posts the ante $0.20
*** HOLE CARDS ***
Dealt to matiko09 [9s 4s]
Bron By: folds 
vano7777: folds 
toprmaw leaves the table
azzad2007: folds 
Monsthand leaves the table
matiko09: folds 
Uncalled bet ($0.50) returned to mycka86
mycka86 collected $2 from pot
*** SUMMARY ***
Total pot $2 | Rake $0 
Seat 1: Bron By folded before Flop (didn't bet)
Seat 2: vano7777 folded before Flop (didn't bet)
Seat 3: azzad2007 (button) folded before Flop (didn't bet)
Seat 4: matiko09 (small blind) folded before Flop
Seat 7: mycka86 (big blind) collected ($2)





PokerStars Hand #150121053962:  Hold'em No Limit ($1/$2 USD) - 2016/03/10 10:20:39 CET [2016/03/10 4:20:39 ET]
Table 'Solstice II' 9-max Seat #9 is the button
Seat 1: Rycious ($96.92 in chips) 
Seat 3: vano7777 ($145.79 in chips) 
Seat 4: matiko09 ($200 in chips) 
Seat 5: toprmaw ($213.25 in chips) 
Seat 6: thecurv ($200 in chips) 
Seat 9: Monsthand ($200 in chips) 
Rycious: posts small blind $1
vano7777: posts big blind $2
*** HOLE CARDS ***
Dealt to matiko09 [5d Qc]
matiko09: folds 
toprmaw: folds 
thecurv: raises $3 to $5
Monsthand: folds 
Rycious: folds 
vano7777: folds 
Uncalled bet ($3) returned to thecurv
thecurv collected $5 from pot
thecurv: doesn't show hand 
*** SUMMARY ***
Total pot $5 | Rake $0 
Seat 1: Rycious (small blind) folded before Flop
Seat 3: vano7777 (big blind) folded before Flop
Seat 4: matiko09 folded before Flop (didn't bet)
Seat 5: toprmaw folded before Flop (didn't bet)
Seat 6: thecurv collected ($5)
Seat 9: Monsthand (button) folded before Flop (didn't bet)





PokerStars Hand #150121055876:  Hold'em No Limit ($0.50/$1.00 USD) - 2016/03/10 10:20:44 CET [2016/03/10 4:20:44 ET]
Table 'Nereid' 9-max Seat #9 is the button
Seat 1: matiko09 ($100 in chips) 
Seat 2: PHILLY_D_S ($100 in chips) 
Seat 3: mycka86 ($101.50 in chips) 
Seat 4: xiaoxiaoniao ($254.11 in chips) 
Seat 5: ilaviiitech ($100 in chips) 
Seat 6: thecurv ($100 in chips) 
Seat 7: Monsthand ($121.88 in chips) 
Seat 8: Rikti ($25.96 in chips) 
Seat 9: zxp12345 ($198.31 in chips) 
matiko09: posts small blind $0.50
PHILLY_D_S: posts big blind $1
*** HOLE CARDS ***
Dealt to matiko09 [Js 5s]
mycka86: folds 
xiaoxiaoniao: folds 
ilaviiitech: folds 
thecurv: raises $1.50 to $2.50
Monsthand: folds 
Rikti: folds 
zxp12345: calls $2.50
matiko09: folds 
PHILLY_D_S: folds 
*** FLOP *** [6h Qs Qc]
thecurv: checks 
zxp12345: bets $3.10
thecurv: folds 
Uncalled bet ($3.10) returned to zxp12345
zxp12345 collected $6.21 from pot
zxp12345: doesn't show hand 
*** SUMMARY ***
Total pot $6.50 | Rake $0.29 
Board [6h Qs Qc]
Seat 1: matiko09 (small blind) folded before Flop
Seat 2: PHILLY_D_S (big blind) folded before Flop
Seat 3: mycka86 folded before Flop (didn't bet)
Seat 4: xiaoxiaoniao folded before Flop (didn't bet)
Seat 5: ilaviiitech folded before Flop (didn't bet)
Seat 6: thecurv folded on the Flop
Seat 7: Monsthand folded before Flop (didn't bet)
Seat 8: Rikti folded before Flop (didn't bet)
Seat 9: zxp12345 (button) collected ($6.21)





PokerStars Hand #150121055649:  Hold'em No Limit ($0.50/$1.00 USD) - 2016/03/10 10:20:44 CET [2016/03/10 4:20:44 ET]
Table 'Liriope II' 9-max Seat #4 is the button
Seat 1: Bron By ($106.70 in chips) 
Seat 2: vano7777 ($211.74 in chips) 
Seat 3: azzad2007 ($113.80 in chips) 
Seat 4: matiko09 ($130.25 in chips) 
Seat 7: mycka86 ($138.10 in chips) 
Seat 8: Sweden_Pound ($250 in chips) 
mycka86: posts small blind $0.50
Sweden_Pound: posts big blind $1
Bron By: posts the ante $0.20
vano7777: posts the ante $0.20
azzad2007: posts the ante $0.20
matiko09: posts the ante $0.20
mycka86: posts the ante $0.20
Sweden_Pound: posts the ante $0.20
*** HOLE CARDS ***
Dealt to matiko09 [9d Kh]
Bron By: folds 
vano7777: folds 
azzad2007: raises $1.50 to $2.50
matiko09: folds 
Bron By leaves the table
mycka86: folds 
Sweden_Pound: raises $7.50 to $10
er13to joins the table at seat #9 
azzad2007: folds 
Uncalled bet ($7.50) returned to Sweden_Pound
Sweden_Pound collected $6.70 from pot
Sweden_Pound: doesn't show hand 
*** SUMMARY ***
Total pot $6.70 | Rake $0 
Seat 1: Bron By folded before Flop (didn't bet)
Seat 2: vano7777 folded before Flop (didn't bet)
Seat 3: azzad2007 folded before Flop
Seat 4: matiko09 (button) folded before Flop (didn't bet)
Seat 7: mycka86 (small blind) folded before Flop
Seat 8: Sweden_Pound (big blind) collected ($6.70)





PokerStars Hand #150121056610:  Hold'em No Limit ($1/$2 USD) - 2016/03/10 10:20:46 CET [2016/03/10 4:20:46 ET]
Table 'Tauris II' 9-max Seat #7 is the button
Seat 2: nickreason17 ($203 in chips) 
Seat 4: matiko09 ($379.86 in chips) 
Seat 5: Spudly6 ($164.52 in chips) 
Seat 6: Yaaaazz ($230.79 in chips) 
Seat 7: Monsthand ($222.85 in chips) 
Seat 8: WrongButton ($226.69 in chips) 
Seat 9: darren1031 ($185.78 in chips) 
WrongButton: posts small blind $1
darren1031: posts big blind $2
toprmaw: sits out 
BOAYARSKIY: sits out 
*** HOLE CARDS ***
Dealt to matiko09 [Qh Ts]
nickreason17: raises $4 to $6
matiko09: folds 
Spudly6: folds 
Yaaaazz: folds 
Monsthand: folds 
WrongButton: folds 
darren1031: folds 
Uncalled bet ($4) returned to nickreason17
nickreason17 collected $5 from pot
*** SUMMARY ***
Total pot $5 | Rake $0 
Seat 2: nickreason17 collected ($5)
Seat 4: matiko09 folded before Flop (didn't bet)
Seat 5: Spudly6 folded before Flop (didn't bet)
Seat 6: Yaaaazz folded before Flop (didn't bet)
Seat 7: Monsthand (button) folded before Flop (didn't bet)
Seat 8: WrongButton (small blind) folded before Flop
Seat 9: darren1031 (big blind) folded before Flop





PokerStars Hand #150121058923:  Hold'em No Limit ($0.25/$0.50 USD) - 2016/03/10 10:20:52 CET [2016/03/10 4:20:52 ET]
Table 'Aegina' 9-max Seat #8 is the button
Seat 1: Wess_1970 ($114.10 in chips) 
Seat 2: el.suertero ($139.47 in chips) 
Seat 3: matiko09 ($50 in chips) 
Seat 4: vlad11122007 ($64.86 in chips) 
Seat 5: depokerlord ($52.86 in chips) 
Seat 6: ardo888 ($143.37 in chips) 
Seat 7: Bohne0815 ($79.40 in chips) 
Seat 8: q3storm ($54.30 in chips) 
Seat 9: i L00K great ($50 in chips) 
i L00K great: posts small blind $0.25
Wess_1970: posts big blind $0.50
Wess_1970: posts the ante $0.10
el.suertero: posts the ante $0.10
matiko09: posts the ante $0.10
vlad11122007: posts the ante $0.10
depokerlord: posts the ante $0.10
ardo888: posts the ante $0.10
Bohne0815: posts the ante $0.10
q3storm: posts the ante $0.10
i L00K great: posts the ante $0.10
*** HOLE CARDS ***
Dealt to matiko09 [8s 2h]
el.suertero: folds 
matiko09: folds 
vlad11122007: folds 
depokerlord: calls $0.50
ardo888: folds 
Bohne0815: calls $0.50
q3storm: raises $2.25 to $2.75
i L00K great: folds 
Wess_1970: calls $2.25
depokerlord: calls $2.25
Bohne0815: calls $2.25
*** FLOP *** [Jd Jc Jh]
Wess_1970: bets $0.50
depokerlord: calls $0.50
Bohne0815: folds 
q3storm: calls $0.50
*** TURN *** [Jd Jc Jh] [Tc]
Wess_1970: bets $0.50
depokerlord: calls $0.50
q3storm: calls $0.50
*** RIVER *** [Jd Jc Jh Tc] [3h]
Wess_1970: bets $0.50
depokerlord: calls $0.50
q3storm: folds 
*** SHOW DOWN ***
Wess_1970: shows [Ac 4s] (three of a kind, Jacks)
depokerlord: shows [2c 2d] (a full house, Jacks full of Deuces)
depokerlord collected $15.42 from pot
*** SUMMARY ***
Total pot $16.15 | Rake $0.73 
Board [Jd Jc Jh Tc 3h]
Seat 1: Wess_1970 (big blind) showed [Ac 4s] and lost with three of a kind, Jacks
Seat 2: el.suertero folded before Flop (didn't bet)
Seat 3: matiko09 folded before Flop (didn't bet)
Seat 4: vlad11122007 folded before Flop (didn't bet)
Seat 5: depokerlord showed [2c 2d] and won ($15.42) with a full house, Jacks full of Deuces
Seat 6: ardo888 folded before Flop (didn't bet)
Seat 7: Bohne0815 folded on the Flop
Seat 8: q3storm (button) folded on the River
Seat 9: i L00K great (small blind) folded before Flop





PokerStars Hand #150121059688:  Hold'em No Limit ($1/$2 USD) - 2016/03/10 10:20:54 CET [2016/03/10 4:20:54 ET]
Table 'Solstice II' 9-max Seat #1 is the button
Seat 1: Rycious ($95.92 in chips) 
Seat 3: vano7777 ($143.79 in chips) 
Seat 4: matiko09 ($200 in chips) 
Seat 5: toprmaw ($213.25 in chips) 
Seat 6: thecurv ($203 in chips) 
Seat 9: Monsthand ($200 in chips) 
vano7777: posts small blind $1
matiko09: posts big blind $2
*** HOLE CARDS ***
Dealt to matiko09 [4c 5c]
toprmaw: folds 
thecurv: raises $3 to $5
Monsthand: folds 
Rycious: folds 
vano7777: folds 
matiko09: folds 
Uncalled bet ($3) returned to thecurv
thecurv collected $5 from pot
thecurv: doesn't show hand 
*** SUMMARY ***
Total pot $5 | Rake $0 
Seat 1: Rycious (button) folded before Flop (didn't bet)
Seat 3: vano7777 (small blind) folded before Flop
Seat 4: matiko09 (big blind) folded before Flop
Seat 5: toprmaw folded before Flop (didn't bet)
Seat 6: thecurv collected ($5)
Seat 9: Monsthand folded before Flop (didn't bet)





PokerStars Hand #150121062216:  Hold'em No Limit (€0.25/€0.50 EUR) - 2016/03/10 10:21:01 CET [2016/03/10 4:21:01 ET]
Table 'Algorab' 9-max Seat #8 is the button
Seat 1: nubpoker (€50 in chips) 
Seat 3: dididi2000 (€35.76 in chips) 
Seat 6: Bron By (€50.75 in chips) 
Seat 7: matiko09 (€93.38 in chips) 
Seat 8: fudzi (€50.50 in chips) 
Seat 9: vlad11122007 (€49.50 in chips) 
vlad11122007: posts small blind €0.25
nubpoker: posts big blind €0.50
Butcher1848: sits out 
*** HOLE CARDS ***
Dealt to matiko09 [8c Qd]
dididi2000: folds 
Bron By: folds 
matiko09: folds 
fudzi: folds 
vlad11122007: raises €1 to €1.50
nubpoker: calls €1
*** FLOP *** [7c 2s Ts]
vlad11122007: bets €1.94
nubpoker: calls €1.94
*** TURN *** [7c 2s Ts] [4c]
vlad11122007: bets €4.50
nubpoker: folds 
Uncalled bet (€4.50) returned to vlad11122007
vlad11122007 collected €6.57 from pot
vlad11122007: doesn't show hand 
*** SUMMARY ***
Total pot €6.88 | Rake €0.31 
Board [7c 2s Ts 4c]
Seat 1: nubpoker (big blind) folded on the Turn
Seat 3: dididi2000 folded before Flop (didn't bet)
Seat 6: Bron By folded before Flop (didn't bet)
Seat 7: matiko09 folded before Flop (didn't bet)
Seat 8: fudzi (button) folded before Flop (didn't bet)
Seat 9: vlad11122007 (small blind) collected (€6.57)





PokerStars Hand #150121062261:  Hold'em No Limit ($1/$2 USD) - 2016/03/10 10:21:01 CET [2016/03/10 4:21:01 ET]
Table 'Archid' 9-max Seat #1 is the button
Seat 1: AP3221 ($97.22 in chips) 
Seat 2: geiranger011 ($88.64 in chips) 
Seat 3: sarkat104 ($231.53 in chips) 
Seat 4: Monsthand ($211.37 in chips) 
Seat 5: toprmaw ($203 in chips) 
Seat 6: Yaaaazz ($643.49 in chips) 
Seat 7: maxxmeister ($200 in chips) 
Seat 8: matiko09 ($260.20 in chips) 
Seat 9: WrongButton ($220.29 in chips) 
geiranger011: posts small blind $1
sarkat104: posts big blind $2
*** HOLE CARDS ***
Dealt to matiko09 [2h 2d]
Monsthand: folds 
toprmaw: folds 
Yaaaazz: folds 
maxxmeister: folds 
matiko09: raises $4 to $6
WrongButton: folds 
AP3221: raises $6 to $12
geiranger011: folds 
sarkat104: folds 
matiko09: folds 
Uncalled bet ($6) returned to AP3221
AP3221 collected $15 from pot
AP3221: doesn't show hand 
*** SUMMARY ***
Total pot $15 | Rake $0 
Seat 1: AP3221 (button) collected ($15)
Seat 2: geiranger011 (small blind) folded before Flop
Seat 3: sarkat104 (big blind) folded before Flop
Seat 4: Monsthand folded before Flop (didn't bet)
Seat 5: toprmaw folded before Flop (didn't bet)
Seat 6: Yaaaazz folded before Flop (didn't bet)
Seat 7: maxxmeister folded before Flop (didn't bet)
Seat 8: matiko09 folded before Flop
Seat 9: WrongButton folded before Flop (didn't bet)





PokerStars Hand #150121062436:  Hold'em No Limit ($1/$2 USD) - 2016/03/10 10:21:02 CET [2016/03/10 4:21:02 ET]
Table 'Tauris II' 9-max Seat #8 is the button
Seat 1: toprmaw ($271.49 in chips) 
Seat 2: nickreason17 ($206 in chips) 
Seat 4: matiko09 ($379.86 in chips) 
Seat 5: Spudly6 ($164.52 in chips) 
Seat 6: Yaaaazz ($230.79 in chips) 
Seat 7: Monsthand ($222.85 in chips) 
Seat 8: WrongButton ($225.69 in chips) 
Seat 9: darren1031 ($183.78 in chips) 
darren1031: posts small blind $1
toprmaw: posts big blind $2
BOAYARSKIY: sits out 
*** HOLE CARDS ***
Dealt to matiko09 [Js 3c]
nickreason17: folds 
matiko09: folds 
Spudly6: folds 
Yaaaazz has timed out
Yaaaazz: folds 
Monsthand: raises $3 to $5
WrongButton: folds 
darren1031: folds 
toprmaw: folds 
Uncalled bet ($3) returned to Monsthand
Monsthand collected $5 from pot
Monsthand: doesn't show hand 
*** SUMMARY ***
Total pot $5 | Rake $0 
Seat 1: toprmaw (big blind) folded before Flop
Seat 2: nickreason17 folded before Flop (didn't bet)
Seat 4: matiko09 folded before Flop (didn't bet)
Seat 5: Spudly6 folded before Flop (didn't bet)
Seat 6: Yaaaazz folded before Flop (didn't bet)
Seat 7: Monsthand collected ($5)
Seat 8: WrongButton (button) folded before Flop (didn't bet)
Seat 9: darren1031 (small blind) folded before Flop





PokerStars Hand #150121063580:  Hold'em No Limit ($0.50/$1.00 USD) - 2016/03/10 10:21:05 CET [2016/03/10 4:21:05 ET]
Table 'Rarahu' 9-max Seat #9 is the button
Seat 1: matiko09 ($100 in chips) 
Seat 2: azzad2007 ($100 in chips) 
Seat 3: ka100pka527 ($42.56 in chips) 
Seat 4: vilo1070 ($112 in chips) 
Seat 5: blackw0lf_03 ($108.23 in chips) 
Seat 6: RMilPoker ($108.39 in chips) 
Seat 7: PHILLY_D_S ($146.72 in chips) 
Seat 8: Rikti ($97.28 in chips) 
Seat 9: Srz7v44 ($109.86 in chips) 
matiko09: posts small blind $0.50
azzad2007: posts big blind $1
*** HOLE CARDS ***
Dealt to matiko09 [8d Th]
ka100pka527: folds 
vilo1070: folds 
blackw0lf_03: raises $2 to $3
RMilPoker: calls $3
PHILLY_D_S: folds 
Rikti: folds 
Srz7v44: folds 
matiko09: folds 
azzad2007: calls $2
*** FLOP *** [Tc As Ah]
azzad2007: checks 
blackw0lf_03: checks 
RMilPoker: checks 
*** TURN *** [Tc As Ah] [7c]
azzad2007: checks 
blackw0lf_03: bets $13.79
RMilPoker: folds 
azzad2007: folds 
Uncalled bet ($13.79) returned to blackw0lf_03
blackw0lf_03 collected $9.07 from pot
blackw0lf_03: doesn't show hand 
*** SUMMARY ***
Total pot $9.50 | Rake $0.43 
Board [Tc As Ah 7c]
Seat 1: matiko09 (small blind) folded before Flop
Seat 2: azzad2007 (big blind) folded on the Turn
Seat 3: ka100pka527 folded before Flop (didn't bet)
Seat 4: vilo1070 folded before Flop (didn't bet)
Seat 5: blackw0lf_03 collected ($9.07)
Seat 6: RMilPoker folded on the Turn
Seat 7: PHILLY_D_S folded before Flop (didn't bet)
Seat 8: Rikti folded before Flop (didn't bet)
Seat 9: Srz7v44 (button) folded before Flop (didn't bet)





PokerStars Hand #150121063878:  Hold'em No Limit ($0.50/$1.00 USD) - 2016/03/10 10:21:06 CET [2016/03/10 4:21:06 ET]
Table 'Alsciaukat' 9-max Seat #9 is the button
Seat 1: Kelvin sai ($68.50 in chips) 
Seat 2: mycka86 ($100 in chips) 
Seat 3: blackw0lf_03 ($100 in chips) 
Seat 4: Rikti ($34.50 in chips) 
Seat 5: toprmaw ($111.92 in chips) 
Seat 7: Yaaaazz ($121.74 in chips) 
Seat 8: F1dgeT ($100 in chips) 
Seat 9: matiko09 ($105.88 in chips) 
Kelvin sai: posts small blind $0.50
mycka86: posts big blind $1
Sweden_Pound: sits out 
*** HOLE CARDS ***
Dealt to matiko09 [8s Qc]
blackw0lf_03: folds 
Rikti: folds 
toprmaw: folds 
Yaaaazz: folds 
F1dgeT: folds 
matiko09: folds 
Kelvin sai: folds 
Uncalled bet ($0.50) returned to mycka86
mycka86 collected $1 from pot
*** SUMMARY ***
Total pot $1 | Rake $0 
Seat 1: Kelvin sai (small blind) folded before Flop
Seat 2: mycka86 (big blind) collected ($1)
Seat 3: blackw0lf_03 folded before Flop (didn't bet)
Seat 4: Rikti folded before Flop (didn't bet)
Seat 5: toprmaw folded before Flop (didn't bet)
Seat 7: Yaaaazz folded before Flop (didn't bet)
Seat 8: F1dgeT folded before Flop (didn't bet)
Seat 9: matiko09 (button) folded before Flop (didn't bet)





PokerStars Hand #150121064831:  Hold'em No Limit ($1/$2 USD) - 2016/03/10 10:21:08 CET [2016/03/10 4:21:08 ET]
Table 'Solstice II' 9-max Seat #3 is the button
Seat 1: Rycious ($95.92 in chips) 
Seat 3: vano7777 ($142.79 in chips) 
Seat 4: matiko09 ($200 in chips) 
Seat 5: toprmaw ($213.25 in chips) 
Seat 6: thecurv ($206 in chips) 
Seat 9: Monsthand ($200 in chips) 
matiko09: posts small blind $1
toprmaw: posts big blind $2
*** HOLE CARDS ***
Dealt to matiko09 [Kd 7d]
thecurv: raises $3 to $5
Monsthand: folds 
Rycious: folds 
vano7777: raises $11 to $16
matiko09: folds 
toprmaw: folds 
thecurv: calls $11
*** FLOP *** [2d 5h 2h]
thecurv: checks 
vano7777: checks 
*** TURN *** [2d 5h 2h] [4d]
thecurv: checks 
vano7777: checks 
*** RIVER *** [2d 5h 2h 4d] [Qs]
thecurv: checks 
vano7777: checks 
*** SHOW DOWN ***
thecurv: shows [Tc Td] (two pair, Tens and Deuces)
vano7777: mucks hand 
thecurv collected $33.42 from pot
*** SUMMARY ***
Total pot $35 | Rake $1.58 
Board [2d 5h 2h 4d Qs]
Seat 1: Rycious folded before Flop (didn't bet)
Seat 3: vano7777 (button) mucked [Ah Kc]
Seat 4: matiko09 (small blind) folded before Flop
Seat 5: toprmaw (big blind) folded before Flop
Seat 6: thecurv showed [Tc Td] and won ($33.42) with two pair, Tens and Deuces
Seat 9: Monsthand folded before Flop (didn't bet)





PokerStars Hand #150121066980:  Hold'em No Limit ($1/$2 USD) - 2016/03/10 10:21:14 CET [2016/03/10 4:21:14 ET]
Table 'Vesta' 9-max Seat #2 is the button
Seat 1: nickreason17 ($200 in chips) 
Seat 2: Pernilla E A ($226.06 in chips) 
Seat 3: matiko09 ($201 in chips) 
Seat 4: Yaaaazz ($251.40 in chips) 
Seat 5: PHILLY_D_S ($313.71 in chips) 
Seat 6: djammusic ($560.69 in chips) 
Seat 7: Monsthand ($200 in chips) 
Seat 8: 13Ghosts ($265.47 in chips) 
Seat 9: lixiangli ($439.01 in chips) 
matiko09: posts small blind $1
Yaaaazz: posts big blind $2
*** HOLE CARDS ***
Dealt to matiko09 [Kc 3h]
PHILLY_D_S: folds 
djammusic: folds 
Monsthand: raises $4 to $6
13Ghosts: folds 
lixiangli: folds 
nickreason17: folds 
Pernilla E A: calls $6
13Ghosts said, "lix"
matiko09: folds 
lixiangli said, "?"
Yaaaazz: folds 
*** FLOP *** [5c 2d 4c]
13Ghosts said, "come play every day"
13Ghosts said, "here"
13Ghosts said, "for fun"
Monsthand: checks 
lixiangli said, "not every"
Pernilla E A: checks 
*** TURN *** [5c 2d 4c] [6h]
13Ghosts said, "why not"
Monsthand: checks 
Pernilla E A: checks 
*** RIVER *** [5c 2d 4c 6h] [5s]
Monsthand: checks 
13Ghosts said, "u play good"
lixiangli said, "i am work in company"
13Ghosts said, "ok"
Pernilla E A: checks 
*** SHOW DOWN ***
Monsthand: shows [9d Td] (a pair of Fives)
Pernilla E A: shows [Jc 9s] (a pair of Fives - Jack kicker)
Pernilla E A collected $14.32 from pot
*** SUMMARY ***
Total pot $15 | Rake $0.68 
Board [5c 2d 4c 6h 5s]
Seat 1: nickreason17 folded before Flop (didn't bet)
Seat 2: Pernilla E A (button) showed [Jc 9s] and won ($14.32) with a pair of Fives
Seat 3: matiko09 (small blind) folded before Flop
Seat 4: Yaaaazz (big blind) folded before Flop
Seat 5: PHILLY_D_S folded before Flop (didn't bet)
Seat 6: djammusic folded before Flop (didn't bet)
Seat 7: Monsthand showed [9d Td] and lost with a pair of Fives
Seat 8: 13Ghosts folded before Flop (didn't bet)
Seat 9: lixiangli folded before Flop (didn't bet)





PokerStars Hand #150121068553:  Hold'em No Limit ($1/$2 USD) - 2016/03/10 10:21:18 CET [2016/03/10 4:21:18 ET]
Table 'Sophia II' 9-max Seat #5 is the button
Seat 1: thecurv ($255.58 in chips) 
Seat 2: Sang2015 ($14.17 in chips) 
Seat 3: maxxmeister ($200 in chips) 
Seat 4: hejun0713 ($187.36 in chips) 
Seat 5: matiko09 ($202 in chips) 
Seat 6: WrongButton ($417.86 in chips) 
Seat 7: Monsthand ($275.62 in chips) 
WrongButton: posts small blind $1
Monsthand: posts big blind $2
BOAYARSKIY: sits out 
CARDNAPPED: sits out 
*** HOLE CARDS ***
Dealt to matiko09 [5c Kc]
thecurv: folds 
Sang2015: folds 
Sang2015 leaves the table
maxxmeister: raises $4 to $6
nickreason17 joins the table at seat #2 
hejun0713: folds 
matiko09: folds 
WrongButton: folds 
Monsthand: folds 
Uncalled bet ($4) returned to maxxmeister
maxxmeister collected $5 from pot
maxxmeister: doesn't show hand 
*** SUMMARY ***
Total pot $5 | Rake $0 
Seat 1: thecurv folded before Flop (didn't bet)
Seat 2: Sang2015 folded before Flop (didn't bet)
Seat 3: maxxmeister collected ($5)
Seat 4: hejun0713 folded before Flop (didn't bet)
Seat 5: matiko09 (button) folded before Flop (didn't bet)
Seat 6: WrongButton (small blind) folded before Flop
Seat 7: Monsthand (big blind) folded before Flop





PokerStars Hand #150121068963:  Hold'em No Limit ($0.50/$1.00 USD) - 2016/03/10 10:21:19 CET [2016/03/10 4:21:19 ET]
Table 'Saskia' 9-max Seat #6 is the button
Seat 1: matiko09 ($111 in chips) 
Seat 2: nickreason17 ($103.21 in chips) 
Seat 3: Monsthand ($104.70 in chips) 
Seat 4: blackw0lf_03 ($109.48 in chips) 
Seat 6: kenheung ($123.04 in chips) 
Seat 7: AlKatrone ($138.43 in chips) 
Seat 8: DIMAN_324 ($100 in chips) 
Seat 9: mycka86 ($116.97 in chips) 
AlKatrone: posts small blind $0.50
DIMAN_324: posts big blind $1
*** HOLE CARDS ***
Dealt to matiko09 [Jc Qh]
mycka86: folds 
matiko09: folds 
nickreason17: raises $2 to $3
Monsthand: folds 
blackw0lf_03: folds 
kenheung: calls $3
AlKatrone: calls $2.50
DIMAN_324: folds 
*** FLOP *** [8h 7d Tc]
Rikti leaves the table
toprmaw joins the table at seat #5 
AlKatrone: checks 
toprmaw leaves the table
nickreason17: checks 
kenheung: bets $5
AlKatrone: folds 
nickreason17: folds 
Uncalled bet ($5) returned to kenheung
Prettyspitz joins the table at seat #5 
kenheung collected $9.55 from pot
kenheung: doesn't show hand 
*** SUMMARY ***
Total pot $10 | Rake $0.45 
Board [8h 7d Tc]
Seat 1: matiko09 folded before Flop (didn't bet)
Seat 2: nickreason17 folded on the Flop
Seat 3: Monsthand folded before Flop (didn't bet)
Seat 4: blackw0lf_03 folded before Flop (didn't bet)
Seat 6: kenheung (button) collected ($9.55)
Seat 7: AlKatrone (small blind) folded on the Flop
Seat 8: DIMAN_324 (big blind) folded before Flop
Seat 9: mycka86 folded before Flop (didn't bet)





PokerStars Hand #150121070481:  Hold'em No Limit ($0.50/$1.00 USD) - 2016/03/10 10:21:24 CET [2016/03/10 4:21:24 ET]
Table 'Nereid' 9-max Seat #1 is the button
Seat 1: matiko09 ($100 in chips) 
Seat 2: PHILLY_D_S ($100 in chips) 
Seat 3: mycka86 ($101.50 in chips) 
Seat 4: xiaoxiaoniao ($254.11 in chips) 
Seat 5: ilaviiitech ($100 in chips) 
Seat 6: thecurv ($100 in chips) 
Seat 7: Monsthand ($121.88 in chips) 
Seat 8: Rikti ($25.96 in chips) 
Seat 9: zxp12345 ($202.02 in chips) 
PHILLY_D_S: posts small blind $0.50
mycka86: posts big blind $1
*** HOLE CARDS ***
Dealt to matiko09 [5c 7s]
xiaoxiaoniao: raises $1 to $2
ilaviiitech: folds 
thecurv: calls $2
Monsthand: raises $8 to $10
Rikti: folds 
zxp12345: folds 
matiko09: folds 
PHILLY_D_S: folds 
mycka86: folds 
xiaoxiaoniao: calls $8
thecurv: folds 
*** FLOP *** [Qs 2h 4c]
xiaoxiaoniao: checks 
Monsthand: bets $13.65
xiaoxiaoniao: folds 
Uncalled bet ($13.65) returned to Monsthand
Monsthand collected $22.44 from pot
Monsthand: doesn't show hand 
*** SUMMARY ***
Total pot $23.50 | Rake $1.06 
Board [Qs 2h 4c]
Seat 1: matiko09 (button) folded before Flop (didn't bet)
Seat 2: PHILLY_D_S (small blind) folded before Flop
Seat 3: mycka86 (big blind) folded before Flop
Seat 4: xiaoxiaoniao folded on the Flop
Seat 5: ilaviiitech folded before Flop (didn't bet)
Seat 6: thecurv folded before Flop
Seat 7: Monsthand collected ($22.44)
Seat 8: Rikti folded before Flop (didn't bet)
Seat 9: zxp12345 folded before Flop (didn't bet)





PokerStars Hand #150121070971:  Hold'em No Limit ($0.50/$1.00 USD) - 2016/03/10 10:21:25 CET [2016/03/10 4:21:25 ET]
Table 'Alsciaukat' 9-max Seat #1 is the button
Seat 1: Kelvin sai ($68 in chips) 
Seat 2: mycka86 ($100.50 in chips) 
Seat 3: blackw0lf_03 ($100 in chips) 
Seat 4: Rikti ($34.50 in chips) 
Seat 5: toprmaw ($111.92 in chips) 
Seat 7: Yaaaazz ($121.74 in chips) 
Seat 8: F1dgeT ($100 in chips) 
Seat 9: matiko09 ($105.88 in chips) 
mycka86: posts small blind $0.50
blackw0lf_03: posts big blind $1
Sweden_Pound: sits out 
*** HOLE CARDS ***
Dealt to matiko09 [4h 9c]
Rikti: folds 
toprmaw: folds 
Yaaaazz: raises $2 to $3
F1dgeT: folds 
matiko09: folds 
Kelvin sai: folds 
mycka86: folds 
blackw0lf_03: folds 
Uncalled bet ($2) returned to Yaaaazz
Yaaaazz collected $2.50 from pot
*** SUMMARY ***
Total pot $2.50 | Rake $0 
Seat 1: Kelvin sai (button) folded before Flop (didn't bet)
Seat 2: mycka86 (small blind) folded before Flop
Seat 3: blackw0lf_03 (big blind) folded before Flop
Seat 4: Rikti folded before Flop (didn't bet)
Seat 5: toprmaw folded before Flop (didn't bet)
Seat 7: Yaaaazz collected ($2.50)
Seat 8: F1dgeT folded before Flop (didn't bet)
Seat 9: matiko09 folded before Flop (didn't bet)





PokerStars Hand #150121074545:  Hold'em No Limit ($1/$2 USD) - 2016/03/10 10:21:34 CET [2016/03/10 4:21:34 ET]
Table 'Archid' 9-max Seat #2 is the button
Seat 1: AP3221 ($106.22 in chips) 
Seat 2: geiranger011 ($87.64 in chips) 
Seat 3: sarkat104 ($229.53 in chips) 
Seat 4: Monsthand ($211.37 in chips) 
Seat 5: toprmaw ($203 in chips) 
Seat 6: Yaaaazz ($643.49 in chips) 
Seat 7: maxxmeister ($200 in chips) 
Seat 8: matiko09 ($254.20 in chips) 
Seat 9: WrongButton ($220.29 in chips) 
sarkat104: posts small blind $1
Monsthand: posts big blind $2
*** HOLE CARDS ***
Dealt to matiko09 [7c 7h]
toprmaw: folds 
Yaaaazz: folds 
maxxmeister: folds 
matiko09: raises $4 to $6
WrongButton: folds 
AP3221: folds 
geiranger011: folds 
sarkat104: calls $5
Monsthand: folds 
*** FLOP *** [Ks 2c 5c]
sarkat104: checks 
matiko09: bets $8
sarkat104: calls $8
*** TURN *** [Ks 2c 5c] [2s]
sarkat104: checks 
matiko09: bets $10
sarkat104: raises $10 to $20
matiko09: folds 
Uncalled bet ($10) returned to sarkat104
sarkat104 collected $47.75 from pot
*** SUMMARY ***
Total pot $50 | Rake $2.25 
Board [Ks 2c 5c 2s]
Seat 1: AP3221 folded before Flop (didn't bet)
Seat 2: geiranger011 (button) folded before Flop (didn't bet)
Seat 3: sarkat104 (small blind) collected ($47.75)
Seat 4: Monsthand (big blind) folded before Flop
Seat 5: toprmaw folded before Flop (didn't bet)
Seat 6: Yaaaazz folded before Flop (didn't bet)
Seat 7: maxxmeister folded before Flop (didn't bet)
Seat 8: matiko09 folded on the Turn
Seat 9: WrongButton folded before Flop (didn't bet)





PokerStars Hand #150121079259:  Hold'em No Limit ($0.50/$1.00 USD) - 2016/03/10 10:21:47 CET [2016/03/10 4:21:47 ET]
Table 'Ymir II' 9-max Seat #1 is the button
Seat 1: nickreason17 ($100 in chips) 
Seat 2: toprmaw ($102.63 in chips) 
Seat 3: matiko09 ($100 in chips) 
Seat 4: blackw0lf_03 ($149.71 in chips) 
Seat 6: RMilPoker ($112.03 in chips) 
Seat 7: PHILLY_D_S ($164.20 in chips) 
Seat 8: Sweden_Pound ($100 in chips) 
Seat 9: Beni Ca$h ($121.49 in chips) 
toprmaw: posts small blind $0.50
matiko09: posts big blind $1
mycka86: sits out 
*** HOLE CARDS ***
Dealt to matiko09 [Kd 8h]
blackw0lf_03: folds 
RMilPoker: folds 
PHILLY_D_S: folds 
Sweden_Pound: raises $2 to $3
Beni Ca$h: folds 
nickreason17: folds 
toprmaw: folds 
matiko09: folds 
Uncalled bet ($2) returned to Sweden_Pound
Sweden_Pound collected $2.50 from pot
Sweden_Pound: doesn't show hand 
*** SUMMARY ***
Total pot $2.50 | Rake $0 
Seat 1: nickreason17 (button) folded before Flop (didn't bet)
Seat 2: toprmaw (small blind) folded before Flop
Seat 3: matiko09 (big blind) folded before Flop
Seat 4: blackw0lf_03 folded before Flop (didn't bet)
Seat 6: RMilPoker folded before Flop (didn't bet)
Seat 7: PHILLY_D_S folded before Flop (didn't bet)
Seat 8: Sweden_Pound collected ($2.50)
Seat 9: Beni Ca$h folded before Flop (didn't bet)





PokerStars Hand #150121080816:  Hold'em No Limit ($0.25/$0.50 USD) - 2016/03/10 10:21:51 CET [2016/03/10 4:21:51 ET]
Table 'Aegina' 9-max Seat #9 is the button
Seat 1: Wess_1970 ($109.75 in chips) 
Seat 2: el.suertero ($139.37 in chips) 
Seat 3: matiko09 ($50 in chips) 
Seat 4: vlad11122007 ($64.76 in chips) 
Seat 5: depokerlord ($63.93 in chips) 
Seat 6: ardo888 ($143.27 in chips) 
Seat 7: Bohne0815 ($76.55 in chips) 
Seat 8: q3storm ($50.45 in chips) 
Seat 9: i L00K great ($50 in chips) 
Wess_1970: posts small blind $0.25
el.suertero: posts big blind $0.50
Wess_1970: posts the ante $0.10
el.suertero: posts the ante $0.10
matiko09: posts the ante $0.10
vlad11122007: posts the ante $0.10
depokerlord: posts the ante $0.10
ardo888: posts the ante $0.10
Bohne0815: posts the ante $0.10
q3storm: posts the ante $0.10
i L00K great: posts the ante $0.10
*** HOLE CARDS ***
Dealt to matiko09 [4c 6h]
matiko09: folds 
vlad11122007: folds 
depokerlord: calls $0.50
ardo888: folds 
Bohne0815: folds 
q3storm: folds 
i L00K great: folds 
Wess_1970: calls $0.25
el.suertero: raises $2.50 to $3
depokerlord: calls $2.50
Wess_1970: folds 
*** FLOP *** [8s Kc 6d]
el.suertero: bets $3.88
depokerlord: calls $3.88
*** TURN *** [8s Kc 6d] [3c]
el.suertero: checks 
depokerlord: checks 
*** RIVER *** [8s Kc 6d 3c] [Qc]
el.suertero: checks 
depokerlord: checks 
*** SHOW DOWN ***
el.suertero: shows [Ah Qd] (a pair of Queens)
depokerlord: shows [Jd Ks] (a pair of Kings)
depokerlord collected $14.48 from pot
*** SUMMARY ***
Total pot $15.16 | Rake $0.68 
Board [8s Kc 6d 3c Qc]
Seat 1: Wess_1970 (small blind) folded before Flop
Seat 2: el.suertero (big blind) showed [Ah Qd] and lost with a pair of Queens
Seat 3: matiko09 folded before Flop (didn't bet)
Seat 4: vlad11122007 folded before Flop (didn't bet)
Seat 5: depokerlord showed [Jd Ks] and won ($14.48) with a pair of Kings
Seat 6: ardo888 folded before Flop (didn't bet)
Seat 7: Bohne0815 folded before Flop (didn't bet)
Seat 8: q3storm folded before Flop (didn't bet)
Seat 9: i L00K great (button) folded before Flop (didn't bet)





PokerStars Hand #150121081037:  Hold'em No Limit ($1/$2 USD) - 2016/03/10 10:21:52 CET [2016/03/10 4:21:52 ET]
Table 'Sophia II' 9-max Seat #6 is the button
Seat 1: thecurv ($255.58 in chips) 
Seat 3: maxxmeister ($203 in chips) 
Seat 4: hejun0713 ($187.36 in chips) 
Seat 5: matiko09 ($202 in chips) 
Seat 6: WrongButton ($416.86 in chips) 
Seat 7: Monsthand ($273.62 in chips) 
Seat 8: BOAYARSKIY ($80 in chips) 
Seat 9: CARDNAPPED ($80 in chips) 
Monsthand: posts small blind $1
BOAYARSKIY: posts big blind $2
CARDNAPPED: posts big blind $2
nickreason17: sits out 
*** HOLE CARDS ***
Dealt to matiko09 [6h Ad]
CARDNAPPED: checks 
thecurv: folds 
maxxmeister: folds 
hejun0713: folds 
matiko09: raises $6 to $8
WrongButton: folds 
Monsthand: folds 
BOAYARSKIY: folds 
CARDNAPPED: calls $6
*** FLOP *** [Qh 8d 6s]
CARDNAPPED: checks 
matiko09: checks 
*** TURN *** [Qh 8d 6s] [6d]
CARDNAPPED: bets $9.07
matiko09: calls $9.07
*** RIVER *** [Qh 8d 6s 6d] [4c]
CARDNAPPED: checks 
matiko09: bets $30
CARDNAPPED: folds 
Uncalled bet ($30) returned to matiko09
matiko09 collected $35.47 from pot
matiko09: doesn't show hand 
*** SUMMARY ***
Total pot $37.14 | Rake $1.67 
Board [Qh 8d 6s 6d 4c]
Seat 1: thecurv folded before Flop (didn't bet)
Seat 3: maxxmeister folded before Flop (didn't bet)
Seat 4: hejun0713 folded before Flop (didn't bet)
Seat 5: matiko09 collected ($35.47)
Seat 6: WrongButton (button) folded before Flop (didn't bet)
Seat 7: Monsthand (small blind) folded before Flop
Seat 8: BOAYARSKIY (big blind) folded before Flop
Seat 9: CARDNAPPED folded on the River





PokerStars Hand #150121081686:  Hold'em No Limit ($1/$2 USD) - 2016/03/10 10:21:53 CET [2016/03/10 4:21:53 ET]
Table 'Tauris II' 9-max Seat #9 is the button
Seat 1: toprmaw ($269.49 in chips) 
Seat 2: nickreason17 ($206 in chips) 
Seat 4: matiko09 ($379.86 in chips) 
Seat 5: Spudly6 ($164.52 in chips) 
Seat 6: Yaaaazz ($230.79 in chips) 
Seat 7: Monsthand ($225.85 in chips) 
Seat 8: WrongButton ($225.69 in chips) 
Seat 9: darren1031 ($182.78 in chips) 
toprmaw: posts small blind $1
nickreason17: posts big blind $2
BOAYARSKIY: sits out 
*** HOLE CARDS ***
Dealt to matiko09 [5s 2s]
matiko09: folds 
Spudly6: folds 
Yaaaazz: folds 
Monsthand: folds 
WrongButton: raises $4 to $6
darren1031: folds 
toprmaw: folds 
nickreason17: raises $14 to $20
WrongButton: folds 
Uncalled bet ($14) returned to nickreason17
nickreason17 collected $13 from pot
*** SUMMARY ***
Total pot $13 | Rake $0 
Seat 1: toprmaw (small blind) folded before Flop
Seat 2: nickreason17 (big blind) collected ($13)
Seat 4: matiko09 folded before Flop (didn't bet)
Seat 5: Spudly6 folded before Flop (didn't bet)
Seat 6: Yaaaazz folded before Flop (didn't bet)
Seat 7: Monsthand folded before Flop (didn't bet)
Seat 8: WrongButton folded before Flop
Seat 9: darren1031 (button) folded before Flop (didn't bet)





PokerStars Hand #150121082574:  Hold'em No Limit ($1/$2 USD) - 2016/03/10 10:21:56 CET [2016/03/10 4:21:56 ET]
Table 'Solstice II' 9-max Seat #4 is the button
Seat 1: Rycious ($95.92 in chips) 
Seat 3: vano7777 ($126.79 in chips) 
Seat 4: matiko09 ($200 in chips) 
Seat 5: toprmaw ($211.25 in chips) 
Seat 6: thecurv ($223.42 in chips) 
Seat 9: Monsthand ($200 in chips) 
toprmaw: posts small blind $1
thecurv: posts big blind $2
*** HOLE CARDS ***
Dealt to matiko09 [Kc Kd]
Monsthand: raises $3.40 to $5.40
Rycious: calls $5.40
vano7777: folds 
matiko09: raises $10.60 to $16
toprmaw: folds 
thecurv: folds 
Monsthand: folds 
Rycious: calls $10.60
*** FLOP *** [Qs 9s Th]
Rycious: bets $18
matiko09: calls $18
*** TURN *** [Qs 9s Th] [7s]
Rycious: bets $26
matiko09: raises $81.64 to $107.64
Rycious: calls $35.92 and is all-in
Uncalled bet ($45.72) returned to matiko09
*** RIVER *** [Qs 9s Th 7s] [5c]
*** SHOW DOWN ***
Rycious: shows [7h 9h] (two pair, Nines and Sevens)
matiko09: mucks hand 
Rycious collected $197.44 from pot
*** SUMMARY ***
Total pot $200.24 | Rake $2.80 
Board [Qs 9s Th 7s 5c]
Seat 1: Rycious showed [7h 9h] and won ($197.44) with two pair, Nines and Sevens
Seat 3: vano7777 folded before Flop (didn't bet)
Seat 4: matiko09 (button) mucked [Kc Kd]
Seat 5: toprmaw (small blind) folded before Flop
Seat 6: thecurv (big blind) folded before Flop
Seat 9: Monsthand folded before Flop





PokerStars Hand #150121089549:  Hold'em No Limit ($0.50/$1.00 USD) - 2016/03/10 10:22:14 CET [2016/03/10 4:22:14 ET]
Table 'Alsciaukat' 9-max Seat #2 is the button
Seat 1: Kelvin sai ($68 in chips) 
Seat 2: mycka86 ($100 in chips) 
Seat 3: blackw0lf_03 ($100 in chips) 
Seat 4: Rikti ($34.50 in chips) 
Seat 5: toprmaw ($111.92 in chips) 
Seat 7: Yaaaazz ($123.24 in chips) 
Seat 8: F1dgeT ($100 in chips) 
Seat 9: matiko09 ($105.88 in chips) 
blackw0lf_03: posts small blind $0.50
Rikti: posts big blind $1
Sweden_Pound: sits out 
*** HOLE CARDS ***
Dealt to matiko09 [Ah 7d]
toprmaw: folds 
Yaaaazz: raises $2 to $3
F1dgeT: folds 
matiko09: folds 
Kelvin sai: folds 
mycka86: raises $6.25 to $9.25
blackw0lf_03: folds 
Rikti: folds 
Yaaaazz: calls $6.25
*** FLOP *** [4h Jc 9d]
Yaaaazz: checks 
mycka86: bets $10.50
Yaaaazz: calls $10.50
*** TURN *** [4h Jc 9d] [Ks]
Yaaaazz: checks 
mycka86: checks 
*** RIVER *** [4h Jc 9d Ks] [8c]
Yaaaazz: bets $19.97
mycka86: folds 
Uncalled bet ($19.97) returned to Yaaaazz
Yaaaazz collected $39.16 from pot
*** SUMMARY ***
Total pot $41 | Rake $1.84 
Board [4h Jc 9d Ks 8c]
Seat 1: Kelvin sai folded before Flop (didn't bet)
Seat 2: mycka86 (button) folded on the River
Seat 3: blackw0lf_03 (small blind) folded before Flop
Seat 4: Rikti (big blind) folded before Flop
Seat 5: toprmaw folded before Flop (didn't bet)
Seat 7: Yaaaazz collected ($39.16)
Seat 8: F1dgeT folded before Flop (didn't bet)
Seat 9: matiko09 folded before Flop (didn't bet)





PokerStars Hand #150121089991:  Hold'em No Limit ($1/$2 USD) - 2016/03/10 10:22:16 CET [2016/03/10 4:22:16 ET]
Table 'Vesta' 9-max Seat #3 is the button
Seat 1: nickreason17 ($200 in chips) 
Seat 2: Pernilla E A ($234.38 in chips) 
Seat 3: matiko09 ($200 in chips) 
Seat 4: Yaaaazz ($249.40 in chips) 
Seat 6: djammusic ($560.69 in chips) 
Seat 7: Monsthand ($200 in chips) 
Seat 8: 13Ghosts ($265.47 in chips) 
Seat 9: lixiangli ($439.01 in chips) 
Yaaaazz: posts small blind $1
PHILLY_D_S: is sitting out 
djammusic: posts big blind $2
*** HOLE CARDS ***
Dealt to matiko09 [6c Js]
13Ghosts said, "thats better"
Monsthand: folds 
13Ghosts: folds 
lixiangli: folds 
nickreason17: folds 
lixiangli said, "yes"
lixiangli said, "it man"
Pernilla E A: calls $2
13Ghosts said, "how long u can save 5k HKD"
matiko09: folds 
lixiangli said, ":)"
Yaaaazz: calls $1
13Ghosts said, "one day cost at macu"
djammusic: checks 
*** FLOP *** [4d Ah 2s]
Yaaaazz: checks 
djammusic: checks 
Pernilla E A: bets $5.73
Yaaaazz: folds 
djammusic: folds 
Uncalled bet ($5.73) returned to Pernilla E A
Pernilla E A collected $5.73 from pot
*** SUMMARY ***
Total pot $6 | Rake $0.27 
Board [4d Ah 2s]
Seat 1: nickreason17 folded before Flop (didn't bet)
Seat 2: Pernilla E A collected ($5.73)
Seat 3: matiko09 (button) folded before Flop (didn't bet)
Seat 4: Yaaaazz (small blind) folded on the Flop
Seat 6: djammusic (big blind) folded on the Flop
Seat 7: Monsthand folded before Flop (didn't bet)
Seat 8: 13Ghosts folded before Flop (didn't bet)
Seat 9: lixiangli folded before Flop (didn't bet)





PokerStars Hand #150121091487:  Hold'em No Limit ($0.50/$1.00 USD) - 2016/03/10 10:22:20 CET [2016/03/10 4:22:20 ET]
Table 'Rarahu' 9-max Seat #1 is the button
Seat 1: matiko09 ($100 in chips) 
Seat 2: azzad2007 ($100 in chips) 
Seat 4: vilo1070 ($112 in chips) 
Seat 5: blackw0lf_03 ($114.30 in chips) 
Seat 6: RMilPoker ($105.39 in chips) 
Seat 7: PHILLY_D_S ($146.72 in chips) 
Seat 8: Rikti ($97.28 in chips) 
Seat 9: Srz7v44 ($109.86 in chips) 
azzad2007: posts small blind $0.50
ka100pka527: is sitting out 
vilo1070: posts big blind $1
*** HOLE CARDS ***
Dealt to matiko09 [8d Qc]
ka100pka527 leaves the table
BKA12 joins the table at seat #3 
blackw0lf_03: folds 
RMilPoker: raises $2 to $3
PHILLY_D_S: folds 
Rikti: folds 
Srz7v44: folds 
matiko09: folds 
azzad2007: folds 
vilo1070: folds 
Uncalled bet ($2) returned to RMilPoker
RMilPoker collected $2.50 from pot
RMilPoker: doesn't show hand 
*** SUMMARY ***
Total pot $2.50 | Rake $0 
Seat 1: matiko09 (button) folded before Flop (didn't bet)
Seat 2: azzad2007 (small blind) folded before Flop
Seat 4: vilo1070 (big blind) folded before Flop
Seat 5: blackw0lf_03 folded before Flop (didn't bet)
Seat 6: RMilPoker collected ($2.50)
Seat 7: PHILLY_D_S folded before Flop (didn't bet)
Seat 8: Rikti folded before Flop (didn't bet)
Seat 9: Srz7v44 folded before Flop (didn't bet)





PokerStars Hand #150121091904:  Hold'em No Limit ($0.50/$1.00 USD) - 2016/03/10 10:22:21 CET [2016/03/10 4:22:21 ET]
Table 'Ymir II' 9-max Seat #2 is the button
Seat 1: nickreason17 ($100 in chips) 
Seat 2: toprmaw ($102.13 in chips) 
Seat 3: matiko09 ($100 in chips) 
Seat 4: blackw0lf_03 ($149.71 in chips) 
Seat 6: RMilPoker ($112.03 in chips) 
Seat 7: PHILLY_D_S ($164.20 in chips) 
Seat 8: Sweden_Pound ($101.50 in chips) 
Seat 9: Beni Ca$h ($121.49 in chips) 
matiko09: posts small blind $0.50
blackw0lf_03: posts big blind $1
mycka86: sits out 
*** HOLE CARDS ***
Dealt to matiko09 [6c 3h]
RMilPoker: folds 
PHILLY_D_S: folds 
Sweden_Pound: folds 
Beni Ca$h: folds 
nickreason17: raises $1.50 to $2.50
toprmaw: folds 
matiko09: folds 
blackw0lf_03: folds 
Uncalled bet ($1.50) returned to nickreason17
nickreason17 collected $2.50 from pot
*** SUMMARY ***
Total pot $2.50 | Rake $0 
Seat 1: nickreason17 collected ($2.50)
Seat 2: toprmaw (button) folded before Flop (didn't bet)
Seat 3: matiko09 (small blind) folded before Flop
Seat 4: blackw0lf_03 (big blind) folded before Flop
Seat 6: RMilPoker folded before Flop (didn't bet)
Seat 7: PHILLY_D_S folded before Flop (didn't bet)
Seat 8: Sweden_Pound folded before Flop (didn't bet)
Seat 9: Beni Ca$h folded before Flop (didn't bet)





PokerStars Hand #150121095424:  Hold'em No Limit ($0.50/$1.00 USD) - 2016/03/10 10:22:30 CET [2016/03/10 4:22:30 ET]
Table 'Nereid' 9-max Seat #2 is the button
Seat 1: matiko09 ($100 in chips) 
Seat 2: PHILLY_D_S ($100 in chips) 
Seat 3: mycka86 ($100.50 in chips) 
Seat 4: xiaoxiaoniao ($244.11 in chips) 
Seat 5: ilaviiitech ($100 in chips) 
Seat 6: thecurv ($100 in chips) 
Seat 7: Monsthand ($134.32 in chips) 
Seat 8: Rikti ($25.96 in chips) 
Seat 9: zxp12345 ($202.02 in chips) 
mycka86: posts small blind $0.50
xiaoxiaoniao: posts big blind $1
*** HOLE CARDS ***
Dealt to matiko09 [2d Qs]
ilaviiitech: raises $2 to $3
thecurv: folds 
Monsthand: folds 
Rikti: folds 
zxp12345: folds 
matiko09: folds 
PHILLY_D_S: folds 
mycka86: folds 
xiaoxiaoniao: folds 
Uncalled bet ($2) returned to ilaviiitech
ilaviiitech collected $2.50 from pot
ilaviiitech: doesn't show hand 
*** SUMMARY ***
Total pot $2.50 | Rake $0 
Seat 1: matiko09 folded before Flop (didn't bet)
Seat 2: PHILLY_D_S (button) folded before Flop (didn't bet)
Seat 3: mycka86 (small blind) folded before Flop
Seat 4: xiaoxiaoniao (big blind) folded before Flop
Seat 5: ilaviiitech collected ($2.50)
Seat 6: thecurv folded before Flop (didn't bet)
Seat 7: Monsthand folded before Flop (didn't bet)
Seat 8: Rikti folded before Flop (didn't bet)
Seat 9: zxp12345 folded before Flop (didn't bet)





PokerStars Hand #150121097517:  Hold'em No Limit ($1/$2 USD) - 2016/03/10 10:22:36 CET [2016/03/10 4:22:36 ET]
Table 'Tauris II' 9-max Seat #1 is the button
Seat 1: toprmaw ($268.49 in chips) 
Seat 2: nickreason17 ($213 in chips) 
Seat 3: BOAYARSKIY ($80 in chips) 
Seat 4: matiko09 ($379.86 in chips) 
Seat 5: Spudly6 ($164.52 in chips) 
Seat 6: Yaaaazz ($230.79 in chips) 
Seat 7: Monsthand ($225.85 in chips) 
Seat 8: WrongButton ($219.69 in chips) 
Seat 9: darren1031 ($182.78 in chips) 
nickreason17: posts small blind $1
BOAYARSKIY: posts big blind $2
*** HOLE CARDS ***
Dealt to matiko09 [2s 7d]
matiko09: folds 
Spudly6: raises $2 to $4
Yaaaazz: folds 
Monsthand: folds 
WrongButton: folds 
darren1031: calls $4
toprmaw: folds 
nickreason17: calls $3
BOAYARSKIY: folds 
*** FLOP *** [7h Qh As]
nickreason17: checks 
Spudly6: checks 
darren1031: bets $6
nickreason17: folds 
Spudly6: folds 
Uncalled bet ($6) returned to darren1031
darren1031 collected $13.37 from pot
darren1031: doesn't show hand 
*** SUMMARY ***
Total pot $14 | Rake $0.63 
Board [7h Qh As]
Seat 1: toprmaw (button) folded before Flop (didn't bet)
Seat 2: nickreason17 (small blind) folded on the Flop
Seat 3: BOAYARSKIY (big blind) folded before Flop
Seat 4: matiko09 folded before Flop (didn't bet)
Seat 5: Spudly6 folded on the Flop
Seat 6: Yaaaazz folded before Flop (didn't bet)
Seat 7: Monsthand folded before Flop (didn't bet)
Seat 8: WrongButton folded before Flop (didn't bet)
Seat 9: darren1031 collected ($13.37)





PokerStars Hand #150121097947:  Hold'em No Limit (€0.25/€0.50 EUR) - 2016/03/10 10:22:37 CET [2016/03/10 4:22:37 ET]
Table 'Algorab' 9-max Seat #9 is the button
Seat 1: nubpoker (€50 in chips) 
Seat 3: dididi2000 (€35.76 in chips) 
Seat 6: Bron By (€50.75 in chips) 
Seat 7: matiko09 (€93.38 in chips) 
Seat 8: fudzi (€50.50 in chips) 
Seat 9: vlad11122007 (€52.63 in chips) 
nubpoker: posts small blind €0.25
dididi2000: posts big blind €0.50
Butcher1848: sits out 
*** HOLE CARDS ***
Dealt to matiko09 [Qh 9d]
Bron By: folds 
Bron By leaves the table
St.LaCoste joins the table at seat #6 
St.LaCoste leaves the table
q3storm joins the table at seat #6 
matiko09: folds 
fudzi: folds 
vlad11122007: raises €0.50 to €1
nubpoker: folds 
dididi2000: folds 
Uncalled bet (€0.50) returned to vlad11122007
vlad11122007 collected €1.25 from pot
vlad11122007: doesn't show hand 
*** SUMMARY ***
Total pot €1.25 | Rake €0 
Seat 1: nubpoker (small blind) folded before Flop
Seat 3: dididi2000 (big blind) folded before Flop
Seat 6: Bron By folded before Flop (didn't bet)
Seat 7: matiko09 folded before Flop (didn't bet)
Seat 8: fudzi folded before Flop (didn't bet)
Seat 9: vlad11122007 (button) collected (€1.25)





PokerStars Hand #150121103188:  Hold'em No Limit ($0.25/$0.50 USD) - 2016/03/10 10:22:51 CET [2016/03/10 4:22:51 ET]
Table 'Aegina' 9-max Seat #1 is the button
Seat 1: Wess_1970 ($109.15 in chips) 
Seat 2: el.suertero ($132.39 in chips) 
Seat 3: matiko09 ($50 in chips) 
Seat 4: vlad11122007 ($64.66 in chips) 
Seat 5: depokerlord ($71.43 in chips) 
Seat 6: ardo888 ($143.17 in chips) 
Seat 7: Bohne0815 ($76.45 in chips) 
Seat 8: q3storm ($50.35 in chips) 
Seat 9: i L00K great ($50 in chips) 
el.suertero: posts small blind $0.25
matiko09: posts big blind $0.50
Wess_1970: posts the ante $0.10
el.suertero: posts the ante $0.10
matiko09: posts the ante $0.10
vlad11122007: posts the ante $0.10
depokerlord: posts the ante $0.10
ardo888: posts the ante $0.10
Bohne0815: posts the ante $0.10
q3storm: posts the ante $0.10
i L00K great: posts the ante $0.10
*** HOLE CARDS ***
Dealt to matiko09 [Jd 4s]
vlad11122007: folds 
depokerlord: folds 
ardo888: folds 
Bohne0815: calls $0.50
q3storm: raises $2 to $2.50
i L00K great: calls $2.50
Wess_1970: folds 
el.suertero: folds 
matiko09: folds 
Bohne0815: calls $2
*** FLOP *** [3c 7s 9c]
Bohne0815: checks 
q3storm: checks 
i L00K great: bets $6.99
Bohne0815: folds 
q3storm: folds 
Uncalled bet ($6.99) returned to i L00K great
i L00K great collected $8.74 from pot
i L00K great: doesn't show hand 
*** SUMMARY ***
Total pot $9.15 | Rake $0.41 
Board [3c 7s 9c]
Seat 1: Wess_1970 (button) folded before Flop (didn't bet)
Seat 2: el.suertero (small blind) folded before Flop
Seat 3: matiko09 (big blind) folded before Flop
Seat 4: vlad11122007 folded before Flop (didn't bet)
Seat 5: depokerlord folded before Flop (didn't bet)
Seat 6: ardo888 folded before Flop (didn't bet)
Seat 7: Bohne0815 folded on the Flop
Seat 8: q3storm folded on the Flop
Seat 9: i L00K great collected ($8.74)





PokerStars Hand #150121104610:  Hold'em No Limit ($1/$2 USD) - 2016/03/10 10:22:55 CET [2016/03/10 4:22:55 ET]
Table 'Archid' 9-max Seat #3 is the button
Seat 1: AP3221 ($106.22 in chips) 
Seat 2: geiranger011 ($87.64 in chips) 
Seat 3: sarkat104 ($253.28 in chips) 
Seat 4: Monsthand ($209.37 in chips) 
Seat 5: toprmaw ($203 in chips) 
Seat 6: Yaaaazz ($643.49 in chips) 
Seat 7: maxxmeister ($200 in chips) 
Seat 8: matiko09 ($230.20 in chips) 
Seat 9: WrongButton ($220.29 in chips) 
Monsthand: posts small blind $1
toprmaw: posts big blind $2
*** HOLE CARDS ***
Dealt to matiko09 [Qh Tc]
Yaaaazz: folds 
maxxmeister: folds 
matiko09: folds 
WrongButton: folds 
AP3221: folds 
geiranger011: folds 
sarkat104: folds 
Monsthand: folds 
Uncalled bet ($1) returned to toprmaw
toprmaw collected $2 from pot
toprmaw: doesn't show hand 
*** SUMMARY ***
Total pot $2 | Rake $0 
Seat 1: AP3221 folded before Flop (didn't bet)
Seat 2: geiranger011 folded before Flop (didn't bet)
Seat 3: sarkat104 (button) folded before Flop (didn't bet)
Seat 4: Monsthand (small blind) folded before Flop
Seat 5: toprmaw (big blind) collected ($2)
Seat 6: Yaaaazz folded before Flop (didn't bet)
Seat 7: maxxmeister folded before Flop (didn't bet)
Seat 8: matiko09 folded before Flop (didn't bet)
Seat 9: WrongButton folded before Flop (didn't bet)





PokerStars Hand #150121108616:  Hold'em No Limit ($1/$2 USD) - 2016/03/10 10:23:05 CET [2016/03/10 4:23:05 ET]
Table 'Solstice II' 9-max Seat #5 is the button
Seat 1: Rycious ($197.44 in chips) 
Seat 3: vano7777 ($126.79 in chips) 
Seat 4: matiko09 ($200 in chips) 
Seat 5: toprmaw ($210.25 in chips) 
Seat 6: thecurv ($221.42 in chips) 
Seat 9: Monsthand ($200 in chips) 
thecurv: posts small blind $1
Monsthand: posts big blind $2
*** HOLE CARDS ***
Dealt to matiko09 [Ks 2s]
Rycious: folds 
vano7777: folds 
matiko09: folds 
toprmaw: folds 
thecurv: calls $1
Monsthand: checks 
*** FLOP *** [4d 7h 3h]
thecurv: checks 
Monsthand: checks 
*** TURN *** [4d 7h 3h] [Ac]
thecurv: checks 
Monsthand: checks 
*** RIVER *** [4d 7h 3h Ac] [8h]
thecurv: bets $3
Monsthand: folds 
Uncalled bet ($3) returned to thecurv
thecurv collected $3.82 from pot
thecurv: doesn't show hand 
*** SUMMARY ***
Total pot $4 | Rake $0.18 
Board [4d 7h 3h Ac 8h]
Seat 1: Rycious folded before Flop (didn't bet)
Seat 3: vano7777 folded before Flop (didn't bet)
Seat 4: matiko09 folded before Flop (didn't bet)
Seat 5: toprmaw (button) folded before Flop (didn't bet)
Seat 6: thecurv (small blind) collected ($3.82)
Seat 9: Monsthand (big blind) folded on the River





PokerStars Hand #150121111249:  Hold'em No Limit ($0.50/$1.00 USD) - 2016/03/10 10:23:12 CET [2016/03/10 4:23:12 ET]
Table 'Rarahu' 9-max Seat #2 is the button
Seat 1: matiko09 ($100 in chips) 
Seat 2: azzad2007 ($100 in chips) 
Seat 4: vilo1070 ($111 in chips) 
Seat 5: blackw0lf_03 ($114.30 in chips) 
Seat 6: RMilPoker ($106.89 in chips) 
Seat 7: PHILLY_D_S ($146.72 in chips) 
Seat 8: Rikti ($97.28 in chips) 
Seat 9: Srz7v44 ($109.86 in chips) 
BKA12 will be allowed to play after the button
vilo1070: posts small blind $0.50
blackw0lf_03: posts big blind $1
*** HOLE CARDS ***
Dealt to matiko09 [7h Jd]
RMilPoker: folds 
PHILLY_D_S: folds 
Rikti: folds 
Srz7v44: folds 
matiko09: folds 
azzad2007: folds 
vilo1070: folds 
Uncalled bet ($0.50) returned to blackw0lf_03
blackw0lf_03 collected $1 from pot
blackw0lf_03: doesn't show hand 
*** SUMMARY ***
Total pot $1 | Rake $0 
Seat 1: matiko09 folded before Flop (didn't bet)
Seat 2: azzad2007 (button) folded before Flop (didn't bet)
Seat 4: vilo1070 (small blind) folded before Flop
Seat 5: blackw0lf_03 (big blind) collected ($1)
Seat 6: RMilPoker folded before Flop (didn't bet)
Seat 7: PHILLY_D_S folded before Flop (didn't bet)
Seat 8: Rikti folded before Flop (didn't bet)
Seat 9: Srz7v44 folded before Flop (didn't bet)





PokerStars Hand #150121113904:  Hold'em No Limit ($0.50/$1.00 USD) - 2016/03/10 10:23:19 CET [2016/03/10 4:23:19 ET]
Table 'Ymir II' 9-max Seat #3 is the button
Seat 1: nickreason17 ($101.50 in chips) 
Seat 2: toprmaw ($102.13 in chips) 
Seat 3: matiko09 ($100 in chips) 
Seat 4: blackw0lf_03 ($148.71 in chips) 
Seat 5: mycka86 ($100 in chips) 
Seat 6: RMilPoker ($112.03 in chips) 
Seat 7: PHILLY_D_S ($164.20 in chips) 
Seat 8: Sweden_Pound ($101.50 in chips) 
Seat 9: Beni Ca$h ($121.49 in chips) 
blackw0lf_03: posts small blind $0.50
mycka86: posts big blind $1
*** HOLE CARDS ***
Dealt to matiko09 [Jc 9d]
RMilPoker: folds 
PHILLY_D_S: folds 
Sweden_Pound: raises $2 to $3
Beni Ca$h: folds 
nickreason17: folds 
toprmaw: folds 
matiko09: folds 
blackw0lf_03: raises $7 to $10
mycka86: folds 
Sweden_Pound: folds 
Uncalled bet ($7) returned to blackw0lf_03
blackw0lf_03 collected $7 from pot
*** SUMMARY ***
Total pot $7 | Rake $0 
Seat 1: nickreason17 folded before Flop (didn't bet)
Seat 2: toprmaw folded before Flop (didn't bet)
Seat 3: matiko09 (button) folded before Flop (didn't bet)
Seat 4: blackw0lf_03 (small blind) collected ($7)
Seat 5: mycka86 (big blind) folded before Flop
Seat 6: RMilPoker folded before Flop (didn't bet)
Seat 7: PHILLY_D_S folded before Flop (didn't bet)
Seat 8: Sweden_Pound folded before Flop
Seat 9: Beni Ca$h folded before Flop (didn't bet)





PokerStars Hand #150121116385:  Hold'em No Limit ($0.50/$1.00 USD) - 2016/03/10 10:23:26 CET [2016/03/10 4:23:26 ET]
Table 'Nereid' 9-max Seat #3 is the button
Seat 1: matiko09 ($100 in chips) 
Seat 2: PHILLY_D_S ($100 in chips) 
Seat 3: mycka86 ($100 in chips) 
Seat 4: xiaoxiaoniao ($243.11 in chips) 
Seat 5: ilaviiitech ($101.50 in chips) 
Seat 6: thecurv ($100 in chips) 
Seat 7: Monsthand ($134.32 in chips) 
Seat 8: Rikti ($25.96 in chips) 
Seat 9: zxp12345 ($202.02 in chips) 
xiaoxiaoniao: posts small blind $0.50
ilaviiitech: posts big blind $1
*** HOLE CARDS ***
Dealt to matiko09 [4s Kc]
thecurv: folds 
Monsthand: folds 
Rikti: folds 
zxp12345: folds 
matiko09: folds 
PHILLY_D_S: folds 
mycka86: folds 
xiaoxiaoniao: folds 
Uncalled bet ($0.50) returned to ilaviiitech
ilaviiitech collected $1 from pot
ilaviiitech: doesn't show hand 
*** SUMMARY ***
Total pot $1 | Rake $0 
Seat 1: matiko09 folded before Flop (didn't bet)
Seat 2: PHILLY_D_S folded before Flop (didn't bet)
Seat 3: mycka86 (button) folded before Flop (didn't bet)
Seat 4: xiaoxiaoniao (small blind) folded before Flop
Seat 5: ilaviiitech (big blind) collected ($1)
Seat 6: thecurv folded before Flop (didn't bet)
Seat 7: Monsthand folded before Flop (didn't bet)
Seat 8: Rikti folded before Flop (didn't bet)
Seat 9: zxp12345 folded before Flop (didn't bet)





PokerStars Hand #150121116547:  Hold'em No Limit ($1/$2 USD) - 2016/03/10 10:23:26 CET [2016/03/10 4:23:26 ET]
Table 'Archid' 9-max Seat #4 is the button
Seat 1: AP3221 ($106.22 in chips) 
Seat 2: geiranger011 ($87.64 in chips) 
Seat 3: sarkat104 ($253.28 in chips) 
Seat 4: Monsthand ($208.37 in chips) 
Seat 5: toprmaw ($204 in chips) 
Seat 7: maxxmeister ($200 in chips) 
Seat 8: matiko09 ($230.20 in chips) 
Seat 9: WrongButton ($220.29 in chips) 
toprmaw: posts small blind $1
Yaaaazz: is sitting out 
maxxmeister: posts big blind $2
*** HOLE CARDS ***
Dealt to matiko09 [5c Qd]
matiko09: folds 
WrongButton: folds 
Yaaaazz leaves the table
BOAYARSKIY joins the table at seat #6 
AP3221: raises $3 to $5
geiranger011: folds 
sarkat104: folds 
Monsthand: folds 
toprmaw: folds 
maxxmeister: folds 
Uncalled bet ($3) returned to AP3221
AP3221 collected $5 from pot
AP3221: doesn't show hand 
*** SUMMARY ***
Total pot $5 | Rake $0 
Seat 1: AP3221 collected ($5)
Seat 2: geiranger011 folded before Flop (didn't bet)
Seat 3: sarkat104 folded before Flop (didn't bet)
Seat 4: Monsthand (button) folded before Flop (didn't bet)
Seat 5: toprmaw (small blind) folded before Flop
Seat 7: maxxmeister (big blind) folded before Flop
Seat 8: matiko09 folded before Flop (didn't bet)
Seat 9: WrongButton folded before Flop (didn't bet)





PokerStars Hand #150121116293:  Hold'em No Limit ($1/$2 USD) - 2016/03/10 10:23:26 CET [2016/03/10 4:23:26 ET]
Table 'Sophia II' 9-max Seat #7 is the button
Seat 1: thecurv ($255.58 in chips) 
Seat 3: maxxmeister ($203 in chips) 
Seat 4: hejun0713 ($187.36 in chips) 
Seat 5: matiko09 ($220.40 in chips) 
Seat 6: WrongButton ($416.86 in chips) 
Seat 7: Monsthand ($272.62 in chips) 
Seat 8: BOAYARSKIY ($78 in chips) 
Seat 9: CARDNAPPED ($62.93 in chips) 
BOAYARSKIY: posts small blind $1
CARDNAPPED: posts big blind $2
nickreason17: sits out 
*** HOLE CARDS ***
Dealt to matiko09 [Kh Qc]
thecurv: folds 
maxxmeister: folds 
hejun0713: folds 
matiko09: raises $4 to $6
WrongButton: folds 
Monsthand: folds 
BOAYARSKIY: folds 
CARDNAPPED: calls $4
*** FLOP *** [2d 3s 4c]
CARDNAPPED: checks 
matiko09: checks 
*** TURN *** [2d 3s 4c] [Tc]
CARDNAPPED: checks 
matiko09: checks 
*** RIVER *** [2d 3s 4c Tc] [Kc]
CARDNAPPED: bets $2
matiko09: raises $4 to $6
CARDNAPPED: folds 
Uncalled bet ($4) returned to matiko09
matiko09 collected $16.24 from pot
matiko09: doesn't show hand 
*** SUMMARY ***
Total pot $17 | Rake $0.76 
Board [2d 3s 4c Tc Kc]
Seat 1: thecurv folded before Flop (didn't bet)
Seat 3: maxxmeister folded before Flop (didn't bet)
Seat 4: hejun0713 folded before Flop (didn't bet)
Seat 5: matiko09 collected ($16.24)
Seat 6: WrongButton folded before Flop (didn't bet)
Seat 7: Monsthand (button) folded before Flop (didn't bet)
Seat 8: BOAYARSKIY (small blind) folded before Flop
Seat 9: CARDNAPPED (big blind) folded on the River





PokerStars Hand #150121117286:  Hold'em No Limit (€0.25/€0.50 EUR) - 2016/03/10 10:23:28 CET [2016/03/10 4:23:28 ET]
Table 'Algorab' 9-max Seat #1 is the button
Seat 1: nubpoker (€50 in chips) 
Seat 3: dididi2000 (€35.26 in chips) 
Seat 4: Butcher1848 (€50 in chips) 
Seat 7: matiko09 (€93.38 in chips) 
Seat 8: fudzi (€50.50 in chips) 
Seat 9: vlad11122007 (€53.38 in chips) 
dididi2000: posts small blind €0.25
Butcher1848: posts big blind €0.50
q3storm: sits out 
*** HOLE CARDS ***
Dealt to matiko09 [6h Jc]
matiko09: folds 
fudzi: folds 
vlad11122007: folds 
nubpoker: raises €0.75 to €1.25
dididi2000: calls €1
Butcher1848: folds 
*** FLOP *** [As Kd 7d]
dididi2000: checks 
nubpoker: bets €1.50
dididi2000: calls €1.50
*** TURN *** [As Kd 7d] [5d]
dididi2000: checks 
nubpoker: checks 
*** RIVER *** [As Kd 7d 5d] [3c]
dididi2000: bets €3
nubpoker: folds 
Uncalled bet (€3) returned to dididi2000
dididi2000 collected €5.73 from pot
dididi2000: doesn't show hand 
*** SUMMARY ***
Total pot €6 | Rake €0.27 
Board [As Kd 7d 5d 3c]
Seat 1: nubpoker (button) folded on the River
Seat 3: dididi2000 (small blind) collected (€5.73)
Seat 4: Butcher1848 (big blind) folded before Flop
Seat 7: matiko09 folded before Flop (didn't bet)
Seat 8: fudzi folded before Flop (didn't bet)
Seat 9: vlad11122007 folded before Flop (didn't bet)





PokerStars Hand #150121119479:  Hold'em No Limit ($1/$2 USD) - 2016/03/10 10:23:34 CET [2016/03/10 4:23:34 ET]
Table 'Vesta' 9-max Seat #4 is the button
Seat 1: nickreason17 ($200 in chips) 
Seat 2: Pernilla E A ($238.11 in chips) 
Seat 3: matiko09 ($200 in chips) 
Seat 4: Yaaaazz ($247.40 in chips) 
Seat 6: djammusic ($558.69 in chips) 
Seat 7: Monsthand ($200 in chips) 
Seat 8: 13Ghosts ($265.47 in chips) 
Seat 9: lixiangli ($439.01 in chips) 
djammusic: posts small blind $1
Monsthand: posts big blind $2
*** HOLE CARDS ***
Dealt to matiko09 [2h 9d]
13Ghosts said, "3 months ?"
lixiangli said, "maybe 1 or 10 day:D"
13Ghosts: folds 
lixiangli: folds 
nickreason17: raises $4 to $6
Pernilla E A: folds 
matiko09: folds 
Yaaaazz: folds 
djammusic: folds 
Monsthand: folds 
Uncalled bet ($4) returned to nickreason17
nickreason17 collected $5 from pot
lixiangli said, "some time easy money"
*** SUMMARY ***
Total pot $5 | Rake $0 
Seat 1: nickreason17 collected ($5)
Seat 2: Pernilla E A folded before Flop (didn't bet)
Seat 3: matiko09 folded before Flop (didn't bet)
Seat 4: Yaaaazz (button) folded before Flop (didn't bet)
Seat 6: djammusic (small blind) folded before Flop
Seat 7: Monsthand (big blind) folded before Flop
Seat 8: 13Ghosts folded before Flop (didn't bet)
Seat 9: lixiangli folded before Flop (didn't bet)





PokerStars Hand #150121119766:  Hold'em No Limit ($0.50/$1.00 USD) - 2016/03/10 10:23:35 CET [2016/03/10 4:23:35 ET]
Table 'Alsciaukat' 9-max Seat #3 is the button
Seat 1: Kelvin sai ($68 in chips) 
Seat 2: mycka86 ($100 in chips) 
Seat 3: blackw0lf_03 ($100 in chips) 
Seat 4: Rikti ($33.50 in chips) 
Seat 5: toprmaw ($111.92 in chips) 
Seat 7: Yaaaazz ($142.65 in chips) 
Seat 8: F1dgeT ($100 in chips) 
Seat 9: matiko09 ($105.88 in chips) 
Rikti: posts small blind $0.50
toprmaw: posts big blind $1
Sweden_Pound: sits out 
*** HOLE CARDS ***
Dealt to matiko09 [9c Ts]
Yaaaazz: folds 
F1dgeT: folds 
matiko09: folds 
Kelvin sai: folds 
mycka86: folds 
blackw0lf_03: folds 
Rikti: folds 
Uncalled bet ($0.50) returned to toprmaw
toprmaw collected $1 from pot
toprmaw: doesn't show hand 
*** SUMMARY ***
Total pot $1 | Rake $0 
Seat 1: Kelvin sai folded before Flop (didn't bet)
Seat 2: mycka86 folded before Flop (didn't bet)
Seat 3: blackw0lf_03 (button) folded before Flop (didn't bet)
Seat 4: Rikti (small blind) folded before Flop
Seat 5: toprmaw (big blind) collected ($1)
Seat 7: Yaaaazz folded before Flop (didn't bet)
Seat 8: F1dgeT folded before Flop (didn't bet)
Seat 9: matiko09 folded before Flop (didn't bet)





PokerStars Hand #150121121798:  Hold'em No Limit ($1/$2 USD) - 2016/03/10 10:23:40 CET [2016/03/10 4:23:40 ET]
Table 'Tauris II' 9-max Seat #2 is the button
Seat 1: toprmaw ($268.49 in chips) 
Seat 2: nickreason17 ($209 in chips) 
Seat 3: BOAYARSKIY ($78 in chips) 
Seat 4: matiko09 ($379.86 in chips) 
Seat 5: Spudly6 ($160.52 in chips) 
Seat 6: Yaaaazz ($230.79 in chips) 
Seat 7: Monsthand ($225.85 in chips) 
Seat 8: WrongButton ($219.69 in chips) 
Seat 9: darren1031 ($192.15 in chips) 
BOAYARSKIY: posts small blind $1
matiko09: posts big blind $2
*** HOLE CARDS ***
Dealt to matiko09 [Th Qs]
Spudly6: folds 
Yaaaazz: folds 
Monsthand: folds 
WrongButton: folds 
darren1031: folds 
toprmaw: folds 
nickreason17: raises $2.08 to $4.08
BOAYARSKIY: folds 
matiko09: calls $2.08
*** FLOP *** [Jc 8d 4d]
matiko09: checks 
nickreason17: bets $4.58
matiko09: folds 
Uncalled bet ($4.58) returned to nickreason17
nickreason17 collected $8.75 from pot
*** SUMMARY ***
Total pot $9.16 | Rake $0.41 
Board [Jc 8d 4d]
Seat 1: toprmaw folded before Flop (didn't bet)
Seat 2: nickreason17 (button) collected ($8.75)
Seat 3: BOAYARSKIY (small blind) folded before Flop
Seat 4: matiko09 (big blind) folded on the Flop
Seat 5: Spudly6 folded before Flop (didn't bet)
Seat 6: Yaaaazz folded before Flop (didn't bet)
Seat 7: Monsthand folded before Flop (didn't bet)
Seat 8: WrongButton folded before Flop (didn't bet)
Seat 9: darren1031 folded before Flop (didn't bet)





PokerStars Hand #150121123789:  Hold'em No Limit ($0.25/$0.50 USD) - 2016/03/10 10:23:46 CET [2016/03/10 4:23:46 ET]
Table 'Aegina' 9-max Seat #2 is the button
Seat 1: Wess_1970 ($109.05 in chips) 
Seat 2: el.suertero ($132.04 in chips) 
Seat 3: matiko09 ($50 in chips) 
Seat 5: depokerlord ($71.33 in chips) 
Seat 6: ardo888 ($143.07 in chips) 
Seat 7: Bohne0815 ($73.85 in chips) 
Seat 8: q3storm ($50 in chips) 
Seat 9: i L00K great ($56.14 in chips) 
matiko09: posts small blind $0.25
vlad11122007: is sitting out 
depokerlord: posts big blind $0.50
Wess_1970: posts the ante $0.10
el.suertero: posts the ante $0.10
matiko09: posts the ante $0.10
depokerlord: posts the ante $0.10
ardo888: posts the ante $0.10
Bohne0815: posts the ante $0.10
q3storm: posts the ante $0.10
i L00K great: posts the ante $0.10
*** HOLE CARDS ***
Dealt to matiko09 [9h 3d]
ardo888: raises $1.50 to $2
Bohne0815: folds 
q3storm: folds 
i L00K great: folds 
Wess_1970: folds 
el.suertero: folds 
matiko09: folds 
depokerlord: calls $1.50
*** FLOP *** [Td 9s 5s]
depokerlord: checks 
ardo888: bets $3.51
depokerlord: calls $3.51
*** TURN *** [Td 9s 5s] [9c]
depokerlord: checks 
ardo888: bets $8.41
depokerlord: folds 
Uncalled bet ($8.41) returned to ardo888
ardo888 collected $11.53 from pot
ardo888: doesn't show hand 
*** SUMMARY ***
Total pot $12.07 | Rake $0.54 
Board [Td 9s 5s 9c]
Seat 1: Wess_1970 folded before Flop (didn't bet)
Seat 2: el.suertero (button) folded before Flop (didn't bet)
Seat 3: matiko09 (small blind) folded before Flop
Seat 5: depokerlord (big blind) folded on the Turn
Seat 6: ardo888 collected ($11.53)
Seat 7: Bohne0815 folded before Flop (didn't bet)
Seat 8: q3storm folded before Flop (didn't bet)
Seat 9: i L00K great folded before Flop (didn't bet)





PokerStars Hand #150121124884:  Hold'em No Limit ($0.50/$1.00 USD) - 2016/03/10 10:23:49 CET [2016/03/10 4:23:49 ET]
Table 'Nereid' 9-max Seat #4 is the button
Seat 1: matiko09 ($100 in chips) 
Seat 2: PHILLY_D_S ($100 in chips) 
Seat 3: mycka86 ($100 in chips) 
Seat 4: xiaoxiaoniao ($242.61 in chips) 
Seat 5: ilaviiitech ($102 in chips) 
Seat 6: thecurv ($100 in chips) 
Seat 7: Monsthand ($134.32 in chips) 
Seat 8: Rikti ($25.96 in chips) 
Seat 9: zxp12345 ($202.02 in chips) 
ilaviiitech: posts small blind $0.50
thecurv: posts big blind $1
*** HOLE CARDS ***
Dealt to matiko09 [Jh 6s]
Monsthand: folds 
Rikti: folds 
zxp12345: calls $1
matiko09: folds 
PHILLY_D_S: raises $3 to $4
mycka86: folds 
xiaoxiaoniao: calls $4
ilaviiitech: folds 
thecurv: calls $3
zxp12345: calls $3
*** FLOP *** [Qh 3c 7c]
thecurv: bets $10.50
zxp12345: folds 
PHILLY_D_S: folds 
xiaoxiaoniao: folds 
Uncalled bet ($10.50) returned to thecurv
thecurv collected $15.76 from pot
thecurv: doesn't show hand 
*** SUMMARY ***
Total pot $16.50 | Rake $0.74 
Board [Qh 3c 7c]
Seat 1: matiko09 folded before Flop (didn't bet)
Seat 2: PHILLY_D_S folded on the Flop
Seat 3: mycka86 folded before Flop (didn't bet)
Seat 4: xiaoxiaoniao (button) folded on the Flop
Seat 5: ilaviiitech (small blind) folded before Flop
Seat 6: thecurv (big blind) collected ($15.76)
Seat 7: Monsthand folded before Flop (didn't bet)
Seat 8: Rikti folded before Flop (didn't bet)
Seat 9: zxp12345 folded on the Flop





PokerStars Hand #150121125880:  Hold'em No Limit ($0.50/$1.00 USD) - 2016/03/10 10:23:51 CET [2016/03/10 4:23:51 ET]
Table 'Rarahu' 9-max Seat #4 is the button
Seat 1: matiko09 ($100 in chips) 
Seat 2: azzad2007 ($100 in chips) 
Seat 3: BKA12 ($100 in chips) 
Seat 4: vilo1070 ($110.50 in chips) 
Seat 5: blackw0lf_03 ($114.80 in chips) 
Seat 6: RMilPoker ($106.89 in chips) 
Seat 7: PHILLY_D_S ($146.72 in chips) 
Seat 8: Rikti ($97.28 in chips) 
Seat 9: Srz7v44 ($109.86 in chips) 
blackw0lf_03: posts small blind $0.50
RMilPoker: posts big blind $1
BKA12: posts big blind $1
*** HOLE CARDS ***
Dealt to matiko09 [6s Js]
PHILLY_D_S: folds 
Rikti: folds 
Srz7v44: calls $1
matiko09: folds 
azzad2007: folds 
BKA12: checks 
vilo1070: folds 
blackw0lf_03: folds 
RMilPoker: checks 
*** FLOP *** [Kh Tc Ah]
RMilPoker: checks 
Srz7v44: bets $5
BKA12: folds 
RMilPoker: folds 
Uncalled bet ($5) returned to Srz7v44
Srz7v44 collected $3.34 from pot
*** SUMMARY ***
Total pot $3.50 | Rake $0.16 
Board [Kh Tc Ah]
Seat 1: matiko09 folded before Flop (didn't bet)
Seat 2: azzad2007 folded before Flop (didn't bet)
Seat 3: BKA12 folded on the Flop
Seat 4: vilo1070 (button) folded before Flop (didn't bet)
Seat 5: blackw0lf_03 (small blind) folded before Flop
Seat 6: RMilPoker (big blind) folded on the Flop
Seat 7: PHILLY_D_S folded before Flop (didn't bet)
Seat 8: Rikti folded before Flop (didn't bet)
Seat 9: Srz7v44 collected ($3.34)





PokerStars Hand #150121126699:  Hold'em No Limit ($1/$2 USD) - 2016/03/10 10:23:53 CET [2016/03/10 4:23:53 ET]
Table 'Solstice II' 9-max Seat #6 is the button
Seat 1: Rycious ($197.44 in chips) 
Seat 3: vano7777 ($200 in chips) 
Seat 4: matiko09 ($200 in chips) 
Seat 5: toprmaw ($210.25 in chips) 
Seat 6: thecurv ($223.24 in chips) 
Seat 9: Monsthand ($200 in chips) 
Monsthand: posts small blind $1
Rycious: posts big blind $2
*** HOLE CARDS ***
Dealt to matiko09 [7s Qh]
vano7777: folds 
matiko09: folds 
toprmaw: raises $3 to $5
thecurv: folds 
Monsthand: folds 
Rycious: folds 
Uncalled bet ($3) returned to toprmaw
toprmaw collected $5 from pot
toprmaw: doesn't show hand 
*** SUMMARY ***
Total pot $5 | Rake $0 
Seat 1: Rycious (big blind) folded before Flop
Seat 3: vano7777 folded before Flop (didn't bet)
Seat 4: matiko09 folded before Flop (didn't bet)
Seat 5: toprmaw collected ($5)
Seat 6: thecurv (button) folded before Flop (didn't bet)
Seat 9: Monsthand (small blind) folded before Flop





PokerStars Hand #150121129242:  Hold'em No Limit ($1/$2 USD) - 2016/03/10 10:24:00 CET [2016/03/10 4:24:00 ET]
Table 'Archid' 9-max Seat #5 is the button
Seat 1: AP3221 ($109.22 in chips) 
Seat 2: geiranger011 ($87.64 in chips) 
Seat 3: sarkat104 ($253.28 in chips) 
Seat 4: Monsthand ($208.37 in chips) 
Seat 5: toprmaw ($203 in chips) 
Seat 7: maxxmeister ($200 in chips) 
Seat 8: matiko09 ($230.20 in chips) 
Seat 9: WrongButton ($220.29 in chips) 
BOAYARSKIY will be allowed to play after the button
maxxmeister: posts small blind $1
matiko09: posts big blind $2
*** HOLE CARDS ***
Dealt to matiko09 [4s Jd]
WrongButton: raises $4 to $6
AP3221: folds 
geiranger011: folds 
sarkat104: calls $6
Monsthand: folds 
toprmaw: folds 
maxxmeister: folds 
matiko09: folds 
*** FLOP *** [6h 9c 4d]
WrongButton: checks 
sarkat104: bets $10
WrongButton: folds 
Uncalled bet ($10) returned to sarkat104
sarkat104 collected $14.32 from pot
*** SUMMARY ***
Total pot $15 | Rake $0.68 
Board [6h 9c 4d]
Seat 1: AP3221 folded before Flop (didn't bet)
Seat 2: geiranger011 folded before Flop (didn't bet)
Seat 3: sarkat104 collected ($14.32)
Seat 4: Monsthand folded before Flop (didn't bet)
Seat 5: toprmaw (button) folded before Flop (didn't bet)
Seat 7: maxxmeister (small blind) folded before Flop
Seat 8: matiko09 (big blind) folded before Flop
Seat 9: WrongButton folded on the Flop





PokerStars Hand #150121130156:  Hold'em No Limit ($1/$2 USD) - 2016/03/10 10:24:03 CET [2016/03/10 4:24:03 ET]
Table 'Vesta' 9-max Seat #6 is the button
Seat 1: nickreason17 ($203 in chips) 
Seat 2: Pernilla E A ($238.11 in chips) 
Seat 3: matiko09 ($200 in chips) 
Seat 4: Yaaaazz ($247.40 in chips) 
Seat 6: djammusic ($557.69 in chips) 
Seat 7: Monsthand ($200 in chips) 
Seat 8: 13Ghosts ($265.47 in chips) 
Seat 9: lixiangli ($439.01 in chips) 
Monsthand: posts small blind $1
13Ghosts said, "but u need to spend"
13Ghosts: posts big blind $2
*** HOLE CARDS ***
Dealt to matiko09 [Ks Th]
lixiangli: folds 
nickreason17: folds 
Pernilla E A: calls $2
matiko09: raises $6 to $8
13Ghosts said, "what kind of job u got"
lixiangli said, "it"
lixiangli said, "IT"
Yaaaazz: raises $16 to $24
djammusic: folds 
Monsthand: folds 
13Ghosts: raises $28 to $52
Pernilla E A: folds 
matiko09: folds 
Yaaaazz: folds 
Uncalled bet ($28) returned to 13Ghosts
13Ghosts collected $59 from pot
13Ghosts: doesn't show hand 
*** SUMMARY ***
Total pot $59 | Rake $0 
Seat 1: nickreason17 folded before Flop (didn't bet)
Seat 2: Pernilla E A folded before Flop
Seat 3: matiko09 folded before Flop
Seat 4: Yaaaazz folded before Flop
Seat 6: djammusic (button) folded before Flop (didn't bet)
Seat 7: Monsthand (small blind) folded before Flop
Seat 8: 13Ghosts (big blind) collected ($59)
Seat 9: lixiangli folded before Flop (didn't bet)





PokerStars Hand #150121131929:  Hold'em No Limit ($0.50/$1.00 USD) - 2016/03/10 10:24:08 CET [2016/03/10 4:24:08 ET]
Table 'Alsciaukat' 9-max Seat #4 is the button
Seat 1: Kelvin sai ($68 in chips) 
Seat 2: mycka86 ($100 in chips) 
Seat 3: blackw0lf_03 ($100 in chips) 
Seat 4: Rikti ($33 in chips) 
Seat 5: toprmaw ($112.42 in chips) 
Seat 6: Sweden_Pound ($100 in chips) 
Seat 7: Yaaaazz ($142.65 in chips) 
Seat 8: F1dgeT ($100 in chips) 
Seat 9: matiko09 ($105.88 in chips) 
toprmaw: posts small blind $0.50
Sweden_Pound: posts big blind $1
*** HOLE CARDS ***
Dealt to matiko09 [Jc Ts]
Yaaaazz: folds 
F1dgeT: folds 
matiko09: folds 
Kelvin sai: folds 
mycka86: raises $1.50 to $2.50
blackw0lf_03: folds 
Rikti: folds 
toprmaw: raises $6 to $8.50
Sweden_Pound: folds 
mycka86: folds 
Uncalled bet ($6) returned to toprmaw
toprmaw collected $6 from pot
toprmaw: doesn't show hand 
*** SUMMARY ***
Total pot $6 | Rake $0 
Seat 1: Kelvin sai folded before Flop (didn't bet)
Seat 2: mycka86 folded before Flop
Seat 3: blackw0lf_03 folded before Flop (didn't bet)
Seat 4: Rikti (button) folded before Flop (didn't bet)
Seat 5: toprmaw (small blind) collected ($6)
Seat 6: Sweden_Pound (big blind) folded before Flop
Seat 7: Yaaaazz folded before Flop (didn't bet)
Seat 8: F1dgeT folded before Flop (didn't bet)
Seat 9: matiko09 folded before Flop (didn't bet)





PokerStars Hand #150121139015:  Hold'em No Limit ($1/$2 USD) - 2016/03/10 10:24:27 CET [2016/03/10 4:24:27 ET]
Table 'Solstice II' 9-max Seat #9 is the button
Seat 1: Rycious ($195.44 in chips) 
Seat 3: vano7777 ($200 in chips) 
Seat 4: matiko09 ($200 in chips) 
Seat 5: toprmaw ($213.25 in chips) 
Seat 6: thecurv ($223.24 in chips) 
Seat 9: Monsthand ($200 in chips) 
Rycious: posts small blind $1
vano7777: posts big blind $2
*** HOLE CARDS ***
Dealt to matiko09 [3c 9s]
matiko09: folds 
toprmaw: folds 
thecurv: raises $3 to $5
Monsthand: folds 
Rycious: calls $4
vano7777: folds 
*** FLOP *** [3h Ac 4d]
Rycious: checks 
thecurv: checks 
*** TURN *** [3h Ac 4d] [7d]
Rycious: bets $4
thecurv: folds 
Uncalled bet ($4) returned to Rycious
Rycious collected $11.46 from pot
Rycious: doesn't show hand 
*** SUMMARY ***
Total pot $12 | Rake $0.54 
Board [3h Ac 4d 7d]
Seat 1: Rycious (small blind) collected ($11.46)
Seat 3: vano7777 (big blind) folded before Flop
Seat 4: matiko09 folded before Flop (didn't bet)
Seat 5: toprmaw folded before Flop (didn't bet)
Seat 6: thecurv folded on the Turn
Seat 9: Monsthand (button) folded before Flop (didn't bet)





PokerStars Hand #150121140284:  Hold'em No Limit ($0.50/$1.00 USD) - 2016/03/10 10:24:30 CET [2016/03/10 4:24:30 ET]
Table 'Ymir II' 9-max Seat #4 is the button
Seat 1: nickreason17 ($101.50 in chips) 
Seat 2: toprmaw ($102.13 in chips) 
Seat 3: matiko09 ($100 in chips) 
Seat 4: blackw0lf_03 ($152.71 in chips) 
Seat 5: mycka86 ($100 in chips) 
Seat 6: RMilPoker ($112.03 in chips) 
Seat 7: PHILLY_D_S ($164.20 in chips) 
Seat 8: Sweden_Pound ($100 in chips) 
Seat 9: Beni Ca$h ($121.49 in chips) 
mycka86: posts small blind $0.50
RMilPoker: posts big blind $1
*** HOLE CARDS ***
Dealt to matiko09 [Ah 9d]
PHILLY_D_S: folds 
Sweden_Pound: folds 
Beni Ca$h: folds 
nickreason17: folds 
toprmaw: folds 
matiko09: raises $1.50 to $2.50
blackw0lf_03: raises $5.50 to $8
mycka86: folds 
RMilPoker: folds 
matiko09: folds 
Uncalled bet ($5.50) returned to blackw0lf_03
blackw0lf_03 collected $6.50 from pot
blackw0lf_03: doesn't show hand 
*** SUMMARY ***
Total pot $6.50 | Rake $0 
Seat 1: nickreason17 folded before Flop (didn't bet)
Seat 2: toprmaw folded before Flop (didn't bet)
Seat 3: matiko09 folded before Flop
Seat 4: blackw0lf_03 (button) collected ($6.50)
Seat 5: mycka86 (small blind) folded before Flop
Seat 6: RMilPoker (big blind) folded before Flop
Seat 7: PHILLY_D_S folded before Flop (didn't bet)
Seat 8: Sweden_Pound folded before Flop (didn't bet)
Seat 9: Beni Ca$h folded before Flop (didn't bet)





PokerStars Hand #150121140575:  Hold'em No Limit ($1/$2 USD) - 2016/03/10 10:24:31 CET [2016/03/10 4:24:31 ET]
Table 'Tauris II' 9-max Seat #3 is the button
Seat 1: toprmaw ($268.49 in chips) 
Seat 2: nickreason17 ($213.67 in chips) 
Seat 3: BOAYARSKIY ($77 in chips) 
Seat 4: matiko09 ($375.78 in chips) 
Seat 5: Spudly6 ($160.52 in chips) 
Seat 6: Yaaaazz ($230.79 in chips) 
Seat 7: Monsthand ($225.85 in chips) 
Seat 8: WrongButton ($219.69 in chips) 
Seat 9: darren1031 ($192.15 in chips) 
matiko09: posts small blind $1
Spudly6: posts big blind $2
*** HOLE CARDS ***
Dealt to matiko09 [8s 7h]
Yaaaazz: folds 
Monsthand: folds 
WrongButton: folds 
darren1031: folds 
toprmaw: folds 
nickreason17: raises $3 to $5
BOAYARSKIY: folds 
matiko09: folds 
Spudly6: raises $11 to $16
nickreason17: folds 
Uncalled bet ($11) returned to Spudly6
Spudly6 collected $11 from pot
Spudly6: doesn't show hand 
*** SUMMARY ***
Total pot $11 | Rake $0 
Seat 1: toprmaw folded before Flop (didn't bet)
Seat 2: nickreason17 folded before Flop
Seat 3: BOAYARSKIY (button) folded before Flop (didn't bet)
Seat 4: matiko09 (small blind) folded before Flop
Seat 5: Spudly6 (big blind) collected ($11)
Seat 6: Yaaaazz folded before Flop (didn't bet)
Seat 7: Monsthand folded before Flop (didn't bet)
Seat 8: WrongButton folded before Flop (didn't bet)
Seat 9: darren1031 folded before Flop (didn't bet)





PokerStars Hand #150121141416:  Hold'em No Limit ($1/$2 USD) - 2016/03/10 10:24:33 CET [2016/03/10 4:24:33 ET]
Table 'Sophia II' 9-max Seat #8 is the button
Seat 2: nickreason17 ($215.71 in chips) 
Seat 3: maxxmeister ($203 in chips) 
Seat 4: hejun0713 ($187.36 in chips) 
Seat 5: matiko09 ($228.64 in chips) 
Seat 6: WrongButton ($416.86 in chips) 
Seat 7: Monsthand ($272.62 in chips) 
Seat 8: BOAYARSKIY ($77 in chips) 
Seat 9: CARDNAPPED ($54.93 in chips) 
CARDNAPPED: posts small blind $1
thecurv: is sitting out 
thecurv leaves the table
nickreason17: posts big blind $2
*** HOLE CARDS ***
Dealt to matiko09 [2h 6d]
toprmaw joins the table at seat #1 
maxxmeister: folds 
maxxmeister leaves the table
hejun0713: folds 
matiko09: folds 
WrongButton: raises $4 to $6
Monsthand: raises $12 to $18
BOAYARSKIY: folds 
CARDNAPPED: folds 
nickreason17: folds 
WrongButton: calls $12
*** FLOP *** [9s 2c Kd]
WrongButton: checks 
Monsthand: bets $20
WrongButton: calls $20
*** TURN *** [9s 2c Kd] [7s]
WrongButton: checks 
Monsthand: bets $51.50
WrongButton: folds 
Uncalled bet ($51.50) returned to Monsthand
Monsthand collected $76.20 from pot
Monsthand: doesn't show hand 
*** SUMMARY ***
Total pot $79 | Rake $2.80 
Board [9s 2c Kd 7s]
Seat 2: nickreason17 (big blind) folded before Flop
Seat 3: maxxmeister folded before Flop (didn't bet)
Seat 4: hejun0713 folded before Flop (didn't bet)
Seat 5: matiko09 folded before Flop (didn't bet)
Seat 6: WrongButton folded on the Turn
Seat 7: Monsthand collected ($76.20)
Seat 8: BOAYARSKIY (button) folded before Flop (didn't bet)
Seat 9: CARDNAPPED (small blind) folded before Flop





PokerStars Hand #150121145636:  Hold'em No Limit ($0.25/$0.50 USD) - 2016/03/10 10:24:45 CET [2016/03/10 4:24:45 ET]
Table 'Aegina' 9-max Seat #3 is the button
Seat 1: Wess_1970 ($108.95 in chips) 
Seat 2: el.suertero ($131.94 in chips) 
Seat 3: matiko09 ($50 in chips) 
Seat 5: depokerlord ($65.72 in chips) 
Seat 6: ardo888 ($148.99 in chips) 
Seat 7: Bohne0815 ($73.75 in chips) 
Seat 8: q3storm ($50 in chips) 
Seat 9: i L00K great ($56.04 in chips) 
depokerlord: posts small blind $0.25
ardo888: posts big blind $0.50
Wess_1970: posts the ante $0.10
el.suertero: posts the ante $0.10
matiko09: posts the ante $0.10
depokerlord: posts the ante $0.10
ardo888: posts the ante $0.10
Bohne0815: posts the ante $0.10
q3storm: posts the ante $0.10
i L00K great: posts the ante $0.10
*** HOLE CARDS ***
Dealt to matiko09 [3s 7s]
Bohne0815: folds 
q3storm: folds 
i L00K great: folds 
Wess_1970: calls $0.50
el.suertero: raises $1.50 to $2
matiko09: folds 
depokerlord: calls $1.75
ardo888: folds 
Wess_1970: calls $1.50
*** FLOP *** [Kc 9s 2h]
depokerlord: checks 
Wess_1970: checks 
el.suertero: bets $3.83
depokerlord: calls $3.83
Wess_1970: folds 
*** TURN *** [Kc 9s 2h] [2c]
depokerlord: checks 
el.suertero: checks 
*** RIVER *** [Kc 9s 2h 2c] [Jc]
depokerlord: checks 
el.suertero: checks 
*** SHOW DOWN ***
depokerlord: shows [As 2s] (three of a kind, Deuces)
el.suertero: mucks hand 
depokerlord collected $14.29 from pot
*** SUMMARY ***
Total pot $14.96 | Rake $0.67 
Board [Kc 9s 2h 2c Jc]
Seat 1: Wess_1970 folded on the Flop
Seat 2: el.suertero mucked [6c Ad]
Seat 3: matiko09 (button) folded before Flop (didn't bet)
Seat 5: depokerlord (small blind) showed [As 2s] and won ($14.29) with three of a kind, Deuces
Seat 6: ardo888 (big blind) folded before Flop
Seat 7: Bohne0815 folded before Flop (didn't bet)
Seat 8: q3storm folded before Flop (didn't bet)
Seat 9: i L00K great folded before Flop (didn't bet)





PokerStars Hand #150121146748:  Hold'em No Limit ($0.50/$1.00 USD) - 2016/03/10 10:24:48 CET [2016/03/10 4:24:48 ET]
Table 'Nereid' 9-max Seat #5 is the button
Seat 1: matiko09 ($100 in chips) 
Seat 2: PHILLY_D_S ($100 in chips) 
Seat 3: mycka86 ($100 in chips) 
Seat 4: xiaoxiaoniao ($238.61 in chips) 
Seat 5: ilaviiitech ($101.50 in chips) 
Seat 6: thecurv ($111.76 in chips) 
Seat 7: Monsthand ($134.32 in chips) 
Seat 8: Rikti ($25.96 in chips) 
Seat 9: zxp12345 ($198.02 in chips) 
thecurv: posts small blind $0.50
Monsthand: posts big blind $1
*** HOLE CARDS ***
Dealt to matiko09 [5h 6c]
Rikti: folds 
zxp12345: calls $1
matiko09: folds 
PHILLY_D_S: folds 
mycka86: raises $3.50 to $4.50
xiaoxiaoniao: folds 
ilaviiitech: folds 
thecurv: folds 
Monsthand: folds 
zxp12345: folds 
Uncalled bet ($3.50) returned to mycka86
mycka86 collected $3.50 from pot
*** SUMMARY ***
Total pot $3.50 | Rake $0 
Seat 1: matiko09 folded before Flop (didn't bet)
Seat 2: PHILLY_D_S folded before Flop (didn't bet)
Seat 3: mycka86 collected ($3.50)
Seat 4: xiaoxiaoniao folded before Flop (didn't bet)
Seat 5: ilaviiitech (button) folded before Flop (didn't bet)
Seat 6: thecurv (small blind) folded before Flop
Seat 7: Monsthand (big blind) folded before Flop
Seat 8: Rikti folded before Flop (didn't bet)
Seat 9: zxp12345 folded before Flop





PokerStars Hand #150121147168:  Hold'em No Limit ($0.50/$1.00 USD) - 2016/03/10 10:24:49 CET [2016/03/10 4:24:49 ET]
Table 'Rarahu' 9-max Seat #5 is the button
Seat 1: matiko09 ($100 in chips) 
Seat 2: azzad2007 ($100 in chips) 
Seat 3: BKA12 ($100 in chips) 
Seat 4: vilo1070 ($110.50 in chips) 
Seat 5: blackw0lf_03 ($114.30 in chips) 
Seat 6: RMilPoker ($105.89 in chips) 
Seat 8: Rikti ($97.28 in chips) 
Seat 9: Srz7v44 ($112.20 in chips) 
RMilPoker: posts small blind $0.50
PHILLY_D_S: is sitting out 
Rikti: posts big blind $1
*** HOLE CARDS ***
Dealt to matiko09 [8c 9d]
Srz7v44: folds 
matiko09: folds 
azzad2007: folds 
BKA12: raises $2 to $3
vilo1070: calls $3
blackw0lf_03: folds 
RMilPoker: folds 
Rikti: calls $2
*** FLOP *** [6c Ah 3h]
Rikti: checks 
BKA12: checks 
vilo1070: checks 
*** TURN *** [6c Ah 3h] [8h]
Rikti: checks 
BKA12: checks 
vilo1070: bets $6.04
Rikti: folds 
BKA12: folds 
Uncalled bet ($6.04) returned to vilo1070
vilo1070 collected $9.07 from pot
vilo1070: doesn't show hand 
*** SUMMARY ***
Total pot $9.50 | Rake $0.43 
Board [6c Ah 3h 8h]
Seat 1: matiko09 folded before Flop (didn't bet)
Seat 2: azzad2007 folded before Flop (didn't bet)
Seat 3: BKA12 folded on the Turn
Seat 4: vilo1070 collected ($9.07)
Seat 5: blackw0lf_03 (button) folded before Flop (didn't bet)
Seat 6: RMilPoker (small blind) folded before Flop
Seat 8: Rikti (big blind) folded on the Turn
Seat 9: Srz7v44 folded before Flop (didn't bet)





PokerStars Hand #150121147957:  Hold'em No Limit ($1/$2 USD) - 2016/03/10 10:24:51 CET [2016/03/10 4:24:51 ET]
Table 'Archid' 9-max Seat #7 is the button
Seat 1: AP3221 ($109.22 in chips) 
Seat 2: geiranger011 ($87.64 in chips) 
Seat 3: sarkat104 ($261.60 in chips) 
Seat 4: Monsthand ($208.37 in chips) 
Seat 5: toprmaw ($203 in chips) 
Seat 7: maxxmeister ($200 in chips) 
Seat 8: matiko09 ($228.20 in chips) 
Seat 9: WrongButton ($214.29 in chips) 
matiko09: posts small blind $1
WrongButton: posts big blind $2
BOAYARSKIY: sits out 
*** HOLE CARDS ***
Dealt to matiko09 [8c 6h]
AP3221: folds 
geiranger011: raises $3 to $5
sarkat104: folds 
Monsthand: folds 
toprmaw: folds 
maxxmeister: folds 
matiko09: folds 
WrongButton: folds 
Uncalled bet ($3) returned to geiranger011
geiranger011 collected $5 from pot
geiranger011: doesn't show hand 
*** SUMMARY ***
Total pot $5 | Rake $0 
Seat 1: AP3221 folded before Flop (didn't bet)
Seat 2: geiranger011 collected ($5)
Seat 3: sarkat104 folded before Flop (didn't bet)
Seat 4: Monsthand folded before Flop (didn't bet)
Seat 5: toprmaw folded before Flop (didn't bet)
Seat 7: maxxmeister (button) folded before Flop (didn't bet)
Seat 8: matiko09 (small blind) folded before Flop
Seat 9: WrongButton (big blind) folded before Flop





PokerStars Hand #150121148871:  Hold'em No Limit (€0.25/€0.50 EUR) - 2016/03/10 10:24:53 CET [2016/03/10 4:24:53 ET]
Table 'Algorab' 9-max Seat #3 is the button
Seat 1: nubpoker (€50 in chips) 
Seat 3: dididi2000 (€38.24 in chips) 
Seat 4: Butcher1848 (€50 in chips) 
Seat 6: q3storm (€50 in chips) 
Seat 7: matiko09 (€93.38 in chips) 
Seat 8: fudzi (€50.50 in chips) 
Seat 9: vlad11122007 (€53.38 in chips) 
Butcher1848: posts small blind €0.25
q3storm: posts big blind €0.50
*** HOLE CARDS ***
Dealt to matiko09 [Qd 8h]
matiko09: folds 
fudzi: folds 
vlad11122007: raises €1 to €1.50
nubpoker: folds 
dididi2000: folds 
Butcher1848: raises €3.50 to €5
q3storm: folds 
vlad11122007: calls €3.50
*** FLOP *** [9s 8d 7c]
Butcher1848: checks 
vlad11122007: bets €6
Butcher1848: calls €6
*** TURN *** [9s 8d 7c] [8s]
Butcher1848: checks 
vlad11122007: bets €11.50
Butcher1848: calls €11.50
*** RIVER *** [9s 8d 7c 8s] [Tc]
Butcher1848: checks 
vlad11122007: checks 
*** SHOW DOWN ***
Butcher1848: shows [Ts Td] (a full house, Tens full of Eights)
vlad11122007: mucks hand 
Butcher1848 collected €43.50 from pot
*** SUMMARY ***
Total pot €45.50 | Rake €2 
Board [9s 8d 7c 8s Tc]
Seat 1: nubpoker folded before Flop (didn't bet)
Seat 3: dididi2000 (button) folded before Flop (didn't bet)
Seat 4: Butcher1848 (small blind) showed [Ts Td] and won (€43.50) with a full house, Tens full of Eights
Seat 6: q3storm (big blind) folded before Flop
Seat 7: matiko09 folded before Flop (didn't bet)
Seat 8: fudzi folded before Flop (didn't bet)
Seat 9: vlad11122007 mucked [Kh Qh]





PokerStars Hand #150121150059:  Hold'em No Limit ($0.50/$1.00 USD) - 2016/03/10 10:24:56 CET [2016/03/10 4:24:56 ET]
Table 'Alsciaukat' 9-max Seat #5 is the button
Seat 1: Kelvin sai ($68 in chips) 
Seat 2: mycka86 ($100 in chips) 
Seat 3: blackw0lf_03 ($100 in chips) 
Seat 4: Rikti ($33 in chips) 
Seat 5: toprmaw ($115.92 in chips) 
Seat 6: Sweden_Pound ($100 in chips) 
Seat 7: Yaaaazz ($142.65 in chips) 
Seat 8: F1dgeT ($100 in chips) 
Seat 9: matiko09 ($105.88 in chips) 
Sweden_Pound: posts small blind $0.50
Yaaaazz: posts big blind $1
*** HOLE CARDS ***
Dealt to matiko09 [Ts Jd]
F1dgeT: folds 
matiko09: folds 
Kelvin sai: raises $2 to $3
mycka86: raises $6 to $9
blackw0lf_03: folds 
Rikti: folds 
toprmaw: folds 
Sweden_Pound: folds 
Yaaaazz: folds 
Kelvin sai: raises $11 to $20
mycka86: folds 
Uncalled bet ($11) returned to Kelvin sai
Kelvin sai collected $19.50 from pot
Kelvin sai: doesn't show hand 
*** SUMMARY ***
Total pot $19.50 | Rake $0 
Seat 1: Kelvin sai collected ($19.50)
Seat 2: mycka86 folded before Flop
Seat 3: blackw0lf_03 folded before Flop (didn't bet)
Seat 4: Rikti folded before Flop (didn't bet)
Seat 5: toprmaw (button) folded before Flop (didn't bet)
Seat 6: Sweden_Pound (small blind) folded before Flop
Seat 7: Yaaaazz (big blind) folded before Flop
Seat 8: F1dgeT folded before Flop (didn't bet)
Seat 9: matiko09 folded before Flop (didn't bet)





PokerStars Hand #150121152259:  Hold'em No Limit ($1/$2 USD) - 2016/03/10 10:25:02 CET [2016/03/10 4:25:02 ET]
Table 'Solstice II' 9-max Seat #1 is the button
Seat 1: Rycious ($201.90 in chips) 
Seat 3: vano7777 ($198 in chips) 
Seat 4: matiko09 ($200 in chips) 
Seat 5: toprmaw ($213.25 in chips) 
Seat 6: thecurv ($218.24 in chips) 
Seat 9: Monsthand ($200 in chips) 
vano7777: posts small blind $1
matiko09: posts big blind $2
*** HOLE CARDS ***
Dealt to matiko09 [9d 4s]
toprmaw: folds 
thecurv: folds 
Monsthand: folds 
Rycious: folds 
vano7777: folds 
Uncalled bet ($1) returned to matiko09
matiko09 collected $2 from pot
matiko09: doesn't show hand 
*** SUMMARY ***
Total pot $2 | Rake $0 
Seat 1: Rycious (button) folded before Flop (didn't bet)
Seat 3: vano7777 (small blind) folded before Flop
Seat 4: matiko09 (big blind) collected ($2)
Seat 5: toprmaw folded before Flop (didn't bet)
Seat 6: thecurv folded before Flop (didn't bet)
Seat 9: Monsthand folded before Flop (didn't bet)





PokerStars Hand #150121153325:  Hold'em No Limit ($1/$2 USD) - 2016/03/10 10:25:05 CET [2016/03/10 4:25:05 ET]
Table 'Tauris II' 9-max Seat #4 is the button
Seat 1: toprmaw ($268.49 in chips) 
Seat 2: nickreason17 ($208.67 in chips) 
Seat 3: BOAYARSKIY ($77 in chips) 
Seat 4: matiko09 ($374.78 in chips) 
Seat 5: Spudly6 ($166.52 in chips) 
Seat 6: Yaaaazz ($230.79 in chips) 
Seat 7: Monsthand ($225.85 in chips) 
Seat 8: WrongButton ($219.69 in chips) 
Seat 9: darren1031 ($192.15 in chips) 
Spudly6: posts small blind $1
Yaaaazz: posts big blind $2
*** HOLE CARDS ***
Dealt to matiko09 [Jh 6c]
Monsthand: folds 
WrongButton: folds 
darren1031: calls $2
toprmaw: folds 
nickreason17: folds 
BOAYARSKIY: folds 
matiko09: folds 
Spudly6: folds 
Yaaaazz: raises $6 to $8
darren1031: calls $6
*** FLOP *** [4h 9c Qd]
Yaaaazz: checks 
darren1031: bets $8.12
Yaaaazz: folds 
Uncalled bet ($8.12) returned to darren1031
darren1031 collected $16.24 from pot
*** SUMMARY ***
Total pot $17 | Rake $0.76 
Board [4h 9c Qd]
Seat 1: toprmaw folded before Flop (didn't bet)
Seat 2: nickreason17 folded before Flop (didn't bet)
Seat 3: BOAYARSKIY folded before Flop (didn't bet)
Seat 4: matiko09 (button) folded before Flop (didn't bet)
Seat 5: Spudly6 (small blind) folded before Flop
Seat 6: Yaaaazz (big blind) folded on the Flop
Seat 7: Monsthand folded before Flop (didn't bet)
Seat 8: WrongButton folded before Flop (didn't bet)
Seat 9: darren1031 collected ($16.24)





PokerStars Hand #150121156922:  Hold'em No Limit ($1/$2 USD) - 2016/03/10 10:25:15 CET [2016/03/10 4:25:15 ET]
Table 'Solstice II' 9-max Seat #3 is the button
Seat 1: Rycious ($201.90 in chips) 
Seat 3: vano7777 ($197 in chips) 
Seat 4: matiko09 ($201 in chips) 
Seat 5: toprmaw ($213.25 in chips) 
Seat 6: thecurv ($218.24 in chips) 
Seat 9: Monsthand ($200 in chips) 
matiko09: posts small blind $1
toprmaw: posts big blind $2
*** HOLE CARDS ***
Dealt to matiko09 [9d Tc]
thecurv: folds 
Monsthand: folds 
Rycious: folds 
vano7777: raises $2 to $4
matiko09: folds 
toprmaw: folds 
Uncalled bet ($2) returned to vano7777
vano7777 collected $5 from pot
*** SUMMARY ***
Total pot $5 | Rake $0 
Seat 1: Rycious folded before Flop (didn't bet)
Seat 3: vano7777 (button) collected ($5)
Seat 4: matiko09 (small blind) folded before Flop
Seat 5: toprmaw (big blind) folded before Flop
Seat 6: thecurv folded before Flop (didn't bet)
Seat 9: Monsthand folded before Flop (didn't bet)





PokerStars Hand #150121157795:  Hold'em No Limit ($1/$2 USD) - 2016/03/10 10:25:17 CET [2016/03/10 4:25:17 ET]
Table 'Vesta' 9-max Seat #7 is the button
Seat 1: nickreason17 ($203 in chips) 
Seat 2: Pernilla E A ($236.11 in chips) 
Seat 3: matiko09 ($200 in chips) 
Seat 4: Yaaaazz ($223.40 in chips) 
Seat 6: djammusic ($557.69 in chips) 
Seat 7: Monsthand ($200 in chips) 
Seat 8: 13Ghosts ($300.47 in chips) 
Seat 9: lixiangli ($439.01 in chips) 
13Ghosts: posts small blind $1
lixiangli: posts big blind $2
*** HOLE CARDS ***
Dealt to matiko09 [3h 4d]
nickreason17: raises $4 to $6
Pernilla E A: folds 
matiko09: folds 
Yaaaazz: folds 
djammusic: folds 
Monsthand: folds 
13Ghosts: folds 
lixiangli: folds 
Uncalled bet ($4) returned to nickreason17
nickreason17 collected $5 from pot
*** SUMMARY ***
Total pot $5 | Rake $0 
Seat 1: nickreason17 collected ($5)
Seat 2: Pernilla E A folded before Flop (didn't bet)
Seat 3: matiko09 folded before Flop (didn't bet)
Seat 4: Yaaaazz folded before Flop (didn't bet)
Seat 6: djammusic folded before Flop (didn't bet)
Seat 7: Monsthand (button) folded before Flop (didn't bet)
Seat 8: 13Ghosts (small blind) folded before Flop
Seat 9: lixiangli (big blind) folded before Flop





PokerStars Hand #150121157626:  Hold'em No Limit ($1/$2 USD) - 2016/03/10 10:25:17 CET [2016/03/10 4:25:17 ET]
Table 'Archid' 9-max Seat #8 is the button
Seat 1: AP3221 ($109.22 in chips) 
Seat 2: geiranger011 ($90.64 in chips) 
Seat 3: sarkat104 ($261.60 in chips) 
Seat 4: Monsthand ($208.37 in chips) 
Seat 5: toprmaw ($203 in chips) 
Seat 7: maxxmeister ($200 in chips) 
Seat 8: matiko09 ($227.20 in chips) 
Seat 9: WrongButton ($212.29 in chips) 
WrongButton: posts small blind $1
AP3221: posts big blind $2
BOAYARSKIY: sits out 
*** HOLE CARDS ***
Dealt to matiko09 [3c 7s]
geiranger011: folds 
sarkat104: folds 
Monsthand: folds 
toprmaw: folds 
maxxmeister: folds 
matiko09: folds 
WrongButton: folds 
Uncalled bet ($1) returned to AP3221
AP3221 collected $2 from pot
AP3221: doesn't show hand 
*** SUMMARY ***
Total pot $2 | Rake $0 
Seat 1: AP3221 (big blind) collected ($2)
Seat 2: geiranger011 folded before Flop (didn't bet)
Seat 3: sarkat104 folded before Flop (didn't bet)
Seat 4: Monsthand folded before Flop (didn't bet)
Seat 5: toprmaw folded before Flop (didn't bet)
Seat 7: maxxmeister folded before Flop (didn't bet)
Seat 8: matiko09 (button) folded before Flop (didn't bet)
Seat 9: WrongButton (small blind) folded before Flop





PokerStars Hand #150121161654:  Hold'em No Limit ($0.50/$1.00 USD) - 2016/03/10 10:25:27 CET [2016/03/10 4:25:27 ET]
Table 'Ymir II' 9-max Seat #5 is the button
Seat 1: nickreason17 ($101.50 in chips) 
Seat 2: toprmaw ($102.13 in chips) 
Seat 3: matiko09 ($100 in chips) 
Seat 4: blackw0lf_03 ($156.71 in chips) 
Seat 5: mycka86 ($100 in chips) 
Seat 6: RMilPoker ($111.03 in chips) 
Seat 8: Sweden_Pound ($100 in chips) 
Seat 9: Beni Ca$h ($121.49 in chips) 
RMilPoker: posts small blind $0.50
Sweden_Pound: posts big blind $1
*** HOLE CARDS ***
Dealt to matiko09 [2d 9s]
Beni Ca$h: raises $2 to $3
nickreason17: folds 
toprmaw: folds 
matiko09: folds 
blackw0lf_03: folds 
mycka86: folds 
RMilPoker: folds 
Sweden_Pound: calls $2
*** FLOP *** [8h 3d 4c]
Sweden_Pound: checks 
Beni Ca$h: checks 
*** TURN *** [8h 3d 4c] [7s]
Sweden_Pound: checks 
Beni Ca$h: checks 
*** RIVER *** [8h 3d 4c 7s] [7d]
Sweden_Pound: checks 
Beni Ca$h: bets $7
Sweden_Pound: folds 
Uncalled bet ($7) returned to Beni Ca$h
Beni Ca$h collected $6.21 from pot
*** SUMMARY ***
Total pot $6.50 | Rake $0.29 
Board [8h 3d 4c 7s 7d]
Seat 1: nickreason17 folded before Flop (didn't bet)
Seat 2: toprmaw folded before Flop (didn't bet)
Seat 3: matiko09 folded before Flop (didn't bet)
Seat 4: blackw0lf_03 folded before Flop (didn't bet)
Seat 5: mycka86 (button) folded before Flop (didn't bet)
Seat 6: RMilPoker (small blind) folded before Flop
Seat 8: Sweden_Pound (big blind) folded on the River
Seat 9: Beni Ca$h collected ($6.21)





PokerStars Hand #150121163018:  Hold'em No Limit ($1/$2 USD) - 2016/03/10 10:25:31 CET [2016/03/10 4:25:31 ET]
Table 'Solstice II' 9-max Seat #4 is the button
Seat 1: Rycious ($201.90 in chips) 
Seat 3: vano7777 ($200 in chips) 
Seat 4: matiko09 ($200 in chips) 
Seat 5: toprmaw ($211.25 in chips) 
Seat 6: thecurv ($218.24 in chips) 
Seat 9: Monsthand ($200 in chips) 
toprmaw: posts small blind $1
thecurv: posts big blind $2
*** HOLE CARDS ***
Dealt to matiko09 [6h 9s]
Monsthand: folds 
Rycious: folds 
vano7777: folds 
matiko09: folds 
toprmaw: calls $1
thecurv: checks 
*** FLOP *** [7d 4h 8c]
toprmaw: checks 
thecurv: bets $3
WrongButton joins the table at seat #7 
toprmaw: folds 
Uncalled bet ($3) returned to thecurv
thecurv collected $3.82 from pot
thecurv: doesn't show hand 
*** SUMMARY ***
Total pot $4 | Rake $0.18 
Board [7d 4h 8c]
Seat 1: Rycious folded before Flop (didn't bet)
Seat 3: vano7777 folded before Flop (didn't bet)
Seat 4: matiko09 (button) folded before Flop (didn't bet)
Seat 5: toprmaw (small blind) folded on the Flop
Seat 6: thecurv (big blind) collected ($3.82)
Seat 9: Monsthand folded before Flop (didn't bet)





PokerStars Hand #150121163755:  Hold'em No Limit ($1/$2 USD) - 2016/03/10 10:25:33 CET [2016/03/10 4:25:33 ET]
Table 'Archid' 9-max Seat #9 is the button
Seat 1: AP3221 ($110.22 in chips) 
Seat 2: geiranger011 ($90.64 in chips) 
Seat 3: sarkat104 ($261.60 in chips) 
Seat 4: Monsthand ($208.37 in chips) 
Seat 5: toprmaw ($203 in chips) 
Seat 7: maxxmeister ($200 in chips) 
Seat 8: matiko09 ($227.20 in chips) 
Seat 9: WrongButton ($211.29 in chips) 
AP3221: posts small blind $1
geiranger011: posts big blind $2
BOAYARSKIY: sits out 
*** HOLE CARDS ***
Dealt to matiko09 [8h 8d]
sarkat104: folds 
Monsthand: folds 
toprmaw: folds 
maxxmeister: folds 
matiko09: raises $3 to $5
WrongButton: folds 
AP3221: folds 
geiranger011: folds 
Uncalled bet ($3) returned to matiko09
matiko09 collected $5 from pot
matiko09: doesn't show hand 
*** SUMMARY ***
Total pot $5 | Rake $0 
Seat 1: AP3221 (small blind) folded before Flop
Seat 2: geiranger011 (big blind) folded before Flop
Seat 3: sarkat104 folded before Flop (didn't bet)
Seat 4: Monsthand folded before Flop (didn't bet)
Seat 5: toprmaw folded before Flop (didn't bet)
Seat 7: maxxmeister folded before Flop (didn't bet)
Seat 8: matiko09 collected ($5)
Seat 9: WrongButton (button) folded before Flop (didn't bet)





PokerStars Hand #150121166858:  Hold'em No Limit ($0.50/$1.00 USD) - 2016/03/10 10:25:41 CET [2016/03/10 4:25:41 ET]
Table 'Nereid' 9-max Seat #6 is the button
Seat 1: matiko09 ($100 in chips) 
Seat 3: mycka86 ($102.50 in chips) 
Seat 4: xiaoxiaoniao ($238.61 in chips) 
Seat 5: ilaviiitech ($101.50 in chips) 
Seat 6: thecurv ($111.26 in chips) 
Seat 7: Monsthand ($133.32 in chips) 
Seat 8: Rikti ($25.96 in chips) 
Seat 9: zxp12345 ($197.02 in chips) 
Monsthand: posts small blind $0.50
Rikti: posts big blind $1
*** HOLE CARDS ***
Dealt to matiko09 [Ks Js]
zxp12345: calls $1
matiko09: raises $3 to $4
mycka86: folds 
xiaoxiaoniao: folds 
ilaviiitech: folds 
thecurv: folds 
Monsthand: folds 
Rikti: folds 
zxp12345: calls $3
*** FLOP *** [Th 4c 7h]
zxp12345: checks 
matiko09: checks 
*** TURN *** [Th 4c 7h] [3c]
zxp12345: bets $4.53
matiko09: folds 
Uncalled bet ($4.53) returned to zxp12345
zxp12345 collected $9.07 from pot
*** SUMMARY ***
Total pot $9.50 | Rake $0.43 
Board [Th 4c 7h 3c]
Seat 1: matiko09 folded on the Turn
Seat 3: mycka86 folded before Flop (didn't bet)
Seat 4: xiaoxiaoniao folded before Flop (didn't bet)
Seat 5: ilaviiitech folded before Flop (didn't bet)
Seat 6: thecurv (button) folded before Flop (didn't bet)
Seat 7: Monsthand (small blind) folded before Flop
Seat 8: Rikti (big blind) folded before Flop
Seat 9: zxp12345 collected ($9.07)





PokerStars Hand #150121170790:  Hold'em No Limit ($1/$2 USD) - 2016/03/10 10:25:52 CET [2016/03/10 4:25:52 ET]
Table 'Archid' 9-max Seat #1 is the button
Seat 1: AP3221 ($109.22 in chips) 
Seat 2: geiranger011 ($88.64 in chips) 
Seat 3: sarkat104 ($261.60 in chips) 
Seat 4: Monsthand ($208.37 in chips) 
Seat 5: toprmaw ($203 in chips) 
Seat 7: maxxmeister ($200 in chips) 
Seat 8: matiko09 ($230.20 in chips) 
Seat 9: WrongButton ($211.29 in chips) 
geiranger011: posts small blind $1
sarkat104: posts big blind $2
BOAYARSKIY: sits out 
*** HOLE CARDS ***
Dealt to matiko09 [Jd Ks]
Monsthand: folds 
toprmaw: folds 
maxxmeister: folds 
matiko09: raises $4 to $6
WrongButton: folds 
AP3221: folds 
geiranger011: folds 
sarkat104: calls $4
*** FLOP *** [Td 5s Ah]
sarkat104: bets $2
matiko09: calls $2
*** TURN *** [Td 5s Ah] [6d]
sarkat104: bets $2
matiko09: calls $2
*** RIVER *** [Td 5s Ah 6d] [4d]
sarkat104: checks 
matiko09: checks 
*** SHOW DOWN ***
sarkat104: shows [Jh Kd] (high card Ace)
matiko09: shows [Jd Ks] (high card Ace)
sarkat104 collected $10.03 from pot
matiko09 collected $10.03 from pot
*** SUMMARY ***
Total pot $21 | Rake $0.94 
Board [Td 5s Ah 6d 4d]
Seat 1: AP3221 (button) folded before Flop (didn't bet)
Seat 2: geiranger011 (small blind) folded before Flop
Seat 3: sarkat104 (big blind) showed [Jh Kd] and won ($10.03) with high card Ace
Seat 4: Monsthand folded before Flop (didn't bet)
Seat 5: toprmaw folded before Flop (didn't bet)
Seat 7: maxxmeister folded before Flop (didn't bet)
Seat 8: matiko09 showed [Jd Ks] and won ($10.03) with high card Ace
Seat 9: WrongButton folded before Flop (didn't bet)





PokerStars Hand #150121171340:  Hold'em No Limit ($0.25/$0.50 USD) - 2016/03/10 10:25:53 CET [2016/03/10 4:25:53 ET]
Table 'Aegina' 9-max Seat #5 is the button
Seat 1: Wess_1970 ($106.85 in chips) 
Seat 2: el.suertero ($126.01 in chips) 
Seat 3: matiko09 ($50 in chips) 
Seat 5: depokerlord ($74.08 in chips) 
Seat 6: ardo888 ($148.39 in chips) 
Seat 7: Bohne0815 ($73.65 in chips) 
Seat 8: q3storm ($50 in chips) 
Seat 9: i L00K great ($55.94 in chips) 
ardo888: posts small blind $0.25
Bohne0815: posts big blind $0.50
Wess_1970: posts the ante $0.10
el.suertero: posts the ante $0.10
matiko09: posts the ante $0.10
depokerlord: posts the ante $0.10
ardo888: posts the ante $0.10
Bohne0815: posts the ante $0.10
q3storm: posts the ante $0.10
i L00K great: posts the ante $0.10
*** HOLE CARDS ***
Dealt to matiko09 [8s 8c]
q3storm: folds 
i L00K great: folds 
Wess_1970: folds 
el.suertero: folds 
matiko09: raises $1 to $1.50
depokerlord: folds 
ardo888: folds 
Bohne0815: calls $1
*** FLOP *** [2c Jh 2h]
Bohne0815: checks 
matiko09: checks 
*** TURN *** [2c Jh 2h] [6h]
Bohne0815: bets $2.50
matiko09: calls $2.50
*** RIVER *** [2c Jh 2h 6h] [Qs]
Bohne0815: checks 
matiko09: checks 
*** SHOW DOWN ***
Bohne0815: shows [6d Qd] (two pair, Queens and Sixes)
matiko09: mucks hand 
Bohne0815 collected $8.64 from pot
*** SUMMARY ***
Total pot $9.05 | Rake $0.41 
Board [2c Jh 2h 6h Qs]
Seat 1: Wess_1970 folded before Flop (didn't bet)
Seat 2: el.suertero folded before Flop (didn't bet)
Seat 3: matiko09 mucked [8s 8c]
Seat 5: depokerlord (button) folded before Flop (didn't bet)
Seat 6: ardo888 (small blind) folded before Flop
Seat 7: Bohne0815 (big blind) showed [6d Qd] and won ($8.64) with two pair, Queens and Sixes
Seat 8: q3storm folded before Flop (didn't bet)
Seat 9: i L00K great folded before Flop (didn't bet)





PokerStars Hand #150121172173:  Hold'em No Limit ($1/$2 USD) - 2016/03/10 10:25:56 CET [2016/03/10 4:25:56 ET]
Table 'Sophia II' 9-max Seat #9 is the button
Seat 2: nickreason17 ($213.71 in chips) 
Seat 4: hejun0713 ($187.36 in chips) 
Seat 5: matiko09 ($228.64 in chips) 
Seat 6: WrongButton ($378.86 in chips) 
Seat 7: Monsthand ($310.82 in chips) 
Seat 8: BOAYARSKIY ($77 in chips) 
Seat 9: CARDNAPPED ($53.93 in chips) 
toprmaw will be allowed to play after the button
nickreason17: posts small blind $1
hejun0713: posts big blind $2
*** HOLE CARDS ***
Dealt to matiko09 [Ts Td]
matiko09: raises $4 to $6
WrongButton: folds 
Monsthand: calls $6
BOAYARSKIY: folds 
CARDNAPPED: folds 
nickreason17: folds 
hejun0713: folds 
*** FLOP *** [5c 2s 3h]
matiko09: checks 
Monsthand: bets $9.30
matiko09: calls $9.30
*** TURN *** [5c 2s 3h] [2d]
matiko09: checks 
Monsthand: bets $21
matiko09: calls $21
*** RIVER *** [5c 2s 3h 2d] [2h]
matiko09: checks 
Monsthand: bets $39
matiko09: calls $39
*** SHOW DOWN ***
Monsthand: shows [Qh Qd] (a full house, Deuces full of Queens)
matiko09: mucks hand 
Monsthand collected $150.80 from pot
*** SUMMARY ***
Total pot $153.60 | Rake $2.80 
Board [5c 2s 3h 2d 2h]
Seat 2: nickreason17 (small blind) folded before Flop
Seat 4: hejun0713 (big blind) folded before Flop
Seat 5: matiko09 mucked [Ts Td]
Seat 6: WrongButton folded before Flop (didn't bet)
Seat 7: Monsthand showed [Qh Qd] and won ($150.80) with a full house, Deuces full of Queens
Seat 8: BOAYARSKIY folded before Flop (didn't bet)
Seat 9: CARDNAPPED (button) folded before Flop (didn't bet)





PokerStars Hand #150121173689:  Hold'em No Limit ($1/$2 USD) - 2016/03/10 10:26:00 CET [2016/03/10 4:26:00 ET]
Table 'Vesta' 9-max Seat #8 is the button
Seat 1: nickreason17 ($206 in chips) 
Seat 2: Pernilla E A ($236.11 in chips) 
Seat 3: matiko09 ($200 in chips) 
Seat 4: Yaaaazz ($223.40 in chips) 
Seat 6: djammusic ($557.69 in chips) 
Seat 7: Monsthand ($200 in chips) 
Seat 8: 13Ghosts ($299.47 in chips) 
Seat 9: lixiangli ($437.01 in chips) 
lixiangli: posts small blind $1
nickreason17: posts big blind $2
*** HOLE CARDS ***
Dealt to matiko09 [4s 2d]
13Ghosts said, "?"
Pernilla E A has timed out
Pernilla E A: folds 
13Ghosts said, "it"
matiko09: folds 
Yaaaazz: folds 
lixiangli said, "yes"
djammusic: folds 
13Ghosts said, "?"
lixiangli said, "for computer"
Monsthand: folds 
13Ghosts said, "what is it"
13Ghosts: folds 
lixiangli: raises $2 to $4
nickreason17: raises $11 to $15
lixiangli: calls $11
*** FLOP *** [Qc 3d Ac]
lixiangli: checks 
nickreason17: checks 
*** TURN *** [Qc 3d Ac] [7c]
lixiangli: bets $14.32
nickreason17: calls $14.32
*** RIVER *** [Qc 3d Ac 7c] [6d]
lixiangli: checks 
nickreason17: checks 
*** SHOW DOWN ***
lixiangli: shows [Ks Qs] (a pair of Queens)
nickreason17: shows [2h Ah] (a pair of Aces)
nickreason17 collected $56 from pot
*** SUMMARY ***
Total pot $58.64 | Rake $2.64 
Board [Qc 3d Ac 7c 6d]
Seat 1: nickreason17 (big blind) showed [2h Ah] and won ($56) with a pair of Aces
Seat 2: Pernilla E A folded before Flop (didn't bet)
Seat 3: matiko09 folded before Flop (didn't bet)
Seat 4: Yaaaazz folded before Flop (didn't bet)
Seat 6: djammusic folded before Flop (didn't bet)
Seat 7: Monsthand folded before Flop (didn't bet)
Seat 8: 13Ghosts (button) folded before Flop (didn't bet)
Seat 9: lixiangli (small blind) showed [Ks Qs] and lost with a pair of Queens





PokerStars Hand #150121175771:  Hold'em No Limit ($0.50/$1.00 USD) - 2016/03/10 10:26:05 CET [2016/03/10 4:26:05 ET]
Table 'Alsciaukat' 9-max Seat #6 is the button
Seat 1: Kelvin sai ($78.50 in chips) 
Seat 2: mycka86 ($100 in chips) 
Seat 3: blackw0lf_03 ($100 in chips) 
Seat 4: Rikti ($33 in chips) 
Seat 5: toprmaw ($115.92 in chips) 
Seat 6: Sweden_Pound ($100 in chips) 
Seat 7: Yaaaazz ($141.65 in chips) 
Seat 8: F1dgeT ($100 in chips) 
Seat 9: matiko09 ($105.88 in chips) 
Yaaaazz: posts small blind $0.50
F1dgeT: posts big blind $1
*** HOLE CARDS ***
Dealt to matiko09 [Ac 5c]
matiko09: folds 
Kelvin sai: folds 
mycka86: folds 
blackw0lf_03: folds 
Rikti: folds 
toprmaw: folds 
Sweden_Pound: raises $1 to $2
Yaaaazz: folds 
F1dgeT: folds 
Uncalled bet ($1) returned to Sweden_Pound
Sweden_Pound collected $2.50 from pot
Sweden_Pound: doesn't show hand 
*** SUMMARY ***
Total pot $2.50 | Rake $0 
Seat 1: Kelvin sai folded before Flop (didn't bet)
Seat 2: mycka86 folded before Flop (didn't bet)
Seat 3: blackw0lf_03 folded before Flop (didn't bet)
Seat 4: Rikti folded before Flop (didn't bet)
Seat 5: toprmaw folded before Flop (didn't bet)
Seat 6: Sweden_Pound (button) collected ($2.50)
Seat 7: Yaaaazz (small blind) folded before Flop
Seat 8: F1dgeT (big blind) folded before Flop
Seat 9: matiko09 folded before Flop (didn't bet)





PokerStars Hand #150121176968:  Hold'em No Limit ($0.50/$1.00 USD) - 2016/03/10 10:26:09 CET [2016/03/10 4:26:09 ET]
Table 'Rarahu' 9-max Seat #6 is the button
Seat 1: matiko09 ($100 in chips) 
Seat 2: azzad2007 ($100 in chips) 
Seat 3: BKA12 ($100 in chips) 
Seat 4: vilo1070 ($116.57 in chips) 
Seat 5: blackw0lf_03 ($114.30 in chips) 
Seat 6: RMilPoker ($105.39 in chips) 
Seat 8: Rikti ($94.28 in chips) 
Seat 9: Srz7v44 ($112.20 in chips) 
Rikti: posts small blind $0.50
Srz7v44: posts big blind $1
*** HOLE CARDS ***
Dealt to matiko09 [8d Kc]
matiko09: folds 
azzad2007: folds 
BKA12: folds 
vilo1070: folds 
blackw0lf_03: folds 
RMilPoker: folds 
Rikti: raises $1.50 to $2.50
Srz7v44: raises $1.50 to $4
Rikti: calls $1.50
*** FLOP *** [Ts As Ah]
Rikti: checks 
Srz7v44: bets $3.82
Rikti: folds 
Uncalled bet ($3.82) returned to Srz7v44
Srz7v44 collected $7.64 from pot
*** SUMMARY ***
Total pot $8 | Rake $0.36 
Board [Ts As Ah]
Seat 1: matiko09 folded before Flop (didn't bet)
Seat 2: azzad2007 folded before Flop (didn't bet)
Seat 3: BKA12 folded before Flop (didn't bet)
Seat 4: vilo1070 folded before Flop (didn't bet)
Seat 5: blackw0lf_03 folded before Flop (didn't bet)
Seat 6: RMilPoker (button) folded before Flop (didn't bet)
Seat 8: Rikti (small blind) folded on the Flop
Seat 9: Srz7v44 (big blind) collected ($7.64)





PokerStars Hand #150121178812:  Hold'em No Limit ($1/$2 USD) - 2016/03/10 10:26:13 CET [2016/03/10 4:26:13 ET]
Table 'Solstice II' 9-max Seat #5 is the button
Seat 1: Rycious ($201.90 in chips) 
Seat 3: vano7777 ($200 in chips) 
Seat 4: matiko09 ($200 in chips) 
Seat 5: toprmaw ($209.25 in chips) 
Seat 6: thecurv ($220.06 in chips) 
Seat 7: WrongButton ($200 in chips) 
Seat 9: Monsthand ($200 in chips) 
thecurv: posts small blind $1
WrongButton: posts big blind $2
*** HOLE CARDS ***
Dealt to matiko09 [Qs 4d]
Monsthand: folds 
Rycious: folds 
vano7777: folds 
matiko09: folds 
toprmaw: folds 
thecurv: folds 
Uncalled bet ($1) returned to WrongButton
WrongButton collected $2 from pot
*** SUMMARY ***
Total pot $2 | Rake $0 
Seat 1: Rycious folded before Flop (didn't bet)
Seat 3: vano7777 folded before Flop (didn't bet)
Seat 4: matiko09 folded before Flop (didn't bet)
Seat 5: toprmaw (button) folded before Flop (didn't bet)
Seat 6: thecurv (small blind) folded before Flop
Seat 7: WrongButton (big blind) collected ($2)
Seat 9: Monsthand folded before Flop (didn't bet)





PokerStars Hand #150121184101:  Hold'em No Limit ($0.50/$1.00 USD) - 2016/03/10 10:26:28 CET [2016/03/10 4:26:28 ET]
Table 'Nereid' 9-max Seat #7 is the button
Seat 1: matiko09 ($100 in chips) 
Seat 3: mycka86 ($102.50 in chips) 
Seat 4: xiaoxiaoniao ($238.61 in chips) 
Seat 5: ilaviiitech ($101.50 in chips) 
Seat 6: thecurv ($111.26 in chips) 
Seat 7: Monsthand ($132.82 in chips) 
Seat 8: Rikti ($24.96 in chips) 
Rikti: posts small blind $0.50
zxp12345: is sitting out 
matiko09: posts big blind $1
*** HOLE CARDS ***
Dealt to matiko09 [3c Jc]
mycka86: folds 
xiaoxiaoniao: raises $2 to $3
ilaviiitech: calls $3
thecurv: calls $3
Monsthand: folds 
Rikti: folds 
matiko09: folds 
*** FLOP *** [7c Tc 5h]
xiaoxiaoniao: bets $5
ilaviiitech: calls $5
thecurv: folds 
*** TURN *** [7c Tc 5h] [Ac]
xiaoxiaoniao: bets $10
ilaviiitech: calls $10
*** RIVER *** [7c Tc 5h Ac] [6d]
xiaoxiaoniao: bets $23
ilaviiitech: folds 
Uncalled bet ($23) returned to xiaoxiaoniao
xiaoxiaoniao collected $38.68 from pot
xiaoxiaoniao: doesn't show hand 
*** SUMMARY ***
Total pot $40.50 | Rake $1.82 
Board [7c Tc 5h Ac 6d]
Seat 1: matiko09 (big blind) folded before Flop
Seat 3: mycka86 folded before Flop (didn't bet)
Seat 4: xiaoxiaoniao collected ($38.68)
Seat 5: ilaviiitech folded on the River
Seat 6: thecurv folded on the Flop
Seat 7: Monsthand (button) folded before Flop (didn't bet)
Seat 8: Rikti (small blind) folded before Flop





PokerStars Hand #150121184704:  Hold'em No Limit ($0.50/$1.00 USD) - 2016/03/10 10:26:29 CET [2016/03/10 4:26:29 ET]
Table 'Ymir II' 9-max Seat #6 is the button
Seat 1: nickreason17 ($101.50 in chips) 
Seat 2: toprmaw ($102.13 in chips) 
Seat 3: matiko09 ($100 in chips) 
Seat 4: blackw0lf_03 ($156.71 in chips) 
Seat 5: mycka86 ($100 in chips) 
Seat 6: RMilPoker ($110.53 in chips) 
Seat 8: Sweden_Pound ($100 in chips) 
Seat 9: Beni Ca$h ($124.70 in chips) 
Sweden_Pound: posts small blind $0.50
Beni Ca$h: posts big blind $1
*** HOLE CARDS ***
Dealt to matiko09 [8h 3h]
nickreason17: folds 
nickreason17 leaves the table
toprmaw: folds 
matiko09: folds 
Monsthand joins the table at seat #1 
blackw0lf_03: folds 
mycka86: folds 
RMilPoker: folds 
Sweden_Pound: raises $2 to $3
Beni Ca$h: calls $2
*** FLOP *** [2h Jc 4c]
Sweden_Pound: bets $3.72
Beni Ca$h: raises $4.28 to $8
Sweden_Pound: raises $14 to $22
Beni Ca$h: calls $14
*** TURN *** [2h Jc 4c] [6s]
Sweden_Pound: bets $28.50
Beni Ca$h: folds 
Uncalled bet ($28.50) returned to Sweden_Pound
Sweden_Pound collected $47.75 from pot
Sweden_Pound: doesn't show hand 
*** SUMMARY ***
Total pot $50 | Rake $2.25 
Board [2h Jc 4c 6s]
Seat 1: nickreason17 folded before Flop (didn't bet)
Seat 2: toprmaw folded before Flop (didn't bet)
Seat 3: matiko09 folded before Flop (didn't bet)
Seat 4: blackw0lf_03 folded before Flop (didn't bet)
Seat 5: mycka86 folded before Flop (didn't bet)
Seat 6: RMilPoker (button) folded before Flop (didn't bet)
Seat 8: Sweden_Pound (small blind) collected ($47.75)
Seat 9: Beni Ca$h (big blind) folded on the Turn





PokerStars Hand #150121185827:  Hold'em No Limit ($0.25/$0.50 USD) - 2016/03/10 10:26:32 CET [2016/03/10 4:26:32 ET]
Table 'Aegina' 9-max Seat #6 is the button
Seat 1: Wess_1970 ($106.75 in chips) 
Seat 2: el.suertero ($125.91 in chips) 
Seat 3: matiko09 ($50 in chips) 
Seat 5: depokerlord ($73.98 in chips) 
Seat 6: ardo888 ($148.04 in chips) 
Seat 7: Bohne0815 ($78.19 in chips) 
Seat 8: q3storm ($50 in chips) 
Seat 9: i L00K great ($55.84 in chips) 
Bohne0815: posts small blind $0.25
q3storm: posts big blind $0.50
Wess_1970: posts the ante $0.10
el.suertero: posts the ante $0.10
matiko09: posts the ante $0.10
depokerlord: posts the ante $0.10
ardo888: posts the ante $0.10
Bohne0815: posts the ante $0.10
q3storm: posts the ante $0.10
i L00K great: posts the ante $0.10
*** HOLE CARDS ***
Dealt to matiko09 [4c Jh]
i L00K great: folds 
Wess_1970: calls $0.50
el.suertero: raises $1.50 to $2
matiko09: folds 
depokerlord: folds 
ardo888: folds 
Bohne0815 is disconnected 
Bohne0815 has timed out while disconnected
Bohne0815: folds 
q3storm: folds 
Wess_1970: calls $1.50
*** FLOP *** [Kc 8d Kh]
Wess_1970: checks 
el.suertero: bets $2.91
Wess_1970: calls $2.91
*** TURN *** [Kc 8d Kh] [5c]
Wess_1970: checks 
el.suertero: bets $5.97
Wess_1970: calls $5.97
*** RIVER *** [Kc 8d Kh 5c] [5s]
Wess_1970: checks 
el.suertero: checks 
*** SHOW DOWN ***
Wess_1970: shows [Ah 2s] (two pair, Kings and Fives)
el.suertero: shows [7c 8c] (two pair, Kings and Eights)
el.suertero collected $22.26 from pot
*** SUMMARY ***
Total pot $23.31 | Rake $1.05 
Board [Kc 8d Kh 5c 5s]
Seat 1: Wess_1970 showed [Ah 2s] and lost with two pair, Kings and Fives
Seat 2: el.suertero showed [7c 8c] and won ($22.26) with two pair, Kings and Eights
Seat 3: matiko09 folded before Flop (didn't bet)
Seat 5: depokerlord folded before Flop (didn't bet)
Seat 6: ardo888 (button) folded before Flop (didn't bet)
Seat 7: Bohne0815 (small blind) folded before Flop
Seat 8: q3storm (big blind) folded before Flop
Seat 9: i L00K great folded before Flop (didn't bet)





PokerStars Hand #150121186283:  Hold'em No Limit (€0.25/€0.50 EUR) - 2016/03/10 10:26:34 CET [2016/03/10 4:26:34 ET]
Table 'Algorab' 9-max Seat #4 is the button
Seat 1: nubpoker (€50 in chips) 
Seat 3: dididi2000 (€38.24 in chips) 
Seat 4: Butcher1848 (€71 in chips) 
Seat 6: q3storm (€50 in chips) 
Seat 7: matiko09 (€93.38 in chips) 
Seat 8: fudzi (€50.50 in chips) 
Seat 9: vlad11122007 (€50 in chips) 
q3storm: posts small blind €0.25
matiko09: posts big blind €0.50
*** HOLE CARDS ***
Dealt to matiko09 [Jh 7d]
fudzi: folds 
vlad11122007: raises €1 to €1.50
nubpoker: folds 
dididi2000: folds 
Butcher1848: folds 
q3storm: raises €2.25 to €3.75
matiko09: folds 
vlad11122007: raises €3.50 to €7.25
q3storm: folds 
Uncalled bet (€3.50) returned to vlad11122007
vlad11122007 collected €8 from pot
vlad11122007: doesn't show hand 
*** SUMMARY ***
Total pot €8 | Rake €0 
Seat 1: nubpoker folded before Flop (didn't bet)
Seat 3: dididi2000 folded before Flop (didn't bet)
Seat 4: Butcher1848 (button) folded before Flop (didn't bet)
Seat 6: q3storm (small blind) folded before Flop
Seat 7: matiko09 (big blind) folded before Flop
Seat 8: fudzi folded before Flop (didn't bet)
Seat 9: vlad11122007 collected (€8)





PokerStars Hand #150121186721:  Hold'em No Limit ($1/$2 USD) - 2016/03/10 10:26:35 CET [2016/03/10 4:26:35 ET]
Table 'Tauris II' 9-max Seat #5 is the button
Seat 1: toprmaw ($268.49 in chips) 
Seat 2: nickreason17 ($208.67 in chips) 
Seat 3: BOAYARSKIY ($77 in chips) 
Seat 4: matiko09 ($374.78 in chips) 
Seat 5: Spudly6 ($165.52 in chips) 
Seat 6: Yaaaazz ($222.79 in chips) 
Seat 7: Monsthand ($225.85 in chips) 
Seat 8: WrongButton ($219.69 in chips) 
Seat 9: darren1031 ($200.39 in chips) 
Yaaaazz: posts small blind $1
Monsthand: posts big blind $2
*** HOLE CARDS ***
Dealt to matiko09 [4c 4s]
WrongButton: folds 
darren1031: folds 
toprmaw: folds 
nickreason17: folds 
BOAYARSKIY: folds 
matiko09: raises $3 to $5
Spudly6: folds 
Yaaaazz: folds 
Monsthand: folds 
Uncalled bet ($3) returned to matiko09
matiko09 collected $5 from pot
matiko09: doesn't show hand 
*** SUMMARY ***
Total pot $5 | Rake $0 
Seat 1: toprmaw folded before Flop (didn't bet)
Seat 2: nickreason17 folded before Flop (didn't bet)
Seat 3: BOAYARSKIY folded before Flop (didn't bet)
Seat 4: matiko09 collected ($5)
Seat 5: Spudly6 (button) folded before Flop (didn't bet)
Seat 6: Yaaaazz (small blind) folded before Flop
Seat 7: Monsthand (big blind) folded before Flop
Seat 8: WrongButton folded before Flop (didn't bet)
Seat 9: darren1031 folded before Flop (didn't bet)





PokerStars Hand #150121187437:  Hold'em No Limit ($1/$2 USD) - 2016/03/10 10:26:37 CET [2016/03/10 4:26:37 ET]
Table 'Archid' 9-max Seat #2 is the button
Seat 1: AP3221 ($109.22 in chips) 
Seat 2: geiranger011 ($87.64 in chips) 
Seat 3: sarkat104 ($261.63 in chips) 
Seat 4: Monsthand ($208.37 in chips) 
Seat 5: toprmaw ($203 in chips) 
Seat 7: maxxmeister ($200 in chips) 
Seat 8: matiko09 ($230.23 in chips) 
Seat 9: WrongButton ($211.29 in chips) 
sarkat104: posts small blind $1
Monsthand: posts big blind $2
BOAYARSKIY: sits out 
*** HOLE CARDS ***
Dealt to matiko09 [Ks 7s]
toprmaw: folds 
maxxmeister: folds 
matiko09: folds 
WrongButton: folds 
AP3221: raises $2 to $4
geiranger011: folds 
sarkat104: calls $3
Monsthand: folds 
*** FLOP *** [4d 6d 4s]
sarkat104: checks 
AP3221: checks 
*** TURN *** [4d 6d 4s] [8d]
sarkat104: checks 
AP3221: bets $5
sarkat104: folds 
Uncalled bet ($5) returned to AP3221
AP3221 collected $9.55 from pot
AP3221: doesn't show hand 
*** SUMMARY ***
Total pot $10 | Rake $0.45 
Board [4d 6d 4s 8d]
Seat 1: AP3221 collected ($9.55)
Seat 2: geiranger011 (button) folded before Flop (didn't bet)
Seat 3: sarkat104 (small blind) folded on the Turn
Seat 4: Monsthand (big blind) folded before Flop
Seat 5: toprmaw folded before Flop (didn't bet)
Seat 7: maxxmeister folded before Flop (didn't bet)
Seat 8: matiko09 folded before Flop (didn't bet)
Seat 9: WrongButton folded before Flop (didn't bet)





PokerStars Hand #150121188827:  Hold'em No Limit ($1/$2 USD) - 2016/03/10 10:26:40 CET [2016/03/10 4:26:40 ET]
Table 'Solstice II' 9-max Seat #6 is the button
Seat 1: Rycious ($201.90 in chips) 
Seat 3: vano7777 ($200 in chips) 
Seat 4: matiko09 ($200 in chips) 
Seat 5: toprmaw ($209.25 in chips) 
Seat 6: thecurv ($219.06 in chips) 
Seat 7: WrongButton ($201 in chips) 
Seat 9: Monsthand ($200 in chips) 
WrongButton: posts small blind $1
Monsthand: posts big blind $2
*** HOLE CARDS ***
Dealt to matiko09 [9s Ac]
Rycious: folds 
vano7777: folds 
matiko09: folds 
toprmaw: folds 
thecurv: raises $3 to $5
WrongButton: folds 
Monsthand: calls $3
*** FLOP *** [5c Kh Jh]
Monsthand: checks 
thecurv: bets $6
Monsthand: raises $14 to $20
thecurv: folds 
Uncalled bet ($14) returned to Monsthand
Monsthand collected $21.96 from pot
Monsthand: doesn't show hand 
*** SUMMARY ***
Total pot $23 | Rake $1.04 
Board [5c Kh Jh]
Seat 1: Rycious folded before Flop (didn't bet)
Seat 3: vano7777 folded before Flop (didn't bet)
Seat 4: matiko09 folded before Flop (didn't bet)
Seat 5: toprmaw folded before Flop (didn't bet)
Seat 6: thecurv (button) folded on the Flop
Seat 7: WrongButton (small blind) folded before Flop
Seat 9: Monsthand (big blind) collected ($21.96)





PokerStars Hand #150121189718:  Hold'em No Limit ($0.50/$1.00 USD) - 2016/03/10 10:26:43 CET [2016/03/10 4:26:43 ET]
Table 'Alsciaukat' 9-max Seat #7 is the button
Seat 1: Kelvin sai ($78.50 in chips) 
Seat 2: mycka86 ($100 in chips) 
Seat 3: blackw0lf_03 ($100 in chips) 
Seat 4: Rikti ($33 in chips) 
Seat 5: toprmaw ($115.92 in chips) 
Seat 6: Sweden_Pound ($101.50 in chips) 
Seat 7: Yaaaazz ($141.15 in chips) 
Seat 8: F1dgeT ($100 in chips) 
Seat 9: matiko09 ($105.88 in chips) 
F1dgeT: posts small blind $0.50
matiko09: posts big blind $1
*** HOLE CARDS ***
Dealt to matiko09 [2c Kc]
Kelvin sai: folds 
mycka86: raises $2 to $3
blackw0lf_03: folds 
Rikti: folds 
toprmaw: folds 
Sweden_Pound: folds 
Yaaaazz: folds 
F1dgeT: folds 
matiko09: folds 
Uncalled bet ($2) returned to mycka86
mycka86 collected $2.50 from pot
*** SUMMARY ***
Total pot $2.50 | Rake $0 
Seat 1: Kelvin sai folded before Flop (didn't bet)
Seat 2: mycka86 collected ($2.50)
Seat 3: blackw0lf_03 folded before Flop (didn't bet)
Seat 4: Rikti folded before Flop (didn't bet)
Seat 5: toprmaw folded before Flop (didn't bet)
Seat 6: Sweden_Pound folded before Flop (didn't bet)
Seat 7: Yaaaazz (button) folded before Flop (didn't bet)
Seat 8: F1dgeT (small blind) folded before Flop
Seat 9: matiko09 (big blind) folded before Flop





PokerStars Hand #150121195630:  Hold'em No Limit ($0.50/$1.00 USD) - 2016/03/10 10:26:58 CET [2016/03/10 4:26:58 ET]
Table 'Rarahu' 9-max Seat #8 is the button
Seat 1: matiko09 ($100 in chips) 
Seat 2: azzad2007 ($100 in chips) 
Seat 3: BKA12 ($100 in chips) 
Seat 4: vilo1070 ($116.57 in chips) 
Seat 5: blackw0lf_03 ($114.30 in chips) 
Seat 6: RMilPoker ($105.39 in chips) 
Seat 8: Rikti ($90.28 in chips) 
Seat 9: Srz7v44 ($115.84 in chips) 
Srz7v44: posts small blind $0.50
matiko09: posts big blind $1
*** HOLE CARDS ***
Dealt to matiko09 [3c Td]
azzad2007: folds 
BKA12: folds 
vilo1070: folds 
blackw0lf_03: folds 
RMilPoker: folds 
Rikti: folds 
Srz7v44: folds 
Uncalled bet ($0.50) returned to matiko09
matiko09 collected $1 from pot
matiko09: doesn't show hand 
*** SUMMARY ***
Total pot $1 | Rake $0 
Seat 1: matiko09 (big blind) collected ($1)
Seat 2: azzad2007 folded before Flop (didn't bet)
Seat 3: BKA12 folded before Flop (didn't bet)
Seat 4: vilo1070 folded before Flop (didn't bet)
Seat 5: blackw0lf_03 folded before Flop (didn't bet)
Seat 6: RMilPoker folded before Flop (didn't bet)
Seat 8: Rikti (button) folded before Flop (didn't bet)
Seat 9: Srz7v44 (small blind) folded before Flop





PokerStars Hand #150121196730:  Hold'em No Limit ($1/$2 USD) - 2016/03/10 10:27:01 CET [2016/03/10 4:27:01 ET]
Table 'Tauris II' 9-max Seat #6 is the button
Seat 1: toprmaw ($268.49 in chips) 
Seat 2: nickreason17 ($208.67 in chips) 
Seat 3: BOAYARSKIY ($77 in chips) 
Seat 4: matiko09 ($377.78 in chips) 
Seat 5: Spudly6 ($165.52 in chips) 
Seat 6: Yaaaazz ($221.79 in chips) 
Seat 7: Monsthand ($223.85 in chips) 
Seat 8: WrongButton ($219.69 in chips) 
Seat 9: darren1031 ($200.39 in chips) 
Monsthand: posts small blind $1
WrongButton: posts big blind $2
*** HOLE CARDS ***
Dealt to matiko09 [4d 9h]
darren1031: raises $4 to $6
toprmaw: folds 
nickreason17: folds 
BOAYARSKIY: folds 
matiko09: folds 
Spudly6: folds 
Yaaaazz: folds 
Monsthand: folds 
WrongButton: calls $4
*** FLOP *** [Td 8c 6h]
WrongButton: checks 
darren1031: bets $12.42
WrongButton: calls $12.42
*** TURN *** [Td 8c 6h] [5d]
WrongButton: checks 
darren1031: bets $18.07
WrongButton: calls $18.07
*** RIVER *** [Td 8c 6h 5d] [2h]
WrongButton: checks 
darren1031: checks 
*** SHOW DOWN ***
WrongButton: shows [Jh Jc] (a pair of Jacks)
darren1031: mucks hand 
WrongButton collected $71.18 from pot
*** SUMMARY ***
Total pot $73.98 | Rake $2.80 
Board [Td 8c 6h 5d 2h]
Seat 1: toprmaw folded before Flop (didn't bet)
Seat 2: nickreason17 folded before Flop (didn't bet)
Seat 3: BOAYARSKIY folded before Flop (didn't bet)
Seat 4: matiko09 folded before Flop (didn't bet)
Seat 5: Spudly6 folded before Flop (didn't bet)
Seat 6: Yaaaazz (button) folded before Flop (didn't bet)
Seat 7: Monsthand (small blind) folded before Flop
Seat 8: WrongButton (big blind) showed [Jh Jc] and won ($71.18) with a pair of Jacks
Seat 9: darren1031 mucked [As Tc]





PokerStars Hand #150121201585:  Hold'em No Limit ($1/$2 USD) - 2016/03/10 10:27:14 CET [2016/03/10 4:27:14 ET]
Table 'Vesta' 9-max Seat #9 is the button
Seat 1: nickreason17 ($232.68 in chips) 
Seat 2: Pernilla E A ($236.11 in chips) 
Seat 3: matiko09 ($200 in chips) 
Seat 4: Yaaaazz ($223.40 in chips) 
Seat 6: djammusic ($557.69 in chips) 
Seat 7: Monsthand ($200 in chips) 
Seat 8: 13Ghosts ($299.47 in chips) 
Seat 9: lixiangli ($407.69 in chips) 
nickreason17: posts small blind $1
Pernilla E A: posts big blind $2
*** HOLE CARDS ***
Dealt to matiko09 [Qc Qs]
matiko09: raises $4 to $6
Yaaaazz: folds 
djammusic: folds 
Monsthand: folds 
13Ghosts: folds 
lixiangli: folds 
nickreason17: calls $5
Pernilla E A: calls $4
*** FLOP *** [5s 2s Kc]
nickreason17: checks 
Pernilla E A: checks 
matiko09: checks 
*** TURN *** [5s 2s Kc] [6s]
nickreason17: bets $10
Pernilla E A: calls $10
matiko09: calls $10
*** RIVER *** [5s 2s Kc 6s] [Th]
nickreason17: checks 
Pernilla E A: checks 
matiko09: checks 
*** SHOW DOWN ***
nickreason17: shows [Qh Qd] (a pair of Queens)
Pernilla E A: mucks hand 
matiko09: shows [Qc Qs] (a pair of Queens)
nickreason17 collected $22.92 from pot
matiko09 collected $22.92 from pot
*** SUMMARY ***
Total pot $48 | Rake $2.16 
Board [5s 2s Kc 6s Th]
Seat 1: nickreason17 (small blind) showed [Qh Qd] and won ($22.92) with a pair of Queens
Seat 2: Pernilla E A (big blind) mucked [6h 4d]
Seat 3: matiko09 showed [Qc Qs] and won ($22.92) with a pair of Queens
Seat 4: Yaaaazz folded before Flop (didn't bet)
Seat 6: djammusic folded before Flop (didn't bet)
Seat 7: Monsthand folded before Flop (didn't bet)
Seat 8: 13Ghosts folded before Flop (didn't bet)
Seat 9: lixiangli (button) folded before Flop (didn't bet)





PokerStars Hand #150121202709:  Hold'em No Limit ($0.50/$1.00 USD) - 2016/03/10 10:27:18 CET [2016/03/10 4:27:18 ET]
Table 'Rarahu' 9-max Seat #9 is the button
Seat 1: matiko09 ($100.50 in chips) 
Seat 2: azzad2007 ($100 in chips) 
Seat 3: BKA12 ($100 in chips) 
Seat 4: vilo1070 ($116.57 in chips) 
Seat 5: blackw0lf_03 ($114.30 in chips) 
Seat 6: RMilPoker ($105.39 in chips) 
Seat 8: Rikti ($90.28 in chips) 
Seat 9: Srz7v44 ($115.34 in chips) 
matiko09: posts small blind $0.50
azzad2007: posts big blind $1
*** HOLE CARDS ***
Dealt to matiko09 [8s 8c]
BKA12: folds 
vilo1070: folds 
blackw0lf_03: folds 
RMilPoker: folds 
Rikti: folds 
Srz7v44: folds 
matiko09: raises $1.50 to $2.50
azzad2007: folds 
Uncalled bet ($1.50) returned to matiko09
matiko09 collected $2 from pot
matiko09: doesn't show hand 
*** SUMMARY ***
Total pot $2 | Rake $0 
Seat 1: matiko09 (small blind) collected ($2)
Seat 2: azzad2007 (big blind) folded before Flop
Seat 3: BKA12 folded before Flop (didn't bet)
Seat 4: vilo1070 folded before Flop (didn't bet)
Seat 5: blackw0lf_03 folded before Flop (didn't bet)
Seat 6: RMilPoker folded before Flop (didn't bet)
Seat 8: Rikti folded before Flop (didn't bet)
Seat 9: Srz7v44 (button) folded before Flop (didn't bet)





PokerStars Hand #150121205973:  Hold'em No Limit ($1/$2 USD) - 2016/03/10 10:27:26 CET [2016/03/10 4:27:26 ET]
Table 'Sophia II' 9-max Seat #2 is the button
Seat 2: nickreason17 ($212.71 in chips) 
Seat 4: hejun0713 ($185.36 in chips) 
Seat 5: matiko09 ($200 in chips) 
Seat 6: WrongButton ($378.86 in chips) 
Seat 7: Monsthand ($386.32 in chips) 
Seat 8: BOAYARSKIY ($77 in chips) 
Seat 9: CARDNAPPED ($53.93 in chips) 
hejun0713: posts small blind $1
matiko09: posts big blind $2
toprmaw: sits out 
*** HOLE CARDS ***
Dealt to matiko09 [Ac Ad]
WrongButton: folds 
Monsthand: raises $4 to $6
BOAYARSKIY: folds 
CARDNAPPED has timed out while being disconnected
CARDNAPPED: folds 
nickreason17: folds 
CARDNAPPED is disconnected 
hejun0713: calls $5
matiko09: raises $18 to $24
Monsthand: folds 
hejun0713: folds 
Uncalled bet ($18) returned to matiko09
matiko09 collected $18 from pot
matiko09: doesn't show hand 
*** SUMMARY ***
Total pot $18 | Rake $0 
Seat 2: nickreason17 (button) folded before Flop (didn't bet)
Seat 4: hejun0713 (small blind) folded before Flop
Seat 5: matiko09 (big blind) collected ($18)
Seat 6: WrongButton folded before Flop (didn't bet)
Seat 7: Monsthand folded before Flop
Seat 8: BOAYARSKIY folded before Flop (didn't bet)
Seat 9: CARDNAPPED folded before Flop (didn't bet)





PokerStars Hand #150121207309:  Hold'em No Limit ($0.50/$1.00 USD) - 2016/03/10 10:27:30 CET [2016/03/10 4:27:30 ET]
Table 'Alsciaukat' 9-max Seat #8 is the button
Seat 1: Kelvin sai ($78.50 in chips) 
Seat 2: mycka86 ($101.50 in chips) 
Seat 3: blackw0lf_03 ($100 in chips) 
Seat 4: Rikti ($33 in chips) 
Seat 5: toprmaw ($115.92 in chips) 
Seat 6: Sweden_Pound ($101.50 in chips) 
Seat 7: Yaaaazz ($141.15 in chips) 
Seat 8: F1dgeT ($100 in chips) 
Seat 9: matiko09 ($104.88 in chips) 
matiko09: posts small blind $0.50
Kelvin sai: posts big blind $1
*** HOLE CARDS ***
Dealt to matiko09 [Th 5d]
mycka86: folds 
blackw0lf_03: folds 
Rikti: folds 
toprmaw: folds 
Sweden_Pound: folds 
Yaaaazz: folds 
F1dgeT: folds 
matiko09: folds 
Uncalled bet ($0.50) returned to Kelvin sai
Kelvin sai collected $1 from pot
Kelvin sai: doesn't show hand 
*** SUMMARY ***
Total pot $1 | Rake $0 
Seat 1: Kelvin sai (big blind) collected ($1)
Seat 2: mycka86 folded before Flop (didn't bet)
Seat 3: blackw0lf_03 folded before Flop (didn't bet)
Seat 4: Rikti folded before Flop (didn't bet)
Seat 5: toprmaw folded before Flop (didn't bet)
Seat 6: Sweden_Pound folded before Flop (didn't bet)
Seat 7: Yaaaazz folded before Flop (didn't bet)
Seat 8: F1dgeT (button) folded before Flop (didn't bet)
Seat 9: matiko09 (small blind) folded before Flop





PokerStars Hand #150121211146:  Hold'em No Limit ($0.50/$1.00 USD) - 2016/03/10 10:27:40 CET [2016/03/10 4:27:40 ET]
Table 'Nereid' 9-max Seat #8 is the button
Seat 1: matiko09 ($100 in chips) 
Seat 3: mycka86 ($102.50 in chips) 
Seat 4: xiaoxiaoniao ($259.29 in chips) 
Seat 5: ilaviiitech ($100 in chips) 
Seat 6: thecurv ($108.26 in chips) 
Seat 7: Monsthand ($132.82 in chips) 
Seat 8: Rikti ($24.46 in chips) 
matiko09: posts small blind $0.50
mycka86: posts big blind $1
*** HOLE CARDS ***
Dealt to matiko09 [3c Qc]
xiaoxiaoniao: raises $1 to $2
ilaviiitech: raises $8 to $10
thecurv: folds 
Monsthand: folds 
Rikti: folds 
matiko09: folds 
mycka86: folds 
xiaoxiaoniao: folds 
Uncalled bet ($8) returned to ilaviiitech
ilaviiitech collected $5.50 from pot
ilaviiitech: doesn't show hand 
*** SUMMARY ***
Total pot $5.50 | Rake $0 
Seat 1: matiko09 (small blind) folded before Flop
Seat 3: mycka86 (big blind) folded before Flop
Seat 4: xiaoxiaoniao folded before Flop
Seat 5: ilaviiitech collected ($5.50)
Seat 6: thecurv folded before Flop (didn't bet)
Seat 7: Monsthand folded before Flop (didn't bet)
Seat 8: Rikti (button) folded before Flop (didn't bet)





PokerStars Hand #150121210972:  Hold'em No Limit (€0.25/€0.50 EUR) - 2016/03/10 10:27:40 CET [2016/03/10 4:27:40 ET]
Table 'Algorab' 9-max Seat #6 is the button
Seat 1: nubpoker (€50 in chips) 
Seat 3: dididi2000 (€38.24 in chips) 
Seat 4: Butcher1848 (€71 in chips) 
Seat 6: q3storm (€50 in chips) 
Seat 7: matiko09 (€92.88 in chips) 
Seat 8: fudzi (€50.50 in chips) 
Seat 9: vlad11122007 (€54.25 in chips) 
matiko09: posts small blind €0.25
fudzi: posts big blind €0.50
*** HOLE CARDS ***
Dealt to matiko09 [3c Ac]
vlad11122007: folds 
nubpoker: folds 
dididi2000: raises €1 to €1.50
Butcher1848: folds 
q3storm: folds 
matiko09: folds 
fudzi: folds 
Uncalled bet (€1) returned to dididi2000
dididi2000 collected €1.25 from pot
dididi2000: doesn't show hand 
*** SUMMARY ***
Total pot €1.25 | Rake €0 
Seat 1: nubpoker folded before Flop (didn't bet)
Seat 3: dididi2000 collected (€1.25)
Seat 4: Butcher1848 folded before Flop (didn't bet)
Seat 6: q3storm (button) folded before Flop (didn't bet)
Seat 7: matiko09 (small blind) folded before Flop
Seat 8: fudzi (big blind) folded before Flop
Seat 9: vlad11122007 folded before Flop (didn't bet)





PokerStars Hand #150121214044:  Hold'em No Limit ($1/$2 USD) - 2016/03/10 10:27:48 CET [2016/03/10 4:27:48 ET]
Table 'Archid' 9-max Seat #3 is the button
Seat 1: AP3221 ($114.77 in chips) 
Seat 2: geiranger011 ($87.64 in chips) 
Seat 3: sarkat104 ($257.63 in chips) 
Seat 4: Monsthand ($206.37 in chips) 
Seat 5: toprmaw ($203 in chips) 
Seat 7: maxxmeister ($200 in chips) 
Seat 8: matiko09 ($230.23 in chips) 
Seat 9: WrongButton ($211.29 in chips) 
Monsthand: posts small blind $1
toprmaw: posts big blind $2
BOAYARSKIY: sits out 
*** HOLE CARDS ***
Dealt to matiko09 [6c Qh]
maxxmeister: folds 
matiko09: folds 
WrongButton: folds 
AP3221: folds 
geiranger011: folds 
sarkat104: folds 
Monsthand: raises $4 to $6
toprmaw: raises $10.40 to $16.40
Monsthand: folds 
Uncalled bet ($10.40) returned to toprmaw
toprmaw collected $12 from pot
toprmaw: doesn't show hand 
*** SUMMARY ***
Total pot $12 | Rake $0 
Seat 1: AP3221 folded before Flop (didn't bet)
Seat 2: geiranger011 folded before Flop (didn't bet)
Seat 3: sarkat104 (button) folded before Flop (didn't bet)
Seat 4: Monsthand (small blind) folded before Flop
Seat 5: toprmaw (big blind) collected ($12)
Seat 7: maxxmeister folded before Flop (didn't bet)
Seat 8: matiko09 folded before Flop (didn't bet)
Seat 9: WrongButton folded before Flop (didn't bet)





PokerStars Hand #150121214372:  Hold'em No Limit ($1/$2 USD) - 2016/03/10 10:27:49 CET [2016/03/10 4:27:49 ET]
Table 'Solstice II' 9-max Seat #7 is the button
Seat 1: Rycious ($201.90 in chips) 
Seat 3: vano7777 ($200 in chips) 
Seat 4: matiko09 ($200 in chips) 
Seat 5: toprmaw ($209.25 in chips) 
Seat 6: thecurv ($208.06 in chips) 
Seat 7: WrongButton ($200 in chips) 
Seat 9: Monsthand ($210.96 in chips) 
Monsthand: posts small blind $1
Rycious: posts big blind $2
*** HOLE CARDS ***
Dealt to matiko09 [Th As]
vano7777: folds 
matiko09: raises $4 to $6
toprmaw: folds 
thecurv: folds 
WrongButton: calls $6
Monsthand: folds 
Rycious: folds 
*** FLOP *** [Ad 8s 3s]
matiko09: checks 
WrongButton: checks 
*** TURN *** [Ad 8s 3s] [Kh]
matiko09: bets $9.31
WrongButton: calls $9.31
*** RIVER *** [Ad 8s 3s Kh] [Ah]
matiko09: checks 
WrongButton: checks 
*** SHOW DOWN ***
matiko09: shows [Th As] (three of a kind, Aces)
WrongButton: mucks hand 
matiko09 collected $32.11 from pot
*** SUMMARY ***
Total pot $33.62 | Rake $1.51 
Board [Ad 8s 3s Kh Ah]
Seat 1: Rycious (big blind) folded before Flop
Seat 3: vano7777 folded before Flop (didn't bet)
Seat 4: matiko09 showed [Th As] and won ($32.11) with three of a kind, Aces
Seat 5: toprmaw folded before Flop (didn't bet)
Seat 6: thecurv folded before Flop (didn't bet)
Seat 7: WrongButton (button) mucked [Kc Tc]
Seat 9: Monsthand (small blind) folded before Flop





PokerStars Hand #150121215583:  Hold'em No Limit ($0.50/$1.00 USD) - 2016/03/10 10:27:52 CET [2016/03/10 4:27:52 ET]
Table 'Rarahu' 9-max Seat #1 is the button
Seat 1: matiko09 ($101.50 in chips) 
Seat 2: azzad2007 ($100 in chips) 
Seat 3: BKA12 ($100 in chips) 
Seat 4: vilo1070 ($116.57 in chips) 
Seat 5: blackw0lf_03 ($114.30 in chips) 
Seat 6: RMilPoker ($105.39 in chips) 
Seat 8: Rikti ($90.28 in chips) 
Seat 9: Srz7v44 ($115.34 in chips) 
azzad2007: posts small blind $0.50
BKA12: posts big blind $1
*** HOLE CARDS ***
Dealt to matiko09 [Tc 4c]
vilo1070: folds 
blackw0lf_03: raises $2 to $3
RMilPoker: folds 
Rikti: folds 
Srz7v44: folds 
matiko09: folds 
azzad2007: folds 
BKA12: folds 
Uncalled bet ($2) returned to blackw0lf_03
blackw0lf_03 collected $2.50 from pot
blackw0lf_03: doesn't show hand 
*** SUMMARY ***
Total pot $2.50 | Rake $0 
Seat 1: matiko09 (button) folded before Flop (didn't bet)
Seat 2: azzad2007 (small blind) folded before Flop
Seat 3: BKA12 (big blind) folded before Flop
Seat 4: vilo1070 folded before Flop (didn't bet)
Seat 5: blackw0lf_03 collected ($2.50)
Seat 6: RMilPoker folded before Flop (didn't bet)
Seat 8: Rikti folded before Flop (didn't bet)
Seat 9: Srz7v44 folded before Flop (didn't bet)





PokerStars Hand #150121216084:  Hold'em No Limit ($0.50/$1.00 USD) - 2016/03/10 10:27:53 CET [2016/03/10 4:27:53 ET]
Table 'Alsciaukat' 9-max Seat #9 is the button
Seat 1: Kelvin sai ($79 in chips) 
Seat 2: mycka86 ($101.50 in chips) 
Seat 3: blackw0lf_03 ($100 in chips) 
Seat 4: Rikti ($33 in chips) 
Seat 5: toprmaw ($115.92 in chips) 
Seat 6: Sweden_Pound ($101.50 in chips) 
Seat 7: Yaaaazz ($141.15 in chips) 
Seat 8: F1dgeT ($100 in chips) 
Seat 9: matiko09 ($104.38 in chips) 
Kelvin sai: posts small blind $0.50
mycka86: posts big blind $1
*** HOLE CARDS ***
Dealt to matiko09 [3s 6h]
blackw0lf_03: folds 
Rikti: folds 
toprmaw: raises $2 to $3
Sweden_Pound: folds 
Yaaaazz: folds 
F1dgeT: folds 
matiko09: folds 
Kelvin sai: folds 
mycka86: folds 
Uncalled bet ($2) returned to toprmaw
toprmaw collected $2.50 from pot
toprmaw: doesn't show hand 
*** SUMMARY ***
Total pot $2.50 | Rake $0 
Seat 1: Kelvin sai (small blind) folded before Flop
Seat 2: mycka86 (big blind) folded before Flop
Seat 3: blackw0lf_03 folded before Flop (didn't bet)
Seat 4: Rikti folded before Flop (didn't bet)
Seat 5: toprmaw collected ($2.50)
Seat 6: Sweden_Pound folded before Flop (didn't bet)
Seat 7: Yaaaazz folded before Flop (didn't bet)
Seat 8: F1dgeT folded before Flop (didn't bet)
Seat 9: matiko09 (button) folded before Flop (didn't bet)





PokerStars Hand #150121219463:  Hold'em No Limit (€0.25/€0.50 EUR) - 2016/03/10 10:28:02 CET [2016/03/10 4:28:02 ET]
Table 'Algorab' 9-max Seat #7 is the button
Seat 1: nubpoker (€50 in chips) 
Seat 3: dididi2000 (€38.99 in chips) 
Seat 4: Butcher1848 (€71 in chips) 
Seat 6: q3storm (€50 in chips) 
Seat 7: matiko09 (€92.63 in chips) 
Seat 8: fudzi (€50 in chips) 
fudzi: posts small blind €0.25
vlad11122007: is sitting out 
nubpoker: posts big blind €0.50
*** HOLE CARDS ***
Dealt to matiko09 [8h Tc]
dididi2000: folds 
Butcher1848: folds 
q3storm: folds 
matiko09: folds 
fudzi: folds 
Uncalled bet (€0.25) returned to nubpoker
nubpoker collected €0.50 from pot
nubpoker: doesn't show hand 
*** SUMMARY ***
Total pot €0.50 | Rake €0 
Seat 1: nubpoker (big blind) collected (€0.50)
Seat 3: dididi2000 folded before Flop (didn't bet)
Seat 4: Butcher1848 folded before Flop (didn't bet)
Seat 6: q3storm folded before Flop (didn't bet)
Seat 7: matiko09 (button) folded before Flop (didn't bet)
Seat 8: fudzi (small blind) folded before Flop





PokerStars Hand #150121220015:  Hold'em No Limit ($0.50/$1.00 USD) - 2016/03/10 10:28:04 CET [2016/03/10 4:28:04 ET]
Table 'Nereid' 9-max Seat #1 is the button
Seat 1: matiko09 ($100 in chips) 
Seat 3: mycka86 ($101.50 in chips) 
Seat 4: xiaoxiaoniao ($257.29 in chips) 
Seat 5: ilaviiitech ($103.50 in chips) 
Seat 6: thecurv ($108.26 in chips) 
Seat 7: Monsthand ($132.82 in chips) 
Seat 8: Rikti ($24.46 in chips) 
mycka86: posts small blind $0.50
xiaoxiaoniao: posts big blind $1
*** HOLE CARDS ***
Dealt to matiko09 [Js Jh]
ilaviiitech: folds 
thecurv: folds 
Monsthand: folds 
Rikti: folds 
matiko09: raises $1.27 to $2.27
mycka86: folds 
xiaoxiaoniao: raises $5.27 to $7.54
matiko09: calls $5.27
*** FLOP *** [8d 6s 4h]
xiaoxiaoniao: bets $4
matiko09: calls $4
*** TURN *** [8d 6s 4h] [Qs]
xiaoxiaoniao: checks 
matiko09: checks 
*** RIVER *** [8d 6s 4h Qs] [Tc]
xiaoxiaoniao: bets $13
matiko09: calls $13
*** SHOW DOWN ***
xiaoxiaoniao: shows [8h 8c] (three of a kind, Eights)
matiko09: mucks hand 
xiaoxiaoniao collected $47.35 from pot
*** SUMMARY ***
Total pot $49.58 | Rake $2.23 
Board [8d 6s 4h Qs Tc]
Seat 1: matiko09 (button) mucked [Js Jh]
Seat 3: mycka86 (small blind) folded before Flop
Seat 4: xiaoxiaoniao (big blind) showed [8h 8c] and won ($47.35) with three of a kind, Eights
Seat 5: ilaviiitech folded before Flop (didn't bet)
Seat 6: thecurv folded before Flop (didn't bet)
Seat 7: Monsthand folded before Flop (didn't bet)
Seat 8: Rikti folded before Flop (didn't bet)





PokerStars Hand #150121225026:  Hold'em No Limit ($0.50/$1.00 USD) - 2016/03/10 10:28:17 CET [2016/03/10 4:28:17 ET]
Table 'Ymir II' 9-max Seat #8 is the button
Seat 1: Monsthand ($100 in chips) 
Seat 2: toprmaw ($102.13 in chips) 
Seat 3: matiko09 ($100 in chips) 
Seat 4: blackw0lf_03 ($156.71 in chips) 
Seat 5: mycka86 ($100 in chips) 
Seat 6: RMilPoker ($110.53 in chips) 
Seat 8: Sweden_Pound ($122.75 in chips) 
Seat 9: Beni Ca$h ($99.70 in chips) 
Beni Ca$h: posts small blind $0.50
Monsthand: posts big blind $1
*** HOLE CARDS ***
Dealt to matiko09 [Kc 5c]
toprmaw: folds 
matiko09: folds 
toprmaw leaves the table
blackw0lf_03: folds 
mycka86: raises $1.50 to $2.50
RMilPoker: folds 
Sweden_Pound: folds 
Beni Ca$h: calls $2
Monsthand: folds 
*** FLOP *** [Jd 7s Qd]
Beni Ca$h: bets $3
mycka86: raises $3.87 to $6.87
er13to joins the table at seat #2 
Beni Ca$h: calls $3.87
*** TURN *** [Jd 7s Qd] [Qc]
Beni Ca$h: bets $10
mycka86: folds 
Uncalled bet ($10) returned to Beni Ca$h
Beni Ca$h collected $18.85 from pot
*** SUMMARY ***
Total pot $19.74 | Rake $0.89 
Board [Jd 7s Qd Qc]
Seat 1: Monsthand (big blind) folded before Flop
Seat 2: toprmaw folded before Flop (didn't bet)
Seat 3: matiko09 folded before Flop (didn't bet)
Seat 4: blackw0lf_03 folded before Flop (didn't bet)
Seat 5: mycka86 folded on the Turn
Seat 6: RMilPoker folded before Flop (didn't bet)
Seat 8: Sweden_Pound (button) folded before Flop (didn't bet)
Seat 9: Beni Ca$h (small blind) collected ($18.85)





PokerStars Hand #150121226670:  Hold'em No Limit ($0.50/$1.00 USD) - 2016/03/10 10:28:21 CET [2016/03/10 4:28:21 ET]
Table 'Alsciaukat' 9-max Seat #1 is the button
Seat 1: Kelvin sai ($78.50 in chips) 
Seat 2: mycka86 ($100.50 in chips) 
Seat 3: blackw0lf_03 ($100 in chips) 
Seat 4: Rikti ($33 in chips) 
Seat 5: toprmaw ($117.42 in chips) 
Seat 6: Sweden_Pound ($101.50 in chips) 
Seat 7: Yaaaazz ($141.15 in chips) 
Seat 8: F1dgeT ($100 in chips) 
Seat 9: matiko09 ($104.38 in chips) 
mycka86: posts small blind $0.50
blackw0lf_03: posts big blind $1
*** HOLE CARDS ***
Dealt to matiko09 [Ad 2d]
Rikti: folds 
toprmaw: folds 
Sweden_Pound: folds 
Yaaaazz: folds 
F1dgeT: folds 
matiko09: raises $1.50 to $2.50
Kelvin sai: calls $2.50
mycka86: folds 
blackw0lf_03: calls $1.50
*** FLOP *** [Kh Qh 7h]
blackw0lf_03: checks 
matiko09: checks 
Kelvin sai: bets $3
blackw0lf_03: folds 
matiko09: folds 
Uncalled bet ($3) returned to Kelvin sai
Kelvin sai collected $7.64 from pot
Kelvin sai: doesn't show hand 
*** SUMMARY ***
Total pot $8 | Rake $0.36 
Board [Kh Qh 7h]
Seat 1: Kelvin sai (button) collected ($7.64)
Seat 2: mycka86 (small blind) folded before Flop
Seat 3: blackw0lf_03 (big blind) folded on the Flop
Seat 4: Rikti folded before Flop (didn't bet)
Seat 5: toprmaw folded before Flop (didn't bet)
Seat 6: Sweden_Pound folded before Flop (didn't bet)
Seat 7: Yaaaazz folded before Flop (didn't bet)
Seat 8: F1dgeT folded before Flop (didn't bet)
Seat 9: matiko09 folded on the Flop





PokerStars Hand #150121228315:  Hold'em No Limit ($1/$2 USD) - 2016/03/10 10:28:26 CET [2016/03/10 4:28:26 ET]
Table 'Vesta' 9-max Seat #1 is the button
Seat 1: nickreason17 ($239.60 in chips) 
Seat 2: Pernilla E A ($220.11 in chips) 
Seat 3: matiko09 ($206.92 in chips) 
Seat 4: Yaaaazz ($223.40 in chips) 
Seat 6: djammusic ($557.69 in chips) 
Seat 7: Monsthand ($200 in chips) 
Seat 8: 13Ghosts ($299.47 in chips) 
Seat 9: lixiangli ($407.69 in chips) 
Pernilla E A: posts small blind $1
matiko09: posts big blind $2
*** HOLE CARDS ***
Dealt to matiko09 [2d 7c]
Yaaaazz: folds 
djammusic: folds 
Monsthand: raises $3.40 to $5.40
13Ghosts: calls $5.40
lixiangli: folds 
nickreason17: calls $5.40
Pernilla E A: folds 
matiko09: folds 
*** FLOP *** [7s 4d 3s]
Monsthand: checks 
13Ghosts: bets $13.75
nickreason17: folds 
Monsthand: folds 
Uncalled bet ($13.75) returned to 13Ghosts
13Ghosts collected $18.34 from pot
13Ghosts: doesn't show hand 
*** SUMMARY ***
Total pot $19.20 | Rake $0.86 
Board [7s 4d 3s]
Seat 1: nickreason17 (button) folded on the Flop
Seat 2: Pernilla E A (small blind) folded before Flop
Seat 3: matiko09 (big blind) folded before Flop
Seat 4: Yaaaazz folded before Flop (didn't bet)
Seat 6: djammusic folded before Flop (didn't bet)
Seat 7: Monsthand folded on the Flop
Seat 8: 13Ghosts collected ($18.34)
Seat 9: lixiangli folded before Flop (didn't bet)





PokerStars Hand #150121229022:  Hold'em No Limit ($0.25/$0.50 USD) - 2016/03/10 10:28:28 CET [2016/03/10 4:28:28 ET]
Table 'Aegina' 9-max Seat #7 is the button
Seat 1: Wess_1970 ($95.77 in chips) 
Seat 2: el.suertero ($137.19 in chips) 
Seat 3: matiko09 ($50 in chips) 
Seat 5: depokerlord ($73.88 in chips) 
Seat 6: ardo888 ($147.94 in chips) 
Seat 7: Bohne0815 ($77.84 in chips) 
Seat 8: q3storm ($50 in chips) 
Seat 9: i L00K great ($55.74 in chips) 
q3storm: posts small blind $0.25
i L00K great: posts big blind $0.50
Wess_1970: posts the ante $0.10
el.suertero: posts the ante $0.10
matiko09: posts the ante $0.10
depokerlord: posts the ante $0.10
ardo888: posts the ante $0.10
Bohne0815: posts the ante $0.10
q3storm: posts the ante $0.10
i L00K great: posts the ante $0.10
*** HOLE CARDS ***
Dealt to matiko09 [4s 6h]
Wess_1970: folds 
el.suertero: folds 
matiko09: folds 
depokerlord: calls $0.50
ardo888: raises $2 to $2.50
Bohne0815: folds 
q3storm: folds 
i L00K great: folds 
depokerlord: calls $2
*** FLOP *** [5c 3d 5h]
depokerlord: checks 
ardo888: bets $2.50
depokerlord: calls $2.50
*** TURN *** [5c 3d 5h] [Th]
depokerlord: checks 
ardo888: bets $5.84
depokerlord: calls $5.84
*** RIVER *** [5c 3d 5h Th] [Ts]
depokerlord: checks 
ardo888: bets $16.19
depokerlord: calls $16.19
*** SHOW DOWN ***
ardo888: shows [Td Jd] (a full house, Tens full of Fives)
depokerlord: mucks hand 
ardo888 collected $53.11 from pot
*** SUMMARY ***
Total pot $55.61 | Rake $2.50 
Board [5c 3d 5h Th Ts]
Seat 1: Wess_1970 folded before Flop (didn't bet)
Seat 2: el.suertero folded before Flop (didn't bet)
Seat 3: matiko09 folded before Flop (didn't bet)
Seat 5: depokerlord mucked [9s 9c]
Seat 6: ardo888 showed [Td Jd] and won ($53.11) with a full house, Tens full of Fives
Seat 7: Bohne0815 (button) folded before Flop (didn't bet)
Seat 8: q3storm (small blind) folded before Flop
Seat 9: i L00K great (big blind) folded before Flop





PokerStars Hand #150121229834:  Hold'em No Limit (€0.25/€0.50 EUR) - 2016/03/10 10:28:30 CET [2016/03/10 4:28:30 ET]
Table 'Algorab' 9-max Seat #8 is the button
Seat 1: nubpoker (€50.25 in chips) 
Seat 3: dididi2000 (€38.99 in chips) 
Seat 4: Butcher1848 (€71 in chips) 
Seat 6: q3storm (€50 in chips) 
Seat 7: matiko09 (€92.63 in chips) 
Seat 8: fudzi (€50 in chips) 
nubpoker: posts small blind €0.25
dididi2000: posts big blind €0.50
*** HOLE CARDS ***
Dealt to matiko09 [Td 2c]
Butcher1848: folds 
q3storm: folds 
matiko09: folds 
fudzi: raises €1 to €1.50
nubpoker: folds 
dididi2000: folds 
Uncalled bet (€1) returned to fudzi
fudzi collected €1.25 from pot
fudzi: doesn't show hand 
*** SUMMARY ***
Total pot €1.25 | Rake €0 
Seat 1: nubpoker (small blind) folded before Flop
Seat 3: dididi2000 (big blind) folded before Flop
Seat 4: Butcher1848 folded before Flop (didn't bet)
Seat 6: q3storm folded before Flop (didn't bet)
Seat 7: matiko09 folded before Flop (didn't bet)
Seat 8: fudzi (button) collected (€1.25)





PokerStars Hand #150121231225:  Hold'em No Limit ($0.50/$1.00 USD) - 2016/03/10 10:28:33 CET [2016/03/10 4:28:33 ET]
Table 'Rarahu' 9-max Seat #2 is the button
Seat 1: matiko09 ($101.50 in chips) 
Seat 2: azzad2007 ($100 in chips) 
Seat 3: BKA12 ($100 in chips) 
Seat 4: vilo1070 ($116.57 in chips) 
Seat 5: blackw0lf_03 ($115.80 in chips) 
Seat 6: RMilPoker ($105.39 in chips) 
Seat 8: Rikti ($90.28 in chips) 
Seat 9: Srz7v44 ($115.34 in chips) 
BKA12: posts small blind $0.50
vilo1070: posts big blind $1
*** HOLE CARDS ***
Dealt to matiko09 [Qd 3s]
blackw0lf_03: folds 
RMilPoker: folds 
Rikti: folds 
Srz7v44: folds 
matiko09: folds 
azzad2007: folds 
BKA12: folds 
Uncalled bet ($0.50) returned to vilo1070
vilo1070 collected $1 from pot
vilo1070: doesn't show hand 
*** SUMMARY ***
Total pot $1 | Rake $0 
Seat 1: matiko09 folded before Flop (didn't bet)
Seat 2: azzad2007 (button) folded before Flop (didn't bet)
Seat 3: BKA12 (small blind) folded before Flop
Seat 4: vilo1070 (big blind) collected ($1)
Seat 5: blackw0lf_03 folded before Flop (didn't bet)
Seat 6: RMilPoker folded before Flop (didn't bet)
Seat 8: Rikti folded before Flop (didn't bet)
Seat 9: Srz7v44 folded before Flop (didn't bet)





PokerStars Hand #150121232232:  Hold'em No Limit ($1/$2 USD) - 2016/03/10 10:28:36 CET [2016/03/10 4:28:36 ET]
Table 'Tauris II' 9-max Seat #7 is the button
Seat 1: toprmaw ($268.49 in chips) 
Seat 2: nickreason17 ($208.67 in chips) 
Seat 3: BOAYARSKIY ($77 in chips) 
Seat 4: matiko09 ($377.78 in chips) 
Seat 5: Spudly6 ($165.52 in chips) 
Seat 6: Yaaaazz ($221.79 in chips) 
Seat 7: Monsthand ($222.85 in chips) 
Seat 8: WrongButton ($254.38 in chips) 
Seat 9: darren1031 ($163.90 in chips) 
WrongButton: posts small blind $1
darren1031: posts big blind $2
*** HOLE CARDS ***
Dealt to matiko09 [8d Ks]
toprmaw: folds 
nickreason17: folds 
BOAYARSKIY: raises $3 to $5
matiko09: folds 
Spudly6: calls $5
Yaaaazz: folds 
Monsthand: folds 
WrongButton: folds 
darren1031: calls $3
*** FLOP *** [Ac 2c 2s]
darren1031: checks 
BOAYARSKIY: bets $10
Spudly6: calls $10
darren1031: folds 
*** TURN *** [Ac 2c 2s] [5s]
BOAYARSKIY: checks 
Spudly6: bets $16
BOAYARSKIY: calls $16
*** RIVER *** [Ac 2c 2s 5s] [8s]
BOAYARSKIY: checks 
Spudly6: bets $64
BOAYARSKIY: folds 
Uncalled bet ($64) returned to Spudly6
Spudly6 collected $65.20 from pot
Spudly6: doesn't show hand 
*** SUMMARY ***
Total pot $68 | Rake $2.80 
Board [Ac 2c 2s 5s 8s]
Seat 1: toprmaw folded before Flop (didn't bet)
Seat 2: nickreason17 folded before Flop (didn't bet)
Seat 3: BOAYARSKIY folded on the River
Seat 4: matiko09 folded before Flop (didn't bet)
Seat 5: Spudly6 collected ($65.20)
Seat 6: Yaaaazz folded before Flop (didn't bet)
Seat 7: Monsthand (button) folded before Flop (didn't bet)
Seat 8: WrongButton (small blind) folded before Flop
Seat 9: darren1031 (big blind) folded on the Flop





PokerStars Hand #150121234139:  Hold'em No Limit ($1/$2 USD) - 2016/03/10 10:28:41 CET [2016/03/10 4:28:41 ET]
Table 'Archid' 9-max Seat #4 is the button
Seat 1: AP3221 ($114.77 in chips) 
Seat 2: geiranger011 ($87.64 in chips) 
Seat 3: sarkat104 ($257.63 in chips) 
Seat 4: Monsthand ($200.37 in chips) 
Seat 5: toprmaw ($209 in chips) 
Seat 6: BOAYARSKIY ($80 in chips) 
Seat 7: maxxmeister ($200 in chips) 
Seat 8: matiko09 ($230.23 in chips) 
Seat 9: WrongButton ($211.29 in chips) 
toprmaw: posts small blind $1
BOAYARSKIY: posts big blind $2
*** HOLE CARDS ***
Dealt to matiko09 [4c 8s]
maxxmeister: folds 
maxxmeister leaves the table
matiko09: folds 
WrongButton: folds 
AP3221: folds 
geiranger011: folds 
sarkat104: folds 
Monsthand: folds 
toprmaw: folds 
Uncalled bet ($1) returned to BOAYARSKIY
BOAYARSKIY collected $2 from pot
BOAYARSKIY: doesn't show hand 
*** SUMMARY ***
Total pot $2 | Rake $0 
Seat 1: AP3221 folded before Flop (didn't bet)
Seat 2: geiranger011 folded before Flop (didn't bet)
Seat 3: sarkat104 folded before Flop (didn't bet)
Seat 4: Monsthand (button) folded before Flop (didn't bet)
Seat 5: toprmaw (small blind) folded before Flop
Seat 6: BOAYARSKIY (big blind) collected ($2)
Seat 7: maxxmeister folded before Flop (didn't bet)
Seat 8: matiko09 folded before Flop (didn't bet)
Seat 9: WrongButton folded before Flop (didn't bet)





PokerStars Hand #150121238237:  Hold'em No Limit ($1/$2 USD) - 2016/03/10 10:28:52 CET [2016/03/10 4:28:52 ET]
Table 'Solstice II' 9-max Seat #9 is the button
Seat 1: Rycious ($199.90 in chips) 
Seat 3: vano7777 ($200 in chips) 
Seat 4: matiko09 ($216.80 in chips) 
Seat 5: toprmaw ($209.25 in chips) 
Seat 6: thecurv ($208.06 in chips) 
Seat 7: WrongButton ($200 in chips) 
Seat 9: Monsthand ($209.96 in chips) 
Rycious: posts small blind $1
vano7777: posts big blind $2
*** HOLE CARDS ***
Dealt to matiko09 [Qd Qh]
matiko09: raises $4 to $6
toprmaw: raises $10.40 to $16.40
thecurv: folds 
WrongButton: folds 
Monsthand: folds 
Rycious: folds 
vano7777: folds 
matiko09: calls $10.40
*** FLOP *** [Tc Th 4d]
matiko09: checks 
toprmaw: checks 
*** TURN *** [Tc Th 4d] [Kh]
matiko09: checks 
toprmaw: bets $24
matiko09: folds 
Uncalled bet ($24) returned to toprmaw
toprmaw collected $34.19 from pot
toprmaw: doesn't show hand 
*** SUMMARY ***
Total pot $35.80 | Rake $1.61 
Board [Tc Th 4d Kh]
Seat 1: Rycious (small blind) folded before Flop
Seat 3: vano7777 (big blind) folded before Flop
Seat 4: matiko09 folded on the Turn
Seat 5: toprmaw collected ($34.19)
Seat 6: thecurv folded before Flop (didn't bet)
Seat 7: WrongButton folded before Flop (didn't bet)
Seat 9: Monsthand (button) folded before Flop (didn't bet)





PokerStars Hand #150121241197:  Hold'em No Limit (€0.25/€0.50 EUR) - 2016/03/10 10:29:00 CET [2016/03/10 4:29:00 ET]
Table 'Algorab' 9-max Seat #1 is the button
Seat 1: nubpoker (€50 in chips) 
Seat 3: dididi2000 (€38.49 in chips) 
Seat 4: Butcher1848 (€71 in chips) 
Seat 6: q3storm (€50 in chips) 
Seat 7: matiko09 (€92.63 in chips) 
Seat 8: fudzi (€50.75 in chips) 
dididi2000: posts small blind €0.25
Butcher1848: posts big blind €0.50
*** HOLE CARDS ***
Dealt to matiko09 [5h Jc]
q3storm: folds 
matiko09: folds 
fudzi: folds 
nubpoker: raises €0.75 to €1.25
dididi2000: calls €1
Butcher1848: folds 
*** FLOP *** [As Kc 6h]
dididi2000: checks 
nubpoker: checks 
*** TURN *** [As Kc 6h] [9h]
dididi2000: bets €1.50
nubpoker: folds 
Uncalled bet (€1.50) returned to dididi2000
dididi2000 collected €2.86 from pot
dididi2000: doesn't show hand 
*** SUMMARY ***
Total pot €3 | Rake €0.14 
Board [As Kc 6h 9h]
Seat 1: nubpoker (button) folded on the Turn
Seat 3: dididi2000 (small blind) collected (€2.86)
Seat 4: Butcher1848 (big blind) folded before Flop
Seat 6: q3storm folded before Flop (didn't bet)
Seat 7: matiko09 folded before Flop (didn't bet)
Seat 8: fudzi folded before Flop (didn't bet)





PokerStars Hand #150121241646:  Hold'em No Limit ($0.50/$1.00 USD) - 2016/03/10 10:29:01 CET [2016/03/10 4:29:01 ET]
Table 'Rarahu' 9-max Seat #3 is the button
Seat 1: matiko09 ($101.50 in chips) 
Seat 2: azzad2007 ($100 in chips) 
Seat 3: BKA12 ($100 in chips) 
Seat 4: vilo1070 ($117.07 in chips) 
Seat 5: blackw0lf_03 ($115.80 in chips) 
Seat 6: RMilPoker ($105.39 in chips) 
Seat 8: Rikti ($90.28 in chips) 
Seat 9: Srz7v44 ($115.34 in chips) 
vilo1070: posts small blind $0.50
blackw0lf_03: posts big blind $1
*** HOLE CARDS ***
Dealt to matiko09 [2h 6s]
RMilPoker: folds 
Rikti: folds 
Srz7v44: raises $2 to $3
matiko09: folds 
azzad2007: folds 
BKA12: folds 
vilo1070: folds 
blackw0lf_03: folds 
Uncalled bet ($2) returned to Srz7v44
Srz7v44 collected $2.50 from pot
*** SUMMARY ***
Total pot $2.50 | Rake $0 
Seat 1: matiko09 folded before Flop (didn't bet)
Seat 2: azzad2007 folded before Flop (didn't bet)
Seat 3: BKA12 (button) folded before Flop (didn't bet)
Seat 4: vilo1070 (small blind) folded before Flop
Seat 5: blackw0lf_03 (big blind) folded before Flop
Seat 6: RMilPoker folded before Flop (didn't bet)
Seat 8: Rikti folded before Flop (didn't bet)
Seat 9: Srz7v44 collected ($2.50)





PokerStars Hand #150121247511:  Hold'em No Limit ($1/$2 USD) - 2016/03/10 10:29:16 CET [2016/03/10 4:29:16 ET]
Table 'Vesta' 9-max Seat #2 is the button
Seat 1: nickreason17 ($234.20 in chips) 
Seat 2: Pernilla E A ($219.11 in chips) 
Seat 3: matiko09 ($204.92 in chips) 
Seat 4: Yaaaazz ($223.40 in chips) 
Seat 6: djammusic ($557.69 in chips) 
Seat 7: Monsthand ($200 in chips) 
Seat 8: 13Ghosts ($312.41 in chips) 
Seat 9: lixiangli ($407.69 in chips) 
matiko09: posts small blind $1
Yaaaazz: posts big blind $2
*** HOLE CARDS ***
Dealt to matiko09 [Kc 3h]
djammusic: folds 
Monsthand: folds 
13Ghosts: folds 
lixiangli: folds 
nickreason17: folds 
Pernilla E A: raises $2 to $4
matiko09: folds 
Yaaaazz: calls $2
*** FLOP *** [5h 8h 2h]
Yaaaazz: checks 
Pernilla E A: bets $8.60
Yaaaazz: folds 
Uncalled bet ($8.60) returned to Pernilla E A
Pernilla E A collected $8.60 from pot
*** SUMMARY ***
Total pot $9 | Rake $0.40 
Board [5h 8h 2h]
Seat 1: nickreason17 folded before Flop (didn't bet)
Seat 2: Pernilla E A (button) collected ($8.60)
Seat 3: matiko09 (small blind) folded before Flop
Seat 4: Yaaaazz (big blind) folded on the Flop
Seat 6: djammusic folded before Flop (didn't bet)
Seat 7: Monsthand folded before Flop (didn't bet)
Seat 8: 13Ghosts folded before Flop (didn't bet)
Seat 9: lixiangli folded before Flop (didn't bet)





PokerStars Hand #150121249751:  Hold'em No Limit ($1/$2 USD) - 2016/03/10 10:29:22 CET [2016/03/10 4:29:22 ET]
Table 'Sophia II' 9-max Seat #4 is the button
Seat 2: nickreason17 ($212.71 in chips) 
Seat 4: hejun0713 ($179.36 in chips) 
Seat 5: matiko09 ($212 in chips) 
Seat 6: WrongButton ($378.86 in chips) 
Seat 7: Monsthand ($380.32 in chips) 
Seat 8: BOAYARSKIY ($77 in chips) 
Seat 9: CARDNAPPED ($53.93 in chips) 
matiko09: posts small blind $1
WrongButton: posts big blind $2
toprmaw: sits out 
*** HOLE CARDS ***
Dealt to matiko09 [Qs 9s]
Monsthand: folds 
BOAYARSKIY: folds 
CARDNAPPED: calls $2
nickreason17: folds 
hejun0713: raises $6 to $8
matiko09: folds 
WrongButton: folds 
CARDNAPPED: calls $6
*** FLOP *** [6c Qc 7d]
docwark joins the table at seat #3 
CARDNAPPED: checks 
hejun0713: bets $9.07
CARDNAPPED: folds 
Uncalled bet ($9.07) returned to hejun0713
hejun0713 collected $18.14 from pot
hejun0713: doesn't show hand 
*** SUMMARY ***
Total pot $19 | Rake $0.86 
Board [6c Qc 7d]
Seat 2: nickreason17 folded before Flop (didn't bet)
Seat 4: hejun0713 (button) collected ($18.14)
Seat 5: matiko09 (small blind) folded before Flop
Seat 6: WrongButton (big blind) folded before Flop
Seat 7: Monsthand folded before Flop (didn't bet)
Seat 8: BOAYARSKIY folded before Flop (didn't bet)
Seat 9: CARDNAPPED folded on the Flop





PokerStars Hand #150121250078:  Hold'em No Limit ($1/$2 USD) - 2016/03/10 10:29:23 CET [2016/03/10 4:29:23 ET]
Table 'Archid' 9-max Seat #5 is the button
Seat 1: AP3221 ($114.77 in chips) 
Seat 2: geiranger011 ($87.64 in chips) 
Seat 3: sarkat104 ($257.63 in chips) 
Seat 4: Monsthand ($200.37 in chips) 
Seat 5: toprmaw ($208 in chips) 
Seat 6: BOAYARSKIY ($81 in chips) 
Seat 8: matiko09 ($230.23 in chips) 
Seat 9: WrongButton ($211.29 in chips) 
BOAYARSKIY: posts small blind $1
matiko09: posts big blind $2
*** HOLE CARDS ***
Dealt to matiko09 [8d 7c]
WrongButton: folds 
AP3221: folds 
geiranger011: raises $3 to $5
sarkat104: folds 
Monsthand: folds 
toprmaw: folds 
BOAYARSKIY: folds 
matiko09: folds 
Uncalled bet ($3) returned to geiranger011
geiranger011 collected $5 from pot
geiranger011: doesn't show hand 
*** SUMMARY ***
Total pot $5 | Rake $0 
Seat 1: AP3221 folded before Flop (didn't bet)
Seat 2: geiranger011 collected ($5)
Seat 3: sarkat104 folded before Flop (didn't bet)
Seat 4: Monsthand folded before Flop (didn't bet)
Seat 5: toprmaw (button) folded before Flop (didn't bet)
Seat 6: BOAYARSKIY (small blind) folded before Flop
Seat 8: matiko09 (big blind) folded before Flop
Seat 9: WrongButton folded before Flop (didn't bet)





PokerStars Hand #150121250009:  Hold'em No Limit ($0.50/$1.00 USD) - 2016/03/10 10:29:23 CET [2016/03/10 4:29:23 ET]
Table 'Ymir II' 9-max Seat #9 is the button
Seat 1: Monsthand ($100 in chips) 
Seat 2: er13to ($100 in chips) 
Seat 3: matiko09 ($100 in chips) 
Seat 4: blackw0lf_03 ($156.71 in chips) 
Seat 5: mycka86 ($100 in chips) 
Seat 6: RMilPoker ($110.53 in chips) 
Seat 8: Sweden_Pound ($122.75 in chips) 
Seat 9: Beni Ca$h ($109.18 in chips) 
Monsthand: posts small blind $0.50
er13to: posts big blind $1
*** HOLE CARDS ***
Dealt to matiko09 [9s 6c]
matiko09: folds 
blackw0lf_03: folds 
mycka86: folds 
RMilPoker: folds 
Sweden_Pound: folds 
Beni Ca$h: folds 
Monsthand: raises $2 to $3
er13to: calls $2
*** FLOP *** [3c As Qh]
Monsthand: checks 
er13to: bets $2.98
Monsthand: calls $2.98
*** TURN *** [3c As Qh] [Ts]
Monsthand: checks 
er13to: checks 
*** RIVER *** [3c As Qh Ts] [4c]
Monsthand: checks 
er13to: checks 
*** SHOW DOWN ***
Monsthand: shows [Qs Kh] (a pair of Queens)
er13to: mucks hand 
Monsthand collected $11.42 from pot
*** SUMMARY ***
Total pot $11.96 | Rake $0.54 
Board [3c As Qh Ts 4c]
Seat 1: Monsthand (small blind) showed [Qs Kh] and won ($11.42) with a pair of Queens
Seat 2: er13to (big blind) mucked [Js Tc]
Seat 3: matiko09 folded before Flop (didn't bet)
Seat 4: blackw0lf_03 folded before Flop (didn't bet)
Seat 5: mycka86 folded before Flop (didn't bet)
Seat 6: RMilPoker folded before Flop (didn't bet)
Seat 8: Sweden_Pound folded before Flop (didn't bet)
Seat 9: Beni Ca$h (button) folded before Flop (didn't bet)





PokerStars Hand #150121251316:  Hold'em No Limit ($0.50/$1.00 USD) - 2016/03/10 10:29:26 CET [2016/03/10 4:29:26 ET]
Table 'Nereid' 9-max Seat #3 is the button
Seat 1: matiko09 ($100 in chips) 
Seat 3: mycka86 ($101 in chips) 
Seat 4: xiaoxiaoniao ($280.10 in chips) 
Seat 5: ilaviiitech ($103.50 in chips) 
Seat 6: thecurv ($108.26 in chips) 
Seat 7: Monsthand ($132.82 in chips) 
Seat 8: Rikti ($24.46 in chips) 
xiaoxiaoniao: posts small blind $0.50
ilaviiitech: posts big blind $1
*** HOLE CARDS ***
Dealt to matiko09 [4d As]
thecurv: folds 
Monsthand: folds 
Rikti: folds 
matiko09: folds 
mycka86: folds 
xiaoxiaoniao: folds 
Uncalled bet ($0.50) returned to ilaviiitech
ilaviiitech collected $1 from pot
ilaviiitech: doesn't show hand 
*** SUMMARY ***
Total pot $1 | Rake $0 
Seat 1: matiko09 folded before Flop (didn't bet)
Seat 3: mycka86 (button) folded before Flop (didn't bet)
Seat 4: xiaoxiaoniao (small blind) folded before Flop
Seat 5: ilaviiitech (big blind) collected ($1)
Seat 6: thecurv folded before Flop (didn't bet)
Seat 7: Monsthand folded before Flop (didn't bet)
Seat 8: Rikti folded before Flop (didn't bet)





PokerStars Hand #150121251236:  Hold'em No Limit ($0.50/$1.00 USD) - 2016/03/10 10:29:26 CET [2016/03/10 4:29:26 ET]
Table 'Leda II' 9-max Seat #2 is the button
Seat 1: DIMAN_324 ($100 in chips) 
Seat 2: corsair888 ($100 in chips) 
Seat 4: Zier89 ($105.46 in chips) 
Seat 5: matiko09 ($100 in chips) 
Seat 6: AlKatrone ($182.99 in chips) 
Seat 7: BKA12 ($100 in chips) 
Seat 8: peppsta ($84.35 in chips) 
Seat 9: Yaaaazz ($107.21 in chips) 
Zier89: posts small blind $0.50
matiko09: posts big blind $1
*** HOLE CARDS ***
Dealt to matiko09 [Jh 9d]
AlKatrone: folds 
BKA12: folds 
peppsta: folds 
Yaaaazz: folds 
DIMAN_324: folds 
corsair888: folds 
Zier89: calls $0.50
matiko09: raises $3 to $4
Zier89: calls $3
*** FLOP *** [8s Ah 9s]
Zier89: bets $4
matiko09: calls $4
*** TURN *** [8s Ah 9s] [2h]
Zier89: bets $3
matiko09: calls $3
*** RIVER *** [8s Ah 9s 2h] [7h]
Zier89: checks 
matiko09: checks 
*** SHOW DOWN ***
Zier89: shows [7d 5d] (a pair of Sevens)
matiko09: shows [Jh 9d] (a pair of Nines)
matiko09 collected $21.01 from pot
*** SUMMARY ***
Total pot $22 | Rake $0.99 
Board [8s Ah 9s 2h 7h]
Seat 1: DIMAN_324 folded before Flop (didn't bet)
Seat 2: corsair888 (button) folded before Flop (didn't bet)
Seat 4: Zier89 (small blind) showed [7d 5d] and lost with a pair of Sevens
Seat 5: matiko09 (big blind) showed [Jh 9d] and won ($21.01) with a pair of Nines
Seat 6: AlKatrone folded before Flop (didn't bet)
Seat 7: BKA12 folded before Flop (didn't bet)
Seat 8: peppsta folded before Flop (didn't bet)
Seat 9: Yaaaazz folded before Flop (didn't bet)





PokerStars Hand #150121255271:  Hold'em No Limit ($0.25/$0.50 USD) - 2016/03/10 10:29:37 CET [2016/03/10 4:29:37 ET]
Table 'Aegina' 9-max Seat #8 is the button
Seat 1: Wess_1970 ($95.67 in chips) 
Seat 2: el.suertero ($137.09 in chips) 
Seat 3: matiko09 ($50 in chips) 
Seat 5: depokerlord ($46.75 in chips) 
Seat 6: ardo888 ($173.92 in chips) 
Seat 7: Bohne0815 ($77.74 in chips) 
Seat 8: q3storm ($50 in chips) 
Seat 9: i L00K great ($55.14 in chips) 
i L00K great: posts small blind $0.25
Wess_1970: posts big blind $0.50
Wess_1970: posts the ante $0.10
el.suertero: posts the ante $0.10
matiko09: posts the ante $0.10
depokerlord: posts the ante $0.10
ardo888: posts the ante $0.10
Bohne0815: posts the ante $0.10
q3storm: posts the ante $0.10
i L00K great: posts the ante $0.10
*** HOLE CARDS ***
Dealt to matiko09 [9d 5c]
el.suertero: raises $1 to $1.50
matiko09: folds 
depokerlord: raises $4.55 to $6.05
ardo888: folds 
Bohne0815 is disconnected 
Bohne0815 is connected 
Bohne0815: folds 
q3storm: folds 
i L00K great: folds 
Wess_1970: calls $5.55
el.suertero: calls $4.55
*** FLOP *** [8h 6d 2s]
Wess_1970: checks 
el.suertero: checks 
depokerlord: bets $9
Wess_1970: calls $9
el.suertero: folds 
*** TURN *** [8h 6d 2s] [Kc]
Wess_1970: checks 
depokerlord: checks 
*** RIVER *** [8h 6d 2s Kc] [2h]
Wess_1970: checks 
depokerlord: checks 
*** SHOW DOWN ***
Wess_1970: shows [Qc As] (a pair of Deuces)
depokerlord: shows [8s 4c] (two pair, Eights and Deuces)
depokerlord collected $35.53 from pot
*** SUMMARY ***
Total pot $37.20 | Rake $1.67 
Board [8h 6d 2s Kc 2h]
Seat 1: Wess_1970 (big blind) showed [Qc As] and lost with a pair of Deuces
Seat 2: el.suertero folded on the Flop
Seat 3: matiko09 folded before Flop (didn't bet)
Seat 5: depokerlord showed [8s 4c] and won ($35.53) with two pair, Eights and Deuces
Seat 6: ardo888 folded before Flop (didn't bet)
Seat 7: Bohne0815 folded before Flop (didn't bet)
Seat 8: q3storm (button) folded before Flop (didn't bet)
Seat 9: i L00K great (small blind) folded before Flop





PokerStars Hand #150121257446:  Hold'em No Limit ($0.50/$1.00 USD) - 2016/03/10 10:29:43 CET [2016/03/10 4:29:43 ET]
Table 'Rarahu' 9-max Seat #4 is the button
Seat 1: matiko09 ($101.50 in chips) 
Seat 2: azzad2007 ($100 in chips) 
Seat 3: BKA12 ($100 in chips) 
Seat 4: vilo1070 ($116.57 in chips) 
Seat 5: blackw0lf_03 ($114.80 in chips) 
Seat 6: RMilPoker ($105.39 in chips) 
Seat 8: Rikti ($90.28 in chips) 
Seat 9: Srz7v44 ($116.84 in chips) 
blackw0lf_03: posts small blind $0.50
RMilPoker: posts big blind $1
*** HOLE CARDS ***
Dealt to matiko09 [4s Jc]
Rikti: raises $2 to $3
Srz7v44: calls $3
matiko09: folds 
azzad2007: folds 
BKA12: folds 
vilo1070: folds 
blackw0lf_03: folds 
RMilPoker: folds 
*** FLOP *** [4d Ts Jd]
Rikti: bets $5
Srz7v44: calls $5
*** TURN *** [4d Ts Jd] [Th]
Rikti: checks 
Srz7v44: checks 
*** RIVER *** [4d Ts Jd Th] [3c]
Rikti: bets $9
Srz7v44: calls $9
*** SHOW DOWN ***
Rikti: shows [8d 7d] (a pair of Tens)
Srz7v44: shows [As Kd] (a pair of Tens - Ace kicker)
Srz7v44 collected $33.90 from pot
*** SUMMARY ***
Total pot $35.50 | Rake $1.60 
Board [4d Ts Jd Th 3c]
Seat 1: matiko09 folded before Flop (didn't bet)
Seat 2: azzad2007 folded before Flop (didn't bet)
Seat 3: BKA12 folded before Flop (didn't bet)
Seat 4: vilo1070 (button) folded before Flop (didn't bet)
Seat 5: blackw0lf_03 (small blind) folded before Flop
Seat 6: RMilPoker (big blind) folded before Flop
Seat 8: Rikti showed [8d 7d] and lost with a pair of Tens
Seat 9: Srz7v44 showed [As Kd] and won ($33.90) with a pair of Tens





PokerStars Hand #150121262700:  Hold'em No Limit ($0.50/$1.00 USD) - 2016/03/10 10:29:57 CET [2016/03/10 4:29:57 ET]
Table 'Nereid' 9-max Seat #4 is the button
Seat 1: matiko09 ($100 in chips) 
Seat 3: mycka86 ($101 in chips) 
Seat 4: xiaoxiaoniao ($279.60 in chips) 
Seat 5: ilaviiitech ($104 in chips) 
Seat 6: thecurv ($108.26 in chips) 
Seat 7: Monsthand ($132.82 in chips) 
Seat 8: Rikti ($24.46 in chips) 
ilaviiitech: posts small blind $0.50
thecurv: posts big blind $1
*** HOLE CARDS ***
Dealt to matiko09 [9h Jc]
Monsthand: folds 
Rikti: folds 
matiko09: folds 
mycka86: folds 
xiaoxiaoniao: folds 
ilaviiitech: folds 
Uncalled bet ($0.50) returned to thecurv
thecurv collected $1 from pot
thecurv: doesn't show hand 
*** SUMMARY ***
Total pot $1 | Rake $0 
Seat 1: matiko09 folded before Flop (didn't bet)
Seat 3: mycka86 folded before Flop (didn't bet)
Seat 4: xiaoxiaoniao (button) folded before Flop (didn't bet)
Seat 5: ilaviiitech (small blind) folded before Flop
Seat 6: thecurv (big blind) collected ($1)
Seat 7: Monsthand folded before Flop (didn't bet)
Seat 8: Rikti folded before Flop (didn't bet)





PokerStars Hand #150121265376:  Hold'em No Limit (€0.25/€0.50 EUR) - 2016/03/10 10:30:04 CET [2016/03/10 4:30:04 ET]
Table 'Algorab' 9-max Seat #3 is the button
Seat 1: nubpoker (€50 in chips) 
Seat 3: dididi2000 (€40.10 in chips) 
Seat 4: Butcher1848 (€70.50 in chips) 
Seat 6: q3storm (€50 in chips) 
Seat 7: matiko09 (€92.63 in chips) 
Seat 8: fudzi (€50.75 in chips) 
Butcher1848: posts small blind €0.25
q3storm: posts big blind €0.50
*** HOLE CARDS ***
Dealt to matiko09 [2h 3h]
IvanUrgant was removed from the table for failing to post
matiko09: folds 
fudzi: folds 
nubpoker: folds 
dididi2000: raises €1 to €1.50
Butcher1848: folds 
q3storm: calls €1
*** FLOP *** [Tc 4s 2c]
q3storm: checks 
dididi2000: bets €2.50
q3storm: folds 
Uncalled bet (€2.50) returned to dididi2000
dididi2000 collected €3.10 from pot
dididi2000: doesn't show hand 
*** SUMMARY ***
Total pot €3.25 | Rake €0.15 
Board [Tc 4s 2c]
Seat 1: nubpoker folded before Flop (didn't bet)
Seat 3: dididi2000 (button) collected (€3.10)
Seat 4: Butcher1848 (small blind) folded before Flop
Seat 6: q3storm (big blind) folded on the Flop
Seat 7: matiko09 folded before Flop (didn't bet)
Seat 8: fudzi folded before Flop (didn't bet)





PokerStars Hand #150121268094:  Hold'em No Limit ($1/$2 USD) - 2016/03/10 10:30:11 CET [2016/03/10 4:30:11 ET]
Table 'Sophia II' 9-max Seat #5 is the button
Seat 2: nickreason17 ($212.71 in chips) 
Seat 4: hejun0713 ($189.50 in chips) 
Seat 5: matiko09 ($211 in chips) 
Seat 6: WrongButton ($376.86 in chips) 
Seat 7: Monsthand ($380.32 in chips) 
Seat 8: BOAYARSKIY ($77 in chips) 
Seat 9: CARDNAPPED ($45.93 in chips) 
WrongButton: posts small blind $1
Monsthand: posts big blind $2
toprmaw: sits out 
docwark: sits out 
*** HOLE CARDS ***
Dealt to matiko09 [9h Js]
BOAYARSKIY: folds 
CARDNAPPED: folds 
nickreason17: folds 
hejun0713: folds 
matiko09: raises $2.54 to $4.54
WrongButton: folds 
Monsthand: calls $2.54
*** FLOP *** [7d 2d 6s]
Monsthand: checks 
matiko09: checks 
*** TURN *** [7d 2d 6s] [2h]
Monsthand: checks 
matiko09: checks 
*** RIVER *** [7d 2d 6s 2h] [Qc]
Monsthand: bets $6.25
matiko09: folds 
Uncalled bet ($6.25) returned to Monsthand
Monsthand collected $9.63 from pot
Monsthand: doesn't show hand 
*** SUMMARY ***
Total pot $10.08 | Rake $0.45 
Board [7d 2d 6s 2h Qc]
Seat 2: nickreason17 folded before Flop (didn't bet)
Seat 4: hejun0713 folded before Flop (didn't bet)
Seat 5: matiko09 (button) folded on the River
Seat 6: WrongButton (small blind) folded before Flop
Seat 7: Monsthand (big blind) collected ($9.63)
Seat 8: BOAYARSKIY folded before Flop (didn't bet)
Seat 9: CARDNAPPED folded before Flop (didn't bet)





PokerStars Hand #150121268434:  Hold'em No Limit ($1/$2 USD) - 2016/03/10 10:30:12 CET [2016/03/10 4:30:12 ET]
Table 'Archid' 9-max Seat #6 is the button
Seat 1: AP3221 ($114.77 in chips) 
Seat 2: geiranger011 ($90.64 in chips) 
Seat 3: sarkat104 ($257.63 in chips) 
Seat 4: Monsthand ($200.37 in chips) 
Seat 5: toprmaw ($208 in chips) 
Seat 6: BOAYARSKIY ($80 in chips) 
Seat 8: matiko09 ($228.23 in chips) 
Seat 9: WrongButton ($211.29 in chips) 
matiko09: posts small blind $1
WrongButton: posts big blind $2
*** HOLE CARDS ***
Dealt to matiko09 [9s 3h]
AP3221: folds 
geiranger011: folds 
sarkat104: calls $2
Monsthand: raises $6 to $8
toprmaw: folds 
BOAYARSKIY: folds 
matiko09: folds 
WrongButton: folds 
sarkat104: folds 
Uncalled bet ($6) returned to Monsthand
Monsthand collected $7 from pot
Monsthand: doesn't show hand 
*** SUMMARY ***
Total pot $7 | Rake $0 
Seat 1: AP3221 folded before Flop (didn't bet)
Seat 2: geiranger011 folded before Flop (didn't bet)
Seat 3: sarkat104 folded before Flop
Seat 4: Monsthand collected ($7)
Seat 5: toprmaw folded before Flop (didn't bet)
Seat 6: BOAYARSKIY (button) folded before Flop (didn't bet)
Seat 8: matiko09 (small blind) folded before Flop
Seat 9: WrongButton (big blind) folded before Flop





PokerStars Hand #150121268741:  Hold'em No Limit ($1/$2 USD) - 2016/03/10 10:30:13 CET [2016/03/10 4:30:13 ET]
Table 'Tauris II' 9-max Seat #8 is the button
Seat 1: toprmaw ($268.49 in chips) 
Seat 2: nickreason17 ($208.67 in chips) 
Seat 3: BOAYARSKIY ($80 in chips) 
Seat 4: matiko09 ($377.78 in chips) 
Seat 5: Spudly6 ($199.72 in chips) 
Seat 6: Yaaaazz ($221.79 in chips) 
Seat 7: Monsthand ($222.85 in chips) 
Seat 8: WrongButton ($253.38 in chips) 
Seat 9: darren1031 ($158.90 in chips) 
darren1031: posts small blind $1
toprmaw: posts big blind $2
*** HOLE CARDS ***
Dealt to matiko09 [Qh 9s]
nickreason17: raises $4 to $6
BOAYARSKIY: folds 
matiko09: folds 
Spudly6: folds 
Yaaaazz: folds 
Monsthand: folds 
WrongButton: folds 
darren1031: folds 
toprmaw: folds 
Uncalled bet ($4) returned to nickreason17
nickreason17 collected $5 from pot
*** SUMMARY ***
Total pot $5 | Rake $0 
Seat 1: toprmaw (big blind) folded before Flop
Seat 2: nickreason17 collected ($5)
Seat 3: BOAYARSKIY folded before Flop (didn't bet)
Seat 4: matiko09 folded before Flop (didn't bet)
Seat 5: Spudly6 folded before Flop (didn't bet)
Seat 6: Yaaaazz folded before Flop (didn't bet)
Seat 7: Monsthand folded before Flop (didn't bet)
Seat 8: WrongButton (button) folded before Flop (didn't bet)
Seat 9: darren1031 (small blind) folded before Flop





PokerStars Hand #150121269405:  Hold'em No Limit ($1/$2 USD) - 2016/03/10 10:30:14 CET [2016/03/10 4:30:14 ET]
Table 'Solstice II' 9-max Seat #1 is the button
Seat 1: Rycious ($198.90 in chips) 
Seat 3: vano7777 ($198 in chips) 
Seat 4: matiko09 ($200.40 in chips) 
Seat 5: toprmaw ($227.04 in chips) 
Seat 6: thecurv ($208.06 in chips) 
Seat 7: WrongButton ($200 in chips) 
Seat 9: Monsthand ($209.96 in chips) 
vano7777: posts small blind $1
matiko09: posts big blind $2
*** HOLE CARDS ***
Dealt to matiko09 [Kd Js]
toprmaw: folds 
thecurv: folds 
WrongButton: folds 
Monsthand: raises $3 to $5
Rycious: folds 
vano7777: folds 
matiko09: calls $3
*** FLOP *** [5c 8h 9d]
matiko09: checks 
Monsthand: checks 
*** TURN *** [5c 8h 9d] [Ah]
matiko09: checks 
Monsthand: bets $6.82
matiko09: folds 
Uncalled bet ($6.82) returned to Monsthand
Monsthand collected $10.50 from pot
Monsthand: doesn't show hand 
*** SUMMARY ***
Total pot $11 | Rake $0.50 
Board [5c 8h 9d Ah]
Seat 1: Rycious (button) folded before Flop (didn't bet)
Seat 3: vano7777 (small blind) folded before Flop
Seat 4: matiko09 (big blind) folded on the Turn
Seat 5: toprmaw folded before Flop (didn't bet)
Seat 6: thecurv folded before Flop (didn't bet)
Seat 7: WrongButton folded before Flop (didn't bet)
Seat 9: Monsthand collected ($10.50)





PokerStars Hand #150121274582:  Hold'em No Limit ($1/$2 USD) - 2016/03/10 10:30:28 CET [2016/03/10 4:30:28 ET]
Table 'Vesta' 9-max Seat #3 is the button
Seat 1: nickreason17 ($234.20 in chips) 
Seat 2: Pernilla E A ($223.71 in chips) 
Seat 3: matiko09 ($203.92 in chips) 
Seat 4: Yaaaazz ($219.40 in chips) 
Seat 6: djammusic ($557.69 in chips) 
Seat 7: Monsthand ($200 in chips) 
Seat 8: 13Ghosts ($312.41 in chips) 
Seat 9: lixiangli ($407.69 in chips) 
Yaaaazz: posts small blind $1
djammusic: posts big blind $2
*** HOLE CARDS ***
Dealt to matiko09 [5s Ad]
Monsthand: folds 
13Ghosts: folds 
lixiangli: folds 
nickreason17: folds 
Pernilla E A: folds 
matiko09: raises $2.54 to $4.54
Yaaaazz: folds 
djammusic: folds 
Uncalled bet ($2.54) returned to matiko09
matiko09 collected $5 from pot
matiko09: doesn't show hand 
*** SUMMARY ***
Total pot $5 | Rake $0 
Seat 1: nickreason17 folded before Flop (didn't bet)
Seat 2: Pernilla E A folded before Flop (didn't bet)
Seat 3: matiko09 (button) collected ($5)
Seat 4: Yaaaazz (small blind) folded before Flop
Seat 6: djammusic (big blind) folded before Flop
Seat 7: Monsthand folded before Flop (didn't bet)
Seat 8: 13Ghosts folded before Flop (didn't bet)
Seat 9: lixiangli folded before Flop (didn't bet)





PokerStars Hand #150121274827:  Hold'em No Limit ($0.50/$1.00 USD) - 2016/03/10 10:30:29 CET [2016/03/10 4:30:29 ET]
Table 'Alsciaukat' 9-max Seat #2 is the button
Seat 1: Kelvin sai ($83.64 in chips) 
Seat 2: mycka86 ($100 in chips) 
Seat 3: blackw0lf_03 ($100 in chips) 
Seat 4: Rikti ($33 in chips) 
Seat 5: toprmaw ($117.42 in chips) 
Seat 6: Sweden_Pound ($101.50 in chips) 
Seat 7: Yaaaazz ($141.15 in chips) 
Seat 8: F1dgeT ($100 in chips) 
Seat 9: matiko09 ($101.88 in chips) 
blackw0lf_03: posts small blind $0.50
Rikti: posts big blind $1
*** HOLE CARDS ***
Dealt to matiko09 [6c 3d]
toprmaw: raises $2.20 to $3.20
Sweden_Pound: folds 
Yaaaazz: folds 
F1dgeT: folds 
matiko09: folds 
Kelvin sai: folds 
mycka86: folds 
blackw0lf_03: folds 
Rikti: folds 
Uncalled bet ($2.20) returned to toprmaw
toprmaw collected $2.50 from pot
toprmaw: doesn't show hand 
*** SUMMARY ***
Total pot $2.50 | Rake $0 
Seat 1: Kelvin sai folded before Flop (didn't bet)
Seat 2: mycka86 (button) folded before Flop (didn't bet)
Seat 3: blackw0lf_03 (small blind) folded before Flop
Seat 4: Rikti (big blind) folded before Flop
Seat 5: toprmaw collected ($2.50)
Seat 6: Sweden_Pound folded before Flop (didn't bet)
Seat 7: Yaaaazz folded before Flop (didn't bet)
Seat 8: F1dgeT folded before Flop (didn't bet)
Seat 9: matiko09 folded before Flop (didn't bet)





PokerStars Hand #150121276916:  Hold'em No Limit ($1/$2 USD) - 2016/03/10 10:30:35 CET [2016/03/10 4:30:35 ET]
Table 'Tauris II' 9-max Seat #9 is the button
Seat 1: toprmaw ($266.49 in chips) 
Seat 2: nickreason17 ($211.67 in chips) 
Seat 3: BOAYARSKIY ($80 in chips) 
Seat 4: matiko09 ($377.78 in chips) 
Seat 5: Spudly6 ($199.72 in chips) 
Seat 6: Yaaaazz ($221.79 in chips) 
Seat 7: Monsthand ($222.85 in chips) 
Seat 8: WrongButton ($253.38 in chips) 
Seat 9: darren1031 ($157.90 in chips) 
toprmaw: posts small blind $1
nickreason17: posts big blind $2
*** HOLE CARDS ***
Dealt to matiko09 [Ah 8c]
BOAYARSKIY: folds 
matiko09: folds 
Spudly6: folds 
Yaaaazz: raises $4 to $6
Monsthand: folds 
WrongButton: folds 
darren1031: folds 
toprmaw: folds 
nickreason17: folds 
Uncalled bet ($4) returned to Yaaaazz
Yaaaazz collected $5 from pot
*** SUMMARY ***
Total pot $5 | Rake $0 
Seat 1: toprmaw (small blind) folded before Flop
Seat 2: nickreason17 (big blind) folded before Flop
Seat 3: BOAYARSKIY folded before Flop (didn't bet)
Seat 4: matiko09 folded before Flop (didn't bet)
Seat 5: Spudly6 folded before Flop (didn't bet)
Seat 6: Yaaaazz collected ($5)
Seat 7: Monsthand folded before Flop (didn't bet)
Seat 8: WrongButton folded before Flop (didn't bet)
Seat 9: darren1031 (button) folded before Flop (didn't bet)





PokerStars Hand #150121277852:  Hold'em No Limit ($0.50/$1.00 USD) - 2016/03/10 10:30:37 CET [2016/03/10 4:30:37 ET]
Table 'Nereid' 9-max Seat #5 is the button
Seat 1: matiko09 ($100 in chips) 
Seat 3: mycka86 ($101 in chips) 
Seat 4: xiaoxiaoniao ($279.60 in chips) 
Seat 5: ilaviiitech ($103.50 in chips) 
Seat 6: thecurv ($108.76 in chips) 
Seat 7: Monsthand ($132.82 in chips) 
Seat 8: Rikti ($24.46 in chips) 
thecurv: posts small blind $0.50
Monsthand: posts big blind $1
*** HOLE CARDS ***
Dealt to matiko09 [5c Jh]
Rikti: folds 
matiko09: folds 
mycka86: raises $1.50 to $2.50
xiaoxiaoniao: folds 
ilaviiitech: folds 
thecurv: folds 
Monsthand: folds 
Uncalled bet ($1.50) returned to mycka86
mycka86 collected $2.50 from pot
*** SUMMARY ***
Total pot $2.50 | Rake $0 
Seat 1: matiko09 folded before Flop (didn't bet)
Seat 3: mycka86 collected ($2.50)
Seat 4: xiaoxiaoniao folded before Flop (didn't bet)
Seat 5: ilaviiitech (button) folded before Flop (didn't bet)
Seat 6: thecurv (small blind) folded before Flop
Seat 7: Monsthand (big blind) folded before Flop
Seat 8: Rikti folded before Flop (didn't bet)





PokerStars Hand #150121282196:  Hold'em No Limit ($1/$2 USD) - 2016/03/10 10:30:49 CET [2016/03/10 4:30:49 ET]
Table 'Vesta' 9-max Seat #4 is the button
Seat 1: nickreason17 ($234.20 in chips) 
Seat 2: Pernilla E A ($223.71 in chips) 
Seat 3: matiko09 ($206.92 in chips) 
Seat 4: Yaaaazz ($218.40 in chips) 
Seat 6: djammusic ($555.69 in chips) 
Seat 7: Monsthand ($200 in chips) 
Seat 8: 13Ghosts ($312.41 in chips) 
Seat 9: lixiangli ($407.69 in chips) 
djammusic: posts small blind $1
Monsthand: posts big blind $2
*** HOLE CARDS ***
Dealt to matiko09 [Jd Jh]
13Ghosts: folds 
lixiangli: raises $3 to $5
nickreason17: folds 
Pernilla E A: raises $3 to $8
matiko09: raises $12 to $20
Yaaaazz: folds 
djammusic: folds 
Monsthand: folds 
lixiangli: folds 
Pernilla E A: calls $12
*** FLOP *** [Tc Ac 5c]
Pernilla E A: checks 
matiko09: checks 
*** TURN *** [Tc Ac 5c] [2h]
Pernilla E A: bets $22.92
matiko09: folds 
Uncalled bet ($22.92) returned to Pernilla E A
Pernilla E A collected $45.84 from pot
*** SUMMARY ***
Total pot $48 | Rake $2.16 
Board [Tc Ac 5c 2h]
Seat 1: nickreason17 folded before Flop (didn't bet)
Seat 2: Pernilla E A collected ($45.84)
Seat 3: matiko09 folded on the Turn
Seat 4: Yaaaazz (button) folded before Flop (didn't bet)
Seat 6: djammusic (small blind) folded before Flop
Seat 7: Monsthand (big blind) folded before Flop
Seat 8: 13Ghosts folded before Flop (didn't bet)
Seat 9: lixiangli folded before Flop





PokerStars Hand #150121283128:  Hold'em No Limit ($0.50/$1.00 USD) - 2016/03/10 10:30:51 CET [2016/03/10 4:30:51 ET]
Table 'Ymir II' 9-max Seat #1 is the button
Seat 1: Monsthand ($105.44 in chips) 
Seat 2: er13to ($100 in chips) 
Seat 3: matiko09 ($100 in chips) 
Seat 4: blackw0lf_03 ($156.71 in chips) 
Seat 5: mycka86 ($100 in chips) 
Seat 6: RMilPoker ($110.53 in chips) 
Seat 8: Sweden_Pound ($122.75 in chips) 
Seat 9: Beni Ca$h ($109.18 in chips) 
er13to: posts small blind $0.50
matiko09: posts big blind $1
*** HOLE CARDS ***
Dealt to matiko09 [3c 2c]
blackw0lf_03: folds 
mycka86: folds 
RMilPoker: folds 
Sweden_Pound: folds 
Beni Ca$h: raises $2 to $3
Monsthand: folds 
er13to: folds 
matiko09: folds 
Uncalled bet ($2) returned to Beni Ca$h
Beni Ca$h collected $2.50 from pot
*** SUMMARY ***
Total pot $2.50 | Rake $0 
Seat 1: Monsthand (button) folded before Flop (didn't bet)
Seat 2: er13to (small blind) folded before Flop
Seat 3: matiko09 (big blind) folded before Flop
Seat 4: blackw0lf_03 folded before Flop (didn't bet)
Seat 5: mycka86 folded before Flop (didn't bet)
Seat 6: RMilPoker folded before Flop (didn't bet)
Seat 8: Sweden_Pound folded before Flop (didn't bet)
Seat 9: Beni Ca$h collected ($2.50)





PokerStars Hand #150121283475:  Hold'em No Limit ($0.50/$1.00 USD) - 2016/03/10 10:30:52 CET [2016/03/10 4:30:52 ET]
Table 'Rarahu' 9-max Seat #5 is the button
Seat 1: matiko09 ($101.50 in chips) 
Seat 2: azzad2007 ($100 in chips) 
Seat 3: BKA12 ($100 in chips) 
Seat 4: vilo1070 ($116.57 in chips) 
Seat 5: blackw0lf_03 ($114.30 in chips) 
Seat 6: RMilPoker ($104.39 in chips) 
Seat 8: Rikti ($73.28 in chips) 
Seat 9: Srz7v44 ($133.74 in chips) 
RMilPoker: posts small blind $0.50
Rikti: posts big blind $1
*** HOLE CARDS ***
Dealt to matiko09 [7c 4s]
Srz7v44: folds 
matiko09: folds 
azzad2007: folds 
BKA12: folds 
vilo1070: folds 
blackw0lf_03: raises $1 to $2
RMilPoker: folds 
Rikti: calls $1
*** FLOP *** [5d Kd 8d]
Rikti: checks 
blackw0lf_03: bets $1.46
Rikti: folds 
Uncalled bet ($1.46) returned to blackw0lf_03
blackw0lf_03 collected $4.30 from pot
blackw0lf_03: doesn't show hand 
*** SUMMARY ***
Total pot $4.50 | Rake $0.20 
Board [5d Kd 8d]
Seat 1: matiko09 folded before Flop (didn't bet)
Seat 2: azzad2007 folded before Flop (didn't bet)
Seat 3: BKA12 folded before Flop (didn't bet)
Seat 4: vilo1070 folded before Flop (didn't bet)
Seat 5: blackw0lf_03 (button) collected ($4.30)
Seat 6: RMilPoker (small blind) folded before Flop
Seat 8: Rikti (big blind) folded on the Flop
Seat 9: Srz7v44 folded before Flop (didn't bet)





PokerStars Hand #150121284179:  Hold'em No Limit ($1/$2 USD) - 2016/03/10 10:30:54 CET [2016/03/10 4:30:54 ET]
Table 'Archid' 9-max Seat #8 is the button
Seat 1: AP3221 ($114.77 in chips) 
Seat 2: geiranger011 ($90.64 in chips) 
Seat 3: sarkat104 ($255.63 in chips) 
Seat 4: Monsthand ($205.37 in chips) 
Seat 5: toprmaw ($208 in chips) 
Seat 6: BOAYARSKIY ($80 in chips) 
Seat 8: matiko09 ($227.23 in chips) 
Seat 9: WrongButton ($209.29 in chips) 
WrongButton: posts small blind $1
AP3221: posts big blind $2
*** HOLE CARDS ***
Dealt to matiko09 [2s 7h]
geiranger011: folds 
sarkat104: folds 
Monsthand: folds 
toprmaw: folds 
BOAYARSKIY: folds 
matiko09: folds 
WrongButton: calls $1
AP3221: checks 
*** FLOP *** [Ks 4s 7d]
WrongButton: bets $2.06
AP3221: calls $2.06
*** TURN *** [Ks 4s 7d] [7c]
WrongButton: checks 
AP3221: checks 
*** RIVER *** [Ks 4s 7d 7c] [3h]
WrongButton: checks 
AP3221: checks 
*** SHOW DOWN ***
WrongButton: shows [4c 6c] (two pair, Sevens and Fours)
AP3221: shows [4d 3d] (two pair, Sevens and Fours)
WrongButton collected $3.88 from pot
AP3221 collected $3.87 from pot
*** SUMMARY ***
Total pot $8.12 | Rake $0.37 
Board [Ks 4s 7d 7c 3h]
Seat 1: AP3221 (big blind) showed [4d 3d] and won ($3.87) with two pair, Sevens and Fours
Seat 2: geiranger011 folded before Flop (didn't bet)
Seat 3: sarkat104 folded before Flop (didn't bet)
Seat 4: Monsthand folded before Flop (didn't bet)
Seat 5: toprmaw folded before Flop (didn't bet)
Seat 6: BOAYARSKIY folded before Flop (didn't bet)
Seat 8: matiko09 (button) folded before Flop (didn't bet)
Seat 9: WrongButton (small blind) showed [4c 6c] and won ($3.88) with two pair, Sevens and Fours





PokerStars Hand #150121285540:  Hold'em No Limit ($1/$2 USD) - 2016/03/10 10:30:57 CET [2016/03/10 4:30:57 ET]
Table 'Tauris II' 9-max Seat #1 is the button
Seat 1: toprmaw ($265.49 in chips) 
Seat 2: nickreason17 ($209.67 in chips) 
Seat 3: BOAYARSKIY ($80 in chips) 
Seat 4: matiko09 ($377.78 in chips) 
Seat 5: Spudly6 ($199.72 in chips) 
Seat 6: Yaaaazz ($224.79 in chips) 
Seat 7: Monsthand ($222.85 in chips) 
Seat 8: WrongButton ($253.38 in chips) 
Seat 9: darren1031 ($157.90 in chips) 
nickreason17: posts small blind $1
BOAYARSKIY: posts big blind $2
*** HOLE CARDS ***
Dealt to matiko09 [Qs Kc]
matiko09: raises $4 to $6
Spudly6: folds 
Yaaaazz: folds 
Monsthand: folds 
WrongButton: folds 
darren1031: folds 
toprmaw: calls $6
nickreason17: folds 
BOAYARSKIY: folds 
*** FLOP *** [4d 9d 9c]
matiko09: checks 
toprmaw: bets $8.59
matiko09: folds 
Uncalled bet ($8.59) returned to toprmaw
toprmaw collected $14.32 from pot
toprmaw: doesn't show hand 
*** SUMMARY ***
Total pot $15 | Rake $0.68 
Board [4d 9d 9c]
Seat 1: toprmaw (button) collected ($14.32)
Seat 2: nickreason17 (small blind) folded before Flop
Seat 3: BOAYARSKIY (big blind) folded before Flop
Seat 4: matiko09 folded on the Flop
Seat 5: Spudly6 folded before Flop (didn't bet)
Seat 6: Yaaaazz folded before Flop (didn't bet)
Seat 7: Monsthand folded before Flop (didn't bet)
Seat 8: WrongButton folded before Flop (didn't bet)
Seat 9: darren1031 folded before Flop (didn't bet)





PokerStars Hand #150121286458:  Hold'em No Limit (€0.25/€0.50 EUR) - 2016/03/10 10:31:00 CET [2016/03/10 4:31:00 ET]
Table 'Algorab' 9-max Seat #4 is the button
Seat 1: nubpoker (€50 in chips) 
Seat 3: dididi2000 (€41.70 in chips) 
Seat 4: Butcher1848 (€70.25 in chips) 
Seat 6: q3storm (€50 in chips) 
Seat 7: matiko09 (€92.63 in chips) 
Seat 8: fudzi (€50.75 in chips) 
q3storm: posts small blind €0.25
matiko09: posts big blind €0.50
*** HOLE CARDS ***
Dealt to matiko09 [Jh 5c]
fudzi: folds 
nubpoker: folds 
dididi2000: raises €1 to €1.50
Dantist1122 joins the table at seat #2 
Butcher1848: raises €2.75 to €4.25
q3storm: folds 
matiko09: folds 
dididi2000: calls €2.75
*** FLOP *** [Kc 8d Kd]
dididi2000: checks 
Butcher1848: bets €2.91
dididi2000: folds 
Uncalled bet (€2.91) returned to Butcher1848
Butcher1848 collected €8.83 from pot
Butcher1848: doesn't show hand 
*** SUMMARY ***
Total pot €9.25 | Rake €0.42 
Board [Kc 8d Kd]
Seat 1: nubpoker folded before Flop (didn't bet)
Seat 3: dididi2000 folded on the Flop
Seat 4: Butcher1848 (button) collected (€8.83)
Seat 6: q3storm (small blind) folded before Flop
Seat 7: matiko09 (big blind) folded before Flop
Seat 8: fudzi folded before Flop (didn't bet)





PokerStars Hand #150121289303:  Hold'em No Limit ($0.50/$1.00 USD) - 2016/03/10 10:31:07 CET [2016/03/10 4:31:07 ET]
Table 'Alsciaukat' 9-max Seat #3 is the button
Seat 1: Kelvin sai ($83.64 in chips) 
Seat 2: mycka86 ($100 in chips) 
Seat 3: blackw0lf_03 ($100 in chips) 
Seat 4: Rikti ($32 in chips) 
Seat 5: toprmaw ($118.92 in chips) 
Seat 6: Sweden_Pound ($101.50 in chips) 
Seat 7: Yaaaazz ($141.15 in chips) 
Seat 8: F1dgeT ($100 in chips) 
Seat 9: matiko09 ($101.88 in chips) 
Rikti: posts small blind $0.50
toprmaw: posts big blind $1
*** HOLE CARDS ***
Dealt to matiko09 [5s Jc]
Sweden_Pound: folds 
Yaaaazz: folds 
F1dgeT: folds 
matiko09: folds 
Kelvin sai: folds 
mycka86: raises $1.10 to $2.10
blackw0lf_03: raises $5.40 to $7.50
Rikti: folds 
toprmaw: folds 
mycka86: raises $8.50 to $16
blackw0lf_03: calls $8.50
*** FLOP *** [4s 9d Ac]
mycka86: checks 
blackw0lf_03: bets $10.88
mycka86: calls $10.88
*** TURN *** [4s 9d Ac] [9s]
mycka86: checks 
blackw0lf_03: bets $17.94
mycka86: folds 
Uncalled bet ($17.94) returned to blackw0lf_03
blackw0lf_03 collected $52.77 from pot
blackw0lf_03: doesn't show hand 
*** SUMMARY ***
Total pot $55.26 | Rake $2.49 
Board [4s 9d Ac 9s]
Seat 1: Kelvin sai folded before Flop (didn't bet)
Seat 2: mycka86 folded on the Turn
Seat 3: blackw0lf_03 (button) collected ($52.77)
Seat 4: Rikti (small blind) folded before Flop
Seat 5: toprmaw (big blind) folded before Flop
Seat 6: Sweden_Pound folded before Flop (didn't bet)
Seat 7: Yaaaazz folded before Flop (didn't bet)
Seat 8: F1dgeT folded before Flop (didn't bet)
Seat 9: matiko09 folded before Flop (didn't bet)





PokerStars Hand #150121291112:  Hold'em No Limit ($0.50/$1.00 USD) - 2016/03/10 10:31:12 CET [2016/03/10 4:31:12 ET]
Table 'Leda II' 9-max Seat #4 is the button
Seat 1: DIMAN_324 ($100 in chips) 
Seat 2: corsair888 ($100 in chips) 
Seat 4: Zier89 ($94.46 in chips) 
Seat 5: matiko09 ($110.01 in chips) 
Seat 6: AlKatrone ($182.99 in chips) 
Seat 7: BKA12 ($100 in chips) 
Seat 8: peppsta ($84.35 in chips) 
Seat 9: Yaaaazz ($107.21 in chips) 
matiko09: posts small blind $0.50
AlKatrone: posts big blind $1
*** HOLE CARDS ***
Dealt to matiko09 [Jh Kd]
BKA12: folds 
peppsta: folds 
Yaaaazz: folds 
DIMAN_324: folds 
corsair888: raises $2 to $3
Zier89: calls $3
matiko09: folds 
AlKatrone: folds 
*** FLOP *** [2s 9h 5h]
corsair888: bets $4
Zier89: calls $4
*** TURN *** [2s 9h 5h] [6s]
corsair888: bets $9
Zier89: folds 
Uncalled bet ($9) returned to corsair888
corsair888 collected $14.80 from pot
corsair888: doesn't show hand 
*** SUMMARY ***
Total pot $15.50 | Rake $0.70 
Board [2s 9h 5h 6s]
Seat 1: DIMAN_324 folded before Flop (didn't bet)
Seat 2: corsair888 collected ($14.80)
Seat 4: Zier89 (button) folded on the Turn
Seat 5: matiko09 (small blind) folded before Flop
Seat 6: AlKatrone (big blind) folded before Flop
Seat 7: BKA12 folded before Flop (didn't bet)
Seat 8: peppsta folded before Flop (didn't bet)
Seat 9: Yaaaazz folded before Flop (didn't bet)





PokerStars Hand #150121292060:  Hold'em No Limit ($1/$2 USD) - 2016/03/10 10:31:15 CET [2016/03/10 4:31:15 ET]
Table 'Solstice II' 9-max Seat #3 is the button
Seat 1: Rycious ($198.90 in chips) 
Seat 3: vano7777 ($197 in chips) 
Seat 4: matiko09 ($200 in chips) 
Seat 5: toprmaw ($227.04 in chips) 
Seat 6: thecurv ($208.06 in chips) 
Seat 7: WrongButton ($200 in chips) 
Seat 9: Monsthand ($215.46 in chips) 
matiko09: posts small blind $1
toprmaw: posts big blind $2
*** HOLE CARDS ***
Dealt to matiko09 [4h 6h]
thecurv: folds 
WrongButton: folds 
Monsthand: raises $3.40 to $5.40
Rycious: calls $5.40
vano7777: folds 
matiko09: folds 
toprmaw: folds 
*** FLOP *** [4s 4c 9c]
Monsthand: bets $8.50
Rycious: calls $8.50
*** TURN *** [4s 4c 9c] [9d]
Monsthand: checks 
Rycious: checks 
*** RIVER *** [4s 4c 9c 9d] [7d]
Monsthand: bets $21
Rycious: folds 
Uncalled bet ($21) returned to Monsthand
Monsthand collected $29.41 from pot
Monsthand: doesn't show hand 
*** SUMMARY ***
Total pot $30.80 | Rake $1.39 
Board [4s 4c 9c 9d 7d]
Seat 1: Rycious folded on the River
Seat 3: vano7777 (button) folded before Flop (didn't bet)
Seat 4: matiko09 (small blind) folded before Flop
Seat 5: toprmaw (big blind) folded before Flop
Seat 6: thecurv folded before Flop (didn't bet)
Seat 7: WrongButton folded before Flop (didn't bet)
Seat 9: Monsthand collected ($29.41)





PokerStars Hand #150121292837:  Hold'em No Limit ($0.50/$1.00 USD) - 2016/03/10 10:31:17 CET [2016/03/10 4:31:17 ET]
Table 'Nereid' 9-max Seat #6 is the button
Seat 1: matiko09 ($100 in chips) 
Seat 3: mycka86 ($102.50 in chips) 
Seat 4: xiaoxiaoniao ($279.60 in chips) 
Seat 5: ilaviiitech ($103.50 in chips) 
Seat 6: thecurv ($108.26 in chips) 
Seat 7: Monsthand ($131.82 in chips) 
Seat 8: Rikti ($24.46 in chips) 
Monsthand: posts small blind $0.50
Rikti: posts big blind $1
*** HOLE CARDS ***
Dealt to matiko09 [2d 5h]
matiko09: folds 
mycka86: folds 
xiaoxiaoniao: folds 
ilaviiitech: folds 
thecurv: folds 
Monsthand: folds 
Uncalled bet ($0.50) returned to Rikti
Rikti collected $1 from pot
Rikti: doesn't show hand 
*** SUMMARY ***
Total pot $1 | Rake $0 
Seat 1: matiko09 folded before Flop (didn't bet)
Seat 3: mycka86 folded before Flop (didn't bet)
Seat 4: xiaoxiaoniao folded before Flop (didn't bet)
Seat 5: ilaviiitech folded before Flop (didn't bet)
Seat 6: thecurv (button) folded before Flop (didn't bet)
Seat 7: Monsthand (small blind) folded before Flop
Seat 8: Rikti (big blind) collected ($1)





PokerStars Hand #150121295642:  Hold'em No Limit ($0.25/$0.50 USD) - 2016/03/10 10:31:24 CET [2016/03/10 4:31:24 ET]
Table 'Aegina' 9-max Seat #9 is the button
Seat 1: Wess_1970 ($80.52 in chips) 
Seat 2: el.suertero ($130.94 in chips) 
Seat 3: matiko09 ($50 in chips) 
Seat 5: depokerlord ($67.13 in chips) 
Seat 6: ardo888 ($173.82 in chips) 
Seat 7: Bohne0815 ($77.64 in chips) 
Seat 8: q3storm ($50 in chips) 
Seat 9: i L00K great ($54.79 in chips) 
Wess_1970: posts small blind $0.25
el.suertero: posts big blind $0.50
Wess_1970: posts the ante $0.10
el.suertero: posts the ante $0.10
matiko09: posts the ante $0.10
depokerlord: posts the ante $0.10
ardo888: posts the ante $0.10
Bohne0815: posts the ante $0.10
q3storm: posts the ante $0.10
i L00K great: posts the ante $0.10
*** HOLE CARDS ***
Dealt to matiko09 [Qd Tc]
matiko09: folds 
depokerlord: folds 
ardo888: folds 
Bohne0815: folds 
q3storm: folds 
i L00K great: raises $0.50 to $1
Wess_1970: raises $0.50 to $1.50
el.suertero: calls $1
i L00K great: calls $0.50
*** FLOP *** [3h 9c 8s]
Wess_1970: bets $0.50
el.suertero: calls $0.50
i L00K great: raises $4.32 to $4.82
Wess_1970: calls $4.32
el.suertero: folds 
*** TURN *** [3h 9c 8s] [6d]
Wess_1970: checks 
i L00K great: bets $5.16
Wess_1970: folds 
Uncalled bet ($5.16) returned to i L00K great
i L00K great collected $14.75 from pot
i L00K great: doesn't show hand 
*** SUMMARY ***
Total pot $15.44 | Rake $0.69 
Board [3h 9c 8s 6d]
Seat 1: Wess_1970 (small blind) folded on the Turn
Seat 2: el.suertero (big blind) folded on the Flop
Seat 3: matiko09 folded before Flop (didn't bet)
Seat 5: depokerlord folded before Flop (didn't bet)
Seat 6: ardo888 folded before Flop (didn't bet)
Seat 7: Bohne0815 folded before Flop (didn't bet)
Seat 8: q3storm folded before Flop (didn't bet)
Seat 9: i L00K great (button) collected ($14.75)





PokerStars Hand #150121297186:  Hold'em No Limit ($1/$2 USD) - 2016/03/10 10:31:28 CET [2016/03/10 4:31:28 ET]
Table 'Sophia II' 9-max Seat #6 is the button
Seat 2: nickreason17 ($212.71 in chips) 
Seat 4: hejun0713 ($189.50 in chips) 
Seat 5: matiko09 ($206.46 in chips) 
Seat 6: WrongButton ($375.86 in chips) 
Seat 7: Monsthand ($385.41 in chips) 
Seat 8: BOAYARSKIY ($77 in chips) 
Seat 9: CARDNAPPED ($45.93 in chips) 
Monsthand: posts small blind $1
BOAYARSKIY: posts big blind $2
toprmaw: sits out 
docwark: sits out 
*** HOLE CARDS ***
Dealt to matiko09 [Jd 8c]
CARDNAPPED: folds 
nickreason17: folds 
hejun0713: folds 
matiko09: folds 
WrongButton: raises $2 to $4
Monsthand: raises $12 to $16
BOAYARSKIY: folds 
WrongButton: folds 
Uncalled bet ($12) returned to Monsthand
Monsthand collected $10 from pot
Monsthand: doesn't show hand 
*** SUMMARY ***
Total pot $10 | Rake $0 
Seat 2: nickreason17 folded before Flop (didn't bet)
Seat 4: hejun0713 folded before Flop (didn't bet)
Seat 5: matiko09 folded before Flop (didn't bet)
Seat 6: WrongButton (button) folded before Flop
Seat 7: Monsthand (small blind) collected ($10)
Seat 8: BOAYARSKIY (big blind) folded before Flop
Seat 9: CARDNAPPED folded before Flop (didn't bet)





PokerStars Hand #150121298492:  Hold'em No Limit ($0.50/$1.00 USD) - 2016/03/10 10:31:32 CET [2016/03/10 4:31:32 ET]
Table 'Ymir II' 9-max Seat #2 is the button
Seat 1: Monsthand ($105.44 in chips) 
Seat 2: er13to ($100 in chips) 
Seat 3: matiko09 ($100 in chips) 
Seat 4: blackw0lf_03 ($156.71 in chips) 
Seat 5: mycka86 ($100 in chips) 
Seat 6: RMilPoker ($110.53 in chips) 
Seat 8: Sweden_Pound ($122.75 in chips) 
Seat 9: Beni Ca$h ($110.68 in chips) 
matiko09: posts small blind $0.50
blackw0lf_03: posts big blind $1
*** HOLE CARDS ***
Dealt to matiko09 [2d Ac]
mycka86: folds 
RMilPoker: raises $2 to $3
Sweden_Pound: folds 
Beni Ca$h: folds 
Monsthand: folds 
er13to: folds 
matiko09: folds 
blackw0lf_03: calls $2
*** FLOP *** [2s 8d 8h]
blackw0lf_03: checks 
RMilPoker: bets $5
blackw0lf_03: folds 
Uncalled bet ($5) returned to RMilPoker
RMilPoker collected $6.21 from pot
RMilPoker: doesn't show hand 
*** SUMMARY ***
Total pot $6.50 | Rake $0.29 
Board [2s 8d 8h]
Seat 1: Monsthand folded before Flop (didn't bet)
Seat 2: er13to (button) folded before Flop (didn't bet)
Seat 3: matiko09 (small blind) folded before Flop
Seat 4: blackw0lf_03 (big blind) folded on the Flop
Seat 5: mycka86 folded before Flop (didn't bet)
Seat 6: RMilPoker collected ($6.21)
Seat 8: Sweden_Pound folded before Flop (didn't bet)
Seat 9: Beni Ca$h folded before Flop (didn't bet)





PokerStars Hand #150121298726:  Hold'em No Limit ($0.50/$1.00 USD) - 2016/03/10 10:31:32 CET [2016/03/10 4:31:32 ET]
Table 'Nereid' 9-max Seat #7 is the button
Seat 1: matiko09 ($100 in chips) 
Seat 3: mycka86 ($102.50 in chips) 
Seat 4: xiaoxiaoniao ($279.60 in chips) 
Seat 5: ilaviiitech ($103.50 in chips) 
Seat 6: thecurv ($108.26 in chips) 
Seat 7: Monsthand ($131.32 in chips) 
Seat 8: Rikti ($24.96 in chips) 
Rikti: posts small blind $0.50
matiko09: posts big blind $1
*** HOLE CARDS ***
Dealt to matiko09 [Th Qc]
mycka86: folds 
xiaoxiaoniao: raises $1 to $2
ilaviiitech: folds 
thecurv: folds 
Monsthand: folds 
Rikti: folds 
matiko09: folds 
Uncalled bet ($1) returned to xiaoxiaoniao
xiaoxiaoniao collected $2.50 from pot
xiaoxiaoniao: doesn't show hand 
*** SUMMARY ***
Total pot $2.50 | Rake $0 
Seat 1: matiko09 (big blind) folded before Flop
Seat 3: mycka86 folded before Flop (didn't bet)
Seat 4: xiaoxiaoniao collected ($2.50)
Seat 5: ilaviiitech folded before Flop (didn't bet)
Seat 6: thecurv folded before Flop (didn't bet)
Seat 7: Monsthand (button) folded before Flop (didn't bet)
Seat 8: Rikti (small blind) folded before Flop





PokerStars Hand #150121303994:  Hold'em No Limit ($0.50/$1.00 USD) - 2016/03/10 10:31:47 CET [2016/03/10 4:31:47 ET]
Table 'Rarahu' 9-max Seat #6 is the button
Seat 1: matiko09 ($101.50 in chips) 
Seat 2: azzad2007 ($100 in chips) 
Seat 3: BKA12 ($100 in chips) 
Seat 4: vilo1070 ($116.57 in chips) 
Seat 5: blackw0lf_03 ($116.60 in chips) 
Seat 6: RMilPoker ($103.89 in chips) 
Seat 8: Rikti ($71.28 in chips) 
Seat 9: Srz7v44 ($133.74 in chips) 
Rikti: posts small blind $0.50
Srz7v44: posts big blind $1
*** HOLE CARDS ***
Dealt to matiko09 [6d 6s]
matiko09: raises $2 to $3
azzad2007: folds 
BKA12: folds 
vilo1070: folds 
blackw0lf_03: calls $3
RMilPoker: folds 
Rikti: folds 
Srz7v44: folds 
*** FLOP *** [Jc 8s 6h]
matiko09: bets $4.65
blackw0lf_03: folds 
Uncalled bet ($4.65) returned to matiko09
matiko09 collected $7.16 from pot
matiko09: doesn't show hand 
*** SUMMARY ***
Total pot $7.50 | Rake $0.34 
Board [Jc 8s 6h]
Seat 1: matiko09 collected ($7.16)
Seat 2: azzad2007 folded before Flop (didn't bet)
Seat 3: BKA12 folded before Flop (didn't bet)
Seat 4: vilo1070 folded before Flop (didn't bet)
Seat 5: blackw0lf_03 folded on the Flop
Seat 6: RMilPoker (button) folded before Flop (didn't bet)
Seat 8: Rikti (small blind) folded before Flop
Seat 9: Srz7v44 (big blind) folded before Flop





PokerStars Hand #150121305159:  Hold'em No Limit ($1/$2 USD) - 2016/03/10 10:31:50 CET [2016/03/10 4:31:50 ET]
Table 'Vesta' 9-max Seat #6 is the button
Seat 1: nickreason17 ($234.20 in chips) 
Seat 2: Pernilla E A ($249.55 in chips) 
Seat 3: matiko09 ($200 in chips) 
Seat 4: Yaaaazz ($218.40 in chips) 
Seat 6: djammusic ($554.69 in chips) 
Seat 7: Monsthand ($200 in chips) 
Seat 8: 13Ghosts ($312.41 in chips) 
Seat 9: lixiangli ($402.69 in chips) 
Monsthand: posts small blind $1
13Ghosts: posts big blind $2
*** HOLE CARDS ***
Dealt to matiko09 [4h 4s]
lixiangli: calls $2
nickreason17: folds 
Pernilla E A: calls $2
matiko09: calls $2
Yaaaazz: folds 
djammusic: folds 
Monsthand: folds 
13Ghosts: checks 
*** FLOP *** [Qh 6d 3s]
13Ghosts: checks 
lixiangli: bets $4.30
Pernilla E A: folds 
matiko09: folds 
13Ghosts: folds 
Uncalled bet ($4.30) returned to lixiangli
lixiangli collected $8.60 from pot
lixiangli: doesn't show hand 
*** SUMMARY ***
Total pot $9 | Rake $0.40 
Board [Qh 6d 3s]
Seat 1: nickreason17 folded before Flop (didn't bet)
Seat 2: Pernilla E A folded on the Flop
Seat 3: matiko09 folded on the Flop
Seat 4: Yaaaazz folded before Flop (didn't bet)
Seat 6: djammusic (button) folded before Flop (didn't bet)
Seat 7: Monsthand (small blind) folded before Flop
Seat 8: 13Ghosts (big blind) folded on the Flop
Seat 9: lixiangli collected ($8.60)





PokerStars Hand #150121306064:  Hold'em No Limit ($0.50/$1.00 USD) - 2016/03/10 10:31:52 CET [2016/03/10 4:31:52 ET]
Table 'Nereid' 9-max Seat #8 is the button
Seat 1: matiko09 ($100 in chips) 
Seat 3: mycka86 ($102.50 in chips) 
Seat 4: xiaoxiaoniao ($281.10 in chips) 
Seat 5: ilaviiitech ($103.50 in chips) 
Seat 6: thecurv ($108.26 in chips) 
Seat 7: Monsthand ($131.32 in chips) 
Seat 8: Rikti ($24.46 in chips) 
matiko09: posts small blind $0.50
mycka86: posts big blind $1
*** HOLE CARDS ***
Dealt to matiko09 [6s 5h]
xiaoxiaoniao: folds 
ilaviiitech: raises $2 to $3
thecurv: folds 
Monsthand: calls $3
Rikti: folds 
matiko09: folds 
mycka86: calls $2
*** FLOP *** [Qc Qs Qh]
mycka86: checks 
ilaviiitech: checks 
Monsthand: bets $6
mycka86: folds 
ilaviiitech: calls $6
*** TURN *** [Qc Qs Qh] [3d]
ilaviiitech: checks 
Monsthand: checks 
*** RIVER *** [Qc Qs Qh 3d] [9h]
ilaviiitech: bets $18.47
Monsthand: folds 
Uncalled bet ($18.47) returned to ilaviiitech
ilaviiitech collected $20.53 from pot
ilaviiitech: doesn't show hand 
*** SUMMARY ***
Total pot $21.50 | Rake $0.97 
Board [Qc Qs Qh 3d 9h]
Seat 1: matiko09 (small blind) folded before Flop
Seat 3: mycka86 (big blind) folded on the Flop
Seat 4: xiaoxiaoniao folded before Flop (didn't bet)
Seat 5: ilaviiitech collected ($20.53)
Seat 6: thecurv folded before Flop (didn't bet)
Seat 7: Monsthand folded on the River
Seat 8: Rikti (button) folded before Flop (didn't bet)





PokerStars Hand #150121305722:  Hold'em No Limit (€0.25/€0.50 EUR) - 2016/03/10 10:31:52 CET [2016/03/10 4:31:52 ET]
Table 'Algorab' 9-max Seat #6 is the button
Seat 1: nubpoker (€50 in chips) 
Seat 3: dididi2000 (€37.45 in chips) 
Seat 4: Butcher1848 (€74.83 in chips) 
Seat 6: q3storm (€50 in chips) 
Seat 7: matiko09 (€92.13 in chips) 
Seat 8: fudzi (€50.75 in chips) 
matiko09: posts small blind €0.25
fudzi: posts big blind €0.50
*** HOLE CARDS ***
Dealt to matiko09 [2c Js]
nubpoker: folds 
dididi2000: folds 
Butcher1848: raises €0.77 to €1.27
q3storm: folds 
matiko09: folds 
Dantist1122 leaves the table
fudzi: folds 
Uncalled bet (€0.77) returned to Butcher1848
Butcher1848 collected €1.25 from pot
Butcher1848: doesn't show hand 
*** SUMMARY ***
Total pot €1.25 | Rake €0 
Seat 1: nubpoker folded before Flop (didn't bet)
Seat 3: dididi2000 folded before Flop (didn't bet)
Seat 4: Butcher1848 collected (€1.25)
Seat 6: q3storm (button) folded before Flop (didn't bet)
Seat 7: matiko09 (small blind) folded before Flop
Seat 8: fudzi (big blind) folded before Flop





PokerStars Hand #150121308908:  Hold'em No Limit ($1/$2 USD) - 2016/03/10 10:32:00 CET [2016/03/10 4:32:00 ET]
Table 'Solstice II' 9-max Seat #4 is the button
Seat 1: Rycious ($185 in chips) 
Seat 3: vano7777 ($197 in chips) 
Seat 4: matiko09 ($200 in chips) 
Seat 5: toprmaw ($225.04 in chips) 
Seat 6: thecurv ($208.06 in chips) 
Seat 7: WrongButton ($200 in chips) 
Seat 9: Monsthand ($230.97 in chips) 
toprmaw: posts small blind $1
thecurv: posts big blind $2
*** HOLE CARDS ***
Dealt to matiko09 [Qh Js]
WrongButton: folds 
Monsthand: folds 
Rycious: folds 
vano7777: folds 
matiko09: raises $2.54 to $4.54
toprmaw: folds 
thecurv: calls $2.54
*** FLOP *** [6s 4s 5s]
thecurv: checks 
matiko09: checks 
*** TURN *** [6s 4s 5s] [7d]
thecurv: bets $6
matiko09: folds 
Uncalled bet ($6) returned to thecurv
thecurv collected $9.63 from pot
thecurv: doesn't show hand 
*** SUMMARY ***
Total pot $10.08 | Rake $0.45 
Board [6s 4s 5s 7d]
Seat 1: Rycious folded before Flop (didn't bet)
Seat 3: vano7777 folded before Flop (didn't bet)
Seat 4: matiko09 (button) folded on the Turn
Seat 5: toprmaw (small blind) folded before Flop
Seat 6: thecurv (big blind) collected ($9.63)
Seat 7: WrongButton folded before Flop (didn't bet)
Seat 9: Monsthand folded before Flop (didn't bet)





PokerStars Hand #150121314464:  Hold'em No Limit ($0.50/$1.00 USD) - 2016/03/10 10:32:15 CET [2016/03/10 4:32:15 ET]
Table 'Leda II' 9-max Seat #5 is the button
Seat 1: DIMAN_324 ($100 in chips) 
Seat 2: corsair888 ($107.80 in chips) 
Seat 4: Zier89 ($87.46 in chips) 
Seat 5: matiko09 ($109.51 in chips) 
Seat 6: AlKatrone ($181.99 in chips) 
Seat 7: BKA12 ($100 in chips) 
Seat 8: peppsta ($84.35 in chips) 
Seat 9: Yaaaazz ($107.21 in chips) 
AlKatrone: posts small blind $0.50
BKA12: posts big blind $1
*** HOLE CARDS ***
Dealt to matiko09 [Kd 5d]
peppsta: folds 
Yaaaazz: folds 
DIMAN_324: folds 
corsair888: folds 
Zier89: folds 
matiko09: raises $1.27 to $2.27
AlKatrone: folds 
BKA12: folds 
Uncalled bet ($1.27) returned to matiko09
matiko09 collected $2.50 from pot
matiko09: doesn't show hand 
*** SUMMARY ***
Total pot $2.50 | Rake $0 
Seat 1: DIMAN_324 folded before Flop (didn't bet)
Seat 2: corsair888 folded before Flop (didn't bet)
Seat 4: Zier89 folded before Flop (didn't bet)
Seat 5: matiko09 (button) collected ($2.50)
Seat 6: AlKatrone (small blind) folded before Flop
Seat 7: BKA12 (big blind) folded before Flop
Seat 8: peppsta folded before Flop (didn't bet)
Seat 9: Yaaaazz folded before Flop (didn't bet)





PokerStars Hand #150121314520:  Hold'em No Limit (€0.25/€0.50 EUR) - 2016/03/10 10:32:15 CET [2016/03/10 4:32:15 ET]
Table 'Algorab' 9-max Seat #7 is the button
Seat 1: nubpoker (€50 in chips) 
Seat 3: dididi2000 (€37.45 in chips) 
Seat 4: Butcher1848 (€75.58 in chips) 
Seat 6: q3storm (€50 in chips) 
Seat 7: matiko09 (€91.88 in chips) 
Seat 8: fudzi (€50.25 in chips) 
Seat 9: vlad11122007 (€54.25 in chips) 
fudzi: posts small blind €0.25
vlad11122007: posts big blind €0.50
*** HOLE CARDS ***
Dealt to matiko09 [Qs 7h]
Sweden_Pound joins the table at seat #2 
nubpoker: raises €1 to €1.50
dididi2000: folds 
Butcher1848: folds 
q3storm: folds 
matiko09: folds 
fudzi: folds 
vlad11122007: folds 
Uncalled bet (€1) returned to nubpoker
nubpoker collected €1.25 from pot
nubpoker: doesn't show hand 
*** SUMMARY ***
Total pot €1.25 | Rake €0 
Seat 1: nubpoker collected (€1.25)
Seat 3: dididi2000 folded before Flop (didn't bet)
Seat 4: Butcher1848 folded before Flop (didn't bet)
Seat 6: q3storm folded before Flop (didn't bet)
Seat 7: matiko09 (button) folded before Flop (didn't bet)
Seat 8: fudzi (small blind) folded before Flop
Seat 9: vlad11122007 (big blind) folded before Flop





PokerStars Hand #150121314870:  Hold'em No Limit ($0.25/$0.50 USD) - 2016/03/10 10:32:16 CET [2016/03/10 4:32:16 ET]
Table 'Aegina' 9-max Seat #1 is the button
Seat 1: Wess_1970 ($74.10 in chips) 
Seat 2: el.suertero ($128.84 in chips) 
Seat 3: matiko09 ($50 in chips) 
Seat 5: depokerlord ($67.03 in chips) 
Seat 6: ardo888 ($173.72 in chips) 
Seat 7: Bohne0815 ($77.54 in chips) 
Seat 8: q3storm ($50 in chips) 
Seat 9: i L00K great ($63.12 in chips) 
el.suertero: posts small blind $0.25
matiko09: posts big blind $0.50
vlad11122007: sits out 
Wess_1970: posts the ante $0.10
el.suertero: posts the ante $0.10
matiko09: posts the ante $0.10
depokerlord: posts the ante $0.10
ardo888: posts the ante $0.10
Bohne0815: posts the ante $0.10
q3storm: posts the ante $0.10
i L00K great: posts the ante $0.10
*** HOLE CARDS ***
Dealt to matiko09 [9s As]
depokerlord: raises $0.50 to $1
ardo888: folds 
Bohne0815: folds 
q3storm: folds 
i L00K great: folds 
Wess_1970: folds 
el.suertero: folds 
matiko09: calls $0.50
*** FLOP *** [Jh Qs Th]
matiko09: checks 
depokerlord: checks 
*** TURN *** [Jh Qs Th] [Js]
matiko09: checks 
depokerlord: checks 
*** RIVER *** [Jh Qs Th Js] [Ac]
matiko09: checks 
depokerlord: bets $3
Bohne0815 is disconnected 
matiko09: folds 
Uncalled bet ($3) returned to depokerlord
depokerlord collected $2.91 from pot
depokerlord: doesn't show hand 
*** SUMMARY ***
Total pot $3.05 | Rake $0.14 
Board [Jh Qs Th Js Ac]
Seat 1: Wess_1970 (button) folded before Flop (didn't bet)
Seat 2: el.suertero (small blind) folded before Flop
Seat 3: matiko09 (big blind) folded on the River
Seat 5: depokerlord collected ($2.91)
Seat 6: ardo888 folded before Flop (didn't bet)
Seat 7: Bohne0815 folded before Flop (didn't bet)
Seat 8: q3storm folded before Flop (didn't bet)
Seat 9: i L00K great folded before Flop (didn't bet)





PokerStars Hand #150121317589:  Hold'em No Limit ($1/$2 USD) - 2016/03/10 10:32:23 CET [2016/03/10 4:32:23 ET]
Table 'Vesta' 9-max Seat #7 is the button
Seat 1: nickreason17 ($234.20 in chips) 
Seat 2: Pernilla E A ($247.55 in chips) 
Seat 3: matiko09 ($200 in chips) 
Seat 4: Yaaaazz ($218.40 in chips) 
Seat 6: djammusic ($554.69 in chips) 
Seat 7: Monsthand ($200 in chips) 
Seat 8: 13Ghosts ($310.41 in chips) 
13Ghosts: posts small blind $1
lixiangli: is sitting out 
nickreason17: posts big blind $2
*** HOLE CARDS ***
Dealt to matiko09 [2s 9c]
Pernilla E A: calls $2
matiko09: folds 
Yaaaazz: folds 
djammusic: folds 
Monsthand: folds 
13Ghosts: calls $1
nickreason17: checks 
*** FLOP *** [Kc 7c Th]
13Ghosts: checks 
nickreason17: checks 
Pernilla E A: checks 
*** TURN *** [Kc 7c Th] [Kd]
13Ghosts: bets $3.81
nickreason17: folds 
Pernilla E A: folds 
Uncalled bet ($3.81) returned to 13Ghosts
13Ghosts collected $5.73 from pot
13Ghosts: doesn't show hand 
lixiangli said, "88"
*** SUMMARY ***
Total pot $6 | Rake $0.27 
Board [Kc 7c Th Kd]
Seat 1: nickreason17 (big blind) folded on the Turn
Seat 2: Pernilla E A folded on the Turn
Seat 3: matiko09 folded before Flop (didn't bet)
Seat 4: Yaaaazz folded before Flop (didn't bet)
Seat 6: djammusic folded before Flop (didn't bet)
Seat 7: Monsthand (button) folded before Flop (didn't bet)
Seat 8: 13Ghosts (small blind) collected ($5.73)





PokerStars Hand #150121318095:  Hold'em No Limit ($1/$2 USD) - 2016/03/10 10:32:24 CET [2016/03/10 4:32:24 ET]
Table 'Sophia II' 9-max Seat #7 is the button
Seat 2: nickreason17 ($212.71 in chips) 
Seat 4: hejun0713 ($189.50 in chips) 
Seat 5: matiko09 ($206.46 in chips) 
Seat 6: WrongButton ($371.86 in chips) 
Seat 7: Monsthand ($391.41 in chips) 
Seat 8: BOAYARSKIY ($75 in chips) 
Seat 9: CARDNAPPED ($45.93 in chips) 
BOAYARSKIY: posts small blind $1
CARDNAPPED: posts big blind $2
toprmaw: sits out 
docwark: sits out 
*** HOLE CARDS ***
Dealt to matiko09 [4d 6d]
nickreason17: folds 
hejun0713: folds 
matiko09: folds 
WrongButton: folds 
Monsthand: folds 
BOAYARSKIY: folds 
Uncalled bet ($1) returned to CARDNAPPED
CARDNAPPED collected $2 from pot
CARDNAPPED: doesn't show hand 
*** SUMMARY ***
Total pot $2 | Rake $0 
Seat 2: nickreason17 folded before Flop (didn't bet)
Seat 4: hejun0713 folded before Flop (didn't bet)
Seat 5: matiko09 folded before Flop (didn't bet)
Seat 6: WrongButton folded before Flop (didn't bet)
Seat 7: Monsthand (button) folded before Flop (didn't bet)
Seat 8: BOAYARSKIY (small blind) folded before Flop
Seat 9: CARDNAPPED (big blind) collected ($2)





PokerStars Hand #150121319514:  Hold'em No Limit ($1/$2 USD) - 2016/03/10 10:32:28 CET [2016/03/10 4:32:28 ET]
Table 'Tauris II' 9-max Seat #2 is the button
Seat 1: toprmaw ($273.81 in chips) 
Seat 2: nickreason17 ($208.67 in chips) 
Seat 3: BOAYARSKIY ($78 in chips) 
Seat 4: matiko09 ($371.78 in chips) 
Seat 5: Spudly6 ($199.72 in chips) 
Seat 6: Yaaaazz ($224.79 in chips) 
Seat 7: Monsthand ($222.85 in chips) 
Seat 8: WrongButton ($253.38 in chips) 
Seat 9: darren1031 ($157.90 in chips) 
BOAYARSKIY: posts small blind $1
matiko09: posts big blind $2
*** HOLE CARDS ***
Dealt to matiko09 [4h 7c]
Spudly6: folds 
Yaaaazz: folds 
Monsthand: folds 
WrongButton: folds 
darren1031: raises $4 to $6
toprmaw: folds 
nickreason17: folds 
BOAYARSKIY: folds 
matiko09: folds 
Uncalled bet ($4) returned to darren1031
darren1031 collected $5 from pot
darren1031: doesn't show hand 
*** SUMMARY ***
Total pot $5 | Rake $0 
Seat 1: toprmaw folded before Flop (didn't bet)
Seat 2: nickreason17 (button) folded before Flop (didn't bet)
Seat 3: BOAYARSKIY (small blind) folded before Flop
Seat 4: matiko09 (big blind) folded before Flop
Seat 5: Spudly6 folded before Flop (didn't bet)
Seat 6: Yaaaazz folded before Flop (didn't bet)
Seat 7: Monsthand folded before Flop (didn't bet)
Seat 8: WrongButton folded before Flop (didn't bet)
Seat 9: darren1031 collected ($5)





PokerStars Hand #150121319463:  Hold'em No Limit ($1/$2 USD) - 2016/03/10 10:32:28 CET [2016/03/10 4:32:28 ET]
Table 'Archid' 9-max Seat #9 is the button
Seat 1: AP3221 ($114.58 in chips) 
Seat 2: geiranger011 ($90.64 in chips) 
Seat 3: sarkat104 ($255.63 in chips) 
Seat 4: Monsthand ($205.37 in chips) 
Seat 5: toprmaw ($208 in chips) 
Seat 6: BOAYARSKIY ($80 in chips) 
Seat 8: matiko09 ($227.23 in chips) 
Seat 9: WrongButton ($209.11 in chips) 
AP3221: posts small blind $1
geiranger011: posts big blind $2
*** HOLE CARDS ***
Dealt to matiko09 [9s 5d]
sarkat104: folds 
Monsthand: raises $3.40 to $5.40
toprmaw: folds 
BOAYARSKIY: folds 
matiko09: folds 
WrongButton: folds 
AP3221: folds 
geiranger011: folds 
Uncalled bet ($3.40) returned to Monsthand
Monsthand collected $5 from pot
Monsthand: doesn't show hand 
*** SUMMARY ***
Total pot $5 | Rake $0 
Seat 1: AP3221 (small blind) folded before Flop
Seat 2: geiranger011 (big blind) folded before Flop
Seat 3: sarkat104 folded before Flop (didn't bet)
Seat 4: Monsthand collected ($5)
Seat 5: toprmaw folded before Flop (didn't bet)
Seat 6: BOAYARSKIY folded before Flop (didn't bet)
Seat 8: matiko09 folded before Flop (didn't bet)
Seat 9: WrongButton (button) folded before Flop (didn't bet)





PokerStars Hand #150121323934:  Hold'em No Limit (€0.25/€0.50 EUR) - 2016/03/10 10:32:40 CET [2016/03/10 4:32:40 ET]
Table 'Algorab' 9-max Seat #8 is the button
Seat 2: Sweden_Pound (€50 in chips) 
Seat 3: dididi2000 (€37.45 in chips) 
Seat 4: Butcher1848 (€75.58 in chips) 
Seat 6: q3storm (€50 in chips) 
Seat 7: matiko09 (€91.88 in chips) 
Seat 8: fudzi (€50 in chips) 
Seat 9: vlad11122007 (€53.75 in chips) 
vlad11122007: posts small blind €0.25
nubpoker: is sitting out 
Sweden_Pound: posts big blind €0.50
*** HOLE CARDS ***
Dealt to matiko09 [Kh Ah]
nubpoker leaves the table
St.LaCoste joins the table at seat #1 
dididi2000: folds 
Butcher1848: folds 
q3storm: folds 
St.LaCoste leaves the table
Dantist1122 joins the table at seat #1 
matiko09: raises €1 to €1.50
fudzi: folds 
vlad11122007: folds 
Dantist1122 leaves the table
St.LaCoste joins the table at seat #1 
Sweden_Pound: folds 
Uncalled bet (€1) returned to matiko09
matiko09 collected €1.25 from pot
matiko09: doesn't show hand 
*** SUMMARY ***
Total pot €1.25 | Rake €0 
Seat 2: Sweden_Pound (big blind) folded before Flop
Seat 3: dididi2000 folded before Flop (didn't bet)
Seat 4: Butcher1848 folded before Flop (didn't bet)
Seat 6: q3storm folded before Flop (didn't bet)
Seat 7: matiko09 collected (€1.25)
Seat 8: fudzi (button) folded before Flop (didn't bet)
Seat 9: vlad11122007 (small blind) folded before Flop





PokerStars Hand #150121326391:  Hold'em No Limit ($1/$2 USD) - 2016/03/10 10:32:46 CET [2016/03/10 4:32:46 ET]
Table 'Sophia II' 9-max Seat #8 is the button
Seat 1: toprmaw ($200 in chips) 
Seat 2: nickreason17 ($212.71 in chips) 
Seat 4: hejun0713 ($189.50 in chips) 
Seat 5: matiko09 ($206.46 in chips) 
Seat 6: WrongButton ($371.86 in chips) 
Seat 7: Monsthand ($391.41 in chips) 
Seat 8: BOAYARSKIY ($74 in chips) 
Seat 9: CARDNAPPED ($46.93 in chips) 
CARDNAPPED: posts small blind $1
toprmaw: posts big blind $2
docwark: sits out 
*** HOLE CARDS ***
Dealt to matiko09 [6h 5d]
nickreason17: folds 
hejun0713: folds 
matiko09: folds 
WrongButton: folds 
Monsthand: folds 
BOAYARSKIY: raises $2.26 to $4.26
CARDNAPPED: folds 
toprmaw: raises $8.74 to $13
BOAYARSKIY: folds 
Uncalled bet ($8.74) returned to toprmaw
toprmaw collected $9.52 from pot
toprmaw: doesn't show hand 
*** SUMMARY ***
Total pot $9.52 | Rake $0 
Seat 1: toprmaw (big blind) collected ($9.52)
Seat 2: nickreason17 folded before Flop (didn't bet)
Seat 4: hejun0713 folded before Flop (didn't bet)
Seat 5: matiko09 folded before Flop (didn't bet)
Seat 6: WrongButton folded before Flop (didn't bet)
Seat 7: Monsthand folded before Flop (didn't bet)
Seat 8: BOAYARSKIY (button) folded before Flop
Seat 9: CARDNAPPED (small blind) folded before Flop





PokerStars Hand #150121327033:  Hold'em No Limit ($0.50/$1.00 USD) - 2016/03/10 10:32:48 CET [2016/03/10 4:32:48 ET]
Table 'Leda II' 9-max Seat #6 is the button
Seat 1: DIMAN_324 ($100 in chips) 
Seat 2: corsair888 ($107.80 in chips) 
Seat 4: Zier89 ($87.46 in chips) 
Seat 5: matiko09 ($111.01 in chips) 
Seat 6: AlKatrone ($181.49 in chips) 
Seat 7: BKA12 ($100 in chips) 
Seat 8: peppsta ($84.35 in chips) 
Seat 9: Yaaaazz ($107.21 in chips) 
BKA12: posts small blind $0.50
peppsta: posts big blind $1
*** HOLE CARDS ***
Dealt to matiko09 [Kd Kh]
Yaaaazz: folds 
DIMAN_324: folds 
corsair888: folds 
Zier89: calls $1
matiko09: raises $3 to $4
AlKatrone: calls $4
BKA12: calls $3.50
peppsta: folds 
Zier89: calls $3
*** FLOP *** [3d 5c 4d]
BKA12: bets $10
Zier89: folds 
matiko09: calls $10
AlKatrone: calls $10
*** TURN *** [3d 5c 4d] [6d]
BKA12: checks 
matiko09: checks 
AlKatrone: bets $24.68
BKA12: folds 
Zier89 is disconnected 
matiko09: folds 
Uncalled bet ($24.68) returned to AlKatrone
AlKatrone collected $44.88 from pot
AlKatrone: doesn't show hand 
*** SUMMARY ***
Total pot $47 | Rake $2.12 
Board [3d 5c 4d 6d]
Seat 1: DIMAN_324 folded before Flop (didn't bet)
Seat 2: corsair888 folded before Flop (didn't bet)
Seat 4: Zier89 folded on the Flop
Seat 5: matiko09 folded on the Turn
Seat 6: AlKatrone (button) collected ($44.88)
Seat 7: BKA12 (small blind) folded on the Turn
Seat 8: peppsta (big blind) folded before Flop
Seat 9: Yaaaazz folded before Flop (didn't bet)





PokerStars Hand #150121327360:  Hold'em No Limit ($1/$2 USD) - 2016/03/10 10:32:49 CET [2016/03/10 4:32:49 ET]
Table 'Solstice II' 9-max Seat #5 is the button
Seat 1: Rycious ($185 in chips) 
Seat 3: vano7777 ($197 in chips) 
Seat 4: matiko09 ($200 in chips) 
Seat 5: toprmaw ($224.04 in chips) 
Seat 6: thecurv ($213.15 in chips) 
Seat 7: WrongButton ($200 in chips) 
Seat 9: Monsthand ($230.97 in chips) 
thecurv: posts small blind $1
WrongButton: posts big blind $2
*** HOLE CARDS ***
Dealt to matiko09 [8s Th]
Monsthand: folds 
Rycious: calls $2
vano7777: raises $7 to $9
matiko09: folds 
toprmaw: folds 
thecurv: folds 
WrongButton: folds 
Rycious: calls $7
*** FLOP *** [Ah Tc 5s]
Rycious: bets $8
vano7777: calls $8
*** TURN *** [Ah Tc 5s] [5h]
Rycious: checks 
peevoajax joins the table at seat #8 
vano7777: bets $10
Rycious: calls $10
*** RIVER *** [Ah Tc 5s 5h] [9d]
Rycious: checks 
maxxmeister leaves the table
vano7777: bets $16
Rycious: folds 
Uncalled bet ($16) returned to vano7777
vano7777 collected $54.44 from pot
*** SUMMARY ***
Total pot $57 | Rake $2.56 
Board [Ah Tc 5s 5h 9d]
Seat 1: Rycious folded on the River
Seat 3: vano7777 collected ($54.44)
Seat 4: matiko09 folded before Flop (didn't bet)
Seat 5: toprmaw (button) folded before Flop (didn't bet)
Seat 6: thecurv (small blind) folded before Flop
Seat 7: WrongButton (big blind) folded before Flop
Seat 9: Monsthand folded before Flop (didn't bet)





PokerStars Hand #150121328496:  Hold'em No Limit ($1/$2 USD) - 2016/03/10 10:32:52 CET [2016/03/10 4:32:52 ET]
Table 'Tauris II' 9-max Seat #3 is the button
Seat 1: toprmaw ($273.81 in chips) 
Seat 2: nickreason17 ($208.67 in chips) 
Seat 3: BOAYARSKIY ($77 in chips) 
Seat 4: matiko09 ($369.78 in chips) 
Seat 5: Spudly6 ($199.72 in chips) 
Seat 6: Yaaaazz ($224.79 in chips) 
Seat 7: Monsthand ($222.85 in chips) 
Seat 8: WrongButton ($253.38 in chips) 
Seat 9: darren1031 ($160.90 in chips) 
matiko09: posts small blind $1
Spudly6: posts big blind $2
*** HOLE CARDS ***
Dealt to matiko09 [Ad Kd]
Yaaaazz: folds 
Monsthand: folds 
WrongButton: folds 
darren1031: folds 
toprmaw: folds 
nickreason17: folds 
BOAYARSKIY: raises $2.26 to $4.26
matiko09: raises $11.74 to $16
Spudly6: folds 
BOAYARSKIY: folds 
Uncalled bet ($11.74) returned to matiko09
matiko09 collected $10.52 from pot
matiko09: doesn't show hand 
*** SUMMARY ***
Total pot $10.52 | Rake $0 
Seat 1: toprmaw folded before Flop (didn't bet)
Seat 2: nickreason17 folded before Flop (didn't bet)
Seat 3: BOAYARSKIY (button) folded before Flop
Seat 4: matiko09 (small blind) collected ($10.52)
Seat 5: Spudly6 (big blind) folded before Flop
Seat 6: Yaaaazz folded before Flop (didn't bet)
Seat 7: Monsthand folded before Flop (didn't bet)
Seat 8: WrongButton folded before Flop (didn't bet)
Seat 9: darren1031 folded before Flop (didn't bet)





PokerStars Hand #150121329577:  Hold'em No Limit ($1/$2 USD) - 2016/03/10 10:32:54 CET [2016/03/10 4:32:54 ET]
Table 'Vesta' 9-max Seat #8 is the button
Seat 1: nickreason17 ($232.20 in chips) 
Seat 2: Pernilla E A ($245.55 in chips) 
Seat 3: matiko09 ($200 in chips) 
Seat 4: Yaaaazz ($218.40 in chips) 
Seat 6: djammusic ($554.69 in chips) 
Seat 7: Monsthand ($200 in chips) 
Seat 8: 13Ghosts ($314.14 in chips) 
nickreason17: posts small blind $1
Pernilla E A: posts big blind $2
*** HOLE CARDS ***
Dealt to matiko09 [Jc Ts]
matiko09: folds 
lixiangli leaves the table
13Ghosts said, "lol"
Yaaaazz: folds 
djammusic: folds 
Monsthand: raises $4 to $6
13Ghosts: folds 
nickreason17: folds 
Pernilla E A: folds 
Uncalled bet ($4) returned to Monsthand
Monsthand collected $5 from pot
Monsthand: doesn't show hand 
*** SUMMARY ***
Total pot $5 | Rake $0 
Seat 1: nickreason17 (small blind) folded before Flop
Seat 2: Pernilla E A (big blind) folded before Flop
Seat 3: matiko09 folded before Flop (didn't bet)
Seat 4: Yaaaazz folded before Flop (didn't bet)
Seat 6: djammusic folded before Flop (didn't bet)
Seat 7: Monsthand collected ($5)
Seat 8: 13Ghosts (button) folded before Flop (didn't bet)





PokerStars Hand #150121329745:  Hold'em No Limit ($0.50/$1.00 USD) - 2016/03/10 10:32:55 CET [2016/03/10 4:32:55 ET]
Table 'Nereid' 9-max Seat #1 is the button
Seat 1: matiko09 ($100 in chips) 
Seat 3: mycka86 ($100 in chips) 
Seat 5: ilaviiitech ($115.03 in chips) 
Seat 6: thecurv ($108.26 in chips) 
Seat 7: Monsthand ($122.32 in chips) 
Seat 8: Rikti ($24.46 in chips) 
mycka86: posts small blind $0.50
xiaoxiaoniao: is sitting out 
ilaviiitech: posts big blind $1
*** HOLE CARDS ***
Dealt to matiko09 [6s Ts]
thecurv: folds 
Monsthand: folds 
Rikti: raises $1 to $2
matiko09: folds 
mycka86: folds 
ilaviiitech: folds 
Uncalled bet ($1) returned to Rikti
Rikti collected $2.50 from pot
Rikti: doesn't show hand 
*** SUMMARY ***
Total pot $2.50 | Rake $0 
Seat 1: matiko09 (button) folded before Flop (didn't bet)
Seat 3: mycka86 (small blind) folded before Flop
Seat 5: ilaviiitech (big blind) folded before Flop
Seat 6: thecurv folded before Flop (didn't bet)
Seat 7: Monsthand folded before Flop (didn't bet)
Seat 8: Rikti collected ($2.50)





PokerStars Hand #150121330377:  Hold'em No Limit ($0.50/$1.00 USD) - 2016/03/10 10:32:56 CET [2016/03/10 4:32:56 ET]
Table 'Ymir II' 9-max Seat #3 is the button
Seat 1: Monsthand ($105.44 in chips) 
Seat 2: er13to ($100 in chips) 
Seat 3: matiko09 ($100 in chips) 
Seat 4: blackw0lf_03 ($153.71 in chips) 
Seat 5: mycka86 ($100 in chips) 
Seat 6: RMilPoker ($113.74 in chips) 
Seat 8: Sweden_Pound ($122.75 in chips) 
Seat 9: Beni Ca$h ($110.68 in chips) 
blackw0lf_03: posts small blind $0.50
mycka86: posts big blind $1
*** HOLE CARDS ***
Dealt to matiko09 [2d Td]
RMilPoker: folds 
Sweden_Pound: raises $2 to $3
Beni Ca$h: folds 
Monsthand: folds 
er13to: folds 
matiko09: folds 
blackw0lf_03: folds 
mycka86: folds 
Uncalled bet ($2) returned to Sweden_Pound
Sweden_Pound collected $2.50 from pot
Sweden_Pound: doesn't show hand 
*** SUMMARY ***
Total pot $2.50 | Rake $0 
Seat 1: Monsthand folded before Flop (didn't bet)
Seat 2: er13to folded before Flop (didn't bet)
Seat 3: matiko09 (button) folded before Flop (didn't bet)
Seat 4: blackw0lf_03 (small blind) folded before Flop
Seat 5: mycka86 (big blind) folded before Flop
Seat 6: RMilPoker folded before Flop (didn't bet)
Seat 8: Sweden_Pound collected ($2.50)
Seat 9: Beni Ca$h folded before Flop (didn't bet)





PokerStars Hand #150121330235:  Hold'em No Limit ($1/$2 USD) - 2016/03/10 10:32:56 CET [2016/03/10 4:32:56 ET]
Table 'Archid' 9-max Seat #1 is the button
Seat 1: AP3221 ($113.58 in chips) 
Seat 2: geiranger011 ($88.64 in chips) 
Seat 3: sarkat104 ($255.63 in chips) 
Seat 4: Monsthand ($208.37 in chips) 
Seat 5: toprmaw ($208 in chips) 
Seat 6: BOAYARSKIY ($80 in chips) 
Seat 8: matiko09 ($227.23 in chips) 
Seat 9: WrongButton ($209.11 in chips) 
geiranger011: posts small blind $1
sarkat104: posts big blind $2
*** HOLE CARDS ***
Dealt to matiko09 [5h Jc]
Monsthand: folds 
toprmaw: folds 
BOAYARSKIY: folds 
matiko09: folds 
WrongButton: raises $4 to $6
AP3221: folds 
geiranger011: folds 
sarkat104: folds 
Uncalled bet ($4) returned to WrongButton
WrongButton collected $5 from pot
*** SUMMARY ***
Total pot $5 | Rake $0 
Seat 1: AP3221 (button) folded before Flop (didn't bet)
Seat 2: geiranger011 (small blind) folded before Flop
Seat 3: sarkat104 (big blind) folded before Flop
Seat 4: Monsthand folded before Flop (didn't bet)
Seat 5: toprmaw folded before Flop (didn't bet)
Seat 6: BOAYARSKIY folded before Flop (didn't bet)
Seat 8: matiko09 folded before Flop (didn't bet)
Seat 9: WrongButton collected ($5)





PokerStars Hand #150121330885:  Hold'em No Limit ($0.50/$1.00 USD) - 2016/03/10 10:32:58 CET [2016/03/10 4:32:58 ET]
Table 'Rarahu' 9-max Seat #8 is the button
Seat 1: matiko09 ($105.66 in chips) 
Seat 2: azzad2007 ($100 in chips) 
Seat 3: BKA12 ($100 in chips) 
Seat 4: vilo1070 ($116.57 in chips) 
Seat 5: blackw0lf_03 ($113.60 in chips) 
Seat 6: RMilPoker ($103.89 in chips) 
Seat 8: Rikti ($70.78 in chips) 
Seat 9: Srz7v44 ($132.74 in chips) 
Srz7v44: posts small blind $0.50
matiko09: posts big blind $1
*** HOLE CARDS ***
Dealt to matiko09 [5s 7c]
azzad2007: folds 
BKA12: folds 
vilo1070: folds 
blackw0lf_03: folds 
RMilPoker: folds 
Rikti: raises $1 to $2
Srz7v44: calls $1.50
matiko09: folds 
*** FLOP *** [9h 9c 8h]
Srz7v44: checks 
Rikti: bets $3
Srz7v44: folds 
Uncalled bet ($3) returned to Rikti
Rikti collected $4.78 from pot
Rikti: doesn't show hand 
*** SUMMARY ***
Total pot $5 | Rake $0.22 
Board [9h 9c 8h]
Seat 1: matiko09 (big blind) folded before Flop
Seat 2: azzad2007 folded before Flop (didn't bet)
Seat 3: BKA12 folded before Flop (didn't bet)
Seat 4: vilo1070 folded before Flop (didn't bet)
Seat 5: blackw0lf_03 folded before Flop (didn't bet)
Seat 6: RMilPoker folded before Flop (didn't bet)
Seat 8: Rikti (button) collected ($4.78)
Seat 9: Srz7v44 (small blind) folded on the Flop





PokerStars Hand #150121338845:  Hold'em No Limit ($0.25/$0.50 USD) - 2016/03/10 10:33:19 CET [2016/03/10 4:33:19 ET]
Table 'Aegina' 9-max Seat #2 is the button
Seat 1: Wess_1970 ($74 in chips) 
Seat 2: el.suertero ($128.49 in chips) 
Seat 3: matiko09 ($50 in chips) 
Seat 4: vlad11122007 ($64.56 in chips) 
Seat 5: depokerlord ($68.84 in chips) 
Seat 6: ardo888 ($173.62 in chips) 
Seat 7: Bohne0815 ($77.44 in chips) 
Seat 8: q3storm ($50 in chips) 
Seat 9: i L00K great ($63.02 in chips) 
matiko09: posts small blind $0.25
vlad11122007: posts big blind $0.50
Wess_1970: posts the ante $0.10
el.suertero: posts the ante $0.10
matiko09: posts the ante $0.10
vlad11122007: posts the ante $0.10
depokerlord: posts the ante $0.10
ardo888: posts the ante $0.10
Bohne0815: posts the ante $0.10
q3storm: posts the ante $0.10
i L00K great: posts the ante $0.10
*** HOLE CARDS ***
Dealt to matiko09 [Kh 6s]
depokerlord: folds 
ardo888: folds 
Bohne0815: folds 
q3storm: folds 
i L00K great: raises $1 to $1.50
Wess_1970: raises $1 to $2.50
el.suertero: calls $2.50
matiko09: folds 
vlad11122007: folds 
i L00K great: calls $1
*** FLOP *** [8d 4h 9c]
i L00K great: checks 
Wess_1970: checks 
el.suertero: checks 
*** TURN *** [8d 4h 9c] [Th]
i L00K great: bets $6.99
Wess_1970: folds 
el.suertero: raises $12.49 to $19.48
i L00K great: raises $40.94 to $60.42 and is all-in
el.suertero: folds 
Uncalled bet ($40.94) returned to i L00K great
i L00K great collected $45.95 from pot
i L00K great: doesn't show hand 
*** SUMMARY ***
Total pot $48.11 | Rake $2.16 
Board [8d 4h 9c Th]
Seat 1: Wess_1970 folded on the Turn
Seat 2: el.suertero (button) folded on the Turn
Seat 3: matiko09 (small blind) folded before Flop
Seat 4: vlad11122007 (big blind) folded before Flop
Seat 5: depokerlord folded before Flop (didn't bet)
Seat 6: ardo888 folded before Flop (didn't bet)
Seat 7: Bohne0815 folded before Flop (didn't bet)
Seat 8: q3storm folded before Flop (didn't bet)
Seat 9: i L00K great collected ($45.95)





PokerStars Hand #150121339919:  Hold'em No Limit ($0.50/$1.00 USD) - 2016/03/10 10:33:21 CET [2016/03/10 4:33:21 ET]
Table 'Nereid' 9-max Seat #3 is the button
Seat 1: matiko09 ($100 in chips) 
Seat 3: mycka86 ($100 in chips) 
Seat 5: ilaviiitech ($114.03 in chips) 
Seat 6: thecurv ($108.26 in chips) 
Seat 7: Monsthand ($122.32 in chips) 
Seat 8: Rikti ($25.96 in chips) 
ilaviiitech: posts small blind $0.50
thecurv: posts big blind $1
*** HOLE CARDS ***
Dealt to matiko09 [8s Ah]
Monsthand: raises $2 to $3
Rikti: folds 
matiko09: folds 
mycka86: folds 
ilaviiitech: folds 
thecurv: folds 
Uncalled bet ($2) returned to Monsthand
Monsthand collected $2.50 from pot
Monsthand: doesn't show hand 
*** SUMMARY ***
Total pot $2.50 | Rake $0 
Seat 1: matiko09 folded before Flop (didn't bet)
Seat 3: mycka86 (button) folded before Flop (didn't bet)
Seat 5: ilaviiitech (small blind) folded before Flop
Seat 6: thecurv (big blind) folded before Flop
Seat 7: Monsthand collected ($2.50)
Seat 8: Rikti folded before Flop (didn't bet)





PokerStars Hand #150121339614:  Hold'em No Limit ($1/$2 USD) - 2016/03/10 10:33:21 CET [2016/03/10 4:33:21 ET]
Table 'Sophia II' 9-max Seat #9 is the button
Seat 1: toprmaw ($205.26 in chips) 
Seat 2: nickreason17 ($212.71 in chips) 
Seat 4: hejun0713 ($189.50 in chips) 
Seat 5: matiko09 ($206.46 in chips) 
Seat 6: WrongButton ($371.86 in chips) 
Seat 7: Monsthand ($391.41 in chips) 
Seat 8: BOAYARSKIY ($80 in chips) 
Seat 9: CARDNAPPED ($45.93 in chips) 
toprmaw: posts small blind $1
nickreason17: posts big blind $2
docwark: sits out 
*** HOLE CARDS ***
Dealt to matiko09 [5c Kd]
hejun0713: folds 
matiko09: folds 
WrongButton: folds 
Monsthand: folds 
BOAYARSKIY: raises $2.26 to $4.26
CARDNAPPED: raises $41.67 to $45.93 and is all-in
toprmaw: folds 
nickreason17: folds 
BOAYARSKIY: folds 
Uncalled bet ($41.67) returned to CARDNAPPED
CARDNAPPED collected $11.52 from pot
CARDNAPPED: doesn't show hand 
*** SUMMARY ***
Total pot $11.52 | Rake $0 
Seat 1: toprmaw (small blind) folded before Flop
Seat 2: nickreason17 (big blind) folded before Flop
Seat 4: hejun0713 folded before Flop (didn't bet)
Seat 5: matiko09 folded before Flop (didn't bet)
Seat 6: WrongButton folded before Flop (didn't bet)
Seat 7: Monsthand folded before Flop (didn't bet)
Seat 8: BOAYARSKIY folded before Flop
Seat 9: CARDNAPPED (button) collected ($11.52)





PokerStars Hand #150121340312:  Hold'em No Limit ($1/$2 USD) - 2016/03/10 10:33:22 CET [2016/03/10 4:33:22 ET]
Table 'Tauris II' 9-max Seat #4 is the button
Seat 1: toprmaw ($273.81 in chips) 
Seat 2: nickreason17 ($208.67 in chips) 
Seat 3: BOAYARSKIY ($72.74 in chips) 
Seat 4: matiko09 ($376.04 in chips) 
Seat 5: Spudly6 ($197.72 in chips) 
Seat 6: Yaaaazz ($224.79 in chips) 
Seat 7: Monsthand ($222.85 in chips) 
Seat 8: WrongButton ($253.38 in chips) 
Seat 9: darren1031 ($160.90 in chips) 
Spudly6: posts small blind $1
Yaaaazz: posts big blind $2
*** HOLE CARDS ***
Dealt to matiko09 [2s 7c]
Monsthand: folds 
WrongButton: folds 
darren1031: folds 
toprmaw: folds 
nickreason17: folds 
BOAYARSKIY: folds 
matiko09: folds 
Spudly6: calls $1
Yaaaazz: checks 
*** FLOP *** [Qs Ks 9s]
Spudly6: checks 
Yaaaazz: checks 
*** TURN *** [Qs Ks 9s] [Jc]
Spudly6: checks 
Yaaaazz: checks 
*** RIVER *** [Qs Ks 9s Jc] [3d]
Spudly6: checks 
Yaaaazz: checks 
*** SHOW DOWN ***
Spudly6: shows [3h Ad] (a pair of Threes)
Yaaaazz: shows [Kc 7h] (a pair of Kings)
Yaaaazz collected $3.82 from pot
*** SUMMARY ***
Total pot $4 | Rake $0.18 
Board [Qs Ks 9s Jc 3d]
Seat 1: toprmaw folded before Flop (didn't bet)
Seat 2: nickreason17 folded before Flop (didn't bet)
Seat 3: BOAYARSKIY folded before Flop (didn't bet)
Seat 4: matiko09 (button) folded before Flop (didn't bet)
Seat 5: Spudly6 (small blind) showed [3h Ad] and lost with a pair of Threes
Seat 6: Yaaaazz (big blind) showed [Kc 7h] and won ($3.82) with a pair of Kings
Seat 7: Monsthand folded before Flop (didn't bet)
Seat 8: WrongButton folded before Flop (didn't bet)
Seat 9: darren1031 folded before Flop (didn't bet)





PokerStars Hand #150121340518:  Hold'em No Limit ($1/$2 USD) - 2016/03/10 10:33:23 CET [2016/03/10 4:33:23 ET]
Table 'Vesta' 9-max Seat #1 is the button
Seat 1: nickreason17 ($231.20 in chips) 
Seat 2: Pernilla E A ($243.55 in chips) 
Seat 3: matiko09 ($200 in chips) 
Seat 4: Yaaaazz ($218.40 in chips) 
Seat 6: djammusic ($554.69 in chips) 
Seat 7: Monsthand ($203 in chips) 
Seat 8: 13Ghosts ($314.14 in chips) 
Pernilla E A: posts small blind $1
matiko09: posts big blind $2
*** HOLE CARDS ***
Dealt to matiko09 [5s 7s]
Yaaaazz: folds 
djammusic: folds 
Monsthand: folds 
13Ghosts: folds 
toprmaw joins the table at seat #9 
nickreason17: folds 
toprmaw leaves the table
BOAYARSKIY joins the table at seat #9 
Pernilla E A: folds 
Uncalled bet ($1) returned to matiko09
matiko09 collected $2 from pot
matiko09: doesn't show hand 
*** SUMMARY ***
Total pot $2 | Rake $0 
Seat 1: nickreason17 (button) folded before Flop (didn't bet)
Seat 2: Pernilla E A (small blind) folded before Flop
Seat 3: matiko09 (big blind) collected ($2)
Seat 4: Yaaaazz folded before Flop (didn't bet)
Seat 6: djammusic folded before Flop (didn't bet)
Seat 7: Monsthand folded before Flop (didn't bet)
Seat 8: 13Ghosts folded before Flop (didn't bet)





PokerStars Hand #150121342629:  Hold'em No Limit ($0.50/$1.00 USD) - 2016/03/10 10:33:28 CET [2016/03/10 4:33:28 ET]
Table 'Ymir II' 9-max Seat #4 is the button
Seat 1: Monsthand ($105.44 in chips) 
Seat 2: er13to ($100 in chips) 
Seat 3: matiko09 ($100 in chips) 
Seat 4: blackw0lf_03 ($153.21 in chips) 
Seat 5: mycka86 ($100 in chips) 
Seat 6: RMilPoker ($113.74 in chips) 
Seat 8: Sweden_Pound ($124.25 in chips) 
Seat 9: Beni Ca$h ($110.68 in chips) 
mycka86: posts small blind $0.50
RMilPoker: posts big blind $1
*** HOLE CARDS ***
Dealt to matiko09 [Ts Ks]
Sweden_Pound: folds 
Beni Ca$h: folds 
Monsthand: raises $1.70 to $2.70
er13to: folds 
matiko09: calls $2.70
blackw0lf_03: folds 
mycka86: folds 
RMilPoker: folds 
*** FLOP *** [2d Qc 3s]
Monsthand: checks 
matiko09: bets $4.28
Monsthand: folds 
Uncalled bet ($4.28) returned to matiko09
matiko09 collected $6.59 from pot
matiko09: doesn't show hand 
*** SUMMARY ***
Total pot $6.90 | Rake $0.31 
Board [2d Qc 3s]
Seat 1: Monsthand folded on the Flop
Seat 2: er13to folded before Flop (didn't bet)
Seat 3: matiko09 collected ($6.59)
Seat 4: blackw0lf_03 (button) folded before Flop (didn't bet)
Seat 5: mycka86 (small blind) folded before Flop
Seat 6: RMilPoker (big blind) folded before Flop
Seat 8: Sweden_Pound folded before Flop (didn't bet)
Seat 9: Beni Ca$h folded before Flop (didn't bet)





PokerStars Hand #150121343294:  Hold'em No Limit ($1/$2 USD) - 2016/03/10 10:33:30 CET [2016/03/10 4:33:30 ET]
Table 'Archid' 9-max Seat #2 is the button
Seat 1: AP3221 ($113.58 in chips) 
Seat 2: geiranger011 ($87.64 in chips) 
Seat 3: sarkat104 ($253.63 in chips) 
Seat 4: Monsthand ($208.37 in chips) 
Seat 5: toprmaw ($208 in chips) 
Seat 6: BOAYARSKIY ($80 in chips) 
Seat 8: matiko09 ($227.23 in chips) 
Seat 9: WrongButton ($212.11 in chips) 
sarkat104: posts small blind $1
Monsthand: posts big blind $2
*** HOLE CARDS ***
Dealt to matiko09 [8s 9s]
peevoajax joins the table at seat #7 
toprmaw: folds 
BOAYARSKIY: folds 
matiko09: raises $4 to $6
WrongButton: folds 
AP3221: folds 
geiranger011: folds 
sarkat104: folds 
Monsthand: folds 
Uncalled bet ($4) returned to matiko09
matiko09 collected $5 from pot
matiko09: doesn't show hand 
*** SUMMARY ***
Total pot $5 | Rake $0 
Seat 1: AP3221 folded before Flop (didn't bet)
Seat 2: geiranger011 (button) folded before Flop (didn't bet)
Seat 3: sarkat104 (small blind) folded before Flop
Seat 4: Monsthand (big blind) folded before Flop
Seat 5: toprmaw folded before Flop (didn't bet)
Seat 6: BOAYARSKIY folded before Flop (didn't bet)
Seat 8: matiko09 collected ($5)
Seat 9: WrongButton folded before Flop (didn't bet)





PokerStars Hand #150121343381:  Hold'em No Limit (€0.25/€0.50 EUR) - 2016/03/10 10:33:30 CET [2016/03/10 4:33:30 ET]
Table 'Algorab' 9-max Seat #9 is the button
Seat 2: Sweden_Pound (€50 in chips) 
Seat 3: dididi2000 (€37.45 in chips) 
Seat 4: Butcher1848 (€75.58 in chips) 
Seat 6: q3storm (€50 in chips) 
Seat 7: matiko09 (€92.63 in chips) 
Seat 8: fudzi (€50 in chips) 
Seat 9: vlad11122007 (€53.50 in chips) 
Sweden_Pound: posts small blind €0.25
dididi2000: posts big blind €0.50
*** HOLE CARDS ***
Dealt to matiko09 [9h 5h]
Butcher1848: folds 
q3storm: folds 
matiko09: folds 
St.LaCoste leaves the table
fudzi: folds 
vlad11122007: raises €0.50 to €1
Sweden_Pound: folds 
dididi2000: calls €0.50
*** FLOP *** [9s Qs 4h]
dididi2000: checks 
vlad11122007: checks 
*** TURN *** [9s Qs 4h] [Js]
dididi2000: bets €1.50
vlad11122007: folds 
Uncalled bet (€1.50) returned to dididi2000
dididi2000 collected €2.15 from pot
dididi2000: doesn't show hand 
*** SUMMARY ***
Total pot €2.25 | Rake €0.10 
Board [9s Qs 4h Js]
Seat 2: Sweden_Pound (small blind) folded before Flop
Seat 3: dididi2000 (big blind) collected (€2.15)
Seat 4: Butcher1848 folded before Flop (didn't bet)
Seat 6: q3storm folded before Flop (didn't bet)
Seat 7: matiko09 folded before Flop (didn't bet)
Seat 8: fudzi folded before Flop (didn't bet)
Seat 9: vlad11122007 (button) folded on the Turn





PokerStars Hand #150121345515:  Hold'em No Limit ($0.50/$1.00 USD) - 2016/03/10 10:33:36 CET [2016/03/10 4:33:36 ET]
Table 'Nereid' 9-max Seat #5 is the button
Seat 1: matiko09 ($100 in chips) 
Seat 3: mycka86 ($100 in chips) 
Seat 5: ilaviiitech ($113.53 in chips) 
Seat 6: thecurv ($107.26 in chips) 
Seat 7: Monsthand ($123.82 in chips) 
Seat 8: Rikti ($25.96 in chips) 
thecurv: posts small blind $0.50
Monsthand: posts big blind $1
*** HOLE CARDS ***
Dealt to matiko09 [9s Ks]
Rikti: folds 
matiko09: raises $2 to $3
mycka86: folds 
ilaviiitech: folds 
thecurv: raises $7 to $10
Monsthand: folds 
matiko09: folds 
Uncalled bet ($7) returned to thecurv
thecurv collected $7 from pot
thecurv: doesn't show hand 
*** SUMMARY ***
Total pot $7 | Rake $0 
Seat 1: matiko09 folded before Flop
Seat 3: mycka86 folded before Flop (didn't bet)
Seat 5: ilaviiitech (button) folded before Flop (didn't bet)
Seat 6: thecurv (small blind) collected ($7)
Seat 7: Monsthand (big blind) folded before Flop
Seat 8: Rikti folded before Flop (didn't bet)





PokerStars Hand #150121346263:  Hold'em No Limit ($1/$2 USD) - 2016/03/10 10:33:38 CET [2016/03/10 4:33:38 ET]
Table 'Vesta' 9-max Seat #2 is the button
Seat 1: nickreason17 ($231.20 in chips) 
Seat 2: Pernilla E A ($242.55 in chips) 
Seat 3: matiko09 ($201 in chips) 
Seat 4: Yaaaazz ($218.40 in chips) 
Seat 6: djammusic ($554.69 in chips) 
Seat 7: Monsthand ($203 in chips) 
Seat 8: 13Ghosts ($314.14 in chips) 
matiko09: posts small blind $1
Yaaaazz: posts big blind $2
BOAYARSKIY: sits out 
*** HOLE CARDS ***
Dealt to matiko09 [4c Td]
13Ghosts said, "pern"
djammusic: raises $4 to $6
Monsthand: folds 
13Ghosts: folds 
nickreason17: raises $12 to $18
Pernilla E A: folds 
13Ghosts said, "did u ever go to  Macau"
matiko09: folds 
Yaaaazz: folds 
djammusic: folds 
Uncalled bet ($12) returned to nickreason17
nickreason17 collected $15 from pot
*** SUMMARY ***
Total pot $15 | Rake $0 
Seat 1: nickreason17 collected ($15)
Seat 2: Pernilla E A (button) folded before Flop (didn't bet)
Seat 3: matiko09 (small blind) folded before Flop
Seat 4: Yaaaazz (big blind) folded before Flop
Seat 6: djammusic folded before Flop
Seat 7: Monsthand folded before Flop (didn't bet)
Seat 8: 13Ghosts folded before Flop (didn't bet)





PokerStars Hand #150121347972:  Hold'em No Limit ($0.50/$1.00 USD) - 2016/03/10 10:33:42 CET [2016/03/10 4:33:42 ET]
Table 'Rarahu' 9-max Seat #9 is the button
Seat 1: matiko09 ($104.66 in chips) 
Seat 2: azzad2007 ($100 in chips) 
Seat 3: BKA12 ($100 in chips) 
Seat 4: vilo1070 ($116.57 in chips) 
Seat 5: blackw0lf_03 ($113.60 in chips) 
Seat 6: RMilPoker ($103.89 in chips) 
Seat 8: Rikti ($73.56 in chips) 
Seat 9: Srz7v44 ($130.74 in chips) 
matiko09: posts small blind $0.50
azzad2007: posts big blind $1
*** HOLE CARDS ***
Dealt to matiko09 [7s 2s]
BKA12: folds 
vilo1070: folds 
blackw0lf_03: folds 
RMilPoker: folds 
Rikti: folds 
Srz7v44: raises $1 to $2
matiko09: folds 
azzad2007: folds 
Uncalled bet ($1) returned to Srz7v44
Srz7v44 collected $2.50 from pot
*** SUMMARY ***
Total pot $2.50 | Rake $0 
Seat 1: matiko09 (small blind) folded before Flop
Seat 2: azzad2007 (big blind) folded before Flop
Seat 3: BKA12 folded before Flop (didn't bet)
Seat 4: vilo1070 folded before Flop (didn't bet)
Seat 5: blackw0lf_03 folded before Flop (didn't bet)
Seat 6: RMilPoker folded before Flop (didn't bet)
Seat 8: Rikti folded before Flop (didn't bet)
Seat 9: Srz7v44 (button) collected ($2.50)





PokerStars Hand #150121350036:  Hold'em No Limit ($0.50/$1.00 USD) - 2016/03/10 10:33:48 CET [2016/03/10 4:33:48 ET]
Table 'Alsciaukat' 9-max Seat #4 is the button
Seat 1: Kelvin sai ($83.64 in chips) 
Seat 2: mycka86 ($100 in chips) 
Seat 3: blackw0lf_03 ($125.89 in chips) 
Seat 4: Rikti ($31.50 in chips) 
Seat 5: toprmaw ($117.92 in chips) 
Seat 6: Sweden_Pound ($101.50 in chips) 
Seat 7: Yaaaazz ($141.15 in chips) 
Seat 8: F1dgeT ($100 in chips) 
Seat 9: matiko09 ($101.88 in chips) 
toprmaw: posts small blind $0.50
Sweden_Pound: posts big blind $1
*** HOLE CARDS ***
Dealt to matiko09 [9d Ad]
Yaaaazz: folds 
F1dgeT: folds 
matiko09: folds 
Kelvin sai: folds 
mycka86: folds 
blackw0lf_03: folds 
Rikti: folds 
toprmaw: raises $2 to $3
Sweden_Pound: calls $2
*** FLOP *** [5h Kh 9s]
toprmaw: checks 
Sweden_Pound: bets $3.72
toprmaw: folds 
Uncalled bet ($3.72) returned to Sweden_Pound
Sweden_Pound collected $5.73 from pot
Sweden_Pound: doesn't show hand 
*** SUMMARY ***
Total pot $6 | Rake $0.27 
Board [5h Kh 9s]
Seat 1: Kelvin sai folded before Flop (didn't bet)
Seat 2: mycka86 folded before Flop (didn't bet)
Seat 3: blackw0lf_03 folded before Flop (didn't bet)
Seat 4: Rikti (button) folded before Flop (didn't bet)
Seat 5: toprmaw (small blind) folded on the Flop
Seat 6: Sweden_Pound (big blind) collected ($5.73)
Seat 7: Yaaaazz folded before Flop (didn't bet)
Seat 8: F1dgeT folded before Flop (didn't bet)
Seat 9: matiko09 folded before Flop (didn't bet)





PokerStars Hand #150121351409:  Hold'em No Limit ($1/$2 USD) - 2016/03/10 10:33:51 CET [2016/03/10 4:33:51 ET]
Table 'Solstice II' 9-max Seat #6 is the button
Seat 1: Rycious ($158 in chips) 
Seat 3: vano7777 ($224.44 in chips) 
Seat 4: matiko09 ($200 in chips) 
Seat 5: toprmaw ($224.04 in chips) 
Seat 6: thecurv ($212.15 in chips) 
Seat 7: WrongButton ($200 in chips) 
Seat 8: peevoajax ($200 in chips) 
Seat 9: Monsthand ($230.97 in chips) 
WrongButton: posts small blind $1
peevoajax: posts big blind $2
*** HOLE CARDS ***
Dealt to matiko09 [8c 5c]
Monsthand: raises $4 to $6
Rycious: calls $6
vano7777: folds 
matiko09: folds 
toprmaw: folds 
thecurv: folds 
WrongButton: folds 
peevoajax: folds 
*** FLOP *** [Ah 8d Td]
Monsthand: checks 
Rycious: bets $6
Monsthand: calls $6
*** TURN *** [Ah 8d Td] [2s]
Monsthand: checks 
Rycious: bets $16
Monsthand: raises $31 to $47
Rycious: calls $31
*** RIVER *** [Ah 8d Td 2s] [5d]
Monsthand: bets $100
Rycious: folds 
Uncalled bet ($100) returned to Monsthand
Monsthand collected $118.20 from pot
Monsthand: doesn't show hand 
*** SUMMARY ***
Total pot $121 | Rake $2.80 
Board [Ah 8d Td 2s 5d]
Seat 1: Rycious folded on the River
Seat 3: vano7777 folded before Flop (didn't bet)
Seat 4: matiko09 folded before Flop (didn't bet)
Seat 5: toprmaw folded before Flop (didn't bet)
Seat 6: thecurv (button) folded before Flop (didn't bet)
Seat 7: WrongButton (small blind) folded before Flop
Seat 8: peevoajax (big blind) folded before Flop
Seat 9: Monsthand collected ($118.20)





PokerStars Hand #150121353035:  Hold'em No Limit ($1/$2 USD) - 2016/03/10 10:33:56 CET [2016/03/10 4:33:56 ET]
Table 'Sophia II' 9-max Seat #1 is the button
Seat 1: toprmaw ($204.26 in chips) 
Seat 2: nickreason17 ($210.71 in chips) 
Seat 3: docwark ($120.27 in chips) 
Seat 4: hejun0713 ($189.50 in chips) 
Seat 5: matiko09 ($206.46 in chips) 
Seat 6: WrongButton ($371.86 in chips) 
Seat 7: Monsthand ($391.41 in chips) 
Seat 8: BOAYARSKIY ($75.74 in chips) 
Seat 9: CARDNAPPED ($53.19 in chips) 
nickreason17: posts small blind $1
docwark: posts big blind $2
*** HOLE CARDS ***
Dealt to matiko09 [As Qd]
hejun0713: folds 
matiko09: raises $4 to $6
WrongButton: folds 
Monsthand: folds 
BOAYARSKIY: folds 
CARDNAPPED: calls $6
toprmaw: folds 
nickreason17: folds 
docwark: calls $4
*** FLOP *** [6c 5s 5c]
docwark: checks 
matiko09: checks 
CARDNAPPED: checks 
*** TURN *** [6c 5s 5c] [4h]
docwark: checks 
matiko09: checks 
CARDNAPPED: checks 
*** RIVER *** [6c 5s 5c 4h] [8s]
docwark: checks 
matiko09: checks 
CARDNAPPED: checks 
*** SHOW DOWN ***
docwark: shows [2d Js] (a pair of Fives)
matiko09: shows [As Qd] (a pair of Fives - Ace kicker)
CARDNAPPED: mucks hand 
matiko09 collected $18.14 from pot
*** SUMMARY ***
Total pot $19 | Rake $0.86 
Board [6c 5s 5c 4h 8s]
Seat 1: toprmaw (button) folded before Flop (didn't bet)
Seat 2: nickreason17 (small blind) folded before Flop
Seat 3: docwark (big blind) showed [2d Js] and lost with a pair of Fives
Seat 4: hejun0713 folded before Flop (didn't bet)
Seat 5: matiko09 showed [As Qd] and won ($18.14) with a pair of Fives
Seat 6: WrongButton folded before Flop (didn't bet)
Seat 7: Monsthand folded before Flop (didn't bet)
Seat 8: BOAYARSKIY folded before Flop (didn't bet)
Seat 9: CARDNAPPED mucked [Jh Qc]





PokerStars Hand #150121353328:  Hold'em No Limit ($0.50/$1.00 USD) - 2016/03/10 10:33:56 CET [2016/03/10 4:33:56 ET]
Table 'Nereid' 9-max Seat #6 is the button
Seat 1: matiko09 ($100 in chips) 
Seat 3: mycka86 ($100 in chips) 
Seat 5: ilaviiitech ($113.53 in chips) 
Seat 6: thecurv ($111.26 in chips) 
Seat 7: Monsthand ($122.82 in chips) 
Seat 8: Rikti ($25.96 in chips) 
Monsthand: posts small blind $0.50
Rikti: posts big blind $1
*** HOLE CARDS ***
Dealt to matiko09 [Td Jc]
matiko09: folds 
mycka86: folds 
ilaviiitech: raises $2 to $3
thecurv: folds 
Monsthand: folds 
xiaoxiaoniao is disconnected 
Rikti: folds 
Uncalled bet ($2) returned to ilaviiitech
ilaviiitech collected $2.50 from pot
ilaviiitech: doesn't show hand 
*** SUMMARY ***
Total pot $2.50 | Rake $0 
Seat 1: matiko09 folded before Flop (didn't bet)
Seat 3: mycka86 folded before Flop (didn't bet)
Seat 5: ilaviiitech collected ($2.50)
Seat 6: thecurv (button) folded before Flop (didn't bet)
Seat 7: Monsthand (small blind) folded before Flop
Seat 8: Rikti (big blind) folded before Flop





PokerStars Hand #150121354924:  Hold'em No Limit ($1/$2 USD) - 2016/03/10 10:34:00 CET [2016/03/10 4:34:00 ET]
Table 'Vesta' 9-max Seat #3 is the button
Seat 1: nickreason17 ($240.20 in chips) 
Seat 2: Pernilla E A ($242.55 in chips) 
Seat 3: matiko09 ($200 in chips) 
Seat 4: Yaaaazz ($216.40 in chips) 
Seat 6: djammusic ($548.69 in chips) 
Seat 7: Monsthand ($203 in chips) 
Seat 8: 13Ghosts ($314.14 in chips) 
Yaaaazz: posts small blind $1
djammusic: posts big blind $2
BOAYARSKIY: sits out 
*** HOLE CARDS ***
Dealt to matiko09 [2d 4s]
Monsthand: folds 
13Ghosts: folds 
nickreason17: folds 
Pernilla E A: folds 
matiko09: folds 
Yaaaazz: folds 
Uncalled bet ($1) returned to djammusic
djammusic collected $2 from pot
djammusic: doesn't show hand 
*** SUMMARY ***
Total pot $2 | Rake $0 
Seat 1: nickreason17 folded before Flop (didn't bet)
Seat 2: Pernilla E A folded before Flop (didn't bet)
Seat 3: matiko09 (button) folded before Flop (didn't bet)
Seat 4: Yaaaazz (small blind) folded before Flop
Seat 6: djammusic (big blind) collected ($2)
Seat 7: Monsthand folded before Flop (didn't bet)
Seat 8: 13Ghosts folded before Flop (didn't bet)





PokerStars Hand #150121355341:  Hold'em No Limit ($0.50/$1.00 USD) - 2016/03/10 10:34:01 CET [2016/03/10 4:34:01 ET]
Table 'Rarahu' 9-max Seat #1 is the button
Seat 1: matiko09 ($104.16 in chips) 
Seat 2: azzad2007 ($100 in chips) 
Seat 3: BKA12 ($100 in chips) 
Seat 4: vilo1070 ($116.57 in chips) 
Seat 5: blackw0lf_03 ($113.60 in chips) 
Seat 6: RMilPoker ($103.89 in chips) 
Seat 8: Rikti ($73.56 in chips) 
Seat 9: Srz7v44 ($132.24 in chips) 
azzad2007: posts small blind $0.50
BKA12: posts big blind $1
*** HOLE CARDS ***
Dealt to matiko09 [5d Qh]
vilo1070: folds 
blackw0lf_03: folds 
RMilPoker: folds 
Rikti: folds 
Srz7v44: raises $2 to $3
matiko09: folds 
azzad2007: folds 
BKA12: folds 
Uncalled bet ($2) returned to Srz7v44
Srz7v44 collected $2.50 from pot
*** SUMMARY ***
Total pot $2.50 | Rake $0 
Seat 1: matiko09 (button) folded before Flop (didn't bet)
Seat 2: azzad2007 (small blind) folded before Flop
Seat 3: BKA12 (big blind) folded before Flop
Seat 4: vilo1070 folded before Flop (didn't bet)
Seat 5: blackw0lf_03 folded before Flop (didn't bet)
Seat 6: RMilPoker folded before Flop (didn't bet)
Seat 8: Rikti folded before Flop (didn't bet)
Seat 9: Srz7v44 collected ($2.50)





PokerStars Hand #150121356706:  Hold'em No Limit ($1/$2 USD) - 2016/03/10 10:34:05 CET [2016/03/10 4:34:05 ET]
Table 'Archid' 9-max Seat #3 is the button
Seat 1: AP3221 ($113.58 in chips) 
Seat 2: geiranger011 ($87.64 in chips) 
Seat 3: sarkat104 ($252.63 in chips) 
Seat 4: Monsthand ($206.37 in chips) 
Seat 5: toprmaw ($208 in chips) 
Seat 6: BOAYARSKIY ($80 in chips) 
Seat 8: matiko09 ($230.23 in chips) 
Seat 9: WrongButton ($212.11 in chips) 
Monsthand: posts small blind $1
toprmaw: posts big blind $2
peevoajax: sits out 
*** HOLE CARDS ***
Dealt to matiko09 [7d Th]
BOAYARSKIY: folds 
matiko09: folds 
WrongButton: folds 
AP3221: folds 
geiranger011: raises $3 to $5
sarkat104: folds 
Monsthand: folds 
toprmaw: folds 
Uncalled bet ($3) returned to geiranger011
geiranger011 collected $5 from pot
geiranger011: doesn't show hand 
*** SUMMARY ***
Total pot $5 | Rake $0 
Seat 1: AP3221 folded before Flop (didn't bet)
Seat 2: geiranger011 collected ($5)
Seat 3: sarkat104 (button) folded before Flop (didn't bet)
Seat 4: Monsthand (small blind) folded before Flop
Seat 5: toprmaw (big blind) folded before Flop
Seat 6: BOAYARSKIY folded before Flop (didn't bet)
Seat 8: matiko09 folded before Flop (didn't bet)
Seat 9: WrongButton folded before Flop (didn't bet)





PokerStars Hand #150121364000:  Hold'em No Limit ($1/$2 USD) - 2016/03/10 10:34:24 CET [2016/03/10 4:34:24 ET]
Table 'Tauris II' 9-max Seat #5 is the button
Seat 1: toprmaw ($273.81 in chips) 
Seat 2: nickreason17 ($208.67 in chips) 
Seat 3: BOAYARSKIY ($72.74 in chips) 
Seat 4: matiko09 ($376.04 in chips) 
Seat 5: Spudly6 ($195.72 in chips) 
Seat 6: Yaaaazz ($226.61 in chips) 
Seat 7: Monsthand ($222.85 in chips) 
Seat 8: WrongButton ($253.38 in chips) 
Seat 9: darren1031 ($160.90 in chips) 
Yaaaazz: posts small blind $1
Monsthand: posts big blind $2
*** HOLE CARDS ***
Dealt to matiko09 [9h Tc]
WrongButton: folds 
darren1031: calls $2
toprmaw: folds 
nickreason17: raises $6 to $8
BOAYARSKIY: folds 
matiko09: folds 
Spudly6: folds 
Yaaaazz: folds 
Monsthand: folds 
darren1031: calls $6
*** FLOP *** [2h 4h Qh]
darren1031: bets $10
nickreason17: folds 
Uncalled bet ($10) returned to darren1031
darren1031 collected $18.14 from pot
darren1031: doesn't show hand 
*** SUMMARY ***
Total pot $19 | Rake $0.86 
Board [2h 4h Qh]
Seat 1: toprmaw folded before Flop (didn't bet)
Seat 2: nickreason17 folded on the Flop
Seat 3: BOAYARSKIY folded before Flop (didn't bet)
Seat 4: matiko09 folded before Flop (didn't bet)
Seat 5: Spudly6 (button) folded before Flop (didn't bet)
Seat 6: Yaaaazz (small blind) folded before Flop
Seat 7: Monsthand (big blind) folded before Flop
Seat 8: WrongButton folded before Flop (didn't bet)
Seat 9: darren1031 collected ($18.14)





PokerStars Hand #150121364667:  Hold'em No Limit ($0.50/$1.00 USD) - 2016/03/10 10:34:25 CET [2016/03/10 4:34:25 ET]
Table 'Ymir II' 9-max Seat #5 is the button
Seat 1: Monsthand ($102.74 in chips) 
Seat 2: er13to ($100 in chips) 
Seat 3: matiko09 ($103.89 in chips) 
Seat 4: blackw0lf_03 ($153.21 in chips) 
Seat 5: mycka86 ($100 in chips) 
Seat 6: RMilPoker ($112.74 in chips) 
Seat 8: Sweden_Pound ($124.25 in chips) 
Seat 9: Beni Ca$h ($110.68 in chips) 
RMilPoker: posts small blind $0.50
Sweden_Pound: posts big blind $1
*** HOLE CARDS ***
Dealt to matiko09 [6c 6h]
Beni Ca$h has timed out
Beni Ca$h: folds 
Monsthand: folds 
er13to: folds 
matiko09: raises $2 to $3
blackw0lf_03: folds 
mycka86: folds 
RMilPoker: raises $7 to $10
Sweden_Pound: folds 
matiko09: folds 
Uncalled bet ($7) returned to RMilPoker
RMilPoker collected $7 from pot
RMilPoker: doesn't show hand 
*** SUMMARY ***
Total pot $7 | Rake $0 
Seat 1: Monsthand folded before Flop (didn't bet)
Seat 2: er13to folded before Flop (didn't bet)
Seat 3: matiko09 folded before Flop
Seat 4: blackw0lf_03 folded before Flop (didn't bet)
Seat 5: mycka86 (button) folded before Flop (didn't bet)
Seat 6: RMilPoker (small blind) collected ($7)
Seat 8: Sweden_Pound (big blind) folded before Flop
Seat 9: Beni Ca$h folded before Flop (didn't bet)





PokerStars Hand #150121364560:  Hold'em No Limit ($1/$2 USD) - 2016/03/10 10:34:25 CET [2016/03/10 4:34:25 ET]
Table 'Vesta' 9-max Seat #4 is the button
Seat 1: nickreason17 ($240.20 in chips) 
Seat 2: Pernilla E A ($242.55 in chips) 
Seat 3: matiko09 ($200 in chips) 
Seat 4: Yaaaazz ($215.40 in chips) 
Seat 6: djammusic ($549.69 in chips) 
Seat 7: Monsthand ($203 in chips) 
Seat 8: 13Ghosts ($314.14 in chips) 
djammusic: posts small blind $1
Monsthand: posts big blind $2
BOAYARSKIY: sits out 
*** HOLE CARDS ***
Dealt to matiko09 [4h Kd]
13Ghosts: folds 
nickreason17: folds 
Pernilla E A: raises $4 to $6
matiko09: folds 
Yaaaazz: folds 
djammusic: folds 
Monsthand: folds 
Uncalled bet ($4) returned to Pernilla E A
Pernilla E A collected $5 from pot
*** SUMMARY ***
Total pot $5 | Rake $0 
Seat 1: nickreason17 folded before Flop (didn't bet)
Seat 2: Pernilla E A collected ($5)
Seat 3: matiko09 folded before Flop (didn't bet)
Seat 4: Yaaaazz (button) folded before Flop (didn't bet)
Seat 6: djammusic (small blind) folded before Flop
Seat 7: Monsthand (big blind) folded before Flop
Seat 8: 13Ghosts folded before Flop (didn't bet)





PokerStars Hand #150121365961:  Hold'em No Limit (€0.25/€0.50 EUR) - 2016/03/10 10:34:29 CET [2016/03/10 4:34:29 ET]
Table 'Algorab' 9-max Seat #2 is the button
Seat 2: Sweden_Pound (€50 in chips) 
Seat 3: dididi2000 (€38.60 in chips) 
Seat 4: Butcher1848 (€75.58 in chips) 
Seat 6: q3storm (€50 in chips) 
Seat 7: matiko09 (€92.63 in chips) 
Seat 8: fudzi (€50 in chips) 
Seat 9: vlad11122007 (€52.50 in chips) 
dididi2000: posts small blind €0.25
Butcher1848: posts big blind €0.50
*** HOLE CARDS ***
Dealt to matiko09 [6h 3h]
q3storm: folds 
matiko09: folds 
fudzi: folds 
vlad11122007: folds 
Sweden_Pound: raises €0.50 to €1
dididi2000: calls €0.75
Butcher1848: calls €0.50
*** FLOP *** [5d 5s Jh]
dididi2000: checks 
Butcher1848: checks 
Sweden_Pound: bets €1.86
dididi2000: folds 
Butcher1848: calls €1.86
*** TURN *** [5d 5s Jh] [Kd]
Butcher1848: checks 
Sweden_Pound: bets €4.17
Butcher1848: calls €4.17
*** RIVER *** [5d 5s Jh Kd] [3s]
Butcher1848: checks 
Sweden_Pound: bets €9
Butcher1848: folds 
Uncalled bet (€9) returned to Sweden_Pound
Sweden_Pound collected €14.38 from pot
Sweden_Pound: doesn't show hand 
*** SUMMARY ***
Total pot €15.06 | Rake €0.68 
Board [5d 5s Jh Kd 3s]
Seat 2: Sweden_Pound (button) collected (€14.38)
Seat 3: dididi2000 (small blind) folded on the Flop
Seat 4: Butcher1848 (big blind) folded on the River
Seat 6: q3storm folded before Flop (didn't bet)
Seat 7: matiko09 folded before Flop (didn't bet)
Seat 8: fudzi folded before Flop (didn't bet)
Seat 9: vlad11122007 folded before Flop (didn't bet)





PokerStars Hand #150121367538:  Hold'em No Limit ($0.50/$1.00 USD) - 2016/03/10 10:34:33 CET [2016/03/10 4:34:33 ET]
Table 'Rarahu' 9-max Seat #2 is the button
Seat 1: matiko09 ($104.16 in chips) 
Seat 2: azzad2007 ($100 in chips) 
Seat 3: BKA12 ($100 in chips) 
Seat 4: vilo1070 ($116.57 in chips) 
Seat 5: blackw0lf_03 ($113.60 in chips) 
Seat 6: RMilPoker ($103.89 in chips) 
Seat 8: Rikti ($73.56 in chips) 
Seat 9: Srz7v44 ($133.74 in chips) 
BKA12: posts small blind $0.50
vilo1070: posts big blind $1
*** HOLE CARDS ***
Dealt to matiko09 [7h 6h]
blackw0lf_03: folds 
RMilPoker: folds 
Rikti: folds 
Srz7v44: folds 
matiko09: raises $1.50 to $2.50
azzad2007: folds 
BKA12: folds 
vilo1070: raises $5.50 to $8
matiko09: calls $5.50
*** FLOP *** [2d Qc Ks]
vilo1070: checks 
matiko09: checks 
*** TURN *** [2d Qc Ks] [8d]
vilo1070: bets $7
matiko09: folds 
Uncalled bet ($7) returned to vilo1070
vilo1070 collected $15.76 from pot
vilo1070: doesn't show hand 
*** SUMMARY ***
Total pot $16.50 | Rake $0.74 
Board [2d Qc Ks 8d]
Seat 1: matiko09 folded on the Turn
Seat 2: azzad2007 (button) folded before Flop (didn't bet)
Seat 3: BKA12 (small blind) folded before Flop
Seat 4: vilo1070 (big blind) collected ($15.76)
Seat 5: blackw0lf_03 folded before Flop (didn't bet)
Seat 6: RMilPoker folded before Flop (didn't bet)
Seat 8: Rikti folded before Flop (didn't bet)
Seat 9: Srz7v44 folded before Flop (didn't bet)





PokerStars Hand #150121372499:  Hold'em No Limit ($0.25/$0.50 USD) - 2016/03/10 10:34:46 CET [2016/03/10 4:34:46 ET]
Table 'Aegina' 9-max Seat #3 is the button
Seat 1: Wess_1970 ($71.40 in chips) 
Seat 2: el.suertero ($125 in chips) 
Seat 3: matiko09 ($50 in chips) 
Seat 4: vlad11122007 ($63.96 in chips) 
Seat 5: depokerlord ($68.74 in chips) 
Seat 6: ardo888 ($173.52 in chips) 
Seat 7: Bohne0815 ($77.34 in chips) 
Seat 8: q3storm ($50 in chips) 
Seat 9: i L00K great ($86.89 in chips) 
vlad11122007: posts small blind $0.25
depokerlord: posts big blind $0.50
Wess_1970: posts the ante $0.10
el.suertero: posts the ante $0.10
matiko09: posts the ante $0.10
vlad11122007: posts the ante $0.10
depokerlord: posts the ante $0.10
ardo888: posts the ante $0.10
Bohne0815: posts the ante $0.10
q3storm: posts the ante $0.10
i L00K great: posts the ante $0.10
*** HOLE CARDS ***
Dealt to matiko09 [Th 9d]
ardo888: folds 
Bohne0815: folds 
q3storm: folds 
i L00K great: folds 
Wess_1970: folds 
Wess_1970 leaves the table
Sweden_Pound joins the table at seat #1 
el.suertero: folds 
matiko09: raises $0.75 to $1.25
vlad11122007: folds 
depokerlord: calls $0.75
*** FLOP *** [4c 8h 5h]
depokerlord: checks 
matiko09: checks 
*** TURN *** [4c 8h 5h] [6h]
depokerlord: checks 
Bohne0815 is disconnected 
matiko09: checks 
*** RIVER *** [4c 8h 5h 6h] [7c]
depokerlord: checks 
matiko09: bets $3.50
depokerlord: calls $3.50
*** SHOW DOWN ***
matiko09: shows [Th 9d] (a straight, Six to Ten)
depokerlord: mucks hand 
matiko09 collected $10.17 from pot
*** SUMMARY ***
Total pot $10.65 | Rake $0.48 
Board [4c 8h 5h 6h 7c]
Seat 1: Wess_1970 folded before Flop (didn't bet)
Seat 2: el.suertero folded before Flop (didn't bet)
Seat 3: matiko09 (button) showed [Th 9d] and won ($10.17) with a straight, Six to Ten
Seat 4: vlad11122007 (small blind) folded before Flop
Seat 5: depokerlord (big blind) mucked [5s Ah]
Seat 6: ardo888 folded before Flop (didn't bet)
Seat 7: Bohne0815 folded before Flop (didn't bet)
Seat 8: q3storm folded before Flop (didn't bet)
Seat 9: i L00K great folded before Flop (didn't bet)





PokerStars Hand #150121373637:  Hold'em No Limit ($1/$2 USD) - 2016/03/10 10:34:49 CET [2016/03/10 4:34:49 ET]
Table 'Archid' 9-max Seat #4 is the button
Seat 1: AP3221 ($113.58 in chips) 
Seat 2: geiranger011 ($90.64 in chips) 
Seat 3: sarkat104 ($252.63 in chips) 
Seat 4: Monsthand ($205.37 in chips) 
Seat 5: toprmaw ($206 in chips) 
Seat 6: BOAYARSKIY ($80 in chips) 
Seat 8: matiko09 ($230.23 in chips) 
Seat 9: WrongButton ($212.11 in chips) 
toprmaw: posts small blind $1
BOAYARSKIY: posts big blind $2
peevoajax: sits out 
*** HOLE CARDS ***
Dealt to matiko09 [Js 8c]
matiko09: folds 
WrongButton: folds 
AP3221: folds 
geiranger011: folds 
sarkat104: folds 
Monsthand: raises $2 to $4
toprmaw: folds 
BOAYARSKIY: calls $2
*** FLOP *** [6s 5h 3c]
BOAYARSKIY: checks 
Monsthand: bets $4.73
BOAYARSKIY: calls $4.73
*** TURN *** [6s 5h 3c] [Ts]
BOAYARSKIY: checks 
Monsthand: bets $11.20
BOAYARSKIY: folds 
Uncalled bet ($11.20) returned to Monsthand
Monsthand collected $17.63 from pot
Monsthand: doesn't show hand 
*** SUMMARY ***
Total pot $18.46 | Rake $0.83 
Board [6s 5h 3c Ts]
Seat 1: AP3221 folded before Flop (didn't bet)
Seat 2: geiranger011 folded before Flop (didn't bet)
Seat 3: sarkat104 folded before Flop (didn't bet)
Seat 4: Monsthand (button) collected ($17.63)
Seat 5: toprmaw (small blind) folded before Flop
Seat 6: BOAYARSKIY (big blind) folded on the Turn
Seat 8: matiko09 folded before Flop (didn't bet)
Seat 9: WrongButton folded before Flop (didn't bet)





PokerStars Hand #150121374433:  Hold'em No Limit ($0.50/$1.00 USD) - 2016/03/10 10:34:51 CET [2016/03/10 4:34:51 ET]
Table 'Leda II' 9-max Seat #7 is the button
Seat 1: DIMAN_324 ($100 in chips) 
Seat 2: corsair888 ($107.80 in chips) 
Seat 4: Zier89 ($83.46 in chips) 
Seat 5: matiko09 ($100 in chips) 
Seat 6: AlKatrone ($212.37 in chips) 
Seat 7: BKA12 ($100 in chips) 
Seat 8: peppsta ($83.35 in chips) 
Seat 9: Yaaaazz ($107.21 in chips) 
peppsta: posts small blind $0.50
Yaaaazz: posts big blind $1
*** HOLE CARDS ***
Dealt to matiko09 [Jd Qd]
DIMAN_324: folds 
corsair888: folds 
Zier89 has timed out while disconnected
Zier89: folds 
matiko09: raises $2 to $3
AlKatrone: folds 
BKA12: folds 
peppsta: folds 
Yaaaazz: calls $2
*** FLOP *** [Js 2h 6s]
Yaaaazz: checks 
matiko09: bets $4.04
Yaaaazz: folds 
Uncalled bet ($4.04) returned to matiko09
matiko09 collected $6.21 from pot
matiko09: doesn't show hand 
*** SUMMARY ***
Total pot $6.50 | Rake $0.29 
Board [Js 2h 6s]
Seat 1: DIMAN_324 folded before Flop (didn't bet)
Seat 2: corsair888 folded before Flop (didn't bet)
Seat 4: Zier89 folded before Flop (didn't bet)
Seat 5: matiko09 collected ($6.21)
Seat 6: AlKatrone folded before Flop (didn't bet)
Seat 7: BKA12 (button) folded before Flop (didn't bet)
Seat 8: peppsta (small blind) folded before Flop
Seat 9: Yaaaazz (big blind) folded on the Flop





PokerStars Hand #150121376386:  Hold'em No Limit ($0.50/$1.00 USD) - 2016/03/10 10:34:56 CET [2016/03/10 4:34:56 ET]
Table 'Alsciaukat' 9-max Seat #5 is the button
Seat 1: Kelvin sai ($83.64 in chips) 
Seat 2: mycka86 ($100 in chips) 
Seat 3: blackw0lf_03 ($125.89 in chips) 
Seat 4: Rikti ($31.50 in chips) 
Seat 5: toprmaw ($114.92 in chips) 
Seat 6: Sweden_Pound ($104.23 in chips) 
Seat 7: Yaaaazz ($141.15 in chips) 
Seat 8: F1dgeT ($100 in chips) 
Seat 9: matiko09 ($101.88 in chips) 
Sweden_Pound: posts small blind $0.50
Yaaaazz: posts big blind $1
*** HOLE CARDS ***
Dealt to matiko09 [Kd 8s]
F1dgeT: folds 
matiko09: folds 
Kelvin sai: folds 
mycka86: folds 
blackw0lf_03: raises $2 to $3
Rikti: folds 
toprmaw: folds 
Sweden_Pound: folds 
Yaaaazz: folds 
Uncalled bet ($2) returned to blackw0lf_03
blackw0lf_03 collected $2.50 from pot
blackw0lf_03: doesn't show hand 
*** SUMMARY ***
Total pot $2.50 | Rake $0 
Seat 1: Kelvin sai folded before Flop (didn't bet)
Seat 2: mycka86 folded before Flop (didn't bet)
Seat 3: blackw0lf_03 collected ($2.50)
Seat 4: Rikti folded before Flop (didn't bet)
Seat 5: toprmaw (button) folded before Flop (didn't bet)
Seat 6: Sweden_Pound (small blind) folded before Flop
Seat 7: Yaaaazz (big blind) folded before Flop
Seat 8: F1dgeT folded before Flop (didn't bet)
Seat 9: matiko09 folded before Flop (didn't bet)





PokerStars Hand #150121380638:  Hold'em No Limit ($1/$2 USD) - 2016/03/10 10:35:07 CET [2016/03/10 4:35:07 ET]
Table 'Vesta' 9-max Seat #6 is the button
Seat 1: nickreason17 ($240.20 in chips) 
Seat 2: Pernilla E A ($245.55 in chips) 
Seat 3: matiko09 ($200 in chips) 
Seat 4: Yaaaazz ($215.40 in chips) 
Seat 6: djammusic ($548.69 in chips) 
Seat 7: Monsthand ($201 in chips) 
Seat 8: 13Ghosts ($314.14 in chips) 
Monsthand: posts small blind $1
13Ghosts: posts big blind $2
BOAYARSKIY: sits out 
*** HOLE CARDS ***
Dealt to matiko09 [9d 3d]
nickreason17: folds 
Pernilla E A: calls $2
matiko09: folds 
Yaaaazz: folds 
djammusic: folds 
Monsthand: calls $1
13Ghosts: checks 
*** FLOP *** [5s Ac 7d]
Monsthand: checks 
13Ghosts: checks 
Pernilla E A: bets $5.73
Monsthand: folds 
13Ghosts: folds 
Uncalled bet ($5.73) returned to Pernilla E A
Pernilla E A collected $5.73 from pot
*** SUMMARY ***
Total pot $6 | Rake $0.27 
Board [5s Ac 7d]
Seat 1: nickreason17 folded before Flop (didn't bet)
Seat 2: Pernilla E A collected ($5.73)
Seat 3: matiko09 folded before Flop (didn't bet)
Seat 4: Yaaaazz folded before Flop (didn't bet)
Seat 6: djammusic (button) folded before Flop (didn't bet)
Seat 7: Monsthand (small blind) folded on the Flop
Seat 8: 13Ghosts (big blind) folded on the Flop





PokerStars Hand #150121386069:  Hold'em No Limit ($0.50/$1.00 USD) - 2016/03/10 10:35:21 CET [2016/03/10 4:35:21 ET]
Table 'Ymir II' 9-max Seat #6 is the button
Seat 1: Monsthand ($102.74 in chips) 
Seat 2: er13to ($100 in chips) 
Seat 3: matiko09 ($100.89 in chips) 
Seat 4: blackw0lf_03 ($153.21 in chips) 
Seat 5: mycka86 ($100 in chips) 
Seat 6: RMilPoker ($116.74 in chips) 
Seat 8: Sweden_Pound ($123.25 in chips) 
Seat 9: Beni Ca$h ($110.68 in chips) 
Sweden_Pound: posts small blind $0.50
Beni Ca$h: posts big blind $1
*** HOLE CARDS ***
Dealt to matiko09 [Ts 3c]
Monsthand: folds 
er13to: folds 
matiko09: folds 
blackw0lf_03: folds 
mycka86: folds 
RMilPoker: raises $2 to $3
Sweden_Pound: folds 
Beni Ca$h: folds 
Uncalled bet ($2) returned to RMilPoker
RMilPoker collected $2.50 from pot
RMilPoker: doesn't show hand 
*** SUMMARY ***
Total pot $2.50 | Rake $0 
Seat 1: Monsthand folded before Flop (didn't bet)
Seat 2: er13to folded before Flop (didn't bet)
Seat 3: matiko09 folded before Flop (didn't bet)
Seat 4: blackw0lf_03 folded before Flop (didn't bet)
Seat 5: mycka86 folded before Flop (didn't bet)
Seat 6: RMilPoker (button) collected ($2.50)
Seat 8: Sweden_Pound (small blind) folded before Flop
Seat 9: Beni Ca$h (big blind) folded before Flop





PokerStars Hand #150121389530:  Hold'em No Limit ($1/$2 USD) - 2016/03/10 10:35:29 CET [2016/03/10 4:35:29 ET]
Table 'Solstice II' 9-max Seat #7 is the button
Seat 1: Rycious ($99 in chips) 
Seat 3: vano7777 ($224.44 in chips) 
Seat 4: matiko09 ($200 in chips) 
Seat 5: toprmaw ($224.04 in chips) 
Seat 6: thecurv ($212.15 in chips) 
Seat 7: WrongButton ($200 in chips) 
Seat 8: peevoajax ($200 in chips) 
Seat 9: Monsthand ($290.17 in chips) 
peevoajax: posts small blind $1
Monsthand: posts big blind $2
*** HOLE CARDS ***
Dealt to matiko09 [6c 2d]
Rycious: folds 
vano7777: folds 
matiko09: folds 
toprmaw: folds 
thecurv: folds 
WrongButton: raises $2 to $4
peevoajax: folds 
Monsthand: calls $2
*** FLOP *** [7s 6h 2c]
Monsthand: checks 
WrongButton: bets $5.76
Monsthand: folds 
Uncalled bet ($5.76) returned to WrongButton
WrongButton collected $8.60 from pot
*** SUMMARY ***
Total pot $9 | Rake $0.40 
Board [7s 6h 2c]
Seat 1: Rycious folded before Flop (didn't bet)
Seat 3: vano7777 folded before Flop (didn't bet)
Seat 4: matiko09 folded before Flop (didn't bet)
Seat 5: toprmaw folded before Flop (didn't bet)
Seat 6: thecurv folded before Flop (didn't bet)
Seat 7: WrongButton (button) collected ($8.60)
Seat 8: peevoajax (small blind) folded before Flop
Seat 9: Monsthand (big blind) folded on the Flop





PokerStars Hand #150121390778:  Hold'em No Limit ($0.50/$1.00 USD) - 2016/03/10 10:35:33 CET [2016/03/10 4:35:33 ET]
Table 'Rarahu' 9-max Seat #3 is the button
Seat 1: matiko09 ($100 in chips) 
Seat 2: azzad2007 ($100 in chips) 
Seat 3: BKA12 ($100 in chips) 
Seat 4: vilo1070 ($124.33 in chips) 
Seat 5: blackw0lf_03 ($113.60 in chips) 
Seat 6: RMilPoker ($103.89 in chips) 
Seat 8: Rikti ($73.56 in chips) 
Seat 9: Srz7v44 ($133.74 in chips) 
vilo1070: posts small blind $0.50
blackw0lf_03: posts big blind $1
*** HOLE CARDS ***
Dealt to matiko09 [Qd 8s]
RMilPoker: folds 
Rikti: folds 
Srz7v44: folds 
matiko09: folds 
azzad2007: folds 
BKA12: raises $1.50 to $2.50
vilo1070: calls $2
blackw0lf_03: folds 
*** FLOP *** [4s Qc 9d]
vilo1070: checks 
BKA12: checks 
*** TURN *** [4s Qc 9d] [Jc]
vilo1070: bets $3.81
BKA12: calls $3.81
*** RIVER *** [4s Qc 9d Jc] [Qs]
vilo1070: bets $6.50
BKA12: folds 
Uncalled bet ($6.50) returned to vilo1070
vilo1070 collected $13.01 from pot
vilo1070: doesn't show hand 
*** SUMMARY ***
Total pot $13.62 | Rake $0.61 
Board [4s Qc 9d Jc Qs]
Seat 1: matiko09 folded before Flop (didn't bet)
Seat 2: azzad2007 folded before Flop (didn't bet)
Seat 3: BKA12 (button) folded on the River
Seat 4: vilo1070 (small blind) collected ($13.01)
Seat 5: blackw0lf_03 (big blind) folded before Flop
Seat 6: RMilPoker folded before Flop (didn't bet)
Seat 8: Rikti folded before Flop (didn't bet)
Seat 9: Srz7v44 folded before Flop (didn't bet)





PokerStars Hand #150121390952:  Hold'em No Limit ($0.25/$0.50 USD) - 2016/03/10 10:35:33 CET [2016/03/10 4:35:33 ET]
Table 'Aegina' 9-max Seat #4 is the button
Seat 2: el.suertero ($125 in chips) 
Seat 3: matiko09 ($55.32 in chips) 
Seat 4: vlad11122007 ($63.61 in chips) 
Seat 5: depokerlord ($63.89 in chips) 
Seat 6: ardo888 ($173.42 in chips) 
Seat 7: Bohne0815 ($77.24 in chips) 
Seat 8: q3storm ($50 in chips) 
Seat 9: i L00K great ($86.79 in chips) 
depokerlord: posts small blind $0.25
ardo888: posts big blind $0.50
Sweden_Pound: sits out 
el.suertero: posts the ante $0.10
matiko09: posts the ante $0.10
vlad11122007: posts the ante $0.10
depokerlord: posts the ante $0.10
ardo888: posts the ante $0.10
Bohne0815: posts the ante $0.10
q3storm: posts the ante $0.10
i L00K great: posts the ante $0.10
*** HOLE CARDS ***
Dealt to matiko09 [3s 4c]
Bohne0815 has timed out while disconnected
Bohne0815: folds 
q3storm: folds 
i L00K great: folds 
el.suertero: folds 
matiko09: folds 
vlad11122007: folds 
depokerlord: folds 
Uncalled bet ($0.25) returned to ardo888
ardo888 collected $1.30 from pot
ardo888: doesn't show hand 
*** SUMMARY ***
Total pot $1.30 | Rake $0 
Seat 2: el.suertero folded before Flop (didn't bet)
Seat 3: matiko09 folded before Flop (didn't bet)
Seat 4: vlad11122007 (button) folded before Flop (didn't bet)
Seat 5: depokerlord (small blind) folded before Flop
Seat 6: ardo888 (big blind) collected ($1.30)
Seat 7: Bohne0815 folded before Flop (didn't bet)
Seat 8: q3storm folded before Flop (didn't bet)
Seat 9: i L00K great folded before Flop (didn't bet)





PokerStars Hand #150121390877:  Hold'em No Limit ($1/$2 USD) - 2016/03/10 10:35:33 CET [2016/03/10 4:35:33 ET]
Table 'Sophia II' 9-max Seat #2 is the button
Seat 1: toprmaw ($204.26 in chips) 
Seat 2: nickreason17 ($209.71 in chips) 
Seat 3: docwark ($114.27 in chips) 
Seat 4: hejun0713 ($189.50 in chips) 
Seat 5: matiko09 ($218.60 in chips) 
Seat 6: WrongButton ($371.86 in chips) 
Seat 7: Monsthand ($391.41 in chips) 
Seat 8: BOAYARSKIY ($75.74 in chips) 
Seat 9: CARDNAPPED ($47.19 in chips) 
docwark: posts small blind $1
hejun0713: posts big blind $2
*** HOLE CARDS ***
Dealt to matiko09 [Tc 6h]
matiko09: folds 
WrongButton: folds 
Monsthand: folds 
BOAYARSKIY: raises $3 to $5
CARDNAPPED: calls $5
toprmaw: folds 
nickreason17: folds 
docwark: calls $4
hejun0713: calls $3
*** FLOP *** [7c 4d Kc]
docwark: checks 
hejun0713: checks 
BOAYARSKIY: checks 
CARDNAPPED: bets $9.55
docwark: calls $9.55
hejun0713: calls $9.55
BOAYARSKIY: folds 
*** TURN *** [7c 4d Kc] [8s]
docwark: checks 
hejun0713: bets $23.23
CARDNAPPED: raises $9.41 to $32.64 and is all-in
docwark: folds 
hejun0713: calls $9.41
*** RIVER *** [7c 4d Kc 8s] [5d]
*** SHOW DOWN ***
hejun0713: shows [Th Kh] (a pair of Kings)
CARDNAPPED: shows [Kd 7d] (two pair, Kings and Sevens)
CARDNAPPED collected $111.13 from pot
*** SUMMARY ***
Total pot $113.93 | Rake $2.80 
Board [7c 4d Kc 8s 5d]
Seat 1: toprmaw folded before Flop (didn't bet)
Seat 2: nickreason17 (button) folded before Flop (didn't bet)
Seat 3: docwark (small blind) folded on the Turn
Seat 4: hejun0713 (big blind) showed [Th Kh] and lost with a pair of Kings
Seat 5: matiko09 folded before Flop (didn't bet)
Seat 6: WrongButton folded before Flop (didn't bet)
Seat 7: Monsthand folded before Flop (didn't bet)
Seat 8: BOAYARSKIY folded on the Flop
Seat 9: CARDNAPPED showed [Kd 7d] and won ($111.13) with two pair, Kings and Sevens





PokerStars Hand #150121394462:  Hold'em No Limit ($1/$2 USD) - 2016/03/10 10:35:42 CET [2016/03/10 4:35:42 ET]
Table 'Archid' 9-max Seat #5 is the button
Seat 1: AP3221 ($113.58 in chips) 
Seat 2: geiranger011 ($90.64 in chips) 
Seat 3: sarkat104 ($252.63 in chips) 
Seat 4: Monsthand ($214.27 in chips) 
Seat 5: toprmaw ($205 in chips) 
Seat 6: BOAYARSKIY ($71.27 in chips) 
Seat 7: peevoajax ($200 in chips) 
Seat 8: matiko09 ($230.23 in chips) 
Seat 9: WrongButton ($212.11 in chips) 
BOAYARSKIY: posts small blind $1
peevoajax: posts big blind $2
*** HOLE CARDS ***
Dealt to matiko09 [2c 2h]
matiko09: folds 
WrongButton: folds 
AP3221: folds 
geiranger011: folds 
sarkat104: folds 
Monsthand: folds 
toprmaw: folds 
BOAYARSKIY: raises $2.26 to $4.26
peevoajax: folds 
Uncalled bet ($2.26) returned to BOAYARSKIY
BOAYARSKIY collected $4 from pot
BOAYARSKIY: doesn't show hand 
*** SUMMARY ***
Total pot $4 | Rake $0 
Seat 1: AP3221 folded before Flop (didn't bet)
Seat 2: geiranger011 folded before Flop (didn't bet)
Seat 3: sarkat104 folded before Flop (didn't bet)
Seat 4: Monsthand folded before Flop (didn't bet)
Seat 5: toprmaw (button) folded before Flop (didn't bet)
Seat 6: BOAYARSKIY (small blind) collected ($4)
Seat 7: peevoajax (big blind) folded before Flop
Seat 8: matiko09 folded before Flop (didn't bet)
Seat 9: WrongButton folded before Flop (didn't bet)





PokerStars Hand #150121395088:  Hold'em No Limit ($1/$2 USD) - 2016/03/10 10:35:44 CET [2016/03/10 4:35:44 ET]
Table 'Tauris II' 9-max Seat #6 is the button
Seat 1: toprmaw ($273.81 in chips) 
Seat 2: nickreason17 ($200.67 in chips) 
Seat 3: BOAYARSKIY ($72.74 in chips) 
Seat 4: matiko09 ($376.04 in chips) 
Seat 5: Spudly6 ($195.72 in chips) 
Seat 6: Yaaaazz ($225.61 in chips) 
Seat 7: Monsthand ($220.85 in chips) 
Seat 8: WrongButton ($253.38 in chips) 
Seat 9: darren1031 ($171.04 in chips) 
Monsthand: posts small blind $1
WrongButton: posts big blind $2
*** HOLE CARDS ***
Dealt to matiko09 [9h 7h]
darren1031: calls $2
toprmaw: folds 
nickreason17: folds 
BOAYARSKIY: raises $6 to $8
matiko09: folds 
Spudly6: folds 
Yaaaazz: calls $8
Monsthand: calls $7
WrongButton: folds 
darren1031: calls $6
*** FLOP *** [Qc Kd 2c]
Monsthand: checks 
darren1031: checks 
BOAYARSKIY: checks 
Yaaaazz: bets $12
Monsthand: folds 
darren1031: calls $12
BOAYARSKIY: folds 
*** TURN *** [Qc Kd 2c] [3h]
darren1031: checks 
Yaaaazz: bets $28.24
darren1031: calls $28.24
*** RIVER *** [Qc Kd 2c 3h] [2d]
darren1031: checks 
Yaaaazz: bets $86
darren1031: folds 
Uncalled bet ($86) returned to Yaaaazz
Yaaaazz collected $111.68 from pot
*** SUMMARY ***
Total pot $114.48 | Rake $2.80 
Board [Qc Kd 2c 3h 2d]
Seat 1: toprmaw folded before Flop (didn't bet)
Seat 2: nickreason17 folded before Flop (didn't bet)
Seat 3: BOAYARSKIY folded on the Flop
Seat 4: matiko09 folded before Flop (didn't bet)
Seat 5: Spudly6 folded before Flop (didn't bet)
Seat 6: Yaaaazz (button) collected ($111.68)
Seat 7: Monsthand (small blind) folded on the Flop
Seat 8: WrongButton (big blind) folded before Flop
Seat 9: darren1031 folded on the River





PokerStars Hand #150121395191:  Hold'em No Limit ($0.50/$1.00 USD) - 2016/03/10 10:35:44 CET [2016/03/10 4:35:44 ET]
Table 'Ymir II' 9-max Seat #8 is the button
Seat 1: Monsthand ($102.74 in chips) 
Seat 2: er13to ($100 in chips) 
Seat 3: matiko09 ($100.89 in chips) 
Seat 4: blackw0lf_03 ($153.21 in chips) 
Seat 5: mycka86 ($100 in chips) 
Seat 6: RMilPoker ($118.24 in chips) 
Seat 8: Sweden_Pound ($122.75 in chips) 
Seat 9: Beni Ca$h ($109.68 in chips) 
Beni Ca$h: posts small blind $0.50
Monsthand: posts big blind $1
*** HOLE CARDS ***
Dealt to matiko09 [4s 9h]
er13to: raises $2 to $3
matiko09: folds 
blackw0lf_03: folds 
mycka86: folds 
RMilPoker: folds 
Sweden_Pound: folds 
Beni Ca$h: folds 
Monsthand: folds 
Uncalled bet ($2) returned to er13to
er13to collected $2.50 from pot
*** SUMMARY ***
Total pot $2.50 | Rake $0 
Seat 1: Monsthand (big blind) folded before Flop
Seat 2: er13to collected ($2.50)
Seat 3: matiko09 folded before Flop (didn't bet)
Seat 4: blackw0lf_03 folded before Flop (didn't bet)
Seat 5: mycka86 folded before Flop (didn't bet)
Seat 6: RMilPoker folded before Flop (didn't bet)
Seat 8: Sweden_Pound (button) folded before Flop (didn't bet)
Seat 9: Beni Ca$h (small blind) folded before Flop





PokerStars Hand #150121395114:  Hold'em No Limit ($1/$2 USD) - 2016/03/10 10:35:44 CET [2016/03/10 4:35:44 ET]
Table 'Vesta' 9-max Seat #7 is the button
Seat 1: nickreason17 ($240.20 in chips) 
Seat 2: Pernilla E A ($249.28 in chips) 
Seat 3: matiko09 ($200 in chips) 
Seat 4: Yaaaazz ($215.40 in chips) 
Seat 6: djammusic ($548.69 in chips) 
Seat 7: Monsthand ($200 in chips) 
Seat 8: 13Ghosts ($312.14 in chips) 
Seat 9: BOAYARSKIY ($80 in chips) 
13Ghosts: posts small blind $1
BOAYARSKIY: posts big blind $2
*** HOLE CARDS ***
Dealt to matiko09 [8h Qc]
nickreason17: folds 
Pernilla E A: folds 
matiko09: folds 
Yaaaazz: folds 
djammusic: folds 
Monsthand: folds 
13Ghosts: folds 
Uncalled bet ($1) returned to BOAYARSKIY
BOAYARSKIY collected $2 from pot
BOAYARSKIY: doesn't show hand 
*** SUMMARY ***
Total pot $2 | Rake $0 
Seat 1: nickreason17 folded before Flop (didn't bet)
Seat 2: Pernilla E A folded before Flop (didn't bet)
Seat 3: matiko09 folded before Flop (didn't bet)
Seat 4: Yaaaazz folded before Flop (didn't bet)
Seat 6: djammusic folded before Flop (didn't bet)
Seat 7: Monsthand (button) folded before Flop (didn't bet)
Seat 8: 13Ghosts (small blind) folded before Flop
Seat 9: BOAYARSKIY (big blind) collected ($2)





PokerStars Hand #150121397491:  Hold'em No Limit ($0.50/$1.00 USD) - 2016/03/10 10:35:50 CET [2016/03/10 4:35:50 ET]
Table 'Alsciaukat' 9-max Seat #6 is the button
Seat 1: Kelvin sai ($83.64 in chips) 
Seat 2: mycka86 ($100 in chips) 
Seat 3: blackw0lf_03 ($127.39 in chips) 
Seat 4: Rikti ($31.50 in chips) 
Seat 5: toprmaw ($114.92 in chips) 
Seat 6: Sweden_Pound ($103.73 in chips) 
Seat 7: Yaaaazz ($140.15 in chips) 
Seat 8: F1dgeT ($100 in chips) 
Seat 9: matiko09 ($101.88 in chips) 
Yaaaazz: posts small blind $0.50
F1dgeT: posts big blind $1
*** HOLE CARDS ***
Dealt to matiko09 [8s 2d]
matiko09: folds 
Kelvin sai: raises $1 to $2
mycka86: raises $5.50 to $7.50
blackw0lf_03: folds 
Rikti: folds 
toprmaw: folds 
Sweden_Pound: folds 
Yaaaazz: calls $7
F1dgeT: folds 
Kelvin sai: folds 
*** FLOP *** [3d Jd 7d]
Yaaaazz: checks 
mycka86: checks 
*** TURN *** [3d Jd 7d] [Qh]
Yaaaazz: bets $10
mycka86: folds 
Uncalled bet ($10) returned to Yaaaazz
Yaaaazz collected $17.19 from pot
*** SUMMARY ***
Total pot $18 | Rake $0.81 
Board [3d Jd 7d Qh]
Seat 1: Kelvin sai folded before Flop
Seat 2: mycka86 folded on the Turn
Seat 3: blackw0lf_03 folded before Flop (didn't bet)
Seat 4: Rikti folded before Flop (didn't bet)
Seat 5: toprmaw folded before Flop (didn't bet)
Seat 6: Sweden_Pound (button) folded before Flop (didn't bet)
Seat 7: Yaaaazz (small blind) collected ($17.19)
Seat 8: F1dgeT (big blind) folded before Flop
Seat 9: matiko09 folded before Flop (didn't bet)





PokerStars Hand #150121400741:  Hold'em No Limit ($0.50/$1.00 USD) - 2016/03/10 10:35:58 CET [2016/03/10 4:35:58 ET]
Table 'Leda II' 9-max Seat #8 is the button
Seat 1: DIMAN_324 ($100 in chips) 
Seat 2: corsair888 ($107.80 in chips) 
Seat 4: Zier89 ($83.46 in chips) 
Seat 5: matiko09 ($103.21 in chips) 
Seat 6: AlKatrone ($212.37 in chips) 
Seat 7: BKA12 ($100 in chips) 
Seat 8: peppsta ($82.85 in chips) 
Seat 9: Yaaaazz ($104.21 in chips) 
Yaaaazz: posts small blind $0.50
DIMAN_324: posts big blind $1
*** HOLE CARDS ***
Dealt to matiko09 [6s Qd]
corsair888: folds 
Zier89: folds 
matiko09: folds 
AlKatrone: folds 
BKA12: folds 
peppsta: folds 
Yaaaazz: raises $1 to $2
DIMAN_324: folds 
Uncalled bet ($1) returned to Yaaaazz
Yaaaazz collected $2 from pot
*** SUMMARY ***
Total pot $2 | Rake $0 
Seat 1: DIMAN_324 (big blind) folded before Flop
Seat 2: corsair888 folded before Flop (didn't bet)
Seat 4: Zier89 folded before Flop (didn't bet)
Seat 5: matiko09 folded before Flop (didn't bet)
Seat 6: AlKatrone folded before Flop (didn't bet)
Seat 7: BKA12 folded before Flop (didn't bet)
Seat 8: peppsta (button) folded before Flop (didn't bet)
Seat 9: Yaaaazz (small blind) collected ($2)





PokerStars Hand #150121401566:  Hold'em No Limit ($1/$2 USD) - 2016/03/10 10:36:00 CET [2016/03/10 4:36:00 ET]
Table 'Vesta' 9-max Seat #8 is the button
Seat 1: nickreason17 ($240.20 in chips) 
Seat 2: Pernilla E A ($249.28 in chips) 
Seat 3: matiko09 ($200 in chips) 
Seat 4: Yaaaazz ($215.40 in chips) 
Seat 6: djammusic ($548.69 in chips) 
Seat 7: Monsthand ($200 in chips) 
Seat 8: 13Ghosts ($311.14 in chips) 
Seat 9: BOAYARSKIY ($81 in chips) 
BOAYARSKIY: posts small blind $1
nickreason17: posts big blind $2
*** HOLE CARDS ***
Dealt to matiko09 [Kd Tc]
Pernilla E A: calls $2
matiko09: folds 
Yaaaazz: folds 
djammusic: folds 
Monsthand: raises $6 to $8
13Ghosts: folds 
BOAYARSKIY: folds 
nickreason17: folds 
Pernilla E A: calls $6
*** FLOP *** [2h 5c Ts]
Pernilla E A: checks 
Monsthand: bets $11.50
Pernilla E A: calls $11.50
*** TURN *** [2h 5c Ts] [Qc]
Pernilla E A: checks 
Monsthand: bets $25.50
Pernilla E A: calls $25.50
*** RIVER *** [2h 5c Ts Qc] [2d]
Pernilla E A: checks 
Monsthand: bets $37.50
Pernilla E A: raises $72.50 to $110
Monsthand: folds 
Uncalled bet ($72.50) returned to Pernilla E A
Pernilla E A collected $165.20 from pot
*** SUMMARY ***
Total pot $168 | Rake $2.80 
Board [2h 5c Ts Qc 2d]
Seat 1: nickreason17 (big blind) folded before Flop
Seat 2: Pernilla E A collected ($165.20)
Seat 3: matiko09 folded before Flop (didn't bet)
Seat 4: Yaaaazz folded before Flop (didn't bet)
Seat 6: djammusic folded before Flop (didn't bet)
Seat 7: Monsthand folded on the River
Seat 8: 13Ghosts (button) folded before Flop (didn't bet)
Seat 9: BOAYARSKIY (small blind) folded before Flop





PokerStars Hand #150121401573:  Hold'em No Limit ($1/$2 USD) - 2016/03/10 10:36:00 CET [2016/03/10 4:36:00 ET]
Table 'Solstice II' 9-max Seat #8 is the button
Seat 1: Rycious ($99 in chips) 
Seat 3: vano7777 ($224.44 in chips) 
Seat 4: matiko09 ($200 in chips) 
Seat 5: toprmaw ($224.04 in chips) 
Seat 6: thecurv ($212.15 in chips) 
Seat 7: WrongButton ($204.60 in chips) 
Seat 8: peevoajax ($200 in chips) 
Seat 9: Monsthand ($286.17 in chips) 
Monsthand: posts small blind $1
Rycious: posts big blind $2
*** HOLE CARDS ***
Dealt to matiko09 [5s 6d]
vano7777: folds 
matiko09: folds 
toprmaw: folds 
thecurv: folds 
WrongButton: folds 
peevoajax: raises $3 to $5
Monsthand: folds 
Rycious: calls $3
*** FLOP *** [Qd Ad 3h]
Rycious: checks 
peevoajax: checks 
*** TURN *** [Qd Ad 3h] [Td]
Rycious: bets $4
peevoajax: calls $4
*** RIVER *** [Qd Ad 3h Td] [Qs]
Rycious: bets $8
peevoajax: calls $8
*** SHOW DOWN ***
Rycious: shows [6s Tc] (two pair, Queens and Tens)
peevoajax: shows [As 7h] (two pair, Aces and Queens)
peevoajax collected $33.42 from pot
*** SUMMARY ***
Total pot $35 | Rake $1.58 
Board [Qd Ad 3h Td Qs]
Seat 1: Rycious (big blind) showed [6s Tc] and lost with two pair, Queens and Tens
Seat 3: vano7777 folded before Flop (didn't bet)
Seat 4: matiko09 folded before Flop (didn't bet)
Seat 5: toprmaw folded before Flop (didn't bet)
Seat 6: thecurv folded before Flop (didn't bet)
Seat 7: WrongButton folded before Flop (didn't bet)
Seat 8: peevoajax (button) showed [As 7h] and won ($33.42) with two pair, Aces and Queens
Seat 9: Monsthand (small blind) folded before Flop





PokerStars Hand #150121403927:  Hold'em No Limit ($0.25/$0.50 USD) - 2016/03/10 10:36:06 CET [2016/03/10 4:36:06 ET]
Table 'Aegina' 9-max Seat #5 is the button
Seat 2: el.suertero ($125 in chips) 
Seat 3: matiko09 ($55.22 in chips) 
Seat 4: vlad11122007 ($63.51 in chips) 
Seat 5: depokerlord ($63.54 in chips) 
Seat 6: ardo888 ($174.37 in chips) 
Seat 7: Bohne0815 ($77.14 in chips) 
Seat 8: q3storm ($50 in chips) 
Seat 9: i L00K great ($86.69 in chips) 
ardo888: posts small blind $0.25
Bohne0815: posts big blind $0.50
Sweden_Pound: sits out 
el.suertero: posts the ante $0.10
matiko09: posts the ante $0.10
vlad11122007: posts the ante $0.10
depokerlord: posts the ante $0.10
ardo888: posts the ante $0.10
Bohne0815: posts the ante $0.10
q3storm: posts the ante $0.10
i L00K great: posts the ante $0.10
*** HOLE CARDS ***
Dealt to matiko09 [2s 8s]
q3storm: folds 
i L00K great: folds 
el.suertero: folds 
matiko09: folds 
vlad11122007: folds 
depokerlord: raises $0.50 to $1
ardo888: folds 
Bohne0815: calls $0.50
*** FLOP *** [Qd 3c Jh]
Bohne0815: checks 
depokerlord: bets $1
Bohne0815: folds 
Uncalled bet ($1) returned to depokerlord
depokerlord collected $2.91 from pot
depokerlord: doesn't show hand 
*** SUMMARY ***
Total pot $3.05 | Rake $0.14 
Board [Qd 3c Jh]
Seat 2: el.suertero folded before Flop (didn't bet)
Seat 3: matiko09 folded before Flop (didn't bet)
Seat 4: vlad11122007 folded before Flop (didn't bet)
Seat 5: depokerlord (button) collected ($2.91)
Seat 6: ardo888 (small blind) folded before Flop
Seat 7: Bohne0815 (big blind) folded on the Flop
Seat 8: q3storm folded before Flop (didn't bet)
Seat 9: i L00K great folded before Flop (didn't bet)





PokerStars Hand #150121406111:  Hold'em No Limit ($0.50/$1.00 USD) - 2016/03/10 10:36:12 CET [2016/03/10 4:36:12 ET]
Table 'Ymir II' 9-max Seat #9 is the button
Seat 1: Monsthand ($101.74 in chips) 
Seat 2: er13to ($101.50 in chips) 
Seat 3: matiko09 ($100.89 in chips) 
Seat 4: blackw0lf_03 ($153.21 in chips) 
Seat 5: mycka86 ($100 in chips) 
Seat 6: RMilPoker ($118.24 in chips) 
Seat 8: Sweden_Pound ($122.75 in chips) 
Seat 9: Beni Ca$h ($109.18 in chips) 
Monsthand: posts small blind $0.50
er13to: posts big blind $1
*** HOLE CARDS ***
Dealt to matiko09 [As Th]
matiko09: folds 
blackw0lf_03: folds 
mycka86: folds 
RMilPoker: folds 
Sweden_Pound: folds 
Beni Ca$h: calls $1
Monsthand: folds 
er13to: checks 
*** FLOP *** [Ad 5s Ac]
er13to: checks 
Beni Ca$h: checks 
*** TURN *** [Ad 5s Ac] [9h]
er13to: checks 
Beni Ca$h: checks 
*** RIVER *** [Ad 5s Ac 9h] [6d]
er13to: checks 
Beni Ca$h: checks 
*** SHOW DOWN ***
er13to: shows [5h Js] (two pair, Aces and Fives)
Beni Ca$h: mucks hand 
er13to collected $2.39 from pot
*** SUMMARY ***
Total pot $2.50 | Rake $0.11 
Board [Ad 5s Ac 9h 6d]
Seat 1: Monsthand (small blind) folded before Flop
Seat 2: er13to (big blind) showed [5h Js] and won ($2.39) with two pair, Aces and Fives
Seat 3: matiko09 folded before Flop (didn't bet)
Seat 4: blackw0lf_03 folded before Flop (didn't bet)
Seat 5: mycka86 folded before Flop (didn't bet)
Seat 6: RMilPoker folded before Flop (didn't bet)
Seat 8: Sweden_Pound folded before Flop (didn't bet)
Seat 9: Beni Ca$h (button) mucked [Kh Td]





PokerStars Hand #150121411744:  Hold'em No Limit (€0.25/€0.50 EUR) - 2016/03/10 10:36:27 CET [2016/03/10 4:36:27 ET]
Table 'Algorab' 9-max Seat #3 is the button
Seat 2: Sweden_Pound (€57.35 in chips) 
Seat 3: dididi2000 (€37.60 in chips) 
Seat 4: Butcher1848 (€68.55 in chips) 
Seat 6: q3storm (€50 in chips) 
Seat 7: matiko09 (€92.63 in chips) 
Seat 8: fudzi (€50 in chips) 
Seat 9: vlad11122007 (€52.50 in chips) 
Butcher1848: posts small blind €0.25
priterix was removed from the table for failing to post
q3storm: posts big blind €0.50
*** HOLE CARDS ***
Dealt to matiko09 [5h 2d]
matiko09: folds 
fudzi: folds 
vlad11122007: folds 
Sweden_Pound: folds 
dididi2000: folds 
Butcher1848: raises €1 to €1.50
q3storm: folds 
Uncalled bet (€1) returned to Butcher1848
Butcher1848 collected €1 from pot
Butcher1848: doesn't show hand 
*** SUMMARY ***
Total pot €1 | Rake €0 
Seat 2: Sweden_Pound folded before Flop (didn't bet)
Seat 3: dididi2000 (button) folded before Flop (didn't bet)
Seat 4: Butcher1848 (small blind) collected (€1)
Seat 6: q3storm (big blind) folded before Flop
Seat 7: matiko09 folded before Flop (didn't bet)
Seat 8: fudzi folded before Flop (didn't bet)
Seat 9: vlad11122007 folded before Flop (didn't bet)





PokerStars Hand #150121413338:  Hold'em No Limit ($0.50/$1.00 USD) - 2016/03/10 10:36:31 CET [2016/03/10 4:36:31 ET]
Table 'Leda II' 9-max Seat #9 is the button
Seat 1: DIMAN_324 ($100 in chips) 
Seat 2: corsair888 ($107.80 in chips) 
Seat 4: Zier89 ($83.46 in chips) 
Seat 5: matiko09 ($103.21 in chips) 
Seat 6: AlKatrone ($212.37 in chips) 
Seat 7: BKA12 ($100 in chips) 
Seat 8: peppsta ($82.85 in chips) 
Seat 9: Yaaaazz ($105.21 in chips) 
DIMAN_324: posts small blind $0.50
corsair888: posts big blind $1
*** HOLE CARDS ***
Dealt to matiko09 [3c Qc]
Zier89: folds 
matiko09: folds 
AlKatrone: raises $2 to $3
BKA12: folds 
peppsta: folds 
Yaaaazz: folds 
DIMAN_324: folds 
corsair888: folds 
Uncalled bet ($2) returned to AlKatrone
AlKatrone collected $2.50 from pot
AlKatrone: doesn't show hand 
*** SUMMARY ***
Total pot $2.50 | Rake $0 
Seat 1: DIMAN_324 (small blind) folded before Flop
Seat 2: corsair888 (big blind) folded before Flop
Seat 4: Zier89 folded before Flop (didn't bet)
Seat 5: matiko09 folded before Flop (didn't bet)
Seat 6: AlKatrone collected ($2.50)
Seat 7: BKA12 folded before Flop (didn't bet)
Seat 8: peppsta folded before Flop (didn't bet)
Seat 9: Yaaaazz (button) folded before Flop (didn't bet)





PokerStars Hand #150121415060:  Hold'em No Limit ($1/$2 USD) - 2016/03/10 10:36:35 CET [2016/03/10 4:36:35 ET]
Table 'Solstice II' 9-max Seat #9 is the button
Seat 1: Rycious ($82 in chips) 
Seat 3: vano7777 ($224.44 in chips) 
Seat 4: matiko09 ($200 in chips) 
Seat 5: toprmaw ($224.04 in chips) 
Seat 6: thecurv ($212.15 in chips) 
Seat 7: WrongButton ($204.60 in chips) 
Seat 8: peevoajax ($216.42 in chips) 
Seat 9: Monsthand ($285.17 in chips) 
Rycious: posts small blind $1
vano7777: posts big blind $2
*** HOLE CARDS ***
Dealt to matiko09 [Kc 3d]
matiko09: folds 
toprmaw: raises $4 to $6
thecurv: folds 
WrongButton: folds 
peevoajax: folds 
Monsthand: raises $12 to $18
Rycious: folds 
vano7777: folds 
toprmaw: folds 
Uncalled bet ($12) returned to Monsthand
Monsthand collected $15 from pot
Monsthand: doesn't show hand 
*** SUMMARY ***
Total pot $15 | Rake $0 
Seat 1: Rycious (small blind) folded before Flop
Seat 3: vano7777 (big blind) folded before Flop
Seat 4: matiko09 folded before Flop (didn't bet)
Seat 5: toprmaw folded before Flop
Seat 6: thecurv folded before Flop (didn't bet)
Seat 7: WrongButton folded before Flop (didn't bet)
Seat 8: peevoajax folded before Flop (didn't bet)
Seat 9: Monsthand (button) collected ($15)





PokerStars Hand #150121418600:  Hold'em No Limit ($0.25/$0.50 USD) - 2016/03/10 10:36:44 CET [2016/03/10 4:36:44 ET]
Table 'Aegina' 9-max Seat #6 is the button
Seat 2: el.suertero ($125 in chips) 
Seat 3: matiko09 ($55.12 in chips) 
Seat 4: vlad11122007 ($63.41 in chips) 
Seat 5: depokerlord ($65.35 in chips) 
Seat 6: ardo888 ($174.02 in chips) 
Seat 7: Bohne0815 ($76.04 in chips) 
Seat 8: q3storm ($50 in chips) 
Seat 9: i L00K great ($86.59 in chips) 
Bohne0815: posts small blind $0.25
q3storm: posts big blind $0.50
Sweden_Pound: sits out 
el.suertero: posts the ante $0.10
matiko09: posts the ante $0.10
vlad11122007: posts the ante $0.10
depokerlord: posts the ante $0.10
ardo888: posts the ante $0.10
Bohne0815: posts the ante $0.10
q3storm: posts the ante $0.10
i L00K great: posts the ante $0.10
*** HOLE CARDS ***
Dealt to matiko09 [2s 5c]
i L00K great: folds 
el.suertero: folds 
matiko09: folds 
vlad11122007: folds 
depokerlord: raises $0.50 to $1
ardo888: folds 
Bohne0815: folds 
q3storm: folds 
Uncalled bet ($0.50) returned to depokerlord
depokerlord collected $2.05 from pot
depokerlord: doesn't show hand 
*** SUMMARY ***
Total pot $2.05 | Rake $0 
Seat 2: el.suertero folded before Flop (didn't bet)
Seat 3: matiko09 folded before Flop (didn't bet)
Seat 4: vlad11122007 folded before Flop (didn't bet)
Seat 5: depokerlord collected ($2.05)
Seat 6: ardo888 (button) folded before Flop (didn't bet)
Seat 7: Bohne0815 (small blind) folded before Flop
Seat 8: q3storm (big blind) folded before Flop
Seat 9: i L00K great folded before Flop (didn't bet)





PokerStars Hand #150121422474:  Hold'em No Limit ($0.50/$1.00 USD) - 2016/03/10 10:36:54 CET [2016/03/10 4:36:54 ET]
Table 'Rarahu' 9-max Seat #4 is the button
Seat 1: matiko09 ($100 in chips) 
Seat 2: azzad2007 ($100 in chips) 
Seat 3: BKA12 ($100 in chips) 
Seat 4: vilo1070 ($131.03 in chips) 
Seat 5: blackw0lf_03 ($112.60 in chips) 
Seat 6: RMilPoker ($103.89 in chips) 
Seat 8: Rikti ($73.56 in chips) 
Seat 9: Srz7v44 ($133.74 in chips) 
blackw0lf_03: posts small blind $0.50
RMilPoker: posts big blind $1
*** HOLE CARDS ***
Dealt to matiko09 [Js Jh]
Rikti: folds 
Srz7v44: folds 
matiko09: raises $2 to $3
azzad2007: folds 
BKA12: folds 
vilo1070: folds 
blackw0lf_03: folds 
RMilPoker: folds 
Uncalled bet ($2) returned to matiko09
matiko09 collected $2.50 from pot
matiko09: doesn't show hand 
*** SUMMARY ***
Total pot $2.50 | Rake $0 
Seat 1: matiko09 collected ($2.50)
Seat 2: azzad2007 folded before Flop (didn't bet)
Seat 3: BKA12 folded before Flop (didn't bet)
Seat 4: vilo1070 (button) folded before Flop (didn't bet)
Seat 5: blackw0lf_03 (small blind) folded before Flop
Seat 6: RMilPoker (big blind) folded before Flop
Seat 8: Rikti folded before Flop (didn't bet)
Seat 9: Srz7v44 folded before Flop (didn't bet)





PokerStars Hand #150121423688:  Hold'em No Limit ($0.50/$1.00 USD) - 2016/03/10 10:36:58 CET [2016/03/10 4:36:58 ET]
Table 'Leda II' 9-max Seat #1 is the button
Seat 1: DIMAN_324 ($100 in chips) 
Seat 2: corsair888 ($106.80 in chips) 
Seat 4: Zier89 ($83.46 in chips) 
Seat 5: matiko09 ($103.21 in chips) 
Seat 6: AlKatrone ($213.87 in chips) 
Seat 7: BKA12 ($100 in chips) 
Seat 8: peppsta ($82.85 in chips) 
Seat 9: Yaaaazz ($105.21 in chips) 
corsair888: posts small blind $0.50
Zier89: posts big blind $1
*** HOLE CARDS ***
Dealt to matiko09 [Jc 3s]
matiko09: folds 
AlKatrone: folds 
BKA12: raises $2 to $3
peppsta: calls $3
Yaaaazz: folds 
DIMAN_324: calls $3
corsair888: calls $2.50
Zier89: calls $2
*** FLOP *** [Jh 9c 5h]
corsair888: checks 
Zier89: checks 
BKA12: checks 
peppsta: checks 
DIMAN_324: checks 
*** TURN *** [Jh 9c 5h] [9d]
corsair888: checks 
Zier89: checks 
BKA12: checks 
peppsta: checks 
DIMAN_324: bets $9.45
corsair888: folds 
Zier89: folds 
BKA12: folds 
peppsta: folds 
Uncalled bet ($9.45) returned to DIMAN_324
DIMAN_324 collected $14.32 from pot
DIMAN_324: doesn't show hand 
*** SUMMARY ***
Total pot $15 | Rake $0.68 
Board [Jh 9c 5h 9d]
Seat 1: DIMAN_324 (button) collected ($14.32)
Seat 2: corsair888 (small blind) folded on the Turn
Seat 4: Zier89 (big blind) folded on the Turn
Seat 5: matiko09 folded before Flop (didn't bet)
Seat 6: AlKatrone folded before Flop (didn't bet)
Seat 7: BKA12 folded on the Turn
Seat 8: peppsta folded on the Turn
Seat 9: Yaaaazz folded before Flop (didn't bet)





PokerStars Hand #150121431791:  Hold'em No Limit ($0.25/$0.50 USD) - 2016/03/10 10:37:19 CET [2016/03/10 4:37:19 ET]
Table 'Aegina' 9-max Seat #7 is the button
Seat 2: el.suertero ($125 in chips) 
Seat 3: matiko09 ($55.02 in chips) 
Seat 4: vlad11122007 ($63.31 in chips) 
Seat 5: depokerlord ($66.80 in chips) 
Seat 6: ardo888 ($173.92 in chips) 
Seat 7: Bohne0815 ($75.69 in chips) 
Seat 8: q3storm ($50 in chips) 
Seat 9: i L00K great ($86.49 in chips) 
q3storm: posts small blind $0.25
i L00K great: posts big blind $0.50
Sweden_Pound: sits out 
el.suertero: posts the ante $0.10
matiko09: posts the ante $0.10
vlad11122007: posts the ante $0.10
depokerlord: posts the ante $0.10
ardo888: posts the ante $0.10
Bohne0815: posts the ante $0.10
q3storm: posts the ante $0.10
i L00K great: posts the ante $0.10
*** HOLE CARDS ***
Dealt to matiko09 [3h 8d]
el.suertero: raises $1 to $1.50
matiko09: folds 
vlad11122007: folds 
depokerlord: calls $1.50
ardo888: calls $1.50
Bohne0815: folds 
q3storm: folds 
i L00K great: folds 
*** FLOP *** [Js Td 7h]
el.suertero: bets $4.50
depokerlord: calls $4.50
ardo888: folds 
*** TURN *** [Js Td 7h] [Qc]
el.suertero: bets $9.50
depokerlord: calls $9.50
*** RIVER *** [Js Td 7h Qc] [Kc]
el.suertero: bets $16
depokerlord: calls $16
*** SHOW DOWN ***
el.suertero: shows [7c 7d] (three of a kind, Sevens)
depokerlord: shows [Qh 9d] (a straight, Nine to King)
depokerlord collected $63.55 from pot
*** SUMMARY ***
Total pot $66.05 | Rake $2.50 
Board [Js Td 7h Qc Kc]
Seat 2: el.suertero showed [7c 7d] and lost with three of a kind, Sevens
Seat 3: matiko09 folded before Flop (didn't bet)
Seat 4: vlad11122007 folded before Flop (didn't bet)
Seat 5: depokerlord showed [Qh 9d] and won ($63.55) with a straight, Nine to King
Seat 6: ardo888 folded on the Flop
Seat 7: Bohne0815 (button) folded before Flop (didn't bet)
Seat 8: q3storm (small blind) folded before Flop
Seat 9: i L00K great (big blind) folded before Flop





PokerStars Hand #150121440640:  Hold'em No Limit ($0.50/$1.00 USD) - 2016/03/10 10:37:41 CET [2016/03/10 4:37:41 ET]
Table 'Rarahu' 9-max Seat #5 is the button
Seat 1: matiko09 ($101.50 in chips) 
Seat 2: azzad2007 ($100 in chips) 
Seat 3: BKA12 ($100 in chips) 
Seat 4: vilo1070 ($131.03 in chips) 
Seat 5: blackw0lf_03 ($112.10 in chips) 
Seat 6: RMilPoker ($102.89 in chips) 
Seat 8: Rikti ($73.56 in chips) 
Seat 9: Srz7v44 ($133.74 in chips) 
RMilPoker: posts small blind $0.50
Rikti: posts big blind $1
*** HOLE CARDS ***
Dealt to matiko09 [Td Qc]
Srz7v44: calls $1
matiko09: folds 
azzad2007: folds 
BKA12: folds 
vilo1070: calls $1
blackw0lf_03: calls $1
RMilPoker: folds 
Rikti: checks 
*** FLOP *** [9h 6c 2h]
Rikti: bets $3
Srz7v44: calls $3
vilo1070: folds 
blackw0lf_03: folds 
*** TURN *** [9h 6c 2h] [7h]
Rikti: bets $6.50
Srz7v44: calls $6.50
*** RIVER *** [9h 6c 2h 7h] [Th]
Rikti: checks 
Srz7v44: checks 
*** SHOW DOWN ***
Rikti: shows [6h 2c] (a flush, Ten high)
Srz7v44: mucks hand 
Rikti collected $22.44 from pot
*** SUMMARY ***
Total pot $23.50 | Rake $1.06 
Board [9h 6c 2h 7h Th]
Seat 1: matiko09 folded before Flop (didn't bet)
Seat 2: azzad2007 folded before Flop (didn't bet)
Seat 3: BKA12 folded before Flop (didn't bet)
Seat 4: vilo1070 folded on the Flop
Seat 5: blackw0lf_03 (button) folded on the Flop
Seat 6: RMilPoker (small blind) folded before Flop
Seat 8: Rikti (big blind) showed [6h 2c] and won ($22.44) with a flush, Ten high
Seat 9: Srz7v44 mucked [7c 7d]





PokerStars Hand #150121456750:  Hold'em No Limit ($1/$2 USD) - 2016/03/10 10:38:24 CET [2016/03/10 4:38:24 ET]
Table 'Vesta' 9-max Seat #9 is the button
Seat 1: nickreason17 ($238.20 in chips) 
Seat 2: Pernilla E A ($331.98 in chips) 
Seat 3: matiko09 ($200 in chips) 
Seat 4: Yaaaazz ($215.40 in chips) 
Seat 6: djammusic ($548.69 in chips) 
Seat 7: Monsthand ($200 in chips) 
Seat 8: 13Ghosts ($311.14 in chips) 
Seat 9: BOAYARSKIY ($80 in chips) 
nickreason17: posts small blind $1
Pernilla E A: posts big blind $2
*** HOLE CARDS ***
Dealt to matiko09 [Ts Ks]
matiko09: raises $4 to $6
Yaaaazz: folds 
djammusic: folds 
Monsthand: folds 
13Ghosts: calls $6
BOAYARSKIY: folds 
nickreason17: folds 
Pernilla E A: calls $4
*** FLOP *** [7s Td 6s]
Pernilla E A: checks 
matiko09: bets $10
13Ghosts: calls $10
Pernilla E A: folds 
*** TURN *** [7s Td 6s] [Kd]
matiko09: checks 
13Ghosts: bets $27.93
matiko09: calls $27.93
*** RIVER *** [7s Td 6s Kd] [Ah]
matiko09: checks 
13Ghosts: bets $61.37
matiko09: calls $61.37
*** SHOW DOWN ***
13Ghosts: shows [Ad 3d] (a pair of Aces)
matiko09: shows [Ts Ks] (two pair, Kings and Tens)
matiko09 collected $214.80 from pot
*** SUMMARY ***
Total pot $217.60 | Rake $2.80 
Board [7s Td 6s Kd Ah]
Seat 1: nickreason17 (small blind) folded before Flop
Seat 2: Pernilla E A (big blind) folded on the Flop
Seat 3: matiko09 showed [Ts Ks] and won ($214.80) with two pair, Kings and Tens
Seat 4: Yaaaazz folded before Flop (didn't bet)
Seat 6: djammusic folded before Flop (didn't bet)
Seat 7: Monsthand folded before Flop (didn't bet)
Seat 8: 13Ghosts showed [Ad 3d] and lost with a pair of Aces
Seat 9: BOAYARSKIY (button) folded before Flop (didn't bet)





PokerStars Hand #150121464147:  Hold'em No Limit ($0.25/$0.50 USD) - 2016/03/10 10:38:43 CET [2016/03/10 4:38:43 ET]
Table 'Aegina' 9-max Seat #8 is the button
Seat 1: Sweden_Pound ($125 in chips) 
Seat 2: el.suertero ($125 in chips) 
Seat 3: matiko09 ($54.92 in chips) 
Seat 4: vlad11122007 ($63.21 in chips) 
Seat 5: depokerlord ($98.75 in chips) 
Seat 6: ardo888 ($172.32 in chips) 
Seat 7: Bohne0815 ($75.59 in chips) 
Seat 8: q3storm ($50 in chips) 
Seat 9: i L00K great ($85.89 in chips) 
i L00K great: posts small blind $0.25
Sweden_Pound: posts big blind $0.50
Sweden_Pound: posts the ante $0.10
el.suertero: posts the ante $0.10
matiko09: posts the ante $0.10
vlad11122007: posts the ante $0.10
depokerlord: posts the ante $0.10
ardo888: posts the ante $0.10
Bohne0815: posts the ante $0.10
q3storm: posts the ante $0.10
i L00K great: posts the ante $0.10
*** HOLE CARDS ***
Dealt to matiko09 [3s Jh]
el.suertero: folds 
matiko09: folds 
vlad11122007: folds 
depokerlord: calls $0.50
ardo888: folds 
Bohne0815: calls $0.50
q3storm: folds 
i L00K great: folds 
Sweden_Pound: raises $2.50 to $3
depokerlord: calls $2.50
Bohne0815: folds 
*** FLOP *** [Kc Ad 6c]
Sweden_Pound: bets $4.75
depokerlord: folds 
Uncalled bet ($4.75) returned to Sweden_Pound
Sweden_Pound collected $7.31 from pot
Sweden_Pound: doesn't show hand 
*** SUMMARY ***
Total pot $7.65 | Rake $0.34 
Board [Kc Ad 6c]
Seat 1: Sweden_Pound (big blind) collected ($7.31)
Seat 2: el.suertero folded before Flop (didn't bet)
Seat 3: matiko09 folded before Flop (didn't bet)
Seat 4: vlad11122007 folded before Flop (didn't bet)
Seat 5: depokerlord folded on the Flop
Seat 6: ardo888 folded before Flop (didn't bet)
Seat 7: Bohne0815 folded before Flop
Seat 8: q3storm (button) folded before Flop (didn't bet)
Seat 9: i L00K great (small blind) folded before Flop





PokerStars Hand #150121479417:  Hold'em No Limit ($0.50/$1.00 USD) - 2016/03/10 10:39:22 CET [2016/03/10 4:39:22 ET]
Table 'Rarahu' 9-max Seat #6 is the button
Seat 1: matiko09 ($101.50 in chips) 
Seat 2: azzad2007 ($100 in chips) 
Seat 3: BKA12 ($100 in chips) 
Seat 4: vilo1070 ($130.03 in chips) 
Seat 5: blackw0lf_03 ($111.10 in chips) 
Seat 6: RMilPoker ($102.39 in chips) 
Seat 8: Rikti ($85.50 in chips) 
Seat 9: Srz7v44 ($123.24 in chips) 
Rikti: posts small blind $0.50
Srz7v44: posts big blind $1
*** HOLE CARDS ***
Dealt to matiko09 [6d 5h]
matiko09: folds 
azzad2007: folds 
BKA12: raises $2 to $3
vilo1070: folds 
blackw0lf_03: folds 
RMilPoker: calls $3
Rikti: folds 
Srz7v44: folds 
*** FLOP *** [8s 5d 6c]
BKA12: checks 
RMilPoker: bets $5
BKA12: calls $5
*** TURN *** [8s 5d 6c] [Kh]
BKA12: checks 
RMilPoker: checks 
*** RIVER *** [8s 5d 6c Kh] [9c]
BKA12: checks 
RMilPoker: checks 
*** SHOW DOWN ***
BKA12: shows [Js Jc] (a pair of Jacks)
RMilPoker: mucks hand 
BKA12 collected $16.71 from pot
*** SUMMARY ***
Total pot $17.50 | Rake $0.79 
Board [8s 5d 6c Kh 9c]
Seat 1: matiko09 folded before Flop (didn't bet)
Seat 2: azzad2007 folded before Flop (didn't bet)
Seat 3: BKA12 showed [Js Jc] and won ($16.71) with a pair of Jacks
Seat 4: vilo1070 folded before Flop (didn't bet)
Seat 5: blackw0lf_03 folded before Flop (didn't bet)
Seat 6: RMilPoker (button) mucked [4c 4h]
Seat 8: Rikti (small blind) folded before Flop
Seat 9: Srz7v44 (big blind) folded before Flop





PokerStars Hand #150121485500:  Hold'em No Limit ($1/$2 USD) - 2016/03/10 10:39:38 CET [2016/03/10 4:39:38 ET]
Table 'Tauris II' 9-max Seat #7 is the button
Seat 1: toprmaw ($273.81 in chips) 
Seat 2: nickreason17 ($200.67 in chips) 
Seat 3: BOAYARSKIY ($80 in chips) 
Seat 4: matiko09 ($376.04 in chips) 
Seat 5: Spudly6 ($195.72 in chips) 
Seat 6: Yaaaazz ($289.05 in chips) 
Seat 7: Monsthand ($212.85 in chips) 
Seat 8: WrongButton ($251.38 in chips) 
Seat 9: darren1031 ($122.80 in chips) 
WrongButton: posts small blind $1
darren1031: posts big blind $2
*** HOLE CARDS ***
Dealt to matiko09 [4c Ah]
toprmaw: folds 
nickreason17: folds 
BOAYARSKIY: folds 
matiko09: folds 
Spudly6: folds 
Yaaaazz: folds 
Monsthand: folds 
WrongButton: folds 
Uncalled bet ($1) returned to darren1031
darren1031 collected $2 from pot
darren1031: doesn't show hand 
*** SUMMARY ***
Total pot $2 | Rake $0 
Seat 1: toprmaw folded before Flop (didn't bet)
Seat 2: nickreason17 folded before Flop (didn't bet)
Seat 3: BOAYARSKIY folded before Flop (didn't bet)
Seat 4: matiko09 folded before Flop (didn't bet)
Seat 5: Spudly6 folded before Flop (didn't bet)
Seat 6: Yaaaazz folded before Flop (didn't bet)
Seat 7: Monsthand (button) folded before Flop (didn't bet)
Seat 8: WrongButton (small blind) folded before Flop
Seat 9: darren1031 (big blind) collected ($2)





PokerStars Hand #150121488176:  Hold'em No Limit ($0.25/$0.50 USD) - 2016/03/10 10:39:45 CET [2016/03/10 4:39:45 ET]
Table 'Aegina' 9-max Seat #9 is the button
Seat 1: Sweden_Pound ($129.21 in chips) 
Seat 2: el.suertero ($125 in chips) 
Seat 3: matiko09 ($54.82 in chips) 
Seat 4: vlad11122007 ($63.11 in chips) 
Seat 5: depokerlord ($95.65 in chips) 
Seat 6: ardo888 ($172.22 in chips) 
Seat 7: Bohne0815 ($74.99 in chips) 
Seat 8: q3storm ($50 in chips) 
Seat 9: i L00K great ($85.54 in chips) 
Sweden_Pound: posts small blind $0.25
el.suertero: posts big blind $0.50
Sweden_Pound: posts the ante $0.10
el.suertero: posts the ante $0.10
matiko09: posts the ante $0.10
vlad11122007: posts the ante $0.10
depokerlord: posts the ante $0.10
ardo888: posts the ante $0.10
Bohne0815: posts the ante $0.10
q3storm: posts the ante $0.10
i L00K great: posts the ante $0.10
*** HOLE CARDS ***
Dealt to matiko09 [3c Th]
matiko09: folds 
vlad11122007: folds 
depokerlord: raises $1 to $1.50
ardo888: folds 
Bohne0815: folds 
q3storm: folds 
i L00K great: folds 
Sweden_Pound: folds 
el.suertero: folds 
Uncalled bet ($1) returned to depokerlord
depokerlord collected $2.15 from pot
depokerlord: doesn't show hand 
*** SUMMARY ***
Total pot $2.15 | Rake $0 
Seat 1: Sweden_Pound (small blind) folded before Flop
Seat 2: el.suertero (big blind) folded before Flop
Seat 3: matiko09 folded before Flop (didn't bet)
Seat 4: vlad11122007 folded before Flop (didn't bet)
Seat 5: depokerlord collected ($2.15)
Seat 6: ardo888 folded before Flop (didn't bet)
Seat 7: Bohne0815 folded before Flop (didn't bet)
Seat 8: q3storm folded before Flop (didn't bet)
Seat 9: i L00K great (button) folded before Flop (didn't bet)





PokerStars Hand #150121493144:  Hold'em No Limit ($1/$2 USD) - 2016/03/10 10:39:58 CET [2016/03/10 4:39:58 ET]
Table 'Tauris II' 9-max Seat #8 is the button
Seat 1: toprmaw ($273.81 in chips) 
Seat 2: nickreason17 ($200.67 in chips) 
Seat 3: BOAYARSKIY ($80 in chips) 
Seat 4: matiko09 ($376.04 in chips) 
Seat 5: Spudly6 ($195.72 in chips) 
Seat 6: Yaaaazz ($289.05 in chips) 
Seat 7: Monsthand ($212.85 in chips) 
Seat 8: WrongButton ($250.38 in chips) 
Seat 9: darren1031 ($123.80 in chips) 
darren1031: posts small blind $1
toprmaw: posts big blind $2
*** HOLE CARDS ***
Dealt to matiko09 [As 9d]
nickreason17: folds 
BOAYARSKIY: folds 
matiko09: folds 
Spudly6: folds 
Spudly6 leaves the table
Yaaaazz: folds 
Monsthand: folds 
WrongButton: folds 
darren1031: folds 
Uncalled bet ($1) returned to toprmaw
toprmaw collected $2 from pot
toprmaw: doesn't show hand 
*** SUMMARY ***
Total pot $2 | Rake $0 
Seat 1: toprmaw (big blind) collected ($2)
Seat 2: nickreason17 folded before Flop (didn't bet)
Seat 3: BOAYARSKIY folded before Flop (didn't bet)
Seat 4: matiko09 folded before Flop (didn't bet)
Seat 5: Spudly6 folded before Flop (didn't bet)
Seat 6: Yaaaazz folded before Flop (didn't bet)
Seat 7: Monsthand folded before Flop (didn't bet)
Seat 8: WrongButton (button) folded before Flop (didn't bet)
Seat 9: darren1031 (small blind) folded before Flop





PokerStars Hand #150121508552:  Hold'em No Limit ($1/$2 USD) - 2016/03/10 10:40:38 CET [2016/03/10 4:40:38 ET]
Table 'Tauris II' 9-max Seat #9 is the button
Seat 1: toprmaw ($274.81 in chips) 
Seat 2: nickreason17 ($200.67 in chips) 
Seat 3: BOAYARSKIY ($80 in chips) 
Seat 4: matiko09 ($376.04 in chips) 
Seat 6: Yaaaazz ($289.05 in chips) 
Seat 7: Monsthand ($212.85 in chips) 
Seat 8: WrongButton ($250.38 in chips) 
Seat 9: darren1031 ($122.80 in chips) 
toprmaw: posts small blind $1
nickreason17: posts big blind $2
*** HOLE CARDS ***
Dealt to matiko09 [Qs 4c]
BOAYARSKIY: raises $2.26 to $4.26
matiko09: folds 
Yaaaazz: folds 
Monsthand: folds 
WrongButton: folds 
darren1031: calls $4.26
toprmaw: folds 
nickreason17: calls $2.26
*** FLOP *** [Th Kc 5h]
nickreason17: checks 
BOAYARSKIY: bets $10
darren1031: folds 
nickreason17: folds 
Uncalled bet ($10) returned to BOAYARSKIY
BOAYARSKIY collected $13.16 from pot
BOAYARSKIY: doesn't show hand 
*** SUMMARY ***
Total pot $13.78 | Rake $0.62 
Board [Th Kc 5h]
Seat 1: toprmaw (small blind) folded before Flop
Seat 2: nickreason17 (big blind) folded on the Flop
Seat 3: BOAYARSKIY collected ($13.16)
Seat 4: matiko09 folded before Flop (didn't bet)
Seat 6: Yaaaazz folded before Flop (didn't bet)
Seat 7: Monsthand folded before Flop (didn't bet)
Seat 8: WrongButton folded before Flop (didn't bet)
Seat 9: darren1031 (button) folded on the Flop





PokerStars Hand #150121528201:  Hold'em No Limit ($1/$2 USD) - 2016/03/10 10:41:28 CET [2016/03/10 4:41:28 ET]
Table 'Tauris II' 9-max Seat #1 is the button
Seat 1: toprmaw ($273.81 in chips) 
Seat 2: nickreason17 ($200 in chips) 
Seat 3: BOAYARSKIY ($88.90 in chips) 
Seat 4: matiko09 ($376.04 in chips) 
Seat 6: Yaaaazz ($289.05 in chips) 
Seat 7: Monsthand ($212.85 in chips) 
Seat 8: WrongButton ($250.38 in chips) 
Seat 9: darren1031 ($118.54 in chips) 
nickreason17: posts small blind $1
BOAYARSKIY: posts big blind $2
*** HOLE CARDS ***
Dealt to matiko09 [9s Ts]
matiko09: raises $4 to $6
Yaaaazz: folds 
Monsthand: folds 
WrongButton: folds 
darren1031: folds 
toprmaw: calls $6
nickreason17: folds 
BOAYARSKIY: folds 
*** FLOP *** [8h 8d 4d]
matiko09: checks 
toprmaw: bets $8.59
matiko09: folds 
Uncalled bet ($8.59) returned to toprmaw
toprmaw collected $14.32 from pot
toprmaw: doesn't show hand 
*** SUMMARY ***
Total pot $15 | Rake $0.68 
Board [8h 8d 4d]
Seat 1: toprmaw (button) collected ($14.32)
Seat 2: nickreason17 (small blind) folded before Flop
Seat 3: BOAYARSKIY (big blind) folded before Flop
Seat 4: matiko09 folded on the Flop
Seat 6: Yaaaazz folded before Flop (didn't bet)
Seat 7: Monsthand folded before Flop (didn't bet)
Seat 8: WrongButton folded before Flop (didn't bet)
Seat 9: darren1031 folded before Flop (didn't bet)





PokerStars Hand #150123325123:  Hold'em No Limit ($0.50/$1.00 USD) - 2016/03/10 11:52:32 CET [2016/03/10 5:52:32 ET]
Table 'Zellner' 9-max Seat #3 is the button
Seat 1: di0d80 ($108.16 in chips) 
Seat 2: AlKatrone ($100 in chips) 
Seat 3: BKA12 ($100 in chips) 
Seat 8: mycka86 ($216.97 in chips) 
Seat 9: matiko09 ($100 in chips) 
mycka86: posts small blind $0.50
matiko09: posts big blind $1
*** HOLE CARDS ***
Dealt to matiko09 [8d Ks]
di0d80: raises $1.50 to $2.50
AlKatrone: folds 
BKA12: folds 
mycka86: folds 
matiko09: folds 
Uncalled bet ($1.50) returned to di0d80
di0d80 collected $2.50 from pot
di0d80: doesn't show hand 
*** SUMMARY ***
Total pot $2.50 | Rake $0 
Seat 1: di0d80 collected ($2.50)
Seat 2: AlKatrone folded before Flop (didn't bet)
Seat 3: BKA12 (button) folded before Flop (didn't bet)
Seat 8: mycka86 (small blind) folded before Flop
Seat 9: matiko09 (big blind) folded before Flop





PokerStars Hand #150123335657:  Hold'em No Limit ($0.50/$1.00 USD) - 2016/03/10 11:52:55 CET [2016/03/10 5:52:55 ET]
Table 'Zellner' 9-max Seat #8 is the button
Seat 1: di0d80 ($109.66 in chips) 
Seat 2: AlKatrone ($100 in chips) 
Seat 3: BKA12 ($100 in chips) 
Seat 8: mycka86 ($216.47 in chips) 
Seat 9: matiko09 ($100 in chips) 
matiko09: posts small blind $0.50
di0d80: posts big blind $1
*** HOLE CARDS ***
Dealt to matiko09 [4c 9c]
AlKatrone: raises $2 to $3
BKA12: folds 
mycka86: folds 
ReneP27 joins the table at seat #4 
matiko09: folds 
di0d80: calls $2
*** FLOP *** [Kh Qs 2d]
hammerwife joins the table at seat #6 
di0d80: checks 
AlKatrone has timed out
AlKatrone: checks 
*** TURN *** [Kh Qs 2d] [8s]
di0d80: bets $4
AlKatrone: calls $4
*** RIVER *** [Kh Qs 2d 8s] [6c]
di0d80: bets $11
AlKatrone: calls $11
*** SHOW DOWN ***
di0d80: shows [2h 2c] (three of a kind, Deuces)
AlKatrone: mucks hand 
di0d80 collected $34.86 from pot
*** SUMMARY ***
Total pot $36.50 | Rake $1.64 
Board [Kh Qs 2d 8s 6c]
Seat 1: di0d80 (big blind) showed [2h 2c] and won ($34.86) with three of a kind, Deuces
Seat 2: AlKatrone mucked [Ah Kd]
Seat 3: BKA12 folded before Flop (didn't bet)
Seat 8: mycka86 (button) folded before Flop (didn't bet)
Seat 9: matiko09 (small blind) folded before Flop





PokerStars Hand #150123350760:  Hold'em No Limit ($0.50/$1.00 USD) - 2016/03/10 11:53:29 CET [2016/03/10 5:53:29 ET]
Table 'Eurysaces' 9-max Seat #7 is the button
Seat 1: Dantist1122 ($103.54 in chips) 
Seat 4: peevoajax ($132.41 in chips) 
Seat 6: mycka86 ($118.21 in chips) 
Seat 7: SedativeHigh ($82.94 in chips) 
Seat 8: di0d80 ($100.50 in chips) 
Seat 9: matiko09 ($100 in chips) 
di0d80: posts small blind $0.50
matiko09: posts big blind $1
Dachish: sits out 
stds st: sits out 
*** HOLE CARDS ***
Dealt to matiko09 [5c 9c]
Dantist1122: folds 
peevoajax: folds 
mycka86: folds 
SedativeHigh: calls $1
di0d80: folds 
matiko09: checks 
*** FLOP *** [Ah 3d 7s]
matiko09: checks 
SedativeHigh: bets $2
matiko09: folds 
Uncalled bet ($2) returned to SedativeHigh
SedativeHigh collected $2.39 from pot
*** SUMMARY ***
Total pot $2.50 | Rake $0.11 
Board [Ah 3d 7s]
Seat 1: Dantist1122 folded before Flop (didn't bet)
Seat 4: peevoajax folded before Flop (didn't bet)
Seat 6: mycka86 folded before Flop (didn't bet)
Seat 7: SedativeHigh (button) collected ($2.39)
Seat 8: di0d80 (small blind) folded before Flop
Seat 9: matiko09 (big blind) folded on the Flop





PokerStars Hand #150123368716:  Hold'em No Limit ($0.50/$1.00 USD) - 2016/03/10 11:54:08 CET [2016/03/10 5:54:08 ET]
Table 'Eurysaces' 9-max Seat #8 is the button
Seat 1: Dantist1122 ($103.54 in chips) 
Seat 4: peevoajax ($132.41 in chips) 
Seat 6: mycka86 ($118.21 in chips) 
Seat 7: SedativeHigh ($84.33 in chips) 
Seat 8: di0d80 ($100 in chips) 
Seat 9: matiko09 ($100 in chips) 
matiko09: posts small blind $0.50
Dantist1122: posts big blind $1
Dachish: sits out 
stds st: sits out 
nickreason17: sits out 
*** HOLE CARDS ***
Dealt to matiko09 [Kh 6d]
peevoajax: folds 
mycka86: folds 
SedativeHigh: calls $1
di0d80: raises $3 to $4
matiko09: folds 
Dantist1122: folds 
SedativeHigh: folds 
Uncalled bet ($3) returned to di0d80
di0d80 collected $3.50 from pot
di0d80: doesn't show hand 
*** SUMMARY ***
Total pot $3.50 | Rake $0 
Seat 1: Dantist1122 (big blind) folded before Flop
Seat 4: peevoajax folded before Flop (didn't bet)
Seat 6: mycka86 folded before Flop (didn't bet)
Seat 7: SedativeHigh folded before Flop
Seat 8: di0d80 (button) collected ($3.50)
Seat 9: matiko09 (small blind) folded before Flop





PokerStars Hand #150123385069:  Hold'em No Limit ($0.50/$1.00 USD) - 2016/03/10 11:54:44 CET [2016/03/10 5:54:44 ET]
Table 'Eurysaces' 9-max Seat #9 is the button
Seat 1: Dantist1122 ($102.54 in chips) 
Seat 2: Dachish ($80 in chips) 
Seat 4: peevoajax ($132.41 in chips) 
Seat 6: mycka86 ($118.21 in chips) 
Seat 7: SedativeHigh ($83.33 in chips) 
Seat 8: di0d80 ($102.50 in chips) 
Seat 9: matiko09 ($100 in chips) 
Dantist1122: posts small blind $0.50
Dachish: posts big blind $1
stds st: sits out 
nickreason17: sits out 
*** HOLE CARDS ***
Dealt to matiko09 [6d Tc]
peevoajax: folds 
mycka86: folds 
SedativeHigh: raises $2 to $3
di0d80: folds 
matiko09: folds 
Dantist1122: folds 
Dachish: folds 
Uncalled bet ($2) returned to SedativeHigh
SedativeHigh collected $2.50 from pot
*** SUMMARY ***
Total pot $2.50 | Rake $0 
Seat 1: Dantist1122 (small blind) folded before Flop
Seat 2: Dachish (big blind) folded before Flop
Seat 4: peevoajax folded before Flop (didn't bet)
Seat 6: mycka86 folded before Flop (didn't bet)
Seat 7: SedativeHigh collected ($2.50)
Seat 8: di0d80 folded before Flop (didn't bet)
Seat 9: matiko09 (button) folded before Flop (didn't bet)





PokerStars Hand #150123389737:  Hold'em No Limit ($0.50/$1.00 USD) - 2016/03/10 11:54:55 CET [2016/03/10 5:54:55 ET]
Table 'Zellner' 9-max Seat #9 is the button
Seat 1: di0d80 ($126.52 in chips) 
Seat 2: AlKatrone ($100 in chips) 
Seat 3: BKA12 ($100 in chips) 
Seat 8: mycka86 ($216.47 in chips) 
Seat 9: matiko09 ($100 in chips) 
di0d80: posts small blind $0.50
AlKatrone: posts big blind $1
ReneP27: sits out 
*** HOLE CARDS ***
Dealt to matiko09 [4c 5c]
BKA12: folds 
mycka86: raises $1.10 to $2.10
matiko09: folds 
BKA12 leaves the table
di0d80: folds 
AlKatrone: folds 
Uncalled bet ($1.10) returned to mycka86
mycka86 collected $2.50 from pot
*** SUMMARY ***
Total pot $2.50 | Rake $0 
Seat 1: di0d80 (small blind) folded before Flop
Seat 2: AlKatrone (big blind) folded before Flop
Seat 3: BKA12 folded before Flop (didn't bet)
Seat 8: mycka86 collected ($2.50)
Seat 9: matiko09 (button) folded before Flop (didn't bet)





PokerStars Hand #150123401653:  Hold'em No Limit ($0.50/$1.00 USD) - 2016/03/10 11:55:22 CET [2016/03/10 5:55:22 ET]
Table 'Zellner' 9-max Seat #1 is the button
Seat 1: di0d80 ($126.02 in chips) 
Seat 2: AlKatrone ($100 in chips) 
Seat 4: ReneP27 ($100 in chips) 
Seat 8: mycka86 ($217.97 in chips) 
Seat 9: matiko09 ($100 in chips) 
AlKatrone: posts small blind $0.50
ReneP27: posts big blind $1
*** HOLE CARDS ***
Dealt to matiko09 [Ks Qh]
nickreason17 joins the table at seat #3 
nickreason17 leaves the table
mycka86: folds 
Yaaaazz joins the table at seat #3 
matiko09: raises $1.50 to $2.50
di0d80: folds 
AlKatrone: folds 
ReneP27: folds 
Uncalled bet ($1.50) returned to matiko09
matiko09 collected $2.50 from pot
matiko09: doesn't show hand 
*** SUMMARY ***
Total pot $2.50 | Rake $0 
Seat 1: di0d80 (button) folded before Flop (didn't bet)
Seat 2: AlKatrone (small blind) folded before Flop
Seat 4: ReneP27 (big blind) folded before Flop
Seat 8: mycka86 folded before Flop (didn't bet)
Seat 9: matiko09 collected ($2.50)





PokerStars Hand #150123415897:  Hold'em No Limit ($0.50/$1.00 USD) - 2016/03/10 11:55:57 CET [2016/03/10 5:55:57 ET]
Table 'Zellner' 9-max Seat #2 is the button
Seat 1: di0d80 ($126.02 in chips) 
Seat 2: AlKatrone ($100 in chips) 
Seat 4: ReneP27 ($99 in chips) 
Seat 8: mycka86 ($217.97 in chips) 
Seat 9: matiko09 ($101.50 in chips) 
Yaaaazz will be allowed to play after the button
ReneP27: posts small blind $0.50
mycka86: posts big blind $1
*** HOLE CARDS ***
Dealt to matiko09 [9s 6h]
matiko09: folds 
di0d80: raises $1.50 to $2.50
AlKatrone: folds 
ReneP27: folds 
mycka86: folds 
Uncalled bet ($1.50) returned to di0d80
di0d80 collected $2.50 from pot
di0d80: doesn't show hand 
*** SUMMARY ***
Total pot $2.50 | Rake $0 
Seat 1: di0d80 collected ($2.50)
Seat 2: AlKatrone (button) folded before Flop (didn't bet)
Seat 4: ReneP27 (small blind) folded before Flop
Seat 8: mycka86 (big blind) folded before Flop
Seat 9: matiko09 folded before Flop (didn't bet)





PokerStars Hand #150123418212:  Hold'em No Limit ($0.50/$1.00 USD) - 2016/03/10 11:56:03 CET [2016/03/10 5:56:03 ET]
Table 'Eurysaces' 9-max Seat #1 is the button
Seat 1: Dantist1122 ($102.04 in chips) 
Seat 2: Dachish ($79 in chips) 
Seat 3: stds st ($40 in chips) 
Seat 4: peevoajax ($132.41 in chips) 
Seat 6: mycka86 ($118.21 in chips) 
Seat 7: SedativeHigh ($84.83 in chips) 
Seat 8: di0d80 ($102.50 in chips) 
Seat 9: matiko09 ($100 in chips) 
Dachish: posts small blind $0.50
stds st: posts big blind $1
nickreason17: sits out 
*** HOLE CARDS ***
Dealt to matiko09 [4c 4h]
peevoajax: folds 
mycka86: folds 
SedativeHigh: folds 
di0d80: folds 
matiko09: raises $1.50 to $2.50
Dantist1122: folds 
Dachish: calls $2
stds st: folds 
*** FLOP *** [9d Th 9s]
Dachish: checks 
matiko09: checks 
*** TURN *** [9d Th 9s] [Qc]
Dachish: bets $3
matiko09: folds 
Uncalled bet ($3) returned to Dachish
Dachish collected $5.73 from pot
Dachish: doesn't show hand 
*** SUMMARY ***
Total pot $6 | Rake $0.27 
Board [9d Th 9s Qc]
Seat 1: Dantist1122 (button) folded before Flop (didn't bet)
Seat 2: Dachish (small blind) collected ($5.73)
Seat 3: stds st (big blind) folded before Flop
Seat 4: peevoajax folded before Flop (didn't bet)
Seat 6: mycka86 folded before Flop (didn't bet)
Seat 7: SedativeHigh folded before Flop (didn't bet)
Seat 8: di0d80 folded before Flop (didn't bet)
Seat 9: matiko09 folded on the Turn





PokerStars Hand #150123429298:  Hold'em No Limit ($0.50/$1.00 USD) - 2016/03/10 11:56:30 CET [2016/03/10 5:56:30 ET]
Table 'Zellner' 9-max Seat #4 is the button
Seat 1: di0d80 ($127.52 in chips) 
Seat 2: AlKatrone ($100 in chips) 
Seat 4: ReneP27 ($98.50 in chips) 
Seat 8: mycka86 ($216.97 in chips) 
Seat 9: matiko09 ($101.50 in chips) 
mycka86: posts small blind $0.50
matiko09: posts big blind $1
Yaaaazz: sits out 
*** HOLE CARDS ***
Dealt to matiko09 [4d Ts]
di0d80: raises $1.50 to $2.50
AlKatrone: folds 
ReneP27 has timed out
ReneP27: folds 
mycka86: folds 
matiko09: folds 
Uncalled bet ($1.50) returned to di0d80
di0d80 collected $2.50 from pot
di0d80: doesn't show hand 
*** SUMMARY ***
Total pot $2.50 | Rake $0 
Seat 1: di0d80 collected ($2.50)
Seat 2: AlKatrone folded before Flop (didn't bet)
Seat 4: ReneP27 (button) folded before Flop (didn't bet)
Seat 8: mycka86 (small blind) folded before Flop
Seat 9: matiko09 (big blind) folded before Flop





PokerStars Hand #150123431840:  Hold'em No Limit ($0.50/$1.00 USD) - 2016/03/10 11:56:37 CET [2016/03/10 5:56:37 ET]
Table 'Eurysaces' 9-max Seat #2 is the button
Seat 1: Dantist1122 ($102.04 in chips) 
Seat 2: Dachish ($82.23 in chips) 
Seat 3: stds st ($39 in chips) 
Seat 4: peevoajax ($132.41 in chips) 
Seat 6: mycka86 ($118.21 in chips) 
Seat 7: SedativeHigh ($84.83 in chips) 
Seat 8: di0d80 ($102.50 in chips) 
Seat 9: matiko09 ($100 in chips) 
stds st: posts small blind $0.50
peevoajax: posts big blind $1
nickreason17: sits out 
*** HOLE CARDS ***
Dealt to matiko09 [9h Jh]
mycka86: folds 
SedativeHigh: folds 
di0d80: folds 
matiko09: raises $2 to $3
Dantist1122: folds 
Dachish: folds 
stds st: folds 
peevoajax: folds 
Uncalled bet ($2) returned to matiko09
matiko09 collected $2.50 from pot
matiko09: doesn't show hand 
*** SUMMARY ***
Total pot $2.50 | Rake $0 
Seat 1: Dantist1122 folded before Flop (didn't bet)
Seat 2: Dachish (button) folded before Flop (didn't bet)
Seat 3: stds st (small blind) folded before Flop
Seat 4: peevoajax (big blind) folded before Flop
Seat 6: mycka86 folded before Flop (didn't bet)
Seat 7: SedativeHigh folded before Flop (didn't bet)
Seat 8: di0d80 folded before Flop (didn't bet)
Seat 9: matiko09 collected ($2.50)





PokerStars Hand #150123441036:  Hold'em No Limit ($0.50/$1.00 USD) - 2016/03/10 11:57:00 CET [2016/03/10 5:57:00 ET]
Table 'Eurysaces' 9-max Seat #3 is the button
Seat 1: Dantist1122 ($102.04 in chips) 
Seat 2: Dachish ($82.23 in chips) 
Seat 3: stds st ($38.50 in chips) 
Seat 4: peevoajax ($131.41 in chips) 
Seat 5: nickreason17 ($111.45 in chips) 
Seat 6: mycka86 ($118.21 in chips) 
Seat 7: SedativeHigh ($84.83 in chips) 
Seat 8: di0d80 ($102.50 in chips) 
Seat 9: matiko09 ($101.50 in chips) 
peevoajax: posts small blind $0.50
nickreason17: posts big blind $1
*** HOLE CARDS ***
Dealt to matiko09 [9h 5s]
mycka86: folds 
SedativeHigh: folds 
di0d80: folds 
matiko09: folds 
Dantist1122: folds 
Dachish: folds 
stds st: folds 
peevoajax: folds 
Uncalled bet ($0.50) returned to nickreason17
nickreason17 collected $1 from pot
*** SUMMARY ***
Total pot $1 | Rake $0 
Seat 1: Dantist1122 folded before Flop (didn't bet)
Seat 2: Dachish folded before Flop (didn't bet)
Seat 3: stds st (button) folded before Flop (didn't bet)
Seat 4: peevoajax (small blind) folded before Flop
Seat 5: nickreason17 (big blind) collected ($1)
Seat 6: mycka86 folded before Flop (didn't bet)
Seat 7: SedativeHigh folded before Flop (didn't bet)
Seat 8: di0d80 folded before Flop (didn't bet)
Seat 9: matiko09 folded before Flop (didn't bet)





PokerStars Hand #150123444070:  Hold'em No Limit ($0.50/$1.00 USD) - 2016/03/10 11:57:07 CET [2016/03/10 5:57:07 ET]
Table 'Liriope II' 9-max Seat #4 is the button
Seat 1: BOAYARSKIY ($58.48 in chips) 
Seat 4: ka100pka527 ($55.88 in chips) 
Seat 6: nobu-azabu ($79.93 in chips) 
Seat 7: matiko09 ($100 in chips) 
Seat 8: hammerwife ($134.63 in chips) 
Seat 9: peevoajax ($101.80 in chips) 
nobu-azabu: posts small blind $0.50
matiko09: posts big blind $1
*** HOLE CARDS ***
Dealt to matiko09 [3c 8s]
hammerwife: folds 
peevoajax: folds 
BOAYARSKIY has timed out
BOAYARSKIY: folds 
ka100pka527: folds 
nobu-azabu: folds 
Uncalled bet ($0.50) returned to matiko09
matiko09 collected $1 from pot
matiko09: doesn't show hand 
*** SUMMARY ***
Total pot $1 | Rake $0 
Seat 1: BOAYARSKIY folded before Flop (didn't bet)
Seat 4: ka100pka527 (button) folded before Flop (didn't bet)
Seat 6: nobu-azabu (small blind) folded before Flop
Seat 7: matiko09 (big blind) collected ($1)
Seat 8: hammerwife folded before Flop (didn't bet)
Seat 9: peevoajax folded before Flop (didn't bet)





PokerStars Hand #150123451822:  Hold'em No Limit ($0.50/$1.00 USD) - 2016/03/10 11:57:26 CET [2016/03/10 5:57:26 ET]
Table 'Zellner' 9-max Seat #8 is the button
Seat 1: di0d80 ($129.02 in chips) 
Seat 2: AlKatrone ($100 in chips) 
Seat 8: mycka86 ($216.47 in chips) 
Seat 9: matiko09 ($100.50 in chips) 
matiko09: posts small blind $0.50
di0d80: posts big blind $1
Yaaaazz: sits out 
*** HOLE CARDS ***
Dealt to matiko09 [Ah 9d]
AlKatrone: folds 
mycka86: folds 
matiko09: raises $1.50 to $2.50
di0d80: folds 
Uncalled bet ($1.50) returned to matiko09
matiko09 collected $2 from pot
matiko09: doesn't show hand 
*** SUMMARY ***
Total pot $2 | Rake $0 
Seat 1: di0d80 (big blind) folded before Flop
Seat 2: AlKatrone folded before Flop (didn't bet)
Seat 8: mycka86 (button) folded before Flop (didn't bet)
Seat 9: matiko09 (small blind) collected ($2)





PokerStars Hand #150123452434:  Hold'em No Limit ($0.50/$1.00 USD) - 2016/03/10 11:57:28 CET [2016/03/10 5:57:28 ET]
Table 'Eurysaces' 9-max Seat #4 is the button
Seat 1: Dantist1122 ($102.04 in chips) 
Seat 2: Dachish ($82.23 in chips) 
Seat 3: stds st ($38.50 in chips) 
Seat 4: peevoajax ($130.91 in chips) 
Seat 5: nickreason17 ($111.95 in chips) 
Seat 6: mycka86 ($118.21 in chips) 
Seat 7: SedativeHigh ($84.83 in chips) 
Seat 8: di0d80 ($102.50 in chips) 
Seat 9: matiko09 ($101.50 in chips) 
nickreason17: posts small blind $0.50
mycka86: posts big blind $1
*** HOLE CARDS ***
Dealt to matiko09 [6c 3c]
SedativeHigh: folds 
di0d80: folds 
matiko09: folds 
Dantist1122: folds 
Dachish: raises $2 to $3
stds st: folds 
peevoajax: folds 
nickreason17: folds 
mycka86: folds 
Uncalled bet ($2) returned to Dachish
Dachish collected $2.50 from pot
Dachish: doesn't show hand 
*** SUMMARY ***
Total pot $2.50 | Rake $0 
Seat 1: Dantist1122 folded before Flop (didn't bet)
Seat 2: Dachish collected ($2.50)
Seat 3: stds st folded before Flop (didn't bet)
Seat 4: peevoajax (button) folded before Flop (didn't bet)
Seat 5: nickreason17 (small blind) folded before Flop
Seat 6: mycka86 (big blind) folded before Flop
Seat 7: SedativeHigh folded before Flop (didn't bet)
Seat 8: di0d80 folded before Flop (didn't bet)
Seat 9: matiko09 folded before Flop (didn't bet)





PokerStars Hand #150123456197:  Hold'em No Limit ($0.50/$1.00 USD) - 2016/03/10 11:57:37 CET [2016/03/10 5:57:37 ET]
Table 'Liriope II' 9-max Seat #6 is the button
Seat 4: ka100pka527 ($55.88 in chips) 
Seat 6: nobu-azabu ($79.43 in chips) 
Seat 7: matiko09 ($100.50 in chips) 
Seat 9: peevoajax ($101.80 in chips) 
matiko09: posts small blind $0.50
hammerwife: is sitting out 
peevoajax: posts big blind $1
*** HOLE CARDS ***
Dealt to matiko09 [3c 2h]
ka100pka527: folds 
nobu-azabu: raises $1.50 to $2.50
matiko09: folds 
peevoajax: raises $7.50 to $10
nobu-azabu: folds 
Uncalled bet ($7.50) returned to peevoajax
peevoajax collected $5.50 from pot
peevoajax: doesn't show hand 
*** SUMMARY ***
Total pot $5.50 | Rake $0 
Seat 4: ka100pka527 folded before Flop (didn't bet)
Seat 6: nobu-azabu (button) folded before Flop
Seat 7: matiko09 (small blind) folded before Flop
Seat 9: peevoajax (big blind) collected ($5.50)





PokerStars Hand #150123457545:  Hold'em No Limit ($0.50/$1.00 USD) - 2016/03/10 11:57:40 CET [2016/03/10 5:57:40 ET]
Table 'Zellner' 9-max Seat #9 is the button
Seat 1: di0d80 ($128.02 in chips) 
Seat 2: AlKatrone ($100 in chips) 
Seat 8: mycka86 ($216.47 in chips) 
Seat 9: matiko09 ($101.50 in chips) 
di0d80: posts small blind $0.50
AlKatrone: posts big blind $1
Yaaaazz: sits out 
*** HOLE CARDS ***
Dealt to matiko09 [5h 4s]
mycka86: raises $1.10 to $2.10
matiko09: folds 
di0d80: folds 
AlKatrone: calls $1.10
*** FLOP *** [7d 9c 9d]
AlKatrone: checks 
mycka86: checks 
*** TURN *** [7d 9c 9d] [Js]
AlKatrone: checks 
mycka86: bets $3.20
AlKatrone: folds 
Uncalled bet ($3.20) returned to mycka86
mycka86 collected $4.49 from pot
*** SUMMARY ***
Total pot $4.70 | Rake $0.21 
Board [7d 9c 9d Js]
Seat 1: di0d80 (small blind) folded before Flop
Seat 2: AlKatrone (big blind) folded on the Turn
Seat 8: mycka86 collected ($4.49)
Seat 9: matiko09 (button) folded before Flop (didn't bet)





PokerStars Hand #150123462897:  Hold'em No Limit ($0.50/$1.00 USD) - 2016/03/10 11:57:53 CET [2016/03/10 5:57:53 ET]
Table 'Eurysaces' 9-max Seat #5 is the button
Seat 1: Dantist1122 ($102.04 in chips) 
Seat 2: Dachish ($83.73 in chips) 
Seat 3: stds st ($38.50 in chips) 
Seat 4: peevoajax ($130.91 in chips) 
Seat 5: nickreason17 ($111.45 in chips) 
Seat 6: mycka86 ($117.21 in chips) 
Seat 7: SedativeHigh ($84.83 in chips) 
Seat 8: di0d80 ($102.50 in chips) 
Seat 9: matiko09 ($101.50 in chips) 
mycka86: posts small blind $0.50
SedativeHigh: posts big blind $1
*** HOLE CARDS ***
Dealt to matiko09 [9c Qc]
di0d80: folds 
matiko09: folds 
Dantist1122: raises $2 to $3
Dachish: folds 
stds st: folds 
peevoajax: folds 
nickreason17: folds 
mycka86: folds 
SedativeHigh: folds 
Uncalled bet ($2) returned to Dantist1122
Dantist1122 collected $2.50 from pot
Dantist1122: doesn't show hand 
*** SUMMARY ***
Total pot $2.50 | Rake $0 
Seat 1: Dantist1122 collected ($2.50)
Seat 2: Dachish folded before Flop (didn't bet)
Seat 3: stds st folded before Flop (didn't bet)
Seat 4: peevoajax folded before Flop (didn't bet)
Seat 5: nickreason17 (button) folded before Flop (didn't bet)
Seat 6: mycka86 (small blind) folded before Flop
Seat 7: SedativeHigh (big blind) folded before Flop
Seat 8: di0d80 folded before Flop (didn't bet)
Seat 9: matiko09 folded before Flop (didn't bet)





PokerStars Hand #150123463827:  Hold'em No Limit ($0.50/$1.00 USD) - 2016/03/10 11:57:56 CET [2016/03/10 5:57:56 ET]
Table 'Liriope II' 9-max Seat #7 is the button
Seat 4: ka100pka527 ($55.88 in chips) 
Seat 6: nobu-azabu ($76.93 in chips) 
Seat 7: matiko09 ($100 in chips) 
Seat 9: peevoajax ($104.80 in chips) 
peevoajax: posts small blind $0.50
ka100pka527: posts big blind $1
*** HOLE CARDS ***
Dealt to matiko09 [6h 7c]
nobu-azabu: folds 
matiko09: folds 
peevoajax: raises $2 to $3
ka100pka527: raises $5 to $8
peevoajax: folds 
Uncalled bet ($5) returned to ka100pka527
ka100pka527 collected $6 from pot
ka100pka527: doesn't show hand 
*** SUMMARY ***
Total pot $6 | Rake $0 
Seat 4: ka100pka527 (big blind) collected ($6)
Seat 6: nobu-azabu folded before Flop (didn't bet)
Seat 7: matiko09 (button) folded before Flop (didn't bet)
Seat 9: peevoajax (small blind) folded before Flop





PokerStars Hand #150123475713:  Hold'em No Limit ($0.50/$1.00 USD) - 2016/03/10 11:58:25 CET [2016/03/10 5:58:25 ET]
Table 'Liriope II' 9-max Seat #9 is the button
Seat 4: ka100pka527 ($58.88 in chips) 
Seat 6: nobu-azabu ($76.93 in chips) 
Seat 7: matiko09 ($100 in chips) 
Seat 9: peevoajax ($101.80 in chips) 
BOAYARSKIY will be allowed to play after the button
ka100pka527: posts small blind $0.50
nobu-azabu: posts big blind $1
*** HOLE CARDS ***
Dealt to matiko09 [Ac 2s]
matiko09: folds 
peevoajax: folds 
ka100pka527: raises $2 to $3
nobu-azabu: calls $2
*** FLOP *** [2c Qs 8c]
ka100pka527: checks 
nobu-azabu: checks 
*** TURN *** [2c Qs 8c] [Qd]
ka100pka527: bets $3.81
nobu-azabu: folds 
Uncalled bet ($3.81) returned to ka100pka527
ka100pka527 collected $5.73 from pot
ka100pka527: doesn't show hand 
*** SUMMARY ***
Total pot $6 | Rake $0.27 
Board [2c Qs 8c Qd]
Seat 4: ka100pka527 (small blind) collected ($5.73)
Seat 6: nobu-azabu (big blind) folded on the Turn
Seat 7: matiko09 folded before Flop (didn't bet)
Seat 9: peevoajax (button) folded before Flop (didn't bet)





PokerStars Hand #150123476212:  Hold'em No Limit ($0.50/$1.00 USD) - 2016/03/10 11:58:26 CET [2016/03/10 5:58:26 ET]
Table 'Eurysaces' 9-max Seat #6 is the button
Seat 1: Dantist1122 ($103.54 in chips) 
Seat 2: Dachish ($83.73 in chips) 
Seat 3: stds st ($38.50 in chips) 
Seat 4: peevoajax ($130.91 in chips) 
Seat 5: nickreason17 ($111.45 in chips) 
Seat 6: mycka86 ($116.71 in chips) 
Seat 7: SedativeHigh ($83.83 in chips) 
Seat 8: di0d80 ($102.50 in chips) 
Seat 9: matiko09 ($101.50 in chips) 
SedativeHigh: posts small blind $0.50
di0d80: posts big blind $1
*** HOLE CARDS ***
Dealt to matiko09 [8c 6s]
matiko09: folds 
Dantist1122: folds 
Dachish: folds 
stds st: folds 
peevoajax: raises $2 to $3
nickreason17: raises $6 to $9
mycka86: folds 
SedativeHigh: folds 
di0d80: folds 
peevoajax: folds 
Uncalled bet ($6) returned to nickreason17
nickreason17 collected $7.50 from pot
*** SUMMARY ***
Total pot $7.50 | Rake $0 
Seat 1: Dantist1122 folded before Flop (didn't bet)
Seat 2: Dachish folded before Flop (didn't bet)
Seat 3: stds st folded before Flop (didn't bet)
Seat 4: peevoajax folded before Flop
Seat 5: nickreason17 collected ($7.50)
Seat 6: mycka86 (button) folded before Flop (didn't bet)
Seat 7: SedativeHigh (small blind) folded before Flop
Seat 8: di0d80 (big blind) folded before Flop
Seat 9: matiko09 folded before Flop (didn't bet)





PokerStars Hand #150123482467:  Hold'em No Limit ($0.50/$1.00 USD) - 2016/03/10 11:58:42 CET [2016/03/10 5:58:42 ET]
Table 'Zellner' 9-max Seat #1 is the button
Seat 1: di0d80 ($127.52 in chips) 
Seat 2: AlKatrone ($100 in chips) 
Seat 3: Yaaaazz ($100 in chips) 
Seat 4: ReneP27 ($98.50 in chips) 
Seat 8: mycka86 ($218.86 in chips) 
Seat 9: matiko09 ($101.50 in chips) 
AlKatrone: posts small blind $0.50
Yaaaazz: posts big blind $1
PopShoveIt13: sits out 
*** HOLE CARDS ***
Dealt to matiko09 [Qc Kc]
ReneP27: folds 
mycka86: folds 
matiko09: raises $1.50 to $2.50
di0d80: folds 
AlKatrone: raises $6.50 to $9
Yaaaazz: folds 
matiko09: calls $6.50
*** FLOP *** [Js 9d Qd]
AlKatrone: checks 
matiko09: bets $10
AlKatrone: folds 
Uncalled bet ($10) returned to matiko09
matiko09 collected $18.14 from pot
matiko09: doesn't show hand 
*** SUMMARY ***
Total pot $19 | Rake $0.86 
Board [Js 9d Qd]
Seat 1: di0d80 (button) folded before Flop (didn't bet)
Seat 2: AlKatrone (small blind) folded on the Flop
Seat 3: Yaaaazz (big blind) folded before Flop
Seat 4: ReneP27 folded before Flop (didn't bet)
Seat 8: mycka86 folded before Flop (didn't bet)
Seat 9: matiko09 collected ($18.14)





PokerStars Hand #150123487777:  Hold'em No Limit ($0.50/$1.00 USD) - 2016/03/10 11:58:55 CET [2016/03/10 5:58:55 ET]
Table 'Liriope II' 9-max Seat #4 is the button
Seat 4: ka100pka527 ($61.61 in chips) 
Seat 6: nobu-azabu ($73.93 in chips) 
Seat 7: matiko09 ($100 in chips) 
Seat 9: peevoajax ($101.80 in chips) 
nobu-azabu: posts small blind $0.50
matiko09: posts big blind $1
BOAYARSKIY: sits out 
*** HOLE CARDS ***
Dealt to matiko09 [9d 4c]
peevoajax: folds 
ka100pka527: raises $1 to $2
nobu-azabu: folds 
matiko09: folds 
Uncalled bet ($1) returned to ka100pka527
ka100pka527 collected $2.50 from pot
ka100pka527: doesn't show hand 
*** SUMMARY ***
Total pot $2.50 | Rake $0 
Seat 4: ka100pka527 (button) collected ($2.50)
Seat 6: nobu-azabu (small blind) folded before Flop
Seat 7: matiko09 (big blind) folded before Flop
Seat 9: peevoajax folded before Flop (didn't bet)





PokerStars Hand #150123494237:  Hold'em No Limit ($0.50/$1.00 USD) - 2016/03/10 11:59:11 CET [2016/03/10 5:59:11 ET]
Table 'Eurysaces' 9-max Seat #7 is the button
Seat 1: Dantist1122 ($103.54 in chips) 
Seat 2: Dachish ($83.73 in chips) 
Seat 3: stds st ($38.50 in chips) 
Seat 4: peevoajax ($127.91 in chips) 
Seat 5: nickreason17 ($115.95 in chips) 
Seat 6: mycka86 ($116.71 in chips) 
Seat 7: SedativeHigh ($83.33 in chips) 
Seat 8: di0d80 ($101.50 in chips) 
Seat 9: matiko09 ($101.50 in chips) 
di0d80: posts small blind $0.50
matiko09: posts big blind $1
*** HOLE CARDS ***
Dealt to matiko09 [Th 8s]
Dantist1122: folds 
Dachish: folds 
stds st: folds 
peevoajax: folds 
nickreason17: folds 
mycka86: folds 
SedativeHigh: calls $1
di0d80: folds 
matiko09: checks 
*** FLOP *** [9s 3c Td]
matiko09: bets $1.55
SedativeHigh: raises $2.45 to $4
matiko09: calls $2.45
*** TURN *** [9s 3c Td] [3h]
matiko09: checks 
SedativeHigh: checks 
*** RIVER *** [9s 3c Td 3h] [6s]
matiko09: checks 
SedativeHigh: bets $10.03
matiko09: folds 
Uncalled bet ($10.03) returned to SedativeHigh
SedativeHigh collected $10.03 from pot
*** SUMMARY ***
Total pot $10.50 | Rake $0.47 
Board [9s 3c Td 3h 6s]
Seat 1: Dantist1122 folded before Flop (didn't bet)
Seat 2: Dachish folded before Flop (didn't bet)
Seat 3: stds st folded before Flop (didn't bet)
Seat 4: peevoajax folded before Flop (didn't bet)
Seat 5: nickreason17 folded before Flop (didn't bet)
Seat 6: mycka86 folded before Flop (didn't bet)
Seat 7: SedativeHigh (button) collected ($10.03)
Seat 8: di0d80 (small blind) folded before Flop
Seat 9: matiko09 (big blind) folded on the River





PokerStars Hand #150123495595:  Hold'em No Limit ($0.50/$1.00 USD) - 2016/03/10 11:59:14 CET [2016/03/10 5:59:14 ET]
Table 'Liriope II' 9-max Seat #6 is the button
Seat 1: BOAYARSKIY ($58.48 in chips) 
Seat 4: ka100pka527 ($63.11 in chips) 
Seat 6: nobu-azabu ($73.43 in chips) 
Seat 7: matiko09 ($100 in chips) 
matiko09: posts small blind $0.50
peevoajax: is sitting out 
BOAYARSKIY: posts big blind $1
*** HOLE CARDS ***
Dealt to matiko09 [2c 9d]
ka100pka527: folds 
nobu-azabu: folds 
peevoajax leaves the table
matiko09: folds 
Uncalled bet ($0.50) returned to BOAYARSKIY
BOAYARSKIY collected $1 from pot
BOAYARSKIY: doesn't show hand 
*** SUMMARY ***
Total pot $1 | Rake $0 
Seat 1: BOAYARSKIY (big blind) collected ($1)
Seat 4: ka100pka527 folded before Flop (didn't bet)
Seat 6: nobu-azabu (button) folded before Flop (didn't bet)
Seat 7: matiko09 (small blind) folded before Flop





PokerStars Hand #150123498973:  Hold'em No Limit ($0.50/$1.00 USD) - 2016/03/10 11:59:22 CET [2016/03/10 5:59:22 ET]
Table 'Liriope II' 9-max Seat #7 is the button
Seat 1: BOAYARSKIY ($58.98 in chips) 
Seat 4: ka100pka527 ($63.11 in chips) 
Seat 6: nobu-azabu ($73.43 in chips) 
Seat 7: matiko09 ($100 in chips) 
BOAYARSKIY: posts small blind $0.50
ka100pka527: posts big blind $1
*** HOLE CARDS ***
Dealt to matiko09 [8s Kc]
nobu-azabu: raises $2 to $3
matiko09: folds 
BOAYARSKIY: raises $5.50 to $8.50
ka100pka527: folds 
nobu-azabu: calls $5.50
*** FLOP *** [4h Kh 4d]
BOAYARSKIY: bets $10.50
nobu-azabu: calls $10.50
*** TURN *** [4h Kh 4d] [9s]
BOAYARSKIY: checks 
nobu-azabu: bets $18.75
chaps1988 joins the table at seat #5 
BOAYARSKIY: folds 
Uncalled bet ($18.75) returned to nobu-azabu
nobu-azabu collected $37.50 from pot
*** SUMMARY ***
Total pot $39 | Rake $1.50 
Board [4h Kh 4d 9s]
Seat 1: BOAYARSKIY (small blind) folded on the Turn
Seat 4: ka100pka527 (big blind) folded before Flop
Seat 6: nobu-azabu collected ($37.50)
Seat 7: matiko09 (button) folded before Flop (didn't bet)





PokerStars Hand #150123508397:  Hold'em No Limit ($0.50/$1.00 USD) - 2016/03/10 11:59:46 CET [2016/03/10 5:59:46 ET]
Table 'Zellner' 9-max Seat #2 is the button
Seat 1: di0d80 ($127.52 in chips) 
Seat 2: AlKatrone ($100 in chips) 
Seat 3: Yaaaazz ($100 in chips) 
Seat 4: ReneP27 ($98.50 in chips) 
Seat 8: mycka86 ($218.86 in chips) 
Seat 9: matiko09 ($110.64 in chips) 
Yaaaazz: posts small blind $0.50
ReneP27: posts big blind $1
PopShoveIt13: sits out 
*** HOLE CARDS ***
Dealt to matiko09 [Ac 5s]
mycka86: folds 
matiko09: folds 
di0d80: raises $1.50 to $2.50
AlKatrone: folds 
Yaaaazz: folds 
ReneP27: folds 
Uncalled bet ($1.50) returned to di0d80
di0d80 collected $2.50 from pot
di0d80: doesn't show hand 
*** SUMMARY ***
Total pot $2.50 | Rake $0 
Seat 1: di0d80 collected ($2.50)
Seat 2: AlKatrone (button) folded before Flop (didn't bet)
Seat 3: Yaaaazz (small blind) folded before Flop
Seat 4: ReneP27 (big blind) folded before Flop
Seat 8: mycka86 folded before Flop (didn't bet)
Seat 9: matiko09 folded before Flop (didn't bet)





PokerStars Hand #150123520784:  Hold'em No Limit ($0.50/$1.00 USD) - 2016/03/10 12:00:15 CET [2016/03/10 6:00:15 ET]
Table 'Zellner' 9-max Seat #3 is the button
Seat 1: di0d80 ($129.02 in chips) 
Seat 2: AlKatrone ($100 in chips) 
Seat 3: Yaaaazz ($100 in chips) 
Seat 4: ReneP27 ($97.50 in chips) 
Seat 7: PopShoveIt13 ($100 in chips) 
Seat 8: mycka86 ($218.86 in chips) 
Seat 9: matiko09 ($110.64 in chips) 
ReneP27: posts small blind $0.50
LiGuoDongLi was removed from the table for failing to post
PopShoveIt13: posts big blind $1
*** HOLE CARDS ***
Dealt to matiko09 [9c 2d]
mycka86: folds 
lumen21 joins the table at seat #5 
matiko09: folds 
di0d80: raises $1.50 to $2.50
AlKatrone: folds 
Yaaaazz: folds 
ReneP27: calls $2
PopShoveIt13: calls $1.50
*** FLOP *** [6c 7s Td]
ReneP27: bets $7.16
PopShoveIt13: calls $7.16
di0d80: folds 
*** TURN *** [6c 7s Td] [7h]
ReneP27: bets $20.84
PopShoveIt13: folds 
Uncalled bet ($20.84) returned to ReneP27
ReneP27 collected $20.84 from pot
ReneP27: doesn't show hand 
*** SUMMARY ***
Total pot $21.82 | Rake $0.98 
Board [6c 7s Td 7h]
Seat 1: di0d80 folded on the Flop
Seat 2: AlKatrone folded before Flop (didn't bet)
Seat 3: Yaaaazz (button) folded before Flop (didn't bet)
Seat 4: ReneP27 (small blind) collected ($20.84)
Seat 7: PopShoveIt13 (big blind) folded on the Turn
Seat 8: mycka86 folded before Flop (didn't bet)
Seat 9: matiko09 folded before Flop (didn't bet)





PokerStars Hand #150123523384:  Hold'em No Limit ($0.50/$1.00 USD) - 2016/03/10 12:00:22 CET [2016/03/10 6:00:22 ET]
Table 'Liriope II' 9-max Seat #1 is the button
Seat 1: BOAYARSKIY ($39.98 in chips) 
Seat 4: ka100pka527 ($62.11 in chips) 
Seat 5: chaps1988 ($100 in chips) 
Seat 6: nobu-azabu ($91.93 in chips) 
Seat 7: matiko09 ($100 in chips) 
ka100pka527: posts small blind $0.50
chaps1988: posts big blind $1
*** HOLE CARDS ***
Dealt to matiko09 [3d Ac]
nobu-azabu: raises $1.50 to $2.50
anatoliy976 joins the table at seat #3 
matiko09: folds 
jaccall joins the table at seat #2 
BOAYARSKIY: raises $5 to $7.50
ka100pka527: folds 
chaps1988: folds 
nobu-azabu: calls $5
*** FLOP *** [6h 6s Th]
nobu-azabu: checks 
FRANTICBLOND joins the table at seat #9 
BOAYARSKIY: bets $10.50
nobu-azabu: calls $10.50
*** TURN *** [6h 6s Th] [Ah]
nobu-azabu: checks 
BOAYARSKIY: bets $21.98 and is all-in
nobu-azabu: calls $21.98
*** RIVER *** [6h 6s Th Ah] [5c]
*** SHOW DOWN ***
nobu-azabu: shows [8h Jh] (a flush, Ace high)
BOAYARSKIY: shows [Kc Ks] (two pair, Kings and Sixes)
nobu-azabu collected $78.66 from pot
*** SUMMARY ***
Total pot $81.46 | Rake $2.80 
Board [6h 6s Th Ah 5c]
Seat 1: BOAYARSKIY (button) showed [Kc Ks] and lost with two pair, Kings and Sixes
Seat 4: ka100pka527 (small blind) folded before Flop
Seat 5: chaps1988 (big blind) folded before Flop
Seat 6: nobu-azabu showed [8h Jh] and won ($78.66) with a flush, Ace high
Seat 7: matiko09 folded before Flop (didn't bet)





PokerStars Hand #150123533456:  Hold'em No Limit ($0.50/$1.00 USD) - 2016/03/10 12:00:45 CET [2016/03/10 6:00:45 ET]
Table 'Eurysaces' 9-max Seat #8 is the button
Seat 1: Dantist1122 ($103.54 in chips) 
Seat 2: Dachish ($83.73 in chips) 
Seat 3: stds st ($38.50 in chips) 
Seat 4: peevoajax ($127.91 in chips) 
Seat 5: nickreason17 ($115.95 in chips) 
Seat 6: mycka86 ($116.71 in chips) 
Seat 7: SedativeHigh ($88.36 in chips) 
Seat 8: di0d80 ($101 in chips) 
Seat 9: matiko09 ($100 in chips) 
matiko09: posts small blind $0.50
Dantist1122: posts big blind $1
*** HOLE CARDS ***
Dealt to matiko09 [6h Jc]
Dachish: folds 
stds st: folds 
peevoajax: raises $2 to $3
nickreason17: folds 
mycka86: folds 
SedativeHigh: calls $3
di0d80: folds 
matiko09: folds 
Dantist1122: folds 
*** FLOP *** [Tc Qh 3c]
peevoajax: bets $5
SedativeHigh: folds 
Uncalled bet ($5) returned to peevoajax
peevoajax collected $7.16 from pot
peevoajax: doesn't show hand 
*** SUMMARY ***
Total pot $7.50 | Rake $0.34 
Board [Tc Qh 3c]
Seat 1: Dantist1122 (big blind) folded before Flop
Seat 2: Dachish folded before Flop (didn't bet)
Seat 3: stds st folded before Flop (didn't bet)
Seat 4: peevoajax collected ($7.16)
Seat 5: nickreason17 folded before Flop (didn't bet)
Seat 6: mycka86 folded before Flop (didn't bet)
Seat 7: SedativeHigh folded on the Flop
Seat 8: di0d80 (button) folded before Flop (didn't bet)
Seat 9: matiko09 (small blind) folded before Flop





PokerStars Hand #150123543733:  Hold'em No Limit ($0.50/$1.00 USD) - 2016/03/10 12:01:09 CET [2016/03/10 6:01:09 ET]
Table 'Liriope II' 9-max Seat #4 is the button
Seat 1: BOAYARSKIY ($40 in chips) 
Seat 3: anatoliy976 ($50.38 in chips) 
Seat 4: ka100pka527 ($61.61 in chips) 
Seat 5: chaps1988 ($100 in chips) 
Seat 6: nobu-azabu ($130.61 in chips) 
Seat 7: matiko09 ($100 in chips) 
chaps1988: posts small blind $0.50
nobu-azabu: posts big blind $1
FRANTICBLOND: sits out 
jaccall: sits out 
anatoliy976: posts big blind $1
*** HOLE CARDS ***
Dealt to matiko09 [Ah Qh]
matiko09: raises $3 to $4
FRANTICBLOND leaves the table
BOAYARSKIY: raises $36 to $40 and is all-in
anatoliy976: folds 
ka100pka527: folds 
chaps1988: folds 
nobu-azabu: folds 
matiko09: calls $36
*** FLOP *** [Ts 6h Td]
*** TURN *** [Ts 6h Td] [As]
*** RIVER *** [Ts 6h Td As] [5h]
*** SHOW DOWN ***
matiko09: shows [Ah Qh] (two pair, Aces and Tens)
BOAYARSKIY: mucks hand 
matiko09 collected $79.70 from pot
*** SUMMARY ***
Total pot $82.50 | Rake $2.80 
Board [Ts 6h Td As 5h]
Seat 1: BOAYARSKIY mucked [Qs Qd]
Seat 3: anatoliy976 folded before Flop
Seat 4: ka100pka527 (button) folded before Flop (didn't bet)
Seat 5: chaps1988 (small blind) folded before Flop
Seat 6: nobu-azabu (big blind) folded before Flop
Seat 7: matiko09 showed [Ah Qh] and won ($79.70) with two pair, Aces and Tens





PokerStars Hand #150123551970:  Hold'em No Limit ($0.50/$1.00 USD) - 2016/03/10 12:01:28 CET [2016/03/10 6:01:28 ET]
Table 'Zellner' 9-max Seat #4 is the button
Seat 1: di0d80 ($126.52 in chips) 
Seat 2: AlKatrone ($100 in chips) 
Seat 3: Yaaaazz ($100 in chips) 
Seat 4: ReneP27 ($108.68 in chips) 
Seat 7: PopShoveIt13 ($100 in chips) 
Seat 8: mycka86 ($218.86 in chips) 
Seat 9: matiko09 ($110.64 in chips) 
lumen21 will be allowed to play after the button
PopShoveIt13: posts small blind $0.50
mycka86: posts big blind $1
*** HOLE CARDS ***
Dealt to matiko09 [Kh Ah]
matiko09: raises $2 to $3
di0d80: folds 
AlKatrone: folds 
Yaaaazz: folds 
ReneP27: folds 
PopShoveIt13: folds 
mycka86: folds 
Uncalled bet ($2) returned to matiko09
matiko09 collected $2.50 from pot
matiko09: doesn't show hand 
*** SUMMARY ***
Total pot $2.50 | Rake $0 
Seat 1: di0d80 folded before Flop (didn't bet)
Seat 2: AlKatrone folded before Flop (didn't bet)
Seat 3: Yaaaazz folded before Flop (didn't bet)
Seat 4: ReneP27 (button) folded before Flop (didn't bet)
Seat 7: PopShoveIt13 (small blind) folded before Flop
Seat 8: mycka86 (big blind) folded before Flop
Seat 9: matiko09 collected ($2.50)





PokerStars Hand #150123562746:  Hold'em No Limit ($0.50/$1.00 USD) - 2016/03/10 12:01:52 CET [2016/03/10 6:01:52 ET]
Table 'Eurysaces' 9-max Seat #9 is the button
Seat 1: Dantist1122 ($102.54 in chips) 
Seat 2: Dachish ($83.73 in chips) 
Seat 3: stds st ($38.50 in chips) 
Seat 4: peevoajax ($132.07 in chips) 
Seat 5: nickreason17 ($115.95 in chips) 
Seat 6: mycka86 ($116.71 in chips) 
Seat 7: SedativeHigh ($85.36 in chips) 
Seat 8: di0d80 ($101 in chips) 
Seat 9: matiko09 ($100 in chips) 
Dantist1122: posts small blind $0.50
Dachish: posts big blind $1
*** HOLE CARDS ***
Dealt to matiko09 [9s 8d]
stds st: folds 
peevoajax: folds 
nickreason17: folds 
mycka86: folds 
SedativeHigh: folds 
di0d80: folds 
matiko09: folds 
Dantist1122: raises $1.05 to $2.05
Dachish: folds 
Uncalled bet ($1.05) returned to Dantist1122
Dantist1122 collected $2 from pot
Dantist1122: doesn't show hand 
*** SUMMARY ***
Total pot $2 | Rake $0 
Seat 1: Dantist1122 (small blind) collected ($2)
Seat 2: Dachish (big blind) folded before Flop
Seat 3: stds st folded before Flop (didn't bet)
Seat 4: peevoajax folded before Flop (didn't bet)
Seat 5: nickreason17 folded before Flop (didn't bet)
Seat 6: mycka86 folded before Flop (didn't bet)
Seat 7: SedativeHigh folded before Flop (didn't bet)
Seat 8: di0d80 folded before Flop (didn't bet)
Seat 9: matiko09 (button) folded before Flop (didn't bet)





PokerStars Hand #150123573282:  Hold'em No Limit ($0.50/$1.00 USD) - 2016/03/10 12:02:15 CET [2016/03/10 6:02:15 ET]
Table 'Liriope II' 9-max Seat #5 is the button
Seat 1: BOAYARSKIY ($40 in chips) 
Seat 3: anatoliy976 ($49.38 in chips) 
Seat 4: ka100pka527 ($61.61 in chips) 
Seat 5: chaps1988 ($100 in chips) 
Seat 6: nobu-azabu ($129.61 in chips) 
Seat 7: matiko09 ($139.70 in chips) 
nobu-azabu: posts small blind $0.50
matiko09: posts big blind $1
jaccall: sits out 
*** HOLE CARDS ***
Dealt to matiko09 [4s 4h]
BOAYARSKIY: raises $1.13 to $2.13
anatoliy976: folds 
ka100pka527: folds 
chaps1988: calls $2.13
nobu-azabu: folds 
Yaaaazz joins the table at seat #9 
matiko09: calls $1.13
*** FLOP *** [3c Js 5c]
matiko09: checks 
BOAYARSKIY: bets $4.50
chaps1988: folds 
matiko09: folds 
Uncalled bet ($4.50) returned to BOAYARSKIY
BOAYARSKIY collected $6.58 from pot
BOAYARSKIY: doesn't show hand 
*** SUMMARY ***
Total pot $6.89 | Rake $0.31 
Board [3c Js 5c]
Seat 1: BOAYARSKIY collected ($6.58)
Seat 3: anatoliy976 folded before Flop (didn't bet)
Seat 4: ka100pka527 folded before Flop (didn't bet)
Seat 5: chaps1988 (button) folded on the Flop
Seat 6: nobu-azabu (small blind) folded before Flop
Seat 7: matiko09 (big blind) folded on the Flop





PokerStars Hand #150123574253:  Hold'em No Limit ($0.50/$1.00 USD) - 2016/03/10 12:02:18 CET [2016/03/10 6:02:18 ET]
Table 'Eurysaces' 9-max Seat #1 is the button
Seat 1: Dantist1122 ($103.54 in chips) 
Seat 2: Dachish ($82.73 in chips) 
Seat 3: stds st ($38.50 in chips) 
Seat 4: peevoajax ($132.07 in chips) 
Seat 5: nickreason17 ($115.95 in chips) 
Seat 6: mycka86 ($116.71 in chips) 
Seat 7: SedativeHigh ($85.36 in chips) 
Seat 8: di0d80 ($101 in chips) 
Seat 9: matiko09 ($100 in chips) 
Dachish: posts small blind $0.50
stds st: posts big blind $1
*** HOLE CARDS ***
Dealt to matiko09 [2c 2s]
peevoajax: folds 
nickreason17: folds 
mycka86: folds 
SedativeHigh: folds 
di0d80: folds 
matiko09: raises $1.50 to $2.50
Dantist1122: folds 
Dachish: folds 
stds st: folds 
Uncalled bet ($1.50) returned to matiko09
matiko09 collected $2.50 from pot
matiko09: doesn't show hand 
*** SUMMARY ***
Total pot $2.50 | Rake $0 
Seat 1: Dantist1122 (button) folded before Flop (didn't bet)
Seat 2: Dachish (small blind) folded before Flop
Seat 3: stds st (big blind) folded before Flop
Seat 4: peevoajax folded before Flop (didn't bet)
Seat 5: nickreason17 folded before Flop (didn't bet)
Seat 6: mycka86 folded before Flop (didn't bet)
Seat 7: SedativeHigh folded before Flop (didn't bet)
Seat 8: di0d80 folded before Flop (didn't bet)
Seat 9: matiko09 collected ($2.50)





PokerStars Hand #150123591586:  Hold'em No Limit ($0.50/$1.00 USD) - 2016/03/10 12:02:56 CET [2016/03/10 6:02:56 ET]
Table 'Eurysaces' 9-max Seat #2 is the button
Seat 1: Dantist1122 ($103.54 in chips) 
Seat 2: Dachish ($82.23 in chips) 
Seat 3: stds st ($37.50 in chips) 
Seat 6: mycka86 ($116.71 in chips) 
Seat 7: SedativeHigh ($85.36 in chips) 
Seat 8: di0d80 ($101 in chips) 
Seat 9: matiko09 ($101.50 in chips) 
stds st: posts small blind $0.50
peevoajax: is sitting out 
nickreason17: is sitting out 
peevoajax leaves the table
nickreason17 leaves the table
mycka86: posts big blind $1
*** HOLE CARDS ***
Dealt to matiko09 [9s Ts]
SedativeHigh: folds 
di0d80: folds 
matiko09: raises $2 to $3
SedativeHigh leaves the table
Dantist1122: folds 
chaps1988 joins the table at seat #7 
Dachish: folds 
stds st: folds 
mycka86: calls $2
*** FLOP *** [Ac Js Qh]
mycka86: checks 
matiko09: bets $4.04
mycka86: folds 
Uncalled bet ($4.04) returned to matiko09
matiko09 collected $6.21 from pot
matiko09: doesn't show hand 
*** SUMMARY ***
Total pot $6.50 | Rake $0.29 
Board [Ac Js Qh]
Seat 1: Dantist1122 folded before Flop (didn't bet)
Seat 2: Dachish (button) folded before Flop (didn't bet)
Seat 3: stds st (small blind) folded before Flop
Seat 6: mycka86 (big blind) folded on the Flop
Seat 7: SedativeHigh folded before Flop (didn't bet)
Seat 8: di0d80 folded before Flop (didn't bet)
Seat 9: matiko09 collected ($6.21)





PokerStars Hand #150123596288:  Hold'em No Limit ($0.50/$1.00 USD) - 2016/03/10 12:03:06 CET [2016/03/10 6:03:06 ET]
Table 'Liriope II' 9-max Seat #6 is the button
Seat 1: BOAYARSKIY ($44.45 in chips) 
Seat 3: anatoliy976 ($49.38 in chips) 
Seat 4: ka100pka527 ($61.61 in chips) 
Seat 5: chaps1988 ($100 in chips) 
Seat 6: nobu-azabu ($129.11 in chips) 
Seat 7: matiko09 ($137.57 in chips) 
Seat 9: Yaaaazz ($100 in chips) 
matiko09: posts small blind $0.50
Yaaaazz: posts big blind $1
jaccall: sits out 
*** HOLE CARDS ***
Dealt to matiko09 [Ac Qd]
BOAYARSKIY: raises $1.13 to $2.13
anatoliy976: folds 
ka100pka527: folds 
chaps1988: folds 
nobu-azabu: folds 
matiko09: raises $5.87 to $8
Yaaaazz: folds 
BOAYARSKIY: folds 
Uncalled bet ($5.87) returned to matiko09
matiko09 collected $5.26 from pot
matiko09: doesn't show hand 
*** SUMMARY ***
Total pot $5.26 | Rake $0 
Seat 1: BOAYARSKIY folded before Flop
Seat 3: anatoliy976 folded before Flop (didn't bet)
Seat 4: ka100pka527 folded before Flop (didn't bet)
Seat 5: chaps1988 folded before Flop (didn't bet)
Seat 6: nobu-azabu (button) folded before Flop (didn't bet)
Seat 7: matiko09 (small blind) collected ($5.26)
Seat 9: Yaaaazz (big blind) folded before Flop





PokerStars Hand #150123607971:  Hold'em No Limit ($0.50/$1.00 USD) - 2016/03/10 12:03:31 CET [2016/03/10 6:03:31 ET]
Table 'Eurysaces' 9-max Seat #3 is the button
Seat 1: Dantist1122 ($103.54 in chips) 
Seat 2: Dachish ($82.23 in chips) 
Seat 3: stds st ($37 in chips) 
Seat 6: mycka86 ($113.71 in chips) 
Seat 7: chaps1988 ($100 in chips) 
Seat 8: di0d80 ($101 in chips) 
Seat 9: matiko09 ($104.71 in chips) 
mycka86: posts small blind $0.50
chaps1988: posts big blind $1
*** HOLE CARDS ***
Dealt to matiko09 [5h 8s]
di0d80: raises $1.50 to $2.50
matiko09: folds 
Dantist1122: folds 
Dachish: raises $5.50 to $8
stds st: folds 
mycka86: folds 
chaps1988: folds 
di0d80: calls $5.50
*** FLOP *** [4h 6d 7d]
di0d80: checks 
Dachish: bets $10
19SERGE74 joins the table at seat #5 
di0d80: calls $10
*** TURN *** [4h 6d 7d] [2c]
di0d80: checks 
Dachish: bets $29
di0d80: folds 
Uncalled bet ($29) returned to Dachish
Dachish collected $35.81 from pot
Dachish: doesn't show hand 
*** SUMMARY ***
Total pot $37.50 | Rake $1.69 
Board [4h 6d 7d 2c]
Seat 1: Dantist1122 folded before Flop (didn't bet)
Seat 2: Dachish collected ($35.81)
Seat 3: stds st (button) folded before Flop (didn't bet)
Seat 6: mycka86 (small blind) folded before Flop
Seat 7: chaps1988 (big blind) folded before Flop
Seat 8: di0d80 folded on the Turn
Seat 9: matiko09 folded before Flop (didn't bet)





PokerStars Hand #150123612037:  Hold'em No Limit ($0.50/$1.00 USD) - 2016/03/10 12:03:40 CET [2016/03/10 6:03:40 ET]
Table 'Liriope II' 9-max Seat #7 is the button
Seat 1: BOAYARSKIY ($42.32 in chips) 
Seat 3: anatoliy976 ($49.38 in chips) 
Seat 4: ka100pka527 ($61.61 in chips) 
Seat 5: chaps1988 ($100 in chips) 
Seat 6: nobu-azabu ($129.11 in chips) 
Seat 7: matiko09 ($140.70 in chips) 
Seat 9: Yaaaazz ($100 in chips) 
Yaaaazz: posts small blind $0.50
BOAYARSKIY: posts big blind $1
jaccall: sits out 
*** HOLE CARDS ***
Dealt to matiko09 [6c 3h]
anatoliy976: folds 
ka100pka527: raises $1 to $2
chaps1988: folds 
nobu-azabu: folds 
matiko09: folds 
Yaaaazz: folds 
BOAYARSKIY: folds 
Uncalled bet ($1) returned to ka100pka527
ka100pka527 collected $2.50 from pot
ka100pka527: doesn't show hand 
*** SUMMARY ***
Total pot $2.50 | Rake $0 
Seat 1: BOAYARSKIY (big blind) folded before Flop
Seat 3: anatoliy976 folded before Flop (didn't bet)
Seat 4: ka100pka527 collected ($2.50)
Seat 5: chaps1988 folded before Flop (didn't bet)
Seat 6: nobu-azabu folded before Flop (didn't bet)
Seat 7: matiko09 (button) folded before Flop (didn't bet)
Seat 9: Yaaaazz (small blind) folded before Flop





PokerStars Hand #150123636538:  Hold'em No Limit ($0.50/$1.00 USD) - 2016/03/10 12:04:33 CET [2016/03/10 6:04:33 ET]
Table 'Liriope II' 9-max Seat #9 is the button
Seat 1: BOAYARSKIY ($41.32 in chips) 
Seat 2: jaccall ($67.89 in chips) 
Seat 3: anatoliy976 ($49.38 in chips) 
Seat 4: ka100pka527 ($63.11 in chips) 
Seat 5: chaps1988 ($100 in chips) 
Seat 6: nobu-azabu ($129.11 in chips) 
Seat 7: matiko09 ($140.70 in chips) 
Seat 9: Yaaaazz ($100 in chips) 
BOAYARSKIY: posts small blind $0.50
jaccall: posts big blind $1
*** HOLE CARDS ***
Dealt to matiko09 [Tc 4d]
anatoliy976 has timed out
anatoliy976: folds 
ka100pka527: folds 
chaps1988: folds 
nobu-azabu: folds 
matiko09: folds 
Yaaaazz: folds 
BOAYARSKIY: raises $1.13 to $2.13
jaccall: folds 
Uncalled bet ($1.13) returned to BOAYARSKIY
BOAYARSKIY collected $2 from pot
BOAYARSKIY: doesn't show hand 
*** SUMMARY ***
Total pot $2 | Rake $0 
Seat 1: BOAYARSKIY (small blind) collected ($2)
Seat 2: jaccall (big blind) folded before Flop
Seat 3: anatoliy976 folded before Flop (didn't bet)
Seat 4: ka100pka527 folded before Flop (didn't bet)
Seat 5: chaps1988 folded before Flop (didn't bet)
Seat 6: nobu-azabu folded before Flop (didn't bet)
Seat 7: matiko09 folded before Flop (didn't bet)
Seat 9: Yaaaazz (button) folded before Flop (didn't bet)





PokerStars Hand #150123655515:  Hold'em No Limit ($0.50/$1.00 USD) - 2016/03/10 12:05:15 CET [2016/03/10 6:05:15 ET]
Table 'Liriope II' 9-max Seat #1 is the button
Seat 1: BOAYARSKIY ($42.32 in chips) 
Seat 2: jaccall ($66.89 in chips) 
Seat 3: anatoliy976 ($49.38 in chips) 
Seat 4: ka100pka527 ($63.11 in chips) 
Seat 5: chaps1988 ($100 in chips) 
Seat 6: nobu-azabu ($129.11 in chips) 
Seat 7: matiko09 ($140.70 in chips) 
Seat 9: Yaaaazz ($100 in chips) 
jaccall: posts small blind $0.50
anatoliy976: posts big blind $1
*** HOLE CARDS ***
Dealt to matiko09 [Tc 9s]
ka100pka527: folds 
chaps1988: folds 
nobu-azabu: raises $1.50 to $2.50
matiko09: folds 
Yaaaazz: folds 
BOAYARSKIY: folds 
jaccall: raises $1.50 to $4
anatoliy976: folds 
nobu-azabu: calls $1.50
*** FLOP *** [2d 3s 5d]
jaccall: bets $3
nobu-azabu: calls $3
*** TURN *** [2d 3s 5d] [5c]
jaccall: checks 
nobu-azabu: checks 
*** RIVER *** [2d 3s 5d 5c] [6h]
jaccall: bets $4
nobu-azabu: calls $4
*** SHOW DOWN ***
jaccall: shows [Qc Qh] (two pair, Queens and Fives)
nobu-azabu: mucks hand 
jaccall collected $21.96 from pot
*** SUMMARY ***
Total pot $23 | Rake $1.04 
Board [2d 3s 5d 5c 6h]
Seat 1: BOAYARSKIY (button) folded before Flop (didn't bet)
Seat 2: jaccall (small blind) showed [Qc Qh] and won ($21.96) with two pair, Queens and Fives
Seat 3: anatoliy976 (big blind) folded before Flop
Seat 4: ka100pka527 folded before Flop (didn't bet)
Seat 5: chaps1988 folded before Flop (didn't bet)
Seat 6: nobu-azabu mucked [Ah Kc]
Seat 7: matiko09 folded before Flop (didn't bet)
Seat 9: Yaaaazz folded before Flop (didn't bet)





PokerStars Hand #150123689910:  Hold'em No Limit ($0.50/$1.00 USD) - 2016/03/10 12:06:29 CET [2016/03/10 6:06:29 ET]
Table 'Liriope II' 9-max Seat #2 is the button
Seat 1: BOAYARSKIY ($42.32 in chips) 
Seat 2: jaccall ($77.85 in chips) 
Seat 3: anatoliy976 ($48.38 in chips) 
Seat 4: ka100pka527 ($63.11 in chips) 
Seat 5: chaps1988 ($100 in chips) 
Seat 6: nobu-azabu ($118.11 in chips) 
Seat 7: matiko09 ($140.70 in chips) 
Seat 9: Yaaaazz ($100 in chips) 
anatoliy976: posts small blind $0.50
ka100pka527: posts big blind $1
*** HOLE CARDS ***
Dealt to matiko09 [Qs 5s]
chaps1988: folds 
nobu-azabu: folds 
matiko09: folds 
Yaaaazz: folds 
BOAYARSKIY: folds 
jaccall: calls $1
anatoliy976: raises $2 to $3
ka100pka527: folds 
jaccall: calls $2
*** FLOP *** [6c 4h Tc]
anatoliy976: checks 
jaccall: checks 
*** TURN *** [6c 4h Tc] [Kd]
anatoliy976: checks 
jaccall: bets $4
anatoliy976: folds 
Uncalled bet ($4) returned to jaccall
jaccall collected $6.68 from pot
jaccall: doesn't show hand 
*** SUMMARY ***
Total pot $7 | Rake $0.32 
Board [6c 4h Tc Kd]
Seat 1: BOAYARSKIY folded before Flop (didn't bet)
Seat 2: jaccall (button) collected ($6.68)
Seat 3: anatoliy976 (small blind) folded on the Turn
Seat 4: ka100pka527 (big blind) folded before Flop
Seat 5: chaps1988 folded before Flop (didn't bet)
Seat 6: nobu-azabu folded before Flop (didn't bet)
Seat 7: matiko09 folded before Flop (didn't bet)
Seat 9: Yaaaazz folded before Flop (didn't bet)





PokerStars Hand #150123724373:  Hold'em No Limit ($0.50/$1.00 USD) - 2016/03/10 12:07:43 CET [2016/03/10 6:07:43 ET]
Table 'Liriope II' 9-max Seat #3 is the button
Seat 1: BOAYARSKIY ($42.32 in chips) 
Seat 2: jaccall ($81.53 in chips) 
Seat 3: anatoliy976 ($45.38 in chips) 
Seat 4: ka100pka527 ($62.11 in chips) 
Seat 5: chaps1988 ($100 in chips) 
Seat 6: nobu-azabu ($118.11 in chips) 
Seat 7: matiko09 ($140.70 in chips) 
Seat 9: Yaaaazz ($100 in chips) 
ka100pka527: posts small blind $0.50
chaps1988: posts big blind $1
*** HOLE CARDS ***
Dealt to matiko09 [Jh Jd]
nobu-azabu: folds 
matiko09: raises $2 to $3
Yaaaazz: folds 
BOAYARSKIY: folds 
jaccall: calls $3
anatoliy976: folds 
ka100pka527: folds 
chaps1988: folds 
*** FLOP *** [7h Js Tc]
matiko09: checks 
jaccall: bets $3
matiko09: calls $3
*** TURN *** [7h Js Tc] [Ad]
matiko09: checks 
jaccall: checks 
*** RIVER *** [7h Js Tc Ad] [3h]
matiko09: checks 
jaccall: checks 
*** SHOW DOWN ***
matiko09: shows [Jh Jd] (three of a kind, Jacks)
jaccall: mucks hand 
matiko09 collected $12.89 from pot
*** SUMMARY ***
Total pot $13.50 | Rake $0.61 
Board [7h Js Tc Ad 3h]
Seat 1: BOAYARSKIY folded before Flop (didn't bet)
Seat 2: jaccall mucked [6c Ac]
Seat 3: anatoliy976 (button) folded before Flop (didn't bet)
Seat 4: ka100pka527 (small blind) folded before Flop
Seat 5: chaps1988 (big blind) folded before Flop
Seat 6: nobu-azabu folded before Flop (didn't bet)
Seat 7: matiko09 showed [Jh Jd] and won ($12.89) with three of a kind, Jacks
Seat 9: Yaaaazz folded before Flop (didn't bet)





PokerStars Hand #150123746829:  Hold'em No Limit ($0.50/$1.00 USD) - 2016/03/10 12:08:32 CET [2016/03/10 6:08:32 ET]
Table 'Akiyama II' 9-max Seat #5 is the button
Seat 1: vano7777 ($83.39 in chips) 
Seat 2: AlKatrone ($103 in chips) 
Seat 3: cdv1984 ($101.50 in chips) 
Seat 5: corsair888 ($100 in chips) 
Seat 7: REX0970 ($99 in chips) 
Seat 9: matiko09 ($100 in chips) 
REX0970: posts small blind $0.50
matiko09: posts big blind $1
*** HOLE CARDS ***
Dealt to matiko09 [2h Ac]
vano7777: folds 
vano7777 leaves the table
AlKatrone: folds 
cdv1984: folds 
corsair888: raises $1 to $2
REX0970: raises $1 to $3
matiko09: folds 
corsair888: calls $1
*** FLOP *** [3s Ks 6c]
REX0970: checks 
corsair888: checks 
*** TURN *** [3s Ks 6c] [3c]
REX0970: checks 
corsair888: checks 
*** RIVER *** [3s Ks 6c 3c] [6h]
REX0970: bets $1.50
corsair888: folds 
Uncalled bet ($1.50) returned to REX0970
REX0970 collected $6.68 from pot
REX0970: doesn't show hand 
*** SUMMARY ***
Total pot $7 | Rake $0.32 
Board [3s Ks 6c 3c 6h]
Seat 1: vano7777 folded before Flop (didn't bet)
Seat 2: AlKatrone folded before Flop (didn't bet)
Seat 3: cdv1984 folded before Flop (didn't bet)
Seat 5: corsair888 (button) folded on the River
Seat 7: REX0970 (small blind) collected ($6.68)
Seat 9: matiko09 (big blind) folded before Flop





PokerStars Hand #150123761552:  Hold'em No Limit ($0.50/$1.00 USD) - 2016/03/10 12:09:04 CET [2016/03/10 6:09:04 ET]
Table 'Liriope II' 9-max Seat #4 is the button
Seat 1: BOAYARSKIY ($42.32 in chips) 
Seat 2: jaccall ($75.53 in chips) 
Seat 3: anatoliy976 ($45.38 in chips) 
Seat 4: ka100pka527 ($61.61 in chips) 
Seat 5: chaps1988 ($100 in chips) 
Seat 6: nobu-azabu ($118.11 in chips) 
Seat 7: matiko09 ($147.59 in chips) 
Seat 9: Yaaaazz ($100 in chips) 
chaps1988: posts small blind $0.50
nobu-azabu: posts big blind $1
*** HOLE CARDS ***
Dealt to matiko09 [Tc 2c]
matiko09: folds 
Yaaaazz: folds 
BOAYARSKIY: folds 
jaccall: calls $1
anatoliy976: folds 
ka100pka527: folds 
chaps1988: calls $0.50
nobu-azabu: checks 
*** FLOP *** [Ac 6h 7s]
chaps1988: checks 
nobu-azabu: checks 
jaccall: checks 
*** TURN *** [Ac 6h 7s] [6s]
chaps1988: checks 
nobu-azabu: bets $2
jaccall: calls $2
chaps1988: folds 
*** RIVER *** [Ac 6h 7s 6s] [8h]
nobu-azabu: checks 
jaccall: checks 
*** SHOW DOWN ***
nobu-azabu: shows [3c 6d] (three of a kind, Sixes)
jaccall: mucks hand 
nobu-azabu collected $6.68 from pot
*** SUMMARY ***
Total pot $7 | Rake $0.32 
Board [Ac 6h 7s 6s 8h]
Seat 1: BOAYARSKIY folded before Flop (didn't bet)
Seat 2: jaccall mucked [9s 8s]
Seat 3: anatoliy976 folded before Flop (didn't bet)
Seat 4: ka100pka527 (button) folded before Flop (didn't bet)
Seat 5: chaps1988 (small blind) folded on the Turn
Seat 6: nobu-azabu (big blind) showed [3c 6d] and won ($6.68) with three of a kind, Sixes
Seat 7: matiko09 folded before Flop (didn't bet)
Seat 9: Yaaaazz folded before Flop (didn't bet)





PokerStars Hand #150123779458:  Hold'em No Limit ($0.50/$1.00 USD) - 2016/03/10 12:09:43 CET [2016/03/10 6:09:43 ET]
Table 'Akiyama II' 9-max Seat #7 is the button
Seat 2: AlKatrone ($103 in chips) 
Seat 3: cdv1984 ($101.50 in chips) 
Seat 5: corsair888 ($100 in chips) 
Seat 7: REX0970 ($102.68 in chips) 
Seat 9: matiko09 ($100 in chips) 
matiko09: posts small blind $0.50
AlKatrone: posts big blind $1
Sweden_Pound: sits out 
*** HOLE CARDS ***
Dealt to matiko09 [Qd Jc]
tipner joins the table at seat #1 
cdv1984: folds 
corsair888: folds 
REX0970: folds 
matiko09: raises $1.50 to $2.50
AlKatrone: folds 
Uncalled bet ($1.50) returned to matiko09
matiko09 collected $2 from pot
matiko09: doesn't show hand 
*** SUMMARY ***
Total pot $2 | Rake $0 
Seat 2: AlKatrone (big blind) folded before Flop
Seat 3: cdv1984 folded before Flop (didn't bet)
Seat 5: corsair888 folded before Flop (didn't bet)
Seat 7: REX0970 (button) folded before Flop (didn't bet)
Seat 9: matiko09 (small blind) collected ($2)





PokerStars Hand #150123787024:  Hold'em No Limit ($0.50/$1.00 USD) - 2016/03/10 12:10:00 CET [2016/03/10 6:10:00 ET]
Table 'Akiyama II' 9-max Seat #9 is the button
Seat 2: AlKatrone ($102 in chips) 
Seat 3: cdv1984 ($101.50 in chips) 
Seat 5: corsair888 ($100 in chips) 
Seat 7: REX0970 ($102.68 in chips) 
Seat 9: matiko09 ($101 in chips) 
tipner will be allowed to play after the button
AlKatrone: posts small blind $0.50
cdv1984: posts big blind $1
Sweden_Pound: sits out 
*** HOLE CARDS ***
Dealt to matiko09 [Jh 3s]
corsair888: raises $1.50 to $2.50
REX0970: folds 
matiko09: folds 
AlKatrone: folds 
cdv1984: folds 
Uncalled bet ($1.50) returned to corsair888
corsair888 collected $2.50 from pot
corsair888: doesn't show hand 
*** SUMMARY ***
Total pot $2.50 | Rake $0 
Seat 2: AlKatrone (small blind) folded before Flop
Seat 3: cdv1984 (big blind) folded before Flop
Seat 5: corsair888 collected ($2.50)
Seat 7: REX0970 folded before Flop (didn't bet)
Seat 9: matiko09 (button) folded before Flop (didn't bet)





PokerStars Hand #150123792286:  Hold'em No Limit ($0.50/$1.00 USD) - 2016/03/10 12:10:11 CET [2016/03/10 6:10:11 ET]
Table 'Liriope II' 9-max Seat #5 is the button
Seat 1: BOAYARSKIY ($42.32 in chips) 
Seat 2: jaccall ($72.53 in chips) 
Seat 3: anatoliy976 ($45.38 in chips) 
Seat 4: ka100pka527 ($61.61 in chips) 
Seat 5: chaps1988 ($100 in chips) 
Seat 6: nobu-azabu ($121.79 in chips) 
Seat 7: matiko09 ($147.59 in chips) 
Seat 9: Yaaaazz ($100 in chips) 
nobu-azabu: posts small blind $0.50
matiko09: posts big blind $1
*** HOLE CARDS ***
Dealt to matiko09 [2s 2c]
Yaaaazz: folds 
BOAYARSKIY: folds 
jaccall: folds 
anatoliy976: folds 
ka100pka527: folds 
chaps1988: raises $1 to $2
nobu-azabu: folds 
matiko09: calls $1
*** FLOP *** [8c Qh 3s]
matiko09: checks 
chaps1988: checks 
*** TURN *** [8c Qh 3s] [5d]
matiko09: checks 
chaps1988: bets $3
matiko09: folds 
Uncalled bet ($3) returned to chaps1988
chaps1988 collected $4.30 from pot
chaps1988: doesn't show hand 
*** SUMMARY ***
Total pot $4.50 | Rake $0.20 
Board [8c Qh 3s 5d]
Seat 1: BOAYARSKIY folded before Flop (didn't bet)
Seat 2: jaccall folded before Flop (didn't bet)
Seat 3: anatoliy976 folded before Flop (didn't bet)
Seat 4: ka100pka527 folded before Flop (didn't bet)
Seat 5: chaps1988 (button) collected ($4.30)
Seat 6: nobu-azabu (small blind) folded before Flop
Seat 7: matiko09 (big blind) folded on the Turn
Seat 9: Yaaaazz folded before Flop (didn't bet)





PokerStars Hand #150124614951:  Hold'em No Limit ($1/$2 USD) - 2016/03/10 12:38:42 CET [2016/03/10 6:38:42 ET]
Table 'Rimito II' 9-max Seat #5 is the button
Seat 5: rijger321 ($171.90 in chips) 
Seat 6: Fish4trips ($202.31 in chips) 
Seat 7: matiko09 ($200 in chips) 
Fish4trips: posts small blind $1
matiko09: posts big blind $2
tipner: sits out 
NeedBeat: sits out 
chaps1988: sits out 
Yaaaazz: sits out 
Zier89: sits out 
*** HOLE CARDS ***
Dealt to matiko09 [Ks Kh]
rijger321: folds 
Fish4trips: raises $3 to $5
matiko09: raises $12 to $17
Fish4trips: folds 
Uncalled bet ($12) returned to matiko09
matiko09 collected $10 from pot
matiko09: doesn't show hand 
*** SUMMARY ***
Total pot $10 | Rake $0 
Seat 5: rijger321 (button) folded before Flop (didn't bet)
Seat 6: Fish4trips (small blind) folded before Flop
Seat 7: matiko09 (big blind) collected ($10)





PokerStars Hand #150124626409:  Hold'em No Limit ($1/$2 USD) - 2016/03/10 12:39:05 CET [2016/03/10 6:39:05 ET]
Table 'Rimito II' 9-max Seat #6 is the button
Seat 5: rijger321 ($171.90 in chips) 
Seat 6: Fish4trips ($200 in chips) 
Seat 7: matiko09 ($205 in chips) 
Seat 9: tipner ($200 in chips) 
matiko09: posts small blind $1
tipner: posts big blind $2
NeedBeat: sits out 
chaps1988: sits out 
Yaaaazz: sits out 
Zier89: sits out 
*** HOLE CARDS ***
Dealt to matiko09 [7h 3c]
rijger321: raises $4 to $6
Fish4trips: folds 
matiko09: folds 
tipner: folds 
Uncalled bet ($4) returned to rijger321
rijger321 collected $5 from pot
rijger321: doesn't show hand 
*** SUMMARY ***
Total pot $5 | Rake $0 
Seat 5: rijger321 collected ($5)
Seat 6: Fish4trips (button) folded before Flop (didn't bet)
Seat 7: matiko09 (small blind) folded before Flop
Seat 9: tipner (big blind) folded before Flop





PokerStars Hand #150124640221:  Hold'em No Limit ($1/$2 USD) - 2016/03/10 12:39:32 CET [2016/03/10 6:39:32 ET]
Table 'Rimito II' 9-max Seat #7 is the button
Seat 1: NeedBeat ($200 in chips) 
Seat 5: rijger321 ($174.90 in chips) 
Seat 6: Fish4trips ($200 in chips) 
Seat 7: matiko09 ($204 in chips) 
Seat 9: tipner ($200 in chips) 
tipner: posts small blind $1
NeedBeat: posts big blind $2
chaps1988: sits out 
Yaaaazz: sits out 
Zier89: sits out 
*** HOLE CARDS ***
Dealt to matiko09 [Ad 4c]
rijger321: folds 
Fish4trips: folds 
matiko09: raises $2.54 to $4.54
tipner: folds 
NeedBeat: folds 
Uncalled bet ($2.54) returned to matiko09
matiko09 collected $5 from pot
matiko09: doesn't show hand 
*** SUMMARY ***
Total pot $5 | Rake $0 
Seat 1: NeedBeat (big blind) folded before Flop
Seat 5: rijger321 folded before Flop (didn't bet)
Seat 6: Fish4trips folded before Flop (didn't bet)
Seat 7: matiko09 (button) collected ($5)
Seat 9: tipner (small blind) folded before Flop





PokerStars Hand #150124650416:  Hold'em No Limit ($1/$2 USD) - 2016/03/10 12:39:53 CET [2016/03/10 6:39:53 ET]
Table 'Rimito II' 9-max Seat #9 is the button
Seat 1: NeedBeat ($200 in chips) 
Seat 2: chaps1988 ($200 in chips) 
Seat 5: rijger321 ($174.90 in chips) 
Seat 6: Fish4trips ($200 in chips) 
Seat 7: matiko09 ($207 in chips) 
Seat 9: tipner ($200 in chips) 
NeedBeat: posts small blind $1
chaps1988: posts big blind $2
Yaaaazz: sits out 
Zier89: sits out 
*** HOLE CARDS ***
Dealt to matiko09 [3h 8c]
rijger321: folds 
Fish4trips: folds 
matiko09: folds 
tipner: folds 
NeedBeat: raises $4 to $6
chaps1988: raises $12 to $18
NeedBeat: calls $12
*** FLOP *** [8h 9s 5c]
NeedBeat: checks 
Olddogtom888 joins the table at seat #8 
chaps1988: checks 
*** TURN *** [8h 9s 5c] [8d]
NeedBeat: bets $25.78
chaps1988: folds 
Uncalled bet ($25.78) returned to NeedBeat
NeedBeat collected $34.38 from pot
NeedBeat: doesn't show hand 
*** SUMMARY ***
Total pot $36 | Rake $1.62 
Board [8h 9s 5c 8d]
Seat 1: NeedBeat (small blind) collected ($34.38)
Seat 2: chaps1988 (big blind) folded on the Turn
Seat 5: rijger321 folded before Flop (didn't bet)
Seat 6: Fish4trips folded before Flop (didn't bet)
Seat 7: matiko09 folded before Flop (didn't bet)
Seat 9: tipner (button) folded before Flop (didn't bet)





PokerStars Hand #150124677872:  Hold'em No Limit ($0.25/$0.50 USD) - 2016/03/10 12:40:47 CET [2016/03/10 6:40:47 ET]
Table 'Aegina' 9-max Seat #4 is the button
Seat 1: BingoIng0 ($104.39 in chips) 
Seat 4: digimatical ($28.58 in chips) 
Seat 5: Ahangama ($50 in chips) 
Seat 6: matiko09 ($54.72 in chips) 
Seat 9: congcongnbnb ($139.21 in chips) 
Ahangama: posts small blind $0.25
matiko09: posts big blind $0.50
BingoIng0: posts the ante $0.10
digimatical: posts the ante $0.10
Ahangama: posts the ante $0.10
matiko09: posts the ante $0.10
congcongnbnb: posts the ante $0.10
*** HOLE CARDS ***
Dealt to matiko09 [4s 6s]
congcongnbnb: raises $1.50 to $2
BingoIng0: folds 
digimatical: folds 
Ahangama: folds 
matiko09: folds 
Uncalled bet ($1.50) returned to congcongnbnb
congcongnbnb collected $1.75 from pot
congcongnbnb: doesn't show hand 
*** SUMMARY ***
Total pot $1.75 | Rake $0 
Seat 1: BingoIng0 folded before Flop (didn't bet)
Seat 4: digimatical (button) folded before Flop (didn't bet)
Seat 5: Ahangama (small blind) folded before Flop
Seat 6: matiko09 (big blind) folded before Flop
Seat 9: congcongnbnb collected ($1.75)





PokerStars Hand #150124690584:  Hold'em No Limit ($0.25/$0.50 USD) - 2016/03/10 12:41:13 CET [2016/03/10 6:41:13 ET]
Table 'Aegina' 9-max Seat #5 is the button
Seat 1: BingoIng0 ($104.29 in chips) 
Seat 4: digimatical ($28.48 in chips) 
Seat 5: Ahangama ($50 in chips) 
Seat 6: matiko09 ($54.12 in chips) 
Seat 9: congcongnbnb ($140.36 in chips) 
matiko09: posts small blind $0.25
congcongnbnb: posts big blind $0.50
BingoIng0: posts the ante $0.10
digimatical: posts the ante $0.10
Ahangama: posts the ante $0.10
matiko09: posts the ante $0.10
congcongnbnb: posts the ante $0.10
*** HOLE CARDS ***
Dealt to matiko09 [Jh 7h]
BingoIng0: folds 
digimatical: folds 
Ahangama: folds 
matiko09: raises $1 to $1.50
congcongnbnb: calls $1
*** FLOP *** [9c 6d Kd]
matiko09: checks 
congcongnbnb: bets $2.22
matiko09: folds 
Uncalled bet ($2.22) returned to congcongnbnb
congcongnbnb collected $3.34 from pot
congcongnbnb: doesn't show hand 
*** SUMMARY ***
Total pot $3.50 | Rake $0.16 
Board [9c 6d Kd]
Seat 1: BingoIng0 folded before Flop (didn't bet)
Seat 4: digimatical folded before Flop (didn't bet)
Seat 5: Ahangama (button) folded before Flop (didn't bet)
Seat 6: matiko09 (small blind) folded on the Flop
Seat 9: congcongnbnb (big blind) collected ($3.34)





PokerStars Hand #150124696835:  Hold'em No Limit ($1/$2 USD) - 2016/03/10 12:41:25 CET [2016/03/10 6:41:25 ET]
Table 'Rimito II' 9-max Seat #1 is the button
Seat 1: NeedBeat ($216.38 in chips) 
Seat 2: chaps1988 ($200 in chips) 
Seat 3: Yaaaazz ($200 in chips) 
Seat 5: rijger321 ($174.90 in chips) 
Seat 6: Fish4trips ($200 in chips) 
Seat 7: matiko09 ($207 in chips) 
Seat 8: Olddogtom888 ($200 in chips) 
Seat 9: tipner ($200 in chips) 
chaps1988: posts small blind $1
Yaaaazz: posts big blind $2
Zier89: sits out 
Olddogtom888: posts big blind $2
*** HOLE CARDS ***
Dealt to matiko09 [Kc 2h]
rijger321: raises $4 to $6
Fish4trips: folds 
matiko09: folds 
Olddogtom888: calls $4
tipner: folds 
NeedBeat: folds 
chaps1988: folds 
Yaaaazz: folds 
*** FLOP *** [Qc 7s Qs]
rijger321: bets $6
Olddogtom888: folds 
Uncalled bet ($6) returned to rijger321
rijger321 collected $14.32 from pot
rijger321: doesn't show hand 
*** SUMMARY ***
Total pot $15 | Rake $0.68 
Board [Qc 7s Qs]
Seat 1: NeedBeat (button) folded before Flop (didn't bet)
Seat 2: chaps1988 (small blind) folded before Flop
Seat 3: Yaaaazz (big blind) folded before Flop
Seat 5: rijger321 collected ($14.32)
Seat 6: Fish4trips folded before Flop (didn't bet)
Seat 7: matiko09 folded before Flop (didn't bet)
Seat 8: Olddogtom888 folded on the Flop
Seat 9: tipner folded before Flop (didn't bet)





PokerStars Hand #150124709140:  Hold'em No Limit ($0.25/$0.50 USD) - 2016/03/10 12:41:49 CET [2016/03/10 6:41:49 ET]
Table 'Aegina' 9-max Seat #6 is the button
Seat 1: BingoIng0 ($104.19 in chips) 
Seat 4: digimatical ($28.38 in chips) 
Seat 5: Ahangama ($50 in chips) 
Seat 6: matiko09 ($52.52 in chips) 
Seat 9: congcongnbnb ($142.10 in chips) 
congcongnbnb: posts small blind $0.25
BingoIng0: posts big blind $0.50
BingoIng0: posts the ante $0.10
digimatical: posts the ante $0.10
Ahangama: posts the ante $0.10
matiko09: posts the ante $0.10
congcongnbnb: posts the ante $0.10
*** HOLE CARDS ***
Dealt to matiko09 [4h Jd]
digimatical: folds 
Ahangama: raises $0.75 to $1.25
matiko09: folds 
congcongnbnb: folds 
BingoIng0: folds 
Uncalled bet ($0.75) returned to Ahangama
Ahangama collected $1.75 from pot
Ahangama: doesn't show hand 
*** SUMMARY ***
Total pot $1.75 | Rake $0 
Seat 1: BingoIng0 (big blind) folded before Flop
Seat 4: digimatical folded before Flop (didn't bet)
Seat 5: Ahangama collected ($1.75)
Seat 6: matiko09 (button) folded before Flop (didn't bet)
Seat 9: congcongnbnb (small blind) folded before Flop





PokerStars Hand #150124722382:  Hold'em No Limit ($0.25/$0.50 USD) - 2016/03/10 12:42:16 CET [2016/03/10 6:42:16 ET]
Table 'Aegina' 9-max Seat #9 is the button
Seat 1: BingoIng0 ($103.59 in chips) 
Seat 4: digimatical ($28.28 in chips) 
Seat 5: Ahangama ($51.15 in chips) 
Seat 6: matiko09 ($52.42 in chips) 
Seat 9: congcongnbnb ($141.75 in chips) 
BingoIng0: posts small blind $0.25
digimatical: posts big blind $0.50
BingoIng0: posts the ante $0.10
digimatical: posts the ante $0.10
Ahangama: posts the ante $0.10
matiko09: posts the ante $0.10
congcongnbnb: posts the ante $0.10
*** HOLE CARDS ***
Dealt to matiko09 [4d 6d]
Ahangama: raises $0.75 to $1.25
matiko09: folds 
congcongnbnb: calls $1.25
BingoIng0: folds 
digimatical: calls $0.75
*** FLOP *** [7h 9h 2d]
digimatical: bets $4.30
Ahangama: folds 
congcongnbnb: folds 
Uncalled bet ($4.30) returned to digimatical
digimatical collected $4.30 from pot
*** SUMMARY ***
Total pot $4.50 | Rake $0.20 
Board [7h 9h 2d]
Seat 1: BingoIng0 (small blind) folded before Flop
Seat 4: digimatical (big blind) collected ($4.30)
Seat 5: Ahangama folded on the Flop
Seat 6: matiko09 folded before Flop (didn't bet)
Seat 9: congcongnbnb (button) folded on the Flop





PokerStars Hand #150124729057:  Hold'em No Limit ($1/$2 USD) - 2016/03/10 12:42:29 CET [2016/03/10 6:42:29 ET]
Table 'Rimito II' 9-max Seat #2 is the button
Seat 1: NeedBeat ($216.38 in chips) 
Seat 2: chaps1988 ($200 in chips) 
Seat 3: Yaaaazz ($200 in chips) 
Seat 4: Zier89 ($80 in chips) 
Seat 5: rijger321 ($183.22 in chips) 
Seat 6: Fish4trips ($200 in chips) 
Seat 7: matiko09 ($207 in chips) 
Seat 8: Olddogtom888 ($194 in chips) 
Seat 9: tipner ($200 in chips) 
Yaaaazz: posts small blind $1
Zier89: posts big blind $2
*** HOLE CARDS ***
Dealt to matiko09 [Kh 5d]
rijger321: folds 
Fish4trips: folds 
matiko09: folds 
Olddogtom888: folds 
tipner: raises $4 to $6
NeedBeat: folds 
chaps1988: folds 
Yaaaazz: folds 
Zier89: raises $4 to $10
tipner: calls $4
*** FLOP *** [Ah 3c 3d]
Zier89: bets $10
tipner: folds 
Uncalled bet ($10) returned to Zier89
Zier89 collected $20.06 from pot
Zier89: doesn't show hand 
*** SUMMARY ***
Total pot $21 | Rake $0.94 
Board [Ah 3c 3d]
Seat 1: NeedBeat folded before Flop (didn't bet)
Seat 2: chaps1988 (button) folded before Flop (didn't bet)
Seat 3: Yaaaazz (small blind) folded before Flop
Seat 4: Zier89 (big blind) collected ($20.06)
Seat 5: rijger321 folded before Flop (didn't bet)
Seat 6: Fish4trips folded before Flop (didn't bet)
Seat 7: matiko09 folded before Flop (didn't bet)
Seat 8: Olddogtom888 folded before Flop (didn't bet)
Seat 9: tipner folded on the Flop





PokerStars Hand #150124737516:  Hold'em No Limit ($0.25/$0.50 USD) - 2016/03/10 12:42:45 CET [2016/03/10 6:42:45 ET]
Table 'Aegina' 9-max Seat #1 is the button
Seat 1: BingoIng0 ($103.24 in chips) 
Seat 4: digimatical ($31.23 in chips) 
Seat 5: Ahangama ($50 in chips) 
Seat 6: matiko09 ($52.32 in chips) 
Seat 9: congcongnbnb ($140.40 in chips) 
digimatical: posts small blind $0.25
Ahangama: posts big blind $0.50
BingoIng0: posts the ante $0.10
digimatical: posts the ante $0.10
Ahangama: posts the ante $0.10
matiko09: posts the ante $0.10
congcongnbnb: posts the ante $0.10
*** HOLE CARDS ***
Dealt to matiko09 [8h 8c]
matiko09: raises $1 to $1.50
congcongnbnb: folds 
BingoIng0: folds 
digimatical: calls $1.25
Ahangama: folds 
*** FLOP *** [Kc 8s Jd]
digimatical: checks 
matiko09: bets $2.48
digimatical: folds 
Uncalled bet ($2.48) returned to matiko09
matiko09 collected $3.82 from pot
matiko09: doesn't show hand 
*** SUMMARY ***
Total pot $4 | Rake $0.18 
Board [Kc 8s Jd]
Seat 1: BingoIng0 (button) folded before Flop (didn't bet)
Seat 4: digimatical (small blind) folded on the Flop
Seat 5: Ahangama (big blind) folded before Flop
Seat 6: matiko09 collected ($3.82)
Seat 9: congcongnbnb folded before Flop (didn't bet)





PokerStars Hand #150124751630:  Hold'em No Limit ($1/$2 USD) - 2016/03/10 12:43:13 CET [2016/03/10 6:43:13 ET]
Table 'Rimito II' 9-max Seat #3 is the button
Seat 1: NeedBeat ($216.38 in chips) 
Seat 2: chaps1988 ($200 in chips) 
Seat 3: Yaaaazz ($200 in chips) 
Seat 4: Zier89 ($90.06 in chips) 
Seat 5: rijger321 ($183.22 in chips) 
Seat 6: Fish4trips ($200 in chips) 
Seat 7: matiko09 ($207 in chips) 
Seat 8: Olddogtom888 ($194 in chips) 
Seat 9: tipner ($200 in chips) 
Zier89: posts small blind $1
rijger321: posts big blind $2
*** HOLE CARDS ***
Dealt to matiko09 [8s 8d]
Fish4trips: folds 
matiko09: raises $3 to $5
Olddogtom888: folds 
tipner: folds 
NeedBeat: folds 
chaps1988: folds 
Yaaaazz: folds 
Zier89: folds 
rijger321: folds 
Uncalled bet ($3) returned to matiko09
matiko09 collected $5 from pot
matiko09: doesn't show hand 
*** SUMMARY ***
Total pot $5 | Rake $0 
Seat 1: NeedBeat folded before Flop (didn't bet)
Seat 2: chaps1988 folded before Flop (didn't bet)
Seat 3: Yaaaazz (button) folded before Flop (didn't bet)
Seat 4: Zier89 (small blind) folded before Flop
Seat 5: rijger321 (big blind) folded before Flop
Seat 6: Fish4trips folded before Flop (didn't bet)
Seat 7: matiko09 collected ($5)
Seat 8: Olddogtom888 folded before Flop (didn't bet)
Seat 9: tipner folded before Flop (didn't bet)





PokerStars Hand #150124757799:  Hold'em No Limit ($0.25/$0.50 USD) - 2016/03/10 12:43:26 CET [2016/03/10 6:43:26 ET]
Table 'Aegina' 9-max Seat #4 is the button
Seat 1: BingoIng0 ($103.14 in chips) 
Seat 4: digimatical ($29.63 in chips) 
Seat 5: Ahangama ($50 in chips) 
Seat 6: matiko09 ($54.54 in chips) 
Seat 9: congcongnbnb ($140.30 in chips) 
Ahangama: posts small blind $0.25
matiko09: posts big blind $0.50
BingoIng0: posts the ante $0.10
digimatical: posts the ante $0.10
Ahangama: posts the ante $0.10
matiko09: posts the ante $0.10
congcongnbnb: posts the ante $0.10
*** HOLE CARDS ***
Dealt to matiko09 [6s 9h]
congcongnbnb: raises $1.50 to $2
BingoIng0: folds 
digimatical: calls $2
Ahangama: raises $5 to $7
matiko09: folds 
congcongnbnb: folds 
digimatical: folds 
Uncalled bet ($5) returned to Ahangama
Ahangama collected $7 from pot
Ahangama: doesn't show hand 
*** SUMMARY ***
Total pot $7 | Rake $0 
Seat 1: BingoIng0 folded before Flop (didn't bet)
Seat 4: digimatical (button) folded before Flop
Seat 5: Ahangama (small blind) collected ($7)
Seat 6: matiko09 (big blind) folded before Flop
Seat 9: congcongnbnb folded before Flop





PokerStars Hand #150124776139:  Hold'em No Limit ($1/$2 USD) - 2016/03/10 12:44:03 CET [2016/03/10 6:44:03 ET]
Table 'Rimito II' 9-max Seat #4 is the button
Seat 1: NeedBeat ($216.38 in chips) 
Seat 2: chaps1988 ($200 in chips) 
Seat 3: Yaaaazz ($200 in chips) 
Seat 4: Zier89 ($89.06 in chips) 
Seat 5: rijger321 ($181.22 in chips) 
Seat 6: Fish4trips ($200 in chips) 
Seat 7: matiko09 ($210 in chips) 
Seat 8: Olddogtom888 ($194 in chips) 
Seat 9: tipner ($200 in chips) 
rijger321: posts small blind $1
Fish4trips: posts big blind $2
*** HOLE CARDS ***
Dealt to matiko09 [9s Ad]
matiko09: folds 
Olddogtom888: calls $2
tipner: folds 
NeedBeat: folds 
chaps1988: raises $5 to $7
Yaaaazz: folds 
Zier89: folds 
rijger321: folds 
Fish4trips: calls $5
Olddogtom888: raises $17 to $24
chaps1988: folds 
Fish4trips: folds 
Uncalled bet ($17) returned to Olddogtom888
Olddogtom888 collected $22 from pot
Olddogtom888: doesn't show hand 
*** SUMMARY ***
Total pot $22 | Rake $0 
Seat 1: NeedBeat folded before Flop (didn't bet)
Seat 2: chaps1988 folded before Flop
Seat 3: Yaaaazz folded before Flop (didn't bet)
Seat 4: Zier89 (button) folded before Flop (didn't bet)
Seat 5: rijger321 (small blind) folded before Flop
Seat 6: Fish4trips (big blind) folded before Flop
Seat 7: matiko09 folded before Flop (didn't bet)
Seat 8: Olddogtom888 collected ($22)
Seat 9: tipner folded before Flop (didn't bet)





PokerStars Hand #150124781040:  Hold'em No Limit ($0.25/$0.50 USD) - 2016/03/10 12:44:12 CET [2016/03/10 6:44:12 ET]
Table 'Aegina' 9-max Seat #5 is the button
Seat 1: BingoIng0 ($103.04 in chips) 
Seat 4: digimatical ($27.53 in chips) 
Seat 5: Ahangama ($54.90 in chips) 
Seat 6: matiko09 ($53.94 in chips) 
Seat 9: congcongnbnb ($138.20 in chips) 
matiko09: posts small blind $0.25
congcongnbnb: posts big blind $0.50
BingoIng0: posts the ante $0.10
digimatical: posts the ante $0.10
Ahangama: posts the ante $0.10
matiko09: posts the ante $0.10
congcongnbnb: posts the ante $0.10
*** HOLE CARDS ***
Dealt to matiko09 [Ks 3s]
BingoIng0: folds 
digimatical: calls $0.50
Ahangama: calls $0.50
matiko09: calls $0.25
congcongnbnb: checks 
*** FLOP *** [2d 7d 2c]
matiko09: checks 
congcongnbnb: checks 
digimatical: checks 
Ahangama: checks 
*** TURN *** [2d 7d 2c] [Kh]
matiko09: checks 
congcongnbnb: checks 
digimatical: checks 
Ahangama: checks 
*** RIVER *** [2d 7d 2c Kh] [7c]
matiko09: bets $0.50
congcongnbnb: folds 
digimatical: folds 
Ahangama: folds 
Uncalled bet ($0.50) returned to matiko09
matiko09 collected $2.39 from pot
matiko09: doesn't show hand 
*** SUMMARY ***
Total pot $2.50 | Rake $0.11 
Board [2d 7d 2c Kh 7c]
Seat 1: BingoIng0 folded before Flop (didn't bet)
Seat 4: digimatical folded on the River
Seat 5: Ahangama (button) folded on the River
Seat 6: matiko09 (small blind) collected ($2.39)
Seat 9: congcongnbnb (big blind) folded on the River





PokerStars Hand #150124782933:  Hold'em No Limit ($0.50/$1.00 USD) - 2016/03/10 12:44:16 CET [2016/03/10 6:44:16 ET]
Table 'Philoctetes II' 9-max Seat #7 is the button
Seat 1: chaps1988 ($171.73 in chips) 
Seat 2: Plz3betMe ($40 in chips) 
Seat 3: stds st ($27.33 in chips) 
Seat 4: di0d80 ($100 in chips) 
Seat 5: RMilPoker ($107.50 in chips) 
Seat 7: Dachish ($77.50 in chips) 
Seat 8: Sweden_Pound ($168.51 in chips) 
Seat 9: matiko09 ($100 in chips) 
Sweden_Pound: posts small blind $0.50
matiko09: posts big blind $1
*** HOLE CARDS ***
Dealt to matiko09 [2c Qc]
chaps1988: folds 
Plz3betMe: folds 
stds st: folds 
di0d80: folds 
RMilPoker: folds 
Dachish: folds 
Sweden_Pound: folds 
Uncalled bet ($0.50) returned to matiko09
matiko09 collected $1 from pot
matiko09: doesn't show hand 
*** SUMMARY ***
Total pot $1 | Rake $0 
Seat 1: chaps1988 folded before Flop (didn't bet)
Seat 2: Plz3betMe folded before Flop (didn't bet)
Seat 3: stds st folded before Flop (didn't bet)
Seat 4: di0d80 folded before Flop (didn't bet)
Seat 5: RMilPoker folded before Flop (didn't bet)
Seat 7: Dachish (button) folded before Flop (didn't bet)
Seat 8: Sweden_Pound (small blind) folded before Flop
Seat 9: matiko09 (big blind) collected ($1)





PokerStars Hand #150124790930:  Hold'em No Limit ($0.50/$1.00 USD) - 2016/03/10 12:44:32 CET [2016/03/10 6:44:32 ET]
Table 'Philoctetes II' 9-max Seat #8 is the button
Seat 1: chaps1988 ($171.73 in chips) 
Seat 2: Plz3betMe ($40 in chips) 
Seat 3: stds st ($27.33 in chips) 
Seat 4: di0d80 ($100 in chips) 
Seat 5: RMilPoker ($107.50 in chips) 
Seat 7: Dachish ($77.50 in chips) 
Seat 8: Sweden_Pound ($168.01 in chips) 
Seat 9: matiko09 ($100.50 in chips) 
matiko09: posts small blind $0.50
chaps1988: posts big blind $1
*** HOLE CARDS ***
Dealt to matiko09 [3c 8s]
Plz3betMe: folds 
stds st: folds 
di0d80: folds 
RMilPoker: folds 
Dachish: raises $1 to $2
Sweden_Pound: folds 
matiko09: folds 
chaps1988: calls $1
*** FLOP *** [9c Jh 4c]
chaps1988: checks 
Dachish: bets $2
chaps1988: calls $2
*** TURN *** [9c Jh 4c] [4h]
chaps1988: checks 
Dachish: checks 
*** RIVER *** [9c Jh 4c 4h] [7s]
chaps1988: bets $6
Dachish: folds 
Uncalled bet ($6) returned to chaps1988
chaps1988 collected $8.12 from pot
chaps1988: doesn't show hand 
*** SUMMARY ***
Total pot $8.50 | Rake $0.38 
Board [9c Jh 4c 4h 7s]
Seat 1: chaps1988 (big blind) collected ($8.12)
Seat 2: Plz3betMe folded before Flop (didn't bet)
Seat 3: stds st folded before Flop (didn't bet)
Seat 4: di0d80 folded before Flop (didn't bet)
Seat 5: RMilPoker folded before Flop (didn't bet)
Seat 7: Dachish folded on the River
Seat 8: Sweden_Pound (button) folded before Flop (didn't bet)
Seat 9: matiko09 (small blind) folded before Flop





PokerStars Hand #150124809831:  Hold'em No Limit ($1/$2 USD) - 2016/03/10 12:45:10 CET [2016/03/10 6:45:10 ET]
Table 'Rimito II' 9-max Seat #5 is the button
Seat 1: NeedBeat ($216.38 in chips) 
Seat 2: chaps1988 ($200 in chips) 
Seat 3: Yaaaazz ($200 in chips) 
Seat 4: Zier89 ($89.06 in chips) 
Seat 5: rijger321 ($180.22 in chips) 
Seat 6: Fish4trips ($200 in chips) 
Seat 7: matiko09 ($210 in chips) 
Seat 8: Olddogtom888 ($209 in chips) 
Seat 9: tipner ($200 in chips) 
Fish4trips: posts small blind $1
matiko09: posts big blind $2
*** HOLE CARDS ***
Dealt to matiko09 [2d Js]
Olddogtom888: calls $2
tipner: folds 
NeedBeat: folds 
chaps1988: calls $2
Yaaaazz: raises $6 to $8
Zier89: folds 
rijger321: folds 
Fish4trips: folds 
matiko09: folds 
Olddogtom888: folds 
chaps1988: folds 
Uncalled bet ($6) returned to Yaaaazz
Yaaaazz collected $9 from pot
*** SUMMARY ***
Total pot $9 | Rake $0 
Seat 1: NeedBeat folded before Flop (didn't bet)
Seat 2: chaps1988 folded before Flop
Seat 3: Yaaaazz collected ($9)
Seat 4: Zier89 folded before Flop (didn't bet)
Seat 5: rijger321 (button) folded before Flop (didn't bet)
Seat 6: Fish4trips (small blind) folded before Flop
Seat 7: matiko09 (big blind) folded before Flop
Seat 8: Olddogtom888 folded before Flop
Seat 9: tipner folded before Flop (didn't bet)





PokerStars Hand #150124814766:  Hold'em No Limit ($0.25/$0.50 USD) - 2016/03/10 12:45:20 CET [2016/03/10 6:45:20 ET]
Table 'Aegina' 9-max Seat #6 is the button
Seat 1: BingoIng0 ($102.94 in chips) 
Seat 4: digimatical ($26.93 in chips) 
Seat 5: Ahangama ($54.30 in chips) 
Seat 6: matiko09 ($55.73 in chips) 
Seat 9: congcongnbnb ($137.60 in chips) 
congcongnbnb: posts small blind $0.25
BingoIng0: posts big blind $0.50
BingoIng0: posts the ante $0.10
digimatical: posts the ante $0.10
Ahangama: posts the ante $0.10
matiko09: posts the ante $0.10
congcongnbnb: posts the ante $0.10
*** HOLE CARDS ***
Dealt to matiko09 [9h 5h]
digimatical: folds 
Ahangama: raises $0.75 to $1.25
matiko09: folds 
congcongnbnb: folds 
BingoIng0: folds 
Uncalled bet ($0.75) returned to Ahangama
Ahangama collected $1.75 from pot
Ahangama: doesn't show hand 
*** SUMMARY ***
Total pot $1.75 | Rake $0 
Seat 1: BingoIng0 (big blind) folded before Flop
Seat 4: digimatical folded before Flop (didn't bet)
Seat 5: Ahangama collected ($1.75)
Seat 6: matiko09 (button) folded before Flop (didn't bet)
Seat 9: congcongnbnb (small blind) folded before Flop





PokerStars Hand #150124821776:  Hold'em No Limit ($0.50/$1.00 USD) - 2016/03/10 12:45:33 CET [2016/03/10 6:45:33 ET]
Table 'Philoctetes II' 9-max Seat #9 is the button
Seat 1: chaps1988 ($175.85 in chips) 
Seat 2: Plz3betMe ($40 in chips) 
Seat 3: stds st ($27.33 in chips) 
Seat 4: di0d80 ($100 in chips) 
Seat 5: RMilPoker ($107.50 in chips) 
Seat 7: Dachish ($73.50 in chips) 
Seat 8: Sweden_Pound ($168.01 in chips) 
Seat 9: matiko09 ($100 in chips) 
chaps1988: posts small blind $0.50
Plz3betMe: posts big blind $1
*** HOLE CARDS ***
Dealt to matiko09 [Jd 2s]
stds st: folds 
di0d80: folds 
RMilPoker: folds 
Dachish: raises $2 to $3
Sweden_Pound: folds 
matiko09: folds 
chaps1988: folds 
Plz3betMe: folds 
Uncalled bet ($2) returned to Dachish
Dachish collected $2.50 from pot
Dachish: doesn't show hand 
*** SUMMARY ***
Total pot $2.50 | Rake $0 
Seat 1: chaps1988 (small blind) folded before Flop
Seat 2: Plz3betMe (big blind) folded before Flop
Seat 3: stds st folded before Flop (didn't bet)
Seat 4: di0d80 folded before Flop (didn't bet)
Seat 5: RMilPoker folded before Flop (didn't bet)
Seat 7: Dachish collected ($2.50)
Seat 8: Sweden_Pound folded before Flop (didn't bet)
Seat 9: matiko09 (button) folded before Flop (didn't bet)





PokerStars Hand #150124830329:  Hold'em No Limit ($0.25/$0.50 USD) - 2016/03/10 12:45:50 CET [2016/03/10 6:45:50 ET]
Table 'Aegina' 9-max Seat #9 is the button
Seat 1: BingoIng0 ($102.34 in chips) 
Seat 4: digimatical ($26.83 in chips) 
Seat 5: Ahangama ($55.45 in chips) 
Seat 6: matiko09 ($55.63 in chips) 
Seat 9: congcongnbnb ($137.25 in chips) 
BingoIng0: posts small blind $0.25
digimatical: posts big blind $0.50
BingoIng0: posts the ante $0.10
digimatical: posts the ante $0.10
Ahangama: posts the ante $0.10
matiko09: posts the ante $0.10
congcongnbnb: posts the ante $0.10
*** HOLE CARDS ***
Dealt to matiko09 [2d Jh]
Ahangama: folds 
matiko09: folds 
congcongnbnb: folds 
BingoIng0: folds 
Uncalled bet ($0.25) returned to digimatical
digimatical collected $1 from pot
*** SUMMARY ***
Total pot $1 | Rake $0 
Seat 1: BingoIng0 (small blind) folded before Flop
Seat 4: digimatical (big blind) collected ($1)
Seat 5: Ahangama folded before Flop (didn't bet)
Seat 6: matiko09 folded before Flop (didn't bet)
Seat 9: congcongnbnb (button) folded before Flop (didn't bet)





PokerStars Hand #150124837061:  Hold'em No Limit ($0.25/$0.50 USD) - 2016/03/10 12:46:03 CET [2016/03/10 6:46:03 ET]
Table 'Aegina' 9-max Seat #1 is the button
Seat 1: BingoIng0 ($101.99 in chips) 
Seat 4: digimatical ($27.48 in chips) 
Seat 5: Ahangama ($55.35 in chips) 
Seat 6: matiko09 ($55.53 in chips) 
Seat 9: congcongnbnb ($137.15 in chips) 
digimatical: posts small blind $0.25
Ahangama: posts big blind $0.50
BingoIng0: posts the ante $0.10
digimatical: posts the ante $0.10
Ahangama: posts the ante $0.10
matiko09: posts the ante $0.10
congcongnbnb: posts the ante $0.10
*** HOLE CARDS ***
Dealt to matiko09 [2h 8d]
matiko09: folds 
congcongnbnb: raises $1 to $1.50
BingoIng0: folds 
digimatical: calls $1.25
Ahangama: folds 
*** FLOP *** [4d 9c Ts]
digimatical: checks 
congcongnbnb: checks 
*** TURN *** [4d 9c Ts] [5h]
digimatical: checks 
congcongnbnb: bets $2
digimatical: calls $2
*** RIVER *** [4d 9c Ts 5h] [9d]
digimatical: checks 
congcongnbnb: bets $4.50
digimatical: folds 
Uncalled bet ($4.50) returned to congcongnbnb
congcongnbnb collected $7.64 from pot
congcongnbnb: doesn't show hand 
*** SUMMARY ***
Total pot $8 | Rake $0.36 
Board [4d 9c Ts 5h 9d]
Seat 1: BingoIng0 (button) folded before Flop (didn't bet)
Seat 4: digimatical (small blind) folded on the River
Seat 5: Ahangama (big blind) folded before Flop
Seat 6: matiko09 folded before Flop (didn't bet)
Seat 9: congcongnbnb collected ($7.64)





PokerStars Hand #150124841537:  Hold'em No Limit ($1/$2 USD) - 2016/03/10 12:46:12 CET [2016/03/10 6:46:12 ET]
Table 'Rimito II' 9-max Seat #6 is the button
Seat 1: NeedBeat ($216.38 in chips) 
Seat 2: chaps1988 ($200 in chips) 
Seat 3: Yaaaazz ($207 in chips) 
Seat 4: Zier89 ($89.06 in chips) 
Seat 5: rijger321 ($180.22 in chips) 
Seat 6: Fish4trips ($200 in chips) 
Seat 7: matiko09 ($208 in chips) 
Seat 8: Olddogtom888 ($207 in chips) 
Seat 9: tipner ($200 in chips) 
matiko09: posts small blind $1
Olddogtom888: posts big blind $2
*** HOLE CARDS ***
Dealt to matiko09 [2d 4h]
tipner: folds 
NeedBeat: folds 
chaps1988: folds 
Yaaaazz: folds 
Zier89: folds 
rijger321: folds 
Fish4trips: folds 
matiko09: folds 
Uncalled bet ($1) returned to Olddogtom888
Olddogtom888 collected $2 from pot
Olddogtom888: doesn't show hand 
*** SUMMARY ***
Total pot $2 | Rake $0 
Seat 1: NeedBeat folded before Flop (didn't bet)
Seat 2: chaps1988 folded before Flop (didn't bet)
Seat 3: Yaaaazz folded before Flop (didn't bet)
Seat 4: Zier89 folded before Flop (didn't bet)
Seat 5: rijger321 folded before Flop (didn't bet)
Seat 6: Fish4trips (button) folded before Flop (didn't bet)
Seat 7: matiko09 (small blind) folded before Flop
Seat 8: Olddogtom888 (big blind) collected ($2)
Seat 9: tipner folded before Flop (didn't bet)





PokerStars Hand #150124843401:  Hold'em No Limit ($0.50/$1.00 USD) - 2016/03/10 12:46:16 CET [2016/03/10 6:46:16 ET]
Table 'Philoctetes II' 9-max Seat #1 is the button
Seat 1: chaps1988 ($175.35 in chips) 
Seat 2: Plz3betMe ($39 in chips) 
Seat 5: RMilPoker ($107.50 in chips) 
Seat 7: Dachish ($75 in chips) 
Seat 8: Sweden_Pound ($168.01 in chips) 
Seat 9: matiko09 ($100 in chips) 
Plz3betMe: posts small blind $0.50
stds st: is sitting out 
di0d80: is sitting out 
RMilPoker: posts big blind $1
*** HOLE CARDS ***
Dealt to matiko09 [8s Kc]
Dachish: folds 
Dachish leaves the table
Sweden_Pound: folds 
matiko09: folds 
chaps1988: folds 
Plz3betMe: folds 
Uncalled bet ($0.50) returned to RMilPoker
RMilPoker collected $1 from pot
RMilPoker: doesn't show hand 
*** SUMMARY ***
Total pot $1 | Rake $0 
Seat 1: chaps1988 (button) folded before Flop (didn't bet)
Seat 2: Plz3betMe (small blind) folded before Flop
Seat 5: RMilPoker (big blind) collected ($1)
Seat 7: Dachish folded before Flop (didn't bet)
Seat 8: Sweden_Pound folded before Flop (didn't bet)
Seat 9: matiko09 folded before Flop (didn't bet)





PokerStars Hand #150124850701:  Hold'em No Limit ($1/$2 USD) - 2016/03/10 12:46:30 CET [2016/03/10 6:46:30 ET]
Table 'Rimito II' 9-max Seat #7 is the button
Seat 1: NeedBeat ($216.38 in chips) 
Seat 2: chaps1988 ($200 in chips) 
Seat 3: Yaaaazz ($207 in chips) 
Seat 4: Zier89 ($89.06 in chips) 
Seat 5: rijger321 ($180.22 in chips) 
Seat 6: Fish4trips ($200 in chips) 
Seat 7: matiko09 ($207 in chips) 
Seat 8: Olddogtom888 ($208 in chips) 
Seat 9: tipner ($200 in chips) 
Olddogtom888: posts small blind $1
tipner: posts big blind $2
*** HOLE CARDS ***
Dealt to matiko09 [Js 9d]
NeedBeat: folds 
chaps1988: folds 
Yaaaazz has timed out
Yaaaazz: folds 
Zier89: raises $2 to $4
rijger321: folds 
Fish4trips: folds 
matiko09: folds 
Olddogtom888: folds 
tipner: calls $2
*** FLOP *** [Qs 9c Kc]
tipner: checks 
Zier89: checks 
*** TURN *** [Qs 9c Kc] [5d]
tipner: checks 
Zier89: bets $4
tipner: calls $4
*** RIVER *** [Qs 9c Kc 5d] [3d]
tipner: checks 
Zier89: bets $12
tipner: calls $12
*** SHOW DOWN ***
Zier89: shows [Kh Qh] (two pair, Kings and Queens)
tipner: mucks hand 
Zier89 collected $39.16 from pot
*** SUMMARY ***
Total pot $41 | Rake $1.84 
Board [Qs 9c Kc 5d 3d]
Seat 1: NeedBeat folded before Flop (didn't bet)
Seat 2: chaps1988 folded before Flop (didn't bet)
Seat 3: Yaaaazz folded before Flop (didn't bet)
Seat 4: Zier89 showed [Kh Qh] and won ($39.16) with two pair, Kings and Queens
Seat 5: rijger321 folded before Flop (didn't bet)
Seat 6: Fish4trips folded before Flop (didn't bet)
Seat 7: matiko09 (button) folded before Flop (didn't bet)
Seat 8: Olddogtom888 (small blind) folded before Flop
Seat 9: tipner (big blind) mucked [Th Ts]





PokerStars Hand #150124870915:  Hold'em No Limit ($0.25/$0.50 USD) - 2016/03/10 12:47:11 CET [2016/03/10 6:47:11 ET]
Table 'Aegina' 9-max Seat #4 is the button
Seat 1: BingoIng0 ($101.89 in chips) 
Seat 4: digimatical ($23.88 in chips) 
Seat 5: Ahangama ($54.75 in chips) 
Seat 6: matiko09 ($55.43 in chips) 
Seat 9: congcongnbnb ($141.19 in chips) 
Ahangama: posts small blind $0.25
matiko09: posts big blind $0.50
BingoIng0: posts the ante $0.10
digimatical: posts the ante $0.10
Ahangama: posts the ante $0.10
matiko09: posts the ante $0.10
congcongnbnb: posts the ante $0.10
*** HOLE CARDS ***
Dealt to matiko09 [Td 6c]
congcongnbnb: folds 
BingoIng0: folds 
digimatical: folds 
Ahangama: folds 
Uncalled bet ($0.25) returned to matiko09
matiko09 collected $1 from pot
matiko09: doesn't show hand 
*** SUMMARY ***
Total pot $1 | Rake $0 
Seat 1: BingoIng0 folded before Flop (didn't bet)
Seat 4: digimatical (button) folded before Flop (didn't bet)
Seat 5: Ahangama (small blind) folded before Flop
Seat 6: matiko09 (big blind) collected ($1)
Seat 9: congcongnbnb folded before Flop (didn't bet)





PokerStars Hand #150124879114:  Hold'em No Limit ($0.25/$0.50 USD) - 2016/03/10 12:47:27 CET [2016/03/10 6:47:27 ET]
Table 'Aegina' 9-max Seat #5 is the button
Seat 1: BingoIng0 ($101.79 in chips) 
Seat 4: digimatical ($23.78 in chips) 
Seat 5: Ahangama ($54.40 in chips) 
Seat 6: matiko09 ($56.08 in chips) 
Seat 9: congcongnbnb ($141.09 in chips) 
matiko09: posts small blind $0.25
congcongnbnb: posts big blind $0.50
BingoIng0: posts the ante $0.10
digimatical: posts the ante $0.10
Ahangama: posts the ante $0.10
matiko09: posts the ante $0.10
congcongnbnb: posts the ante $0.10
*** HOLE CARDS ***
Dealt to matiko09 [As Qd]
BingoIng0: folds 
digimatical: calls $0.50
Ahangama: raises $1.50 to $2
matiko09: calls $1.75
congcongnbnb: raises $4.50 to $6.50
digimatical: calls $6
Ahangama: calls $4.50
matiko09: calls $4.50
*** FLOP *** [Jh Js 2c]
matiko09: checks 
congcongnbnb: checks 
digimatical: checks 
Ahangama: checks 
*** TURN *** [Jh Js 2c] [6h]
matiko09: checks 
congcongnbnb: checks 
digimatical: bets $6
Ahangama: folds 
matiko09: folds 
congcongnbnb: folds 
Uncalled bet ($6) returned to digimatical
digimatical collected $25.31 from pot
*** SUMMARY ***
Total pot $26.50 | Rake $1.19 
Board [Jh Js 2c 6h]
Seat 1: BingoIng0 folded before Flop (didn't bet)
Seat 4: digimatical collected ($25.31)
Seat 5: Ahangama (button) folded on the Turn
Seat 6: matiko09 (small blind) folded on the Turn
Seat 9: congcongnbnb (big blind) folded on the Turn





PokerStars Hand #150124890756:  Hold'em No Limit ($1/$2 USD) - 2016/03/10 12:47:50 CET [2016/03/10 6:47:50 ET]
Table 'Rimito II' 9-max Seat #8 is the button
Seat 1: NeedBeat ($216.38 in chips) 
Seat 2: chaps1988 ($200 in chips) 
Seat 3: Yaaaazz ($207 in chips) 
Seat 4: Zier89 ($108.22 in chips) 
Seat 5: rijger321 ($180.22 in chips) 
Seat 6: Fish4trips ($200 in chips) 
Seat 7: matiko09 ($207 in chips) 
Seat 8: Olddogtom888 ($207 in chips) 
Seat 9: tipner ($200 in chips) 
tipner: posts small blind $1
NeedBeat: posts big blind $2
*** HOLE CARDS ***
Dealt to matiko09 [6s Js]
chaps1988: folds 
Yaaaazz: folds 
Zier89: folds 
rijger321: raises $4 to $6
Fish4trips: folds 
matiko09: folds 
Olddogtom888: folds 
tipner: folds 
NeedBeat: folds 
Uncalled bet ($4) returned to rijger321
rijger321 collected $5 from pot
rijger321: doesn't show hand 
*** SUMMARY ***
Total pot $5 | Rake $0 
Seat 1: NeedBeat (big blind) folded before Flop
Seat 2: chaps1988 folded before Flop (didn't bet)
Seat 3: Yaaaazz folded before Flop (didn't bet)
Seat 4: Zier89 folded before Flop (didn't bet)
Seat 5: rijger321 collected ($5)
Seat 6: Fish4trips folded before Flop (didn't bet)
Seat 7: matiko09 folded before Flop (didn't bet)
Seat 8: Olddogtom888 (button) folded before Flop (didn't bet)
Seat 9: tipner (small blind) folded before Flop





PokerStars Hand #150124893669:  Hold'em No Limit ($0.50/$1.00 USD) - 2016/03/10 12:47:56 CET [2016/03/10 6:47:56 ET]
Table 'Saskia' 9-max Seat #4 is the button
Seat 1: Sweden_Pound ($101.50 in chips) 
Seat 2: PacPacBum ($141.12 in chips) 
Seat 3: ccmaster001 ($61.60 in chips) 
Seat 4: Plz3betMe ($91.70 in chips) 
Seat 5: dreded11 ($80.30 in chips) 
Seat 6: matiko09 ($100 in chips) 
Seat 7: stds st ($32.62 in chips) 
Seat 8: chaps1988 ($172.10 in chips) 
dreded11: posts small blind $0.50
matiko09: posts big blind $1
tipner: sits out 
*** HOLE CARDS ***
Dealt to matiko09 [8c Th]
stds st: folds 
chaps1988: folds 
Sweden_Pound: raises $2 to $3
PacPacBum: folds 
ccmaster001: folds 
Plz3betMe: calls $3
dreded11: folds 
matiko09: folds 
*** FLOP *** [Ad 9c Td]
Sweden_Pound: checks 
Plz3betMe: checks 
*** TURN *** [Ad 9c Td] [Jc]
Sweden_Pound: checks 
Plz3betMe: checks 
*** RIVER *** [Ad 9c Td Jc] [8d]
Sweden_Pound: checks 
Plz3betMe: checks 
*** SHOW DOWN ***
Sweden_Pound: shows [7h 6h] (a straight, Seven to Jack)
Plz3betMe: mucks hand 
Sweden_Pound collected $7.16 from pot
*** SUMMARY ***
Total pot $7.50 | Rake $0.34 
Board [Ad 9c Td Jc 8d]
Seat 1: Sweden_Pound showed [7h 6h] and won ($7.16) with a straight, Seven to Jack
Seat 2: PacPacBum folded before Flop (didn't bet)
Seat 3: ccmaster001 folded before Flop (didn't bet)
Seat 4: Plz3betMe (button) mucked [5s 5d]
Seat 5: dreded11 (small blind) folded before Flop
Seat 6: matiko09 (big blind) folded before Flop
Seat 7: stds st folded before Flop (didn't bet)
Seat 8: chaps1988 folded before Flop (didn't bet)





PokerStars Hand #150124909035:  Hold'em No Limit ($1/$2 USD) - 2016/03/10 12:48:26 CET [2016/03/10 6:48:26 ET]
Table 'Rimito II' 9-max Seat #9 is the button
Seat 1: NeedBeat ($214.38 in chips) 
Seat 2: chaps1988 ($200 in chips) 
Seat 3: Yaaaazz ($207 in chips) 
Seat 4: Zier89 ($108.22 in chips) 
Seat 5: rijger321 ($183.22 in chips) 
Seat 6: Fish4trips ($200 in chips) 
Seat 7: matiko09 ($207 in chips) 
Seat 8: Olddogtom888 ($207 in chips) 
Seat 9: tipner ($200 in chips) 
NeedBeat: posts small blind $1
chaps1988: posts big blind $2
*** HOLE CARDS ***
Dealt to matiko09 [As 8s]
Yaaaazz: folds 
Zier89: raises $2 to $4
rijger321: folds 
Fish4trips: raises $9 to $13
matiko09: folds 
Olddogtom888: folds 
tipner: folds 
NeedBeat: folds 
chaps1988: folds 
Zier89: folds 
Uncalled bet ($9) returned to Fish4trips
Fish4trips collected $11 from pot
Fish4trips: doesn't show hand 
*** SUMMARY ***
Total pot $11 | Rake $0 
Seat 1: NeedBeat (small blind) folded before Flop
Seat 2: chaps1988 (big blind) folded before Flop
Seat 3: Yaaaazz folded before Flop (didn't bet)
Seat 4: Zier89 folded before Flop
Seat 5: rijger321 folded before Flop (didn't bet)
Seat 6: Fish4trips collected ($11)
Seat 7: matiko09 folded before Flop (didn't bet)
Seat 8: Olddogtom888 folded before Flop (didn't bet)
Seat 9: tipner (button) folded before Flop (didn't bet)





PokerStars Hand #150124930604:  Hold'em No Limit ($0.50/$1.00 USD) - 2016/03/10 12:49:08 CET [2016/03/10 6:49:08 ET]
Table 'Saskia' 9-max Seat #5 is the button
Seat 1: Sweden_Pound ($105.66 in chips) 
Seat 2: PacPacBum ($141.12 in chips) 
Seat 3: ccmaster001 ($61.60 in chips) 
Seat 4: Plz3betMe ($88.70 in chips) 
Seat 5: dreded11 ($79.80 in chips) 
Seat 6: matiko09 ($100 in chips) 
Seat 7: stds st ($32.62 in chips) 
Seat 8: chaps1988 ($172.10 in chips) 
matiko09: posts small blind $0.50
stds st: posts big blind $1
tipner: sits out 
*** HOLE CARDS ***
Dealt to matiko09 [Ts Qs]
chaps1988: folds 
Sweden_Pound: folds 
PacPacBum: folds 
ccmaster001: raises $1 to $2
Plz3betMe: folds 
dreded11: folds 
matiko09: calls $1.50
stds st: folds 
*** FLOP *** [4c 3c 2d]
matiko09: checks 
ccmaster001: bets $2
matiko09: folds 
Uncalled bet ($2) returned to ccmaster001
ccmaster001 collected $4.78 from pot
ccmaster001: doesn't show hand 
*** SUMMARY ***
Total pot $5 | Rake $0.22 
Board [4c 3c 2d]
Seat 1: Sweden_Pound folded before Flop (didn't bet)
Seat 2: PacPacBum folded before Flop (didn't bet)
Seat 3: ccmaster001 collected ($4.78)
Seat 4: Plz3betMe folded before Flop (didn't bet)
Seat 5: dreded11 (button) folded before Flop (didn't bet)
Seat 6: matiko09 (small blind) folded on the Flop
Seat 7: stds st (big blind) folded before Flop
Seat 8: chaps1988 folded before Flop (didn't bet)





PokerStars Hand #150124931970:  Hold'em No Limit ($1/$2 USD) - 2016/03/10 12:49:11 CET [2016/03/10 6:49:11 ET]
Table 'Rimito II' 9-max Seat #1 is the button
Seat 1: NeedBeat ($213.38 in chips) 
Seat 2: chaps1988 ($200 in chips) 
Seat 3: Yaaaazz ($207 in chips) 
Seat 4: Zier89 ($104.22 in chips) 
Seat 5: rijger321 ($183.22 in chips) 
Seat 6: Fish4trips ($207 in chips) 
Seat 7: matiko09 ($207 in chips) 
Seat 8: Olddogtom888 ($207 in chips) 
Seat 9: tipner ($200 in chips) 
chaps1988: posts small blind $1
Yaaaazz: posts big blind $2
*** HOLE CARDS ***
Dealt to matiko09 [Qd 8h]
Zier89: folds 
rijger321: raises $2 to $4
Fish4trips: folds 
matiko09: folds 
Olddogtom888: folds 
tipner: raises $12 to $16
NeedBeat: folds 
chaps1988: folds 
Yaaaazz: folds 
rijger321: calls $12
*** FLOP *** [5c Kh Th]
rijger321: checks 
tipner: bets $18
rijger321: folds 
Uncalled bet ($18) returned to tipner
tipner collected $33.42 from pot
*** SUMMARY ***
Total pot $35 | Rake $1.58 
Board [5c Kh Th]
Seat 1: NeedBeat (button) folded before Flop (didn't bet)
Seat 2: chaps1988 (small blind) folded before Flop
Seat 3: Yaaaazz (big blind) folded before Flop
Seat 4: Zier89 folded before Flop (didn't bet)
Seat 5: rijger321 folded on the Flop
Seat 6: Fish4trips folded before Flop (didn't bet)
Seat 7: matiko09 folded before Flop (didn't bet)
Seat 8: Olddogtom888 folded before Flop (didn't bet)
Seat 9: tipner collected ($33.42)





PokerStars Hand #150124941107:  Hold'em No Limit ($0.25/$0.50 USD) - 2016/03/10 12:49:28 CET [2016/03/10 6:49:28 ET]
Table 'Aegina' 9-max Seat #6 is the button
Seat 1: BingoIng0 ($101.69 in chips) 
Seat 4: digimatical ($42.49 in chips) 
Seat 5: Ahangama ($50 in chips) 
Seat 6: matiko09 ($50 in chips) 
Seat 9: congcongnbnb ($134.49 in chips) 
congcongnbnb: posts small blind $0.25
BingoIng0: posts big blind $0.50
BingoIng0: posts the ante $0.10
digimatical: posts the ante $0.10
Ahangama: posts the ante $0.10
matiko09: posts the ante $0.10
congcongnbnb: posts the ante $0.10
*** HOLE CARDS ***
Dealt to matiko09 [9d 6h]
digimatical: raises $0.50 to $1
Ahangama: folds 
matiko09: folds 
congcongnbnb: calls $0.75
BingoIng0: folds 
*** FLOP *** [7h 7c Ts]
congcongnbnb: checks 
digimatical: checks 
*** TURN *** [7h 7c Ts] [Kd]
congcongnbnb: bets $1.50
digimatical: calls $1.50
*** RIVER *** [7h 7c Ts Kd] [5d]
congcongnbnb: bets $3.50
digimatical: folds 
Uncalled bet ($3.50) returned to congcongnbnb
congcongnbnb collected $5.73 from pot
congcongnbnb: doesn't show hand 
*** SUMMARY ***
Total pot $6 | Rake $0.27 
Board [7h 7c Ts Kd 5d]
Seat 1: BingoIng0 (big blind) folded before Flop
Seat 4: digimatical folded on the River
Seat 5: Ahangama folded before Flop (didn't bet)
Seat 6: matiko09 (button) folded before Flop (didn't bet)
Seat 9: congcongnbnb (small blind) collected ($5.73)





PokerStars Hand #150124954231:  Hold'em No Limit ($0.50/$1.00 USD) - 2016/03/10 12:49:55 CET [2016/03/10 6:49:55 ET]
Table 'Saskia' 9-max Seat #6 is the button
Seat 1: Sweden_Pound ($105.66 in chips) 
Seat 2: PacPacBum ($141.12 in chips) 
Seat 3: ccmaster001 ($64.38 in chips) 
Seat 4: Plz3betMe ($88.70 in chips) 
Seat 5: dreded11 ($79.80 in chips) 
Seat 6: matiko09 ($100 in chips) 
Seat 7: stds st ($31.62 in chips) 
Seat 8: chaps1988 ($172.10 in chips) 
stds st: posts small blind $0.50
chaps1988: posts big blind $1
tipner: sits out 
*** HOLE CARDS ***
Dealt to matiko09 [Qs Js]
Sweden_Pound: folds 
PacPacBum: folds 
ccmaster001: folds 
Plz3betMe: folds 
dreded11: folds 
matiko09: raises $1.27 to $2.27
stds st: folds 
chaps1988: folds 
Uncalled bet ($1.27) returned to matiko09
matiko09 collected $2.50 from pot
matiko09: doesn't show hand 
*** SUMMARY ***
Total pot $2.50 | Rake $0 
Seat 1: Sweden_Pound folded before Flop (didn't bet)
Seat 2: PacPacBum folded before Flop (didn't bet)
Seat 3: ccmaster001 folded before Flop (didn't bet)
Seat 4: Plz3betMe folded before Flop (didn't bet)
Seat 5: dreded11 folded before Flop (didn't bet)
Seat 6: matiko09 (button) collected ($2.50)
Seat 7: stds st (small blind) folded before Flop
Seat 8: chaps1988 (big blind) folded before Flop





PokerStars Hand #150124960447:  Hold'em No Limit ($1/$2 USD) - 2016/03/10 12:50:07 CET [2016/03/10 6:50:07 ET]
Table 'Rimito II' 9-max Seat #2 is the button
Seat 1: NeedBeat ($213.38 in chips) 
Seat 2: chaps1988 ($200 in chips) 
Seat 3: Yaaaazz ($205 in chips) 
Seat 4: Zier89 ($104.22 in chips) 
Seat 5: rijger321 ($167.22 in chips) 
Seat 6: Fish4trips ($207 in chips) 
Seat 7: matiko09 ($207 in chips) 
Seat 8: Olddogtom888 ($207 in chips) 
Seat 9: tipner ($217.42 in chips) 
Yaaaazz: posts small blind $1
Zier89: posts big blind $2
*** HOLE CARDS ***
Dealt to matiko09 [8c As]
rijger321: folds 
Fish4trips: raises $3 to $5
matiko09: folds 
Olddogtom888: folds 
tipner: folds 
NeedBeat: folds 
chaps1988: folds 
Yaaaazz: folds 
Zier89: folds 
Uncalled bet ($3) returned to Fish4trips
Fish4trips collected $5 from pot
Fish4trips: doesn't show hand 
*** SUMMARY ***
Total pot $5 | Rake $0 
Seat 1: NeedBeat folded before Flop (didn't bet)
Seat 2: chaps1988 (button) folded before Flop (didn't bet)
Seat 3: Yaaaazz (small blind) folded before Flop
Seat 4: Zier89 (big blind) folded before Flop
Seat 5: rijger321 folded before Flop (didn't bet)
Seat 6: Fish4trips collected ($5)
Seat 7: matiko09 folded before Flop (didn't bet)
Seat 8: Olddogtom888 folded before Flop (didn't bet)
Seat 9: tipner folded before Flop (didn't bet)





PokerStars Hand #150124971904:  Hold'em No Limit ($0.50/$1.00 USD) - 2016/03/10 12:50:30 CET [2016/03/10 6:50:30 ET]
Table 'Saskia' 9-max Seat #7 is the button
Seat 1: Sweden_Pound ($105.66 in chips) 
Seat 2: PacPacBum ($141.12 in chips) 
Seat 3: ccmaster001 ($64.38 in chips) 
Seat 4: Plz3betMe ($88.70 in chips) 
Seat 5: dreded11 ($79.80 in chips) 
Seat 6: matiko09 ($101.50 in chips) 
Seat 7: stds st ($31.12 in chips) 
Seat 8: chaps1988 ($171.10 in chips) 
Seat 9: tipner ($100 in chips) 
chaps1988: posts small blind $0.50
tipner: posts big blind $1
*** HOLE CARDS ***
Dealt to matiko09 [Tc 9s]
Sweden_Pound: folds 
PacPacBum: folds 
ccmaster001: folds 
Plz3betMe: raises $1.50 to $2.50
dreded11: calls $2.50
matiko09: folds 
stds st: folds 
chaps1988: folds 
tipner: folds 
*** FLOP *** [3d 4s 3h]
Plz3betMe: bets $4.65
dreded11: folds 
Uncalled bet ($4.65) returned to Plz3betMe
Plz3betMe collected $6.21 from pot
Plz3betMe: doesn't show hand 
*** SUMMARY ***
Total pot $6.50 | Rake $0.29 
Board [3d 4s 3h]
Seat 1: Sweden_Pound folded before Flop (didn't bet)
Seat 2: PacPacBum folded before Flop (didn't bet)
Seat 3: ccmaster001 folded before Flop (didn't bet)
Seat 4: Plz3betMe collected ($6.21)
Seat 5: dreded11 folded on the Flop
Seat 6: matiko09 folded before Flop (didn't bet)
Seat 7: stds st (button) folded before Flop (didn't bet)
Seat 8: chaps1988 (small blind) folded before Flop
Seat 9: tipner (big blind) folded before Flop





PokerStars Hand #150124973728:  Hold'em No Limit ($0.25/$0.50 USD) - 2016/03/10 12:50:34 CET [2016/03/10 6:50:34 ET]
Table 'Aegina' 9-max Seat #9 is the button
Seat 1: BingoIng0 ($101.09 in chips) 
Seat 4: digimatical ($39.89 in chips) 
Seat 5: Ahangama ($50 in chips) 
Seat 6: matiko09 ($50 in chips) 
Seat 9: congcongnbnb ($137.62 in chips) 
BingoIng0: posts small blind $0.25
digimatical: posts big blind $0.50
BingoIng0: posts the ante $0.10
digimatical: posts the ante $0.10
Ahangama: posts the ante $0.10
matiko09: posts the ante $0.10
congcongnbnb: posts the ante $0.10
*** HOLE CARDS ***
Dealt to matiko09 [7h 9c]
Ahangama: folds 
matiko09: folds 
congcongnbnb: folds 
BingoIng0: folds 
Uncalled bet ($0.25) returned to digimatical
digimatical collected $1 from pot
*** SUMMARY ***
Total pot $1 | Rake $0 
Seat 1: BingoIng0 (small blind) folded before Flop
Seat 4: digimatical (big blind) collected ($1)
Seat 5: Ahangama folded before Flop (didn't bet)
Seat 6: matiko09 folded before Flop (didn't bet)
Seat 9: congcongnbnb (button) folded before Flop (didn't bet)





PokerStars Hand #150124986554:  Hold'em No Limit ($0.25/$0.50 USD) - 2016/03/10 12:50:59 CET [2016/03/10 6:50:59 ET]
Table 'Aegina' 9-max Seat #1 is the button
Seat 1: BingoIng0 ($100.74 in chips) 
Seat 4: digimatical ($40.54 in chips) 
Seat 5: Ahangama ($50 in chips) 
Seat 6: matiko09 ($50 in chips) 
Seat 9: congcongnbnb ($137.52 in chips) 
digimatical: posts small blind $0.25
Ahangama: posts big blind $0.50
BingoIng0: posts the ante $0.10
digimatical: posts the ante $0.10
Ahangama: posts the ante $0.10
matiko09: posts the ante $0.10
congcongnbnb: posts the ante $0.10
*** HOLE CARDS ***
Dealt to matiko09 [3s 4c]
matiko09: folds 
congcongnbnb: folds 
BingoIng0: raises $0.50 to $1
digimatical: calls $0.75
Ahangama: calls $0.50
*** FLOP *** [6c Kh 6d]
digimatical: checks 
Ahangama: checks 
BingoIng0: bets $2.33
digimatical: calls $2.33
Ahangama: folds 
*** TURN *** [6c Kh 6d] [3c]
digimatical: checks 
Gummio joins the table at seat #7 
BingoIng0: bets $5.45
digimatical: folds 
Uncalled bet ($5.45) returned to BingoIng0
BingoIng0 collected $7.79 from pot
BingoIng0: doesn't show hand 
*** SUMMARY ***
Total pot $8.16 | Rake $0.37 
Board [6c Kh 6d 3c]
Seat 1: BingoIng0 (button) collected ($7.79)
Seat 4: digimatical (small blind) folded on the Turn
Seat 5: Ahangama (big blind) folded on the Flop
Seat 6: matiko09 folded before Flop (didn't bet)
Seat 9: congcongnbnb folded before Flop (didn't bet)





PokerStars Hand #150124987584:  Hold'em No Limit ($1/$2 USD) - 2016/03/10 12:51:01 CET [2016/03/10 6:51:01 ET]
Table 'Rimito II' 9-max Seat #3 is the button
Seat 1: NeedBeat ($213.38 in chips) 
Seat 2: chaps1988 ($200 in chips) 
Seat 3: Yaaaazz ($204 in chips) 
Seat 4: Zier89 ($102.22 in chips) 
Seat 5: rijger321 ($167.22 in chips) 
Seat 6: Fish4trips ($210 in chips) 
Seat 7: matiko09 ($207 in chips) 
Seat 8: Olddogtom888 ($207 in chips) 
Seat 9: tipner ($217.42 in chips) 
Zier89: posts small blind $1
rijger321: posts big blind $2
*** HOLE CARDS ***
Dealt to matiko09 [Qh 6c]
Fish4trips: raises $3 to $5
matiko09: folds 
Olddogtom888: folds 
tipner: folds 
NeedBeat: folds 
chaps1988: calls $5
Yaaaazz: folds 
Zier89: folds 
rijger321: folds 
*** FLOP *** [4c 3c 3h]
Fish4trips: checks 
chaps1988: bets $6.21
Fish4trips: folds 
Uncalled bet ($6.21) returned to chaps1988
chaps1988 collected $12.42 from pot
chaps1988: doesn't show hand 
*** SUMMARY ***
Total pot $13 | Rake $0.58 
Board [4c 3c 3h]
Seat 1: NeedBeat folded before Flop (didn't bet)
Seat 2: chaps1988 collected ($12.42)
Seat 3: Yaaaazz (button) folded before Flop (didn't bet)
Seat 4: Zier89 (small blind) folded before Flop
Seat 5: rijger321 (big blind) folded before Flop
Seat 6: Fish4trips folded on the Flop
Seat 7: matiko09 folded before Flop (didn't bet)
Seat 8: Olddogtom888 folded before Flop (didn't bet)
Seat 9: tipner folded before Flop (didn't bet)





PokerStars Hand #150124995150:  Hold'em No Limit ($0.50/$1.00 USD) - 2016/03/10 12:51:16 CET [2016/03/10 6:51:16 ET]
Table 'Saskia' 9-max Seat #8 is the button
Seat 1: Sweden_Pound ($105.66 in chips) 
Seat 2: PacPacBum ($141.12 in chips) 
Seat 3: ccmaster001 ($64.38 in chips) 
Seat 4: Plz3betMe ($92.41 in chips) 
Seat 5: dreded11 ($77.30 in chips) 
Seat 6: matiko09 ($101.50 in chips) 
Seat 7: stds st ($31.12 in chips) 
Seat 8: chaps1988 ($170.60 in chips) 
Seat 9: tipner ($100 in chips) 
tipner: posts small blind $0.50
Sweden_Pound: posts big blind $1
*** HOLE CARDS ***
Dealt to matiko09 [6c 8h]
PacPacBum: folds 
ccmaster001: folds 
Plz3betMe: folds 
dreded11: folds 
matiko09: folds 
stds st: folds 
chaps1988: folds 
tipner: folds 
Uncalled bet ($0.50) returned to Sweden_Pound
Sweden_Pound collected $1 from pot
Sweden_Pound: doesn't show hand 
*** SUMMARY ***
Total pot $1 | Rake $0 
Seat 1: Sweden_Pound (big blind) collected ($1)
Seat 2: PacPacBum folded before Flop (didn't bet)
Seat 3: ccmaster001 folded before Flop (didn't bet)
Seat 4: Plz3betMe folded before Flop (didn't bet)
Seat 5: dreded11 folded before Flop (didn't bet)
Seat 6: matiko09 folded before Flop (didn't bet)
Seat 7: stds st folded before Flop (didn't bet)
Seat 8: chaps1988 (button) folded before Flop (didn't bet)
Seat 9: tipner (small blind) folded before Flop





PokerStars Hand #150125014011:  Hold'em No Limit ($0.50/$1.00 USD) - 2016/03/10 12:51:52 CET [2016/03/10 6:51:52 ET]
Table 'Saskia' 9-max Seat #9 is the button
Seat 1: Sweden_Pound ($106.16 in chips) 
Seat 3: ccmaster001 ($64.38 in chips) 
Seat 4: Plz3betMe ($92.41 in chips) 
Seat 5: dreded11 ($77.30 in chips) 
Seat 6: matiko09 ($101.50 in chips) 
Seat 7: stds st ($31.12 in chips) 
Seat 8: chaps1988 ($170.60 in chips) 
Seat 9: tipner ($100 in chips) 
Sweden_Pound: posts small blind $0.50
PacPacBum: is sitting out 
ccmaster001: posts big blind $1
*** HOLE CARDS ***
Dealt to matiko09 [5s 3d]
PacPacBum leaves the table
Plz3betMe: folds 
cdv1984 joins the table at seat #2 
dreded11: raises $2 to $3
matiko09: folds 
cdv1984 leaves the table
stds st: folds 
chaps1988: folds 
tipner: folds 
Sweden_Pound: folds 
ccmaster001: folds 
Uncalled bet ($2) returned to dreded11
dreded11 collected $2.50 from pot
dreded11: doesn't show hand 
*** SUMMARY ***
Total pot $2.50 | Rake $0 
Seat 1: Sweden_Pound (small blind) folded before Flop
Seat 3: ccmaster001 (big blind) folded before Flop
Seat 4: Plz3betMe folded before Flop (didn't bet)
Seat 5: dreded11 collected ($2.50)
Seat 6: matiko09 folded before Flop (didn't bet)
Seat 7: stds st folded before Flop (didn't bet)
Seat 8: chaps1988 folded before Flop (didn't bet)
Seat 9: tipner (button) folded before Flop (didn't bet)





PokerStars Hand #150125019013:  Hold'em No Limit ($1/$2 USD) - 2016/03/10 12:52:02 CET [2016/03/10 6:52:02 ET]
Table 'Rimito II' 9-max Seat #4 is the button
Seat 1: NeedBeat ($213.38 in chips) 
Seat 2: chaps1988 ($207.42 in chips) 
Seat 3: Yaaaazz ($204 in chips) 
Seat 4: Zier89 ($101.22 in chips) 
Seat 5: rijger321 ($165.22 in chips) 
Seat 6: Fish4trips ($205 in chips) 
Seat 7: matiko09 ($207 in chips) 
Seat 8: Olddogtom888 ($207 in chips) 
Seat 9: tipner ($217.42 in chips) 
rijger321: posts small blind $1
Fish4trips: posts big blind $2
*** HOLE CARDS ***
Dealt to matiko09 [6c 5c]
matiko09: folds 
Olddogtom888: folds 
tipner: folds 
NeedBeat: folds 
chaps1988: raises $3 to $5
Yaaaazz: folds 
Zier89: folds 
rijger321: folds 
Fish4trips: calls $3
*** FLOP *** [9d Ah 4c]
Fish4trips: checks 
chaps1988: checks 
*** TURN *** [9d Ah 4c] [7d]
Fish4trips: checks 
chaps1988: checks 
*** RIVER *** [9d Ah 4c 7d] [4d]
Fish4trips: checks 
chaps1988: checks 
*** SHOW DOWN ***
Fish4trips: shows [Kc Js] (a pair of Fours)
chaps1988: shows [8d 8c] (two pair, Eights and Fours)
chaps1988 collected $10.50 from pot
*** SUMMARY ***
Total pot $11 | Rake $0.50 
Board [9d Ah 4c 7d 4d]
Seat 1: NeedBeat folded before Flop (didn't bet)
Seat 2: chaps1988 showed [8d 8c] and won ($10.50) with two pair, Eights and Fours
Seat 3: Yaaaazz folded before Flop (didn't bet)
Seat 4: Zier89 (button) folded before Flop (didn't bet)
Seat 5: rijger321 (small blind) folded before Flop
Seat 6: Fish4trips (big blind) showed [Kc Js] and lost with a pair of Fours
Seat 7: matiko09 folded before Flop (didn't bet)
Seat 8: Olddogtom888 folded before Flop (didn't bet)
Seat 9: tipner folded before Flop (didn't bet)





PokerStars Hand #150125019963:  Hold'em No Limit ($0.25/$0.50 USD) - 2016/03/10 12:52:04 CET [2016/03/10 6:52:04 ET]
Table 'Aegina' 9-max Seat #4 is the button
Seat 1: BingoIng0 ($105.10 in chips) 
Seat 4: digimatical ($37.11 in chips) 
Seat 5: Ahangama ($50 in chips) 
Seat 6: matiko09 ($50 in chips) 
Seat 9: congcongnbnb ($137.42 in chips) 
Ahangama: posts small blind $0.25
matiko09: posts big blind $0.50
Gummio: sits out 
BingoIng0: posts the ante $0.10
digimatical: posts the ante $0.10
Ahangama: posts the ante $0.10
matiko09: posts the ante $0.10
congcongnbnb: posts the ante $0.10
*** HOLE CARDS ***
Dealt to matiko09 [2c Kc]
congcongnbnb: raises $1.50 to $2
BingoIng0: folds 
digimatical: calls $2
Ahangama: folds 
matiko09: folds 
*** FLOP *** [Kd Td 6h]
congcongnbnb: bets $3
digimatical: folds 
Uncalled bet ($3) returned to congcongnbnb
congcongnbnb collected $5.01 from pot
congcongnbnb: doesn't show hand 
*** SUMMARY ***
Total pot $5.25 | Rake $0.24 
Board [Kd Td 6h]
Seat 1: BingoIng0 folded before Flop (didn't bet)
Seat 4: digimatical (button) folded on the Flop
Seat 5: Ahangama (small blind) folded before Flop
Seat 6: matiko09 (big blind) folded before Flop
Seat 9: congcongnbnb collected ($5.01)





PokerStars Hand #150125039323:  Hold'em No Limit ($0.50/$1.00 USD) - 2016/03/10 12:52:42 CET [2016/03/10 6:52:42 ET]
Table 'Saskia' 9-max Seat #1 is the button
Seat 1: Sweden_Pound ($105.66 in chips) 
Seat 3: ccmaster001 ($63.38 in chips) 
Seat 4: Plz3betMe ($92.41 in chips) 
Seat 5: dreded11 ($78.80 in chips) 
Seat 6: matiko09 ($101.50 in chips) 
Seat 7: stds st ($31.12 in chips) 
Seat 8: chaps1988 ($170.60 in chips) 
Seat 9: tipner ($100 in chips) 
ccmaster001: posts small blind $0.50
Plz3betMe: posts big blind $1
*** HOLE CARDS ***
Dealt to matiko09 [Ac 3c]
dreded11: folds 
matiko09: raises $2 to $3
cdv1984 joins the table at seat #2 
cdv1984 leaves the table
stds st: folds 
chaps1988: folds 
tipner: raises $6 to $9
Sweden_Pound: folds 
ccmaster001: folds 
Plz3betMe: folds 
matiko09: folds 
Uncalled bet ($6) returned to tipner
tipner collected $7.50 from pot
tipner: doesn't show hand 
*** SUMMARY ***
Total pot $7.50 | Rake $0 
Seat 1: Sweden_Pound (button) folded before Flop (didn't bet)
Seat 3: ccmaster001 (small blind) folded before Flop
Seat 4: Plz3betMe (big blind) folded before Flop
Seat 5: dreded11 folded before Flop (didn't bet)
Seat 6: matiko09 folded before Flop
Seat 7: stds st folded before Flop (didn't bet)
Seat 8: chaps1988 folded before Flop (didn't bet)
Seat 9: tipner collected ($7.50)





PokerStars Hand #150125045715:  Hold'em No Limit ($0.25/$0.50 USD) - 2016/03/10 12:52:54 CET [2016/03/10 6:52:54 ET]
Table 'Aegina' 9-max Seat #5 is the button
Seat 1: BingoIng0 ($105 in chips) 
Seat 4: digimatical ($35.01 in chips) 
Seat 5: Ahangama ($50 in chips) 
Seat 6: matiko09 ($50 in chips) 
Seat 7: Gummio ($125 in chips) 
Seat 9: congcongnbnb ($140.33 in chips) 
matiko09: posts small blind $0.25
Gummio: posts big blind $0.50
BingoIng0: posts the ante $0.10
digimatical: posts the ante $0.10
Ahangama: posts the ante $0.10
matiko09: posts the ante $0.10
Gummio: posts the ante $0.10
congcongnbnb: posts the ante $0.10
*** HOLE CARDS ***
Dealt to matiko09 [4s Jd]
congcongnbnb: folds 
BingoIng0: raises $0.75 to $1.25
digimatical: folds 
Ahangama: calls $1.25
matiko09: folds 
Gummio: folds 
*** FLOP *** [5h 6s Qd]
BingoIng0: bets $2.57
Ahangama: calls $2.57
*** TURN *** [5h 6s Qd] [Kc]
BingoIng0: bets $6.01
Ahangama: folds 
Uncalled bet ($6.01) returned to BingoIng0
BingoIng0 collected $8.59 from pot
BingoIng0: doesn't show hand 
*** SUMMARY ***
Total pot $8.99 | Rake $0.40 
Board [5h 6s Qd Kc]
Seat 1: BingoIng0 collected ($8.59)
Seat 4: digimatical folded before Flop (didn't bet)
Seat 5: Ahangama (button) folded on the Turn
Seat 6: matiko09 (small blind) folded before Flop
Seat 7: Gummio (big blind) folded before Flop
Seat 9: congcongnbnb folded before Flop (didn't bet)





PokerStars Hand #150125056452:  Hold'em No Limit ($1/$2 USD) - 2016/03/10 12:53:16 CET [2016/03/10 6:53:16 ET]
Table 'Rimito II' 9-max Seat #5 is the button
Seat 1: NeedBeat ($213.38 in chips) 
Seat 2: chaps1988 ($212.92 in chips) 
Seat 3: Yaaaazz ($204 in chips) 
Seat 4: Zier89 ($101.22 in chips) 
Seat 5: rijger321 ($164.22 in chips) 
Seat 6: Fish4trips ($200 in chips) 
Seat 7: matiko09 ($207 in chips) 
Seat 8: Olddogtom888 ($207 in chips) 
Seat 9: tipner ($217.42 in chips) 
Fish4trips: posts small blind $1
matiko09: posts big blind $2
*** HOLE CARDS ***
Dealt to matiko09 [8s 2d]
Olddogtom888: folds 
tipner: folds 
NeedBeat: folds 
chaps1988: folds 
Yaaaazz: folds 
Zier89: calls $2
rijger321: raises $6 to $8
Fish4trips: folds 
matiko09: folds 
Zier89: calls $6
*** FLOP *** [2c Jc 2s]
Zier89: bets $22
rijger321: raises $134.22 to $156.22 and is all-in
Zier89: calls $71.22 and is all-in
Uncalled bet ($63) returned to rijger321
*** TURN *** [2c Jc 2s] [7s]
*** RIVER *** [2c Jc 2s 7s] [9s]
*** SHOW DOWN ***
Zier89: shows [Ah Js] (two pair, Jacks and Deuces)
rijger321: shows [Kh Jh] (two pair, Jacks and Deuces - lower kicker)
Zier89 collected $202.64 from pot
*** SUMMARY ***
Total pot $205.44 | Rake $2.80 
Board [2c Jc 2s 7s 9s]
Seat 1: NeedBeat folded before Flop (didn't bet)
Seat 2: chaps1988 folded before Flop (didn't bet)
Seat 3: Yaaaazz folded before Flop (didn't bet)
Seat 4: Zier89 showed [Ah Js] and won ($202.64) with two pair, Jacks and Deuces
Seat 5: rijger321 (button) showed [Kh Jh] and lost with two pair, Jacks and Deuces
Seat 6: Fish4trips (small blind) folded before Flop
Seat 7: matiko09 (big blind) folded before Flop
Seat 8: Olddogtom888 folded before Flop (didn't bet)
Seat 9: tipner folded before Flop (didn't bet)





PokerStars Hand #150125066713:  Hold'em No Limit ($0.25/$0.50 USD) - 2016/03/10 12:53:36 CET [2016/03/10 6:53:36 ET]
Table 'Aegina' 9-max Seat #6 is the button
Seat 1: BingoIng0 ($109.67 in chips) 
Seat 4: digimatical ($34.91 in chips) 
Seat 5: Ahangama ($50 in chips) 
Seat 6: matiko09 ($50 in chips) 
Seat 7: Gummio ($124.40 in chips) 
Seat 9: congcongnbnb ($140.23 in chips) 
Gummio: posts small blind $0.25
congcongnbnb: posts big blind $0.50
BingoIng0: posts the ante $0.10
digimatical: posts the ante $0.10
Ahangama: posts the ante $0.10
matiko09: posts the ante $0.10
Gummio: posts the ante $0.10
congcongnbnb: posts the ante $0.10
*** HOLE CARDS ***
Dealt to matiko09 [5c 6h]
BingoIng0: raises $1 to $1.50
digimatical: folds 
ardo888 joins the table at seat #8 
Ahangama: folds 
matiko09: folds 
Gummio: folds 
congcongnbnb: calls $1
*** FLOP *** [2h 2c Ah]
congcongnbnb: checks 
BingoIng0: checks 
*** TURN *** [2h 2c Ah] [Js]
congcongnbnb: checks 
BingoIng0: checks 
*** RIVER *** [2h 2c Ah Js] [Th]
congcongnbnb: bets $2.45
BingoIng0: folds 
Uncalled bet ($2.45) returned to congcongnbnb
congcongnbnb collected $3.68 from pot
congcongnbnb: doesn't show hand 
*** SUMMARY ***
Total pot $3.85 | Rake $0.17 
Board [2h 2c Ah Js Th]
Seat 1: BingoIng0 folded on the River
Seat 4: digimatical folded before Flop (didn't bet)
Seat 5: Ahangama folded before Flop (didn't bet)
Seat 6: matiko09 (button) folded before Flop (didn't bet)
Seat 7: Gummio (small blind) folded before Flop
Seat 9: congcongnbnb (big blind) collected ($3.68)





PokerStars Hand #150125072696:  Hold'em No Limit ($0.50/$1.00 USD) - 2016/03/10 12:53:47 CET [2016/03/10 6:53:47 ET]
Table 'Saskia' 9-max Seat #3 is the button
Seat 1: Sweden_Pound ($105.66 in chips) 
Seat 3: ccmaster001 ($62.88 in chips) 
Seat 4: Plz3betMe ($91.41 in chips) 
Seat 5: dreded11 ($78.80 in chips) 
Seat 6: matiko09 ($100 in chips) 
Seat 7: stds st ($31.12 in chips) 
Seat 8: chaps1988 ($170.60 in chips) 
Seat 9: tipner ($104.50 in chips) 
Plz3betMe: posts small blind $0.50
dreded11: posts big blind $1
*** HOLE CARDS ***
Dealt to matiko09 [8s 8c]
matiko09: raises $2 to $3
stds st: folds 
chaps1988: folds 
tipner: folds 
Sweden_Pound: folds 
njurg aga joins the table at seat #2 
ccmaster001: calls $3
Plz3betMe: folds 
dreded11: folds 
*** FLOP *** [Ac 2d Kd]
matiko09: checks 
ccmaster001: bets $2
matiko09: folds 
Uncalled bet ($2) returned to ccmaster001
ccmaster001 collected $7.16 from pot
ccmaster001: doesn't show hand 
*** SUMMARY ***
Total pot $7.50 | Rake $0.34 
Board [Ac 2d Kd]
Seat 1: Sweden_Pound folded before Flop (didn't bet)
Seat 3: ccmaster001 (button) collected ($7.16)
Seat 4: Plz3betMe (small blind) folded before Flop
Seat 5: dreded11 (big blind) folded before Flop
Seat 6: matiko09 folded on the Flop
Seat 7: stds st folded before Flop (didn't bet)
Seat 8: chaps1988 folded before Flop (didn't bet)
Seat 9: tipner folded before Flop (didn't bet)





PokerStars Hand #150125082868:  Hold'em No Limit ($0.50/$1.00 USD) - 2016/03/10 12:54:07 CET [2016/03/10 6:54:07 ET]
Table 'Liriope II' 9-max Seat #1 is the button
Seat 1: di0d80 ($100 in chips) 
Seat 2: zxp12345 ($56.37 in chips) 
Seat 3: matiko09 ($145.59 in chips) 
Seat 4: Plz3betMe ($51.26 in chips) 
Seat 5: chaps1988 ($135.68 in chips) 
Seat 6: nobu-azabu ($170.28 in chips) 
Seat 7: Sweden_Pound ($100 in chips) 
Seat 8: PacPacBum ($100 in chips) 
zxp12345: posts small blind $0.50
matiko09: posts big blind $1
tipner: sits out 
*** HOLE CARDS ***
Dealt to matiko09 [2c 8s]
Plz3betMe: folds 
chaps1988: folds 
nobu-azabu: folds 
Sweden_Pound: raises $2 to $3
PacPacBum: folds 
di0d80: calls $3
zxp12345: folds 
matiko09: folds 
*** FLOP *** [2h 8d 4h]
Sweden_Pound: bets $4.65
di0d80: calls $4.65
*** TURN *** [2h 8d 4h] [Ah]
Sweden_Pound: checks 
di0d80: checks 
*** RIVER *** [2h 8d 4h Ah] [Ac]
Sweden_Pound: checks 
di0d80: bets $9
Sweden_Pound: folds 
Uncalled bet ($9) returned to di0d80
di0d80 collected $16.04 from pot
di0d80: doesn't show hand 
*** SUMMARY ***
Total pot $16.80 | Rake $0.76 
Board [2h 8d 4h Ah Ac]
Seat 1: di0d80 (button) collected ($16.04)
Seat 2: zxp12345 (small blind) folded before Flop
Seat 3: matiko09 (big blind) folded before Flop
Seat 4: Plz3betMe folded before Flop (didn't bet)
Seat 5: chaps1988 folded before Flop (didn't bet)
Seat 6: nobu-azabu folded before Flop (didn't bet)
Seat 7: Sweden_Pound folded on the River
Seat 8: PacPacBum folded before Flop (didn't bet)





PokerStars Hand #150125089263:  Hold'em No Limit ($0.50/$1.00 USD) - 2016/03/10 12:54:20 CET [2016/03/10 6:54:20 ET]
Table 'Saskia' 9-max Seat #4 is the button
Seat 1: Sweden_Pound ($105.66 in chips) 
Seat 3: ccmaster001 ($67.04 in chips) 
Seat 4: Plz3betMe ($90.91 in chips) 
Seat 5: dreded11 ($77.80 in chips) 
Seat 6: matiko09 ($100 in chips) 
Seat 7: stds st ($31.12 in chips) 
Seat 8: chaps1988 ($170.60 in chips) 
Seat 9: tipner ($104.50 in chips) 
dreded11: posts small blind $0.50
matiko09: posts big blind $1
njurg aga: sits out 
*** HOLE CARDS ***
Dealt to matiko09 [Ac 4d]
stds st: folds 
chaps1988: folds 
tipner: folds 
Sweden_Pound: folds 
ccmaster001: folds 
Plz3betMe: raises $1 to $2
dreded11: folds 
matiko09: calls $1
*** FLOP *** [Qd 3h Kc]
matiko09: checks 
Plz3betMe: checks 
*** TURN *** [Qd 3h Kc] [Qs]
matiko09: checks 
Plz3betMe: bets $2.86
matiko09: folds 
Uncalled bet ($2.86) returned to Plz3betMe
Plz3betMe collected $4.30 from pot
Plz3betMe: doesn't show hand 
*** SUMMARY ***
Total pot $4.50 | Rake $0.20 
Board [Qd 3h Kc Qs]
Seat 1: Sweden_Pound folded before Flop (didn't bet)
Seat 3: ccmaster001 folded before Flop (didn't bet)
Seat 4: Plz3betMe (button) collected ($4.30)
Seat 5: dreded11 (small blind) folded before Flop
Seat 6: matiko09 (big blind) folded on the Turn
Seat 7: stds st folded before Flop (didn't bet)
Seat 8: chaps1988 folded before Flop (didn't bet)
Seat 9: tipner folded before Flop (didn't bet)





PokerStars Hand #150125090355:  Hold'em No Limit ($0.25/$0.50 USD) - 2016/03/10 12:54:22 CET [2016/03/10 6:54:22 ET]
Table 'Aegina' 9-max Seat #7 is the button
Seat 1: BingoIng0 ($108.07 in chips) 
Seat 4: digimatical ($34.81 in chips) 
Seat 5: Ahangama ($50 in chips) 
Seat 6: matiko09 ($50 in chips) 
Seat 7: Gummio ($124.05 in chips) 
Seat 9: congcongnbnb ($142.31 in chips) 
ardo888 will be allowed to play after the button
congcongnbnb: posts small blind $0.25
BingoIng0: posts big blind $0.50
BingoIng0: posts the ante $0.10
digimatical: posts the ante $0.10
Ahangama: posts the ante $0.10
matiko09: posts the ante $0.10
Gummio: posts the ante $0.10
congcongnbnb: posts the ante $0.10
*** HOLE CARDS ***
Dealt to matiko09 [6h Ts]
digimatical: raises $0.50 to $1
Ahangama: folds 
matiko09: folds 
Gummio: calls $1
congcongnbnb: calls $0.75
BingoIng0: calls $0.50
*** FLOP *** [Jd 2d Jc]
congcongnbnb: checks 
BingoIng0: checks 
digimatical: checks 
Gummio: checks 
*** TURN *** [Jd 2d Jc] [Qc]
congcongnbnb: bets $3
BingoIng0: folds 
digimatical: calls $3
Gummio: folds 
*** RIVER *** [Jd 2d Jc Qc] [4c]
congcongnbnb: checks 
digimatical: bets $10
congcongnbnb: folds [Js]
Uncalled bet ($10) returned to digimatical
digimatical collected $10.12 from pot
*** SUMMARY ***
Total pot $10.60 | Rake $0.48 
Board [Jd 2d Jc Qc 4c]
Seat 1: BingoIng0 (big blind) folded on the Turn
Seat 4: digimatical collected ($10.12)
Seat 5: Ahangama folded before Flop (didn't bet)
Seat 6: matiko09 folded before Flop (didn't bet)
Seat 7: Gummio (button) folded on the Turn
Seat 9: congcongnbnb (small blind) folded on the River





PokerStars Hand #150125094043:  Hold'em No Limit ($1/$2 USD) - 2016/03/10 12:54:29 CET [2016/03/10 6:54:29 ET]
Table 'Rimito II' 9-max Seat #6 is the button
Seat 1: NeedBeat ($213.38 in chips) 
Seat 2: chaps1988 ($212.92 in chips) 
Seat 3: Yaaaazz ($204 in chips) 
Seat 4: Zier89 ($202.64 in chips) 
Seat 5: rijger321 ($63 in chips) 
Seat 6: Fish4trips ($200 in chips) 
Seat 7: matiko09 ($205 in chips) 
Seat 8: Olddogtom888 ($207 in chips) 
Seat 9: tipner ($217.42 in chips) 
matiko09: posts small blind $1
Olddogtom888: posts big blind $2
*** HOLE CARDS ***
Dealt to matiko09 [Qh 3c]
tipner: folds 
NeedBeat: folds 
chaps1988: folds 
Yaaaazz: raises $4 to $6
Zier89: calls $6
rijger321: folds 
Fish4trips: folds 
matiko09: folds 
Olddogtom888: folds 
*** FLOP *** [2h Jh 4c]
Yaaaazz: checks 
Zier89: checks 
*** TURN *** [2h Jh 4c] [Qc]
Yaaaazz: checks 
Zier89: checks 
*** RIVER *** [2h Jh 4c Qc] [4s]
Yaaaazz: checks 
Zier89: checks 
*** SHOW DOWN ***
Yaaaazz: shows [Ah Kd] (a pair of Fours)
Zier89: mucks hand 
Yaaaazz collected $14.32 from pot
*** SUMMARY ***
Total pot $15 | Rake $0.68 
Board [2h Jh 4c Qc 4s]
Seat 1: NeedBeat folded before Flop (didn't bet)
Seat 2: chaps1988 folded before Flop (didn't bet)
Seat 3: Yaaaazz showed [Ah Kd] and won ($14.32) with a pair of Fours
Seat 4: Zier89 mucked [Ac 9h]
Seat 5: rijger321 folded before Flop (didn't bet)
Seat 6: Fish4trips (button) folded before Flop (didn't bet)
Seat 7: matiko09 (small blind) folded before Flop
Seat 8: Olddogtom888 (big blind) folded before Flop
Seat 9: tipner folded before Flop (didn't bet)





PokerStars Hand #150125121497:  Hold'em No Limit ($0.50/$1.00 USD) - 2016/03/10 12:55:26 CET [2016/03/10 6:55:26 ET]
Table 'Saskia' 9-max Seat #5 is the button
Seat 1: Sweden_Pound ($105.66 in chips) 
Seat 3: ccmaster001 ($67.04 in chips) 
Seat 4: Plz3betMe ($93.21 in chips) 
Seat 5: dreded11 ($77.30 in chips) 
Seat 6: matiko09 ($100 in chips) 
Seat 7: stds st ($31.12 in chips) 
Seat 8: chaps1988 ($170.60 in chips) 
Seat 9: tipner ($104.50 in chips) 
matiko09: posts small blind $0.50
stds st: posts big blind $1
njurg aga: sits out 
*** HOLE CARDS ***
Dealt to matiko09 [7h 5c]
chaps1988: folds 
tipner: folds 
Sweden_Pound: folds 
ccmaster001: folds 
Plz3betMe: folds 
dreded11: folds 
matiko09: folds 
Uncalled bet ($0.50) returned to stds st
stds st collected $1 from pot
stds st: doesn't show hand 
*** SUMMARY ***
Total pot $1 | Rake $0 
Seat 1: Sweden_Pound folded before Flop (didn't bet)
Seat 3: ccmaster001 folded before Flop (didn't bet)
Seat 4: Plz3betMe folded before Flop (didn't bet)
Seat 5: dreded11 (button) folded before Flop (didn't bet)
Seat 6: matiko09 (small blind) folded before Flop
Seat 7: stds st (big blind) collected ($1)
Seat 8: chaps1988 folded before Flop (didn't bet)
Seat 9: tipner folded before Flop (didn't bet)





PokerStars Hand #150125122280:  Hold'em No Limit ($0.50/$1.00 USD) - 2016/03/10 12:55:28 CET [2016/03/10 6:55:28 ET]
Table 'Liriope II' 9-max Seat #2 is the button
Seat 1: di0d80 ($108.39 in chips) 
Seat 2: zxp12345 ($55.87 in chips) 
Seat 3: matiko09 ($144.59 in chips) 
Seat 4: Plz3betMe ($51.26 in chips) 
Seat 5: chaps1988 ($135.68 in chips) 
Seat 6: nobu-azabu ($170.28 in chips) 
Seat 7: Sweden_Pound ($100 in chips) 
Seat 8: PacPacBum ($100 in chips) 
matiko09: posts small blind $0.50
Plz3betMe: posts big blind $1
tipner: sits out 
*** HOLE CARDS ***
Dealt to matiko09 [7c 6d]
chaps1988: folds 
nobu-azabu: folds 
Sweden_Pound: folds 
PacPacBum: folds 
di0d80: folds 
zxp12345: raises $1 to $2
matiko09: folds 
Plz3betMe: calls $1
*** FLOP *** [4d Kh Ks]
Plz3betMe: checks 
zxp12345: checks 
*** TURN *** [4d Kh Ks] [Ad]
Plz3betMe: checks 
zxp12345: bets $2.15
Plz3betMe: calls $2.15
*** RIVER *** [4d Kh Ks Ad] [Ts]
Plz3betMe: checks 
zxp12345: checks 
*** SHOW DOWN ***
Plz3betMe: shows [Ah 7h] (two pair, Aces and Kings)
zxp12345: mucks hand 
Plz3betMe collected $8.40 from pot
*** SUMMARY ***
Total pot $8.80 | Rake $0.40 
Board [4d Kh Ks Ad Ts]
Seat 1: di0d80 folded before Flop (didn't bet)
Seat 2: zxp12345 (button) mucked [5c Qc]
Seat 3: matiko09 (small blind) folded before Flop
Seat 4: Plz3betMe (big blind) showed [Ah 7h] and won ($8.40) with two pair, Aces and Kings
Seat 5: chaps1988 folded before Flop (didn't bet)
Seat 6: nobu-azabu folded before Flop (didn't bet)
Seat 7: Sweden_Pound folded before Flop (didn't bet)
Seat 8: PacPacBum folded before Flop (didn't bet)





PokerStars Hand #150125131805:  Hold'em No Limit ($1/$2 USD) - 2016/03/10 12:55:49 CET [2016/03/10 6:55:49 ET]
Table 'Rimito II' 9-max Seat #7 is the button
Seat 1: NeedBeat ($213.38 in chips) 
Seat 2: chaps1988 ($212.92 in chips) 
Seat 3: Yaaaazz ($212.32 in chips) 
Seat 4: Zier89 ($196.64 in chips) 
Seat 5: rijger321 ($63 in chips) 
Seat 6: Fish4trips ($200 in chips) 
Seat 7: matiko09 ($204 in chips) 
Seat 8: Olddogtom888 ($205 in chips) 
Seat 9: tipner ($217.42 in chips) 
Olddogtom888: posts small blind $1
tipner: posts big blind $2
*** HOLE CARDS ***
Dealt to matiko09 [7c 3c]
NeedBeat: folds 
chaps1988: raises $4 to $6
Yaaaazz: folds 
Zier89: raises $4 to $10
rijger321: folds 
Fish4trips: folds 
matiko09: folds 
Olddogtom888: calls $9
tipner: folds 
chaps1988: calls $4
*** FLOP *** [3s 9h 9d]
Olddogtom888: checks 
chaps1988: checks 
Zier89: checks 
*** TURN *** [3s 9h 9d] [2c]
Olddogtom888: checks 
chaps1988: checks 
Zier89: checks 
*** RIVER *** [3s 9h 9d 2c] [Td]
Olddogtom888: checks 
chaps1988: checks 
Zier89: bets $12
Olddogtom888: raises $23 to $35
chaps1988: folds 
Zier89: calls $23
*** SHOW DOWN ***
Olddogtom888: shows [Qc Ks] (a pair of Nines)
Zier89: shows [As Th] (two pair, Tens and Nines)
Zier89 collected $99.20 from pot
*** SUMMARY ***
Total pot $102 | Rake $2.80 
Board [3s 9h 9d 2c Td]
Seat 1: NeedBeat folded before Flop (didn't bet)
Seat 2: chaps1988 folded on the River
Seat 3: Yaaaazz folded before Flop (didn't bet)
Seat 4: Zier89 showed [As Th] and won ($99.20) with two pair, Tens and Nines
Seat 5: rijger321 folded before Flop (didn't bet)
Seat 6: Fish4trips folded before Flop (didn't bet)
Seat 7: matiko09 (button) folded before Flop (didn't bet)
Seat 8: Olddogtom888 (small blind) showed [Qc Ks] and lost with a pair of Nines
Seat 9: tipner (big blind) folded before Flop





PokerStars Hand #150125132739:  Hold'em No Limit ($0.50/$1.00 USD) - 2016/03/10 12:55:51 CET [2016/03/10 6:55:51 ET]
Table 'Saskia' 9-max Seat #6 is the button
Seat 1: Sweden_Pound ($105.66 in chips) 
Seat 3: ccmaster001 ($67.04 in chips) 
Seat 4: Plz3betMe ($93.21 in chips) 
Seat 5: dreded11 ($77.30 in chips) 
Seat 6: matiko09 ($100 in chips) 
Seat 7: stds st ($31.62 in chips) 
Seat 8: chaps1988 ($170.60 in chips) 
Seat 9: tipner ($104.50 in chips) 
stds st: posts small blind $0.50
chaps1988: posts big blind $1
njurg aga: sits out 
*** HOLE CARDS ***
Dealt to matiko09 [3d Tc]
tipner: raises $2 to $3
Sweden_Pound: folds 
ccmaster001: folds 
Plz3betMe: folds 
dreded11: raises $9 to $12
matiko09: folds 
stds st: folds 
chaps1988: folds 
tipner: folds 
Uncalled bet ($9) returned to dreded11
dreded11 collected $7.50 from pot
dreded11: doesn't show hand 
*** SUMMARY ***
Total pot $7.50 | Rake $0 
Seat 1: Sweden_Pound folded before Flop (didn't bet)
Seat 3: ccmaster001 folded before Flop (didn't bet)
Seat 4: Plz3betMe folded before Flop (didn't bet)
Seat 5: dreded11 collected ($7.50)
Seat 6: matiko09 (button) folded before Flop (didn't bet)
Seat 7: stds st (small blind) folded before Flop
Seat 8: chaps1988 (big blind) folded before Flop
Seat 9: tipner folded before Flop





PokerStars Hand #150125145324:  Hold'em No Limit ($0.50/$1.00 USD) - 2016/03/10 12:56:20 CET [2016/03/10 6:56:20 ET]
Table 'Liriope II' 9-max Seat #3 is the button
Seat 1: di0d80 ($108.39 in chips) 
Seat 2: zxp12345 ($51.72 in chips) 
Seat 3: matiko09 ($144.09 in chips) 
Seat 4: Plz3betMe ($55.51 in chips) 
Seat 5: chaps1988 ($135.68 in chips) 
Seat 6: nobu-azabu ($170.28 in chips) 
Seat 7: Sweden_Pound ($100 in chips) 
Seat 8: PacPacBum ($100 in chips) 
Plz3betMe: posts small blind $0.50
chaps1988: posts big blind $1
tipner: sits out 
*** HOLE CARDS ***
Dealt to matiko09 [6d Ts]
nobu-azabu: folds 
Sweden_Pound: folds 
PacPacBum: folds 
di0d80: folds 
zxp12345: folds 
matiko09: folds 
Plz3betMe: folds 
Uncalled bet ($0.50) returned to chaps1988
chaps1988 collected $1 from pot
chaps1988: doesn't show hand 
*** SUMMARY ***
Total pot $1 | Rake $0 
Seat 1: di0d80 folded before Flop (didn't bet)
Seat 2: zxp12345 folded before Flop (didn't bet)
Seat 3: matiko09 (button) folded before Flop (didn't bet)
Seat 4: Plz3betMe (small blind) folded before Flop
Seat 5: chaps1988 (big blind) collected ($1)
Seat 6: nobu-azabu folded before Flop (didn't bet)
Seat 7: Sweden_Pound folded before Flop (didn't bet)
Seat 8: PacPacBum folded before Flop (didn't bet)





PokerStars Hand #150125152074:  Hold'em No Limit ($0.50/$1.00 USD) - 2016/03/10 12:56:35 CET [2016/03/10 6:56:35 ET]
Table 'Saskia' 9-max Seat #7 is the button
Seat 1: Sweden_Pound ($105.66 in chips) 
Seat 3: ccmaster001 ($67.04 in chips) 
Seat 4: Plz3betMe ($93.21 in chips) 
Seat 5: dreded11 ($81.80 in chips) 
Seat 6: matiko09 ($100 in chips) 
Seat 7: stds st ($31.12 in chips) 
Seat 8: chaps1988 ($169.60 in chips) 
Seat 9: tipner ($101.50 in chips) 
chaps1988: posts small blind $0.50
tipner: posts big blind $1
njurg aga: sits out 
*** HOLE CARDS ***
Dealt to matiko09 [7s 9d]
Sweden_Pound: folds 
ccmaster001: folds 
Plz3betMe: folds 
dreded11: raises $1 to $2
matiko09: folds 
stds st: folds 
chaps1988: folds 
tipner: folds 
Uncalled bet ($1) returned to dreded11
dreded11 collected $2.50 from pot
dreded11: doesn't show hand 
*** SUMMARY ***
Total pot $2.50 | Rake $0 
Seat 1: Sweden_Pound folded before Flop (didn't bet)
Seat 3: ccmaster001 folded before Flop (didn't bet)
Seat 4: Plz3betMe folded before Flop (didn't bet)
Seat 5: dreded11 collected ($2.50)
Seat 6: matiko09 folded before Flop (didn't bet)
Seat 7: stds st (button) folded before Flop (didn't bet)
Seat 8: chaps1988 (small blind) folded before Flop
Seat 9: tipner (big blind) folded before Flop





PokerStars Hand #150125155146:  Hold'em No Limit ($0.25/$0.50 USD) - 2016/03/10 12:56:42 CET [2016/03/10 6:56:42 ET]
Table 'Aegina' 9-max Seat #9 is the button
Seat 1: BingoIng0 ($106.97 in chips) 
Seat 4: digimatical ($40.83 in chips) 
Seat 5: Ahangama ($50 in chips) 
Seat 6: matiko09 ($50 in chips) 
Seat 7: Gummio ($122.95 in chips) 
Seat 9: congcongnbnb ($138.21 in chips) 
BingoIng0: posts small blind $0.25
digimatical: posts big blind $0.50
ardo888: sits out 
BingoIng0: posts the ante $0.10
digimatical: posts the ante $0.10
Ahangama: posts the ante $0.10
matiko09: posts the ante $0.10
Gummio: posts the ante $0.10
congcongnbnb: posts the ante $0.10
*** HOLE CARDS ***
Dealt to matiko09 [7h 7d]
Ahangama: folds 
matiko09: raises $1 to $1.50
Gummio: folds 
congcongnbnb: raises $3.50 to $5
BingoIng0: folds 
digimatical: folds 
matiko09: folds 
Uncalled bet ($3.50) returned to congcongnbnb
congcongnbnb collected $4.35 from pot
congcongnbnb: doesn't show hand 
*** SUMMARY ***
Total pot $4.35 | Rake $0 
Seat 1: BingoIng0 (small blind) folded before Flop
Seat 4: digimatical (big blind) folded before Flop
Seat 5: Ahangama folded before Flop (didn't bet)
Seat 6: matiko09 folded before Flop
Seat 7: Gummio folded before Flop (didn't bet)
Seat 9: congcongnbnb (button) collected ($4.35)





PokerStars Hand #150125163393:  Hold'em No Limit ($0.50/$1.00 USD) - 2016/03/10 12:57:00 CET [2016/03/10 6:57:00 ET]
Table 'Liriope II' 9-max Seat #4 is the button
Seat 1: di0d80 ($108.39 in chips) 
Seat 2: zxp12345 ($51.72 in chips) 
Seat 3: matiko09 ($144.09 in chips) 
Seat 4: Plz3betMe ($55.01 in chips) 
Seat 5: chaps1988 ($136.18 in chips) 
Seat 6: nobu-azabu ($170.28 in chips) 
Seat 7: Sweden_Pound ($100 in chips) 
Seat 8: PacPacBum ($100 in chips) 
chaps1988: posts small blind $0.50
nobu-azabu: posts big blind $1
tipner: sits out 
*** HOLE CARDS ***
Dealt to matiko09 [Th 7s]
Sweden_Pound: folds 
PacPacBum: folds 
di0d80: folds 
zxp12345: folds 
matiko09: folds 
Plz3betMe: raises $1 to $2
chaps1988: folds 
nobu-azabu: calls $1
*** FLOP *** [3d Jd 8s]
nobu-azabu: checks 
Plz3betMe: bets $2.86
nobu-azabu: folds 
Uncalled bet ($2.86) returned to Plz3betMe
Plz3betMe collected $4.30 from pot
Plz3betMe: doesn't show hand 
*** SUMMARY ***
Total pot $4.50 | Rake $0.20 
Board [3d Jd 8s]
Seat 1: di0d80 folded before Flop (didn't bet)
Seat 2: zxp12345 folded before Flop (didn't bet)
Seat 3: matiko09 folded before Flop (didn't bet)
Seat 4: Plz3betMe (button) collected ($4.30)
Seat 5: chaps1988 (small blind) folded before Flop
Seat 6: nobu-azabu (big blind) folded on the Flop
Seat 7: Sweden_Pound folded before Flop (didn't bet)
Seat 8: PacPacBum folded before Flop (didn't bet)





PokerStars Hand #150125167095:  Hold'em No Limit ($0.50/$1.00 USD) - 2016/03/10 12:57:09 CET [2016/03/10 6:57:09 ET]
Table 'Saskia' 9-max Seat #8 is the button
Seat 1: Sweden_Pound ($105.66 in chips) 
Seat 3: ccmaster001 ($67.04 in chips) 
Seat 4: Plz3betMe ($93.21 in chips) 
Seat 5: dreded11 ($83.30 in chips) 
Seat 6: matiko09 ($100 in chips) 
Seat 7: stds st ($31.12 in chips) 
Seat 8: chaps1988 ($169.10 in chips) 
Seat 9: tipner ($100.50 in chips) 
tipner: posts small blind $0.50
Sweden_Pound: posts big blind $1
njurg aga: sits out 
*** HOLE CARDS ***
Dealt to matiko09 [Th Kc]
ccmaster001: folds 
Plz3betMe: folds 
dreded11: folds 
matiko09: raises $2 to $3
stds st: folds 
chaps1988: folds 
tipner: folds 
Sweden_Pound: folds 
Uncalled bet ($2) returned to matiko09
matiko09 collected $2.50 from pot
matiko09: doesn't show hand 
*** SUMMARY ***
Total pot $2.50 | Rake $0 
Seat 1: Sweden_Pound (big blind) folded before Flop
Seat 3: ccmaster001 folded before Flop (didn't bet)
Seat 4: Plz3betMe folded before Flop (didn't bet)
Seat 5: dreded11 folded before Flop (didn't bet)
Seat 6: matiko09 collected ($2.50)
Seat 7: stds st folded before Flop (didn't bet)
Seat 8: chaps1988 (button) folded before Flop (didn't bet)
Seat 9: tipner (small blind) folded before Flop





PokerStars Hand #150125167502:  Hold'em No Limit ($0.25/$0.50 USD) - 2016/03/10 12:57:10 CET [2016/03/10 6:57:10 ET]
Table 'Aegina' 9-max Seat #1 is the button
Seat 1: BingoIng0 ($106.62 in chips) 
Seat 4: digimatical ($40.23 in chips) 
Seat 5: Ahangama ($50 in chips) 
Seat 6: matiko09 ($50 in chips) 
Seat 7: Gummio ($122.85 in chips) 
Seat 9: congcongnbnb ($140.96 in chips) 
digimatical: posts small blind $0.25
Ahangama: posts big blind $0.50
ardo888: sits out 
BingoIng0: posts the ante $0.10
digimatical: posts the ante $0.10
Ahangama: posts the ante $0.10
matiko09: posts the ante $0.10
Gummio: posts the ante $0.10
congcongnbnb: posts the ante $0.10
*** HOLE CARDS ***
Dealt to matiko09 [Jh Qs]
matiko09: folds 
Gummio: raises $1.85 to $2.35
congcongnbnb: folds 
BingoIng0: calls $2.35
digimatical: folds 
Ahangama: folds 
*** FLOP *** [Th 3s Ks]
Gummio: checks 
BingoIng0: bets $4.04
Gummio: calls $4.04
*** TURN *** [Th 3s Ks] [Kd]
Gummio: checks 
BingoIng0: bets $9.44
Gummio: folds 
Uncalled bet ($9.44) returned to BingoIng0
BingoIng0 collected $13.49 from pot
BingoIng0: doesn't show hand 
*** SUMMARY ***
Total pot $14.13 | Rake $0.64 
Board [Th 3s Ks Kd]
Seat 1: BingoIng0 (button) collected ($13.49)
Seat 4: digimatical (small blind) folded before Flop
Seat 5: Ahangama (big blind) folded before Flop
Seat 6: matiko09 folded before Flop (didn't bet)
Seat 7: Gummio folded on the Turn
Seat 9: congcongnbnb folded before Flop (didn't bet)





PokerStars Hand #150125174183:  Hold'em No Limit ($1/$2 USD) - 2016/03/10 12:57:25 CET [2016/03/10 6:57:25 ET]
Table 'Rimito II' 9-max Seat #8 is the button
Seat 1: NeedBeat ($213.38 in chips) 
Seat 2: chaps1988 ($202.92 in chips) 
Seat 3: Yaaaazz ($212.32 in chips) 
Seat 4: Zier89 ($250.84 in chips) 
Seat 5: rijger321 ($63 in chips) 
Seat 6: Fish4trips ($200 in chips) 
Seat 7: matiko09 ($204 in chips) 
Seat 8: Olddogtom888 ($160 in chips) 
Seat 9: tipner ($215.42 in chips) 
tipner: posts small blind $1
NeedBeat: posts big blind $2
*** HOLE CARDS ***
Dealt to matiko09 [3h Ks]
chaps1988: folds 
Yaaaazz: folds 
Zier89: folds 
rijger321: raises $4 to $6
Fish4trips: folds 
matiko09: folds 
Olddogtom888: calls $6
tipner: calls $5
NeedBeat: folds 
*** FLOP *** [7d Jc 9s]
tipner: checks 
rijger321: checks 
Olddogtom888: checks 
*** TURN *** [7d Jc 9s] [Kh]
tipner: checks 
rijger321: checks 
Olddogtom888: checks 
*** RIVER *** [7d Jc 9s Kh] [8c]
tipner: checks 
rijger321: bets $12
Olddogtom888: calls $12
tipner: folds 
*** SHOW DOWN ***
rijger321: shows [Td Js] (a straight, Seven to Jack)
Olddogtom888: mucks hand 
rijger321 collected $42.02 from pot
*** SUMMARY ***
Total pot $44 | Rake $1.98 
Board [7d Jc 9s Kh 8c]
Seat 1: NeedBeat (big blind) folded before Flop
Seat 2: chaps1988 folded before Flop (didn't bet)
Seat 3: Yaaaazz folded before Flop (didn't bet)
Seat 4: Zier89 folded before Flop (didn't bet)
Seat 5: rijger321 showed [Td Js] and won ($42.02) with a straight, Seven to Jack
Seat 6: Fish4trips folded before Flop (didn't bet)
Seat 7: matiko09 folded before Flop (didn't bet)
Seat 8: Olddogtom888 (button) mucked [7c Kc]
Seat 9: tipner (small blind) folded on the River





PokerStars Hand #150125181550:  Hold'em No Limit ($0.50/$1.00 USD) - 2016/03/10 12:57:41 CET [2016/03/10 6:57:41 ET]
Table 'Saskia' 9-max Seat #9 is the button
Seat 1: Sweden_Pound ($104.66 in chips) 
Seat 2: njurg aga ($100 in chips) 
Seat 3: ccmaster001 ($67.04 in chips) 
Seat 4: Plz3betMe ($93.21 in chips) 
Seat 5: dreded11 ($83.30 in chips) 
Seat 6: matiko09 ($101.50 in chips) 
Seat 7: stds st ($31.12 in chips) 
Seat 8: chaps1988 ($169.10 in chips) 
Seat 9: tipner ($100 in chips) 
Sweden_Pound: posts small blind $0.50
njurg aga: posts big blind $1
*** HOLE CARDS ***
Dealt to matiko09 [8s Qc]
ccmaster001: folds 
Plz3betMe: folds 
dreded11: folds 
matiko09: folds 
stds st: raises $1.02 to $2.02
chaps1988: raises $2.73 to $4.75
tipner: folds 
Sweden_Pound: folds 
njurg aga: folds 
stds st: folds 
Uncalled bet ($2.73) returned to chaps1988
chaps1988 collected $5.54 from pot
chaps1988: doesn't show hand 
*** SUMMARY ***
Total pot $5.54 | Rake $0 
Seat 1: Sweden_Pound (small blind) folded before Flop
Seat 2: njurg aga (big blind) folded before Flop
Seat 3: ccmaster001 folded before Flop (didn't bet)
Seat 4: Plz3betMe folded before Flop (didn't bet)
Seat 5: dreded11 folded before Flop (didn't bet)
Seat 6: matiko09 folded before Flop (didn't bet)
Seat 7: stds st folded before Flop
Seat 8: chaps1988 collected ($5.54)
Seat 9: tipner (button) folded before Flop (didn't bet)





PokerStars Hand #150125188297:  Hold'em No Limit ($0.25/$0.50 USD) - 2016/03/10 12:57:56 CET [2016/03/10 6:57:56 ET]
Table 'Aegina' 9-max Seat #4 is the button
Seat 1: BingoIng0 ($113.62 in chips) 
Seat 4: digimatical ($39.88 in chips) 
Seat 5: Ahangama ($50 in chips) 
Seat 6: matiko09 ($50 in chips) 
Seat 7: Gummio ($116.36 in chips) 
Seat 9: congcongnbnb ($140.86 in chips) 
Ahangama: posts small blind $0.25
matiko09: posts big blind $0.50
ardo888: sits out 
BingoIng0: posts the ante $0.10
digimatical: posts the ante $0.10
Ahangama: posts the ante $0.10
matiko09: posts the ante $0.10
Gummio: posts the ante $0.10
congcongnbnb: posts the ante $0.10
*** HOLE CARDS ***
Dealt to matiko09 [4c Ac]
Gummio: folds 
congcongnbnb: raises $1.50 to $2
BingoIng0: folds 
digimatical: folds 
Ahangama: folds 
matiko09: folds 
Uncalled bet ($1.50) returned to congcongnbnb
congcongnbnb collected $1.85 from pot
congcongnbnb: doesn't show hand 
*** SUMMARY ***
Total pot $1.85 | Rake $0 
Seat 1: BingoIng0 folded before Flop (didn't bet)
Seat 4: digimatical (button) folded before Flop (didn't bet)
Seat 5: Ahangama (small blind) folded before Flop
Seat 6: matiko09 (big blind) folded before Flop
Seat 7: Gummio folded before Flop (didn't bet)
Seat 9: congcongnbnb collected ($1.85)





PokerStars Hand #150125191480:  Hold'em No Limit ($0.50/$1.00 USD) - 2016/03/10 12:58:03 CET [2016/03/10 6:58:03 ET]
Table 'Liriope II' 9-max Seat #5 is the button
Seat 1: di0d80 ($108.39 in chips) 
Seat 2: zxp12345 ($51.72 in chips) 
Seat 3: matiko09 ($144.09 in chips) 
Seat 4: Plz3betMe ($57.31 in chips) 
Seat 5: chaps1988 ($135.68 in chips) 
Seat 6: nobu-azabu ($168.28 in chips) 
Seat 7: Sweden_Pound ($100 in chips) 
Seat 8: PacPacBum ($100 in chips) 
nobu-azabu: posts small blind $0.50
Sweden_Pound: posts big blind $1
tipner: sits out 
*** HOLE CARDS ***
Dealt to matiko09 [2d Jd]
PacPacBum: raises $1.04 to $2.04
di0d80: folds 
zxp12345: folds 
matiko09: folds 
Plz3betMe: raises $3.06 to $5.10
chaps1988: folds 
nobu-azabu: folds 
Sweden_Pound: folds 
PacPacBum: raises $7.90 to $13
Plz3betMe: folds 
Uncalled bet ($7.90) returned to PacPacBum
PacPacBum collected $11.70 from pot
PacPacBum: doesn't show hand 
*** SUMMARY ***
Total pot $11.70 | Rake $0 
Seat 1: di0d80 folded before Flop (didn't bet)
Seat 2: zxp12345 folded before Flop (didn't bet)
Seat 3: matiko09 folded before Flop (didn't bet)
Seat 4: Plz3betMe folded before Flop
Seat 5: chaps1988 (button) folded before Flop (didn't bet)
Seat 6: nobu-azabu (small blind) folded before Flop
Seat 7: Sweden_Pound (big blind) folded before Flop
Seat 8: PacPacBum collected ($11.70)





PokerStars Hand #150125198042:  Hold'em No Limit ($0.25/$0.50 USD) - 2016/03/10 12:58:18 CET [2016/03/10 6:58:18 ET]
Table 'Aegina' 9-max Seat #5 is the button
Seat 1: BingoIng0 ($113.52 in chips) 
Seat 4: digimatical ($39.78 in chips) 
Seat 5: Ahangama ($50 in chips) 
Seat 6: matiko09 ($50 in chips) 
Seat 7: Gummio ($116.26 in chips) 
Seat 9: congcongnbnb ($142.11 in chips) 
matiko09: posts small blind $0.25
Gummio: posts big blind $0.50
ardo888: sits out 
BingoIng0: posts the ante $0.10
digimatical: posts the ante $0.10
Ahangama: posts the ante $0.10
matiko09: posts the ante $0.10
Gummio: posts the ante $0.10
congcongnbnb: posts the ante $0.10
*** HOLE CARDS ***
Dealt to matiko09 [Ts As]
congcongnbnb: folds 
BingoIng0: folds 
digimatical: raises $0.50 to $1
Ahangama: folds 
matiko09: calls $0.75
Gummio: calls $0.50
*** FLOP *** [5c 6d 7h]
matiko09: checks 
Gummio: checks 
dvutavr joins the table at seat #2 
digimatical: bets $2
matiko09: folds 
Gummio: folds 
Uncalled bet ($2) returned to digimatical
digimatical collected $3.44 from pot
*** SUMMARY ***
Total pot $3.60 | Rake $0.16 
Board [5c 6d 7h]
Seat 1: BingoIng0 folded before Flop (didn't bet)
Seat 4: digimatical collected ($3.44)
Seat 5: Ahangama (button) folded before Flop (didn't bet)
Seat 6: matiko09 (small blind) folded on the Flop
Seat 7: Gummio (big blind) folded on the Flop
Seat 9: congcongnbnb folded before Flop (didn't bet)





PokerStars Hand #150125203900:  Hold'em No Limit ($1/$2 USD) - 2016/03/10 12:58:31 CET [2016/03/10 6:58:31 ET]
Table 'Rimito II' 9-max Seat #9 is the button
Seat 1: NeedBeat ($211.38 in chips) 
Seat 2: chaps1988 ($202.92 in chips) 
Seat 3: Yaaaazz ($212.32 in chips) 
Seat 4: Zier89 ($250.84 in chips) 
Seat 5: rijger321 ($87.02 in chips) 
Seat 6: Fish4trips ($200 in chips) 
Seat 7: matiko09 ($204 in chips) 
Seat 8: Olddogtom888 ($142 in chips) 
Seat 9: tipner ($209.42 in chips) 
NeedBeat: posts small blind $1
chaps1988: posts big blind $2
*** HOLE CARDS ***
Dealt to matiko09 [Qh 5s]
Yaaaazz: raises $4 to $6
Zier89: calls $6
rijger321: folds 
Fish4trips: folds 
matiko09: folds 
Olddogtom888: calls $6
tipner: calls $6
NeedBeat: folds 
chaps1988: folds 
*** FLOP *** [As Qc Ah]
Yaaaazz: checks 
Zier89: checks 
Olddogtom888: checks 
tipner: checks 
*** TURN *** [As Qc Ah] [3s]
Yaaaazz: checks 
Zier89: checks 
Olddogtom888: bets $12
tipner: folds 
Yaaaazz: calls $12
Zier89: calls $12
*** RIVER *** [As Qc Ah 3s] [2s]
Yaaaazz: bets $57.19
Zier89: calls $57.19
Olddogtom888: folds 
*** SHOW DOWN ***
Yaaaazz: shows [Js Ts] (a flush, Ace high)
Zier89: mucks hand 
Yaaaazz collected $174.58 from pot
*** SUMMARY ***
Total pot $177.38 | Rake $2.80 
Board [As Qc Ah 3s 2s]
Seat 1: NeedBeat (small blind) folded before Flop
Seat 2: chaps1988 (big blind) folded before Flop
Seat 3: Yaaaazz showed [Js Ts] and won ($174.58) with a flush, Ace high
Seat 4: Zier89 mucked [Kh Ad]
Seat 5: rijger321 folded before Flop (didn't bet)
Seat 6: Fish4trips folded before Flop (didn't bet)
Seat 7: matiko09 folded before Flop (didn't bet)
Seat 8: Olddogtom888 folded on the River
Seat 9: tipner (button) folded on the Turn





PokerStars Hand #150125212670:  Hold'em No Limit ($0.50/$1.00 USD) - 2016/03/10 12:58:51 CET [2016/03/10 6:58:51 ET]
Table 'Saskia' 9-max Seat #1 is the button
Seat 1: Sweden_Pound ($104.16 in chips) 
Seat 2: njurg aga ($99 in chips) 
Seat 3: ccmaster001 ($67.04 in chips) 
Seat 4: Plz3betMe ($93.21 in chips) 
Seat 5: dreded11 ($83.30 in chips) 
Seat 6: matiko09 ($101.50 in chips) 
Seat 7: stds st ($29.10 in chips) 
Seat 8: chaps1988 ($172.62 in chips) 
Seat 9: tipner ($100 in chips) 
njurg aga: posts small blind $0.50
ccmaster001: posts big blind $1
*** HOLE CARDS ***
Dealt to matiko09 [3s Ah]
Plz3betMe: folds 
dreded11: folds 
matiko09: folds 
stds st: folds 
chaps1988: folds 
tipner: folds 
Sweden_Pound: raises $1 to $2
njurg aga: folds 
ccmaster001: folds 
Uncalled bet ($1) returned to Sweden_Pound
Sweden_Pound collected $2.50 from pot
Sweden_Pound: doesn't show hand 
*** SUMMARY ***
Total pot $2.50 | Rake $0 
Seat 1: Sweden_Pound (button) collected ($2.50)
Seat 2: njurg aga (small blind) folded before Flop
Seat 3: ccmaster001 (big blind) folded before Flop
Seat 4: Plz3betMe folded before Flop (didn't bet)
Seat 5: dreded11 folded before Flop (didn't bet)
Seat 6: matiko09 folded before Flop (didn't bet)
Seat 7: stds st folded before Flop (didn't bet)
Seat 8: chaps1988 folded before Flop (didn't bet)
Seat 9: tipner folded before Flop (didn't bet)





PokerStars Hand #150125215845:  Hold'em No Limit ($0.25/$0.50 USD) - 2016/03/10 12:58:58 CET [2016/03/10 6:58:58 ET]
Table 'Aegina' 9-max Seat #6 is the button
Seat 1: BingoIng0 ($113.42 in chips) 
Seat 4: digimatical ($42.12 in chips) 
Seat 5: Ahangama ($50 in chips) 
Seat 6: matiko09 ($50 in chips) 
Seat 7: Gummio ($115.16 in chips) 
Seat 9: congcongnbnb ($142.01 in chips) 
Gummio: posts small blind $0.25
congcongnbnb: posts big blind $0.50
dvutavr: sits out 
BingoIng0: posts the ante $0.10
digimatical: posts the ante $0.10
Ahangama: posts the ante $0.10
matiko09: posts the ante $0.10
Gummio: posts the ante $0.10
congcongnbnb: posts the ante $0.10
*** HOLE CARDS ***
Dealt to matiko09 [Qs Ts]
BingoIng0: folds 
digimatical: folds 
Ahangama: folds 
matiko09: raises $0.75 to $1.25
Gummio: folds 
congcongnbnb: calls $0.75
*** FLOP *** [Kc 4d Js]
congcongnbnb: checks 
matiko09: bets $2.08
congcongnbnb: folds 
Uncalled bet ($2.08) returned to matiko09
matiko09 collected $3.20 from pot
matiko09: doesn't show hand 
*** SUMMARY ***
Total pot $3.35 | Rake $0.15 
Board [Kc 4d Js]
Seat 1: BingoIng0 folded before Flop (didn't bet)
Seat 4: digimatical folded before Flop (didn't bet)
Seat 5: Ahangama folded before Flop (didn't bet)
Seat 6: matiko09 (button) collected ($3.20)
Seat 7: Gummio (small blind) folded before Flop
Seat 9: congcongnbnb (big blind) folded on the Flop





PokerStars Hand #150125219264:  Hold'em No Limit ($0.50/$1.00 USD) - 2016/03/10 12:59:05 CET [2016/03/10 6:59:05 ET]
Table 'Liriope II' 9-max Seat #6 is the button
Seat 1: di0d80 ($108.39 in chips) 
Seat 2: zxp12345 ($51.72 in chips) 
Seat 3: matiko09 ($144.09 in chips) 
Seat 4: Plz3betMe ($52.21 in chips) 
Seat 5: chaps1988 ($135.68 in chips) 
Seat 6: nobu-azabu ($167.78 in chips) 
Seat 7: Sweden_Pound ($100 in chips) 
Seat 8: PacPacBum ($106.60 in chips) 
Sweden_Pound: posts small blind $0.50
PacPacBum: posts big blind $1
tipner: sits out 
*** HOLE CARDS ***
Dealt to matiko09 [9c 3d]
di0d80: folds 
zxp12345: calls $1
matiko09: folds 
Plz3betMe: folds 
chaps1988: folds 
nobu-azabu: calls $1
Sweden_Pound: calls $0.50
PacPacBum: checks 
*** FLOP *** [3h 7s Tc]
Sweden_Pound: checks 
PacPacBum: checks 
zxp12345: bets $1.91
nobu-azabu: calls $1.91
Sweden_Pound: folds 
PacPacBum: folds 
*** TURN *** [3h 7s Tc] [9s]
zxp12345: checks 
nobu-azabu: checks 
*** RIVER *** [3h 7s Tc 9s] [As]
zxp12345: checks 
nobu-azabu: checks 
*** SHOW DOWN ***
zxp12345: shows [Th Kc] (a pair of Tens)
nobu-azabu: shows [Kd Td] (a pair of Tens)
zxp12345 collected $3.74 from pot
nobu-azabu collected $3.73 from pot
*** SUMMARY ***
Total pot $7.82 | Rake $0.35 
Board [3h 7s Tc 9s As]
Seat 1: di0d80 folded before Flop (didn't bet)
Seat 2: zxp12345 showed [Th Kc] and won ($3.74) with a pair of Tens
Seat 3: matiko09 folded before Flop (didn't bet)
Seat 4: Plz3betMe folded before Flop (didn't bet)
Seat 5: chaps1988 folded before Flop (didn't bet)
Seat 6: nobu-azabu (button) showed [Kd Td] and won ($3.73) with a pair of Tens
Seat 7: Sweden_Pound (small blind) folded on the Flop
Seat 8: PacPacBum (big blind) folded on the Flop





PokerStars Hand #150125223954:  Hold'em No Limit ($0.50/$1.00 USD) - 2016/03/10 12:59:16 CET [2016/03/10 6:59:16 ET]
Table 'Saskia' 9-max Seat #2 is the button
Seat 1: Sweden_Pound ($105.66 in chips) 
Seat 2: njurg aga ($98.50 in chips) 
Seat 3: ccmaster001 ($66.04 in chips) 
Seat 4: Plz3betMe ($93.21 in chips) 
Seat 5: dreded11 ($83.30 in chips) 
Seat 6: matiko09 ($101.50 in chips) 
Seat 7: stds st ($29.10 in chips) 
Seat 8: chaps1988 ($172.62 in chips) 
Seat 9: tipner ($100 in chips) 
ccmaster001: posts small blind $0.50
Plz3betMe: posts big blind $1
*** HOLE CARDS ***
Dealt to matiko09 [6c 8s]
dreded11: folds 
matiko09: folds 
stds st: folds 
chaps1988: folds 
tipner: folds 
Sweden_Pound: folds 
njurg aga: raises $1 to $2
ccmaster001: folds 
Plz3betMe: folds 
Uncalled bet ($1) returned to njurg aga
njurg aga collected $2.50 from pot
njurg aga: doesn't show hand 
*** SUMMARY ***
Total pot $2.50 | Rake $0 
Seat 1: Sweden_Pound folded before Flop (didn't bet)
Seat 2: njurg aga (button) collected ($2.50)
Seat 3: ccmaster001 (small blind) folded before Flop
Seat 4: Plz3betMe (big blind) folded before Flop
Seat 5: dreded11 folded before Flop (didn't bet)
Seat 6: matiko09 folded before Flop (didn't bet)
Seat 7: stds st folded before Flop (didn't bet)
Seat 8: chaps1988 folded before Flop (didn't bet)
Seat 9: tipner folded before Flop (didn't bet)





PokerStars Hand #150125231715:  Hold'em No Limit ($0.25/$0.50 USD) - 2016/03/10 12:59:33 CET [2016/03/10 6:59:33 ET]
Table 'Aegina' 9-max Seat #7 is the button
Seat 1: BingoIng0 ($113.32 in chips) 
Seat 4: digimatical ($42.02 in chips) 
Seat 5: Ahangama ($50 in chips) 
Seat 6: matiko09 ($51.85 in chips) 
Seat 7: Gummio ($114.81 in chips) 
Seat 9: congcongnbnb ($140.66 in chips) 
congcongnbnb: posts small blind $0.25
BingoIng0: posts big blind $0.50
dvutavr: sits out 
BingoIng0: posts the ante $0.10
digimatical: posts the ante $0.10
Ahangama: posts the ante $0.10
matiko09: posts the ante $0.10
Gummio: posts the ante $0.10
congcongnbnb: posts the ante $0.10
*** HOLE CARDS ***
Dealt to matiko09 [Qh Tc]
digimatical: raises $1 to $1.50
Ahangama: folds 
matiko09: folds 
mobi1984 joins the table at seat #3 
Gummio: raises $4.35 to $5.85
congcongnbnb: folds 
BingoIng0: folds 
digimatical: calls $4.35
*** FLOP *** [Qc 2c 4c]
digimatical: bets $12.46
Gummio: folds 
Uncalled bet ($12.46) returned to digimatical
digimatical collected $12.46 from pot
*** SUMMARY ***
Total pot $13.05 | Rake $0.59 
Board [Qc 2c 4c]
Seat 1: BingoIng0 (big blind) folded before Flop
Seat 4: digimatical collected ($12.46)
Seat 5: Ahangama folded before Flop (didn't bet)
Seat 6: matiko09 folded before Flop (didn't bet)
Seat 7: Gummio (button) folded on the Flop
Seat 9: congcongnbnb (small blind) folded before Flop





PokerStars Hand #150125233094:  Hold'em No Limit ($0.50/$1.00 USD) - 2016/03/10 12:59:36 CET [2016/03/10 6:59:36 ET]
Table 'Saskia' 9-max Seat #3 is the button
Seat 1: Sweden_Pound ($105.66 in chips) 
Seat 2: njurg aga ($100 in chips) 
Seat 3: ccmaster001 ($65.54 in chips) 
Seat 4: Plz3betMe ($92.21 in chips) 
Seat 5: dreded11 ($83.30 in chips) 
Seat 6: matiko09 ($101.50 in chips) 
Seat 7: stds st ($29.10 in chips) 
Seat 8: chaps1988 ($172.62 in chips) 
Seat 9: tipner ($100 in chips) 
Plz3betMe: posts small blind $0.50
dreded11: posts big blind $1
*** HOLE CARDS ***
Dealt to matiko09 [Kd 9h]
matiko09: folds 
stds st: folds 
chaps1988: folds 
tipner: raises $2 to $3
Sweden_Pound: folds 
njurg aga: folds 
ccmaster001: folds 
Plz3betMe: folds 
dreded11: calls $2
*** FLOP *** [6d 5h 7c]
dreded11: bets $3
tipner: folds 
Uncalled bet ($3) returned to dreded11
dreded11 collected $6.21 from pot
dreded11: doesn't show hand 
*** SUMMARY ***
Total pot $6.50 | Rake $0.29 
Board [6d 5h 7c]
Seat 1: Sweden_Pound folded before Flop (didn't bet)
Seat 2: njurg aga folded before Flop (didn't bet)
Seat 3: ccmaster001 (button) folded before Flop (didn't bet)
Seat 4: Plz3betMe (small blind) folded before Flop
Seat 5: dreded11 (big blind) collected ($6.21)
Seat 6: matiko09 folded before Flop (didn't bet)
Seat 7: stds st folded before Flop (didn't bet)
Seat 8: chaps1988 folded before Flop (didn't bet)
Seat 9: tipner folded on the Flop





PokerStars Hand #150125243383:  Hold'em No Limit ($0.50/$1.00 USD) - 2016/03/10 13:00:00 CET [2016/03/10 7:00:00 ET]
Table 'Liriope II' 9-max Seat #7 is the button
Seat 1: di0d80 ($108.39 in chips) 
Seat 2: zxp12345 ($52.55 in chips) 
Seat 3: matiko09 ($144.09 in chips) 
Seat 4: Plz3betMe ($52.21 in chips) 
Seat 5: chaps1988 ($135.68 in chips) 
Seat 6: nobu-azabu ($168.60 in chips) 
Seat 7: Sweden_Pound ($100 in chips) 
Seat 8: PacPacBum ($105.60 in chips) 
Seat 9: tipner ($112.05 in chips) 
PacPacBum: posts small blind $0.50
tipner: posts big blind $1
*** HOLE CARDS ***
Dealt to matiko09 [7d 2s]
di0d80: folds 
zxp12345: folds 
matiko09: folds 
Plz3betMe: raises $1.50 to $2.50
chaps1988: folds 
nobu-azabu: folds 
Sweden_Pound: folds 
PacPacBum: folds 
tipner: folds 
Uncalled bet ($1.50) returned to Plz3betMe
Plz3betMe collected $2.50 from pot
Plz3betMe: doesn't show hand 
*** SUMMARY ***
Total pot $2.50 | Rake $0 
Seat 1: di0d80 folded before Flop (didn't bet)
Seat 2: zxp12345 folded before Flop (didn't bet)
Seat 3: matiko09 folded before Flop (didn't bet)
Seat 4: Plz3betMe collected ($2.50)
Seat 5: chaps1988 folded before Flop (didn't bet)
Seat 6: nobu-azabu folded before Flop (didn't bet)
Seat 7: Sweden_Pound (button) folded before Flop (didn't bet)
Seat 8: PacPacBum (small blind) folded before Flop
Seat 9: tipner (big blind) folded before Flop





PokerStars Hand #150125252456:  Hold'em No Limit ($0.50/$1.00 USD) - 2016/03/10 13:00:19 CET [2016/03/10 7:00:19 ET]
Table 'Saskia' 9-max Seat #4 is the button
Seat 1: Sweden_Pound ($105.66 in chips) 
Seat 2: njurg aga ($100 in chips) 
Seat 3: ccmaster001 ($65.54 in chips) 
Seat 4: Plz3betMe ($91.71 in chips) 
Seat 5: dreded11 ($86.51 in chips) 
Seat 6: matiko09 ($101.50 in chips) 
Seat 7: stds st ($29.10 in chips) 
Seat 8: chaps1988 ($172.62 in chips) 
Seat 9: tipner ($100 in chips) 
dreded11: posts small blind $0.50
matiko09: posts big blind $1
*** HOLE CARDS ***
Dealt to matiko09 [4c Jd]
stds st: folds 
chaps1988: folds 
tipner: folds 
Sweden_Pound: folds 
njurg aga: folds 
ccmaster001: folds 
Plz3betMe: raises $1 to $2
dreded11: folds 
matiko09: folds 
Uncalled bet ($1) returned to Plz3betMe
Plz3betMe collected $2.50 from pot
Plz3betMe: doesn't show hand 
*** SUMMARY ***
Total pot $2.50 | Rake $0 
Seat 1: Sweden_Pound folded before Flop (didn't bet)
Seat 2: njurg aga folded before Flop (didn't bet)
Seat 3: ccmaster001 folded before Flop (didn't bet)
Seat 4: Plz3betMe (button) collected ($2.50)
Seat 5: dreded11 (small blind) folded before Flop
Seat 6: matiko09 (big blind) folded before Flop
Seat 7: stds st folded before Flop (didn't bet)
Seat 8: chaps1988 folded before Flop (didn't bet)
Seat 9: tipner folded before Flop (didn't bet)





PokerStars Hand #150125257598:  Hold'em No Limit ($0.50/$1.00 USD) - 2016/03/10 13:00:30 CET [2016/03/10 7:00:30 ET]
Table 'Liriope II' 9-max Seat #8 is the button
Seat 1: di0d80 ($108.39 in chips) 
Seat 2: zxp12345 ($52.55 in chips) 
Seat 3: matiko09 ($144.09 in chips) 
Seat 4: Plz3betMe ($53.71 in chips) 
Seat 5: chaps1988 ($135.68 in chips) 
Seat 6: nobu-azabu ($168.60 in chips) 
Seat 7: Sweden_Pound ($100 in chips) 
Seat 8: PacPacBum ($105.10 in chips) 
Seat 9: tipner ($111.05 in chips) 
tipner: posts small blind $0.50
di0d80: posts big blind $1
*** HOLE CARDS ***
Dealt to matiko09 [4h Qc]
zxp12345: calls $1
matiko09: folds 
Plz3betMe: folds 
chaps1988: folds 
nobu-azabu: folds 
Sweden_Pound: raises $3 to $4
PacPacBum: folds 
tipner: folds 
di0d80: folds 
zxp12345: folds 
Uncalled bet ($3) returned to Sweden_Pound
Sweden_Pound collected $3.50 from pot
Sweden_Pound: doesn't show hand 
*** SUMMARY ***
Total pot $3.50 | Rake $0 
Seat 1: di0d80 (big blind) folded before Flop
Seat 2: zxp12345 folded before Flop
Seat 3: matiko09 folded before Flop (didn't bet)
Seat 4: Plz3betMe folded before Flop (didn't bet)
Seat 5: chaps1988 folded before Flop (didn't bet)
Seat 6: nobu-azabu folded before Flop (didn't bet)
Seat 7: Sweden_Pound collected ($3.50)
Seat 8: PacPacBum (button) folded before Flop (didn't bet)
Seat 9: tipner (small blind) folded before Flop





PokerStars Hand #150125259451:  Hold'em No Limit ($0.25/$0.50 USD) - 2016/03/10 13:00:34 CET [2016/03/10 7:00:34 ET]
Table 'Aegina' 9-max Seat #9 is the button
Seat 1: BingoIng0 ($112.72 in chips) 
Seat 2: dvutavr ($125 in chips) 
Seat 3: mobi1984 ($50 in chips) 
Seat 4: digimatical ($48.53 in chips) 
Seat 5: Ahangama ($50 in chips) 
Seat 6: matiko09 ($51.75 in chips) 
Seat 7: Gummio ($108.86 in chips) 
Seat 9: congcongnbnb ($140.31 in chips) 
BingoIng0: posts small blind $0.25
dvutavr: posts big blind $0.50
mobi1984: posts big blind $0.50
BingoIng0: posts the ante $0.10
dvutavr: posts the ante $0.10
mobi1984: posts the ante $0.10
digimatical: posts the ante $0.10
Ahangama: posts the ante $0.10
matiko09: posts the ante $0.10
Gummio: posts the ante $0.10
congcongnbnb: posts the ante $0.10
*** HOLE CARDS ***
Dealt to matiko09 [4d 9s]
mobi1984: checks 
digimatical: folds 
Ahangama: folds 
matiko09: folds 
Gummio: folds 
congcongnbnb: raises $2 to $2.50
BingoIng0: calls $2.25
dvutavr: calls $2
mobi1984: calls $2
*** FLOP *** [5h 2d 8c]
BingoIng0: checks 
dvutavr: checks 
mobi1984: bets $8
congcongnbnb: calls $8
BingoIng0: folds 
dvutavr: folds 
*** TURN *** [5h 2d 8c] [Js]
mobi1984: bets $14
congcongnbnb: raises $53 to $67
mobi1984: folds 
Uncalled bet ($53) returned to congcongnbnb
congcongnbnb collected $52.33 from pot
congcongnbnb: doesn't show hand 
*** SUMMARY ***
Total pot $54.80 | Rake $2.47 
Board [5h 2d 8c Js]
Seat 1: BingoIng0 (small blind) folded on the Flop
Seat 2: dvutavr (big blind) folded on the Flop
Seat 3: mobi1984 folded on the Turn
Seat 4: digimatical folded before Flop (didn't bet)
Seat 5: Ahangama folded before Flop (didn't bet)
Seat 6: matiko09 folded before Flop (didn't bet)
Seat 7: Gummio folded before Flop (didn't bet)
Seat 9: congcongnbnb (button) collected ($52.33)





PokerStars Hand #150125261886:  Hold'em No Limit ($1/$2 USD) - 2016/03/10 13:00:40 CET [2016/03/10 7:00:40 ET]
Table 'Rimito II' 9-max Seat #1 is the button
Seat 1: NeedBeat ($210.38 in chips) 
Seat 2: chaps1988 ($200.92 in chips) 
Seat 3: Yaaaazz ($311.71 in chips) 
Seat 4: Zier89 ($175.65 in chips) 
Seat 5: rijger321 ($87.02 in chips) 
Seat 6: Fish4trips ($200 in chips) 
Seat 7: matiko09 ($204 in chips) 
Seat 8: Olddogtom888 ($124 in chips) 
Seat 9: tipner ($203.42 in chips) 
chaps1988: posts small blind $1
Yaaaazz: posts big blind $2
*** HOLE CARDS ***
Dealt to matiko09 [9c 7s]
Zier89: folds 
rijger321: folds 
Fish4trips: folds 
matiko09: folds 
Olddogtom888: folds 
tipner: folds 
NeedBeat: raises $2 to $4
chaps1988: raises $12 to $16
Yaaaazz: folds 
NeedBeat: raises $20 to $36
chaps1988: folds 
Uncalled bet ($20) returned to NeedBeat
NeedBeat collected $34 from pot
NeedBeat: doesn't show hand 
*** SUMMARY ***
Total pot $34 | Rake $0 
Seat 1: NeedBeat (button) collected ($34)
Seat 2: chaps1988 (small blind) folded before Flop
Seat 3: Yaaaazz (big blind) folded before Flop
Seat 4: Zier89 folded before Flop (didn't bet)
Seat 5: rijger321 folded before Flop (didn't bet)
Seat 6: Fish4trips folded before Flop (didn't bet)
Seat 7: matiko09 folded before Flop (didn't bet)
Seat 8: Olddogtom888 folded before Flop (didn't bet)
Seat 9: tipner folded before Flop (didn't bet)





PokerStars Hand #150125270959:  Hold'em No Limit ($0.50/$1.00 USD) - 2016/03/10 13:00:59 CET [2016/03/10 7:00:59 ET]
Table 'Saskia' 9-max Seat #5 is the button
Seat 1: Sweden_Pound ($105.66 in chips) 
Seat 2: njurg aga ($100 in chips) 
Seat 3: ccmaster001 ($65.54 in chips) 
Seat 4: Plz3betMe ($93.21 in chips) 
Seat 5: dreded11 ($86.01 in chips) 
Seat 6: matiko09 ($100.50 in chips) 
Seat 7: stds st ($29.10 in chips) 
Seat 8: chaps1988 ($172.62 in chips) 
Seat 9: tipner ($100 in chips) 
matiko09: posts small blind $0.50
stds st: posts big blind $1
*** HOLE CARDS ***
Dealt to matiko09 [2s 8c]
chaps1988: folds 
tipner: folds 
Sweden_Pound: folds 
njurg aga: raises $1 to $2
ccmaster001: calls $2
Plz3betMe: calls $2
dreded11: calls $2
matiko09: folds 
stds st: folds 
*** FLOP *** [6s 4c 6d]
njurg aga: bets $9.07
ccmaster001: folds 
Plz3betMe: folds 
dreded11: folds 
Uncalled bet ($9.07) returned to njurg aga
njurg aga collected $9.07 from pot
njurg aga: doesn't show hand 
*** SUMMARY ***
Total pot $9.50 | Rake $0.43 
Board [6s 4c 6d]
Seat 1: Sweden_Pound folded before Flop (didn't bet)
Seat 2: njurg aga collected ($9.07)
Seat 3: ccmaster001 folded on the Flop
Seat 4: Plz3betMe folded on the Flop
Seat 5: dreded11 (button) folded on the Flop
Seat 6: matiko09 (small blind) folded before Flop
Seat 7: stds st (big blind) folded before Flop
Seat 8: chaps1988 folded before Flop (didn't bet)
Seat 9: tipner folded before Flop (didn't bet)





PokerStars Hand #150125280207:  Hold'em No Limit ($0.50/$1.00 USD) - 2016/03/10 13:01:19 CET [2016/03/10 7:01:19 ET]
Table 'Liriope II' 9-max Seat #9 is the button
Seat 1: di0d80 ($107.39 in chips) 
Seat 2: zxp12345 ($51.55 in chips) 
Seat 3: matiko09 ($144.09 in chips) 
Seat 4: Plz3betMe ($53.71 in chips) 
Seat 5: chaps1988 ($135.68 in chips) 
Seat 6: nobu-azabu ($168.60 in chips) 
Seat 7: Sweden_Pound ($102.50 in chips) 
Seat 8: PacPacBum ($105.10 in chips) 
Seat 9: tipner ($110.55 in chips) 
di0d80: posts small blind $0.50
zxp12345: posts big blind $1
*** HOLE CARDS ***
Dealt to matiko09 [Ks Kd]
matiko09: raises $2 to $3
Plz3betMe: folds 
chaps1988: folds 
nobu-azabu: folds 
Sweden_Pound: folds 
PacPacBum: folds 
tipner: folds 
di0d80: folds 
zxp12345: folds 
Uncalled bet ($2) returned to matiko09
matiko09 collected $2.50 from pot
matiko09: doesn't show hand 
*** SUMMARY ***
Total pot $2.50 | Rake $0 
Seat 1: di0d80 (small blind) folded before Flop
Seat 2: zxp12345 (big blind) folded before Flop
Seat 3: matiko09 collected ($2.50)
Seat 4: Plz3betMe folded before Flop (didn't bet)
Seat 5: chaps1988 folded before Flop (didn't bet)
Seat 6: nobu-azabu folded before Flop (didn't bet)
Seat 7: Sweden_Pound folded before Flop (didn't bet)
Seat 8: PacPacBum folded before Flop (didn't bet)
Seat 9: tipner (button) folded before Flop (didn't bet)





PokerStars Hand #150125293178:  Hold'em No Limit ($0.50/$1.00 USD) - 2016/03/10 13:01:45 CET [2016/03/10 7:01:45 ET]
Table 'Liriope II' 9-max Seat #1 is the button
Seat 1: di0d80 ($106.89 in chips) 
Seat 2: zxp12345 ($50.55 in chips) 
Seat 3: matiko09 ($145.59 in chips) 
Seat 4: Plz3betMe ($53.71 in chips) 
Seat 5: chaps1988 ($135.68 in chips) 
Seat 6: nobu-azabu ($168.60 in chips) 
Seat 7: Sweden_Pound ($102.50 in chips) 
Seat 8: PacPacBum ($105.10 in chips) 
Seat 9: tipner ($110.55 in chips) 
zxp12345: posts small blind $0.50
matiko09: posts big blind $1
*** HOLE CARDS ***
Dealt to matiko09 [8s 3s]
Plz3betMe: folds 
chaps1988: folds 
nobu-azabu: folds 
Sweden_Pound: folds 
PacPacBum: folds 
tipner: folds 
di0d80: folds 
zxp12345: folds 
Uncalled bet ($0.50) returned to matiko09
matiko09 collected $1 from pot
matiko09: doesn't show hand 
*** SUMMARY ***
Total pot $1 | Rake $0 
Seat 1: di0d80 (button) folded before Flop (didn't bet)
Seat 2: zxp12345 (small blind) folded before Flop
Seat 3: matiko09 (big blind) collected ($1)
Seat 4: Plz3betMe folded before Flop (didn't bet)
Seat 5: chaps1988 folded before Flop (didn't bet)
Seat 6: nobu-azabu folded before Flop (didn't bet)
Seat 7: Sweden_Pound folded before Flop (didn't bet)
Seat 8: PacPacBum folded before Flop (didn't bet)
Seat 9: tipner folded before Flop (didn't bet)





PokerStars Hand #150125303095:  Hold'em No Limit ($1/$2 USD) - 2016/03/10 13:02:04 CET [2016/03/10 7:02:04 ET]
Table 'Rimito II' 9-max Seat #2 is the button
Seat 1: NeedBeat ($228.38 in chips) 
Seat 2: chaps1988 ($200 in chips) 
Seat 3: Yaaaazz ($309.71 in chips) 
Seat 4: Zier89 ($175.65 in chips) 
Seat 5: rijger321 ($87.02 in chips) 
Seat 6: Fish4trips ($200 in chips) 
Seat 7: matiko09 ($204 in chips) 
Seat 8: Olddogtom888 ($124 in chips) 
Seat 9: tipner ($203.42 in chips) 
Yaaaazz: posts small blind $1
Zier89: posts big blind $2
*** HOLE CARDS ***
Dealt to matiko09 [4s 7s]
rijger321: folds 
Fish4trips: folds 
matiko09: folds 
Olddogtom888: calls $2
tipner: folds 
NeedBeat: raises $6 to $8
chaps1988: folds 
Yaaaazz: folds 
Zier89: folds 
Olddogtom888: calls $6
*** FLOP *** [9d 2s 2d]
Olddogtom888: checks 
NeedBeat: bets $12
Olddogtom888: raises $15 to $27
NeedBeat: calls $15
*** TURN *** [9d 2s 2d] [Kc]
Olddogtom888: bets $56
NeedBeat: folds 
Uncalled bet ($56) returned to Olddogtom888
Olddogtom888 collected $70.20 from pot
Olddogtom888: doesn't show hand 
*** SUMMARY ***
Total pot $73 | Rake $2.80 
Board [9d 2s 2d Kc]
Seat 1: NeedBeat folded on the Turn
Seat 2: chaps1988 (button) folded before Flop (didn't bet)
Seat 3: Yaaaazz (small blind) folded before Flop
Seat 4: Zier89 (big blind) folded before Flop
Seat 5: rijger321 folded before Flop (didn't bet)
Seat 6: Fish4trips folded before Flop (didn't bet)
Seat 7: matiko09 folded before Flop (didn't bet)
Seat 8: Olddogtom888 collected ($70.20)
Seat 9: tipner folded before Flop (didn't bet)





PokerStars Hand #150125302968:  Hold'em No Limit ($0.50/$1.00 USD) - 2016/03/10 13:02:04 CET [2016/03/10 7:02:04 ET]
Table 'Saskia' 9-max Seat #6 is the button
Seat 1: Sweden_Pound ($105.66 in chips) 
Seat 2: njurg aga ($107.07 in chips) 
Seat 3: ccmaster001 ($63.54 in chips) 
Seat 4: Plz3betMe ($91.21 in chips) 
Seat 5: dreded11 ($84.01 in chips) 
Seat 6: matiko09 ($100 in chips) 
Seat 7: stds st ($28.10 in chips) 
Seat 8: chaps1988 ($172.62 in chips) 
Seat 9: tipner ($100 in chips) 
stds st: posts small blind $0.50
chaps1988: posts big blind $1
*** HOLE CARDS ***
Dealt to matiko09 [7d 9c]
tipner: folds 
Sweden_Pound: folds 
njurg aga: folds 
ccmaster001: raises $1 to $2
Plz3betMe: folds 
dreded11: folds 
matiko09: folds 
stds st: folds 
chaps1988: folds 
Uncalled bet ($1) returned to ccmaster001
ccmaster001 collected $2.50 from pot
ccmaster001: doesn't show hand 
*** SUMMARY ***
Total pot $2.50 | Rake $0 
Seat 1: Sweden_Pound folded before Flop (didn't bet)
Seat 2: njurg aga folded before Flop (didn't bet)
Seat 3: ccmaster001 collected ($2.50)
Seat 4: Plz3betMe folded before Flop (didn't bet)
Seat 5: dreded11 folded before Flop (didn't bet)
Seat 6: matiko09 (button) folded before Flop (didn't bet)
Seat 7: stds st (small blind) folded before Flop
Seat 8: chaps1988 (big blind) folded before Flop
Seat 9: tipner folded before Flop (didn't bet)





PokerStars Hand #150125305750:  Hold'em No Limit ($0.50/$1.00 USD) - 2016/03/10 13:02:09 CET [2016/03/10 7:02:09 ET]
Table 'Liriope II' 9-max Seat #2 is the button
Seat 1: di0d80 ($106.89 in chips) 
Seat 2: zxp12345 ($50.05 in chips) 
Seat 3: matiko09 ($146.09 in chips) 
Seat 4: Plz3betMe ($53.71 in chips) 
Seat 5: chaps1988 ($135.68 in chips) 
Seat 6: nobu-azabu ($168.60 in chips) 
Seat 7: Sweden_Pound ($102.50 in chips) 
Seat 8: PacPacBum ($105.10 in chips) 
Seat 9: tipner ($110.55 in chips) 
matiko09: posts small blind $0.50
Plz3betMe: posts big blind $1
*** HOLE CARDS ***
Dealt to matiko09 [8s Js]
chaps1988: folds 
nobu-azabu: folds 
Sweden_Pound: folds 
PacPacBum: folds 
tipner: folds 
di0d80: folds 
zxp12345: calls $1
matiko09: calls $0.50
Plz3betMe: checks 
*** FLOP *** [4c 3s 9c]
matiko09: checks 
Plz3betMe: checks 
zxp12345: bets $1.43
matiko09: folds 
Plz3betMe: raises $6.57 to $8
zxp12345: calls $6.57
*** TURN *** [4c 3s 9c] [Jd]
Plz3betMe: checks 
zxp12345: bets $9.07
Plz3betMe: raises $35.64 to $44.71 and is all-in
zxp12345: folds 
Uncalled bet ($35.64) returned to Plz3betMe
Plz3betMe collected $35.47 from pot
Plz3betMe: doesn't show hand 
*** SUMMARY ***
Total pot $37.14 | Rake $1.67 
Board [4c 3s 9c Jd]
Seat 1: di0d80 folded before Flop (didn't bet)
Seat 2: zxp12345 (button) folded on the Turn
Seat 3: matiko09 (small blind) folded on the Flop
Seat 4: Plz3betMe (big blind) collected ($35.47)
Seat 5: chaps1988 folded before Flop (didn't bet)
Seat 6: nobu-azabu folded before Flop (didn't bet)
Seat 7: Sweden_Pound folded before Flop (didn't bet)
Seat 8: PacPacBum folded before Flop (didn't bet)
Seat 9: tipner folded before Flop (didn't bet)





PokerStars Hand #150125306212:  Hold'em No Limit ($0.25/$0.50 USD) - 2016/03/10 13:02:10 CET [2016/03/10 7:02:10 ET]
Table 'Aegina' 9-max Seat #1 is the button
Seat 1: BingoIng0 ($110.12 in chips) 
Seat 2: dvutavr ($122.40 in chips) 
Seat 3: mobi1984 ($25.40 in chips) 
Seat 4: digimatical ($48.43 in chips) 
Seat 5: Ahangama ($50 in chips) 
Seat 6: matiko09 ($51.65 in chips) 
Seat 7: Gummio ($108.76 in chips) 
Seat 9: congcongnbnb ($168.04 in chips) 
dvutavr: posts small blind $0.25
mobi1984: posts big blind $0.50
BingoIng0: posts the ante $0.10
dvutavr: posts the ante $0.10
mobi1984: posts the ante $0.10
digimatical: posts the ante $0.10
Ahangama: posts the ante $0.10
matiko09: posts the ante $0.10
Gummio: posts the ante $0.10
congcongnbnb: posts the ante $0.10
*** HOLE CARDS ***
Dealt to matiko09 [3d 9h]
digimatical: raises $0.50 to $1
Ahangama: folds 
matiko09: folds 
Gummio: folds 
congcongnbnb: folds 
BingoIng0: folds 
dvutavr: folds 
mobi1984: calls $0.50
*** FLOP *** [Ts 3c 7d]
mobi1984: checks 
digimatical: bets $2
mobi1984: folds 
Uncalled bet ($2) returned to digimatical
digimatical collected $2.91 from pot
*** SUMMARY ***
Total pot $3.05 | Rake $0.14 
Board [Ts 3c 7d]
Seat 1: BingoIng0 (button) folded before Flop (didn't bet)
Seat 2: dvutavr (small blind) folded before Flop
Seat 3: mobi1984 (big blind) folded on the Flop
Seat 4: digimatical collected ($2.91)
Seat 5: Ahangama folded before Flop (didn't bet)
Seat 6: matiko09 folded before Flop (didn't bet)
Seat 7: Gummio folded before Flop (didn't bet)
Seat 9: congcongnbnb folded before Flop (didn't bet)





PokerStars Hand #150125317628:  Hold'em No Limit ($0.50/$1.00 USD) - 2016/03/10 13:02:33 CET [2016/03/10 7:02:33 ET]
Table 'Saskia' 9-max Seat #7 is the button
Seat 1: Sweden_Pound ($105.66 in chips) 
Seat 2: njurg aga ($107.07 in chips) 
Seat 3: ccmaster001 ($65.04 in chips) 
Seat 4: Plz3betMe ($91.21 in chips) 
Seat 5: dreded11 ($84.01 in chips) 
Seat 6: matiko09 ($100 in chips) 
Seat 7: stds st ($27.60 in chips) 
Seat 8: chaps1988 ($171.62 in chips) 
Seat 9: tipner ($100 in chips) 
chaps1988: posts small blind $0.50
tipner: posts big blind $1
*** HOLE CARDS ***
Dealt to matiko09 [7c Qd]
Sweden_Pound: folds 
njurg aga: folds 
ccmaster001: folds 
Plz3betMe: raises $1.50 to $2.50
dreded11: folds 
matiko09: folds 
stds st: calls $2.50
chaps1988: folds 
tipner: folds 
*** FLOP *** [6c 9s 5d]
Plz3betMe: checks 
stds st: bets $4.09
Plz3betMe: calls $4.09
*** TURN *** [6c 9s 5d] [7h]
Plz3betMe: checks 
stds st: checks 
*** RIVER *** [6c 9s 5d 7h] [9c]
Plz3betMe: checks 
stds st: checks 
*** SHOW DOWN ***
Plz3betMe: shows [Kh Ad] (a pair of Nines)
stds st: shows [4c 4d] (two pair, Nines and Fours)
stds st collected $14.02 from pot
*** SUMMARY ***
Total pot $14.68 | Rake $0.66 
Board [6c 9s 5d 7h 9c]
Seat 1: Sweden_Pound folded before Flop (didn't bet)
Seat 2: njurg aga folded before Flop (didn't bet)
Seat 3: ccmaster001 folded before Flop (didn't bet)
Seat 4: Plz3betMe showed [Kh Ad] and lost with a pair of Nines
Seat 5: dreded11 folded before Flop (didn't bet)
Seat 6: matiko09 folded before Flop (didn't bet)
Seat 7: stds st (button) showed [4c 4d] and won ($14.02) with two pair, Nines and Fours
Seat 8: chaps1988 (small blind) folded before Flop
Seat 9: tipner (big blind) folded before Flop





PokerStars Hand #150125326148:  Hold'em No Limit ($0.25/$0.50 USD) - 2016/03/10 13:02:50 CET [2016/03/10 7:02:50 ET]
Table 'Aegina' 9-max Seat #2 is the button
Seat 1: BingoIng0 ($110.02 in chips) 
Seat 2: dvutavr ($122.05 in chips) 
Seat 3: mobi1984 ($24.30 in chips) 
Seat 4: digimatical ($50.24 in chips) 
Seat 5: Ahangama ($50 in chips) 
Seat 6: matiko09 ($51.55 in chips) 
Seat 7: Gummio ($108.66 in chips) 
Seat 9: congcongnbnb ($167.94 in chips) 
mobi1984: posts small blind $0.25
digimatical: posts big blind $0.50
BingoIng0: posts the ante $0.10
dvutavr: posts the ante $0.10
mobi1984: posts the ante $0.10
digimatical: posts the ante $0.10
Ahangama: posts the ante $0.10
matiko09: posts the ante $0.10
Gummio: posts the ante $0.10
congcongnbnb: posts the ante $0.10
*** HOLE CARDS ***
Dealt to matiko09 [5d 7d]
Ahangama: folds 
matiko09: folds 
Gummio: folds 
congcongnbnb: folds 
BingoIng0: raises $0.75 to $1.25
dvutavr: calls $1.25
mobi1984: folds 
digimatical: raises $0.75 to $2
BingoIng0: raises $6.30 to $8.30
dvutavr: folds 
digimatical: calls $6.30
*** FLOP *** [2h 8d 3s]
digimatical: checks 
BingoIng0: checks 
*** TURN *** [2h 8d 3s] [Ts]
digimatical: checks 
BingoIng0: checks 
*** RIVER *** [2h 8d 3s Ts] [6h]
digimatical: bets $24.50
BingoIng0: folds 
Uncalled bet ($24.50) returned to digimatical
digimatical collected $18.05 from pot
*** SUMMARY ***
Total pot $18.90 | Rake $0.85 
Board [2h 8d 3s Ts 6h]
Seat 1: BingoIng0 folded on the River
Seat 2: dvutavr (button) folded before Flop
Seat 3: mobi1984 (small blind) folded before Flop
Seat 4: digimatical (big blind) collected ($18.05)
Seat 5: Ahangama folded before Flop (didn't bet)
Seat 6: matiko09 folded before Flop (didn't bet)
Seat 7: Gummio folded before Flop (didn't bet)
Seat 9: congcongnbnb folded before Flop (didn't bet)





PokerStars Hand #150125360467:  Hold'em No Limit ($0.50/$1.00 USD) - 2016/03/10 13:03:57 CET [2016/03/10 7:03:57 ET]
Table 'Saskia' 9-max Seat #8 is the button
Seat 1: Sweden_Pound ($105.66 in chips) 
Seat 2: njurg aga ($107.07 in chips) 
Seat 3: ccmaster001 ($65.04 in chips) 
Seat 4: Plz3betMe ($84.62 in chips) 
Seat 5: dreded11 ($84.01 in chips) 
Seat 6: matiko09 ($100 in chips) 
Seat 7: stds st ($35.03 in chips) 
Seat 8: chaps1988 ($171.12 in chips) 
Seat 9: tipner ($100 in chips) 
tipner: posts small blind $0.50
Sweden_Pound: posts big blind $1
*** HOLE CARDS ***
Dealt to matiko09 [As 9d]
njurg aga: folds 
ccmaster001: folds 
Plz3betMe: folds 
dreded11: folds 
matiko09: folds 
stds st: raises $1.02 to $2.02
chaps1988: folds 
tipner: folds 
Sweden_Pound: folds 
Uncalled bet ($1.02) returned to stds st
stds st collected $2.50 from pot
stds st: doesn't show hand 
*** SUMMARY ***
Total pot $2.50 | Rake $0 
Seat 1: Sweden_Pound (big blind) folded before Flop
Seat 2: njurg aga folded before Flop (didn't bet)
Seat 3: ccmaster001 folded before Flop (didn't bet)
Seat 4: Plz3betMe folded before Flop (didn't bet)
Seat 5: dreded11 folded before Flop (didn't bet)
Seat 6: matiko09 folded before Flop (didn't bet)
Seat 7: stds st collected ($2.50)
Seat 8: chaps1988 (button) folded before Flop (didn't bet)
Seat 9: tipner (small blind) folded before Flop





PokerStars Hand #150125360456:  Hold'em No Limit ($1/$2 USD) - 2016/03/10 13:03:57 CET [2016/03/10 7:03:57 ET]
Table 'Rimito II' 9-max Seat #3 is the button
Seat 1: NeedBeat ($200 in chips) 
Seat 2: chaps1988 ($200 in chips) 
Seat 3: Yaaaazz ($308.71 in chips) 
Seat 4: Zier89 ($173.65 in chips) 
Seat 5: rijger321 ($87.02 in chips) 
Seat 6: Fish4trips ($200 in chips) 
Seat 7: matiko09 ($204 in chips) 
Seat 8: Olddogtom888 ($159.20 in chips) 
Seat 9: tipner ($203.42 in chips) 
Zier89: posts small blind $1
rijger321: posts big blind $2
*** HOLE CARDS ***
Dealt to matiko09 [Kc 8d]
Fish4trips: folds 
matiko09: folds 
Olddogtom888: folds 
tipner: folds 
NeedBeat: folds 
chaps1988: folds 
Yaaaazz: raises $2.40 to $4.40
Zier89: folds 
rijger321: raises $9.60 to $14
Yaaaazz: folds 
Uncalled bet ($9.60) returned to rijger321
Zier89 leaves the table
rijger321 collected $9.80 from pot
rijger321: doesn't show hand 
*** SUMMARY ***
Total pot $9.80 | Rake $0 
Seat 1: NeedBeat folded before Flop (didn't bet)
Seat 2: chaps1988 folded before Flop (didn't bet)
Seat 3: Yaaaazz (button) folded before Flop
Seat 4: Zier89 (small blind) folded before Flop
Seat 5: rijger321 (big blind) collected ($9.80)
Seat 6: Fish4trips folded before Flop (didn't bet)
Seat 7: matiko09 folded before Flop (didn't bet)
Seat 8: Olddogtom888 folded before Flop (didn't bet)
Seat 9: tipner folded before Flop (didn't bet)





PokerStars Hand #150125369498:  Hold'em No Limit ($0.50/$1.00 USD) - 2016/03/10 13:04:14 CET [2016/03/10 7:04:14 ET]
Table 'Saskia' 9-max Seat #9 is the button
Seat 1: Sweden_Pound ($104.66 in chips) 
Seat 2: njurg aga ($107.07 in chips) 
Seat 3: ccmaster001 ($65.04 in chips) 
Seat 4: Plz3betMe ($84.62 in chips) 
Seat 5: dreded11 ($84.01 in chips) 
Seat 6: matiko09 ($100 in chips) 
Seat 7: stds st ($36.53 in chips) 
Seat 8: chaps1988 ($171.12 in chips) 
Seat 9: tipner ($100 in chips) 
Sweden_Pound: posts small blind $0.50
njurg aga: posts big blind $1
*** HOLE CARDS ***
Dealt to matiko09 [3s 6s]
ccmaster001: folds 
Plz3betMe: folds 
dreded11: folds 
matiko09: folds 
stds st: folds 
chaps1988: folds 
tipner: folds 
Sweden_Pound: raises $2 to $3
njurg aga: calls $2
*** FLOP *** [7d Qd Qh]
Sweden_Pound: bets $3.72
njurg aga: folds 
Uncalled bet ($3.72) returned to Sweden_Pound
Sweden_Pound collected $5.73 from pot
Sweden_Pound: doesn't show hand 
*** SUMMARY ***
Total pot $6 | Rake $0.27 
Board [7d Qd Qh]
Seat 1: Sweden_Pound (small blind) collected ($5.73)
Seat 2: njurg aga (big blind) folded on the Flop
Seat 3: ccmaster001 folded before Flop (didn't bet)
Seat 4: Plz3betMe folded before Flop (didn't bet)
Seat 5: dreded11 folded before Flop (didn't bet)
Seat 6: matiko09 folded before Flop (didn't bet)
Seat 7: stds st folded before Flop (didn't bet)
Seat 8: chaps1988 folded before Flop (didn't bet)
Seat 9: tipner (button) folded before Flop (didn't bet)





PokerStars Hand #150125377948:  Hold'em No Limit ($0.50/$1.00 USD) - 2016/03/10 13:04:31 CET [2016/03/10 7:04:31 ET]
Table 'Liriope II' 9-max Seat #3 is the button
Seat 1: di0d80 ($106.89 in chips) 
Seat 2: zxp12345 ($31.98 in chips) 
Seat 3: matiko09 ($145.09 in chips) 
Seat 4: Plz3betMe ($71.11 in chips) 
Seat 5: chaps1988 ($135.68 in chips) 
Seat 6: nobu-azabu ($168.60 in chips) 
Seat 7: Sweden_Pound ($102.50 in chips) 
Seat 8: PacPacBum ($105.10 in chips) 
Seat 9: tipner ($110.55 in chips) 
Plz3betMe: posts small blind $0.50
chaps1988: posts big blind $1
*** HOLE CARDS ***
Dealt to matiko09 [2h Qh]
nobu-azabu: folds 
Sweden_Pound: folds 
PacPacBum: folds 
tipner: folds 
di0d80: folds 
zxp12345: calls $1
matiko09: folds 
Plz3betMe: calls $0.50
chaps1988: checks 
*** FLOP *** [Jd 2c 6c]
Plz3betMe: checks 
chaps1988: bets $2
zxp12345: folds 
Plz3betMe: folds 
Uncalled bet ($2) returned to chaps1988
chaps1988 collected $2.86 from pot
chaps1988: doesn't show hand 
*** SUMMARY ***
Total pot $3 | Rake $0.14 
Board [Jd 2c 6c]
Seat 1: di0d80 folded before Flop (didn't bet)
Seat 2: zxp12345 folded on the Flop
Seat 3: matiko09 (button) folded before Flop (didn't bet)
Seat 4: Plz3betMe (small blind) folded on the Flop
Seat 5: chaps1988 (big blind) collected ($2.86)
Seat 6: nobu-azabu folded before Flop (didn't bet)
Seat 7: Sweden_Pound folded before Flop (didn't bet)
Seat 8: PacPacBum folded before Flop (didn't bet)
Seat 9: tipner folded before Flop (didn't bet)





PokerStars Hand #150125379001:  Hold'em No Limit ($0.25/$0.50 USD) - 2016/03/10 13:04:33 CET [2016/03/10 7:04:33 ET]
Table 'Aegina' 9-max Seat #3 is the button
Seat 1: BingoIng0 ($101.62 in chips) 
Seat 2: dvutavr ($120.70 in chips) 
Seat 3: mobi1984 ($23.95 in chips) 
Seat 4: digimatical ($59.89 in chips) 
Seat 5: Ahangama ($50 in chips) 
Seat 6: matiko09 ($51.45 in chips) 
Seat 7: Gummio ($108.56 in chips) 
Seat 9: congcongnbnb ($167.84 in chips) 
digimatical: posts small blind $0.25
Ahangama: posts big blind $0.50
BingoIng0: posts the ante $0.10
dvutavr: posts the ante $0.10
mobi1984: posts the ante $0.10
digimatical: posts the ante $0.10
Ahangama: posts the ante $0.10
matiko09: posts the ante $0.10
Gummio: posts the ante $0.10
congcongnbnb: posts the ante $0.10
*** HOLE CARDS ***
Dealt to matiko09 [3s Ah]
matiko09: folds 
Gummio: folds 
congcongnbnb: folds 
BingoIng0: raises $0.75 to $1.25
dvutavr: folds 
mobi1984: folds 
digimatical: folds 
Ahangama: folds 
Uncalled bet ($0.75) returned to BingoIng0
BingoIng0 collected $2.05 from pot
BingoIng0: doesn't show hand 
*** SUMMARY ***
Total pot $2.05 | Rake $0 
Seat 1: BingoIng0 collected ($2.05)
Seat 2: dvutavr folded before Flop (didn't bet)
Seat 3: mobi1984 (button) folded before Flop (didn't bet)
Seat 4: digimatical (small blind) folded before Flop
Seat 5: Ahangama (big blind) folded before Flop
Seat 6: matiko09 folded before Flop (didn't bet)
Seat 7: Gummio folded before Flop (didn't bet)
Seat 9: congcongnbnb folded before Flop (didn't bet)





PokerStars Hand #150125384406:  Hold'em No Limit ($1/$2 USD) - 2016/03/10 13:04:43 CET [2016/03/10 7:04:43 ET]
Table 'Rimito II' 9-max Seat #5 is the button
Seat 1: NeedBeat ($200 in chips) 
Seat 2: chaps1988 ($200 in chips) 
Seat 3: Yaaaazz ($304.31 in chips) 
Seat 5: rijger321 ($92.42 in chips) 
Seat 6: Fish4trips ($200 in chips) 
Seat 7: matiko09 ($204 in chips) 
Seat 8: Olddogtom888 ($159.20 in chips) 
Seat 9: tipner ($203.42 in chips) 
Fish4trips: posts small blind $1
matiko09: posts big blind $2
*** HOLE CARDS ***
Dealt to matiko09 [Kh 5h]
di0d80 joins the table at seat #4 
Olddogtom888 has timed out
Olddogtom888: folds 
tipner: folds 
NeedBeat: folds 
chaps1988: folds 
Yaaaazz: folds 
rijger321: raises $4 to $6
Fish4trips: folds 
matiko09: folds 
Uncalled bet ($4) returned to rijger321
rijger321 collected $5 from pot
rijger321: doesn't show hand 
*** SUMMARY ***
Total pot $5 | Rake $0 
Seat 1: NeedBeat folded before Flop (didn't bet)
Seat 2: chaps1988 folded before Flop (didn't bet)
Seat 3: Yaaaazz folded before Flop (didn't bet)
Seat 5: rijger321 (button) collected ($5)
Seat 6: Fish4trips (small blind) folded before Flop
Seat 7: matiko09 (big blind) folded before Flop
Seat 8: Olddogtom888 folded before Flop (didn't bet)
Seat 9: tipner folded before Flop (didn't bet)





PokerStars Hand #150125388942:  Hold'em No Limit ($0.50/$1.00 USD) - 2016/03/10 13:04:52 CET [2016/03/10 7:04:52 ET]
Table 'Saskia' 9-max Seat #1 is the button
Seat 1: Sweden_Pound ($107.39 in chips) 
Seat 2: njurg aga ($104.07 in chips) 
Seat 3: ccmaster001 ($65.04 in chips) 
Seat 4: Plz3betMe ($84.62 in chips) 
Seat 5: dreded11 ($84.01 in chips) 
Seat 6: matiko09 ($100 in chips) 
Seat 7: stds st ($36.53 in chips) 
Seat 8: chaps1988 ($171.12 in chips) 
Seat 9: tipner ($100 in chips) 
njurg aga: posts small blind $0.50
ccmaster001: posts big blind $1
*** HOLE CARDS ***
Dealt to matiko09 [Th 6c]
Plz3betMe: folds 
dreded11: folds 
matiko09: folds 
stds st: raises $1.02 to $2.02
chaps1988: folds 
tipner: folds 
Sweden_Pound: folds 
njurg aga: folds 
ccmaster001: calls $1.02
*** FLOP *** [7d 2c Jh]
ccmaster001: checks 
stds st: bets $2.38
ccmaster001: folds 
Uncalled bet ($2.38) returned to stds st
stds st collected $4.34 from pot
stds st: doesn't show hand 
*** SUMMARY ***
Total pot $4.54 | Rake $0.20 
Board [7d 2c Jh]
Seat 1: Sweden_Pound (button) folded before Flop (didn't bet)
Seat 2: njurg aga (small blind) folded before Flop
Seat 3: ccmaster001 (big blind) folded on the Flop
Seat 4: Plz3betMe folded before Flop (didn't bet)
Seat 5: dreded11 folded before Flop (didn't bet)
Seat 6: matiko09 folded before Flop (didn't bet)
Seat 7: stds st collected ($4.34)
Seat 8: chaps1988 folded before Flop (didn't bet)
Seat 9: tipner folded before Flop (didn't bet)





PokerStars Hand #150125393850:  Hold'em No Limit ($0.25/$0.50 USD) - 2016/03/10 13:05:01 CET [2016/03/10 7:05:01 ET]
Table 'Aegina' 9-max Seat #4 is the button
Seat 1: BingoIng0 ($103.07 in chips) 
Seat 2: dvutavr ($120.60 in chips) 
Seat 3: mobi1984 ($23.85 in chips) 
Seat 4: digimatical ($59.54 in chips) 
Seat 5: Ahangama ($50 in chips) 
Seat 6: matiko09 ($51.35 in chips) 
Seat 7: Gummio ($108.46 in chips) 
Seat 9: congcongnbnb ($167.74 in chips) 
Ahangama: posts small blind $0.25
matiko09: posts big blind $0.50
ardo888: sits out 
BingoIng0: posts the ante $0.10
dvutavr: posts the ante $0.10
mobi1984: posts the ante $0.10
digimatical: posts the ante $0.10
Ahangama: posts the ante $0.10
matiko09: posts the ante $0.10
Gummio: posts the ante $0.10
congcongnbnb: posts the ante $0.10
*** HOLE CARDS ***
Dealt to matiko09 [6c 2d]
Gummio: calls $0.50
congcongnbnb: folds 
BingoIng0: raises $1 to $1.50
dvutavr: folds 
mobi1984: folds 
digimatical: folds 
Ahangama: folds 
matiko09: folds 
Gummio: calls $1
*** FLOP *** [7c Kd 3s]
Gummio: checks 
BingoIng0: checks 
*** TURN *** [7c Kd 3s] [5s]
Gummio: bets $2.17
mobi1984 is disconnected 
BingoIng0: calls $2.17
*** RIVER *** [7c Kd 3s 5s] [2c]
Gummio: checks 
BingoIng0: checks 
*** SHOW DOWN ***
Gummio: shows [5d Ad] (a pair of Fives)
BingoIng0: shows [Tc Ts] (a pair of Tens)
BingoIng0 collected $8.49 from pot
*** SUMMARY ***
Total pot $8.89 | Rake $0.40 
Board [7c Kd 3s 5s 2c]
Seat 1: BingoIng0 showed [Tc Ts] and won ($8.49) with a pair of Tens
Seat 2: dvutavr folded before Flop (didn't bet)
Seat 3: mobi1984 folded before Flop (didn't bet)
Seat 4: digimatical (button) folded before Flop (didn't bet)
Seat 5: Ahangama (small blind) folded before Flop
Seat 6: matiko09 (big blind) folded before Flop
Seat 7: Gummio showed [5d Ad] and lost with a pair of Fives
Seat 9: congcongnbnb folded before Flop (didn't bet)





PokerStars Hand #150125404294:  Hold'em No Limit ($1/$2 USD) - 2016/03/10 13:05:22 CET [2016/03/10 7:05:22 ET]
Table 'Rimito II' 9-max Seat #6 is the button
Seat 1: NeedBeat ($200 in chips) 
Seat 2: chaps1988 ($200 in chips) 
Seat 3: Yaaaazz ($304.31 in chips) 
Seat 5: rijger321 ($95.42 in chips) 
Seat 6: Fish4trips ($200 in chips) 
Seat 7: matiko09 ($202 in chips) 
Seat 9: tipner ($203.42 in chips) 
matiko09: posts small blind $1
tipner: posts big blind $2
di0d80: sits out 
*** HOLE CARDS ***
Dealt to matiko09 [6d Ad]
NeedBeat: folds 
NeedBeat leaves the table
chaps1988: folds 
Yaaaazz: folds 
rijger321: folds 
Fish4trips: raises $2 to $4
stds st joins the table at seat #1 
matiko09: folds 
tipner: folds 
Uncalled bet ($2) returned to Fish4trips
Fish4trips collected $5 from pot
Fish4trips: doesn't show hand 
*** SUMMARY ***
Total pot $5 | Rake $0 
Seat 1: NeedBeat folded before Flop (didn't bet)
Seat 2: chaps1988 folded before Flop (didn't bet)
Seat 3: Yaaaazz folded before Flop (didn't bet)
Seat 5: rijger321 folded before Flop (didn't bet)
Seat 6: Fish4trips (button) collected ($5)
Seat 7: matiko09 (small blind) folded before Flop
Seat 9: tipner (big blind) folded before Flop





PokerStars Hand #150125406851:  Hold'em No Limit ($0.50/$1.00 USD) - 2016/03/10 13:05:27 CET [2016/03/10 7:05:27 ET]
Table 'Liriope II' 9-max Seat #4 is the button
Seat 1: di0d80 ($106.89 in chips) 
Seat 2: zxp12345 ($30.98 in chips) 
Seat 3: matiko09 ($145.09 in chips) 
Seat 4: Plz3betMe ($70.11 in chips) 
Seat 5: chaps1988 ($137.54 in chips) 
Seat 6: nobu-azabu ($168.60 in chips) 
Seat 7: Sweden_Pound ($102.50 in chips) 
Seat 8: PacPacBum ($105.10 in chips) 
Seat 9: tipner ($110.55 in chips) 
chaps1988: posts small blind $0.50
nobu-azabu: posts big blind $1
*** HOLE CARDS ***
Dealt to matiko09 [Jc 9c]
Sweden_Pound: folds 
PacPacBum: folds 
tipner: folds 
di0d80: folds 
zxp12345: folds 
matiko09: raises $1.50 to $2.50
Plz3betMe: folds 
chaps1988: folds 
nobu-azabu: folds 
Uncalled bet ($1.50) returned to matiko09
matiko09 collected $2.50 from pot
matiko09: doesn't show hand 
*** SUMMARY ***
Total pot $2.50 | Rake $0 
Seat 1: di0d80 folded before Flop (didn't bet)
Seat 2: zxp12345 folded before Flop (didn't bet)
Seat 3: matiko09 collected ($2.50)
Seat 4: Plz3betMe (button) folded before Flop (didn't bet)
Seat 5: chaps1988 (small blind) folded before Flop
Seat 6: nobu-azabu (big blind) folded before Flop
Seat 7: Sweden_Pound folded before Flop (didn't bet)
Seat 8: PacPacBum folded before Flop (didn't bet)
Seat 9: tipner folded before Flop (didn't bet)





PokerStars Hand #150125421453:  Hold'em No Limit ($1/$2 USD) - 2016/03/10 13:05:55 CET [2016/03/10 7:05:55 ET]
Table 'Rimito II' 9-max Seat #7 is the button
Seat 1: stds st ($80 in chips) 
Seat 2: chaps1988 ($200 in chips) 
Seat 3: Yaaaazz ($304.31 in chips) 
Seat 5: rijger321 ($95.42 in chips) 
Seat 6: Fish4trips ($203 in chips) 
Seat 7: matiko09 ($201 in chips) 
Seat 9: tipner ($201.42 in chips) 
tipner: posts small blind $1
stds st: posts big blind $2
di0d80: sits out 
*** HOLE CARDS ***
Dealt to matiko09 [8c 8d]
chaps1988: folds 
Yaaaazz: folds 
rijger321: raises $4 to $6
Fish4trips: calls $6
matiko09: calls $6
tipner: folds 
stds st: folds 
*** FLOP *** [4s 3c Jc]
rijger321: checks 
Fish4trips: checks 
matiko09: bets $10.43
rijger321: calls $10.43
Fish4trips: folds 
*** TURN *** [4s 3c Jc] [Ts]
rijger321: checks 
matiko09: checks 
*** RIVER *** [4s 3c Jc Ts] [Qc]
rijger321: bets $18
matiko09: folds 
Uncalled bet ($18) returned to rijger321
rijger321 collected $39.98 from pot
rijger321: doesn't show hand 
*** SUMMARY ***
Total pot $41.86 | Rake $1.88 
Board [4s 3c Jc Ts Qc]
Seat 1: stds st (big blind) folded before Flop
Seat 2: chaps1988 folded before Flop (didn't bet)
Seat 3: Yaaaazz folded before Flop (didn't bet)
Seat 5: rijger321 collected ($39.98)
Seat 6: Fish4trips folded on the Flop
Seat 7: matiko09 (button) folded on the River
Seat 9: tipner (small blind) folded before Flop





PokerStars Hand #150125425586:  Hold'em No Limit ($0.25/$0.50 USD) - 2016/03/10 13:06:03 CET [2016/03/10 7:06:03 ET]
Table 'Aegina' 9-max Seat #5 is the button
Seat 1: BingoIng0 ($107.79 in chips) 
Seat 2: dvutavr ($120.50 in chips) 
Seat 3: mobi1984 ($23.75 in chips) 
Seat 4: digimatical ($59.44 in chips) 
Seat 5: Ahangama ($50 in chips) 
Seat 6: matiko09 ($50.75 in chips) 
Seat 7: Gummio ($104.69 in chips) 
Seat 9: congcongnbnb ($167.64 in chips) 
matiko09: posts small blind $0.25
Gummio: posts big blind $0.50
ardo888: sits out 
BingoIng0: posts the ante $0.10
dvutavr: posts the ante $0.10
mobi1984: posts the ante $0.10
digimatical: posts the ante $0.10
Ahangama: posts the ante $0.10
matiko09: posts the ante $0.10
Gummio: posts the ante $0.10
congcongnbnb: posts the ante $0.10
*** HOLE CARDS ***
Dealt to matiko09 [Ac Th]
congcongnbnb: folds 
BingoIng0: raises $1 to $1.50
dvutavr: folds 
mobi1984: folds 
digimatical: calls $1.50
Ahangama: folds 
matiko09: folds 
Gummio: folds 
*** FLOP *** [4s As 2c]
BingoIng0: checks 
digimatical: checks 
*** TURN *** [4s As 2c] [Qc]
BingoIng0: checks 
digimatical: checks 
*** RIVER *** [4s As 2c Qc] [2h]
BingoIng0: checks 
digimatical: checks 
*** SHOW DOWN ***
BingoIng0: shows [Jh Kd] (a pair of Deuces)
digimatical: mucks hand 
BingoIng0 collected $4.35 from pot
*** SUMMARY ***
Total pot $4.55 | Rake $0.20 
Board [4s As 2c Qc 2h]
Seat 1: BingoIng0 showed [Jh Kd] and won ($4.35) with a pair of Deuces
Seat 2: dvutavr folded before Flop (didn't bet)
Seat 3: mobi1984 folded before Flop (didn't bet)
Seat 4: digimatical mucked [9h Jd]
Seat 5: Ahangama (button) folded before Flop (didn't bet)
Seat 6: matiko09 (small blind) folded before Flop
Seat 7: Gummio (big blind) folded before Flop
Seat 9: congcongnbnb folded before Flop (didn't bet)





PokerStars Hand #150125427493:  Hold'em No Limit ($0.50/$1.00 USD) - 2016/03/10 13:06:07 CET [2016/03/10 7:06:07 ET]
Table 'Saskia' 9-max Seat #2 is the button
Seat 1: Sweden_Pound ($107.39 in chips) 
Seat 2: njurg aga ($103.57 in chips) 
Seat 3: ccmaster001 ($63.02 in chips) 
Seat 4: Plz3betMe ($84.62 in chips) 
Seat 5: dreded11 ($84.01 in chips) 
Seat 6: matiko09 ($100 in chips) 
Seat 7: stds st ($38.85 in chips) 
Seat 8: chaps1988 ($171.12 in chips) 
Seat 9: tipner ($100 in chips) 
ccmaster001: posts small blind $0.50
Plz3betMe: posts big blind $1
*** HOLE CARDS ***
Dealt to matiko09 [Ad 8h]
dreded11: folds 
matiko09: folds 
stds st: folds 
chaps1988: folds 
tipner: folds 
Sweden_Pound: raises $1.50 to $2.50
njurg aga: calls $2.50
ccmaster001: calls $2
Plz3betMe: folds 
*** FLOP *** [6c 4d 3d]
ccmaster001: checks 
Sweden_Pound: bets $5.28
njurg aga: folds 
ccmaster001: folds 
Uncalled bet ($5.28) returned to Sweden_Pound
Sweden_Pound collected $8.12 from pot
Sweden_Pound: doesn't show hand 
*** SUMMARY ***
Total pot $8.50 | Rake $0.38 
Board [6c 4d 3d]
Seat 1: Sweden_Pound collected ($8.12)
Seat 2: njurg aga (button) folded on the Flop
Seat 3: ccmaster001 (small blind) folded on the Flop
Seat 4: Plz3betMe (big blind) folded before Flop
Seat 5: dreded11 folded before Flop (didn't bet)
Seat 6: matiko09 folded before Flop (didn't bet)
Seat 7: stds st folded before Flop (didn't bet)
Seat 8: chaps1988 folded before Flop (didn't bet)
Seat 9: tipner folded before Flop (didn't bet)





PokerStars Hand #150125429300:  Hold'em No Limit ($0.50/$1.00 USD) - 2016/03/10 13:06:10 CET [2016/03/10 7:06:10 ET]
Table 'Liriope II' 9-max Seat #5 is the button
Seat 1: di0d80 ($106.89 in chips) 
Seat 2: zxp12345 ($30.98 in chips) 
Seat 3: matiko09 ($146.59 in chips) 
Seat 4: Plz3betMe ($70.11 in chips) 
Seat 5: chaps1988 ($137.04 in chips) 
Seat 6: nobu-azabu ($167.60 in chips) 
Seat 7: Sweden_Pound ($102.50 in chips) 
Seat 8: PacPacBum ($105.10 in chips) 
Seat 9: tipner ($110.55 in chips) 
nobu-azabu: posts small blind $0.50
Sweden_Pound: posts big blind $1
*** HOLE CARDS ***
Dealt to matiko09 [8s 6c]
PacPacBum: folds 
tipner: folds 
di0d80: folds 
zxp12345: folds 
matiko09: folds 
Plz3betMe: folds 
chaps1988: raises $1.50 to $2.50
nobu-azabu: folds 
Sweden_Pound: folds 
Uncalled bet ($1.50) returned to chaps1988
chaps1988 collected $2.50 from pot
chaps1988: doesn't show hand 
*** SUMMARY ***
Total pot $2.50 | Rake $0 
Seat 1: di0d80 folded before Flop (didn't bet)
Seat 2: zxp12345 folded before Flop (didn't bet)
Seat 3: matiko09 folded before Flop (didn't bet)
Seat 4: Plz3betMe folded before Flop (didn't bet)
Seat 5: chaps1988 (button) collected ($2.50)
Seat 6: nobu-azabu (small blind) folded before Flop
Seat 7: Sweden_Pound (big blind) folded before Flop
Seat 8: PacPacBum folded before Flop (didn't bet)
Seat 9: tipner folded before Flop (didn't bet)





PokerStars Hand #150125440562:  Hold'em No Limit ($0.50/$1.00 USD) - 2016/03/10 13:06:32 CET [2016/03/10 7:06:32 ET]
Table 'Leuschneria II' 9-max Seat #4 is the button
Seat 1: cdv1984 ($178.71 in chips) 
Seat 2: blackw0lf_03 ($100 in chips) 
Seat 3: gudridornot ($104.50 in chips) 
Seat 4: Sweden_Pound ($117.81 in chips) 
Seat 5: RMilPoker ($123.96 in chips) 
Seat 6: matiko09 ($100 in chips) 
Seat 7: Plz3betMe ($37 in chips) 
Seat 8: hammerwife ($100 in chips) 
Seat 9: Katsulion ($109.99 in chips) 
RMilPoker: posts small blind $0.50
matiko09: posts big blind $1
*** HOLE CARDS ***
Dealt to matiko09 [5d 5c]
Plz3betMe: folds 
hammerwife: folds 
Katsulion: folds 
cdv1984: folds 
blackw0lf_03: raises $2 to $3
gudridornot: folds 
Sweden_Pound: folds 
RMilPoker: folds 
matiko09: calls $2
*** FLOP *** [8h Js Jh]
matiko09: checks 
blackw0lf_03: bets $2.11
matiko09: folds 
Uncalled bet ($2.11) returned to blackw0lf_03
blackw0lf_03 collected $6.21 from pot
*** SUMMARY ***
Total pot $6.50 | Rake $0.29 
Board [8h Js Jh]
Seat 1: cdv1984 folded before Flop (didn't bet)
Seat 2: blackw0lf_03 collected ($6.21)
Seat 3: gudridornot folded before Flop (didn't bet)
Seat 4: Sweden_Pound (button) folded before Flop (didn't bet)
Seat 5: RMilPoker (small blind) folded before Flop
Seat 6: matiko09 (big blind) folded on the Flop
Seat 7: Plz3betMe folded before Flop (didn't bet)
Seat 8: hammerwife folded before Flop (didn't bet)
Seat 9: Katsulion folded before Flop (didn't bet)





PokerStars Hand #150125443559:  Hold'em No Limit ($0.50/$1.00 USD) - 2016/03/10 13:06:38 CET [2016/03/10 7:06:38 ET]
Table 'Iguassu' 9-max Seat #2 is the button
Seat 1: blackw0lf_03 ($100 in chips) 
Seat 2: Rocky6434 ($66 in chips) 
Seat 3: hammerwife ($100.50 in chips) 
Seat 4: matiko09 ($100 in chips) 
Seat 5: ilaviiitech ($176.86 in chips) 
Seat 6: Igor DoUrden ($100 in chips) 
Seat 7: PacPacBum ($100 in chips) 
Seat 9: tipner ($101 in chips) 
hammerwife: posts small blind $0.50
matiko09: posts big blind $1
Sweden_Pound: sits out 
*** HOLE CARDS ***
Dealt to matiko09 [Kh 2c]
ilaviiitech: folds 
Igor DoUrden: folds 
PacPacBum: folds 
tipner: folds 
blackw0lf_03: folds 
Rocky6434: raises $1 to $2
hammerwife: calls $1.50
matiko09: folds 
*** FLOP *** [7c Kd As]
hammerwife: checks 
Rocky6434: checks 
*** TURN *** [7c Kd As] [Kc]
hammerwife: checks 
Rocky6434: checks 
*** RIVER *** [7c Kd As Kc] [6c]
hammerwife: checks 
Rocky6434: checks 
*** SHOW DOWN ***
hammerwife: shows [7h 6h] (two pair, Kings and Sevens)
Rocky6434: mucks hand 
hammerwife collected $4.78 from pot
*** SUMMARY ***
Total pot $5 | Rake $0.22 
Board [7c Kd As Kc 6c]
Seat 1: blackw0lf_03 folded before Flop (didn't bet)
Seat 2: Rocky6434 (button) mucked [8s 9s]
Seat 3: hammerwife (small blind) showed [7h 6h] and won ($4.78) with two pair, Kings and Sevens
Seat 4: matiko09 (big blind) folded before Flop
Seat 5: ilaviiitech folded before Flop (didn't bet)
Seat 6: Igor DoUrden folded before Flop (didn't bet)
Seat 7: PacPacBum folded before Flop (didn't bet)
Seat 9: tipner folded before Flop (didn't bet)





PokerStars Hand #150125446853:  Hold'em No Limit ($0.50/$1.00 USD) - 2016/03/10 13:06:44 CET [2016/03/10 7:06:44 ET]
Table 'Saskia' 9-max Seat #3 is the button
Seat 1: Sweden_Pound ($113.01 in chips) 
Seat 2: njurg aga ($101.07 in chips) 
Seat 3: ccmaster001 ($60.52 in chips) 
Seat 4: Plz3betMe ($83.62 in chips) 
Seat 5: dreded11 ($84.01 in chips) 
Seat 6: matiko09 ($100 in chips) 
Seat 7: stds st ($38.85 in chips) 
Seat 8: chaps1988 ($171.12 in chips) 
Seat 9: tipner ($100 in chips) 
Plz3betMe: posts small blind $0.50
dreded11: posts big blind $1
*** HOLE CARDS ***
Dealt to matiko09 [Td 2d]
matiko09: folds 
stds st: folds 
chaps1988: folds 
tipner: raises $2 to $3
Sweden_Pound: folds 
njurg aga: folds 
ccmaster001: folds 
Plz3betMe: folds 
dreded11: folds 
Uncalled bet ($2) returned to tipner
tipner collected $2.50 from pot
tipner: doesn't show hand 
*** SUMMARY ***
Total pot $2.50 | Rake $0 
Seat 1: Sweden_Pound folded before Flop (didn't bet)
Seat 2: njurg aga folded before Flop (didn't bet)
Seat 3: ccmaster001 (button) folded before Flop (didn't bet)
Seat 4: Plz3betMe (small blind) folded before Flop
Seat 5: dreded11 (big blind) folded before Flop
Seat 6: matiko09 folded before Flop (didn't bet)
Seat 7: stds st folded before Flop (didn't bet)
Seat 8: chaps1988 folded before Flop (didn't bet)
Seat 9: tipner collected ($2.50)





PokerStars Hand #150125449177:  Hold'em No Limit ($0.50/$1.00 USD) - 2016/03/10 13:06:49 CET [2016/03/10 7:06:49 ET]
Table 'Liriope II' 9-max Seat #6 is the button
Seat 1: di0d80 ($106.89 in chips) 
Seat 2: zxp12345 ($30.98 in chips) 
Seat 3: matiko09 ($146.59 in chips) 
Seat 4: Plz3betMe ($70.11 in chips) 
Seat 5: chaps1988 ($138.54 in chips) 
Seat 6: nobu-azabu ($167.10 in chips) 
Seat 7: Sweden_Pound ($101.50 in chips) 
Seat 8: PacPacBum ($105.10 in chips) 
Seat 9: tipner ($110.55 in chips) 
Sweden_Pound: posts small blind $0.50
PacPacBum: posts big blind $1
*** HOLE CARDS ***
Dealt to matiko09 [5s 9d]
tipner: folds 
di0d80: folds 
zxp12345: calls $1
matiko09: folds 
Plz3betMe: raises $2 to $3
chaps1988: folds 
nobu-azabu: calls $3
Sweden_Pound: calls $2.50
PacPacBum: folds 
zxp12345: calls $2
*** FLOP *** [Js 3d 8c]
Sweden_Pound: checks 
zxp12345: checks 
Plz3betMe: checks 
nobu-azabu: checks 
*** TURN *** [Js 3d 8c] [As]
Sweden_Pound: checks 
zxp12345: checks 
Plz3betMe: checks 
nobu-azabu: bets $6.21
Sweden_Pound: folds 
zxp12345: calls $6.21
Plz3betMe: folds 
*** RIVER *** [Js 3d 8c As] [9h]
zxp12345: checks 
nobu-azabu: checks 
*** SHOW DOWN ***
zxp12345: shows [Tc Jh] (a pair of Jacks)
nobu-azabu: shows [Ac Ks] (a pair of Aces)
nobu-azabu collected $24.28 from pot
*** SUMMARY ***
Total pot $25.42 | Rake $1.14 
Board [Js 3d 8c As 9h]
Seat 1: di0d80 folded before Flop (didn't bet)
Seat 2: zxp12345 showed [Tc Jh] and lost with a pair of Jacks
Seat 3: matiko09 folded before Flop (didn't bet)
Seat 4: Plz3betMe folded on the Turn
Seat 5: chaps1988 folded before Flop (didn't bet)
Seat 6: nobu-azabu (button) showed [Ac Ks] and won ($24.28) with a pair of Aces
Seat 7: Sweden_Pound (small blind) folded on the Turn
Seat 8: PacPacBum (big blind) folded before Flop
Seat 9: tipner folded before Flop (didn't bet)





PokerStars Hand #150125448943:  Hold'em No Limit ($1/$2 USD) - 2016/03/10 13:06:49 CET [2016/03/10 7:06:49 ET]
Table 'Rimito II' 9-max Seat #9 is the button
Seat 1: stds st ($78 in chips) 
Seat 2: chaps1988 ($200 in chips) 
Seat 3: Yaaaazz ($304.31 in chips) 
Seat 5: rijger321 ($118.97 in chips) 
Seat 6: Fish4trips ($200 in chips) 
Seat 7: matiko09 ($200 in chips) 
Seat 9: tipner ($200.42 in chips) 
stds st: posts small blind $1
chaps1988: posts big blind $2
di0d80: sits out 
*** HOLE CARDS ***
Dealt to matiko09 [6h Jd]
Yaaaazz: folds 
rijger321: folds 
Fish4trips: folds 
matiko09: folds 
tipner: raises $3 to $5
stds st: folds 
chaps1988: calls $3
*** FLOP *** [7c 2s Ac]
chaps1988: checks 
tipner: bets $5.25
chaps1988: calls $5.25
*** TURN *** [7c 2s Ac] [4c]
chaps1988: checks 
tipner: bets $18
chaps1988: folds 
Uncalled bet ($18) returned to tipner
tipner collected $20.53 from pot
tipner: doesn't show hand 
*** SUMMARY ***
Total pot $21.50 | Rake $0.97 
Board [7c 2s Ac 4c]
Seat 1: stds st (small blind) folded before Flop
Seat 2: chaps1988 (big blind) folded on the Turn
Seat 3: Yaaaazz folded before Flop (didn't bet)
Seat 5: rijger321 folded before Flop (didn't bet)
Seat 6: Fish4trips folded before Flop (didn't bet)
Seat 7: matiko09 folded before Flop (didn't bet)
Seat 9: tipner (button) collected ($20.53)





PokerStars Hand #150125455006:  Hold'em No Limit ($0.25/$0.50 USD) - 2016/03/10 13:07:00 CET [2016/03/10 7:07:00 ET]
Table 'Aegina' 9-max Seat #6 is the button
Seat 1: BingoIng0 ($110.54 in chips) 
Seat 2: dvutavr ($120.40 in chips) 
Seat 3: mobi1984 ($23.65 in chips) 
Seat 4: digimatical ($57.84 in chips) 
Seat 5: Ahangama ($50 in chips) 
Seat 6: matiko09 ($50.40 in chips) 
Seat 7: Gummio ($104.09 in chips) 
Seat 8: ardo888 ($173.72 in chips) 
Seat 9: congcongnbnb ($167.54 in chips) 
Gummio: posts small blind $0.25
ardo888: posts big blind $0.50
BingoIng0: posts the ante $0.10
dvutavr: posts the ante $0.10
mobi1984: posts the ante $0.10
digimatical: posts the ante $0.10
Ahangama: posts the ante $0.10
matiko09: posts the ante $0.10
Gummio: posts the ante $0.10
ardo888: posts the ante $0.10
congcongnbnb: posts the ante $0.10
*** HOLE CARDS ***
Dealt to matiko09 [Kh 3s]
congcongnbnb: folds 
BingoIng0: folds 
dvutavr: raises $1 to $1.50
mobi1984: calls $1.50
digimatical: calls $1.50
Ahangama: folds 
matiko09: folds 
Gummio: folds 
ardo888: folds 
*** FLOP *** [Kd 2s 6c]
dvutavr: bets $3.50
mobi1984: folds 
digimatical: folds 
Uncalled bet ($3.50) returned to dvutavr
dvutavr collected $5.87 from pot
dvutavr: doesn't show hand 
*** SUMMARY ***
Total pot $6.15 | Rake $0.28 
Board [Kd 2s 6c]
Seat 1: BingoIng0 folded before Flop (didn't bet)
Seat 2: dvutavr collected ($5.87)
Seat 3: mobi1984 folded on the Flop
Seat 4: digimatical folded on the Flop
Seat 5: Ahangama folded before Flop (didn't bet)
Seat 6: matiko09 (button) folded before Flop (didn't bet)
Seat 7: Gummio (small blind) folded before Flop
Seat 8: ardo888 (big blind) folded before Flop
Seat 9: congcongnbnb folded before Flop (didn't bet)





PokerStars Hand #150125459040:  Hold'em No Limit ($0.50/$1.00 USD) - 2016/03/10 13:07:08 CET [2016/03/10 7:07:08 ET]
Table 'Saskia' 9-max Seat #4 is the button
Seat 1: Sweden_Pound ($113.01 in chips) 
Seat 2: njurg aga ($101.07 in chips) 
Seat 3: ccmaster001 ($60.52 in chips) 
Seat 4: Plz3betMe ($83.12 in chips) 
Seat 5: dreded11 ($83.01 in chips) 
Seat 6: matiko09 ($100 in chips) 
Seat 7: stds st ($38.85 in chips) 
Seat 8: chaps1988 ($171.12 in chips) 
Seat 9: tipner ($101.50 in chips) 
dreded11: posts small blind $0.50
matiko09: posts big blind $1
*** HOLE CARDS ***
Dealt to matiko09 [4s As]
stds st: folds 
chaps1988: folds 
tipner: folds 
Sweden_Pound: folds 
njurg aga: folds 
ccmaster001: folds 
Plz3betMe: raises $1 to $2
dreded11: folds 
matiko09: calls $1
*** FLOP *** [8h Qh 5h]
matiko09: checks 
Plz3betMe: bets $2.86
matiko09: folds 
Uncalled bet ($2.86) returned to Plz3betMe
Plz3betMe collected $4.30 from pot
Plz3betMe: doesn't show hand 
*** SUMMARY ***
Total pot $4.50 | Rake $0.20 
Board [8h Qh 5h]
Seat 1: Sweden_Pound folded before Flop (didn't bet)
Seat 2: njurg aga folded before Flop (didn't bet)
Seat 3: ccmaster001 folded before Flop (didn't bet)
Seat 4: Plz3betMe (button) collected ($4.30)
Seat 5: dreded11 (small blind) folded before Flop
Seat 6: matiko09 (big blind) folded on the Flop
Seat 7: stds st folded before Flop (didn't bet)
Seat 8: chaps1988 folded before Flop (didn't bet)
Seat 9: tipner folded before Flop (didn't bet)





PokerStars Hand #150125479655:  Hold'em No Limit ($0.25/$0.50 USD) - 2016/03/10 13:07:48 CET [2016/03/10 7:07:48 ET]
Table 'Aegina' 9-max Seat #7 is the button
Seat 1: BingoIng0 ($110.44 in chips) 
Seat 2: dvutavr ($124.67 in chips) 
Seat 3: mobi1984 ($22.05 in chips) 
Seat 4: digimatical ($56.24 in chips) 
Seat 5: Ahangama ($50 in chips) 
Seat 6: matiko09 ($50.30 in chips) 
Seat 7: Gummio ($103.74 in chips) 
Seat 8: ardo888 ($173.12 in chips) 
Seat 9: congcongnbnb ($167.44 in chips) 
ardo888: posts small blind $0.25
congcongnbnb: posts big blind $0.50
BingoIng0: posts the ante $0.10
dvutavr: posts the ante $0.10
mobi1984: posts the ante $0.10
digimatical: posts the ante $0.10
Ahangama: posts the ante $0.10
matiko09: posts the ante $0.10
Gummio: posts the ante $0.10
ardo888: posts the ante $0.10
congcongnbnb: posts the ante $0.10
*** HOLE CARDS ***
Dealt to matiko09 [Kc Qh]
BingoIng0: folds 
dvutavr: folds 
mobi1984: raises $0.50 to $1
digimatical: folds 
Ahangama: folds 
matiko09: calls $1
Gummio: folds 
ardo888: folds 
congcongnbnb: calls $0.50
*** FLOP *** [4h 8h 3s]
congcongnbnb: checks 
mobi1984: checks 
matiko09: checks 
*** TURN *** [4h 8h 3s] [8c]
congcongnbnb: checks 
mobi1984: checks 
matiko09: checks 
*** RIVER *** [4h 8h 3s 8c] [7d]
congcongnbnb: checks 
mobi1984: bets $2
matiko09: folds 
congcongnbnb: folds 
Uncalled bet ($2) returned to mobi1984
mobi1984 collected $3.96 from pot
mobi1984: doesn't show hand 
*** SUMMARY ***
Total pot $4.15 | Rake $0.19 
Board [4h 8h 3s 8c 7d]
Seat 1: BingoIng0 folded before Flop (didn't bet)
Seat 2: dvutavr folded before Flop (didn't bet)
Seat 3: mobi1984 collected ($3.96)
Seat 4: digimatical folded before Flop (didn't bet)
Seat 5: Ahangama folded before Flop (didn't bet)
Seat 6: matiko09 folded on the River
Seat 7: Gummio (button) folded before Flop (didn't bet)
Seat 8: ardo888 (small blind) folded before Flop
Seat 9: congcongnbnb (big blind) folded on the River





PokerStars Hand #150125487859:  Hold'em No Limit ($1/$2 USD) - 2016/03/10 13:08:04 CET [2016/03/10 7:08:04 ET]
Table 'Rimito II' 9-max Seat #1 is the button
Seat 1: stds st ($77 in chips) 
Seat 2: chaps1988 ($200 in chips) 
Seat 3: Yaaaazz ($304.31 in chips) 
Seat 5: rijger321 ($118.97 in chips) 
Seat 6: Fish4trips ($200 in chips) 
Seat 7: matiko09 ($200 in chips) 
Seat 9: tipner ($210.70 in chips) 
chaps1988: posts small blind $1
Yaaaazz: posts big blind $2
di0d80: sits out 
*** HOLE CARDS ***
Dealt to matiko09 [Kd 3c]
rijger321: raises $2 to $4
Fish4trips: folds 
matiko09: folds 
tipner: folds 
stds st: folds 
chaps1988: folds 
Yaaaazz: calls $2
*** FLOP *** [Ac 6s Tc]
Yaaaazz: bets $5
rijger321: calls $5
*** TURN *** [Ac 6s Tc] [6h]
Yaaaazz: checks 
rijger321: checks 
*** RIVER *** [Ac 6s Tc 6h] [2s]
Yaaaazz: checks 
rijger321: bets $12
Yaaaazz has timed out
Yaaaazz: folds 
Uncalled bet ($12) returned to rijger321
rijger321 collected $18.14 from pot
rijger321: doesn't show hand 
*** SUMMARY ***
Total pot $19 | Rake $0.86 
Board [Ac 6s Tc 6h 2s]
Seat 1: stds st (button) folded before Flop (didn't bet)
Seat 2: chaps1988 (small blind) folded before Flop
Seat 3: Yaaaazz (big blind) folded on the River
Seat 5: rijger321 collected ($18.14)
Seat 6: Fish4trips folded before Flop (didn't bet)
Seat 7: matiko09 folded before Flop (didn't bet)
Seat 9: tipner folded before Flop (didn't bet)





PokerStars Hand #150125488909:  Hold'em No Limit ($0.50/$1.00 USD) - 2016/03/10 13:08:06 CET [2016/03/10 7:08:06 ET]
Table 'Saskia' 9-max Seat #5 is the button
Seat 1: Sweden_Pound ($113.01 in chips) 
Seat 2: njurg aga ($101.07 in chips) 
Seat 3: ccmaster001 ($60.52 in chips) 
Seat 4: Plz3betMe ($85.42 in chips) 
Seat 5: dreded11 ($82.51 in chips) 
Seat 6: matiko09 ($100 in chips) 
Seat 7: stds st ($38.85 in chips) 
Seat 8: chaps1988 ($171.12 in chips) 
Seat 9: tipner ($101.50 in chips) 
matiko09: posts small blind $0.50
stds st: posts big blind $1
*** HOLE CARDS ***
Dealt to matiko09 [5h Jc]
chaps1988: folds 
tipner: folds 
Sweden_Pound: folds 
njurg aga: folds 
ccmaster001: raises $1 to $2
Plz3betMe: folds 
dreded11: folds 
matiko09: folds 
stds st: calls $1
*** FLOP *** [4c 3d Ac]
stds st: checks 
ccmaster001: bets $1
stds st: calls $1
*** TURN *** [4c 3d Ac] [Qc]
stds st: checks 
ccmaster001: bets $1
stds st: calls $1
*** RIVER *** [4c 3d Ac Qc] [Kh]
stds st: checks 
ccmaster001: bets $17
stds st: folds 
Uncalled bet ($17) returned to ccmaster001
ccmaster001 collected $8.12 from pot
ccmaster001: doesn't show hand 
*** SUMMARY ***
Total pot $8.50 | Rake $0.38 
Board [4c 3d Ac Qc Kh]
Seat 1: Sweden_Pound folded before Flop (didn't bet)
Seat 2: njurg aga folded before Flop (didn't bet)
Seat 3: ccmaster001 collected ($8.12)
Seat 4: Plz3betMe folded before Flop (didn't bet)
Seat 5: dreded11 (button) folded before Flop (didn't bet)
Seat 6: matiko09 (small blind) folded before Flop
Seat 7: stds st (big blind) folded on the River
Seat 8: chaps1988 folded before Flop (didn't bet)
Seat 9: tipner folded before Flop (didn't bet)





PokerStars Hand #150125498931:  Hold'em No Limit ($0.50/$1.00 USD) - 2016/03/10 13:08:26 CET [2016/03/10 7:08:26 ET]
Table 'Leuschneria II' 9-max Seat #5 is the button
Seat 1: cdv1984 ($178.71 in chips) 
Seat 2: blackw0lf_03 ($103.21 in chips) 
Seat 3: gudridornot ($104.50 in chips) 
Seat 4: Sweden_Pound ($117.81 in chips) 
Seat 5: RMilPoker ($123.46 in chips) 
Seat 6: matiko09 ($100 in chips) 
Seat 7: Plz3betMe ($37 in chips) 
Seat 8: hammerwife ($100 in chips) 
Seat 9: Katsulion ($109.99 in chips) 
matiko09: posts small blind $0.50
Plz3betMe: posts big blind $1
*** HOLE CARDS ***
Dealt to matiko09 [6d 7s]
hammerwife: folds 
Katsulion: folds 
cdv1984: folds 
blackw0lf_03: folds 
gudridornot: folds 
Sweden_Pound: folds 
RMilPoker: folds 
matiko09: folds 
Uncalled bet ($0.50) returned to Plz3betMe
Plz3betMe collected $1 from pot
Plz3betMe: doesn't show hand 
*** SUMMARY ***
Total pot $1 | Rake $0 
Seat 1: cdv1984 folded before Flop (didn't bet)
Seat 2: blackw0lf_03 folded before Flop (didn't bet)
Seat 3: gudridornot folded before Flop (didn't bet)
Seat 4: Sweden_Pound folded before Flop (didn't bet)
Seat 5: RMilPoker (button) folded before Flop (didn't bet)
Seat 6: matiko09 (small blind) folded before Flop
Seat 7: Plz3betMe (big blind) collected ($1)
Seat 8: hammerwife folded before Flop (didn't bet)
Seat 9: Katsulion folded before Flop (didn't bet)





PokerStars Hand #150125504892:  Hold'em No Limit ($0.50/$1.00 USD) - 2016/03/10 13:08:37 CET [2016/03/10 7:08:37 ET]
Table 'Iguassu' 9-max Seat #3 is the button
Seat 1: blackw0lf_03 ($100 in chips) 
Seat 2: Rocky6434 ($64 in chips) 
Seat 3: hammerwife ($103.28 in chips) 
Seat 4: matiko09 ($100 in chips) 
Seat 5: ilaviiitech ($176.86 in chips) 
Seat 6: Igor DoUrden ($100 in chips) 
Seat 7: PacPacBum ($100 in chips) 
Seat 9: tipner ($101 in chips) 
matiko09: posts small blind $0.50
ilaviiitech: posts big blind $1
Sweden_Pound: sits out 
*** HOLE CARDS ***
Dealt to matiko09 [Ts 7h]
Igor DoUrden: folds 
PacPacBum: raises $1.04 to $2.04
tipner: folds 
blackw0lf_03: folds 
Rocky6434: folds 
hammerwife: folds 
matiko09: folds 
ilaviiitech: folds 
Uncalled bet ($1.04) returned to PacPacBum
PacPacBum collected $2.50 from pot
PacPacBum: doesn't show hand 
*** SUMMARY ***
Total pot $2.50 | Rake $0 
Seat 1: blackw0lf_03 folded before Flop (didn't bet)
Seat 2: Rocky6434 folded before Flop (didn't bet)
Seat 3: hammerwife (button) folded before Flop (didn't bet)
Seat 4: matiko09 (small blind) folded before Flop
Seat 5: ilaviiitech (big blind) folded before Flop
Seat 6: Igor DoUrden folded before Flop (didn't bet)
Seat 7: PacPacBum collected ($2.50)
Seat 9: tipner folded before Flop (didn't bet)





PokerStars Hand #150125511749:  Hold'em No Limit ($0.50/$1.00 USD) - 2016/03/10 13:08:51 CET [2016/03/10 7:08:51 ET]
Table 'Liriope II' 9-max Seat #7 is the button
Seat 1: di0d80 ($106.89 in chips) 
Seat 2: zxp12345 ($21.77 in chips) 
Seat 3: matiko09 ($146.59 in chips) 
Seat 4: Plz3betMe ($67.11 in chips) 
Seat 5: chaps1988 ($138.54 in chips) 
Seat 6: nobu-azabu ($182.17 in chips) 
Seat 7: Sweden_Pound ($100 in chips) 
Seat 8: PacPacBum ($104.10 in chips) 
Seat 9: tipner ($110.55 in chips) 
PacPacBum: posts small blind $0.50
tipner: posts big blind $1
*** HOLE CARDS ***
Dealt to matiko09 [Kc Qs]
di0d80: folds 
zxp12345: calls $1
matiko09: raises $3 to $4
Plz3betMe: folds 
chaps1988: folds 
nobu-azabu: folds 
Sweden_Pound: folds 
PacPacBum: folds 
tipner: folds 
zxp12345: calls $3
*** FLOP *** [5s 8c 2s]
zxp12345: checks 
matiko09: checks 
*** TURN *** [5s 8c 2s] [Ts]
zxp12345: bets $4.53
matiko09: folds 
Uncalled bet ($4.53) returned to zxp12345
zxp12345 collected $9.07 from pot
zxp12345: doesn't show hand 
*** SUMMARY ***
Total pot $9.50 | Rake $0.43 
Board [5s 8c 2s Ts]
Seat 1: di0d80 folded before Flop (didn't bet)
Seat 2: zxp12345 collected ($9.07)
Seat 3: matiko09 folded on the Turn
Seat 4: Plz3betMe folded before Flop (didn't bet)
Seat 5: chaps1988 folded before Flop (didn't bet)
Seat 6: nobu-azabu folded before Flop (didn't bet)
Seat 7: Sweden_Pound (button) folded before Flop (didn't bet)
Seat 8: PacPacBum (small blind) folded before Flop
Seat 9: tipner (big blind) folded before Flop





PokerStars Hand #150125515825:  Hold'em No Limit ($0.50/$1.00 USD) - 2016/03/10 13:08:59 CET [2016/03/10 7:08:59 ET]
Table 'Leuschneria II' 9-max Seat #6 is the button
Seat 1: cdv1984 ($178.71 in chips) 
Seat 2: blackw0lf_03 ($103.21 in chips) 
Seat 3: gudridornot ($104.50 in chips) 
Seat 4: Sweden_Pound ($117.81 in chips) 
Seat 5: RMilPoker ($123.46 in chips) 
Seat 6: matiko09 ($100 in chips) 
Seat 7: Plz3betMe ($37.50 in chips) 
Seat 8: hammerwife ($100 in chips) 
Seat 9: Katsulion ($109.99 in chips) 
Plz3betMe: posts small blind $0.50
hammerwife: posts big blind $1
*** HOLE CARDS ***
Dealt to matiko09 [Jh Js]
Katsulion: folds 
cdv1984: raises $2 to $3
blackw0lf_03: folds 
gudridornot: folds 
Sweden_Pound: folds 
RMilPoker: raises $7.50 to $10.50
matiko09: calls $10.50
Plz3betMe: folds 
hammerwife: folds 
cdv1984: folds 
*** FLOP *** [2d 5h Tc]
RMilPoker: checks 
matiko09: bets $12
RMilPoker: folds 
Uncalled bet ($12) returned to matiko09
matiko09 collected $24.35 from pot
matiko09: doesn't show hand 
*** SUMMARY ***
Total pot $25.50 | Rake $1.15 
Board [2d 5h Tc]
Seat 1: cdv1984 folded before Flop
Seat 2: blackw0lf_03 folded before Flop (didn't bet)
Seat 3: gudridornot folded before Flop (didn't bet)
Seat 4: Sweden_Pound folded before Flop (didn't bet)
Seat 5: RMilPoker folded on the Flop
Seat 6: matiko09 (button) collected ($24.35)
Seat 7: Plz3betMe (small blind) folded before Flop
Seat 8: hammerwife (big blind) folded before Flop
Seat 9: Katsulion folded before Flop (didn't bet)





PokerStars Hand #150125517964:  Hold'em No Limit ($0.50/$1.00 USD) - 2016/03/10 13:09:03 CET [2016/03/10 7:09:03 ET]
Table 'Iguassu' 9-max Seat #4 is the button
Seat 1: blackw0lf_03 ($100 in chips) 
Seat 2: Rocky6434 ($64 in chips) 
Seat 3: hammerwife ($103.28 in chips) 
Seat 4: matiko09 ($100 in chips) 
Seat 5: ilaviiitech ($175.86 in chips) 
Seat 6: Igor DoUrden ($100 in chips) 
Seat 7: PacPacBum ($101.50 in chips) 
Seat 9: tipner ($101 in chips) 
ilaviiitech: posts small blind $0.50
Igor DoUrden: posts big blind $1
Sweden_Pound: sits out 
*** HOLE CARDS ***
Dealt to matiko09 [8h 6h]
PacPacBum: folds 
tipner: folds 
blackw0lf_03: raises $2 to $3
Rocky6434: calls $3
hammerwife: folds 
matiko09: folds 
ilaviiitech: folds 
Igor DoUrden: folds 
*** FLOP *** [3c 4h 9s]
blackw0lf_03: checks 
Rocky6434: checks 
*** TURN *** [3c 4h 9s] [6c]
blackw0lf_03: bets $10.88
Rocky6434: calls $10.88
*** RIVER *** [3c 4h 9s 6c] [7h]
blackw0lf_03: checks 
Rocky6434: checks 
*** SHOW DOWN ***
blackw0lf_03: shows [9h Ah] (a pair of Nines)
Rocky6434: mucks hand 
blackw0lf_03 collected $27.94 from pot
*** SUMMARY ***
Total pot $29.26 | Rake $1.32 
Board [3c 4h 9s 6c 7h]
Seat 1: blackw0lf_03 showed [9h Ah] and won ($27.94) with a pair of Nines
Seat 2: Rocky6434 mucked [Qc Ac]
Seat 3: hammerwife folded before Flop (didn't bet)
Seat 4: matiko09 (button) folded before Flop (didn't bet)
Seat 5: ilaviiitech (small blind) folded before Flop
Seat 6: Igor DoUrden (big blind) folded before Flop
Seat 7: PacPacBum folded before Flop (didn't bet)
Seat 9: tipner folded before Flop (didn't bet)





PokerStars Hand #150125521538:  Hold'em No Limit ($0.25/$0.50 USD) - 2016/03/10 13:09:10 CET [2016/03/10 7:09:10 ET]
Table 'Aegina' 9-max Seat #8 is the button
Seat 1: BingoIng0 ($110.34 in chips) 
Seat 2: dvutavr ($124.57 in chips) 
Seat 3: mobi1984 ($24.91 in chips) 
Seat 4: digimatical ($56.14 in chips) 
Seat 5: Ahangama ($50 in chips) 
Seat 6: matiko09 ($50 in chips) 
Seat 7: Gummio ($103.64 in chips) 
Seat 8: ardo888 ($172.77 in chips) 
Seat 9: congcongnbnb ($166.34 in chips) 
congcongnbnb: posts small blind $0.25
BingoIng0: posts big blind $0.50
BingoIng0: posts the ante $0.10
dvutavr: posts the ante $0.10
mobi1984: posts the ante $0.10
digimatical: posts the ante $0.10
Ahangama: posts the ante $0.10
matiko09: posts the ante $0.10
Gummio: posts the ante $0.10
ardo888: posts the ante $0.10
congcongnbnb: posts the ante $0.10
*** HOLE CARDS ***
Dealt to matiko09 [Ks 5d]
dvutavr: folds 
mobi1984: folds 
digimatical: folds 
Ahangama: raises $0.75 to $1.25
matiko09: folds 
Gummio: folds 
ardo888: folds 
congcongnbnb: raises $3.25 to $4.50
BingoIng0: folds 
Ahangama: calls $3.25
*** FLOP *** [2d 3s 6h]
congcongnbnb: bets $6.61
Ahangama: folds 
Uncalled bet ($6.61) returned to congcongnbnb
congcongnbnb collected $9.93 from pot
congcongnbnb: doesn't show hand 
*** SUMMARY ***
Total pot $10.40 | Rake $0.47 
Board [2d 3s 6h]
Seat 1: BingoIng0 (big blind) folded before Flop
Seat 2: dvutavr folded before Flop (didn't bet)
Seat 3: mobi1984 folded before Flop (didn't bet)
Seat 4: digimatical folded before Flop (didn't bet)
Seat 5: Ahangama folded on the Flop
Seat 6: matiko09 folded before Flop (didn't bet)
Seat 7: Gummio folded before Flop (didn't bet)
Seat 8: ardo888 (button) folded before Flop (didn't bet)
Seat 9: congcongnbnb (small blind) collected ($9.93)





PokerStars Hand #150125530214:  Hold'em No Limit ($0.50/$1.00 USD) - 2016/03/10 13:09:26 CET [2016/03/10 7:09:26 ET]
Table 'Saskia' 9-max Seat #6 is the button
Seat 2: njurg aga ($101.07 in chips) 
Seat 3: ccmaster001 ($64.64 in chips) 
Seat 4: Plz3betMe ($85.42 in chips) 
Seat 5: dreded11 ($82.51 in chips) 
Seat 6: matiko09 ($100 in chips) 
Seat 7: stds st ($34.85 in chips) 
Seat 8: chaps1988 ($171.12 in chips) 
Seat 9: tipner ($101.50 in chips) 
stds st: posts small blind $0.50
chaps1988: posts big blind $1
*** HOLE CARDS ***
Dealt to matiko09 [3d 5h]
tipner: folds 
njurg aga: folds 
ccmaster001: raises $1 to $2
Plz3betMe: folds 
dreded11: folds 
matiko09: folds 
stds st: folds 
chaps1988: calls $1
*** FLOP *** [Qh Qs Qc]
chaps1988: checks 
ccmaster001: bets $2
chaps1988: folds 
Uncalled bet ($2) returned to ccmaster001
ccmaster001 collected $4.30 from pot
*** SUMMARY ***
Total pot $4.50 | Rake $0.20 
Board [Qh Qs Qc]
Seat 2: njurg aga folded before Flop (didn't bet)
Seat 3: ccmaster001 collected ($4.30)
Seat 4: Plz3betMe folded before Flop (didn't bet)
Seat 5: dreded11 folded before Flop (didn't bet)
Seat 6: matiko09 (button) folded before Flop (didn't bet)
Seat 7: stds st (small blind) folded before Flop
Seat 8: chaps1988 (big blind) folded on the Flop
Seat 9: tipner folded before Flop (didn't bet)





PokerStars Hand #150125537220:  Hold'em No Limit ($0.50/$1.00 USD) - 2016/03/10 13:09:40 CET [2016/03/10 7:09:40 ET]
Table 'Liriope II' 9-max Seat #8 is the button
Seat 1: di0d80 ($106.89 in chips) 
Seat 2: zxp12345 ($26.84 in chips) 
Seat 3: matiko09 ($142.59 in chips) 
Seat 4: Plz3betMe ($67.11 in chips) 
Seat 5: chaps1988 ($138.54 in chips) 
Seat 6: nobu-azabu ($182.17 in chips) 
Seat 8: PacPacBum ($103.60 in chips) 
Seat 9: tipner ($109.55 in chips) 
tipner: posts small blind $0.50
di0d80: posts big blind $1
*** HOLE CARDS ***
Dealt to matiko09 [Qc Ts]
zxp12345: raises $2.50 to $3.50
matiko09: folds 
Plz3betMe: folds 
chaps1988: folds 
nobu-azabu: folds 
PacPacBum: folds 
tipner: folds 
di0d80: folds 
Uncalled bet ($2.50) returned to zxp12345
zxp12345 collected $2.50 from pot
zxp12345: doesn't show hand 
*** SUMMARY ***
Total pot $2.50 | Rake $0 
Seat 1: di0d80 (big blind) folded before Flop
Seat 2: zxp12345 collected ($2.50)
Seat 3: matiko09 folded before Flop (didn't bet)
Seat 4: Plz3betMe folded before Flop (didn't bet)
Seat 5: chaps1988 folded before Flop (didn't bet)
Seat 6: nobu-azabu folded before Flop (didn't bet)
Seat 8: PacPacBum (button) folded before Flop (didn't bet)
Seat 9: tipner (small blind) folded before Flop





PokerStars Hand #150125542567:  Hold'em No Limit ($0.50/$1.00 USD) - 2016/03/10 13:09:50 CET [2016/03/10 7:09:50 ET]
Table 'Iguassu' 9-max Seat #5 is the button
Seat 1: blackw0lf_03 ($114.06 in chips) 
Seat 2: Rocky6434 ($50.12 in chips) 
Seat 3: hammerwife ($103.28 in chips) 
Seat 4: matiko09 ($100 in chips) 
Seat 5: ilaviiitech ($175.36 in chips) 
Seat 6: Igor DoUrden ($100 in chips) 
Seat 7: PacPacBum ($101.50 in chips) 
Seat 9: tipner ($101 in chips) 
Igor DoUrden: posts small blind $0.50
PacPacBum: posts big blind $1
*** HOLE CARDS ***
Dealt to matiko09 [8d Jc]
tipner: folds 
blackw0lf_03: folds 
Rocky6434: raises $2 to $3
hammerwife: folds 
matiko09: folds 
ilaviiitech: folds 
Igor DoUrden: folds 
PacPacBum: folds 
Uncalled bet ($2) returned to Rocky6434
Rocky6434 collected $2.50 from pot
Rocky6434: doesn't show hand 
*** SUMMARY ***
Total pot $2.50 | Rake $0 
Seat 1: blackw0lf_03 folded before Flop (didn't bet)
Seat 2: Rocky6434 collected ($2.50)
Seat 3: hammerwife folded before Flop (didn't bet)
Seat 4: matiko09 folded before Flop (didn't bet)
Seat 5: ilaviiitech (button) folded before Flop (didn't bet)
Seat 6: Igor DoUrden (small blind) folded before Flop
Seat 7: PacPacBum (big blind) folded before Flop
Seat 9: tipner folded before Flop (didn't bet)





PokerStars Hand #150125547607:  Hold'em No Limit ($0.25/$0.50 USD) - 2016/03/10 13:10:00 CET [2016/03/10 7:10:00 ET]
Table 'Aegina' 9-max Seat #9 is the button
Seat 1: BingoIng0 ($109.74 in chips) 
Seat 2: dvutavr ($124.47 in chips) 
Seat 3: mobi1984 ($24.81 in chips) 
Seat 4: digimatical ($56.04 in chips) 
Seat 5: Ahangama ($50 in chips) 
Seat 6: matiko09 ($50 in chips) 
Seat 7: Gummio ($103.54 in chips) 
Seat 8: ardo888 ($172.67 in chips) 
Seat 9: congcongnbnb ($171.67 in chips) 
BingoIng0: posts small blind $0.25
dvutavr: posts big blind $0.50
BingoIng0: posts the ante $0.10
dvutavr: posts the ante $0.10
mobi1984: posts the ante $0.10
digimatical: posts the ante $0.10
Ahangama: posts the ante $0.10
matiko09: posts the ante $0.10
Gummio: posts the ante $0.10
ardo888: posts the ante $0.10
congcongnbnb: posts the ante $0.10
*** HOLE CARDS ***
Dealt to matiko09 [8d 9s]
mobi1984: raises $0.50 to $1
digimatical: folds 
Ahangama: folds 
matiko09: folds 
Gummio: calls $1
ardo888: folds 
congcongnbnb: folds 
BingoIng0: folds 
dvutavr: folds 
*** FLOP *** [Qh Tc 5d]
mobi1984: checks 
Gummio: bets $3.49
mobi1984: folds 
Uncalled bet ($3.49) returned to Gummio
Gummio collected $3.49 from pot
Gummio: doesn't show hand 
*** SUMMARY ***
Total pot $3.65 | Rake $0.16 
Board [Qh Tc 5d]
Seat 1: BingoIng0 (small blind) folded before Flop
Seat 2: dvutavr (big blind) folded before Flop
Seat 3: mobi1984 folded on the Flop
Seat 4: digimatical folded before Flop (didn't bet)
Seat 5: Ahangama folded before Flop (didn't bet)
Seat 6: matiko09 folded before Flop (didn't bet)
Seat 7: Gummio collected ($3.49)
Seat 8: ardo888 folded before Flop (didn't bet)
Seat 9: congcongnbnb (button) folded before Flop (didn't bet)





PokerStars Hand #150125549453:  Hold'em No Limit ($0.50/$1.00 USD) - 2016/03/10 13:10:04 CET [2016/03/10 7:10:04 ET]
Table 'Liriope II' 9-max Seat #9 is the button
Seat 1: di0d80 ($105.89 in chips) 
Seat 2: zxp12345 ($28.34 in chips) 
Seat 3: matiko09 ($142.59 in chips) 
Seat 4: Plz3betMe ($67.11 in chips) 
Seat 5: chaps1988 ($138.54 in chips) 
Seat 6: nobu-azabu ($182.17 in chips) 
Seat 8: PacPacBum ($103.60 in chips) 
Seat 9: tipner ($109.05 in chips) 
di0d80: posts small blind $0.50
zxp12345: posts big blind $1
*** HOLE CARDS ***
Dealt to matiko09 [2c As]
matiko09: folds 
Plz3betMe: raises $2 to $3
chaps1988: folds 
nobu-azabu: folds 
PacPacBum: folds 
tipner: folds 
di0d80: calls $2.50
zxp12345: folds 
*** FLOP *** [Qc 6s 3c]
di0d80: checks 
Plz3betMe: checks 
*** TURN *** [Qc 6s 3c] [Qh]
di0d80: bets $4
Plz3betMe: calls $4
*** RIVER *** [Qc 6s 3c Qh] [Kc]
di0d80: bets $26
Plz3betMe: folds 
Uncalled bet ($26) returned to di0d80
di0d80 collected $14.32 from pot
di0d80: doesn't show hand 
*** SUMMARY ***
Total pot $15 | Rake $0.68 
Board [Qc 6s 3c Qh Kc]
Seat 1: di0d80 (small blind) collected ($14.32)
Seat 2: zxp12345 (big blind) folded before Flop
Seat 3: matiko09 folded before Flop (didn't bet)
Seat 4: Plz3betMe folded on the River
Seat 5: chaps1988 folded before Flop (didn't bet)
Seat 6: nobu-azabu folded before Flop (didn't bet)
Seat 8: PacPacBum folded before Flop (didn't bet)
Seat 9: tipner (button) folded before Flop (didn't bet)





PokerStars Hand #150125550535:  Hold'em No Limit ($0.50/$1.00 USD) - 2016/03/10 13:10:06 CET [2016/03/10 7:10:06 ET]
Table 'Iguassu' 9-max Seat #6 is the button
Seat 1: blackw0lf_03 ($114.06 in chips) 
Seat 2: Rocky6434 ($51.62 in chips) 
Seat 3: hammerwife ($103.28 in chips) 
Seat 4: matiko09 ($100 in chips) 
Seat 5: ilaviiitech ($175.36 in chips) 
Seat 6: Igor DoUrden ($100 in chips) 
Seat 7: PacPacBum ($100.50 in chips) 
Seat 9: tipner ($101 in chips) 
PacPacBum: posts small blind $0.50
tipner: posts big blind $1
*** HOLE CARDS ***
Dealt to matiko09 [Jd Ks]
blackw0lf_03: raises $2 to $3
Rocky6434: calls $3
hammerwife: raises $4.50 to $7.50
matiko09: folds 
ilaviiitech: folds 
Igor DoUrden: folds 
PacPacBum: folds 
tipner: folds 
blackw0lf_03: calls $4.50
Rocky6434: calls $4.50
*** FLOP *** [7d 5h 5s]
blackw0lf_03: checks 
Rocky6434: checks 
hammerwife: bets $10
blackw0lf_03: folds 
Rocky6434: folds 
Uncalled bet ($10) returned to hammerwife
hammerwife collected $22.92 from pot
hammerwife: doesn't show hand 
*** SUMMARY ***
Total pot $24 | Rake $1.08 
Board [7d 5h 5s]
Seat 1: blackw0lf_03 folded on the Flop
Seat 2: Rocky6434 folded on the Flop
Seat 3: hammerwife collected ($22.92)
Seat 4: matiko09 folded before Flop (didn't bet)
Seat 5: ilaviiitech folded before Flop (didn't bet)
Seat 6: Igor DoUrden (button) folded before Flop (didn't bet)
Seat 7: PacPacBum (small blind) folded before Flop
Seat 9: tipner (big blind) folded before Flop





PokerStars Hand #150125557624:  Hold'em No Limit ($0.50/$1.00 USD) - 2016/03/10 13:10:20 CET [2016/03/10 7:10:20 ET]
Table 'Saskia' 9-max Seat #7 is the button
Seat 2: njurg aga ($101.07 in chips) 
Seat 3: ccmaster001 ($66.94 in chips) 
Seat 4: Plz3betMe ($85.42 in chips) 
Seat 5: dreded11 ($82.51 in chips) 
Seat 6: matiko09 ($100 in chips) 
Seat 7: stds st ($34.35 in chips) 
Seat 8: chaps1988 ($169.12 in chips) 
Seat 9: tipner ($101.50 in chips) 
chaps1988: posts small blind $0.50
tipner: posts big blind $1
*** HOLE CARDS ***
Dealt to matiko09 [4s 8d]
njurg aga: folds 
ccmaster001: folds 
Plz3betMe: folds 
dreded11: folds 
matiko09: folds 
stds st: folds 
chaps1988: folds 
Uncalled bet ($0.50) returned to tipner
tipner collected $1 from pot
tipner: doesn't show hand 
*** SUMMARY ***
Total pot $1 | Rake $0 
Seat 2: njurg aga folded before Flop (didn't bet)
Seat 3: ccmaster001 folded before Flop (didn't bet)
Seat 4: Plz3betMe folded before Flop (didn't bet)
Seat 5: dreded11 folded before Flop (didn't bet)
Seat 6: matiko09 folded before Flop (didn't bet)
Seat 7: stds st (button) folded before Flop (didn't bet)
Seat 8: chaps1988 (small blind) folded before Flop
Seat 9: tipner (big blind) collected ($1)





PokerStars Hand #150125558415:  Hold'em No Limit ($0.50/$1.00 USD) - 2016/03/10 13:10:21 CET [2016/03/10 7:10:21 ET]
Table 'Leuschneria II' 9-max Seat #7 is the button
Seat 1: cdv1984 ($175.71 in chips) 
Seat 2: blackw0lf_03 ($103.21 in chips) 
Seat 3: gudridornot ($104.50 in chips) 
Seat 5: RMilPoker ($112.96 in chips) 
Seat 6: matiko09 ($113.85 in chips) 
Seat 7: Plz3betMe ($37 in chips) 
Seat 8: hammerwife ($100 in chips) 
Seat 9: Katsulion ($109.99 in chips) 
hammerwife: posts small blind $0.50
Katsulion: posts big blind $1
*** HOLE CARDS ***
Dealt to matiko09 [4c Jh]
cdv1984: folds 
blackw0lf_03: folds 
gudridornot: folds 
RMilPoker: folds 
matiko09: folds 
Plz3betMe: raises $1 to $2
hammerwife: folds 
Katsulion: calls $1
*** FLOP *** [8s 3s 2d]
Katsulion: checks 
Plz3betMe: bets $2.86
Katsulion: calls $2.86
*** TURN *** [8s 3s 2d] [Js]
Katsulion: checks 
Plz3betMe: checks 
*** RIVER *** [8s 3s 2d Js] [Ks]
Katsulion: checks 
Plz3betMe: bets $6.50
Katsulion: folds 
Uncalled bet ($6.50) returned to Plz3betMe
Plz3betMe collected $9.76 from pot
Plz3betMe: doesn't show hand 
*** SUMMARY ***
Total pot $10.22 | Rake $0.46 
Board [8s 3s 2d Js Ks]
Seat 1: cdv1984 folded before Flop (didn't bet)
Seat 2: blackw0lf_03 folded before Flop (didn't bet)
Seat 3: gudridornot folded before Flop (didn't bet)
Seat 5: RMilPoker folded before Flop (didn't bet)
Seat 6: matiko09 folded before Flop (didn't bet)
Seat 7: Plz3betMe (button) collected ($9.76)
Seat 8: hammerwife (small blind) folded before Flop
Seat 9: Katsulion (big blind) folded on the River





PokerStars Hand #150125566449:  Hold'em No Limit ($0.50/$1.00 USD) - 2016/03/10 13:10:37 CET [2016/03/10 7:10:37 ET]
Table 'Mars III' 9-max Seat #1 is the button
Seat 1: blackw0lf_03 ($100 in chips) 
Seat 5: ilaviiitech ($116.70 in chips) 
Seat 6: matiko09 ($100 in chips) 
PacPacBum will be allowed to play after the button
Igor DoUrden will be allowed to play after the button
ilaviiitech: posts small blind $0.50
matiko09: posts big blind $1
*** HOLE CARDS ***
Dealt to matiko09 [Ks 7d]
blackw0lf_03: folds 
ilaviiitech: folds 
Uncalled bet ($0.50) returned to matiko09
matiko09 collected $1 from pot
matiko09: doesn't show hand 
*** SUMMARY ***
Total pot $1 | Rake $0 
Seat 1: blackw0lf_03 (button) folded before Flop (didn't bet)
Seat 5: ilaviiitech (small blind) folded before Flop
Seat 6: matiko09 (big blind) collected ($1)





PokerStars Hand #150125570938:  Hold'em No Limit ($0.50/$1.00 USD) - 2016/03/10 13:10:45 CET [2016/03/10 7:10:45 ET]
Table 'Mars III' 9-max Seat #5 is the button
Seat 1: blackw0lf_03 ($100 in chips) 
Seat 5: ilaviiitech ($116.20 in chips) 
Seat 6: matiko09 ($100.50 in chips) 
matiko09: posts small blind $0.50
blackw0lf_03: posts big blind $1
PacPacBum: sits out 
Igor DoUrden: sits out 
*** HOLE CARDS ***
Dealt to matiko09 [5s 9s]
ilaviiitech: raises $2 to $3
matiko09: folds 
blackw0lf_03: folds 
Uncalled bet ($2) returned to ilaviiitech
ilaviiitech collected $2.50 from pot
ilaviiitech: doesn't show hand 
*** SUMMARY ***
Total pot $2.50 | Rake $0 
Seat 1: blackw0lf_03 (big blind) folded before Flop
Seat 5: ilaviiitech (button) collected ($2.50)
Seat 6: matiko09 (small blind) folded before Flop





PokerStars Hand #150125572201:  Hold'em No Limit ($0.25/$0.50 USD) - 2016/03/10 13:10:48 CET [2016/03/10 7:10:48 ET]
Table 'Aegina' 9-max Seat #1 is the button
Seat 1: BingoIng0 ($109.39 in chips) 
Seat 2: dvutavr ($123.87 in chips) 
Seat 3: mobi1984 ($23.71 in chips) 
Seat 4: digimatical ($55.94 in chips) 
Seat 5: Ahangama ($50 in chips) 
Seat 6: matiko09 ($50 in chips) 
Seat 7: Gummio ($105.93 in chips) 
Seat 8: ardo888 ($172.57 in chips) 
Seat 9: congcongnbnb ($171.57 in chips) 
dvutavr: posts small blind $0.25
mobi1984: posts big blind $0.50
BingoIng0: posts the ante $0.10
dvutavr: posts the ante $0.10
mobi1984: posts the ante $0.10
digimatical: posts the ante $0.10
Ahangama: posts the ante $0.10
matiko09: posts the ante $0.10
Gummio: posts the ante $0.10
ardo888: posts the ante $0.10
congcongnbnb: posts the ante $0.10
*** HOLE CARDS ***
Dealt to matiko09 [5h 2h]
digimatical: calls $0.50
Ahangama: folds 
matiko09: folds 
Gummio: folds 
ardo888: raises $2.65 to $3.15
congcongnbnb: folds 
BingoIng0: folds 
dvutavr: folds 
mobi1984: folds 
digimatical: folds 
Uncalled bet ($2.65) returned to ardo888
ardo888 collected $2.65 from pot
ardo888: doesn't show hand 
*** SUMMARY ***
Total pot $2.65 | Rake $0 
Seat 1: BingoIng0 (button) folded before Flop (didn't bet)
Seat 2: dvutavr (small blind) folded before Flop
Seat 3: mobi1984 (big blind) folded before Flop
Seat 4: digimatical folded before Flop
Seat 5: Ahangama folded before Flop (didn't bet)
Seat 6: matiko09 folded before Flop (didn't bet)
Seat 7: Gummio folded before Flop (didn't bet)
Seat 8: ardo888 collected ($2.65)
Seat 9: congcongnbnb folded before Flop (didn't bet)





PokerStars Hand #150125575075:  Hold'em No Limit ($0.50/$1.00 USD) - 2016/03/10 13:10:53 CET [2016/03/10 7:10:53 ET]
Table 'Saskia' 9-max Seat #8 is the button
Seat 2: njurg aga ($101.07 in chips) 
Seat 3: ccmaster001 ($66.94 in chips) 
Seat 4: Plz3betMe ($85.42 in chips) 
Seat 5: dreded11 ($82.51 in chips) 
Seat 6: matiko09 ($100 in chips) 
Seat 7: stds st ($34.35 in chips) 
Seat 8: chaps1988 ($168.62 in chips) 
Seat 9: tipner ($102 in chips) 
tipner: posts small blind $0.50
njurg aga: posts big blind $1
*** HOLE CARDS ***
Dealt to matiko09 [3c Js]
ccmaster001: folds 
Plz3betMe: folds 
dreded11: raises $1 to $2
matiko09: folds 
stds st: calls $2
chaps1988: folds 
tipner: folds 
njurg aga: calls $1
*** FLOP *** [Th 4h 9h]
njurg aga: checks 
dreded11: checks 
stds st: checks 
*** TURN *** [Th 4h 9h] [Qh]
njurg aga: checks 
dreded11: bets $1
stds st: folds 
njurg aga: folds 
Uncalled bet ($1) returned to dreded11
dreded11 collected $6.21 from pot
dreded11: doesn't show hand 
*** SUMMARY ***
Total pot $6.50 | Rake $0.29 
Board [Th 4h 9h Qh]
Seat 2: njurg aga (big blind) folded on the Turn
Seat 3: ccmaster001 folded before Flop (didn't bet)
Seat 4: Plz3betMe folded before Flop (didn't bet)
Seat 5: dreded11 collected ($6.21)
Seat 6: matiko09 folded before Flop (didn't bet)
Seat 7: stds st folded on the Turn
Seat 8: chaps1988 (button) folded before Flop (didn't bet)
Seat 9: tipner (small blind) folded before Flop





PokerStars Hand #150125579508:  Hold'em No Limit ($1/$2 USD) - 2016/03/10 13:11:02 CET [2016/03/10 7:11:02 ET]
Table 'Rimito II' 9-max Seat #2 is the button
Seat 1: stds st ($77 in chips) 
Seat 2: chaps1988 ($200 in chips) 
Seat 3: Yaaaazz ($295.31 in chips) 
Seat 4: di0d80 ($200 in chips) 
Seat 5: rijger321 ($128.11 in chips) 
Seat 6: Fish4trips ($200 in chips) 
Seat 7: matiko09 ($200 in chips) 
Seat 8: Olddogtom888 ($159.20 in chips) 
Seat 9: tipner ($210.70 in chips) 
Yaaaazz: posts small blind $1
di0d80: posts big blind $2
Olddogtom888: posts small & big blinds $3
*** HOLE CARDS ***
Dealt to matiko09 [2d Kc]
rijger321: folds 
Fish4trips: folds 
matiko09: folds 
Olddogtom888: raises $4 to $6
tipner: folds 
stds st: folds 
chaps1988: folds 
Yaaaazz: folds 
di0d80: raises $12 to $18
Olddogtom888: calls $12
*** FLOP *** [Kd 3c 9c]
di0d80: checks 
Olddogtom888: checks 
*** TURN *** [Kd 3c 9c] [Ts]
di0d80: checks 
Olddogtom888: bets $25
di0d80: calls $25
*** RIVER *** [Kd 3c 9c Ts] [5h]
di0d80: checks 
Olddogtom888: bets $35
di0d80: calls $35
*** SHOW DOWN ***
Olddogtom888: shows [Ac Kh] (a pair of Kings)
di0d80: mucks hand 
Olddogtom888 collected $155.20 from pot
*** SUMMARY ***
Total pot $158 | Rake $2.80 
Board [Kd 3c 9c Ts 5h]
Seat 1: stds st folded before Flop (didn't bet)
Seat 2: chaps1988 (button) folded before Flop (didn't bet)
Seat 3: Yaaaazz (small blind) folded before Flop
Seat 4: di0d80 (big blind) mucked [Jc Js]
Seat 5: rijger321 folded before Flop (didn't bet)
Seat 6: Fish4trips folded before Flop (didn't bet)
Seat 7: matiko09 folded before Flop (didn't bet)
Seat 8: Olddogtom888 showed [Ac Kh] and won ($155.20) with a pair of Kings
Seat 9: tipner folded before Flop (didn't bet)





PokerStars Hand #150125581860:  Hold'em No Limit ($0.50/$1.00 USD) - 2016/03/10 13:11:06 CET [2016/03/10 7:11:06 ET]
Table 'Mars III' 9-max Seat #6 is the button
Seat 1: blackw0lf_03 ($100 in chips) 
Seat 2: pokixy800 ($80 in chips) 
Seat 5: ilaviiitech ($117.70 in chips) 
Seat 6: matiko09 ($100 in chips) 
blackw0lf_03: posts small blind $0.50
pokixy800: posts big blind $1
PacPacBum: sits out 
Igor DoUrden: sits out 
*** HOLE CARDS ***
Dealt to matiko09 [Td 9d]
ilaviiitech: folds 
matiko09: raises $1.27 to $2.27
er13to joins the table at seat #9 
blackw0lf_03: folds 
pokixy800: calls $1.27
*** FLOP *** [5h 8c Tc]
pokixy800: checks 
matiko09: bets $3.13
pokixy800: calls $3.13
*** TURN *** [5h 8c Tc] [5c]
pokixy800: checks 
matiko09: checks 
*** RIVER *** [5h 8c Tc 5c] [9h]
pokixy800: checks 
matiko09: bets $7.01
pokixy800: folds 
Uncalled bet ($7.01) returned to matiko09
matiko09 collected $10.79 from pot
matiko09: doesn't show hand 
*** SUMMARY ***
Total pot $11.30 | Rake $0.51 
Board [5h 8c Tc 5c 9h]
Seat 1: blackw0lf_03 (small blind) folded before Flop
Seat 2: pokixy800 (big blind) folded on the River
Seat 5: ilaviiitech folded before Flop (didn't bet)
Seat 6: matiko09 (button) collected ($10.79)





PokerStars Hand #150125592854:  Hold'em No Limit ($0.50/$1.00 USD) - 2016/03/10 13:11:27 CET [2016/03/10 7:11:27 ET]
Table 'Iguassu' 9-max Seat #7 is the button
Seat 1: blackw0lf_03 ($106.56 in chips) 
Seat 2: Rocky6434 ($44.12 in chips) 
Seat 3: hammerwife ($118.70 in chips) 
Seat 4: matiko09 ($100 in chips) 
Seat 5: ilaviiitech ($175.36 in chips) 
Seat 6: Igor DoUrden ($100 in chips) 
Seat 7: PacPacBum ($100 in chips) 
Seat 9: tipner ($100 in chips) 
tipner: posts small blind $0.50
blackw0lf_03: posts big blind $1
*** HOLE CARDS ***
Dealt to matiko09 [9c 6c]
Rocky6434: folds 
hammerwife: raises $2 to $3
matiko09: folds 
ilaviiitech: folds 
Igor DoUrden: folds 
PacPacBum: folds 
tipner: folds 
blackw0lf_03: folds 
Uncalled bet ($2) returned to hammerwife
hammerwife collected $2.50 from pot
hammerwife: doesn't show hand 
*** SUMMARY ***
Total pot $2.50 | Rake $0 
Seat 1: blackw0lf_03 (big blind) folded before Flop
Seat 2: Rocky6434 folded before Flop (didn't bet)
Seat 3: hammerwife collected ($2.50)
Seat 4: matiko09 folded before Flop (didn't bet)
Seat 5: ilaviiitech folded before Flop (didn't bet)
Seat 6: Igor DoUrden folded before Flop (didn't bet)
Seat 7: PacPacBum (button) folded before Flop (didn't bet)
Seat 9: tipner (small blind) folded before Flop





PokerStars Hand #150125593153:  Hold'em No Limit ($0.25/$0.50 USD) - 2016/03/10 13:11:28 CET [2016/03/10 7:11:28 ET]
Table 'Aegina' 9-max Seat #2 is the button
Seat 1: BingoIng0 ($109.29 in chips) 
Seat 2: dvutavr ($123.52 in chips) 
Seat 3: mobi1984 ($23.11 in chips) 
Seat 4: digimatical ($55.34 in chips) 
Seat 5: Ahangama ($50 in chips) 
Seat 6: matiko09 ($50 in chips) 
Seat 7: Gummio ($105.83 in chips) 
Seat 8: ardo888 ($174.62 in chips) 
Seat 9: congcongnbnb ($171.47 in chips) 
mobi1984: posts small blind $0.25
digimatical: posts big blind $0.50
BingoIng0: posts the ante $0.10
dvutavr: posts the ante $0.10
mobi1984: posts the ante $0.10
digimatical: posts the ante $0.10
Ahangama: posts the ante $0.10
matiko09: posts the ante $0.10
Gummio: posts the ante $0.10
ardo888: posts the ante $0.10
congcongnbnb: posts the ante $0.10
*** HOLE CARDS ***
Dealt to matiko09 [9c Jd]
Ahangama: folds 
matiko09: folds 
Gummio: folds 
ardo888: folds 
congcongnbnb: folds 
BingoIng0: raises $0.75 to $1.25
dvutavr: folds 
mobi1984: folds 
digimatical: calls $0.75
*** FLOP *** [5d 6c Tc]
digimatical: checks 
BingoIng0: bets $3.17
digimatical: folds 
Uncalled bet ($3.17) returned to BingoIng0
BingoIng0 collected $3.49 from pot
BingoIng0: doesn't show hand 
*** SUMMARY ***
Total pot $3.65 | Rake $0.16 
Board [5d 6c Tc]
Seat 1: BingoIng0 collected ($3.49)
Seat 2: dvutavr (button) folded before Flop (didn't bet)
Seat 3: mobi1984 (small blind) folded before Flop
Seat 4: digimatical (big blind) folded on the Flop
Seat 5: Ahangama folded before Flop (didn't bet)
Seat 6: matiko09 folded before Flop (didn't bet)
Seat 7: Gummio folded before Flop (didn't bet)
Seat 8: ardo888 folded before Flop (didn't bet)
Seat 9: congcongnbnb folded before Flop (didn't bet)





PokerStars Hand #150125597509:  Hold'em No Limit ($0.50/$1.00 USD) - 2016/03/10 13:11:36 CET [2016/03/10 7:11:36 ET]
Table 'Leuschneria II' 9-max Seat #8 is the button
Seat 1: cdv1984 ($175.71 in chips) 
Seat 2: blackw0lf_03 ($103.21 in chips) 
Seat 3: gudridornot ($104.50 in chips) 
Seat 4: Sweden_Pound ($117.81 in chips) 
Seat 5: RMilPoker ($112.96 in chips) 
Seat 6: matiko09 ($113.85 in chips) 
Seat 7: Plz3betMe ($41.90 in chips) 
Seat 8: hammerwife ($100 in chips) 
Seat 9: Katsulion ($105.13 in chips) 
Katsulion: posts small blind $0.50
cdv1984: posts big blind $1
*** HOLE CARDS ***
Dealt to matiko09 [Js 6d]
blackw0lf_03: folds 
gudridornot: folds 
Sweden_Pound: folds 
RMilPoker: folds 
matiko09: folds 
Plz3betMe: folds 
hammerwife: folds 
Katsulion: raises $2 to $3
cdv1984: folds 
Uncalled bet ($2) returned to Katsulion
Katsulion collected $2 from pot
*** SUMMARY ***
Total pot $2 | Rake $0 
Seat 1: cdv1984 (big blind) folded before Flop
Seat 2: blackw0lf_03 folded before Flop (didn't bet)
Seat 3: gudridornot folded before Flop (didn't bet)
Seat 4: Sweden_Pound folded before Flop (didn't bet)
Seat 5: RMilPoker folded before Flop (didn't bet)
Seat 6: matiko09 folded before Flop (didn't bet)
Seat 7: Plz3betMe folded before Flop (didn't bet)
Seat 8: hammerwife (button) folded before Flop (didn't bet)
Seat 9: Katsulion (small blind) collected ($2)





PokerStars Hand #150125599748:  Hold'em No Limit ($0.50/$1.00 USD) - 2016/03/10 13:11:41 CET [2016/03/10 7:11:41 ET]
Table 'Liriope II' 9-max Seat #1 is the button
Seat 1: di0d80 ($113.21 in chips) 
Seat 2: zxp12345 ($27.34 in chips) 
Seat 3: matiko09 ($142.59 in chips) 
Seat 4: Plz3betMe ($60.11 in chips) 
Seat 5: chaps1988 ($138.54 in chips) 
Seat 6: nobu-azabu ($182.17 in chips) 
Seat 7: Sweden_Pound ($100 in chips) 
Seat 8: PacPacBum ($103.60 in chips) 
Seat 9: tipner ($109.05 in chips) 
zxp12345: posts small blind $0.50
matiko09: posts big blind $1
*** HOLE CARDS ***
Dealt to matiko09 [Jh Td]
Plz3betMe: folds 
chaps1988: folds 
nobu-azabu: folds 
Sweden_Pound: folds 
PacPacBum: folds 
tipner: raises $1 to $2
di0d80: folds 
zxp12345: raises $5 to $7
matiko09: folds 
tipner: folds 
Uncalled bet ($5) returned to zxp12345
zxp12345 collected $5 from pot
zxp12345: doesn't show hand 
*** SUMMARY ***
Total pot $5 | Rake $0 
Seat 1: di0d80 (button) folded before Flop (didn't bet)
Seat 2: zxp12345 (small blind) collected ($5)
Seat 3: matiko09 (big blind) folded before Flop
Seat 4: Plz3betMe folded before Flop (didn't bet)
Seat 5: chaps1988 folded before Flop (didn't bet)
Seat 6: nobu-azabu folded before Flop (didn't bet)
Seat 7: Sweden_Pound folded before Flop (didn't bet)
Seat 8: PacPacBum folded before Flop (didn't bet)
Seat 9: tipner folded before Flop





PokerStars Hand #150125604551:  Hold'em No Limit ($0.50/$1.00 USD) - 2016/03/10 13:11:50 CET [2016/03/10 7:11:50 ET]
Table 'Saskia' 9-max Seat #9 is the button
Seat 2: njurg aga ($99.07 in chips) 
Seat 3: ccmaster001 ($66.94 in chips) 
Seat 4: Plz3betMe ($85.42 in chips) 
Seat 5: dreded11 ($86.72 in chips) 
Seat 6: matiko09 ($100 in chips) 
Seat 7: stds st ($32.35 in chips) 
Seat 8: chaps1988 ($168.62 in chips) 
Seat 9: tipner ($101.50 in chips) 
Sweden_Pound will be allowed to play after the button
njurg aga: posts small blind $0.50
ccmaster001: posts big blind $1
*** HOLE CARDS ***
Dealt to matiko09 [Qs 5d]
Plz3betMe: folds 
dreded11: folds 
matiko09: folds 
stds st: folds 
chaps1988: folds 
tipner: raises $1.50 to $2.50
njurg aga: folds 
ccmaster001: calls $1.50
*** FLOP *** [Kd Qd 4s]
ccmaster001: bets $3
tipner: calls $3
*** TURN *** [Kd Qd 4s] [7c]
ccmaster001: checks 
tipner: bets $6
ccmaster001: folds 
Uncalled bet ($6) returned to tipner
tipner collected $10.98 from pot
tipner: doesn't show hand 
*** SUMMARY ***
Total pot $11.50 | Rake $0.52 
Board [Kd Qd 4s 7c]
Seat 2: njurg aga (small blind) folded before Flop
Seat 3: ccmaster001 (big blind) folded on the Turn
Seat 4: Plz3betMe folded before Flop (didn't bet)
Seat 5: dreded11 folded before Flop (didn't bet)
Seat 6: matiko09 folded before Flop (didn't bet)
Seat 7: stds st folded before Flop (didn't bet)
Seat 8: chaps1988 folded before Flop (didn't bet)
Seat 9: tipner (button) collected ($10.98)





PokerStars Hand #150125607728:  Hold'em No Limit ($0.50/$1.00 USD) - 2016/03/10 13:11:56 CET [2016/03/10 7:11:56 ET]
Table 'Iguassu' 9-max Seat #9 is the button
Seat 1: blackw0lf_03 ($105.56 in chips) 
Seat 2: Rocky6434 ($44.12 in chips) 
Seat 3: hammerwife ($120.20 in chips) 
Seat 4: matiko09 ($100 in chips) 
Seat 5: ilaviiitech ($175.36 in chips) 
Seat 6: Igor DoUrden ($100 in chips) 
Seat 7: PacPacBum ($100 in chips) 
Seat 9: tipner ($100 in chips) 
blackw0lf_03: posts small blind $0.50
Rocky6434: posts big blind $1
Sweden_Pound: sits out 
*** HOLE CARDS ***
Dealt to matiko09 [3c As]
hammerwife: folds 
matiko09: folds 
ilaviiitech: folds 
Igor DoUrden: folds 
PacPacBum: folds 
tipner: folds 
blackw0lf_03: calls $0.50
Rocky6434: checks 
*** FLOP *** [Qd 7h 5s]
blackw0lf_03: checks 
Rocky6434: checks 
*** TURN *** [Qd 7h 5s] [5c]
blackw0lf_03: checks 
Rocky6434: checks 
*** RIVER *** [Qd 7h 5s 5c] [Ad]
blackw0lf_03: checks 
Rocky6434: checks 
*** SHOW DOWN ***
blackw0lf_03: shows [4h Ac] (two pair, Aces and Fives)
Rocky6434: mucks hand 
blackw0lf_03 collected $1.91 from pot
*** SUMMARY ***
Total pot $2 | Rake $0.09 
Board [Qd 7h 5s 5c Ad]
Seat 1: blackw0lf_03 (small blind) showed [4h Ac] and won ($1.91) with two pair, Aces and Fives
Seat 2: Rocky6434 (big blind) mucked [7c 9d]
Seat 3: hammerwife folded before Flop (didn't bet)
Seat 4: matiko09 folded before Flop (didn't bet)
Seat 5: ilaviiitech folded before Flop (didn't bet)
Seat 6: Igor DoUrden folded before Flop (didn't bet)
Seat 7: PacPacBum folded before Flop (didn't bet)
Seat 9: tipner (button) folded before Flop (didn't bet)





PokerStars Hand #150125608449:  Hold'em No Limit ($0.50/$1.00 USD) - 2016/03/10 13:11:57 CET [2016/03/10 7:11:57 ET]
Table 'Mars III' 9-max Seat #1 is the button
Seat 1: blackw0lf_03 ($100 in chips) 
Seat 2: pokixy800 ($74.60 in chips) 
Seat 3: PacPacBum ($100 in chips) 
Seat 5: ilaviiitech ($117.70 in chips) 
Seat 6: matiko09 ($105.39 in chips) 
pokixy800: posts small blind $0.50
PacPacBum: posts big blind $1
Igor DoUrden: sits out 
*** HOLE CARDS ***
Dealt to matiko09 [5c 7d]
ilaviiitech: folds 
matiko09: folds 
blackw0lf_03: folds 
pokixy800: raises $1.50 to $2.50
PacPacBum: folds 
Uncalled bet ($1.50) returned to pokixy800
pokixy800 collected $2 from pot
*** SUMMARY ***
Total pot $2 | Rake $0 
Seat 1: blackw0lf_03 (button) folded before Flop (didn't bet)
Seat 2: pokixy800 (small blind) collected ($2)
Seat 3: PacPacBum (big blind) folded before Flop
Seat 5: ilaviiitech folded before Flop (didn't bet)
Seat 6: matiko09 folded before Flop (didn't bet)





PokerStars Hand #150125614341:  Hold'em No Limit ($0.50/$1.00 USD) - 2016/03/10 13:12:09 CET [2016/03/10 7:12:09 ET]
Table 'Leuschneria II' 9-max Seat #9 is the button
Seat 1: cdv1984 ($174.71 in chips) 
Seat 2: blackw0lf_03 ($103.21 in chips) 
Seat 3: gudridornot ($104.50 in chips) 
Seat 4: Sweden_Pound ($117.81 in chips) 
Seat 5: RMilPoker ($112.96 in chips) 
Seat 6: matiko09 ($113.85 in chips) 
Seat 7: Plz3betMe ($41.90 in chips) 
Seat 8: hammerwife ($100 in chips) 
Seat 9: Katsulion ($106.13 in chips) 
cdv1984: posts small blind $0.50
blackw0lf_03: posts big blind $1
*** HOLE CARDS ***
Dealt to matiko09 [7c 7h]
gudridornot: folds 
Sweden_Pound: folds 
RMilPoker: folds 
matiko09: raises $2 to $3
Plz3betMe: folds 
hammerwife: folds 
Katsulion: raises $4 to $7
cdv1984: folds 
blackw0lf_03: folds 
matiko09: calls $4
*** FLOP *** [5h 8h 5d]
matiko09: checks 
Katsulion: bets $8.22
matiko09: calls $8.22
*** TURN *** [5h 8h 5d] [5s]
matiko09: checks 
Katsulion: bets $20
matiko09: folds 
Uncalled bet ($20) returned to Katsulion
Katsulion collected $30.50 from pot
*** SUMMARY ***
Total pot $31.94 | Rake $1.44 
Board [5h 8h 5d 5s]
Seat 1: cdv1984 (small blind) folded before Flop
Seat 2: blackw0lf_03 (big blind) folded before Flop
Seat 3: gudridornot folded before Flop (didn't bet)
Seat 4: Sweden_Pound folded before Flop (didn't bet)
Seat 5: RMilPoker folded before Flop (didn't bet)
Seat 6: matiko09 folded on the Turn
Seat 7: Plz3betMe folded before Flop (didn't bet)
Seat 8: hammerwife folded before Flop (didn't bet)
Seat 9: Katsulion (button) collected ($30.50)





PokerStars Hand #150125615663:  Hold'em No Limit ($0.50/$1.00 USD) - 2016/03/10 13:12:11 CET [2016/03/10 7:12:11 ET]
Table 'Mars III' 9-max Seat #2 is the button
Seat 1: blackw0lf_03 ($100 in chips) 
Seat 2: pokixy800 ($75.60 in chips) 
Seat 3: PacPacBum ($100 in chips) 
Seat 4: Igor DoUrden ($100 in chips) 
Seat 5: ilaviiitech ($117.70 in chips) 
Seat 6: matiko09 ($105.39 in chips) 
PacPacBum: posts small blind $0.50
Igor DoUrden: posts big blind $1
*** HOLE CARDS ***
Dealt to matiko09 [2s 7h]
ilaviiitech: folds 
matiko09: folds 
blackw0lf_03: folds 
pokixy800: raises $1.50 to $2.50
PacPacBum: raises $5.50 to $8
Igor DoUrden: folds 
pokixy800: calls $5.50
*** FLOP *** [Td 3h Ah]
PacPacBum: checks 
pokixy800: checks 
*** TURN *** [Td 3h Ah] [Tc]
PacPacBum: checks 
pokixy800: checks 
*** RIVER *** [Td 3h Ah Tc] [Th]
Sweden_Pound joins the table at seat #7 
Dennie Denc joins the table at seat #8 
PacPacBum: checks 
pokixy800: checks 
*** SHOW DOWN ***
PacPacBum: shows [Ad 2d] (a full house, Tens full of Aces)
pokixy800: mucks hand 
PacPacBum collected $16.24 from pot
*** SUMMARY ***
Total pot $17 | Rake $0.76 
Board [Td 3h Ah Tc Th]
Seat 1: blackw0lf_03 folded before Flop (didn't bet)
Seat 2: pokixy800 (button) mucked [Jd Kc]
Seat 3: PacPacBum (small blind) showed [Ad 2d] and won ($16.24) with a full house, Tens full of Aces
Seat 4: Igor DoUrden (big blind) folded before Flop
Seat 5: ilaviiitech folded before Flop (didn't bet)
Seat 6: matiko09 folded before Flop (didn't bet)





PokerStars Hand #150125616066:  Hold'em No Limit ($0.25/$0.50 USD) - 2016/03/10 13:12:12 CET [2016/03/10 7:12:12 ET]
Table 'Aegina' 9-max Seat #3 is the button
Seat 1: BingoIng0 ($111.43 in chips) 
Seat 2: dvutavr ($123.42 in chips) 
Seat 3: mobi1984 ($22.76 in chips) 
Seat 4: digimatical ($53.99 in chips) 
Seat 5: Ahangama ($50 in chips) 
Seat 6: matiko09 ($50 in chips) 
Seat 7: Gummio ($105.73 in chips) 
Seat 8: ardo888 ($174.52 in chips) 
Seat 9: congcongnbnb ($171.37 in chips) 
digimatical: posts small blind $0.25
Ahangama: posts big blind $0.50
BingoIng0: posts the ante $0.10
dvutavr: posts the ante $0.10
mobi1984: posts the ante $0.10
digimatical: posts the ante $0.10
Ahangama: posts the ante $0.10
matiko09: posts the ante $0.10
Gummio: posts the ante $0.10
ardo888: posts the ante $0.10
congcongnbnb: posts the ante $0.10
*** HOLE CARDS ***
Dealt to matiko09 [Js 5d]
matiko09: folds 
Gummio: folds 
ardo888: folds 
congcongnbnb: folds 
BingoIng0: folds 
dvutavr: folds 
mobi1984: raises $0.50 to $1
digimatical: calls $0.75
Ahangama: folds 
*** FLOP *** [9d 6d Td]
digimatical: bets $1.62
mobi1984: folds 
Uncalled bet ($1.62) returned to digimatical
digimatical collected $3.25 from pot
*** SUMMARY ***
Total pot $3.40 | Rake $0.15 
Board [9d 6d Td]
Seat 1: BingoIng0 folded before Flop (didn't bet)
Seat 2: dvutavr folded before Flop (didn't bet)
Seat 3: mobi1984 (button) folded on the Flop
Seat 4: digimatical (small blind) collected ($3.25)
Seat 5: Ahangama (big blind) folded before Flop
Seat 6: matiko09 folded before Flop (didn't bet)
Seat 7: Gummio folded before Flop (didn't bet)
Seat 8: ardo888 folded before Flop (didn't bet)
Seat 9: congcongnbnb folded before Flop (didn't bet)





PokerStars Hand #150125619490:  Hold'em No Limit ($0.50/$1.00 USD) - 2016/03/10 13:12:19 CET [2016/03/10 7:12:19 ET]
Table 'Liriope II' 9-max Seat #2 is the button
Seat 1: di0d80 ($113.21 in chips) 
Seat 2: zxp12345 ($30.34 in chips) 
Seat 3: matiko09 ($141.59 in chips) 
Seat 4: Plz3betMe ($60.11 in chips) 
Seat 5: chaps1988 ($138.54 in chips) 
Seat 6: nobu-azabu ($182.17 in chips) 
Seat 7: Sweden_Pound ($100 in chips) 
Seat 8: PacPacBum ($103.60 in chips) 
Seat 9: tipner ($107.05 in chips) 
matiko09: posts small blind $0.50
Plz3betMe: posts big blind $1
*** HOLE CARDS ***
Dealt to matiko09 [As Ac]
chaps1988: folds 
nobu-azabu: folds 
Sweden_Pound: raises $2 to $3
PacPacBum: folds 
tipner: folds 
di0d80: folds 
zxp12345: calls $3
matiko09: raises $9 to $12
Plz3betMe: folds 
Sweden_Pound: calls $9
zxp12345: calls $9
*** FLOP *** [6s 8d 2h]
matiko09: bets $18.34
Sweden_Pound: folds 
zxp12345: folds 
Uncalled bet ($18.34) returned to matiko09
matiko09 collected $35.34 from pot
matiko09: doesn't show hand 
*** SUMMARY ***
Total pot $37 | Rake $1.66 
Board [6s 8d 2h]
Seat 1: di0d80 folded before Flop (didn't bet)
Seat 2: zxp12345 (button) folded on the Flop
Seat 3: matiko09 (small blind) collected ($35.34)
Seat 4: Plz3betMe (big blind) folded before Flop
Seat 5: chaps1988 folded before Flop (didn't bet)
Seat 6: nobu-azabu folded before Flop (didn't bet)
Seat 7: Sweden_Pound folded on the Flop
Seat 8: PacPacBum folded before Flop (didn't bet)
Seat 9: tipner folded before Flop (didn't bet)





PokerStars Hand #150125636420:  Hold'em No Limit ($0.50/$1.00 USD) - 2016/03/10 13:12:51 CET [2016/03/10 7:12:51 ET]
Table 'Saskia' 9-max Seat #2 is the button
Seat 2: njurg aga ($98.57 in chips) 
Seat 3: ccmaster001 ($61.44 in chips) 
Seat 4: Plz3betMe ($85.42 in chips) 
Seat 5: dreded11 ($86.72 in chips) 
Seat 6: matiko09 ($100 in chips) 
Seat 7: stds st ($32.35 in chips) 
Seat 8: chaps1988 ($168.62 in chips) 
Seat 9: tipner ($106.98 in chips) 
ccmaster001: posts small blind $0.50
Plz3betMe: posts big blind $1
Sweden_Pound: sits out 
*** HOLE CARDS ***
Dealt to matiko09 [6d 7c]
dreded11: folds 
matiko09: folds 
stds st: folds 
chaps1988: folds 
tipner: folds 
njurg aga: folds 
ccmaster001: folds 
Uncalled bet ($0.50) returned to Plz3betMe
Plz3betMe collected $1 from pot
Plz3betMe: doesn't show hand 
*** SUMMARY ***
Total pot $1 | Rake $0 
Seat 2: njurg aga (button) folded before Flop (didn't bet)
Seat 3: ccmaster001 (small blind) folded before Flop
Seat 4: Plz3betMe (big blind) collected ($1)
Seat 5: dreded11 folded before Flop (didn't bet)
Seat 6: matiko09 folded before Flop (didn't bet)
Seat 7: stds st folded before Flop (didn't bet)
Seat 8: chaps1988 folded before Flop (didn't bet)
Seat 9: tipner folded before Flop (didn't bet)





PokerStars Hand #150125638339:  Hold'em No Limit (€0.50/€1.00 EUR) - 2016/03/10 13:12:55 CET [2016/03/10 7:12:55 ET]
Table 'Claudia' 9-max Seat #3 is the button
Seat 1: matiko09 (€100 in chips) 
Seat 2: er13to (€100 in chips) 
Seat 3: full-deck699 (€52.28 in chips) 
Seat 4: Sweden_Pound (€100 in chips) 
Seat 5: Spid1 (€100 in chips) 
Seat 6: di0d80 (€100 in chips) 
Seat 7: tipner (€100 in chips) 
Seat 8: UnBent022 (€100 in chips) 
Seat 9: blackw0lf_03 (€100 in chips) 
Sweden_Pound: posts small blind €0.50
Spid1: posts big blind €1
*** HOLE CARDS ***
Dealt to matiko09 [8h 3h]
di0d80: raises €1.50 to €2.50
tipner: folds 
UnBent022: folds 
blackw0lf_03: folds 
matiko09: folds 
er13to: folds 
full-deck699: folds 
Sweden_Pound: calls €2
Spid1: folds 
*** FLOP *** [2c Kh Ah]
Sweden_Pound: checks 
di0d80: bets €4
Sweden_Pound: folds 
Uncalled bet (€4) returned to di0d80
di0d80 collected €5.73 from pot
di0d80: doesn't show hand 
*** SUMMARY ***
Total pot €6 | Rake €0.27 
Board [2c Kh Ah]
Seat 1: matiko09 folded before Flop (didn't bet)
Seat 2: er13to folded before Flop (didn't bet)
Seat 3: full-deck699 (button) folded before Flop (didn't bet)
Seat 4: Sweden_Pound (small blind) folded on the Flop
Seat 5: Spid1 (big blind) folded before Flop
Seat 6: di0d80 collected (€5.73)
Seat 7: tipner folded before Flop (didn't bet)
Seat 8: UnBent022 folded before Flop (didn't bet)
Seat 9: blackw0lf_03 folded before Flop (didn't bet)





PokerStars Hand #150125640498:  Hold'em No Limit ($0.25/$0.50 USD) - 2016/03/10 13:12:59 CET [2016/03/10 7:12:59 ET]
Table 'Aegina' 9-max Seat #4 is the button
Seat 1: BingoIng0 ($111.33 in chips) 
Seat 2: dvutavr ($123.32 in chips) 
Seat 3: mobi1984 ($21.66 in chips) 
Seat 4: digimatical ($56.14 in chips) 
Seat 5: Ahangama ($50 in chips) 
Seat 6: matiko09 ($50 in chips) 
Seat 7: Gummio ($105.63 in chips) 
Seat 8: ardo888 ($174.42 in chips) 
Seat 9: congcongnbnb ($171.27 in chips) 
Ahangama: posts small blind $0.25
matiko09: posts big blind $0.50
BingoIng0: posts the ante $0.10
dvutavr: posts the ante $0.10
mobi1984: posts the ante $0.10
digimatical: posts the ante $0.10
Ahangama: posts the ante $0.10
matiko09: posts the ante $0.10
Gummio: posts the ante $0.10
ardo888: posts the ante $0.10
congcongnbnb: posts the ante $0.10
*** HOLE CARDS ***
Dealt to matiko09 [4s 8h]
Gummio: raises $0.50 to $1
ardo888: folds 
congcongnbnb: folds 
BingoIng0: folds 
dvutavr: folds 
mobi1984: calls $1
digimatical: folds 
Ahangama: calls $0.75
matiko09: folds 
*** FLOP *** [Jh 2s 3d]
Ahangama: checks 
Gummio: checks 
mobi1984: bets $1
Ahangama: raises $3 to $4
Gummio: folds 
mobi1984: folds 
Uncalled bet ($3) returned to Ahangama
Ahangama collected $6.11 from pot
Ahangama: doesn't show hand 
*** SUMMARY ***
Total pot $6.40 | Rake $0.29 
Board [Jh 2s 3d]
Seat 1: BingoIng0 folded before Flop (didn't bet)
Seat 2: dvutavr folded before Flop (didn't bet)
Seat 3: mobi1984 folded on the Flop
Seat 4: digimatical (button) folded before Flop (didn't bet)
Seat 5: Ahangama (small blind) collected ($6.11)
Seat 6: matiko09 (big blind) folded before Flop
Seat 7: Gummio folded on the Flop
Seat 8: ardo888 folded before Flop (didn't bet)
Seat 9: congcongnbnb folded before Flop (didn't bet)





PokerStars Hand #150125642756:  Hold'em No Limit ($0.50/$1.00 USD) - 2016/03/10 13:13:03 CET [2016/03/10 7:13:03 ET]
Table 'Mars III' 9-max Seat #3 is the button
Seat 1: blackw0lf_03 ($100 in chips) 
Seat 2: pokixy800 ($67.60 in chips) 
Seat 3: PacPacBum ($108.24 in chips) 
Seat 4: Igor DoUrden ($100 in chips) 
Seat 5: ilaviiitech ($117.70 in chips) 
Seat 6: matiko09 ($105.39 in chips) 
Igor DoUrden: posts small blind $0.50
ilaviiitech: posts big blind $1
Sweden_Pound: sits out 
Dennie Denc: sits out 
er13to: sits out 
*** HOLE CARDS ***
Dealt to matiko09 [5c 3d]
matiko09: folds 
blackw0lf_03: raises $2 to $3
pokixy800: folds 
PacPacBum: folds 
Igor DoUrden: folds 
ilaviiitech: folds 
Uncalled bet ($2) returned to blackw0lf_03
blackw0lf_03 collected $2.50 from pot
blackw0lf_03: doesn't show hand 
*** SUMMARY ***
Total pot $2.50 | Rake $0 
Seat 1: blackw0lf_03 collected ($2.50)
Seat 2: pokixy800 folded before Flop (didn't bet)
Seat 3: PacPacBum (button) folded before Flop (didn't bet)
Seat 4: Igor DoUrden (small blind) folded before Flop
Seat 5: ilaviiitech (big blind) folded before Flop
Seat 6: matiko09 folded before Flop (didn't bet)





PokerStars Hand #150125644591:  Hold'em No Limit ($0.50/$1.00 USD) - 2016/03/10 13:13:07 CET [2016/03/10 7:13:07 ET]
Table 'Iguassu' 9-max Seat #1 is the button
Seat 1: blackw0lf_03 ($106.47 in chips) 
Seat 2: Rocky6434 ($43.12 in chips) 
Seat 3: hammerwife ($120.20 in chips) 
Seat 4: matiko09 ($100 in chips) 
Seat 5: ilaviiitech ($175.36 in chips) 
Seat 6: Igor DoUrden ($100 in chips) 
Seat 7: PacPacBum ($100 in chips) 
Seat 9: tipner ($100 in chips) 
Rocky6434: posts small blind $0.50
hammerwife: posts big blind $1
Sweden_Pound: sits out 
*** HOLE CARDS ***
Dealt to matiko09 [8h 3c]
matiko09: folds 
ilaviiitech: raises $2 to $3
Igor DoUrden: folds 
PacPacBum: folds 
tipner: folds 
blackw0lf_03: calls $3
Rocky6434: folds 
hammerwife: folds 
*** FLOP *** [6h 6c Kc]
ilaviiitech: bets $5
blackw0lf_03: calls $5
*** TURN *** [6h 6c Kc] [Qc]
ilaviiitech: bets $10.02
blackw0lf_03: calls $10.02
*** RIVER *** [6h 6c Kc Qc] [Qd]
ilaviiitech: checks 
blackw0lf_03: checks 
*** SHOW DOWN ***
ilaviiitech: shows [Ac Tc] (a flush, Ace high)
blackw0lf_03: mucks hand 
ilaviiitech collected $35.85 from pot
*** SUMMARY ***
Total pot $37.54 | Rake $1.69 
Board [6h 6c Kc Qc Qd]
Seat 1: blackw0lf_03 (button) mucked [Kd Ad]
Seat 2: Rocky6434 (small blind) folded before Flop
Seat 3: hammerwife (big blind) folded before Flop
Seat 4: matiko09 folded before Flop (didn't bet)
Seat 5: ilaviiitech showed [Ac Tc] and won ($35.85) with a flush, Ace high
Seat 6: Igor DoUrden folded before Flop (didn't bet)
Seat 7: PacPacBum folded before Flop (didn't bet)
Seat 9: tipner folded before Flop (didn't bet)





PokerStars Hand #150125645902:  Hold'em No Limit ($1/$2 USD) - 2016/03/10 13:13:09 CET [2016/03/10 7:13:09 ET]
Table 'Rimito II' 9-max Seat #3 is the button
Seat 1: stds st ($77 in chips) 
Seat 2: chaps1988 ($200 in chips) 
Seat 3: Yaaaazz ($294.31 in chips) 
Seat 4: di0d80 ($200 in chips) 
Seat 5: rijger321 ($128.11 in chips) 
Seat 6: Fish4trips ($200 in chips) 
Seat 7: matiko09 ($200 in chips) 
Seat 8: Olddogtom888 ($235.40 in chips) 
Seat 9: tipner ($210.70 in chips) 
di0d80: posts small blind $1
rijger321: posts big blind $2
*** HOLE CARDS ***
Dealt to matiko09 [Ah Tc]
Fish4trips: raises $3 to $5
matiko09: folds 
Olddogtom888: calls $5
tipner: folds 
stds st: folds 
chaps1988: calls $5
Yaaaazz: folds 
di0d80: folds 
rijger321: folds 
*** FLOP *** [Th 3s 8c]
Fish4trips: checks 
Olddogtom888: checks 
chaps1988: bets $8.59
Fish4trips: folds 
Olddogtom888: folds 
Uncalled bet ($8.59) returned to chaps1988
chaps1988 collected $17.19 from pot
chaps1988: doesn't show hand 
*** SUMMARY ***
Total pot $18 | Rake $0.81 
Board [Th 3s 8c]
Seat 1: stds st folded before Flop (didn't bet)
Seat 2: chaps1988 collected ($17.19)
Seat 3: Yaaaazz (button) folded before Flop (didn't bet)
Seat 4: di0d80 (small blind) folded before Flop
Seat 5: rijger321 (big blind) folded before Flop
Seat 6: Fish4trips folded on the Flop
Seat 7: matiko09 folded before Flop (didn't bet)
Seat 8: Olddogtom888 folded on the Flop
Seat 9: tipner folded before Flop (didn't bet)





PokerStars Hand #150125647054:  Hold'em No Limit ($0.50/$1.00 USD) - 2016/03/10 13:13:11 CET [2016/03/10 7:13:11 ET]
Table 'Saskia' 9-max Seat #3 is the button
Seat 2: njurg aga ($98.57 in chips) 
Seat 3: ccmaster001 ($60.94 in chips) 
Seat 4: Plz3betMe ($85.92 in chips) 
Seat 5: dreded11 ($86.72 in chips) 
Seat 6: matiko09 ($100 in chips) 
Seat 7: stds st ($32.35 in chips) 
Seat 8: chaps1988 ($168.62 in chips) 
Seat 9: tipner ($106.98 in chips) 
Plz3betMe: posts small blind $0.50
dreded11: posts big blind $1
Sweden_Pound: sits out 
*** HOLE CARDS ***
Dealt to matiko09 [Ac Jh]
matiko09: raises $2 to $3
stds st: folds 
chaps1988: folds 
tipner: folds 
njurg aga: folds 
ccmaster001: folds 
Plz3betMe: folds 
dreded11: calls $2
*** FLOP *** [7d 4c Td]
dreded11: checks 
matiko09: checks 
*** TURN *** [7d 4c Td] [5d]
dreded11: bets $3
matiko09: folds 
Uncalled bet ($3) returned to dreded11
dreded11 collected $6.21 from pot
dreded11: doesn't show hand 
*** SUMMARY ***
Total pot $6.50 | Rake $0.29 
Board [7d 4c Td 5d]
Seat 2: njurg aga folded before Flop (didn't bet)
Seat 3: ccmaster001 (button) folded before Flop (didn't bet)
Seat 4: Plz3betMe (small blind) folded before Flop
Seat 5: dreded11 (big blind) collected ($6.21)
Seat 6: matiko09 folded on the Turn
Seat 7: stds st folded before Flop (didn't bet)
Seat 8: chaps1988 folded before Flop (didn't bet)
Seat 9: tipner folded before Flop (didn't bet)





PokerStars Hand #150125662482:  Hold'em No Limit ($0.50/$1.00 USD) - 2016/03/10 13:13:42 CET [2016/03/10 7:13:42 ET]
Table 'Liriope II' 9-max Seat #3 is the button
Seat 1: di0d80 ($113.21 in chips) 
Seat 2: zxp12345 ($18.34 in chips) 
Seat 3: matiko09 ($164.93 in chips) 
Seat 4: Plz3betMe ($59.11 in chips) 
Seat 6: nobu-azabu ($182.17 in chips) 
Seat 7: Sweden_Pound ($100 in chips) 
Seat 8: PacPacBum ($103.60 in chips) 
Seat 9: tipner ($107.05 in chips) 
Plz3betMe: posts small blind $0.50
chaps1988: is sitting out 
chaps1988 leaves the table
nobu-azabu: posts big blind $1
*** HOLE CARDS ***
Dealt to matiko09 [2c 3c]
Sweden_Pound: folds 
PacPacBum: folds 
tipner: folds 
lumen21 joins the table at seat #5 
di0d80: folds 
zxp12345: folds 
matiko09: folds 
Plz3betMe: calls $0.50
nobu-azabu: checks 
*** FLOP *** [5d 4s 4d]
Plz3betMe: bets $1
nobu-azabu: calls $1
*** TURN *** [5d 4s 4d] [Jd]
Plz3betMe: bets $2
nobu-azabu: calls $2
*** RIVER *** [5d 4s 4d Jd] [2d]
Plz3betMe: checks 
nobu-azabu: checks 
*** SHOW DOWN ***
Plz3betMe: shows [5h 3h] (two pair, Fives and Fours)
nobu-azabu: shows [Th 5c] (two pair, Fives and Fours)
Plz3betMe collected $3.82 from pot
nobu-azabu collected $3.82 from pot
*** SUMMARY ***
Total pot $8 | Rake $0.36 
Board [5d 4s 4d Jd 2d]
Seat 1: di0d80 folded before Flop (didn't bet)
Seat 2: zxp12345 folded before Flop (didn't bet)
Seat 3: matiko09 (button) folded before Flop (didn't bet)
Seat 4: Plz3betMe (small blind) showed [5h 3h] and won ($3.82) with two pair, Fives and Fours
Seat 6: nobu-azabu (big blind) showed [Th 5c] and won ($3.82) with two pair, Fives and Fours
Seat 7: Sweden_Pound folded before Flop (didn't bet)
Seat 8: PacPacBum folded before Flop (didn't bet)
Seat 9: tipner folded before Flop (didn't bet)





PokerStars Hand #150125664630:  Hold'em No Limit ($0.50/$1.00 USD) - 2016/03/10 13:13:46 CET [2016/03/10 7:13:46 ET]
Table 'Leuschneria II' 9-max Seat #1 is the button
Seat 1: cdv1984 ($174.21 in chips) 
Seat 2: blackw0lf_03 ($102.21 in chips) 
Seat 3: gudridornot ($104.50 in chips) 
Seat 4: Sweden_Pound ($117.81 in chips) 
Seat 5: RMilPoker ($112.96 in chips) 
Seat 6: matiko09 ($100 in chips) 
Seat 7: Plz3betMe ($41.90 in chips) 
Seat 8: hammerwife ($100 in chips) 
Seat 9: Katsulion ($121.41 in chips) 
blackw0lf_03: posts small blind $0.50
gudridornot: posts big blind $1
*** HOLE CARDS ***
Dealt to matiko09 [Jd 2c]
Sweden_Pound: raises $2 to $3
RMilPoker: folds 
matiko09: folds 
Plz3betMe: folds 
hammerwife: raises $6 to $9
Katsulion: folds 
cdv1984: folds 
blackw0lf_03: folds 
gudridornot: calls $8
Sweden_Pound: calls $6
*** FLOP *** [5s 8h 5c]
gudridornot: checks 
Sweden_Pound: checks 
hammerwife: checks 
*** TURN *** [5s 8h 5c] [8c]
gudridornot: bets $10
Sweden_Pound: raises $20 to $30
hammerwife: folds 
gudridornot: folds 
Uncalled bet ($20) returned to Sweden_Pound
Sweden_Pound collected $45.36 from pot
Sweden_Pound: doesn't show hand 
*** SUMMARY ***
Total pot $47.50 | Rake $2.14 
Board [5s 8h 5c 8c]
Seat 1: cdv1984 (button) folded before Flop (didn't bet)
Seat 2: blackw0lf_03 (small blind) folded before Flop
Seat 3: gudridornot (big blind) folded on the Turn
Seat 4: Sweden_Pound collected ($45.36)
Seat 5: RMilPoker folded before Flop (didn't bet)
Seat 6: matiko09 folded before Flop (didn't bet)
Seat 7: Plz3betMe folded before Flop (didn't bet)
Seat 8: hammerwife folded on the Turn
Seat 9: Katsulion folded before Flop (didn't bet)





PokerStars Hand #150125670936:  Hold'em No Limit ($0.50/$1.00 USD) - 2016/03/10 13:13:58 CET [2016/03/10 7:13:58 ET]
Table 'Mars III' 9-max Seat #4 is the button
Seat 1: blackw0lf_03 ($101.50 in chips) 
Seat 2: pokixy800 ($67.60 in chips) 
Seat 3: PacPacBum ($108.24 in chips) 
Seat 4: Igor DoUrden ($100 in chips) 
Seat 5: ilaviiitech ($116.70 in chips) 
Seat 6: matiko09 ($105.39 in chips) 
ilaviiitech: posts small blind $0.50
matiko09: posts big blind $1
Sweden_Pound: sits out 
Dennie Denc: sits out 
er13to: sits out 
*** HOLE CARDS ***
Dealt to matiko09 [8h 4c]
blackw0lf_03: raises $2 to $3
pokixy800: folds 
PacPacBum: folds 
Igor DoUrden: calls $3
ilaviiitech: folds 
matiko09: folds 
*** FLOP *** [Ah 2h Td]
blackw0lf_03: checks 
Igor DoUrden: checks 
*** TURN *** [Ah 2h Td] [8d]
blackw0lf_03: checks 
Igor DoUrden: bets $3.58
blackw0lf_03: calls $3.58
*** RIVER *** [Ah 2h Td 8d] [2d]
blackw0lf_03: checks 
Igor DoUrden: bets $11.20
blackw0lf_03: calls $11.20
*** SHOW DOWN ***
Igor DoUrden: shows [6d 7d] (a flush, Ten high)
blackw0lf_03: mucks hand 
Igor DoUrden collected $35.39 from pot
*** SUMMARY ***
Total pot $37.06 | Rake $1.67 
Board [Ah 2h Td 8d 2d]
Seat 1: blackw0lf_03 mucked [Ac Jc]
Seat 2: pokixy800 folded before Flop (didn't bet)
Seat 3: PacPacBum folded before Flop (didn't bet)
Seat 4: Igor DoUrden (button) showed [6d 7d] and won ($35.39) with a flush, Ten high
Seat 5: ilaviiitech (small blind) folded before Flop
Seat 6: matiko09 (big blind) folded before Flop





PokerStars Hand #150125671506:  Hold'em No Limit ($0.25/$0.50 USD) - 2016/03/10 13:13:59 CET [2016/03/10 7:13:59 ET]
Table 'Aegina' 9-max Seat #5 is the button
Seat 1: BingoIng0 ($111.23 in chips) 
Seat 2: dvutavr ($123.22 in chips) 
Seat 3: mobi1984 ($19.56 in chips) 
Seat 4: digimatical ($56.04 in chips) 
Seat 5: Ahangama ($54.01 in chips) 
Seat 6: matiko09 ($50 in chips) 
Seat 7: Gummio ($104.53 in chips) 
Seat 8: ardo888 ($174.32 in chips) 
Seat 9: congcongnbnb ($171.17 in chips) 
matiko09: posts small blind $0.25
Gummio: posts big blind $0.50
BingoIng0: posts the ante $0.10
dvutavr: posts the ante $0.10
mobi1984: posts the ante $0.10
digimatical: posts the ante $0.10
Ahangama: posts the ante $0.10
matiko09: posts the ante $0.10
Gummio: posts the ante $0.10
ardo888: posts the ante $0.10
congcongnbnb: posts the ante $0.10
*** HOLE CARDS ***
Dealt to matiko09 [8c Ad]
ardo888: folds 
congcongnbnb: folds 
BingoIng0: folds 
dvutavr: folds 
mobi1984: folds 
digimatical: raises $1.44 to $1.94
Ahangama: folds 
matiko09: folds 
Gummio: folds 
Uncalled bet ($1.44) returned to digimatical
digimatical collected $2.15 from pot
*** SUMMARY ***
Total pot $2.15 | Rake $0 
Seat 1: BingoIng0 folded before Flop (didn't bet)
Seat 2: dvutavr folded before Flop (didn't bet)
Seat 3: mobi1984 folded before Flop (didn't bet)
Seat 4: digimatical collected ($2.15)
Seat 5: Ahangama (button) folded before Flop (didn't bet)
Seat 6: matiko09 (small blind) folded before Flop
Seat 7: Gummio (big blind) folded before Flop
Seat 8: ardo888 folded before Flop (didn't bet)
Seat 9: congcongnbnb folded before Flop (didn't bet)





PokerStars Hand #150125671336:  Hold'em No Limit ($0.50/$1.00 USD) - 2016/03/10 13:13:59 CET [2016/03/10 7:13:59 ET]
Table 'Saskia' 9-max Seat #4 is the button
Seat 2: njurg aga ($98.57 in chips) 
Seat 3: ccmaster001 ($60.94 in chips) 
Seat 4: Plz3betMe ($85.42 in chips) 
Seat 5: dreded11 ($89.93 in chips) 
Seat 6: matiko09 ($100 in chips) 
Seat 7: stds st ($32.35 in chips) 
Seat 8: chaps1988 ($168.62 in chips) 
Seat 9: tipner ($106.98 in chips) 
dreded11: posts small blind $0.50
matiko09: posts big blind $1
Sweden_Pound: sits out 
*** HOLE CARDS ***
Dealt to matiko09 [Ac Qh]
stds st: folds 
chaps1988: folds 
tipner: folds 
njurg aga: raises $2 to $3
ccmaster001: folds 
Plz3betMe: folds 
dreded11: folds 
matiko09: calls $2
*** FLOP *** [4s Ah 8h]
matiko09: checks 
njurg aga: checks 
*** TURN *** [4s Ah 8h] [3s]
matiko09: bets $4.04
njurg aga: calls $4.04
*** RIVER *** [4s Ah 8h 3s] [Ks]
matiko09: bets $8.09
njurg aga: folds 
Uncalled bet ($8.09) returned to matiko09
matiko09 collected $13.92 from pot
matiko09: doesn't show hand 
*** SUMMARY ***
Total pot $14.58 | Rake $0.66 
Board [4s Ah 8h 3s Ks]
Seat 2: njurg aga folded on the River
Seat 3: ccmaster001 folded before Flop (didn't bet)
Seat 4: Plz3betMe (button) folded before Flop (didn't bet)
Seat 5: dreded11 (small blind) folded before Flop
Seat 6: matiko09 (big blind) collected ($13.92)
Seat 7: stds st folded before Flop (didn't bet)
Seat 8: chaps1988 folded before Flop (didn't bet)
Seat 9: tipner folded before Flop (didn't bet)





PokerStars Hand #150125681071:  Hold'em No Limit (€0.50/€1.00 EUR) - 2016/03/10 13:14:17 CET [2016/03/10 7:14:17 ET]
Table 'Claudia' 9-max Seat #4 is the button
Seat 1: matiko09 (€100 in chips) 
Seat 2: er13to (€100 in chips) 
Seat 3: full-deck699 (€52.28 in chips) 
Seat 4: Sweden_Pound (€100 in chips) 
Seat 5: Spid1 (€100 in chips) 
Seat 6: di0d80 (€103.23 in chips) 
Seat 7: tipner (€100 in chips) 
Seat 8: UnBent022 (€100 in chips) 
Seat 9: blackw0lf_03 (€100 in chips) 
Spid1: posts small blind €0.50
di0d80: posts big blind €1
*** HOLE CARDS ***
Dealt to matiko09 [8s 6d]
tipner: folds 
UnBent022: folds 
blackw0lf_03: folds 
matiko09: folds 
er13to: raises €2 to €3
full-deck699: calls €3
Sweden_Pound: folds 
Spid1: folds 
di0d80: folds 
*** FLOP *** [Ah 4c 7d]
er13to: checks 
full-deck699: checks 
*** TURN *** [Ah 4c 7d] [4d]
er13to: checks 
full-deck699: bets €1
er13to: folds 
Uncalled bet (€1) returned to full-deck699
full-deck699 collected €7.16 from pot
full-deck699: doesn't show hand 
*** SUMMARY ***
Total pot €7.50 | Rake €0.34 
Board [Ah 4c 7d 4d]
Seat 1: matiko09 folded before Flop (didn't bet)
Seat 2: er13to folded on the Turn
Seat 3: full-deck699 collected (€7.16)
Seat 4: Sweden_Pound (button) folded before Flop (didn't bet)
Seat 5: Spid1 (small blind) folded before Flop
Seat 6: di0d80 (big blind) folded before Flop
Seat 7: tipner folded before Flop (didn't bet)
Seat 8: UnBent022 folded before Flop (didn't bet)
Seat 9: blackw0lf_03 folded before Flop (didn't bet)





PokerStars Hand #150125683652:  Hold'em No Limit ($0.50/$1.00 USD) - 2016/03/10 13:14:22 CET [2016/03/10 7:14:22 ET]
Table 'Liriope II' 9-max Seat #4 is the button
Seat 1: di0d80 ($113.21 in chips) 
Seat 2: zxp12345 ($18.34 in chips) 
Seat 3: matiko09 ($164.93 in chips) 
Seat 4: Plz3betMe ($58.93 in chips) 
Seat 6: nobu-azabu ($181.99 in chips) 
Seat 7: Sweden_Pound ($100 in chips) 
Seat 8: PacPacBum ($103.60 in chips) 
Seat 9: tipner ($107.05 in chips) 
lumen21 will be allowed to play after the button
nobu-azabu: posts small blind $0.50
Sweden_Pound: posts big blind $1
*** HOLE CARDS ***
Dealt to matiko09 [7s 2d]
PacPacBum: folds 
tipner: folds 
di0d80: folds 
zxp12345: calls $1
matiko09: folds 
Plz3betMe: folds 
nobu-azabu: calls $0.50
Sweden_Pound: checks 
*** FLOP *** [Ks 7d 6s]
nobu-azabu: checks 
Sweden_Pound: checks 
zxp12345: checks 
*** TURN *** [Ks 7d 6s] [Kh]
nobu-azabu: bets $1.43
Sweden_Pound: folds 
zxp12345: folds 
Uncalled bet ($1.43) returned to nobu-azabu
nobu-azabu collected $2.86 from pot
*** SUMMARY ***
Total pot $3 | Rake $0.14 
Board [Ks 7d 6s Kh]
Seat 1: di0d80 folded before Flop (didn't bet)
Seat 2: zxp12345 folded on the Turn
Seat 3: matiko09 folded before Flop (didn't bet)
Seat 4: Plz3betMe (button) folded before Flop (didn't bet)
Seat 6: nobu-azabu (small blind) collected ($2.86)
Seat 7: Sweden_Pound (big blind) folded on the Turn
Seat 8: PacPacBum folded before Flop (didn't bet)
Seat 9: tipner folded before Flop (didn't bet)





PokerStars Hand #150125688725:  Hold'em No Limit ($0.50/$1.00 USD) - 2016/03/10 13:14:32 CET [2016/03/10 7:14:32 ET]
Table 'Virgo II' 9-max Seat #7 is the button
Seat 1: cdv1984 ($191.90 in chips) 
Seat 2: Plz3betMe ($53.27 in chips) 
Seat 3: chaps1988 ($179.51 in chips) 
Seat 4: UnBent022 ($102.75 in chips) 
Seat 5: stds st ($48.15 in chips) 
Seat 6: PacPacBum ($110 in chips) 
Seat 7: mamilets ($58.57 in chips) 
Seat 8: Sweden_Pound ($124.79 in chips) 
Seat 9: matiko09 ($100 in chips) 
Sweden_Pound: posts small blind $0.50
matiko09: posts big blind $1
*** HOLE CARDS ***
Dealt to matiko09 [7c 4d]
cdv1984: raises $2 to $3
Plz3betMe: folds 
chaps1988: folds 
UnBent022: folds 
stds st: folds 
PacPacBum: folds 
mamilets: folds 
Sweden_Pound: folds 
matiko09: folds 
Uncalled bet ($2) returned to cdv1984
cdv1984 collected $2.50 from pot
cdv1984: doesn't show hand 
*** SUMMARY ***
Total pot $2.50 | Rake $0 
Seat 1: cdv1984 collected ($2.50)
Seat 2: Plz3betMe folded before Flop (didn't bet)
Seat 3: chaps1988 folded before Flop (didn't bet)
Seat 4: UnBent022 folded before Flop (didn't bet)
Seat 5: stds st folded before Flop (didn't bet)
Seat 6: PacPacBum folded before Flop (didn't bet)
Seat 7: mamilets (button) folded before Flop (didn't bet)
Seat 8: Sweden_Pound (small blind) folded before Flop
Seat 9: matiko09 (big blind) folded before Flop





PokerStars Hand #150125690664:  Hold'em No Limit ($0.25/$0.50 USD) - 2016/03/10 13:14:36 CET [2016/03/10 7:14:36 ET]
Table 'Aegina' 9-max Seat #6 is the button
Seat 1: BingoIng0 ($111.13 in chips) 
Seat 2: dvutavr ($123.12 in chips) 
Seat 3: mobi1984 ($19.46 in chips) 
Seat 4: digimatical ($57.59 in chips) 
Seat 5: Ahangama ($53.91 in chips) 
Seat 6: matiko09 ($50 in chips) 
Seat 7: Gummio ($103.93 in chips) 
Seat 8: ardo888 ($174.22 in chips) 
Seat 9: congcongnbnb ($171.07 in chips) 
Gummio: posts small blind $0.25
ardo888: posts big blind $0.50
BingoIng0: posts the ante $0.10
dvutavr: posts the ante $0.10
mobi1984: posts the ante $0.10
digimatical: posts the ante $0.10
Ahangama: posts the ante $0.10
matiko09: posts the ante $0.10
Gummio: posts the ante $0.10
ardo888: posts the ante $0.10
congcongnbnb: posts the ante $0.10
*** HOLE CARDS ***
Dealt to matiko09 [6c Td]
congcongnbnb: folds 
BingoIng0: folds 
dvutavr: folds 
mobi1984: folds 
digimatical: calls $0.50
Ahangama: raises $1.50 to $2
matiko09: folds 
Gummio: folds 
ardo888: calls $1.50
digimatical: calls $1.50
*** FLOP *** [Qs 7c 6d]
ardo888: checks 
digimatical: checks 
Ahangama: checks 
*** TURN *** [Qs 7c 6d] [3c]
ardo888: checks 
digimatical: bets $1.50
Ahangama: folds 
ardo888: folds 
Uncalled bet ($1.50) returned to digimatical
digimatical collected $6.83 from pot
*** SUMMARY ***
Total pot $7.15 | Rake $0.32 
Board [Qs 7c 6d 3c]
Seat 1: BingoIng0 folded before Flop (didn't bet)
Seat 2: dvutavr folded before Flop (didn't bet)
Seat 3: mobi1984 folded before Flop (didn't bet)
Seat 4: digimatical collected ($6.83)
Seat 5: Ahangama folded on the Turn
Seat 6: matiko09 (button) folded before Flop (didn't bet)
Seat 7: Gummio (small blind) folded before Flop
Seat 8: ardo888 (big blind) folded on the Turn
Seat 9: congcongnbnb folded before Flop (didn't bet)





PokerStars Hand #150125696209:  Hold'em No Limit ($0.50/$1.00 USD) - 2016/03/10 13:14:47 CET [2016/03/10 7:14:47 ET]
Table 'Iguassu' 9-max Seat #2 is the button
Seat 1: blackw0lf_03 ($100 in chips) 
Seat 2: Rocky6434 ($42.62 in chips) 
Seat 3: hammerwife ($119.20 in chips) 
Seat 4: matiko09 ($100 in chips) 
Seat 5: ilaviiitech ($193.19 in chips) 
Seat 6: Igor DoUrden ($100 in chips) 
Seat 7: PacPacBum ($100 in chips) 
Seat 9: tipner ($100 in chips) 
hammerwife: posts small blind $0.50
matiko09: posts big blind $1
Sweden_Pound: sits out 
*** HOLE CARDS ***
Dealt to matiko09 [Kh 8d]
ilaviiitech: folds 
Igor DoUrden: folds 
PacPacBum: folds 
tipner: folds 
blackw0lf_03: folds 
Rocky6434: folds 
hammerwife: raises $1.60 to $2.60
matiko09: calls $1.60
*** FLOP *** [9h Th 7s]
hammerwife: bets $3
matiko09: calls $3
*** TURN *** [9h Th 7s] [9s]
hammerwife: checks 
matiko09: checks 
*** RIVER *** [9h Th 7s 9s] [Qc]
hammerwife: checks 
matiko09: checks 
*** SHOW DOWN ***
hammerwife: shows [8s Ad] (a pair of Nines)
matiko09: mucks hand 
hammerwife collected $10.70 from pot
*** SUMMARY ***
Total pot $11.20 | Rake $0.50 
Board [9h Th 7s 9s Qc]
Seat 1: blackw0lf_03 folded before Flop (didn't bet)
Seat 2: Rocky6434 (button) folded before Flop (didn't bet)
Seat 3: hammerwife (small blind) showed [8s Ad] and won ($10.70) with a pair of Nines
Seat 4: matiko09 (big blind) mucked [Kh 8d]
Seat 5: ilaviiitech folded before Flop (didn't bet)
Seat 6: Igor DoUrden folded before Flop (didn't bet)
Seat 7: PacPacBum folded before Flop (didn't bet)
Seat 9: tipner folded before Flop (didn't bet)





PokerStars Hand #150125700635:  Hold'em No Limit ($0.50/$1.00 USD) - 2016/03/10 13:14:55 CET [2016/03/10 7:14:55 ET]
Table 'Saskia' 9-max Seat #5 is the button
Seat 2: njurg aga ($91.53 in chips) 
Seat 3: ccmaster001 ($60.94 in chips) 
Seat 4: Plz3betMe ($85.42 in chips) 
Seat 5: dreded11 ($89.43 in chips) 
Seat 6: matiko09 ($106.88 in chips) 
Seat 7: stds st ($32.35 in chips) 
Seat 8: chaps1988 ($168.62 in chips) 
Seat 9: tipner ($106.98 in chips) 
matiko09: posts small blind $0.50
stds st: posts big blind $1
Sweden_Pound: sits out 
*** HOLE CARDS ***
Dealt to matiko09 [5h 8s]
chaps1988: folds 
tipner: folds 
njurg aga: raises $2 to $3
ccmaster001: folds 
Plz3betMe: folds 
dreded11: folds 
matiko09: folds 
stds st: folds 
Uncalled bet ($2) returned to njurg aga
njurg aga collected $2.50 from pot
njurg aga: doesn't show hand 
*** SUMMARY ***
Total pot $2.50 | Rake $0 
Seat 2: njurg aga collected ($2.50)
Seat 3: ccmaster001 folded before Flop (didn't bet)
Seat 4: Plz3betMe folded before Flop (didn't bet)
Seat 5: dreded11 (button) folded before Flop (didn't bet)
Seat 6: matiko09 (small blind) folded before Flop
Seat 7: stds st (big blind) folded before Flop
Seat 8: chaps1988 folded before Flop (didn't bet)
Seat 9: tipner folded before Flop (didn't bet)





PokerStars Hand #150125705549:  Hold'em No Limit ($0.50/$1.00 USD) - 2016/03/10 13:15:04 CET [2016/03/10 7:15:04 ET]
Table 'Virgo II' 9-max Seat #8 is the button
Seat 1: cdv1984 ($193.40 in chips) 
Seat 2: Plz3betMe ($53.27 in chips) 
Seat 3: chaps1988 ($179.51 in chips) 
Seat 4: UnBent022 ($102.75 in chips) 
Seat 5: stds st ($48.15 in chips) 
Seat 6: PacPacBum ($110 in chips) 
Seat 7: mamilets ($58.57 in chips) 
Seat 8: Sweden_Pound ($124.29 in chips) 
Seat 9: matiko09 ($100 in chips) 
matiko09: posts small blind $0.50
cdv1984: posts big blind $1
*** HOLE CARDS ***
Dealt to matiko09 [7d 3c]
Plz3betMe: folds 
chaps1988: folds 
UnBent022: folds 
stds st: raises $1.02 to $2.02
PacPacBum: folds 
mamilets: folds 
Sweden_Pound: folds 
matiko09: folds 
cdv1984: calls $1.02
*** FLOP *** [9d 3s 6s]
cdv1984: checks 
stds st: bets $3.12
cdv1984: raises $5.88 to $9
stds st: folds 
Uncalled bet ($5.88) returned to cdv1984
cdv1984 collected $10.29 from pot
cdv1984: doesn't show hand 
*** SUMMARY ***
Total pot $10.78 | Rake $0.49 
Board [9d 3s 6s]
Seat 1: cdv1984 (big blind) collected ($10.29)
Seat 2: Plz3betMe folded before Flop (didn't bet)
Seat 3: chaps1988 folded before Flop (didn't bet)
Seat 4: UnBent022 folded before Flop (didn't bet)
Seat 5: stds st folded on the Flop
Seat 6: PacPacBum folded before Flop (didn't bet)
Seat 7: mamilets folded before Flop (didn't bet)
Seat 8: Sweden_Pound (button) folded before Flop (didn't bet)
Seat 9: matiko09 (small blind) folded before Flop





PokerStars Hand #150125711945:  Hold'em No Limit (€0.50/€1.00 EUR) - 2016/03/10 13:15:16 CET [2016/03/10 7:15:16 ET]
Table 'Claudia' 9-max Seat #5 is the button
Seat 1: matiko09 (€100 in chips) 
Seat 2: er13to (€100 in chips) 
Seat 3: full-deck699 (€56.44 in chips) 
Seat 4: Sweden_Pound (€100 in chips) 
Seat 5: Spid1 (€100 in chips) 
Seat 6: di0d80 (€102.23 in chips) 
Seat 7: tipner (€100 in chips) 
Seat 8: UnBent022 (€100 in chips) 
Seat 9: blackw0lf_03 (€100 in chips) 
di0d80: posts small blind €0.50
tipner: posts big blind €1
*** HOLE CARDS ***
Dealt to matiko09 [Jh Ah]
UnBent022: folds 
blackw0lf_03: folds 
matiko09: raises €2 to €3
er13to: raises €5 to €8
full-deck699: calls €8
Sweden_Pound: folds 
Spid1: folds 
di0d80: folds 
tipner: folds 
matiko09: calls €5
*** FLOP *** [Jd 9h 7h]
matiko09: checks 
er13to: bets €22
full-deck699: folds 
matiko09: raises €70 to €92 and is all-in
er13to: folds 
Uncalled bet (€70) returned to matiko09
matiko09 collected €67.35 from pot
matiko09: doesn't show hand 
*** SUMMARY ***
Total pot €69.50 | Rake €2.15 
Board [Jd 9h 7h]
Seat 1: matiko09 collected (€67.35)
Seat 2: er13to folded on the Flop
Seat 3: full-deck699 folded on the Flop
Seat 4: Sweden_Pound folded before Flop (didn't bet)
Seat 5: Spid1 (button) folded before Flop (didn't bet)
Seat 6: di0d80 (small blind) folded before Flop
Seat 7: tipner (big blind) folded before Flop
Seat 8: UnBent022 folded before Flop (didn't bet)
Seat 9: blackw0lf_03 folded before Flop (didn't bet)





PokerStars Hand #150125714353:  Hold'em No Limit ($0.50/$1.00 USD) - 2016/03/10 13:15:21 CET [2016/03/10 7:15:21 ET]
Table 'Saskia' 9-max Seat #6 is the button
Seat 1: Sweden_Pound ($113.01 in chips) 
Seat 2: njurg aga ($93.03 in chips) 
Seat 3: ccmaster001 ($60.94 in chips) 
Seat 4: Plz3betMe ($85.42 in chips) 
Seat 5: dreded11 ($89.43 in chips) 
Seat 6: matiko09 ($106.38 in chips) 
Seat 7: stds st ($31.35 in chips) 
stds st: posts small blind $0.50
chaps1988: is sitting out 
tipner: is sitting out 
Sweden_Pound: posts big blind $1
*** HOLE CARDS ***
Dealt to matiko09 [4c 9c]
chaps1988 leaves the table
tipner leaves the table
njurg aga: folds 
ccmaster001: folds 
Plz3betMe: raises $1.50 to $2.50
dreded11: folds 
matiko09: folds 
stds st: folds 
Sweden_Pound: folds 
Uncalled bet ($1.50) returned to Plz3betMe
Plz3betMe collected $2.50 from pot
Plz3betMe: doesn't show hand 
*** SUMMARY ***
Total pot $2.50 | Rake $0 
Seat 1: Sweden_Pound (big blind) folded before Flop
Seat 2: njurg aga folded before Flop (didn't bet)
Seat 3: ccmaster001 folded before Flop (didn't bet)
Seat 4: Plz3betMe collected ($2.50)
Seat 5: dreded11 folded before Flop (didn't bet)
Seat 6: matiko09 (button) folded before Flop (didn't bet)
Seat 7: stds st (small blind) folded before Flop





PokerStars Hand #150125715506:  Hold'em No Limit ($0.25/$0.50 USD) - 2016/03/10 13:15:23 CET [2016/03/10 7:15:23 ET]
Table 'Aegina' 9-max Seat #7 is the button
Seat 1: BingoIng0 ($111.03 in chips) 
Seat 2: dvutavr ($123.02 in chips) 
Seat 3: mobi1984 ($19.36 in chips) 
Seat 4: digimatical ($62.32 in chips) 
Seat 5: Ahangama ($51.81 in chips) 
Seat 6: matiko09 ($50 in chips) 
Seat 7: Gummio ($103.58 in chips) 
Seat 8: ardo888 ($172.12 in chips) 
Seat 9: congcongnbnb ($170.97 in chips) 
ardo888: posts small blind $0.25
congcongnbnb: posts big blind $0.50
BingoIng0: posts the ante $0.10
dvutavr: posts the ante $0.10
mobi1984: posts the ante $0.10
digimatical: posts the ante $0.10
Ahangama: posts the ante $0.10
matiko09: posts the ante $0.10
Gummio: posts the ante $0.10
ardo888: posts the ante $0.10
congcongnbnb: posts the ante $0.10
*** HOLE CARDS ***
Dealt to matiko09 [7d Jc]
BingoIng0: folds 
dvutavr: folds 
mobi1984: folds 
digimatical: folds 
Ahangama: raises $0.75 to $1.25
matiko09: folds 
Gummio: folds 
ardo888: folds 
congcongnbnb: calls $0.75
*** FLOP *** [5s Jh 8s]
congcongnbnb: checks 
Ahangama: bets $2.25
congcongnbnb: folds 
Uncalled bet ($2.25) returned to Ahangama
Ahangama collected $3.49 from pot
Ahangama: doesn't show hand 
*** SUMMARY ***
Total pot $3.65 | Rake $0.16 
Board [5s Jh 8s]
Seat 1: BingoIng0 folded before Flop (didn't bet)
Seat 2: dvutavr folded before Flop (didn't bet)
Seat 3: mobi1984 folded before Flop (didn't bet)
Seat 4: digimatical folded before Flop (didn't bet)
Seat 5: Ahangama collected ($3.49)
Seat 6: matiko09 folded before Flop (didn't bet)
Seat 7: Gummio (button) folded before Flop (didn't bet)
Seat 8: ardo888 (small blind) folded before Flop
Seat 9: congcongnbnb (big blind) folded on the Flop





PokerStars Hand #150125728274:  Hold'em No Limit ($0.50/$1.00 USD) - 2016/03/10 13:15:47 CET [2016/03/10 7:15:47 ET]
Table 'Liriope II' 9-max Seat #6 is the button
Seat 1: di0d80 ($113.21 in chips) 
Seat 2: zxp12345 ($17.34 in chips) 
Seat 3: matiko09 ($164.93 in chips) 
Seat 4: Plz3betMe ($58.93 in chips) 
Seat 6: nobu-azabu ($183.85 in chips) 
Seat 7: Sweden_Pound ($100 in chips) 
Seat 8: PacPacBum ($103.60 in chips) 
Seat 9: tipner ($107.05 in chips) 
Sweden_Pound: posts small blind $0.50
PacPacBum: posts big blind $1
lumen21: sits out 
*** HOLE CARDS ***
Dealt to matiko09 [Kd Ts]
tipner: folds 
di0d80: folds 
zxp12345: folds 
matiko09: folds 
Plz3betMe: folds 
nobu-azabu: raises $1.50 to $2.50
Sweden_Pound: folds 
PacPacBum: folds 
Uncalled bet ($1.50) returned to nobu-azabu
nobu-azabu collected $2.50 from pot
*** SUMMARY ***
Total pot $2.50 | Rake $0 
Seat 1: di0d80 folded before Flop (didn't bet)
Seat 2: zxp12345 folded before Flop (didn't bet)
Seat 3: matiko09 folded before Flop (didn't bet)
Seat 4: Plz3betMe folded before Flop (didn't bet)
Seat 6: nobu-azabu (button) collected ($2.50)
Seat 7: Sweden_Pound (small blind) folded before Flop
Seat 8: PacPacBum (big blind) folded before Flop
Seat 9: tipner folded before Flop (didn't bet)





PokerStars Hand #150125729487:  Hold'em No Limit ($0.50/$1.00 USD) - 2016/03/10 13:15:50 CET [2016/03/10 7:15:50 ET]
Table 'Saskia' 9-max Seat #7 is the button
Seat 1: Sweden_Pound ($112.01 in chips) 
Seat 2: njurg aga ($93.03 in chips) 
Seat 3: ccmaster001 ($60.94 in chips) 
Seat 4: Plz3betMe ($86.92 in chips) 
Seat 5: dreded11 ($89.43 in chips) 
Seat 6: matiko09 ($106.38 in chips) 
Seat 7: stds st ($30.85 in chips) 
Sweden_Pound: posts small blind $0.50
njurg aga: posts big blind $1
*** HOLE CARDS ***
Dealt to matiko09 [9c Th]
blackw0lf_03 joins the table at seat #8 
ccmaster001: folds 
cdv1984 joins the table at seat #9 
cdv1984 leaves the table
er13to joins the table at seat #9 
Plz3betMe: raises $1.50 to $2.50
dreded11: folds 
matiko09: folds 
stds st: folds 
Sweden_Pound: folds 
njurg aga: folds 
Uncalled bet ($1.50) returned to Plz3betMe
Plz3betMe collected $2.50 from pot
Plz3betMe: doesn't show hand 
*** SUMMARY ***
Total pot $2.50 | Rake $0 
Seat 1: Sweden_Pound (small blind) folded before Flop
Seat 2: njurg aga (big blind) folded before Flop
Seat 3: ccmaster001 folded before Flop (didn't bet)
Seat 4: Plz3betMe collected ($2.50)
Seat 5: dreded11 folded before Flop (didn't bet)
Seat 6: matiko09 folded before Flop (didn't bet)
Seat 7: stds st (button) folded before Flop (didn't bet)





PokerStars Hand #150125738224:  Hold'em No Limit ($0.50/$1.00 USD) - 2016/03/10 13:16:06 CET [2016/03/10 7:16:06 ET]
Table 'Mars III' 9-max Seat #5 is the button
Seat 1: blackw0lf_03 ($100 in chips) 
Seat 2: pokixy800 ($67.60 in chips) 
Seat 3: PacPacBum ($108.24 in chips) 
Seat 4: Igor DoUrden ($117.61 in chips) 
Seat 5: ilaviiitech ($116.20 in chips) 
Seat 6: matiko09 ($104.39 in chips) 
Seat 7: Sweden_Pound ($100 in chips) 
matiko09: posts small blind $0.50
Sweden_Pound: posts big blind $1
Dennie Denc: sits out 
er13to: sits out 
*** HOLE CARDS ***
Dealt to matiko09 [Ts 3d]
blackw0lf_03: folds 
pokixy800: folds 
PacPacBum: folds 
Igor DoUrden: folds 
ilaviiitech: folds 
matiko09: folds 
Uncalled bet ($0.50) returned to Sweden_Pound
Sweden_Pound collected $1 from pot
Sweden_Pound: doesn't show hand 
*** SUMMARY ***
Total pot $1 | Rake $0 
Seat 1: blackw0lf_03 folded before Flop (didn't bet)
Seat 2: pokixy800 folded before Flop (didn't bet)
Seat 3: PacPacBum folded before Flop (didn't bet)
Seat 4: Igor DoUrden folded before Flop (didn't bet)
Seat 5: ilaviiitech (button) folded before Flop (didn't bet)
Seat 6: matiko09 (small blind) folded before Flop
Seat 7: Sweden_Pound (big blind) collected ($1)





PokerStars Hand #150125738580:  Hold'em No Limit ($0.25/$0.50 USD) - 2016/03/10 13:16:07 CET [2016/03/10 7:16:07 ET]
Table 'Aegina' 9-max Seat #8 is the button
Seat 1: BingoIng0 ($110.93 in chips) 
Seat 2: dvutavr ($122.92 in chips) 
Seat 3: mobi1984 ($19.26 in chips) 
Seat 4: digimatical ($62.22 in chips) 
Seat 5: Ahangama ($53.95 in chips) 
Seat 6: matiko09 ($50 in chips) 
Seat 7: Gummio ($103.48 in chips) 
Seat 8: ardo888 ($171.77 in chips) 
Seat 9: congcongnbnb ($169.62 in chips) 
congcongnbnb: posts small blind $0.25
BingoIng0: posts big blind $0.50
BingoIng0: posts the ante $0.10
dvutavr: posts the ante $0.10
mobi1984: posts the ante $0.10
digimatical: posts the ante $0.10
Ahangama: posts the ante $0.10
matiko09: posts the ante $0.10
Gummio: posts the ante $0.10
ardo888: posts the ante $0.10
congcongnbnb: posts the ante $0.10
*** HOLE CARDS ***
Dealt to matiko09 [Th 6c]
dvutavr: folds 
mobi1984: folds 
digimatical: folds 
Ahangama: folds 
matiko09: folds 
Gummio: raises $2.15 to $2.65
ardo888: calls $2.65
congcongnbnb: calls $2.40
BingoIng0: folds 
*** FLOP *** [3s As 5c]
congcongnbnb: checks 
Gummio: bets $8.93
ardo888: folds 
congcongnbnb: folds 
Uncalled bet ($8.93) returned to Gummio
Gummio collected $8.93 from pot
Gummio: doesn't show hand 
*** SUMMARY ***
Total pot $9.35 | Rake $0.42 
Board [3s As 5c]
Seat 1: BingoIng0 (big blind) folded before Flop
Seat 2: dvutavr folded before Flop (didn't bet)
Seat 3: mobi1984 folded before Flop (didn't bet)
Seat 4: digimatical folded before Flop (didn't bet)
Seat 5: Ahangama folded before Flop (didn't bet)
Seat 6: matiko09 folded before Flop (didn't bet)
Seat 7: Gummio collected ($8.93)
Seat 8: ardo888 (button) folded on the Flop
Seat 9: congcongnbnb (small blind) folded on the Flop





PokerStars Hand #150125745043:  Hold'em No Limit ($0.50/$1.00 USD) - 2016/03/10 13:16:19 CET [2016/03/10 7:16:19 ET]
Table 'Liriope II' 9-max Seat #7 is the button
Seat 1: di0d80 ($113.21 in chips) 
Seat 2: zxp12345 ($17.34 in chips) 
Seat 3: matiko09 ($164.93 in chips) 
Seat 4: Plz3betMe ($58.93 in chips) 
Seat 6: nobu-azabu ($185.35 in chips) 
Seat 7: Sweden_Pound ($100 in chips) 
Seat 8: PacPacBum ($102.60 in chips) 
Seat 9: tipner ($107.05 in chips) 
PacPacBum: posts small blind $0.50
tipner: posts big blind $1
lumen21: sits out 
*** HOLE CARDS ***
Dealt to matiko09 [9h Ts]
di0d80: raises $1.50 to $2.50
zxp12345: folds 
matiko09: folds 
Plz3betMe: folds 
nobu-azabu: folds 
Sweden_Pound: folds 
PacPacBum: folds 
tipner: folds 
Uncalled bet ($1.50) returned to di0d80
di0d80 collected $2.50 from pot
di0d80: doesn't show hand 
*** SUMMARY ***
Total pot $2.50 | Rake $0 
Seat 1: di0d80 collected ($2.50)
Seat 2: zxp12345 folded before Flop (didn't bet)
Seat 3: matiko09 folded before Flop (didn't bet)
Seat 4: Plz3betMe folded before Flop (didn't bet)
Seat 6: nobu-azabu folded before Flop (didn't bet)
Seat 7: Sweden_Pound (button) folded before Flop (didn't bet)
Seat 8: PacPacBum (small blind) folded before Flop
Seat 9: tipner (big blind) folded before Flop





PokerStars Hand #150125746794:  Hold'em No Limit ($0.50/$1.00 USD) - 2016/03/10 13:16:22 CET [2016/03/10 7:16:22 ET]
Table 'Saskia' 9-max Seat #1 is the button
Seat 1: Sweden_Pound ($111.51 in chips) 
Seat 2: njurg aga ($92.03 in chips) 
Seat 3: ccmaster001 ($60.94 in chips) 
Seat 4: Plz3betMe ($88.42 in chips) 
Seat 5: dreded11 ($89.43 in chips) 
Seat 6: matiko09 ($106.38 in chips) 
Seat 7: stds st ($30.85 in chips) 
njurg aga: posts small blind $0.50
ccmaster001: posts big blind $1
blackw0lf_03: sits out 
er13to: sits out 
*** HOLE CARDS ***
Dealt to matiko09 [3d Td]
Plz3betMe: raises $1.50 to $2.50
dreded11: folds 
matiko09: folds 
stds st: folds 
Sweden_Pound: folds 
njurg aga: folds 
ccmaster001: folds 
Uncalled bet ($1.50) returned to Plz3betMe
Plz3betMe collected $2.50 from pot
Plz3betMe: doesn't show hand 
*** SUMMARY ***
Total pot $2.50 | Rake $0 
Seat 1: Sweden_Pound (button) folded before Flop (didn't bet)
Seat 2: njurg aga (small blind) folded before Flop
Seat 3: ccmaster001 (big blind) folded before Flop
Seat 4: Plz3betMe collected ($2.50)
Seat 5: dreded11 folded before Flop (didn't bet)
Seat 6: matiko09 folded before Flop (didn't bet)
Seat 7: stds st folded before Flop (didn't bet)





PokerStars Hand #150125747061:  Hold'em No Limit ($0.50/$1.00 USD) - 2016/03/10 13:16:23 CET [2016/03/10 7:16:23 ET]
Table 'Mars III' 9-max Seat #6 is the button
Seat 1: blackw0lf_03 ($100 in chips) 
Seat 2: pokixy800 ($67.60 in chips) 
Seat 3: PacPacBum ($108.24 in chips) 
Seat 4: Igor DoUrden ($117.61 in chips) 
Seat 5: ilaviiitech ($116.20 in chips) 
Seat 6: matiko09 ($103.89 in chips) 
Seat 7: Sweden_Pound ($100.50 in chips) 
Seat 8: Dennie Denc ($80 in chips) 
Sweden_Pound: posts small blind $0.50
Dennie Denc: posts big blind $1
er13to: sits out 
*** HOLE CARDS ***
Dealt to matiko09 [6d 6s]
blackw0lf_03: folds 
pokixy800: folds 
PacPacBum: raises $1.04 to $2.04
Igor DoUrden: folds 
ilaviiitech: folds 
matiko09: calls $2.04
Sweden_Pound: folds 
Dennie Denc: calls $1.04
*** FLOP *** [Jh Ks 7s]
Dennie Denc: checks 
PacPacBum: bets $4.36
matiko09: folds 
Dennie Denc: folds 
Uncalled bet ($4.36) returned to PacPacBum
PacPacBum collected $6.32 from pot
PacPacBum: doesn't show hand 
*** SUMMARY ***
Total pot $6.62 | Rake $0.30 
Board [Jh Ks 7s]
Seat 1: blackw0lf_03 folded before Flop (didn't bet)
Seat 2: pokixy800 folded before Flop (didn't bet)
Seat 3: PacPacBum collected ($6.32)
Seat 4: Igor DoUrden folded before Flop (didn't bet)
Seat 5: ilaviiitech folded before Flop (didn't bet)
Seat 6: matiko09 (button) folded on the Flop
Seat 7: Sweden_Pound (small blind) folded before Flop
Seat 8: Dennie Denc (big blind) folded on the Flop





PokerStars Hand #150125747997:  Hold'em No Limit ($0.50/$1.00 USD) - 2016/03/10 13:16:25 CET [2016/03/10 7:16:25 ET]
Table 'Leuschneria II' 9-max Seat #2 is the button
Seat 1: cdv1984 ($174.21 in chips) 
Seat 2: blackw0lf_03 ($101.71 in chips) 
Seat 3: gudridornot ($85.50 in chips) 
Seat 4: Sweden_Pound ($144.17 in chips) 
Seat 5: RMilPoker ($112.96 in chips) 
Seat 6: matiko09 ($100 in chips) 
Seat 7: Plz3betMe ($41.90 in chips) 
Seat 8: hammerwife ($100 in chips) 
Seat 9: Katsulion ($121.41 in chips) 
gudridornot: posts small blind $0.50
Sweden_Pound: posts big blind $1
*** HOLE CARDS ***
Dealt to matiko09 [Qd 4d]
RMilPoker: raises $2 to $3
matiko09: folds 
Plz3betMe: folds 
hammerwife: raises $6 to $9
Katsulion: folds 
cdv1984: folds 
blackw0lf_03: folds 
gudridornot: folds 
Sweden_Pound: folds 
RMilPoker: folds 
Uncalled bet ($6) returned to hammerwife
hammerwife collected $7.50 from pot
hammerwife: doesn't show hand 
*** SUMMARY ***
Total pot $7.50 | Rake $0 
Seat 1: cdv1984 folded before Flop (didn't bet)
Seat 2: blackw0lf_03 (button) folded before Flop (didn't bet)
Seat 3: gudridornot (small blind) folded before Flop
Seat 4: Sweden_Pound (big blind) folded before Flop
Seat 5: RMilPoker folded before Flop
Seat 6: matiko09 folded before Flop (didn't bet)
Seat 7: Plz3betMe folded before Flop (didn't bet)
Seat 8: hammerwife collected ($7.50)
Seat 9: Katsulion folded before Flop (didn't bet)





PokerStars Hand #150125752559:  Hold'em No Limit ($0.50/$1.00 USD) - 2016/03/10 13:16:33 CET [2016/03/10 7:16:33 ET]
Table 'Iguassu' 9-max Seat #3 is the button
Seat 1: blackw0lf_03 ($100 in chips) 
Seat 2: Rocky6434 ($42.62 in chips) 
Seat 3: hammerwife ($124.30 in chips) 
Seat 4: matiko09 ($100 in chips) 
Seat 6: Igor DoUrden ($100 in chips) 
Seat 7: PacPacBum ($100 in chips) 
Seat 9: tipner ($100 in chips) 
matiko09: posts small blind $0.50
ilaviiitech: is sitting out 
Igor DoUrden: posts big blind $1
Sweden_Pound: sits out 
*** HOLE CARDS ***
Dealt to matiko09 [Ad 9s]
PacPacBum: folds 
ilaviiitech leaves the table
UnBent022 joins the table at seat #5 
tipner: folds 
blackw0lf_03: folds 
Rocky6434: raises $1 to $2
hammerwife: folds 
matiko09: folds 
Igor DoUrden: calls $1
*** FLOP *** [6s Kc Js]
Igor DoUrden: checks 
Rocky6434: bets $2.15
Igor DoUrden: raises $8.60 to $10.75
Rocky6434: calls $8.60
*** TURN *** [6s Kc Js] [Ah]
Igor DoUrden: checks 
Rocky6434: bets $12.41
Igor DoUrden: calls $12.41
*** RIVER *** [6s Kc Js Ah] [6c]
Igor DoUrden: checks 
Rocky6434: checks 
*** SHOW DOWN ***
Igor DoUrden: shows [Jh Ks] (two pair, Kings and Jacks)
Rocky6434: shows [Ts As] (two pair, Aces and Sixes)
Rocky6434 collected $48.53 from pot
*** SUMMARY ***
Total pot $50.82 | Rake $2.29 
Board [6s Kc Js Ah 6c]
Seat 1: blackw0lf_03 folded before Flop (didn't bet)
Seat 2: Rocky6434 showed [Ts As] and won ($48.53) with two pair, Aces and Sixes
Seat 3: hammerwife (button) folded before Flop (didn't bet)
Seat 4: matiko09 (small blind) folded before Flop
Seat 6: Igor DoUrden (big blind) showed [Jh Ks] and lost with two pair, Kings and Jacks
Seat 7: PacPacBum folded before Flop (didn't bet)
Seat 9: tipner folded before Flop (didn't bet)





PokerStars Hand #150125759189:  Hold'em No Limit ($0.50/$1.00 USD) - 2016/03/10 13:16:46 CET [2016/03/10 7:16:46 ET]
Table 'Virgo II' 9-max Seat #9 is the button
Seat 1: cdv1984 ($198.55 in chips) 
Seat 2: Plz3betMe ($53.27 in chips) 
Seat 3: chaps1988 ($179.51 in chips) 
Seat 4: UnBent022 ($102.75 in chips) 
Seat 5: stds st ($43.01 in chips) 
Seat 6: PacPacBum ($110 in chips) 
Seat 7: mamilets ($58.57 in chips) 
Seat 8: Sweden_Pound ($124.29 in chips) 
Seat 9: matiko09 ($100 in chips) 
cdv1984: posts small blind $0.50
Plz3betMe: posts big blind $1
*** HOLE CARDS ***
Dealt to matiko09 [5d 9c]
chaps1988: folds 
UnBent022: folds 
stds st: raises $1.02 to $2.02
PacPacBum: folds 
mamilets: folds 
Sweden_Pound: raises $4.48 to $6.50
matiko09: folds 
cdv1984: folds 
Plz3betMe: folds 
stds st: folds 
Uncalled bet ($4.48) returned to Sweden_Pound
Sweden_Pound collected $5.54 from pot
Sweden_Pound: doesn't show hand 
*** SUMMARY ***
Total pot $5.54 | Rake $0 
Seat 1: cdv1984 (small blind) folded before Flop
Seat 2: Plz3betMe (big blind) folded before Flop
Seat 3: chaps1988 folded before Flop (didn't bet)
Seat 4: UnBent022 folded before Flop (didn't bet)
Seat 5: stds st folded before Flop
Seat 6: PacPacBum folded before Flop (didn't bet)
Seat 7: mamilets folded before Flop (didn't bet)
Seat 8: Sweden_Pound collected ($5.54)
Seat 9: matiko09 (button) folded before Flop (didn't bet)





PokerStars Hand #150125759482:  Hold'em No Limit ($0.50/$1.00 USD) - 2016/03/10 13:16:47 CET [2016/03/10 7:16:47 ET]
Table 'Liriope II' 9-max Seat #8 is the button
Seat 1: di0d80 ($114.71 in chips) 
Seat 2: zxp12345 ($17.34 in chips) 
Seat 3: matiko09 ($164.93 in chips) 
Seat 4: Plz3betMe ($58.93 in chips) 
Seat 6: nobu-azabu ($185.35 in chips) 
Seat 7: Sweden_Pound ($100 in chips) 
Seat 8: PacPacBum ($102.10 in chips) 
Seat 9: tipner ($106.05 in chips) 
tipner: posts small blind $0.50
di0d80: posts big blind $1
lumen21: sits out 
*** HOLE CARDS ***
Dealt to matiko09 [3c 8h]
zxp12345: folds 
matiko09: folds 
Plz3betMe: folds 
nobu-azabu: folds 
Sweden_Pound: folds 
PacPacBum: raises $1.04 to $2.04
tipner: folds 
di0d80: raises $4.96 to $7
PacPacBum: calls $4.96
*** FLOP *** [Kd 7h 5d]
di0d80: checks 
PacPacBum: checks 
*** TURN *** [Kd 7h 5d] [7c]
di0d80: bets $8
PacPacBum: folds 
Uncalled bet ($8) returned to di0d80
di0d80 collected $13.85 from pot
di0d80: doesn't show hand 
*** SUMMARY ***
Total pot $14.50 | Rake $0.65 
Board [Kd 7h 5d 7c]
Seat 1: di0d80 (big blind) collected ($13.85)
Seat 2: zxp12345 folded before Flop (didn't bet)
Seat 3: matiko09 folded before Flop (didn't bet)
Seat 4: Plz3betMe folded before Flop (didn't bet)
Seat 6: nobu-azabu folded before Flop (didn't bet)
Seat 7: Sweden_Pound folded before Flop (didn't bet)
Seat 8: PacPacBum (button) folded on the Turn
Seat 9: tipner (small blind) folded before Flop





PokerStars Hand #150125760986:  Hold'em No Limit ($0.50/$1.00 USD) - 2016/03/10 13:16:50 CET [2016/03/10 7:16:50 ET]
Table 'Saskia' 9-max Seat #2 is the button
Seat 1: Sweden_Pound ($111.51 in chips) 
Seat 2: njurg aga ($91.53 in chips) 
Seat 3: ccmaster001 ($59.94 in chips) 
Seat 4: Plz3betMe ($89.92 in chips) 
Seat 5: dreded11 ($89.43 in chips) 
Seat 6: matiko09 ($106.38 in chips) 
Seat 7: stds st ($30.85 in chips) 
ccmaster001: posts small blind $0.50
Plz3betMe: posts big blind $1
blackw0lf_03: sits out 
er13to: sits out 
*** HOLE CARDS ***
Dealt to matiko09 [8d 7h]
dreded11: calls $1
matiko09: folds 
stds st: raises $2.50 to $3.50
Sweden_Pound: folds 
njurg aga: folds 
ccmaster001: folds 
Plz3betMe: folds 
dreded11: folds 
Uncalled bet ($2.50) returned to stds st
stds st collected $3.50 from pot
stds st: doesn't show hand 
*** SUMMARY ***
Total pot $3.50 | Rake $0 
Seat 1: Sweden_Pound folded before Flop (didn't bet)
Seat 2: njurg aga (button) folded before Flop (didn't bet)
Seat 3: ccmaster001 (small blind) folded before Flop
Seat 4: Plz3betMe (big blind) folded before Flop
Seat 5: dreded11 folded before Flop
Seat 6: matiko09 folded before Flop (didn't bet)
Seat 7: stds st collected ($3.50)





PokerStars Hand #150125764597:  Hold'em No Limit ($0.25/$0.50 USD) - 2016/03/10 13:16:56 CET [2016/03/10 7:16:56 ET]
Table 'Aegina' 9-max Seat #9 is the button
Seat 1: BingoIng0 ($110.33 in chips) 
Seat 2: dvutavr ($122.82 in chips) 
Seat 3: mobi1984 ($19.16 in chips) 
Seat 4: digimatical ($62.12 in chips) 
Seat 5: Ahangama ($53.85 in chips) 
Seat 6: matiko09 ($50 in chips) 
Seat 7: Gummio ($109.66 in chips) 
Seat 8: ardo888 ($169.02 in chips) 
Seat 9: congcongnbnb ($166.87 in chips) 
BingoIng0: posts small blind $0.25
dvutavr: posts big blind $0.50
BingoIng0: posts the ante $0.10
dvutavr: posts the ante $0.10
mobi1984: posts the ante $0.10
digimatical: posts the ante $0.10
Ahangama: posts the ante $0.10
matiko09: posts the ante $0.10
Gummio: posts the ante $0.10
ardo888: posts the ante $0.10
congcongnbnb: posts the ante $0.10
*** HOLE CARDS ***
Dealt to matiko09 [6h 3d]
mobi1984: folds 
digimatical: raises $0.50 to $1
Ahangama: folds 
matiko09: folds 
Gummio: folds 
ardo888: folds 
congcongnbnb: folds 
congcongnbnb leaves the table
BingoIng0: folds 
draken08 joins the table at seat #9 
dvutavr: calls $0.50
*** FLOP *** [Kd 4c 9d]
dvutavr: checks 
digimatical: bets $2
dvutavr: calls $2
*** TURN *** [Kd 4c 9d] [3s]
dvutavr: checks 
digimatical: checks 
*** RIVER *** [Kd 4c 9d 3s] [Kh]
dvutavr: bets $4
digimatical: folds 
Uncalled bet ($4) returned to dvutavr
dvutavr collected $6.83 from pot
dvutavr: doesn't show hand 
*** SUMMARY ***
Total pot $7.15 | Rake $0.32 
Board [Kd 4c 9d 3s Kh]
Seat 1: BingoIng0 (small blind) folded before Flop
Seat 2: dvutavr (big blind) collected ($6.83)
Seat 3: mobi1984 folded before Flop (didn't bet)
Seat 4: digimatical folded on the River
Seat 5: Ahangama folded before Flop (didn't bet)
Seat 6: matiko09 folded before Flop (didn't bet)
Seat 7: Gummio folded before Flop (didn't bet)
Seat 8: ardo888 folded before Flop (didn't bet)
Seat 9: congcongnbnb (button) folded before Flop (didn't bet)





PokerStars Hand #150125766126:  Hold'em No Limit ($0.50/$1.00 USD) - 2016/03/10 13:16:59 CET [2016/03/10 7:16:59 ET]
Table 'Leuschneria II' 9-max Seat #3 is the button
Seat 1: cdv1984 ($174.21 in chips) 
Seat 2: blackw0lf_03 ($101.71 in chips) 
Seat 3: gudridornot ($85 in chips) 
Seat 4: Sweden_Pound ($143.17 in chips) 
Seat 5: RMilPoker ($109.96 in chips) 
Seat 6: matiko09 ($100 in chips) 
Seat 7: Plz3betMe ($41.90 in chips) 
Seat 8: hammerwife ($104.50 in chips) 
Seat 9: Katsulion ($121.41 in chips) 
Sweden_Pound: posts small blind $0.50
RMilPoker: posts big blind $1
*** HOLE CARDS ***
Dealt to matiko09 [Qd As]
matiko09: raises $2 to $3
Plz3betMe: folds 
hammerwife: folds 
Katsulion: folds 
cdv1984: folds 
blackw0lf_03: folds 
gudridornot: folds 
Sweden_Pound: folds 
RMilPoker: folds 
Uncalled bet ($2) returned to matiko09
matiko09 collected $2.50 from pot
matiko09: doesn't show hand 
*** SUMMARY ***
Total pot $2.50 | Rake $0 
Seat 1: cdv1984 folded before Flop (didn't bet)
Seat 2: blackw0lf_03 folded before Flop (didn't bet)
Seat 3: gudridornot (button) folded before Flop (didn't bet)
Seat 4: Sweden_Pound (small blind) folded before Flop
Seat 5: RMilPoker (big blind) folded before Flop
Seat 6: matiko09 collected ($2.50)
Seat 7: Plz3betMe folded before Flop (didn't bet)
Seat 8: hammerwife folded before Flop (didn't bet)
Seat 9: Katsulion folded before Flop (didn't bet)





PokerStars Hand #150125767582:  Hold'em No Limit ($0.50/$1.00 USD) - 2016/03/10 13:17:02 CET [2016/03/10 7:17:02 ET]
Table 'Mars III' 9-max Seat #7 is the button
Seat 1: blackw0lf_03 ($100 in chips) 
Seat 2: pokixy800 ($67.60 in chips) 
Seat 3: PacPacBum ($112.52 in chips) 
Seat 4: Igor DoUrden ($117.61 in chips) 
Seat 5: ilaviiitech ($116.20 in chips) 
Seat 6: matiko09 ($101.85 in chips) 
Seat 7: Sweden_Pound ($100 in chips) 
Seat 8: Dennie Denc ($77.96 in chips) 
Seat 9: er13to ($100 in chips) 
Dennie Denc: posts small blind $0.50
er13to: posts big blind $1
*** HOLE CARDS ***
Dealt to matiko09 [Jc 7s]
blackw0lf_03: folds 
pokixy800: folds 
PacPacBum: folds 
Igor DoUrden: folds 
ilaviiitech: folds 
matiko09: folds 
Sweden_Pound: folds 
Dennie Denc: raises $2 to $3
er13to: folds 
Uncalled bet ($2) returned to Dennie Denc
Dennie Denc collected $2 from pot
Dennie Denc: doesn't show hand 
*** SUMMARY ***
Total pot $2 | Rake $0 
Seat 1: blackw0lf_03 folded before Flop (didn't bet)
Seat 2: pokixy800 folded before Flop (didn't bet)
Seat 3: PacPacBum folded before Flop (didn't bet)
Seat 4: Igor DoUrden folded before Flop (didn't bet)
Seat 5: ilaviiitech folded before Flop (didn't bet)
Seat 6: matiko09 folded before Flop (didn't bet)
Seat 7: Sweden_Pound (button) folded before Flop (didn't bet)
Seat 8: Dennie Denc (small blind) collected ($2)
Seat 9: er13to (big blind) folded before Flop





PokerStars Hand #150125771212:  Hold'em No Limit (€0.50/€1.00 EUR) - 2016/03/10 13:17:09 CET [2016/03/10 7:17:09 ET]
Table 'Claudia' 9-max Seat #6 is the button
Seat 1: matiko09 (€137.35 in chips) 
Seat 2: er13to (€100 in chips) 
Seat 3: full-deck699 (€48.44 in chips) 
Seat 4: Sweden_Pound (€100 in chips) 
Seat 5: Spid1 (€100 in chips) 
Seat 6: di0d80 (€101.73 in chips) 
Seat 7: tipner (€100 in chips) 
Seat 8: UnBent022 (€100 in chips) 
Seat 9: blackw0lf_03 (€100 in chips) 
tipner: posts small blind €0.50
UnBent022: posts big blind €1
*** HOLE CARDS ***
Dealt to matiko09 [Jh 2h]
blackw0lf_03: folds 
matiko09: folds 
er13to: raises €2 to €3
full-deck699: calls €3
Sweden_Pound: raises €8 to €11
Spid1: folds 
di0d80: folds 
tipner: folds 
UnBent022: folds 
er13to: folds 
full-deck699: calls €8
*** FLOP *** [Kc Ac 6c]
full-deck699: bets €37.44 and is all-in
Sweden_Pound: folds 
Uncalled bet (€37.44) returned to full-deck699
full-deck699 collected €25.31 from pot
full-deck699: doesn't show hand 
*** SUMMARY ***
Total pot €26.50 | Rake €1.19 
Board [Kc Ac 6c]
Seat 1: matiko09 folded before Flop (didn't bet)
Seat 2: er13to folded before Flop
Seat 3: full-deck699 collected (€25.31)
Seat 4: Sweden_Pound folded on the Flop
Seat 5: Spid1 folded before Flop (didn't bet)
Seat 6: di0d80 (button) folded before Flop (didn't bet)
Seat 7: tipner (small blind) folded before Flop
Seat 8: UnBent022 (big blind) folded before Flop
Seat 9: blackw0lf_03 folded before Flop (didn't bet)





PokerStars Hand #150125778342:  Hold'em No Limit ($0.50/$1.00 USD) - 2016/03/10 13:17:22 CET [2016/03/10 7:17:22 ET]
Table 'Iguassu' 9-max Seat #4 is the button
Seat 1: blackw0lf_03 ($100 in chips) 
Seat 2: Rocky6434 ($65.99 in chips) 
Seat 3: hammerwife ($124.30 in chips) 
Seat 4: matiko09 ($100 in chips) 
Seat 6: Igor DoUrden ($100 in chips) 
Seat 7: PacPacBum ($100 in chips) 
Seat 9: tipner ($100 in chips) 
UnBent022 will be allowed to play after the button
Igor DoUrden: posts small blind $0.50
PacPacBum: posts big blind $1
Sweden_Pound: sits out 
*** HOLE CARDS ***
Dealt to matiko09 [6h As]
tipner: folds 
blackw0lf_03: folds 
Rocky6434: raises $1 to $2
hammerwife: folds 
matiko09: folds 
Igor DoUrden: folds 
PacPacBum: folds 
Uncalled bet ($1) returned to Rocky6434
Rocky6434 collected $2.50 from pot
Rocky6434: doesn't show hand 
*** SUMMARY ***
Total pot $2.50 | Rake $0 
Seat 1: blackw0lf_03 folded before Flop (didn't bet)
Seat 2: Rocky6434 collected ($2.50)
Seat 3: hammerwife folded before Flop (didn't bet)
Seat 4: matiko09 (button) folded before Flop (didn't bet)
Seat 6: Igor DoUrden (small blind) folded before Flop
Seat 7: PacPacBum (big blind) folded before Flop
Seat 9: tipner folded before Flop (didn't bet)





PokerStars Hand #150125782825:  Hold'em No Limit ($0.50/$1.00 USD) - 2016/03/10 13:17:31 CET [2016/03/10 7:17:31 ET]
Table 'Leuschneria II' 9-max Seat #4 is the button
Seat 1: cdv1984 ($174.21 in chips) 
Seat 2: blackw0lf_03 ($101.71 in chips) 
Seat 3: gudridornot ($85 in chips) 
Seat 4: Sweden_Pound ($142.67 in chips) 
Seat 5: RMilPoker ($108.96 in chips) 
Seat 6: matiko09 ($101.50 in chips) 
Seat 7: Plz3betMe ($41.90 in chips) 
Seat 8: hammerwife ($104.50 in chips) 
Seat 9: Katsulion ($121.41 in chips) 
RMilPoker: posts small blind $0.50
matiko09: posts big blind $1
*** HOLE CARDS ***
Dealt to matiko09 [Js Ac]
Plz3betMe: folds 
hammerwife: folds 
Katsulion: folds 
cdv1984: folds 
blackw0lf_03: folds 
gudridornot: folds 
Sweden_Pound: folds 
RMilPoker: folds 
Uncalled bet ($0.50) returned to matiko09
matiko09 collected $1 from pot
matiko09: doesn't show hand 
*** SUMMARY ***
Total pot $1 | Rake $0 
Seat 1: cdv1984 folded before Flop (didn't bet)
Seat 2: blackw0lf_03 folded before Flop (didn't bet)
Seat 3: gudridornot folded before Flop (didn't bet)
Seat 4: Sweden_Pound (button) folded before Flop (didn't bet)
Seat 5: RMilPoker (small blind) folded before Flop
Seat 6: matiko09 (big blind) collected ($1)
Seat 7: Plz3betMe folded before Flop (didn't bet)
Seat 8: hammerwife folded before Flop (didn't bet)
Seat 9: Katsulion folded before Flop (didn't bet)





PokerStars Hand #150125783053:  Hold'em No Limit ($0.50/$1.00 USD) - 2016/03/10 13:17:31 CET [2016/03/10 7:17:31 ET]
Table 'Saskia' 9-max Seat #3 is the button
Seat 1: Sweden_Pound ($111.51 in chips) 
Seat 2: njurg aga ($91.53 in chips) 
Seat 3: ccmaster001 ($59.44 in chips) 
Seat 4: Plz3betMe ($88.92 in chips) 
Seat 5: dreded11 ($88.43 in chips) 
Seat 6: matiko09 ($106.38 in chips) 
Seat 7: stds st ($33.35 in chips) 
Plz3betMe: posts small blind $0.50
dreded11: posts big blind $1
blackw0lf_03: sits out 
er13to: sits out 
*** HOLE CARDS ***
Dealt to matiko09 [Js Jh]
matiko09: raises $2 to $3
stds st: folds 
Sweden_Pound: folds 
njurg aga: folds 
ccmaster001: folds 
Plz3betMe: folds 
dreded11: folds 
Uncalled bet ($2) returned to matiko09
matiko09 collected $2.50 from pot
matiko09: doesn't show hand 
*** SUMMARY ***
Total pot $2.50 | Rake $0 
Seat 1: Sweden_Pound folded before Flop (didn't bet)
Seat 2: njurg aga folded before Flop (didn't bet)
Seat 3: ccmaster001 (button) folded before Flop (didn't bet)
Seat 4: Plz3betMe (small blind) folded before Flop
Seat 5: dreded11 (big blind) folded before Flop
Seat 6: matiko09 collected ($2.50)
Seat 7: stds st folded before Flop (didn't bet)





PokerStars Hand #150125783263:  Hold'em No Limit ($0.50/$1.00 USD) - 2016/03/10 13:17:32 CET [2016/03/10 7:17:32 ET]
Table 'Virgo II' 9-max Seat #1 is the button
Seat 1: cdv1984 ($198.05 in chips) 
Seat 2: Plz3betMe ($52.27 in chips) 
Seat 4: UnBent022 ($102.75 in chips) 
Seat 5: stds st ($40.99 in chips) 
Seat 6: PacPacBum ($110 in chips) 
Seat 7: mamilets ($58.57 in chips) 
Seat 8: Sweden_Pound ($127.81 in chips) 
Seat 9: matiko09 ($100 in chips) 
Plz3betMe: posts small blind $0.50
chaps1988: is sitting out 
chaps1988 leaves the table
UnBent022: posts big blind $1
*** HOLE CARDS ***
Dealt to matiko09 [6s 7s]
stds st: folds 
blackw0lf_03 joins the table at seat #3 
PacPacBum: folds 
mamilets: calls $1
Sweden_Pound: folds 
matiko09: raises $3 to $4
cdv1984: folds 
Plz3betMe: folds 
UnBent022: folds 
mamilets: calls $3
*** FLOP *** [Qd 3d Ac]
mamilets: checks 
matiko09: checks 
*** TURN *** [Qd 3d Ac] [6d]
mamilets: checks 
matiko09: checks 
*** RIVER *** [Qd 3d Ac 6d] [8d]
mamilets: checks 
matiko09: checks 
*** SHOW DOWN ***
mamilets: shows [7c 8c] (a pair of Eights)
matiko09: mucks hand 
mamilets collected $9.07 from pot
*** SUMMARY ***
Total pot $9.50 | Rake $0.43 
Board [Qd 3d Ac 6d 8d]
Seat 1: cdv1984 (button) folded before Flop (didn't bet)
Seat 2: Plz3betMe (small blind) folded before Flop
Seat 4: UnBent022 (big blind) folded before Flop
Seat 5: stds st folded before Flop (didn't bet)
Seat 6: PacPacBum folded before Flop (didn't bet)
Seat 7: mamilets showed [7c 8c] and won ($9.07) with a pair of Eights
Seat 8: Sweden_Pound folded before Flop (didn't bet)
Seat 9: matiko09 mucked [6s 7s]





PokerStars Hand #150125790565:  Hold'em No Limit ($0.50/$1.00 USD) - 2016/03/10 13:17:45 CET [2016/03/10 7:17:45 ET]
Table 'Iguassu' 9-max Seat #6 is the button
Seat 1: blackw0lf_03 ($100 in chips) 
Seat 2: Rocky6434 ($67.49 in chips) 
Seat 3: hammerwife ($124.30 in chips) 
Seat 4: matiko09 ($100 in chips) 
Seat 6: Igor DoUrden ($100 in chips) 
Seat 7: PacPacBum ($100 in chips) 
Seat 8: Sweden_Pound ($100 in chips) 
Seat 9: tipner ($100 in chips) 
PacPacBum: posts small blind $0.50
Sweden_Pound: posts big blind $1
UnBent022: sits out 
*** HOLE CARDS ***
Dealt to matiko09 [Ac 8s]
tipner: folds 
blackw0lf_03: folds 
Rocky6434: folds 
hammerwife: folds 
matiko09: folds 
Igor DoUrden: folds 
PacPacBum: raises $1.04 to $2.04
Sweden_Pound: folds 
Uncalled bet ($1.04) returned to PacPacBum
PacPacBum collected $2 from pot
PacPacBum: doesn't show hand 
*** SUMMARY ***
Total pot $2 | Rake $0 
Seat 1: blackw0lf_03 folded before Flop (didn't bet)
Seat 2: Rocky6434 folded before Flop (didn't bet)
Seat 3: hammerwife folded before Flop (didn't bet)
Seat 4: matiko09 folded before Flop (didn't bet)
Seat 6: Igor DoUrden (button) folded before Flop (didn't bet)
Seat 7: PacPacBum (small blind) collected ($2)
Seat 8: Sweden_Pound (big blind) folded before Flop
Seat 9: tipner folded before Flop (didn't bet)





PokerStars Hand #150125791157:  Hold'em No Limit ($0.50/$1.00 USD) - 2016/03/10 13:17:47 CET [2016/03/10 7:17:47 ET]
Table 'Mars III' 9-max Seat #8 is the button
Seat 1: blackw0lf_03 ($100 in chips) 
Seat 2: pokixy800 ($67.60 in chips) 
Seat 3: PacPacBum ($112.52 in chips) 
Seat 4: Igor DoUrden ($117.61 in chips) 
Seat 5: ilaviiitech ($116.20 in chips) 
Seat 6: matiko09 ($101.85 in chips) 
Seat 7: Sweden_Pound ($100 in chips) 
Seat 8: Dennie Denc ($78.96 in chips) 
Seat 9: er13to ($100 in chips) 
er13to: posts small blind $0.50
blackw0lf_03: posts big blind $1
*** HOLE CARDS ***
Dealt to matiko09 [As Jd]
pokixy800: folds 
PacPacBum: raises $1.04 to $2.04
Igor DoUrden: folds 
ilaviiitech: raises $6.96 to $9
matiko09: folds 
Sweden_Pound: folds 
Dennie Denc: folds 
er13to: folds 
blackw0lf_03: folds 
PacPacBum: folds 
Uncalled bet ($6.96) returned to ilaviiitech
ilaviiitech collected $5.58 from pot
ilaviiitech: doesn't show hand 
*** SUMMARY ***
Total pot $5.58 | Rake $0 
Seat 1: blackw0lf_03 (big blind) folded before Flop
Seat 2: pokixy800 folded before Flop (didn't bet)
Seat 3: PacPacBum folded before Flop
Seat 4: Igor DoUrden folded before Flop (didn't bet)
Seat 5: ilaviiitech collected ($5.58)
Seat 6: matiko09 folded before Flop (didn't bet)
Seat 7: Sweden_Pound folded before Flop (didn't bet)
Seat 8: Dennie Denc (button) folded before Flop (didn't bet)
Seat 9: er13to (small blind) folded before Flop





PokerStars Hand #150125793855:  Hold'em No Limit ($0.50/$1.00 USD) - 2016/03/10 13:17:52 CET [2016/03/10 7:17:52 ET]
Table 'Liriope II' 9-max Seat #9 is the button
Seat 1: di0d80 ($121.56 in chips) 
Seat 2: zxp12345 ($49.34 in chips) 
Seat 3: matiko09 ($164.93 in chips) 
Seat 4: Plz3betMe ($58.93 in chips) 
Seat 6: nobu-azabu ($185.35 in chips) 
Seat 7: Sweden_Pound ($100 in chips) 
Seat 8: PacPacBum ($100 in chips) 
Seat 9: tipner ($105.55 in chips) 
di0d80: posts small blind $0.50
zxp12345: posts big blind $1
lumen21: sits out 
*** HOLE CARDS ***
Dealt to matiko09 [5d Ad]
matiko09: folds 
Plz3betMe: folds 
nobu-azabu: folds 
Sweden_Pound: folds 
PacPacBum: folds 
tipner: raises $1.50 to $2.50
di0d80: folds 
zxp12345: folds 
Uncalled bet ($1.50) returned to tipner
tipner collected $2.50 from pot
tipner: doesn't show hand 
*** SUMMARY ***
Total pot $2.50 | Rake $0 
Seat 1: di0d80 (small blind) folded before Flop
Seat 2: zxp12345 (big blind) folded before Flop
Seat 3: matiko09 folded before Flop (didn't bet)
Seat 4: Plz3betMe folded before Flop (didn't bet)
Seat 6: nobu-azabu folded before Flop (didn't bet)
Seat 7: Sweden_Pound folded before Flop (didn't bet)
Seat 8: PacPacBum folded before Flop (didn't bet)
Seat 9: tipner (button) collected ($2.50)





PokerStars Hand #150125795549:  Hold'em No Limit ($0.50/$1.00 USD) - 2016/03/10 13:17:55 CET [2016/03/10 7:17:55 ET]
Table 'Leuschneria II' 9-max Seat #5 is the button
Seat 1: cdv1984 ($174.21 in chips) 
Seat 2: blackw0lf_03 ($101.71 in chips) 
Seat 3: gudridornot ($85 in chips) 
Seat 4: Sweden_Pound ($142.67 in chips) 
Seat 5: RMilPoker ($108.46 in chips) 
Seat 6: matiko09 ($102 in chips) 
Seat 7: Plz3betMe ($41.90 in chips) 
Seat 8: hammerwife ($104.50 in chips) 
Seat 9: Katsulion ($121.41 in chips) 
matiko09: posts small blind $0.50
Plz3betMe: posts big blind $1
*** HOLE CARDS ***
Dealt to matiko09 [2h Ad]
hammerwife: folds 
Katsulion: folds 
cdv1984: folds 
blackw0lf_03: folds 
gudridornot: raises $2 to $3
Sweden_Pound: raises $6 to $9
RMilPoker: folds 
matiko09: folds 
Plz3betMe: folds 
gudridornot: calls $6
*** FLOP *** [6c 8c 5s]
gudridornot: checks 
Sweden_Pound: bets $12.10
gudridornot: calls $12.10
*** TURN *** [6c 8c 5s] [7s]
gudridornot: checks 
Sweden_Pound: checks 
*** RIVER *** [6c 8c 5s 7s] [Td]
gudridornot: checks 
Sweden_Pound: checks 
*** SHOW DOWN ***
gudridornot: shows [Ah Ts] (a pair of Tens)
Sweden_Pound: shows [Qs Qc] (a pair of Queens)
Sweden_Pound collected $41.73 from pot
*** SUMMARY ***
Total pot $43.70 | Rake $1.97 
Board [6c 8c 5s 7s Td]
Seat 1: cdv1984 folded before Flop (didn't bet)
Seat 2: blackw0lf_03 folded before Flop (didn't bet)
Seat 3: gudridornot showed [Ah Ts] and lost with a pair of Tens
Seat 4: Sweden_Pound showed [Qs Qc] and won ($41.73) with a pair of Queens
Seat 5: RMilPoker (button) folded before Flop (didn't bet)
Seat 6: matiko09 (small blind) folded before Flop
Seat 7: Plz3betMe (big blind) folded before Flop
Seat 8: hammerwife folded before Flop (didn't bet)
Seat 9: Katsulion folded before Flop (didn't bet)





PokerStars Hand #150125802386:  Hold'em No Limit ($0.50/$1.00 USD) - 2016/03/10 13:18:08 CET [2016/03/10 7:18:08 ET]
Table 'Saskia' 9-max Seat #4 is the button
Seat 1: Sweden_Pound ($111.51 in chips) 
Seat 2: njurg aga ($91.53 in chips) 
Seat 3: ccmaster001 ($59.44 in chips) 
Seat 4: Plz3betMe ($88.42 in chips) 
Seat 5: dreded11 ($87.43 in chips) 
Seat 6: matiko09 ($107.88 in chips) 
Seat 7: stds st ($33.35 in chips) 
dreded11: posts small blind $0.50
matiko09: posts big blind $1
blackw0lf_03: sits out 
er13to: sits out 
*** HOLE CARDS ***
Dealt to matiko09 [Ac 8s]
stds st: folds 
Sweden_Pound: folds 
njurg aga: folds 
ccmaster001: folds 
Plz3betMe: raises $1 to $2
dreded11: folds 
matiko09: calls $1
*** FLOP *** [9d Jc 7s]
matiko09: checks 
Plz3betMe: bets $2.86
matiko09: folds 
Uncalled bet ($2.86) returned to Plz3betMe
Plz3betMe collected $4.30 from pot
Plz3betMe: doesn't show hand 
*** SUMMARY ***
Total pot $4.50 | Rake $0.20 
Board [9d Jc 7s]
Seat 1: Sweden_Pound folded before Flop (didn't bet)
Seat 2: njurg aga folded before Flop (didn't bet)
Seat 3: ccmaster001 folded before Flop (didn't bet)
Seat 4: Plz3betMe (button) collected ($4.30)
Seat 5: dreded11 (small blind) folded before Flop
Seat 6: matiko09 (big blind) folded on the Flop
Seat 7: stds st folded before Flop (didn't bet)





PokerStars Hand #150125805886:  Hold'em No Limit (€0.50/€1.00 EUR) - 2016/03/10 13:18:14 CET [2016/03/10 7:18:14 ET]
Table 'Claudia' 9-max Seat #7 is the button
Seat 1: matiko09 (€137.35 in chips) 
Seat 2: er13to (€100 in chips) 
Seat 3: full-deck699 (€62.75 in chips) 
Seat 4: Sweden_Pound (€100 in chips) 
Seat 5: Spid1 (€100 in chips) 
Seat 6: di0d80 (€101.73 in chips) 
Seat 7: tipner (€100 in chips) 
Seat 8: UnBent022 (€100 in chips) 
Seat 9: blackw0lf_03 (€100 in chips) 
UnBent022: posts small blind €0.50
blackw0lf_03: posts big blind €1
*** HOLE CARDS ***
Dealt to matiko09 [Jc 8s]
matiko09: folds 
er13to: folds 
full-deck699: folds 
Sweden_Pound: folds 
Spid1: folds 
di0d80: folds 
tipner: raises €1.50 to €2.50
UnBent022: folds 
blackw0lf_03: calls €1.50
*** FLOP *** [Jh 4s Qc]
blackw0lf_03: checks 
tipner: checks 
*** TURN *** [Jh 4s Qc] [5d]
blackw0lf_03: bets €4.10
tipner: calls €4.10
*** RIVER *** [Jh 4s Qc 5d] [2h]
blackw0lf_03: bets €10.20
tipner: calls €10.20
*** SHOW DOWN ***
blackw0lf_03: shows [7h Kc] (high card King)
tipner: shows [Kd Ad] (high card Ace)
tipner collected €32.57 from pot
*** SUMMARY ***
Total pot €34.10 | Rake €1.53 
Board [Jh 4s Qc 5d 2h]
Seat 1: matiko09 folded before Flop (didn't bet)
Seat 2: er13to folded before Flop (didn't bet)
Seat 3: full-deck699 folded before Flop (didn't bet)
Seat 4: Sweden_Pound folded before Flop (didn't bet)
Seat 5: Spid1 folded before Flop (didn't bet)
Seat 6: di0d80 folded before Flop (didn't bet)
Seat 7: tipner (button) showed [Kd Ad] and won (€32.57) with high card Ace
Seat 8: UnBent022 (small blind) folded before Flop
Seat 9: blackw0lf_03 (big blind) showed [7h Kc] and lost with high card King





PokerStars Hand #150125807242:  Hold'em No Limit ($0.50/$1.00 USD) - 2016/03/10 13:18:17 CET [2016/03/10 7:18:17 ET]
Table 'Iguassu' 9-max Seat #7 is the button
Seat 1: blackw0lf_03 ($100 in chips) 
Seat 2: Rocky6434 ($67.49 in chips) 
Seat 3: hammerwife ($124.30 in chips) 
Seat 4: matiko09 ($100 in chips) 
Seat 6: Igor DoUrden ($100 in chips) 
Seat 7: PacPacBum ($101 in chips) 
Seat 8: Sweden_Pound ($100 in chips) 
Sweden_Pound: posts small blind $0.50
tipner: is sitting out 
blackw0lf_03: posts big blind $1
UnBent022: sits out 
*** HOLE CARDS ***
Dealt to matiko09 [2c 8s]
tipner leaves the table
Rocky6434: folds 
hammerwife: folds 
matiko09: folds 
Igor DoUrden: folds 
PacPacBum: folds 
Sweden_Pound: folds 
Uncalled bet ($0.50) returned to blackw0lf_03
blackw0lf_03 collected $1 from pot
blackw0lf_03: doesn't show hand 
*** SUMMARY ***
Total pot $1 | Rake $0 
Seat 1: blackw0lf_03 (big blind) collected ($1)
Seat 2: Rocky6434 folded before Flop (didn't bet)
Seat 3: hammerwife folded before Flop (didn't bet)
Seat 4: matiko09 folded before Flop (didn't bet)
Seat 6: Igor DoUrden folded before Flop (didn't bet)
Seat 7: PacPacBum (button) folded before Flop (didn't bet)
Seat 8: Sweden_Pound (small blind) folded before Flop





PokerStars Hand #150125812815:  Hold'em No Limit ($0.50/$1.00 USD) - 2016/03/10 13:18:27 CET [2016/03/10 7:18:27 ET]
Table 'Mars III' 9-max Seat #9 is the button
Seat 1: blackw0lf_03 ($100 in chips) 
Seat 2: pokixy800 ($67.60 in chips) 
Seat 3: PacPacBum ($110.48 in chips) 
Seat 4: Igor DoUrden ($117.61 in chips) 
Seat 5: ilaviiitech ($119.74 in chips) 
Seat 6: matiko09 ($101.85 in chips) 
Seat 7: Sweden_Pound ($100 in chips) 
Seat 8: Dennie Denc ($78.96 in chips) 
Seat 9: er13to ($100 in chips) 
blackw0lf_03: posts small blind $0.50
pokixy800: posts big blind $1
*** HOLE CARDS ***
Dealt to matiko09 [6d 8s]
PacPacBum: folds 
Igor DoUrden: raises $1 to $2
ilaviiitech: folds 
matiko09: folds 
Sweden_Pound: folds 
Dennie Denc: folds 
er13to: folds 
blackw0lf_03: folds 
pokixy800: calls $1
*** FLOP *** [9c Jd 3h]
pokixy800: checks 
Igor DoUrden: bets $2.15
pokixy800: folds 
Uncalled bet ($2.15) returned to Igor DoUrden
Igor DoUrden collected $4.30 from pot
Igor DoUrden: doesn't show hand 
*** SUMMARY ***
Total pot $4.50 | Rake $0.20 
Board [9c Jd 3h]
Seat 1: blackw0lf_03 (small blind) folded before Flop
Seat 2: pokixy800 (big blind) folded on the Flop
Seat 3: PacPacBum folded before Flop (didn't bet)
Seat 4: Igor DoUrden collected ($4.30)
Seat 5: ilaviiitech folded before Flop (didn't bet)
Seat 6: matiko09 folded before Flop (didn't bet)
Seat 7: Sweden_Pound folded before Flop (didn't bet)
Seat 8: Dennie Denc folded before Flop (didn't bet)
Seat 9: er13to (button) folded before Flop (didn't bet)





PokerStars Hand #150125813930:  Hold'em No Limit ($0.25/$0.50 USD) - 2016/03/10 13:18:29 CET [2016/03/10 7:18:29 ET]
Table 'Aegina' 9-max Seat #1 is the button
Seat 1: BingoIng0 ($109.98 in chips) 
Seat 2: dvutavr ($126.55 in chips) 
Seat 3: mobi1984 ($19.06 in chips) 
Seat 4: digimatical ($59.02 in chips) 
Seat 5: Ahangama ($53.75 in chips) 
Seat 6: matiko09 ($50 in chips) 
Seat 7: Gummio ($109.56 in chips) 
Seat 8: ardo888 ($168.92 in chips) 
dvutavr: posts small blind $0.25
mobi1984: posts big blind $0.50
draken08: sits out 
BingoIng0: posts the ante $0.10
dvutavr: posts the ante $0.10
mobi1984: posts the ante $0.10
digimatical: posts the ante $0.10
Ahangama: posts the ante $0.10
matiko09: posts the ante $0.10
Gummio: posts the ante $0.10
ardo888: posts the ante $0.10
*** HOLE CARDS ***
Dealt to matiko09 [2c 8s]
digimatical: calls $0.50
Ahangama: raises $2 to $2.50
matiko09: folds 
Gummio: folds 
ardo888: folds 
BingoIng0: calls $2.50
dvutavr: calls $2.25
mobi1984: raises $16.46 to $18.96 and is all-in
digimatical: folds 
Ahangama: folds 
BingoIng0: calls $16.46
dvutavr: folds 
*** FLOP *** [5h Jd Qc]
*** TURN *** [5h Jd Qc] [Kd]
*** RIVER *** [5h Jd Qc Kd] [Qs]
*** SHOW DOWN ***
mobi1984: shows [9s 4s] (a pair of Queens)
BingoIng0: shows [6d 6s] (two pair, Queens and Sixes)
BingoIng0 collected $42.23 from pot
*** SUMMARY ***
Total pot $44.22 | Rake $1.99 
Board [5h Jd Qc Kd Qs]
Seat 1: BingoIng0 (button) showed [6d 6s] and won ($42.23) with two pair, Queens and Sixes
Seat 2: dvutavr (small blind) folded before Flop
Seat 3: mobi1984 (big blind) showed [9s 4s] and lost with a pair of Queens
Seat 4: digimatical folded before Flop
Seat 5: Ahangama folded before Flop
Seat 6: matiko09 folded before Flop (didn't bet)
Seat 7: Gummio folded before Flop (didn't bet)
Seat 8: ardo888 folded before Flop (didn't bet)





PokerStars Hand #150125814207:  Hold'em No Limit ($0.50/$1.00 USD) - 2016/03/10 13:18:30 CET [2016/03/10 7:18:30 ET]
Table 'Virgo II' 9-max Seat #2 is the button
Seat 1: cdv1984 ($198.05 in chips) 
Seat 2: Plz3betMe ($51.77 in chips) 
Seat 4: UnBent022 ($101.75 in chips) 
Seat 5: stds st ($40.99 in chips) 
Seat 6: PacPacBum ($110 in chips) 
Seat 7: mamilets ($63.64 in chips) 
Seat 8: Sweden_Pound ($127.81 in chips) 
Seat 9: matiko09 ($100 in chips) 
blackw0lf_03 will be allowed to play after the button
UnBent022: posts small blind $0.50
stds st: posts big blind $1
*** HOLE CARDS ***
Dealt to matiko09 [4h Kc]
PacPacBum: calls $1
mamilets: folds 
Sweden_Pound: folds 
matiko09: folds 
cdv1984: folds 
Plz3betMe: folds 
UnBent022: folds 
stds st: checks 
*** FLOP *** [4c 7h Kd]
stds st: checks 
PacPacBum: bets $1.29
stds st: folds 
Uncalled bet ($1.29) returned to PacPacBum
PacPacBum collected $2.39 from pot
PacPacBum: doesn't show hand 
*** SUMMARY ***
Total pot $2.50 | Rake $0.11 
Board [4c 7h Kd]
Seat 1: cdv1984 folded before Flop (didn't bet)
Seat 2: Plz3betMe (button) folded before Flop (didn't bet)
Seat 4: UnBent022 (small blind) folded before Flop
Seat 5: stds st (big blind) folded on the Flop
Seat 6: PacPacBum collected ($2.39)
Seat 7: mamilets folded before Flop (didn't bet)
Seat 8: Sweden_Pound folded before Flop (didn't bet)
Seat 9: matiko09 folded before Flop (didn't bet)





PokerStars Hand #150125819033:  Hold'em No Limit ($0.50/$1.00 USD) - 2016/03/10 13:18:39 CET [2016/03/10 7:18:39 ET]
Table 'Liriope II' 9-max Seat #1 is the button
Seat 1: di0d80 ($121.06 in chips) 
Seat 2: zxp12345 ($48.34 in chips) 
Seat 3: matiko09 ($164.93 in chips) 
Seat 4: Plz3betMe ($58.93 in chips) 
Seat 6: nobu-azabu ($185.35 in chips) 
Seat 7: Sweden_Pound ($100 in chips) 
Seat 8: PacPacBum ($100 in chips) 
Seat 9: tipner ($107.05 in chips) 
zxp12345: posts small blind $0.50
matiko09: posts big blind $1
lumen21: sits out 
*** HOLE CARDS ***
Dealt to matiko09 [4s 9c]
Plz3betMe: raises $1.50 to $2.50
nobu-azabu: folds 
Sweden_Pound: folds 
PacPacBum: folds 
tipner: folds 
di0d80: folds 
zxp12345: folds 
matiko09: folds 
Uncalled bet ($1.50) returned to Plz3betMe
Plz3betMe collected $2.50 from pot
Plz3betMe: doesn't show hand 
*** SUMMARY ***
Total pot $2.50 | Rake $0 
Seat 1: di0d80 (button) folded before Flop (didn't bet)
Seat 2: zxp12345 (small blind) folded before Flop
Seat 3: matiko09 (big blind) folded before Flop
Seat 4: Plz3betMe collected ($2.50)
Seat 6: nobu-azabu folded before Flop (didn't bet)
Seat 7: Sweden_Pound folded before Flop (didn't bet)
Seat 8: PacPacBum folded before Flop (didn't bet)
Seat 9: tipner folded before Flop (didn't bet)





PokerStars Hand #150125821949:  Hold'em No Limit ($0.50/$1.00 USD) - 2016/03/10 13:18:45 CET [2016/03/10 7:18:45 ET]
Table 'Iguassu' 9-max Seat #8 is the button
Seat 1: blackw0lf_03 ($100.50 in chips) 
Seat 2: Rocky6434 ($67.49 in chips) 
Seat 3: hammerwife ($124.30 in chips) 
Seat 4: matiko09 ($100 in chips) 
Seat 6: Igor DoUrden ($100 in chips) 
Seat 7: PacPacBum ($101 in chips) 
Seat 8: Sweden_Pound ($100 in chips) 
blackw0lf_03: posts small blind $0.50
Rocky6434: posts big blind $1
UnBent022: sits out 
*** HOLE CARDS ***
Dealt to matiko09 [2d 7c]
hammerwife: folds 
matiko09: folds 
Igor DoUrden: folds 
PacPacBum: raises $1.04 to $2.04
Sweden_Pound: folds 
er13to joins the table at seat #9 
blackw0lf_03: folds 
Rocky6434: folds 
Uncalled bet ($1.04) returned to PacPacBum
PacPacBum collected $2.50 from pot
PacPacBum: doesn't show hand 
*** SUMMARY ***
Total pot $2.50 | Rake $0 
Seat 1: blackw0lf_03 (small blind) folded before Flop
Seat 2: Rocky6434 (big blind) folded before Flop
Seat 3: hammerwife folded before Flop (didn't bet)
Seat 4: matiko09 folded before Flop (didn't bet)
Seat 6: Igor DoUrden folded before Flop (didn't bet)
Seat 7: PacPacBum collected ($2.50)
Seat 8: Sweden_Pound (button) folded before Flop (didn't bet)





PokerStars Hand #150125835999:  Hold'em No Limit ($0.50/$1.00 USD) - 2016/03/10 13:19:11 CET [2016/03/10 7:19:11 ET]
Table 'Liriope II' 9-max Seat #2 is the button
Seat 1: di0d80 ($121.06 in chips) 
Seat 2: zxp12345 ($47.84 in chips) 
Seat 3: matiko09 ($163.93 in chips) 
Seat 4: Plz3betMe ($60.43 in chips) 
Seat 6: nobu-azabu ($185.35 in chips) 
Seat 7: Sweden_Pound ($100 in chips) 
Seat 8: PacPacBum ($100 in chips) 
Seat 9: tipner ($107.05 in chips) 
matiko09: posts small blind $0.50
Plz3betMe: posts big blind $1
lumen21: sits out 
*** HOLE CARDS ***
Dealt to matiko09 [2h Kh]
nobu-azabu: folds 
Sweden_Pound: folds 
PacPacBum: folds 
tipner: folds 
di0d80: raises $1.50 to $2.50
zxp12345: folds 
matiko09: folds 
Plz3betMe: calls $1.50
*** FLOP *** [Jh 7c 6d]
Plz3betMe: checks 
di0d80: bets $3
Plz3betMe: calls $3
*** TURN *** [Jh 7c 6d] [Ac]
Plz3betMe: checks 
di0d80: bets $7
Plz3betMe: calls $7
*** RIVER *** [Jh 7c 6d Ac] [6s]
Plz3betMe: checks 
di0d80: bets $19
Plz3betMe: folds 
Uncalled bet ($19) returned to di0d80
di0d80 collected $24.35 from pot
di0d80: doesn't show hand 
*** SUMMARY ***
Total pot $25.50 | Rake $1.15 
Board [Jh 7c 6d Ac 6s]
Seat 1: di0d80 collected ($24.35)
Seat 2: zxp12345 (button) folded before Flop (didn't bet)
Seat 3: matiko09 (small blind) folded before Flop
Seat 4: Plz3betMe (big blind) folded on the River
Seat 6: nobu-azabu folded before Flop (didn't bet)
Seat 7: Sweden_Pound folded before Flop (didn't bet)
Seat 8: PacPacBum folded before Flop (didn't bet)
Seat 9: tipner folded before Flop (didn't bet)





PokerStars Hand #150125836241:  Hold'em No Limit ($0.50/$1.00 USD) - 2016/03/10 13:19:12 CET [2016/03/10 7:19:12 ET]
Table 'Mars III' 9-max Seat #1 is the button
Seat 1: blackw0lf_03 ($100 in chips) 
Seat 2: pokixy800 ($65.60 in chips) 
Seat 3: PacPacBum ($110.48 in chips) 
Seat 4: Igor DoUrden ($119.91 in chips) 
Seat 5: ilaviiitech ($119.74 in chips) 
Seat 6: matiko09 ($101.85 in chips) 
Seat 7: Sweden_Pound ($100 in chips) 
Seat 8: Dennie Denc ($78.96 in chips) 
Seat 9: er13to ($100 in chips) 
pokixy800: posts small blind $0.50
PacPacBum: posts big blind $1
*** HOLE CARDS ***
Dealt to matiko09 [Qc 2c]
Igor DoUrden: folds 
ilaviiitech: folds 
matiko09: folds 
Sweden_Pound: folds 
Dennie Denc: folds 
er13to: folds 
blackw0lf_03: raises $1 to $2
pokixy800: folds 
PacPacBum: folds 
Uncalled bet ($1) returned to blackw0lf_03
blackw0lf_03 collected $2.50 from pot
blackw0lf_03: doesn't show hand 
*** SUMMARY ***
Total pot $2.50 | Rake $0 
Seat 1: blackw0lf_03 (button) collected ($2.50)
Seat 2: pokixy800 (small blind) folded before Flop
Seat 3: PacPacBum (big blind) folded before Flop
Seat 4: Igor DoUrden folded before Flop (didn't bet)
Seat 5: ilaviiitech folded before Flop (didn't bet)
Seat 6: matiko09 folded before Flop (didn't bet)
Seat 7: Sweden_Pound folded before Flop (didn't bet)
Seat 8: Dennie Denc folded before Flop (didn't bet)
Seat 9: er13to folded before Flop (didn't bet)





PokerStars Hand #150125839348:  Hold'em No Limit ($0.50/$1.00 USD) - 2016/03/10 13:19:18 CET [2016/03/10 7:19:18 ET]
Table 'Iguassu' 9-max Seat #1 is the button
Seat 1: blackw0lf_03 ($100 in chips) 
Seat 2: Rocky6434 ($66.49 in chips) 
Seat 3: hammerwife ($124.30 in chips) 
Seat 4: matiko09 ($100 in chips) 
Seat 6: Igor DoUrden ($100 in chips) 
Seat 7: PacPacBum ($102.50 in chips) 
Seat 8: Sweden_Pound ($100 in chips) 
Rocky6434: posts small blind $0.50
hammerwife: posts big blind $1
UnBent022: sits out 
er13to: sits out 
*** HOLE CARDS ***
Dealt to matiko09 [Tc Js]
matiko09: folds 
Igor DoUrden: folds 
PacPacBum: folds 
Sweden_Pound: raises $1.50 to $2.50
blackw0lf_03: folds 
Rocky6434: folds 
hammerwife: calls $1.50
*** FLOP *** [Td 6h 6s]
hammerwife: checks 
Sweden_Pound: checks 
*** TURN *** [Td 6h 6s] [4s]
hammerwife: bets $3.50
Sweden_Pound: folds 
Uncalled bet ($3.50) returned to hammerwife
hammerwife collected $5.25 from pot
hammerwife: doesn't show hand 
*** SUMMARY ***
Total pot $5.50 | Rake $0.25 
Board [Td 6h 6s 4s]
Seat 1: blackw0lf_03 (button) folded before Flop (didn't bet)
Seat 2: Rocky6434 (small blind) folded before Flop
Seat 3: hammerwife (big blind) collected ($5.25)
Seat 4: matiko09 folded before Flop (didn't bet)
Seat 6: Igor DoUrden folded before Flop (didn't bet)
Seat 7: PacPacBum folded before Flop (didn't bet)
Seat 8: Sweden_Pound folded on the Turn





PokerStars Hand #150125840974:  Hold'em No Limit ($0.50/$1.00 USD) - 2016/03/10 13:19:21 CET [2016/03/10 7:19:21 ET]
Table 'Saskia' 9-max Seat #5 is the button
Seat 1: Sweden_Pound ($111.51 in chips) 
Seat 2: njurg aga ($91.53 in chips) 
Seat 3: ccmaster001 ($59.44 in chips) 
Seat 4: Plz3betMe ($90.72 in chips) 
Seat 5: dreded11 ($86.93 in chips) 
Seat 6: matiko09 ($105.88 in chips) 
Seat 7: stds st ($33.35 in chips) 
matiko09: posts small blind $0.50
stds st: posts big blind $1
blackw0lf_03: sits out 
er13to: sits out 
*** HOLE CARDS ***
Dealt to matiko09 [4h 3h]
Sweden_Pound: folds 
njurg aga: raises $2 to $3
ccmaster001: calls $3
Plz3betMe: folds 
dreded11: folds 
matiko09: folds 
stds st: folds 
*** FLOP *** [8h Qd 9d]
njurg aga: bets $3.58
ccmaster001: calls $3.58
*** TURN *** [8h Qd 9d] [Jd]
njurg aga: checks 
ccmaster001: bets $8
njurg aga: calls $8
*** RIVER *** [8h Qd 9d Jd] [4d]
njurg aga: checks 
ccmaster001: bets $17
njurg aga: folds 
Uncalled bet ($17) returned to ccmaster001
ccmaster001 collected $29.28 from pot
ccmaster001: doesn't show hand 
*** SUMMARY ***
Total pot $30.66 | Rake $1.38 
Board [8h Qd 9d Jd 4d]
Seat 1: Sweden_Pound folded before Flop (didn't bet)
Seat 2: njurg aga folded on the River
Seat 3: ccmaster001 collected ($29.28)
Seat 4: Plz3betMe folded before Flop (didn't bet)
Seat 5: dreded11 (button) folded before Flop (didn't bet)
Seat 6: matiko09 (small blind) folded before Flop
Seat 7: stds st (big blind) folded before Flop





PokerStars Hand #150125842782:  Hold'em No Limit ($0.25/$0.50 USD) - 2016/03/10 13:19:24 CET [2016/03/10 7:19:24 ET]
Table 'Aegina' 9-max Seat #2 is the button
Seat 1: BingoIng0 ($133.15 in chips) 
Seat 2: dvutavr ($123.95 in chips) 
Seat 4: digimatical ($58.42 in chips) 
Seat 5: Ahangama ($51.15 in chips) 
Seat 6: matiko09 ($50 in chips) 
Seat 7: Gummio ($109.46 in chips) 
Seat 8: ardo888 ($168.82 in chips) 
digimatical: posts small blind $0.25
Ahangama: posts big blind $0.50
draken08: sits out 
BingoIng0: posts the ante $0.10
dvutavr: posts the ante $0.10
digimatical: posts the ante $0.10
Ahangama: posts the ante $0.10
matiko09: posts the ante $0.10
Gummio: posts the ante $0.10
ardo888: posts the ante $0.10
*** HOLE CARDS ***
Dealt to matiko09 [9h 2s]
matiko09: folds 
Gummio: folds 
mobi1984 leaves the table
ardo888: raises $1.50 to $2
BingoIng0: folds 
dvutavr: calls $2
digimatical: folds 
Ahangama: folds 
*** FLOP *** [As 6c Kc]
ardo888: bets $3.79
dvutavr: calls $3.79
*** TURN *** [As 6c Kc] [8s]
ardo888: bets $9.08
dvutavr: calls $9.08
*** RIVER *** [As 6c Kc 8s] [9c]
ardo888: checks 
dvutavr: checks 
*** SHOW DOWN ***
ardo888: shows [Kd Ah] (two pair, Aces and Kings)
dvutavr: mucks hand 
ardo888 collected $29.79 from pot
*** SUMMARY ***
Total pot $31.19 | Rake $1.40 
Board [As 6c Kc 8s 9c]
Seat 1: BingoIng0 folded before Flop (didn't bet)
Seat 2: dvutavr (button) mucked [Qs Ks]
Seat 4: digimatical (small blind) folded before Flop
Seat 5: Ahangama (big blind) folded before Flop
Seat 6: matiko09 folded before Flop (didn't bet)
Seat 7: Gummio folded before Flop (didn't bet)
Seat 8: ardo888 showed [Kd Ah] and won ($29.79) with two pair, Aces and Kings





PokerStars Hand #150125844531:  Hold'em No Limit ($0.50/$1.00 USD) - 2016/03/10 13:19:27 CET [2016/03/10 7:19:27 ET]
Table 'Virgo II' 9-max Seat #4 is the button
Seat 1: cdv1984 ($198.05 in chips) 
Seat 2: Plz3betMe ($51.77 in chips) 
Seat 4: UnBent022 ($101.25 in chips) 
Seat 5: stds st ($39.99 in chips) 
Seat 6: PacPacBum ($111.39 in chips) 
Seat 7: mamilets ($63.64 in chips) 
Seat 8: Sweden_Pound ($127.81 in chips) 
Seat 9: matiko09 ($100 in chips) 
stds st: posts small blind $0.50
PacPacBum: posts big blind $1
blackw0lf_03: sits out 
*** HOLE CARDS ***
Dealt to matiko09 [Qc Js]
mamilets: raises $1 to $2
Sweden_Pound: folds 
matiko09: folds 
cdv1984: raises $5 to $7
Plz3betMe: folds 
UnBent022: folds 
stds st: folds 
PacPacBum: folds 
mamilets: raises $9 to $16
cdv1984: folds 
Uncalled bet ($9) returned to mamilets
mamilets collected $15.50 from pot
mamilets: doesn't show hand 
*** SUMMARY ***
Total pot $15.50 | Rake $0 
Seat 1: cdv1984 folded before Flop
Seat 2: Plz3betMe folded before Flop (didn't bet)
Seat 4: UnBent022 (button) folded before Flop (didn't bet)
Seat 5: stds st (small blind) folded before Flop
Seat 6: PacPacBum (big blind) folded before Flop
Seat 7: mamilets collected ($15.50)
Seat 8: Sweden_Pound folded before Flop (didn't bet)
Seat 9: matiko09 folded before Flop (didn't bet)





PokerStars Hand #150125849170:  Hold'em No Limit ($0.50/$1.00 USD) - 2016/03/10 13:19:36 CET [2016/03/10 7:19:36 ET]
Table 'Leuschneria II' 9-max Seat #6 is the button
Seat 1: cdv1984 ($174.21 in chips) 
Seat 2: blackw0lf_03 ($101.71 in chips) 
Seat 3: gudridornot ($63.90 in chips) 
Seat 4: Sweden_Pound ($163.30 in chips) 
Seat 5: RMilPoker ($108.46 in chips) 
Seat 6: matiko09 ($101.50 in chips) 
Seat 7: Plz3betMe ($40.90 in chips) 
Seat 9: Katsulion ($121.41 in chips) 
Plz3betMe: posts small blind $0.50
hammerwife: is sitting out 
Katsulion: posts big blind $1
*** HOLE CARDS ***
Dealt to matiko09 [4h Ad]
hammerwife leaves the table
UnBent022 joins the table at seat #8 
cdv1984: folds 
blackw0lf_03: folds 
gudridornot: folds 
Sweden_Pound: folds 
RMilPoker: folds 
matiko09: raises $1.27 to $2.27
Plz3betMe: raises $5.23 to $7.50
Katsulion: folds 
matiko09: folds 
Uncalled bet ($5.23) returned to Plz3betMe
Plz3betMe collected $5.54 from pot
Plz3betMe: doesn't show hand 
*** SUMMARY ***
Total pot $5.54 | Rake $0 
Seat 1: cdv1984 folded before Flop (didn't bet)
Seat 2: blackw0lf_03 folded before Flop (didn't bet)
Seat 3: gudridornot folded before Flop (didn't bet)
Seat 4: Sweden_Pound folded before Flop (didn't bet)
Seat 5: RMilPoker folded before Flop (didn't bet)
Seat 6: matiko09 (button) folded before Flop
Seat 7: Plz3betMe (small blind) collected ($5.54)
Seat 9: Katsulion (big blind) folded before Flop





PokerStars Hand #150125858979:  Hold'em No Limit (€0.50/€1.00 EUR) - 2016/03/10 13:19:55 CET [2016/03/10 7:19:55 ET]
Table 'Claudia' 9-max Seat #8 is the button
Seat 1: matiko09 (€137.35 in chips) 
Seat 2: er13to (€100 in chips) 
Seat 3: full-deck699 (€62.75 in chips) 
Seat 4: Sweden_Pound (€100 in chips) 
Seat 5: Spid1 (€100 in chips) 
Seat 6: di0d80 (€101.73 in chips) 
Seat 7: tipner (€115.77 in chips) 
Seat 8: UnBent022 (€100 in chips) 
Seat 9: blackw0lf_03 (€100 in chips) 
blackw0lf_03: posts small blind €0.50
matiko09: posts big blind €1
*** HOLE CARDS ***
Dealt to matiko09 [3s 3d]
er13to: folds 
full-deck699: calls €1
Sweden_Pound: folds 
Spid1: raises €5 to €6
di0d80: folds 
tipner: folds 
UnBent022: folds 
blackw0lf_03: folds 
matiko09: folds 
full-deck699: calls €5
*** FLOP *** [4c 7c Jh]
full-deck699: bets €1
Spid1: raises €9 to €10
full-deck699: folds 
Uncalled bet (€9) returned to Spid1
Spid1 collected €14.80 from pot
Spid1: doesn't show hand 
*** SUMMARY ***
Total pot €15.50 | Rake €0.70 
Board [4c 7c Jh]
Seat 1: matiko09 (big blind) folded before Flop
Seat 2: er13to folded before Flop (didn't bet)
Seat 3: full-deck699 folded on the Flop
Seat 4: Sweden_Pound folded before Flop (didn't bet)
Seat 5: Spid1 collected (€14.80)
Seat 6: di0d80 folded before Flop (didn't bet)
Seat 7: tipner folded before Flop (didn't bet)
Seat 8: UnBent022 (button) folded before Flop (didn't bet)
Seat 9: blackw0lf_03 (small blind) folded before Flop





PokerStars Hand #150125864285:  Hold'em No Limit ($0.50/$1.00 USD) - 2016/03/10 13:20:05 CET [2016/03/10 7:20:05 ET]
Table 'Mars III' 9-max Seat #2 is the button
Seat 1: blackw0lf_03 ($101.50 in chips) 
Seat 2: pokixy800 ($65.10 in chips) 
Seat 3: PacPacBum ($109.48 in chips) 
Seat 4: Igor DoUrden ($119.91 in chips) 
Seat 5: ilaviiitech ($119.74 in chips) 
Seat 6: matiko09 ($101.85 in chips) 
Seat 7: Sweden_Pound ($100 in chips) 
Seat 8: Dennie Denc ($78.96 in chips) 
Seat 9: er13to ($100 in chips) 
PacPacBum: posts small blind $0.50
Igor DoUrden: posts big blind $1
*** HOLE CARDS ***
Dealt to matiko09 [Kd 6c]
ilaviiitech: folds 
matiko09: folds 
Sweden_Pound: folds 
Dennie Denc: folds 
er13to: raises $2 to $3
blackw0lf_03: raises $6 to $9
pokixy800: folds 
PacPacBum: folds 
Igor DoUrden: folds 
er13to: calls $6
*** FLOP *** [2h 8s Qh]
er13to: checks 
blackw0lf_03: checks 
*** TURN *** [2h 8s Qh] [9s]
er13to: checks 
blackw0lf_03: bets $10.80
er13to: folds 
Uncalled bet ($10.80) returned to blackw0lf_03
blackw0lf_03 collected $18.62 from pot
blackw0lf_03: doesn't show hand 
*** SUMMARY ***
Total pot $19.50 | Rake $0.88 
Board [2h 8s Qh 9s]
Seat 1: blackw0lf_03 collected ($18.62)
Seat 2: pokixy800 (button) folded before Flop (didn't bet)
Seat 3: PacPacBum (small blind) folded before Flop
Seat 4: Igor DoUrden (big blind) folded before Flop
Seat 5: ilaviiitech folded before Flop (didn't bet)
Seat 6: matiko09 folded before Flop (didn't bet)
Seat 7: Sweden_Pound folded before Flop (didn't bet)
Seat 8: Dennie Denc folded before Flop (didn't bet)
Seat 9: er13to folded on the Turn





PokerStars Hand #150125871352:  Hold'em No Limit ($0.50/$1.00 USD) - 2016/03/10 13:20:18 CET [2016/03/10 7:20:18 ET]
Table 'Iguassu' 9-max Seat #2 is the button
Seat 1: blackw0lf_03 ($100 in chips) 
Seat 2: Rocky6434 ($65.99 in chips) 
Seat 3: hammerwife ($127.05 in chips) 
Seat 4: matiko09 ($100 in chips) 
Seat 6: Igor DoUrden ($100 in chips) 
Seat 7: PacPacBum ($102.50 in chips) 
Seat 8: Sweden_Pound ($100 in chips) 
hammerwife: posts small blind $0.50
matiko09: posts big blind $1
UnBent022: sits out 
er13to: sits out 
*** HOLE CARDS ***
Dealt to matiko09 [7h Kc]
Igor DoUrden: folds 
PacPacBum: folds 
Sweden_Pound: folds 
blackw0lf_03: raises $1 to $2
Rocky6434: folds 
hammerwife: folds 
matiko09: folds 
Uncalled bet ($1) returned to blackw0lf_03
blackw0lf_03 collected $2.50 from pot
blackw0lf_03: doesn't show hand 
*** SUMMARY ***
Total pot $2.50 | Rake $0 
Seat 1: blackw0lf_03 collected ($2.50)
Seat 2: Rocky6434 (button) folded before Flop (didn't bet)
Seat 3: hammerwife (small blind) folded before Flop
Seat 4: matiko09 (big blind) folded before Flop
Seat 6: Igor DoUrden folded before Flop (didn't bet)
Seat 7: PacPacBum folded before Flop (didn't bet)
Seat 8: Sweden_Pound folded before Flop (didn't bet)





PokerStars Hand #150125874323:  Hold'em No Limit ($0.50/$1.00 USD) - 2016/03/10 13:20:24 CET [2016/03/10 7:20:24 ET]
Table 'Leuschneria II' 9-max Seat #7 is the button
Seat 1: cdv1984 ($174.21 in chips) 
Seat 2: blackw0lf_03 ($101.71 in chips) 
Seat 3: gudridornot ($64.38 in chips) 
Seat 4: Sweden_Pound ($163.30 in chips) 
Seat 5: RMilPoker ($108.46 in chips) 
Seat 6: matiko09 ($100 in chips) 
Seat 7: Plz3betMe ($44.17 in chips) 
Seat 9: Katsulion ($120.41 in chips) 
UnBent022 will be allowed to play after the button
Katsulion: posts small blind $0.50
cdv1984: posts big blind $1
*** HOLE CARDS ***
Dealt to matiko09 [Jd Jc]
blackw0lf_03: folds 
gudridornot: folds 
Sweden_Pound: raises $2 to $3
RMilPoker: folds 
matiko09: calls $3
Plz3betMe: folds 
Katsulion: folds 
cdv1984: folds 
*** FLOP *** [3d Js Th]
Sweden_Pound: bets $4.65
matiko09: calls $4.65
*** TURN *** [3d Js Th] [5h]
Sweden_Pound: bets $10.43
matiko09: raises $14.57 to $25
Sweden_Pound: folds 
Uncalled bet ($14.57) returned to matiko09
matiko09 collected $35.97 from pot
matiko09: doesn't show hand 
*** SUMMARY ***
Total pot $37.66 | Rake $1.69 
Board [3d Js Th 5h]
Seat 1: cdv1984 (big blind) folded before Flop
Seat 2: blackw0lf_03 folded before Flop (didn't bet)
Seat 3: gudridornot folded before Flop (didn't bet)
Seat 4: Sweden_Pound folded on the Turn
Seat 5: RMilPoker folded before Flop (didn't bet)
Seat 6: matiko09 collected ($35.97)
Seat 7: Plz3betMe (button) folded before Flop (didn't bet)
Seat 9: Katsulion (small blind) folded before Flop





PokerStars Hand #150125874546:  Hold'em No Limit ($0.50/$1.00 USD) - 2016/03/10 13:20:25 CET [2016/03/10 7:20:25 ET]
Table 'Saskia' 9-max Seat #6 is the button
Seat 1: Sweden_Pound ($111.51 in chips) 
Seat 2: njurg aga ($76.95 in chips) 
Seat 3: ccmaster001 ($74.14 in chips) 
Seat 4: Plz3betMe ($90.72 in chips) 
Seat 5: dreded11 ($86.93 in chips) 
Seat 6: matiko09 ($105.38 in chips) 
Seat 7: stds st ($32.35 in chips) 
Seat 8: blackw0lf_03 ($110.20 in chips) 
stds st: posts small blind $0.50
blackw0lf_03: posts big blind $1
er13to: sits out 
*** HOLE CARDS ***
Dealt to matiko09 [Js 4h]
Sweden_Pound: folds 
njurg aga: folds 
ccmaster001: folds 
Plz3betMe: folds 
dreded11: raises $2 to $3
matiko09: folds 
stds st: folds 
blackw0lf_03: folds 
Uncalled bet ($2) returned to dreded11
dreded11 collected $2.50 from pot
dreded11: doesn't show hand 
*** SUMMARY ***
Total pot $2.50 | Rake $0 
Seat 1: Sweden_Pound folded before Flop (didn't bet)
Seat 2: njurg aga folded before Flop (didn't bet)
Seat 3: ccmaster001 folded before Flop (didn't bet)
Seat 4: Plz3betMe folded before Flop (didn't bet)
Seat 5: dreded11 collected ($2.50)
Seat 6: matiko09 (button) folded before Flop (didn't bet)
Seat 7: stds st (small blind) folded before Flop
Seat 8: blackw0lf_03 (big blind) folded before Flop





PokerStars Hand #150125880995:  Hold'em No Limit (€1/€2 EUR) - 2016/03/10 13:20:37 CET [2016/03/10 7:20:37 ET]
Table 'Sigrid II' 9-max Seat #5 is the button
Seat 1: Gamz11 (€203 in chips) 
Seat 5: vr188 (€99 in chips) 
Seat 7: PacPacBum (€200 in chips) 
Seat 8: matiko09 (€200 in chips) 
azzad2007 will be allowed to play after the button
PacPacBum: posts small blind €1
matiko09: posts big blind €2
*** HOLE CARDS ***
Dealt to matiko09 [Td 4s]
Gamz11: raises €2.92 to €4.92
vr188: calls €4.92
PacPacBum: folds 
matiko09: folds 
*** FLOP *** [2h Kd 7h]
Gamz11: bets €8.45
vr188: calls €8.45
*** TURN *** [2h Kd 7h] [Ts]
Gamz11: checks 
vr188: checks 
*** RIVER *** [2h Kd 7h Ts] [8c]
Gamz11: checks 
vr188: checks 
*** SHOW DOWN ***
Gamz11: shows [Th Jc] (a pair of Tens)
vr188: mucks hand 
Gamz11 collected €28.49 from pot
*** SUMMARY ***
Total pot €29.74 | Rake €1.25 
Board [2h Kd 7h Ts 8c]
Seat 1: Gamz11 showed [Th Jc] and won (€28.49) with a pair of Tens
Seat 5: vr188 (button) mucked [Qh Ah]
Seat 7: PacPacBum (small blind) folded before Flop
Seat 8: matiko09 (big blind) folded before Flop





PokerStars Hand #150125886481:  Hold'em No Limit ($0.50/$1.00 USD) - 2016/03/10 13:20:48 CET [2016/03/10 7:20:48 ET]
Table 'Iguassu' 9-max Seat #3 is the button
Seat 1: blackw0lf_03 ($101.50 in chips) 
Seat 2: Rocky6434 ($65.99 in chips) 
Seat 3: hammerwife ($126.55 in chips) 
Seat 4: matiko09 ($100 in chips) 
Seat 5: UnBent022 ($100 in chips) 
Seat 6: Igor DoUrden ($100 in chips) 
Seat 7: PacPacBum ($102.50 in chips) 
Seat 8: Sweden_Pound ($100 in chips) 
matiko09: posts small blind $0.50
UnBent022: posts big blind $1
er13to: sits out 
*** HOLE CARDS ***
Dealt to matiko09 [Ad 2h]
Igor DoUrden: folds 
PacPacBum: folds 
Sweden_Pound: folds 
blackw0lf_03: folds 
Rocky6434: raises $1 to $2
hammerwife: folds 
matiko09: folds 
UnBent022: calls $1
*** FLOP *** [4c 7h 8s]
UnBent022: checks 
Rocky6434: checks 
*** TURN *** [4c 7h 8s] [Ac]
UnBent022: checks 
Rocky6434: checks 
*** RIVER *** [4c 7h 8s Ac] [5s]
UnBent022: checks 
Rocky6434: bets $4.30
UnBent022: folds 
Uncalled bet ($4.30) returned to Rocky6434
Rocky6434 collected $4.30 from pot
Rocky6434: doesn't show hand 
*** SUMMARY ***
Total pot $4.50 | Rake $0.20 
Board [4c 7h 8s Ac 5s]
Seat 1: blackw0lf_03 folded before Flop (didn't bet)
Seat 2: Rocky6434 collected ($4.30)
Seat 3: hammerwife (button) folded before Flop (didn't bet)
Seat 4: matiko09 (small blind) folded before Flop
Seat 5: UnBent022 (big blind) folded on the River
Seat 6: Igor DoUrden folded before Flop (didn't bet)
Seat 7: PacPacBum folded before Flop (didn't bet)
Seat 8: Sweden_Pound folded before Flop (didn't bet)





PokerStars Hand #150125890193:  Hold'em No Limit ($0.25/$0.50 USD) - 2016/03/10 13:20:55 CET [2016/03/10 7:20:55 ET]
Table 'Aegina' 9-max Seat #4 is the button
Seat 1: BingoIng0 ($133.05 in chips) 
Seat 2: dvutavr ($108.98 in chips) 
Seat 4: digimatical ($58.07 in chips) 
Seat 5: Ahangama ($50.55 in chips) 
Seat 6: matiko09 ($50 in chips) 
Seat 7: Gummio ($109.36 in chips) 
Seat 8: ardo888 ($183.64 in chips) 
Ahangama: posts small blind $0.25
matiko09: posts big blind $0.50
draken08: sits out 
BingoIng0: posts the ante $0.10
dvutavr: posts the ante $0.10
digimatical: posts the ante $0.10
Ahangama: posts the ante $0.10
matiko09: posts the ante $0.10
Gummio: posts the ante $0.10
ardo888: posts the ante $0.10
*** HOLE CARDS ***
Dealt to matiko09 [Th 4s]
Gummio: calls $0.50
ardo888: folds 
BingoIng0: folds 
dvutavr: raises $1 to $1.50
digimatical: folds 
Ahangama: folds 
matiko09: folds 
Gummio: calls $1
*** FLOP *** [9c 4h 6c]
Gummio: checks 
dvutavr: bets $2.50
Gummio: folds 
Uncalled bet ($2.50) returned to dvutavr
dvutavr collected $4.25 from pot
dvutavr: doesn't show hand 
*** SUMMARY ***
Total pot $4.45 | Rake $0.20 
Board [9c 4h 6c]
Seat 1: BingoIng0 folded before Flop (didn't bet)
Seat 2: dvutavr collected ($4.25)
Seat 4: digimatical (button) folded before Flop (didn't bet)
Seat 5: Ahangama (small blind) folded before Flop
Seat 6: matiko09 (big blind) folded before Flop
Seat 7: Gummio folded on the Flop
Seat 8: ardo888 folded before Flop (didn't bet)





PokerStars Hand #150125892772:  Hold'em No Limit (€0.50/€1.00 EUR) - 2016/03/10 13:21:00 CET [2016/03/10 7:21:00 ET]
Table 'Claudia' 9-max Seat #9 is the button
Seat 1: matiko09 (€136.35 in chips) 
Seat 2: er13to (€100 in chips) 
Seat 3: full-deck699 (€55.75 in chips) 
Seat 4: Sweden_Pound (€100 in chips) 
Seat 5: Spid1 (€107.80 in chips) 
Seat 6: di0d80 (€101.73 in chips) 
Seat 7: tipner (€115.77 in chips) 
Seat 8: UnBent022 (€100 in chips) 
Seat 9: blackw0lf_03 (€100 in chips) 
matiko09: posts small blind €0.50
er13to: posts big blind €1
*** HOLE CARDS ***
Dealt to matiko09 [2h 4c]
full-deck699: raises €1 to €2
Sweden_Pound: folds 
Spid1: folds 
di0d80: folds 
tipner: folds 
UnBent022: folds 
blackw0lf_03: folds 
matiko09: folds 
er13to: calls €1
*** FLOP *** [4s Jc 6d]
er13to: checks 
full-deck699: bets €1
er13to: folds 
Uncalled bet (€1) returned to full-deck699
full-deck699 collected €4.30 from pot
full-deck699: doesn't show hand 
*** SUMMARY ***
Total pot €4.50 | Rake €0.20 
Board [4s Jc 6d]
Seat 1: matiko09 (small blind) folded before Flop
Seat 2: er13to (big blind) folded on the Flop
Seat 3: full-deck699 collected (€4.30)
Seat 4: Sweden_Pound folded before Flop (didn't bet)
Seat 5: Spid1 folded before Flop (didn't bet)
Seat 6: di0d80 folded before Flop (didn't bet)
Seat 7: tipner folded before Flop (didn't bet)
Seat 8: UnBent022 folded before Flop (didn't bet)
Seat 9: blackw0lf_03 (button) folded before Flop (didn't bet)





PokerStars Hand #150125894864:  Hold'em No Limit ($0.50/$1.00 USD) - 2016/03/10 13:21:04 CET [2016/03/10 7:21:04 ET]
Table 'Saskia' 9-max Seat #7 is the button
Seat 1: Sweden_Pound ($111.51 in chips) 
Seat 2: njurg aga ($76.95 in chips) 
Seat 3: ccmaster001 ($74.14 in chips) 
Seat 4: Plz3betMe ($90.72 in chips) 
Seat 5: dreded11 ($88.43 in chips) 
Seat 6: matiko09 ($105.38 in chips) 
Seat 7: stds st ($31.85 in chips) 
Seat 8: blackw0lf_03 ($109.20 in chips) 
Seat 9: er13to ($119.47 in chips) 
blackw0lf_03: posts small blind $0.50
er13to: posts big blind $1
*** HOLE CARDS ***
Dealt to matiko09 [7h 5h]
Sweden_Pound: folds 
njurg aga: folds 
ccmaster001: folds 
Plz3betMe: folds 
dreded11: raises $1 to $2
matiko09: folds 
stds st: folds 
blackw0lf_03: calls $1.50
er13to: calls $1
*** FLOP *** [2h Td 7c]
blackw0lf_03: checks 
er13to: checks 
dreded11: bets $4
blackw0lf_03: folds 
er13to: folds 
Uncalled bet ($4) returned to dreded11
dreded11 collected $5.73 from pot
dreded11: doesn't show hand 
*** SUMMARY ***
Total pot $6 | Rake $0.27 
Board [2h Td 7c]
Seat 1: Sweden_Pound folded before Flop (didn't bet)
Seat 2: njurg aga folded before Flop (didn't bet)
Seat 3: ccmaster001 folded before Flop (didn't bet)
Seat 4: Plz3betMe folded before Flop (didn't bet)
Seat 5: dreded11 collected ($5.73)
Seat 6: matiko09 folded before Flop (didn't bet)
Seat 7: stds st (button) folded before Flop (didn't bet)
Seat 8: blackw0lf_03 (small blind) folded on the Flop
Seat 9: er13to (big blind) folded on the Flop





PokerStars Hand #150125900174:  Hold'em No Limit ($0.50/$1.00 USD) - 2016/03/10 13:21:14 CET [2016/03/10 7:21:14 ET]
Table 'Virgo II' 9-max Seat #5 is the button
Seat 1: cdv1984 ($191.05 in chips) 
Seat 2: Plz3betMe ($51.77 in chips) 
Seat 4: UnBent022 ($101.25 in chips) 
Seat 5: stds st ($39.49 in chips) 
Seat 6: PacPacBum ($110.39 in chips) 
Seat 7: mamilets ($72.14 in chips) 
Seat 8: Sweden_Pound ($127.81 in chips) 
Seat 9: matiko09 ($100 in chips) 
PacPacBum: posts small blind $0.50
mamilets: posts big blind $1
blackw0lf_03: sits out 
*** HOLE CARDS ***
Dealt to matiko09 [Qs Tc]
Sweden_Pound: folds 
matiko09: folds 
cdv1984: folds 
Plz3betMe: folds 
UnBent022: folds 
stds st: raises $1 to $2
PacPacBum: folds 
mamilets: calls $1
*** FLOP *** [7c 3h As]
mamilets: checks 
stds st: bets $2.36
mamilets: folds 
Uncalled bet ($2.36) returned to stds st
stds st collected $4.30 from pot
stds st: doesn't show hand 
*** SUMMARY ***
Total pot $4.50 | Rake $0.20 
Board [7c 3h As]
Seat 1: cdv1984 folded before Flop (didn't bet)
Seat 2: Plz3betMe folded before Flop (didn't bet)
Seat 4: UnBent022 folded before Flop (didn't bet)
Seat 5: stds st (button) collected ($4.30)
Seat 6: PacPacBum (small blind) folded before Flop
Seat 7: mamilets (big blind) folded on the Flop
Seat 8: Sweden_Pound folded before Flop (didn't bet)
Seat 9: matiko09 folded before Flop (didn't bet)





PokerStars Hand #150125907556:  Hold'em No Limit ($0.50/$1.00 USD) - 2016/03/10 13:21:28 CET [2016/03/10 7:21:28 ET]
Table 'Liriope II' 9-max Seat #3 is the button
Seat 1: di0d80 ($132.91 in chips) 
Seat 2: zxp12345 ($47.84 in chips) 
Seat 3: matiko09 ($163.43 in chips) 
Seat 4: Plz3betMe ($47.93 in chips) 
Seat 5: lumen21 ($100 in chips) 
Seat 6: nobu-azabu ($185.35 in chips) 
Seat 7: Sweden_Pound ($100 in chips) 
Seat 8: PacPacBum ($100 in chips) 
Seat 9: tipner ($107.05 in chips) 
Plz3betMe: posts small blind $0.50
lumen21: posts big blind $1
*** HOLE CARDS ***
Dealt to matiko09 [Jd 8s]
nobu-azabu: folds 
Sweden_Pound: folds 
PacPacBum: folds 
tipner: folds 
di0d80: folds 
zxp12345: folds 
matiko09: folds 
Plz3betMe: folds 
Uncalled bet ($0.50) returned to lumen21
lumen21 collected $1 from pot
lumen21: doesn't show hand 
*** SUMMARY ***
Total pot $1 | Rake $0 
Seat 1: di0d80 folded before Flop (didn't bet)
Seat 2: zxp12345 folded before Flop (didn't bet)
Seat 3: matiko09 (button) folded before Flop (didn't bet)
Seat 4: Plz3betMe (small blind) folded before Flop
Seat 5: lumen21 (big blind) collected ($1)
Seat 6: nobu-azabu folded before Flop (didn't bet)
Seat 7: Sweden_Pound folded before Flop (didn't bet)
Seat 8: PacPacBum folded before Flop (didn't bet)
Seat 9: tipner folded before Flop (didn't bet)





PokerStars Hand #150125913658:  Hold'em No Limit ($0.50/$1.00 USD) - 2016/03/10 13:21:39 CET [2016/03/10 7:21:39 ET]
Table 'Iguassu' 9-max Seat #4 is the button
Seat 1: blackw0lf_03 ($101.50 in chips) 
Seat 2: Rocky6434 ($68.29 in chips) 
Seat 3: hammerwife ($126.55 in chips) 
Seat 4: matiko09 ($100 in chips) 
Seat 5: UnBent022 ($100 in chips) 
Seat 6: Igor DoUrden ($100 in chips) 
Seat 7: PacPacBum ($102.50 in chips) 
Seat 8: Sweden_Pound ($100 in chips) 
UnBent022: posts small blind $0.50
Igor DoUrden: posts big blind $1
er13to: sits out 
*** HOLE CARDS ***
Dealt to matiko09 [2d Qs]
PacPacBum: folds 
Sweden_Pound has timed out
Sweden_Pound: folds 
blackw0lf_03: raises $2 to $3
Rocky6434: folds 
hammerwife: folds 
matiko09: folds 
UnBent022: folds 
Igor DoUrden: folds 
Uncalled bet ($2) returned to blackw0lf_03
blackw0lf_03 collected $2.50 from pot
blackw0lf_03: doesn't show hand 
*** SUMMARY ***
Total pot $2.50 | Rake $0 
Seat 1: blackw0lf_03 collected ($2.50)
Seat 2: Rocky6434 folded before Flop (didn't bet)
Seat 3: hammerwife folded before Flop (didn't bet)
Seat 4: matiko09 (button) folded before Flop (didn't bet)
Seat 5: UnBent022 (small blind) folded before Flop
Seat 6: Igor DoUrden (big blind) folded before Flop
Seat 7: PacPacBum folded before Flop (didn't bet)
Seat 8: Sweden_Pound folded before Flop (didn't bet)





PokerStars Hand #150125916690:  Hold'em No Limit (€0.50/€1.00 EUR) - 2016/03/10 13:21:45 CET [2016/03/10 7:21:45 ET]
Table 'Claudia' 9-max Seat #1 is the button
Seat 1: matiko09 (€135.85 in chips) 
Seat 2: er13to (€100 in chips) 
Seat 3: full-deck699 (€58.05 in chips) 
Seat 4: Sweden_Pound (€100 in chips) 
Seat 5: Spid1 (€107.80 in chips) 
Seat 6: di0d80 (€101.73 in chips) 
Seat 7: tipner (€115.77 in chips) 
Seat 8: UnBent022 (€100 in chips) 
Seat 9: blackw0lf_03 (€100 in chips) 
er13to: posts small blind €0.50
full-deck699: posts big blind €1
*** HOLE CARDS ***
Dealt to matiko09 [Jh 7h]
Sweden_Pound: folds 
Spid1: folds 
di0d80: folds 
tipner: folds 
UnBent022: folds 
blackw0lf_03: folds 
matiko09: raises €1.27 to €2.27
er13to: folds 
full-deck699: calls €1.27
*** FLOP *** [7c 9d 6c]
full-deck699: bets €4.81
matiko09: calls €4.81
*** TURN *** [7c 9d 6c] [Ad]
full-deck699: bets €1
matiko09: calls €1
*** RIVER *** [7c 9d 6c Ad] [2s]
full-deck699: bets €15.91
matiko09: folds 
Uncalled bet (€15.91) returned to full-deck699
full-deck699 collected €15.91 from pot
full-deck699: doesn't show hand 
*** SUMMARY ***
Total pot €16.66 | Rake €0.75 
Board [7c 9d 6c Ad 2s]
Seat 1: matiko09 (button) folded on the River
Seat 2: er13to (small blind) folded before Flop
Seat 3: full-deck699 (big blind) collected (€15.91)
Seat 4: Sweden_Pound folded before Flop (didn't bet)
Seat 5: Spid1 folded before Flop (didn't bet)
Seat 6: di0d80 folded before Flop (didn't bet)
Seat 7: tipner folded before Flop (didn't bet)
Seat 8: UnBent022 folded before Flop (didn't bet)
Seat 9: blackw0lf_03 folded before Flop (didn't bet)





PokerStars Hand #150125917276:  Hold'em No Limit (€1/€2 EUR) - 2016/03/10 13:21:46 CET [2016/03/10 7:21:46 ET]
Table 'Sigrid II' 9-max Seat #7 is the button
Seat 1: Gamz11 (€218.12 in chips) 
Seat 5: vr188 (€85.63 in chips) 
Seat 7: PacPacBum (€200 in chips) 
Seat 8: matiko09 (€200 in chips) 
matiko09: posts small blind €1
Gamz11: posts big blind €2
azzad2007: sits out 
*** HOLE CARDS ***
Dealt to matiko09 [6c 9s]
vr188: folds 
PacPacBum: raises €2.08 to €4.08
matiko09: folds 
Gamz11: calls €2.08
*** FLOP *** [Ks 4c 2c]
Gamz11: checks 
PacPacBum: checks 
*** TURN *** [Ks 4c 2c] [3s]
Gamz11: bets €6.91
PacPacBum: calls €6.91
*** RIVER *** [Ks 4c 2c 3s] [Jd]
Gamz11: bets €15.64
PacPacBum: calls €15.64
*** SHOW DOWN ***
Gamz11: shows [2s Kh] (two pair, Kings and Deuces)
PacPacBum: mucks hand 
Gamz11 collected €53.01 from pot
*** SUMMARY ***
Total pot €54.26 | Rake €1.25 
Board [Ks 4c 2c 3s Jd]
Seat 1: Gamz11 (big blind) showed [2s Kh] and won (€53.01) with two pair, Kings and Deuces
Seat 5: vr188 folded before Flop (didn't bet)
Seat 7: PacPacBum (button) mucked [Kc Qc]
Seat 8: matiko09 (small blind) folded before Flop





PokerStars Hand #150125920173:  Hold'em No Limit ($0.50/$1.00 USD) - 2016/03/10 13:21:52 CET [2016/03/10 7:21:52 ET]
Table 'Liriope II' 9-max Seat #4 is the button
Seat 1: di0d80 ($132.91 in chips) 
Seat 2: zxp12345 ($47.84 in chips) 
Seat 3: matiko09 ($163.43 in chips) 
Seat 4: Plz3betMe ($47.43 in chips) 
Seat 5: lumen21 ($100.50 in chips) 
Seat 6: nobu-azabu ($185.35 in chips) 
Seat 7: Sweden_Pound ($100 in chips) 
Seat 8: PacPacBum ($100 in chips) 
Seat 9: tipner ($107.05 in chips) 
lumen21: posts small blind $0.50
nobu-azabu: posts big blind $1
*** HOLE CARDS ***
Dealt to matiko09 [7s Tc]
Sweden_Pound: folds 
PacPacBum: raises $2 to $3
tipner: folds 
di0d80: folds 
zxp12345: calls $3
matiko09: folds 
Plz3betMe: folds 
lumen21: folds 
nobu-azabu: folds 
*** FLOP *** [9h 7h 9c]
PacPacBum: checks 
zxp12345: checks 
*** TURN *** [9h 7h 9c] [6c]
PacPacBum: bets $4.94
zxp12345: calls $4.94
*** RIVER *** [9h 7h 9c 6c] [4h]
PacPacBum: checks 
zxp12345: bets $8.30
PacPacBum: calls $8.30
*** SHOW DOWN ***
zxp12345: shows [Js 8s] (a pair of Nines)
PacPacBum: shows [Qs Qc] (two pair, Queens and Nines)
PacPacBum collected $32.45 from pot
*** SUMMARY ***
Total pot $33.98 | Rake $1.53 
Board [9h 7h 9c 6c 4h]
Seat 1: di0d80 folded before Flop (didn't bet)
Seat 2: zxp12345 showed [Js 8s] and lost with a pair of Nines
Seat 3: matiko09 folded before Flop (didn't bet)
Seat 4: Plz3betMe (button) folded before Flop (didn't bet)
Seat 5: lumen21 (small blind) folded before Flop
Seat 6: nobu-azabu (big blind) folded before Flop
Seat 7: Sweden_Pound folded before Flop (didn't bet)
Seat 8: PacPacBum showed [Qs Qc] and won ($32.45) with two pair, Queens and Nines
Seat 9: tipner folded before Flop (didn't bet)





PokerStars Hand #150125927711:  Hold'em No Limit ($0.25/$0.50 USD) - 2016/03/10 13:22:06 CET [2016/03/10 7:22:06 ET]
Table 'Aegina' 9-max Seat #5 is the button
Seat 1: BingoIng0 ($132.95 in chips) 
Seat 2: dvutavr ($111.63 in chips) 
Seat 4: digimatical ($57.97 in chips) 
Seat 5: Ahangama ($50.20 in chips) 
Seat 6: matiko09 ($50 in chips) 
Seat 7: Gummio ($107.76 in chips) 
Seat 8: ardo888 ($183.54 in chips) 
matiko09: posts small blind $0.25
Gummio: posts big blind $0.50
draken08: sits out 
BingoIng0: posts the ante $0.10
dvutavr: posts the ante $0.10
digimatical: posts the ante $0.10
Ahangama: posts the ante $0.10
matiko09: posts the ante $0.10
Gummio: posts the ante $0.10
ardo888: posts the ante $0.10
*** HOLE CARDS ***
Dealt to matiko09 [Jh Ad]
ardo888: folds 
BingoIng0: raises $0.75 to $1.25
dvutavr: folds 
digimatical: calls $1.25
Ahangama: folds 
Fandango1991 joins the table at seat #3 
matiko09: raises $4.25 to $5.50
Gummio: folds 
BingoIng0: calls $4.25
digimatical: calls $4.25
*** FLOP *** [Ts 6s 4d]
matiko09: checks 
BingoIng0: checks 
digimatical: bets $9
matiko09: folds 
BingoIng0: calls $9
*** TURN *** [Ts 6s 4d] [4c]
BingoIng0: checks 
digimatical: bets $43.37 and is all-in
BingoIng0: folds 
Uncalled bet ($43.37) returned to digimatical
digimatical collected $34.09 from pot
*** SUMMARY ***
Total pot $35.70 | Rake $1.61 
Board [Ts 6s 4d 4c]
Seat 1: BingoIng0 folded on the Turn
Seat 2: dvutavr folded before Flop (didn't bet)
Seat 4: digimatical collected ($34.09)
Seat 5: Ahangama (button) folded before Flop (didn't bet)
Seat 6: matiko09 (small blind) folded on the Flop
Seat 7: Gummio (big blind) folded before Flop
Seat 8: ardo888 folded before Flop (didn't bet)





PokerStars Hand #150125928632:  Hold'em No Limit ($0.50/$1.00 USD) - 2016/03/10 13:22:08 CET [2016/03/10 7:22:08 ET]
Table 'Leuschneria II' 9-max Seat #9 is the button
Seat 1: cdv1984 ($173.21 in chips) 
Seat 2: blackw0lf_03 ($101.71 in chips) 
Seat 3: gudridornot ($64.38 in chips) 
Seat 4: Sweden_Pound ($145.22 in chips) 
Seat 5: RMilPoker ($108.46 in chips) 
Seat 6: matiko09 ($117.89 in chips) 
Seat 7: Plz3betMe ($44.17 in chips) 
Seat 9: Katsulion ($119.91 in chips) 
cdv1984: posts small blind $0.50
blackw0lf_03: posts big blind $1
UnBent022: sits out 
*** HOLE CARDS ***
Dealt to matiko09 [Ts As]
gudridornot: calls $1
Sweden_Pound: folds 
RMilPoker: folds 
matiko09: raises $3 to $4
Plz3betMe: folds 
Katsulion: raises $8 to $12
cdv1984: folds 
blackw0lf_03: folds 
gudridornot: folds 
matiko09: folds 
Uncalled bet ($8) returned to Katsulion
Katsulion collected $10.50 from pot
*** SUMMARY ***
Total pot $10.50 | Rake $0 
Seat 1: cdv1984 (small blind) folded before Flop
Seat 2: blackw0lf_03 (big blind) folded before Flop
Seat 3: gudridornot folded before Flop
Seat 4: Sweden_Pound folded before Flop (didn't bet)
Seat 5: RMilPoker folded before Flop (didn't bet)
Seat 6: matiko09 folded before Flop
Seat 7: Plz3betMe folded before Flop (didn't bet)
Seat 9: Katsulion (button) collected ($10.50)





PokerStars Hand #150125937050:  Hold'em No Limit ($0.50/$1.00 USD) - 2016/03/10 13:22:24 CET [2016/03/10 7:22:24 ET]
Table 'Iguassu' 9-max Seat #5 is the button
Seat 1: blackw0lf_03 ($103 in chips) 
Seat 2: Rocky6434 ($68.29 in chips) 
Seat 3: hammerwife ($126.55 in chips) 
Seat 4: matiko09 ($100 in chips) 
Seat 5: UnBent022 ($100 in chips) 
Seat 6: Igor DoUrden ($100 in chips) 
Seat 7: PacPacBum ($102.50 in chips) 
Seat 8: Sweden_Pound ($100 in chips) 
Igor DoUrden: posts small blind $0.50
PacPacBum: posts big blind $1
er13to: sits out 
*** HOLE CARDS ***
Dealt to matiko09 [9c 3c]
Sweden_Pound: folds 
blackw0lf_03: folds 
Rocky6434: folds 
hammerwife: raises $1.50 to $2.50
matiko09: folds 
UnBent022: folds 
Igor DoUrden: folds 
PacPacBum: calls $1.50
*** FLOP *** [Th 7c Js]
PacPacBum: checks 
hammerwife: checks 
*** TURN *** [Th 7c Js] [5h]
PacPacBum: bets $3.62
hammerwife: calls $3.62
*** RIVER *** [Th 7c Js 5h] [9s]
PacPacBum: bets $16
hammerwife: folds 
Uncalled bet ($16) returned to PacPacBum
PacPacBum collected $12.17 from pot
PacPacBum: doesn't show hand 
*** SUMMARY ***
Total pot $12.74 | Rake $0.57 
Board [Th 7c Js 5h 9s]
Seat 1: blackw0lf_03 folded before Flop (didn't bet)
Seat 2: Rocky6434 folded before Flop (didn't bet)
Seat 3: hammerwife folded on the River
Seat 4: matiko09 folded before Flop (didn't bet)
Seat 5: UnBent022 (button) folded before Flop (didn't bet)
Seat 6: Igor DoUrden (small blind) folded before Flop
Seat 7: PacPacBum (big blind) collected ($12.17)
Seat 8: Sweden_Pound folded before Flop (didn't bet)





PokerStars Hand #150125940380:  Hold'em No Limit ($0.50/$1.00 USD) - 2016/03/10 13:22:30 CET [2016/03/10 7:22:30 ET]
Table 'Virgo II' 9-max Seat #6 is the button
Seat 1: cdv1984 ($191.05 in chips) 
Seat 2: Plz3betMe ($51.77 in chips) 
Seat 4: UnBent022 ($101.25 in chips) 
Seat 5: stds st ($41.79 in chips) 
Seat 6: PacPacBum ($109.89 in chips) 
Seat 7: mamilets ($70.14 in chips) 
Seat 8: Sweden_Pound ($127.81 in chips) 
Seat 9: matiko09 ($100 in chips) 
mamilets: posts small blind $0.50
Sweden_Pound: posts big blind $1
blackw0lf_03: sits out 
*** HOLE CARDS ***
Dealt to matiko09 [Jh 2d]
matiko09: folds 
cdv1984: folds 
Plz3betMe: folds 
UnBent022: folds 
stds st: folds 
PacPacBum: folds 
mamilets: folds 
Uncalled bet ($0.50) returned to Sweden_Pound
Sweden_Pound collected $1 from pot
Sweden_Pound: doesn't show hand 
*** SUMMARY ***
Total pot $1 | Rake $0 
Seat 1: cdv1984 folded before Flop (didn't bet)
Seat 2: Plz3betMe folded before Flop (didn't bet)
Seat 4: UnBent022 folded before Flop (didn't bet)
Seat 5: stds st folded before Flop (didn't bet)
Seat 6: PacPacBum (button) folded before Flop (didn't bet)
Seat 7: mamilets (small blind) folded before Flop
Seat 8: Sweden_Pound (big blind) collected ($1)
Seat 9: matiko09 folded before Flop (didn't bet)





PokerStars Hand #150125943236:  Hold'em No Limit (€1/€2 EUR) - 2016/03/10 13:22:36 CET [2016/03/10 7:22:36 ET]
Table 'Sigrid II' 9-max Seat #8 is the button
Seat 1: Gamz11 (€244.50 in chips) 
Seat 5: vr188 (€85.63 in chips) 
Seat 7: PacPacBum (€200 in chips) 
Seat 8: matiko09 (€200 in chips) 
Gamz11: posts small blind €1
vr188: posts big blind €2
azzad2007: sits out 
*** HOLE CARDS ***
Dealt to matiko09 [3c 8s]
PacPacBum: raises €2.08 to €4.08
matiko09: folds 
Gamz11: folds 
vr188: folds 
Uncalled bet (€2.08) returned to PacPacBum
PacPacBum collected €5 from pot
PacPacBum: doesn't show hand 
*** SUMMARY ***
Total pot €5 | Rake €0 
Seat 1: Gamz11 (small blind) folded before Flop
Seat 5: vr188 (big blind) folded before Flop
Seat 7: PacPacBum collected (€5)
Seat 8: matiko09 (button) folded before Flop (didn't bet)





PokerStars Hand #150125947780:  Hold'em No Limit ($0.50/$1.00 USD) - 2016/03/10 13:22:44 CET [2016/03/10 7:22:44 ET]
Table 'Mars III' 9-max Seat #3 is the button
Seat 1: blackw0lf_03 ($111.12 in chips) 
Seat 2: pokixy800 ($65.10 in chips) 
Seat 3: PacPacBum ($108.98 in chips) 
Seat 4: Igor DoUrden ($118.91 in chips) 
Seat 5: ilaviiitech ($119.74 in chips) 
Seat 6: matiko09 ($101.85 in chips) 
Seat 7: Sweden_Pound ($100 in chips) 
Seat 8: Dennie Denc ($78.96 in chips) 
Seat 9: er13to ($100 in chips) 
Igor DoUrden: posts small blind $0.50
ilaviiitech: posts big blind $1
*** HOLE CARDS ***
Dealt to matiko09 [9s As]
matiko09: folds 
Sweden_Pound: folds 
Dennie Denc: folds 
Dennie Denc leaves the table
er13to: folds 
blackw0lf_03: folds 
pokixy800: folds 
PacPacBum: folds 
Igor DoUrden: folds 
Uncalled bet ($0.50) returned to ilaviiitech
ilaviiitech collected $1 from pot
ilaviiitech: doesn't show hand 
*** SUMMARY ***
Total pot $1 | Rake $0 
Seat 1: blackw0lf_03 folded before Flop (didn't bet)
Seat 2: pokixy800 folded before Flop (didn't bet)
Seat 3: PacPacBum (button) folded before Flop (didn't bet)
Seat 4: Igor DoUrden (small blind) folded before Flop
Seat 5: ilaviiitech (big blind) collected ($1)
Seat 6: matiko09 folded before Flop (didn't bet)
Seat 7: Sweden_Pound folded before Flop (didn't bet)
Seat 8: Dennie Denc folded before Flop (didn't bet)
Seat 9: er13to folded before Flop (didn't bet)





PokerStars Hand #150125948416:  Hold'em No Limit ($0.50/$1.00 USD) - 2016/03/10 13:22:45 CET [2016/03/10 7:22:45 ET]
Table 'Saskia' 9-max Seat #8 is the button
Seat 1: Sweden_Pound ($111.51 in chips) 
Seat 2: njurg aga ($76.95 in chips) 
Seat 3: ccmaster001 ($74.14 in chips) 
Seat 4: Plz3betMe ($90.72 in chips) 
Seat 5: dreded11 ($92.16 in chips) 
Seat 6: matiko09 ($105.38 in chips) 
Seat 7: stds st ($31.85 in chips) 
Seat 8: blackw0lf_03 ($107.20 in chips) 
Seat 9: er13to ($117.47 in chips) 
er13to: posts small blind $0.50
Sweden_Pound: posts big blind $1
*** HOLE CARDS ***
Dealt to matiko09 [8s Ts]
njurg aga: folds 
ccmaster001: folds 
Plz3betMe: folds 
dreded11: folds 
matiko09: folds 
stds st: folds 
blackw0lf_03: raises $1 to $2
er13to: folds 
Sweden_Pound: folds 
Uncalled bet ($1) returned to blackw0lf_03
blackw0lf_03 collected $2.50 from pot
blackw0lf_03: doesn't show hand 
*** SUMMARY ***
Total pot $2.50 | Rake $0 
Seat 1: Sweden_Pound (big blind) folded before Flop
Seat 2: njurg aga folded before Flop (didn't bet)
Seat 3: ccmaster001 folded before Flop (didn't bet)
Seat 4: Plz3betMe folded before Flop (didn't bet)
Seat 5: dreded11 folded before Flop (didn't bet)
Seat 6: matiko09 folded before Flop (didn't bet)
Seat 7: stds st folded before Flop (didn't bet)
Seat 8: blackw0lf_03 (button) collected ($2.50)
Seat 9: er13to (small blind) folded before Flop





PokerStars Hand #150125948350:  Hold'em No Limit (€1/€2 EUR) - 2016/03/10 13:22:45 CET [2016/03/10 7:22:45 ET]
Table 'Sigrid II' 9-max Seat #1 is the button
Seat 1: Gamz11 (€243.50 in chips) 
Seat 5: vr188 (€83.63 in chips) 
Seat 6: azzad2007 (€200 in chips) 
Seat 7: PacPacBum (€203 in chips) 
Seat 8: matiko09 (€200 in chips) 
vr188: posts small blind €1
azzad2007: posts big blind €2
*** HOLE CARDS ***
Dealt to matiko09 [3h 9h]
PacPacBum: folds 
matiko09: folds 
Gamz11: raises €2.92 to €4.92
vr188: folds 
azzad2007: folds 
Uncalled bet (€2.92) returned to Gamz11
Gamz11 collected €5 from pot
*** SUMMARY ***
Total pot €5 | Rake €0 
Seat 1: Gamz11 (button) collected (€5)
Seat 5: vr188 (small blind) folded before Flop
Seat 6: azzad2007 (big blind) folded before Flop
Seat 7: PacPacBum folded before Flop (didn't bet)
Seat 8: matiko09 folded before Flop (didn't bet)





PokerStars Hand #150125951548:  Hold'em No Limit ($0.50/$1.00 USD) - 2016/03/10 13:22:52 CET [2016/03/10 7:22:52 ET]
Table 'Leuschneria II' 9-max Seat #1 is the button
Seat 1: cdv1984 ($172.71 in chips) 
Seat 2: blackw0lf_03 ($100.71 in chips) 
Seat 3: gudridornot ($63.38 in chips) 
Seat 4: Sweden_Pound ($145.22 in chips) 
Seat 5: RMilPoker ($108.46 in chips) 
Seat 6: matiko09 ($113.89 in chips) 
Seat 7: Plz3betMe ($44.17 in chips) 
Seat 9: Katsulion ($126.41 in chips) 
blackw0lf_03: posts small blind $0.50
gudridornot: posts big blind $1
UnBent022: sits out 
*** HOLE CARDS ***
Dealt to matiko09 [5d Ad]
Sweden_Pound: folds 
RMilPoker: folds 
matiko09: raises $2 to $3
Plz3betMe: folds 
Katsulion: folds 
cdv1984: folds 
blackw0lf_03: folds 
gudridornot: calls $2
*** FLOP *** [3c Td Tc]
gudridornot: checks 
matiko09: bets $4.04
gudridornot: folds 
Uncalled bet ($4.04) returned to matiko09
matiko09 collected $6.21 from pot
matiko09: doesn't show hand 
*** SUMMARY ***
Total pot $6.50 | Rake $0.29 
Board [3c Td Tc]
Seat 1: cdv1984 (button) folded before Flop (didn't bet)
Seat 2: blackw0lf_03 (small blind) folded before Flop
Seat 3: gudridornot (big blind) folded on the Flop
Seat 4: Sweden_Pound folded before Flop (didn't bet)
Seat 5: RMilPoker folded before Flop (didn't bet)
Seat 6: matiko09 collected ($6.21)
Seat 7: Plz3betMe folded before Flop (didn't bet)
Seat 9: Katsulion folded before Flop (didn't bet)





PokerStars Hand #150125960017:  Hold'em No Limit ($0.50/$1.00 USD) - 2016/03/10 13:23:08 CET [2016/03/10 7:23:08 ET]
Table 'Liriope II' 9-max Seat #5 is the button
Seat 1: di0d80 ($132.91 in chips) 
Seat 2: zxp12345 ($31.60 in chips) 
Seat 3: matiko09 ($163.43 in chips) 
Seat 4: Plz3betMe ($47.43 in chips) 
Seat 5: lumen21 ($100 in chips) 
Seat 6: nobu-azabu ($184.35 in chips) 
Seat 7: Sweden_Pound ($100 in chips) 
Seat 8: PacPacBum ($116.21 in chips) 
Seat 9: tipner ($107.05 in chips) 
nobu-azabu: posts small blind $0.50
Sweden_Pound: posts big blind $1
*** HOLE CARDS ***
Dealt to matiko09 [Qs Ac]
PacPacBum: folds 
tipner: folds 
di0d80: folds 
zxp12345: calls $1
matiko09: raises $3 to $4
Plz3betMe: folds 
lumen21: folds 
nobu-azabu: folds 
Sweden_Pound: folds 
zxp12345: folds 
Uncalled bet ($3) returned to matiko09
matiko09 collected $3.50 from pot
matiko09: doesn't show hand 
*** SUMMARY ***
Total pot $3.50 | Rake $0 
Seat 1: di0d80 folded before Flop (didn't bet)
Seat 2: zxp12345 folded before Flop
Seat 3: matiko09 collected ($3.50)
Seat 4: Plz3betMe folded before Flop (didn't bet)
Seat 5: lumen21 (button) folded before Flop (didn't bet)
Seat 6: nobu-azabu (small blind) folded before Flop
Seat 7: Sweden_Pound (big blind) folded before Flop
Seat 8: PacPacBum folded before Flop (didn't bet)
Seat 9: tipner folded before Flop (didn't bet)





PokerStars Hand #150125960432:  Hold'em No Limit ($0.50/$1.00 USD) - 2016/03/10 13:23:09 CET [2016/03/10 7:23:09 ET]
Table 'Virgo II' 9-max Seat #7 is the button
Seat 1: cdv1984 ($191.05 in chips) 
Seat 2: Plz3betMe ($51.77 in chips) 
Seat 4: UnBent022 ($101.25 in chips) 
Seat 5: stds st ($41.79 in chips) 
Seat 6: PacPacBum ($109.89 in chips) 
Seat 7: mamilets ($69.64 in chips) 
Seat 8: Sweden_Pound ($128.31 in chips) 
Seat 9: matiko09 ($100 in chips) 
Sweden_Pound: posts small blind $0.50
matiko09: posts big blind $1
blackw0lf_03: sits out 
*** HOLE CARDS ***
Dealt to matiko09 [As 7c]
cdv1984: folds 
Plz3betMe: folds 
UnBent022: folds 
stds st: folds 
PacPacBum: folds 
mamilets: calls $1
Sweden_Pound: raises $4 to $5
matiko09: folds 
mamilets: calls $4
*** FLOP *** [Kd 4h 7h]
Sweden_Pound: bets $6.82
mamilets: folds 
Uncalled bet ($6.82) returned to Sweden_Pound
Sweden_Pound collected $10.50 from pot
Sweden_Pound: doesn't show hand 
*** SUMMARY ***
Total pot $11 | Rake $0.50 
Board [Kd 4h 7h]
Seat 1: cdv1984 folded before Flop (didn't bet)
Seat 2: Plz3betMe folded before Flop (didn't bet)
Seat 4: UnBent022 folded before Flop (didn't bet)
Seat 5: stds st folded before Flop (didn't bet)
Seat 6: PacPacBum folded before Flop (didn't bet)
Seat 7: mamilets (button) folded on the Flop
Seat 8: Sweden_Pound (small blind) collected ($10.50)
Seat 9: matiko09 (big blind) folded before Flop





PokerStars Hand #150125961649:  Hold'em No Limit ($0.50/$1.00 USD) - 2016/03/10 13:23:11 CET [2016/03/10 7:23:11 ET]
Table 'Saskia' 9-max Seat #9 is the button
Seat 1: Sweden_Pound ($110.51 in chips) 
Seat 2: njurg aga ($76.95 in chips) 
Seat 3: ccmaster001 ($74.14 in chips) 
Seat 4: Plz3betMe ($90.72 in chips) 
Seat 5: dreded11 ($92.16 in chips) 
Seat 6: matiko09 ($105.38 in chips) 
Seat 7: stds st ($31.85 in chips) 
Seat 8: blackw0lf_03 ($108.70 in chips) 
Seat 9: er13to ($116.97 in chips) 
Sweden_Pound: posts small blind $0.50
njurg aga: posts big blind $1
*** HOLE CARDS ***
Dealt to matiko09 [9d 3h]
ccmaster001: folds 
Plz3betMe: folds 
dreded11: folds 
matiko09: folds 
stds st: folds 
blackw0lf_03: folds 
er13to: folds 
Sweden_Pound: raises $2 to $3
njurg aga: folds 
Uncalled bet ($2) returned to Sweden_Pound
Sweden_Pound collected $2 from pot
Sweden_Pound: doesn't show hand 
*** SUMMARY ***
Total pot $2 | Rake $0 
Seat 1: Sweden_Pound (small blind) collected ($2)
Seat 2: njurg aga (big blind) folded before Flop
Seat 3: ccmaster001 folded before Flop (didn't bet)
Seat 4: Plz3betMe folded before Flop (didn't bet)
Seat 5: dreded11 folded before Flop (didn't bet)
Seat 6: matiko09 folded before Flop (didn't bet)
Seat 7: stds st folded before Flop (didn't bet)
Seat 8: blackw0lf_03 folded before Flop (didn't bet)
Seat 9: er13to (button) folded before Flop (didn't bet)





PokerStars Hand #150125963463:  Hold'em No Limit ($0.50/$1.00 USD) - 2016/03/10 13:23:14 CET [2016/03/10 7:23:14 ET]
Table 'Mars III' 9-max Seat #4 is the button
Seat 1: blackw0lf_03 ($111.12 in chips) 
Seat 2: pokixy800 ($65.10 in chips) 
Seat 3: PacPacBum ($108.98 in chips) 
Seat 4: Igor DoUrden ($118.41 in chips) 
Seat 5: ilaviiitech ($120.24 in chips) 
Seat 6: matiko09 ($101.85 in chips) 
Seat 7: Sweden_Pound ($100 in chips) 
Seat 9: er13to ($100 in chips) 
ilaviiitech: posts small blind $0.50
matiko09: posts big blind $1
*** HOLE CARDS ***
Dealt to matiko09 [4h 5d]
Sweden_Pound: folds 
er13to: raises $2 to $3
blackw0lf_03: folds 
pokixy800: folds 
PacPacBum: folds 
Igor DoUrden: folds 
ilaviiitech: folds 
matiko09: folds 
Uncalled bet ($2) returned to er13to
er13to collected $2.50 from pot
*** SUMMARY ***
Total pot $2.50 | Rake $0 
Seat 1: blackw0lf_03 folded before Flop (didn't bet)
Seat 2: pokixy800 folded before Flop (didn't bet)
Seat 3: PacPacBum folded before Flop (didn't bet)
Seat 4: Igor DoUrden (button) folded before Flop (didn't bet)
Seat 5: ilaviiitech (small blind) folded before Flop
Seat 6: matiko09 (big blind) folded before Flop
Seat 7: Sweden_Pound folded before Flop (didn't bet)
Seat 9: er13to collected ($2.50)





PokerStars Hand #150125963590:  Hold'em No Limit (€0.50/€1.00 EUR) - 2016/03/10 13:23:15 CET [2016/03/10 7:23:15 ET]
Table 'Claudia' 9-max Seat #2 is the button
Seat 1: matiko09 (€127.77 in chips) 
Seat 2: er13to (€100 in chips) 
Seat 3: full-deck699 (€65.88 in chips) 
Seat 4: Sweden_Pound (€100 in chips) 
Seat 5: Spid1 (€107.80 in chips) 
Seat 6: di0d80 (€101.73 in chips) 
Seat 7: tipner (€115.77 in chips) 
Seat 8: UnBent022 (€100 in chips) 
Seat 9: blackw0lf_03 (€100 in chips) 
full-deck699: posts small blind €0.50
Sweden_Pound: posts big blind €1
*** HOLE CARDS ***
Dealt to matiko09 [Ac Ad]
Spid1: folds 
di0d80: folds 
tipner: folds 
UnBent022: folds 
blackw0lf_03: folds 
matiko09: raises €1.50 to €2.50
er13to: folds 
full-deck699: calls €2
Sweden_Pound: folds 
*** FLOP *** [6s 6h 8c]
full-deck699: checks 
matiko09: checks 
*** TURN *** [6s 6h 8c] [Qh]
full-deck699: bets €5.73
matiko09: calls €5.73
*** RIVER *** [6s 6h 8c Qh] [6c]
full-deck699: bets €16.67
matiko09: raises €41.33 to €58
full-deck699: calls €40.98 and is all-in
Uncalled bet (€0.35) returned to matiko09
*** SHOW DOWN ***
matiko09: shows [Ac Ad] (a full house, Sixes full of Aces)
full-deck699: mucks hand 
matiko09 collected €130.61 from pot
*** SUMMARY ***
Total pot €132.76 | Rake €2.15 
Board [6s 6h 8c Qh 6c]
Seat 1: matiko09 showed [Ac Ad] and won (€130.61) with a full house, Sixes full of Aces
Seat 2: er13to (button) folded before Flop (didn't bet)
Seat 3: full-deck699 (small blind) mucked [Qc Th]
Seat 4: Sweden_Pound (big blind) folded before Flop
Seat 5: Spid1 folded before Flop (didn't bet)
Seat 6: di0d80 folded before Flop (didn't bet)
Seat 7: tipner folded before Flop (didn't bet)
Seat 8: UnBent022 folded before Flop (didn't bet)
Seat 9: blackw0lf_03 folded before Flop (didn't bet)





PokerStars Hand #150125964091:  Hold'em No Limit (€1/€2 EUR) - 2016/03/10 13:23:16 CET [2016/03/10 7:23:16 ET]
Table 'Sigrid II' 9-max Seat #5 is the button
Seat 1: Gamz11 (€246.50 in chips) 
Seat 5: vr188 (€82.63 in chips) 
Seat 6: azzad2007 (€200 in chips) 
Seat 7: PacPacBum (€203 in chips) 
Seat 8: matiko09 (€200 in chips) 
azzad2007: posts small blind €1
PacPacBum: posts big blind €2
*** HOLE CARDS ***
Dealt to matiko09 [3d 8d]
matiko09: folds 
Gamz11: folds 
vr188: folds 
azzad2007: raises €4 to €6
PacPacBum: folds 
Uncalled bet (€4) returned to azzad2007
azzad2007 collected €4 from pot
azzad2007: doesn't show hand 
*** SUMMARY ***
Total pot €4 | Rake €0 
Seat 1: Gamz11 folded before Flop (didn't bet)
Seat 5: vr188 (button) folded before Flop (didn't bet)
Seat 6: azzad2007 (small blind) collected (€4)
Seat 7: PacPacBum (big blind) folded before Flop
Seat 8: matiko09 folded before Flop (didn't bet)





PokerStars Hand #150125971673:  Hold'em No Limit ($0.50/$1.00 USD) - 2016/03/10 13:23:30 CET [2016/03/10 7:23:30 ET]
Table 'Leuschneria II' 9-max Seat #2 is the button
Seat 1: cdv1984 ($172.71 in chips) 
Seat 2: blackw0lf_03 ($100.21 in chips) 
Seat 3: gudridornot ($60.38 in chips) 
Seat 4: Sweden_Pound ($145.22 in chips) 
Seat 5: RMilPoker ($108.46 in chips) 
Seat 6: matiko09 ($117.10 in chips) 
Seat 7: Plz3betMe ($44.17 in chips) 
Seat 9: Katsulion ($126.41 in chips) 
gudridornot: posts small blind $0.50
Sweden_Pound: posts big blind $1
UnBent022: sits out 
*** HOLE CARDS ***
Dealt to matiko09 [Jc 3s]
RMilPoker: folds 
matiko09: folds 
Plz3betMe: folds 
Katsulion: raises $1 to $2
cdv1984: folds 
blackw0lf_03: calls $2
gudridornot: raises $10 to $12
Sweden_Pound: folds 
Katsulion: folds 
blackw0lf_03: folds 
Uncalled bet ($10) returned to gudridornot
gudridornot collected $7 from pot
gudridornot: doesn't show hand 
*** SUMMARY ***
Total pot $7 | Rake $0 
Seat 1: cdv1984 folded before Flop (didn't bet)
Seat 2: blackw0lf_03 (button) folded before Flop
Seat 3: gudridornot (small blind) collected ($7)
Seat 4: Sweden_Pound (big blind) folded before Flop
Seat 5: RMilPoker folded before Flop (didn't bet)
Seat 6: matiko09 folded before Flop (didn't bet)
Seat 7: Plz3betMe folded before Flop (didn't bet)
Seat 9: Katsulion folded before Flop





PokerStars Hand #150125972393:  Hold'em No Limit (€1/€2 EUR) - 2016/03/10 13:23:32 CET [2016/03/10 7:23:32 ET]
Table 'Sigrid II' 9-max Seat #6 is the button
Seat 1: Gamz11 (€246.50 in chips) 
Seat 5: vr188 (€82.63 in chips) 
Seat 6: azzad2007 (€202 in chips) 
Seat 7: PacPacBum (€201 in chips) 
Seat 8: matiko09 (€200 in chips) 
PacPacBum: posts small blind €1
matiko09: posts big blind €2
*** HOLE CARDS ***
Dealt to matiko09 [Ks Jd]
Gamz11: folds 
vr188: folds 
azzad2007: folds 
PacPacBum: raises €2.08 to €4.08
matiko09: calls €2.08
*** FLOP *** [Jc 2c 5h]
ki11u joins the table at seat #9 
PacPacBum: checks 
Fish4trips joins the table at seat #4 
matiko09: bets €5.06
stds st joins the table at seat #2 
PacPacBum: folds 
Uncalled bet (€5.06) returned to matiko09
matiko09 collected €7.79 from pot
matiko09: doesn't show hand 
*** SUMMARY ***
Total pot €8.16 | Rake €0.37 
Board [Jc 2c 5h]
Seat 1: Gamz11 folded before Flop (didn't bet)
Seat 5: vr188 folded before Flop (didn't bet)
Seat 6: azzad2007 (button) folded before Flop (didn't bet)
Seat 7: PacPacBum (small blind) folded on the Flop
Seat 8: matiko09 (big blind) collected (€7.79)





PokerStars Hand #150125973337:  Hold'em No Limit ($0.50/$1.00 USD) - 2016/03/10 13:23:33 CET [2016/03/10 7:23:33 ET]
Table 'Saskia' 9-max Seat #1 is the button
Seat 1: Sweden_Pound ($111.51 in chips) 
Seat 2: njurg aga ($75.95 in chips) 
Seat 3: ccmaster001 ($74.14 in chips) 
Seat 4: Plz3betMe ($90.72 in chips) 
Seat 5: dreded11 ($92.16 in chips) 
Seat 6: matiko09 ($105.38 in chips) 
Seat 7: stds st ($31.85 in chips) 
Seat 8: blackw0lf_03 ($108.70 in chips) 
Seat 9: er13to ($116.97 in chips) 
njurg aga: posts small blind $0.50
ccmaster001: posts big blind $1
*** HOLE CARDS ***
Dealt to matiko09 [9s 9c]
Plz3betMe: folds 
dreded11: folds 
matiko09: raises $2 to $3
stds st: folds 
blackw0lf_03: folds 
er13to: folds 
Sweden_Pound: folds 
njurg aga: folds 
ccmaster001: folds 
Uncalled bet ($2) returned to matiko09
matiko09 collected $2.50 from pot
matiko09: doesn't show hand 
*** SUMMARY ***
Total pot $2.50 | Rake $0 
Seat 1: Sweden_Pound (button) folded before Flop (didn't bet)
Seat 2: njurg aga (small blind) folded before Flop
Seat 3: ccmaster001 (big blind) folded before Flop
Seat 4: Plz3betMe folded before Flop (didn't bet)
Seat 5: dreded11 folded before Flop (didn't bet)
Seat 6: matiko09 collected ($2.50)
Seat 7: stds st folded before Flop (didn't bet)
Seat 8: blackw0lf_03 folded before Flop (didn't bet)
Seat 9: er13to folded before Flop (didn't bet)





PokerStars Hand #150125980821:  Hold'em No Limit ($0.50/$1.00 USD) - 2016/03/10 13:23:48 CET [2016/03/10 7:23:48 ET]
Table 'Iguassu' 9-max Seat #6 is the button
Seat 1: blackw0lf_03 ($103 in chips) 
Seat 2: Rocky6434 ($68.29 in chips) 
Seat 3: hammerwife ($120.43 in chips) 
Seat 4: matiko09 ($100 in chips) 
Seat 5: UnBent022 ($100 in chips) 
Seat 6: Igor DoUrden ($100 in chips) 
Seat 7: PacPacBum ($108.55 in chips) 
Seat 8: Sweden_Pound ($100 in chips) 
PacPacBum: posts small blind $0.50
Sweden_Pound: posts big blind $1
er13to: sits out 
*** HOLE CARDS ***
Dealt to matiko09 [9s 6c]
blackw0lf_03: folds 
Rocky6434: raises $1 to $2
hammerwife: folds 
matiko09: folds 
UnBent022: folds 
Igor DoUrden: folds 
PacPacBum: folds 
Sweden_Pound: folds 
Uncalled bet ($1) returned to Rocky6434
Rocky6434 collected $2.50 from pot
Rocky6434: doesn't show hand 
*** SUMMARY ***
Total pot $2.50 | Rake $0 
Seat 1: blackw0lf_03 folded before Flop (didn't bet)
Seat 2: Rocky6434 collected ($2.50)
Seat 3: hammerwife folded before Flop (didn't bet)
Seat 4: matiko09 folded before Flop (didn't bet)
Seat 5: UnBent022 folded before Flop (didn't bet)
Seat 6: Igor DoUrden (button) folded before Flop (didn't bet)
Seat 7: PacPacBum (small blind) folded before Flop
Seat 8: Sweden_Pound (big blind) folded before Flop





PokerStars Hand #150125981475:  Hold'em No Limit ($0.50/$1.00 USD) - 2016/03/10 13:23:49 CET [2016/03/10 7:23:49 ET]
Table 'Liriope II' 9-max Seat #6 is the button
Seat 1: di0d80 ($132.91 in chips) 
Seat 2: zxp12345 ($30.60 in chips) 
Seat 3: matiko09 ($165.93 in chips) 
Seat 4: Plz3betMe ($47.43 in chips) 
Seat 5: lumen21 ($100 in chips) 
Seat 6: nobu-azabu ($183.85 in chips) 
Seat 7: Sweden_Pound ($100 in chips) 
Seat 8: PacPacBum ($116.21 in chips) 
Seat 9: tipner ($107.05 in chips) 
Sweden_Pound: posts small blind $0.50
PacPacBum: posts big blind $1
*** HOLE CARDS ***
Dealt to matiko09 [Jc Js]
tipner: folds 
di0d80: folds 
zxp12345: folds 
matiko09: raises $2 to $3
Plz3betMe: folds 
lumen21: folds 
nobu-azabu: folds 
Sweden_Pound: folds 
PacPacBum: folds 
Uncalled bet ($2) returned to matiko09
matiko09 collected $2.50 from pot
matiko09: doesn't show hand 
*** SUMMARY ***
Total pot $2.50 | Rake $0 
Seat 1: di0d80 folded before Flop (didn't bet)
Seat 2: zxp12345 folded before Flop (didn't bet)
Seat 3: matiko09 collected ($2.50)
Seat 4: Plz3betMe folded before Flop (didn't bet)
Seat 5: lumen21 folded before Flop (didn't bet)
Seat 6: nobu-azabu (button) folded before Flop (didn't bet)
Seat 7: Sweden_Pound (small blind) folded before Flop
Seat 8: PacPacBum (big blind) folded before Flop
Seat 9: tipner folded before Flop (didn't bet)





PokerStars Hand #150125987026:  Hold'em No Limit ($0.25/$0.50 USD) - 2016/03/10 13:24:00 CET [2016/03/10 7:24:00 ET]
Table 'Aegina' 9-max Seat #6 is the button
Seat 1: BingoIng0 ($118.35 in chips) 
Seat 2: dvutavr ($111.53 in chips) 
Seat 4: digimatical ($77.46 in chips) 
Seat 5: Ahangama ($50.10 in chips) 
Seat 6: matiko09 ($50 in chips) 
Seat 7: Gummio ($107.16 in chips) 
Seat 8: ardo888 ($183.44 in chips) 
Gummio: posts small blind $0.25
ardo888: posts big blind $0.50
draken08: sits out 
Fandango1991: sits out 
BingoIng0: posts the ante $0.10
dvutavr: posts the ante $0.10
digimatical: posts the ante $0.10
Ahangama: posts the ante $0.10
matiko09: posts the ante $0.10
Gummio: posts the ante $0.10
ardo888: posts the ante $0.10
*** HOLE CARDS ***
Dealt to matiko09 [Ah 5s]
BingoIng0: folds 
dvutavr: folds 
digimatical: folds 
Ahangama: raises $0.75 to $1.25
matiko09: folds 
Gummio: folds 
ardo888: folds 
Uncalled bet ($0.75) returned to Ahangama
Ahangama collected $1.95 from pot
Ahangama: doesn't show hand 
*** SUMMARY ***
Total pot $1.95 | Rake $0 
Seat 1: BingoIng0 folded before Flop (didn't bet)
Seat 2: dvutavr folded before Flop (didn't bet)
Seat 4: digimatical folded before Flop (didn't bet)
Seat 5: Ahangama collected ($1.95)
Seat 6: matiko09 (button) folded before Flop (didn't bet)
Seat 7: Gummio (small blind) folded before Flop
Seat 8: ardo888 (big blind) folded before Flop





PokerStars Hand #150125989462:  Hold'em No Limit (€1/€2 EUR) - 2016/03/10 13:24:04 CET [2016/03/10 7:24:04 ET]
Table 'Sigrid II' 9-max Seat #7 is the button
Seat 1: Gamz11 (€246.50 in chips) 
Seat 5: vr188 (€82.63 in chips) 
Seat 6: azzad2007 (€202 in chips) 
Seat 7: PacPacBum (€200 in chips) 
Seat 8: matiko09 (€203.71 in chips) 
Seat 9: ki11u (€200 in chips) 
matiko09: posts small blind €1
ki11u: posts big blind €2
stds st: sits out 
Fish4trips: sits out 
*** HOLE CARDS ***
Dealt to matiko09 [9c 5c]
Gamz11: folds 
vr188: folds 
azzad2007: folds 
PacPacBum: raises €2.08 to €4.08
matiko09: folds 
ki11u: folds 
Uncalled bet (€2.08) returned to PacPacBum
PacPacBum collected €5 from pot
PacPacBum: doesn't show hand 
*** SUMMARY ***
Total pot €5 | Rake €0 
Seat 1: Gamz11 folded before Flop (didn't bet)
Seat 5: vr188 folded before Flop (didn't bet)
Seat 6: azzad2007 folded before Flop (didn't bet)
Seat 7: PacPacBum (button) collected (€5)
Seat 8: matiko09 (small blind) folded before Flop
Seat 9: ki11u (big blind) folded before Flop





PokerStars Hand #150125991047:  Hold'em No Limit ($0.50/$1.00 USD) - 2016/03/10 13:24:07 CET [2016/03/10 7:24:07 ET]
Table 'Mars III' 9-max Seat #5 is the button
Seat 1: blackw0lf_03 ($111.12 in chips) 
Seat 2: pokixy800 ($65.10 in chips) 
Seat 3: PacPacBum ($108.98 in chips) 
Seat 4: Igor DoUrden ($118.41 in chips) 
Seat 5: ilaviiitech ($119.74 in chips) 
Seat 6: matiko09 ($100.85 in chips) 
Seat 7: Sweden_Pound ($100 in chips) 
Seat 9: er13to ($101.50 in chips) 
matiko09: posts small blind $0.50
Sweden_Pound: posts big blind $1
*** HOLE CARDS ***
Dealt to matiko09 [Js 5h]
Filojoes joins the table at seat #8 
er13to: folds 
blackw0lf_03: folds 
pokixy800: folds 
PacPacBum: folds 
Igor DoUrden: folds 
ilaviiitech: folds 
matiko09: folds 
Uncalled bet ($0.50) returned to Sweden_Pound
Sweden_Pound collected $1 from pot
Sweden_Pound: doesn't show hand 
*** SUMMARY ***
Total pot $1 | Rake $0 
Seat 1: blackw0lf_03 folded before Flop (didn't bet)
Seat 2: pokixy800 folded before Flop (didn't bet)
Seat 3: PacPacBum folded before Flop (didn't bet)
Seat 4: Igor DoUrden folded before Flop (didn't bet)
Seat 5: ilaviiitech (button) folded before Flop (didn't bet)
Seat 6: matiko09 (small blind) folded before Flop
Seat 7: Sweden_Pound (big blind) collected ($1)
Seat 9: er13to folded before Flop (didn't bet)





PokerStars Hand #150125993255:  Hold'em No Limit ($0.50/$1.00 USD) - 2016/03/10 13:24:11 CET [2016/03/10 7:24:11 ET]
Table 'Saskia' 9-max Seat #2 is the button
Seat 1: Sweden_Pound ($111.51 in chips) 
Seat 2: njurg aga ($75.45 in chips) 
Seat 3: ccmaster001 ($73.14 in chips) 
Seat 4: Plz3betMe ($90.72 in chips) 
Seat 5: dreded11 ($92.16 in chips) 
Seat 6: matiko09 ($106.88 in chips) 
Seat 7: stds st ($31.85 in chips) 
Seat 8: blackw0lf_03 ($108.70 in chips) 
Seat 9: er13to ($116.97 in chips) 
ccmaster001: posts small blind $0.50
Plz3betMe: posts big blind $1
*** HOLE CARDS ***
Dealt to matiko09 [Qd 4h]
dreded11: folds 
matiko09: folds 
stds st: raises $1.02 to $2.02
blackw0lf_03: raises $2.98 to $5
er13to: folds 
Sweden_Pound: folds 
njurg aga: folds 
ccmaster001: folds 
Plz3betMe: folds 
stds st: calls $2.98
*** FLOP *** [2s 6s 2c]
stds st: checks 
blackw0lf_03: bets $3.73
stds st: calls $3.73
*** TURN *** [2s 6s 2c] [Jd]
stds st: checks 
blackw0lf_03: checks 
*** RIVER *** [2s 6s 2c Jd] [Ah]
stds st: checks 
blackw0lf_03: bets $8.61
stds st: calls $8.61
*** SHOW DOWN ***
blackw0lf_03: shows [Qs Kc] (a pair of Deuces)
stds st: shows [As Qc] (two pair, Aces and Deuces)
stds st collected $34.55 from pot
*** SUMMARY ***
Total pot $36.18 | Rake $1.63 
Board [2s 6s 2c Jd Ah]
Seat 1: Sweden_Pound folded before Flop (didn't bet)
Seat 2: njurg aga (button) folded before Flop (didn't bet)
Seat 3: ccmaster001 (small blind) folded before Flop
Seat 4: Plz3betMe (big blind) folded before Flop
Seat 5: dreded11 folded before Flop (didn't bet)
Seat 6: matiko09 folded before Flop (didn't bet)
Seat 7: stds st showed [As Qc] and won ($34.55) with two pair, Aces and Deuces
Seat 8: blackw0lf_03 showed [Qs Kc] and lost with a pair of Deuces
Seat 9: er13to folded before Flop (didn't bet)





PokerStars Hand #150125994552:  Hold'em No Limit ($0.50/$1.00 USD) - 2016/03/10 13:24:14 CET [2016/03/10 7:24:14 ET]
Table 'Leuschneria II' 9-max Seat #3 is the button
Seat 1: cdv1984 ($172.71 in chips) 
Seat 2: blackw0lf_03 ($100 in chips) 
Seat 3: gudridornot ($65.38 in chips) 
Seat 4: Sweden_Pound ($144.22 in chips) 
Seat 5: RMilPoker ($108.46 in chips) 
Seat 6: matiko09 ($117.10 in chips) 
Seat 7: Plz3betMe ($44.17 in chips) 
Seat 9: Katsulion ($124.41 in chips) 
Sweden_Pound: posts small blind $0.50
RMilPoker: posts big blind $1
UnBent022: sits out 
*** HOLE CARDS ***
Dealt to matiko09 [Kc 7c]
matiko09: folds 
Plz3betMe: folds 
Katsulion: folds 
cdv1984: folds 
blackw0lf_03: raises $1 to $2
gudridornot: calls $2
Sweden_Pound: calls $1.50
RMilPoker: folds 
*** FLOP *** [Jc Ah 6s]
Sweden_Pound: checks 
blackw0lf_03: checks 
gudridornot: bets $4
Sweden_Pound: folds 
blackw0lf_03: calls $4
*** TURN *** [Jc Ah 6s] [Ac]
blackw0lf_03: checks 
gudridornot: bets $12
blackw0lf_03: folds 
Uncalled bet ($12) returned to gudridornot
gudridornot collected $14.32 from pot
gudridornot: doesn't show hand 
*** SUMMARY ***
Total pot $15 | Rake $0.68 
Board [Jc Ah 6s Ac]
Seat 1: cdv1984 folded before Flop (didn't bet)
Seat 2: blackw0lf_03 folded on the Turn
Seat 3: gudridornot (button) collected ($14.32)
Seat 4: Sweden_Pound (small blind) folded on the Flop
Seat 5: RMilPoker (big blind) folded before Flop
Seat 6: matiko09 folded before Flop (didn't bet)
Seat 7: Plz3betMe folded before Flop (didn't bet)
Seat 9: Katsulion folded before Flop (didn't bet)





PokerStars Hand #150125995475:  Hold'em No Limit ($1/$2 USD) - 2016/03/10 13:24:16 CET [2016/03/10 7:24:16 ET]
Table 'Tauris II' 9-max Seat #7 is the button
Seat 1: matiko09 ($200 in chips) 
Seat 2: stds st ($79 in chips) 
Seat 3: PacPacBum ($207.67 in chips) 
Seat 4: neomorf ($618.02 in chips) 
Seat 7: Fish4trips ($211.06 in chips) 
Seat 8: scout326 ($212.12 in chips) 
scout326: posts small blind $1
matiko09: posts big blind $2
uonlylive1ce: sits out 
*** HOLE CARDS ***
Dealt to matiko09 [6d 6h]
stds st: raises $2.04 to $4.04
PacPacBum: folds 
neomorf: folds 
Fish4trips: folds 
scout326: raises $10.08 to $14.12
matiko09: folds 
stds st: folds 
Uncalled bet ($10.08) returned to scout326
scout326 collected $10.08 from pot
*** SUMMARY ***
Total pot $10.08 | Rake $0 
Seat 1: matiko09 (big blind) folded before Flop
Seat 2: stds st folded before Flop
Seat 3: PacPacBum folded before Flop (didn't bet)
Seat 4: neomorf folded before Flop (didn't bet)
Seat 7: Fish4trips (button) folded before Flop (didn't bet)
Seat 8: scout326 (small blind) collected ($10.08)





PokerStars Hand #150125998869:  Hold'em No Limit ($0.50/$1.00 USD) - 2016/03/10 13:24:22 CET [2016/03/10 7:24:22 ET]
Table 'Virgo II' 9-max Seat #8 is the button
Seat 1: cdv1984 ($191.05 in chips) 
Seat 2: Plz3betMe ($51.77 in chips) 
Seat 4: UnBent022 ($101.25 in chips) 
Seat 5: stds st ($41.79 in chips) 
Seat 6: PacPacBum ($109.89 in chips) 
Seat 7: mamilets ($64.64 in chips) 
Seat 8: Sweden_Pound ($133.81 in chips) 
Seat 9: matiko09 ($100 in chips) 
matiko09: posts small blind $0.50
cdv1984: posts big blind $1
blackw0lf_03: sits out 
*** HOLE CARDS ***
Dealt to matiko09 [3s 8c]
Plz3betMe: folds 
UnBent022: folds 
stds st: raises $1.02 to $2.02
PacPacBum: folds 
mamilets: folds 
Sweden_Pound: raises $4.48 to $6.50
matiko09: folds 
cdv1984: folds 
stds st: folds 
Uncalled bet ($4.48) returned to Sweden_Pound
Sweden_Pound collected $5.54 from pot
Sweden_Pound: doesn't show hand 
*** SUMMARY ***
Total pot $5.54 | Rake $0 
Seat 1: cdv1984 (big blind) folded before Flop
Seat 2: Plz3betMe folded before Flop (didn't bet)
Seat 4: UnBent022 folded before Flop (didn't bet)
Seat 5: stds st folded before Flop
Seat 6: PacPacBum folded before Flop (didn't bet)
Seat 7: mamilets folded before Flop (didn't bet)
Seat 8: Sweden_Pound (button) collected ($5.54)
Seat 9: matiko09 (small blind) folded before Flop





PokerStars Hand #150126001113:  Hold'em No Limit (€1/€2 EUR) - 2016/03/10 13:24:27 CET [2016/03/10 7:24:27 ET]
Table 'Sigrid II' 9-max Seat #8 is the button
Seat 1: Gamz11 (€246.50 in chips) 
Seat 5: vr188 (€82.63 in chips) 
Seat 6: azzad2007 (€202 in chips) 
Seat 7: PacPacBum (€203 in chips) 
Seat 8: matiko09 (€202.71 in chips) 
Seat 9: ki11u (€200 in chips) 
ki11u: posts small blind €1
Gamz11: posts big blind €2
stds st: sits out 
Fish4trips: sits out 
*** HOLE CARDS ***
Dealt to matiko09 [4d 8h]
vr188: folds 
azzad2007: folds 
PacPacBum: folds 
matiko09: folds 
ki11u: raises €4 to €6
Gamz11: calls €4
*** FLOP *** [Kc 5h 7d]
ki11u: checks 
Gamz11: bets €6.76
ki11u: calls €6.76
*** TURN *** [Kc 5h 7d] [9d]
ki11u: checks 
Gamz11: bets €16.81
coinflip_si joins the table at seat #3 
coinflip_si leaves the table
ki11u: raises €33.19 to €50
Gamz11: folds 
Uncalled bet (€33.19) returned to ki11u
ki11u collected €56.99 from pot
ki11u: doesn't show hand 
*** SUMMARY ***
Total pot €59.14 | Rake €2.15 
Board [Kc 5h 7d 9d]
Seat 1: Gamz11 (big blind) folded on the Turn
Seat 5: vr188 folded before Flop (didn't bet)
Seat 6: azzad2007 folded before Flop (didn't bet)
Seat 7: PacPacBum folded before Flop (didn't bet)
Seat 8: matiko09 (button) folded before Flop (didn't bet)
Seat 9: ki11u (small blind) collected (€56.99)





PokerStars Hand #150126002983:  Hold'em No Limit ($0.50/$1.00 USD) - 2016/03/10 13:24:30 CET [2016/03/10 7:24:30 ET]
Table 'Iguassu' 9-max Seat #7 is the button
Seat 1: blackw0lf_03 ($103 in chips) 
Seat 2: Rocky6434 ($69.79 in chips) 
Seat 3: hammerwife ($120.43 in chips) 
Seat 4: matiko09 ($100 in chips) 
Seat 5: UnBent022 ($100 in chips) 
Seat 6: Igor DoUrden ($100 in chips) 
Seat 7: PacPacBum ($108.05 in chips) 
Seat 8: Sweden_Pound ($100 in chips) 
Seat 9: er13to ($100 in chips) 
Sweden_Pound: posts small blind $0.50
er13to: posts big blind $1
*** HOLE CARDS ***
Dealt to matiko09 [Tc Qc]
blackw0lf_03: folds 
Rocky6434: folds 
hammerwife: folds 
matiko09: raises $2 to $3
UnBent022: folds 
Igor DoUrden: folds 
PacPacBum: folds 
Sweden_Pound: folds 
er13to: folds 
Uncalled bet ($2) returned to matiko09
matiko09 collected $2.50 from pot
matiko09: doesn't show hand 
*** SUMMARY ***
Total pot $2.50 | Rake $0 
Seat 1: blackw0lf_03 folded before Flop (didn't bet)
Seat 2: Rocky6434 folded before Flop (didn't bet)
Seat 3: hammerwife folded before Flop (didn't bet)
Seat 4: matiko09 collected ($2.50)
Seat 5: UnBent022 folded before Flop (didn't bet)
Seat 6: Igor DoUrden folded before Flop (didn't bet)
Seat 7: PacPacBum (button) folded before Flop (didn't bet)
Seat 8: Sweden_Pound (small blind) folded before Flop
Seat 9: er13to (big blind) folded before Flop





PokerStars Hand #150126003679:  Hold'em No Limit ($1/$2 USD) - 2016/03/10 13:24:31 CET [2016/03/10 7:24:31 ET]
Table 'Chandra II' 9-max Seat #6 is the button
Seat 1: Fish4trips ($315.43 in chips) 
Seat 2: PacPacBum ($250.91 in chips) 
Seat 4: tipner ($200 in chips) 
Seat 5: uibting ($71.92 in chips) 
Seat 6: stds st ($59.98 in chips) 
Seat 7: johnvu2016 ($160.58 in chips) 
Seat 8: matiko09 ($200 in chips) 
Seat 9: o.miro ($235.78 in chips) 
johnvu2016: posts small blind $1
matiko09: posts big blind $2
*** HOLE CARDS ***
Dealt to matiko09 [3d Jc]
o.miro: folds 
Fish4trips: folds 
PacPacBum: raises $2.08 to $4.08
tipner: folds 
uibting: folds 
stds st: raises $6.32 to $10.40
johnvu2016: folds 
matiko09: folds 
PacPacBum: calls $6.32
*** FLOP *** [9c As Js]
PacPacBum: checks 
stds st: bets $11.36
PacPacBum: folds 
Uncalled bet ($11.36) returned to stds st
stds st collected $22.73 from pot
stds st: doesn't show hand 
*** SUMMARY ***
Total pot $23.80 | Rake $1.07 
Board [9c As Js]
Seat 1: Fish4trips folded before Flop (didn't bet)
Seat 2: PacPacBum folded on the Flop
Seat 4: tipner folded before Flop (didn't bet)
Seat 5: uibting folded before Flop (didn't bet)
Seat 6: stds st (button) collected ($22.73)
Seat 7: johnvu2016 (small blind) folded before Flop
Seat 8: matiko09 (big blind) folded before Flop
Seat 9: o.miro folded before Flop (didn't bet)





PokerStars Hand #150126003919:  Hold'em No Limit ($0.25/$0.50 USD) - 2016/03/10 13:24:32 CET [2016/03/10 7:24:32 ET]
Table 'Aegina' 9-max Seat #7 is the button
Seat 1: BingoIng0 ($118.25 in chips) 
Seat 2: dvutavr ($111.43 in chips) 
Seat 4: digimatical ($77.36 in chips) 
Seat 5: Ahangama ($51.45 in chips) 
Seat 6: matiko09 ($50 in chips) 
Seat 7: Gummio ($106.81 in chips) 
Seat 8: ardo888 ($182.84 in chips) 
Seat 9: draken08 ($125 in chips) 
ardo888: posts small blind $0.25
draken08: posts big blind $0.50
Fandango1991: sits out 
BingoIng0: posts the ante $0.10
dvutavr: posts the ante $0.10
digimatical: posts the ante $0.10
Ahangama: posts the ante $0.10
matiko09: posts the ante $0.10
Gummio: posts the ante $0.10
ardo888: posts the ante $0.10
draken08: posts the ante $0.10
*** HOLE CARDS ***
Dealt to matiko09 [Th 3c]
BingoIng0: folds 
dvutavr: folds 
digimatical: raises $1.76 to $2.26
Ahangama: folds 
matiko09: folds 
Gummio: folds 
ardo888: calls $2.01
draken08: folds 
*** FLOP *** [Kc Jh 8h]
ardo888: checks 
digimatical: bets $3
ardo888: raises $8.43 to $11.43
digimatical: folds 
Uncalled bet ($8.43) returned to ardo888
ardo888 collected $11.29 from pot
ardo888: doesn't show hand 
*** SUMMARY ***
Total pot $11.82 | Rake $0.53 
Board [Kc Jh 8h]
Seat 1: BingoIng0 folded before Flop (didn't bet)
Seat 2: dvutavr folded before Flop (didn't bet)
Seat 4: digimatical folded on the Flop
Seat 5: Ahangama folded before Flop (didn't bet)
Seat 6: matiko09 folded before Flop (didn't bet)
Seat 7: Gummio (button) folded before Flop (didn't bet)
Seat 8: ardo888 (small blind) collected ($11.29)
Seat 9: draken08 (big blind) folded before Flop





PokerStars Hand #150126005145:  Hold'em No Limit ($0.50/$1.00 USD) - 2016/03/10 13:24:34 CET [2016/03/10 7:24:34 ET]
Table 'Liriope II' 9-max Seat #7 is the button
Seat 1: di0d80 ($132.91 in chips) 
Seat 2: zxp12345 ($30.60 in chips) 
Seat 3: matiko09 ($167.43 in chips) 
Seat 4: Plz3betMe ($47.43 in chips) 
Seat 5: lumen21 ($100 in chips) 
Seat 6: nobu-azabu ($183.85 in chips) 
Seat 7: Sweden_Pound ($100 in chips) 
Seat 8: PacPacBum ($115.21 in chips) 
Seat 9: tipner ($107.05 in chips) 
PacPacBum: posts small blind $0.50
tipner: posts big blind $1
*** HOLE CARDS ***
Dealt to matiko09 [Ac Qh]
di0d80: folds 
zxp12345: folds 
matiko09: raises $2 to $3
Plz3betMe: folds 
lumen21: folds 
nobu-azabu: folds 
Sweden_Pound: folds 
PacPacBum: folds 
tipner: folds 
Uncalled bet ($2) returned to matiko09
matiko09 collected $2.50 from pot
matiko09: doesn't show hand 
*** SUMMARY ***
Total pot $2.50 | Rake $0 
Seat 1: di0d80 folded before Flop (didn't bet)
Seat 2: zxp12345 folded before Flop (didn't bet)
Seat 3: matiko09 collected ($2.50)
Seat 4: Plz3betMe folded before Flop (didn't bet)
Seat 5: lumen21 folded before Flop (didn't bet)
Seat 6: nobu-azabu folded before Flop (didn't bet)
Seat 7: Sweden_Pound (button) folded before Flop (didn't bet)
Seat 8: PacPacBum (small blind) folded before Flop
Seat 9: tipner (big blind) folded before Flop





PokerStars Hand #150126008125:  Hold'em No Limit ($0.50/$1.00 USD) - 2016/03/10 13:24:40 CET [2016/03/10 7:24:40 ET]
Table 'Mars III' 9-max Seat #6 is the button
Seat 1: blackw0lf_03 ($111.12 in chips) 
Seat 2: pokixy800 ($65.10 in chips) 
Seat 3: PacPacBum ($108.98 in chips) 
Seat 4: Igor DoUrden ($118.41 in chips) 
Seat 5: ilaviiitech ($119.74 in chips) 
Seat 6: matiko09 ($100.35 in chips) 
Seat 7: Sweden_Pound ($100.50 in chips) 
Seat 8: Filojoes ($100 in chips) 
Seat 9: er13to ($101.50 in chips) 
Sweden_Pound: posts small blind $0.50
Filojoes: posts big blind $1
*** HOLE CARDS ***
Dealt to matiko09 [8d 6d]
er13to: folds 
blackw0lf_03: folds 
pokixy800: folds 
PacPacBum: folds 
Igor DoUrden: folds 
ilaviiitech: folds 
matiko09: raises $1.27 to $2.27
Sweden_Pound: folds 
Filojoes: folds 
Uncalled bet ($1.27) returned to matiko09
matiko09 collected $2.50 from pot
matiko09: doesn't show hand 
*** SUMMARY ***
Total pot $2.50 | Rake $0 
Seat 1: blackw0lf_03 folded before Flop (didn't bet)
Seat 2: pokixy800 folded before Flop (didn't bet)
Seat 3: PacPacBum folded before Flop (didn't bet)
Seat 4: Igor DoUrden folded before Flop (didn't bet)
Seat 5: ilaviiitech folded before Flop (didn't bet)
Seat 6: matiko09 (button) collected ($2.50)
Seat 7: Sweden_Pound (small blind) folded before Flop
Seat 8: Filojoes (big blind) folded before Flop
Seat 9: er13to folded before Flop (didn't bet)





PokerStars Hand #150126008661:  Hold'em No Limit (€0.50/€1.00 EUR) - 2016/03/10 13:24:41 CET [2016/03/10 7:24:41 ET]
Table 'Claudia' 9-max Seat #4 is the button
Seat 1: matiko09 (€192.50 in chips) 
Seat 2: er13to (€100 in chips) 
Seat 4: Sweden_Pound (€100 in chips) 
Seat 5: Spid1 (€107.80 in chips) 
Seat 6: di0d80 (€101.73 in chips) 
Seat 7: tipner (€115.77 in chips) 
Seat 8: UnBent022 (€100 in chips) 
Seat 9: blackw0lf_03 (€100 in chips) 
Spid1: posts small blind €0.50
di0d80: posts big blind €1
*** HOLE CARDS ***
Dealt to matiko09 [5h Qd]
tipner: folds 
full-deck699 leaves the table
UnBent022: folds 
blackw0lf_03: folds 
matiko09: folds 
er13to: folds 
Sweden_Pound: raises €1 to €2
Spid1: raises €6 to €8
di0d80: folds 
Sweden_Pound: folds 
Uncalled bet (€6) returned to Spid1
Spid1 collected €5 from pot
Spid1: doesn't show hand 
*** SUMMARY ***
Total pot €5 | Rake €0 
Seat 1: matiko09 folded before Flop (didn't bet)
Seat 2: er13to folded before Flop (didn't bet)
Seat 4: Sweden_Pound (button) folded before Flop
Seat 5: Spid1 (small blind) collected (€5)
Seat 6: di0d80 (big blind) folded before Flop
Seat 7: tipner folded before Flop (didn't bet)
Seat 8: UnBent022 folded before Flop (didn't bet)
Seat 9: blackw0lf_03 folded before Flop (didn't bet)





PokerStars Hand #150126013594:  Hold'em No Limit ($1/$2 USD) - 2016/03/10 13:24:51 CET [2016/03/10 7:24:51 ET]
Table 'Tauris II' 9-max Seat #8 is the button
Seat 1: matiko09 ($200 in chips) 
Seat 2: stds st ($74.96 in chips) 
Seat 3: PacPacBum ($207.67 in chips) 
Seat 4: neomorf ($618.02 in chips) 
Seat 7: Fish4trips ($211.06 in chips) 
Seat 8: scout326 ($218.16 in chips) 
matiko09: posts small blind $1
stds st: posts big blind $2
uonlylive1ce: sits out 
*** HOLE CARDS ***
Dealt to matiko09 [Jh 8d]
PacPacBum: folds 
neomorf: raises $3.88 to $5.88
Fish4trips: folds 
scout326: calls $5.88
matiko09: folds 
stds st: folds 
*** FLOP *** [9h 6s Qc]
neomorf: checks 
scout326: checks 
*** TURN *** [9h 6s Qc] [5d]
neomorf: checks 
scout326: bets $7.05
neomorf: folds 
Uncalled bet ($7.05) returned to scout326
scout326 collected $14.10 from pot
*** SUMMARY ***
Total pot $14.76 | Rake $0.66 
Board [9h 6s Qc 5d]
Seat 1: matiko09 (small blind) folded before Flop
Seat 2: stds st (big blind) folded before Flop
Seat 3: PacPacBum folded before Flop (didn't bet)
Seat 4: neomorf folded on the Turn
Seat 7: Fish4trips folded before Flop (didn't bet)
Seat 8: scout326 (button) collected ($14.10)





PokerStars Hand #150126025392:  Hold'em No Limit ($0.50/$1.00 USD) - 2016/03/10 13:25:13 CET [2016/03/10 7:25:13 ET]
Table 'Liriope II' 9-max Seat #8 is the button
Seat 2: zxp12345 ($50.60 in chips) 
Seat 3: matiko09 ($168.93 in chips) 
Seat 4: Plz3betMe ($47.43 in chips) 
Seat 5: lumen21 ($100 in chips) 
Seat 6: nobu-azabu ($183.85 in chips) 
Seat 7: Sweden_Pound ($100 in chips) 
Seat 8: PacPacBum ($114.71 in chips) 
Seat 9: tipner ($106.05 in chips) 
tipner: posts small blind $0.50
di0d80: is sitting out 
zxp12345: posts big blind $1
*** HOLE CARDS ***
Dealt to matiko09 [Qh 5d]
matiko09: folds 
Plz3betMe: folds 
lumen21: raises $2 to $3
nobu-azabu: folds 
Sweden_Pound: folds 
PacPacBum: folds 
tipner: calls $2.50
zxp12345: calls $2
*** FLOP *** [2c Ts 6d]
tipner: checks 
zxp12345: checks 
lumen21: checks 
*** TURN *** [2c Ts 6d] [Qs]
tipner: bets $5
zxp12345: calls $5
lumen21: folds 
*** RIVER *** [2c Ts 6d Qs] [As]
tipner: bets $7
zxp12345: folds 
Uncalled bet ($7) returned to tipner
tipner collected $18.14 from pot
tipner: doesn't show hand 
*** SUMMARY ***
Total pot $19 | Rake $0.86 
Board [2c Ts 6d Qs As]
Seat 2: zxp12345 (big blind) folded on the River
Seat 3: matiko09 folded before Flop (didn't bet)
Seat 4: Plz3betMe folded before Flop (didn't bet)
Seat 5: lumen21 folded on the Turn
Seat 6: nobu-azabu folded before Flop (didn't bet)
Seat 7: Sweden_Pound folded before Flop (didn't bet)
Seat 8: PacPacBum (button) folded before Flop (didn't bet)
Seat 9: tipner (small blind) collected ($18.14)





PokerStars Hand #150126027200:  Hold'em No Limit ($0.50/$1.00 USD) - 2016/03/10 13:25:16 CET [2016/03/10 7:25:16 ET]
Table 'Iguassu' 9-max Seat #8 is the button
Seat 1: blackw0lf_03 ($103 in chips) 
Seat 2: Rocky6434 ($69.79 in chips) 
Seat 3: hammerwife ($120.43 in chips) 
Seat 4: matiko09 ($101.50 in chips) 
Seat 5: UnBent022 ($100 in chips) 
Seat 6: Igor DoUrden ($100 in chips) 
Seat 7: PacPacBum ($108.05 in chips) 
Seat 8: Sweden_Pound ($100 in chips) 
Seat 9: er13to ($100 in chips) 
er13to: posts small blind $0.50
blackw0lf_03: posts big blind $1
*** HOLE CARDS ***
Dealt to matiko09 [Jh 7s]
Rocky6434: raises $1 to $2
hammerwife: folds 
matiko09: folds 
UnBent022: folds 
Igor DoUrden: folds 
PacPacBum: folds 
Sweden_Pound: folds 
er13to: calls $1.50
blackw0lf_03: folds 
*** FLOP *** [8h 3s 7d]
er13to: checks 
Rocky6434: bets $2.39
er13to: folds 
Uncalled bet ($2.39) returned to Rocky6434
Rocky6434 collected $4.78 from pot
Rocky6434: doesn't show hand 
*** SUMMARY ***
Total pot $5 | Rake $0.22 
Board [8h 3s 7d]
Seat 1: blackw0lf_03 (big blind) folded before Flop
Seat 2: Rocky6434 collected ($4.78)
Seat 3: hammerwife folded before Flop (didn't bet)
Seat 4: matiko09 folded before Flop (didn't bet)
Seat 5: UnBent022 folded before Flop (didn't bet)
Seat 6: Igor DoUrden folded before Flop (didn't bet)
Seat 7: PacPacBum folded before Flop (didn't bet)
Seat 8: Sweden_Pound (button) folded before Flop (didn't bet)
Seat 9: er13to (small blind) folded on the Flop





PokerStars Hand #150126027597:  Hold'em No Limit ($0.50/$1.00 USD) - 2016/03/10 13:25:17 CET [2016/03/10 7:25:17 ET]
Table 'Virgo II' 9-max Seat #9 is the button
Seat 1: cdv1984 ($190.05 in chips) 
Seat 2: Plz3betMe ($51.77 in chips) 
Seat 4: UnBent022 ($101.25 in chips) 
Seat 5: stds st ($39.77 in chips) 
Seat 6: PacPacBum ($109.89 in chips) 
Seat 7: mamilets ($64.64 in chips) 
Seat 8: Sweden_Pound ($137.33 in chips) 
Seat 9: matiko09 ($100 in chips) 
cdv1984: posts small blind $0.50
Plz3betMe: posts big blind $1
blackw0lf_03: sits out 
*** HOLE CARDS ***
Dealt to matiko09 [4c Tc]
UnBent022: folds 
stds st: folds 
PacPacBum: raises $1.04 to $2.04
mamilets: folds 
Sweden_Pound: calls $2.04
matiko09: folds 
cdv1984: folds 
Plz3betMe: folds 
*** FLOP *** [Ts 9d 3c]
PacPacBum: bets $2.87
Sweden_Pound: calls $2.87
*** TURN *** [Ts 9d 3c] [7s]
PacPacBum: bets $5.83
Sweden_Pound: calls $5.83
*** RIVER *** [Ts 9d 3c 7s] [6h]
PacPacBum: bets $15.14
Sweden_Pound: folds 
Uncalled bet ($15.14) returned to PacPacBum
PacPacBum collected $21.95 from pot
PacPacBum: doesn't show hand 
*** SUMMARY ***
Total pot $22.98 | Rake $1.03 
Board [Ts 9d 3c 7s 6h]
Seat 1: cdv1984 (small blind) folded before Flop
Seat 2: Plz3betMe (big blind) folded before Flop
Seat 4: UnBent022 folded before Flop (didn't bet)
Seat 5: stds st folded before Flop (didn't bet)
Seat 6: PacPacBum collected ($21.95)
Seat 7: mamilets folded before Flop (didn't bet)
Seat 8: Sweden_Pound folded on the River
Seat 9: matiko09 (button) folded before Flop (didn't bet)





PokerStars Hand #150126034623:  Hold'em No Limit ($0.50/$1.00 USD) - 2016/03/10 13:25:31 CET [2016/03/10 7:25:31 ET]
Table 'Mars III' 9-max Seat #7 is the button
Seat 1: blackw0lf_03 ($111.12 in chips) 
Seat 2: pokixy800 ($65.10 in chips) 
Seat 3: PacPacBum ($108.98 in chips) 
Seat 4: Igor DoUrden ($118.41 in chips) 
Seat 5: ilaviiitech ($119.74 in chips) 
Seat 6: matiko09 ($101.85 in chips) 
Seat 7: Sweden_Pound ($100 in chips) 
Seat 8: Filojoes ($100 in chips) 
Filojoes: posts small blind $0.50
er13to: is sitting out 
blackw0lf_03: posts big blind $1
*** HOLE CARDS ***
Dealt to matiko09 [2c 3d]
pokixy800: folds 
PacPacBum: folds 
Igor DoUrden: folds 
ilaviiitech: folds 
matiko09: folds 
er13to leaves the table
Sweden_Pound: folds 
Filojoes: raises $1.50 to $2.50
blackw0lf_03: raises $5.50 to $8
Filojoes: calls $5.50
*** FLOP *** [2s 5c Qd]
Filojoes: checks 
blackw0lf_03: checks 
*** TURN *** [2s 5c Qd] [9h]
Filojoes: checks 
blackw0lf_03: checks 
*** RIVER *** [2s 5c Qd 9h] [Th]
flk.Dasas joins the table at seat #9 
Filojoes: bets $10
blackw0lf_03: calls $10
*** SHOW DOWN ***
Filojoes: shows [7h Ad] (high card Ace)
blackw0lf_03: shows [9c Ac] (a pair of Nines)
blackw0lf_03 collected $34.38 from pot
*** SUMMARY ***
Total pot $36 | Rake $1.62 
Board [2s 5c Qd 9h Th]
Seat 1: blackw0lf_03 (big blind) showed [9c Ac] and won ($34.38) with a pair of Nines
Seat 2: pokixy800 folded before Flop (didn't bet)
Seat 3: PacPacBum folded before Flop (didn't bet)
Seat 4: Igor DoUrden folded before Flop (didn't bet)
Seat 5: ilaviiitech folded before Flop (didn't bet)
Seat 6: matiko09 folded before Flop (didn't bet)
Seat 7: Sweden_Pound (button) folded before Flop (didn't bet)
Seat 8: Filojoes (small blind) showed [7h Ad] and lost with high card Ace





PokerStars Hand #150126036480:  Hold'em No Limit (€0.50/€1.00 EUR) - 2016/03/10 13:25:34 CET [2016/03/10 7:25:34 ET]
Table 'Claudia' 9-max Seat #5 is the button
Seat 1: matiko09 (€192.50 in chips) 
Seat 2: er13to (€100 in chips) 
Seat 4: Sweden_Pound (€100 in chips) 
Seat 5: Spid1 (€110.80 in chips) 
Seat 6: di0d80 (€100.73 in chips) 
Seat 7: tipner (€115.77 in chips) 
Seat 8: UnBent022 (€100 in chips) 
Seat 9: blackw0lf_03 (€100 in chips) 
di0d80: posts small blind €0.50
tipner: posts big blind €1
*** HOLE CARDS ***
Dealt to matiko09 [9c Td]
UnBent022: folds 
blackw0lf_03: folds 
matiko09: folds 
er13to: raises €2 to €3
Sweden_Pound: folds 
Spid1: folds 
di0d80: folds 
tipner: calls €2
*** FLOP *** [3h Qd Kd]
tipner: checks 
er13to: checks 
*** TURN *** [3h Qd Kd] [5s]
tipner: checks 
er13to: bets €4.50
Filojoes joins the table at seat #3 
tipner: raises €9.50 to €14
Filojoes leaves the table
ki11u joins the table at seat #3 
ki11u leaves the table
er13to: folds 
Uncalled bet (€9.50) returned to tipner
tipner collected €14.80 from pot
tipner: doesn't show hand 
*** SUMMARY ***
Total pot €15.50 | Rake €0.70 
Board [3h Qd Kd 5s]
Seat 1: matiko09 folded before Flop (didn't bet)
Seat 2: er13to folded on the Turn
Seat 4: Sweden_Pound folded before Flop (didn't bet)
Seat 5: Spid1 (button) folded before Flop (didn't bet)
Seat 6: di0d80 (small blind) folded before Flop
Seat 7: tipner (big blind) collected (€14.80)
Seat 8: UnBent022 folded before Flop (didn't bet)
Seat 9: blackw0lf_03 folded before Flop (didn't bet)





PokerStars Hand #150126039392:  Hold'em No Limit ($1/$2 USD) - 2016/03/10 13:25:40 CET [2016/03/10 7:25:40 ET]
Table 'Chandra II' 9-max Seat #7 is the button
Seat 1: Fish4trips ($315.43 in chips) 
Seat 2: PacPacBum ($240.51 in chips) 
Seat 4: tipner ($200 in chips) 
Seat 5: uibting ($71.92 in chips) 
Seat 6: stds st ($72.31 in chips) 
Seat 7: johnvu2016 ($159.58 in chips) 
Seat 8: matiko09 ($200 in chips) 
Seat 9: o.miro ($235.78 in chips) 
matiko09: posts small blind $1
o.miro: posts big blind $2
*** HOLE CARDS ***
Dealt to matiko09 [4d 4s]
Fish4trips: folds 
PacPacBum: folds 
tipner: folds 
uibting: folds 
stds st: folds 
johnvu2016: raises $4 to $6
matiko09: folds 
o.miro: folds 
Uncalled bet ($4) returned to johnvu2016
johnvu2016 collected $5 from pot
*** SUMMARY ***
Total pot $5 | Rake $0 
Seat 1: Fish4trips folded before Flop (didn't bet)
Seat 2: PacPacBum folded before Flop (didn't bet)
Seat 4: tipner folded before Flop (didn't bet)
Seat 5: uibting folded before Flop (didn't bet)
Seat 6: stds st folded before Flop (didn't bet)
Seat 7: johnvu2016 (button) collected ($5)
Seat 8: matiko09 (small blind) folded before Flop
Seat 9: o.miro (big blind) folded before Flop





PokerStars Hand #150126043603:  Hold'em No Limit ($0.25/$0.50 USD) - 2016/03/10 13:25:48 CET [2016/03/10 7:25:48 ET]
Table 'Aegina' 9-max Seat #8 is the button
Seat 1: BingoIng0 ($118.15 in chips) 
Seat 2: dvutavr ($111.33 in chips) 
Seat 4: digimatical ($72 in chips) 
Seat 5: Ahangama ($51.35 in chips) 
Seat 6: matiko09 ($50 in chips) 
Seat 7: Gummio ($106.71 in chips) 
Seat 8: ardo888 ($188.77 in chips) 
Seat 9: draken08 ($125 in chips) 
draken08: posts small blind $0.25
BingoIng0: posts big blind $0.50
Fandango1991: sits out 
BingoIng0: posts the ante $0.10
dvutavr: posts the ante $0.10
digimatical: posts the ante $0.10
Ahangama: posts the ante $0.10
matiko09: posts the ante $0.10
Gummio: posts the ante $0.10
ardo888: posts the ante $0.10
draken08: posts the ante $0.10
*** HOLE CARDS ***
Dealt to matiko09 [3s 6c]
dvutavr: folds 
digimatical: folds 
Ahangama: folds 
matiko09: folds 
Gummio: folds 
ardo888: raises $0.75 to $1.25
draken08: folds 
BingoIng0: folds 
Uncalled bet ($0.75) returned to ardo888
ardo888 collected $2.05 from pot
ardo888: doesn't show hand 
*** SUMMARY ***
Total pot $2.05 | Rake $0 
Seat 1: BingoIng0 (big blind) folded before Flop
Seat 2: dvutavr folded before Flop (didn't bet)
Seat 4: digimatical folded before Flop (didn't bet)
Seat 5: Ahangama folded before Flop (didn't bet)
Seat 6: matiko09 folded before Flop (didn't bet)
Seat 7: Gummio folded before Flop (didn't bet)
Seat 8: ardo888 (button) collected ($2.05)
Seat 9: draken08 (small blind) folded before Flop





PokerStars Hand #150126045419:  Hold'em No Limit ($0.50/$1.00 USD) - 2016/03/10 13:25:51 CET [2016/03/10 7:25:51 ET]
Table 'Leuschneria II' 9-max Seat #4 is the button
Seat 1: cdv1984 ($172.71 in chips) 
Seat 2: blackw0lf_03 ($100 in chips) 
Seat 3: gudridornot ($73.70 in chips) 
Seat 4: Sweden_Pound ($142.22 in chips) 
Seat 5: RMilPoker ($107.46 in chips) 
Seat 6: matiko09 ($117.10 in chips) 
Seat 7: Plz3betMe ($44.17 in chips) 
Seat 9: Katsulion ($124.41 in chips) 
RMilPoker: posts small blind $0.50
matiko09: posts big blind $1
UnBent022: sits out 
*** HOLE CARDS ***
Dealt to matiko09 [5h Ad]
Plz3betMe: folds 
Katsulion: folds 
cdv1984: folds 
blackw0lf_03: folds 
gudridornot: calls $1
Katsulion leaves the table
di0d80 joins the table at seat #9 
Sweden_Pound: raises $3 to $4
RMilPoker: folds 
di0d80 leaves the table
er13to joins the table at seat #9 
matiko09: folds 
er13to leaves the table
ki11u joins the table at seat #9 
gudridornot: raises $69.70 to $73.70 and is all-in
Sweden_Pound: folds 
Uncalled bet ($69.70) returned to gudridornot
gudridornot collected $9.50 from pot
gudridornot: doesn't show hand 
*** SUMMARY ***
Total pot $9.50 | Rake $0 
Seat 1: cdv1984 folded before Flop (didn't bet)
Seat 2: blackw0lf_03 folded before Flop (didn't bet)
Seat 3: gudridornot collected ($9.50)
Seat 4: Sweden_Pound (button) folded before Flop
Seat 5: RMilPoker (small blind) folded before Flop
Seat 6: matiko09 (big blind) folded before Flop
Seat 7: Plz3betMe folded before Flop (didn't bet)
Seat 9: Katsulion folded before Flop (didn't bet)





PokerStars Hand #150126046235:  Hold'em No Limit (€1/€2 EUR) - 2016/03/10 13:25:53 CET [2016/03/10 7:25:53 ET]
Table 'Sigrid II' 9-max Seat #9 is the button
Seat 1: Gamz11 (€216.93 in chips) 
Seat 2: stds st (€80 in chips) 
Seat 5: vr188 (€82.63 in chips) 
Seat 6: azzad2007 (€202 in chips) 
Seat 7: PacPacBum (€203 in chips) 
Seat 8: matiko09 (€202.71 in chips) 
Seat 9: ki11u (€227.42 in chips) 
Gamz11: posts small blind €1
stds st: posts big blind €2
Fish4trips: sits out 
*** HOLE CARDS ***
Dealt to matiko09 [3c Qd]
vr188: calls €2
azzad2007: folds 
PacPacBum: folds 
matiko09: folds 
ki11u: folds 
Gamz11: folds 
stds st: checks 
*** FLOP *** [6c 8d Ad]
stds st: checks 
vr188: bets €2
stds st: folds 
Uncalled bet (€2) returned to vr188
vr188 collected €4.78 from pot
vr188: doesn't show hand 
*** SUMMARY ***
Total pot €5 | Rake €0.22 
Board [6c 8d Ad]
Seat 1: Gamz11 (small blind) folded before Flop
Seat 2: stds st (big blind) folded on the Flop
Seat 5: vr188 collected (€4.78)
Seat 6: azzad2007 folded before Flop (didn't bet)
Seat 7: PacPacBum folded before Flop (didn't bet)
Seat 8: matiko09 folded before Flop (didn't bet)
Seat 9: ki11u (button) folded before Flop (didn't bet)





PokerStars Hand #150126053589:  Hold'em No Limit ($1/$2 USD) - 2016/03/10 13:26:07 CET [2016/03/10 7:26:07 ET]
Table 'Chandra II' 9-max Seat #8 is the button
Seat 1: Fish4trips ($315.43 in chips) 
Seat 2: PacPacBum ($240.51 in chips) 
Seat 3: ROLLO 888 ($225.51 in chips) 
Seat 4: tipner ($200 in chips) 
Seat 5: uibting ($71.92 in chips) 
Seat 6: stds st ($72.31 in chips) 
Seat 7: johnvu2016 ($162.58 in chips) 
Seat 8: matiko09 ($200 in chips) 
Seat 9: o.miro ($233.78 in chips) 
o.miro: posts small blind $1
Fish4trips: posts big blind $2
*** HOLE CARDS ***
Dealt to matiko09 [9h 6s]
PacPacBum: folds 
ROLLO 888: folds 
tipner: folds 
uibting: folds 
stds st: folds 
johnvu2016: folds 
matiko09: folds 
o.miro: folds 
Uncalled bet ($1) returned to Fish4trips
Fish4trips collected $2 from pot
Fish4trips: doesn't show hand 
*** SUMMARY ***
Total pot $2 | Rake $0 
Seat 1: Fish4trips (big blind) collected ($2)
Seat 2: PacPacBum folded before Flop (didn't bet)
Seat 3: ROLLO 888 folded before Flop (didn't bet)
Seat 4: tipner folded before Flop (didn't bet)
Seat 5: uibting folded before Flop (didn't bet)
Seat 6: stds st folded before Flop (didn't bet)
Seat 7: johnvu2016 folded before Flop (didn't bet)
Seat 8: matiko09 (button) folded before Flop (didn't bet)
Seat 9: o.miro (small blind) folded before Flop





PokerStars Hand #150126056006:  Hold'em No Limit ($0.25/$0.50 USD) - 2016/03/10 13:26:11 CET [2016/03/10 7:26:11 ET]
Table 'Aegina' 9-max Seat #9 is the button
Seat 1: BingoIng0 ($117.55 in chips) 
Seat 2: dvutavr ($111.23 in chips) 
Seat 4: digimatical ($71.90 in chips) 
Seat 5: Ahangama ($51.25 in chips) 
Seat 6: matiko09 ($50 in chips) 
Seat 7: Gummio ($106.61 in chips) 
Seat 8: ardo888 ($190.22 in chips) 
Seat 9: draken08 ($125 in chips) 
BingoIng0: posts small blind $0.25
dvutavr: posts big blind $0.50
Fandango1991: sits out 
BingoIng0: posts the ante $0.10
dvutavr: posts the ante $0.10
digimatical: posts the ante $0.10
Ahangama: posts the ante $0.10
matiko09: posts the ante $0.10
Gummio: posts the ante $0.10
ardo888: posts the ante $0.10
draken08: posts the ante $0.10
*** HOLE CARDS ***
Dealt to matiko09 [6h Ac]
digimatical: calls $0.50
Ahangama: raises $2 to $2.50
matiko09: folds 
Gummio: folds 
ardo888: folds 
draken08: folds 
BingoIng0: folds 
dvutavr: folds 
digimatical: folds 
Uncalled bet ($2) returned to Ahangama
Ahangama collected $2.55 from pot
Ahangama: doesn't show hand 
*** SUMMARY ***
Total pot $2.55 | Rake $0 
Seat 1: BingoIng0 (small blind) folded before Flop
Seat 2: dvutavr (big blind) folded before Flop
Seat 4: digimatical folded before Flop
Seat 5: Ahangama collected ($2.55)
Seat 6: matiko09 folded before Flop (didn't bet)
Seat 7: Gummio folded before Flop (didn't bet)
Seat 8: ardo888 folded before Flop (didn't bet)
Seat 9: draken08 (button) folded before Flop (didn't bet)





PokerStars Hand #150126056146:  Hold'em No Limit ($1/$2 USD) - 2016/03/10 13:26:12 CET [2016/03/10 7:26:12 ET]
Table 'Tauris II' 9-max Seat #1 is the button
Seat 1: matiko09 ($200 in chips) 
Seat 2: stds st ($72.96 in chips) 
Seat 3: PacPacBum ($207.67 in chips) 
Seat 4: neomorf ($612.14 in chips) 
Seat 7: Fish4trips ($211.06 in chips) 
Seat 8: scout326 ($226.38 in chips) 
stds st: posts small blind $1
PacPacBum: posts big blind $2
uonlylive1ce: sits out 
*** HOLE CARDS ***
Dealt to matiko09 [5c Jd]
neomorf: raises $3.88 to $5.88
Fish4trips: folds 
scout326: folds 
matiko09: folds 
stds st: folds 
PacPacBum: folds 
Uncalled bet ($3.88) returned to neomorf
neomorf collected $5 from pot
neomorf: doesn't show hand 
*** SUMMARY ***
Total pot $5 | Rake $0 
Seat 1: matiko09 (button) folded before Flop (didn't bet)
Seat 2: stds st (small blind) folded before Flop
Seat 3: PacPacBum (big blind) folded before Flop
Seat 4: neomorf collected ($5)
Seat 7: Fish4trips folded before Flop (didn't bet)
Seat 8: scout326 folded before Flop (didn't bet)





PokerStars Hand #150126064500:  Hold'em No Limit ($1/$2 USD) - 2016/03/10 13:26:28 CET [2016/03/10 7:26:28 ET]
Table 'Chandra II' 9-max Seat #9 is the button
Seat 1: Fish4trips ($316.43 in chips) 
Seat 2: PacPacBum ($240.51 in chips) 
Seat 3: ROLLO 888 ($225.51 in chips) 
Seat 4: tipner ($200 in chips) 
Seat 5: uibting ($71.92 in chips) 
Seat 6: stds st ($72.31 in chips) 
Seat 7: johnvu2016 ($162.58 in chips) 
Seat 8: matiko09 ($200 in chips) 
Seat 9: o.miro ($232.78 in chips) 
Fish4trips: posts small blind $1
PacPacBum: posts big blind $2
*** HOLE CARDS ***
Dealt to matiko09 [4c 5c]
ROLLO 888: folds 
tipner: raises $4 to $6
uibting: folds 
stds st: folds 
johnvu2016: calls $6
matiko09: folds 
o.miro: calls $6
Fish4trips: folds 
PacPacBum: folds 
*** FLOP *** [6c Tc Jh]
tipner: checks 
johnvu2016: checks 
o.miro: checks 
*** TURN *** [6c Tc Jh] [8d]
tipner: checks 
johnvu2016: checks 
o.miro: bets $14
tipner: calls $14
johnvu2016: folds 
*** RIVER *** [6c Tc Jh 8d] [Ac]
tipner: checks 
o.miro: checks 
*** SHOW DOWN ***
tipner: shows [9d 9h] (a pair of Nines)
o.miro: shows [Th Kh] (a pair of Tens)
o.miro collected $46.80 from pot
*** SUMMARY ***
Total pot $49 | Rake $2.20 
Board [6c Tc Jh 8d Ac]
Seat 1: Fish4trips (small blind) folded before Flop
Seat 2: PacPacBum (big blind) folded before Flop
Seat 3: ROLLO 888 folded before Flop (didn't bet)
Seat 4: tipner showed [9d 9h] and lost with a pair of Nines
Seat 5: uibting folded before Flop (didn't bet)
Seat 6: stds st folded before Flop (didn't bet)
Seat 7: johnvu2016 folded on the Turn
Seat 8: matiko09 folded before Flop (didn't bet)
Seat 9: o.miro (button) showed [Th Kh] and won ($46.80) with a pair of Tens





PokerStars Hand #150126066412:  Hold'em No Limit ($0.50/$1.00 USD) - 2016/03/10 13:26:31 CET [2016/03/10 7:26:31 ET]
Table 'Liriope II' 9-max Seat #9 is the button
Seat 2: zxp12345 ($42.60 in chips) 
Seat 3: matiko09 ($168.93 in chips) 
Seat 4: Plz3betMe ($47.43 in chips) 
Seat 5: lumen21 ($100 in chips) 
Seat 6: nobu-azabu ($183.85 in chips) 
Seat 7: Sweden_Pound ($100 in chips) 
Seat 8: PacPacBum ($114.71 in chips) 
Seat 9: tipner ($116.19 in chips) 
zxp12345: posts small blind $0.50
matiko09: posts big blind $1
*** HOLE CARDS ***
Dealt to matiko09 [9h Qc]
Plz3betMe: folds 
lumen21: raises $2 to $3
nobu-azabu: folds 
Sweden_Pound: folds 
PacPacBum: folds 
tipner: folds 
zxp12345: calls $2.50
matiko09: folds 
*** FLOP *** [4h 6d Qh]
zxp12345: checks 
lumen21: bets $6
zxp12345: folds 
Uncalled bet ($6) returned to lumen21
lumen21 collected $6.68 from pot
lumen21: doesn't show hand 
*** SUMMARY ***
Total pot $7 | Rake $0.32 
Board [4h 6d Qh]
Seat 2: zxp12345 (small blind) folded on the Flop
Seat 3: matiko09 (big blind) folded before Flop
Seat 4: Plz3betMe folded before Flop (didn't bet)
Seat 5: lumen21 collected ($6.68)
Seat 6: nobu-azabu folded before Flop (didn't bet)
Seat 7: Sweden_Pound folded before Flop (didn't bet)
Seat 8: PacPacBum folded before Flop (didn't bet)
Seat 9: tipner (button) folded before Flop (didn't bet)





PokerStars Hand #150126068392:  Hold'em No Limit (€1/€2 EUR) - 2016/03/10 13:26:35 CET [2016/03/10 7:26:35 ET]
Table 'Sigrid II' 9-max Seat #1 is the button
Seat 1: Gamz11 (€215.93 in chips) 
Seat 2: stds st (€78 in chips) 
Seat 4: Fish4trips (€200 in chips) 
Seat 5: vr188 (€85.41 in chips) 
Seat 6: azzad2007 (€202 in chips) 
Seat 7: PacPacBum (€203 in chips) 
Seat 8: matiko09 (€202.71 in chips) 
Seat 9: ki11u (€227.42 in chips) 
stds st: posts small blind €1
Fish4trips: posts big blind €2
*** HOLE CARDS ***
Dealt to matiko09 [7h 5h]
vr188: folds 
azzad2007: folds 
PacPacBum: folds 
matiko09: folds 
ki11u: folds 
Gamz11: folds 
stds st: raises €2.04 to €4.04
Fish4trips: raises €6.96 to €11
stds st: raises €66 to €77
Fish4trips: raises €123 to €200 and is all-in
stds st: calls €1 and is all-in
Uncalled bet (€122) returned to Fish4trips
*** FIRST FLOP *** [2s 9s 4h]
*** FIRST TURN *** [2s 9s 4h] [Jh]
*** FIRST RIVER *** [2s 9s 4h Jh] [3c]
*** SECOND FLOP *** [4d Td 2c]
*** SECOND TURN *** [4d Td 2c] [2d]
*** SECOND RIVER *** [4d Td 2c 2d] [7d]
*** FIRST SHOW DOWN ***
stds st: shows [Kd Qs] (high card King)
Fish4trips: shows [Ah Js] (a pair of Jacks)
Fish4trips collected €76.93 from pot
*** SECOND SHOW DOWN ***
stds st: shows [Kd Qs] (a flush, King high)
Fish4trips: shows [Ah Js] (a pair of Deuces)
stds st collected €76.92 from pot
*** SUMMARY ***
Total pot €156 | Rake €2.15 
Hand was run twice
FIRST Board [2s 9s 4h Jh 3c]
SECOND Board [4d Td 2c 2d 7d]
Seat 1: Gamz11 (button) folded before Flop (didn't bet)
Seat 2: stds st (small blind) showed [Kd Qs] and lost with high card King, and won (€76.92) with a flush, King high
Seat 4: Fish4trips (big blind) showed [Ah Js] and won (€76.93) with a pair of Jacks, and lost with a pair of Deuces
Seat 5: vr188 folded before Flop (didn't bet)
Seat 6: azzad2007 folded before Flop (didn't bet)
Seat 7: PacPacBum folded before Flop (didn't bet)
Seat 8: matiko09 folded before Flop (didn't bet)
Seat 9: ki11u folded before Flop (didn't bet)





PokerStars Hand #150126069474:  Hold'em No Limit ($0.50/$1.00 USD) - 2016/03/10 13:26:37 CET [2016/03/10 7:26:37 ET]
Table 'Iguassu' 9-max Seat #9 is the button
Seat 1: blackw0lf_03 ($102 in chips) 
Seat 2: Rocky6434 ($72.57 in chips) 
Seat 3: hammerwife ($120.43 in chips) 
Seat 4: matiko09 ($101.50 in chips) 
Seat 5: UnBent022 ($100 in chips) 
Seat 6: Igor DoUrden ($100 in chips) 
Seat 7: PacPacBum ($108.05 in chips) 
Seat 8: Sweden_Pound ($100 in chips) 
Seat 9: er13to ($100 in chips) 
blackw0lf_03: posts small blind $0.50
Rocky6434: posts big blind $1
*** HOLE CARDS ***
Dealt to matiko09 [9s 8d]
hammerwife: folds 
matiko09: folds 
UnBent022: folds 
Igor DoUrden: folds 
PacPacBum: raises $1.04 to $2.04
Sweden_Pound: calls $2.04
er13to: folds 
blackw0lf_03: folds 
Rocky6434: folds 
*** FLOP *** [Kc 5s 8s]
PacPacBum: checks 
Sweden_Pound: bets $3.46
PacPacBum: calls $3.46
*** TURN *** [Kc 5s 8s] [9d]
PacPacBum: checks 
Sweden_Pound: bets $7.76
PacPacBum: calls $7.76
*** RIVER *** [Kc 5s 8s 9d] [Jc]
PacPacBum: checks 
Sweden_Pound: checks 
*** SHOW DOWN ***
PacPacBum: shows [6h 8h] (a pair of Eights)
Sweden_Pound: mucks hand 
PacPacBum collected $26.76 from pot
*** SUMMARY ***
Total pot $28.02 | Rake $1.26 
Board [Kc 5s 8s 9d Jc]
Seat 1: blackw0lf_03 (small blind) folded before Flop
Seat 2: Rocky6434 (big blind) folded before Flop
Seat 3: hammerwife folded before Flop (didn't bet)
Seat 4: matiko09 folded before Flop (didn't bet)
Seat 5: UnBent022 folded before Flop (didn't bet)
Seat 6: Igor DoUrden folded before Flop (didn't bet)
Seat 7: PacPacBum showed [6h 8h] and won ($26.76) with a pair of Eights
Seat 8: Sweden_Pound mucked [4s As]
Seat 9: er13to (button) folded before Flop (didn't bet)





PokerStars Hand #150126071344:  Hold'em No Limit ($0.50/$1.00 USD) - 2016/03/10 13:26:41 CET [2016/03/10 7:26:41 ET]
Table 'Saskia' 9-max Seat #3 is the button
Seat 1: Sweden_Pound ($111.51 in chips) 
Seat 2: njurg aga ($75.45 in chips) 
Seat 3: ccmaster001 ($72.64 in chips) 
Seat 4: Plz3betMe ($89.72 in chips) 
Seat 5: dreded11 ($92.16 in chips) 
Seat 6: matiko09 ($106.88 in chips) 
Seat 7: stds st ($49.06 in chips) 
Seat 8: blackw0lf_03 ($100 in chips) 
Seat 9: er13to ($116.97 in chips) 
Plz3betMe: posts small blind $0.50
dreded11: posts big blind $1
*** HOLE CARDS ***
Dealt to matiko09 [Qs 6d]
matiko09: folds 
stds st: folds 
blackw0lf_03: folds 
er13to: folds 
Sweden_Pound: folds 
njurg aga: folds 
ccmaster001: folds 
Plz3betMe: folds 
Uncalled bet ($0.50) returned to dreded11
dreded11 collected $1 from pot
dreded11: doesn't show hand 
*** SUMMARY ***
Total pot $1 | Rake $0 
Seat 1: Sweden_Pound folded before Flop (didn't bet)
Seat 2: njurg aga folded before Flop (didn't bet)
Seat 3: ccmaster001 (button) folded before Flop (didn't bet)
Seat 4: Plz3betMe (small blind) folded before Flop
Seat 5: dreded11 (big blind) collected ($1)
Seat 6: matiko09 folded before Flop (didn't bet)
Seat 7: stds st folded before Flop (didn't bet)
Seat 8: blackw0lf_03 folded before Flop (didn't bet)
Seat 9: er13to folded before Flop (didn't bet)





PokerStars Hand #150126071887:  Hold'em No Limit ($0.50/$1.00 USD) - 2016/03/10 13:26:42 CET [2016/03/10 7:26:42 ET]
Table 'Leuschneria II' 9-max Seat #5 is the button
Seat 1: cdv1984 ($172.71 in chips) 
Seat 2: blackw0lf_03 ($100 in chips) 
Seat 3: gudridornot ($79.20 in chips) 
Seat 4: Sweden_Pound ($138.22 in chips) 
Seat 5: RMilPoker ($106.96 in chips) 
Seat 6: matiko09 ($116.10 in chips) 
Seat 7: Plz3betMe ($44.17 in chips) 
matiko09: posts small blind $0.50
Plz3betMe: posts big blind $1
UnBent022: sits out 
ki11u: sits out 
*** HOLE CARDS ***
Dealt to matiko09 [8s 6d]
cdv1984: raises $2 to $3
blackw0lf_03: folds 
gudridornot: folds 
Sweden_Pound: folds 
RMilPoker: folds 
matiko09: folds 
Plz3betMe: folds 
Uncalled bet ($2) returned to cdv1984
cdv1984 collected $2.50 from pot
cdv1984: doesn't show hand 
*** SUMMARY ***
Total pot $2.50 | Rake $0 
Seat 1: cdv1984 collected ($2.50)
Seat 2: blackw0lf_03 folded before Flop (didn't bet)
Seat 3: gudridornot folded before Flop (didn't bet)
Seat 4: Sweden_Pound folded before Flop (didn't bet)
Seat 5: RMilPoker (button) folded before Flop (didn't bet)
Seat 6: matiko09 (small blind) folded before Flop
Seat 7: Plz3betMe (big blind) folded before Flop





PokerStars Hand #150126072335:  Hold'em No Limit ($1/$2 USD) - 2016/03/10 13:26:42 CET [2016/03/10 7:26:42 ET]
Table 'Tauris II' 9-max Seat #2 is the button
Seat 1: matiko09 ($200 in chips) 
Seat 2: stds st ($71.96 in chips) 
Seat 3: PacPacBum ($205.67 in chips) 
Seat 4: neomorf ($615.14 in chips) 
Seat 7: Fish4trips ($211.06 in chips) 
Seat 8: scout326 ($226.38 in chips) 
PacPacBum: posts small blind $1
neomorf: posts big blind $2
uonlylive1ce: sits out 
*** HOLE CARDS ***
Dealt to matiko09 [6c 3d]
Fish4trips: raises $3 to $5
scout326: folds 
matiko09: folds 
stds st: folds 
PacPacBum: folds 
neomorf: folds 
Uncalled bet ($3) returned to Fish4trips
Fish4trips collected $5 from pot
Fish4trips: doesn't show hand 
*** SUMMARY ***
Total pot $5 | Rake $0 
Seat 1: matiko09 folded before Flop (didn't bet)
Seat 2: stds st (button) folded before Flop (didn't bet)
Seat 3: PacPacBum (small blind) folded before Flop
Seat 4: neomorf (big blind) folded before Flop
Seat 7: Fish4trips collected ($5)
Seat 8: scout326 folded before Flop (didn't bet)





PokerStars Hand #150126072779:  Hold'em No Limit ($0.25/$0.50 USD) - 2016/03/10 13:26:43 CET [2016/03/10 7:26:43 ET]
Table 'Aegina' 9-max Seat #1 is the button
Seat 1: BingoIng0 ($117.20 in chips) 
Seat 2: dvutavr ($110.63 in chips) 
Seat 3: Fandango1991 ($78.12 in chips) 
Seat 4: digimatical ($71.30 in chips) 
Seat 5: Ahangama ($53.20 in chips) 
Seat 6: matiko09 ($50 in chips) 
Seat 7: Gummio ($106.51 in chips) 
Seat 8: ardo888 ($190.12 in chips) 
Seat 9: draken08 ($125 in chips) 
dvutavr: posts small blind $0.25
Fandango1991: posts big blind $0.50
BingoIng0: posts the ante $0.10
dvutavr: posts the ante $0.10
Fandango1991: posts the ante $0.10
digimatical: posts the ante $0.10
Ahangama: posts the ante $0.10
matiko09: posts the ante $0.10
Gummio: posts the ante $0.10
ardo888: posts the ante $0.10
draken08: posts the ante $0.10
*** HOLE CARDS ***
Dealt to matiko09 [4s Td]
digimatical: raises $0.50 to $1
Ahangama: raises $3.50 to $4.50
matiko09: folds 
Gummio: folds 
ardo888: folds 
draken08: folds 
BingoIng0: folds 
dvutavr: folds 
Fandango1991: folds 
digimatical: calls $3.50
*** FLOP *** [5h 9s Js]
digimatical: checks 
Ahangama: bets $5
digimatical: calls $5
*** TURN *** [5h 9s Js] [Ts]
digimatical: checks 
Ahangama: checks 
*** RIVER *** [5h 9s Js Ts] [3s]
digimatical: bets $6
Ahangama: folds 
Uncalled bet ($6) returned to digimatical
digimatical collected $19.72 from pot
*** SUMMARY ***
Total pot $20.65 | Rake $0.93 
Board [5h 9s Js Ts 3s]
Seat 1: BingoIng0 (button) folded before Flop (didn't bet)
Seat 2: dvutavr (small blind) folded before Flop
Seat 3: Fandango1991 (big blind) folded before Flop
Seat 4: digimatical collected ($19.72)
Seat 5: Ahangama folded on the River
Seat 6: matiko09 folded before Flop (didn't bet)
Seat 7: Gummio folded before Flop (didn't bet)
Seat 8: ardo888 folded before Flop (didn't bet)
Seat 9: draken08 folded before Flop (didn't bet)





PokerStars Hand #150126078614:  Hold'em No Limit ($0.50/$1.00 USD) - 2016/03/10 13:26:54 CET [2016/03/10 7:26:54 ET]
Table 'Virgo II' 9-max Seat #1 is the button
Seat 1: cdv1984 ($189.55 in chips) 
Seat 2: Plz3betMe ($50.77 in chips) 
Seat 3: blackw0lf_03 ($101.50 in chips) 
Seat 4: UnBent022 ($101.25 in chips) 
Seat 5: stds st ($39.77 in chips) 
Seat 6: PacPacBum ($121.10 in chips) 
Seat 7: mamilets ($64.64 in chips) 
Seat 8: Sweden_Pound ($126.59 in chips) 
Seat 9: matiko09 ($100 in chips) 
Plz3betMe: posts small blind $0.50
blackw0lf_03: posts big blind $1
*** HOLE CARDS ***
Dealt to matiko09 [Ah Js]
UnBent022: folds 
stds st has timed out
stds st: folds 
PacPacBum: raises $1.04 to $2.04
mamilets: calls $2.04
Sweden_Pound: folds 
matiko09: raises $6.96 to $9
cdv1984: folds 
Plz3betMe: folds 
blackw0lf_03: folds 
PacPacBum: raises $11 to $20
mamilets: folds 
matiko09: folds 
Uncalled bet ($11) returned to PacPacBum
PacPacBum collected $21.54 from pot
PacPacBum: doesn't show hand 
*** SUMMARY ***
Total pot $21.54 | Rake $0 
Seat 1: cdv1984 (button) folded before Flop (didn't bet)
Seat 2: Plz3betMe (small blind) folded before Flop
Seat 3: blackw0lf_03 (big blind) folded before Flop
Seat 4: UnBent022 folded before Flop (didn't bet)
Seat 5: stds st folded before Flop (didn't bet)
Seat 6: PacPacBum collected ($21.54)
Seat 7: mamilets folded before Flop
Seat 8: Sweden_Pound folded before Flop (didn't bet)
Seat 9: matiko09 folded before Flop





PokerStars Hand #150126086131:  Hold'em No Limit ($0.50/$1.00 USD) - 2016/03/10 13:27:09 CET [2016/03/10 7:27:09 ET]
Table 'Leuschneria II' 9-max Seat #6 is the button
Seat 1: cdv1984 ($174.21 in chips) 
Seat 2: blackw0lf_03 ($100 in chips) 
Seat 3: gudridornot ($79.20 in chips) 
Seat 4: Sweden_Pound ($138.22 in chips) 
Seat 5: RMilPoker ($106.96 in chips) 
Seat 6: matiko09 ($115.60 in chips) 
Seat 7: Plz3betMe ($43.17 in chips) 
Seat 8: UnBent022 ($100 in chips) 
Plz3betMe: posts small blind $0.50
UnBent022: posts big blind $1
ki11u: sits out 
*** HOLE CARDS ***
Dealt to matiko09 [Qd Th]
cdv1984: folds 
blackw0lf_03: folds 
gudridornot: folds 
Sweden_Pound: folds 
RMilPoker: folds 
matiko09: raises $1.27 to $2.27
Plz3betMe: raises $4.73 to $7
UnBent022: folds 
matiko09: folds 
Uncalled bet ($4.73) returned to Plz3betMe
Plz3betMe collected $5.54 from pot
Plz3betMe: doesn't show hand 
*** SUMMARY ***
Total pot $5.54 | Rake $0 
Seat 1: cdv1984 folded before Flop (didn't bet)
Seat 2: blackw0lf_03 folded before Flop (didn't bet)
Seat 3: gudridornot folded before Flop (didn't bet)
Seat 4: Sweden_Pound folded before Flop (didn't bet)
Seat 5: RMilPoker folded before Flop (didn't bet)
Seat 6: matiko09 (button) folded before Flop
Seat 7: Plz3betMe (small blind) collected ($5.54)
Seat 8: UnBent022 (big blind) folded before Flop





PokerStars Hand #150126086499:  Hold'em No Limit ($1/$2 USD) - 2016/03/10 13:27:10 CET [2016/03/10 7:27:10 ET]
Table 'Tauris II' 9-max Seat #3 is the button
Seat 1: matiko09 ($200 in chips) 
Seat 2: stds st ($71.96 in chips) 
Seat 3: PacPacBum ($204.67 in chips) 
Seat 4: neomorf ($613.14 in chips) 
Seat 6: uonlylive1ce ($200 in chips) 
Seat 7: Fish4trips ($214.06 in chips) 
Seat 8: scout326 ($226.38 in chips) 
neomorf: posts small blind $1
uonlylive1ce: posts big blind $2
*** HOLE CARDS ***
Dealt to matiko09 [9d 3h]
Fish4trips: folds 
scout326: folds 
matiko09: folds 
stds st: folds 
PacPacBum: raises $2.08 to $4.08
neomorf: raises $11.92 to $16
uonlylive1ce: folds 
PacPacBum: calls $11.92
*** FLOP *** [Td Qc 9c]
neomorf: checks 
PacPacBum: checks 
*** TURN *** [Td Qc 9c] [5d]
neomorf: bets $48
PacPacBum: folds 
Uncalled bet ($48) returned to neomorf
neomorf collected $32.47 from pot
neomorf: doesn't show hand 
*** SUMMARY ***
Total pot $34 | Rake $1.53 
Board [Td Qc 9c 5d]
Seat 1: matiko09 folded before Flop (didn't bet)
Seat 2: stds st folded before Flop (didn't bet)
Seat 3: PacPacBum (button) folded on the Turn
Seat 4: neomorf (small blind) collected ($32.47)
Seat 6: uonlylive1ce (big blind) folded before Flop
Seat 7: Fish4trips folded before Flop (didn't bet)
Seat 8: scout326 folded before Flop (didn't bet)





PokerStars Hand #150126090515:  Hold'em No Limit ($0.50/$1.00 USD) - 2016/03/10 13:27:17 CET [2016/03/10 7:27:17 ET]
Table 'Saskia' 9-max Seat #4 is the button
Seat 1: Sweden_Pound ($111.51 in chips) 
Seat 2: njurg aga ($75.45 in chips) 
Seat 3: ccmaster001 ($72.64 in chips) 
Seat 4: Plz3betMe ($89.22 in chips) 
Seat 5: dreded11 ($92.66 in chips) 
Seat 6: matiko09 ($106.88 in chips) 
Seat 7: stds st ($49.06 in chips) 
Seat 8: blackw0lf_03 ($100 in chips) 
Seat 9: er13to ($116.97 in chips) 
dreded11: posts small blind $0.50
matiko09: posts big blind $1
*** HOLE CARDS ***
Dealt to matiko09 [6d Qh]
stds st: folds 
blackw0lf_03: folds 
er13to: raises $2 to $3
Sweden_Pound: folds 
njurg aga: folds 
ccmaster001: folds 
Plz3betMe: folds 
dreded11: folds 
matiko09: folds 
Uncalled bet ($2) returned to er13to
er13to collected $2.50 from pot
*** SUMMARY ***
Total pot $2.50 | Rake $0 
Seat 1: Sweden_Pound folded before Flop (didn't bet)
Seat 2: njurg aga folded before Flop (didn't bet)
Seat 3: ccmaster001 folded before Flop (didn't bet)
Seat 4: Plz3betMe (button) folded before Flop (didn't bet)
Seat 5: dreded11 (small blind) folded before Flop
Seat 6: matiko09 (big blind) folded before Flop
Seat 7: stds st folded before Flop (didn't bet)
Seat 8: blackw0lf_03 folded before Flop (didn't bet)
Seat 9: er13to collected ($2.50)





PokerStars Hand #150126095011:  Hold'em No Limit (€0.50/€1.00 EUR) - 2016/03/10 13:27:26 CET [2016/03/10 7:27:26 ET]
Table 'Claudia' 9-max Seat #6 is the button
Seat 1: matiko09 (€192.50 in chips) 
Seat 2: er13to (€100 in chips) 
Seat 4: Sweden_Pound (€100 in chips) 
Seat 5: Spid1 (€110.80 in chips) 
Seat 6: di0d80 (€100.23 in chips) 
Seat 7: tipner (€123.07 in chips) 
Seat 9: blackw0lf_03 (€100 in chips) 
tipner: posts small blind €0.50
UnBent022: is sitting out 
blackw0lf_03: posts big blind €1
*** HOLE CARDS ***
Dealt to matiko09 [3h 7c]
UnBent022 leaves the table
matiko09: folds 
er13to: folds 
matiko09 leaves the table
Login82 joins the table at seat #8 
Sweden_Pound: folds 
Spid1: folds 
di0d80: raises €1 to €2
tipner: folds 
blackw0lf_03: folds 
Uncalled bet (€1) returned to di0d80
di0d80 collected €2.50 from pot
di0d80: doesn't show hand 
*** SUMMARY ***
Total pot €2.50 | Rake €0 
Seat 1: matiko09 folded before Flop (didn't bet)
Seat 2: er13to folded before Flop (didn't bet)
Seat 4: Sweden_Pound folded before Flop (didn't bet)
Seat 5: Spid1 folded before Flop (didn't bet)
Seat 6: di0d80 (button) collected (€2.50)
Seat 7: tipner (small blind) folded before Flop
Seat 9: blackw0lf_03 (big blind) folded before Flop





PokerStars Hand #150126097508:  Hold'em No Limit ($0.50/$1.00 USD) - 2016/03/10 13:27:31 CET [2016/03/10 7:27:31 ET]
Table 'Liriope II' 9-max Seat #2 is the button
Seat 2: zxp12345 ($39.60 in chips) 
Seat 3: matiko09 ($167.93 in chips) 
Seat 4: Plz3betMe ($47.43 in chips) 
Seat 5: lumen21 ($103.68 in chips) 
Seat 6: nobu-azabu ($183.85 in chips) 
Seat 7: Sweden_Pound ($100 in chips) 
Seat 8: PacPacBum ($114.71 in chips) 
Seat 9: tipner ($116.19 in chips) 
matiko09: posts small blind $0.50
Plz3betMe: posts big blind $1
*** HOLE CARDS ***
Dealt to matiko09 [4d 6s]
lumen21: folds 
nobu-azabu: raises $1.50 to $2.50
Sweden_Pound: folds 
PacPacBum: folds 
tipner: folds 
zxp12345: folds 
matiko09: folds 
Plz3betMe: folds 
Uncalled bet ($1.50) returned to nobu-azabu
nobu-azabu collected $2.50 from pot
*** SUMMARY ***
Total pot $2.50 | Rake $0 
Seat 2: zxp12345 (button) folded before Flop (didn't bet)
Seat 3: matiko09 (small blind) folded before Flop
Seat 4: Plz3betMe (big blind) folded before Flop
Seat 5: lumen21 folded before Flop (didn't bet)
Seat 6: nobu-azabu collected ($2.50)
Seat 7: Sweden_Pound folded before Flop (didn't bet)
Seat 8: PacPacBum folded before Flop (didn't bet)
Seat 9: tipner folded before Flop (didn't bet)





PokerStars Hand #150126098738:  Hold'em No Limit (€1/€2 EUR) - 2016/03/10 13:27:33 CET [2016/03/10 7:27:33 ET]
Table 'Sigrid II' 9-max Seat #2 is the button
Seat 1: Gamz11 (€215.93 in chips) 
Seat 2: stds st (€76.92 in chips) 
Seat 4: Fish4trips (€200 in chips) 
Seat 5: vr188 (€85.41 in chips) 
Seat 6: azzad2007 (€202 in chips) 
Seat 7: PacPacBum (€203 in chips) 
Seat 8: matiko09 (€202.71 in chips) 
Seat 9: ki11u (€227.42 in chips) 
Fish4trips: posts small blind €1
vr188: posts big blind €2
*** HOLE CARDS ***
Dealt to matiko09 [Ad 5s]
azzad2007: folds 
PacPacBum: raises €2.08 to €4.08
matiko09: folds 
ki11u: folds 
Gamz11: folds 
stds st: folds 
Fish4trips: folds 
vr188: calls €2.08
*** FLOP *** [7s 9c Ah]
vr188: checks 
PacPacBum: checks 
*** TURN *** [7s 9c Ah] [5c]
vr188: checks 
PacPacBum: checks 
*** RIVER *** [7s 9c Ah 5c] [4h]
vr188: checks 
PacPacBum: checks 
*** SHOW DOWN ***
vr188: shows [Js 6s] (high card Ace)
PacPacBum: shows [8d 8h] (a pair of Eights)
PacPacBum collected €8.75 from pot
*** SUMMARY ***
Total pot €9.16 | Rake €0.41 
Board [7s 9c Ah 5c 4h]
Seat 1: Gamz11 folded before Flop (didn't bet)
Seat 2: stds st (button) folded before Flop (didn't bet)
Seat 4: Fish4trips (small blind) folded before Flop
Seat 5: vr188 (big blind) showed [Js 6s] and lost with high card Ace
Seat 6: azzad2007 folded before Flop (didn't bet)
Seat 7: PacPacBum showed [8d 8h] and won (€8.75) with a pair of Eights
Seat 8: matiko09 folded before Flop (didn't bet)
Seat 9: ki11u folded before Flop (didn't bet)





PokerStars Hand #150126102388:  Hold'em No Limit ($0.50/$1.00 USD) - 2016/03/10 13:27:40 CET [2016/03/10 7:27:40 ET]
Table 'Mars III' 9-max Seat #8 is the button
Seat 1: blackw0lf_03 ($127.50 in chips) 
Seat 2: pokixy800 ($65.10 in chips) 
Seat 3: PacPacBum ($108.98 in chips) 
Seat 4: Igor DoUrden ($118.41 in chips) 
Seat 5: ilaviiitech ($119.74 in chips) 
Seat 6: matiko09 ($101.85 in chips) 
Seat 7: Sweden_Pound ($100 in chips) 
Seat 8: Filojoes ($100 in chips) 
blackw0lf_03: posts small blind $0.50
pokixy800: posts big blind $1
*** HOLE CARDS ***
Dealt to matiko09 [Js Kd]
PacPacBum: folds 
Igor DoUrden: folds 
ilaviiitech: folds 
matiko09: folds 
Sweden_Pound: raises $1.50 to $2.50
Filojoes: folds 
blackw0lf_03: folds 
pokixy800: folds 
Uncalled bet ($1.50) returned to Sweden_Pound
Sweden_Pound collected $2.50 from pot
Sweden_Pound: doesn't show hand 
*** SUMMARY ***
Total pot $2.50 | Rake $0 
Seat 1: blackw0lf_03 (small blind) folded before Flop
Seat 2: pokixy800 (big blind) folded before Flop
Seat 3: PacPacBum folded before Flop (didn't bet)
Seat 4: Igor DoUrden folded before Flop (didn't bet)
Seat 5: ilaviiitech folded before Flop (didn't bet)
Seat 6: matiko09 folded before Flop (didn't bet)
Seat 7: Sweden_Pound collected ($2.50)
Seat 8: Filojoes (button) folded before Flop (didn't bet)





PokerStars Hand #150126107735:  Hold'em No Limit ($0.50/$1.00 USD) - 2016/03/10 13:27:50 CET [2016/03/10 7:27:50 ET]
Table 'Leuschneria II' 9-max Seat #7 is the button
Seat 1: cdv1984 ($174.21 in chips) 
Seat 2: blackw0lf_03 ($100 in chips) 
Seat 3: gudridornot ($79.20 in chips) 
Seat 4: Sweden_Pound ($138.22 in chips) 
Seat 5: RMilPoker ($106.96 in chips) 
Seat 6: matiko09 ($113.33 in chips) 
Seat 7: Plz3betMe ($46.44 in chips) 
Seat 8: UnBent022 ($100 in chips) 
Seat 9: ki11u ($100 in chips) 
UnBent022: posts small blind $0.50
ki11u: posts big blind $1
*** HOLE CARDS ***
Dealt to matiko09 [3s Tc]
cdv1984: folds 
blackw0lf_03: folds 
gudridornot: folds 
Sweden_Pound: folds 
RMilPoker: raises $2 to $3
matiko09: folds 
Plz3betMe: folds 
UnBent022: folds 
ki11u: raises $7 to $10
RMilPoker: calls $7
*** FLOP *** [Ah 2h 5c]
ki11u: bets $7
RMilPoker: calls $7
*** TURN *** [Ah 2h 5c] [4s]
ki11u: checks 
RMilPoker: bets $19
ki11u: folds 
Uncalled bet ($19) returned to RMilPoker
RMilPoker collected $32.95 from pot
RMilPoker: doesn't show hand 
*** SUMMARY ***
Total pot $34.50 | Rake $1.55 
Board [Ah 2h 5c 4s]
Seat 1: cdv1984 folded before Flop (didn't bet)
Seat 2: blackw0lf_03 folded before Flop (didn't bet)
Seat 3: gudridornot folded before Flop (didn't bet)
Seat 4: Sweden_Pound folded before Flop (didn't bet)
Seat 5: RMilPoker collected ($32.95)
Seat 6: matiko09 folded before Flop (didn't bet)
Seat 7: Plz3betMe (button) folded before Flop (didn't bet)
Seat 8: UnBent022 (small blind) folded before Flop
Seat 9: ki11u (big blind) folded on the Turn





PokerStars Hand #150126108740:  Hold'em No Limit ($0.50/$1.00 USD) - 2016/03/10 13:27:52 CET [2016/03/10 7:27:52 ET]
Table 'Saskia' 9-max Seat #5 is the button
Seat 1: Sweden_Pound ($111.51 in chips) 
Seat 2: njurg aga ($75.45 in chips) 
Seat 3: ccmaster001 ($72.64 in chips) 
Seat 4: Plz3betMe ($89.22 in chips) 
Seat 5: dreded11 ($92.16 in chips) 
Seat 6: matiko09 ($105.88 in chips) 
Seat 7: stds st ($49.06 in chips) 
Seat 8: blackw0lf_03 ($100 in chips) 
Seat 9: er13to ($118.47 in chips) 
matiko09: posts small blind $0.50
stds st: posts big blind $1
*** HOLE CARDS ***
Dealt to matiko09 [8h 9h]
blackw0lf_03: folds 
er13to has timed out
er13to: folds 
Sweden_Pound: folds 
njurg aga: folds 
ccmaster001: folds 
Plz3betMe: raises $1.50 to $2.50
dreded11: folds 
matiko09: raises $6.50 to $9
stds st: folds 
Plz3betMe: folds 
Uncalled bet ($6.50) returned to matiko09
matiko09 collected $6 from pot
matiko09: doesn't show hand 
*** SUMMARY ***
Total pot $6 | Rake $0 
Seat 1: Sweden_Pound folded before Flop (didn't bet)
Seat 2: njurg aga folded before Flop (didn't bet)
Seat 3: ccmaster001 folded before Flop (didn't bet)
Seat 4: Plz3betMe folded before Flop
Seat 5: dreded11 (button) folded before Flop (didn't bet)
Seat 6: matiko09 (small blind) collected ($6)
Seat 7: stds st (big blind) folded before Flop
Seat 8: blackw0lf_03 folded before Flop (didn't bet)
Seat 9: er13to folded before Flop (didn't bet)





PokerStars Hand #150126114298:  Hold'em No Limit ($0.50/$1.00 USD) - 2016/03/10 13:28:03 CET [2016/03/10 7:28:03 ET]
Table 'Liriope II' 9-max Seat #3 is the button
Seat 2: zxp12345 ($39.60 in chips) 
Seat 3: matiko09 ($167.43 in chips) 
Seat 4: Plz3betMe ($46.43 in chips) 
Seat 5: lumen21 ($103.68 in chips) 
Seat 6: nobu-azabu ($185.35 in chips) 
Seat 7: Sweden_Pound ($100 in chips) 
Seat 8: PacPacBum ($114.71 in chips) 
Seat 9: tipner ($116.19 in chips) 
Plz3betMe: posts small blind $0.50
lumen21: posts big blind $1
*** HOLE CARDS ***
Dealt to matiko09 [Ad 2c]
nobu-azabu: folds 
Sweden_Pound: folds 
PacPacBum: folds 
di0d80 leaves the table
cdv1984 joins the table at seat #1 
cdv1984 leaves the table
tipner has timed out
tipner: folds 
UnBent022 joins the table at seat #1 
zxp12345: calls $1
matiko09: raises $2 to $3
Plz3betMe: folds 
lumen21: folds 
zxp12345: calls $2
*** FLOP *** [Js Qh 6c]
zxp12345: checks 
matiko09: checks 
*** TURN *** [Js Qh 6c] [4c]
zxp12345: checks 
matiko09: checks 
*** RIVER *** [Js Qh 6c 4c] [8c]
zxp12345: checks 
matiko09: checks 
*** SHOW DOWN ***
zxp12345: shows [As 5h] (high card Ace)
matiko09: shows [Ad 2c] (high card Ace)
zxp12345 collected $3.58 from pot
matiko09 collected $3.58 from pot
*** SUMMARY ***
Total pot $7.50 | Rake $0.34 
Board [Js Qh 6c 4c 8c]
Seat 2: zxp12345 showed [As 5h] and won ($3.58) with high card Ace
Seat 3: matiko09 (button) showed [Ad 2c] and won ($3.58) with high card Ace
Seat 4: Plz3betMe (small blind) folded before Flop
Seat 5: lumen21 (big blind) folded before Flop
Seat 6: nobu-azabu folded before Flop (didn't bet)
Seat 7: Sweden_Pound folded before Flop (didn't bet)
Seat 8: PacPacBum folded before Flop (didn't bet)
Seat 9: tipner folded before Flop (didn't bet)





PokerStars Hand #150126120334:  Hold'em No Limit ($0.50/$1.00 USD) - 2016/03/10 13:28:14 CET [2016/03/10 7:28:14 ET]
Table 'Virgo II' 9-max Seat #2 is the button
Seat 1: cdv1984 ($189.55 in chips) 
Seat 2: Plz3betMe ($50.27 in chips) 
Seat 3: blackw0lf_03 ($100.50 in chips) 
Seat 4: UnBent022 ($101.25 in chips) 
Seat 5: stds st ($39.77 in chips) 
Seat 6: PacPacBum ($133.64 in chips) 
Seat 7: mamilets ($62.60 in chips) 
Seat 8: Sweden_Pound ($126.59 in chips) 
Seat 9: matiko09 ($100 in chips) 
blackw0lf_03: posts small blind $0.50
UnBent022: posts big blind $1
*** HOLE CARDS ***
Dealt to matiko09 [Kh Ac]
stds st: folds 
PacPacBum: folds 
mamilets: folds 
Sweden_Pound: folds 
matiko09: raises $2 to $3
cdv1984: folds 
Plz3betMe: folds 
blackw0lf_03: folds 
UnBent022: calls $2
*** FLOP *** [7d 9c 5s]
UnBent022: checks 
matiko09: checks 
*** TURN *** [7d 9c 5s] [4s]
UnBent022: bets $4.09
matiko09: folds 
Uncalled bet ($4.09) returned to UnBent022
UnBent022 collected $6.21 from pot
UnBent022: doesn't show hand 
*** SUMMARY ***
Total pot $6.50 | Rake $0.29 
Board [7d 9c 5s 4s]
Seat 1: cdv1984 folded before Flop (didn't bet)
Seat 2: Plz3betMe (button) folded before Flop (didn't bet)
Seat 3: blackw0lf_03 (small blind) folded before Flop
Seat 4: UnBent022 (big blind) collected ($6.21)
Seat 5: stds st folded before Flop (didn't bet)
Seat 6: PacPacBum folded before Flop (didn't bet)
Seat 7: mamilets folded before Flop (didn't bet)
Seat 8: Sweden_Pound folded before Flop (didn't bet)
Seat 9: matiko09 folded on the Turn





PokerStars Hand #150126123783:  Hold'em No Limit ($0.50/$1.00 USD) - 2016/03/10 13:28:21 CET [2016/03/10 7:28:21 ET]
Table 'Mars III' 9-max Seat #1 is the button
Seat 1: blackw0lf_03 ($127 in chips) 
Seat 2: pokixy800 ($64.10 in chips) 
Seat 3: PacPacBum ($108.98 in chips) 
Seat 4: Igor DoUrden ($118.41 in chips) 
Seat 5: ilaviiitech ($119.74 in chips) 
Seat 6: matiko09 ($101.85 in chips) 
Seat 7: Sweden_Pound ($101.50 in chips) 
Seat 8: Filojoes ($100 in chips) 
pokixy800: posts small blind $0.50
PacPacBum: posts big blind $1
*** HOLE CARDS ***
Dealt to matiko09 [5c 5d]
Igor DoUrden: folds 
ilaviiitech: raises $2 to $3
matiko09: folds 
Sweden_Pound: folds 
Filojoes: folds 
blackw0lf_03: folds 
pokixy800: folds 
PacPacBum: folds 
Uncalled bet ($2) returned to ilaviiitech
ilaviiitech collected $2.50 from pot
ilaviiitech: doesn't show hand 
*** SUMMARY ***
Total pot $2.50 | Rake $0 
Seat 1: blackw0lf_03 (button) folded before Flop (didn't bet)
Seat 2: pokixy800 (small blind) folded before Flop
Seat 3: PacPacBum (big blind) folded before Flop
Seat 4: Igor DoUrden folded before Flop (didn't bet)
Seat 5: ilaviiitech collected ($2.50)
Seat 6: matiko09 folded before Flop (didn't bet)
Seat 7: Sweden_Pound folded before Flop (didn't bet)
Seat 8: Filojoes folded before Flop (didn't bet)





PokerStars Hand #150126133405:  Hold'em No Limit ($0.25/$0.50 USD) - 2016/03/10 13:28:39 CET [2016/03/10 7:28:39 ET]
Table 'Aegina' 9-max Seat #2 is the button
Seat 1: BingoIng0 ($117.10 in chips) 
Seat 2: dvutavr ($110.28 in chips) 
Seat 3: Fandango1991 ($77.52 in chips) 
Seat 4: digimatical ($81.42 in chips) 
Seat 5: Ahangama ($50 in chips) 
Seat 6: matiko09 ($50 in chips) 
Seat 7: Gummio ($106.41 in chips) 
Seat 8: ardo888 ($190.02 in chips) 
Seat 9: draken08 ($125 in chips) 
Fandango1991: posts small blind $0.25
digimatical: posts big blind $0.50
BingoIng0: posts the ante $0.10
dvutavr: posts the ante $0.10
Fandango1991: posts the ante $0.10
digimatical: posts the ante $0.10
Ahangama: posts the ante $0.10
matiko09: posts the ante $0.10
Gummio: posts the ante $0.10
ardo888: posts the ante $0.10
draken08: posts the ante $0.10
*** HOLE CARDS ***
Dealt to matiko09 [Ah 7s]
Ahangama: folds 
matiko09: folds 
Gummio: folds 
ardo888: folds 
draken08: folds 
BingoIng0: folds 
dvutavr: folds 
Fandango1991: calls $0.25
digimatical: checks 
*** FLOP *** [3d Th Kc]
Fandango1991: checks 
digimatical: bets $0.50
Fandango1991: folds 
Uncalled bet ($0.50) returned to digimatical
digimatical collected $1.81 from pot
*** SUMMARY ***
Total pot $1.90 | Rake $0.09 
Board [3d Th Kc]
Seat 1: BingoIng0 folded before Flop (didn't bet)
Seat 2: dvutavr (button) folded before Flop (didn't bet)
Seat 3: Fandango1991 (small blind) folded on the Flop
Seat 4: digimatical (big blind) collected ($1.81)
Seat 5: Ahangama folded before Flop (didn't bet)
Seat 6: matiko09 folded before Flop (didn't bet)
Seat 7: Gummio folded before Flop (didn't bet)
Seat 8: ardo888 folded before Flop (didn't bet)
Seat 9: draken08 folded before Flop (didn't bet)





PokerStars Hand #150126138098:  Hold'em No Limit ($1/$2 USD) - 2016/03/10 13:28:48 CET [2016/03/10 7:28:48 ET]
Table 'Chandra II' 9-max Seat #1 is the button
Seat 1: Fish4trips ($315.43 in chips) 
Seat 2: PacPacBum ($238.51 in chips) 
Seat 3: ROLLO 888 ($225.51 in chips) 
Seat 4: tipner ($200 in chips) 
Seat 5: uibting ($71.92 in chips) 
Seat 6: stds st ($72.31 in chips) 
Seat 7: johnvu2016 ($156.58 in chips) 
Seat 8: matiko09 ($200 in chips) 
Seat 9: o.miro ($259.58 in chips) 
PacPacBum: posts small blind $1
ROLLO 888: posts big blind $2
*** HOLE CARDS ***
Dealt to matiko09 [9s 4c]
tipner: folds 
uibting: folds 
stds st: folds 
johnvu2016: folds 
matiko09: folds 
o.miro: folds 
Fish4trips: folds 
PacPacBum: folds 
Uncalled bet ($1) returned to ROLLO 888
ROLLO 888 collected $2 from pot
ROLLO 888: doesn't show hand 
*** SUMMARY ***
Total pot $2 | Rake $0 
Seat 1: Fish4trips (button) folded before Flop (didn't bet)
Seat 2: PacPacBum (small blind) folded before Flop
Seat 3: ROLLO 888 (big blind) collected ($2)
Seat 4: tipner folded before Flop (didn't bet)
Seat 5: uibting folded before Flop (didn't bet)
Seat 6: stds st folded before Flop (didn't bet)
Seat 7: johnvu2016 folded before Flop (didn't bet)
Seat 8: matiko09 folded before Flop (didn't bet)
Seat 9: o.miro folded before Flop (didn't bet)





PokerStars Hand #150126138694:  Hold'em No Limit ($0.50/$1.00 USD) - 2016/03/10 13:28:49 CET [2016/03/10 7:28:49 ET]
Table 'Mars III' 9-max Seat #2 is the button
Seat 1: blackw0lf_03 ($127 in chips) 
Seat 2: pokixy800 ($63.60 in chips) 
Seat 3: PacPacBum ($107.98 in chips) 
Seat 6: matiko09 ($101.85 in chips) 
Seat 7: Sweden_Pound ($101.50 in chips) 
Seat 8: Filojoes ($100 in chips) 
PacPacBum: posts small blind $0.50
Igor DoUrden: is sitting out 
Igor DoUrden leaves the table
ilaviiitech: is sitting out 
matiko09: posts big blind $1
*** HOLE CARDS ***
Dealt to matiko09 [Tc 2c]
ilaviiitech leaves the table
Sweden_Pound: folds 
Filojoes: folds 
blackw0lf_03: folds 
pokixy800: folds 
PacPacBum: raises $1.04 to $2.04
matiko09: folds 
Uncalled bet ($1.04) returned to PacPacBum
PacPacBum collected $2 from pot
PacPacBum: doesn't show hand 
*** SUMMARY ***
Total pot $2 | Rake $0 
Seat 1: blackw0lf_03 folded before Flop (didn't bet)
Seat 2: pokixy800 (button) folded before Flop (didn't bet)
Seat 3: PacPacBum (small blind) collected ($2)
Seat 6: matiko09 (big blind) folded before Flop
Seat 7: Sweden_Pound folded before Flop (didn't bet)
Seat 8: Filojoes folded before Flop (didn't bet)





PokerStars Hand #150126141014:  Hold'em No Limit (€1/€2 EUR) - 2016/03/10 13:28:53 CET [2016/03/10 7:28:53 ET]
Table 'Sigrid II' 9-max Seat #4 is the button
Seat 1: Gamz11 (€215.93 in chips) 
Seat 2: stds st (€76.92 in chips) 
Seat 4: Fish4trips (€200 in chips) 
Seat 5: vr188 (€81.33 in chips) 
Seat 6: azzad2007 (€202 in chips) 
Seat 7: PacPacBum (€207.67 in chips) 
Seat 8: matiko09 (€202.71 in chips) 
Seat 9: ki11u (€227.42 in chips) 
vr188: posts small blind €1
azzad2007: posts big blind €2
*** HOLE CARDS ***
Dealt to matiko09 [6d Qh]
PacPacBum: folds 
matiko09: folds 
ki11u: raises €3 to €5
Gamz11: folds 
stds st: folds 
Fish4trips: raises €10 to €15
vr188: folds 
azzad2007: folds 
ki11u: calls €10
*** FLOP *** [As 3d Qs]
ki11u: checks 
Fish4trips: bets €17.02
ki11u: folds 
Uncalled bet (€17.02) returned to Fish4trips
Fish4trips collected €31.52 from pot
Fish4trips: doesn't show hand 
*** SUMMARY ***
Total pot €33 | Rake €1.48 
Board [As 3d Qs]
Seat 1: Gamz11 folded before Flop (didn't bet)
Seat 2: stds st folded before Flop (didn't bet)
Seat 4: Fish4trips (button) collected (€31.52)
Seat 5: vr188 (small blind) folded before Flop
Seat 6: azzad2007 (big blind) folded before Flop
Seat 7: PacPacBum folded before Flop (didn't bet)
Seat 8: matiko09 folded before Flop (didn't bet)
Seat 9: ki11u folded on the Flop





PokerStars Hand #150126143238:  Hold'em No Limit ($0.50/$1.00 USD) - 2016/03/10 13:28:58 CET [2016/03/10 7:28:58 ET]
Table 'Iguassu' 9-max Seat #1 is the button
Seat 1: blackw0lf_03 ($101.50 in chips) 
Seat 2: Rocky6434 ($71.57 in chips) 
Seat 3: hammerwife ($120.43 in chips) 
Seat 4: matiko09 ($101.50 in chips) 
Seat 5: UnBent022 ($100 in chips) 
Seat 6: Igor DoUrden ($100 in chips) 
Seat 7: PacPacBum ($121.55 in chips) 
Seat 8: Sweden_Pound ($100 in chips) 
Seat 9: er13to ($100 in chips) 
Rocky6434: posts small blind $0.50
hammerwife: posts big blind $1
*** HOLE CARDS ***
Dealt to matiko09 [Qd 2h]
matiko09: folds 
UnBent022: folds 
Igor DoUrden: folds 
PacPacBum: folds 
Sweden_Pound: folds 
er13to: folds 
blackw0lf_03: folds 
Rocky6434: folds 
Uncalled bet ($0.50) returned to hammerwife
hammerwife collected $1 from pot
hammerwife: doesn't show hand 
*** SUMMARY ***
Total pot $1 | Rake $0 
Seat 1: blackw0lf_03 (button) folded before Flop (didn't bet)
Seat 2: Rocky6434 (small blind) folded before Flop
Seat 3: hammerwife (big blind) collected ($1)
Seat 4: matiko09 folded before Flop (didn't bet)
Seat 5: UnBent022 folded before Flop (didn't bet)
Seat 6: Igor DoUrden folded before Flop (didn't bet)
Seat 7: PacPacBum folded before Flop (didn't bet)
Seat 8: Sweden_Pound folded before Flop (didn't bet)
Seat 9: er13to folded before Flop (didn't bet)





PokerStars Hand #150126147880:  Hold'em No Limit ($1/$2 USD) - 2016/03/10 13:29:07 CET [2016/03/10 7:29:07 ET]
Table 'Tauris II' 9-max Seat #4 is the button
Seat 1: matiko09 ($200 in chips) 
Seat 2: stds st ($71.96 in chips) 
Seat 3: PacPacBum ($200 in chips) 
Seat 4: neomorf ($629.61 in chips) 
Seat 6: uonlylive1ce ($200 in chips) 
Seat 7: Fish4trips ($214.06 in chips) 
Seat 8: scout326 ($226.38 in chips) 
uonlylive1ce: posts small blind $1
Fish4trips: posts big blind $2
*** HOLE CARDS ***
Dealt to matiko09 [Ts As]
scout326: folds 
matiko09: raises $3 to $5
stds st: folds 
PacPacBum: folds 
neomorf: folds 
uonlylive1ce: folds 
Fish4trips: folds 
Uncalled bet ($3) returned to matiko09
matiko09 collected $5 from pot
matiko09: doesn't show hand 
*** SUMMARY ***
Total pot $5 | Rake $0 
Seat 1: matiko09 collected ($5)
Seat 2: stds st folded before Flop (didn't bet)
Seat 3: PacPacBum folded before Flop (didn't bet)
Seat 4: neomorf (button) folded before Flop (didn't bet)
Seat 6: uonlylive1ce (small blind) folded before Flop
Seat 7: Fish4trips (big blind) folded before Flop
Seat 8: scout326 folded before Flop (didn't bet)





PokerStars Hand #150126151757:  Hold'em No Limit ($1/$2 USD) - 2016/03/10 13:29:14 CET [2016/03/10 7:29:14 ET]
Table 'Chandra II' 9-max Seat #2 is the button
Seat 1: Fish4trips ($315.43 in chips) 
Seat 2: PacPacBum ($237.51 in chips) 
Seat 3: ROLLO 888 ($226.51 in chips) 
Seat 4: tipner ($200 in chips) 
Seat 5: uibting ($71.92 in chips) 
Seat 6: stds st ($72.31 in chips) 
Seat 7: johnvu2016 ($156.58 in chips) 
Seat 8: matiko09 ($200 in chips) 
Seat 9: o.miro ($259.58 in chips) 
ROLLO 888: posts small blind $1
tipner: posts big blind $2
*** HOLE CARDS ***
Dealt to matiko09 [Js Jh]
uibting: raises $2 to $4
stds st: folds 
johnvu2016: folds 
matiko09: calls $4
o.miro: folds 
Fish4trips: folds 
PacPacBum: folds 
ROLLO 888: calls $3
tipner: folds 
*** FLOP *** [4h Qs Ts]
ROLLO 888: checks 
uibting: checks 
matiko09: checks 
*** TURN *** [4h Qs Ts] [2h]
ROLLO 888: checks 
uibting: bets $6.68
matiko09: calls $6.68
ROLLO 888: raises $9.32 to $16
uibting: folds 
matiko09: calls $9.32
*** RIVER *** [4h Qs Ts 2h] [5s]
ROLLO 888: checks 
matiko09: checks 
*** SHOW DOWN ***
ROLLO 888: shows [7d Qc] (a pair of Queens)
matiko09: mucks hand 
ROLLO 888 collected $50.31 from pot
*** SUMMARY ***
Total pot $52.68 | Rake $2.37 
Board [4h Qs Ts 2h 5s]
Seat 1: Fish4trips folded before Flop (didn't bet)
Seat 2: PacPacBum (button) folded before Flop (didn't bet)
Seat 3: ROLLO 888 (small blind) showed [7d Qc] and won ($50.31) with a pair of Queens
Seat 4: tipner (big blind) folded before Flop
Seat 5: uibting folded on the Turn
Seat 6: stds st folded before Flop (didn't bet)
Seat 7: johnvu2016 folded before Flop (didn't bet)
Seat 8: matiko09 mucked [Js Jh]
Seat 9: o.miro folded before Flop (didn't bet)





PokerStars Hand #150126159477:  Hold'em No Limit ($0.50/$1.00 USD) - 2016/03/10 13:29:29 CET [2016/03/10 7:29:29 ET]
Table 'Liriope II' 9-max Seat #4 is the button
Seat 2: zxp12345 ($40.18 in chips) 
Seat 3: matiko09 ($168.01 in chips) 
Seat 4: Plz3betMe ($45.93 in chips) 
Seat 5: lumen21 ($102.68 in chips) 
Seat 6: nobu-azabu ($185.35 in chips) 
Seat 7: Sweden_Pound ($100 in chips) 
Seat 8: PacPacBum ($114.71 in chips) 
lumen21: posts small blind $0.50
nobu-azabu: posts big blind $1
UnBent022: sits out 
*** HOLE CARDS ***
Dealt to matiko09 [4s Ad]
Sweden_Pound: folds 
PacPacBum: folds 
zxp12345: folds 
matiko09: folds 
Plz3betMe: folds 
lumen21: raises $2 to $3
nobu-azabu: folds 
Uncalled bet ($2) returned to lumen21
lumen21 collected $2 from pot
lumen21: doesn't show hand 
*** SUMMARY ***
Total pot $2 | Rake $0 
Seat 2: zxp12345 folded before Flop (didn't bet)
Seat 3: matiko09 folded before Flop (didn't bet)
Seat 4: Plz3betMe (button) folded before Flop (didn't bet)
Seat 5: lumen21 (small blind) collected ($2)
Seat 6: nobu-azabu (big blind) folded before Flop
Seat 7: Sweden_Pound folded before Flop (didn't bet)
Seat 8: PacPacBum folded before Flop (didn't bet)





PokerStars Hand #150126161277:  Hold'em No Limit ($0.50/$1.00 USD) - 2016/03/10 13:29:32 CET [2016/03/10 7:29:32 ET]
Table 'Mars III' 9-max Seat #3 is the button
Seat 1: blackw0lf_03 ($127 in chips) 
Seat 2: pokixy800 ($63.60 in chips) 
Seat 3: PacPacBum ($108.98 in chips) 
Seat 6: matiko09 ($100.85 in chips) 
Seat 7: Sweden_Pound ($101.50 in chips) 
Seat 8: Filojoes ($100 in chips) 
matiko09: posts small blind $0.50
Sweden_Pound: posts big blind $1
*** HOLE CARDS ***
Dealt to matiko09 [9h Kd]
Filojoes: folds 
blackw0lf_03: folds 
pokixy800: folds 
PacPacBum: folds 
matiko09: raises $1.50 to $2.50
Sweden_Pound: folds 
Uncalled bet ($1.50) returned to matiko09
matiko09 collected $2 from pot
matiko09: doesn't show hand 
*** SUMMARY ***
Total pot $2 | Rake $0 
Seat 1: blackw0lf_03 folded before Flop (didn't bet)
Seat 2: pokixy800 folded before Flop (didn't bet)
Seat 3: PacPacBum (button) folded before Flop (didn't bet)
Seat 6: matiko09 (small blind) collected ($2)
Seat 7: Sweden_Pound (big blind) folded before Flop
Seat 8: Filojoes folded before Flop (didn't bet)





PokerStars Hand #150126162175:  Hold'em No Limit ($0.50/$1.00 USD) - 2016/03/10 13:29:34 CET [2016/03/10 7:29:34 ET]
Table 'Virgo II' 9-max Seat #3 is the button
Seat 1: cdv1984 ($189.55 in chips) 
Seat 2: Plz3betMe ($50.27 in chips) 
Seat 3: blackw0lf_03 ($100 in chips) 
Seat 4: UnBent022 ($104.46 in chips) 
Seat 5: stds st ($39.77 in chips) 
Seat 6: PacPacBum ($133.64 in chips) 
Seat 7: mamilets ($62.60 in chips) 
Seat 8: Sweden_Pound ($126.59 in chips) 
Seat 9: matiko09 ($100 in chips) 
UnBent022: posts small blind $0.50
stds st: posts big blind $1
*** HOLE CARDS ***
Dealt to matiko09 [7s 8s]
PacPacBum: folds 
mamilets has timed out
mamilets: folds 
Sweden_Pound: raises $2 to $3
matiko09: calls $3
cdv1984: folds 
Plz3betMe: folds 
blackw0lf_03: raises $9 to $12
UnBent022: folds 
stds st: folds 
Sweden_Pound: raises $16 to $28
matiko09: folds 
blackw0lf_03: folds 
Uncalled bet ($16) returned to Sweden_Pound
Sweden_Pound collected $28.50 from pot
Sweden_Pound: doesn't show hand 
*** SUMMARY ***
Total pot $28.50 | Rake $0 
Seat 1: cdv1984 folded before Flop (didn't bet)
Seat 2: Plz3betMe folded before Flop (didn't bet)
Seat 3: blackw0lf_03 (button) folded before Flop
Seat 4: UnBent022 (small blind) folded before Flop
Seat 5: stds st (big blind) folded before Flop
Seat 6: PacPacBum folded before Flop (didn't bet)
Seat 7: mamilets folded before Flop (didn't bet)
Seat 8: Sweden_Pound collected ($28.50)
Seat 9: matiko09 folded before Flop





PokerStars Hand #150126162513:  Hold'em No Limit ($0.50/$1.00 USD) - 2016/03/10 13:29:35 CET [2016/03/10 7:29:35 ET]
Table 'Iguassu' 9-max Seat #2 is the button
Seat 1: blackw0lf_03 ($101.50 in chips) 
Seat 2: Rocky6434 ($71.07 in chips) 
Seat 3: hammerwife ($120.93 in chips) 
Seat 4: matiko09 ($101.50 in chips) 
Seat 5: UnBent022 ($100 in chips) 
Seat 6: Igor DoUrden ($100 in chips) 
Seat 7: PacPacBum ($121.55 in chips) 
Seat 8: Sweden_Pound ($100 in chips) 
Seat 9: er13to ($100 in chips) 
hammerwife: posts small blind $0.50
matiko09: posts big blind $1
*** HOLE CARDS ***
Dealt to matiko09 [4h 7s]
UnBent022: folds 
Igor DoUrden: folds 
PacPacBum: folds 
Sweden_Pound: raises $2 to $3
er13to: folds 
blackw0lf_03: folds 
Rocky6434: calls $3
hammerwife: folds 
matiko09: folds 
*** FLOP *** [Jd Th 5c]
Sweden_Pound: bets $4.65
Rocky6434: calls $4.65
*** TURN *** [Jd Th 5c] [Qd]
Sweden_Pound: bets $10.43
Rocky6434: calls $10.43
*** RIVER *** [Jd Th 5c Qd] [5s]
Sweden_Pound: bets $22.50
Rocky6434: calls $22.50
*** SHOW DOWN ***
Sweden_Pound: shows [Kh As] (a straight, Ten to Ace)
Rocky6434: mucks hand 
Sweden_Pound collected $79.86 from pot
*** SUMMARY ***
Total pot $82.66 | Rake $2.80 
Board [Jd Th 5c Qd 5s]
Seat 1: blackw0lf_03 folded before Flop (didn't bet)
Seat 2: Rocky6434 (button) mucked [Jc 8c]
Seat 3: hammerwife (small blind) folded before Flop
Seat 4: matiko09 (big blind) folded before Flop
Seat 5: UnBent022 folded before Flop (didn't bet)
Seat 6: Igor DoUrden folded before Flop (didn't bet)
Seat 7: PacPacBum folded before Flop (didn't bet)
Seat 8: Sweden_Pound showed [Kh As] and won ($79.86) with a straight, Ten to Ace
Seat 9: er13to folded before Flop (didn't bet)





PokerStars Hand #150126163252:  Hold'em No Limit (€1/€2 EUR) - 2016/03/10 13:29:36 CET [2016/03/10 7:29:36 ET]
Table 'Sigrid II' 9-max Seat #5 is the button
Seat 1: Gamz11 (€215.93 in chips) 
Seat 2: stds st (€76.92 in chips) 
Seat 4: Fish4trips (€216.52 in chips) 
Seat 5: vr188 (€80.33 in chips) 
Seat 6: azzad2007 (€200 in chips) 
Seat 7: PacPacBum (€207.67 in chips) 
Seat 8: matiko09 (€202.71 in chips) 
Seat 9: ki11u (€212.42 in chips) 
azzad2007: posts small blind €1
PacPacBum: posts big blind €2
*** HOLE CARDS ***
Dealt to matiko09 [4d 3h]
matiko09: folds 
ki11u: folds 
Gamz11: folds 
stds st: folds 
Fish4trips: raises €3 to €5
vr188: folds 
azzad2007: folds 
PacPacBum: folds 
Uncalled bet (€3) returned to Fish4trips
Fish4trips collected €5 from pot
Fish4trips: doesn't show hand 
*** SUMMARY ***
Total pot €5 | Rake €0 
Seat 1: Gamz11 folded before Flop (didn't bet)
Seat 2: stds st folded before Flop (didn't bet)
Seat 4: Fish4trips collected (€5)
Seat 5: vr188 (button) folded before Flop (didn't bet)
Seat 6: azzad2007 (small blind) folded before Flop
Seat 7: PacPacBum (big blind) folded before Flop
Seat 8: matiko09 folded before Flop (didn't bet)
Seat 9: ki11u folded before Flop (didn't bet)





PokerStars Hand #150126168865:  Hold'em No Limit ($1/$2 USD) - 2016/03/10 13:29:47 CET [2016/03/10 7:29:47 ET]
Table 'Tauris II' 9-max Seat #6 is the button
Seat 1: matiko09 ($203 in chips) 
Seat 2: stds st ($71.96 in chips) 
Seat 3: PacPacBum ($200 in chips) 
Seat 4: neomorf ($629.61 in chips) 
Seat 6: uonlylive1ce ($200 in chips) 
Seat 7: Fish4trips ($212.06 in chips) 
Seat 8: scout326 ($226.38 in chips) 
Fish4trips: posts small blind $1
scout326: posts big blind $2
*** HOLE CARDS ***
Dealt to matiko09 [Kc Ts]
matiko09: folds 
stds st: folds 
PacPacBum: folds 
neomorf: raises $3.88 to $5.88
uonlylive1ce: folds 
Fish4trips: folds 
scout326: calls $3.88
*** FLOP *** [9s Qc Ad]
scout326: checks 
neomorf: checks 
*** TURN *** [9s Qc Ad] [Td]
scout326: checks 
neomorf: checks 
*** RIVER *** [9s Qc Ad Td] [8s]
scout326: checks 
neomorf: bets $8.77
scout326: folds 
Uncalled bet ($8.77) returned to neomorf
neomorf collected $12.19 from pot
neomorf: doesn't show hand 
*** SUMMARY ***
Total pot $12.76 | Rake $0.57 
Board [9s Qc Ad Td 8s]
Seat 1: matiko09 folded before Flop (didn't bet)
Seat 2: stds st folded before Flop (didn't bet)
Seat 3: PacPacBum folded before Flop (didn't bet)
Seat 4: neomorf collected ($12.19)
Seat 6: uonlylive1ce (button) folded before Flop (didn't bet)
Seat 7: Fish4trips (small blind) folded before Flop
Seat 8: scout326 (big blind) folded on the River





PokerStars Hand #150126169041:  Hold'em No Limit ($0.50/$1.00 USD) - 2016/03/10 13:29:47 CET [2016/03/10 7:29:47 ET]
Table 'Saskia' 9-max Seat #6 is the button
Seat 1: Sweden_Pound ($111.51 in chips) 
Seat 2: njurg aga ($75.45 in chips) 
Seat 3: ccmaster001 ($72.64 in chips) 
Seat 4: Plz3betMe ($86.72 in chips) 
Seat 5: dreded11 ($92.16 in chips) 
Seat 6: matiko09 ($109.38 in chips) 
Seat 7: stds st ($48.06 in chips) 
Seat 8: blackw0lf_03 ($100 in chips) 
Seat 9: er13to ($118.47 in chips) 
stds st: posts small blind $0.50
blackw0lf_03: posts big blind $1
*** HOLE CARDS ***
Dealt to matiko09 [8h As]
er13to: folds 
Sweden_Pound: folds 
njurg aga: folds 
ccmaster001: folds 
Plz3betMe: folds 
dreded11: raises $2 to $3
matiko09: folds 
stds st: folds 
blackw0lf_03: folds 
Uncalled bet ($2) returned to dreded11
dreded11 collected $2.50 from pot
dreded11: doesn't show hand 
*** SUMMARY ***
Total pot $2.50 | Rake $0 
Seat 1: Sweden_Pound folded before Flop (didn't bet)
Seat 2: njurg aga folded before Flop (didn't bet)
Seat 3: ccmaster001 folded before Flop (didn't bet)
Seat 4: Plz3betMe folded before Flop (didn't bet)
Seat 5: dreded11 collected ($2.50)
Seat 6: matiko09 (button) folded before Flop (didn't bet)
Seat 7: stds st (small blind) folded before Flop
Seat 8: blackw0lf_03 (big blind) folded before Flop
Seat 9: er13to folded before Flop (didn't bet)





PokerStars Hand #150126173748:  Hold'em No Limit (€1/€2 EUR) - 2016/03/10 13:29:56 CET [2016/03/10 7:29:56 ET]
Table 'Sigrid II' 9-max Seat #6 is the button
Seat 1: Gamz11 (€215.93 in chips) 
Seat 2: stds st (€76.92 in chips) 
Seat 4: Fish4trips (€219.52 in chips) 
Seat 5: vr188 (€80.33 in chips) 
Seat 6: azzad2007 (€200 in chips) 
Seat 7: PacPacBum (€205.67 in chips) 
Seat 8: matiko09 (€202.71 in chips) 
Seat 9: ki11u (€212.42 in chips) 
PacPacBum: posts small blind €1
matiko09: posts big blind €2
*** HOLE CARDS ***
Dealt to matiko09 [6d Qc]
ki11u: folds 
Gamz11: folds 
stds st: folds 
Fish4trips: folds 
vr188: folds 
azzad2007: folds 
PacPacBum: raises €2.08 to €4.08
matiko09: folds 
Uncalled bet (€2.08) returned to PacPacBum
PacPacBum collected €4 from pot
PacPacBum: doesn't show hand 
*** SUMMARY ***
Total pot €4 | Rake €0 
Seat 1: Gamz11 folded before Flop (didn't bet)
Seat 2: stds st folded before Flop (didn't bet)
Seat 4: Fish4trips folded before Flop (didn't bet)
Seat 5: vr188 folded before Flop (didn't bet)
Seat 6: azzad2007 (button) folded before Flop (didn't bet)
Seat 7: PacPacBum (small blind) collected (€4)
Seat 8: matiko09 (big blind) folded before Flop
Seat 9: ki11u folded before Flop (didn't bet)





PokerStars Hand #150126176810:  Hold'em No Limit ($0.50/$1.00 USD) - 2016/03/10 13:30:02 CET [2016/03/10 7:30:02 ET]
Table 'Liriope II' 9-max Seat #5 is the button
Seat 2: zxp12345 ($40.18 in chips) 
Seat 3: matiko09 ($168.01 in chips) 
Seat 4: Plz3betMe ($45.93 in chips) 
Seat 5: lumen21 ($103.68 in chips) 
Seat 6: nobu-azabu ($184.35 in chips) 
Seat 7: Sweden_Pound ($100 in chips) 
Seat 8: PacPacBum ($114.71 in chips) 
nobu-azabu: posts small blind $0.50
Sweden_Pound: posts big blind $1
UnBent022: sits out 
*** HOLE CARDS ***
Dealt to matiko09 [Ad 2c]
PacPacBum: folds 
zxp12345: raises $2 to $3
matiko09: folds 
Plz3betMe: folds 
lumen21: folds 
nobu-azabu: folds 
Sweden_Pound: folds 
Uncalled bet ($2) returned to zxp12345
zxp12345 collected $2.50 from pot
zxp12345: doesn't show hand 
*** SUMMARY ***
Total pot $2.50 | Rake $0 
Seat 2: zxp12345 collected ($2.50)
Seat 3: matiko09 folded before Flop (didn't bet)
Seat 4: Plz3betMe folded before Flop (didn't bet)
Seat 5: lumen21 (button) folded before Flop (didn't bet)
Seat 6: nobu-azabu (small blind) folded before Flop
Seat 7: Sweden_Pound (big blind) folded before Flop
Seat 8: PacPacBum folded before Flop (didn't bet)





PokerStars Hand #150126181515:  Hold'em No Limit ($0.50/$1.00 USD) - 2016/03/10 13:30:11 CET [2016/03/10 7:30:11 ET]
Table 'Mars III' 9-max Seat #6 is the button
Seat 1: blackw0lf_03 ($127 in chips) 
Seat 2: pokixy800 ($63.60 in chips) 
Seat 3: PacPacBum ($108.98 in chips) 
Seat 6: matiko09 ($101.85 in chips) 
Seat 7: Sweden_Pound ($100.50 in chips) 
Seat 8: Filojoes ($100 in chips) 
Sweden_Pound: posts small blind $0.50
Filojoes: posts big blind $1
*** HOLE CARDS ***
Dealt to matiko09 [2c 3h]
blackw0lf_03: raises $2 to $3
pokixy800: folds 
ki11u joins the table at seat #4 
PacPacBum: folds 
matiko09: folds 
Sweden_Pound: folds 
Filojoes: folds 
Uncalled bet ($2) returned to blackw0lf_03
blackw0lf_03 collected $2.50 from pot
blackw0lf_03: doesn't show hand 
*** SUMMARY ***
Total pot $2.50 | Rake $0 
Seat 1: blackw0lf_03 collected ($2.50)
Seat 2: pokixy800 folded before Flop (didn't bet)
Seat 3: PacPacBum folded before Flop (didn't bet)
Seat 6: matiko09 (button) folded before Flop (didn't bet)
Seat 7: Sweden_Pound (small blind) folded before Flop
Seat 8: Filojoes (big blind) folded before Flop





PokerStars Hand #150126181927:  Hold'em No Limit ($0.50/$1.00 USD) - 2016/03/10 13:30:11 CET [2016/03/10 7:30:11 ET]
Table 'Leuschneria II' 9-max Seat #8 is the button
Seat 2: blackw0lf_03 ($100 in chips) 
Seat 3: gudridornot ($79.20 in chips) 
Seat 4: Sweden_Pound ($138.22 in chips) 
Seat 5: RMilPoker ($122.91 in chips) 
Seat 6: matiko09 ($113.33 in chips) 
Seat 7: Plz3betMe ($46.44 in chips) 
Seat 8: UnBent022 ($100 in chips) 
Seat 9: ki11u ($100 in chips) 
ki11u: posts small blind $0.50
cdv1984: is sitting out 
blackw0lf_03: posts big blind $1
*** HOLE CARDS ***
Dealt to matiko09 [Jd 5d]
cdv1984 leaves the table
gudridornot: calls $1
Sweden_Pound: folds 
RMilPoker: folds 
matiko09: folds 
Plz3betMe: folds 
UnBent022: folds 
ki11u: folds 
blackw0lf_03: checks 
*** FLOP *** [4c 4d 2d]
blackw0lf_03: checks 
gudridornot: bets $6
blackw0lf_03: folds 
Uncalled bet ($6) returned to gudridornot
gudridornot collected $2.39 from pot
gudridornot: doesn't show hand 
*** SUMMARY ***
Total pot $2.50 | Rake $0.11 
Board [4c 4d 2d]
Seat 2: blackw0lf_03 (big blind) folded on the Flop
Seat 3: gudridornot collected ($2.39)
Seat 4: Sweden_Pound folded before Flop (didn't bet)
Seat 5: RMilPoker folded before Flop (didn't bet)
Seat 6: matiko09 folded before Flop (didn't bet)
Seat 7: Plz3betMe folded before Flop (didn't bet)
Seat 8: UnBent022 (button) folded before Flop (didn't bet)
Seat 9: ki11u (small blind) folded before Flop





PokerStars Hand #150126185065:  Hold'em No Limit ($0.50/$1.00 USD) - 2016/03/10 13:30:17 CET [2016/03/10 7:30:17 ET]
Table 'Saskia' 9-max Seat #7 is the button
Seat 1: Sweden_Pound ($111.51 in chips) 
Seat 2: njurg aga ($75.45 in chips) 
Seat 3: ccmaster001 ($72.64 in chips) 
Seat 4: Plz3betMe ($86.72 in chips) 
Seat 5: dreded11 ($93.66 in chips) 
Seat 6: matiko09 ($109.38 in chips) 
Seat 7: stds st ($47.56 in chips) 
Seat 8: blackw0lf_03 ($100 in chips) 
Seat 9: er13to ($118.47 in chips) 
blackw0lf_03: posts small blind $0.50
er13to: posts big blind $1
*** HOLE CARDS ***
Dealt to matiko09 [Td Jc]
Sweden_Pound: folds 
njurg aga: folds 
ccmaster001: raises $1 to $2
Plz3betMe: folds 
dreded11: folds 
matiko09: folds 
stds st: folds 
blackw0lf_03: raises $6 to $8
er13to: folds 
ccmaster001: folds 
Uncalled bet ($6) returned to blackw0lf_03
blackw0lf_03 collected $5 from pot
blackw0lf_03: doesn't show hand 
*** SUMMARY ***
Total pot $5 | Rake $0 
Seat 1: Sweden_Pound folded before Flop (didn't bet)
Seat 2: njurg aga folded before Flop (didn't bet)
Seat 3: ccmaster001 folded before Flop
Seat 4: Plz3betMe folded before Flop (didn't bet)
Seat 5: dreded11 folded before Flop (didn't bet)
Seat 6: matiko09 folded before Flop (didn't bet)
Seat 7: stds st (button) folded before Flop (didn't bet)
Seat 8: blackw0lf_03 (small blind) collected ($5)
Seat 9: er13to (big blind) folded before Flop





PokerStars Hand #150126188547:  Hold'em No Limit ($0.25/$0.50 USD) - 2016/03/10 13:30:24 CET [2016/03/10 7:30:24 ET]
Table 'Aegina' 9-max Seat #3 is the button
Seat 1: BingoIng0 ($117 in chips) 
Seat 2: dvutavr ($110.18 in chips) 
Seat 3: Fandango1991 ($76.92 in chips) 
Seat 4: digimatical ($82.63 in chips) 
Seat 5: Ahangama ($50 in chips) 
Seat 6: matiko09 ($50 in chips) 
Seat 7: Gummio ($106.31 in chips) 
Seat 8: ardo888 ($189.92 in chips) 
Seat 9: draken08 ($125 in chips) 
digimatical: posts small blind $0.25
Ahangama: posts big blind $0.50
BingoIng0: posts the ante $0.10
dvutavr: posts the ante $0.10
Fandango1991: posts the ante $0.10
digimatical: posts the ante $0.10
Ahangama: posts the ante $0.10
matiko09: posts the ante $0.10
Gummio: posts the ante $0.10
ardo888: posts the ante $0.10
draken08: posts the ante $0.10
*** HOLE CARDS ***
Dealt to matiko09 [2c 6d]
matiko09: folds 
Gummio: folds 
ardo888: folds 
draken08: raises $1 to $1.50
BingoIng0: folds 
dvutavr: folds 
Fandango1991 has timed out
Fandango1991: folds 
digimatical: folds 
Ahangama: calls $1
*** FLOP *** [As Jh Qd]
Ahangama: checks 
draken08: checks 
*** TURN *** [As Jh Qd] [Kd]
Ahangama: checks 
draken08: bets $2.63
Ahangama: folds 
Uncalled bet ($2.63) returned to draken08
draken08 collected $3.96 from pot
draken08: doesn't show hand 
*** SUMMARY ***
Total pot $4.15 | Rake $0.19 
Board [As Jh Qd Kd]
Seat 1: BingoIng0 folded before Flop (didn't bet)
Seat 2: dvutavr folded before Flop (didn't bet)
Seat 3: Fandango1991 (button) folded before Flop (didn't bet)
Seat 4: digimatical (small blind) folded before Flop
Seat 5: Ahangama (big blind) folded on the Turn
Seat 6: matiko09 folded before Flop (didn't bet)
Seat 7: Gummio folded before Flop (didn't bet)
Seat 8: ardo888 folded before Flop (didn't bet)
Seat 9: draken08 collected ($3.96)





PokerStars Hand #150126192305:  Hold'em No Limit (€1/€2 EUR) - 2016/03/10 13:30:31 CET [2016/03/10 7:30:31 ET]
Table 'Sigrid II' 9-max Seat #7 is the button
Seat 1: Gamz11 (€215.93 in chips) 
Seat 2: stds st (€76.92 in chips) 
Seat 4: Fish4trips (€219.52 in chips) 
Seat 5: vr188 (€80.33 in chips) 
Seat 6: azzad2007 (€200 in chips) 
Seat 7: PacPacBum (€207.67 in chips) 
Seat 8: matiko09 (€200.71 in chips) 
Seat 9: ki11u (€212.42 in chips) 
matiko09: posts small blind €1
ki11u: posts big blind €2
*** HOLE CARDS ***
Dealt to matiko09 [7s 3c]
Gamz11: folds 
stds st: folds 
Fish4trips: folds 
vr188: folds 
azzad2007: raises €3 to €5
PacPacBum: folds 
matiko09: folds 
ki11u: folds 
Uncalled bet (€3) returned to azzad2007
azzad2007 collected €5 from pot
azzad2007: doesn't show hand 
*** SUMMARY ***
Total pot €5 | Rake €0 
Seat 1: Gamz11 folded before Flop (didn't bet)
Seat 2: stds st folded before Flop (didn't bet)
Seat 4: Fish4trips folded before Flop (didn't bet)
Seat 5: vr188 folded before Flop (didn't bet)
Seat 6: azzad2007 collected (€5)
Seat 7: PacPacBum (button) folded before Flop (didn't bet)
Seat 8: matiko09 (small blind) folded before Flop
Seat 9: ki11u (big blind) folded before Flop





PokerStars Hand #150126199813:  Hold'em No Limit ($0.50/$1.00 USD) - 2016/03/10 13:30:45 CET [2016/03/10 7:30:45 ET]
Table 'Liriope II' 9-max Seat #6 is the button
Seat 2: zxp12345 ($41.68 in chips) 
Seat 3: matiko09 ($168.01 in chips) 
Seat 4: Plz3betMe ($45.93 in chips) 
Seat 5: lumen21 ($103.68 in chips) 
Seat 6: nobu-azabu ($183.85 in chips) 
Seat 7: Sweden_Pound ($100 in chips) 
Seat 8: PacPacBum ($114.71 in chips) 
Sweden_Pound: posts small blind $0.50
PacPacBum: posts big blind $1
UnBent022: sits out 
*** HOLE CARDS ***
Dealt to matiko09 [9d 7h]
zxp12345: calls $1
matiko09: folds 
Plz3betMe: folds 
lumen21: folds 
nobu-azabu: calls $1
Sweden_Pound: folds 
PacPacBum: checks 
*** FLOP *** [Qc Th Kc]
PacPacBum: checks 
zxp12345: checks 
nobu-azabu: bets $1
PacPacBum: folds 
zxp12345: calls $1
*** TURN *** [Qc Th Kc] [2c]
zxp12345: checks 
nobu-azabu: bets $3
zxp12345: folds 
Uncalled bet ($3) returned to nobu-azabu
nobu-azabu collected $5.25 from pot
nobu-azabu: doesn't show hand 
*** SUMMARY ***
Total pot $5.50 | Rake $0.25 
Board [Qc Th Kc 2c]
Seat 2: zxp12345 folded on the Turn
Seat 3: matiko09 folded before Flop (didn't bet)
Seat 4: Plz3betMe folded before Flop (didn't bet)
Seat 5: lumen21 folded before Flop (didn't bet)
Seat 6: nobu-azabu (button) collected ($5.25)
Seat 7: Sweden_Pound (small blind) folded before Flop
Seat 8: PacPacBum (big blind) folded on the Flop





PokerStars Hand #150126202560:  Hold'em No Limit ($0.50/$1.00 USD) - 2016/03/10 13:30:50 CET [2016/03/10 7:30:50 ET]
Table 'Mars III' 9-max Seat #7 is the button
Seat 1: blackw0lf_03 ($128.50 in chips) 
Seat 2: pokixy800 ($63.60 in chips) 
Seat 3: PacPacBum ($108.98 in chips) 
Seat 6: matiko09 ($101.85 in chips) 
Seat 7: Sweden_Pound ($100 in chips) 
Seat 8: Filojoes ($100 in chips) 
Filojoes: posts small blind $0.50
blackw0lf_03: posts big blind $1
ki11u: sits out 
*** HOLE CARDS ***
Dealt to matiko09 [Jh 9h]
pokixy800: folds 
PacPacBum: raises $1.04 to $2.04
Slash3r joins the table at seat #5 
matiko09: folds 
Sweden_Pound: folds 
Filojoes: folds 
blackw0lf_03: folds 
Uncalled bet ($1.04) returned to PacPacBum
PacPacBum collected $2.50 from pot
PacPacBum: doesn't show hand 
*** SUMMARY ***
Total pot $2.50 | Rake $0 
Seat 1: blackw0lf_03 (big blind) folded before Flop
Seat 2: pokixy800 folded before Flop (didn't bet)
Seat 3: PacPacBum collected ($2.50)
Seat 6: matiko09 folded before Flop (didn't bet)
Seat 7: Sweden_Pound (button) folded before Flop (didn't bet)
Seat 8: Filojoes (small blind) folded before Flop





PokerStars Hand #150126202435:  Hold'em No Limit (€1/€2 EUR) - 2016/03/10 13:30:50 CET [2016/03/10 7:30:50 ET]
Table 'Sigrid II' 9-max Seat #8 is the button
Seat 1: Gamz11 (€215.93 in chips) 
Seat 2: stds st (€76.92 in chips) 
Seat 4: Fish4trips (€219.52 in chips) 
Seat 5: vr188 (€80.33 in chips) 
Seat 6: azzad2007 (€203 in chips) 
Seat 7: PacPacBum (€207.67 in chips) 
Seat 8: matiko09 (€200 in chips) 
Seat 9: ki11u (€210.42 in chips) 
ki11u: posts small blind €1
Gamz11: posts big blind €2
*** HOLE CARDS ***
Dealt to matiko09 [8h 6s]
stds st: folds 
Fish4trips: raises €3 to €5
vr188: folds 
azzad2007: folds 
PacPacBum: folds 
matiko09: folds 
ki11u: calls €4
Gamz11: folds 
*** FLOP *** [2c 8s Jc]
ki11u: checks 
Fish4trips: checks 
*** TURN *** [2c 8s Jc] [Ts]
ki11u: checks 
Fish4trips: checks 
*** RIVER *** [2c 8s Jc Ts] [2d]
ki11u: checks 
Fish4trips: bets €7
ki11u: calls €7
*** SHOW DOWN ***
Fish4trips: shows [3d Ad] (a pair of Deuces)
ki11u: shows [9s 9c] (two pair, Nines and Deuces)
ki11u collected €24.83 from pot
*** SUMMARY ***
Total pot €26 | Rake €1.17 
Board [2c 8s Jc Ts 2d]
Seat 1: Gamz11 (big blind) folded before Flop
Seat 2: stds st folded before Flop (didn't bet)
Seat 4: Fish4trips showed [3d Ad] and lost with a pair of Deuces
Seat 5: vr188 folded before Flop (didn't bet)
Seat 6: azzad2007 folded before Flop (didn't bet)
Seat 7: PacPacBum folded before Flop (didn't bet)
Seat 8: matiko09 (button) folded before Flop (didn't bet)
Seat 9: ki11u (small blind) showed [9s 9c] and won (€24.83) with two pair, Nines and Deuces





PokerStars Hand #150126205056:  Hold'em No Limit ($0.50/$1.00 USD) - 2016/03/10 13:30:55 CET [2016/03/10 7:30:55 ET]
Table 'Virgo II' 9-max Seat #4 is the button
Seat 1: cdv1984 ($189.55 in chips) 
Seat 2: Plz3betMe ($50.27 in chips) 
Seat 3: blackw0lf_03 ($100 in chips) 
Seat 4: UnBent022 ($103.96 in chips) 
Seat 5: stds st ($38.77 in chips) 
Seat 6: PacPacBum ($133.64 in chips) 
Seat 7: mamilets ($62.60 in chips) 
Seat 8: Sweden_Pound ($143.09 in chips) 
Seat 9: matiko09 ($100 in chips) 
stds st: posts small blind $0.50
PacPacBum: posts big blind $1
*** HOLE CARDS ***
Dealt to matiko09 [3c 4s]
mamilets: folds 
Sweden_Pound: raises $2 to $3
matiko09: folds 
cdv1984: folds 
Plz3betMe: raises $4.50 to $7.50
blackw0lf_03: folds 
UnBent022: folds 
stds st: folds 
PacPacBum: folds 
Sweden_Pound: folds 
Uncalled bet ($4.50) returned to Plz3betMe
Plz3betMe collected $7.50 from pot
Plz3betMe: doesn't show hand 
*** SUMMARY ***
Total pot $7.50 | Rake $0 
Seat 1: cdv1984 folded before Flop (didn't bet)
Seat 2: Plz3betMe collected ($7.50)
Seat 3: blackw0lf_03 folded before Flop (didn't bet)
Seat 4: UnBent022 (button) folded before Flop (didn't bet)
Seat 5: stds st (small blind) folded before Flop
Seat 6: PacPacBum (big blind) folded before Flop
Seat 7: mamilets folded before Flop (didn't bet)
Seat 8: Sweden_Pound folded before Flop
Seat 9: matiko09 folded before Flop (didn't bet)





PokerStars Hand #150126213160:  Hold'em No Limit ($0.50/$1.00 USD) - 2016/03/10 13:31:10 CET [2016/03/10 7:31:10 ET]
Table 'Iguassu' 9-max Seat #3 is the button
Seat 1: blackw0lf_03 ($101.50 in chips) 
Seat 2: Rocky6434 ($30.49 in chips) 
Seat 3: hammerwife ($120.43 in chips) 
Seat 4: matiko09 ($100.50 in chips) 
Seat 5: UnBent022 ($100 in chips) 
Seat 6: Igor DoUrden ($100 in chips) 
Seat 7: PacPacBum ($121.55 in chips) 
Seat 8: Sweden_Pound ($139.28 in chips) 
Seat 9: er13to ($100 in chips) 
matiko09: posts small blind $0.50
UnBent022: posts big blind $1
*** HOLE CARDS ***
Dealt to matiko09 [6h 4c]
Igor DoUrden: folds 
PacPacBum: folds 
Sweden_Pound: folds 
er13to: folds 
blackw0lf_03: folds 
Rocky6434: folds 
hammerwife: raises $1.01 to $2.01
matiko09: folds 
UnBent022: folds 
Uncalled bet ($1.01) returned to hammerwife
hammerwife collected $2.50 from pot
hammerwife: doesn't show hand 
*** SUMMARY ***
Total pot $2.50 | Rake $0 
Seat 1: blackw0lf_03 folded before Flop (didn't bet)
Seat 2: Rocky6434 folded before Flop (didn't bet)
Seat 3: hammerwife (button) collected ($2.50)
Seat 4: matiko09 (small blind) folded before Flop
Seat 5: UnBent022 (big blind) folded before Flop
Seat 6: Igor DoUrden folded before Flop (didn't bet)
Seat 7: PacPacBum folded before Flop (didn't bet)
Seat 8: Sweden_Pound folded before Flop (didn't bet)
Seat 9: er13to folded before Flop (didn't bet)





PokerStars Hand #150126213678:  Hold'em No Limit ($0.50/$1.00 USD) - 2016/03/10 13:31:11 CET [2016/03/10 7:31:11 ET]
Table 'Leuschneria II' 9-max Seat #9 is the button
Seat 2: blackw0lf_03 ($100 in chips) 
Seat 3: gudridornot ($80.59 in chips) 
Seat 4: Sweden_Pound ($138.22 in chips) 
Seat 5: RMilPoker ($122.91 in chips) 
Seat 6: matiko09 ($113.33 in chips) 
Seat 7: Plz3betMe ($46.44 in chips) 
Seat 8: UnBent022 ($100 in chips) 
Seat 9: ki11u ($100 in chips) 
blackw0lf_03: posts small blind $0.50
gudridornot: posts big blind $1
*** HOLE CARDS ***
Dealt to matiko09 [4c 7h]
cdv1984 joins the table at seat #1 
cdv1984 leaves the table
Sweden_Pound: folds 
RMilPoker: folds 
matiko09: folds 
Plz3betMe: folds 
UnBent022: raises $1.50 to $2.50
ki11u: folds 
SHARKFIN168 joins the table at seat #1 
blackw0lf_03: folds 
gudridornot: calls $1.50
*** FLOP *** [6s Kh 6c]
gudridornot: checks 
UnBent022: bets $3.62
gudridornot: folds 
Uncalled bet ($3.62) returned to UnBent022
UnBent022 collected $5.25 from pot
UnBent022: doesn't show hand 
*** SUMMARY ***
Total pot $5.50 | Rake $0.25 
Board [6s Kh 6c]
Seat 2: blackw0lf_03 (small blind) folded before Flop
Seat 3: gudridornot (big blind) folded on the Flop
Seat 4: Sweden_Pound folded before Flop (didn't bet)
Seat 5: RMilPoker folded before Flop (didn't bet)
Seat 6: matiko09 folded before Flop (didn't bet)
Seat 7: Plz3betMe folded before Flop (didn't bet)
Seat 8: UnBent022 collected ($5.25)
Seat 9: ki11u (button) folded before Flop (didn't bet)





PokerStars Hand #150126215130:  Hold'em No Limit ($1/$2 USD) - 2016/03/10 13:31:14 CET [2016/03/10 7:31:14 ET]
Table 'Chandra II' 9-max Seat #3 is the button
Seat 1: Fish4trips ($315.43 in chips) 
Seat 2: PacPacBum ($237.51 in chips) 
Seat 3: ROLLO 888 ($256.82 in chips) 
Seat 4: tipner ($200 in chips) 
Seat 5: uibting ($61.24 in chips) 
Seat 6: stds st ($72.31 in chips) 
Seat 7: johnvu2016 ($156.58 in chips) 
Seat 8: matiko09 ($200 in chips) 
Seat 9: o.miro ($259.58 in chips) 
tipner: posts small blind $1
uibting: posts big blind $2
*** HOLE CARDS ***
Dealt to matiko09 [Ah 3s]
stds st: folds 
johnvu2016: raises $4 to $6
matiko09: folds 
o.miro: folds 
Fish4trips: folds 
PacPacBum: folds 
ROLLO 888: folds 
tipner: folds 
uibting: calls $4
*** FLOP *** [2d 2h 5c]
uibting: checks 
johnvu2016: checks 
*** TURN *** [2d 2h 5c] [6s]
uibting: checks 
johnvu2016: bets $6.21
uibting: calls $6.21
*** RIVER *** [2d 2h 5c 6s] [9h]
uibting: checks 
johnvu2016: bets $24.28
uibting: folds 
Uncalled bet ($24.28) returned to johnvu2016
johnvu2016 collected $24.28 from pot
*** SUMMARY ***
Total pot $25.42 | Rake $1.14 
Board [2d 2h 5c 6s 9h]
Seat 1: Fish4trips folded before Flop (didn't bet)
Seat 2: PacPacBum folded before Flop (didn't bet)
Seat 3: ROLLO 888 (button) folded before Flop (didn't bet)
Seat 4: tipner (small blind) folded before Flop
Seat 5: uibting (big blind) folded on the River
Seat 6: stds st folded before Flop (didn't bet)
Seat 7: johnvu2016 collected ($24.28)
Seat 8: matiko09 folded before Flop (didn't bet)
Seat 9: o.miro folded before Flop (didn't bet)





PokerStars Hand #150126215622:  Hold'em No Limit ($1/$2 USD) - 2016/03/10 13:31:15 CET [2016/03/10 7:31:15 ET]
Table 'Tauris II' 9-max Seat #7 is the button
Seat 1: matiko09 ($203 in chips) 
Seat 2: stds st ($71.96 in chips) 
Seat 3: PacPacBum ($200 in chips) 
Seat 4: neomorf ($635.92 in chips) 
Seat 6: uonlylive1ce ($200 in chips) 
Seat 7: Fish4trips ($211.06 in chips) 
Seat 8: scout326 ($220.50 in chips) 
scout326: posts small blind $1
matiko09: posts big blind $2
*** HOLE CARDS ***
Dealt to matiko09 [4h 5d]
stds st: folds 
PacPacBum: folds 
neomorf: raises $3.88 to $5.88
uonlylive1ce: folds 
Fish4trips: folds 
scout326: raises $14.12 to $20
matiko09: folds 
neomorf: folds 
Uncalled bet ($14.12) returned to scout326
scout326 collected $13.76 from pot
*** SUMMARY ***
Total pot $13.76 | Rake $0 
Seat 1: matiko09 (big blind) folded before Flop
Seat 2: stds st folded before Flop (didn't bet)
Seat 3: PacPacBum folded before Flop (didn't bet)
Seat 4: neomorf folded before Flop
Seat 6: uonlylive1ce folded before Flop (didn't bet)
Seat 7: Fish4trips (button) folded before Flop (didn't bet)
Seat 8: scout326 (small blind) collected ($13.76)





PokerStars Hand #150126217820:  Hold'em No Limit ($0.50/$1.00 USD) - 2016/03/10 13:31:19 CET [2016/03/10 7:31:19 ET]
Table 'Saskia' 9-max Seat #8 is the button
Seat 1: Sweden_Pound ($111.51 in chips) 
Seat 2: njurg aga ($75.45 in chips) 
Seat 3: ccmaster001 ($70.64 in chips) 
Seat 4: Plz3betMe ($86.72 in chips) 
Seat 5: dreded11 ($93.66 in chips) 
Seat 6: matiko09 ($109.38 in chips) 
Seat 7: stds st ($47.56 in chips) 
Seat 8: blackw0lf_03 ($103 in chips) 
Seat 9: er13to ($117.47 in chips) 
er13to: posts small blind $0.50
Sweden_Pound: posts big blind $1
*** HOLE CARDS ***
Dealt to matiko09 [9s 6h]
njurg aga: folds 
ccmaster001: folds 
Plz3betMe: raises $2 to $3
dreded11: raises $7.50 to $10.50
matiko09: folds 
stds st: folds 
blackw0lf_03: folds 
er13to: folds 
Sweden_Pound: folds 
Plz3betMe: folds 
Uncalled bet ($7.50) returned to dreded11
dreded11 collected $7.50 from pot
dreded11: doesn't show hand 
*** SUMMARY ***
Total pot $7.50 | Rake $0 
Seat 1: Sweden_Pound (big blind) folded before Flop
Seat 2: njurg aga folded before Flop (didn't bet)
Seat 3: ccmaster001 folded before Flop (didn't bet)
Seat 4: Plz3betMe folded before Flop
Seat 5: dreded11 collected ($7.50)
Seat 6: matiko09 folded before Flop (didn't bet)
Seat 7: stds st folded before Flop (didn't bet)
Seat 8: blackw0lf_03 (button) folded before Flop (didn't bet)
Seat 9: er13to (small blind) folded before Flop





PokerStars Hand #150126224464:  Hold'em No Limit ($0.50/$1.00 USD) - 2016/03/10 13:31:32 CET [2016/03/10 7:31:32 ET]
Table 'Mars III' 9-max Seat #8 is the button
Seat 1: blackw0lf_03 ($127.50 in chips) 
Seat 2: pokixy800 ($63.60 in chips) 
Seat 3: PacPacBum ($110.48 in chips) 
Seat 5: Slash3r ($64.53 in chips) 
Seat 6: matiko09 ($101.85 in chips) 
Seat 7: Sweden_Pound ($100 in chips) 
Seat 8: Filojoes ($100 in chips) 
flk.Dasas will be allowed to play after the button
blackw0lf_03: posts small blind $0.50
pokixy800: posts big blind $1
ki11u: sits out 
Slash3r: posts big blind $1
*** HOLE CARDS ***
Dealt to matiko09 [6s 5s]
PacPacBum: folds 
Slash3r: raises $1 to $2
matiko09: folds 
Sweden_Pound: folds 
Filojoes: calls $2
blackw0lf_03: calls $1.50
pokixy800: folds 
*** FLOP *** [5c Qh 8c]
blackw0lf_03: checks 
Slash3r: bets $3
Filojoes: calls $3
blackw0lf_03: folds 
*** TURN *** [5c Qh 8c] [9c]
Slash3r: bets $5
Filojoes: folds 
Uncalled bet ($5) returned to Slash3r
Slash3r collected $12.42 from pot
Slash3r: doesn't show hand 
*** SUMMARY ***
Total pot $13 | Rake $0.58 
Board [5c Qh 8c 9c]
Seat 1: blackw0lf_03 (small blind) folded on the Flop
Seat 2: pokixy800 (big blind) folded before Flop
Seat 3: PacPacBum folded before Flop (didn't bet)
Seat 5: Slash3r collected ($12.42)
Seat 6: matiko09 folded before Flop (didn't bet)
Seat 7: Sweden_Pound folded before Flop (didn't bet)
Seat 8: Filojoes (button) folded on the Turn





PokerStars Hand #150126224964:  Hold'em No Limit ($0.50/$1.00 USD) - 2016/03/10 13:31:33 CET [2016/03/10 7:31:33 ET]
Table 'Virgo II' 9-max Seat #5 is the button
Seat 1: cdv1984 ($189.55 in chips) 
Seat 2: Plz3betMe ($54.77 in chips) 
Seat 3: blackw0lf_03 ($100 in chips) 
Seat 4: UnBent022 ($103.96 in chips) 
Seat 5: stds st ($38.27 in chips) 
Seat 6: PacPacBum ($132.64 in chips) 
Seat 7: mamilets ($62.60 in chips) 
Seat 8: Sweden_Pound ($140.09 in chips) 
Seat 9: matiko09 ($100 in chips) 
PacPacBum: posts small blind $0.50
mamilets: posts big blind $1
*** HOLE CARDS ***
Dealt to matiko09 [7d 5d]
Sweden_Pound: folds 
matiko09: folds 
cdv1984: folds 
Plz3betMe: folds 
blackw0lf_03: raises $2 to $3
UnBent022: folds 
stds st: folds 
PacPacBum: folds 
mamilets: folds 
Uncalled bet ($2) returned to blackw0lf_03
blackw0lf_03 collected $2.50 from pot
blackw0lf_03: doesn't show hand 
*** SUMMARY ***
Total pot $2.50 | Rake $0 
Seat 1: cdv1984 folded before Flop (didn't bet)
Seat 2: Plz3betMe folded before Flop (didn't bet)
Seat 3: blackw0lf_03 collected ($2.50)
Seat 4: UnBent022 folded before Flop (didn't bet)
Seat 5: stds st (button) folded before Flop (didn't bet)
Seat 6: PacPacBum (small blind) folded before Flop
Seat 7: mamilets (big blind) folded before Flop
Seat 8: Sweden_Pound folded before Flop (didn't bet)
Seat 9: matiko09 folded before Flop (didn't bet)





PokerStars Hand #150126233004:  Hold'em No Limit ($1/$2 USD) - 2016/03/10 13:31:48 CET [2016/03/10 7:31:48 ET]
Table 'Tauris II' 9-max Seat #8 is the button
Seat 1: matiko09 ($201 in chips) 
Seat 2: stds st ($71.96 in chips) 
Seat 3: PacPacBum ($200 in chips) 
Seat 4: neomorf ($630.04 in chips) 
Seat 6: uonlylive1ce ($200 in chips) 
Seat 7: Fish4trips ($211.06 in chips) 
Seat 8: scout326 ($228.38 in chips) 
matiko09: posts small blind $1
stds st: posts big blind $2
*** HOLE CARDS ***
Dealt to matiko09 [7c Kh]
PacPacBum: folds 
neomorf: folds 
uonlylive1ce: folds 
Fish4trips: folds 
scout326: raises $2 to $4
matiko09: folds 
stds st: folds 
Uncalled bet ($2) returned to scout326
scout326 collected $5 from pot
*** SUMMARY ***
Total pot $5 | Rake $0 
Seat 1: matiko09 (small blind) folded before Flop
Seat 2: stds st (big blind) folded before Flop
Seat 3: PacPacBum folded before Flop (didn't bet)
Seat 4: neomorf folded before Flop (didn't bet)
Seat 6: uonlylive1ce folded before Flop (didn't bet)
Seat 7: Fish4trips folded before Flop (didn't bet)
Seat 8: scout326 (button) collected ($5)





PokerStars Hand #150126235080:  Hold'em No Limit ($0.25/$0.50 USD) - 2016/03/10 13:31:52 CET [2016/03/10 7:31:52 ET]
Table 'Aegina' 9-max Seat #4 is the button
Seat 1: BingoIng0 ($116.90 in chips) 
Seat 2: dvutavr ($110.08 in chips) 
Seat 4: digimatical ($82.28 in chips) 
Seat 5: Ahangama ($50 in chips) 
Seat 6: matiko09 ($50 in chips) 
Seat 7: Gummio ($106.21 in chips) 
Seat 8: ardo888 ($189.82 in chips) 
Seat 9: draken08 ($127.36 in chips) 
Ahangama: posts small blind $0.25
matiko09: posts big blind $0.50
BingoIng0: posts the ante $0.10
dvutavr: posts the ante $0.10
digimatical: posts the ante $0.10
Ahangama: posts the ante $0.10
matiko09: posts the ante $0.10
Gummio: posts the ante $0.10
ardo888: posts the ante $0.10
draken08: posts the ante $0.10
*** HOLE CARDS ***
Dealt to matiko09 [5h Qh]
Gummio: folds 
ardo888: folds 
draken08: folds 
BingoIng0: folds 
dvutavr: folds 
digimatical: calls $0.50
Ahangama: folds 
matiko09: checks 
*** FLOP *** [Kh 2c Th]
matiko09: bets $1.27
digimatical: calls $1.27
*** TURN *** [Kh 2c Th] [7h]
matiko09: bets $3
digimatical: calls $3
*** RIVER *** [Kh 2c Th 7h] [2h]
matiko09: checks 
digimatical: checks 
*** SHOW DOWN ***
matiko09: shows [5h Qh] (a flush, King high)
digimatical: mucks hand 
matiko09 collected $10.11 from pot
*** SUMMARY ***
Total pot $10.59 | Rake $0.48 
Board [Kh 2c Th 7h 2h]
Seat 1: BingoIng0 folded before Flop (didn't bet)
Seat 2: dvutavr folded before Flop (didn't bet)
Seat 4: digimatical (button) mucked [Kc 9d]
Seat 5: Ahangama (small blind) folded before Flop
Seat 6: matiko09 (big blind) showed [5h Qh] and won ($10.11) with a flush, King high
Seat 7: Gummio folded before Flop (didn't bet)
Seat 8: ardo888 folded before Flop (didn't bet)
Seat 9: draken08 folded before Flop (didn't bet)





PokerStars Hand #150126234940:  Hold'em No Limit ($0.50/$1.00 USD) - 2016/03/10 13:31:52 CET [2016/03/10 7:31:52 ET]
Table 'Iguassu' 9-max Seat #4 is the button
Seat 1: blackw0lf_03 ($101.50 in chips) 
Seat 2: Rocky6434 ($67.10 in chips) 
Seat 3: hammerwife ($121.93 in chips) 
Seat 4: matiko09 ($100 in chips) 
Seat 5: UnBent022 ($100 in chips) 
Seat 6: Igor DoUrden ($100 in chips) 
Seat 7: PacPacBum ($121.55 in chips) 
Seat 8: Sweden_Pound ($139.28 in chips) 
Seat 9: er13to ($100 in chips) 
UnBent022: posts small blind $0.50
Igor DoUrden: posts big blind $1
*** HOLE CARDS ***
Dealt to matiko09 [Jh Qc]
PacPacBum: folds 
Sweden_Pound: folds 
er13to: folds 
blackw0lf_03: folds 
Rocky6434: raises $1 to $2
hammerwife: folds 
matiko09: folds 
UnBent022: folds 
Igor DoUrden: calls $1
*** FLOP *** [6s Jc 5s]
Igor DoUrden: bets $2.15
Rocky6434: calls $2.15
*** TURN *** [6s Jc 5s] [8d]
Igor DoUrden: bets $4.20
Rocky6434: calls $4.20
*** RIVER *** [6s Jc 5s 8d] [2h]
Igor DoUrden: bets $24.64
Rocky6434: folds 
Uncalled bet ($24.64) returned to Igor DoUrden
Igor DoUrden collected $16.43 from pot
Igor DoUrden: doesn't show hand 
*** SUMMARY ***
Total pot $17.20 | Rake $0.77 
Board [6s Jc 5s 8d 2h]
Seat 1: blackw0lf_03 folded before Flop (didn't bet)
Seat 2: Rocky6434 folded on the River
Seat 3: hammerwife folded before Flop (didn't bet)
Seat 4: matiko09 (button) folded before Flop (didn't bet)
Seat 5: UnBent022 (small blind) folded before Flop
Seat 6: Igor DoUrden (big blind) collected ($16.43)
Seat 7: PacPacBum folded before Flop (didn't bet)
Seat 8: Sweden_Pound folded before Flop (didn't bet)
Seat 9: er13to folded before Flop (didn't bet)





PokerStars Hand #150126236360:  Hold'em No Limit ($0.50/$1.00 USD) - 2016/03/10 13:31:55 CET [2016/03/10 7:31:55 ET]
Table 'Liriope II' 9-max Seat #7 is the button
Seat 1: UnBent022 ($100 in chips) 
Seat 2: zxp12345 ($39.68 in chips) 
Seat 3: matiko09 ($168.01 in chips) 
Seat 4: Plz3betMe ($45.93 in chips) 
Seat 5: lumen21 ($103.68 in chips) 
Seat 6: nobu-azabu ($187.10 in chips) 
Seat 7: Sweden_Pound ($100 in chips) 
Seat 8: PacPacBum ($113.71 in chips) 
PacPacBum: posts small blind $0.50
UnBent022: posts big blind $1
*** HOLE CARDS ***
Dealt to matiko09 [Qc 6s]
zxp12345: folds 
matiko09: folds 
Plz3betMe: folds 
lumen21: folds 
nobu-azabu: folds 
Sweden_Pound: raises $1 to $2
PacPacBum: folds 
UnBent022: folds 
Uncalled bet ($1) returned to Sweden_Pound
Sweden_Pound collected $2.50 from pot
Sweden_Pound: doesn't show hand 
*** SUMMARY ***
Total pot $2.50 | Rake $0 
Seat 1: UnBent022 (big blind) folded before Flop
Seat 2: zxp12345 folded before Flop (didn't bet)
Seat 3: matiko09 folded before Flop (didn't bet)
Seat 4: Plz3betMe folded before Flop (didn't bet)
Seat 5: lumen21 folded before Flop (didn't bet)
Seat 6: nobu-azabu folded before Flop (didn't bet)
Seat 7: Sweden_Pound (button) collected ($2.50)
Seat 8: PacPacBum (small blind) folded before Flop





PokerStars Hand #150126238304:  Hold'em No Limit ($0.50/$1.00 USD) - 2016/03/10 13:31:58 CET [2016/03/10 7:31:58 ET]
Table 'Saskia' 9-max Seat #9 is the button
Seat 1: Sweden_Pound ($110.51 in chips) 
Seat 2: njurg aga ($75.45 in chips) 
Seat 3: ccmaster001 ($70.64 in chips) 
Seat 4: Plz3betMe ($83.72 in chips) 
Seat 5: dreded11 ($98.16 in chips) 
Seat 6: matiko09 ($109.38 in chips) 
Seat 7: stds st ($47.56 in chips) 
Seat 8: blackw0lf_03 ($103 in chips) 
Seat 9: er13to ($116.97 in chips) 
Sweden_Pound: posts small blind $0.50
njurg aga: posts big blind $1
*** HOLE CARDS ***
Dealt to matiko09 [Qs 9h]
ccmaster001: raises $1 to $2
Plz3betMe: raises $5 to $7
dreded11: folds 
matiko09: folds 
stds st: folds 
blackw0lf_03: folds 
er13to: folds 
Sweden_Pound: folds 
njurg aga: folds 
ccmaster001: calls $5
*** FLOP *** [Js Th 4c]
ccmaster001: bets $7
Plz3betMe: calls $7
*** TURN *** [Js Th 4c] [7h]
ccmaster001: bets $28
Plz3betMe: folds 
Uncalled bet ($28) returned to ccmaster001
ccmaster001 collected $28.17 from pot
ccmaster001: doesn't show hand 
*** SUMMARY ***
Total pot $29.50 | Rake $1.33 
Board [Js Th 4c 7h]
Seat 1: Sweden_Pound (small blind) folded before Flop
Seat 2: njurg aga (big blind) folded before Flop
Seat 3: ccmaster001 collected ($28.17)
Seat 4: Plz3betMe folded on the Turn
Seat 5: dreded11 folded before Flop (didn't bet)
Seat 6: matiko09 folded before Flop (didn't bet)
Seat 7: stds st folded before Flop (didn't bet)
Seat 8: blackw0lf_03 folded before Flop (didn't bet)
Seat 9: er13to (button) folded before Flop (didn't bet)





PokerStars Hand #150126243637:  Hold'em No Limit ($1/$2 USD) - 2016/03/10 13:32:09 CET [2016/03/10 7:32:09 ET]
Table 'Tauris II' 9-max Seat #1 is the button
Seat 1: matiko09 ($200 in chips) 
Seat 2: stds st ($69.96 in chips) 
Seat 3: PacPacBum ($200 in chips) 
Seat 4: neomorf ($630.04 in chips) 
Seat 6: uonlylive1ce ($200 in chips) 
Seat 7: Fish4trips ($211.06 in chips) 
Seat 8: scout326 ($231.38 in chips) 
stds st: posts small blind $1
PacPacBum: posts big blind $2
*** HOLE CARDS ***
Dealt to matiko09 [Qc 2s]
neomorf: folds 
uonlylive1ce: folds 
Fish4trips: folds 
scout326: raises $4 to $6
matiko09: folds 
stds st: folds 
PacPacBum: folds 
Uncalled bet ($4) returned to scout326
scout326 collected $5 from pot
*** SUMMARY ***
Total pot $5 | Rake $0 
Seat 1: matiko09 (button) folded before Flop (didn't bet)
Seat 2: stds st (small blind) folded before Flop
Seat 3: PacPacBum (big blind) folded before Flop
Seat 4: neomorf folded before Flop (didn't bet)
Seat 6: uonlylive1ce folded before Flop (didn't bet)
Seat 7: Fish4trips folded before Flop (didn't bet)
Seat 8: scout326 collected ($5)





PokerStars Hand #150126247988:  Hold'em No Limit ($1/$2 USD) - 2016/03/10 13:32:17 CET [2016/03/10 7:32:17 ET]
Table 'Chandra II' 9-max Seat #4 is the button
Seat 1: Fish4trips ($315.43 in chips) 
Seat 2: PacPacBum ($237.51 in chips) 
Seat 4: tipner ($200 in chips) 
Seat 5: uibting ($49.03 in chips) 
Seat 6: stds st ($72.31 in chips) 
Seat 7: johnvu2016 ($168.65 in chips) 
Seat 8: matiko09 ($200 in chips) 
Seat 9: o.miro ($259.58 in chips) 
uibting: posts small blind $1
stds st: posts big blind $2
*** HOLE CARDS ***
Dealt to matiko09 [9c 8h]
johnvu2016: raises $4 to $6
matiko09: folds 
o.miro: folds 
Fish4trips: calls $6
PacPacBum: folds 
tipner: folds 
uibting: folds 
stds st: folds 
*** FLOP *** [Ks 2d 7c]
johnvu2016: checks 
Fish4trips: bets $9.02
johnvu2016: folds 
Uncalled bet ($9.02) returned to Fish4trips
Fish4trips collected $14.32 from pot
Fish4trips: doesn't show hand 
*** SUMMARY ***
Total pot $15 | Rake $0.68 
Board [Ks 2d 7c]
Seat 1: Fish4trips collected ($14.32)
Seat 2: PacPacBum folded before Flop (didn't bet)
Seat 4: tipner (button) folded before Flop (didn't bet)
Seat 5: uibting (small blind) folded before Flop
Seat 6: stds st (big blind) folded before Flop
Seat 7: johnvu2016 folded on the Flop
Seat 8: matiko09 folded before Flop (didn't bet)
Seat 9: o.miro folded before Flop (didn't bet)





PokerStars Hand #150126248367:  Hold'em No Limit ($0.50/$1.00 USD) - 2016/03/10 13:32:18 CET [2016/03/10 7:32:18 ET]
Table 'Leuschneria II' 9-max Seat #2 is the button
Seat 1: SHARKFIN168 ($100 in chips) 
Seat 2: blackw0lf_03 ($100 in chips) 
Seat 3: gudridornot ($78.09 in chips) 
Seat 4: Sweden_Pound ($138.22 in chips) 
Seat 5: RMilPoker ($122.91 in chips) 
Seat 6: matiko09 ($113.33 in chips) 
Seat 7: Plz3betMe ($46.44 in chips) 
Seat 8: UnBent022 ($102.75 in chips) 
Seat 9: ki11u ($100 in chips) 
gudridornot: posts small blind $0.50
Sweden_Pound: posts big blind $1
SHARKFIN168: posts big blind $1
*** HOLE CARDS ***
Dealt to matiko09 [7c 2s]
RMilPoker: raises $2 to $3
matiko09: folds 
Plz3betMe: folds 
UnBent022: folds 
ki11u: calls $3
SHARKFIN168: calls $2
blackw0lf_03: folds 
gudridornot: raises $75.09 to $78.09 and is all-in
Sweden_Pound: folds 
RMilPoker: raises $44.82 to $122.91 and is all-in
ki11u: folds 
SHARKFIN168: folds 
Uncalled bet ($44.82) returned to RMilPoker
*** FLOP *** [3s 6c Ah]
*** TURN *** [3s 6c Ah] [7d]
*** RIVER *** [3s 6c Ah 7d] [Qd]
*** SHOW DOWN ***
gudridornot: shows [6d 9c] (a pair of Sixes)
RMilPoker: shows [Kd Ks] (a pair of Kings)
RMilPoker collected $160.38 from pot
*** SUMMARY ***
Total pot $163.18 | Rake $2.80 
Board [3s 6c Ah 7d Qd]
Seat 1: SHARKFIN168 folded before Flop
Seat 2: blackw0lf_03 (button) folded before Flop (didn't bet)
Seat 3: gudridornot (small blind) showed [6d 9c] and lost with a pair of Sixes
Seat 4: Sweden_Pound (big blind) folded before Flop
Seat 5: RMilPoker showed [Kd Ks] and won ($160.38) with a pair of Kings
Seat 6: matiko09 folded before Flop (didn't bet)
Seat 7: Plz3betMe folded before Flop (didn't bet)
Seat 8: UnBent022 folded before Flop (didn't bet)
Seat 9: ki11u folded before Flop





PokerStars Hand #150126249710:  Hold'em No Limit ($0.50/$1.00 USD) - 2016/03/10 13:32:20 CET [2016/03/10 7:32:20 ET]
Table 'Virgo II' 9-max Seat #6 is the button
Seat 1: cdv1984 ($189.55 in chips) 
Seat 2: Plz3betMe ($54.77 in chips) 
Seat 3: blackw0lf_03 ($101.50 in chips) 
Seat 4: UnBent022 ($103.96 in chips) 
Seat 5: stds st ($38.27 in chips) 
Seat 6: PacPacBum ($132.14 in chips) 
Seat 7: mamilets ($61.60 in chips) 
Seat 8: Sweden_Pound ($140.09 in chips) 
Seat 9: matiko09 ($100 in chips) 
mamilets: posts small blind $0.50
Sweden_Pound: posts big blind $1
*** HOLE CARDS ***
Dealt to matiko09 [Th 8s]
matiko09: folds 
cdv1984: folds 
Plz3betMe: folds 
blackw0lf_03: folds 
UnBent022: folds 
stds st: folds 
PacPacBum: raises $1.04 to $2.04
mamilets: calls $1.54
Sweden_Pound: folds 
*** FLOP *** [As 2s 7s]
mamilets: checks 
PacPacBum: checks 
*** TURN *** [As 2s 7s] [Js]
mamilets: checks 
PacPacBum: bets $1.69
mamilets: folds 
Uncalled bet ($1.69) returned to PacPacBum
PacPacBum collected $4.85 from pot
PacPacBum: doesn't show hand 
*** SUMMARY ***
Total pot $5.08 | Rake $0.23 
Board [As 2s 7s Js]
Seat 1: cdv1984 folded before Flop (didn't bet)
Seat 2: Plz3betMe folded before Flop (didn't bet)
Seat 3: blackw0lf_03 folded before Flop (didn't bet)
Seat 4: UnBent022 folded before Flop (didn't bet)
Seat 5: stds st folded before Flop (didn't bet)
Seat 6: PacPacBum (button) collected ($4.85)
Seat 7: mamilets (small blind) folded on the Turn
Seat 8: Sweden_Pound (big blind) folded before Flop
Seat 9: matiko09 folded before Flop (didn't bet)





PokerStars Hand #150126258688:  Hold'em No Limit ($1/$2 USD) - 2016/03/10 13:32:37 CET [2016/03/10 7:32:37 ET]
Table 'Tauris II' 9-max Seat #2 is the button
Seat 1: matiko09 ($200 in chips) 
Seat 2: stds st ($68.96 in chips) 
Seat 3: PacPacBum ($200 in chips) 
Seat 4: neomorf ($630.04 in chips) 
Seat 6: uonlylive1ce ($200 in chips) 
Seat 7: Fish4trips ($211.06 in chips) 
Seat 8: scout326 ($234.38 in chips) 
PacPacBum: posts small blind $1
neomorf: posts big blind $2
*** HOLE CARDS ***
Dealt to matiko09 [9c Ts]
uonlylive1ce: folds 
Fish4trips: folds 
scout326: folds 
matiko09: folds 
stds st: folds 
PacPacBum: folds 
Uncalled bet ($1) returned to neomorf
neomorf collected $2 from pot
neomorf: doesn't show hand 
*** SUMMARY ***
Total pot $2 | Rake $0 
Seat 1: matiko09 folded before Flop (didn't bet)
Seat 2: stds st (button) folded before Flop (didn't bet)
Seat 3: PacPacBum (small blind) folded before Flop
Seat 4: neomorf (big blind) collected ($2)
Seat 6: uonlylive1ce folded before Flop (didn't bet)
Seat 7: Fish4trips folded before Flop (didn't bet)
Seat 8: scout326 folded before Flop (didn't bet)





PokerStars Hand #150126259200:  Hold'em No Limit ($0.50/$1.00 USD) - 2016/03/10 13:32:38 CET [2016/03/10 7:32:38 ET]
Table 'Liriope II' 9-max Seat #8 is the button
Seat 1: UnBent022 ($100 in chips) 
Seat 2: zxp12345 ($39.68 in chips) 
Seat 3: matiko09 ($168.01 in chips) 
Seat 4: Plz3betMe ($45.93 in chips) 
Seat 5: lumen21 ($103.68 in chips) 
Seat 6: nobu-azabu ($187.10 in chips) 
Seat 7: Sweden_Pound ($101.50 in chips) 
Seat 8: PacPacBum ($113.21 in chips) 
UnBent022: posts small blind $0.50
zxp12345: posts big blind $1
*** HOLE CARDS ***
Dealt to matiko09 [Ac 8s]
matiko09: folds 
Plz3betMe: folds 
lumen21: raises $2 to $3
nobu-azabu: folds 
Sweden_Pound: folds 
PacPacBum: folds 
UnBent022: folds 
zxp12345: folds 
Uncalled bet ($2) returned to lumen21
lumen21 collected $2.50 from pot
lumen21: doesn't show hand 
*** SUMMARY ***
Total pot $2.50 | Rake $0 
Seat 1: UnBent022 (small blind) folded before Flop
Seat 2: zxp12345 (big blind) folded before Flop
Seat 3: matiko09 folded before Flop (didn't bet)
Seat 4: Plz3betMe folded before Flop (didn't bet)
Seat 5: lumen21 collected ($2.50)
Seat 6: nobu-azabu folded before Flop (didn't bet)
Seat 7: Sweden_Pound folded before Flop (didn't bet)
Seat 8: PacPacBum (button) folded before Flop (didn't bet)





PokerStars Hand #150126262482:  Hold'em No Limit ($0.50/$1.00 USD) - 2016/03/10 13:32:44 CET [2016/03/10 7:32:44 ET]
Table 'Mars III' 9-max Seat #1 is the button
Seat 1: blackw0lf_03 ($125.50 in chips) 
Seat 2: pokixy800 ($62.60 in chips) 
Seat 3: PacPacBum ($110.48 in chips) 
Seat 5: Slash3r ($71.95 in chips) 
Seat 6: matiko09 ($101.85 in chips) 
Seat 7: Sweden_Pound ($100 in chips) 
Seat 8: Filojoes ($100 in chips) 
pokixy800: posts small blind $0.50
PacPacBum: posts big blind $1
ki11u: sits out 
flk.Dasas: sits out 
*** HOLE CARDS ***
Dealt to matiko09 [9c 3d]
Slash3r: calls $1
matiko09: folds 
Sweden_Pound: folds 
Filojoes: folds 
blackw0lf_03: raises $3 to $4
pokixy800: folds 
PacPacBum: folds 
Slash3r: calls $3
*** FLOP *** [Qh Qs 2h]
Slash3r: checks 
blackw0lf_03: bets $3.08
Slash3r: folds 
Uncalled bet ($3.08) returned to blackw0lf_03
blackw0lf_03 collected $9.07 from pot
blackw0lf_03: doesn't show hand 
*** SUMMARY ***
Total pot $9.50 | Rake $0.43 
Board [Qh Qs 2h]
Seat 1: blackw0lf_03 (button) collected ($9.07)
Seat 2: pokixy800 (small blind) folded before Flop
Seat 3: PacPacBum (big blind) folded before Flop
Seat 5: Slash3r folded on the Flop
Seat 6: matiko09 folded before Flop (didn't bet)
Seat 7: Sweden_Pound folded before Flop (didn't bet)
Seat 8: Filojoes folded before Flop (didn't bet)





PokerStars Hand #150126263227:  Hold'em No Limit ($0.25/$0.50 USD) - 2016/03/10 13:32:46 CET [2016/03/10 7:32:46 ET]
Table 'Aegina' 9-max Seat #5 is the button
Seat 1: BingoIng0 ($116.80 in chips) 
Seat 2: dvutavr ($109.98 in chips) 
Seat 3: Fandango1991 ($76.82 in chips) 
Seat 4: digimatical ($77.41 in chips) 
Seat 5: Ahangama ($50 in chips) 
Seat 6: matiko09 ($55.24 in chips) 
Seat 7: Gummio ($106.11 in chips) 
Seat 8: ardo888 ($189.72 in chips) 
Seat 9: draken08 ($127.26 in chips) 
matiko09: posts small blind $0.25
Gummio: posts big blind $0.50
BingoIng0: posts the ante $0.10
dvutavr: posts the ante $0.10
Fandango1991: posts the ante $0.10
digimatical: posts the ante $0.10
Ahangama: posts the ante $0.10
matiko09: posts the ante $0.10
Gummio: posts the ante $0.10
ardo888: posts the ante $0.10
draken08: posts the ante $0.10
*** HOLE CARDS ***
Dealt to matiko09 [3c 8d]
ardo888: folds 
draken08: folds 
BingoIng0: folds 
dvutavr: folds 
Fandango1991: calls $0.50
digimatical: calls $0.50
Ahangama: calls $0.50
matiko09: folds 
Gummio: checks 
*** FLOP *** [2s 9h 9d]
Gummio: checks 
Fandango1991: checks 
digimatical: checks 
Ahangama: checks 
*** TURN *** [2s 9h 9d] [Td]
Gummio: checks 
Fandango1991: checks 
digimatical: checks 
Ahangama: checks 
*** RIVER *** [2s 9h 9d Td] [4h]
Gummio: bets $0.50
Fandango1991: raises $3.50 to $4
digimatical: folds 
Ahangama: folds 
Gummio: folds 
Uncalled bet ($3.50) returned to Fandango1991
Fandango1991 collected $3.96 from pot
Fandango1991: doesn't show hand 
*** SUMMARY ***
Total pot $4.15 | Rake $0.19 
Board [2s 9h 9d Td 4h]
Seat 1: BingoIng0 folded before Flop (didn't bet)
Seat 2: dvutavr folded before Flop (didn't bet)
Seat 3: Fandango1991 collected ($3.96)
Seat 4: digimatical folded on the River
Seat 5: Ahangama (button) folded on the River
Seat 6: matiko09 (small blind) folded before Flop
Seat 7: Gummio (big blind) folded on the River
Seat 8: ardo888 folded before Flop (didn't bet)
Seat 9: draken08 folded before Flop (didn't bet)





PokerStars Hand #150126267965:  Hold'em No Limit ($1/$2 USD) - 2016/03/10 13:32:55 CET [2016/03/10 7:32:55 ET]
Table 'Chandra II' 9-max Seat #5 is the button
Seat 1: Fish4trips ($323.75 in chips) 
Seat 2: PacPacBum ($237.51 in chips) 
Seat 4: tipner ($200 in chips) 
Seat 5: uibting ($48.03 in chips) 
Seat 6: stds st ($70.31 in chips) 
Seat 7: johnvu2016 ($162.65 in chips) 
Seat 8: matiko09 ($200 in chips) 
Seat 9: o.miro ($259.58 in chips) 
stds st: posts small blind $1
johnvu2016: posts big blind $2
*** HOLE CARDS ***
Dealt to matiko09 [2d 3h]
matiko09: folds 
o.miro: folds 
Fish4trips: folds 
PacPacBum: folds 
tipner: folds 
uibting: folds 
stds st: raises $2.04 to $4.04
johnvu2016: folds 
Uncalled bet ($2.04) returned to stds st
stds st collected $4 from pot
stds st: doesn't show hand 
*** SUMMARY ***
Total pot $4 | Rake $0 
Seat 1: Fish4trips folded before Flop (didn't bet)
Seat 2: PacPacBum folded before Flop (didn't bet)
Seat 4: tipner folded before Flop (didn't bet)
Seat 5: uibting (button) folded before Flop (didn't bet)
Seat 6: stds st (small blind) collected ($4)
Seat 7: johnvu2016 (big blind) folded before Flop
Seat 8: matiko09 folded before Flop (didn't bet)
Seat 9: o.miro folded before Flop (didn't bet)





PokerStars Hand #150126269794:  Hold'em No Limit ($1/$2 USD) - 2016/03/10 13:32:58 CET [2016/03/10 7:32:58 ET]
Table 'Tauris II' 9-max Seat #3 is the button
Seat 1: matiko09 ($200 in chips) 
Seat 2: stds st ($68.96 in chips) 
Seat 3: PacPacBum ($200 in chips) 
Seat 4: neomorf ($631.04 in chips) 
Seat 6: uonlylive1ce ($200 in chips) 
Seat 7: Fish4trips ($211.06 in chips) 
Seat 8: scout326 ($234.38 in chips) 
neomorf: posts small blind $1
uonlylive1ce: posts big blind $2
*** HOLE CARDS ***
Dealt to matiko09 [2c Td]
Fish4trips: folds 
scout326: folds 
matiko09: folds 
stds st: folds 
PacPacBum: folds 
neomorf: folds 
Uncalled bet ($1) returned to uonlylive1ce
uonlylive1ce collected $2 from pot
uonlylive1ce: doesn't show hand 
*** SUMMARY ***
Total pot $2 | Rake $0 
Seat 1: matiko09 folded before Flop (didn't bet)
Seat 2: stds st folded before Flop (didn't bet)
Seat 3: PacPacBum (button) folded before Flop (didn't bet)
Seat 4: neomorf (small blind) folded before Flop
Seat 6: uonlylive1ce (big blind) collected ($2)
Seat 7: Fish4trips folded before Flop (didn't bet)
Seat 8: scout326 folded before Flop (didn't bet)





PokerStars Hand #150126269870:  Hold'em No Limit ($0.50/$1.00 USD) - 2016/03/10 13:32:58 CET [2016/03/10 7:32:58 ET]
Table 'Saskia' 9-max Seat #1 is the button
Seat 1: Sweden_Pound ($110.01 in chips) 
Seat 2: njurg aga ($74.45 in chips) 
Seat 3: ccmaster001 ($84.81 in chips) 
Seat 4: Plz3betMe ($69.72 in chips) 
Seat 5: dreded11 ($98.16 in chips) 
Seat 6: matiko09 ($109.38 in chips) 
Seat 7: stds st ($47.56 in chips) 
Seat 8: blackw0lf_03 ($103 in chips) 
Seat 9: er13to ($116.97 in chips) 
njurg aga: posts small blind $0.50
ccmaster001: posts big blind $1
*** HOLE CARDS ***
Dealt to matiko09 [5h Kh]
Plz3betMe: folds 
dreded11: folds 
matiko09: folds 
stds st: folds 
blackw0lf_03: folds 
er13to: folds 
Sweden_Pound: raises $1 to $2
njurg aga: calls $1.50
ccmaster001: folds 
*** FLOP *** [5s Jd Ks]
njurg aga: checks 
Sweden_Pound: bets $3.11
njurg aga: raises $3.11 to $6.22
Sweden_Pound: calls $3.11
*** TURN *** [5s Jd Ks] [2d]
njurg aga: checks 
Sweden_Pound: bets $10.83
njurg aga: raises $55.40 to $66.23 and is all-in
Sweden_Pound: folds 
Uncalled bet ($55.40) returned to njurg aga
njurg aga collected $37.34 from pot
njurg aga: doesn't show hand 
*** SUMMARY ***
Total pot $39.10 | Rake $1.76 
Board [5s Jd Ks 2d]
Seat 1: Sweden_Pound (button) folded on the Turn
Seat 2: njurg aga (small blind) collected ($37.34)
Seat 3: ccmaster001 (big blind) folded before Flop
Seat 4: Plz3betMe folded before Flop (didn't bet)
Seat 5: dreded11 folded before Flop (didn't bet)
Seat 6: matiko09 folded before Flop (didn't bet)
Seat 7: stds st folded before Flop (didn't bet)
Seat 8: blackw0lf_03 folded before Flop (didn't bet)
Seat 9: er13to folded before Flop (didn't bet)





PokerStars Hand #150126269512:  Hold'em No Limit (€1/€2 EUR) - 2016/03/10 13:32:58 CET [2016/03/10 7:32:58 ET]
Table 'Sigrid II' 9-max Seat #9 is the button
Seat 1: Gamz11 (€213.93 in chips) 
Seat 2: stds st (€76.92 in chips) 
Seat 4: Fish4trips (€207.52 in chips) 
Seat 5: vr188 (€80.33 in chips) 
Seat 6: azzad2007 (€203 in chips) 
Seat 7: PacPacBum (€207.67 in chips) 
Seat 8: matiko09 (€200 in chips) 
Seat 9: ki11u (€223.25 in chips) 
Gamz11: posts small blind €1
stds st: posts big blind €2
*** HOLE CARDS ***
Dealt to matiko09 [9h 2s]
Fish4trips: folds 
vr188: folds 
azzad2007: folds 
PacPacBum: folds 
matiko09: folds 
ki11u: raises €2.30 to €4.30
Gamz11: folds 
stds st: folds 
Uncalled bet (€2.30) returned to ki11u
ki11u collected €5 from pot
ki11u: doesn't show hand 
*** SUMMARY ***
Total pot €5 | Rake €0 
Seat 1: Gamz11 (small blind) folded before Flop
Seat 2: stds st (big blind) folded before Flop
Seat 4: Fish4trips folded before Flop (didn't bet)
Seat 5: vr188 folded before Flop (didn't bet)
Seat 6: azzad2007 folded before Flop (didn't bet)
Seat 7: PacPacBum folded before Flop (didn't bet)
Seat 8: matiko09 folded before Flop (didn't bet)
Seat 9: ki11u (button) collected (€5)





PokerStars Hand #150126270440:  Hold'em No Limit ($0.50/$1.00 USD) - 2016/03/10 13:32:59 CET [2016/03/10 7:32:59 ET]
Table 'Liriope II' 9-max Seat #1 is the button
Seat 1: UnBent022 ($100 in chips) 
Seat 2: zxp12345 ($38.68 in chips) 
Seat 3: matiko09 ($168.01 in chips) 
Seat 4: Plz3betMe ($45.93 in chips) 
Seat 5: lumen21 ($105.18 in chips) 
Seat 6: nobu-azabu ($187.10 in chips) 
Seat 7: Sweden_Pound ($101.50 in chips) 
Seat 8: PacPacBum ($113.21 in chips) 
zxp12345: posts small blind $0.50
matiko09: posts big blind $1
*** HOLE CARDS ***
Dealt to matiko09 [8s 8d]
Plz3betMe: folds 
lumen21: folds 
nobu-azabu: folds 
Sweden_Pound: raises $2 to $3
PacPacBum: folds 
UnBent022: folds 
zxp12345: calls $2.50
matiko09: calls $2
*** FLOP *** [Jc 9c Ts]
zxp12345: checks 
matiko09: checks 
Sweden_Pound: checks 
*** TURN *** [Jc 9c Ts] [6s]
zxp12345: bets $8.60
matiko09: folds 
Sweden_Pound: folds 
Uncalled bet ($8.60) returned to zxp12345
zxp12345 collected $8.60 from pot
zxp12345: doesn't show hand 
*** SUMMARY ***
Total pot $9 | Rake $0.40 
Board [Jc 9c Ts 6s]
Seat 1: UnBent022 (button) folded before Flop (didn't bet)
Seat 2: zxp12345 (small blind) collected ($8.60)
Seat 3: matiko09 (big blind) folded on the Turn
Seat 4: Plz3betMe folded before Flop (didn't bet)
Seat 5: lumen21 folded before Flop (didn't bet)
Seat 6: nobu-azabu folded before Flop (didn't bet)
Seat 7: Sweden_Pound folded on the Turn
Seat 8: PacPacBum folded before Flop (didn't bet)





PokerStars Hand #150126275775:  Hold'em No Limit ($0.50/$1.00 USD) - 2016/03/10 13:33:10 CET [2016/03/10 7:33:10 ET]
Table 'Leuschneria II' 9-max Seat #4 is the button
Seat 1: SHARKFIN168 ($97 in chips) 
Seat 2: blackw0lf_03 ($100 in chips) 
Seat 4: Sweden_Pound ($137.22 in chips) 
Seat 5: RMilPoker ($205.20 in chips) 
Seat 6: matiko09 ($113.33 in chips) 
Seat 7: Plz3betMe ($46.44 in chips) 
Seat 8: UnBent022 ($102.75 in chips) 
Seat 9: ki11u ($100 in chips) 
RMilPoker: posts small blind $0.50
matiko09: posts big blind $1
*** HOLE CARDS ***
Dealt to matiko09 [Qc 2d]
Plz3betMe: raises $1 to $2
gudridornot leaves the table
UnBent022: folds 
ki11u: folds 
SHARKFIN168: folds 
blackw0lf_03: folds 
Spid1 joins the table at seat #3 
Sweden_Pound: calls $2
RMilPoker: calls $1.50
matiko09: folds 
*** FLOP *** [3h Jh 4c]
RMilPoker: checks 
Plz3betMe: bets $5.01
Sweden_Pound: folds 
RMilPoker: raises $8.35 to $13.36
Plz3betMe: calls $8.35
*** TURN *** [3h Jh 4c] [6h]
RMilPoker: checks 
Plz3betMe: checks 
*** RIVER *** [3h Jh 4c 6h] [8d]
RMilPoker: bets $32.20
Plz3betMe: folds 
Uncalled bet ($32.20) returned to RMilPoker
RMilPoker collected $32.20 from pot
RMilPoker: doesn't show hand 
*** SUMMARY ***
Total pot $33.72 | Rake $1.52 
Board [3h Jh 4c 6h 8d]
Seat 1: SHARKFIN168 folded before Flop (didn't bet)
Seat 2: blackw0lf_03 folded before Flop (didn't bet)
Seat 4: Sweden_Pound (button) folded on the Flop
Seat 5: RMilPoker (small blind) collected ($32.20)
Seat 6: matiko09 (big blind) folded before Flop
Seat 7: Plz3betMe folded on the River
Seat 8: UnBent022 folded before Flop (didn't bet)
Seat 9: ki11u folded before Flop (didn't bet)





PokerStars Hand #150126277243:  Hold'em No Limit ($0.50/$1.00 USD) - 2016/03/10 13:33:13 CET [2016/03/10 7:33:13 ET]
Table 'Iguassu' 9-max Seat #5 is the button
Seat 1: blackw0lf_03 ($101.50 in chips) 
Seat 2: Rocky6434 ($58.75 in chips) 
Seat 3: hammerwife ($121.93 in chips) 
Seat 4: matiko09 ($100 in chips) 
Seat 5: UnBent022 ($100 in chips) 
Seat 6: Igor DoUrden ($108.08 in chips) 
Seat 7: PacPacBum ($121.55 in chips) 
Seat 8: Sweden_Pound ($139.28 in chips) 
Seat 9: er13to ($100 in chips) 
Igor DoUrden: posts small blind $0.50
PacPacBum: posts big blind $1
*** HOLE CARDS ***
Dealt to matiko09 [Jc 5c]
Sweden_Pound: folds 
Sweden_Pound leaves the table
er13to: folds 
blackw0lf_03: folds 
Rocky6434: folds 
hammerwife: folds 
matiko09: folds 
cdv1984 joins the table at seat #8 
UnBent022: raises $1 to $2
cdv1984 leaves the table
Igor DoUrden: raises $5 to $7
PacPacBum: folds 
Filojoes joins the table at seat #8 
UnBent022: folds 
Uncalled bet ($5) returned to Igor DoUrden
Igor DoUrden collected $5 from pot
Igor DoUrden: doesn't show hand 
*** SUMMARY ***
Total pot $5 | Rake $0 
Seat 1: blackw0lf_03 folded before Flop (didn't bet)
Seat 2: Rocky6434 folded before Flop (didn't bet)
Seat 3: hammerwife folded before Flop (didn't bet)
Seat 4: matiko09 folded before Flop (didn't bet)
Seat 5: UnBent022 (button) folded before Flop
Seat 6: Igor DoUrden (small blind) collected ($5)
Seat 7: PacPacBum (big blind) folded before Flop
Seat 8: Sweden_Pound folded before Flop (didn't bet)
Seat 9: er13to folded before Flop (didn't bet)





PokerStars Hand #150126281606:  Hold'em No Limit ($1/$2 USD) - 2016/03/10 13:33:21 CET [2016/03/10 7:33:21 ET]
Table 'Tauris II' 9-max Seat #4 is the button
Seat 1: matiko09 ($200 in chips) 
Seat 2: stds st ($68.96 in chips) 
Seat 3: PacPacBum ($200 in chips) 
Seat 4: neomorf ($630.04 in chips) 
Seat 6: uonlylive1ce ($201 in chips) 
Seat 7: Fish4trips ($211.06 in chips) 
Seat 8: scout326 ($234.38 in chips) 
uonlylive1ce: posts small blind $1
Fish4trips: posts big blind $2
*** HOLE CARDS ***
Dealt to matiko09 [6d 4h]
scout326: raises $4 to $6
matiko09: folds 
stds st: folds 
PacPacBum: folds 
neomorf: folds 
uonlylive1ce: folds 
Fish4trips: calls $4
*** FLOP *** [6s 9s 2s]
Fish4trips: checks 
scout326: checks 
*** TURN *** [6s 9s 2s] [Qh]
Fish4trips: bets $7.82
scout326: folds 
Uncalled bet ($7.82) returned to Fish4trips
Fish4trips collected $12.42 from pot
Fish4trips: doesn't show hand 
*** SUMMARY ***
Total pot $13 | Rake $0.58 
Board [6s 9s 2s Qh]
Seat 1: matiko09 folded before Flop (didn't bet)
Seat 2: stds st folded before Flop (didn't bet)
Seat 3: PacPacBum folded before Flop (didn't bet)
Seat 4: neomorf (button) folded before Flop (didn't bet)
Seat 6: uonlylive1ce (small blind) folded before Flop
Seat 7: Fish4trips (big blind) collected ($12.42)
Seat 8: scout326 folded on the Turn





PokerStars Hand #150126282949:  Hold'em No Limit (€1/€2 EUR) - 2016/03/10 13:33:23 CET [2016/03/10 7:33:23 ET]
Table 'Sigrid II' 9-max Seat #1 is the button
Seat 1: Gamz11 (€212.93 in chips) 
Seat 2: stds st (€74.92 in chips) 
Seat 4: Fish4trips (€207.52 in chips) 
Seat 5: vr188 (€80.33 in chips) 
Seat 6: azzad2007 (€203 in chips) 
Seat 7: PacPacBum (€207.67 in chips) 
Seat 8: matiko09 (€200 in chips) 
Seat 9: ki11u (€226.25 in chips) 
stds st: posts small blind €1
Fish4trips: posts big blind €2
*** HOLE CARDS ***
Dealt to matiko09 [8c Qc]
vr188: calls €2
azzad2007: folds 
PacPacBum: folds 
matiko09: folds 
ki11u: folds 
Gamz11: folds 
stds st: folds 
Fish4trips: checks 
*** FLOP *** [Qd Ad Jd]
Fish4trips: checks 
vr188: checks 
*** TURN *** [Qd Ad Jd] [2d]
Fish4trips: checks 
vr188: bets €2
Fish4trips: folds 
Uncalled bet (€2) returned to vr188
vr188 collected €4.78 from pot
*** SUMMARY ***
Total pot €5 | Rake €0.22 
Board [Qd Ad Jd 2d]
Seat 1: Gamz11 (button) folded before Flop (didn't bet)
Seat 2: stds st (small blind) folded before Flop
Seat 4: Fish4trips (big blind) folded on the Turn
Seat 5: vr188 collected (€4.78)
Seat 6: azzad2007 folded before Flop (didn't bet)
Seat 7: PacPacBum folded before Flop (didn't bet)
Seat 8: matiko09 folded before Flop (didn't bet)
Seat 9: ki11u folded before Flop (didn't bet)





PokerStars Hand #150126286048:  Hold'em No Limit ($1/$2 USD) - 2016/03/10 13:33:29 CET [2016/03/10 7:33:29 ET]
Table 'Chandra II' 9-max Seat #6 is the button
Seat 1: Fish4trips ($323.75 in chips) 
Seat 2: PacPacBum ($237.51 in chips) 
Seat 4: tipner ($200 in chips) 
Seat 5: uibting ($48.03 in chips) 
Seat 6: stds st ($72.31 in chips) 
Seat 7: johnvu2016 ($160.65 in chips) 
Seat 8: matiko09 ($200 in chips) 
Seat 9: o.miro ($259.58 in chips) 
johnvu2016: posts small blind $1
matiko09: posts big blind $2
*** HOLE CARDS ***
Dealt to matiko09 [5h Td]
o.miro: raises $4 to $6
Fish4trips: folds 
PacPacBum: folds 
tipner: folds 
uibting: folds 
stds st: folds 
johnvu2016: calls $5
matiko09: folds 
*** FLOP *** [8c As 6c]
johnvu2016: checks 
o.miro: checks 
*** TURN *** [8c As 6c] [7c]
johnvu2016: bets $6.68
o.miro: calls $6.68
*** RIVER *** [8c As 6c 7c] [3h]
johnvu2016: checks 
o.miro: bets $18
johnvu2016: folds 
Uncalled bet ($18) returned to o.miro
o.miro collected $26.13 from pot
o.miro: doesn't show hand 
*** SUMMARY ***
Total pot $27.36 | Rake $1.23 
Board [8c As 6c 7c 3h]
Seat 1: Fish4trips folded before Flop (didn't bet)
Seat 2: PacPacBum folded before Flop (didn't bet)
Seat 4: tipner folded before Flop (didn't bet)
Seat 5: uibting folded before Flop (didn't bet)
Seat 6: stds st (button) folded before Flop (didn't bet)
Seat 7: johnvu2016 (small blind) folded on the River
Seat 8: matiko09 (big blind) folded before Flop
Seat 9: o.miro collected ($26.13)





PokerStars Hand #150126296812:  Hold'em No Limit ($0.50/$1.00 USD) - 2016/03/10 13:33:50 CET [2016/03/10 7:33:50 ET]
Table 'Virgo II' 9-max Seat #7 is the button
Seat 1: cdv1984 ($189.55 in chips) 
Seat 2: Plz3betMe ($54.77 in chips) 
Seat 3: blackw0lf_03 ($101.50 in chips) 
Seat 4: UnBent022 ($103.96 in chips) 
Seat 5: stds st ($38.27 in chips) 
Seat 6: PacPacBum ($134.95 in chips) 
Seat 7: mamilets ($59.56 in chips) 
Seat 8: Sweden_Pound ($139.09 in chips) 
Seat 9: matiko09 ($100 in chips) 
Sweden_Pound: posts small blind $0.50
matiko09: posts big blind $1
*** HOLE CARDS ***
Dealt to matiko09 [6c 4d]
cdv1984: folds 
Plz3betMe: folds 
blackw0lf_03: raises $2 to $3
UnBent022: folds 
stds st: folds 
PacPacBum: folds 
mamilets: calls $3
Sweden_Pound: calls $2.50
matiko09: folds 
*** FLOP *** [8d 4h 5h]
Sweden_Pound: checks 
blackw0lf_03: checks 
mamilets: checks 
*** TURN *** [8d 4h 5h] [6d]
Sweden_Pound: checks 
blackw0lf_03: checks 
mamilets: checks 
*** RIVER *** [8d 4h 5h 6d] [Tc]
Sweden_Pound: checks 
blackw0lf_03: bets $3.25
mamilets: folds 
Sweden_Pound: folds 
Uncalled bet ($3.25) returned to blackw0lf_03
blackw0lf_03 collected $9.55 from pot
blackw0lf_03: doesn't show hand 
*** SUMMARY ***
Total pot $10 | Rake $0.45 
Board [8d 4h 5h 6d Tc]
Seat 1: cdv1984 folded before Flop (didn't bet)
Seat 2: Plz3betMe folded before Flop (didn't bet)
Seat 3: blackw0lf_03 collected ($9.55)
Seat 4: UnBent022 folded before Flop (didn't bet)
Seat 5: stds st folded before Flop (didn't bet)
Seat 6: PacPacBum folded before Flop (didn't bet)
Seat 7: mamilets (button) folded on the River
Seat 8: Sweden_Pound (small blind) folded on the River
Seat 9: matiko09 (big blind) folded before Flop





PokerStars Hand #150126299741:  Hold'em No Limit ($0.50/$1.00 USD) - 2016/03/10 13:33:55 CET [2016/03/10 7:33:55 ET]
Table 'Mars III' 9-max Seat #2 is the button
Seat 1: blackw0lf_03 ($130.57 in chips) 
Seat 2: pokixy800 ($62.10 in chips) 
Seat 3: PacPacBum ($109.48 in chips) 
Seat 4: ki11u ($100 in chips) 
Seat 5: Slash3r ($67.95 in chips) 
Seat 6: matiko09 ($101.85 in chips) 
Seat 7: Sweden_Pound ($100 in chips) 
Seat 8: Filojoes ($100 in chips) 
PacPacBum: posts small blind $0.50
ki11u: posts big blind $1
flk.Dasas: sits out 
*** HOLE CARDS ***
Dealt to matiko09 [3h Ks]
Slash3r: calls $1
matiko09: folds 
Sweden_Pound: folds 
Filojoes: folds 
blackw0lf_03: raises $3 to $4
pokixy800: folds 
PacPacBum: folds 
ki11u: folds 
Slash3r: calls $3
*** FLOP *** [Qc 6c 3s]
Slash3r: checks 
blackw0lf_03: bets $3.08
Slash3r: folds 
Uncalled bet ($3.08) returned to blackw0lf_03
blackw0lf_03 collected $9.07 from pot
blackw0lf_03: doesn't show hand 
*** SUMMARY ***
Total pot $9.50 | Rake $0.43 
Board [Qc 6c 3s]
Seat 1: blackw0lf_03 collected ($9.07)
Seat 2: pokixy800 (button) folded before Flop (didn't bet)
Seat 3: PacPacBum (small blind) folded before Flop
Seat 4: ki11u (big blind) folded before Flop
Seat 5: Slash3r folded on the Flop
Seat 6: matiko09 folded before Flop (didn't bet)
Seat 7: Sweden_Pound folded before Flop (didn't bet)
Seat 8: Filojoes folded before Flop (didn't bet)





PokerStars Hand #150126302988:  Hold'em No Limit ($0.50/$1.00 USD) - 2016/03/10 13:34:02 CET [2016/03/10 7:34:02 ET]
Table 'Liriope II' 9-max Seat #2 is the button
Seat 1: UnBent022 ($100 in chips) 
Seat 2: zxp12345 ($44.28 in chips) 
Seat 3: matiko09 ($165.01 in chips) 
Seat 4: Plz3betMe ($45.93 in chips) 
Seat 5: lumen21 ($105.18 in chips) 
Seat 6: nobu-azabu ($187.10 in chips) 
Seat 7: Sweden_Pound ($100 in chips) 
Seat 8: PacPacBum ($113.21 in chips) 
matiko09: posts small blind $0.50
Plz3betMe: posts big blind $1
*** HOLE CARDS ***
Dealt to matiko09 [5d 4h]
lumen21: folds 
nobu-azabu: folds 
Sweden_Pound: folds 
PacPacBum: folds 
UnBent022: folds 
zxp12345: folds 
matiko09: folds 
Uncalled bet ($0.50) returned to Plz3betMe
Plz3betMe collected $1 from pot
Plz3betMe: doesn't show hand 
*** SUMMARY ***
Total pot $1 | Rake $0 
Seat 1: UnBent022 folded before Flop (didn't bet)
Seat 2: zxp12345 (button) folded before Flop (didn't bet)
Seat 3: matiko09 (small blind) folded before Flop
Seat 4: Plz3betMe (big blind) collected ($1)
Seat 5: lumen21 folded before Flop (didn't bet)
Seat 6: nobu-azabu folded before Flop (didn't bet)
Seat 7: Sweden_Pound folded before Flop (didn't bet)
Seat 8: PacPacBum folded before Flop (didn't bet)





PokerStars Hand #150126312602:  Hold'em No Limit ($1/$2 USD) - 2016/03/10 13:34:20 CET [2016/03/10 7:34:20 ET]
Table 'Tauris II' 9-max Seat #6 is the button
Seat 1: matiko09 ($200 in chips) 
Seat 2: stds st ($68.96 in chips) 
Seat 3: PacPacBum ($200 in chips) 
Seat 4: neomorf ($630.04 in chips) 
Seat 6: uonlylive1ce ($200 in chips) 
Seat 7: Fish4trips ($217.48 in chips) 
Seat 8: scout326 ($228.38 in chips) 
Fish4trips: posts small blind $1
scout326: posts big blind $2
*** HOLE CARDS ***
Dealt to matiko09 [2d 7d]
matiko09: folds 
stds st: folds 
PacPacBum: folds 
neomorf: folds 
uonlylive1ce: raises $2 to $4
Fish4trips: calls $3
scout326: folds 
*** FLOP *** [5c 9h 6c]
Fish4trips: checks 
uonlylive1ce: bets $3.53
Fish4trips: folds 
Uncalled bet ($3.53) returned to uonlylive1ce
uonlylive1ce collected $9.55 from pot
uonlylive1ce: doesn't show hand 
*** SUMMARY ***
Total pot $10 | Rake $0.45 
Board [5c 9h 6c]
Seat 1: matiko09 folded before Flop (didn't bet)
Seat 2: stds st folded before Flop (didn't bet)
Seat 3: PacPacBum folded before Flop (didn't bet)
Seat 4: neomorf folded before Flop (didn't bet)
Seat 6: uonlylive1ce (button) collected ($9.55)
Seat 7: Fish4trips (small blind) folded on the Flop
Seat 8: scout326 (big blind) folded before Flop





PokerStars Hand #150126319671:  Hold'em No Limit (€1/€2 EUR) - 2016/03/10 13:34:33 CET [2016/03/10 7:34:33 ET]
Table 'Sigrid II' 9-max Seat #2 is the button
Seat 1: Gamz11 (€212.93 in chips) 
Seat 2: stds st (€73.92 in chips) 
Seat 4: Fish4trips (€205.52 in chips) 
Seat 5: vr188 (€83.11 in chips) 
Seat 6: azzad2007 (€203 in chips) 
Seat 7: PacPacBum (€207.67 in chips) 
Seat 8: matiko09 (€200 in chips) 
Seat 9: ki11u (€226.25 in chips) 
Fish4trips: posts small blind €1
vr188: posts big blind €2
*** HOLE CARDS ***
Dealt to matiko09 [9h 9c]
azzad2007: folds 
PacPacBum: folds 
matiko09: raises €3 to €5
ki11u: folds 
azzad2007 leaves the table
Gamz11: folds 
stds st: folds 
Fish4trips: folds 
vr188: folds 
Uncalled bet (€3) returned to matiko09
matiko09 collected €5 from pot
matiko09: doesn't show hand 
*** SUMMARY ***
Total pot €5 | Rake €0 
Seat 1: Gamz11 folded before Flop (didn't bet)
Seat 2: stds st (button) folded before Flop (didn't bet)
Seat 4: Fish4trips (small blind) folded before Flop
Seat 5: vr188 (big blind) folded before Flop
Seat 6: azzad2007 folded before Flop (didn't bet)
Seat 7: PacPacBum folded before Flop (didn't bet)
Seat 8: matiko09 collected (€5)
Seat 9: ki11u folded before Flop (didn't bet)





PokerStars Hand #150126320562:  Hold'em No Limit ($0.50/$1.00 USD) - 2016/03/10 13:34:35 CET [2016/03/10 7:34:35 ET]
Table 'Iguassu' 9-max Seat #6 is the button
Seat 1: blackw0lf_03 ($101.50 in chips) 
Seat 2: Rocky6434 ($58.75 in chips) 
Seat 3: hammerwife ($121.93 in chips) 
Seat 4: matiko09 ($100 in chips) 
Seat 5: UnBent022 ($100 in chips) 
Seat 6: Igor DoUrden ($111.08 in chips) 
Seat 7: PacPacBum ($120.55 in chips) 
Seat 8: Filojoes ($100 in chips) 
Seat 9: er13to ($100 in chips) 
PacPacBum: posts small blind $0.50
Filojoes: posts big blind $1
*** HOLE CARDS ***
Dealt to matiko09 [8c 8d]
er13to: raises $2 to $3
blackw0lf_03: folds 
Rocky6434: folds 
hammerwife: folds 
matiko09: calls $3
UnBent022: folds 
Igor DoUrden: raises $9 to $12
PacPacBum: folds 
Filojoes: folds 
er13to: folds 
matiko09: folds 
Uncalled bet ($9) returned to Igor DoUrden
Igor DoUrden collected $10.50 from pot
Igor DoUrden: doesn't show hand 
*** SUMMARY ***
Total pot $10.50 | Rake $0 
Seat 1: blackw0lf_03 folded before Flop (didn't bet)
Seat 2: Rocky6434 folded before Flop (didn't bet)
Seat 3: hammerwife folded before Flop (didn't bet)
Seat 4: matiko09 folded before Flop
Seat 5: UnBent022 folded before Flop (didn't bet)
Seat 6: Igor DoUrden (button) collected ($10.50)
Seat 7: PacPacBum (small blind) folded before Flop
Seat 8: Filojoes (big blind) folded before Flop
Seat 9: er13to folded before Flop





PokerStars Hand #150126324499:  Hold'em No Limit ($0.25/$0.50 USD) - 2016/03/10 13:34:42 CET [2016/03/10 7:34:42 ET]
Table 'Aegina' 9-max Seat #6 is the button
Seat 1: BingoIng0 ($116.70 in chips) 
Seat 2: dvutavr ($109.88 in chips) 
Seat 3: Fandango1991 ($79.68 in chips) 
Seat 4: digimatical ($76.81 in chips) 
Seat 5: Ahangama ($50 in chips) 
Seat 6: matiko09 ($54.89 in chips) 
Seat 7: Gummio ($105.01 in chips) 
Seat 8: ardo888 ($189.62 in chips) 
Seat 9: draken08 ($127.16 in chips) 
Gummio: posts small blind $0.25
ardo888: posts big blind $0.50
BingoIng0: posts the ante $0.10
dvutavr: posts the ante $0.10
Fandango1991: posts the ante $0.10
digimatical: posts the ante $0.10
Ahangama: posts the ante $0.10
matiko09: posts the ante $0.10
Gummio: posts the ante $0.10
ardo888: posts the ante $0.10
draken08: posts the ante $0.10
*** HOLE CARDS ***
Dealt to matiko09 [4s 3c]
draken08: folds 
BingoIng0: folds 
dvutavr: folds 
Fandango1991: folds 
digimatical: calls $0.50
Ahangama: folds 
matiko09: folds 
Gummio: raises $2.40 to $2.90
ardo888: calls $2.40
digimatical: folds 
*** FLOP *** [Qs 6c Jh]
Gummio: bets $6.88
ardo888: calls $6.88
*** TURN *** [Qs 6c Jh] [Jd]
Gummio: checks 
ardo888: checks 
*** RIVER *** [Qs 6c Jh Jd] [4c]
Gummio: bets $10.01
ardo888: folds 
Uncalled bet ($10.01) returned to Gummio
Gummio collected $20.02 from pot
Gummio: doesn't show hand 
*** SUMMARY ***
Total pot $20.96 | Rake $0.94 
Board [Qs 6c Jh Jd 4c]
Seat 1: BingoIng0 folded before Flop (didn't bet)
Seat 2: dvutavr folded before Flop (didn't bet)
Seat 3: Fandango1991 folded before Flop (didn't bet)
Seat 4: digimatical folded before Flop
Seat 5: Ahangama folded before Flop (didn't bet)
Seat 6: matiko09 (button) folded before Flop (didn't bet)
Seat 7: Gummio (small blind) collected ($20.02)
Seat 8: ardo888 (big blind) folded on the River
Seat 9: draken08 folded before Flop (didn't bet)





PokerStars Hand #150126324705:  Hold'em No Limit ($0.50/$1.00 USD) - 2016/03/10 13:34:43 CET [2016/03/10 7:34:43 ET]
Table 'Liriope II' 9-max Seat #3 is the button
Seat 1: UnBent022 ($100 in chips) 
Seat 2: zxp12345 ($44.28 in chips) 
Seat 3: matiko09 ($164.51 in chips) 
Seat 4: Plz3betMe ($46.43 in chips) 
Seat 5: lumen21 ($105.18 in chips) 
Seat 6: nobu-azabu ($187.10 in chips) 
Seat 7: Sweden_Pound ($100 in chips) 
Seat 8: PacPacBum ($113.21 in chips) 
Plz3betMe: posts small blind $0.50
lumen21: posts big blind $1
*** HOLE CARDS ***
Dealt to matiko09 [3s Ah]
nobu-azabu: folds 
Sweden_Pound: folds 
PacPacBum: folds 
UnBent022: folds 
zxp12345: raises $2.50 to $3.50
matiko09: folds 
Plz3betMe: folds 
lumen21: folds 
Uncalled bet ($2.50) returned to zxp12345
zxp12345 collected $2.50 from pot
zxp12345: doesn't show hand 
*** SUMMARY ***
Total pot $2.50 | Rake $0 
Seat 1: UnBent022 folded before Flop (didn't bet)
Seat 2: zxp12345 collected ($2.50)
Seat 3: matiko09 (button) folded before Flop (didn't bet)
Seat 4: Plz3betMe (small blind) folded before Flop
Seat 5: lumen21 (big blind) folded before Flop
Seat 6: nobu-azabu folded before Flop (didn't bet)
Seat 7: Sweden_Pound folded before Flop (didn't bet)
Seat 8: PacPacBum folded before Flop (didn't bet)





PokerStars Hand #150126329981:  Hold'em No Limit ($1/$2 USD) - 2016/03/10 13:34:53 CET [2016/03/10 7:34:53 ET]
Table 'Chandra II' 9-max Seat #7 is the button
Seat 1: Fish4trips ($323.75 in chips) 
Seat 2: PacPacBum ($237.51 in chips) 
Seat 4: tipner ($200 in chips) 
Seat 5: uibting ($48.03 in chips) 
Seat 6: stds st ($72.31 in chips) 
Seat 7: johnvu2016 ($147.97 in chips) 
Seat 8: matiko09 ($200 in chips) 
Seat 9: o.miro ($273.03 in chips) 
matiko09: posts small blind $1
o.miro: posts big blind $2
*** HOLE CARDS ***
Dealt to matiko09 [Ad 2h]
Fish4trips: raises $3 to $5
PacPacBum: folds 
tipner: folds 
uibting: folds 
stds st: folds 
johnvu2016: raises $10 to $15
matiko09: folds 
o.miro: folds 
Fish4trips: folds 
Uncalled bet ($10) returned to johnvu2016
johnvu2016 collected $13 from pot
*** SUMMARY ***
Total pot $13 | Rake $0 
Seat 1: Fish4trips folded before Flop
Seat 2: PacPacBum folded before Flop (didn't bet)
Seat 4: tipner folded before Flop (didn't bet)
Seat 5: uibting folded before Flop (didn't bet)
Seat 6: stds st folded before Flop (didn't bet)
Seat 7: johnvu2016 (button) collected ($13)
Seat 8: matiko09 (small blind) folded before Flop
Seat 9: o.miro (big blind) folded before Flop





PokerStars Hand #150126330374:  Hold'em No Limit ($1/$2 USD) - 2016/03/10 13:34:53 CET [2016/03/10 7:34:53 ET]
Table 'Tauris II' 9-max Seat #7 is the button
Seat 1: matiko09 ($200 in chips) 
Seat 2: stds st ($68.96 in chips) 
Seat 3: PacPacBum ($200 in chips) 
Seat 4: neomorf ($630.04 in chips) 
Seat 6: uonlylive1ce ($205.55 in chips) 
Seat 7: Fish4trips ($213.48 in chips) 
Seat 8: scout326 ($226.38 in chips) 
scout326: posts small blind $1
matiko09: posts big blind $2
*** HOLE CARDS ***
Dealt to matiko09 [As 5s]
stds st: raises $2.04 to $4.04
PacPacBum: folds 
neomorf: calls $4.04
uonlylive1ce: folds 
Fish4trips: folds 
scout326: folds 
matiko09: calls $2.04
*** FLOP *** [3c Ts 4d]
matiko09: checks 
stds st: bets $7.51
neomorf: calls $7.51
matiko09: calls $7.51
*** TURN *** [3c Ts 4d] [8s]
matiko09: checks 
stds st: checks 
neomorf: bets $14.30
matiko09: raises $29.70 to $44
stds st: folds 
neomorf: calls $29.70
*** RIVER *** [3c Ts 4d 8s] [9h]
matiko09: checks 
neomorf: checks 
*** SHOW DOWN ***
matiko09: shows [As 5s] (high card Ace)
neomorf: shows [Kh Kc] (a pair of Kings)
neomorf collected $120.85 from pot
*** SUMMARY ***
Total pot $123.65 | Rake $2.80 
Board [3c Ts 4d 8s 9h]
Seat 1: matiko09 (big blind) showed [As 5s] and lost with high card Ace
Seat 2: stds st folded on the Turn
Seat 3: PacPacBum folded before Flop (didn't bet)
Seat 4: neomorf showed [Kh Kc] and won ($120.85) with a pair of Kings
Seat 6: uonlylive1ce folded before Flop (didn't bet)
Seat 7: Fish4trips (button) folded before Flop (didn't bet)
Seat 8: scout326 (small blind) folded before Flop





PokerStars Hand #150126332762:  Hold'em No Limit ($0.50/$1.00 USD) - 2016/03/10 13:34:58 CET [2016/03/10 7:34:58 ET]
Table 'Mars III' 9-max Seat #3 is the button
Seat 1: blackw0lf_03 ($135.64 in chips) 
Seat 2: pokixy800 ($62.10 in chips) 
Seat 3: PacPacBum ($108.98 in chips) 
Seat 4: ki11u ($100 in chips) 
Seat 5: Slash3r ($63.95 in chips) 
Seat 6: matiko09 ($101.85 in chips) 
Seat 7: Sweden_Pound ($100 in chips) 
Seat 8: Filojoes ($100 in chips) 
ki11u: posts small blind $0.50
Slash3r: posts big blind $1
flk.Dasas: sits out 
*** HOLE CARDS ***
Dealt to matiko09 [4d Qc]
matiko09: folds 
Sweden_Pound: folds 
Filojoes: raises $2 to $3
blackw0lf_03: folds 
pokixy800: folds 
PacPacBum: folds 
ki11u: folds 
Slash3r: calls $2
*** FLOP *** [4c Jh 8c]
Slash3r: checks 
Filojoes: bets $3.73
Slash3r: calls $3.73
*** TURN *** [4c Jh 8c] [7d]
Slash3r: checks 
Filojoes: checks 
*** RIVER *** [4c Jh 8c 7d] [5s]
Slash3r: checks 
Filojoes: checks 
*** SHOW DOWN ***
Slash3r: shows [7c 2c] (a pair of Sevens)
Filojoes: mucks hand 
Slash3r collected $13.33 from pot
*** SUMMARY ***
Total pot $13.96 | Rake $0.63 
Board [4c Jh 8c 7d 5s]
Seat 1: blackw0lf_03 folded before Flop (didn't bet)
Seat 2: pokixy800 folded before Flop (didn't bet)
Seat 3: PacPacBum (button) folded before Flop (didn't bet)
Seat 4: ki11u (small blind) folded before Flop
Seat 5: Slash3r (big blind) showed [7c 2c] and won ($13.33) with a pair of Sevens
Seat 6: matiko09 folded before Flop (didn't bet)
Seat 7: Sweden_Pound folded before Flop (didn't bet)
Seat 8: Filojoes mucked [Kh Qs]





PokerStars Hand #150126332503:  Hold'em No Limit ($0.50/$1.00 USD) - 2016/03/10 13:34:58 CET [2016/03/10 7:34:58 ET]
Table 'Saskia' 9-max Seat #2 is the button
Seat 1: Sweden_Pound ($100 in chips) 
Seat 2: njurg aga ($92.74 in chips) 
Seat 3: ccmaster001 ($83.81 in chips) 
Seat 4: Plz3betMe ($69.72 in chips) 
Seat 5: dreded11 ($98.16 in chips) 
Seat 6: matiko09 ($109.38 in chips) 
Seat 7: stds st ($47.56 in chips) 
Seat 8: blackw0lf_03 ($103 in chips) 
Seat 9: er13to ($116.97 in chips) 
ccmaster001: posts small blind $0.50
Plz3betMe: posts big blind $1
*** HOLE CARDS ***
Dealt to matiko09 [Qs Ah]
dreded11: folds 
matiko09: raises $2 to $3
stds st: folds 
blackw0lf_03: folds 
er13to: folds 
Sweden_Pound: raises $6 to $9
njurg aga: folds 
ccmaster001: folds 
Plz3betMe: folds 
matiko09: folds 
Uncalled bet ($6) returned to Sweden_Pound
Sweden_Pound collected $7.50 from pot
Sweden_Pound: doesn't show hand 
*** SUMMARY ***
Total pot $7.50 | Rake $0 
Seat 1: Sweden_Pound collected ($7.50)
Seat 2: njurg aga (button) folded before Flop (didn't bet)
Seat 3: ccmaster001 (small blind) folded before Flop
Seat 4: Plz3betMe (big blind) folded before Flop
Seat 5: dreded11 folded before Flop (didn't bet)
Seat 6: matiko09 folded before Flop
Seat 7: stds st folded before Flop (didn't bet)
Seat 8: blackw0lf_03 folded before Flop (didn't bet)
Seat 9: er13to folded before Flop (didn't bet)





PokerStars Hand #150126334131:  Hold'em No Limit (€1/€2 EUR) - 2016/03/10 13:35:01 CET [2016/03/10 7:35:01 ET]
Table 'Sigrid II' 9-max Seat #4 is the button
Seat 1: Gamz11 (€212.93 in chips) 
Seat 2: stds st (€73.92 in chips) 
Seat 4: Fish4trips (€204.52 in chips) 
Seat 5: vr188 (€81.11 in chips) 
Seat 7: PacPacBum (€207.67 in chips) 
Seat 8: matiko09 (€203 in chips) 
Seat 9: ki11u (€226.25 in chips) 
vr188: posts small blind €1
PacPacBum: posts big blind €2
*** HOLE CARDS ***
Dealt to matiko09 [Qs 4c]
matiko09: folds 
ki11u: folds 
Gamz11: raises €4 to €6
stds st: calls €6
RoadtoNepal joins the table at seat #3 
Fish4trips: folds 
vr188: folds 
PacPacBum: folds 
*** FLOP *** [6d 2c 9c]
Gamz11: checks 
stds st: checks 
*** TURN *** [6d 2c 9c] [8s]
Gamz11: bets €9.88
stds st: calls €9.88
*** RIVER *** [6d 2c 9c 8s] [5c]
Gamz11: checks 
stds st: checks 
*** SHOW DOWN ***
Gamz11: shows [Th Kh] (high card King)
stds st: shows [Ac Qd] (high card Ace)
stds st collected €33.20 from pot
*** SUMMARY ***
Total pot €34.76 | Rake €1.56 
Board [6d 2c 9c 8s 5c]
Seat 1: Gamz11 showed [Th Kh] and lost with high card King
Seat 2: stds st showed [Ac Qd] and won (€33.20) with high card Ace
Seat 4: Fish4trips (button) folded before Flop (didn't bet)
Seat 5: vr188 (small blind) folded before Flop
Seat 7: PacPacBum (big blind) folded before Flop
Seat 8: matiko09 folded before Flop (didn't bet)
Seat 9: ki11u folded before Flop (didn't bet)





PokerStars Hand #150126346334:  Hold'em No Limit ($0.50/$1.00 USD) - 2016/03/10 13:35:23 CET [2016/03/10 7:35:23 ET]
Table 'Liriope II' 9-max Seat #4 is the button
Seat 1: UnBent022 ($100 in chips) 
Seat 2: zxp12345 ($45.78 in chips) 
Seat 3: matiko09 ($164.51 in chips) 
Seat 4: Plz3betMe ($45.93 in chips) 
Seat 5: lumen21 ($104.18 in chips) 
Seat 6: nobu-azabu ($187.10 in chips) 
Seat 7: Sweden_Pound ($100 in chips) 
Seat 8: PacPacBum ($113.21 in chips) 
lumen21: posts small blind $0.50
nobu-azabu: posts big blind $1
*** HOLE CARDS ***
Dealt to matiko09 [3c Qh]
Sweden_Pound: folds 
PacPacBum: folds 
UnBent022: folds 
zxp12345: folds 
matiko09: folds 
Plz3betMe: folds 
lumen21: folds 
Uncalled bet ($0.50) returned to nobu-azabu
nobu-azabu collected $1 from pot
nobu-azabu: doesn't show hand 
*** SUMMARY ***
Total pot $1 | Rake $0 
Seat 1: UnBent022 folded before Flop (didn't bet)
Seat 2: zxp12345 folded before Flop (didn't bet)
Seat 3: matiko09 folded before Flop (didn't bet)
Seat 4: Plz3betMe (button) folded before Flop (didn't bet)
Seat 5: lumen21 (small blind) folded before Flop
Seat 6: nobu-azabu (big blind) collected ($1)
Seat 7: Sweden_Pound folded before Flop (didn't bet)
Seat 8: PacPacBum folded before Flop (didn't bet)





PokerStars Hand #150126346968:  Hold'em No Limit ($0.50/$1.00 USD) - 2016/03/10 13:35:24 CET [2016/03/10 7:35:24 ET]
Table 'Iguassu' 9-max Seat #7 is the button
Seat 1: blackw0lf_03 ($101.50 in chips) 
Seat 2: Rocky6434 ($58.75 in chips) 
Seat 3: hammerwife ($121.93 in chips) 
Seat 4: matiko09 ($100 in chips) 
Seat 5: UnBent022 ($100 in chips) 
Seat 6: Igor DoUrden ($118.58 in chips) 
Seat 7: PacPacBum ($120.05 in chips) 
Seat 8: Filojoes ($100 in chips) 
Seat 9: er13to ($100 in chips) 
Filojoes: posts small blind $0.50
er13to: posts big blind $1
*** HOLE CARDS ***
Dealt to matiko09 [7s 5h]
blackw0lf_03: folds 
Rocky6434: folds 
hammerwife: raises $2 to $3
matiko09: folds 
UnBent022: folds 
Igor DoUrden: folds 
PacPacBum: folds 
Filojoes: folds 
er13to: folds 
Uncalled bet ($2) returned to hammerwife
hammerwife collected $2.50 from pot
hammerwife: doesn't show hand 
*** SUMMARY ***
Total pot $2.50 | Rake $0 
Seat 1: blackw0lf_03 folded before Flop (didn't bet)
Seat 2: Rocky6434 folded before Flop (didn't bet)
Seat 3: hammerwife collected ($2.50)
Seat 4: matiko09 folded before Flop (didn't bet)
Seat 5: UnBent022 folded before Flop (didn't bet)
Seat 6: Igor DoUrden folded before Flop (didn't bet)
Seat 7: PacPacBum (button) folded before Flop (didn't bet)
Seat 8: Filojoes (small blind) folded before Flop
Seat 9: er13to (big blind) folded before Flop





PokerStars Hand #150126348482:  Hold'em No Limit ($0.50/$1.00 USD) - 2016/03/10 13:35:27 CET [2016/03/10 7:35:27 ET]
Table 'Leuschneria II' 9-max Seat #5 is the button
Seat 1: SHARKFIN168 ($97 in chips) 
Seat 2: blackw0lf_03 ($100 in chips) 
Seat 4: Sweden_Pound ($135.22 in chips) 
Seat 5: RMilPoker ($222.04 in chips) 
Seat 6: matiko09 ($112.33 in chips) 
Seat 7: Plz3betMe ($40 in chips) 
Seat 8: UnBent022 ($102.75 in chips) 
Seat 9: ki11u ($100 in chips) 
matiko09: posts small blind $0.50
Plz3betMe: posts big blind $1
Spid1: sits out 
*** HOLE CARDS ***
Dealt to matiko09 [Ac 9c]
UnBent022: folds 
ki11u: folds 
SHARKFIN168: folds 
blackw0lf_03: folds 
Sweden_Pound: folds 
RMilPoker: folds 
matiko09: raises $1.50 to $2.50
Plz3betMe: calls $1.50
*** FLOP *** [Jc 2c 4c]
matiko09: bets $3.11
Plz3betMe: folds 
Uncalled bet ($3.11) returned to matiko09
matiko09 collected $4.78 from pot
matiko09: doesn't show hand 
*** SUMMARY ***
Total pot $5 | Rake $0.22 
Board [Jc 2c 4c]
Seat 1: SHARKFIN168 folded before Flop (didn't bet)
Seat 2: blackw0lf_03 folded before Flop (didn't bet)
Seat 4: Sweden_Pound folded before Flop (didn't bet)
Seat 5: RMilPoker (button) folded before Flop (didn't bet)
Seat 6: matiko09 (small blind) collected ($4.78)
Seat 7: Plz3betMe (big blind) folded on the Flop
Seat 8: UnBent022 folded before Flop (didn't bet)
Seat 9: ki11u folded before Flop (didn't bet)





PokerStars Hand #150126350236:  Hold'em No Limit ($1/$2 USD) - 2016/03/10 13:35:31 CET [2016/03/10 7:35:31 ET]
Table 'Chandra II' 9-max Seat #8 is the button
Seat 1: Fish4trips ($318.75 in chips) 
Seat 2: PacPacBum ($237.51 in chips) 
Seat 4: tipner ($200 in chips) 
Seat 5: uibting ($48.03 in chips) 
Seat 6: stds st ($72.31 in chips) 
Seat 7: johnvu2016 ($155.97 in chips) 
Seat 8: matiko09 ($200 in chips) 
Seat 9: o.miro ($271.03 in chips) 
o.miro: posts small blind $1
Fish4trips: posts big blind $2
*** HOLE CARDS ***
Dealt to matiko09 [Kh 7d]
PacPacBum: folds 
tipner: folds 
uibting: folds 
stds st: folds 
johnvu2016: raises $4 to $6
matiko09: folds 
o.miro: folds 
Fish4trips: folds 
Uncalled bet ($4) returned to johnvu2016
johnvu2016 collected $5 from pot
*** SUMMARY ***
Total pot $5 | Rake $0 
Seat 1: Fish4trips (big blind) folded before Flop
Seat 2: PacPacBum folded before Flop (didn't bet)
Seat 4: tipner folded before Flop (didn't bet)
Seat 5: uibting folded before Flop (didn't bet)
Seat 6: stds st folded before Flop (didn't bet)
Seat 7: johnvu2016 collected ($5)
Seat 8: matiko09 (button) folded before Flop (didn't bet)
Seat 9: o.miro (small blind) folded before Flop





PokerStars Hand #150126363531:  Hold'em No Limit ($0.50/$1.00 USD) - 2016/03/10 13:35:56 CET [2016/03/10 7:35:56 ET]
Table 'Saskia' 9-max Seat #3 is the button
Seat 1: Sweden_Pound ($104.50 in chips) 
Seat 2: njurg aga ($92.74 in chips) 
Seat 3: ccmaster001 ($83.31 in chips) 
Seat 4: Plz3betMe ($68.72 in chips) 
Seat 5: dreded11 ($98.16 in chips) 
Seat 6: matiko09 ($106.38 in chips) 
Seat 7: stds st ($47.56 in chips) 
Seat 8: blackw0lf_03 ($103 in chips) 
Seat 9: er13to ($116.97 in chips) 
Plz3betMe: posts small blind $0.50
dreded11: posts big blind $1
*** HOLE CARDS ***
Dealt to matiko09 [3c 9s]
matiko09: folds 
stds st: raises $1.02 to $2.02
blackw0lf_03: folds 
er13to: folds 
Sweden_Pound: folds 
njurg aga: folds 
ccmaster001: folds 
Plz3betMe: folds 
dreded11: folds 
Uncalled bet ($1.02) returned to stds st
stds st collected $2.50 from pot
stds st: doesn't show hand 
*** SUMMARY ***
Total pot $2.50 | Rake $0 
Seat 1: Sweden_Pound folded before Flop (didn't bet)
Seat 2: njurg aga folded before Flop (didn't bet)
Seat 3: ccmaster001 (button) folded before Flop (didn't bet)
Seat 4: Plz3betMe (small blind) folded before Flop
Seat 5: dreded11 (big blind) folded before Flop
Seat 6: matiko09 folded before Flop (didn't bet)
Seat 7: stds st collected ($2.50)
Seat 8: blackw0lf_03 folded before Flop (didn't bet)
Seat 9: er13to folded before Flop (didn't bet)





PokerStars Hand #150126365338:  Hold'em No Limit ($0.25/$0.50 USD) - 2016/03/10 13:35:59 CET [2016/03/10 7:35:59 ET]
Table 'Aegina' 9-max Seat #7 is the button
Seat 1: BingoIng0 ($116.60 in chips) 
Seat 2: dvutavr ($109.78 in chips) 
Seat 3: Fandango1991 ($79.58 in chips) 
Seat 4: digimatical ($76.21 in chips) 
Seat 5: Ahangama ($50 in chips) 
Seat 6: matiko09 ($54.79 in chips) 
Seat 7: Gummio ($115.15 in chips) 
Seat 8: ardo888 ($179.74 in chips) 
Seat 9: draken08 ($127.06 in chips) 
ardo888: posts small blind $0.25
draken08: posts big blind $0.50
BingoIng0: posts the ante $0.10
dvutavr: posts the ante $0.10
Fandango1991: posts the ante $0.10
digimatical: posts the ante $0.10
Ahangama: posts the ante $0.10
matiko09: posts the ante $0.10
Gummio: posts the ante $0.10
ardo888: posts the ante $0.10
draken08: posts the ante $0.10
*** HOLE CARDS ***
Dealt to matiko09 [Jd 6h]
BingoIng0: raises $1 to $1.50
dvutavr: folds 
Fandango1991: folds 
digimatical: folds 
Ahangama: folds 
matiko09: folds 
Gummio: folds 
ardo888: folds 
draken08: folds 
Uncalled bet ($1) returned to BingoIng0
BingoIng0 collected $2.15 from pot
BingoIng0: doesn't show hand 
*** SUMMARY ***
Total pot $2.15 | Rake $0 
Seat 1: BingoIng0 collected ($2.15)
Seat 2: dvutavr folded before Flop (didn't bet)
Seat 3: Fandango1991 folded before Flop (didn't bet)
Seat 4: digimatical folded before Flop (didn't bet)
Seat 5: Ahangama folded before Flop (didn't bet)
Seat 6: matiko09 folded before Flop (didn't bet)
Seat 7: Gummio (button) folded before Flop (didn't bet)
Seat 8: ardo888 (small blind) folded before Flop
Seat 9: draken08 (big blind) folded before Flop





PokerStars Hand #150126373557:  Hold'em No Limit ($0.50/$1.00 USD) - 2016/03/10 13:36:14 CET [2016/03/10 7:36:14 ET]
Table 'Liriope II' 9-max Seat #5 is the button
Seat 1: UnBent022 ($100 in chips) 
Seat 2: zxp12345 ($45.78 in chips) 
Seat 3: matiko09 ($164.51 in chips) 
Seat 4: Plz3betMe ($45.93 in chips) 
Seat 5: lumen21 ($103.68 in chips) 
Seat 6: nobu-azabu ($187.60 in chips) 
Seat 7: Sweden_Pound ($100 in chips) 
Seat 8: PacPacBum ($113.21 in chips) 
nobu-azabu: posts small blind $0.50
Sweden_Pound: posts big blind $1
*** HOLE CARDS ***
Dealt to matiko09 [7c Qc]
PacPacBum: folds 
UnBent022: folds 
zxp12345: calls $1
matiko09: folds 
Plz3betMe: folds 
lumen21: folds 
nobu-azabu: calls $0.50
Sweden_Pound: checks 
*** FLOP *** [2h 4s 7h]
nobu-azabu: bets $2
Sweden_Pound: folds 
zxp12345: calls $2
*** TURN *** [2h 4s 7h] [Kd]
nobu-azabu: bets $3.34
zxp12345: folds 
Uncalled bet ($3.34) returned to nobu-azabu
nobu-azabu collected $6.68 from pot
*** SUMMARY ***
Total pot $7 | Rake $0.32 
Board [2h 4s 7h Kd]
Seat 1: UnBent022 folded before Flop (didn't bet)
Seat 2: zxp12345 folded on the Turn
Seat 3: matiko09 folded before Flop (didn't bet)
Seat 4: Plz3betMe folded before Flop (didn't bet)
Seat 5: lumen21 (button) folded before Flop (didn't bet)
Seat 6: nobu-azabu (small blind) collected ($6.68)
Seat 7: Sweden_Pound (big blind) folded on the Flop
Seat 8: PacPacBum folded before Flop (didn't bet)





PokerStars Hand #150126375206:  Hold'em No Limit ($1/$2 USD) - 2016/03/10 13:36:17 CET [2016/03/10 7:36:17 ET]
Table 'Chandra II' 9-max Seat #9 is the button
Seat 1: Fish4trips ($316.75 in chips) 
Seat 2: PacPacBum ($237.51 in chips) 
Seat 4: tipner ($200 in chips) 
Seat 5: uibting ($48.03 in chips) 
Seat 6: stds st ($72.31 in chips) 
Seat 7: johnvu2016 ($158.97 in chips) 
Seat 8: matiko09 ($200 in chips) 
Seat 9: o.miro ($270.03 in chips) 
Fish4trips: posts small blind $1
PacPacBum: posts big blind $2
*** HOLE CARDS ***
Dealt to matiko09 [6h Jd]
tipner: folds 
uibting: folds 
stds st: raises $2.04 to $4.04
johnvu2016: folds 
matiko09: folds 
o.miro: folds 
Fish4trips: folds 
PacPacBum: folds 
Uncalled bet ($2.04) returned to stds st
stds st collected $5 from pot
stds st: doesn't show hand 
*** SUMMARY ***
Total pot $5 | Rake $0 
Seat 1: Fish4trips (small blind) folded before Flop
Seat 2: PacPacBum (big blind) folded before Flop
Seat 4: tipner folded before Flop (didn't bet)
Seat 5: uibting folded before Flop (didn't bet)
Seat 6: stds st collected ($5)
Seat 7: johnvu2016 folded before Flop (didn't bet)
Seat 8: matiko09 folded before Flop (didn't bet)
Seat 9: o.miro (button) folded before Flop (didn't bet)





PokerStars Hand #150126375695:  Hold'em No Limit ($0.50/$1.00 USD) - 2016/03/10 13:36:18 CET [2016/03/10 7:36:18 ET]
Table 'Iguassu' 9-max Seat #8 is the button
Seat 1: blackw0lf_03 ($101.50 in chips) 
Seat 2: Rocky6434 ($58.75 in chips) 
Seat 3: hammerwife ($123.43 in chips) 
Seat 4: matiko09 ($100 in chips) 
Seat 5: UnBent022 ($100 in chips) 
Seat 6: Igor DoUrden ($118.58 in chips) 
Seat 7: PacPacBum ($120.05 in chips) 
Seat 8: Filojoes ($100 in chips) 
Seat 9: er13to ($100 in chips) 
er13to: posts small blind $0.50
blackw0lf_03: posts big blind $1
*** HOLE CARDS ***
Dealt to matiko09 [Ad 2s]
Rocky6434: folds 
hammerwife: raises $2 to $3
matiko09: folds 
UnBent022: folds 
Igor DoUrden: folds 
PacPacBum: folds 
Filojoes: folds 
er13to: folds 
blackw0lf_03: folds 
Uncalled bet ($2) returned to hammerwife
hammerwife collected $2.50 from pot
hammerwife: doesn't show hand 
*** SUMMARY ***
Total pot $2.50 | Rake $0 
Seat 1: blackw0lf_03 (big blind) folded before Flop
Seat 2: Rocky6434 folded before Flop (didn't bet)
Seat 3: hammerwife collected ($2.50)
Seat 4: matiko09 folded before Flop (didn't bet)
Seat 5: UnBent022 folded before Flop (didn't bet)
Seat 6: Igor DoUrden folded before Flop (didn't bet)
Seat 7: PacPacBum folded before Flop (didn't bet)
Seat 8: Filojoes (button) folded before Flop (didn't bet)
Seat 9: er13to (small blind) folded before Flop





PokerStars Hand #150126379276:  Hold'em No Limit ($0.50/$1.00 USD) - 2016/03/10 13:36:25 CET [2016/03/10 7:36:25 ET]
Table 'Saskia' 9-max Seat #4 is the button
Seat 1: Sweden_Pound ($104.50 in chips) 
Seat 2: njurg aga ($92.74 in chips) 
Seat 3: ccmaster001 ($83.31 in chips) 
Seat 4: Plz3betMe ($68.22 in chips) 
Seat 5: dreded11 ($97.16 in chips) 
Seat 6: matiko09 ($106.38 in chips) 
Seat 7: stds st ($49.06 in chips) 
Seat 8: blackw0lf_03 ($103 in chips) 
Seat 9: er13to ($116.97 in chips) 
dreded11: posts small blind $0.50
matiko09: posts big blind $1
*** HOLE CARDS ***
Dealt to matiko09 [4s 7d]
stds st: folds 
blackw0lf_03: raises $2 to $3
er13to: folds 
Sweden_Pound: folds 
njurg aga: folds 
ccmaster001: folds 
Plz3betMe: folds 
dreded11: folds 
matiko09: folds 
Uncalled bet ($2) returned to blackw0lf_03
blackw0lf_03 collected $2.50 from pot
blackw0lf_03: doesn't show hand 
*** SUMMARY ***
Total pot $2.50 | Rake $0 
Seat 1: Sweden_Pound folded before Flop (didn't bet)
Seat 2: njurg aga folded before Flop (didn't bet)
Seat 3: ccmaster001 folded before Flop (didn't bet)
Seat 4: Plz3betMe (button) folded before Flop (didn't bet)
Seat 5: dreded11 (small blind) folded before Flop
Seat 6: matiko09 (big blind) folded before Flop
Seat 7: stds st folded before Flop (didn't bet)
Seat 8: blackw0lf_03 collected ($2.50)
Seat 9: er13to folded before Flop (didn't bet)





PokerStars Hand #150126383004:  Hold'em No Limit ($0.50/$1.00 USD) - 2016/03/10 13:36:32 CET [2016/03/10 7:36:32 ET]
Table 'Leuschneria II' 9-max Seat #6 is the button
Seat 1: SHARKFIN168 ($97 in chips) 
Seat 2: blackw0lf_03 ($100 in chips) 
Seat 4: Sweden_Pound ($135.22 in chips) 
Seat 5: RMilPoker ($222.04 in chips) 
Seat 6: matiko09 ($114.61 in chips) 
Seat 7: Plz3betMe ($37.50 in chips) 
Seat 8: UnBent022 ($102.75 in chips) 
Seat 9: ki11u ($100 in chips) 
Plz3betMe: posts small blind $0.50
UnBent022: posts big blind $1
Spid1: sits out 
*** HOLE CARDS ***
Dealt to matiko09 [8c 3c]
ki11u: folds 
SHARKFIN168: folds 
blackw0lf_03: folds 
Sweden_Pound: folds 
RMilPoker: folds 
matiko09: folds 
Plz3betMe: raises $1.50 to $2.50
UnBent022: raises $5.50 to $8
Plz3betMe: folds 
Uncalled bet ($5.50) returned to UnBent022
UnBent022 collected $5 from pot
UnBent022: doesn't show hand 
*** SUMMARY ***
Total pot $5 | Rake $0 
Seat 1: SHARKFIN168 folded before Flop (didn't bet)
Seat 2: blackw0lf_03 folded before Flop (didn't bet)
Seat 4: Sweden_Pound folded before Flop (didn't bet)
Seat 5: RMilPoker folded before Flop (didn't bet)
Seat 6: matiko09 (button) folded before Flop (didn't bet)
Seat 7: Plz3betMe (small blind) folded before Flop
Seat 8: UnBent022 (big blind) collected ($5)
Seat 9: ki11u folded before Flop (didn't bet)





PokerStars Hand #150126386659:  Hold'em No Limit ($0.50/$1.00 USD) - 2016/03/10 13:36:39 CET [2016/03/10 7:36:39 ET]
Table 'Mars III' 9-max Seat #4 is the button
Seat 1: blackw0lf_03 ($135.64 in chips) 
Seat 2: pokixy800 ($62.10 in chips) 
Seat 3: PacPacBum ($108.98 in chips) 
Seat 4: ki11u ($100 in chips) 
Seat 5: Slash3r ($70.55 in chips) 
Seat 6: matiko09 ($101.85 in chips) 
Seat 7: Sweden_Pound ($100 in chips) 
Seat 8: Filojoes ($100 in chips) 
Slash3r: posts small blind $0.50
matiko09: posts big blind $1
flk.Dasas: sits out 
*** HOLE CARDS ***
Dealt to matiko09 [8c 6s]
Sweden_Pound: folds 
Filojoes: folds 
blackw0lf_03: folds 
pokixy800: raises $1.50 to $2.50
PacPacBum: folds 
ki11u: folds 
Slash3r: folds 
matiko09: folds 
Uncalled bet ($1.50) returned to pokixy800
pokixy800 collected $2.50 from pot
*** SUMMARY ***
Total pot $2.50 | Rake $0 
Seat 1: blackw0lf_03 folded before Flop (didn't bet)
Seat 2: pokixy800 collected ($2.50)
Seat 3: PacPacBum folded before Flop (didn't bet)
Seat 4: ki11u (button) folded before Flop (didn't bet)
Seat 5: Slash3r (small blind) folded before Flop
Seat 6: matiko09 (big blind) folded before Flop
Seat 7: Sweden_Pound folded before Flop (didn't bet)
Seat 8: Filojoes folded before Flop (didn't bet)





PokerStars Hand #150126386531:  Hold'em No Limit ($0.50/$1.00 USD) - 2016/03/10 13:36:39 CET [2016/03/10 7:36:39 ET]
Table 'Virgo II' 9-max Seat #8 is the button
Seat 2: Plz3betMe ($54.77 in chips) 
Seat 3: blackw0lf_03 ($108.05 in chips) 
Seat 4: UnBent022 ($103.96 in chips) 
Seat 5: stds st ($38.27 in chips) 
Seat 6: PacPacBum ($134.95 in chips) 
Seat 7: mamilets ($56.56 in chips) 
Seat 8: Sweden_Pound ($136.09 in chips) 
Seat 9: matiko09 ($100 in chips) 
matiko09: posts small blind $0.50
cdv1984: is sitting out 
Plz3betMe: posts big blind $1
*** HOLE CARDS ***
Dealt to matiko09 [Qd Jh]
blackw0lf_03: folds 
UnBent022: folds 
cdv1984 leaves the table
stds st: folds 
PacPacBum: folds 
mamilets: raises $2 to $3
Sweden_Pound: calls $3
matiko09: folds 
Plz3betMe: folds 
*** FLOP *** [8d 4h 4c]
mamilets: bets $4
Sweden_Pound: calls $4
*** TURN *** [8d 4h 4c] [2d]
mamilets: bets $6
Sweden_Pound: raises $14 to $20
mamilets: calls $14
*** RIVER *** [8d 4h 4c 2d] [Ts]
mamilets: checks 
Filojoes joins the table at seat #1 
Sweden_Pound: bets $34.45
mamilets: calls $29.56 and is all-in
Uncalled bet ($4.89) returned to Sweden_Pound
*** SHOW DOWN ***
Sweden_Pound: shows [5d 4d] (three of a kind, Fours)
mamilets: shows [7s 7c] (two pair, Sevens and Fours)
Sweden_Pound collected $111.82 from pot
*** SUMMARY ***
Total pot $114.62 | Rake $2.80 
Board [8d 4h 4c 2d Ts]
Seat 2: Plz3betMe (big blind) folded before Flop
Seat 3: blackw0lf_03 folded before Flop (didn't bet)
Seat 4: UnBent022 folded before Flop (didn't bet)
Seat 5: stds st folded before Flop (didn't bet)
Seat 6: PacPacBum folded before Flop (didn't bet)
Seat 7: mamilets showed [7s 7c] and lost with two pair, Sevens and Fours
Seat 8: Sweden_Pound (button) showed [5d 4d] and won ($111.82) with three of a kind, Fours
Seat 9: matiko09 (small blind) folded before Flop





PokerStars Hand #150126387699:  Hold'em No Limit ($0.25/$0.50 USD) - 2016/03/10 13:36:41 CET [2016/03/10 7:36:41 ET]
Table 'Aegina' 9-max Seat #8 is the button
Seat 1: BingoIng0 ($118.15 in chips) 
Seat 2: dvutavr ($109.68 in chips) 
Seat 3: Fandango1991 ($79.48 in chips) 
Seat 4: digimatical ($76.11 in chips) 
Seat 5: Ahangama ($50 in chips) 
Seat 6: matiko09 ($54.69 in chips) 
Seat 7: Gummio ($115.05 in chips) 
Seat 8: ardo888 ($179.39 in chips) 
Seat 9: draken08 ($126.46 in chips) 
draken08: posts small blind $0.25
BingoIng0: posts big blind $0.50
BingoIng0: posts the ante $0.10
dvutavr: posts the ante $0.10
Fandango1991: posts the ante $0.10
digimatical: posts the ante $0.10
Ahangama: posts the ante $0.10
matiko09: posts the ante $0.10
Gummio: posts the ante $0.10
ardo888: posts the ante $0.10
draken08: posts the ante $0.10
*** HOLE CARDS ***
Dealt to matiko09 [3d Jd]
dvutavr: folds 
Fandango1991: folds 
digimatical: calls $0.50
Fandango1991 leaves the table
MyMilkCans=D joins the table at seat #3 
Ahangama: folds 
matiko09: folds 
Gummio: folds 
ardo888: folds 
draken08: folds 
BingoIng0: checks 
*** FLOP *** [7h 4c 9s]
BingoIng0: checks 
digimatical: bets $1
BingoIng0: calls $1
*** TURN *** [7h 4c 9s] [3s]
BingoIng0: checks 
digimatical: bets $1
BingoIng0: folds 
Uncalled bet ($1) returned to digimatical
digimatical collected $3.96 from pot
*** SUMMARY ***
Total pot $4.15 | Rake $0.19 
Board [7h 4c 9s 3s]
Seat 1: BingoIng0 (big blind) folded on the Turn
Seat 2: dvutavr folded before Flop (didn't bet)
Seat 3: Fandango1991 folded before Flop (didn't bet)
Seat 4: digimatical collected ($3.96)
Seat 5: Ahangama folded before Flop (didn't bet)
Seat 6: matiko09 folded before Flop (didn't bet)
Seat 7: Gummio folded before Flop (didn't bet)
Seat 8: ardo888 (button) folded before Flop (didn't bet)
Seat 9: draken08 (small blind) folded before Flop





PokerStars Hand #150126389832:  Hold'em No Limit ($0.50/$1.00 USD) - 2016/03/10 13:36:45 CET [2016/03/10 7:36:45 ET]
Table 'Iguassu' 9-max Seat #9 is the button
Seat 1: blackw0lf_03 ($100.50 in chips) 
Seat 2: Rocky6434 ($58.75 in chips) 
Seat 3: hammerwife ($124.93 in chips) 
Seat 4: matiko09 ($100 in chips) 
Seat 5: UnBent022 ($100 in chips) 
Seat 6: Igor DoUrden ($118.58 in chips) 
Seat 7: PacPacBum ($120.05 in chips) 
Seat 8: Filojoes ($100 in chips) 
Seat 9: er13to ($100 in chips) 
blackw0lf_03: posts small blind $0.50
Rocky6434: posts big blind $1
*** HOLE CARDS ***
Dealt to matiko09 [Ks 2d]
hammerwife: folds 
matiko09: folds 
UnBent022: folds 
Igor DoUrden: folds 
PacPacBum: folds 
Filojoes: raises $1.50 to $2.50
er13to: raises $5.50 to $8
blackw0lf_03: folds 
Rocky6434: folds 
Filojoes: calls $5.50
*** FLOP *** [9c 5s 6d]
Filojoes: checks 
er13to: bets $11.02
Filojoes: calls $11.02
*** TURN *** [9c 5s 6d] [Kh]
Filojoes: checks 
er13to: checks 
*** RIVER *** [9c 5s 6d Kh] [Qh]
Filojoes: checks 
er13to: checks 
*** SHOW DOWN ***
Filojoes: shows [Tc Jc] (a straight, Nine to King)
er13to: mucks hand 
Filojoes collected $37.76 from pot
*** SUMMARY ***
Total pot $39.54 | Rake $1.78 
Board [9c 5s 6d Kh Qh]
Seat 1: blackw0lf_03 (small blind) folded before Flop
Seat 2: Rocky6434 (big blind) folded before Flop
Seat 3: hammerwife folded before Flop (didn't bet)
Seat 4: matiko09 folded before Flop (didn't bet)
Seat 5: UnBent022 folded before Flop (didn't bet)
Seat 6: Igor DoUrden folded before Flop (didn't bet)
Seat 7: PacPacBum folded before Flop (didn't bet)
Seat 8: Filojoes showed [Tc Jc] and won ($37.76) with a straight, Nine to King
Seat 9: er13to (button) mucked [Th 9s]





PokerStars Hand #150126393142:  Hold'em No Limit ($1/$2 USD) - 2016/03/10 13:36:51 CET [2016/03/10 7:36:51 ET]
Table 'Chandra II' 9-max Seat #1 is the button
Seat 1: Fish4trips ($315.75 in chips) 
Seat 2: PacPacBum ($235.51 in chips) 
Seat 4: tipner ($200 in chips) 
Seat 5: uibting ($48.03 in chips) 
Seat 6: stds st ($75.31 in chips) 
Seat 7: johnvu2016 ($158.97 in chips) 
Seat 8: matiko09 ($200 in chips) 
Seat 9: o.miro ($270.03 in chips) 
PacPacBum: posts small blind $1
tipner: posts big blind $2
*** HOLE CARDS ***
Dealt to matiko09 [4s 9c]
uibting: folds 
stds st: raises $2.04 to $4.04
johnvu2016: folds 
matiko09: folds 
o.miro: folds 
Fish4trips: folds 
PacPacBum: folds 
tipner: folds 
Uncalled bet ($2.04) returned to stds st
stds st collected $5 from pot
stds st: doesn't show hand 
*** SUMMARY ***
Total pot $5 | Rake $0 
Seat 1: Fish4trips (button) folded before Flop (didn't bet)
Seat 2: PacPacBum (small blind) folded before Flop
Seat 4: tipner (big blind) folded before Flop
Seat 5: uibting folded before Flop (didn't bet)
Seat 6: stds st collected ($5)
Seat 7: johnvu2016 folded before Flop (didn't bet)
Seat 8: matiko09 folded before Flop (didn't bet)
Seat 9: o.miro folded before Flop (didn't bet)





PokerStars Hand #150126395692:  Hold'em No Limit ($0.50/$1.00 USD) - 2016/03/10 13:36:56 CET [2016/03/10 7:36:56 ET]
Table 'Saskia' 9-max Seat #5 is the button
Seat 1: Sweden_Pound ($104.50 in chips) 
Seat 2: njurg aga ($92.74 in chips) 
Seat 3: ccmaster001 ($83.31 in chips) 
Seat 4: Plz3betMe ($68.22 in chips) 
Seat 5: dreded11 ($96.66 in chips) 
Seat 6: matiko09 ($105.38 in chips) 
Seat 7: stds st ($49.06 in chips) 
Seat 8: blackw0lf_03 ($104.50 in chips) 
Seat 9: er13to ($116.97 in chips) 
matiko09: posts small blind $0.50
stds st: posts big blind $1
*** HOLE CARDS ***
Dealt to matiko09 [3h 8s]
blackw0lf_03: folds 
er13to: folds 
Sweden_Pound: folds 
njurg aga: folds 
ccmaster001: folds 
Plz3betMe: folds 
dreded11: folds 
matiko09: folds 
Uncalled bet ($0.50) returned to stds st
stds st collected $1 from pot
stds st: doesn't show hand 
*** SUMMARY ***
Total pot $1 | Rake $0 
Seat 1: Sweden_Pound folded before Flop (didn't bet)
Seat 2: njurg aga folded before Flop (didn't bet)
Seat 3: ccmaster001 folded before Flop (didn't bet)
Seat 4: Plz3betMe folded before Flop (didn't bet)
Seat 5: dreded11 (button) folded before Flop (didn't bet)
Seat 6: matiko09 (small blind) folded before Flop
Seat 7: stds st (big blind) collected ($1)
Seat 8: blackw0lf_03 folded before Flop (didn't bet)
Seat 9: er13to folded before Flop (didn't bet)





PokerStars Hand #150126402050:  Hold'em No Limit (€1/€2 EUR) - 2016/03/10 13:37:08 CET [2016/03/10 7:37:08 ET]
Table 'Sigrid II' 9-max Seat #5 is the button
Seat 1: Gamz11 (€200 in chips) 
Seat 2: stds st (€91.24 in chips) 
Seat 4: Fish4trips (€204.52 in chips) 
Seat 5: vr188 (€80.11 in chips) 
Seat 7: PacPacBum (€205.67 in chips) 
Seat 8: matiko09 (€203 in chips) 
Seat 9: ki11u (€226.25 in chips) 
PacPacBum: posts small blind €1
matiko09: posts big blind €2
RoadtoNepal: sits out 
*** HOLE CARDS ***
Dealt to matiko09 [Kh 9c]
ki11u: folds 
Gamz11: folds 
stds st: folds 
Fish4trips: folds 
vr188: folds 
PacPacBum: raises €3 to €5
matiko09: calls €3
*** FLOP *** [Td Kc Qh]
PacPacBum: checks 
matiko09: bets €6.21
PacPacBum: calls €6.21
*** TURN *** [Td Kc Qh] [4d]
PacPacBum: checks 
matiko09: checks 
*** RIVER *** [Td Kc Qh 4d] [4s]
PacPacBum: checks 
matiko09: checks 
*** SHOW DOWN ***
PacPacBum: shows [Jd Kd] (two pair, Kings and Fours)
matiko09: shows [Kh 9c] (two pair, Kings and Fours)
PacPacBum collected €10.71 from pot
matiko09 collected €10.70 from pot
*** SUMMARY ***
Total pot €22.42 | Rake €1.01 
Board [Td Kc Qh 4d 4s]
Seat 1: Gamz11 folded before Flop (didn't bet)
Seat 2: stds st folded before Flop (didn't bet)
Seat 4: Fish4trips folded before Flop (didn't bet)
Seat 5: vr188 (button) folded before Flop (didn't bet)
Seat 7: PacPacBum (small blind) showed [Jd Kd] and won (€10.71) with two pair, Kings and Fours
Seat 8: matiko09 (big blind) showed [Kh 9c] and won (€10.70) with two pair, Kings and Fours
Seat 9: ki11u folded before Flop (didn't bet)





PokerStars Hand #150126408866:  Hold'em No Limit ($1/$2 USD) - 2016/03/10 13:37:21 CET [2016/03/10 7:37:21 ET]
Table 'Chandra II' 9-max Seat #2 is the button
Seat 1: Fish4trips ($315.75 in chips) 
Seat 2: PacPacBum ($234.51 in chips) 
Seat 4: tipner ($200 in chips) 
Seat 5: uibting ($48.03 in chips) 
Seat 6: stds st ($78.31 in chips) 
Seat 7: johnvu2016 ($158.97 in chips) 
Seat 8: matiko09 ($200 in chips) 
Seat 9: o.miro ($270.03 in chips) 
tipner: posts small blind $1
uibting: posts big blind $2
*** HOLE CARDS ***
Dealt to matiko09 [Qs Qd]
stds st: folds 
johnvu2016: folds 
matiko09: raises $3 to $5
o.miro: folds 
Fish4trips: calls $5
PacPacBum: folds 
tipner: calls $4
uibting: calls $3
*** FLOP *** [Kc Kd 7s]
tipner: checks 
uibting: checks 
matiko09: checks 
Fish4trips: bets $10.31
tipner: folds 
uibting: folds 
matiko09: calls $10.31
*** TURN *** [Kc Kd 7s] [Js]
matiko09: checks 
Fish4trips: checks 
*** RIVER *** [Kc Kd 7s Js] [Jh]
matiko09: checks 
Fish4trips: checks 
*** SHOW DOWN ***
matiko09: shows [Qs Qd] (two pair, Kings and Queens)
Fish4trips: mucks hand 
matiko09 collected $38.79 from pot
*** SUMMARY ***
Total pot $40.62 | Rake $1.83 
Board [Kc Kd 7s Js Jh]
Seat 1: Fish4trips mucked [Th Tc]
Seat 2: PacPacBum (button) folded before Flop (didn't bet)
Seat 4: tipner (small blind) folded on the Flop
Seat 5: uibting (big blind) folded on the Flop
Seat 6: stds st folded before Flop (didn't bet)
Seat 7: johnvu2016 folded before Flop (didn't bet)
Seat 8: matiko09 showed [Qs Qd] and won ($38.79) with two pair, Kings and Queens
Seat 9: o.miro folded before Flop (didn't bet)





PokerStars Hand #150126412528:  Hold'em No Limit ($0.50/$1.00 USD) - 2016/03/10 13:37:27 CET [2016/03/10 7:37:27 ET]
Table 'Mars III' 9-max Seat #5 is the button
Seat 1: blackw0lf_03 ($135.64 in chips) 
Seat 2: pokixy800 ($63.60 in chips) 
Seat 3: PacPacBum ($108.98 in chips) 
Seat 4: ki11u ($100 in chips) 
Seat 5: Slash3r ($70.05 in chips) 
Seat 6: matiko09 ($100.85 in chips) 
Seat 7: Sweden_Pound ($100 in chips) 
Seat 8: Filojoes ($100 in chips) 
matiko09: posts small blind $0.50
Sweden_Pound: posts big blind $1
flk.Dasas: sits out 
*** HOLE CARDS ***
Dealt to matiko09 [5c 9h]
Filojoes: folds 
blackw0lf_03: folds 
pokixy800: folds 
PacPacBum: raises $1.04 to $2.04
ki11u: folds 
Slash3r: folds 
matiko09: folds 
Sweden_Pound: folds 
Uncalled bet ($1.04) returned to PacPacBum
PacPacBum collected $2.50 from pot
PacPacBum: doesn't show hand 
*** SUMMARY ***
Total pot $2.50 | Rake $0 
Seat 1: blackw0lf_03 folded before Flop (didn't bet)
Seat 2: pokixy800 folded before Flop (didn't bet)
Seat 3: PacPacBum collected ($2.50)
Seat 4: ki11u folded before Flop (didn't bet)
Seat 5: Slash3r (button) folded before Flop (didn't bet)
Seat 6: matiko09 (small blind) folded before Flop
Seat 7: Sweden_Pound (big blind) folded before Flop
Seat 8: Filojoes folded before Flop (didn't bet)





PokerStars Hand #150126413690:  Hold'em No Limit ($0.50/$1.00 USD) - 2016/03/10 13:37:30 CET [2016/03/10 7:37:30 ET]
Table 'Leuschneria II' 9-max Seat #7 is the button
Seat 1: SHARKFIN168 ($97 in chips) 
Seat 2: blackw0lf_03 ($100 in chips) 
Seat 4: Sweden_Pound ($135.22 in chips) 
Seat 5: RMilPoker ($222.04 in chips) 
Seat 6: matiko09 ($114.61 in chips) 
Seat 7: Plz3betMe ($40 in chips) 
Seat 8: UnBent022 ($105.25 in chips) 
Seat 9: ki11u ($100 in chips) 
UnBent022: posts small blind $0.50
ki11u: posts big blind $1
Spid1: sits out 
*** HOLE CARDS ***
Dealt to matiko09 [6s Qc]
SHARKFIN168: raises $1 to $2
blackw0lf_03: folds 
Sweden_Pound: folds 
RMilPoker: folds 
matiko09: folds 
Plz3betMe: folds 
UnBent022: folds 
ki11u: folds 
Uncalled bet ($1) returned to SHARKFIN168
SHARKFIN168 collected $2.50 from pot
SHARKFIN168: doesn't show hand 
*** SUMMARY ***
Total pot $2.50 | Rake $0 
Seat 1: SHARKFIN168 collected ($2.50)
Seat 2: blackw0lf_03 folded before Flop (didn't bet)
Seat 4: Sweden_Pound folded before Flop (didn't bet)
Seat 5: RMilPoker folded before Flop (didn't bet)
Seat 6: matiko09 folded before Flop (didn't bet)
Seat 7: Plz3betMe (button) folded before Flop (didn't bet)
Seat 8: UnBent022 (small blind) folded before Flop
Seat 9: ki11u (big blind) folded before Flop





PokerStars Hand #150126415531:  Hold'em No Limit ($0.50/$1.00 USD) - 2016/03/10 13:37:33 CET [2016/03/10 7:37:33 ET]
Table 'Saskia' 9-max Seat #6 is the button
Seat 1: Sweden_Pound ($104.50 in chips) 
Seat 2: njurg aga ($92.74 in chips) 
Seat 3: ccmaster001 ($83.31 in chips) 
Seat 4: Plz3betMe ($68.22 in chips) 
Seat 5: dreded11 ($96.66 in chips) 
Seat 6: matiko09 ($104.88 in chips) 
Seat 7: stds st ($49.56 in chips) 
Seat 8: blackw0lf_03 ($104.50 in chips) 
Seat 9: er13to ($116.97 in chips) 
stds st: posts small blind $0.50
blackw0lf_03: posts big blind $1
*** HOLE CARDS ***
Dealt to matiko09 [Jd Kh]
er13to: folds 
Sweden_Pound: folds 
njurg aga: folds 
ccmaster001: folds 
Plz3betMe: folds 
dreded11: folds 
matiko09: raises $1.27 to $2.27
stds st: folds 
blackw0lf_03: calls $1.27
*** FLOP *** [7c 9c Qs]
blackw0lf_03: checks 
matiko09: checks 
*** TURN *** [7c 9c Qs] [Ah]
blackw0lf_03: bets $9.72
matiko09: folds 
Uncalled bet ($9.72) returned to blackw0lf_03
blackw0lf_03 collected $4.81 from pot
*** SUMMARY ***
Total pot $5.04 | Rake $0.23 
Board [7c 9c Qs Ah]
Seat 1: Sweden_Pound folded before Flop (didn't bet)
Seat 2: njurg aga folded before Flop (didn't bet)
Seat 3: ccmaster001 folded before Flop (didn't bet)
Seat 4: Plz3betMe folded before Flop (didn't bet)
Seat 5: dreded11 folded before Flop (didn't bet)
Seat 6: matiko09 (button) folded on the Turn
Seat 7: stds st (small blind) folded before Flop
Seat 8: blackw0lf_03 (big blind) collected ($4.81)
Seat 9: er13to folded before Flop (didn't bet)





PokerStars Hand #150126419771:  Hold'em No Limit ($1/$2 USD) - 2016/03/10 13:37:41 CET [2016/03/10 7:37:41 ET]
Table 'Tauris II' 9-max Seat #8 is the button
Seat 1: matiko09 ($200 in chips) 
Seat 2: stds st ($57.41 in chips) 
Seat 3: PacPacBum ($200 in chips) 
Seat 4: neomorf ($695.34 in chips) 
Seat 6: uonlylive1ce ($205.55 in chips) 
Seat 7: Fish4trips ($213.48 in chips) 
Seat 8: scout326 ($225.38 in chips) 
darren1031 will be allowed to play after the button
matiko09: posts small blind $1
stds st: posts big blind $2
*** HOLE CARDS ***
Dealt to matiko09 [9s 2h]
PacPacBum: raises $2.08 to $4.08
neomorf: calls $4.08
uonlylive1ce: calls $4.08
Fish4trips: folds 
scout326: raises $19.92 to $24
matiko09: folds 
stds st: folds 
PacPacBum: folds 
neomorf: raises $671.34 to $695.34 and is all-in
uonlylive1ce: folds 
scout326: calls $201.38 and is all-in
Uncalled bet ($469.96) returned to neomorf
*** FLOP *** [4c As 9c]
*** TURN *** [4c As 9c] [Qs]
*** RIVER *** [4c As 9c Qs] [7h]
*** SHOW DOWN ***
neomorf: shows [Kc Ah] (a pair of Aces)
scout326: shows [Ad Kh] (a pair of Aces)
neomorf collected $229.56 from pot
scout326 collected $229.56 from pot
*** SUMMARY ***
Total pot $461.92 | Rake $2.80 
Board [4c As 9c Qs 7h]
Seat 1: matiko09 (small blind) folded before Flop
Seat 2: stds st (big blind) folded before Flop
Seat 3: PacPacBum folded before Flop
Seat 4: neomorf showed [Kc Ah] and won ($229.56) with a pair of Aces
Seat 6: uonlylive1ce folded before Flop
Seat 7: Fish4trips folded before Flop (didn't bet)
Seat 8: scout326 (button) showed [Ad Kh] and won ($229.56) with a pair of Aces





PokerStars Hand #150126425695:  Hold'em No Limit ($0.50/$1.00 USD) - 2016/03/10 13:37:52 CET [2016/03/10 7:37:52 ET]
Table 'Liriope II' 9-max Seat #6 is the button
Seat 1: UnBent022 ($100 in chips) 
Seat 2: zxp12345 ($42.78 in chips) 
Seat 3: matiko09 ($164.51 in chips) 
Seat 4: Plz3betMe ($45.93 in chips) 
Seat 5: lumen21 ($103.68 in chips) 
Seat 6: nobu-azabu ($191.28 in chips) 
Seat 7: Sweden_Pound ($100 in chips) 
Seat 8: PacPacBum ($113.21 in chips) 
Sweden_Pound: posts small blind $0.50
PacPacBum: posts big blind $1
*** HOLE CARDS ***
Dealt to matiko09 [9d Qs]
UnBent022: folds 
zxp12345: folds 
matiko09: folds 
Plz3betMe: folds 
lumen21: folds 
nobu-azabu: folds 
Sweden_Pound: raises $2 to $3
PacPacBum: calls $2
*** FLOP *** [Kd 6d 2h]
Sweden_Pound: bets $3.72
PacPacBum: folds 
Uncalled bet ($3.72) returned to Sweden_Pound
Sweden_Pound collected $5.73 from pot
Sweden_Pound: doesn't show hand 
*** SUMMARY ***
Total pot $6 | Rake $0.27 
Board [Kd 6d 2h]
Seat 1: UnBent022 folded before Flop (didn't bet)
Seat 2: zxp12345 folded before Flop (didn't bet)
Seat 3: matiko09 folded before Flop (didn't bet)
Seat 4: Plz3betMe folded before Flop (didn't bet)
Seat 5: lumen21 folded before Flop (didn't bet)
Seat 6: nobu-azabu (button) folded before Flop (didn't bet)
Seat 7: Sweden_Pound (small blind) collected ($5.73)
Seat 8: PacPacBum (big blind) folded on the Flop





PokerStars Hand #150126426297:  Hold'em No Limit ($0.25/$0.50 USD) - 2016/03/10 13:37:53 CET [2016/03/10 7:37:53 ET]
Table 'Aegina' 9-max Seat #9 is the button
Seat 1: BingoIng0 ($116.55 in chips) 
Seat 3: MyMilkCans=D ($125 in chips) 
Seat 4: digimatical ($78.47 in chips) 
Seat 5: Ahangama ($50 in chips) 
Seat 6: matiko09 ($54.59 in chips) 
Seat 7: Gummio ($114.95 in chips) 
Seat 8: ardo888 ($179.29 in chips) 
Seat 9: draken08 ($126.11 in chips) 
BingoIng0: posts small blind $0.25
dvutavr: is sitting out 
MyMilkCans=D: posts big blind $0.50
BingoIng0: posts the ante $0.10
MyMilkCans=D: posts the ante $0.10
digimatical: posts the ante $0.10
Ahangama: posts the ante $0.10
matiko09: posts the ante $0.10
Gummio: posts the ante $0.10
ardo888: posts the ante $0.10
draken08: posts the ante $0.10
*** HOLE CARDS ***
Dealt to matiko09 [Jc 3d]
digimatical: calls $0.50
Ahangama: folds 
matiko09: folds 
Gummio: raises $0.50 to $1
dvutavr leaves the table
ardo888: folds 
draken08: calls $1
BingoIng0: folds 
MyMilkCans=D: folds 
digimatical: calls $0.50
*** FLOP *** [4s 2h 9s]
Spid1 joins the table at seat #2 
digimatical: bets $2.17
Gummio: folds 
draken08: folds 
Uncalled bet ($2.17) returned to digimatical
digimatical collected $4.35 from pot
*** SUMMARY ***
Total pot $4.55 | Rake $0.20 
Board [4s 2h 9s]
Seat 1: BingoIng0 (small blind) folded before Flop
Seat 3: MyMilkCans=D (big blind) folded before Flop
Seat 4: digimatical collected ($4.35)
Seat 5: Ahangama folded before Flop (didn't bet)
Seat 6: matiko09 folded before Flop (didn't bet)
Seat 7: Gummio folded on the Flop
Seat 8: ardo888 folded before Flop (didn't bet)
Seat 9: draken08 (button) folded on the Flop





PokerStars Hand #150126429091:  Hold'em No Limit ($0.50/$1.00 USD) - 2016/03/10 13:37:59 CET [2016/03/10 7:37:59 ET]
Table 'Mars III' 9-max Seat #6 is the button
Seat 1: blackw0lf_03 ($135.64 in chips) 
Seat 2: pokixy800 ($63.60 in chips) 
Seat 3: PacPacBum ($110.48 in chips) 
Seat 4: ki11u ($100 in chips) 
Seat 5: Slash3r ($70.05 in chips) 
Seat 6: matiko09 ($100.35 in chips) 
Seat 7: Sweden_Pound ($100 in chips) 
Seat 8: Filojoes ($100 in chips) 
Sweden_Pound: posts small blind $0.50
Filojoes: posts big blind $1
flk.Dasas: sits out 
*** HOLE CARDS ***
Dealt to matiko09 [Qd Js]
blackw0lf_03: folds 
pokixy800: raises $1.50 to $2.50
PacPacBum: folds 
ki11u: folds 
Slash3r: calls $2.50
matiko09: folds 
Sweden_Pound: folds 
Filojoes: folds 
*** FLOP *** [2d 9s 9d]
pokixy800: bets $3.10
Slash3r: calls $3.10
*** TURN *** [2d 9s 9d] [Ks]
pokixy800: checks 
Slash3r: bets $3
pokixy800: calls $3
*** RIVER *** [2d 9s 9d Ks] [Kc]
pokixy800: checks 
Slash3r: bets $10
pokixy800: calls $10
*** SHOW DOWN ***
Slash3r: shows [Ah 9c] (a full house, Nines full of Kings)
pokixy800: mucks hand 
Slash3r collected $36.96 from pot
*** SUMMARY ***
Total pot $38.70 | Rake $1.74 
Board [2d 9s 9d Ks Kc]
Seat 1: blackw0lf_03 folded before Flop (didn't bet)
Seat 2: pokixy800 mucked [Qh Qc]
Seat 3: PacPacBum folded before Flop (didn't bet)
Seat 4: ki11u folded before Flop (didn't bet)
Seat 5: Slash3r showed [Ah 9c] and won ($36.96) with a full house, Nines full of Kings
Seat 6: matiko09 (button) folded before Flop (didn't bet)
Seat 7: Sweden_Pound (small blind) folded before Flop
Seat 8: Filojoes (big blind) folded before Flop





PokerStars Hand #150126430917:  Hold'em No Limit (€1/€2 EUR) - 2016/03/10 13:38:02 CET [2016/03/10 7:38:02 ET]
Table 'Sigrid II' 9-max Seat #7 is the button
Seat 1: Gamz11 (€200 in chips) 
Seat 2: stds st (€91.24 in chips) 
Seat 4: Fish4trips (€204.52 in chips) 
Seat 5: vr188 (€80.11 in chips) 
Seat 7: PacPacBum (€205.17 in chips) 
Seat 8: matiko09 (€202.49 in chips) 
Seat 9: ki11u (€226.25 in chips) 
matiko09: posts small blind €1
ki11u: posts big blind €2
RoadtoNepal: sits out 
*** HOLE CARDS ***
Dealt to matiko09 [Ah 9d]
Gamz11: raises €4 to €6
stds st: folds 
Fish4trips: folds 
vr188: folds 
PacPacBum: folds 
matiko09: folds 
ki11u: folds 
Uncalled bet (€4) returned to Gamz11
Gamz11 collected €5 from pot
*** SUMMARY ***
Total pot €5 | Rake €0 
Seat 1: Gamz11 collected (€5)
Seat 2: stds st folded before Flop (didn't bet)
Seat 4: Fish4trips folded before Flop (didn't bet)
Seat 5: vr188 folded before Flop (didn't bet)
Seat 7: PacPacBum (button) folded before Flop (didn't bet)
Seat 8: matiko09 (small blind) folded before Flop
Seat 9: ki11u (big blind) folded before Flop





PokerStars Hand #150126432983:  Hold'em No Limit ($0.50/$1.00 USD) - 2016/03/10 13:38:06 CET [2016/03/10 7:38:06 ET]
Table 'Leuschneria II' 9-max Seat #8 is the button
Seat 1: SHARKFIN168 ($98.50 in chips) 
Seat 2: blackw0lf_03 ($100 in chips) 
Seat 4: Sweden_Pound ($135.22 in chips) 
Seat 5: RMilPoker ($222.04 in chips) 
Seat 6: matiko09 ($114.61 in chips) 
Seat 7: Plz3betMe ($40 in chips) 
Seat 8: UnBent022 ($104.75 in chips) 
Seat 9: ki11u ($100 in chips) 
ki11u: posts small blind $0.50
SHARKFIN168: posts big blind $1
Spid1: sits out 
*** HOLE CARDS ***
Dealt to matiko09 [2c 8c]
blackw0lf_03: folds 
Sweden_Pound: folds 
RMilPoker: folds 
matiko09: folds 
Plz3betMe: raises $1 to $2
UnBent022: calls $2
ki11u: folds 
SHARKFIN168: calls $1
*** FLOP *** [Qc 9h 4h]
SHARKFIN168: checks 
Plz3betMe: checks 
UnBent022: bets $4.65
SHARKFIN168: folds 
Plz3betMe: folds 
Uncalled bet ($4.65) returned to UnBent022
UnBent022 collected $6.21 from pot
UnBent022: doesn't show hand 
*** SUMMARY ***
Total pot $6.50 | Rake $0.29 
Board [Qc 9h 4h]
Seat 1: SHARKFIN168 (big blind) folded on the Flop
Seat 2: blackw0lf_03 folded before Flop (didn't bet)
Seat 4: Sweden_Pound folded before Flop (didn't bet)
Seat 5: RMilPoker folded before Flop (didn't bet)
Seat 6: matiko09 folded before Flop (didn't bet)
Seat 7: Plz3betMe folded on the Flop
Seat 8: UnBent022 (button) collected ($6.21)
Seat 9: ki11u (small blind) folded before Flop





PokerStars Hand #150126448442:  Hold'em No Limit ($0.50/$1.00 USD) - 2016/03/10 13:38:35 CET [2016/03/10 7:38:35 ET]
Table 'Iguassu' 9-max Seat #1 is the button
Seat 1: blackw0lf_03 ($100 in chips) 
Seat 2: Rocky6434 ($57.75 in chips) 
Seat 3: hammerwife ($124.93 in chips) 
Seat 4: matiko09 ($100 in chips) 
Seat 5: UnBent022 ($100 in chips) 
Seat 6: Igor DoUrden ($118.58 in chips) 
Seat 7: PacPacBum ($120.05 in chips) 
Seat 8: Filojoes ($118.74 in chips) 
Seat 9: er13to ($100 in chips) 
Rocky6434: posts small blind $0.50
hammerwife: posts big blind $1
*** HOLE CARDS ***
Dealt to matiko09 [9c 8d]
matiko09: folds 
UnBent022: raises $2 to $3
Igor DoUrden: folds 
PacPacBum: folds 
Filojoes: folds 
er13to: folds 
blackw0lf_03: folds 
Rocky6434: folds 
hammerwife: folds 
Uncalled bet ($2) returned to UnBent022
UnBent022 collected $2.50 from pot
UnBent022: doesn't show hand 
*** SUMMARY ***
Total pot $2.50 | Rake $0 
Seat 1: blackw0lf_03 (button) folded before Flop (didn't bet)
Seat 2: Rocky6434 (small blind) folded before Flop
Seat 3: hammerwife (big blind) folded before Flop
Seat 4: matiko09 folded before Flop (didn't bet)
Seat 5: UnBent022 collected ($2.50)
Seat 6: Igor DoUrden folded before Flop (didn't bet)
Seat 7: PacPacBum folded before Flop (didn't bet)
Seat 8: Filojoes folded before Flop (didn't bet)
Seat 9: er13to folded before Flop (didn't bet)





PokerStars Hand #150126448900:  Hold'em No Limit ($1/$2 USD) - 2016/03/10 13:38:36 CET [2016/03/10 7:38:36 ET]
Table 'Tauris II' 9-max Seat #1 is the button
Seat 1: matiko09 ($200 in chips) 
Seat 2: stds st ($55.41 in chips) 
Seat 3: PacPacBum ($200 in chips) 
Seat 4: neomorf ($699.52 in chips) 
Seat 6: uonlylive1ce ($201.47 in chips) 
Seat 7: Fish4trips ($213.48 in chips) 
Seat 8: scout326 ($229.56 in chips) 
stds st: posts small blind $1
PacPacBum: posts big blind $2
darren1031: sits out 
*** HOLE CARDS ***
Dealt to matiko09 [Qd 5h]
neomorf: folds 
uonlylive1ce: folds 
Fish4trips: raises $3 to $5
scout326: calls $5
matiko09: folds 
stds st: folds 
PacPacBum: folds 
*** FLOP *** [Ac 4h Ks]
Fish4trips: checks 
scout326: checks 
*** TURN *** [Ac 4h Ks] [Ts]
Fish4trips: checks 
scout326: checks 
*** RIVER *** [Ac 4h Ks Ts] [3d]
Fish4trips: checks 
scout326: checks 
*** SHOW DOWN ***
Fish4trips: shows [8d 8c] (a pair of Eights)
scout326: shows [6h Ah] (a pair of Aces)
scout326 collected $12.42 from pot
*** SUMMARY ***
Total pot $13 | Rake $0.58 
Board [Ac 4h Ks Ts 3d]
Seat 1: matiko09 (button) folded before Flop (didn't bet)
Seat 2: stds st (small blind) folded before Flop
Seat 3: PacPacBum (big blind) folded before Flop
Seat 4: neomorf folded before Flop (didn't bet)
Seat 6: uonlylive1ce folded before Flop (didn't bet)
Seat 7: Fish4trips showed [8d 8c] and lost with a pair of Eights
Seat 8: scout326 showed [6h Ah] and won ($12.42) with a pair of Aces





PokerStars Hand #150126449289:  Hold'em No Limit ($0.50/$1.00 USD) - 2016/03/10 13:38:36 CET [2016/03/10 7:38:36 ET]
Table 'Virgo II' 9-max Seat #9 is the button
Seat 2: Plz3betMe ($53.77 in chips) 
Seat 3: blackw0lf_03 ($108.05 in chips) 
Seat 4: UnBent022 ($103.96 in chips) 
Seat 5: stds st ($38.27 in chips) 
Seat 6: PacPacBum ($134.95 in chips) 
Seat 8: Sweden_Pound ($191.35 in chips) 
Seat 9: matiko09 ($100 in chips) 
Filojoes will be allowed to play after the button
Plz3betMe: posts small blind $0.50
blackw0lf_03: posts big blind $1
*** HOLE CARDS ***
Dealt to matiko09 [4s Ad]
mamilets leaves the table
UnBent022: raises $2 to $3
stds st: folds 
PacPacBum: folds 
Sweden_Pound: folds 
matiko09: folds 
Plz3betMe: folds 
blackw0lf_03: folds 
Uncalled bet ($2) returned to UnBent022
UnBent022 collected $2.50 from pot
UnBent022: doesn't show hand 
*** SUMMARY ***
Total pot $2.50 | Rake $0 
Seat 2: Plz3betMe (small blind) folded before Flop
Seat 3: blackw0lf_03 (big blind) folded before Flop
Seat 4: UnBent022 collected ($2.50)
Seat 5: stds st folded before Flop (didn't bet)
Seat 6: PacPacBum folded before Flop (didn't bet)
Seat 8: Sweden_Pound folded before Flop (didn't bet)
Seat 9: matiko09 (button) folded before Flop (didn't bet)





PokerStars Hand #150126452327:  Hold'em No Limit (€1/€2 EUR) - 2016/03/10 13:38:42 CET [2016/03/10 7:38:42 ET]
Table 'Sigrid II' 9-max Seat #8 is the button
Seat 1: Gamz11 (€203 in chips) 
Seat 2: stds st (€91.24 in chips) 
Seat 4: Fish4trips (€204.52 in chips) 
Seat 5: vr188 (€80.11 in chips) 
Seat 7: PacPacBum (€205.17 in chips) 
Seat 8: matiko09 (€201.49 in chips) 
Seat 9: ki11u (€224.25 in chips) 
ki11u: posts small blind €1
Gamz11: posts big blind €2
RoadtoNepal: sits out 
*** HOLE CARDS ***
Dealt to matiko09 [Jd Ah]
stds st: folds 
Fish4trips: raises €3 to €5
vr188: folds 
PacPacBum: folds 
matiko09: raises €12 to €17
ki11u: folds 
Gamz11: folds 
Fish4trips: folds 
Uncalled bet (€12) returned to matiko09
matiko09 collected €13 from pot
matiko09: doesn't show hand 
*** SUMMARY ***
Total pot €13 | Rake €0 
Seat 1: Gamz11 (big blind) folded before Flop
Seat 2: stds st folded before Flop (didn't bet)
Seat 4: Fish4trips folded before Flop
Seat 5: vr188 folded before Flop (didn't bet)
Seat 7: PacPacBum folded before Flop (didn't bet)
Seat 8: matiko09 (button) collected (€13)
Seat 9: ki11u (small blind) folded before Flop





PokerStars Hand #150126456759:  Hold'em No Limit ($0.50/$1.00 USD) - 2016/03/10 13:38:51 CET [2016/03/10 7:38:51 ET]
Table 'Mars III' 9-max Seat #7 is the button
Seat 1: blackw0lf_03 ($135.64 in chips) 
Seat 2: pokixy800 ($45 in chips) 
Seat 3: PacPacBum ($110.48 in chips) 
Seat 4: ki11u ($100 in chips) 
Seat 5: Slash3r ($88.41 in chips) 
Seat 6: matiko09 ($100.35 in chips) 
Seat 7: Sweden_Pound ($100 in chips) 
Seat 8: Filojoes ($100 in chips) 
Seat 9: flk.Dasas ($100 in chips) 
Filojoes: posts small blind $0.50
flk.Dasas: posts big blind $1
*** HOLE CARDS ***
Dealt to matiko09 [8h 7h]
blackw0lf_03: folds 
pokixy800: folds 
PacPacBum: folds 
ki11u: folds 
Slash3r: calls $1
matiko09: raises $3 to $4
Sweden_Pound: raises $8 to $12
Filojoes: folds 
flk.Dasas: folds 
Slash3r: folds 
matiko09: folds 
Uncalled bet ($8) returned to Sweden_Pound
Sweden_Pound collected $10.50 from pot
Sweden_Pound: doesn't show hand 
*** SUMMARY ***
Total pot $10.50 | Rake $0 
Seat 1: blackw0lf_03 folded before Flop (didn't bet)
Seat 2: pokixy800 folded before Flop (didn't bet)
Seat 3: PacPacBum folded before Flop (didn't bet)
Seat 4: ki11u folded before Flop (didn't bet)
Seat 5: Slash3r folded before Flop
Seat 6: matiko09 folded before Flop
Seat 7: Sweden_Pound (button) collected ($10.50)
Seat 8: Filojoes (small blind) folded before Flop
Seat 9: flk.Dasas (big blind) folded before Flop





PokerStars Hand #150126457678:  Hold'em No Limit ($0.25/$0.50 USD) - 2016/03/10 13:38:52 CET [2016/03/10 7:38:52 ET]
Table 'Aegina' 9-max Seat #1 is the button
Seat 1: BingoIng0 ($116.20 in chips) 
Seat 3: MyMilkCans=D ($125 in chips) 
Seat 4: digimatical ($81.72 in chips) 
Seat 5: Ahangama ($50 in chips) 
Seat 6: matiko09 ($54.49 in chips) 
Seat 7: Gummio ($113.85 in chips) 
Seat 8: ardo888 ($179.19 in chips) 
Seat 9: draken08 ($125.01 in chips) 
Spid1 will be allowed to play after the button
MyMilkCans=D: posts small blind $0.25
digimatical: posts big blind $0.50
BingoIng0: posts the ante $0.10
MyMilkCans=D: posts the ante $0.10
digimatical: posts the ante $0.10
Ahangama: posts the ante $0.10
matiko09: posts the ante $0.10
Gummio: posts the ante $0.10
ardo888: posts the ante $0.10
draken08: posts the ante $0.10
*** HOLE CARDS ***
Dealt to matiko09 [Qs 3d]
Ahangama: folds 
matiko09: folds 
Gummio: folds 
ardo888: folds 
draken08: folds 
BingoIng0: raises $0.50 to $1
MyMilkCans=D: folds 
digimatical: raises $3.05 to $4.05
BingoIng0: calls $3.05
*** FLOP *** [Qd 8h 3h]
digimatical: checks 
BingoIng0: checks 
*** TURN *** [Qd 8h 3h] [3c]
digimatical: bets $2.50
BingoIng0: calls $2.50
*** RIVER *** [Qd 8h 3h 3c] [8d]
digimatical: bets $3
BingoIng0: raises $17.75 to $20.75
digimatical: folds 
Uncalled bet ($17.75) returned to BingoIng0
BingoIng0 collected $19.24 from pot
BingoIng0: doesn't show hand 
*** SUMMARY ***
Total pot $20.15 | Rake $0.91 
Board [Qd 8h 3h 3c 8d]
Seat 1: BingoIng0 (button) collected ($19.24)
Seat 3: MyMilkCans=D (small blind) folded before Flop
Seat 4: digimatical (big blind) folded on the River
Seat 5: Ahangama folded before Flop (didn't bet)
Seat 6: matiko09 folded before Flop (didn't bet)
Seat 7: Gummio folded before Flop (didn't bet)
Seat 8: ardo888 folded before Flop (didn't bet)
Seat 9: draken08 folded before Flop (didn't bet)





PokerStars Hand #150126458175:  Hold'em No Limit ($0.50/$1.00 USD) - 2016/03/10 13:38:53 CET [2016/03/10 7:38:53 ET]
Table 'Liriope II' 9-max Seat #7 is the button
Seat 1: UnBent022 ($100 in chips) 
Seat 2: zxp12345 ($42.78 in chips) 
Seat 3: matiko09 ($164.51 in chips) 
Seat 4: Plz3betMe ($45.93 in chips) 
Seat 5: lumen21 ($103.68 in chips) 
Seat 6: nobu-azabu ($191.28 in chips) 
Seat 7: Sweden_Pound ($102.73 in chips) 
Seat 8: PacPacBum ($110.21 in chips) 
PacPacBum: posts small blind $0.50
UnBent022: posts big blind $1
*** HOLE CARDS ***
Dealt to matiko09 [7s Kc]
zxp12345: folds 
matiko09: folds 
Plz3betMe: folds 
lumen21: folds 
nobu-azabu: folds 
Sweden_Pound: raises $1 to $2
PacPacBum: folds 
UnBent022: folds 
Uncalled bet ($1) returned to Sweden_Pound
Sweden_Pound collected $2.50 from pot
Sweden_Pound: doesn't show hand 
*** SUMMARY ***
Total pot $2.50 | Rake $0 
Seat 1: UnBent022 (big blind) folded before Flop
Seat 2: zxp12345 folded before Flop (didn't bet)
Seat 3: matiko09 folded before Flop (didn't bet)
Seat 4: Plz3betMe folded before Flop (didn't bet)
Seat 5: lumen21 folded before Flop (didn't bet)
Seat 6: nobu-azabu folded before Flop (didn't bet)
Seat 7: Sweden_Pound (button) collected ($2.50)
Seat 8: PacPacBum (small blind) folded before Flop





PokerStars Hand #150126461561:  Hold'em No Limit ($1/$2 USD) - 2016/03/10 13:38:59 CET [2016/03/10 7:38:59 ET]
Table 'Chandra II' 9-max Seat #4 is the button
Seat 1: Fish4trips ($300.44 in chips) 
Seat 2: PacPacBum ($234.51 in chips) 
Seat 4: tipner ($200 in chips) 
Seat 5: uibting ($43.03 in chips) 
Seat 6: stds st ($78.31 in chips) 
Seat 7: johnvu2016 ($158.97 in chips) 
Seat 8: matiko09 ($223.48 in chips) 
Seat 9: o.miro ($270.03 in chips) 
uibting: posts small blind $1
stds st: posts big blind $2
*** HOLE CARDS ***
Dealt to matiko09 [9d Qs]
johnvu2016: calls $2
matiko09: folds 
o.miro: raises $5 to $7
Fish4trips: folds 
PacPacBum: folds 
tipner: folds 
uibting: folds 
stds st: folds 
johnvu2016: calls $5
*** FLOP *** [5s 9s 4c]
johnvu2016: checks 
o.miro: bets $11
johnvu2016: calls $11
*** TURN *** [5s 9s 4c] [Kh]
johnvu2016: checks 
o.miro: checks 
*** RIVER *** [5s 9s 4c Kh] [Ks]
johnvu2016: checks 
o.miro: checks 
*** SHOW DOWN ***
johnvu2016: shows [7h As] (a pair of Kings)
o.miro: shows [9h 8h] (two pair, Kings and Nines)
o.miro collected $37.24 from pot
*** SUMMARY ***
Total pot $39 | Rake $1.76 
Board [5s 9s 4c Kh Ks]
Seat 1: Fish4trips folded before Flop (didn't bet)
Seat 2: PacPacBum folded before Flop (didn't bet)
Seat 4: tipner (button) folded before Flop (didn't bet)
Seat 5: uibting (small blind) folded before Flop
Seat 6: stds st (big blind) folded before Flop
Seat 7: johnvu2016 showed [7h As] and lost with a pair of Kings
Seat 8: matiko09 folded before Flop (didn't bet)
Seat 9: o.miro showed [9h 8h] and won ($37.24) with two pair, Kings and Nines





PokerStars Hand #150126469338:  Hold'em No Limit ($0.50/$1.00 USD) - 2016/03/10 13:39:14 CET [2016/03/10 7:39:14 ET]
Table 'Iguassu' 9-max Seat #2 is the button
Seat 1: blackw0lf_03 ($100 in chips) 
Seat 2: Rocky6434 ($57.25 in chips) 
Seat 3: hammerwife ($123.93 in chips) 
Seat 4: matiko09 ($100 in chips) 
Seat 5: UnBent022 ($101.50 in chips) 
Seat 6: Igor DoUrden ($118.58 in chips) 
Seat 7: PacPacBum ($120.05 in chips) 
Seat 8: Filojoes ($118.74 in chips) 
Seat 9: er13to ($100 in chips) 
hammerwife: posts small blind $0.50
matiko09: posts big blind $1
*** HOLE CARDS ***
Dealt to matiko09 [Qd 2d]
UnBent022: folds 
Igor DoUrden: folds 
PacPacBum: folds 
Filojoes: raises $2 to $3
er13to: folds 
blackw0lf_03: folds 
Rocky6434: calls $3
hammerwife: folds 
matiko09: folds 
*** FLOP *** [Qs 7s Kd]
Filojoes: checks 
Rocky6434: checks 
*** TURN *** [Qs 7s Kd] [Qc]
Filojoes: bets $4.30
Rocky6434: calls $4.30
*** RIVER *** [Qs 7s Kd Qc] [6c]
Filojoes: checks 
Rocky6434: checks 
*** SHOW DOWN ***
Filojoes: shows [9d 9s] (two pair, Queens and Nines)
Rocky6434: mucks hand 
Filojoes collected $15.38 from pot
*** SUMMARY ***
Total pot $16.10 | Rake $0.72 
Board [Qs 7s Kd Qc 6c]
Seat 1: blackw0lf_03 folded before Flop (didn't bet)
Seat 2: Rocky6434 (button) mucked [Jc 7c]
Seat 3: hammerwife (small blind) folded before Flop
Seat 4: matiko09 (big blind) folded before Flop
Seat 5: UnBent022 folded before Flop (didn't bet)
Seat 6: Igor DoUrden folded before Flop (didn't bet)
Seat 7: PacPacBum folded before Flop (didn't bet)
Seat 8: Filojoes showed [9d 9s] and won ($15.38) with two pair, Queens and Nines
Seat 9: er13to folded before Flop (didn't bet)





PokerStars Hand #150126469351:  Hold'em No Limit ($0.50/$1.00 USD) - 2016/03/10 13:39:14 CET [2016/03/10 7:39:14 ET]
Table 'Leuschneria II' 9-max Seat #9 is the button
Seat 1: SHARKFIN168 ($96.50 in chips) 
Seat 2: blackw0lf_03 ($100 in chips) 
Seat 4: Sweden_Pound ($135.22 in chips) 
Seat 5: RMilPoker ($222.04 in chips) 
Seat 6: matiko09 ($114.61 in chips) 
Seat 7: Plz3betMe ($38 in chips) 
Seat 8: UnBent022 ($108.96 in chips) 
Seat 9: ki11u ($100 in chips) 
SHARKFIN168: posts small blind $0.50
blackw0lf_03: posts big blind $1
Spid1: sits out 
*** HOLE CARDS ***
Dealt to matiko09 [Th 8s]
Sweden_Pound: folds 
RMilPoker: folds 
matiko09: folds 
Plz3betMe: folds 
UnBent022: raises $1.50 to $2.50
ki11u: folds 
SHARKFIN168: calls $2
blackw0lf_03: folds 
*** FLOP *** [Qs Ad Ac]
SHARKFIN168: checks 
UnBent022: checks 
*** TURN *** [Qs Ad Ac] [Ts]
SHARKFIN168: bets $2
UnBent022: calls $2
*** RIVER *** [Qs Ad Ac Ts] [5h]
SHARKFIN168: bets $3
UnBent022: calls $3
*** SHOW DOWN ***
SHARKFIN168: shows [Qh Td] (two pair, Aces and Queens)
UnBent022: mucks hand 
SHARKFIN168 collected $15.28 from pot
*** SUMMARY ***
Total pot $16 | Rake $0.72 
Board [Qs Ad Ac Ts 5h]
Seat 1: SHARKFIN168 (small blind) showed [Qh Td] and won ($15.28) with two pair, Aces and Queens
Seat 2: blackw0lf_03 (big blind) folded before Flop
Seat 4: Sweden_Pound folded before Flop (didn't bet)
Seat 5: RMilPoker folded before Flop (didn't bet)
Seat 6: matiko09 folded before Flop (didn't bet)
Seat 7: Plz3betMe folded before Flop (didn't bet)
Seat 8: UnBent022 mucked [Js Jc]
Seat 9: ki11u (button) folded before Flop (didn't bet)





PokerStars Hand #150126473782:  Hold'em No Limit ($0.50/$1.00 USD) - 2016/03/10 13:39:22 CET [2016/03/10 7:39:22 ET]
Table 'Saskia' 9-max Seat #7 is the button
Seat 1: Sweden_Pound ($104.50 in chips) 
Seat 2: njurg aga ($92.74 in chips) 
Seat 3: ccmaster001 ($83.31 in chips) 
Seat 4: Plz3betMe ($68.22 in chips) 
Seat 5: dreded11 ($96.66 in chips) 
Seat 6: matiko09 ($102.61 in chips) 
Seat 7: stds st ($49.06 in chips) 
Seat 8: blackw0lf_03 ($107.04 in chips) 
Seat 9: er13to ($116.97 in chips) 
blackw0lf_03: posts small blind $0.50
er13to: posts big blind $1
*** HOLE CARDS ***
Dealt to matiko09 [9h Ad]
Sweden_Pound: folds 
njurg aga: folds 
ccmaster001: calls $1
Plz3betMe: folds 
dreded11: folds 
matiko09: raises $3 to $4
stds st: folds 
blackw0lf_03: folds 
er13to: raises $12 to $16
ccmaster001: folds 
matiko09: folds 
Uncalled bet ($12) returned to er13to
er13to collected $9.50 from pot
*** SUMMARY ***
Total pot $9.50 | Rake $0 
Seat 1: Sweden_Pound folded before Flop (didn't bet)
Seat 2: njurg aga folded before Flop (didn't bet)
Seat 3: ccmaster001 folded before Flop
Seat 4: Plz3betMe folded before Flop (didn't bet)
Seat 5: dreded11 folded before Flop (didn't bet)
Seat 6: matiko09 folded before Flop
Seat 7: stds st (button) folded before Flop (didn't bet)
Seat 8: blackw0lf_03 (small blind) folded before Flop
Seat 9: er13to (big blind) collected ($9.50)





PokerStars Hand #150126478131:  Hold'em No Limit (€1/€2 EUR) - 2016/03/10 13:39:31 CET [2016/03/10 7:39:31 ET]
Table 'Sigrid II' 9-max Seat #9 is the button
Seat 1: Gamz11 (€201 in chips) 
Seat 2: stds st (€91.24 in chips) 
Seat 4: Fish4trips (€200 in chips) 
Seat 5: vr188 (€80.11 in chips) 
Seat 7: PacPacBum (€205.17 in chips) 
Seat 8: matiko09 (€209.49 in chips) 
Seat 9: ki11u (€223.25 in chips) 
Gamz11: posts small blind €1
stds st: posts big blind €2
RoadtoNepal: sits out 
*** HOLE CARDS ***
Dealt to matiko09 [8s 6s]
Fish4trips: raises €3 to €5
vr188: folds 
PacPacBum: folds 
matiko09: folds 
ki11u: folds 
Gamz11: folds 
stds st: raises €8 to €13
Fish4trips: folds 
Uncalled bet (€8) returned to stds st
stds st collected €11 from pot
stds st: doesn't show hand 
*** SUMMARY ***
Total pot €11 | Rake €0 
Seat 1: Gamz11 (small blind) folded before Flop
Seat 2: stds st (big blind) collected (€11)
Seat 4: Fish4trips folded before Flop
Seat 5: vr188 folded before Flop (didn't bet)
Seat 7: PacPacBum folded before Flop (didn't bet)
Seat 8: matiko09 folded before Flop (didn't bet)
Seat 9: ki11u (button) folded before Flop (didn't bet)





PokerStars Hand #150126484576:  Hold'em No Limit ($0.50/$1.00 USD) - 2016/03/10 13:39:43 CET [2016/03/10 7:39:43 ET]
Table 'Liriope II' 9-max Seat #8 is the button
Seat 1: UnBent022 ($100 in chips) 
Seat 2: zxp12345 ($42.78 in chips) 
Seat 3: matiko09 ($164.51 in chips) 
Seat 4: Plz3betMe ($45.93 in chips) 
Seat 5: lumen21 ($103.68 in chips) 
Seat 6: nobu-azabu ($191.28 in chips) 
Seat 7: Sweden_Pound ($104.23 in chips) 
Seat 8: PacPacBum ($109.71 in chips) 
UnBent022: posts small blind $0.50
zxp12345: posts big blind $1
*** HOLE CARDS ***
Dealt to matiko09 [Qs 8h]
matiko09: folds 
Plz3betMe: folds 
lumen21: folds 
nobu-azabu: folds 
Sweden_Pound: folds 
PacPacBum: raises $1.04 to $2.04
UnBent022: folds 
zxp12345: calls $1.04
*** FLOP *** [4d Jc Js]
zxp12345: checks 
PacPacBum: bets $2.35
zxp12345: raises $2.35 to $4.70
PacPacBum: calls $2.35
*** TURN *** [4d Jc Js] [9c]
zxp12345: bets $6.67
PacPacBum: calls $6.67
*** RIVER *** [4d Jc Js 9c] [4c]
zxp12345: checks 
PacPacBum: bets $10
zxp12345: calls $10
*** SHOW DOWN ***
PacPacBum: shows [4s Ad] (a full house, Fours full of Jacks)
zxp12345: mucks hand 
PacPacBum collected $45.19 from pot
*** SUMMARY ***
Total pot $47.32 | Rake $2.13 
Board [4d Jc Js 9c 4c]
Seat 1: UnBent022 (small blind) folded before Flop
Seat 2: zxp12345 (big blind) mucked [5d Ac]
Seat 3: matiko09 folded before Flop (didn't bet)
Seat 4: Plz3betMe folded before Flop (didn't bet)
Seat 5: lumen21 folded before Flop (didn't bet)
Seat 6: nobu-azabu folded before Flop (didn't bet)
Seat 7: Sweden_Pound folded before Flop (didn't bet)
Seat 8: PacPacBum (button) showed [4s Ad] and won ($45.19) with a full house, Fours full of Jacks





PokerStars Hand #150126489669:  Hold'em No Limit ($0.50/$1.00 USD) - 2016/03/10 13:39:52 CET [2016/03/10 7:39:52 ET]
Table 'Mars III' 9-max Seat #8 is the button
Seat 1: blackw0lf_03 ($135.64 in chips) 
Seat 3: PacPacBum ($110.48 in chips) 
Seat 4: ki11u ($100 in chips) 
Seat 5: Slash3r ($87.41 in chips) 
Seat 6: matiko09 ($100 in chips) 
Seat 7: Sweden_Pound ($106.50 in chips) 
Seat 8: Filojoes ($100 in chips) 
Seat 9: flk.Dasas ($100 in chips) 
flk.Dasas: posts small blind $0.50
blackw0lf_03: posts big blind $1
*** HOLE CARDS ***
Dealt to matiko09 [Kh 9c]
PacPacBum: folds 
ki11u: folds 
Slash3r: calls $1
matiko09: folds 
Sweden_Pound: folds 
Filojoes: folds 
flk.Dasas: folds 
blackw0lf_03: raises $3 to $4
Slash3r: calls $3
*** FLOP *** [4c Qh Qd]
blackw0lf_03: checks 
Slash3r: checks 
*** TURN *** [4c Qh Qd] [5c]
blackw0lf_03: bets $12.34
Slash3r: folds 
Uncalled bet ($12.34) returned to blackw0lf_03
blackw0lf_03 collected $8.12 from pot
blackw0lf_03: doesn't show hand 
*** SUMMARY ***
Total pot $8.50 | Rake $0.38 
Board [4c Qh Qd 5c]
Seat 1: blackw0lf_03 (big blind) collected ($8.12)
Seat 3: PacPacBum folded before Flop (didn't bet)
Seat 4: ki11u folded before Flop (didn't bet)
Seat 5: Slash3r folded on the Turn
Seat 6: matiko09 folded before Flop (didn't bet)
Seat 7: Sweden_Pound folded before Flop (didn't bet)
Seat 8: Filojoes (button) folded before Flop (didn't bet)
Seat 9: flk.Dasas (small blind) folded before Flop





PokerStars Hand #150126490241:  Hold'em No Limit ($1/$2 USD) - 2016/03/10 13:39:53 CET [2016/03/10 7:39:53 ET]
Table 'Tauris II' 9-max Seat #2 is the button
Seat 1: matiko09 ($200 in chips) 
Seat 2: stds st ($54.41 in chips) 
Seat 3: PacPacBum ($200 in chips) 
Seat 4: neomorf ($699.52 in chips) 
Seat 6: uonlylive1ce ($201.47 in chips) 
Seat 7: Fish4trips ($208.48 in chips) 
Seat 8: scout326 ($236.98 in chips) 
PacPacBum: posts small blind $1
neomorf: posts big blind $2
darren1031: sits out 
*** HOLE CARDS ***
Dealt to matiko09 [Ad 7d]
uonlylive1ce: folds 
Fish4trips: raises $3 to $5
scout326: folds 
matiko09: folds 
stds st: folds 
PacPacBum: folds 
neomorf: folds 
Uncalled bet ($3) returned to Fish4trips
Fish4trips collected $5 from pot
Fish4trips: doesn't show hand 
*** SUMMARY ***
Total pot $5 | Rake $0 
Seat 1: matiko09 folded before Flop (didn't bet)
Seat 2: stds st (button) folded before Flop (didn't bet)
Seat 3: PacPacBum (small blind) folded before Flop
Seat 4: neomorf (big blind) folded before Flop
Seat 6: uonlylive1ce folded before Flop (didn't bet)
Seat 7: Fish4trips collected ($5)
Seat 8: scout326 folded before Flop (didn't bet)





PokerStars Hand #150126501967:  Hold'em No Limit ($1/$2 USD) - 2016/03/10 13:40:15 CET [2016/03/10 7:40:15 ET]
Table 'Chandra II' 9-max Seat #5 is the button
Seat 1: Fish4trips ($300.44 in chips) 
Seat 2: PacPacBum ($234.51 in chips) 
Seat 4: tipner ($200 in chips) 
Seat 5: uibting ($42.03 in chips) 
Seat 6: stds st ($76.31 in chips) 
Seat 7: johnvu2016 ($140.97 in chips) 
Seat 8: matiko09 ($223.48 in chips) 
Seat 9: o.miro ($289.27 in chips) 
stds st: posts small blind $1
johnvu2016: posts big blind $2
*** HOLE CARDS ***
Dealt to matiko09 [Qc Ah]
matiko09: raises $3 to $5
o.miro: folds 
Fish4trips: folds 
PacPacBum: folds 
tipner: folds 
uibting: calls $5
stds st: folds 
johnvu2016: calls $3
*** FLOP *** [8h 2c 6s]
johnvu2016: checks 
matiko09: checks 
uibting: checks 
*** TURN *** [8h 2c 6s] [Kc]
johnvu2016: checks 
matiko09: checks 
uibting: bets $7.64
johnvu2016: folds 
matiko09: folds 
Uncalled bet ($7.64) returned to uibting
uibting collected $15.28 from pot
*** SUMMARY ***
Total pot $16 | Rake $0.72 
Board [8h 2c 6s Kc]
Seat 1: Fish4trips folded before Flop (didn't bet)
Seat 2: PacPacBum folded before Flop (didn't bet)
Seat 4: tipner folded before Flop (didn't bet)
Seat 5: uibting (button) collected ($15.28)
Seat 6: stds st (small blind) folded before Flop
Seat 7: johnvu2016 (big blind) folded on the Turn
Seat 8: matiko09 folded on the Turn
Seat 9: o.miro folded before Flop (didn't bet)





PokerStars Hand #150126501820:  Hold'em No Limit (€1/€2 EUR) - 2016/03/10 13:40:15 CET [2016/03/10 7:40:15 ET]
Table 'Sigrid II' 9-max Seat #1 is the button
Seat 1: Gamz11 (€200 in chips) 
Seat 2: stds st (€97.24 in chips) 
Seat 3: RoadtoNepal (€200 in chips) 
Seat 4: Fish4trips (€200 in chips) 
Seat 5: vr188 (€80.11 in chips) 
Seat 7: PacPacBum (€205.17 in chips) 
Seat 8: matiko09 (€209.49 in chips) 
Seat 9: ki11u (€223.25 in chips) 
stds st: posts small blind €1
RoadtoNepal: posts big blind €2
*** HOLE CARDS ***
Dealt to matiko09 [6c Kh]
Fish4trips: folds 
vr188: folds 
PacPacBum: folds 
matiko09: folds 
ki11u: folds 
Gamz11: folds 
stds st: raises €2.04 to €4.04
RoadtoNepal: calls €2.04
*** FLOP *** [Kc Td 9s]
stds st: bets €5.55
RoadtoNepal: folds 
Uncalled bet (€5.55) returned to stds st
stds st collected €7.72 from pot
stds st: doesn't show hand 
*** SUMMARY ***
Total pot €8.08 | Rake €0.36 
Board [Kc Td 9s]
Seat 1: Gamz11 (button) folded before Flop (didn't bet)
Seat 2: stds st (small blind) collected (€7.72)
Seat 3: RoadtoNepal (big blind) folded on the Flop
Seat 4: Fish4trips folded before Flop (didn't bet)
Seat 5: vr188 folded before Flop (didn't bet)
Seat 7: PacPacBum folded before Flop (didn't bet)
Seat 8: matiko09 folded before Flop (didn't bet)
Seat 9: ki11u folded before Flop (didn't bet)





PokerStars Hand #150126510818:  Hold'em No Limit ($0.50/$1.00 USD) - 2016/03/10 13:40:32 CET [2016/03/10 7:40:32 ET]
Table 'Mars III' 9-max Seat #9 is the button
Seat 1: blackw0lf_03 ($139.76 in chips) 
Seat 3: PacPacBum ($110.48 in chips) 
Seat 4: ki11u ($100 in chips) 
Seat 5: Slash3r ($83.41 in chips) 
Seat 6: matiko09 ($100 in chips) 
Seat 7: Sweden_Pound ($106.50 in chips) 
Seat 8: Filojoes ($100 in chips) 
Seat 9: flk.Dasas ($100 in chips) 
blackw0lf_03: posts small blind $0.50
PacPacBum: posts big blind $1
*** HOLE CARDS ***
Dealt to matiko09 [4d 2s]
ki11u: folds 
Slash3r: raises $2 to $3
matiko09: folds 
Sweden_Pound: folds 
Filojoes: calls $3
flk.Dasas: folds 
blackw0lf_03: folds 
PacPacBum: folds 
*** FLOP *** [Ad 4h 2d]
Slash3r: bets $3
Filojoes: raises $6 to $9
Slash3r: folds 
Uncalled bet ($6) returned to Filojoes
Filojoes collected $12.89 from pot
Filojoes: doesn't show hand 
*** SUMMARY ***
Total pot $13.50 | Rake $0.61 
Board [Ad 4h 2d]
Seat 1: blackw0lf_03 (small blind) folded before Flop
Seat 3: PacPacBum (big blind) folded before Flop
Seat 4: ki11u folded before Flop (didn't bet)
Seat 5: Slash3r folded on the Flop
Seat 6: matiko09 folded before Flop (didn't bet)
Seat 7: Sweden_Pound folded before Flop (didn't bet)
Seat 8: Filojoes collected ($12.89)
Seat 9: flk.Dasas (button) folded before Flop (didn't bet)





PokerStars Hand #150126513878:  Hold'em No Limit ($1/$2 USD) - 2016/03/10 13:40:37 CET [2016/03/10 7:40:37 ET]
Table 'Tauris II' 9-max Seat #3 is the button
Seat 1: matiko09 ($200 in chips) 
Seat 2: stds st ($54.41 in chips) 
Seat 3: PacPacBum ($200 in chips) 
Seat 4: neomorf ($697.52 in chips) 
Seat 6: uonlylive1ce ($201.47 in chips) 
Seat 7: Fish4trips ($211.48 in chips) 
Seat 8: scout326 ($236.98 in chips) 
neomorf: posts small blind $1
uonlylive1ce: posts big blind $2
darren1031: sits out 
*** HOLE CARDS ***
Dealt to matiko09 [9s 8s]
Fish4trips: folds 
scout326: folds 
matiko09: raises $3 to $5
stds st: folds 
PacPacBum: folds 
neomorf: folds 
uonlylive1ce: folds 
Uncalled bet ($3) returned to matiko09
matiko09 collected $5 from pot
matiko09: doesn't show hand 
*** SUMMARY ***
Total pot $5 | Rake $0 
Seat 1: matiko09 collected ($5)
Seat 2: stds st folded before Flop (didn't bet)
Seat 3: PacPacBum (button) folded before Flop (didn't bet)
Seat 4: neomorf (small blind) folded before Flop
Seat 6: uonlylive1ce (big blind) folded before Flop
Seat 7: Fish4trips folded before Flop (didn't bet)
Seat 8: scout326 folded before Flop (didn't bet)





PokerStars Hand #150126513994:  Hold'em No Limit ($0.50/$1.00 USD) - 2016/03/10 13:40:38 CET [2016/03/10 7:40:38 ET]
Table 'Iguassu' 9-max Seat #3 is the button
Seat 1: blackw0lf_03 ($100 in chips) 
Seat 2: Rocky6434 ($49.95 in chips) 
Seat 3: hammerwife ($123.43 in chips) 
Seat 4: matiko09 ($100 in chips) 
Seat 5: UnBent022 ($101.50 in chips) 
Seat 6: Igor DoUrden ($118.58 in chips) 
Seat 7: PacPacBum ($120.05 in chips) 
Seat 8: Filojoes ($126.82 in chips) 
Seat 9: er13to ($100 in chips) 
matiko09: posts small blind $0.50
UnBent022: posts big blind $1
*** HOLE CARDS ***
Dealt to matiko09 [8d 4h]
Igor DoUrden: folds 
PacPacBum: folds 
Filojoes: folds 
er13to: raises $2 to $3
blackw0lf_03: folds 
Rocky6434: folds 
hammerwife: folds 
matiko09: folds 
UnBent022: folds 
Uncalled bet ($2) returned to er13to
er13to collected $2.50 from pot
*** SUMMARY ***
Total pot $2.50 | Rake $0 
Seat 1: blackw0lf_03 folded before Flop (didn't bet)
Seat 2: Rocky6434 folded before Flop (didn't bet)
Seat 3: hammerwife (button) folded before Flop (didn't bet)
Seat 4: matiko09 (small blind) folded before Flop
Seat 5: UnBent022 (big blind) folded before Flop
Seat 6: Igor DoUrden folded before Flop (didn't bet)
Seat 7: PacPacBum folded before Flop (didn't bet)
Seat 8: Filojoes folded before Flop (didn't bet)
Seat 9: er13to collected ($2.50)





PokerStars Hand #150126522007:  Hold'em No Limit ($0.50/$1.00 USD) - 2016/03/10 13:40:53 CET [2016/03/10 7:40:53 ET]
Table 'Saskia' 9-max Seat #8 is the button
Seat 1: Sweden_Pound ($104.50 in chips) 
Seat 2: njurg aga ($92.74 in chips) 
Seat 3: ccmaster001 ($82.31 in chips) 
Seat 4: Plz3betMe ($68.22 in chips) 
Seat 5: dreded11 ($96.66 in chips) 
Seat 6: matiko09 ($100 in chips) 
Seat 7: stds st ($49.06 in chips) 
Seat 8: blackw0lf_03 ($106.54 in chips) 
Seat 9: er13to ($122.47 in chips) 
er13to: posts small blind $0.50
Sweden_Pound: posts big blind $1
*** HOLE CARDS ***
Dealt to matiko09 [2d 7s]
njurg aga: folds 
ccmaster001: raises $1 to $2
Plz3betMe: folds 
dreded11: folds 
matiko09: folds 
stds st: folds 
blackw0lf_03: folds 
er13to: folds 
Sweden_Pound: folds 
Uncalled bet ($1) returned to ccmaster001
ccmaster001 collected $2.50 from pot
ccmaster001: doesn't show hand 
*** SUMMARY ***
Total pot $2.50 | Rake $0 
Seat 1: Sweden_Pound (big blind) folded before Flop
Seat 2: njurg aga folded before Flop (didn't bet)
Seat 3: ccmaster001 collected ($2.50)
Seat 4: Plz3betMe folded before Flop (didn't bet)
Seat 5: dreded11 folded before Flop (didn't bet)
Seat 6: matiko09 folded before Flop (didn't bet)
Seat 7: stds st folded before Flop (didn't bet)
Seat 8: blackw0lf_03 (button) folded before Flop (didn't bet)
Seat 9: er13to (small blind) folded before Flop





PokerStars Hand #150126523194:  Hold'em No Limit ($0.25/$0.50 USD) - 2016/03/10 13:40:55 CET [2016/03/10 7:40:55 ET]
Table 'Aegina' 9-max Seat #3 is the button
Seat 1: BingoIng0 ($125.79 in chips) 
Seat 3: MyMilkCans=D ($125 in chips) 
Seat 4: digimatical ($72.07 in chips) 
Seat 5: Ahangama ($50 in chips) 
Seat 6: matiko09 ($54.39 in chips) 
Seat 7: Gummio ($113.75 in chips) 
Seat 8: ardo888 ($179.09 in chips) 
Seat 9: draken08 ($125 in chips) 
digimatical: posts small blind $0.25
Ahangama: posts big blind $0.50
Spid1: sits out 
BingoIng0: posts the ante $0.10
MyMilkCans=D: posts the ante $0.10
digimatical: posts the ante $0.10
Ahangama: posts the ante $0.10
matiko09: posts the ante $0.10
Gummio: posts the ante $0.10
ardo888: posts the ante $0.10
draken08: posts the ante $0.10
*** HOLE CARDS ***
Dealt to matiko09 [2h 6d]
matiko09: folds 
Gummio: raises $0.50 to $1
ardo888: folds 
draken08: folds 
BingoIng0: folds 
MyMilkCans=D: folds 
digimatical: folds 
Ahangama: folds 
Uncalled bet ($0.50) returned to Gummio
Gummio collected $2.05 from pot
Gummio: doesn't show hand 
*** SUMMARY ***
Total pot $2.05 | Rake $0 
Seat 1: BingoIng0 folded before Flop (didn't bet)
Seat 3: MyMilkCans=D (button) folded before Flop (didn't bet)
Seat 4: digimatical (small blind) folded before Flop
Seat 5: Ahangama (big blind) folded before Flop
Seat 6: matiko09 folded before Flop (didn't bet)
Seat 7: Gummio collected ($2.05)
Seat 8: ardo888 folded before Flop (didn't bet)
Seat 9: draken08 folded before Flop (didn't bet)





PokerStars Hand #150126524251:  Hold'em No Limit ($0.50/$1.00 USD) - 2016/03/10 13:40:57 CET [2016/03/10 7:40:57 ET]
Table 'Leuschneria II' 9-max Seat #1 is the button
Seat 1: SHARKFIN168 ($104.28 in chips) 
Seat 2: blackw0lf_03 ($100 in chips) 
Seat 3: Spid1 ($100 in chips) 
Seat 4: Sweden_Pound ($135.22 in chips) 
Seat 5: RMilPoker ($222.04 in chips) 
Seat 6: matiko09 ($114.61 in chips) 
Seat 7: Plz3betMe ($38 in chips) 
Seat 8: UnBent022 ($101.46 in chips) 
Seat 9: ki11u ($100 in chips) 
blackw0lf_03: posts small blind $0.50
Spid1: posts big blind $1
*** HOLE CARDS ***
Dealt to matiko09 [9h 4s]
Sweden_Pound: folds 
RMilPoker: folds 
matiko09: folds 
Plz3betMe: folds 
UnBent022: folds 
ki11u: folds 
SHARKFIN168: folds 
blackw0lf_03: folds 
Uncalled bet ($0.50) returned to Spid1
Spid1 collected $1 from pot
Spid1: doesn't show hand 
*** SUMMARY ***
Total pot $1 | Rake $0 
Seat 1: SHARKFIN168 (button) folded before Flop (didn't bet)
Seat 2: blackw0lf_03 (small blind) folded before Flop
Seat 3: Spid1 (big blind) collected ($1)
Seat 4: Sweden_Pound folded before Flop (didn't bet)
Seat 5: RMilPoker folded before Flop (didn't bet)
Seat 6: matiko09 folded before Flop (didn't bet)
Seat 7: Plz3betMe folded before Flop (didn't bet)
Seat 8: UnBent022 folded before Flop (didn't bet)
Seat 9: ki11u folded before Flop (didn't bet)





PokerStars Hand #150126525973:  Hold'em No Limit ($1/$2 USD) - 2016/03/10 13:41:00 CET [2016/03/10 7:41:00 ET]
Table 'Tauris II' 9-max Seat #4 is the button
Seat 1: matiko09 ($203 in chips) 
Seat 2: stds st ($54.41 in chips) 
Seat 3: PacPacBum ($200 in chips) 
Seat 4: neomorf ($696.52 in chips) 
Seat 6: uonlylive1ce ($200 in chips) 
Seat 7: Fish4trips ($211.48 in chips) 
Seat 8: scout326 ($236.98 in chips) 
uonlylive1ce: posts small blind $1
Fish4trips: posts big blind $2
darren1031: sits out 
*** HOLE CARDS ***
Dealt to matiko09 [Kd 2c]
scout326 has timed out
scout326: folds 
matiko09: folds 
stds st: folds 
PacPacBum: folds 
neomorf: raises $2.48 to $4.48
uonlylive1ce: folds 
Fish4trips: folds 
Uncalled bet ($2.48) returned to neomorf
neomorf collected $5 from pot
neomorf: doesn't show hand 
*** SUMMARY ***
Total pot $5 | Rake $0 
Seat 1: matiko09 folded before Flop (didn't bet)
Seat 2: stds st folded before Flop (didn't bet)
Seat 3: PacPacBum folded before Flop (didn't bet)
Seat 4: neomorf (button) collected ($5)
Seat 6: uonlylive1ce (small blind) folded before Flop
Seat 7: Fish4trips (big blind) folded before Flop
Seat 8: scout326 folded before Flop (didn't bet)





PokerStars Hand #150126535741:  Hold'em No Limit (€1/€2 EUR) - 2016/03/10 13:41:18 CET [2016/03/10 7:41:18 ET]
Table 'Sigrid II' 9-max Seat #2 is the button
Seat 1: Gamz11 (€200 in chips) 
Seat 2: stds st (€100.92 in chips) 
Seat 3: RoadtoNepal (€200 in chips) 
Seat 4: Fish4trips (€200 in chips) 
Seat 5: vr188 (€80.11 in chips) 
Seat 7: PacPacBum (€205.17 in chips) 
Seat 8: matiko09 (€209.49 in chips) 
Seat 9: ki11u (€223.25 in chips) 
RoadtoNepal: posts small blind €1
Fish4trips: posts big blind €2
*** HOLE CARDS ***
Dealt to matiko09 [6s Ac]
vr188: folds 
PacPacBum: raises €2.08 to €4.08
matiko09: folds 
ki11u: calls €4.08
Gamz11: calls €4.08
stds st: folds 
RoadtoNepal: folds 
Fish4trips: folds 
*** FLOP *** [As Ad 9h]
PacPacBum: checks 
ki11u: bets €8
Gamz11: folds 
PacPacBum: folds 
Uncalled bet (€8) returned to ki11u
ki11u collected €14.55 from pot
ki11u: doesn't show hand 
*** SUMMARY ***
Total pot €15.24 | Rake €0.69 
Board [As Ad 9h]
Seat 1: Gamz11 folded on the Flop
Seat 2: stds st (button) folded before Flop (didn't bet)
Seat 3: RoadtoNepal (small blind) folded before Flop
Seat 4: Fish4trips (big blind) folded before Flop
Seat 5: vr188 folded before Flop (didn't bet)
Seat 7: PacPacBum folded on the Flop
Seat 8: matiko09 folded before Flop (didn't bet)
Seat 9: ki11u collected (€14.55)





PokerStars Hand #150126537034:  Hold'em No Limit ($0.50/$1.00 USD) - 2016/03/10 13:41:21 CET [2016/03/10 7:41:21 ET]
Table 'Saskia' 9-max Seat #9 is the button
Seat 1: Sweden_Pound ($103.50 in chips) 
Seat 2: njurg aga ($92.74 in chips) 
Seat 3: ccmaster001 ($83.81 in chips) 
Seat 4: Plz3betMe ($68.22 in chips) 
Seat 5: dreded11 ($96.66 in chips) 
Seat 6: matiko09 ($100 in chips) 
Seat 7: stds st ($49.06 in chips) 
Seat 8: blackw0lf_03 ($106.54 in chips) 
Seat 9: er13to ($121.97 in chips) 
Sweden_Pound: posts small blind $0.50
njurg aga: posts big blind $1
*** HOLE CARDS ***
Dealt to matiko09 [Kd 5h]
ccmaster001: raises $1 to $2
Plz3betMe: folds 
dreded11: folds 
matiko09: folds 
stds st: folds 
blackw0lf_03: calls $2
er13to: folds 
Sweden_Pound: folds 
njurg aga: calls $1
*** FLOP *** [7d 6d 7s]
njurg aga: checks 
ccmaster001: bets $3
blackw0lf_03: folds 
njurg aga: folds 
Uncalled bet ($3) returned to ccmaster001
ccmaster001 collected $6.21 from pot
ccmaster001: doesn't show hand 
*** SUMMARY ***
Total pot $6.50 | Rake $0.29 
Board [7d 6d 7s]
Seat 1: Sweden_Pound (small blind) folded before Flop
Seat 2: njurg aga (big blind) folded on the Flop
Seat 3: ccmaster001 collected ($6.21)
Seat 4: Plz3betMe folded before Flop (didn't bet)
Seat 5: dreded11 folded before Flop (didn't bet)
Seat 6: matiko09 folded before Flop (didn't bet)
Seat 7: stds st folded before Flop (didn't bet)
Seat 8: blackw0lf_03 folded on the Flop
Seat 9: er13to (button) folded before Flop (didn't bet)





PokerStars Hand #150126536987:  Hold'em No Limit ($1/$2 USD) - 2016/03/10 13:41:21 CET [2016/03/10 7:41:21 ET]
Table 'Chandra II' 9-max Seat #6 is the button
Seat 1: Fish4trips ($300.44 in chips) 
Seat 2: PacPacBum ($234.51 in chips) 
Seat 4: tipner ($200 in chips) 
Seat 5: uibting ($52.31 in chips) 
Seat 6: stds st ($75.31 in chips) 
Seat 7: johnvu2016 ($135.97 in chips) 
Seat 8: matiko09 ($218.48 in chips) 
Seat 9: o.miro ($289.27 in chips) 
johnvu2016: posts small blind $1
matiko09: posts big blind $2
*** HOLE CARDS ***
Dealt to matiko09 [Qh Kh]
o.miro: folds 
Fish4trips: folds 
PacPacBum: folds 
tipner: folds 
uibting: raises $2 to $4
stds st: folds 
johnvu2016: calls $3
matiko09: calls $2
*** FLOP *** [Kc 6s 5c]
johnvu2016: checks 
matiko09: bets $7.45
uibting: calls $7.45
johnvu2016: folds 
*** TURN *** [Kc 6s 5c] [3h]
matiko09: bets $18
uibting: calls $18
*** RIVER *** [Kc 6s 5c 3h] [8s]
matiko09: bets $40
uibting: calls $22.86 and is all-in
Uncalled bet ($17.14) returned to matiko09
*** SHOW DOWN ***
matiko09: shows [Qh Kh] (a pair of Kings)
uibting: mucks hand 
matiko09 collected $105.82 from pot
*** SUMMARY ***
Total pot $108.62 | Rake $2.80 
Board [Kc 6s 5c 3h 8s]
Seat 1: Fish4trips folded before Flop (didn't bet)
Seat 2: PacPacBum folded before Flop (didn't bet)
Seat 4: tipner folded before Flop (didn't bet)
Seat 5: uibting mucked [Ks Ts]
Seat 6: stds st (button) folded before Flop (didn't bet)
Seat 7: johnvu2016 (small blind) folded on the Flop
Seat 8: matiko09 (big blind) showed [Qh Kh] and won ($105.82) with a pair of Kings
Seat 9: o.miro folded before Flop (didn't bet)





PokerStars Hand #150126537693:  Hold'em No Limit ($0.50/$1.00 USD) - 2016/03/10 13:41:22 CET [2016/03/10 7:41:22 ET]
Table 'Liriope II' 9-max Seat #1 is the button
Seat 1: UnBent022 ($100 in chips) 
Seat 2: zxp12345 ($19.37 in chips) 
Seat 3: matiko09 ($164.51 in chips) 
Seat 4: Plz3betMe ($45.93 in chips) 
Seat 5: lumen21 ($103.68 in chips) 
Seat 6: nobu-azabu ($191.28 in chips) 
Seat 7: Sweden_Pound ($104.23 in chips) 
Seat 8: PacPacBum ($131.49 in chips) 
zxp12345: posts small blind $0.50
matiko09: posts big blind $1
*** HOLE CARDS ***
Dealt to matiko09 [Qh 3d]
Plz3betMe: folds 
lumen21: raises $2 to $3
nobu-azabu: folds 
Sweden_Pound: folds 
PacPacBum: folds 
UnBent022: folds 
zxp12345: folds 
matiko09: folds 
Uncalled bet ($2) returned to lumen21
lumen21 collected $2.50 from pot
lumen21: doesn't show hand 
*** SUMMARY ***
Total pot $2.50 | Rake $0 
Seat 1: UnBent022 (button) folded before Flop (didn't bet)
Seat 2: zxp12345 (small blind) folded before Flop
Seat 3: matiko09 (big blind) folded before Flop
Seat 4: Plz3betMe folded before Flop (didn't bet)
Seat 5: lumen21 collected ($2.50)
Seat 6: nobu-azabu folded before Flop (didn't bet)
Seat 7: Sweden_Pound folded before Flop (didn't bet)
Seat 8: PacPacBum folded before Flop (didn't bet)





PokerStars Hand #150126540095:  Hold'em No Limit ($0.50/$1.00 USD) - 2016/03/10 13:41:26 CET [2016/03/10 7:41:26 ET]
Table 'Leuschneria II' 9-max Seat #2 is the button
Seat 1: SHARKFIN168 ($104.28 in chips) 
Seat 2: blackw0lf_03 ($100 in chips) 
Seat 3: Spid1 ($100.50 in chips) 
Seat 4: Sweden_Pound ($135.22 in chips) 
Seat 5: RMilPoker ($222.04 in chips) 
Seat 6: matiko09 ($114.61 in chips) 
Seat 7: Plz3betMe ($38 in chips) 
Seat 8: UnBent022 ($101.46 in chips) 
Seat 9: ki11u ($100 in chips) 
Spid1: posts small blind $0.50
Sweden_Pound: posts big blind $1
*** HOLE CARDS ***
Dealt to matiko09 [Qs 9h]
RMilPoker: folds 
matiko09: folds 
Plz3betMe: raises $1 to $2
UnBent022: folds 
ki11u: folds 
SHARKFIN168: folds 
blackw0lf_03: folds 
Spid1: folds 
Sweden_Pound: folds 
Uncalled bet ($1) returned to Plz3betMe
Plz3betMe collected $2.50 from pot
Plz3betMe: doesn't show hand 
*** SUMMARY ***
Total pot $2.50 | Rake $0 
Seat 1: SHARKFIN168 folded before Flop (didn't bet)
Seat 2: blackw0lf_03 (button) folded before Flop (didn't bet)
Seat 3: Spid1 (small blind) folded before Flop
Seat 4: Sweden_Pound (big blind) folded before Flop
Seat 5: RMilPoker folded before Flop (didn't bet)
Seat 6: matiko09 folded before Flop (didn't bet)
Seat 7: Plz3betMe collected ($2.50)
Seat 8: UnBent022 folded before Flop (didn't bet)
Seat 9: ki11u folded before Flop (didn't bet)





PokerStars Hand #150126540860:  Hold'em No Limit ($0.50/$1.00 USD) - 2016/03/10 13:41:28 CET [2016/03/10 7:41:28 ET]
Table 'Mars III' 9-max Seat #1 is the button
Seat 1: blackw0lf_03 ($139.26 in chips) 
Seat 3: PacPacBum ($109.48 in chips) 
Seat 4: ki11u ($100 in chips) 
Seat 5: Slash3r ($77.41 in chips) 
Seat 6: matiko09 ($100 in chips) 
Seat 7: Sweden_Pound ($106.50 in chips) 
Seat 8: Filojoes ($106.89 in chips) 
Seat 9: flk.Dasas ($100 in chips) 
PacPacBum: posts small blind $0.50
ki11u: posts big blind $1
*** HOLE CARDS ***
Dealt to matiko09 [8h 3s]
Slash3r: calls $1
matiko09: folds 
Sweden_Pound: folds 
Filojoes: folds 
flk.Dasas: raises $3 to $4
blackw0lf_03: folds 
PacPacBum: folds 
ki11u: folds 
Slash3r: folds 
Uncalled bet ($3) returned to flk.Dasas
flk.Dasas collected $3.50 from pot
flk.Dasas: doesn't show hand 
*** SUMMARY ***
Total pot $3.50 | Rake $0 
Seat 1: blackw0lf_03 (button) folded before Flop (didn't bet)
Seat 3: PacPacBum (small blind) folded before Flop
Seat 4: ki11u (big blind) folded before Flop
Seat 5: Slash3r folded before Flop
Seat 6: matiko09 folded before Flop (didn't bet)
Seat 7: Sweden_Pound folded before Flop (didn't bet)
Seat 8: Filojoes folded before Flop (didn't bet)
Seat 9: flk.Dasas collected ($3.50)





PokerStars Hand #150126543491:  Hold'em No Limit ($0.25/$0.50 USD) - 2016/03/10 13:41:33 CET [2016/03/10 7:41:33 ET]
Table 'Aegina' 9-max Seat #4 is the button
Seat 1: BingoIng0 ($125.69 in chips) 
Seat 3: MyMilkCans=D ($125 in chips) 
Seat 4: digimatical ($71.72 in chips) 
Seat 5: Ahangama ($50 in chips) 
Seat 6: matiko09 ($54.29 in chips) 
Seat 7: Gummio ($115.20 in chips) 
Seat 8: ardo888 ($178.99 in chips) 
Seat 9: draken08 ($125 in chips) 
Ahangama: posts small blind $0.25
matiko09: posts big blind $0.50
Spid1: sits out 
BingoIng0: posts the ante $0.10
MyMilkCans=D: posts the ante $0.10
digimatical: posts the ante $0.10
Ahangama: posts the ante $0.10
matiko09: posts the ante $0.10
Gummio: posts the ante $0.10
ardo888: posts the ante $0.10
draken08: posts the ante $0.10
*** HOLE CARDS ***
Dealt to matiko09 [4d 3d]
Gummio: folds 
ardo888: folds 
draken08: raises $1 to $1.50
BingoIng0: folds 
MyMilkCans=D: folds 
digimatical: folds 
Ahangama: folds 
matiko09: folds 
Uncalled bet ($1) returned to draken08
draken08 collected $2.05 from pot
draken08: doesn't show hand 
*** SUMMARY ***
Total pot $2.05 | Rake $0 
Seat 1: BingoIng0 folded before Flop (didn't bet)
Seat 3: MyMilkCans=D folded before Flop (didn't bet)
Seat 4: digimatical (button) folded before Flop (didn't bet)
Seat 5: Ahangama (small blind) folded before Flop
Seat 6: matiko09 (big blind) folded before Flop
Seat 7: Gummio folded before Flop (didn't bet)
Seat 8: ardo888 folded before Flop (didn't bet)
Seat 9: draken08 collected ($2.05)





PokerStars Hand #150126551007:  Hold'em No Limit ($1/$2 USD) - 2016/03/10 13:41:47 CET [2016/03/10 7:41:47 ET]
Table 'Tauris II' 9-max Seat #6 is the button
Seat 1: matiko09 ($203 in chips) 
Seat 2: stds st ($54.41 in chips) 
Seat 3: PacPacBum ($200 in chips) 
Seat 4: neomorf ($699.52 in chips) 
Seat 6: uonlylive1ce ($200 in chips) 
Seat 7: Fish4trips ($209.48 in chips) 
Seat 8: scout326 ($236.98 in chips) 
Fish4trips: posts small blind $1
scout326: posts big blind $2
darren1031: sits out 
tipner: sits out 
*** HOLE CARDS ***
Dealt to matiko09 [4c Qs]
matiko09: folds 
stds st: raises $2.04 to $4.04
PacPacBum: calls $4.04
neomorf: folds 
uonlylive1ce: folds 
Fish4trips: folds 
scout326: folds 
*** FLOP *** [Ad 4d 7d]
stds st: checks 
PacPacBum: checks 
*** TURN *** [Ad 4d 7d] [3d]
stds st: bets $6.34
PacPacBum: folds 
Uncalled bet ($6.34) returned to stds st
stds st collected $10.58 from pot
stds st: doesn't show hand 
*** SUMMARY ***
Total pot $11.08 | Rake $0.50 
Board [Ad 4d 7d 3d]
Seat 1: matiko09 folded before Flop (didn't bet)
Seat 2: stds st collected ($10.58)
Seat 3: PacPacBum folded on the Turn
Seat 4: neomorf folded before Flop (didn't bet)
Seat 6: uonlylive1ce (button) folded before Flop (didn't bet)
Seat 7: Fish4trips (small blind) folded before Flop
Seat 8: scout326 (big blind) folded before Flop





PokerStars Hand #150126553806:  Hold'em No Limit ($0.50/$1.00 USD) - 2016/03/10 13:41:52 CET [2016/03/10 7:41:52 ET]
Table 'Mars III' 9-max Seat #3 is the button
Seat 1: blackw0lf_03 ($139.26 in chips) 
Seat 3: PacPacBum ($108.98 in chips) 
Seat 4: ki11u ($100 in chips) 
Seat 5: Slash3r ($76.41 in chips) 
Seat 6: matiko09 ($100 in chips) 
Seat 7: Sweden_Pound ($106.50 in chips) 
Seat 8: Filojoes ($106.89 in chips) 
Seat 9: flk.Dasas ($102.50 in chips) 
ki11u: posts small blind $0.50
Slash3r: posts big blind $1
*** HOLE CARDS ***
Dealt to matiko09 [9h Jc]
matiko09: folds 
Sweden_Pound: folds 
Filojoes: folds 
flk.Dasas: folds 
blackw0lf_03: folds 
PacPacBum: folds 
ki11u: raises $2 to $3
Slash3r: calls $2
*** FLOP *** [6h Jh 6c]
ki11u: bets $3
Slash3r: folds 
Uncalled bet ($3) returned to ki11u
ki11u collected $5.73 from pot
ki11u: doesn't show hand 
*** SUMMARY ***
Total pot $6 | Rake $0.27 
Board [6h Jh 6c]
Seat 1: blackw0lf_03 folded before Flop (didn't bet)
Seat 3: PacPacBum (button) folded before Flop (didn't bet)
Seat 4: ki11u (small blind) collected ($5.73)
Seat 5: Slash3r (big blind) folded on the Flop
Seat 6: matiko09 folded before Flop (didn't bet)
Seat 7: Sweden_Pound folded before Flop (didn't bet)
Seat 8: Filojoes folded before Flop (didn't bet)
Seat 9: flk.Dasas folded before Flop (didn't bet)





PokerStars Hand #150126555783:  Hold'em No Limit ($0.50/$1.00 USD) - 2016/03/10 13:41:56 CET [2016/03/10 7:41:56 ET]
Table 'Iguassu' 9-max Seat #4 is the button
Seat 1: blackw0lf_03 ($100 in chips) 
Seat 2: Rocky6434 ($49.95 in chips) 
Seat 3: hammerwife ($123.43 in chips) 
Seat 4: matiko09 ($100 in chips) 
Seat 5: UnBent022 ($100.50 in chips) 
Seat 6: Igor DoUrden ($118.58 in chips) 
Seat 7: PacPacBum ($120.05 in chips) 
Seat 8: Filojoes ($126.82 in chips) 
Seat 9: er13to ($101.50 in chips) 
UnBent022: posts small blind $0.50
Igor DoUrden: posts big blind $1
*** HOLE CARDS ***
Dealt to matiko09 [Jc 4h]
PacPacBum: folds 
Filojoes: folds 
er13to: folds 
blackw0lf_03: folds 
Rocky6434: folds 
hammerwife: folds 
matiko09: folds 
UnBent022: raises $2 to $3
Igor DoUrden: folds 
Uncalled bet ($2) returned to UnBent022
UnBent022 collected $2 from pot
UnBent022: doesn't show hand 
*** SUMMARY ***
Total pot $2 | Rake $0 
Seat 1: blackw0lf_03 folded before Flop (didn't bet)
Seat 2: Rocky6434 folded before Flop (didn't bet)
Seat 3: hammerwife folded before Flop (didn't bet)
Seat 4: matiko09 (button) folded before Flop (didn't bet)
Seat 5: UnBent022 (small blind) collected ($2)
Seat 6: Igor DoUrden (big blind) folded before Flop
Seat 7: PacPacBum folded before Flop (didn't bet)
Seat 8: Filojoes folded before Flop (didn't bet)
Seat 9: er13to folded before Flop (didn't bet)





PokerStars Hand #150126556226:  Hold'em No Limit ($0.50/$1.00 USD) - 2016/03/10 13:41:56 CET [2016/03/10 7:41:56 ET]
Table 'Liriope II' 9-max Seat #2 is the button
Seat 1: UnBent022 ($100 in chips) 
Seat 2: zxp12345 ($18.87 in chips) 
Seat 3: matiko09 ($163.51 in chips) 
Seat 4: Plz3betMe ($45.93 in chips) 
Seat 5: lumen21 ($105.18 in chips) 
Seat 6: nobu-azabu ($191.28 in chips) 
Seat 7: Sweden_Pound ($104.23 in chips) 
Seat 8: PacPacBum ($131.49 in chips) 
matiko09: posts small blind $0.50
Plz3betMe: posts big blind $1
*** HOLE CARDS ***
Dealt to matiko09 [6s Jc]
lumen21: folds 
nobu-azabu: folds 
Sweden_Pound: folds 
PacPacBum: folds 
UnBent022: raises $1.50 to $2.50
zxp12345: raises $1.50 to $4
matiko09: folds 
Plz3betMe: raises $18 to $22
UnBent022: folds 
zxp12345: calls $14.87 and is all-in
Uncalled bet ($3.13) returned to Plz3betMe
*** FLOP *** [Qc 4d 8s]
*** TURN *** [Qc 4d 8s] [8h]
*** RIVER *** [Qc 4d 8s 8h] [9c]
*** SHOW DOWN ***
Plz3betMe: shows [Qd Qh] (a full house, Queens full of Eights)
zxp12345: shows [Kh Qs] (two pair, Queens and Eights)
Plz3betMe collected $38.91 from pot
*** SUMMARY ***
Total pot $40.74 | Rake $1.83 
Board [Qc 4d 8s 8h 9c]
Seat 1: UnBent022 folded before Flop
Seat 2: zxp12345 (button) showed [Kh Qs] and lost with two pair, Queens and Eights
Seat 3: matiko09 (small blind) folded before Flop
Seat 4: Plz3betMe (big blind) showed [Qd Qh] and won ($38.91) with a full house, Queens full of Eights
Seat 5: lumen21 folded before Flop (didn't bet)
Seat 6: nobu-azabu folded before Flop (didn't bet)
Seat 7: Sweden_Pound folded before Flop (didn't bet)
Seat 8: PacPacBum folded before Flop (didn't bet)





PokerStars Hand #150126561467:  Hold'em No Limit ($0.25/$0.50 USD) - 2016/03/10 13:42:06 CET [2016/03/10 7:42:06 ET]
Table 'Aegina' 9-max Seat #5 is the button
Seat 1: BingoIng0 ($125.59 in chips) 
Seat 3: MyMilkCans=D ($125 in chips) 
Seat 4: digimatical ($71.62 in chips) 
Seat 5: Ahangama ($50 in chips) 
Seat 6: matiko09 ($53.69 in chips) 
Seat 7: Gummio ($115.10 in chips) 
Seat 8: ardo888 ($178.89 in chips) 
Seat 9: draken08 ($126.45 in chips) 
matiko09: posts small blind $0.25
Gummio: posts big blind $0.50
Spid1: sits out 
BingoIng0: posts the ante $0.10
MyMilkCans=D: posts the ante $0.10
digimatical: posts the ante $0.10
Ahangama: posts the ante $0.10
matiko09: posts the ante $0.10
Gummio: posts the ante $0.10
ardo888: posts the ante $0.10
draken08: posts the ante $0.10
*** HOLE CARDS ***
Dealt to matiko09 [6c 8d]
ardo888: folds 
draken08: folds 
BingoIng0: raises $1 to $1.50
MyMilkCans=D: folds 
digimatical: calls $1.50
Ahangama: folds 
matiko09: folds 
Gummio: calls $1
*** FLOP *** [7h 3c 4c]
Gummio: checks 
BingoIng0: checks 
digimatical: checks 
*** TURN *** [7h 3c 4c] [Kd]
Gummio: bets $5.30
BingoIng0: calls $5.30
digimatical: folds 
*** RIVER *** [7h 3c 4c Kd] [5d]
Gummio: bets $15.42
BingoIng0: folds [Kh]
Uncalled bet ($15.42) returned to Gummio
Gummio collected $15.42 from pot
Gummio: doesn't show hand 
*** SUMMARY ***
Total pot $16.15 | Rake $0.73 
Board [7h 3c 4c Kd 5d]
Seat 1: BingoIng0 folded on the River
Seat 3: MyMilkCans=D folded before Flop (didn't bet)
Seat 4: digimatical folded on the Turn
Seat 5: Ahangama (button) folded before Flop (didn't bet)
Seat 6: matiko09 (small blind) folded before Flop
Seat 7: Gummio (big blind) collected ($15.42)
Seat 8: ardo888 folded before Flop (didn't bet)
Seat 9: draken08 folded before Flop (didn't bet)





PokerStars Hand #150126562014:  Hold'em No Limit ($0.50/$1.00 USD) - 2016/03/10 13:42:07 CET [2016/03/10 7:42:07 ET]
Table 'Leuschneria II' 9-max Seat #3 is the button
Seat 1: SHARKFIN168 ($104.28 in chips) 
Seat 2: blackw0lf_03 ($100 in chips) 
Seat 3: Spid1 ($100 in chips) 
Seat 4: Sweden_Pound ($134.22 in chips) 
Seat 5: RMilPoker ($222.04 in chips) 
Seat 6: matiko09 ($114.61 in chips) 
Seat 7: Plz3betMe ($39.50 in chips) 
Seat 8: UnBent022 ($101.46 in chips) 
Seat 9: ki11u ($100 in chips) 
Sweden_Pound: posts small blind $0.50
RMilPoker: posts big blind $1
*** HOLE CARDS ***
Dealt to matiko09 [3d 6d]
matiko09: folds 
Plz3betMe: folds 
UnBent022: folds 
ki11u: folds 
SHARKFIN168: folds 
blackw0lf_03: folds 
Spid1: raises $1.50 to $2.50
Sweden_Pound: folds 
RMilPoker: folds 
Uncalled bet ($1.50) returned to Spid1
Spid1 collected $2.50 from pot
Spid1: doesn't show hand 
*** SUMMARY ***
Total pot $2.50 | Rake $0 
Seat 1: SHARKFIN168 folded before Flop (didn't bet)
Seat 2: blackw0lf_03 folded before Flop (didn't bet)
Seat 3: Spid1 (button) collected ($2.50)
Seat 4: Sweden_Pound (small blind) folded before Flop
Seat 5: RMilPoker (big blind) folded before Flop
Seat 6: matiko09 folded before Flop (didn't bet)
Seat 7: Plz3betMe folded before Flop (didn't bet)
Seat 8: UnBent022 folded before Flop (didn't bet)
Seat 9: ki11u folded before Flop (didn't bet)





PokerStars Hand #150126569449:  Hold'em No Limit ($0.50/$1.00 USD) - 2016/03/10 13:42:21 CET [2016/03/10 7:42:21 ET]
Table 'Saskia' 9-max Seat #1 is the button
Seat 1: Sweden_Pound ($103 in chips) 
Seat 2: njurg aga ($90.74 in chips) 
Seat 4: Plz3betMe ($68.22 in chips) 
Seat 5: dreded11 ($96.66 in chips) 
Seat 6: matiko09 ($100 in chips) 
Seat 7: stds st ($49.06 in chips) 
Seat 8: blackw0lf_03 ($104.54 in chips) 
Seat 9: er13to ($121.97 in chips) 
njurg aga: posts small blind $0.50
ccmaster001: is sitting out 
Plz3betMe: posts big blind $1
*** HOLE CARDS ***
Dealt to matiko09 [3c Qc]
dreded11: folds 
matiko09: folds 
ccmaster001 leaves the table
stds st: folds 
blackw0lf_03: folds 
er13to: raises $2 to $3
Filojoes joins the table at seat #3 
Filojoes leaves the table
Sweden_Pound: folds 
njurg aga: folds 
Plz3betMe: folds 
Uncalled bet ($2) returned to er13to
er13to collected $2.50 from pot
*** SUMMARY ***
Total pot $2.50 | Rake $0 
Seat 1: Sweden_Pound (button) folded before Flop (didn't bet)
Seat 2: njurg aga (small blind) folded before Flop
Seat 4: Plz3betMe (big blind) folded before Flop
Seat 5: dreded11 folded before Flop (didn't bet)
Seat 6: matiko09 folded before Flop (didn't bet)
Seat 7: stds st folded before Flop (didn't bet)
Seat 8: blackw0lf_03 folded before Flop (didn't bet)
Seat 9: er13to collected ($2.50)





PokerStars Hand #150126574529:  Hold'em No Limit ($0.50/$1.00 USD) - 2016/03/10 13:42:31 CET [2016/03/10 7:42:31 ET]
Table 'Leuschneria II' 9-max Seat #4 is the button
Seat 1: SHARKFIN168 ($104.28 in chips) 
Seat 2: blackw0lf_03 ($100 in chips) 
Seat 3: Spid1 ($101.50 in chips) 
Seat 4: Sweden_Pound ($133.72 in chips) 
Seat 5: RMilPoker ($221.04 in chips) 
Seat 6: matiko09 ($114.61 in chips) 
Seat 7: Plz3betMe ($39.50 in chips) 
Seat 8: UnBent022 ($101.46 in chips) 
Seat 9: ki11u ($100 in chips) 
RMilPoker: posts small blind $0.50
matiko09: posts big blind $1
*** HOLE CARDS ***
Dealt to matiko09 [Tc 7c]
Plz3betMe: folds 
UnBent022: folds 
ki11u: folds 
SHARKFIN168: raises $1 to $2
blackw0lf_03: folds 
Spid1: folds 
Sweden_Pound: folds 
RMilPoker: folds 
matiko09: folds 
Uncalled bet ($1) returned to SHARKFIN168
SHARKFIN168 collected $2.50 from pot
SHARKFIN168: doesn't show hand 
*** SUMMARY ***
Total pot $2.50 | Rake $0 
Seat 1: SHARKFIN168 collected ($2.50)
Seat 2: blackw0lf_03 folded before Flop (didn't bet)
Seat 3: Spid1 folded before Flop (didn't bet)
Seat 4: Sweden_Pound (button) folded before Flop (didn't bet)
Seat 5: RMilPoker (small blind) folded before Flop
Seat 6: matiko09 (big blind) folded before Flop
Seat 7: Plz3betMe folded before Flop (didn't bet)
Seat 8: UnBent022 folded before Flop (didn't bet)
Seat 9: ki11u folded before Flop (didn't bet)





PokerStars Hand #150126576964:  Hold'em No Limit ($0.50/$1.00 USD) - 2016/03/10 13:42:35 CET [2016/03/10 7:42:35 ET]
Table 'Iguassu' 9-max Seat #5 is the button
Seat 1: blackw0lf_03 ($100 in chips) 
Seat 2: Rocky6434 ($49.95 in chips) 
Seat 3: hammerwife ($123.43 in chips) 
Seat 4: matiko09 ($100 in chips) 
Seat 5: UnBent022 ($101.50 in chips) 
Seat 6: Igor DoUrden ($117.58 in chips) 
Seat 7: PacPacBum ($120.05 in chips) 
Seat 8: Filojoes ($126.82 in chips) 
Seat 9: er13to ($101.50 in chips) 
Igor DoUrden: posts small blind $0.50
PacPacBum: posts big blind $1
*** HOLE CARDS ***
Dealt to matiko09 [3c Kd]
Filojoes: folds 
er13to: raises $2 to $3
blackw0lf_03: folds 
Rocky6434: calls $3
hammerwife: folds 
matiko09: folds 
UnBent022: folds 
Igor DoUrden: folds 
PacPacBum: folds 
*** FLOP *** [Jc 7d Ts]
er13to: checks 
Rocky6434: bets $7.16
er13to: folds 
Uncalled bet ($7.16) returned to Rocky6434
Rocky6434 collected $7.16 from pot
Rocky6434: doesn't show hand 
*** SUMMARY ***
Total pot $7.50 | Rake $0.34 
Board [Jc 7d Ts]
Seat 1: blackw0lf_03 folded before Flop (didn't bet)
Seat 2: Rocky6434 collected ($7.16)
Seat 3: hammerwife folded before Flop (didn't bet)
Seat 4: matiko09 folded before Flop (didn't bet)
Seat 5: UnBent022 (button) folded before Flop (didn't bet)
Seat 6: Igor DoUrden (small blind) folded before Flop
Seat 7: PacPacBum (big blind) folded before Flop
Seat 8: Filojoes folded before Flop (didn't bet)
Seat 9: er13to folded on the Flop





PokerStars Hand #150126576577:  Hold'em No Limit ($1/$2 USD) - 2016/03/10 13:42:35 CET [2016/03/10 7:42:35 ET]
Table 'Chandra II' 9-max Seat #7 is the button
Seat 1: Fish4trips ($300.44 in chips) 
Seat 2: PacPacBum ($234.51 in chips) 
Seat 3: ROLLO 888 ($256.82 in chips) 
Seat 4: tipner ($200 in chips) 
Seat 6: stds st ($75.31 in chips) 
Seat 7: johnvu2016 ($131.97 in chips) 
Seat 8: matiko09 ($271.99 in chips) 
Seat 9: o.miro ($289.27 in chips) 
matiko09: posts small blind $1
o.miro: posts big blind $2
ROLLO 888: posts small & big blinds $3
*** HOLE CARDS ***
Dealt to matiko09 [9s 8d]
Fish4trips: folds 
PacPacBum: folds 
ROLLO 888: raises $4 to $6
tipner: folds 
stds st: folds 
johnvu2016: calls $6
matiko09: folds 
o.miro: folds 
*** FLOP *** [9h 7s Jd]
ROLLO 888: checks 
johnvu2016: bets $7.64
ROLLO 888: folds 
Uncalled bet ($7.64) returned to johnvu2016
johnvu2016 collected $15.28 from pot
*** SUMMARY ***
Total pot $16 | Rake $0.72 
Board [9h 7s Jd]
Seat 1: Fish4trips folded before Flop (didn't bet)
Seat 2: PacPacBum folded before Flop (didn't bet)
Seat 3: ROLLO 888 folded on the Flop
Seat 4: tipner folded before Flop (didn't bet)
Seat 6: stds st folded before Flop (didn't bet)
Seat 7: johnvu2016 (button) collected ($15.28)
Seat 8: matiko09 (small blind) folded before Flop
Seat 9: o.miro (big blind) folded before Flop





PokerStars Hand #150126585860:  Hold'em No Limit ($1/$2 USD) - 2016/03/10 13:42:52 CET [2016/03/10 7:42:52 ET]
Table 'Tauris II' 9-max Seat #7 is the button
Seat 1: matiko09 ($203 in chips) 
Seat 2: stds st ($60.95 in chips) 
Seat 3: PacPacBum ($200 in chips) 
Seat 4: neomorf ($699.52 in chips) 
Seat 6: uonlylive1ce ($200 in chips) 
Seat 7: Fish4trips ($208.48 in chips) 
Seat 8: scout326 ($234.98 in chips) 
Seat 9: darren1031 ($222.41 in chips) 
scout326: posts small blind $1
darren1031: posts big blind $2
tipner: sits out 
*** HOLE CARDS ***
Dealt to matiko09 [4d 2h]
matiko09: folds 
stds st: folds 
PacPacBum: folds 
neomorf: folds 
uonlylive1ce: folds 
Fish4trips: raises $2 to $4
scout326: folds 
darren1031: calls $2
*** FLOP *** [6s 2d Qd]
darren1031: bets $6
Fish4trips: folds 
Uncalled bet ($6) returned to darren1031
darren1031 collected $8.60 from pot
darren1031: doesn't show hand 
*** SUMMARY ***
Total pot $9 | Rake $0.40 
Board [6s 2d Qd]
Seat 1: matiko09 folded before Flop (didn't bet)
Seat 2: stds st folded before Flop (didn't bet)
Seat 3: PacPacBum folded before Flop (didn't bet)
Seat 4: neomorf folded before Flop (didn't bet)
Seat 6: uonlylive1ce folded before Flop (didn't bet)
Seat 7: Fish4trips (button) folded on the Flop
Seat 8: scout326 (small blind) folded before Flop
Seat 9: darren1031 (big blind) collected ($8.60)





PokerStars Hand #150126586270:  Hold'em No Limit ($0.50/$1.00 USD) - 2016/03/10 13:42:53 CET [2016/03/10 7:42:53 ET]
Table 'Leuschneria II' 9-max Seat #5 is the button
Seat 1: SHARKFIN168 ($105.78 in chips) 
Seat 2: blackw0lf_03 ($100 in chips) 
Seat 3: Spid1 ($101.50 in chips) 
Seat 4: Sweden_Pound ($133.72 in chips) 
Seat 5: RMilPoker ($220.54 in chips) 
Seat 6: matiko09 ($113.61 in chips) 
Seat 7: Plz3betMe ($39.50 in chips) 
Seat 8: UnBent022 ($101.46 in chips) 
Seat 9: ki11u ($100 in chips) 
matiko09: posts small blind $0.50
Plz3betMe: posts big blind $1
*** HOLE CARDS ***
Dealt to matiko09 [7c Th]
UnBent022: folds 
ki11u: folds 
SHARKFIN168: folds 
blackw0lf_03: folds 
Spid1: folds 
Sweden_Pound: folds 
RMilPoker: folds 
matiko09: folds 
Uncalled bet ($0.50) returned to Plz3betMe
Plz3betMe collected $1 from pot
Plz3betMe: doesn't show hand 
*** SUMMARY ***
Total pot $1 | Rake $0 
Seat 1: SHARKFIN168 folded before Flop (didn't bet)
Seat 2: blackw0lf_03 folded before Flop (didn't bet)
Seat 3: Spid1 folded before Flop (didn't bet)
Seat 4: Sweden_Pound folded before Flop (didn't bet)
Seat 5: RMilPoker (button) folded before Flop (didn't bet)
Seat 6: matiko09 (small blind) folded before Flop
Seat 7: Plz3betMe (big blind) collected ($1)
Seat 8: UnBent022 folded before Flop (didn't bet)
Seat 9: ki11u folded before Flop (didn't bet)





PokerStars Hand #150126588745:  Hold'em No Limit (€1/€2 EUR) - 2016/03/10 13:42:57 CET [2016/03/10 7:42:57 ET]
Table 'Sigrid II' 9-max Seat #3 is the button
Seat 1: Gamz11 (€200 in chips) 
Seat 2: stds st (€100.92 in chips) 
Seat 3: RoadtoNepal (€200 in chips) 
Seat 4: Fish4trips (€200 in chips) 
Seat 5: vr188 (€80.11 in chips) 
Seat 7: PacPacBum (€201.09 in chips) 
Seat 8: matiko09 (€209.49 in chips) 
Seat 9: ki11u (€233.72 in chips) 
Fish4trips: posts small blind €1
vr188: posts big blind €2
*** HOLE CARDS ***
Dealt to matiko09 [Qh 7d]
PacPacBum: folds 
matiko09: folds 
ki11u: folds 
Gamz11: folds 
stds st: folds 
RoadtoNepal: raises €2 to €4
Fish4trips: raises €10 to €14
vr188: folds 
RoadtoNepal: folds 
Uncalled bet (€10) returned to Fish4trips
Fish4trips collected €10 from pot
Fish4trips: doesn't show hand 
*** SUMMARY ***
Total pot €10 | Rake €0 
Seat 1: Gamz11 folded before Flop (didn't bet)
Seat 2: stds st folded before Flop (didn't bet)
Seat 3: RoadtoNepal (button) folded before Flop
Seat 4: Fish4trips (small blind) collected (€10)
Seat 5: vr188 (big blind) folded before Flop
Seat 7: PacPacBum folded before Flop (didn't bet)
Seat 8: matiko09 folded before Flop (didn't bet)
Seat 9: ki11u folded before Flop (didn't bet)





PokerStars Hand #150126589345:  Hold'em No Limit ($0.50/$1.00 USD) - 2016/03/10 13:42:59 CET [2016/03/10 7:42:59 ET]
Table 'Mars III' 9-max Seat #4 is the button
Seat 1: blackw0lf_03 ($139.26 in chips) 
Seat 3: PacPacBum ($108.98 in chips) 
Seat 4: ki11u ($102.73 in chips) 
Seat 5: Slash3r ($73.41 in chips) 
Seat 6: matiko09 ($100 in chips) 
Seat 7: Sweden_Pound ($106.50 in chips) 
Seat 8: Filojoes ($106.89 in chips) 
Seat 9: flk.Dasas ($102.50 in chips) 
Slash3r: posts small blind $0.50
matiko09: posts big blind $1
*** HOLE CARDS ***
Dealt to matiko09 [Ah 7c]
Sweden_Pound: folds 
Filojoes: folds 
flk.Dasas: folds 
blackw0lf_03: folds 
PacPacBum: folds 
ki11u: folds 
Slash3r: calls $0.50
matiko09: checks 
*** FLOP *** [9d Th Jd]
Slash3r: checks 
matiko09: checks 
*** TURN *** [9d Th Jd] [Kd]
Slash3r: bets $2
matiko09: folds 
Uncalled bet ($2) returned to Slash3r
Slash3r collected $1.91 from pot
Slash3r: doesn't show hand 
*** SUMMARY ***
Total pot $2 | Rake $0.09 
Board [9d Th Jd Kd]
Seat 1: blackw0lf_03 folded before Flop (didn't bet)
Seat 3: PacPacBum folded before Flop (didn't bet)
Seat 4: ki11u (button) folded before Flop (didn't bet)
Seat 5: Slash3r (small blind) collected ($1.91)
Seat 6: matiko09 (big blind) folded on the Turn
Seat 7: Sweden_Pound folded before Flop (didn't bet)
Seat 8: Filojoes folded before Flop (didn't bet)
Seat 9: flk.Dasas folded before Flop (didn't bet)





PokerStars Hand #150126591521:  Hold'em No Limit ($0.50/$1.00 USD) - 2016/03/10 13:43:03 CET [2016/03/10 7:43:03 ET]
Table 'Liriope II' 9-max Seat #3 is the button
Seat 1: UnBent022 ($100 in chips) 
Seat 3: matiko09 ($163.01 in chips) 
Seat 4: Plz3betMe ($65.97 in chips) 
Seat 5: lumen21 ($105.18 in chips) 
Seat 6: nobu-azabu ($191.28 in chips) 
Seat 7: Sweden_Pound ($104.23 in chips) 
Seat 8: PacPacBum ($131.49 in chips) 
Plz3betMe: posts small blind $0.50
lumen21: posts big blind $1
*** HOLE CARDS ***
Dealt to matiko09 [4c 7h]
nobu-azabu: folds 
Sweden_Pound: folds 
PacPacBum: raises $1.04 to $2.04
zxp12345 leaves the table
UnBent022: folds 
matiko09: folds 
er13to joins the table at seat #2 
Plz3betMe: folds 
lumen21: folds 
Uncalled bet ($1.04) returned to PacPacBum
PacPacBum collected $2.50 from pot
PacPacBum: doesn't show hand 
*** SUMMARY ***
Total pot $2.50 | Rake $0 
Seat 1: UnBent022 folded before Flop (didn't bet)
Seat 3: matiko09 (button) folded before Flop (didn't bet)
Seat 4: Plz3betMe (small blind) folded before Flop
Seat 5: lumen21 (big blind) folded before Flop
Seat 6: nobu-azabu folded before Flop (didn't bet)
Seat 7: Sweden_Pound folded before Flop (didn't bet)
Seat 8: PacPacBum collected ($2.50)





PokerStars Hand #150126591728:  Hold'em No Limit ($0.25/$0.50 USD) - 2016/03/10 13:43:03 CET [2016/03/10 7:43:03 ET]
Table 'Aegina' 9-max Seat #6 is the button
Seat 1: BingoIng0 ($118.69 in chips) 
Seat 3: MyMilkCans=D ($125 in chips) 
Seat 4: digimatical ($70.02 in chips) 
Seat 5: Ahangama ($50 in chips) 
Seat 6: matiko09 ($53.34 in chips) 
Seat 7: Gummio ($123.62 in chips) 
Seat 8: ardo888 ($178.79 in chips) 
Seat 9: draken08 ($126.35 in chips) 
Gummio: posts small blind $0.25
ardo888: posts big blind $0.50
Spid1: sits out 
BingoIng0: posts the ante $0.10
MyMilkCans=D: posts the ante $0.10
digimatical: posts the ante $0.10
Ahangama: posts the ante $0.10
matiko09: posts the ante $0.10
Gummio: posts the ante $0.10
ardo888: posts the ante $0.10
draken08: posts the ante $0.10
*** HOLE CARDS ***
Dealt to matiko09 [3s 9d]
draken08: folds 
BingoIng0: folds 
MyMilkCans=D: folds 
digimatical: calls $0.50
Ahangama: raises $1.50 to $2
matiko09: folds 
Gummio: folds 
ardo888: folds 
digimatical: folds 
Uncalled bet ($1.50) returned to Ahangama
Ahangama collected $2.55 from pot
Ahangama: doesn't show hand 
*** SUMMARY ***
Total pot $2.55 | Rake $0 
Seat 1: BingoIng0 folded before Flop (didn't bet)
Seat 3: MyMilkCans=D folded before Flop (didn't bet)
Seat 4: digimatical folded before Flop
Seat 5: Ahangama collected ($2.55)
Seat 6: matiko09 (button) folded before Flop (didn't bet)
Seat 7: Gummio (small blind) folded before Flop
Seat 8: ardo888 (big blind) folded before Flop
Seat 9: draken08 folded before Flop (didn't bet)





PokerStars Hand #150126601220:  Hold'em No Limit ($0.50/$1.00 USD) - 2016/03/10 13:43:21 CET [2016/03/10 7:43:21 ET]
Table 'Leuschneria II' 9-max Seat #6 is the button
Seat 1: SHARKFIN168 ($105.78 in chips) 
Seat 2: blackw0lf_03 ($100 in chips) 
Seat 3: Spid1 ($101.50 in chips) 
Seat 4: Sweden_Pound ($133.72 in chips) 
Seat 5: RMilPoker ($220.54 in chips) 
Seat 6: matiko09 ($113.11 in chips) 
Seat 7: Plz3betMe ($40 in chips) 
Seat 8: UnBent022 ($101.46 in chips) 
Seat 9: ki11u ($100 in chips) 
Plz3betMe: posts small blind $0.50
UnBent022: posts big blind $1
*** HOLE CARDS ***
Dealt to matiko09 [4c Qd]
ki11u: folds 
SHARKFIN168: raises $1 to $2
blackw0lf_03: folds 
Spid1: folds 
Sweden_Pound: folds 
RMilPoker: folds 
matiko09: folds 
Plz3betMe: folds 
UnBent022: calls $1
*** FLOP *** [6h Th 4d]
UnBent022: checks 
SHARKFIN168: checks 
*** TURN *** [6h Th 4d] [Tc]
UnBent022: checks 
SHARKFIN168: checks 
*** RIVER *** [6h Th 4d Tc] [Qc]
UnBent022: checks 
SHARKFIN168: checks 
*** SHOW DOWN ***
UnBent022: shows [9d 7d] (a pair of Tens)
SHARKFIN168: shows [Jc Ks] (a pair of Tens - King kicker)
SHARKFIN168 collected $4.30 from pot
*** SUMMARY ***
Total pot $4.50 | Rake $0.20 
Board [6h Th 4d Tc Qc]
Seat 1: SHARKFIN168 showed [Jc Ks] and won ($4.30) with a pair of Tens
Seat 2: blackw0lf_03 folded before Flop (didn't bet)
Seat 3: Spid1 folded before Flop (didn't bet)
Seat 4: Sweden_Pound folded before Flop (didn't bet)
Seat 5: RMilPoker folded before Flop (didn't bet)
Seat 6: matiko09 (button) folded before Flop (didn't bet)
Seat 7: Plz3betMe (small blind) folded before Flop
Seat 8: UnBent022 (big blind) showed [9d 7d] and lost with a pair of Tens
Seat 9: ki11u folded before Flop (didn't bet)





PokerStars Hand #150126604916:  Hold'em No Limit ($1/$2 USD) - 2016/03/10 13:43:27 CET [2016/03/10 7:43:27 ET]
Table 'Chandra II' 9-max Seat #8 is the button
Seat 1: Fish4trips ($300.44 in chips) 
Seat 2: PacPacBum ($234.51 in chips) 
Seat 3: ROLLO 888 ($249.82 in chips) 
Seat 4: tipner ($200 in chips) 
Seat 6: stds st ($75.31 in chips) 
Seat 7: johnvu2016 ($141.25 in chips) 
Seat 8: matiko09 ($270.99 in chips) 
Seat 9: o.miro ($287.27 in chips) 
o.miro: posts small blind $1
Fish4trips: posts big blind $2
*** HOLE CARDS ***
Dealt to matiko09 [Th 4h]
PacPacBum: folds 
ROLLO 888: folds 
tipner: raises $4 to $6
stds st: folds 
johnvu2016: folds 
matiko09: folds 
o.miro: folds 
Fish4trips: folds 
Uncalled bet ($4) returned to tipner
tipner collected $5 from pot
tipner: doesn't show hand 
*** SUMMARY ***
Total pot $5 | Rake $0 
Seat 1: Fish4trips (big blind) folded before Flop
Seat 2: PacPacBum folded before Flop (didn't bet)
Seat 3: ROLLO 888 folded before Flop (didn't bet)
Seat 4: tipner collected ($5)
Seat 6: stds st folded before Flop (didn't bet)
Seat 7: johnvu2016 folded before Flop (didn't bet)
Seat 8: matiko09 (button) folded before Flop (didn't bet)
Seat 9: o.miro (small blind) folded before Flop





PokerStars Hand #150126609203:  Hold'em No Limit ($0.50/$1.00 USD) - 2016/03/10 13:43:35 CET [2016/03/10 7:43:35 ET]
Table 'Liriope II' 9-max Seat #4 is the button
Seat 1: UnBent022 ($100 in chips) 
Seat 3: matiko09 ($163.01 in chips) 
Seat 4: Plz3betMe ($65.47 in chips) 
Seat 5: lumen21 ($104.18 in chips) 
Seat 6: nobu-azabu ($191.28 in chips) 
Seat 7: Sweden_Pound ($104.23 in chips) 
Seat 8: PacPacBum ($132.99 in chips) 
lumen21: posts small blind $0.50
nobu-azabu: posts big blind $1
er13to: sits out 
*** HOLE CARDS ***
Dealt to matiko09 [7s 7h]
Sweden_Pound: folds 
PacPacBum: folds 
UnBent022: folds 
matiko09: raises $1.50 to $2.50
Plz3betMe: folds 
lumen21: raises $6.50 to $9
nobu-azabu: folds 
matiko09: calls $6.50
*** FLOP *** [Qh Js 8h]
lumen21: checks 
matiko09: checks 
*** TURN *** [Qh Js 8h] [Tc]
lumen21: checks 
matiko09: checks 
*** RIVER *** [Qh Js 8h Tc] [6c]
lumen21: checks 
matiko09: checks 
*** SHOW DOWN ***
lumen21: shows [Kc Qc] (a pair of Queens)
matiko09: mucks hand 
lumen21 collected $18.14 from pot
*** SUMMARY ***
Total pot $19 | Rake $0.86 
Board [Qh Js 8h Tc 6c]
Seat 1: UnBent022 folded before Flop (didn't bet)
Seat 3: matiko09 mucked [7s 7h]
Seat 4: Plz3betMe (button) folded before Flop (didn't bet)
Seat 5: lumen21 (small blind) showed [Kc Qc] and won ($18.14) with a pair of Queens
Seat 6: nobu-azabu (big blind) folded before Flop
Seat 7: Sweden_Pound folded before Flop (didn't bet)
Seat 8: PacPacBum folded before Flop (didn't bet)





PokerStars Hand #150126610137:  Hold'em No Limit ($0.50/$1.00 USD) - 2016/03/10 13:43:37 CET [2016/03/10 7:43:37 ET]
Table 'Iguassu' 9-max Seat #6 is the button
Seat 1: blackw0lf_03 ($100 in chips) 
Seat 2: Rocky6434 ($54.11 in chips) 
Seat 3: hammerwife ($123.43 in chips) 
Seat 4: matiko09 ($100 in chips) 
Seat 5: UnBent022 ($101.50 in chips) 
Seat 6: Igor DoUrden ($117.08 in chips) 
Seat 7: PacPacBum ($119.05 in chips) 
Seat 8: Filojoes ($126.82 in chips) 
Seat 9: er13to ($100 in chips) 
PacPacBum: posts small blind $0.50
Filojoes: posts big blind $1
*** HOLE CARDS ***
Dealt to matiko09 [Th 7d]
er13to: folds 
blackw0lf_03: folds 
Rocky6434: folds 
hammerwife: folds 
matiko09: folds 
UnBent022: raises $1.50 to $2.50
Igor DoUrden: folds 
PacPacBum: folds 
Filojoes: folds 
Uncalled bet ($1.50) returned to UnBent022
UnBent022 collected $2.50 from pot
*** SUMMARY ***
Total pot $2.50 | Rake $0 
Seat 1: blackw0lf_03 folded before Flop (didn't bet)
Seat 2: Rocky6434 folded before Flop (didn't bet)
Seat 3: hammerwife folded before Flop (didn't bet)
Seat 4: matiko09 folded before Flop (didn't bet)
Seat 5: UnBent022 collected ($2.50)
Seat 6: Igor DoUrden (button) folded before Flop (didn't bet)
Seat 7: PacPacBum (small blind) folded before Flop
Seat 8: Filojoes (big blind) folded before Flop
Seat 9: er13to folded before Flop (didn't bet)





PokerStars Hand #150126612291:  Hold'em No Limit ($0.50/$1.00 USD) - 2016/03/10 13:43:41 CET [2016/03/10 7:43:41 ET]
Table 'Mars III' 9-max Seat #5 is the button
Seat 1: blackw0lf_03 ($139.26 in chips) 
Seat 3: PacPacBum ($108.98 in chips) 
Seat 4: ki11u ($102.73 in chips) 
Seat 5: Slash3r ($74.32 in chips) 
Seat 6: matiko09 ($100 in chips) 
Seat 7: Sweden_Pound ($106.50 in chips) 
Seat 8: Filojoes ($106.89 in chips) 
Seat 9: flk.Dasas ($102.50 in chips) 
matiko09: posts small blind $0.50
Sweden_Pound: posts big blind $1
*** HOLE CARDS ***
Dealt to matiko09 [5c Jd]
Filojoes: folds 
pokixy800 leaves the table
Spid1 joins the table at seat #2 
flk.Dasas: folds 
blackw0lf_03: folds 
PacPacBum: folds 
ki11u: folds 
Slash3r: raises $2 to $3
matiko09: folds 
Sweden_Pound: folds 
Uncalled bet ($2) returned to Slash3r
Slash3r collected $2.50 from pot
Slash3r: doesn't show hand 
*** SUMMARY ***
Total pot $2.50 | Rake $0 
Seat 1: blackw0lf_03 folded before Flop (didn't bet)
Seat 3: PacPacBum folded before Flop (didn't bet)
Seat 4: ki11u folded before Flop (didn't bet)
Seat 5: Slash3r (button) collected ($2.50)
Seat 6: matiko09 (small blind) folded before Flop
Seat 7: Sweden_Pound (big blind) folded before Flop
Seat 8: Filojoes folded before Flop (didn't bet)
Seat 9: flk.Dasas folded before Flop (didn't bet)





PokerStars Hand #150126613338:  Hold'em No Limit ($1/$2 USD) - 2016/03/10 13:43:43 CET [2016/03/10 7:43:43 ET]
Table 'Tauris II' 9-max Seat #8 is the button
Seat 1: matiko09 ($203 in chips) 
Seat 2: stds st ($60.95 in chips) 
Seat 3: PacPacBum ($200 in chips) 
Seat 4: neomorf ($699.52 in chips) 
Seat 6: uonlylive1ce ($200 in chips) 
Seat 7: Fish4trips ($204.48 in chips) 
Seat 8: scout326 ($233.98 in chips) 
Seat 9: darren1031 ($227.01 in chips) 
darren1031: posts small blind $1
matiko09: posts big blind $2
tipner: sits out 
*** HOLE CARDS ***
Dealt to matiko09 [2c 8c]
stds st: folds 
PacPacBum: folds 
neomorf: folds 
uonlylive1ce: raises $3 to $5
Fish4trips: folds 
scout326: calls $5
darren1031: folds 
matiko09: folds 
*** FLOP *** [Qs Td Kc]
uonlylive1ce: bets $8
scout326: folds 
Uncalled bet ($8) returned to uonlylive1ce
uonlylive1ce collected $12.42 from pot
uonlylive1ce: doesn't show hand 
*** SUMMARY ***
Total pot $13 | Rake $0.58 
Board [Qs Td Kc]
Seat 1: matiko09 (big blind) folded before Flop
Seat 2: stds st folded before Flop (didn't bet)
Seat 3: PacPacBum folded before Flop (didn't bet)
Seat 4: neomorf folded before Flop (didn't bet)
Seat 6: uonlylive1ce collected ($12.42)
Seat 7: Fish4trips folded before Flop (didn't bet)
Seat 8: scout326 (button) folded on the Flop
Seat 9: darren1031 (small blind) folded before Flop





PokerStars Hand #150126614711:  Hold'em No Limit (€1/€2 EUR) - 2016/03/10 13:43:46 CET [2016/03/10 7:43:46 ET]
Table 'Sigrid II' 9-max Seat #4 is the button
Seat 1: Gamz11 (€200 in chips) 
Seat 2: stds st (€100.92 in chips) 
Seat 3: RoadtoNepal (€200 in chips) 
Seat 4: Fish4trips (€206 in chips) 
Seat 5: vr188 (€78.11 in chips) 
Seat 7: PacPacBum (€201.09 in chips) 
Seat 8: matiko09 (€209.49 in chips) 
Seat 9: ki11u (€233.72 in chips) 
vr188: posts small blind €1
PacPacBum: posts big blind €2
*** HOLE CARDS ***
Dealt to matiko09 [Qh 4h]
matiko09: folds 
ki11u: folds 
Gamz11: folds 
stds st: folds 
RoadtoNepal: folds 
Fish4trips: folds 
vr188: raises €2 to €4
PacPacBum: folds 
Uncalled bet (€2) returned to vr188
vr188 collected €4 from pot
vr188: doesn't show hand 
*** SUMMARY ***
Total pot €4 | Rake €0 
Seat 1: Gamz11 folded before Flop (didn't bet)
Seat 2: stds st folded before Flop (didn't bet)
Seat 3: RoadtoNepal folded before Flop (didn't bet)
Seat 4: Fish4trips (button) folded before Flop (didn't bet)
Seat 5: vr188 (small blind) collected (€4)
Seat 7: PacPacBum (big blind) folded before Flop
Seat 8: matiko09 folded before Flop (didn't bet)
Seat 9: ki11u folded before Flop (didn't bet)





PokerStars Hand #150126616982:  Hold'em No Limit ($0.25/$0.50 USD) - 2016/03/10 13:43:50 CET [2016/03/10 7:43:50 ET]
Table 'Aegina' 9-max Seat #7 is the button
Seat 1: BingoIng0 ($118.59 in chips) 
Seat 3: MyMilkCans=D ($125 in chips) 
Seat 4: digimatical ($69.42 in chips) 
Seat 5: Ahangama ($51.95 in chips) 
Seat 6: matiko09 ($53.24 in chips) 
Seat 7: Gummio ($123.27 in chips) 
Seat 8: ardo888 ($178.19 in chips) 
Seat 9: draken08 ($126.25 in chips) 
ardo888: posts small blind $0.25
draken08: posts big blind $0.50
Spid1: sits out 
BingoIng0: posts the ante $0.10
MyMilkCans=D: posts the ante $0.10
digimatical: posts the ante $0.10
Ahangama: posts the ante $0.10
matiko09: posts the ante $0.10
Gummio: posts the ante $0.10
ardo888: posts the ante $0.10
draken08: posts the ante $0.10
*** HOLE CARDS ***
Dealt to matiko09 [5h As]
BingoIng0: folds 
MyMilkCans=D: folds 
digimatical: calls $0.50
Ahangama: folds 
matiko09: folds 
Gummio: folds 
ardo888: folds 
draken08: checks 
*** FLOP *** [Ad 3d Jc]
draken08: checks 
digimatical: checks 
*** TURN *** [Ad 3d Jc] [8c]
draken08: checks 
digimatical: checks 
*** RIVER *** [Ad 3d Jc 8c] [7s]
draken08: checks 
digimatical: checks 
*** SHOW DOWN ***
draken08: shows [4h 6d] (high card Ace)
digimatical: shows [7h Ts] (a pair of Sevens)
digimatical collected $1.96 from pot
*** SUMMARY ***
Total pot $2.05 | Rake $0.09 
Board [Ad 3d Jc 8c 7s]
Seat 1: BingoIng0 folded before Flop (didn't bet)
Seat 3: MyMilkCans=D folded before Flop (didn't bet)
Seat 4: digimatical showed [7h Ts] and won ($1.96) with a pair of Sevens
Seat 5: Ahangama folded before Flop (didn't bet)
Seat 6: matiko09 folded before Flop (didn't bet)
Seat 7: Gummio (button) folded before Flop (didn't bet)
Seat 8: ardo888 (small blind) folded before Flop
Seat 9: draken08 (big blind) showed [4h 6d] and lost with high card Ace





PokerStars Hand #150126619379:  Hold'em No Limit ($1/$2 USD) - 2016/03/10 13:43:55 CET [2016/03/10 7:43:55 ET]
Table 'Chandra II' 9-max Seat #9 is the button
Seat 1: Fish4trips ($298.44 in chips) 
Seat 2: PacPacBum ($234.51 in chips) 
Seat 3: ROLLO 888 ($249.82 in chips) 
Seat 4: tipner ($203 in chips) 
Seat 6: stds st ($75.31 in chips) 
Seat 7: johnvu2016 ($141.25 in chips) 
Seat 8: matiko09 ($270.99 in chips) 
Seat 9: o.miro ($286.27 in chips) 
Fish4trips: posts small blind $1
PacPacBum: posts big blind $2
*** HOLE CARDS ***
Dealt to matiko09 [3h 3s]
ROLLO 888: folds 
tipner: folds 
stds st: folds 
johnvu2016: folds 
matiko09: raises $3 to $5
o.miro: folds 
Fish4trips: folds 
PacPacBum: raises $11 to $16
matiko09: folds 
Uncalled bet ($11) returned to PacPacBum
PacPacBum collected $11 from pot
PacPacBum: doesn't show hand 
*** SUMMARY ***
Total pot $11 | Rake $0 
Seat 1: Fish4trips (small blind) folded before Flop
Seat 2: PacPacBum (big blind) collected ($11)
Seat 3: ROLLO 888 folded before Flop (didn't bet)
Seat 4: tipner folded before Flop (didn't bet)
Seat 6: stds st folded before Flop (didn't bet)
Seat 7: johnvu2016 folded before Flop (didn't bet)
Seat 8: matiko09 folded before Flop
Seat 9: o.miro (button) folded before Flop (didn't bet)





PokerStars Hand #150126628135:  Hold'em No Limit ($0.50/$1.00 USD) - 2016/03/10 13:44:11 CET [2016/03/10 7:44:11 ET]
Table 'Iguassu' 9-max Seat #7 is the button
Seat 1: blackw0lf_03 ($100 in chips) 
Seat 2: Rocky6434 ($54.11 in chips) 
Seat 3: hammerwife ($123.43 in chips) 
Seat 4: matiko09 ($100 in chips) 
Seat 5: UnBent022 ($103 in chips) 
Seat 6: Igor DoUrden ($117.08 in chips) 
Seat 7: PacPacBum ($118.55 in chips) 
Seat 8: Filojoes ($125.82 in chips) 
Seat 9: er13to ($100 in chips) 
Filojoes: posts small blind $0.50
er13to: posts big blind $1
*** HOLE CARDS ***
Dealt to matiko09 [Js 2c]
blackw0lf_03: folds 
Rocky6434: folds 
hammerwife: folds 
matiko09: folds 
UnBent022: folds 
Igor DoUrden: raises $1 to $2
PacPacBum: folds 
Filojoes: folds 
er13to: raises $6 to $8
Igor DoUrden: calls $6
*** FLOP *** [4s 2h 5c]
er13to: bets $8.66
Igor DoUrden: folds 
Uncalled bet ($8.66) returned to er13to
er13to collected $15.76 from pot
*** SUMMARY ***
Total pot $16.50 | Rake $0.74 
Board [4s 2h 5c]
Seat 1: blackw0lf_03 folded before Flop (didn't bet)
Seat 2: Rocky6434 folded before Flop (didn't bet)
Seat 3: hammerwife folded before Flop (didn't bet)
Seat 4: matiko09 folded before Flop (didn't bet)
Seat 5: UnBent022 folded before Flop (didn't bet)
Seat 6: Igor DoUrden folded on the Flop
Seat 7: PacPacBum (button) folded before Flop (didn't bet)
Seat 8: Filojoes (small blind) folded before Flop
Seat 9: er13to (big blind) collected ($15.76)





PokerStars Hand #150126633454:  Hold'em No Limit (€1/€2 EUR) - 2016/03/10 13:44:21 CET [2016/03/10 7:44:21 ET]
Table 'Sigrid II' 9-max Seat #5 is the button
Seat 1: Gamz11 (€200 in chips) 
Seat 2: stds st (€100.92 in chips) 
Seat 3: RoadtoNepal (€200 in chips) 
Seat 4: Fish4trips (€206 in chips) 
Seat 5: vr188 (€80.11 in chips) 
Seat 7: PacPacBum (€200 in chips) 
Seat 8: matiko09 (€209.49 in chips) 
Seat 9: ki11u (€233.72 in chips) 
PacPacBum: posts small blind €1
matiko09: posts big blind €2
*** HOLE CARDS ***
Dealt to matiko09 [4s 4c]
ki11u: folds 
Gamz11: folds 
stds st: folds 
RoadtoNepal: folds 
Fish4trips: folds 
vr188: folds 
PacPacBum: raises €2.08 to €4.08
matiko09: calls €2.08
*** FLOP *** [3d Qs Qc]
PacPacBum: checks 
matiko09: bets €5.06
PacPacBum: folds 
Uncalled bet (€5.06) returned to matiko09
matiko09 collected €7.79 from pot
matiko09: doesn't show hand 
*** SUMMARY ***
Total pot €8.16 | Rake €0.37 
Board [3d Qs Qc]
Seat 1: Gamz11 folded before Flop (didn't bet)
Seat 2: stds st folded before Flop (didn't bet)
Seat 3: RoadtoNepal folded before Flop (didn't bet)
Seat 4: Fish4trips folded before Flop (didn't bet)
Seat 5: vr188 (button) folded before Flop (didn't bet)
Seat 7: PacPacBum (small blind) folded on the Flop
Seat 8: matiko09 (big blind) collected (€7.79)
Seat 9: ki11u folded before Flop (didn't bet)





PokerStars Hand #150126634996:  Hold'em No Limit ($0.50/$1.00 USD) - 2016/03/10 13:44:24 CET [2016/03/10 7:44:24 ET]
Table 'Mars III' 9-max Seat #6 is the button
Seat 1: blackw0lf_03 ($139.26 in chips) 
Seat 3: PacPacBum ($108.98 in chips) 
Seat 4: ki11u ($102.73 in chips) 
Seat 5: Slash3r ($75.82 in chips) 
Seat 6: matiko09 ($100 in chips) 
Seat 7: Sweden_Pound ($105.50 in chips) 
Seat 8: Filojoes ($106.89 in chips) 
Seat 9: flk.Dasas ($102.50 in chips) 
Sweden_Pound: posts small blind $0.50
Filojoes: posts big blind $1
Spid1: sits out 
*** HOLE CARDS ***
Dealt to matiko09 [9s 3c]
flk.Dasas: folds 
blackw0lf_03: folds 
PacPacBum: folds 
ki11u: folds 
Slash3r: calls $1
matiko09: folds 
Sweden_Pound: calls $0.50
Filojoes: checks 
*** FLOP *** [Th 5h Td]
Sweden_Pound: checks 
Filojoes: checks 
Slash3r: bets $3
Sweden_Pound: folds 
Filojoes: folds 
Uncalled bet ($3) returned to Slash3r
Slash3r collected $2.86 from pot
Slash3r: doesn't show hand 
*** SUMMARY ***
Total pot $3 | Rake $0.14 
Board [Th 5h Td]
Seat 1: blackw0lf_03 folded before Flop (didn't bet)
Seat 3: PacPacBum folded before Flop (didn't bet)
Seat 4: ki11u folded before Flop (didn't bet)
Seat 5: Slash3r collected ($2.86)
Seat 6: matiko09 (button) folded before Flop (didn't bet)
Seat 7: Sweden_Pound (small blind) folded on the Flop
Seat 8: Filojoes (big blind) folded on the Flop
Seat 9: flk.Dasas folded before Flop (didn't bet)





PokerStars Hand #150126638426:  Hold'em No Limit ($1/$2 USD) - 2016/03/10 13:44:30 CET [2016/03/10 7:44:30 ET]
Table 'Tauris II' 9-max Seat #9 is the button
Seat 1: matiko09 ($201 in chips) 
Seat 2: stds st ($60.95 in chips) 
Seat 3: PacPacBum ($200 in chips) 
Seat 4: neomorf ($699.52 in chips) 
Seat 6: uonlylive1ce ($207.42 in chips) 
Seat 7: Fish4trips ($204.48 in chips) 
Seat 8: scout326 ($228.98 in chips) 
Seat 9: darren1031 ($226.01 in chips) 
matiko09: posts small blind $1
stds st: posts big blind $2
tipner: sits out 
*** HOLE CARDS ***
Dealt to matiko09 [5s Ad]
PacPacBum: folds 
neomorf: folds 
uonlylive1ce: folds 
Fish4trips: folds 
scout326: raises $4 to $6
darren1031: folds 
matiko09: folds 
stds st: folds 
Uncalled bet ($4) returned to scout326
scout326 collected $5 from pot
*** SUMMARY ***
Total pot $5 | Rake $0 
Seat 1: matiko09 (small blind) folded before Flop
Seat 2: stds st (big blind) folded before Flop
Seat 3: PacPacBum folded before Flop (didn't bet)
Seat 4: neomorf folded before Flop (didn't bet)
Seat 6: uonlylive1ce folded before Flop (didn't bet)
Seat 7: Fish4trips folded before Flop (didn't bet)
Seat 8: scout326 collected ($5)
Seat 9: darren1031 (button) folded before Flop (didn't bet)





PokerStars Hand #150126639988:  Hold'em No Limit ($0.25/$0.50 USD) - 2016/03/10 13:44:33 CET [2016/03/10 7:44:33 ET]
Table 'Aegina' 9-max Seat #8 is the button
Seat 1: BingoIng0 ($118.49 in chips) 
Seat 3: MyMilkCans=D ($125 in chips) 
Seat 4: digimatical ($70.78 in chips) 
Seat 5: Ahangama ($51.85 in chips) 
Seat 6: matiko09 ($53.14 in chips) 
Seat 7: Gummio ($123.17 in chips) 
Seat 8: ardo888 ($177.84 in chips) 
Seat 9: draken08 ($125.65 in chips) 
draken08: posts small blind $0.25
BingoIng0: posts big blind $0.50
Spid1: sits out 
BingoIng0: posts the ante $0.10
MyMilkCans=D: posts the ante $0.10
digimatical: posts the ante $0.10
Ahangama: posts the ante $0.10
matiko09: posts the ante $0.10
Gummio: posts the ante $0.10
ardo888: posts the ante $0.10
draken08: posts the ante $0.10
*** HOLE CARDS ***
Dealt to matiko09 [7c As]
MyMilkCans=D: folds 
digimatical: folds 
Ahangama: folds 
matiko09: folds 
Gummio: raises $1 to $1.50
ardo888: folds 
draken08: folds 
BingoIng0: folds 
Uncalled bet ($1) returned to Gummio
Gummio collected $2.05 from pot
Gummio: doesn't show hand 
*** SUMMARY ***
Total pot $2.05 | Rake $0 
Seat 1: BingoIng0 (big blind) folded before Flop
Seat 3: MyMilkCans=D folded before Flop (didn't bet)
Seat 4: digimatical folded before Flop (didn't bet)
Seat 5: Ahangama folded before Flop (didn't bet)
Seat 6: matiko09 folded before Flop (didn't bet)
Seat 7: Gummio collected ($2.05)
Seat 8: ardo888 (button) folded before Flop (didn't bet)
Seat 9: draken08 (small blind) folded before Flop





PokerStars Hand #150126640247:  Hold'em No Limit ($1/$2 USD) - 2016/03/10 13:44:34 CET [2016/03/10 7:44:34 ET]
Table 'Chandra II' 9-max Seat #1 is the button
Seat 1: Fish4trips ($297.44 in chips) 
Seat 2: PacPacBum ($240.51 in chips) 
Seat 3: ROLLO 888 ($249.82 in chips) 
Seat 4: tipner ($203 in chips) 
Seat 5: uibting ($80.29 in chips) 
Seat 6: stds st ($75.31 in chips) 
Seat 7: johnvu2016 ($141.25 in chips) 
Seat 8: matiko09 ($265.99 in chips) 
Seat 9: o.miro ($286.27 in chips) 
PacPacBum: posts small blind $1
ROLLO 888: posts big blind $2
*** HOLE CARDS ***
Dealt to matiko09 [7s Jd]
tipner: folds 
uibting: folds 
stds st: folds 
johnvu2016: folds 
matiko09: folds 
o.miro: raises $3 to $5
Fish4trips: folds 
PacPacBum: folds 
ROLLO 888: calls $3
*** FLOP *** [8c 2s 8d]
ROLLO 888: bets $8
o.miro: calls $8
*** TURN *** [8c 2s 8d] [8h]
ROLLO 888: bets $8
o.miro: calls $8
*** RIVER *** [8c 2s 8d 8h] [6h]
ROLLO 888: bets $10
o.miro: calls $10
*** SHOW DOWN ***
ROLLO 888: shows [9s Qc] (three of a kind, Eights)
o.miro: shows [Qd Ac] (three of a kind, Eights - Ace kicker)
o.miro collected $60.20 from pot
*** SUMMARY ***
Total pot $63 | Rake $2.80 
Board [8c 2s 8d 8h 6h]
Seat 1: Fish4trips (button) folded before Flop (didn't bet)
Seat 2: PacPacBum (small blind) folded before Flop
Seat 3: ROLLO 888 (big blind) showed [9s Qc] and lost with three of a kind, Eights
Seat 4: tipner folded before Flop (didn't bet)
Seat 5: uibting folded before Flop (didn't bet)
Seat 6: stds st folded before Flop (didn't bet)
Seat 7: johnvu2016 folded before Flop (didn't bet)
Seat 8: matiko09 folded before Flop (didn't bet)
Seat 9: o.miro showed [Qd Ac] and won ($60.20) with three of a kind, Eights





PokerStars Hand #150126642453:  Hold'em No Limit ($0.50/$1.00 USD) - 2016/03/10 13:44:38 CET [2016/03/10 7:44:38 ET]
Table 'Leuschneria II' 9-max Seat #7 is the button
Seat 1: SHARKFIN168 ($108.08 in chips) 
Seat 2: blackw0lf_03 ($100 in chips) 
Seat 3: Spid1 ($101.50 in chips) 
Seat 4: Sweden_Pound ($133.72 in chips) 
Seat 5: RMilPoker ($220.54 in chips) 
Seat 6: matiko09 ($113.11 in chips) 
Seat 7: Plz3betMe ($39.50 in chips) 
Seat 8: UnBent022 ($100 in chips) 
Seat 9: ki11u ($100 in chips) 
UnBent022: posts small blind $0.50
ki11u: posts big blind $1
*** HOLE CARDS ***
Dealt to matiko09 [Ks Th]
SHARKFIN168: folds 
blackw0lf_03: folds 
Spid1: folds 
Sweden_Pound: folds 
RMilPoker: folds 
matiko09: raises $1.50 to $2.50
Plz3betMe: folds 
UnBent022: folds 
ki11u: folds 
Uncalled bet ($1.50) returned to matiko09
matiko09 collected $2.50 from pot
matiko09: doesn't show hand 
*** SUMMARY ***
Total pot $2.50 | Rake $0 
Seat 1: SHARKFIN168 folded before Flop (didn't bet)
Seat 2: blackw0lf_03 folded before Flop (didn't bet)
Seat 3: Spid1 folded before Flop (didn't bet)
Seat 4: Sweden_Pound folded before Flop (didn't bet)
Seat 5: RMilPoker folded before Flop (didn't bet)
Seat 6: matiko09 collected ($2.50)
Seat 7: Plz3betMe (button) folded before Flop (didn't bet)
Seat 8: UnBent022 (small blind) folded before Flop
Seat 9: ki11u (big blind) folded before Flop





PokerStars Hand #150126654284:  Hold'em No Limit (€1/€2 EUR) - 2016/03/10 13:45:00 CET [2016/03/10 7:45:00 ET]
Table 'Sigrid II' 9-max Seat #7 is the button
Seat 1: Gamz11 (€200 in chips) 
Seat 2: stds st (€100.92 in chips) 
Seat 3: RoadtoNepal (€200 in chips) 
Seat 4: Fish4trips (€206 in chips) 
Seat 5: vr188 (€80.11 in chips) 
Seat 7: PacPacBum (€200 in chips) 
Seat 8: matiko09 (€213.20 in chips) 
Seat 9: ki11u (€233.72 in chips) 
matiko09: posts small blind €1
ki11u: posts big blind €2
*** HOLE CARDS ***
Dealt to matiko09 [Tc Th]
Gamz11: folds 
stds st: raises €2.04 to €4.04
RoadtoNepal: folds 
Fish4trips: folds 
vr188: folds 
PacPacBum: folds 
matiko09: calls €3.04
ki11u: folds 
*** FLOP *** [Jd 5d 4d]
matiko09: checks 
stds st: checks 
*** TURN *** [Jd 5d 4d] [3d]
matiko09: checks 
stds st: bets €6.35
matiko09: folds 
Uncalled bet (€6.35) returned to stds st
stds st collected €9.63 from pot
stds st: doesn't show hand 
*** SUMMARY ***
Total pot €10.08 | Rake €0.45 
Board [Jd 5d 4d 3d]
Seat 1: Gamz11 folded before Flop (didn't bet)
Seat 2: stds st collected (€9.63)
Seat 3: RoadtoNepal folded before Flop (didn't bet)
Seat 4: Fish4trips folded before Flop (didn't bet)
Seat 5: vr188 folded before Flop (didn't bet)
Seat 7: PacPacBum (button) folded before Flop (didn't bet)
Seat 8: matiko09 (small blind) folded on the Turn
Seat 9: ki11u (big blind) folded before Flop





PokerStars Hand #150126654211:  Hold'em No Limit ($1/$2 USD) - 2016/03/10 13:45:00 CET [2016/03/10 7:45:00 ET]
Table 'Tauris II' 9-max Seat #1 is the button
Seat 1: matiko09 ($200 in chips) 
Seat 2: stds st ($58.95 in chips) 
Seat 3: PacPacBum ($200 in chips) 
Seat 4: neomorf ($699.52 in chips) 
Seat 6: uonlylive1ce ($207.42 in chips) 
Seat 7: Fish4trips ($204.48 in chips) 
Seat 8: scout326 ($231.98 in chips) 
Seat 9: darren1031 ($226.01 in chips) 
stds st: posts small blind $1
PacPacBum: posts big blind $2
tipner: sits out 
*** HOLE CARDS ***
Dealt to matiko09 [2d 3d]
neomorf: folds 
uonlylive1ce: folds 
Fish4trips: folds 
scout326: folds 
darren1031: folds 
matiko09: folds 
stds st: raises $2.04 to $4.04
PacPacBum: folds 
Uncalled bet ($2.04) returned to stds st
stds st collected $4 from pot
stds st: doesn't show hand 
*** SUMMARY ***
Total pot $4 | Rake $0 
Seat 1: matiko09 (button) folded before Flop (didn't bet)
Seat 2: stds st (small blind) collected ($4)
Seat 3: PacPacBum (big blind) folded before Flop
Seat 4: neomorf folded before Flop (didn't bet)
Seat 6: uonlylive1ce folded before Flop (didn't bet)
Seat 7: Fish4trips folded before Flop (didn't bet)
Seat 8: scout326 folded before Flop (didn't bet)
Seat 9: darren1031 folded before Flop (didn't bet)





PokerStars Hand #150126655146:  Hold'em No Limit ($0.25/$0.50 USD) - 2016/03/10 13:45:01 CET [2016/03/10 7:45:01 ET]
Table 'Aegina' 9-max Seat #9 is the button
Seat 1: BingoIng0 ($117.89 in chips) 
Seat 2: Spid1 ($100 in chips) 
Seat 3: MyMilkCans=D ($125 in chips) 
Seat 4: digimatical ($70.68 in chips) 
Seat 5: Ahangama ($51.75 in chips) 
Seat 6: matiko09 ($53.04 in chips) 
Seat 7: Gummio ($124.62 in chips) 
Seat 8: ardo888 ($177.74 in chips) 
Seat 9: draken08 ($125.30 in chips) 
BingoIng0: posts small blind $0.25
Spid1: posts big blind $0.50
BingoIng0: posts the ante $0.10
Spid1: posts the ante $0.10
MyMilkCans=D: posts the ante $0.10
digimatical: posts the ante $0.10
Ahangama: posts the ante $0.10
matiko09: posts the ante $0.10
Gummio: posts the ante $0.10
ardo888: posts the ante $0.10
draken08: posts the ante $0.10
*** HOLE CARDS ***
Dealt to matiko09 [7h 7d]
MyMilkCans=D: folds 
digimatical: calls $0.50
Ahangama: calls $0.50
matiko09: raises $2.50 to $3
Gummio: calls $3
ardo888: folds 
draken08: folds 
BingoIng0: folds 
Spid1: folds 
digimatical: folds 
Ahangama: folds 
*** FLOP *** [3h 6d 5c]
matiko09: bets $4.50
Gummio: calls $4.50
*** TURN *** [3h 6d 5c] [8d]
matiko09: checks 
Gummio: bets $8.43
matiko09: calls $8.43
*** RIVER *** [3h 6d 5c 8d] [Qs]
matiko09: checks 
Gummio: checks 
*** SHOW DOWN ***
matiko09: shows [7h 7d] (a pair of Sevens)
Gummio: mucks hand 
matiko09 collected $32.96 from pot
*** SUMMARY ***
Total pot $34.51 | Rake $1.55 
Board [3h 6d 5c 8d Qs]
Seat 1: BingoIng0 (small blind) folded before Flop
Seat 2: Spid1 (big blind) folded before Flop
Seat 3: MyMilkCans=D folded before Flop (didn't bet)
Seat 4: digimatical folded before Flop
Seat 5: Ahangama folded before Flop
Seat 6: matiko09 showed [7h 7d] and won ($32.96) with a pair of Sevens
Seat 7: Gummio mucked [Ac 6c]
Seat 8: ardo888 folded before Flop (didn't bet)
Seat 9: draken08 (button) folded before Flop (didn't bet)





PokerStars Hand #150126659019:  Hold'em No Limit ($0.50/$1.00 USD) - 2016/03/10 13:45:09 CET [2016/03/10 7:45:09 ET]
Table 'Leuschneria II' 9-max Seat #8 is the button
Seat 1: SHARKFIN168 ($108.08 in chips) 
Seat 2: blackw0lf_03 ($100 in chips) 
Seat 3: Spid1 ($101.50 in chips) 
Seat 4: Sweden_Pound ($133.72 in chips) 
Seat 5: RMilPoker ($220.54 in chips) 
Seat 6: matiko09 ($114.61 in chips) 
Seat 7: Plz3betMe ($39.50 in chips) 
Seat 8: UnBent022 ($100 in chips) 
Seat 9: ki11u ($100 in chips) 
ki11u: posts small blind $0.50
SHARKFIN168: posts big blind $1
*** HOLE CARDS ***
Dealt to matiko09 [4d Ac]
blackw0lf_03: folds 
Spid1: folds 
Sweden_Pound: folds 
RMilPoker: folds 
matiko09: folds 
Plz3betMe: folds 
UnBent022: raises $1 to $2
ki11u: folds 
SHARKFIN168: folds 
Uncalled bet ($1) returned to UnBent022
UnBent022 collected $2.50 from pot
UnBent022: doesn't show hand 
*** SUMMARY ***
Total pot $2.50 | Rake $0 
Seat 1: SHARKFIN168 (big blind) folded before Flop
Seat 2: blackw0lf_03 folded before Flop (didn't bet)
Seat 3: Spid1 folded before Flop (didn't bet)
Seat 4: Sweden_Pound folded before Flop (didn't bet)
Seat 5: RMilPoker folded before Flop (didn't bet)
Seat 6: matiko09 folded before Flop (didn't bet)
Seat 7: Plz3betMe folded before Flop (didn't bet)
Seat 8: UnBent022 (button) collected ($2.50)
Seat 9: ki11u (small blind) folded before Flop





PokerStars Hand #150126660211:  Hold'em No Limit ($0.50/$1.00 USD) - 2016/03/10 13:45:11 CET [2016/03/10 7:45:11 ET]
Table 'Liriope II' 9-max Seat #5 is the button
Seat 1: UnBent022 ($100 in chips) 
Seat 3: matiko09 ($154.01 in chips) 
Seat 4: Plz3betMe ($65.47 in chips) 
Seat 5: lumen21 ($113.32 in chips) 
Seat 6: nobu-azabu ($190.28 in chips) 
Seat 7: Sweden_Pound ($104.23 in chips) 
Seat 8: PacPacBum ($132.99 in chips) 
nobu-azabu: posts small blind $0.50
Sweden_Pound: posts big blind $1
er13to: sits out 
*** HOLE CARDS ***
Dealt to matiko09 [Js 8c]
PacPacBum: raises $1.04 to $2.04
UnBent022: folds 
matiko09: folds 
Plz3betMe: folds 
lumen21: calls $2.04
nobu-azabu: folds 
Sweden_Pound: folds 
*** FLOP *** [4h 4c As]
PacPacBum: checks 
lumen21: checks 
*** TURN *** [4h 4c As] [Kc]
PacPacBum: checks 
lumen21: checks 
*** RIVER *** [4h 4c As Kc] [3h]
PacPacBum: bets $2.87
lumen21: folds 
Uncalled bet ($2.87) returned to PacPacBum
PacPacBum collected $5.33 from pot
PacPacBum: doesn't show hand 
*** SUMMARY ***
Total pot $5.58 | Rake $0.25 
Board [4h 4c As Kc 3h]
Seat 1: UnBent022 folded before Flop (didn't bet)
Seat 3: matiko09 folded before Flop (didn't bet)
Seat 4: Plz3betMe folded before Flop (didn't bet)
Seat 5: lumen21 (button) folded on the River
Seat 6: nobu-azabu (small blind) folded before Flop
Seat 7: Sweden_Pound (big blind) folded before Flop
Seat 8: PacPacBum collected ($5.33)





PokerStars Hand #150126661591:  Hold'em No Limit ($0.50/$1.00 USD) - 2016/03/10 13:45:14 CET [2016/03/10 7:45:14 ET]
Table 'Iguassu' 9-max Seat #8 is the button
Seat 1: blackw0lf_03 ($100 in chips) 
Seat 2: Rocky6434 ($54.11 in chips) 
Seat 3: hammerwife ($123.43 in chips) 
Seat 4: matiko09 ($100 in chips) 
Seat 5: UnBent022 ($103 in chips) 
Seat 6: Igor DoUrden ($109.08 in chips) 
Seat 7: PacPacBum ($118.55 in chips) 
Seat 8: Filojoes ($125.32 in chips) 
Seat 9: er13to ($107.76 in chips) 
er13to: posts small blind $0.50
blackw0lf_03: posts big blind $1
*** HOLE CARDS ***
Dealt to matiko09 [7d 8h]
Rocky6434: folds 
hammerwife: folds 
matiko09: folds 
UnBent022: folds 
Igor DoUrden: raises $1 to $2
PacPacBum: folds 
Filojoes: folds 
er13to: folds 
blackw0lf_03: folds 
Uncalled bet ($1) returned to Igor DoUrden
Igor DoUrden collected $2.50 from pot
Igor DoUrden: doesn't show hand 
*** SUMMARY ***
Total pot $2.50 | Rake $0 
Seat 1: blackw0lf_03 (big blind) folded before Flop
Seat 2: Rocky6434 folded before Flop (didn't bet)
Seat 3: hammerwife folded before Flop (didn't bet)
Seat 4: matiko09 folded before Flop (didn't bet)
Seat 5: UnBent022 folded before Flop (didn't bet)
Seat 6: Igor DoUrden collected ($2.50)
Seat 7: PacPacBum folded before Flop (didn't bet)
Seat 8: Filojoes (button) folded before Flop (didn't bet)
Seat 9: er13to (small blind) folded before Flop





PokerStars Hand #150126669354:  Hold'em No Limit ($1/$2 USD) - 2016/03/10 13:45:28 CET [2016/03/10 7:45:28 ET]
Table 'Tauris II' 9-max Seat #2 is the button
Seat 1: matiko09 ($200 in chips) 
Seat 2: stds st ($60.95 in chips) 
Seat 3: PacPacBum ($200 in chips) 
Seat 4: neomorf ($699.52 in chips) 
Seat 6: uonlylive1ce ($207.42 in chips) 
Seat 7: Fish4trips ($204.48 in chips) 
Seat 8: scout326 ($231.98 in chips) 
Seat 9: darren1031 ($226.01 in chips) 
PacPacBum: posts small blind $1
neomorf: posts big blind $2
tipner: sits out 
*** HOLE CARDS ***
Dealt to matiko09 [Th Ks]
uonlylive1ce: folds 
Fish4trips: folds 
scout326: raises $4 to $6
darren1031: folds 
matiko09: folds 
stds st: folds 
PacPacBum: raises $12 to $18
neomorf: raises $22 to $40
scout326: calls $34
PacPacBum: raises $160 to $200 and is all-in
neomorf: folds 
scout326: folds 
Uncalled bet ($160) returned to PacPacBum
PacPacBum collected $120 from pot
PacPacBum: doesn't show hand 
*** SUMMARY ***
Total pot $120 | Rake $0 
Seat 1: matiko09 folded before Flop (didn't bet)
Seat 2: stds st (button) folded before Flop (didn't bet)
Seat 3: PacPacBum (small blind) collected ($120)
Seat 4: neomorf (big blind) folded before Flop
Seat 6: uonlylive1ce folded before Flop (didn't bet)
Seat 7: Fish4trips folded before Flop (didn't bet)
Seat 8: scout326 folded before Flop
Seat 9: darren1031 folded before Flop (didn't bet)





PokerStars Hand #150126669815:  Hold'em No Limit ($0.50/$1.00 USD) - 2016/03/10 13:45:29 CET [2016/03/10 7:45:29 ET]
Table 'Opik' 9-max Seat #3 is the button
Seat 1: ilaviiitech ($100 in chips) 
Seat 2: tipner ($101 in chips) 
Seat 3: Sweden_Pound ($110.96 in chips) 
Seat 4: white huck ($59 in chips) 
Seat 5: matiko09 ($100 in chips) 
Seat 6: weise1988 ($58.26 in chips) 
Seat 8: Igor DoUrden ($104.62 in chips) 
Seat 9: Spid1 ($100 in chips) 
white huck: posts small blind $0.50
matiko09: posts big blind $1
PacPacBum: sits out 
*** HOLE CARDS ***
Dealt to matiko09 [7c Kh]
weise1988: calls $1
Igor DoUrden: folds 
Spid1: folds 
ilaviiitech: folds 
tipner: folds 
Sweden_Pound: folds 
white huck: folds 
matiko09: checks 
*** FLOP *** [8d Kc 7d]
matiko09: bets $2
weise1988: calls $2
*** TURN *** [8d Kc 7d] [8c]
matiko09: bets $4
weise1988: calls $4
*** RIVER *** [8d Kc 7d 8c] [2h]
matiko09: checks 
weise1988: checks 
*** SHOW DOWN ***
matiko09: shows [7c Kh] (two pair, Kings and Eights)
weise1988: mucks hand 
matiko09 collected $13.85 from pot
*** SUMMARY ***
Total pot $14.50 | Rake $0.65 
Board [8d Kc 7d 8c 2h]
Seat 1: ilaviiitech folded before Flop (didn't bet)
Seat 2: tipner folded before Flop (didn't bet)
Seat 3: Sweden_Pound (button) folded before Flop (didn't bet)
Seat 4: white huck (small blind) folded before Flop
Seat 5: matiko09 (big blind) showed [7c Kh] and won ($13.85) with two pair, Kings and Eights
Seat 6: weise1988 mucked [7h 6c]
Seat 8: Igor DoUrden folded before Flop (didn't bet)
Seat 9: Spid1 folded before Flop (didn't bet)





PokerStars Hand #150126676001:  Hold'em No Limit ($0.50/$1.00 USD) - 2016/03/10 13:45:40 CET [2016/03/10 7:45:40 ET]
Table 'Leuschneria II' 9-max Seat #9 is the button
Seat 1: SHARKFIN168 ($107.08 in chips) 
Seat 2: blackw0lf_03 ($100 in chips) 
Seat 3: Spid1 ($101.50 in chips) 
Seat 4: Sweden_Pound ($133.72 in chips) 
Seat 5: RMilPoker ($220.54 in chips) 
Seat 6: matiko09 ($114.61 in chips) 
Seat 7: Plz3betMe ($39.50 in chips) 
Seat 8: UnBent022 ($101.50 in chips) 
Seat 9: ki11u ($100 in chips) 
SHARKFIN168: posts small blind $0.50
blackw0lf_03: posts big blind $1
*** HOLE CARDS ***
Dealt to matiko09 [4d Jc]
Spid1: folds 
Sweden_Pound: folds 
RMilPoker: folds 
matiko09: folds 
Plz3betMe: folds 
UnBent022: raises $1.50 to $2.50
ki11u: folds 
SHARKFIN168: folds 
blackw0lf_03: folds 
Uncalled bet ($1.50) returned to UnBent022
UnBent022 collected $2.50 from pot
UnBent022: doesn't show hand 
*** SUMMARY ***
Total pot $2.50 | Rake $0 
Seat 1: SHARKFIN168 (small blind) folded before Flop
Seat 2: blackw0lf_03 (big blind) folded before Flop
Seat 3: Spid1 folded before Flop (didn't bet)
Seat 4: Sweden_Pound folded before Flop (didn't bet)
Seat 5: RMilPoker folded before Flop (didn't bet)
Seat 6: matiko09 folded before Flop (didn't bet)
Seat 7: Plz3betMe folded before Flop (didn't bet)
Seat 8: UnBent022 collected ($2.50)
Seat 9: ki11u (button) folded before Flop (didn't bet)





PokerStars Hand #150126675489:  Hold'em No Limit ($1/$2 USD) - 2016/03/10 13:45:40 CET [2016/03/10 7:45:40 ET]
Table 'Chandra II' 9-max Seat #2 is the button
Seat 1: Fish4trips ($297.44 in chips) 
Seat 2: PacPacBum ($239.51 in chips) 
Seat 3: ROLLO 888 ($218.82 in chips) 
Seat 4: tipner ($203 in chips) 
Seat 5: uibting ($80.29 in chips) 
Seat 6: stds st ($75.31 in chips) 
Seat 7: johnvu2016 ($141.25 in chips) 
Seat 8: matiko09 ($265.99 in chips) 
Seat 9: o.miro ($315.47 in chips) 
ROLLO 888: posts small blind $1
tipner: posts big blind $2
*** HOLE CARDS ***
Dealt to matiko09 [9d Kc]
uibting: folds 
stds st: folds 
johnvu2016: folds 
matiko09: folds 
o.miro: folds 
Fish4trips: folds 
PacPacBum: folds 
ROLLO 888: calls $1
tipner: raises $6 to $8
ROLLO 888: folds 
Uncalled bet ($6) returned to tipner
tipner collected $4 from pot
tipner: doesn't show hand 
*** SUMMARY ***
Total pot $4 | Rake $0 
Seat 1: Fish4trips folded before Flop (didn't bet)
Seat 2: PacPacBum (button) folded before Flop (didn't bet)
Seat 3: ROLLO 888 (small blind) folded before Flop
Seat 4: tipner (big blind) collected ($4)
Seat 5: uibting folded before Flop (didn't bet)
Seat 6: stds st folded before Flop (didn't bet)
Seat 7: johnvu2016 folded before Flop (didn't bet)
Seat 8: matiko09 folded before Flop (didn't bet)
Seat 9: o.miro folded before Flop (didn't bet)





PokerStars Hand #150126680514:  Hold'em No Limit ($0.50/$1.00 USD) - 2016/03/10 13:45:49 CET [2016/03/10 7:45:49 ET]
Table 'Mars III' 9-max Seat #7 is the button
Seat 1: blackw0lf_03 ($139.26 in chips) 
Seat 3: PacPacBum ($108.98 in chips) 
Seat 4: ki11u ($102.73 in chips) 
Seat 5: Slash3r ($77.68 in chips) 
Seat 6: matiko09 ($100 in chips) 
Seat 7: Sweden_Pound ($104.50 in chips) 
Seat 8: Filojoes ($105.89 in chips) 
Seat 9: flk.Dasas ($102.50 in chips) 
Filojoes: posts small blind $0.50
flk.Dasas: posts big blind $1
Spid1: sits out 
*** HOLE CARDS ***
Dealt to matiko09 [9c Ts]
blackw0lf_03: folds 
PacPacBum: folds 
ki11u: raises $1.50 to $2.50
Slash3r: folds 
Slash3r leaves the table
matiko09: folds 
Sweden_Pound: folds 
Filojoes: folds 
flk.Dasas: folds 
Uncalled bet ($1.50) returned to ki11u
ki11u collected $2.50 from pot
ki11u: doesn't show hand 
*** SUMMARY ***
Total pot $2.50 | Rake $0 
Seat 1: blackw0lf_03 folded before Flop (didn't bet)
Seat 3: PacPacBum folded before Flop (didn't bet)
Seat 4: ki11u collected ($2.50)
Seat 5: Slash3r folded before Flop (didn't bet)
Seat 6: matiko09 folded before Flop (didn't bet)
Seat 7: Sweden_Pound (button) folded before Flop (didn't bet)
Seat 8: Filojoes (small blind) folded before Flop
Seat 9: flk.Dasas (big blind) folded before Flop





PokerStars Hand #150126685898:  Hold'em No Limit ($0.50/$1.00 USD) - 2016/03/10 13:45:59 CET [2016/03/10 7:45:59 ET]
Table 'Iguassu' 9-max Seat #9 is the button
Seat 1: blackw0lf_03 ($100 in chips) 
Seat 2: Rocky6434 ($54.11 in chips) 
Seat 3: hammerwife ($123.43 in chips) 
Seat 4: matiko09 ($100 in chips) 
Seat 5: UnBent022 ($103 in chips) 
Seat 6: Igor DoUrden ($110.58 in chips) 
Seat 7: PacPacBum ($118.55 in chips) 
Seat 8: Filojoes ($125.32 in chips) 
Seat 9: er13to ($107.26 in chips) 
blackw0lf_03: posts small blind $0.50
Rocky6434: posts big blind $1
*** HOLE CARDS ***
Dealt to matiko09 [2d Qs]
hammerwife: folds 
matiko09: folds 
UnBent022: folds 
Igor DoUrden: raises $1 to $2
PacPacBum: folds 
Filojoes: folds 
er13to: calls $2
blackw0lf_03: folds 
Rocky6434: folds 
*** FLOP *** [2c Ks 8d]
Igor DoUrden: checks 
er13to: checks 
*** TURN *** [2c Ks 8d] [Ad]
Igor DoUrden: checks 
er13to: checks 
*** RIVER *** [2c Ks 8d Ad] [Ac]
Igor DoUrden: checks 
er13to: checks 
*** SHOW DOWN ***
Igor DoUrden: shows [5s 5d] (two pair, Aces and Fives)
er13to: shows [Js 8s] (two pair, Aces and Eights)
er13to collected $5.25 from pot
*** SUMMARY ***
Total pot $5.50 | Rake $0.25 
Board [2c Ks 8d Ad Ac]
Seat 1: blackw0lf_03 (small blind) folded before Flop
Seat 2: Rocky6434 (big blind) folded before Flop
Seat 3: hammerwife folded before Flop (didn't bet)
Seat 4: matiko09 folded before Flop (didn't bet)
Seat 5: UnBent022 folded before Flop (didn't bet)
Seat 6: Igor DoUrden showed [5s 5d] and lost with two pair, Aces and Fives
Seat 7: PacPacBum folded before Flop (didn't bet)
Seat 8: Filojoes folded before Flop (didn't bet)
Seat 9: er13to (button) showed [Js 8s] and won ($5.25) with two pair, Aces and Eights





PokerStars Hand #150126691399:  Hold'em No Limit ($0.25/$0.50 USD) - 2016/03/10 13:46:09 CET [2016/03/10 7:46:09 ET]
Table 'Aegina' 9-max Seat #1 is the button
Seat 1: BingoIng0 ($117.54 in chips) 
Seat 2: Spid1 ($99.40 in chips) 
Seat 3: MyMilkCans=D ($125 in chips) 
Seat 4: digimatical ($70.08 in chips) 
Seat 5: Ahangama ($51.15 in chips) 
Seat 6: matiko09 ($69.97 in chips) 
Seat 7: Gummio ($108.59 in chips) 
Seat 8: ardo888 ($177.64 in chips) 
Seat 9: draken08 ($125.20 in chips) 
Spid1: posts small blind $0.25
MyMilkCans=D: posts big blind $0.50
BingoIng0: posts the ante $0.10
Spid1: posts the ante $0.10
MyMilkCans=D: posts the ante $0.10
digimatical: posts the ante $0.10
Ahangama: posts the ante $0.10
matiko09: posts the ante $0.10
Gummio: posts the ante $0.10
ardo888: posts the ante $0.10
draken08: posts the ante $0.10
*** HOLE CARDS ***
Dealt to matiko09 [7s 8d]
digimatical: folds 
Ahangama: folds 
matiko09: folds 
Gummio: folds 
ardo888: folds 
draken08: raises $1 to $1.50
BingoIng0: folds 
Spid1: raises $3.50 to $5
MyMilkCans=D: folds 
draken08: calls $3.50
*** FLOP *** [Td Qh 3c]
Spid1: checks 
draken08: checks 
*** TURN *** [Td Qh 3c] [Ts]
Spid1: checks 
draken08: checks 
*** RIVER *** [Td Qh 3c Ts] [Tc]
Spid1: bets $8
draken08: folds 
Uncalled bet ($8) returned to Spid1
Spid1 collected $10.89 from pot
Spid1: doesn't show hand 
*** SUMMARY ***
Total pot $11.40 | Rake $0.51 
Board [Td Qh 3c Ts Tc]
Seat 1: BingoIng0 (button) folded before Flop (didn't bet)
Seat 2: Spid1 (small blind) collected ($10.89)
Seat 3: MyMilkCans=D (big blind) folded before Flop
Seat 4: digimatical folded before Flop (didn't bet)
Seat 5: Ahangama folded before Flop (didn't bet)
Seat 6: matiko09 folded before Flop (didn't bet)
Seat 7: Gummio folded before Flop (didn't bet)
Seat 8: ardo888 folded before Flop (didn't bet)
Seat 9: draken08 folded on the River





PokerStars Hand #150126691907:  Hold'em No Limit ($0.50/$1.00 USD) - 2016/03/10 13:46:10 CET [2016/03/10 7:46:10 ET]
Table 'Liriope II' 9-max Seat #6 is the button
Seat 1: UnBent022 ($100 in chips) 
Seat 3: matiko09 ($154.01 in chips) 
Seat 4: Plz3betMe ($65.47 in chips) 
Seat 5: lumen21 ($111.28 in chips) 
Seat 6: nobu-azabu ($189.78 in chips) 
Seat 7: Sweden_Pound ($103.23 in chips) 
Seat 8: PacPacBum ($136.28 in chips) 
Sweden_Pound: posts small blind $0.50
PacPacBum: posts big blind $1
er13to: sits out 
*** HOLE CARDS ***
Dealt to matiko09 [9d Jd]
UnBent022: folds 
matiko09: raises $2 to $3
Plz3betMe: folds 
lumen21: folds 
nobu-azabu: folds 
Sweden_Pound: raises $8 to $11
PacPacBum: folds 
matiko09: folds 
Uncalled bet ($8) returned to Sweden_Pound
Sweden_Pound collected $7 from pot
Sweden_Pound: doesn't show hand 
*** SUMMARY ***
Total pot $7 | Rake $0 
Seat 1: UnBent022 folded before Flop (didn't bet)
Seat 3: matiko09 folded before Flop
Seat 4: Plz3betMe folded before Flop (didn't bet)
Seat 5: lumen21 folded before Flop (didn't bet)
Seat 6: nobu-azabu (button) folded before Flop (didn't bet)
Seat 7: Sweden_Pound (small blind) collected ($7)
Seat 8: PacPacBum (big blind) folded before Flop





PokerStars Hand #150126692811:  Hold'em No Limit ($1/$2 USD) - 2016/03/10 13:46:12 CET [2016/03/10 7:46:12 ET]
Table 'Chandra II' 9-max Seat #3 is the button
Seat 1: Fish4trips ($297.44 in chips) 
Seat 2: PacPacBum ($239.51 in chips) 
Seat 3: ROLLO 888 ($216.82 in chips) 
Seat 4: tipner ($205 in chips) 
Seat 5: uibting ($80.29 in chips) 
Seat 6: stds st ($75.31 in chips) 
Seat 7: johnvu2016 ($141.25 in chips) 
Seat 8: matiko09 ($265.99 in chips) 
Seat 9: o.miro ($315.47 in chips) 
tipner: posts small blind $1
uibting: posts big blind $2
*** HOLE CARDS ***
Dealt to matiko09 [Tc Ad]
stds st: folds 
johnvu2016: raises $4 to $6
matiko09: folds 
o.miro: folds 
Fish4trips: folds 
PacPacBum: folds 
ROLLO 888: folds 
tipner: calls $5
uibting: folds 
*** FLOP *** [Qs Ah As]
tipner: checks 
johnvu2016: checks 
*** TURN *** [Qs Ah As] [2s]
tipner: bets $8
johnvu2016: folds 
Uncalled bet ($8) returned to tipner
tipner collected $13.37 from pot
tipner: doesn't show hand 
*** SUMMARY ***
Total pot $14 | Rake $0.63 
Board [Qs Ah As 2s]
Seat 1: Fish4trips folded before Flop (didn't bet)
Seat 2: PacPacBum folded before Flop (didn't bet)
Seat 3: ROLLO 888 (button) folded before Flop (didn't bet)
Seat 4: tipner (small blind) collected ($13.37)
Seat 5: uibting (big blind) folded before Flop
Seat 6: stds st folded before Flop (didn't bet)
Seat 7: johnvu2016 folded on the Turn
Seat 8: matiko09 folded before Flop (didn't bet)
Seat 9: o.miro folded before Flop (didn't bet)





PokerStars Hand #150126699095:  Hold'em No Limit ($0.50/$1.00 USD) - 2016/03/10 13:46:23 CET [2016/03/10 7:46:23 ET]
Table 'Leuschneria II' 9-max Seat #1 is the button
Seat 1: SHARKFIN168 ($106.58 in chips) 
Seat 2: blackw0lf_03 ($100 in chips) 
Seat 3: Spid1 ($101.50 in chips) 
Seat 4: Sweden_Pound ($133.72 in chips) 
Seat 5: RMilPoker ($220.54 in chips) 
Seat 6: matiko09 ($114.61 in chips) 
Seat 7: Plz3betMe ($39.50 in chips) 
Seat 8: UnBent022 ($103 in chips) 
Seat 9: ki11u ($100 in chips) 
blackw0lf_03: posts small blind $0.50
Spid1: posts big blind $1
*** HOLE CARDS ***
Dealt to matiko09 [4h 3d]
Sweden_Pound: raises $2 to $3
RMilPoker: folds 
matiko09: folds 
Plz3betMe: folds 
UnBent022: folds 
ki11u: folds 
SHARKFIN168: folds 
blackw0lf_03: folds 
Spid1: folds 
Uncalled bet ($2) returned to Sweden_Pound
Sweden_Pound collected $2.50 from pot
Sweden_Pound: doesn't show hand 
*** SUMMARY ***
Total pot $2.50 | Rake $0 
Seat 1: SHARKFIN168 (button) folded before Flop (didn't bet)
Seat 2: blackw0lf_03 (small blind) folded before Flop
Seat 3: Spid1 (big blind) folded before Flop
Seat 4: Sweden_Pound collected ($2.50)
Seat 5: RMilPoker folded before Flop (didn't bet)
Seat 6: matiko09 folded before Flop (didn't bet)
Seat 7: Plz3betMe folded before Flop (didn't bet)
Seat 8: UnBent022 folded before Flop (didn't bet)
Seat 9: ki11u folded before Flop (didn't bet)





PokerStars Hand #150126699905:  Hold'em No Limit ($0.50/$1.00 USD) - 2016/03/10 13:46:25 CET [2016/03/10 7:46:25 ET]
Table 'Mars III' 9-max Seat #8 is the button
Seat 1: blackw0lf_03 ($139.26 in chips) 
Seat 3: PacPacBum ($108.98 in chips) 
Seat 4: ki11u ($104.23 in chips) 
Seat 6: matiko09 ($100 in chips) 
Seat 7: Sweden_Pound ($104.50 in chips) 
Seat 8: Filojoes ($105.39 in chips) 
Seat 9: flk.Dasas ($101.50 in chips) 
flk.Dasas: posts small blind $0.50
blackw0lf_03: posts big blind $1
Spid1: sits out 
*** HOLE CARDS ***
Dealt to matiko09 [Td 6d]
PacPacBum: folds 
ki11u: folds 
matiko09: folds 
Sweden_Pound: folds 
Filojoes: raises $1 to $2
flk.Dasas: folds 
blackw0lf_03: folds 
Uncalled bet ($1) returned to Filojoes
Filojoes collected $2.50 from pot
Filojoes: doesn't show hand 
*** SUMMARY ***
Total pot $2.50 | Rake $0 
Seat 1: blackw0lf_03 (big blind) folded before Flop
Seat 3: PacPacBum folded before Flop (didn't bet)
Seat 4: ki11u folded before Flop (didn't bet)
Seat 6: matiko09 folded before Flop (didn't bet)
Seat 7: Sweden_Pound folded before Flop (didn't bet)
Seat 8: Filojoes (button) collected ($2.50)
Seat 9: flk.Dasas (small blind) folded before Flop





PokerStars Hand #150126701710:  Hold'em No Limit ($0.50/$1.00 USD) - 2016/03/10 13:46:28 CET [2016/03/10 7:46:28 ET]
Table 'Opik' 9-max Seat #4 is the button
Seat 1: ilaviiitech ($100 in chips) 
Seat 2: tipner ($101 in chips) 
Seat 3: Sweden_Pound ($110.96 in chips) 
Seat 4: white huck ($58.50 in chips) 
Seat 5: matiko09 ($106.85 in chips) 
Seat 6: weise1988 ($51.26 in chips) 
Seat 8: Igor DoUrden ($104.62 in chips) 
Seat 9: Spid1 ($100 in chips) 
matiko09: posts small blind $0.50
weise1988: posts big blind $1
PacPacBum: sits out 
*** HOLE CARDS ***
Dealt to matiko09 [8d 8h]
Igor DoUrden: folds 
Spid1: raises $2 to $3
ilaviiitech: folds 
tipner: folds 
Sweden_Pound: folds 
white huck: folds 
matiko09: folds 
weise1988: folds 
Uncalled bet ($2) returned to Spid1
Spid1 collected $2.50 from pot
Spid1: doesn't show hand 
*** SUMMARY ***
Total pot $2.50 | Rake $0 
Seat 1: ilaviiitech folded before Flop (didn't bet)
Seat 2: tipner folded before Flop (didn't bet)
Seat 3: Sweden_Pound folded before Flop (didn't bet)
Seat 4: white huck (button) folded before Flop (didn't bet)
Seat 5: matiko09 (small blind) folded before Flop
Seat 6: weise1988 (big blind) folded before Flop
Seat 8: Igor DoUrden folded before Flop (didn't bet)
Seat 9: Spid1 collected ($2.50)





PokerStars Hand #150126705765:  Hold'em No Limit (€1/€2 EUR) - 2016/03/10 13:46:36 CET [2016/03/10 7:46:36 ET]
Table 'Sigrid II' 9-max Seat #8 is the button
Seat 1: Gamz11 (€200 in chips) 
Seat 2: stds st (€106.51 in chips) 
Seat 3: RoadtoNepal (€200 in chips) 
Seat 4: Fish4trips (€206 in chips) 
Seat 5: vr188 (€80.11 in chips) 
Seat 7: PacPacBum (€200 in chips) 
Seat 8: matiko09 (€209.16 in chips) 
Seat 9: ki11u (€231.72 in chips) 
ki11u: posts small blind €1
Gamz11: posts big blind €2
*** HOLE CARDS ***
Dealt to matiko09 [Td 5s]
stds st: folds 
RoadtoNepal: folds 
Fish4trips: folds 
vr188: folds 
PacPacBum: folds 
matiko09: folds 
ki11u: raises €4 to €6
Gamz11: raises €12 to €18
ki11u: folds 
Uncalled bet (€12) returned to Gamz11
Gamz11 collected €12 from pot
*** SUMMARY ***
Total pot €12 | Rake €0 
Seat 1: Gamz11 (big blind) collected (€12)
Seat 2: stds st folded before Flop (didn't bet)
Seat 3: RoadtoNepal folded before Flop (didn't bet)
Seat 4: Fish4trips folded before Flop (didn't bet)
Seat 5: vr188 folded before Flop (didn't bet)
Seat 7: PacPacBum folded before Flop (didn't bet)
Seat 8: matiko09 (button) folded before Flop (didn't bet)
Seat 9: ki11u (small blind) folded before Flop





PokerStars Hand #150126714590:  Hold'em No Limit ($0.50/$1.00 USD) - 2016/03/10 13:46:52 CET [2016/03/10 7:46:52 ET]
Table 'Leuschneria II' 9-max Seat #2 is the button
Seat 1: SHARKFIN168 ($106.58 in chips) 
Seat 2: blackw0lf_03 ($100 in chips) 
Seat 3: Spid1 ($100.50 in chips) 
Seat 4: Sweden_Pound ($135.22 in chips) 
Seat 5: RMilPoker ($220.54 in chips) 
Seat 6: matiko09 ($114.61 in chips) 
Seat 7: Plz3betMe ($39.50 in chips) 
Seat 8: UnBent022 ($103 in chips) 
Seat 9: ki11u ($100 in chips) 
Spid1: posts small blind $0.50
Sweden_Pound: posts big blind $1
*** HOLE CARDS ***
Dealt to matiko09 [Th 9h]
RMilPoker: raises $2 to $3
matiko09: calls $3
Plz3betMe: folds 
UnBent022: folds 
ki11u: folds 
SHARKFIN168: folds 
blackw0lf_03: folds 
Spid1: folds 
Sweden_Pound: folds 
*** FLOP *** [Ac 8c Qh]
RMilPoker: bets $5
matiko09: folds 
Uncalled bet ($5) returned to RMilPoker
RMilPoker collected $7.16 from pot
RMilPoker: doesn't show hand 
*** SUMMARY ***
Total pot $7.50 | Rake $0.34 
Board [Ac 8c Qh]
Seat 1: SHARKFIN168 folded before Flop (didn't bet)
Seat 2: blackw0lf_03 (button) folded before Flop (didn't bet)
Seat 3: Spid1 (small blind) folded before Flop
Seat 4: Sweden_Pound (big blind) folded before Flop
Seat 5: RMilPoker collected ($7.16)
Seat 6: matiko09 folded on the Flop
Seat 7: Plz3betMe folded before Flop (didn't bet)
Seat 8: UnBent022 folded before Flop (didn't bet)
Seat 9: ki11u folded before Flop (didn't bet)





PokerStars Hand #150126715218:  Hold'em No Limit ($0.50/$1.00 USD) - 2016/03/10 13:46:53 CET [2016/03/10 7:46:53 ET]
Table 'Mars III' 9-max Seat #9 is the button
Seat 1: blackw0lf_03 ($138.26 in chips) 
Seat 2: Spid1 ($100 in chips) 
Seat 3: PacPacBum ($108.98 in chips) 
Seat 4: ki11u ($104.23 in chips) 
Seat 6: matiko09 ($100 in chips) 
Seat 7: Sweden_Pound ($104.50 in chips) 
Seat 8: Filojoes ($106.89 in chips) 
Seat 9: flk.Dasas ($101 in chips) 
blackw0lf_03: posts small blind $0.50
Spid1: posts big blind $1
*** HOLE CARDS ***
Dealt to matiko09 [9h Qd]
PacPacBum: folds 
ki11u: folds 
matiko09: folds 
Sweden_Pound: folds 
Filojoes: raises $1.50 to $2.50
flk.Dasas: folds 
blackw0lf_03: folds 
Spid1: folds 
Uncalled bet ($1.50) returned to Filojoes
Filojoes collected $2.50 from pot
Filojoes: doesn't show hand 
*** SUMMARY ***
Total pot $2.50 | Rake $0 
Seat 1: blackw0lf_03 (small blind) folded before Flop
Seat 2: Spid1 (big blind) folded before Flop
Seat 3: PacPacBum folded before Flop (didn't bet)
Seat 4: ki11u folded before Flop (didn't bet)
Seat 6: matiko09 folded before Flop (didn't bet)
Seat 7: Sweden_Pound folded before Flop (didn't bet)
Seat 8: Filojoes collected ($2.50)
Seat 9: flk.Dasas (button) folded before Flop (didn't bet)





PokerStars Hand #150126715734:  Hold'em No Limit (€1/€2 EUR) - 2016/03/10 13:46:54 CET [2016/03/10 7:46:54 ET]
Table 'Sigrid II' 9-max Seat #9 is the button
Seat 1: Gamz11 (€206 in chips) 
Seat 2: stds st (€106.51 in chips) 
Seat 3: RoadtoNepal (€200 in chips) 
Seat 4: Fish4trips (€206 in chips) 
Seat 5: vr188 (€80.11 in chips) 
Seat 7: PacPacBum (€200 in chips) 
Seat 8: matiko09 (€209.16 in chips) 
Seat 9: ki11u (€225.72 in chips) 
Gamz11: posts small blind €1
stds st: posts big blind €2
*** HOLE CARDS ***
Dealt to matiko09 [2h 8h]
RoadtoNepal: folds 
Fish4trips: raises €3 to €5
vr188: folds 
PacPacBum: folds 
matiko09: folds 
ki11u: folds 
Gamz11: folds 
stds st: folds 
Uncalled bet (€3) returned to Fish4trips
Fish4trips collected €5 from pot
Fish4trips: doesn't show hand 
*** SUMMARY ***
Total pot €5 | Rake €0 
Seat 1: Gamz11 (small blind) folded before Flop
Seat 2: stds st (big blind) folded before Flop
Seat 3: RoadtoNepal folded before Flop (didn't bet)
Seat 4: Fish4trips collected (€5)
Seat 5: vr188 folded before Flop (didn't bet)
Seat 7: PacPacBum folded before Flop (didn't bet)
Seat 8: matiko09 folded before Flop (didn't bet)
Seat 9: ki11u (button) folded before Flop (didn't bet)





PokerStars Hand #150126715385:  Hold'em No Limit ($0.50/$1.00 USD) - 2016/03/10 13:46:54 CET [2016/03/10 7:46:54 ET]
Table 'Liriope II' 9-max Seat #7 is the button
Seat 2: er13to ($100 in chips) 
Seat 3: matiko09 ($151.01 in chips) 
Seat 4: Plz3betMe ($65.47 in chips) 
Seat 5: lumen21 ($111.28 in chips) 
Seat 6: nobu-azabu ($189.78 in chips) 
Seat 7: Sweden_Pound ($107.23 in chips) 
Seat 8: PacPacBum ($135.28 in chips) 
PacPacBum: posts small blind $0.50
UnBent022: is sitting out 
er13to: posts big blind $1
*** HOLE CARDS ***
Dealt to matiko09 [2s 6h]
matiko09: folds 
Plz3betMe: folds 
matiko09 leaves the table
Filojoes joins the table at seat #3 
lumen21: folds 
nobu-azabu: folds 
Sweden_Pound: folds 
UnBent022 leaves the table
PacPacBum: raises $1.04 to $2.04
er13to: calls $1.04
*** FLOP *** [Td Kd 5d]
PacPacBum: checks 
er13to: checks 
*** TURN *** [Td Kd 5d] [Jd]
PacPacBum: checks 
er13to: checks 
*** RIVER *** [Td Kd 5d Jd] [Jc]
PacPacBum: checks 
er13to: checks 
*** SHOW DOWN ***
PacPacBum: shows [Js 9s] (three of a kind, Jacks)
er13to: shows [3d 3h] (a flush, King high)
er13to collected $3.90 from pot
*** SUMMARY ***
Total pot $4.08 | Rake $0.18 
Board [Td Kd 5d Jd Jc]
Seat 2: er13to (big blind) showed [3d 3h] and won ($3.90) with a flush, King high
Seat 3: matiko09 folded before Flop (didn't bet)
Seat 4: Plz3betMe folded before Flop (didn't bet)
Seat 5: lumen21 folded before Flop (didn't bet)
Seat 6: nobu-azabu folded before Flop (didn't bet)
Seat 7: Sweden_Pound (button) folded before Flop (didn't bet)
Seat 8: PacPacBum (small blind) showed [Js 9s] and lost with three of a kind, Jacks





PokerStars Hand #150126717372:  Hold'em No Limit ($1/$2 USD) - 2016/03/10 13:46:57 CET [2016/03/10 7:46:57 ET]
Table 'Tauris II' 9-max Seat #3 is the button
Seat 1: matiko09 ($200 in chips) 
Seat 2: stds st ($60.95 in chips) 
Seat 3: PacPacBum ($280 in chips) 
Seat 4: neomorf ($659.52 in chips) 
Seat 5: tipner ($200 in chips) 
Seat 6: uonlylive1ce ($207.42 in chips) 
Seat 7: Fish4trips ($204.48 in chips) 
Seat 8: scout326 ($191.98 in chips) 
Seat 9: darren1031 ($226.01 in chips) 
neomorf: posts small blind $1
tipner: posts big blind $2
*** HOLE CARDS ***
Dealt to matiko09 [Kh 7s]
uonlylive1ce: folds 
Fish4trips: folds 
scout326: raises $4 to $6
darren1031: calls $6
matiko09: folds 
stds st: folds 
PacPacBum: folds 
neomorf: folds 
tipner: folds 
*** FLOP *** [5d 9c Td]
scout326: bets $7.16
darren1031: raises $8.84 to $16
scout326: raises $46.32 to $62.32
darren1031: folds 
Uncalled bet ($46.32) returned to scout326
scout326 collected $44.88 from pot
*** SUMMARY ***
Total pot $47 | Rake $2.12 
Board [5d 9c Td]
Seat 1: matiko09 folded before Flop (didn't bet)
Seat 2: stds st folded before Flop (didn't bet)
Seat 3: PacPacBum (button) folded before Flop (didn't bet)
Seat 4: neomorf (small blind) folded before Flop
Seat 5: tipner (big blind) folded before Flop
Seat 6: uonlylive1ce folded before Flop (didn't bet)
Seat 7: Fish4trips folded before Flop (didn't bet)
Seat 8: scout326 collected ($44.88)
Seat 9: darren1031 folded on the Flop





PokerStars Hand #150126724073:  Hold'em No Limit ($1/$2 USD) - 2016/03/10 13:47:10 CET [2016/03/10 7:47:10 ET]
Table 'Chandra II' 9-max Seat #4 is the button
Seat 1: Fish4trips ($297.44 in chips) 
Seat 2: PacPacBum ($239.51 in chips) 
Seat 3: ROLLO 888 ($216.82 in chips) 
Seat 4: tipner ($212.37 in chips) 
Seat 5: uibting ($78.29 in chips) 
Seat 6: stds st ($75.31 in chips) 
Seat 7: johnvu2016 ($135.25 in chips) 
Seat 8: matiko09 ($265.99 in chips) 
Seat 9: o.miro ($315.47 in chips) 
uibting: posts small blind $1
stds st: posts big blind $2
*** HOLE CARDS ***
Dealt to matiko09 [3d Ah]
johnvu2016: folds 
matiko09: folds 
o.miro: folds 
Fish4trips: folds 
PacPacBum: raises $2.08 to $4.08
ROLLO 888: calls $4.08
tipner: folds 
uibting: folds 
stds st: folds 
*** FLOP *** [Ac 2h 9d]
PacPacBum: checks 
ROLLO 888: checks 
*** TURN *** [Ac 2h 9d] [7h]
PacPacBum: bets $5.75
ROLLO 888: calls $5.75
*** RIVER *** [Ac 2h 9d 7h] [9s]
PacPacBum: bets $30
ROLLO 888: folds 
Uncalled bet ($30) returned to PacPacBum
PacPacBum collected $21.64 from pot
PacPacBum: doesn't show hand 
*** SUMMARY ***
Total pot $22.66 | Rake $1.02 
Board [Ac 2h 9d 7h 9s]
Seat 1: Fish4trips folded before Flop (didn't bet)
Seat 2: PacPacBum collected ($21.64)
Seat 3: ROLLO 888 folded on the River
Seat 4: tipner (button) folded before Flop (didn't bet)
Seat 5: uibting (small blind) folded before Flop
Seat 6: stds st (big blind) folded before Flop
Seat 7: johnvu2016 folded before Flop (didn't bet)
Seat 8: matiko09 folded before Flop (didn't bet)
Seat 9: o.miro folded before Flop (didn't bet)





PokerStars Hand #150126727424:  Hold'em No Limit ($0.50/$1.00 USD) - 2016/03/10 13:47:16 CET [2016/03/10 7:47:16 ET]
Table 'Iguassu' 9-max Seat #1 is the button
Seat 1: blackw0lf_03 ($100 in chips) 
Seat 2: Rocky6434 ($53.11 in chips) 
Seat 3: hammerwife ($123.43 in chips) 
Seat 4: matiko09 ($100 in chips) 
Seat 5: UnBent022 ($103 in chips) 
Seat 6: Igor DoUrden ($108.58 in chips) 
Seat 7: PacPacBum ($118.55 in chips) 
Seat 8: Filojoes ($125.32 in chips) 
Seat 9: er13to ($110.51 in chips) 
Rocky6434: posts small blind $0.50
hammerwife: posts big blind $1
*** HOLE CARDS ***
Dealt to matiko09 [Kc Ks]
matiko09: raises $2 to $3
UnBent022: folds 
Igor DoUrden: folds 
PacPacBum: folds 
Filojoes: calls $3
er13to: folds 
blackw0lf_03: folds 
Rocky6434: folds 
hammerwife: folds 
*** FLOP *** [Ts 6s 5d]
matiko09: checks 
Filojoes: bets $4.30
matiko09: calls $4.30
*** TURN *** [Ts 6s 5d] [2c]
matiko09: checks 
Filojoes: bets $7.69
matiko09: calls $7.69
*** RIVER *** [Ts 6s 5d 2c] [Js]
matiko09: checks 
Filojoes: bets $22
matiko09: folds 
Uncalled bet ($22) returned to Filojoes
Filojoes collected $30.06 from pot
Filojoes: doesn't show hand 
*** SUMMARY ***
Total pot $31.48 | Rake $1.42 
Board [Ts 6s 5d 2c Js]
Seat 1: blackw0lf_03 (button) folded before Flop (didn't bet)
Seat 2: Rocky6434 (small blind) folded before Flop
Seat 3: hammerwife (big blind) folded before Flop
Seat 4: matiko09 folded on the River
Seat 5: UnBent022 folded before Flop (didn't bet)
Seat 6: Igor DoUrden folded before Flop (didn't bet)
Seat 7: PacPacBum folded before Flop (didn't bet)
Seat 8: Filojoes collected ($30.06)
Seat 9: er13to folded before Flop (didn't bet)





PokerStars Hand #150126728186:  Hold'em No Limit ($0.50/$1.00 USD) - 2016/03/10 13:47:17 CET [2016/03/10 7:47:17 ET]
Table 'Opik' 9-max Seat #5 is the button
Seat 1: ilaviiitech ($100 in chips) 
Seat 2: tipner ($101 in chips) 
Seat 3: Sweden_Pound ($110.96 in chips) 
Seat 4: white huck ($58.50 in chips) 
Seat 5: matiko09 ($106.35 in chips) 
Seat 6: weise1988 ($50.26 in chips) 
Seat 7: PacPacBum ($100 in chips) 
Seat 8: Igor DoUrden ($104.62 in chips) 
Seat 9: Spid1 ($101.50 in chips) 
weise1988: posts small blind $0.50
PacPacBum: posts big blind $1
*** HOLE CARDS ***
Dealt to matiko09 [3h 3s]
Igor DoUrden: folds 
Spid1: folds 
ilaviiitech: folds 
tipner: raises $2 to $3
Sweden_Pound: folds 
white huck: folds 
matiko09: calls $3
weise1988: folds 
PacPacBum: folds 
*** FLOP *** [Ah Qh 4h]
tipner: checks 
matiko09: checks 
*** TURN *** [Ah Qh 4h] [Ks]
tipner: checks 
matiko09: checks 
*** RIVER *** [Ah Qh 4h Ks] [7h]
tipner: bets $3.58
matiko09: calls $3.58
*** SHOW DOWN ***
tipner: shows [Ts 8s] (high card Ace)
matiko09: shows [3h 3s] (a flush, Ace high)
matiko09 collected $14 from pot
*** SUMMARY ***
Total pot $14.66 | Rake $0.66 
Board [Ah Qh 4h Ks 7h]
Seat 1: ilaviiitech folded before Flop (didn't bet)
Seat 2: tipner showed [Ts 8s] and lost with high card Ace
Seat 3: Sweden_Pound folded before Flop (didn't bet)
Seat 4: white huck folded before Flop (didn't bet)
Seat 5: matiko09 (button) showed [3h 3s] and won ($14) with a flush, Ace high
Seat 6: weise1988 (small blind) folded before Flop
Seat 7: PacPacBum (big blind) folded before Flop
Seat 8: Igor DoUrden folded before Flop (didn't bet)
Seat 9: Spid1 folded before Flop (didn't bet)





PokerStars Hand #150126734013:  Hold'em No Limit (€1/€2 EUR) - 2016/03/10 13:47:28 CET [2016/03/10 7:47:28 ET]
Table 'Sigrid II' 9-max Seat #1 is the button
Seat 1: Gamz11 (€205 in chips) 
Seat 2: stds st (€104.51 in chips) 
Seat 5: vr188 (€80.11 in chips) 
Seat 7: PacPacBum (€200 in chips) 
Seat 8: matiko09 (€209.16 in chips) 
Seat 9: ki11u (€225.72 in chips) 
stds st: posts small blind €1
RoadtoNepal: is sitting out 
Fish4trips: is sitting out 
vr188: posts big blind €2
*** HOLE CARDS ***
Dealt to matiko09 [8h Qh]
Fish4trips leaves the table
PacPacBum: folds 
matiko09: folds 
ki11u: folds 
Gamz11: folds 
stds st: folds 
Uncalled bet (€1) returned to vr188
vr188 collected €2 from pot
vr188: doesn't show hand 
*** SUMMARY ***
Total pot €2 | Rake €0 
Seat 1: Gamz11 (button) folded before Flop (didn't bet)
Seat 2: stds st (small blind) folded before Flop
Seat 5: vr188 (big blind) collected (€2)
Seat 7: PacPacBum folded before Flop (didn't bet)
Seat 8: matiko09 folded before Flop (didn't bet)
Seat 9: ki11u folded before Flop (didn't bet)





PokerStars Hand #150126743837:  Hold'em No Limit ($0.50/$1.00 USD) - 2016/03/10 13:47:46 CET [2016/03/10 7:47:46 ET]
Table 'Mars III' 9-max Seat #1 is the button
Seat 1: blackw0lf_03 ($137.76 in chips) 
Seat 2: Spid1 ($100 in chips) 
Seat 3: PacPacBum ($108.98 in chips) 
Seat 4: ki11u ($104.23 in chips) 
Seat 6: matiko09 ($100 in chips) 
Seat 7: Sweden_Pound ($104.50 in chips) 
Seat 8: Filojoes ($108.39 in chips) 
Seat 9: flk.Dasas ($101 in chips) 
Spid1: posts small blind $0.50
PacPacBum: posts big blind $1
*** HOLE CARDS ***
Dealt to matiko09 [Js 7d]
ki11u: folds 
matiko09: folds 
Sweden_Pound: folds 
Filojoes: raises $2 to $3
flk.Dasas: folds 
blackw0lf_03: folds 
Spid1: folds 
PacPacBum: folds 
Uncalled bet ($2) returned to Filojoes
Filojoes collected $2.50 from pot
Filojoes: doesn't show hand 
*** SUMMARY ***
Total pot $2.50 | Rake $0 
Seat 1: blackw0lf_03 (button) folded before Flop (didn't bet)
Seat 2: Spid1 (small blind) folded before Flop
Seat 3: PacPacBum (big blind) folded before Flop
Seat 4: ki11u folded before Flop (didn't bet)
Seat 6: matiko09 folded before Flop (didn't bet)
Seat 7: Sweden_Pound folded before Flop (didn't bet)
Seat 8: Filojoes collected ($2.50)
Seat 9: flk.Dasas folded before Flop (didn't bet)





PokerStars Hand #150126744294:  Hold'em No Limit ($0.25/$0.50 USD) - 2016/03/10 13:47:47 CET [2016/03/10 7:47:47 ET]
Table 'Aegina' 9-max Seat #2 is the button
Seat 1: BingoIng0 ($117.44 in chips) 
Seat 2: Spid1 ($105.19 in chips) 
Seat 3: MyMilkCans=D ($125 in chips) 
Seat 4: digimatical ($69.98 in chips) 
Seat 5: Ahangama ($51.05 in chips) 
Seat 6: matiko09 ($69.87 in chips) 
Seat 7: Gummio ($108.49 in chips) 
Seat 8: ardo888 ($177.54 in chips) 
Seat 9: draken08 ($125 in chips) 
MyMilkCans=D: posts small blind $0.25
digimatical: posts big blind $0.50
BingoIng0: posts the ante $0.10
Spid1: posts the ante $0.10
MyMilkCans=D: posts the ante $0.10
digimatical: posts the ante $0.10
Ahangama: posts the ante $0.10
matiko09: posts the ante $0.10
Gummio: posts the ante $0.10
ardo888: posts the ante $0.10
draken08: posts the ante $0.10
*** HOLE CARDS ***
Dealt to matiko09 [4h 7s]
Ahangama: folds 
matiko09: folds 
Gummio: folds 
ardo888: folds 
draken08: raises $1 to $1.50
BingoIng0: folds 
Spid1: folds 
BingoIng0 leaves the table
congcongnbnb joins the table at seat #1 
MyMilkCans=D: folds 
digimatical: calls $1
*** FLOP *** [4d Th 8h]
digimatical: checks 
draken08: checks 
*** TURN *** [4d Th 8h] [Kh]
digimatical: checks 
draken08: checks 
*** RIVER *** [4d Th 8h Kh] [Ts]
digimatical: checks 
draken08: checks 
*** SHOW DOWN ***
digimatical: shows [9c 2c] (a pair of Tens)
draken08: shows [Ad 5h] (a pair of Tens - Ace kicker)
draken08 collected $3.96 from pot
*** SUMMARY ***
Total pot $4.15 | Rake $0.19 
Board [4d Th 8h Kh Ts]
Seat 1: BingoIng0 folded before Flop (didn't bet)
Seat 2: Spid1 (button) folded before Flop (didn't bet)
Seat 3: MyMilkCans=D (small blind) folded before Flop
Seat 4: digimatical (big blind) showed [9c 2c] and lost with a pair of Tens
Seat 5: Ahangama folded before Flop (didn't bet)
Seat 6: matiko09 folded before Flop (didn't bet)
Seat 7: Gummio folded before Flop (didn't bet)
Seat 8: ardo888 folded before Flop (didn't bet)
Seat 9: draken08 showed [Ad 5h] and won ($3.96) with a pair of Tens





PokerStars Hand #150126745355:  Hold'em No Limit (€1/€2 EUR) - 2016/03/10 13:47:49 CET [2016/03/10 7:47:49 ET]
Table 'Sigrid II' 9-max Seat #2 is the button
Seat 1: Gamz11 (€205 in chips) 
Seat 2: stds st (€103.51 in chips) 
Seat 5: vr188 (€81.11 in chips) 
Seat 7: PacPacBum (€200 in chips) 
Seat 8: matiko09 (€209.16 in chips) 
Seat 9: ki11u (€225.72 in chips) 
vr188: posts small blind €1
PacPacBum: posts big blind €2
*** HOLE CARDS ***
Dealt to matiko09 [7c 3c]
matiko09: folds 
ki11u: folds 
Gamz11: folds 
stds st: folds 
vr188: folds 
Uncalled bet (€1) returned to PacPacBum
PacPacBum collected €2 from pot
PacPacBum: doesn't show hand 
*** SUMMARY ***
Total pot €2 | Rake €0 
Seat 1: Gamz11 folded before Flop (didn't bet)
Seat 2: stds st (button) folded before Flop (didn't bet)
Seat 5: vr188 (small blind) folded before Flop
Seat 7: PacPacBum (big blind) collected (€2)
Seat 8: matiko09 folded before Flop (didn't bet)
Seat 9: ki11u folded before Flop (didn't bet)





PokerStars Hand #150126753301:  Hold'em No Limit (€1/€2 EUR) - 2016/03/10 13:48:03 CET [2016/03/10 7:48:03 ET]
Table 'Sigrid II' 9-max Seat #5 is the button
Seat 1: Gamz11 (€205 in chips) 
Seat 2: stds st (€103.51 in chips) 
Seat 5: vr188 (€80.11 in chips) 
Seat 7: PacPacBum (€201 in chips) 
Seat 8: matiko09 (€209.16 in chips) 
Seat 9: ki11u (€225.72 in chips) 
PacPacBum: posts small blind €1
matiko09: posts big blind €2
*** HOLE CARDS ***
Dealt to matiko09 [8d Ah]
ki11u: folds 
Gamz11: folds 
stds st: folds 
vr188: folds 
PacPacBum: folds 
Uncalled bet (€1) returned to matiko09
matiko09 collected €2 from pot
matiko09: doesn't show hand 
*** SUMMARY ***
Total pot €2 | Rake €0 
Seat 1: Gamz11 folded before Flop (didn't bet)
Seat 2: stds st folded before Flop (didn't bet)
Seat 5: vr188 (button) folded before Flop (didn't bet)
Seat 7: PacPacBum (small blind) folded before Flop
Seat 8: matiko09 (big blind) collected (€2)
Seat 9: ki11u folded before Flop (didn't bet)





PokerStars Hand #150126758932:  Hold'em No Limit ($1/$2 USD) - 2016/03/10 13:48:14 CET [2016/03/10 7:48:14 ET]
Table 'Tauris II' 9-max Seat #4 is the button
Seat 1: matiko09 ($200 in chips) 
Seat 2: stds st ($60.95 in chips) 
Seat 3: PacPacBum ($280 in chips) 
Seat 4: neomorf ($658.52 in chips) 
Seat 5: tipner ($200 in chips) 
Seat 6: uonlylive1ce ($207.42 in chips) 
Seat 7: Fish4trips ($204.48 in chips) 
Seat 8: scout326 ($214.86 in chips) 
Seat 9: darren1031 ($204.01 in chips) 
tipner: posts small blind $1
uonlylive1ce: posts big blind $2
*** HOLE CARDS ***
Dealt to matiko09 [7s 4s]
Fish4trips: raises $3 to $5
scout326: folds 
darren1031: calls $5
matiko09: folds 
stds st: calls $5
PacPacBum: folds 
neomorf: folds 
tipner: folds 
uonlylive1ce: folds 
*** FLOP *** [Tc 9h 8c]
Fish4trips: checks 
darren1031: bets $6
stds st: folds 
Fish4trips: calls $6
*** TURN *** [Tc 9h 8c] [2s]
Fish4trips: checks 
darren1031: checks 
*** RIVER *** [Tc 9h 8c 2s] [8s]
Fish4trips: bets $18
darren1031: folds 
Uncalled bet ($18) returned to Fish4trips
Fish4trips collected $28.65 from pot
Fish4trips: doesn't show hand 
*** SUMMARY ***
Total pot $30 | Rake $1.35 
Board [Tc 9h 8c 2s 8s]
Seat 1: matiko09 folded before Flop (didn't bet)
Seat 2: stds st folded on the Flop
Seat 3: PacPacBum folded before Flop (didn't bet)
Seat 4: neomorf (button) folded before Flop (didn't bet)
Seat 5: tipner (small blind) folded before Flop
Seat 6: uonlylive1ce (big blind) folded before Flop
Seat 7: Fish4trips collected ($28.65)
Seat 8: scout326 folded before Flop (didn't bet)
Seat 9: darren1031 folded on the River





PokerStars Hand #150126759645:  Hold'em No Limit ($0.50/$1.00 USD) - 2016/03/10 13:48:15 CET [2016/03/10 7:48:15 ET]
Table 'Leuschneria II' 9-max Seat #3 is the button
Seat 1: SHARKFIN168 ($106.58 in chips) 
Seat 2: blackw0lf_03 ($100 in chips) 
Seat 3: Spid1 ($100 in chips) 
Seat 4: Sweden_Pound ($134.22 in chips) 
Seat 5: RMilPoker ($224.70 in chips) 
Seat 6: matiko09 ($111.61 in chips) 
Seat 7: Plz3betMe ($39.50 in chips) 
Seat 8: UnBent022 ($103 in chips) 
Seat 9: ki11u ($100 in chips) 
Sweden_Pound: posts small blind $0.50
RMilPoker: posts big blind $1
*** HOLE CARDS ***
Dealt to matiko09 [6d 5c]
matiko09: folds 
Plz3betMe: folds 
UnBent022: folds 
ki11u: folds 
SHARKFIN168: raises $1 to $2
blackw0lf_03: folds 
Spid1: calls $2
Sweden_Pound: folds 
RMilPoker: folds 
*** FLOP *** [Qc Td 2c]
SHARKFIN168: bets $4
Spid1: calls $4
*** TURN *** [Qc Td 2c] [Jd]
SHARKFIN168: checks 
Spid1: bets $9.50
SHARKFIN168: calls $9.50
*** RIVER *** [Qc Td 2c Jd] [6h]
SHARKFIN168: checks 
Spid1: bets $22.50
SHARKFIN168: folds 
Uncalled bet ($22.50) returned to Spid1
Spid1 collected $31.04 from pot
Spid1: doesn't show hand 
*** SUMMARY ***
Total pot $32.50 | Rake $1.46 
Board [Qc Td 2c Jd 6h]
Seat 1: SHARKFIN168 folded on the River
Seat 2: blackw0lf_03 folded before Flop (didn't bet)
Seat 3: Spid1 (button) collected ($31.04)
Seat 4: Sweden_Pound (small blind) folded before Flop
Seat 5: RMilPoker (big blind) folded before Flop
Seat 6: matiko09 folded before Flop (didn't bet)
Seat 7: Plz3betMe folded before Flop (didn't bet)
Seat 8: UnBent022 folded before Flop (didn't bet)
Seat 9: ki11u folded before Flop (didn't bet)





PokerStars Hand #150126764145:  Hold'em No Limit (€1/€2 EUR) - 2016/03/10 13:48:24 CET [2016/03/10 7:48:24 ET]
Table 'Sigrid II' 9-max Seat #7 is the button
Seat 1: Gamz11 (€205 in chips) 
Seat 2: stds st (€103.51 in chips) 
Seat 5: vr188 (€80.11 in chips) 
Seat 7: PacPacBum (€200 in chips) 
Seat 8: matiko09 (€210.16 in chips) 
Seat 9: ki11u (€225.72 in chips) 
matiko09: posts small blind €1
ki11u: posts big blind €2
*** HOLE CARDS ***
Dealt to matiko09 [Qh 7h]
Gamz11: folds 
stds st: folds 
vr188: raises €2 to €4
PacPacBum: folds 
matiko09: folds 
ki11u: folds 
Uncalled bet (€2) returned to vr188
vr188 collected €5 from pot
*** SUMMARY ***
Total pot €5 | Rake €0 
Seat 1: Gamz11 folded before Flop (didn't bet)
Seat 2: stds st folded before Flop (didn't bet)
Seat 5: vr188 collected (€5)
Seat 7: PacPacBum (button) folded before Flop (didn't bet)
Seat 8: matiko09 (small blind) folded before Flop
Seat 9: ki11u (big blind) folded before Flop





PokerStars Hand #150126776615:  Hold'em No Limit ($0.25/$0.50 USD) - 2016/03/10 13:48:46 CET [2016/03/10 7:48:46 ET]
Table 'Aegina' 9-max Seat #3 is the button
Seat 2: Spid1 ($105.09 in chips) 
Seat 3: MyMilkCans=D ($125 in chips) 
Seat 4: digimatical ($68.38 in chips) 
Seat 5: Ahangama ($50.95 in chips) 
Seat 6: matiko09 ($69.77 in chips) 
Seat 7: Gummio ($108.39 in chips) 
Seat 8: ardo888 ($177.44 in chips) 
Seat 9: draken08 ($127.36 in chips) 
digimatical: posts small blind $0.25
Ahangama: posts big blind $0.50
congcongnbnb: sits out 
Spid1: posts the ante $0.10
MyMilkCans=D: posts the ante $0.10
digimatical: posts the ante $0.10
Ahangama: posts the ante $0.10
matiko09: posts the ante $0.10
Gummio: posts the ante $0.10
ardo888: posts the ante $0.10
draken08: posts the ante $0.10
*** HOLE CARDS ***
Dealt to matiko09 [Ac 8c]
matiko09: folds 
Gummio: calls $0.50
ardo888: folds 
draken08: folds 
Spid1: raises $1.50 to $2
MyMilkCans=D: calls $2
digimatical: calls $1.75
Ahangama: folds 
Gummio: calls $1.50
*** FLOP *** [Ks 4s 5c]
digimatical: checks 
Gummio: bets $5
Spid1: folds 
MyMilkCans=D: folds 
digimatical: folds 
Uncalled bet ($5) returned to Gummio
Gummio collected $8.88 from pot
Gummio: doesn't show hand 
*** SUMMARY ***
Total pot $9.30 | Rake $0.42 
Board [Ks 4s 5c]
Seat 2: Spid1 folded on the Flop
Seat 3: MyMilkCans=D (button) folded on the Flop
Seat 4: digimatical (small blind) folded on the Flop
Seat 5: Ahangama (big blind) folded before Flop
Seat 6: matiko09 folded before Flop (didn't bet)
Seat 7: Gummio collected ($8.88)
Seat 8: ardo888 folded before Flop (didn't bet)
Seat 9: draken08 folded before Flop (didn't bet)





PokerStars Hand #150126776327:  Hold'em No Limit ($1/$2 USD) - 2016/03/10 13:48:46 CET [2016/03/10 7:48:46 ET]
Table 'Chandra II' 9-max Seat #5 is the button
Seat 1: Fish4trips ($297.44 in chips) 
Seat 2: PacPacBum ($251.32 in chips) 
Seat 3: ROLLO 888 ($206.99 in chips) 
Seat 4: tipner ($212.37 in chips) 
Seat 5: uibting ($77.29 in chips) 
Seat 6: stds st ($73.31 in chips) 
Seat 7: johnvu2016 ($135.25 in chips) 
Seat 8: matiko09 ($265.99 in chips) 
Seat 9: o.miro ($315.47 in chips) 
stds st: posts small blind $1
johnvu2016: posts big blind $2
*** HOLE CARDS ***
Dealt to matiko09 [7h 7s]
matiko09: raises $3 to $5
o.miro: folds 
Fish4trips: calls $5
PacPacBum: folds 
ROLLO 888: folds 
tipner: calls $5
uibting: calls $5
ROLLO 888 leaves the table
uonlylive1ce joins the table at seat #3 
stds st: calls $4
johnvu2016: folds 
*** FLOP *** [2h 9c 6c]
stds st: checks 
matiko09: checks 
Fish4trips: bets $13.92
tipner: calls $13.92
uibting: calls $13.92
stds st: folds 
matiko09: folds 
*** TURN *** [2h 9c 6c] [Th]
Fish4trips: checks 
tipner: checks 
uibting: bets $28
Fish4trips: calls $28
tipner: raises $165.45 to $193.45 and is all-in
uibting: calls $30.37 and is all-in
Fish4trips: folds 
Uncalled bet ($135.08) returned to tipner
*** RIVER *** [2h 9c 6c Th] [6s]
*** SHOW DOWN ***
tipner: shows [Ac Kc] (a pair of Sixes)
uibting: shows [Ts Td] (a full house, Tens full of Sixes)
uibting collected $210.70 from pot
*** SUMMARY ***
Total pot $213.50 | Rake $2.80 
Board [2h 9c 6c Th 6s]
Seat 1: Fish4trips folded on the Turn
Seat 2: PacPacBum folded before Flop (didn't bet)
Seat 3: ROLLO 888 folded before Flop (didn't bet)
Seat 4: tipner showed [Ac Kc] and lost with a pair of Sixes
Seat 5: uibting (button) showed [Ts Td] and won ($210.70) with a full house, Tens full of Sixes
Seat 6: stds st (small blind) folded on the Flop
Seat 7: johnvu2016 (big blind) folded before Flop
Seat 8: matiko09 folded on the Flop
Seat 9: o.miro folded before Flop (didn't bet)





PokerStars Hand #150126779102:  Hold'em No Limit ($0.50/$1.00 USD) - 2016/03/10 13:48:51 CET [2016/03/10 7:48:51 ET]
Table 'Opik' 9-max Seat #6 is the button
Seat 1: ilaviiitech ($100 in chips) 
Seat 2: tipner ($100 in chips) 
Seat 3: Sweden_Pound ($110.96 in chips) 
Seat 4: white huck ($58.50 in chips) 
Seat 5: matiko09 ($113.77 in chips) 
Seat 6: weise1988 ($49.76 in chips) 
Seat 7: PacPacBum ($100 in chips) 
Seat 8: Igor DoUrden ($104.62 in chips) 
Seat 9: Spid1 ($101.50 in chips) 
PacPacBum: posts small blind $0.50
Igor DoUrden: posts big blind $1
*** HOLE CARDS ***
Dealt to matiko09 [Kd 5s]
Spid1: folds 
ilaviiitech: folds 
tipner: folds 
Sweden_Pound: folds 
white huck: folds 
matiko09: folds 
weise1988: folds 
weise1988 leaves the table
Filojoes joins the table at seat #6 
Filojoes leaves the table
PacPacBum: raises $1.04 to $2.04
Igor DoUrden: folds 
Uncalled bet ($1.04) returned to PacPacBum
PacPacBum collected $2 from pot
PacPacBum: doesn't show hand 
*** SUMMARY ***
Total pot $2 | Rake $0 
Seat 1: ilaviiitech folded before Flop (didn't bet)
Seat 2: tipner folded before Flop (didn't bet)
Seat 3: Sweden_Pound folded before Flop (didn't bet)
Seat 4: white huck folded before Flop (didn't bet)
Seat 5: matiko09 folded before Flop (didn't bet)
Seat 6: weise1988 (button) folded before Flop (didn't bet)
Seat 7: PacPacBum (small blind) collected ($2)
Seat 8: Igor DoUrden (big blind) folded before Flop
Seat 9: Spid1 folded before Flop (didn't bet)





PokerStars Hand #150126786827:  Hold'em No Limit (€1/€2 EUR) - 2016/03/10 13:49:05 CET [2016/03/10 7:49:05 ET]
Table 'Sigrid II' 9-max Seat #8 is the button
Seat 1: Gamz11 (€205 in chips) 
Seat 2: stds st (€103.51 in chips) 
Seat 5: vr188 (€83.11 in chips) 
Seat 7: PacPacBum (€200 in chips) 
Seat 8: matiko09 (€209.16 in chips) 
Seat 9: ki11u (€223.72 in chips) 
ki11u: posts small blind €1
Gamz11: posts big blind €2
*** HOLE CARDS ***
Dealt to matiko09 [4s As]
stds st: folds 
vr188: folds 
PacPacBum: folds 
matiko09: raises €2.54 to €4.54
ki11u: folds 
Gamz11: folds 
Uncalled bet (€2.54) returned to matiko09
matiko09 collected €5 from pot
matiko09: doesn't show hand 
*** SUMMARY ***
Total pot €5 | Rake €0 
Seat 1: Gamz11 (big blind) folded before Flop
Seat 2: stds st folded before Flop (didn't bet)
Seat 5: vr188 folded before Flop (didn't bet)
Seat 7: PacPacBum folded before Flop (didn't bet)
Seat 8: matiko09 (button) collected (€5)
Seat 9: ki11u (small blind) folded before Flop





PokerStars Hand #150126787303:  Hold'em No Limit ($0.50/$1.00 USD) - 2016/03/10 13:49:06 CET [2016/03/10 7:49:06 ET]
Table 'Iguassu' 9-max Seat #2 is the button
Seat 1: blackw0lf_03 ($100 in chips) 
Seat 2: Rocky6434 ($52.61 in chips) 
Seat 3: hammerwife ($122.43 in chips) 
Seat 4: matiko09 ($100 in chips) 
Seat 5: UnBent022 ($103 in chips) 
Seat 6: Igor DoUrden ($108.58 in chips) 
Seat 7: PacPacBum ($118.55 in chips) 
Seat 8: Filojoes ($140.39 in chips) 
Seat 9: er13to ($110.51 in chips) 
hammerwife: posts small blind $0.50
matiko09: posts big blind $1
*** HOLE CARDS ***
Dealt to matiko09 [7d 9s]
UnBent022: folds 
Igor DoUrden: folds 
PacPacBum: folds 
Filojoes: raises $2 to $3
er13to: folds 
blackw0lf_03: folds 
Rocky6434: calls $3
hammerwife: folds 
matiko09: folds 
*** FLOP *** [4d 6h Ad]
Filojoes: checks 
Rocky6434: bets $3.58
Filojoes: folds 
Uncalled bet ($3.58) returned to Rocky6434
Rocky6434 collected $7.16 from pot
Rocky6434: doesn't show hand 
*** SUMMARY ***
Total pot $7.50 | Rake $0.34 
Board [4d 6h Ad]
Seat 1: blackw0lf_03 folded before Flop (didn't bet)
Seat 2: Rocky6434 (button) collected ($7.16)
Seat 3: hammerwife (small blind) folded before Flop
Seat 4: matiko09 (big blind) folded before Flop
Seat 5: UnBent022 folded before Flop (didn't bet)
Seat 6: Igor DoUrden folded before Flop (didn't bet)
Seat 7: PacPacBum folded before Flop (didn't bet)
Seat 8: Filojoes folded on the Flop
Seat 9: er13to folded before Flop (didn't bet)





PokerStars Hand #150126796316:  Hold'em No Limit (€1/€2 EUR) - 2016/03/10 13:49:22 CET [2016/03/10 7:49:22 ET]
Table 'Sigrid II' 9-max Seat #9 is the button
Seat 1: Gamz11 (€203 in chips) 
Seat 2: stds st (€103.51 in chips) 
Seat 5: vr188 (€83.11 in chips) 
Seat 7: PacPacBum (€200 in chips) 
Seat 8: matiko09 (€212.16 in chips) 
Seat 9: ki11u (€222.72 in chips) 
Gamz11: posts small blind €1
stds st: posts big blind €2
*** HOLE CARDS ***
Dealt to matiko09 [Jh 3c]
vr188: folds 
PacPacBum: folds 
matiko09: folds 
ki11u: folds 
Gamz11: folds 
Uncalled bet (€1) returned to stds st
stds st collected €2 from pot
stds st: doesn't show hand 
*** SUMMARY ***
Total pot €2 | Rake €0 
Seat 1: Gamz11 (small blind) folded before Flop
Seat 2: stds st (big blind) collected (€2)
Seat 5: vr188 folded before Flop (didn't bet)
Seat 7: PacPacBum folded before Flop (didn't bet)
Seat 8: matiko09 folded before Flop (didn't bet)
Seat 9: ki11u (button) folded before Flop (didn't bet)





PokerStars Hand #150126797744:  Hold'em No Limit ($0.50/$1.00 USD) - 2016/03/10 13:49:25 CET [2016/03/10 7:49:25 ET]
Table 'Opik' 9-max Seat #7 is the button
Seat 1: ilaviiitech ($100 in chips) 
Seat 2: tipner ($100 in chips) 
Seat 3: Sweden_Pound ($110.96 in chips) 
Seat 4: white huck ($58.50 in chips) 
Seat 5: matiko09 ($113.77 in chips) 
Seat 7: PacPacBum ($101 in chips) 
Seat 8: Igor DoUrden ($103.62 in chips) 
Seat 9: Spid1 ($101.50 in chips) 
Igor DoUrden: posts small blind $0.50
Spid1: posts big blind $1
*** HOLE CARDS ***
Dealt to matiko09 [3c Js]
ilaviiitech: folds 
tipner: folds 
ilaviiitech leaves the table
Sweden_Pound: folds 
flk.Dasas joins the table at seat #6 
white huck: raises $1.43 to $2.43
matiko09: folds 
PacPacBum: folds 
Igor DoUrden: folds 
Spid1: folds 
Uncalled bet ($1.43) returned to white huck
white huck collected $2.50 from pot
white huck: doesn't show hand 
*** SUMMARY ***
Total pot $2.50 | Rake $0 
Seat 1: ilaviiitech folded before Flop (didn't bet)
Seat 2: tipner folded before Flop (didn't bet)
Seat 3: Sweden_Pound folded before Flop (didn't bet)
Seat 4: white huck collected ($2.50)
Seat 5: matiko09 folded before Flop (didn't bet)
Seat 7: PacPacBum (button) folded before Flop (didn't bet)
Seat 8: Igor DoUrden (small blind) folded before Flop
Seat 9: Spid1 (big blind) folded before Flop





PokerStars Hand #150126807398:  Hold'em No Limit (€1/€2 EUR) - 2016/03/10 13:49:43 CET [2016/03/10 7:49:43 ET]
Table 'Sigrid II' 9-max Seat #1 is the button
Seat 1: Gamz11 (€202 in chips) 
Seat 2: stds st (€104.51 in chips) 
Seat 5: vr188 (€83.11 in chips) 
Seat 7: PacPacBum (€200 in chips) 
Seat 8: matiko09 (€212.16 in chips) 
Seat 9: ki11u (€222.72 in chips) 
stds st: posts small blind €1
vr188: posts big blind €2
*** HOLE CARDS ***
Dealt to matiko09 [Kd Ac]
PacPacBum: raises €2.08 to €4.08
matiko09: calls €4.08
ki11u: folds 
Gamz11: folds 
stds st: folds 
vr188: calls €2.08
*** FLOP *** [Kh 7s 8s]
vr188: checks 
PacPacBum: bets €8.72
matiko09: calls €8.72
vr188: folds 
*** TURN *** [Kh 7s 8s] [Qh]
PacPacBum: bets €15.82
matiko09: calls €15.82
*** RIVER *** [Kh 7s 8s Qh] [3d]
PacPacBum: checks 
matiko09: checks 
*** SHOW DOWN ***
PacPacBum: shows [Tc 9c] (high card King)
matiko09: shows [Kd Ac] (a pair of Kings)
matiko09 collected €60.17 from pot
*** SUMMARY ***
Total pot €62.32 | Rake €2.15 
Board [Kh 7s 8s Qh 3d]
Seat 1: Gamz11 (button) folded before Flop (didn't bet)
Seat 2: stds st (small blind) folded before Flop
Seat 5: vr188 (big blind) folded on the Flop
Seat 7: PacPacBum showed [Tc 9c] and lost with high card King
Seat 8: matiko09 showed [Kd Ac] and won (€60.17) with a pair of Kings
Seat 9: ki11u folded before Flop (didn't bet)





PokerStars Hand #150126808936:  Hold'em No Limit ($0.50/$1.00 USD) - 2016/03/10 13:49:45 CET [2016/03/10 7:49:45 ET]
Table 'Leuschneria II' 9-max Seat #4 is the button
Seat 1: SHARKFIN168 ($91.08 in chips) 
Seat 2: blackw0lf_03 ($100 in chips) 
Seat 3: Spid1 ($115.54 in chips) 
Seat 4: Sweden_Pound ($133.72 in chips) 
Seat 5: RMilPoker ($223.70 in chips) 
Seat 6: matiko09 ($111.61 in chips) 
Seat 7: Plz3betMe ($39.50 in chips) 
Seat 8: UnBent022 ($103 in chips) 
Seat 9: ki11u ($100 in chips) 
RMilPoker: posts small blind $0.50
matiko09: posts big blind $1
*** HOLE CARDS ***
Dealt to matiko09 [9c 2c]
Plz3betMe: folds 
UnBent022: folds 
ki11u: raises $1.50 to $2.50
SHARKFIN168: calls $2.50
blackw0lf_03: folds 
Spid1: folds 
Sweden_Pound: folds 
RMilPoker: folds 
matiko09: folds 
*** FLOP *** [Jc Kc Ts]
ki11u: checks 
SHARKFIN168: bets $6
ki11u: folds 
Uncalled bet ($6) returned to SHARKFIN168
SHARKFIN168 collected $6.21 from pot
SHARKFIN168: doesn't show hand 
*** SUMMARY ***
Total pot $6.50 | Rake $0.29 
Board [Jc Kc Ts]
Seat 1: SHARKFIN168 collected ($6.21)
Seat 2: blackw0lf_03 folded before Flop (didn't bet)
Seat 3: Spid1 folded before Flop (didn't bet)
Seat 4: Sweden_Pound (button) folded before Flop (didn't bet)
Seat 5: RMilPoker (small blind) folded before Flop
Seat 6: matiko09 (big blind) folded before Flop
Seat 7: Plz3betMe folded before Flop (didn't bet)
Seat 8: UnBent022 folded before Flop (didn't bet)
Seat 9: ki11u folded on the Flop





PokerStars Hand #150126809675:  Hold'em No Limit ($1/$2 USD) - 2016/03/10 13:49:47 CET [2016/03/10 7:49:47 ET]
Table 'Solstice II' 9-max Seat #6 is the button
Seat 1: azzad2007 ($276.70 in chips) 
Seat 3: PacPacBum ($200 in chips) 
Seat 4: ki11u ($200 in chips) 
Seat 5: eKCimann 666 ($379.14 in chips) 
Seat 6: Gamz11 ($218.75 in chips) 
Seat 7: uonlylive1ce ($200 in chips) 
Seat 8: matiko09 ($200 in chips) 
Seat 9: zhang0204 ($200 in chips) 
uonlylive1ce: posts small blind $1
matiko09: posts big blind $2
o.miro: sits out 
*** HOLE CARDS ***
Dealt to matiko09 [Qh Th]
PacPacBum said, "classic"
zhang0204: folds 
azzad2007: folds 
PacPacBum: folds 
ki11u: folds 
eKCimann 666 said, "nice hand"
eKCimann 666: folds 
Gamz11: raises $2.92 to $4.92
uonlylive1ce: folds 
matiko09: calls $2.92
*** FLOP *** [4d Jc 8c]
matiko09: checks 
Gamz11: checks 
*** TURN *** [4d Jc 8c] [Js]
matiko09: checks 
Gamz11: bets $7.74
matiko09: folds 
Uncalled bet ($7.74) returned to Gamz11
Gamz11 collected $10.35 from pot
*** SUMMARY ***
Total pot $10.84 | Rake $0.49 
Board [4d Jc 8c Js]
Seat 1: azzad2007 folded before Flop (didn't bet)
Seat 3: PacPacBum folded before Flop (didn't bet)
Seat 4: ki11u folded before Flop (didn't bet)
Seat 5: eKCimann 666 folded before Flop (didn't bet)
Seat 6: Gamz11 (button) collected ($10.35)
Seat 7: uonlylive1ce (small blind) folded before Flop
Seat 8: matiko09 (big blind) folded on the Turn
Seat 9: zhang0204 folded before Flop (didn't bet)





PokerStars Hand #150126814761:  Hold'em No Limit ($0.50/$1.00 USD) - 2016/03/10 13:49:56 CET [2016/03/10 7:49:56 ET]
Table 'Iguassu' 9-max Seat #3 is the button
Seat 1: blackw0lf_03 ($100 in chips) 
Seat 2: Rocky6434 ($56.77 in chips) 
Seat 3: hammerwife ($121.93 in chips) 
Seat 4: matiko09 ($100 in chips) 
Seat 5: UnBent022 ($103 in chips) 
Seat 6: Igor DoUrden ($108.58 in chips) 
Seat 7: PacPacBum ($118.55 in chips) 
Seat 8: Filojoes ($137.39 in chips) 
Seat 9: er13to ($110.51 in chips) 
matiko09: posts small blind $0.50
UnBent022: posts big blind $1
*** HOLE CARDS ***
Dealt to matiko09 [6c Qs]
Igor DoUrden: raises $1 to $2
PacPacBum: folds 
Filojoes: folds 
er13to: folds 
blackw0lf_03: folds 
Rocky6434: folds 
hammerwife: folds 
matiko09: folds 
UnBent022: folds 
Uncalled bet ($1) returned to Igor DoUrden
Igor DoUrden collected $2.50 from pot
Igor DoUrden: doesn't show hand 
*** SUMMARY ***
Total pot $2.50 | Rake $0 
Seat 1: blackw0lf_03 folded before Flop (didn't bet)
Seat 2: Rocky6434 folded before Flop (didn't bet)
Seat 3: hammerwife (button) folded before Flop (didn't bet)
Seat 4: matiko09 (small blind) folded before Flop
Seat 5: UnBent022 (big blind) folded before Flop
Seat 6: Igor DoUrden collected ($2.50)
Seat 7: PacPacBum folded before Flop (didn't bet)
Seat 8: Filojoes folded before Flop (didn't bet)
Seat 9: er13to folded before Flop (didn't bet)





PokerStars Hand #150126817252:  Hold'em No Limit ($0.50/$1.00 USD) - 2016/03/10 13:50:01 CET [2016/03/10 7:50:01 ET]
Table 'Opik' 9-max Seat #8 is the button
Seat 2: tipner ($100 in chips) 
Seat 3: Sweden_Pound ($110.96 in chips) 
Seat 4: white huck ($60 in chips) 
Seat 5: matiko09 ($113.77 in chips) 
Seat 7: PacPacBum ($101 in chips) 
Seat 8: Igor DoUrden ($103.12 in chips) 
Seat 9: Spid1 ($100.50 in chips) 
Spid1: posts small blind $0.50
tipner: posts big blind $1
flk.Dasas: sits out 
*** HOLE CARDS ***
Dealt to matiko09 [Ks 8s]
UnBent022 joins the table at seat #1 
flk.Dasas leaves the table
Sweden_Pound: folds 
white huck: folds 
matiko09: folds 
PacPacBum: folds 
Igor DoUrden: raises $1 to $2
UnBent022 leaves the table
Spid1: raises $6 to $8
tipner: folds 
Igor DoUrden: calls $6
*** FLOP *** [7c 3h 4h]
Spid1: bets $10.50
Igor DoUrden: calls $10.50
*** TURN *** [7c 3h 4h] [Kh]
Spid1: checks 
FroggyPlay joins the table at seat #6 
172140 joins the table at seat #1 
Igor DoUrden: bets $18.14
Spid1: calls $18.14
*** RIVER *** [7c 3h 4h Kh] [9c]
Spid1: checks 
Igor DoUrden: bets $66.48 and is all-in
Spid1: folds 
Uncalled bet ($66.48) returned to Igor DoUrden
Igor DoUrden collected $71.48 from pot
Igor DoUrden: doesn't show hand 
*** SUMMARY ***
Total pot $74.28 | Rake $2.80 
Board [7c 3h 4h Kh 9c]
Seat 2: tipner (big blind) folded before Flop
Seat 3: Sweden_Pound folded before Flop (didn't bet)
Seat 4: white huck folded before Flop (didn't bet)
Seat 5: matiko09 folded before Flop (didn't bet)
Seat 7: PacPacBum folded before Flop (didn't bet)
Seat 8: Igor DoUrden (button) collected ($71.48)
Seat 9: Spid1 (small blind) folded on the River





PokerStars Hand #150126829492:  Hold'em No Limit ($0.25/$0.50 USD) - 2016/03/10 13:50:23 CET [2016/03/10 7:50:23 ET]
Table 'Aegina' 9-max Seat #4 is the button
Seat 1: congcongnbnb ($166.77 in chips) 
Seat 2: Spid1 ($102.99 in chips) 
Seat 3: MyMilkCans=D ($125 in chips) 
Seat 4: digimatical ($66.28 in chips) 
Seat 5: Ahangama ($50.35 in chips) 
Seat 6: matiko09 ($69.67 in chips) 
Seat 7: Gummio ($115.17 in chips) 
Seat 8: ardo888 ($177.34 in chips) 
Seat 9: draken08 ($127.26 in chips) 
Ahangama: posts small blind $0.25
matiko09: posts big blind $0.50
congcongnbnb: posts big blind $0.50
congcongnbnb: posts the ante $0.10
Spid1: posts the ante $0.10
MyMilkCans=D: posts the ante $0.10
digimatical: posts the ante $0.10
Ahangama: posts the ante $0.10
matiko09: posts the ante $0.10
Gummio: posts the ante $0.10
ardo888: posts the ante $0.10
draken08: posts the ante $0.10
*** HOLE CARDS ***
Dealt to matiko09 [7h 5h]
Gummio: folds 
ardo888: folds 
draken08: folds 
congcongnbnb: checks 
Spid1: folds 
MyMilkCans=D: folds 
digimatical: calls $0.50
Ahangama: calls $0.25
matiko09: checks 
*** FLOP *** [Jh 9c Qc]
Ahangama: checks 
matiko09: checks 
congcongnbnb: bets $1.84
digimatical: calls $1.84
Ahangama: folds 
matiko09: folds 
*** TURN *** [Jh 9c Qc] [Js]
congcongnbnb: checks 
digimatical: checks 
*** RIVER *** [Jh 9c Qc Js] [5d]
congcongnbnb: checks 
digimatical: checks 
*** SHOW DOWN ***
congcongnbnb: shows [Ts 7d] (a pair of Jacks)
digimatical: shows [Kd 5c] (two pair, Jacks and Fives)
digimatical collected $6.28 from pot
*** SUMMARY ***
Total pot $6.58 | Rake $0.30 
Board [Jh 9c Qc Js 5d]
Seat 1: congcongnbnb showed [Ts 7d] and lost with a pair of Jacks
Seat 2: Spid1 folded before Flop (didn't bet)
Seat 3: MyMilkCans=D folded before Flop (didn't bet)
Seat 4: digimatical (button) showed [Kd 5c] and won ($6.28) with two pair, Jacks and Fives
Seat 5: Ahangama (small blind) folded on the Flop
Seat 6: matiko09 (big blind) folded on the Flop
Seat 7: Gummio folded before Flop (didn't bet)
Seat 8: ardo888 folded before Flop (didn't bet)
Seat 9: draken08 folded before Flop (didn't bet)





PokerStars Hand #150126835945:  Hold'em No Limit ($1/$2 USD) - 2016/03/10 13:50:35 CET [2016/03/10 7:50:35 ET]
Table 'Tauris II' 9-max Seat #5 is the button
Seat 1: matiko09 ($200 in chips) 
Seat 2: stds st ($55.95 in chips) 
Seat 3: PacPacBum ($280 in chips) 
Seat 4: neomorf ($658.52 in chips) 
Seat 5: tipner ($200 in chips) 
Seat 6: uonlylive1ce ($205.42 in chips) 
Seat 8: scout326 ($214.86 in chips) 
Seat 9: darren1031 ($193.01 in chips) 
uonlylive1ce: posts small blind $1
Fish4trips: is sitting out 
scout326: posts big blind $2
*** HOLE CARDS ***
Dealt to matiko09 [Tc 6h]
Fish4trips leaves the table
darren1031: folds 
Gamz11 joins the table at seat #7 
matiko09: folds 
stds st: folds 
PacPacBum: folds 
neomorf: raises $3.88 to $5.88
tipner: folds 
uonlylive1ce: folds 
scout326: folds 
Uncalled bet ($3.88) returned to neomorf
neomorf collected $5 from pot
neomorf: doesn't show hand 
*** SUMMARY ***
Total pot $5 | Rake $0 
Seat 1: matiko09 folded before Flop (didn't bet)
Seat 2: stds st folded before Flop (didn't bet)
Seat 3: PacPacBum folded before Flop (didn't bet)
Seat 4: neomorf collected ($5)
Seat 5: tipner (button) folded before Flop (didn't bet)
Seat 6: uonlylive1ce (small blind) folded before Flop
Seat 8: scout326 (big blind) folded before Flop
Seat 9: darren1031 folded before Flop (didn't bet)





PokerStars Hand #150126838229:  Hold'em No Limit ($0.50/$1.00 USD) - 2016/03/10 13:50:39 CET [2016/03/10 7:50:39 ET]
Table 'Iguassu' 9-max Seat #4 is the button
Seat 1: blackw0lf_03 ($100 in chips) 
Seat 2: Rocky6434 ($56.77 in chips) 
Seat 3: hammerwife ($121.93 in chips) 
Seat 4: matiko09 ($100 in chips) 
Seat 5: UnBent022 ($102 in chips) 
Seat 6: Igor DoUrden ($110.08 in chips) 
Seat 7: PacPacBum ($118.55 in chips) 
Seat 8: Filojoes ($137.39 in chips) 
Seat 9: er13to ($110.51 in chips) 
UnBent022: posts small blind $0.50
Igor DoUrden: posts big blind $1
*** HOLE CARDS ***
Dealt to matiko09 [6d 4d]
PacPacBum: folds 
Filojoes: folds 
er13to: folds 
blackw0lf_03: folds 
Rocky6434: raises $1 to $2
hammerwife: folds 
matiko09: folds 
UnBent022: folds 
Igor DoUrden: calls $1
*** FLOP *** [6s Kh 6c]
Igor DoUrden: checks 
Rocky6434: checks 
*** TURN *** [6s Kh 6c] [8c]
Igor DoUrden: checks 
Rocky6434: checks 
*** RIVER *** [6s Kh 6c 8c] [7s]
Igor DoUrden: checks 
Rocky6434: checks 
*** SHOW DOWN ***
Igor DoUrden: shows [As Td] (a pair of Sixes)
Rocky6434: mucks hand 
Igor DoUrden collected $4.30 from pot
*** SUMMARY ***
Total pot $4.50 | Rake $0.20 
Board [6s Kh 6c 8c 7s]
Seat 1: blackw0lf_03 folded before Flop (didn't bet)
Seat 2: Rocky6434 mucked [Qh 9h]
Seat 3: hammerwife folded before Flop (didn't bet)
Seat 4: matiko09 (button) folded before Flop (didn't bet)
Seat 5: UnBent022 (small blind) folded before Flop
Seat 6: Igor DoUrden (big blind) showed [As Td] and won ($4.30) with a pair of Sixes
Seat 7: PacPacBum folded before Flop (didn't bet)
Seat 8: Filojoes folded before Flop (didn't bet)
Seat 9: er13to folded before Flop (didn't bet)





PokerStars Hand #150126848454:  Hold'em No Limit ($0.50/$1.00 USD) - 2016/03/10 13:50:57 CET [2016/03/10 7:50:57 ET]
Table 'Leuschneria II' 9-max Seat #5 is the button
Seat 1: SHARKFIN168 ($94.79 in chips) 
Seat 2: blackw0lf_03 ($100 in chips) 
Seat 3: Spid1 ($115.54 in chips) 
Seat 4: Sweden_Pound ($133.72 in chips) 
Seat 5: RMilPoker ($223.20 in chips) 
Seat 6: matiko09 ($110.61 in chips) 
Seat 7: Plz3betMe ($39.50 in chips) 
Seat 8: UnBent022 ($103 in chips) 
Seat 9: ki11u ($100 in chips) 
matiko09: posts small blind $0.50
Plz3betMe: posts big blind $1
*** HOLE CARDS ***
Dealt to matiko09 [Td 8h]
UnBent022: folds 
ki11u: folds 
SHARKFIN168: folds 
blackw0lf_03: folds 
Spid1: folds 
Sweden_Pound: folds 
RMilPoker: folds 
matiko09: folds 
Uncalled bet ($0.50) returned to Plz3betMe
Plz3betMe collected $1 from pot
Plz3betMe: doesn't show hand 
*** SUMMARY ***
Total pot $1 | Rake $0 
Seat 1: SHARKFIN168 folded before Flop (didn't bet)
Seat 2: blackw0lf_03 folded before Flop (didn't bet)
Seat 3: Spid1 folded before Flop (didn't bet)
Seat 4: Sweden_Pound folded before Flop (didn't bet)
Seat 5: RMilPoker (button) folded before Flop (didn't bet)
Seat 6: matiko09 (small blind) folded before Flop
Seat 7: Plz3betMe (big blind) collected ($1)
Seat 8: UnBent022 folded before Flop (didn't bet)
Seat 9: ki11u folded before Flop (didn't bet)





PokerStars Hand #150126852535:  Hold'em No Limit ($1/$2 USD) - 2016/03/10 13:51:05 CET [2016/03/10 7:51:05 ET]
Table 'Tauris II' 9-max Seat #6 is the button
Seat 1: matiko09 ($200 in chips) 
Seat 2: stds st ($55.95 in chips) 
Seat 3: PacPacBum ($280 in chips) 
Seat 4: neomorf ($661.52 in chips) 
Seat 5: tipner ($200 in chips) 
Seat 6: uonlylive1ce ($204.42 in chips) 
Seat 8: scout326 ($212.86 in chips) 
Seat 9: darren1031 ($193.01 in chips) 
Gamz11 will be allowed to play after the button
scout326: posts small blind $1
darren1031: posts big blind $2
*** HOLE CARDS ***
Dealt to matiko09 [2h 4d]
matiko09: folds 
stds st: folds 
PacPacBum: raises $2.08 to $4.08
neomorf: folds 
tipner: calls $4.08
uonlylive1ce: folds 
scout326: raises $14.24 to $18.32
darren1031: calls $16.32
PacPacBum: calls $14.24
tipner: calls $14.24
*** FLOP *** [5h 8h 3s]
scout326: bets $42
darren1031: folds 
PacPacBum: folds 
tipner: folds 
Uncalled bet ($42) returned to scout326
scout326 collected $70.48 from pot
*** SUMMARY ***
Total pot $73.28 | Rake $2.80 
Board [5h 8h 3s]
Seat 1: matiko09 folded before Flop (didn't bet)
Seat 2: stds st folded before Flop (didn't bet)
Seat 3: PacPacBum folded on the Flop
Seat 4: neomorf folded before Flop (didn't bet)
Seat 5: tipner folded on the Flop
Seat 6: uonlylive1ce (button) folded before Flop (didn't bet)
Seat 8: scout326 (small blind) collected ($70.48)
Seat 9: darren1031 (big blind) folded on the Flop





PokerStars Hand #150126853232:  Hold'em No Limit (€1/€2 EUR) - 2016/03/10 13:51:06 CET [2016/03/10 7:51:06 ET]
Table 'Sigrid II' 9-max Seat #2 is the button
Seat 1: Gamz11 (€202 in chips) 
Seat 2: stds st (€103.51 in chips) 
Seat 5: vr188 (€79.03 in chips) 
Seat 7: PacPacBum (€200 in chips) 
Seat 8: matiko09 (€243.71 in chips) 
Seat 9: ki11u (€222.72 in chips) 
vr188: posts small blind €1
PacPacBum: posts big blind €2
*** HOLE CARDS ***
Dealt to matiko09 [Js 5c]
matiko09: folds 
ki11u: folds 
Gamz11: raises €2.92 to €4.92
stds st: folds 
vr188: folds 
PacPacBum: folds 
Uncalled bet (€2.92) returned to Gamz11
Gamz11 collected €5 from pot
*** SUMMARY ***
Total pot €5 | Rake €0 
Seat 1: Gamz11 collected (€5)
Seat 2: stds st (button) folded before Flop (didn't bet)
Seat 5: vr188 (small blind) folded before Flop
Seat 7: PacPacBum (big blind) folded before Flop
Seat 8: matiko09 folded before Flop (didn't bet)
Seat 9: ki11u folded before Flop (didn't bet)





PokerStars Hand #150126855810:  Hold'em No Limit ($1/$2 USD) - 2016/03/10 13:51:11 CET [2016/03/10 7:51:11 ET]
Table 'Solstice II' 9-max Seat #7 is the button
Seat 1: azzad2007 ($276.70 in chips) 
Seat 3: PacPacBum ($200 in chips) 
Seat 4: ki11u ($200 in chips) 
Seat 5: eKCimann 666 ($379.14 in chips) 
Seat 6: Gamz11 ($224.18 in chips) 
Seat 7: uonlylive1ce ($200 in chips) 
Seat 8: matiko09 ($200 in chips) 
Seat 9: zhang0204 ($200 in chips) 
matiko09: posts small blind $1
zhang0204: posts big blind $2
o.miro: sits out 
*** HOLE CARDS ***
Dealt to matiko09 [3h 7c]
azzad2007: folds 
PacPacBum: folds 
ki11u: folds 
eKCimann 666: folds 
Gamz11: folds 
uonlylive1ce: raises $2 to $4
matiko09: folds 
zhang0204: calls $2
*** FLOP *** [2d 9h Qh]
zhang0204: checks 
uonlylive1ce: bets $7
zhang0204: calls $7
*** TURN *** [2d 9h Qh] [6c]
zhang0204: checks 
uonlylive1ce: bets $17
zhang0204: folds 
Uncalled bet ($17) returned to uonlylive1ce
uonlylive1ce collected $21.96 from pot
uonlylive1ce: doesn't show hand 
*** SUMMARY ***
Total pot $23 | Rake $1.04 
Board [2d 9h Qh 6c]
Seat 1: azzad2007 folded before Flop (didn't bet)
Seat 3: PacPacBum folded before Flop (didn't bet)
Seat 4: ki11u folded before Flop (didn't bet)
Seat 5: eKCimann 666 folded before Flop (didn't bet)
Seat 6: Gamz11 folded before Flop (didn't bet)
Seat 7: uonlylive1ce (button) collected ($21.96)
Seat 8: matiko09 (small blind) folded before Flop
Seat 9: zhang0204 (big blind) folded on the Turn





PokerStars Hand #150126861645:  Hold'em No Limit ($0.50/$1.00 USD) - 2016/03/10 13:51:22 CET [2016/03/10 7:51:22 ET]
Table 'Iguassu' 9-max Seat #5 is the button
Seat 1: blackw0lf_03 ($100 in chips) 
Seat 2: Rocky6434 ($54.77 in chips) 
Seat 3: hammerwife ($121.93 in chips) 
Seat 4: matiko09 ($100 in chips) 
Seat 5: UnBent022 ($101.50 in chips) 
Seat 6: Igor DoUrden ($112.38 in chips) 
Seat 7: PacPacBum ($118.55 in chips) 
Seat 8: Filojoes ($137.39 in chips) 
Seat 9: er13to ($110.51 in chips) 
Igor DoUrden: posts small blind $0.50
PacPacBum: posts big blind $1
*** HOLE CARDS ***
Dealt to matiko09 [Jc As]
Filojoes: folds 
er13to: folds 
blackw0lf_03: folds 
Rocky6434: folds 
hammerwife: folds 
matiko09: raises $1.50 to $2.50
UnBent022: raises $5.50 to $8
Igor DoUrden: folds 
PacPacBum: folds 
matiko09: raises $10 to $18
UnBent022: folds 
Uncalled bet ($10) returned to matiko09
matiko09 collected $17.50 from pot
matiko09: doesn't show hand 
*** SUMMARY ***
Total pot $17.50 | Rake $0 
Seat 1: blackw0lf_03 folded before Flop (didn't bet)
Seat 2: Rocky6434 folded before Flop (didn't bet)
Seat 3: hammerwife folded before Flop (didn't bet)
Seat 4: matiko09 collected ($17.50)
Seat 5: UnBent022 (button) folded before Flop
Seat 6: Igor DoUrden (small blind) folded before Flop
Seat 7: PacPacBum (big blind) folded before Flop
Seat 8: Filojoes folded before Flop (didn't bet)
Seat 9: er13to folded before Flop (didn't bet)





PokerStars Hand #150126864817:  Hold'em No Limit (€1/€2 EUR) - 2016/03/10 13:51:27 CET [2016/03/10 7:51:27 ET]
Table 'Sigrid II' 9-max Seat #5 is the button
Seat 1: Gamz11 (€205 in chips) 
Seat 2: stds st (€103.51 in chips) 
Seat 5: vr188 (€78.03 in chips) 
Seat 7: PacPacBum (€200 in chips) 
Seat 8: matiko09 (€243.71 in chips) 
Seat 9: ki11u (€222.72 in chips) 
PacPacBum: posts small blind €1
matiko09: posts big blind €2
*** HOLE CARDS ***
Dealt to matiko09 [4s Qs]
ki11u: folds 
Gamz11: raises €4 to €6
stds st: folds 
vr188: folds 
PacPacBum: folds 
matiko09: folds 
Uncalled bet (€4) returned to Gamz11
Gamz11 collected €5 from pot
*** SUMMARY ***
Total pot €5 | Rake €0 
Seat 1: Gamz11 collected (€5)
Seat 2: stds st folded before Flop (didn't bet)
Seat 5: vr188 (button) folded before Flop (didn't bet)
Seat 7: PacPacBum (small blind) folded before Flop
Seat 8: matiko09 (big blind) folded before Flop
Seat 9: ki11u folded before Flop (didn't bet)





PokerStars Hand #150126868221:  Hold'em No Limit ($0.50/$1.00 USD) - 2016/03/10 13:51:34 CET [2016/03/10 7:51:34 ET]
Table 'Leuschneria II' 9-max Seat #6 is the button
Seat 1: SHARKFIN168 ($94.79 in chips) 
Seat 2: blackw0lf_03 ($100 in chips) 
Seat 3: Spid1 ($115.54 in chips) 
Seat 4: Sweden_Pound ($133.72 in chips) 
Seat 5: RMilPoker ($223.20 in chips) 
Seat 6: matiko09 ($110.11 in chips) 
Seat 7: Plz3betMe ($40 in chips) 
Seat 8: UnBent022 ($103 in chips) 
Seat 9: ki11u ($100 in chips) 
Plz3betMe: posts small blind $0.50
UnBent022: posts big blind $1
*** HOLE CARDS ***
Dealt to matiko09 [8c 6h]
ki11u: raises $1.50 to $2.50
SHARKFIN168: folds 
blackw0lf_03: folds 
Spid1: folds 
Sweden_Pound: folds 
RMilPoker: folds 
matiko09: folds 
Plz3betMe: folds 
UnBent022: folds 
Uncalled bet ($1.50) returned to ki11u
ki11u collected $2.50 from pot
ki11u: doesn't show hand 
*** SUMMARY ***
Total pot $2.50 | Rake $0 
Seat 1: SHARKFIN168 folded before Flop (didn't bet)
Seat 2: blackw0lf_03 folded before Flop (didn't bet)
Seat 3: Spid1 folded before Flop (didn't bet)
Seat 4: Sweden_Pound folded before Flop (didn't bet)
Seat 5: RMilPoker folded before Flop (didn't bet)
Seat 6: matiko09 (button) folded before Flop (didn't bet)
Seat 7: Plz3betMe (small blind) folded before Flop
Seat 8: UnBent022 (big blind) folded before Flop
Seat 9: ki11u collected ($2.50)





PokerStars Hand #150126873984:  Hold'em No Limit ($0.25/$0.50 USD) - 2016/03/10 13:51:44 CET [2016/03/10 7:51:44 ET]
Table 'Aegina' 9-max Seat #5 is the button
Seat 1: congcongnbnb ($164.33 in chips) 
Seat 2: Spid1 ($102.89 in chips) 
Seat 3: MyMilkCans=D ($125 in chips) 
Seat 4: digimatical ($70.12 in chips) 
Seat 5: Ahangama ($50 in chips) 
Seat 6: matiko09 ($69.07 in chips) 
Seat 7: Gummio ($115.07 in chips) 
Seat 8: ardo888 ($177.24 in chips) 
Seat 9: draken08 ($127.16 in chips) 
matiko09: posts small blind $0.25
Gummio: posts big blind $0.50
congcongnbnb: posts the ante $0.10
Spid1: posts the ante $0.10
MyMilkCans=D: posts the ante $0.10
digimatical: posts the ante $0.10
Ahangama: posts the ante $0.10
matiko09: posts the ante $0.10
Gummio: posts the ante $0.10
ardo888: posts the ante $0.10
draken08: posts the ante $0.10
*** HOLE CARDS ***
Dealt to matiko09 [Qs 4d]
ardo888: raises $1.50 to $2
draken08: folds 
congcongnbnb: folds 
Spid1: folds 
MyMilkCans=D: calls $2
digimatical: folds 
Ahangama: folds 
matiko09: folds 
Gummio: folds 
*** FLOP *** [Jh 2c Qc]
ardo888: checks 
MyMilkCans=D: bets $4.02
ardo888: calls $4.02
*** TURN *** [Jh 2c Qc] [Td]
ardo888: checks 
MyMilkCans=D: bets $16.07
ardo888: folds 
Uncalled bet ($16.07) returned to MyMilkCans=D
MyMilkCans=D collected $13.07 from pot
MyMilkCans=D: doesn't show hand 
*** SUMMARY ***
Total pot $13.69 | Rake $0.62 
Board [Jh 2c Qc Td]
Seat 1: congcongnbnb folded before Flop (didn't bet)
Seat 2: Spid1 folded before Flop (didn't bet)
Seat 3: MyMilkCans=D collected ($13.07)
Seat 4: digimatical folded before Flop (didn't bet)
Seat 5: Ahangama (button) folded before Flop (didn't bet)
Seat 6: matiko09 (small blind) folded before Flop
Seat 7: Gummio (big blind) folded before Flop
Seat 8: ardo888 folded on the Turn
Seat 9: draken08 folded before Flop (didn't bet)





PokerStars Hand #150126875887:  Hold'em No Limit (€1/€2 EUR) - 2016/03/10 13:51:47 CET [2016/03/10 7:51:47 ET]
Table 'Sigrid II' 9-max Seat #7 is the button
Seat 1: Gamz11 (€208 in chips) 
Seat 2: stds st (€103.51 in chips) 
Seat 5: vr188 (€78.03 in chips) 
Seat 7: PacPacBum (€200 in chips) 
Seat 8: matiko09 (€241.71 in chips) 
Seat 9: ki11u (€222.72 in chips) 
matiko09: posts small blind €1
ki11u: posts big blind €2
*** HOLE CARDS ***
Dealt to matiko09 [4h Jc]
Gamz11: folds 
stds st: folds 
vr188: folds 
PacPacBum: folds 
matiko09: folds 
Uncalled bet (€1) returned to ki11u
ki11u collected €2 from pot
ki11u: doesn't show hand 
*** SUMMARY ***
Total pot €2 | Rake €0 
Seat 1: Gamz11 folded before Flop (didn't bet)
Seat 2: stds st folded before Flop (didn't bet)
Seat 5: vr188 folded before Flop (didn't bet)
Seat 7: PacPacBum (button) folded before Flop (didn't bet)
Seat 8: matiko09 (small blind) folded before Flop
Seat 9: ki11u (big blind) collected (€2)





PokerStars Hand #150126886894:  Hold'em No Limit ($0.50/$1.00 USD) - 2016/03/10 13:52:08 CET [2016/03/10 7:52:08 ET]
Table 'Leuschneria II' 9-max Seat #7 is the button
Seat 1: SHARKFIN168 ($94.79 in chips) 
Seat 2: blackw0lf_03 ($100 in chips) 
Seat 3: Spid1 ($115.54 in chips) 
Seat 4: Sweden_Pound ($133.72 in chips) 
Seat 5: RMilPoker ($223.20 in chips) 
Seat 6: matiko09 ($110.11 in chips) 
Seat 7: Plz3betMe ($39.50 in chips) 
Seat 8: UnBent022 ($102 in chips) 
Seat 9: ki11u ($101.50 in chips) 
UnBent022: posts small blind $0.50
ki11u: posts big blind $1
*** HOLE CARDS ***
Dealt to matiko09 [3d 6s]
SHARKFIN168: raises $1 to $2
blackw0lf_03: folds 
Spid1: folds 
Sweden_Pound: folds 
RMilPoker: folds 
matiko09: folds 
Plz3betMe: calls $2
UnBent022: folds 
ki11u: folds 
*** FLOP *** [Ad 2s Ah]
SHARKFIN168: checks 
Plz3betMe: checks 
*** TURN *** [Ad 2s Ah] [Js]
SHARKFIN168: bets $2
Plz3betMe: calls $2
*** RIVER *** [Ad 2s Ah Js] [5d]
SHARKFIN168: checks 
Plz3betMe: checks 
*** SHOW DOWN ***
SHARKFIN168: shows [6h 6d] (two pair, Aces and Sixes)
Plz3betMe: shows [Jh 9h] (two pair, Aces and Jacks)
Plz3betMe collected $9.07 from pot
*** SUMMARY ***
Total pot $9.50 | Rake $0.43 
Board [Ad 2s Ah Js 5d]
Seat 1: SHARKFIN168 showed [6h 6d] and lost with two pair, Aces and Sixes
Seat 2: blackw0lf_03 folded before Flop (didn't bet)
Seat 3: Spid1 folded before Flop (didn't bet)
Seat 4: Sweden_Pound folded before Flop (didn't bet)
Seat 5: RMilPoker folded before Flop (didn't bet)
Seat 6: matiko09 folded before Flop (didn't bet)
Seat 7: Plz3betMe (button) showed [Jh 9h] and won ($9.07) with two pair, Aces and Jacks
Seat 8: UnBent022 (small blind) folded before Flop
Seat 9: ki11u (big blind) folded before Flop





PokerStars Hand #150126887234:  Hold'em No Limit (€1/€2 EUR) - 2016/03/10 13:52:08 CET [2016/03/10 7:52:08 ET]
Table 'Sigrid II' 9-max Seat #8 is the button
Seat 1: Gamz11 (€208 in chips) 
Seat 2: stds st (€103.51 in chips) 
Seat 5: vr188 (€78.03 in chips) 
Seat 7: PacPacBum (€200 in chips) 
Seat 8: matiko09 (€240.71 in chips) 
Seat 9: ki11u (€223.72 in chips) 
ki11u: posts small blind €1
Gamz11: posts big blind €2
*** HOLE CARDS ***
Dealt to matiko09 [Ts 2h]
stds st: folds 
vr188: folds 
PacPacBum: folds 
matiko09: folds 
ki11u: folds 
Uncalled bet (€1) returned to Gamz11
Gamz11 collected €2 from pot
*** SUMMARY ***
Total pot €2 | Rake €0 
Seat 1: Gamz11 (big blind) collected (€2)
Seat 2: stds st folded before Flop (didn't bet)
Seat 5: vr188 folded before Flop (didn't bet)
Seat 7: PacPacBum folded before Flop (didn't bet)
Seat 8: matiko09 (button) folded before Flop (didn't bet)
Seat 9: ki11u (small blind) folded before Flop





PokerStars Hand #150126902430:  Hold'em No Limit ($1/$2 USD) - 2016/03/10 13:52:36 CET [2016/03/10 7:52:36 ET]
Table 'Chandra II' 9-max Seat #6 is the button
Seat 1: Fish4trips ($250.52 in chips) 
Seat 2: PacPacBum ($251.32 in chips) 
Seat 4: tipner ($200 in chips) 
Seat 5: uibting ($210.70 in chips) 
Seat 6: stds st ($68.31 in chips) 
Seat 7: johnvu2016 ($133.25 in chips) 
Seat 8: matiko09 ($260.99 in chips) 
Seat 9: o.miro ($315.47 in chips) 
johnvu2016: posts small blind $1
matiko09: posts big blind $2
uonlylive1ce: sits out 
*** HOLE CARDS ***
Dealt to matiko09 [4d 5h]
o.miro: folds 
Fish4trips: folds 
PacPacBum: folds 
tipner: raises $4 to $6
uibting: folds 
stds st: folds 
johnvu2016: folds 
matiko09: folds 
Uncalled bet ($4) returned to tipner
tipner collected $5 from pot
tipner: doesn't show hand 
*** SUMMARY ***
Total pot $5 | Rake $0 
Seat 1: Fish4trips folded before Flop (didn't bet)
Seat 2: PacPacBum folded before Flop (didn't bet)
Seat 4: tipner collected ($5)
Seat 5: uibting folded before Flop (didn't bet)
Seat 6: stds st (button) folded before Flop (didn't bet)
Seat 7: johnvu2016 (small blind) folded before Flop
Seat 8: matiko09 (big blind) folded before Flop
Seat 9: o.miro folded before Flop (didn't bet)





PokerStars Hand #150126905510:  Hold'em No Limit (€1/€2 EUR) - 2016/03/10 13:52:42 CET [2016/03/10 7:52:42 ET]
Table 'Sigrid II' 9-max Seat #9 is the button
Seat 1: Gamz11 (€209 in chips) 
Seat 2: stds st (€103.51 in chips) 
Seat 5: vr188 (€78.03 in chips) 
Seat 7: PacPacBum (€200 in chips) 
Seat 8: matiko09 (€240.71 in chips) 
Seat 9: ki11u (€222.72 in chips) 
Gamz11: posts small blind €1
stds st: posts big blind €2
*** HOLE CARDS ***
Dealt to matiko09 [As 4h]
vr188: folds 
PacPacBum: folds 
matiko09: folds 
ki11u: raises €2.30 to €4.30
Gamz11: folds 
stds st: folds 
Uncalled bet (€2.30) returned to ki11u
ki11u collected €5 from pot
ki11u: doesn't show hand 
*** SUMMARY ***
Total pot €5 | Rake €0 
Seat 1: Gamz11 (small blind) folded before Flop
Seat 2: stds st (big blind) folded before Flop
Seat 5: vr188 folded before Flop (didn't bet)
Seat 7: PacPacBum folded before Flop (didn't bet)
Seat 8: matiko09 folded before Flop (didn't bet)
Seat 9: ki11u (button) collected (€5)





PokerStars Hand #150126906528:  Hold'em No Limit ($1/$2 USD) - 2016/03/10 13:52:44 CET [2016/03/10 7:52:44 ET]
Table 'Solstice II' 9-max Seat #8 is the button
Seat 1: azzad2007 ($276.70 in chips) 
Seat 3: PacPacBum ($200 in chips) 
Seat 4: ki11u ($200 in chips) 
Seat 5: eKCimann 666 ($379.14 in chips) 
Seat 6: Gamz11 ($224.18 in chips) 
Seat 7: uonlylive1ce ($210.96 in chips) 
Seat 8: matiko09 ($200 in chips) 
Seat 9: zhang0204 ($189 in chips) 
zhang0204: posts small blind $1
azzad2007: posts big blind $2
o.miro: sits out 
*** HOLE CARDS ***
Dealt to matiko09 [Jh 9s]
PacPacBum: folds 
ki11u: folds 
eKCimann 666: folds 
Gamz11: folds 
uonlylive1ce: folds 
matiko09: raises $2.54 to $4.54
zhang0204: calls $3.54
azzad2007: calls $2.54
*** FLOP *** [Kd Td 4d]
zhang0204: checks 
azzad2007: bets $10.40
matiko09: folds 
zhang0204: calls $10.40
*** TURN *** [Kd Td 4d] [Qd]
zhang0204: checks 
azzad2007: bets $18
zhang0204: raises $34 to $52
azzad2007: folds 
Uncalled bet ($34) returned to zhang0204
zhang0204 collected $67.62 from pot
*** SUMMARY ***
Total pot $70.42 | Rake $2.80 
Board [Kd Td 4d Qd]
Seat 1: azzad2007 (big blind) folded on the Turn
Seat 3: PacPacBum folded before Flop (didn't bet)
Seat 4: ki11u folded before Flop (didn't bet)
Seat 5: eKCimann 666 folded before Flop (didn't bet)
Seat 6: Gamz11 folded before Flop (didn't bet)
Seat 7: uonlylive1ce folded before Flop (didn't bet)
Seat 8: matiko09 (button) folded on the Flop
Seat 9: zhang0204 (small blind) collected ($67.62)





PokerStars Hand #150126913047:  Hold'em No Limit ($0.50/$1.00 USD) - 2016/03/10 13:52:55 CET [2016/03/10 7:52:55 ET]
Table 'Iguassu' 9-max Seat #6 is the button
Seat 1: blackw0lf_03 ($100 in chips) 
Seat 2: Rocky6434 ($54.77 in chips) 
Seat 3: hammerwife ($121.93 in chips) 
Seat 4: matiko09 ($109.50 in chips) 
Seat 5: UnBent022 ($100 in chips) 
Seat 6: Igor DoUrden ($111.88 in chips) 
Seat 7: PacPacBum ($117.55 in chips) 
Seat 8: Filojoes ($137.39 in chips) 
Seat 9: er13to ($110.51 in chips) 
PacPacBum: posts small blind $0.50
Filojoes: posts big blind $1
*** HOLE CARDS ***
Dealt to matiko09 [Jc 6d]
er13to: folds 
blackw0lf_03: folds 
Rocky6434: folds 
hammerwife: folds 
matiko09: folds 
UnBent022: folds 
Igor DoUrden: raises $1 to $2
PacPacBum: folds 
Filojoes: raises $6.50 to $8.50
Igor DoUrden: folds 
Uncalled bet ($6.50) returned to Filojoes
Filojoes collected $4.50 from pot
Filojoes: doesn't show hand 
*** SUMMARY ***
Total pot $4.50 | Rake $0 
Seat 1: blackw0lf_03 folded before Flop (didn't bet)
Seat 2: Rocky6434 folded before Flop (didn't bet)
Seat 3: hammerwife folded before Flop (didn't bet)
Seat 4: matiko09 folded before Flop (didn't bet)
Seat 5: UnBent022 folded before Flop (didn't bet)
Seat 6: Igor DoUrden (button) folded before Flop
Seat 7: PacPacBum (small blind) folded before Flop
Seat 8: Filojoes (big blind) collected ($4.50)
Seat 9: er13to folded before Flop (didn't bet)





PokerStars Hand #150126914897:  Hold'em No Limit ($1/$2 USD) - 2016/03/10 13:52:59 CET [2016/03/10 7:52:59 ET]
Table 'Tauris II' 9-max Seat #8 is the button
Seat 1: matiko09 ($200 in chips) 
Seat 2: stds st ($55.95 in chips) 
Seat 3: PacPacBum ($261.68 in chips) 
Seat 4: neomorf ($661.52 in chips) 
Seat 5: tipner ($200 in chips) 
Seat 6: uonlylive1ce ($204.42 in chips) 
Seat 8: scout326 ($265.02 in chips) 
Seat 9: darren1031 ($174.69 in chips) 
darren1031: posts small blind $1
matiko09: posts big blind $2
Gamz11: sits out 
*** HOLE CARDS ***
Dealt to matiko09 [Ks 5c]
stds st: folds 
PacPacBum: folds 
neomorf: folds 
tipner: folds 
uonlylive1ce: folds 
scout326: raises $4 to $6
darren1031: folds 
matiko09: folds 
Uncalled bet ($4) returned to scout326
scout326 collected $5 from pot
*** SUMMARY ***
Total pot $5 | Rake $0 
Seat 1: matiko09 (big blind) folded before Flop
Seat 2: stds st folded before Flop (didn't bet)
Seat 3: PacPacBum folded before Flop (didn't bet)
Seat 4: neomorf folded before Flop (didn't bet)
Seat 5: tipner folded before Flop (didn't bet)
Seat 6: uonlylive1ce folded before Flop (didn't bet)
Seat 8: scout326 (button) collected ($5)
Seat 9: darren1031 (small blind) folded before Flop





PokerStars Hand #150126916362:  Hold'em No Limit ($1/$2 USD) - 2016/03/10 13:53:01 CET [2016/03/10 7:53:01 ET]
Table 'Chandra II' 9-max Seat #7 is the button
Seat 1: Fish4trips ($250.52 in chips) 
Seat 2: PacPacBum ($251.32 in chips) 
Seat 4: tipner ($203 in chips) 
Seat 5: uibting ($210.70 in chips) 
Seat 6: stds st ($68.31 in chips) 
Seat 7: johnvu2016 ($132.25 in chips) 
Seat 8: matiko09 ($258.99 in chips) 
Seat 9: o.miro ($315.47 in chips) 
matiko09: posts small blind $1
o.miro: posts big blind $2
uonlylive1ce: sits out 
*** HOLE CARDS ***
Dealt to matiko09 [Kh Ks]
Fish4trips: folds 
PacPacBum: folds 
tipner: folds 
uibting: folds 
stds st: raises $2.04 to $4.04
johnvu2016: folds 
matiko09: raises $9.96 to $14
o.miro: folds 
stds st: raises $54.31 to $68.31 and is all-in
matiko09: calls $54.31
*** FLOP *** [5d Jd 4c]
*** TURN *** [5d Jd 4c] [2d]
*** RIVER *** [5d Jd 4c 2d] [9d]
*** SHOW DOWN ***
matiko09: shows [Kh Ks] (a pair of Kings)
stds st: shows [Ah As] (a pair of Aces)
stds st collected $135.82 from pot
*** SUMMARY ***
Total pot $138.62 | Rake $2.80 
Board [5d Jd 4c 2d 9d]
Seat 1: Fish4trips folded before Flop (didn't bet)
Seat 2: PacPacBum folded before Flop (didn't bet)
Seat 4: tipner folded before Flop (didn't bet)
Seat 5: uibting folded before Flop (didn't bet)
Seat 6: stds st showed [Ah As] and won ($135.82) with a pair of Aces
Seat 7: johnvu2016 (button) folded before Flop (didn't bet)
Seat 8: matiko09 (small blind) showed [Kh Ks] and lost with a pair of Kings
Seat 9: o.miro (big blind) folded before Flop





PokerStars Hand #150126918194:  Hold'em No Limit ($0.50/$1.00 USD) - 2016/03/10 13:53:05 CET [2016/03/10 7:53:05 ET]
Table 'Opik' 9-max Seat #9 is the button
Seat 2: tipner ($100 in chips) 
Seat 4: white huck ($60 in chips) 
Seat 5: matiko09 ($113.77 in chips) 
Seat 7: PacPacBum ($101 in chips) 
Seat 8: Igor DoUrden ($137.96 in chips) 
Seat 9: Spid1 ($100 in chips) 
172140 will be allowed to play after the button
tipner: posts small blind $0.50
Sweden_Pound: is sitting out 
white huck: posts big blind $1
FroggyPlay: sits out 
*** HOLE CARDS ***
Dealt to matiko09 [Qd 4d]
Sweden_Pound leaves the table
Filojoes joins the table at seat #3 
matiko09: folds 
PacPacBum: raises $1.04 to $2.04
Igor DoUrden: calls $2.04
Spid1: folds 
tipner: folds 
white huck: folds 
*** FLOP *** [Kc 3h Th]
PacPacBum: checks 
Igor DoUrden: checks 
*** TURN *** [Kc 3h Th] [7h]
PacPacBum: checks 
Igor DoUrden: checks 
*** RIVER *** [Kc 3h Th 7h] [Ts]
PacPacBum: checks 
Igor DoUrden: checks 
*** SHOW DOWN ***
PacPacBum: shows [7c Ac] (two pair, Tens and Sevens)
Igor DoUrden: mucks hand 
PacPacBum collected $5.33 from pot
172140 is disconnected 
*** SUMMARY ***
Total pot $5.58 | Rake $0.25 
Board [Kc 3h Th 7h Ts]
Seat 2: tipner (small blind) folded before Flop
Seat 4: white huck (big blind) folded before Flop
Seat 5: matiko09 folded before Flop (didn't bet)
Seat 7: PacPacBum showed [7c Ac] and won ($5.33) with two pair, Tens and Sevens
Seat 8: Igor DoUrden mucked [2s 2h]
Seat 9: Spid1 (button) folded before Flop (didn't bet)





PokerStars Hand #150126919206:  Hold'em No Limit (€1/€2 EUR) - 2016/03/10 13:53:07 CET [2016/03/10 7:53:07 ET]
Table 'Sigrid II' 9-max Seat #1 is the button
Seat 1: Gamz11 (€208 in chips) 
Seat 2: stds st (€101.51 in chips) 
Seat 5: vr188 (€78.03 in chips) 
Seat 7: PacPacBum (€200 in chips) 
Seat 8: matiko09 (€240.71 in chips) 
Seat 9: ki11u (€225.72 in chips) 
stds st: posts small blind €1
vr188: posts big blind €2
*** HOLE CARDS ***
Dealt to matiko09 [6d Jd]
PacPacBum: folds 
matiko09: folds 
ki11u: raises €3.10 to €5.10
Gamz11: folds 
stds st: folds 
vr188: folds 
Uncalled bet (€3.10) returned to ki11u
ki11u collected €5 from pot
ki11u: doesn't show hand 
*** SUMMARY ***
Total pot €5 | Rake €0 
Seat 1: Gamz11 (button) folded before Flop (didn't bet)
Seat 2: stds st (small blind) folded before Flop
Seat 5: vr188 (big blind) folded before Flop
Seat 7: PacPacBum folded before Flop (didn't bet)
Seat 8: matiko09 folded before Flop (didn't bet)
Seat 9: ki11u collected (€5)





PokerStars Hand #150126929087:  Hold'em No Limit ($1/$2 USD) - 2016/03/10 13:53:25 CET [2016/03/10 7:53:25 ET]
Table 'Tauris II' 9-max Seat #9 is the button
Seat 1: matiko09 ($200 in chips) 
Seat 2: stds st ($55.95 in chips) 
Seat 3: PacPacBum ($261.68 in chips) 
Seat 4: neomorf ($661.52 in chips) 
Seat 5: tipner ($200 in chips) 
Seat 6: uonlylive1ce ($204.42 in chips) 
Seat 8: scout326 ($268.02 in chips) 
Seat 9: darren1031 ($173.69 in chips) 
matiko09: posts small blind $1
stds st: posts big blind $2
Gamz11: sits out 
*** HOLE CARDS ***
Dealt to matiko09 [As 8h]
PacPacBum: folds 
neomorf: folds 
tipner: folds 
uonlylive1ce: folds 
scout326: folds 
darren1031: calls $2
matiko09: calls $1
stds st: checks 
*** FLOP *** [2h 5c Qd]
matiko09: checks 
stds st: checks 
darren1031: checks 
*** TURN *** [2h 5c Qd] [5s]
matiko09: checks 
stds st: checks 
darren1031: bets $5.73
matiko09: folds 
stds st: folds 
Uncalled bet ($5.73) returned to darren1031
darren1031 collected $5.73 from pot
*** SUMMARY ***
Total pot $6 | Rake $0.27 
Board [2h 5c Qd 5s]
Seat 1: matiko09 (small blind) folded on the Turn
Seat 2: stds st (big blind) folded on the Turn
Seat 3: PacPacBum folded before Flop (didn't bet)
Seat 4: neomorf folded before Flop (didn't bet)
Seat 5: tipner folded before Flop (didn't bet)
Seat 6: uonlylive1ce folded before Flop (didn't bet)
Seat 8: scout326 folded before Flop (didn't bet)
Seat 9: darren1031 (button) collected ($5.73)





PokerStars Hand #150126934267:  Hold'em No Limit ($0.25/$0.50 USD) - 2016/03/10 13:53:34 CET [2016/03/10 7:53:34 ET]
Table 'Aegina' 9-max Seat #6 is the button
Seat 1: congcongnbnb ($164.23 in chips) 
Seat 2: Spid1 ($102.79 in chips) 
Seat 3: MyMilkCans=D ($131.95 in chips) 
Seat 4: digimatical ($70.02 in chips) 
Seat 5: Ahangama ($50 in chips) 
Seat 6: matiko09 ($68.72 in chips) 
Seat 7: Gummio ($114.47 in chips) 
Seat 8: ardo888 ($171.12 in chips) 
Seat 9: draken08 ($127.06 in chips) 
Gummio: posts small blind $0.25
ardo888: posts big blind $0.50
congcongnbnb: posts the ante $0.10
Spid1: posts the ante $0.10
MyMilkCans=D: posts the ante $0.10
digimatical: posts the ante $0.10
Ahangama: posts the ante $0.10
matiko09: posts the ante $0.10
Gummio: posts the ante $0.10
ardo888: posts the ante $0.10
draken08: posts the ante $0.10
*** HOLE CARDS ***
Dealt to matiko09 [6h 2s]
draken08: folds 
congcongnbnb: raises $1.50 to $2
Spid1: folds 
MyMilkCans=D: folds 
digimatical: calls $2
Ahangama: folds 
matiko09: folds 
Gummio: folds 
ardo888: folds 
*** FLOP *** [Ac 2c Tc]
congcongnbnb: bets $3
digimatical: calls $3
*** TURN *** [Ac 2c Tc] [5s]
congcongnbnb: checks 
digimatical: bets $11.13
congcongnbnb: calls $11.13
*** RIVER *** [Ac 2c Tc 5s] [Ad]
congcongnbnb: checks 
digimatical: bets $53.79 and is all-in
congcongnbnb: calls $53.79
*** SHOW DOWN ***
digimatical: shows [Qc Kc] (a flush, Ace high)
congcongnbnb: shows [Ah Jh] (three of a kind, Aces)
digimatical collected $138.99 from pot
*** SUMMARY ***
Total pot $141.49 | Rake $2.50 
Board [Ac 2c Tc 5s Ad]
Seat 1: congcongnbnb showed [Ah Jh] and lost with three of a kind, Aces
Seat 2: Spid1 folded before Flop (didn't bet)
Seat 3: MyMilkCans=D folded before Flop (didn't bet)
Seat 4: digimatical showed [Qc Kc] and won ($138.99) with a flush, Ace high
Seat 5: Ahangama folded before Flop (didn't bet)
Seat 6: matiko09 (button) folded before Flop (didn't bet)
Seat 7: Gummio (small blind) folded before Flop
Seat 8: ardo888 (big blind) folded before Flop
Seat 9: draken08 folded before Flop (didn't bet)





PokerStars Hand #150126940849:  Hold'em No Limit (€1/€2 EUR) - 2016/03/10 13:53:46 CET [2016/03/10 7:53:46 ET]
Table 'Sigrid II' 9-max Seat #2 is the button
Seat 1: Gamz11 (€208 in chips) 
Seat 2: stds st (€100.51 in chips) 
Seat 5: vr188 (€76.03 in chips) 
Seat 7: PacPacBum (€200 in chips) 
Seat 8: matiko09 (€240.71 in chips) 
Seat 9: ki11u (€228.72 in chips) 
vr188: posts small blind €1
PacPacBum: posts big blind €2
*** HOLE CARDS ***
Dealt to matiko09 [Ad 6d]
matiko09: folds 
ki11u: folds 
Gamz11: folds 
stds st: raises €2 to €4
RoadtoNepal leaves the table
vr188: folds 
PacPacBum: raises €10 to €14
stds st: folds 
Uncalled bet (€10) returned to PacPacBum
PacPacBum collected €9 from pot
PacPacBum: doesn't show hand 
*** SUMMARY ***
Total pot €9 | Rake €0 
Seat 1: Gamz11 folded before Flop (didn't bet)
Seat 2: stds st (button) folded before Flop
Seat 5: vr188 (small blind) folded before Flop
Seat 7: PacPacBum (big blind) collected (€9)
Seat 8: matiko09 folded before Flop (didn't bet)
Seat 9: ki11u folded before Flop (didn't bet)





PokerStars Hand #150126941059:  Hold'em No Limit ($0.50/$1.00 USD) - 2016/03/10 13:53:47 CET [2016/03/10 7:53:47 ET]
Table 'Iguassu' 9-max Seat #7 is the button
Seat 1: blackw0lf_03 ($100 in chips) 
Seat 2: Rocky6434 ($54.77 in chips) 
Seat 3: hammerwife ($121.93 in chips) 
Seat 4: matiko09 ($109.50 in chips) 
Seat 5: UnBent022 ($100 in chips) 
Seat 6: Igor DoUrden ($109.88 in chips) 
Seat 7: PacPacBum ($117.05 in chips) 
Seat 8: Filojoes ($139.89 in chips) 
Seat 9: er13to ($110.51 in chips) 
Filojoes: posts small blind $0.50
er13to: posts big blind $1
*** HOLE CARDS ***
Dealt to matiko09 [Kd 9s]
blackw0lf_03: folds 
Rocky6434: raises $1 to $2
hammerwife: folds 
matiko09: folds 
UnBent022: folds 
Igor DoUrden: folds 
PacPacBum: folds 
Filojoes: calls $1.50
er13to: calls $1
*** FLOP *** [4d 5h 7h]
Filojoes: bets $3.44
er13to: folds 
Rocky6434: folds 
Uncalled bet ($3.44) returned to Filojoes
Filojoes collected $5.73 from pot
Filojoes: doesn't show hand 
*** SUMMARY ***
Total pot $6 | Rake $0.27 
Board [4d 5h 7h]
Seat 1: blackw0lf_03 folded before Flop (didn't bet)
Seat 2: Rocky6434 folded on the Flop
Seat 3: hammerwife folded before Flop (didn't bet)
Seat 4: matiko09 folded before Flop (didn't bet)
Seat 5: UnBent022 folded before Flop (didn't bet)
Seat 6: Igor DoUrden folded before Flop (didn't bet)
Seat 7: PacPacBum (button) folded before Flop (didn't bet)
Seat 8: Filojoes (small blind) collected ($5.73)
Seat 9: er13to (big blind) folded on the Flop





PokerStars Hand #150126941987:  Hold'em No Limit ($0.50/$1.00 USD) - 2016/03/10 13:53:48 CET [2016/03/10 7:53:48 ET]
Table 'Leuschneria II' 9-max Seat #8 is the button
Seat 1: SHARKFIN168 ($90.79 in chips) 
Seat 2: blackw0lf_03 ($100 in chips) 
Seat 3: Spid1 ($115.54 in chips) 
Seat 4: Sweden_Pound ($133.72 in chips) 
Seat 5: RMilPoker ($223.20 in chips) 
Seat 6: matiko09 ($110.11 in chips) 
Seat 7: Plz3betMe ($44.57 in chips) 
Seat 8: UnBent022 ($101.50 in chips) 
Seat 9: ki11u ($100.50 in chips) 
ki11u: posts small blind $0.50
SHARKFIN168: posts big blind $1
*** HOLE CARDS ***
Dealt to matiko09 [Qc 3d]
blackw0lf_03: folds 
Spid1: folds 
Sweden_Pound: folds 
RMilPoker: folds 
matiko09: folds 
Plz3betMe: folds 
UnBent022: raises $1 to $2
ki11u: folds 
SHARKFIN168: calls $1
*** FLOP *** [7c 9h 4c]
SHARKFIN168: checks 
UnBent022: bets $2.97
SHARKFIN168: folds 
Uncalled bet ($2.97) returned to UnBent022
UnBent022 collected $4.30 from pot
UnBent022: doesn't show hand 
*** SUMMARY ***
Total pot $4.50 | Rake $0.20 
Board [7c 9h 4c]
Seat 1: SHARKFIN168 (big blind) folded on the Flop
Seat 2: blackw0lf_03 folded before Flop (didn't bet)
Seat 3: Spid1 folded before Flop (didn't bet)
Seat 4: Sweden_Pound folded before Flop (didn't bet)
Seat 5: RMilPoker folded before Flop (didn't bet)
Seat 6: matiko09 folded before Flop (didn't bet)
Seat 7: Plz3betMe folded before Flop (didn't bet)
Seat 8: UnBent022 (button) collected ($4.30)
Seat 9: ki11u (small blind) folded before Flop





PokerStars Hand #150126944224:  Hold'em No Limit ($0.50/$1.00 USD) - 2016/03/10 13:53:52 CET [2016/03/10 7:53:52 ET]
Table 'Opik' 9-max Seat #2 is the button
Seat 2: tipner ($100 in chips) 
Seat 4: white huck ($59 in chips) 
Seat 5: matiko09 ($113.77 in chips) 
Seat 7: PacPacBum ($104.29 in chips) 
Seat 8: Igor DoUrden ($135.92 in chips) 
Seat 9: Spid1 ($100 in chips) 
Filojoes will be allowed to play after the button
white huck: posts small blind $0.50
matiko09: posts big blind $1
FroggyPlay: sits out 
172140 is connected 
172140: sits out 
*** HOLE CARDS ***
Dealt to matiko09 [5d 3c]
PacPacBum: folds 
Igor DoUrden: folds 
Spid1: raises $1.50 to $2.50
tipner: folds 
white huck: folds 
matiko09: folds 
Uncalled bet ($1.50) returned to Spid1
Spid1 collected $2.50 from pot
Spid1: doesn't show hand 
*** SUMMARY ***
Total pot $2.50 | Rake $0 
Seat 2: tipner (button) folded before Flop (didn't bet)
Seat 4: white huck (small blind) folded before Flop
Seat 5: matiko09 (big blind) folded before Flop
Seat 7: PacPacBum folded before Flop (didn't bet)
Seat 8: Igor DoUrden folded before Flop (didn't bet)
Seat 9: Spid1 collected ($2.50)





PokerStars Hand #150126945289:  Hold'em No Limit ($1/$2 USD) - 2016/03/10 13:53:54 CET [2016/03/10 7:53:54 ET]
Table 'Chandra II' 9-max Seat #8 is the button
Seat 2: PacPacBum ($251.32 in chips) 
Seat 4: tipner ($203 in chips) 
Seat 5: uibting ($210.70 in chips) 
Seat 6: stds st ($135.82 in chips) 
Seat 7: johnvu2016 ($132.25 in chips) 
Seat 8: matiko09 ($200 in chips) 
Seat 9: o.miro ($313.47 in chips) 
o.miro: posts small blind $1
Fish4trips: is sitting out 
PacPacBum: posts big blind $2
uonlylive1ce: sits out 
*** HOLE CARDS ***
Dealt to matiko09 [Ad Jc]
tipner: folds 
uibting: folds 
Fish4trips leaves the table
Gamz11 joins the table at seat #1 
stds st has timed out
stds st: folds 
johnvu2016: folds 
matiko09: raises $2.54 to $4.54
o.miro: folds 
PacPacBum: calls $2.54
*** FLOP *** [6c 4c 2d]
PacPacBum: checks 
matiko09: checks 
*** TURN *** [6c 4c 2d] [Jd]
PacPacBum: bets $6.64
matiko09: raises $14.89 to $21.53
PacPacBum: calls $14.89
*** RIVER *** [6c 4c 2d Jd] [3h]
PacPacBum: checks 
matiko09: checks 
*** SHOW DOWN ***
PacPacBum: shows [Jh Kc] (a pair of Jacks)
matiko09: shows [Ad Jc] (a pair of Jacks - Ace kicker)
matiko09 collected $50.75 from pot
*** SUMMARY ***
Total pot $53.14 | Rake $2.39 
Board [6c 4c 2d Jd 3h]
Seat 2: PacPacBum (big blind) showed [Jh Kc] and lost with a pair of Jacks
Seat 4: tipner folded before Flop (didn't bet)
Seat 5: uibting folded before Flop (didn't bet)
Seat 6: stds st folded before Flop (didn't bet)
Seat 7: johnvu2016 folded before Flop (didn't bet)
Seat 8: matiko09 (button) showed [Ad Jc] and won ($50.75) with a pair of Jacks
Seat 9: o.miro (small blind) folded before Flop





PokerStars Hand #150126949117:  Hold'em No Limit ($1/$2 USD) - 2016/03/10 13:54:02 CET [2016/03/10 7:54:02 ET]
Table 'Solstice II' 9-max Seat #9 is the button
Seat 1: azzad2007 ($243.76 in chips) 
Seat 2: o.miro ($200 in chips) 
Seat 3: PacPacBum ($200 in chips) 
Seat 4: ki11u ($200 in chips) 
Seat 5: eKCimann 666 ($379.14 in chips) 
Seat 6: Gamz11 ($224.18 in chips) 
Seat 7: uonlylive1ce ($210.96 in chips) 
Seat 8: matiko09 ($200 in chips) 
Seat 9: zhang0204 ($223.68 in chips) 
azzad2007: posts small blind $1
o.miro: posts big blind $2
*** HOLE CARDS ***
Dealt to matiko09 [5s Ac]
PacPacBum: folds 
ki11u: folds 
eKCimann 666: raises $5 to $7
Gamz11: folds 
uonlylive1ce: folds 
matiko09: folds 
zhang0204: folds 
azzad2007: folds 
o.miro: folds 
Uncalled bet ($5) returned to eKCimann 666
eKCimann 666 collected $5 from pot
eKCimann 666: doesn't show hand 
*** SUMMARY ***
Total pot $5 | Rake $0 
Seat 1: azzad2007 (small blind) folded before Flop
Seat 2: o.miro (big blind) folded before Flop
Seat 3: PacPacBum folded before Flop (didn't bet)
Seat 4: ki11u folded before Flop (didn't bet)
Seat 5: eKCimann 666 collected ($5)
Seat 6: Gamz11 folded before Flop (didn't bet)
Seat 7: uonlylive1ce folded before Flop (didn't bet)
Seat 8: matiko09 folded before Flop (didn't bet)
Seat 9: zhang0204 (button) folded before Flop (didn't bet)





PokerStars Hand #150126952876:  Hold'em No Limit (€1/€2 EUR) - 2016/03/10 13:54:08 CET [2016/03/10 7:54:08 ET]
Table 'Sigrid II' 9-max Seat #5 is the button
Seat 1: Gamz11 (€208 in chips) 
Seat 2: stds st (€96.51 in chips) 
Seat 5: vr188 (€75.03 in chips) 
Seat 7: PacPacBum (€205 in chips) 
Seat 8: matiko09 (€240.71 in chips) 
Seat 9: ki11u (€228.72 in chips) 
PacPacBum: posts small blind €1
matiko09: posts big blind €2
*** HOLE CARDS ***
Dealt to matiko09 [Ks Th]
ki11u: folds 
Gamz11: folds 
stds st: folds 
vr188: folds 
PacPacBum: raises €4 to €6
matiko09: calls €4
*** FLOP *** [4d Ad Tc]
PacPacBum: checks 
matiko09: checks 
*** TURN *** [4d Ad Tc] [5c]
PacPacBum: checks 
matiko09: bets €5.95
PacPacBum: raises €12.61 to €18.56
matiko09: folds 
Uncalled bet (€12.61) returned to PacPacBum
PacPacBum collected €22.82 from pot
PacPacBum: doesn't show hand 
*** SUMMARY ***
Total pot €23.90 | Rake €1.08 
Board [4d Ad Tc 5c]
Seat 1: Gamz11 folded before Flop (didn't bet)
Seat 2: stds st folded before Flop (didn't bet)
Seat 5: vr188 (button) folded before Flop (didn't bet)
Seat 7: PacPacBum (small blind) collected (€22.82)
Seat 8: matiko09 (big blind) folded on the Turn
Seat 9: ki11u folded before Flop (didn't bet)





PokerStars Hand #150126958090:  Hold'em No Limit ($0.50/$1.00 USD) - 2016/03/10 13:54:18 CET [2016/03/10 7:54:18 ET]
Table 'Opik' 9-max Seat #4 is the button
Seat 1: 172140 ($97 in chips) 
Seat 2: tipner ($100 in chips) 
Seat 4: white huck ($58.50 in chips) 
Seat 5: matiko09 ($112.77 in chips) 
Seat 6: FroggyPlay ($100 in chips) 
Seat 7: PacPacBum ($104.29 in chips) 
Seat 8: Igor DoUrden ($135.92 in chips) 
Seat 9: Spid1 ($101.50 in chips) 
matiko09: posts small blind $0.50
FroggyPlay: posts big blind $1
172140: posts big blind $1
Filojoes: sits out 
*** HOLE CARDS ***
Dealt to matiko09 [Ks 7d]
PacPacBum: folds 
Igor DoUrden: folds 
Spid1: folds 
172140: checks 
tipner: folds 
white huck: raises $1.43 to $2.43
matiko09: folds 
FroggyPlay: calls $1.43
172140: folds 
*** FLOP *** [8d 5s 3s]
FroggyPlay: checks 
white huck: bets $4.04
FroggyPlay: folds 
Uncalled bet ($4.04) returned to white huck
white huck collected $6.07 from pot
white huck: doesn't show hand 
*** SUMMARY ***
Total pot $6.36 | Rake $0.29 
Board [8d 5s 3s]
Seat 1: 172140 folded before Flop
Seat 2: tipner folded before Flop (didn't bet)
Seat 4: white huck (button) collected ($6.07)
Seat 5: matiko09 (small blind) folded before Flop
Seat 6: FroggyPlay (big blind) folded on the Flop
Seat 7: PacPacBum folded before Flop (didn't bet)
Seat 8: Igor DoUrden folded before Flop (didn't bet)
Seat 9: Spid1 folded before Flop (didn't bet)





PokerStars Hand #150126960844:  Hold'em No Limit ($1/$2 USD) - 2016/03/10 13:54:23 CET [2016/03/10 7:54:23 ET]
Table 'Solstice II' 9-max Seat #1 is the button
Seat 1: azzad2007 ($242.76 in chips) 
Seat 2: o.miro ($200 in chips) 
Seat 3: PacPacBum ($200 in chips) 
Seat 4: ki11u ($200 in chips) 
Seat 5: eKCimann 666 ($382.14 in chips) 
Seat 6: Gamz11 ($224.18 in chips) 
Seat 7: uonlylive1ce ($210.96 in chips) 
Seat 8: matiko09 ($200 in chips) 
Seat 9: zhang0204 ($223.68 in chips) 
o.miro: posts small blind $1
PacPacBum: posts big blind $2
*** HOLE CARDS ***
Dealt to matiko09 [Kc 4d]
ki11u: folds 
eKCimann 666: folds 
Gamz11: folds 
uonlylive1ce: folds 
matiko09: folds 
zhang0204: raises $4 to $6
azzad2007: folds 
o.miro: folds 
PacPacBum: folds 
Uncalled bet ($4) returned to zhang0204
zhang0204 collected $5 from pot
zhang0204: doesn't show hand 
*** SUMMARY ***
Total pot $5 | Rake $0 
Seat 1: azzad2007 (button) folded before Flop (didn't bet)
Seat 2: o.miro (small blind) folded before Flop
Seat 3: PacPacBum (big blind) folded before Flop
Seat 4: ki11u folded before Flop (didn't bet)
Seat 5: eKCimann 666 folded before Flop (didn't bet)
Seat 6: Gamz11 folded before Flop (didn't bet)
Seat 7: uonlylive1ce folded before Flop (didn't bet)
Seat 8: matiko09 folded before Flop (didn't bet)
Seat 9: zhang0204 collected ($5)





PokerStars Hand #150126966957:  Hold'em No Limit ($0.50/$1.00 USD) - 2016/03/10 13:54:34 CET [2016/03/10 7:54:34 ET]
Table 'Leuschneria II' 9-max Seat #9 is the button
Seat 1: SHARKFIN168 ($88.79 in chips) 
Seat 2: blackw0lf_03 ($100 in chips) 
Seat 3: Spid1 ($115.54 in chips) 
Seat 4: Sweden_Pound ($133.72 in chips) 
Seat 5: RMilPoker ($223.20 in chips) 
Seat 6: matiko09 ($110.11 in chips) 
Seat 7: Plz3betMe ($44.57 in chips) 
Seat 8: UnBent022 ($103.80 in chips) 
Seat 9: ki11u ($100 in chips) 
SHARKFIN168: posts small blind $0.50
blackw0lf_03: posts big blind $1
*** HOLE CARDS ***
Dealt to matiko09 [9d 8c]
Spid1: raises $2 to $3
Sweden_Pound: folds 
RMilPoker: folds 
matiko09: folds 
Plz3betMe: folds 
UnBent022: folds 
ki11u: folds 
SHARKFIN168: folds 
blackw0lf_03: folds 
Uncalled bet ($2) returned to Spid1
Spid1 collected $2.50 from pot
Spid1: doesn't show hand 
*** SUMMARY ***
Total pot $2.50 | Rake $0 
Seat 1: SHARKFIN168 (small blind) folded before Flop
Seat 2: blackw0lf_03 (big blind) folded before Flop
Seat 3: Spid1 collected ($2.50)
Seat 4: Sweden_Pound folded before Flop (didn't bet)
Seat 5: RMilPoker folded before Flop (didn't bet)
Seat 6: matiko09 folded before Flop (didn't bet)
Seat 7: Plz3betMe folded before Flop (didn't bet)
Seat 8: UnBent022 folded before Flop (didn't bet)
Seat 9: ki11u (button) folded before Flop (didn't bet)





PokerStars Hand #150126981291:  Hold'em No Limit ($1/$2 USD) - 2016/03/10 13:55:00 CET [2016/03/10 7:55:00 ET]
Table 'Chandra II' 9-max Seat #9 is the button
Seat 2: PacPacBum ($225.25 in chips) 
Seat 3: uonlylive1ce ($200 in chips) 
Seat 4: tipner ($203 in chips) 
Seat 5: uibting ($210.70 in chips) 
Seat 6: stds st ($135.82 in chips) 
Seat 7: johnvu2016 ($132.25 in chips) 
Seat 8: matiko09 ($224.68 in chips) 
Seat 9: o.miro ($312.47 in chips) 
Gamz11 will be allowed to play after the button
PacPacBum: posts small blind $1
uonlylive1ce: posts big blind $2
*** HOLE CARDS ***
Dealt to matiko09 [9h Jd]
tipner: folds 
uibting: folds 
stds st: folds 
johnvu2016: folds 
matiko09: folds 
o.miro: folds 
PacPacBum: folds 
Uncalled bet ($1) returned to uonlylive1ce
uonlylive1ce collected $2 from pot
uonlylive1ce: doesn't show hand 
*** SUMMARY ***
Total pot $2 | Rake $0 
Seat 2: PacPacBum (small blind) folded before Flop
Seat 3: uonlylive1ce (big blind) collected ($2)
Seat 4: tipner folded before Flop (didn't bet)
Seat 5: uibting folded before Flop (didn't bet)
Seat 6: stds st folded before Flop (didn't bet)
Seat 7: johnvu2016 folded before Flop (didn't bet)
Seat 8: matiko09 folded before Flop (didn't bet)
Seat 9: o.miro (button) folded before Flop (didn't bet)





PokerStars Hand #150126981003:  Hold'em No Limit ($0.50/$1.00 USD) - 2016/03/10 13:55:00 CET [2016/03/10 7:55:00 ET]
Table 'Iguassu' 9-max Seat #8 is the button
Seat 1: blackw0lf_03 ($100 in chips) 
Seat 2: Rocky6434 ($52.77 in chips) 
Seat 3: hammerwife ($121.93 in chips) 
Seat 4: matiko09 ($109.50 in chips) 
Seat 5: UnBent022 ($100 in chips) 
Seat 6: Igor DoUrden ($109.88 in chips) 
Seat 7: PacPacBum ($117.05 in chips) 
Seat 8: Filojoes ($143.62 in chips) 
Seat 9: er13to ($108.51 in chips) 
er13to: posts small blind $0.50
blackw0lf_03: posts big blind $1
*** HOLE CARDS ***
Dealt to matiko09 [Jh 9h]
Rocky6434: folds 
hammerwife: raises $2 to $3
matiko09: folds 
UnBent022: folds 
Igor DoUrden: folds 
PacPacBum: folds 
Filojoes: calls $3
er13to: folds 
blackw0lf_03: folds 
*** FLOP *** [3d 5h Jc]
hammerwife: bets $4
Filojoes: folds 
Uncalled bet ($4) returned to hammerwife
hammerwife collected $7.16 from pot
hammerwife: doesn't show hand 
*** SUMMARY ***
Total pot $7.50 | Rake $0.34 
Board [3d 5h Jc]
Seat 1: blackw0lf_03 (big blind) folded before Flop
Seat 2: Rocky6434 folded before Flop (didn't bet)
Seat 3: hammerwife collected ($7.16)
Seat 4: matiko09 folded before Flop (didn't bet)
Seat 5: UnBent022 folded before Flop (didn't bet)
Seat 6: Igor DoUrden folded before Flop (didn't bet)
Seat 7: PacPacBum folded before Flop (didn't bet)
Seat 8: Filojoes (button) folded on the Flop
Seat 9: er13to (small blind) folded before Flop





PokerStars Hand #150126987490:  Hold'em No Limit ($0.50/$1.00 USD) - 2016/03/10 13:55:12 CET [2016/03/10 7:55:12 ET]
Table 'Leuschneria II' 9-max Seat #1 is the button
Seat 1: SHARKFIN168 ($88.29 in chips) 
Seat 2: blackw0lf_03 ($100 in chips) 
Seat 3: Spid1 ($117.04 in chips) 
Seat 4: Sweden_Pound ($133.72 in chips) 
Seat 5: RMilPoker ($223.20 in chips) 
Seat 6: matiko09 ($110.11 in chips) 
Seat 7: Plz3betMe ($44.57 in chips) 
Seat 8: UnBent022 ($103.80 in chips) 
Seat 9: ki11u ($100 in chips) 
blackw0lf_03: posts small blind $0.50
Spid1: posts big blind $1
*** HOLE CARDS ***
Dealt to matiko09 [7c Ac]
Sweden_Pound: folds 
RMilPoker: folds 
matiko09: folds 
Plz3betMe: folds 
UnBent022: raises $2 to $3
ki11u: folds 
SHARKFIN168: raises $5 to $8
blackw0lf_03: folds 
Spid1: folds 
UnBent022: calls $5
*** FLOP *** [7h 9c Ad]
UnBent022: checks 
SHARKFIN168: bets $6
UnBent022: folds 
Uncalled bet ($6) returned to SHARKFIN168
SHARKFIN168 collected $16.71 from pot
SHARKFIN168: doesn't show hand 
*** SUMMARY ***
Total pot $17.50 | Rake $0.79 
Board [7h 9c Ad]
Seat 1: SHARKFIN168 (button) collected ($16.71)
Seat 2: blackw0lf_03 (small blind) folded before Flop
Seat 3: Spid1 (big blind) folded before Flop
Seat 4: Sweden_Pound folded before Flop (didn't bet)
Seat 5: RMilPoker folded before Flop (didn't bet)
Seat 6: matiko09 folded before Flop (didn't bet)
Seat 7: Plz3betMe folded before Flop (didn't bet)
Seat 8: UnBent022 folded on the Flop
Seat 9: ki11u folded before Flop (didn't bet)





PokerStars Hand #150126989876:  Hold'em No Limit (€1/€2 EUR) - 2016/03/10 13:55:17 CET [2016/03/10 7:55:17 ET]
Table 'Sigrid II' 9-max Seat #7 is the button
Seat 1: Gamz11 (€208 in chips) 
Seat 2: stds st (€96.51 in chips) 
Seat 5: vr188 (€75.03 in chips) 
Seat 7: PacPacBum (€215.87 in chips) 
Seat 8: matiko09 (€228.76 in chips) 
Seat 9: ki11u (€228.72 in chips) 
matiko09: posts small blind €1
ki11u: posts big blind €2
*** HOLE CARDS ***
Dealt to matiko09 [Ad 7c]
Gamz11: folds 
stds st: raises €2.04 to €4.04
vr188: folds 
PacPacBum: raises €9.96 to €14
matiko09: folds 
ki11u: folds 
stds st: folds 
Uncalled bet (€9.96) returned to PacPacBum
PacPacBum collected €11.08 from pot
PacPacBum: doesn't show hand 
*** SUMMARY ***
Total pot €11.08 | Rake €0 
Seat 1: Gamz11 folded before Flop (didn't bet)
Seat 2: stds st folded before Flop
Seat 5: vr188 folded before Flop (didn't bet)
Seat 7: PacPacBum (button) collected (€11.08)
Seat 8: matiko09 (small blind) folded before Flop
Seat 9: ki11u (big blind) folded before Flop





PokerStars Hand #150126993253:  Hold'em No Limit ($1/$2 USD) - 2016/03/10 13:55:24 CET [2016/03/10 7:55:24 ET]
Table 'Solstice II' 9-max Seat #2 is the button
Seat 1: azzad2007 ($242.76 in chips) 
Seat 2: o.miro ($200 in chips) 
Seat 3: PacPacBum ($200 in chips) 
Seat 4: ki11u ($200 in chips) 
Seat 5: eKCimann 666 ($382.14 in chips) 
Seat 6: Gamz11 ($224.18 in chips) 
Seat 7: uonlylive1ce ($210.96 in chips) 
Seat 8: matiko09 ($200 in chips) 
Seat 9: zhang0204 ($226.68 in chips) 
PacPacBum: posts small blind $1
ki11u: posts big blind $2
*** HOLE CARDS ***
Dealt to matiko09 [7d 9c]
eKCimann 666: raises $8 to $10
Gamz11: folds 
uonlylive1ce: folds 
matiko09: folds 
zhang0204: folds 
azzad2007: folds 
o.miro: folds 
PacPacBum: folds 
ki11u: calls $8
*** FLOP *** [2c 2d Qc]
ki11u: checks 
eKCimann 666: bets $20.06
ki11u: calls $20.06
*** TURN *** [2c 2d Qc] [7s]
ki11u: checks 
eKCimann 666: bets $76
ki11u: folds 
Uncalled bet ($76) returned to eKCimann 666
eKCimann 666 collected $58.37 from pot
eKCimann 666: doesn't show hand 
*** SUMMARY ***
Total pot $61.12 | Rake $2.75 
Board [2c 2d Qc 7s]
Seat 1: azzad2007 folded before Flop (didn't bet)
Seat 2: o.miro (button) folded before Flop (didn't bet)
Seat 3: PacPacBum (small blind) folded before Flop
Seat 4: ki11u (big blind) folded on the Turn
Seat 5: eKCimann 666 collected ($58.37)
Seat 6: Gamz11 folded before Flop (didn't bet)
Seat 7: uonlylive1ce folded before Flop (didn't bet)
Seat 8: matiko09 folded before Flop (didn't bet)
Seat 9: zhang0204 folded before Flop (didn't bet)





PokerStars Hand #150126994324:  Hold'em No Limit ($0.25/$0.50 USD) - 2016/03/10 13:55:26 CET [2016/03/10 7:55:26 ET]
Table 'Aegina' 9-max Seat #7 is the button
Seat 1: congcongnbnb ($94.21 in chips) 
Seat 2: Spid1 ($102.69 in chips) 
Seat 3: MyMilkCans=D ($131.85 in chips) 
Seat 4: digimatical ($138.99 in chips) 
Seat 5: Ahangama ($50 in chips) 
Seat 6: matiko09 ($68.62 in chips) 
Seat 7: Gummio ($114.12 in chips) 
Seat 8: ardo888 ($170.52 in chips) 
ardo888: posts small blind $0.25
draken08: is sitting out 
congcongnbnb: posts big blind $0.50
congcongnbnb: posts the ante $0.10
Spid1: posts the ante $0.10
MyMilkCans=D: posts the ante $0.10
digimatical: posts the ante $0.10
Ahangama: posts the ante $0.10
matiko09: posts the ante $0.10
Gummio: posts the ante $0.10
ardo888: posts the ante $0.10
*** HOLE CARDS ***
Dealt to matiko09 [Ts 9s]
Spid1: folds 
MyMilkCans=D: folds 
digimatical: calls $0.50
Ahangama: folds 
matiko09: raises $1.50 to $2
Gummio: folds 
ardo888: folds 
congcongnbnb: calls $1.50
digimatical: folds 
*** FLOP *** [Jd 5s 3c]
congcongnbnb: checks 
matiko09: bets $3
congcongnbnb: folds 
Uncalled bet ($3) returned to matiko09
matiko09 collected $5.30 from pot
matiko09: doesn't show hand 
*** SUMMARY ***
Total pot $5.55 | Rake $0.25 
Board [Jd 5s 3c]
Seat 1: congcongnbnb (big blind) folded on the Flop
Seat 2: Spid1 folded before Flop (didn't bet)
Seat 3: MyMilkCans=D folded before Flop (didn't bet)
Seat 4: digimatical folded before Flop
Seat 5: Ahangama folded before Flop (didn't bet)
Seat 6: matiko09 collected ($5.30)
Seat 7: Gummio (button) folded before Flop (didn't bet)
Seat 8: ardo888 (small blind) folded before Flop





PokerStars Hand #150126994717:  Hold'em No Limit ($1/$2 USD) - 2016/03/10 13:55:27 CET [2016/03/10 7:55:27 ET]
Table 'Tauris II' 9-max Seat #1 is the button
Seat 1: matiko09 ($200 in chips) 
Seat 2: stds st ($53.95 in chips) 
Seat 3: PacPacBum ($261.68 in chips) 
Seat 4: neomorf ($661.52 in chips) 
Seat 5: tipner ($200 in chips) 
Seat 6: uonlylive1ce ($204.42 in chips) 
Seat 8: scout326 ($268.02 in chips) 
Seat 9: darren1031 ($177.42 in chips) 
stds st: posts small blind $1
PacPacBum: posts big blind $2
Gamz11: sits out 
*** HOLE CARDS ***
Dealt to matiko09 [Th 8s]
neomorf: folds 
tipner: folds 
uonlylive1ce: folds 
scout326: folds 
darren1031: raises $2 to $4
matiko09: folds 
stds st: folds 
PacPacBum: folds 
Uncalled bet ($2) returned to darren1031
darren1031 collected $5 from pot
darren1031: doesn't show hand 
*** SUMMARY ***
Total pot $5 | Rake $0 
Seat 1: matiko09 (button) folded before Flop (didn't bet)
Seat 2: stds st (small blind) folded before Flop
Seat 3: PacPacBum (big blind) folded before Flop
Seat 4: neomorf folded before Flop (didn't bet)
Seat 5: tipner folded before Flop (didn't bet)
Seat 6: uonlylive1ce folded before Flop (didn't bet)
Seat 8: scout326 folded before Flop (didn't bet)
Seat 9: darren1031 collected ($5)





PokerStars Hand #150126995117:  Hold'em No Limit ($1/$2 USD) - 2016/03/10 13:55:28 CET [2016/03/10 7:55:28 ET]
Table 'Chandra II' 9-max Seat #2 is the button
Seat 2: PacPacBum ($224.25 in chips) 
Seat 3: uonlylive1ce ($201 in chips) 
Seat 4: tipner ($203 in chips) 
Seat 5: uibting ($210.70 in chips) 
Seat 6: stds st ($135.82 in chips) 
Seat 7: johnvu2016 ($132.25 in chips) 
Seat 8: matiko09 ($224.68 in chips) 
Seat 9: o.miro ($312.47 in chips) 
uonlylive1ce: posts small blind $1
tipner: posts big blind $2
Gamz11: sits out 
*** HOLE CARDS ***
Dealt to matiko09 [5s 3c]
uibting: raises $4 to $6
stds st: folds 
johnvu2016: calls $6
matiko09: folds 
o.miro: raises $23 to $29
PacPacBum: folds 
uonlylive1ce: folds 
tipner: folds 
uibting: calls $23
johnvu2016: folds 
*** FLOP *** [8d Kc 3d]
uibting: checks 
o.miro: bets $45
uibting: folds 
Uncalled bet ($45) returned to o.miro
o.miro collected $64.20 from pot
o.miro: doesn't show hand 
*** SUMMARY ***
Total pot $67 | Rake $2.80 
Board [8d Kc 3d]
Seat 2: PacPacBum (button) folded before Flop (didn't bet)
Seat 3: uonlylive1ce (small blind) folded before Flop
Seat 4: tipner (big blind) folded before Flop
Seat 5: uibting folded on the Flop
Seat 6: stds st folded before Flop (didn't bet)
Seat 7: johnvu2016 folded before Flop
Seat 8: matiko09 folded before Flop (didn't bet)
Seat 9: o.miro collected ($64.20)





PokerStars Hand #150126998717:  Hold'em No Limit ($0.50/$1.00 USD) - 2016/03/10 13:55:35 CET [2016/03/10 7:55:35 ET]
Table 'Opik' 9-max Seat #5 is the button
Seat 1: 172140 ($96 in chips) 
Seat 2: tipner ($100 in chips) 
Seat 4: white huck ($62.14 in chips) 
Seat 5: matiko09 ($112.27 in chips) 
Seat 6: FroggyPlay ($100 in chips) 
FroggyPlay: posts small blind $0.50
PacPacBum: is sitting out 
Igor DoUrden: is sitting out 
Igor DoUrden leaves the table
Spid1: is sitting out 
172140: posts big blind $1
Filojoes: sits out 
*** HOLE CARDS ***
Dealt to matiko09 [8d 4h]
Spid1 leaves the table
PacPacBum leaves the table
tipner: raises $2 to $3
Komandantes joins the table at seat #8 
pardama joins the table at seat #7 
white huck: folds 
matiko09: folds 
FroggyPlay: folds 
Sweden_Pound joins the table at seat #9 
172140: raises $3 to $6
tipner: calls $3
*** FLOP *** [9h Tc 5c]
172140: bets $6
tipner: calls $6
*** TURN *** [9h Tc 5c] [Ts]
172140: bets $12
tipner: folds 
Uncalled bet ($12) returned to 172140
172140 collected $23.40 from pot
172140: doesn't show hand 
*** SUMMARY ***
Total pot $24.50 | Rake $1.10 
Board [9h Tc 5c Ts]
Seat 1: 172140 (big blind) collected ($23.40)
Seat 2: tipner folded on the Turn
Seat 4: white huck folded before Flop (didn't bet)
Seat 5: matiko09 (button) folded before Flop (didn't bet)
Seat 6: FroggyPlay (small blind) folded before Flop





PokerStars Hand #150127005719:  Hold'em No Limit (€1/€2 EUR) - 2016/03/10 13:55:49 CET [2016/03/10 7:55:49 ET]
Table 'Sigrid II' 9-max Seat #8 is the button
Seat 1: Gamz11 (€208 in chips) 
Seat 2: stds st (€92.47 in chips) 
Seat 5: vr188 (€75.03 in chips) 
Seat 7: PacPacBum (€222.91 in chips) 
Seat 8: matiko09 (€227.76 in chips) 
Seat 9: ki11u (€226.72 in chips) 
ki11u: posts small blind €1
Gamz11: posts big blind €2
*** HOLE CARDS ***
Dealt to matiko09 [3d 5s]
stds st: folds 
vr188: calls €2
PacPacBum: raises €6 to €8
matiko09: folds 
ki11u: folds 
Gamz11: folds 
vr188: calls €6
*** FLOP *** [Kc 9h 2c]
vr188: checks 
PacPacBum: bets €6.34
vr188: raises €10.34 to €16.68
PacPacBum: folds 
Uncalled bet (€10.34) returned to vr188
vr188 collected €30.25 from pot
*** SUMMARY ***
Total pot €31.68 | Rake €1.43 
Board [Kc 9h 2c]
Seat 1: Gamz11 (big blind) folded before Flop
Seat 2: stds st folded before Flop (didn't bet)
Seat 5: vr188 collected (€30.25)
Seat 7: PacPacBum folded on the Flop
Seat 8: matiko09 (button) folded before Flop (didn't bet)
Seat 9: ki11u (small blind) folded before Flop





PokerStars Hand #150127005971:  Hold'em No Limit ($1/$2 USD) - 2016/03/10 13:55:50 CET [2016/03/10 7:55:50 ET]
Table 'Tauris II' 9-max Seat #2 is the button
Seat 1: matiko09 ($200 in chips) 
Seat 2: stds st ($52.95 in chips) 
Seat 3: PacPacBum ($259.68 in chips) 
Seat 4: neomorf ($661.52 in chips) 
Seat 5: tipner ($200 in chips) 
Seat 6: uonlylive1ce ($204.42 in chips) 
Seat 8: scout326 ($268.02 in chips) 
Seat 9: darren1031 ($180.42 in chips) 
PacPacBum: posts small blind $1
neomorf: posts big blind $2
Gamz11: sits out 
*** HOLE CARDS ***
Dealt to matiko09 [2d 9d]
tipner: folds 
uonlylive1ce: folds 
scout326: raises $4 to $6
darren1031: calls $6
matiko09: folds 
stds st: calls $6
PacPacBum: folds 
neomorf: calls $4
*** FLOP *** [Qs 9s 7c]
neomorf: checks 
scout326: bets $11.94
darren1031: calls $11.94
stds st: calls $11.94
neomorf: folds 
*** TURN *** [Qs 9s 7c] [4c]
scout326: bets $29.04
darren1031: folds 
stds st: raises $5.97 to $35.01 and is all-in
scout326: calls $5.97
*** RIVER *** [Qs 9s 7c 4c] [5s]
*** SHOW DOWN ***
scout326: shows [Td Qh] (a pair of Queens)
stds st: shows [Ks Ts] (a flush, King high)
stds st collected $128.04 from pot
*** SUMMARY ***
Total pot $130.84 | Rake $2.80 
Board [Qs 9s 7c 4c 5s]
Seat 1: matiko09 folded before Flop (didn't bet)
Seat 2: stds st (button) showed [Ks Ts] and won ($128.04) with a flush, King high
Seat 3: PacPacBum (small blind) folded before Flop
Seat 4: neomorf (big blind) folded on the Flop
Seat 5: tipner folded before Flop (didn't bet)
Seat 6: uonlylive1ce folded before Flop (didn't bet)
Seat 8: scout326 showed [Td Qh] and lost with a pair of Queens
Seat 9: darren1031 folded on the Turn





PokerStars Hand #150127015310:  Hold'em No Limit ($0.50/$1.00 USD) - 2016/03/10 13:56:09 CET [2016/03/10 7:56:09 ET]
Table 'Iguassu' 9-max Seat #9 is the button
Seat 1: blackw0lf_03 ($100 in chips) 
Seat 2: Rocky6434 ($52.77 in chips) 
Seat 3: hammerwife ($126.09 in chips) 
Seat 4: matiko09 ($109.50 in chips) 
Seat 5: UnBent022 ($100 in chips) 
Seat 6: Igor DoUrden ($109.88 in chips) 
Seat 7: PacPacBum ($117.05 in chips) 
Seat 8: Filojoes ($140.62 in chips) 
Seat 9: er13to ($108.01 in chips) 
blackw0lf_03: posts small blind $0.50
Rocky6434: posts big blind $1
*** HOLE CARDS ***
Dealt to matiko09 [Tc 8c]
hammerwife: folds 
matiko09: folds 
UnBent022: folds 
Igor DoUrden: folds 
PacPacBum: folds 
Filojoes: raises $1.50 to $2.50
er13to: raises $5.50 to $8
blackw0lf_03: folds 
Rocky6434: calls $7
Filojoes: folds 
*** FLOP *** [3s 4s Qd]
Rocky6434: checks 
er13to: checks 
*** TURN *** [3s 4s Qd] [6h]
Rocky6434: checks 
er13to: bets $9.97
Rocky6434: calls $9.97
*** RIVER *** [3s 4s Qd 6h] [Qc]
Rocky6434: checks 
er13to: bets $7.50
Rocky6434: folds 
Uncalled bet ($7.50) returned to er13to
er13to collected $37.19 from pot
*** SUMMARY ***
Total pot $38.94 | Rake $1.75 
Board [3s 4s Qd 6h Qc]
Seat 1: blackw0lf_03 (small blind) folded before Flop
Seat 2: Rocky6434 (big blind) folded on the River
Seat 3: hammerwife folded before Flop (didn't bet)
Seat 4: matiko09 folded before Flop (didn't bet)
Seat 5: UnBent022 folded before Flop (didn't bet)
Seat 6: Igor DoUrden folded before Flop (didn't bet)
Seat 7: PacPacBum folded before Flop (didn't bet)
Seat 8: Filojoes folded before Flop
Seat 9: er13to (button) collected ($37.19)





PokerStars Hand #150127016779:  Hold'em No Limit ($0.50/$1.00 USD) - 2016/03/10 13:56:12 CET [2016/03/10 7:56:12 ET]
Table 'Leuschneria II' 9-max Seat #2 is the button
Seat 1: SHARKFIN168 ($97 in chips) 
Seat 2: blackw0lf_03 ($100 in chips) 
Seat 3: Spid1 ($116.04 in chips) 
Seat 5: RMilPoker ($223.20 in chips) 
Seat 6: matiko09 ($110.11 in chips) 
Seat 7: Plz3betMe ($44.57 in chips) 
Seat 8: UnBent022 ($100 in chips) 
Seat 9: ki11u ($100 in chips) 
Spid1: posts small blind $0.50
Sweden_Pound: is sitting out 
RMilPoker: posts big blind $1
*** HOLE CARDS ***
Dealt to matiko09 [9d 7h]
matiko09: folds 
Plz3betMe: folds 
UnBent022: folds 
ki11u: folds 
SHARKFIN168: raises $2 to $3
blackw0lf_03: raises $5 to $8
Spid1: folds 
RMilPoker: folds 
SHARKFIN168: calls $5
*** FLOP *** [6d Kc 6c]
SHARKFIN168: checks 
blackw0lf_03: bets $5.68
SHARKFIN168: calls $5.68
*** TURN *** [6d Kc 6c] [9h]
SHARKFIN168: checks 
blackw0lf_03: checks 
*** RIVER *** [6d Kc 6c 9h] [4c]
SHARKFIN168: bets $14
blackw0lf_03: calls $14
*** SHOW DOWN ***
SHARKFIN168: shows [Qh Ks] (two pair, Kings and Sixes)
blackw0lf_03: mucks hand 
SHARKFIN168 collected $54.30 from pot
*** SUMMARY ***
Total pot $56.86 | Rake $2.56 
Board [6d Kc 6c 9h 4c]
Seat 1: SHARKFIN168 showed [Qh Ks] and won ($54.30) with two pair, Kings and Sixes
Seat 2: blackw0lf_03 (button) mucked [8d Kd]
Seat 3: Spid1 (small blind) folded before Flop
Seat 5: RMilPoker (big blind) folded before Flop
Seat 6: matiko09 folded before Flop (didn't bet)
Seat 7: Plz3betMe folded before Flop (didn't bet)
Seat 8: UnBent022 folded before Flop (didn't bet)
Seat 9: ki11u folded before Flop (didn't bet)





PokerStars Hand #150127018529:  Hold'em No Limit ($0.50/$1.00 USD) - 2016/03/10 13:56:16 CET [2016/03/10 7:56:16 ET]
Table 'Opik' 9-max Seat #6 is the button
Seat 1: 172140 ($107.40 in chips) 
Seat 3: Filojoes ($100 in chips) 
Seat 4: white huck ($62.14 in chips) 
Seat 5: matiko09 ($112.27 in chips) 
Seat 6: FroggyPlay ($100 in chips) 
pardama will be allowed to play after the button
Komandantes will be allowed to play after the button
172140: posts small blind $0.50
tipner: is sitting out 
Filojoes: posts big blind $1
*** HOLE CARDS ***
Dealt to matiko09 [Ah 2s]
tipner leaves the table
white huck: folds 
vrnMike joins the table at seat #2 
matiko09: folds 
FroggyPlay: raises $1 to $2
172140: folds 
Filojoes: calls $1
*** FLOP *** [4c 2c Ks]
Filojoes: checks 
FroggyPlay: checks 
*** TURN *** [4c 2c Ks] [4h]
Filojoes: checks 
FroggyPlay: checks 
*** RIVER *** [4c 2c Ks 4h] [4s]
Filojoes: bets $2.58
FroggyPlay: folds 
Uncalled bet ($2.58) returned to Filojoes
Filojoes collected $4.30 from pot
Filojoes: doesn't show hand 
*** SUMMARY ***
Total pot $4.50 | Rake $0.20 
Board [4c 2c Ks 4h 4s]
Seat 1: 172140 (small blind) folded before Flop
Seat 3: Filojoes (big blind) collected ($4.30)
Seat 4: white huck folded before Flop (didn't bet)
Seat 5: matiko09 folded before Flop (didn't bet)
Seat 6: FroggyPlay (button) folded on the River





PokerStars Hand #150127020514:  Hold'em No Limit ($0.25/$0.50 USD) - 2016/03/10 13:56:20 CET [2016/03/10 7:56:20 ET]
Table 'Aegina' 9-max Seat #8 is the button
Seat 1: congcongnbnb ($92.11 in chips) 
Seat 2: Spid1 ($102.59 in chips) 
Seat 3: MyMilkCans=D ($131.75 in chips) 
Seat 4: digimatical ($138.39 in chips) 
Seat 5: Ahangama ($50 in chips) 
Seat 6: matiko09 ($71.82 in chips) 
Seat 7: Gummio ($114.02 in chips) 
Seat 8: ardo888 ($170.17 in chips) 
congcongnbnb: posts small blind $0.25
Spid1: posts big blind $0.50
congcongnbnb: posts the ante $0.10
Spid1: posts the ante $0.10
MyMilkCans=D: posts the ante $0.10
digimatical: posts the ante $0.10
Ahangama: posts the ante $0.10
matiko09: posts the ante $0.10
Gummio: posts the ante $0.10
ardo888: posts the ante $0.10
*** HOLE CARDS ***
Dealt to matiko09 [3d 8s]
MyMilkCans=D: raises $1.25 to $1.75
digimatical: folds 
Ahangama: folds 
matiko09: folds 
Gummio: folds 
ardo888: folds 
congcongnbnb: folds 
Spid1: folds 
Uncalled bet ($1.25) returned to MyMilkCans=D
MyMilkCans=D collected $2.05 from pot
MyMilkCans=D: doesn't show hand 
*** SUMMARY ***
Total pot $2.05 | Rake $0 
Seat 1: congcongnbnb (small blind) folded before Flop
Seat 2: Spid1 (big blind) folded before Flop
Seat 3: MyMilkCans=D collected ($2.05)
Seat 4: digimatical folded before Flop (didn't bet)
Seat 5: Ahangama folded before Flop (didn't bet)
Seat 6: matiko09 folded before Flop (didn't bet)
Seat 7: Gummio folded before Flop (didn't bet)
Seat 8: ardo888 (button) folded before Flop (didn't bet)





PokerStars Hand #150127034181:  Hold'em No Limit ($0.25/$0.50 USD) - 2016/03/10 13:56:48 CET [2016/03/10 7:56:48 ET]
Table 'Aegina' 9-max Seat #1 is the button
Seat 1: congcongnbnb ($91.76 in chips) 
Seat 2: Spid1 ($101.99 in chips) 
Seat 3: MyMilkCans=D ($133.20 in chips) 
Seat 4: digimatical ($138.29 in chips) 
Seat 5: Ahangama ($50 in chips) 
Seat 6: matiko09 ($71.72 in chips) 
Seat 7: Gummio ($113.92 in chips) 
Seat 8: ardo888 ($170.07 in chips) 
Spid1: posts small blind $0.25
MyMilkCans=D: posts big blind $0.50
congcongnbnb: posts the ante $0.10
Spid1: posts the ante $0.10
MyMilkCans=D: posts the ante $0.10
digimatical: posts the ante $0.10
Ahangama: posts the ante $0.10
matiko09: posts the ante $0.10
Gummio: posts the ante $0.10
ardo888: posts the ante $0.10
*** HOLE CARDS ***
Dealt to matiko09 [5h 8d]
digimatical: raises $2.05 to $2.55
Ahangama: folds 
matiko09: folds 
Gummio: folds 
ardo888: folds 
congcongnbnb: folds 
Spid1: folds 
MyMilkCans=D: folds 
Uncalled bet ($2.05) returned to digimatical
digimatical collected $2.05 from pot
*** SUMMARY ***
Total pot $2.05 | Rake $0 
Seat 1: congcongnbnb (button) folded before Flop (didn't bet)
Seat 2: Spid1 (small blind) folded before Flop
Seat 3: MyMilkCans=D (big blind) folded before Flop
Seat 4: digimatical collected ($2.05)
Seat 5: Ahangama folded before Flop (didn't bet)
Seat 6: matiko09 folded before Flop (didn't bet)
Seat 7: Gummio folded before Flop (didn't bet)
Seat 8: ardo888 folded before Flop (didn't bet)





PokerStars Hand #150127036177:  Hold'em No Limit ($1/$2 USD) - 2016/03/10 13:56:52 CET [2016/03/10 7:56:52 ET]
Table 'Solstice II' 9-max Seat #3 is the button
Seat 1: azzad2007 ($242.76 in chips) 
Seat 2: o.miro ($200 in chips) 
Seat 3: PacPacBum ($200 in chips) 
Seat 4: ki11u ($200 in chips) 
Seat 5: eKCimann 666 ($410.45 in chips) 
Seat 6: Gamz11 ($224.18 in chips) 
Seat 7: uonlylive1ce ($210.96 in chips) 
Seat 8: matiko09 ($200 in chips) 
Seat 9: zhang0204 ($226.68 in chips) 
ki11u: posts small blind $1
eKCimann 666: posts big blind $2
*** HOLE CARDS ***
Dealt to matiko09 [4h 4s]
Gamz11: folds 
uonlylive1ce: raises $4 to $6
matiko09: folds 
zhang0204: folds 
azzad2007: calls $6
o.miro: folds 
PacPacBum: folds 
ki11u: calls $5
eKCimann 666: folds 
*** FLOP *** [Qh 3s 7h]
ki11u: checks 
uonlylive1ce: checks 
azzad2007: bets $9.55
ki11u: calls $9.55
uonlylive1ce: folds 
*** TURN *** [Qh 3s 7h] [Ts]
ki11u: checks 
azzad2007: checks 
*** RIVER *** [Qh 3s 7h Ts] [6h]
ki11u: checks 
azzad2007: bets $47.21
ki11u: folds 
Uncalled bet ($47.21) returned to azzad2007
azzad2007 collected $37.34 from pot
azzad2007: doesn't show hand 
*** SUMMARY ***
Total pot $39.10 | Rake $1.76 
Board [Qh 3s 7h Ts 6h]
Seat 1: azzad2007 collected ($37.34)
Seat 2: o.miro folded before Flop (didn't bet)
Seat 3: PacPacBum (button) folded before Flop (didn't bet)
Seat 4: ki11u (small blind) folded on the River
Seat 5: eKCimann 666 (big blind) folded before Flop
Seat 6: Gamz11 folded before Flop (didn't bet)
Seat 7: uonlylive1ce folded on the Flop
Seat 8: matiko09 folded before Flop (didn't bet)
Seat 9: zhang0204 folded before Flop (didn't bet)





PokerStars Hand #150127043328:  Hold'em No Limit ($0.50/$1.00 USD) - 2016/03/10 13:57:06 CET [2016/03/10 7:57:06 ET]
Table 'Opik' 9-max Seat #1 is the button
Seat 1: 172140 ($106.90 in chips) 
Seat 3: Filojoes ($102.30 in chips) 
Seat 4: white huck ($62.14 in chips) 
Seat 5: matiko09 ($112.27 in chips) 
Seat 6: FroggyPlay ($100 in chips) 
vrnMike will be allowed to play after the button
Filojoes: posts small blind $0.50
white huck: posts big blind $1
pardama: sits out 
Komandantes: sits out 
*** HOLE CARDS ***
Dealt to matiko09 [Ad Qd]
matiko09: raises $2 to $3
FroggyPlay: folds 
172140: folds 
Filojoes: folds 
white huck: folds 
Uncalled bet ($2) returned to matiko09
matiko09 collected $2.50 from pot
matiko09: doesn't show hand 
*** SUMMARY ***
Total pot $2.50 | Rake $0 
Seat 1: 172140 (button) folded before Flop (didn't bet)
Seat 3: Filojoes (small blind) folded before Flop
Seat 4: white huck (big blind) folded before Flop
Seat 5: matiko09 collected ($2.50)
Seat 6: FroggyPlay folded before Flop (didn't bet)





PokerStars Hand #150127043753:  Hold'em No Limit ($1/$2 USD) - 2016/03/10 13:57:07 CET [2016/03/10 7:57:07 ET]
Table 'Chandra II' 9-max Seat #3 is the button
Seat 2: PacPacBum ($224.25 in chips) 
Seat 3: uonlylive1ce ($200 in chips) 
Seat 4: tipner ($201 in chips) 
Seat 5: uibting ($181.70 in chips) 
Seat 6: stds st ($135.82 in chips) 
Seat 7: johnvu2016 ($126.25 in chips) 
Seat 8: matiko09 ($224.68 in chips) 
Seat 9: o.miro ($347.67 in chips) 
tipner: posts small blind $1
uibting: posts big blind $2
Gamz11: sits out 
*** HOLE CARDS ***
Dealt to matiko09 [7d 7h]
stds st: folds 
johnvu2016: folds 
matiko09: raises $3 to $5
o.miro: folds 
PacPacBum: folds 
uonlylive1ce: raises $11 to $16
tipner: folds 
uibting: folds 
matiko09: folds 
Uncalled bet ($11) returned to uonlylive1ce
uonlylive1ce collected $13 from pot
uonlylive1ce: doesn't show hand 
*** SUMMARY ***
Total pot $13 | Rake $0 
Seat 2: PacPacBum folded before Flop (didn't bet)
Seat 3: uonlylive1ce (button) collected ($13)
Seat 4: tipner (small blind) folded before Flop
Seat 5: uibting (big blind) folded before Flop
Seat 6: stds st folded before Flop (didn't bet)
Seat 7: johnvu2016 folded before Flop (didn't bet)
Seat 8: matiko09 folded before Flop
Seat 9: o.miro folded before Flop (didn't bet)





PokerStars Hand #150127046636:  Hold'em No Limit (€1/€2 EUR) - 2016/03/10 13:57:13 CET [2016/03/10 7:57:13 ET]
Table 'Sigrid II' 9-max Seat #9 is the button
Seat 1: Gamz11 (€206 in chips) 
Seat 2: stds st (€92.47 in chips) 
Seat 5: vr188 (€90.94 in chips) 
Seat 7: PacPacBum (€208.57 in chips) 
Seat 8: matiko09 (€227.76 in chips) 
Seat 9: ki11u (€225.72 in chips) 
Gamz11: posts small blind €1
stds st: posts big blind €2
*** HOLE CARDS ***
Dealt to matiko09 [Qd Ts]
vr188: folds 
PacPacBum: folds 
matiko09: raises €3 to €5
ki11u: folds 
Gamz11: folds 
stds st: folds 
Uncalled bet (€3) returned to matiko09
matiko09 collected €5 from pot
matiko09: doesn't show hand 
*** SUMMARY ***
Total pot €5 | Rake €0 
Seat 1: Gamz11 (small blind) folded before Flop
Seat 2: stds st (big blind) folded before Flop
Seat 5: vr188 folded before Flop (didn't bet)
Seat 7: PacPacBum folded before Flop (didn't bet)
Seat 8: matiko09 collected (€5)
Seat 9: ki11u (button) folded before Flop (didn't bet)





PokerStars Hand #150127048682:  Hold'em No Limit ($0.25/$0.50 USD) - 2016/03/10 13:57:18 CET [2016/03/10 7:57:18 ET]
Table 'Aegina' 9-max Seat #2 is the button
Seat 1: congcongnbnb ($91.66 in chips) 
Seat 2: Spid1 ($101.64 in chips) 
Seat 3: MyMilkCans=D ($132.60 in chips) 
Seat 4: digimatical ($139.74 in chips) 
Seat 5: Ahangama ($50 in chips) 
Seat 6: matiko09 ($71.62 in chips) 
Seat 7: Gummio ($113.82 in chips) 
Seat 8: ardo888 ($169.97 in chips) 
MyMilkCans=D: posts small blind $0.25
digimatical: posts big blind $0.50
congcongnbnb: posts the ante $0.10
Spid1: posts the ante $0.10
MyMilkCans=D: posts the ante $0.10
digimatical: posts the ante $0.10
Ahangama: posts the ante $0.10
matiko09: posts the ante $0.10
Gummio: posts the ante $0.10
ardo888: posts the ante $0.10
*** HOLE CARDS ***
Dealt to matiko09 [3s Kh]
Ahangama: folds 
matiko09: folds 
Gummio: folds 
ardo888: raises $1.50 to $2
congcongnbnb: folds 
Spid1: calls $2
MyMilkCans=D: folds 
digimatical: folds 
*** FLOP *** [Qc Ac 2h]
ardo888: checks 
Spid1: bets $3.25
ardo888: folds 
Uncalled bet ($3.25) returned to Spid1
congcongnbnb leaves the table
Spid1 collected $5.30 from pot
Spid1: doesn't show hand 
*** SUMMARY ***
Total pot $5.55 | Rake $0.25 
Board [Qc Ac 2h]
Seat 1: congcongnbnb folded before Flop (didn't bet)
Seat 2: Spid1 (button) collected ($5.30)
Seat 3: MyMilkCans=D (small blind) folded before Flop
Seat 4: digimatical (big blind) folded before Flop
Seat 5: Ahangama folded before Flop (didn't bet)
Seat 6: matiko09 folded before Flop (didn't bet)
Seat 7: Gummio folded before Flop (didn't bet)
Seat 8: ardo888 folded on the Flop





PokerStars Hand #150127050249:  Hold'em No Limit ($0.50/$1.00 USD) - 2016/03/10 13:57:21 CET [2016/03/10 7:57:21 ET]
Table 'Opik' 9-max Seat #3 is the button
Seat 1: 172140 ($106.90 in chips) 
Seat 3: Filojoes ($101.80 in chips) 
Seat 4: white huck ($61.14 in chips) 
Seat 5: matiko09 ($113.77 in chips) 
Seat 6: FroggyPlay ($100 in chips) 
white huck: posts small blind $0.50
matiko09: posts big blind $1
pardama: sits out 
Komandantes: sits out 
vrnMike: sits out 
*** HOLE CARDS ***
Dealt to matiko09 [5h 8s]
FroggyPlay: folds 
172140: folds 
Filojoes: folds 
white huck: folds 
Uncalled bet ($0.50) returned to matiko09
matiko09 collected $1 from pot
matiko09: doesn't show hand 
*** SUMMARY ***
Total pot $1 | Rake $0 
Seat 1: 172140 folded before Flop (didn't bet)
Seat 3: Filojoes (button) folded before Flop (didn't bet)
Seat 4: white huck (small blind) folded before Flop
Seat 5: matiko09 (big blind) collected ($1)
Seat 6: FroggyPlay folded before Flop (didn't bet)





PokerStars Hand #150127056376:  Hold'em No Limit ($0.50/$1.00 USD) - 2016/03/10 13:57:33 CET [2016/03/10 7:57:33 ET]
Table 'Opik' 9-max Seat #4 is the button
Seat 1: 172140 ($106.90 in chips) 
Seat 3: Filojoes ($101.80 in chips) 
Seat 4: white huck ($60.64 in chips) 
Seat 5: matiko09 ($114.27 in chips) 
Seat 6: FroggyPlay ($100 in chips) 
matiko09: posts small blind $0.50
FroggyPlay: posts big blind $1
pardama: sits out 
Komandantes: sits out 
vrnMike: sits out 
*** HOLE CARDS ***
Dealt to matiko09 [8d 3s]
172140: raises $2 to $3
Filojoes: folds 
white huck: folds 
matiko09: folds 
FroggyPlay: folds 
Uncalled bet ($2) returned to 172140
172140 collected $2.50 from pot
172140: doesn't show hand 
*** SUMMARY ***
Total pot $2.50 | Rake $0 
Seat 1: 172140 collected ($2.50)
Seat 3: Filojoes folded before Flop (didn't bet)
Seat 4: white huck (button) folded before Flop (didn't bet)
Seat 5: matiko09 (small blind) folded before Flop
Seat 6: FroggyPlay (big blind) folded before Flop





PokerStars Hand #150127060346:  Hold'em No Limit ($1/$2 USD) - 2016/03/10 13:57:41 CET [2016/03/10 7:57:41 ET]
Table 'Chandra II' 9-max Seat #4 is the button
Seat 2: PacPacBum ($224.25 in chips) 
Seat 3: uonlylive1ce ($208 in chips) 
Seat 4: tipner ($200 in chips) 
Seat 5: uibting ($179.70 in chips) 
Seat 7: johnvu2016 ($200 in chips) 
Seat 8: matiko09 ($219.68 in chips) 
Seat 9: o.miro ($347.67 in chips) 
uibting: posts small blind $1
stds st: is sitting out 
johnvu2016: posts big blind $2
Gamz11: sits out 
*** HOLE CARDS ***
Dealt to matiko09 [5h Js]
matiko09: folds 
o.miro: folds 
PacPacBum: raises $2.08 to $4.08
uonlylive1ce: folds 
tipner: folds 
uibting: raises $10.16 to $14.24
johnvu2016: folds 
PacPacBum: folds 
Uncalled bet ($10.16) returned to uibting
uibting collected $10.16 from pot
*** SUMMARY ***
Total pot $10.16 | Rake $0 
Seat 2: PacPacBum folded before Flop
Seat 3: uonlylive1ce folded before Flop (didn't bet)
Seat 4: tipner (button) folded before Flop (didn't bet)
Seat 5: uibting (small blind) collected ($10.16)
Seat 7: johnvu2016 (big blind) folded before Flop
Seat 8: matiko09 folded before Flop (didn't bet)
Seat 9: o.miro folded before Flop (didn't bet)





PokerStars Hand #150127060569:  Hold'em No Limit ($0.50/$1.00 USD) - 2016/03/10 13:57:42 CET [2016/03/10 7:57:42 ET]
Table 'Prudentia II' 9-max Seat #6 is the button
Seat 1: oddjob008 ($84.89 in chips) 
Seat 2: PacPacBum ($100 in chips) 
Seat 3: Filojoes ($110.35 in chips) 
Seat 4: tinghai858 ($127.18 in chips) 
Seat 5: ilaviiitech ($100 in chips) 
Seat 6: Spid1 ($104.50 in chips) 
Seat 7: flk.Dasas ($100.50 in chips) 
Seat 9: matiko09 ($100 in chips) 
flk.Dasas: posts small blind $0.50
hammerwife: is sitting out 
matiko09: posts big blind $1
*** HOLE CARDS ***
Dealt to matiko09 [Kc 7c]
oddjob008: folds 
PacPacBum: folds 
Filojoes: folds 
tinghai858: calls $1
ilaviiitech: folds 
Spid1: folds 
flk.Dasas: folds 
matiko09: checks 
*** FLOP *** [Ad Kd Qd]
matiko09: checks 
tinghai858: bets $1
matiko09: folds 
Uncalled bet ($1) returned to tinghai858
tinghai858 collected $2.39 from pot
tinghai858: doesn't show hand 
*** SUMMARY ***
Total pot $2.50 | Rake $0.11 
Board [Ad Kd Qd]
Seat 1: oddjob008 folded before Flop (didn't bet)
Seat 2: PacPacBum folded before Flop (didn't bet)
Seat 3: Filojoes folded before Flop (didn't bet)
Seat 4: tinghai858 collected ($2.39)
Seat 5: ilaviiitech folded before Flop (didn't bet)
Seat 6: Spid1 (button) folded before Flop (didn't bet)
Seat 7: flk.Dasas (small blind) folded before Flop
Seat 9: matiko09 (big blind) folded on the Flop





PokerStars Hand #150127067065:  Hold'em No Limit ($0.50/$1.00 USD) - 2016/03/10 13:57:55 CET [2016/03/10 7:57:55 ET]
Table 'Opik' 9-max Seat #5 is the button
Seat 1: 172140 ($108.40 in chips) 
Seat 3: Filojoes ($101.80 in chips) 
Seat 4: white huck ($60.64 in chips) 
Seat 5: matiko09 ($113.77 in chips) 
Seat 6: FroggyPlay ($100 in chips) 
Seat 7: pardama ($100 in chips) 
FroggyPlay: posts small blind $0.50
pardama: posts big blind $1
Komandantes: sits out 
vrnMike: sits out 
*** HOLE CARDS ***
Dealt to matiko09 [Qd Ts]
172140: folds 
Filojoes: folds 
white huck: raises $1.43 to $2.43
matiko09: folds 
FroggyPlay: raises $6.57 to $9
pardama: folds 
white huck: calls $6.57
*** FLOP *** [Qs 2c Th]
FroggyPlay: bets $9.07
white huck: calls $9.07
*** TURN *** [Qs 2c Th] [7s]
FroggyPlay: checks 
white huck: checks 
*** RIVER *** [Qs 2c Th 7s] [Kc]
FroggyPlay: checks 
white huck: checks 
*** SHOW DOWN ***
FroggyPlay: shows [9h Ah] (high card Ace)
white huck: shows [Js Jc] (a pair of Jacks)
white huck collected $35.47 from pot
*** SUMMARY ***
Total pot $37.14 | Rake $1.67 
Board [Qs 2c Th 7s Kc]
Seat 1: 172140 folded before Flop (didn't bet)
Seat 3: Filojoes folded before Flop (didn't bet)
Seat 4: white huck showed [Js Jc] and won ($35.47) with a pair of Jacks
Seat 5: matiko09 (button) folded before Flop (didn't bet)
Seat 6: FroggyPlay (small blind) showed [9h Ah] and lost with high card Ace
Seat 7: pardama (big blind) folded before Flop





PokerStars Hand #150127068366:  Hold'em No Limit (€1/€2 EUR) - 2016/03/10 13:57:58 CET [2016/03/10 7:57:58 ET]
Table 'Sigrid II' 9-max Seat #1 is the button
Seat 1: Gamz11 (€205 in chips) 
Seat 2: stds st (€90.47 in chips) 
Seat 5: vr188 (€90.94 in chips) 
Seat 7: PacPacBum (€208.57 in chips) 
Seat 8: matiko09 (€230.76 in chips) 
Seat 9: ki11u (€225.72 in chips) 
stds st: posts small blind €1
vr188: posts big blind €2
*** HOLE CARDS ***
Dealt to matiko09 [Kh 2s]
PacPacBum: raises €4 to €6
matiko09: folds 
ki11u: folds 
Gamz11: folds 
stds st: folds 
vr188: folds 
Uncalled bet (€4) returned to PacPacBum
PacPacBum collected €5 from pot
PacPacBum: doesn't show hand 
*** SUMMARY ***
Total pot €5 | Rake €0 
Seat 1: Gamz11 (button) folded before Flop (didn't bet)
Seat 2: stds st (small blind) folded before Flop
Seat 5: vr188 (big blind) folded before Flop
Seat 7: PacPacBum collected (€5)
Seat 8: matiko09 folded before Flop (didn't bet)
Seat 9: ki11u folded before Flop (didn't bet)





PokerStars Hand #150127072130:  Hold'em No Limit ($0.50/$1.00 USD) - 2016/03/10 13:58:06 CET [2016/03/10 7:58:06 ET]
Table 'Leuschneria II' 9-max Seat #3 is the button
Seat 1: SHARKFIN168 ($123.62 in chips) 
Seat 2: blackw0lf_03 ($100 in chips) 
Seat 3: Spid1 ($115.54 in chips) 
Seat 5: RMilPoker ($222.20 in chips) 
Seat 6: matiko09 ($110.11 in chips) 
Seat 7: Plz3betMe ($44.57 in chips) 
Seat 8: UnBent022 ($100 in chips) 
Seat 9: ki11u ($100 in chips) 
RMilPoker: posts small blind $0.50
matiko09: posts big blind $1
*** HOLE CARDS ***
Dealt to matiko09 [Td 3h]
Plz3betMe: raises $1.50 to $2.50
UnBent022: folds 
ki11u: folds 
SHARKFIN168: folds 
blackw0lf_03: raises $3.50 to $6
Spid1: folds 
RMilPoker: folds 
matiko09: folds 
Plz3betMe: folds 
Uncalled bet ($3.50) returned to blackw0lf_03
blackw0lf_03 collected $6.50 from pot
blackw0lf_03: doesn't show hand 
*** SUMMARY ***
Total pot $6.50 | Rake $0 
Seat 1: SHARKFIN168 folded before Flop (didn't bet)
Seat 2: blackw0lf_03 collected ($6.50)
Seat 3: Spid1 (button) folded before Flop (didn't bet)
Seat 5: RMilPoker (small blind) folded before Flop
Seat 6: matiko09 (big blind) folded before Flop
Seat 7: Plz3betMe folded before Flop
Seat 8: UnBent022 folded before Flop (didn't bet)
Seat 9: ki11u folded before Flop (didn't bet)





PokerStars Hand #150127073924:  Hold'em No Limit ($0.50/$1.00 USD) - 2016/03/10 13:58:09 CET [2016/03/10 7:58:09 ET]
Table 'Iguassu' 9-max Seat #1 is the button
Seat 1: blackw0lf_03 ($100 in chips) 
Seat 2: Rocky6434 ($34.80 in chips) 
Seat 4: matiko09 ($109.50 in chips) 
Seat 5: UnBent022 ($100 in chips) 
Seat 6: Igor DoUrden ($109.88 in chips) 
Seat 7: PacPacBum ($117.05 in chips) 
Seat 8: Filojoes ($138.12 in chips) 
Seat 9: er13to ($127.23 in chips) 
Rocky6434: posts small blind $0.50
hammerwife: is sitting out 
matiko09: posts big blind $1
*** HOLE CARDS ***
Dealt to matiko09 [Qs Tc]
UnBent022: folds 
Igor DoUrden: folds 
PacPacBum: folds 
Filojoes: folds 
er13to: folds 
blackw0lf_03: folds 
Rocky6434: folds 
Uncalled bet ($0.50) returned to matiko09
matiko09 collected $1 from pot
matiko09: doesn't show hand 
*** SUMMARY ***
Total pot $1 | Rake $0 
Seat 1: blackw0lf_03 (button) folded before Flop (didn't bet)
Seat 2: Rocky6434 (small blind) folded before Flop
Seat 4: matiko09 (big blind) collected ($1)
Seat 5: UnBent022 folded before Flop (didn't bet)
Seat 6: Igor DoUrden folded before Flop (didn't bet)
Seat 7: PacPacBum folded before Flop (didn't bet)
Seat 8: Filojoes folded before Flop (didn't bet)
Seat 9: er13to folded before Flop (didn't bet)





PokerStars Hand #150127073861:  Hold'em No Limit ($0.25/$0.50 USD) - 2016/03/10 13:58:09 CET [2016/03/10 7:58:09 ET]
Table 'Aegina' 9-max Seat #3 is the button
Seat 2: Spid1 ($104.84 in chips) 
Seat 3: MyMilkCans=D ($132.25 in chips) 
Seat 4: digimatical ($139.14 in chips) 
Seat 6: matiko09 ($71.52 in chips) 
Seat 7: Gummio ($113.72 in chips) 
Seat 8: ardo888 ($167.87 in chips) 
digimatical: posts small blind $0.25
Ahangama: is sitting out 
matiko09: posts big blind $0.50
Spid1: posts the ante $0.10
MyMilkCans=D: posts the ante $0.10
digimatical: posts the ante $0.10
matiko09: posts the ante $0.10
Gummio: posts the ante $0.10
ardo888: posts the ante $0.10
*** HOLE CARDS ***
Dealt to matiko09 [Th 8d]
Ahangama leaves the table
Gummio: raises $0.50 to $1
ardo888: folds 
Spid1: folds 
MyMilkCans=D: folds 
digimatical: folds 
matiko09: folds 
Uncalled bet ($0.50) returned to Gummio
Gummio collected $1.85 from pot
Gummio: doesn't show hand 
*** SUMMARY ***
Total pot $1.85 | Rake $0 
Seat 2: Spid1 folded before Flop (didn't bet)
Seat 3: MyMilkCans=D (button) folded before Flop (didn't bet)
Seat 4: digimatical (small blind) folded before Flop
Seat 6: matiko09 (big blind) folded before Flop
Seat 7: Gummio collected ($1.85)
Seat 8: ardo888 folded before Flop (didn't bet)





PokerStars Hand #150127074320:  Hold'em No Limit ($1/$2 USD) - 2016/03/10 13:58:10 CET [2016/03/10 7:58:10 ET]
Table 'Chandra II' 9-max Seat #5 is the button
Seat 2: PacPacBum ($220.17 in chips) 
Seat 3: uonlylive1ce ($208 in chips) 
Seat 4: tipner ($200 in chips) 
Seat 5: uibting ($185.78 in chips) 
Seat 7: johnvu2016 ($198 in chips) 
Seat 8: matiko09 ($219.68 in chips) 
Seat 9: o.miro ($347.67 in chips) 
johnvu2016: posts small blind $1
matiko09: posts big blind $2
Gamz11: sits out 
*** HOLE CARDS ***
Dealt to matiko09 [Ah 9d]
o.miro: raises $4 to $6
PacPacBum: folds 
uonlylive1ce: folds 
tipner: folds 
uibting: calls $6
johnvu2016: folds 
matiko09: folds 
*** FLOP *** [Tc 2d Td]
o.miro: bets $4.86
uibting: calls $4.86
*** TURN *** [Tc 2d Td] [Qd]
o.miro: bets $12.27
uibting: folds 
Uncalled bet ($12.27) returned to o.miro
o.miro collected $23.61 from pot
o.miro: doesn't show hand 
*** SUMMARY ***
Total pot $24.72 | Rake $1.11 
Board [Tc 2d Td Qd]
Seat 2: PacPacBum folded before Flop (didn't bet)
Seat 3: uonlylive1ce folded before Flop (didn't bet)
Seat 4: tipner folded before Flop (didn't bet)
Seat 5: uibting (button) folded on the Turn
Seat 7: johnvu2016 (small blind) folded before Flop
Seat 8: matiko09 (big blind) folded before Flop
Seat 9: o.miro collected ($23.61)





PokerStars Hand #150127076650:  Hold'em No Limit ($1/$2 USD) - 2016/03/10 13:58:15 CET [2016/03/10 7:58:15 ET]
Table 'Tauris II' 9-max Seat #3 is the button
Seat 1: matiko09 ($200 in chips) 
Seat 2: stds st ($128.04 in chips) 
Seat 3: PacPacBum ($258.68 in chips) 
Seat 4: neomorf ($655.52 in chips) 
Seat 5: tipner ($200 in chips) 
Seat 6: uonlylive1ce ($204.42 in chips) 
Seat 8: scout326 ($215.07 in chips) 
Seat 9: darren1031 ($162.48 in chips) 
neomorf: posts small blind $1
tipner: posts big blind $2
Gamz11: sits out 
*** HOLE CARDS ***
Dealt to matiko09 [6h 8d]
uonlylive1ce: folds 
scout326: folds 
darren1031: calls $2
matiko09: folds 
stds st: folds 
PacPacBum: folds 
neomorf: raises $7 to $9
tipner: calls $7
darren1031: raises $153.48 to $162.48 and is all-in
neomorf: raises $333.96 to $496.44
tipner: folds 
Uncalled bet ($333.96) returned to neomorf
*** FLOP *** [Jd Kh 6s]
*** TURN *** [Jd Kh 6s] [5h]
*** RIVER *** [Jd Kh 6s 5h] [3h]
*** SHOW DOWN ***
neomorf: shows [Jc Js] (three of a kind, Jacks)
darren1031: shows [Ad Ks] (a pair of Kings)
neomorf collected $331.16 from pot
*** SUMMARY ***
Total pot $333.96 | Rake $2.80 
Board [Jd Kh 6s 5h 3h]
Seat 1: matiko09 folded before Flop (didn't bet)
Seat 2: stds st folded before Flop (didn't bet)
Seat 3: PacPacBum (button) folded before Flop (didn't bet)
Seat 4: neomorf (small blind) showed [Jc Js] and won ($331.16) with three of a kind, Jacks
Seat 5: tipner (big blind) folded before Flop
Seat 6: uonlylive1ce folded before Flop (didn't bet)
Seat 8: scout326 folded before Flop (didn't bet)
Seat 9: darren1031 showed [Ad Ks] and lost with a pair of Kings





PokerStars Hand #150127088365:  Hold'em No Limit ($0.50/$1.00 USD) - 2016/03/10 13:58:39 CET [2016/03/10 7:58:39 ET]
Table 'Iguassu' 9-max Seat #2 is the button
Seat 1: blackw0lf_03 ($100 in chips) 
Seat 2: Rocky6434 ($34.30 in chips) 
Seat 4: matiko09 ($110 in chips) 
Seat 5: UnBent022 ($100 in chips) 
Seat 6: Igor DoUrden ($109.88 in chips) 
Seat 7: PacPacBum ($117.05 in chips) 
Seat 8: Filojoes ($138.12 in chips) 
Seat 9: er13to ($127.23 in chips) 
matiko09: posts small blind $0.50
UnBent022: posts big blind $1
*** HOLE CARDS ***
Dealt to matiko09 [5h 6c]
Igor DoUrden: folds 
PacPacBum: folds 
Filojoes: folds 
er13to: folds 
blackw0lf_03: folds 
Rocky6434: folds 
matiko09: folds 
Uncalled bet ($0.50) returned to UnBent022
UnBent022 collected $1 from pot
UnBent022: doesn't show hand 
*** SUMMARY ***
Total pot $1 | Rake $0 
Seat 1: blackw0lf_03 folded before Flop (didn't bet)
Seat 2: Rocky6434 (button) folded before Flop (didn't bet)
Seat 4: matiko09 (small blind) folded before Flop
Seat 5: UnBent022 (big blind) collected ($1)
Seat 6: Igor DoUrden folded before Flop (didn't bet)
Seat 7: PacPacBum folded before Flop (didn't bet)
Seat 8: Filojoes folded before Flop (didn't bet)
Seat 9: er13to folded before Flop (didn't bet)





PokerStars Hand #150127089445:  Hold'em No Limit ($0.50/$1.00 USD) - 2016/03/10 13:58:41 CET [2016/03/10 7:58:41 ET]
Table 'Prudentia II' 9-max Seat #7 is the button
Seat 1: oddjob008 ($84.89 in chips) 
Seat 2: PacPacBum ($100 in chips) 
Seat 3: Filojoes ($110.35 in chips) 
Seat 4: tinghai858 ($128.57 in chips) 
Seat 5: ilaviiitech ($100 in chips) 
Seat 6: Spid1 ($104.50 in chips) 
Seat 7: flk.Dasas ($100 in chips) 
Seat 9: matiko09 ($100 in chips) 
matiko09: posts small blind $0.50
oddjob008: posts big blind $1
*** HOLE CARDS ***
Dealt to matiko09 [Jd Kd]
PacPacBum: folds 
Filojoes: folds 
tinghai858: raises $1 to $2
ilaviiitech: folds 
Spid1: calls $2
flk.Dasas: folds 
matiko09: calls $1.50
oddjob008: folds 
*** FLOP *** [2d 9c Ad]
matiko09: bets $4.34
tinghai858: raises $4.34 to $8.68
Spid1: folds 
matiko09: calls $4.34
*** TURN *** [2d 9c Ad] [4d]
matiko09: checks 
tinghai858: bets $12
matiko09: calls $12
*** RIVER *** [2d 9c Ad 4d] [5h]
matiko09: checks 
tinghai858: checks 
*** SHOW DOWN ***
matiko09: shows [Jd Kd] (a flush, Ace high)
tinghai858: mucks hand 
matiko09 collected $46.18 from pot
*** SUMMARY ***
Total pot $48.36 | Rake $2.18 
Board [2d 9c Ad 4d 5h]
Seat 1: oddjob008 (big blind) folded before Flop
Seat 2: PacPacBum folded before Flop (didn't bet)
Seat 3: Filojoes folded before Flop (didn't bet)
Seat 4: tinghai858 mucked [As Th]
Seat 5: ilaviiitech folded before Flop (didn't bet)
Seat 6: Spid1 folded on the Flop
Seat 7: flk.Dasas (button) folded before Flop (didn't bet)
Seat 9: matiko09 (small blind) showed [Jd Kd] and won ($46.18) with a flush, Ace high





PokerStars Hand #150127090717:  Hold'em No Limit ($0.25/$0.50 USD) - 2016/03/10 13:58:43 CET [2016/03/10 7:58:43 ET]
Table 'Aegina' 9-max Seat #4 is the button
Seat 2: Spid1 ($104.74 in chips) 
Seat 3: MyMilkCans=D ($132.15 in chips) 
Seat 4: digimatical ($138.79 in chips) 
Seat 6: matiko09 ($70.92 in chips) 
Seat 7: Gummio ($114.97 in chips) 
Seat 8: ardo888 ($167.77 in chips) 
matiko09: posts small blind $0.25
Gummio: posts big blind $0.50
Spid1: posts the ante $0.10
MyMilkCans=D: posts the ante $0.10
digimatical: posts the ante $0.10
matiko09: posts the ante $0.10
Gummio: posts the ante $0.10
ardo888: posts the ante $0.10
*** HOLE CARDS ***
Dealt to matiko09 [Kh Ks]
ardo888: folds 
Spid1: raises $1 to $1.50
MyMilkCans=D: folds 
digimatical: folds 
matiko09: raises $4.50 to $6
Gummio: folds 
Spid1: folds 
Uncalled bet ($4.50) returned to matiko09
Cmacher18 joins the table at seat #1 
matiko09 collected $4.10 from pot
matiko09: doesn't show hand 
*** SUMMARY ***
Total pot $4.10 | Rake $0 
Seat 2: Spid1 folded before Flop
Seat 3: MyMilkCans=D folded before Flop (didn't bet)
Seat 4: digimatical (button) folded before Flop (didn't bet)
Seat 6: matiko09 (small blind) collected ($4.10)
Seat 7: Gummio (big blind) folded before Flop
Seat 8: ardo888 folded before Flop (didn't bet)





PokerStars Hand #150127092266:  Hold'em No Limit ($0.50/$1.00 USD) - 2016/03/10 13:58:46 CET [2016/03/10 7:58:46 ET]
Table 'Leuschneria II' 9-max Seat #5 is the button
Seat 1: SHARKFIN168 ($123.62 in chips) 
Seat 2: blackw0lf_03 ($104 in chips) 
Seat 3: Spid1 ($115.54 in chips) 
Seat 5: RMilPoker ($221.70 in chips) 
Seat 6: matiko09 ($109.11 in chips) 
Seat 7: Plz3betMe ($42.07 in chips) 
Seat 8: UnBent022 ($100 in chips) 
Seat 9: ki11u ($100 in chips) 
matiko09: posts small blind $0.50
Plz3betMe: posts big blind $1
*** HOLE CARDS ***
Dealt to matiko09 [Kd Qc]
UnBent022: folds 
ki11u: folds 
SHARKFIN168: raises $2 to $3
blackw0lf_03: folds 
Spid1: folds 
RMilPoker: folds 
matiko09: folds 
Plz3betMe: folds 
Uncalled bet ($2) returned to SHARKFIN168
SHARKFIN168 collected $2.50 from pot
SHARKFIN168: doesn't show hand 
*** SUMMARY ***
Total pot $2.50 | Rake $0 
Seat 1: SHARKFIN168 collected ($2.50)
Seat 2: blackw0lf_03 folded before Flop (didn't bet)
Seat 3: Spid1 folded before Flop (didn't bet)
Seat 5: RMilPoker (button) folded before Flop (didn't bet)
Seat 6: matiko09 (small blind) folded before Flop
Seat 7: Plz3betMe (big blind) folded before Flop
Seat 8: UnBent022 folded before Flop (didn't bet)
Seat 9: ki11u folded before Flop (didn't bet)





PokerStars Hand #150127098597:  Hold'em No Limit ($0.50/$1.00 USD) - 2016/03/10 13:59:00 CET [2016/03/10 7:59:00 ET]
Table 'Iguassu' 9-max Seat #4 is the button
Seat 1: blackw0lf_03 ($100 in chips) 
Seat 2: Rocky6434 ($34.30 in chips) 
Seat 4: matiko09 ($109.50 in chips) 
Seat 5: UnBent022 ($100.50 in chips) 
Seat 6: Igor DoUrden ($109.88 in chips) 
Seat 7: PacPacBum ($117.05 in chips) 
Seat 8: Filojoes ($138.12 in chips) 
Seat 9: er13to ($127.23 in chips) 
UnBent022: posts small blind $0.50
Igor DoUrden: posts big blind $1
*** HOLE CARDS ***
Dealt to matiko09 [7s Tc]
PacPacBum: folds 
Filojoes: raises $2 to $3
er13to: folds 
blackw0lf_03: folds 
Rocky6434 has timed out
Rocky6434: folds 
matiko09: folds 
UnBent022: folds 
Igor DoUrden: folds 
Uncalled bet ($2) returned to Filojoes
Filojoes collected $2.50 from pot
Filojoes: doesn't show hand 
*** SUMMARY ***
Total pot $2.50 | Rake $0 
Seat 1: blackw0lf_03 folded before Flop (didn't bet)
Seat 2: Rocky6434 folded before Flop (didn't bet)
Seat 4: matiko09 (button) folded before Flop (didn't bet)
Seat 5: UnBent022 (small blind) folded before Flop
Seat 6: Igor DoUrden (big blind) folded before Flop
Seat 7: PacPacBum folded before Flop (didn't bet)
Seat 8: Filojoes collected ($2.50)
Seat 9: er13to folded before Flop (didn't bet)





PokerStars Hand #150127098801:  Hold'em No Limit ($1/$2 USD) - 2016/03/10 13:59:00 CET [2016/03/10 7:59:00 ET]
Table 'Solstice II' 9-max Seat #4 is the button
Seat 1: azzad2007 ($264.55 in chips) 
Seat 2: o.miro ($200 in chips) 
Seat 3: PacPacBum ($200 in chips) 
Seat 4: ki11u ($200 in chips) 
Seat 5: eKCimann 666 ($408.45 in chips) 
Seat 6: Gamz11 ($224.18 in chips) 
Seat 7: uonlylive1ce ($204.96 in chips) 
Seat 8: matiko09 ($200 in chips) 
Seat 9: zhang0204 ($226.68 in chips) 
eKCimann 666: posts small blind $1
Gamz11: posts big blind $2
*** HOLE CARDS ***
Dealt to matiko09 [6d 7h]
uonlylive1ce: folds 
matiko09: folds 
zhang0204: folds 
azzad2007: folds 
o.miro: folds 
PacPacBum: folds 
ki11u: raises $2.30 to $4.30
eKCimann 666: calls $3.30
Gamz11: folds 
*** FLOP *** [4c 5s 4h]
eKCimann 666: bets $10.12
ki11u: folds 
Uncalled bet ($10.12) returned to eKCimann 666
eKCimann 666 collected $10.12 from pot
eKCimann 666: doesn't show hand 
*** SUMMARY ***
Total pot $10.60 | Rake $0.48 
Board [4c 5s 4h]
Seat 1: azzad2007 folded before Flop (didn't bet)
Seat 2: o.miro folded before Flop (didn't bet)
Seat 3: PacPacBum folded before Flop (didn't bet)
Seat 4: ki11u (button) folded on the Flop
Seat 5: eKCimann 666 (small blind) collected ($10.12)
Seat 6: Gamz11 (big blind) folded before Flop
Seat 7: uonlylive1ce folded before Flop (didn't bet)
Seat 8: matiko09 folded before Flop (didn't bet)
Seat 9: zhang0204 folded before Flop (didn't bet)





PokerStars Hand #150127099470:  Hold'em No Limit ($1/$2 USD) - 2016/03/10 13:59:01 CET [2016/03/10 7:59:01 ET]
Table 'Chandra II' 9-max Seat #7 is the button
Seat 2: PacPacBum ($220.17 in chips) 
Seat 3: uonlylive1ce ($208 in chips) 
Seat 4: tipner ($200 in chips) 
Seat 5: uibting ($174.92 in chips) 
Seat 7: johnvu2016 ($197 in chips) 
Seat 8: matiko09 ($217.68 in chips) 
Seat 9: o.miro ($360.42 in chips) 
matiko09: posts small blind $1
o.miro: posts big blind $2
Gamz11: sits out 
*** HOLE CARDS ***
Dealt to matiko09 [2h Ad]
PacPacBum: folds 
uonlylive1ce: folds 
tipner: folds 
uibting: raises $4 to $6
johnvu2016: calls $6
matiko09: folds 
o.miro: calls $4
*** FLOP *** [3h 4d Ks]
o.miro: checks 
uibting: bets $9.07
johnvu2016: folds 
o.miro: calls $9.07
*** TURN *** [3h 4d Ks] [Jc]
o.miro: checks 
uibting: bets $22
o.miro: folds 
Uncalled bet ($22) returned to uibting
uibting collected $35.47 from pot
*** SUMMARY ***
Total pot $37.14 | Rake $1.67 
Board [3h 4d Ks Jc]
Seat 2: PacPacBum folded before Flop (didn't bet)
Seat 3: uonlylive1ce folded before Flop (didn't bet)
Seat 4: tipner folded before Flop (didn't bet)
Seat 5: uibting collected ($35.47)
Seat 7: johnvu2016 (button) folded on the Flop
Seat 8: matiko09 (small blind) folded before Flop
Seat 9: o.miro (big blind) folded on the Turn





PokerStars Hand #150127107482:  Hold'em No Limit ($0.50/$1.00 USD) - 2016/03/10 13:59:18 CET [2016/03/10 7:59:18 ET]
Table 'Leuschneria II' 9-max Seat #6 is the button
Seat 1: SHARKFIN168 ($125.12 in chips) 
Seat 2: blackw0lf_03 ($104 in chips) 
Seat 3: Spid1 ($115.54 in chips) 
Seat 5: RMilPoker ($221.70 in chips) 
Seat 6: matiko09 ($108.61 in chips) 
Seat 7: Plz3betMe ($41.07 in chips) 
Seat 8: UnBent022 ($100 in chips) 
Seat 9: ki11u ($100 in chips) 
Plz3betMe: posts small blind $0.50
UnBent022: posts big blind $1
*** HOLE CARDS ***
Dealt to matiko09 [Jc Qs]
ki11u: folds 
SHARKFIN168: folds 
blackw0lf_03: folds 
Spid1: folds 
RMilPoker: folds 
matiko09: raises $1.27 to $2.27
Plz3betMe: folds 
UnBent022: folds 
Uncalled bet ($1.27) returned to matiko09
matiko09 collected $2.50 from pot
matiko09: doesn't show hand 
*** SUMMARY ***
Total pot $2.50 | Rake $0 
Seat 1: SHARKFIN168 folded before Flop (didn't bet)
Seat 2: blackw0lf_03 folded before Flop (didn't bet)
Seat 3: Spid1 folded before Flop (didn't bet)
Seat 5: RMilPoker folded before Flop (didn't bet)
Seat 6: matiko09 (button) collected ($2.50)
Seat 7: Plz3betMe (small blind) folded before Flop
Seat 8: UnBent022 (big blind) folded before Flop
Seat 9: ki11u folded before Flop (didn't bet)





PokerStars Hand #150127111865:  Hold'em No Limit ($0.25/$0.50 USD) - 2016/03/10 13:59:27 CET [2016/03/10 7:59:27 ET]
Table 'Aegina' 9-max Seat #6 is the button
Seat 1: Cmacher18 ($50 in chips) 
Seat 2: Spid1 ($103.14 in chips) 
Seat 3: MyMilkCans=D ($132.05 in chips) 
Seat 4: digimatical ($138.69 in chips) 
Seat 6: matiko09 ($73.42 in chips) 
Seat 7: Gummio ($114.37 in chips) 
Seat 8: ardo888 ($167.67 in chips) 
Gummio: posts small blind $0.25
ardo888: posts big blind $0.50
Cmacher18: posts big blind $0.50
Cmacher18: posts the ante $0.10
Spid1: posts the ante $0.10
MyMilkCans=D: posts the ante $0.10
digimatical: posts the ante $0.10
matiko09: posts the ante $0.10
Gummio: posts the ante $0.10
ardo888: posts the ante $0.10
*** HOLE CARDS ***
Dealt to matiko09 [7d 5d]
Cmacher18: checks 
Spid1: folds 
MyMilkCans=D: raises $1.50 to $2
digimatical: folds 
matiko09: folds 
Gummio: raises $5.70 to $7.70
ardo888: folds 
Cmacher18: folds 
MyMilkCans=D: folds 
Uncalled bet ($5.70) returned to Gummio
Gummio collected $5.70 from pot
Gummio: doesn't show hand 
*** SUMMARY ***
Total pot $5.70 | Rake $0 
Seat 1: Cmacher18 folded before Flop
Seat 2: Spid1 folded before Flop (didn't bet)
Seat 3: MyMilkCans=D folded before Flop
Seat 4: digimatical folded before Flop (didn't bet)
Seat 6: matiko09 (button) folded before Flop (didn't bet)
Seat 7: Gummio (small blind) collected ($5.70)
Seat 8: ardo888 (big blind) folded before Flop





PokerStars Hand #150127115186:  Hold'em No Limit ($1/$2 USD) - 2016/03/10 13:59:33 CET [2016/03/10 7:59:33 ET]
Table 'Tauris II' 9-max Seat #4 is the button
Seat 1: matiko09 ($200 in chips) 
Seat 2: stds st ($128.04 in chips) 
Seat 3: PacPacBum ($258.68 in chips) 
Seat 4: neomorf ($824.20 in chips) 
Seat 5: tipner ($200 in chips) 
Seat 6: uonlylive1ce ($204.42 in chips) 
Seat 8: scout326 ($215.07 in chips) 
tipner: posts small blind $1
uonlylive1ce: posts big blind $2
Gamz11: sits out 
*** HOLE CARDS ***
Dealt to matiko09 [2d 9s]
scout326: folds 
matiko09: folds 
stds st: folds 
PacPacBum: raises $2.08 to $4.08
neomorf: calls $4.08
tipner: folds 
uonlylive1ce: folds 
*** FLOP *** [Ah 8d 7c]
PacPacBum: checks 
neomorf: checks 
*** TURN *** [Ah 8d 7c] [Qc]
PacPacBum: checks 
neomorf: bets $8
PacPacBum: calls $8
*** RIVER *** [Ah 8d 7c Qc] [Tc]
PacPacBum: checks 
neomorf: checks 
*** SHOW DOWN ***
PacPacBum: shows [9d Ac] (a pair of Aces)
neomorf: mucks hand 
PacPacBum collected $25.94 from pot
*** SUMMARY ***
Total pot $27.16 | Rake $1.22 
Board [Ah 8d 7c Qc Tc]
Seat 1: matiko09 folded before Flop (didn't bet)
Seat 2: stds st folded before Flop (didn't bet)
Seat 3: PacPacBum showed [9d Ac] and won ($25.94) with a pair of Aces
Seat 4: neomorf (button) mucked [5s As]
Seat 5: tipner (small blind) folded before Flop
Seat 6: uonlylive1ce (big blind) folded before Flop
Seat 8: scout326 folded before Flop (didn't bet)





PokerStars Hand #150127115408:  Hold'em No Limit ($0.50/$1.00 USD) - 2016/03/10 13:59:34 CET [2016/03/10 7:59:34 ET]
Table 'Opik' 9-max Seat #6 is the button
Seat 1: 172140 ($108.40 in chips) 
Seat 3: Filojoes ($101.80 in chips) 
Seat 4: white huck ($78.04 in chips) 
Seat 5: matiko09 ($113.77 in chips) 
Seat 6: FroggyPlay ($100 in chips) 
Seat 7: pardama ($100 in chips) 
Seat 8: Komandantes ($100 in chips) 
pardama: posts small blind $0.50
Komandantes: posts big blind $1
vrnMike: sits out 
*** HOLE CARDS ***
Dealt to matiko09 [Kh 5d]
172140: folds 
Filojoes: folds 
white huck: raises $1.43 to $2.43
matiko09: folds 
FroggyPlay: folds 
pardama: folds 
Komandantes: folds 
Uncalled bet ($1.43) returned to white huck
white huck collected $2.50 from pot
white huck: doesn't show hand 
*** SUMMARY ***
Total pot $2.50 | Rake $0 
Seat 1: 172140 folded before Flop (didn't bet)
Seat 3: Filojoes folded before Flop (didn't bet)
Seat 4: white huck collected ($2.50)
Seat 5: matiko09 folded before Flop (didn't bet)
Seat 6: FroggyPlay (button) folded before Flop (didn't bet)
Seat 7: pardama (small blind) folded before Flop
Seat 8: Komandantes (big blind) folded before Flop





PokerStars Hand #150127128456:  Hold'em No Limit ($0.50/$1.00 USD) - 2016/03/10 14:00:00 CET [2016/03/10 8:00:00 ET]
Table 'Opik' 9-max Seat #7 is the button
Seat 1: 172140 ($108.40 in chips) 
Seat 3: Filojoes ($101.80 in chips) 
Seat 4: white huck ($79.54 in chips) 
Seat 5: matiko09 ($113.77 in chips) 
Seat 6: FroggyPlay ($100 in chips) 
Seat 7: pardama ($100 in chips) 
Seat 8: Komandantes ($100 in chips) 
Komandantes: posts small blind $0.50
172140: posts big blind $1
vrnMike: sits out 
*** HOLE CARDS ***
Dealt to matiko09 [Kh 4h]
Filojoes: raises $2 to $3
white huck: folds 
matiko09: folds 
FroggyPlay: folds 
pardama: folds 
Komandantes: folds 
172140: folds 
Uncalled bet ($2) returned to Filojoes
Filojoes collected $2.50 from pot
Filojoes: doesn't show hand 
*** SUMMARY ***
Total pot $2.50 | Rake $0 
Seat 1: 172140 (big blind) folded before Flop
Seat 3: Filojoes collected ($2.50)
Seat 4: white huck folded before Flop (didn't bet)
Seat 5: matiko09 folded before Flop (didn't bet)
Seat 6: FroggyPlay folded before Flop (didn't bet)
Seat 7: pardama (button) folded before Flop (didn't bet)
Seat 8: Komandantes (small blind) folded before Flop





PokerStars Hand #150127129249:  Hold'em No Limit ($0.50/$1.00 USD) - 2016/03/10 14:00:01 CET [2016/03/10 8:00:01 ET]
Table 'Iguassu' 9-max Seat #5 is the button
Seat 1: blackw0lf_03 ($100 in chips) 
Seat 4: matiko09 ($109.50 in chips) 
Seat 5: UnBent022 ($100 in chips) 
Seat 6: Igor DoUrden ($108.88 in chips) 
Seat 7: PacPacBum ($117.05 in chips) 
Seat 8: Filojoes ($139.62 in chips) 
Seat 9: er13to ($127.23 in chips) 
Igor DoUrden: posts small blind $0.50
PacPacBum: posts big blind $1
*** HOLE CARDS ***
Dealt to matiko09 [Qc 9h]
Filojoes: folds 
er13to: folds 
blackw0lf_03: folds 
matiko09: folds 
UnBent022: raises $1 to $2
Igor DoUrden: folds 
PacPacBum: folds 
Uncalled bet ($1) returned to UnBent022
UnBent022 collected $2.50 from pot
UnBent022: doesn't show hand 
*** SUMMARY ***
Total pot $2.50 | Rake $0 
Seat 1: blackw0lf_03 folded before Flop (didn't bet)
Seat 4: matiko09 folded before Flop (didn't bet)
Seat 5: UnBent022 (button) collected ($2.50)
Seat 6: Igor DoUrden (small blind) folded before Flop
Seat 7: PacPacBum (big blind) folded before Flop
Seat 8: Filojoes folded before Flop (didn't bet)
Seat 9: er13to folded before Flop (didn't bet)





PokerStars Hand #150127129888:  Hold'em No Limit ($1/$2 USD) - 2016/03/10 14:00:03 CET [2016/03/10 8:00:03 ET]
Table 'Chandra II' 9-max Seat #8 is the button
Seat 1: Gamz11 ($200 in chips) 
Seat 2: PacPacBum ($220.17 in chips) 
Seat 3: uonlylive1ce ($208 in chips) 
Seat 4: tipner ($200 in chips) 
Seat 5: uibting ($195.32 in chips) 
Seat 7: johnvu2016 ($191 in chips) 
Seat 8: matiko09 ($216.68 in chips) 
Seat 9: o.miro ($345.35 in chips) 
o.miro: posts small blind $1
Gamz11: posts big blind $2
*** HOLE CARDS ***
Dealt to matiko09 [4h 6s]
PacPacBum: raises $2.08 to $4.08
uonlylive1ce: folds 
tipner: folds 
uibting: folds 
johnvu2016: folds 
matiko09: folds 
o.miro: folds 
Gamz11: calls $2.08
*** FLOP *** [2c 7h Jh]
Gamz11: checks 
PacPacBum: bets $4.72
Gamz11: folds 
Uncalled bet ($4.72) returned to PacPacBum
PacPacBum collected $8.75 from pot
PacPacBum: doesn't show hand 
*** SUMMARY ***
Total pot $9.16 | Rake $0.41 
Board [2c 7h Jh]
Seat 1: Gamz11 (big blind) folded on the Flop
Seat 2: PacPacBum collected ($8.75)
Seat 3: uonlylive1ce folded before Flop (didn't bet)
Seat 4: tipner folded before Flop (didn't bet)
Seat 5: uibting folded before Flop (didn't bet)
Seat 7: johnvu2016 folded before Flop (didn't bet)
Seat 8: matiko09 (button) folded before Flop (didn't bet)
Seat 9: o.miro (small blind) folded before Flop





PokerStars Hand #150127131111:  Hold'em No Limit ($1/$2 USD) - 2016/03/10 14:00:05 CET [2016/03/10 8:00:05 ET]
Table 'Solstice II' 9-max Seat #5 is the button
Seat 1: azzad2007 ($264.55 in chips) 
Seat 2: o.miro ($200 in chips) 
Seat 3: PacPacBum ($200 in chips) 
Seat 4: ki11u ($200 in chips) 
Seat 5: eKCimann 666 ($414.27 in chips) 
Seat 6: Gamz11 ($222.18 in chips) 
Seat 7: uonlylive1ce ($204.96 in chips) 
Seat 8: matiko09 ($200 in chips) 
Seat 9: zhang0204 ($226.68 in chips) 
Gamz11: posts small blind $1
uonlylive1ce: posts big blind $2
*** HOLE CARDS ***
Dealt to matiko09 [5h 3d]
matiko09: folds 
zhang0204: folds 
azzad2007: folds 
o.miro: folds 
PacPacBum: folds 
ki11u: raises $3.10 to $5.10
eKCimann 666: folds 
Gamz11: folds 
uonlylive1ce: folds 
Uncalled bet ($3.10) returned to ki11u
ki11u collected $5 from pot
ki11u: doesn't show hand 
*** SUMMARY ***
Total pot $5 | Rake $0 
Seat 1: azzad2007 folded before Flop (didn't bet)
Seat 2: o.miro folded before Flop (didn't bet)
Seat 3: PacPacBum folded before Flop (didn't bet)
Seat 4: ki11u collected ($5)
Seat 5: eKCimann 666 (button) folded before Flop (didn't bet)
Seat 6: Gamz11 (small blind) folded before Flop
Seat 7: uonlylive1ce (big blind) folded before Flop
Seat 8: matiko09 folded before Flop (didn't bet)
Seat 9: zhang0204 folded before Flop (didn't bet)





PokerStars Hand #150127131247:  Hold'em No Limit ($0.50/$1.00 USD) - 2016/03/10 14:00:05 CET [2016/03/10 8:00:05 ET]
Table 'Leuschneria II' 9-max Seat #7 is the button
Seat 1: SHARKFIN168 ($125.12 in chips) 
Seat 2: blackw0lf_03 ($104 in chips) 
Seat 3: Spid1 ($115.54 in chips) 
Seat 5: RMilPoker ($221.70 in chips) 
Seat 6: matiko09 ($110.11 in chips) 
Seat 7: Plz3betMe ($40.57 in chips) 
Seat 8: UnBent022 ($100 in chips) 
Seat 9: ki11u ($100 in chips) 
UnBent022: posts small blind $0.50
ki11u: posts big blind $1
*** HOLE CARDS ***
Dealt to matiko09 [8d 6h]
SHARKFIN168: folds 
blackw0lf_03: folds 
Spid1: raises $2 to $3
RMilPoker: raises $7.50 to $10.50
matiko09: folds 
Plz3betMe: folds 
UnBent022: folds 
ki11u: folds 
Spid1: folds 
Uncalled bet ($7.50) returned to RMilPoker
RMilPoker collected $7.50 from pot
RMilPoker: doesn't show hand 
*** SUMMARY ***
Total pot $7.50 | Rake $0 
Seat 1: SHARKFIN168 folded before Flop (didn't bet)
Seat 2: blackw0lf_03 folded before Flop (didn't bet)
Seat 3: Spid1 folded before Flop
Seat 5: RMilPoker collected ($7.50)
Seat 6: matiko09 folded before Flop (didn't bet)
Seat 7: Plz3betMe (button) folded before Flop (didn't bet)
Seat 8: UnBent022 (small blind) folded before Flop
Seat 9: ki11u (big blind) folded before Flop





PokerStars Hand #150127139727:  Hold'em No Limit ($0.50/$1.00 USD) - 2016/03/10 14:00:21 CET [2016/03/10 8:00:21 ET]
Table 'Opik' 9-max Seat #8 is the button
Seat 1: 172140 ($107.40 in chips) 
Seat 2: vrnMike ($100 in chips) 
Seat 3: Filojoes ($103.30 in chips) 
Seat 4: white huck ($79.54 in chips) 
Seat 5: matiko09 ($113.77 in chips) 
Seat 6: FroggyPlay ($100 in chips) 
Seat 7: pardama ($100 in chips) 
Seat 8: Komandantes ($100 in chips) 
172140: posts small blind $0.50
vrnMike: posts big blind $1
*** HOLE CARDS ***
Dealt to matiko09 [Ac 7c]
Filojoes: folds 
white huck: folds 
matiko09: folds 
FroggyPlay: raises $2 to $3
pardama: folds 
Komandantes: folds 
172140: folds 
vrnMike: folds 
Uncalled bet ($2) returned to FroggyPlay
FroggyPlay collected $2.50 from pot
FroggyPlay: doesn't show hand 
*** SUMMARY ***
Total pot $2.50 | Rake $0 
Seat 1: 172140 (small blind) folded before Flop
Seat 2: vrnMike (big blind) folded before Flop
Seat 3: Filojoes folded before Flop (didn't bet)
Seat 4: white huck folded before Flop (didn't bet)
Seat 5: matiko09 folded before Flop (didn't bet)
Seat 6: FroggyPlay collected ($2.50)
Seat 7: pardama folded before Flop (didn't bet)
Seat 8: Komandantes (button) folded before Flop (didn't bet)





PokerStars Hand #150127145162:  Hold'em No Limit ($0.50/$1.00 USD) - 2016/03/10 14:00:32 CET [2016/03/10 8:00:32 ET]
Table 'Prudentia II' 9-max Seat #9 is the button
Seat 1: oddjob008 ($83.89 in chips) 
Seat 2: PacPacBum ($100 in chips) 
Seat 3: Filojoes ($110.35 in chips) 
Seat 4: tinghai858 ($105.89 in chips) 
Seat 5: ilaviiitech ($100 in chips) 
Seat 6: Spid1 ($102.50 in chips) 
Seat 7: flk.Dasas ($100 in chips) 
Seat 9: matiko09 ($123.50 in chips) 
oddjob008: posts small blind $0.50
PacPacBum: posts big blind $1
*** HOLE CARDS ***
Dealt to matiko09 [Ts 6c]
Filojoes: raises $2 to $3
tinghai858: raises $2 to $5
ilaviiitech: folds 
Spid1: folds 
flk.Dasas: folds 
matiko09: folds 
oddjob008: folds 
PacPacBum: folds 
Filojoes: calls $2
*** FLOP *** [Td Ah Tc]
Filojoes: checks 
tinghai858: bets $1
Filojoes: calls $1
*** TURN *** [Td Ah Tc] [5c]
Filojoes: checks 
tinghai858: bets $1
Filojoes: calls $1
*** RIVER *** [Td Ah Tc 5c] [5s]
Filojoes: checks 
tinghai858: checks 
*** SHOW DOWN ***
Filojoes: shows [9c 9s] (two pair, Tens and Nines)
tinghai858: shows [Qs Ad] (two pair, Aces and Tens)
tinghai858 collected $14.80 from pot
*** SUMMARY ***
Total pot $15.50 | Rake $0.70 
Board [Td Ah Tc 5c 5s]
Seat 1: oddjob008 (small blind) folded before Flop
Seat 2: PacPacBum (big blind) folded before Flop
Seat 3: Filojoes showed [9c 9s] and lost with two pair, Tens and Nines
Seat 4: tinghai858 showed [Qs Ad] and won ($14.80) with two pair, Aces and Tens
Seat 5: ilaviiitech folded before Flop (didn't bet)
Seat 6: Spid1 folded before Flop (didn't bet)
Seat 7: flk.Dasas folded before Flop (didn't bet)
Seat 9: matiko09 (button) folded before Flop (didn't bet)





PokerStars Hand #150127150729:  Hold'em No Limit ($1/$2 USD) - 2016/03/10 14:00:43 CET [2016/03/10 8:00:43 ET]
Table 'Chandra II' 9-max Seat #9 is the button
Seat 1: Gamz11 ($200 in chips) 
Seat 2: PacPacBum ($224.84 in chips) 
Seat 3: uonlylive1ce ($208 in chips) 
Seat 4: tipner ($200 in chips) 
Seat 5: uibting ($195.32 in chips) 
Seat 7: johnvu2016 ($191 in chips) 
Seat 8: matiko09 ($216.68 in chips) 
Seat 9: o.miro ($344.35 in chips) 
Gamz11: posts small blind $1
PacPacBum: posts big blind $2
*** HOLE CARDS ***
Dealt to matiko09 [Kd 4c]
uonlylive1ce: folds 
tipner: raises $4 to $6
uibting: folds 
johnvu2016: folds 
matiko09: folds 
o.miro: folds 
Gamz11: folds 
PacPacBum: folds 
Uncalled bet ($4) returned to tipner
tipner collected $5 from pot
tipner: doesn't show hand 
*** SUMMARY ***
Total pot $5 | Rake $0 
Seat 1: Gamz11 (small blind) folded before Flop
Seat 2: PacPacBum (big blind) folded before Flop
Seat 3: uonlylive1ce folded before Flop (didn't bet)
Seat 4: tipner collected ($5)
Seat 5: uibting folded before Flop (didn't bet)
Seat 7: johnvu2016 folded before Flop (didn't bet)
Seat 8: matiko09 folded before Flop (didn't bet)
Seat 9: o.miro (button) folded before Flop (didn't bet)





PokerStars Hand #150127154452:  Hold'em No Limit ($1/$2 USD) - 2016/03/10 14:00:50 CET [2016/03/10 8:00:50 ET]
Table 'Tauris II' 9-max Seat #5 is the button
Seat 1: matiko09 ($200 in chips) 
Seat 2: stds st ($128.04 in chips) 
Seat 3: PacPacBum ($272.54 in chips) 
Seat 4: neomorf ($812.12 in chips) 
Seat 5: tipner ($200 in chips) 
Seat 6: uonlylive1ce ($202.42 in chips) 
Seat 7: Gamz11 ($200 in chips) 
Seat 8: scout326 ($215.07 in chips) 
Seat 9: darren1031 ($129.06 in chips) 
uonlylive1ce: posts small blind $1
Gamz11: posts big blind $2
*** HOLE CARDS ***
Dealt to matiko09 [Ah 6s]
scout326: folds 
darren1031: folds 
matiko09: folds 
stds st: raises $3 to $5
PacPacBum: folds 
neomorf: folds 
tipner: folds 
uonlylive1ce: raises $9 to $14
Gamz11: folds 
stds st: raises $10 to $24
uonlylive1ce: calls $10
*** FLOP *** [Td 2c 9h]
uonlylive1ce: checks 
stds st: bets $19.10
uonlylive1ce: folds 
Uncalled bet ($19.10) returned to stds st
stds st collected $47.75 from pot
stds st: doesn't show hand 
*** SUMMARY ***
Total pot $50 | Rake $2.25 
Board [Td 2c 9h]
Seat 1: matiko09 folded before Flop (didn't bet)
Seat 2: stds st collected ($47.75)
Seat 3: PacPacBum folded before Flop (didn't bet)
Seat 4: neomorf folded before Flop (didn't bet)
Seat 5: tipner (button) folded before Flop (didn't bet)
Seat 6: uonlylive1ce (small blind) folded on the Flop
Seat 7: Gamz11 (big blind) folded before Flop
Seat 8: scout326 folded before Flop (didn't bet)
Seat 9: darren1031 folded before Flop (didn't bet)





PokerStars Hand #150127155183:  Hold'em No Limit ($0.50/$1.00 USD) - 2016/03/10 14:00:51 CET [2016/03/10 8:00:51 ET]
Table 'Opik' 9-max Seat #1 is the button
Seat 1: 172140 ($106.90 in chips) 
Seat 2: vrnMike ($100 in chips) 
Seat 3: Filojoes ($103.30 in chips) 
Seat 4: white huck ($79.54 in chips) 
Seat 5: matiko09 ($113.77 in chips) 
Seat 6: FroggyPlay ($101.50 in chips) 
Seat 7: pardama ($100 in chips) 
Seat 8: Komandantes ($100 in chips) 
vrnMike: posts small blind $0.50
Filojoes: posts big blind $1
*** HOLE CARDS ***
Dealt to matiko09 [9h 5s]
white huck: folds 
matiko09: folds 
FroggyPlay: folds 
pardama: raises $1.50 to $2.50
Komandantes: folds 
172140: folds 
vrnMike: folds 
Filojoes: folds 
Uncalled bet ($1.50) returned to pardama
pardama collected $2.50 from pot
pardama: doesn't show hand 
*** SUMMARY ***
Total pot $2.50 | Rake $0 
Seat 1: 172140 (button) folded before Flop (didn't bet)
Seat 2: vrnMike (small blind) folded before Flop
Seat 3: Filojoes (big blind) folded before Flop
Seat 4: white huck folded before Flop (didn't bet)
Seat 5: matiko09 folded before Flop (didn't bet)
Seat 6: FroggyPlay folded before Flop (didn't bet)
Seat 7: pardama collected ($2.50)
Seat 8: Komandantes folded before Flop (didn't bet)





PokerStars Hand #150127159511:  Hold'em No Limit ($0.25/$0.50 USD) - 2016/03/10 14:01:00 CET [2016/03/10 8:01:00 ET]
Table 'Aegina' 9-max Seat #7 is the button
Seat 1: Cmacher18 ($49.40 in chips) 
Seat 2: Spid1 ($103.04 in chips) 
Seat 3: MyMilkCans=D ($129.95 in chips) 
Seat 4: digimatical ($138.59 in chips) 
Seat 6: matiko09 ($73.32 in chips) 
Seat 7: Gummio ($117.97 in chips) 
Seat 8: ardo888 ($167.07 in chips) 
ardo888: posts small blind $0.25
Cmacher18: posts big blind $0.50
Cmacher18: posts the ante $0.10
Spid1: posts the ante $0.10
MyMilkCans=D: posts the ante $0.10
digimatical: posts the ante $0.10
matiko09: posts the ante $0.10
Gummio: posts the ante $0.10
ardo888: posts the ante $0.10
*** HOLE CARDS ***
Dealt to matiko09 [2d Qd]
Spid1: raises $1 to $1.50
MyMilkCans=D: folds 
digimatical: folds 
matiko09: folds 
Gummio: folds 
universpok22 joins the table at seat #5 
ardo888: folds 
Cmacher18: calls $1
*** FLOP *** [Jc Js 9c]
Cmacher18: checks 
Spid1: bets $2.50
Cmacher18: folds 
Uncalled bet ($2.50) returned to Spid1
Spid1 collected $3.77 from pot
Spid1: doesn't show hand 
*** SUMMARY ***
Total pot $3.95 | Rake $0.18 
Board [Jc Js 9c]
Seat 1: Cmacher18 (big blind) folded on the Flop
Seat 2: Spid1 collected ($3.77)
Seat 3: MyMilkCans=D folded before Flop (didn't bet)
Seat 4: digimatical folded before Flop (didn't bet)
Seat 6: matiko09 folded before Flop (didn't bet)
Seat 7: Gummio (button) folded before Flop (didn't bet)
Seat 8: ardo888 (small blind) folded before Flop





PokerStars Hand #150127160546:  Hold'em No Limit ($0.50/$1.00 USD) - 2016/03/10 14:01:01 CET [2016/03/10 8:01:01 ET]
Table 'Iguassu' 9-max Seat #6 is the button
Seat 1: blackw0lf_03 ($100 in chips) 
Seat 2: Rocky6434 ($34.30 in chips) 
Seat 4: matiko09 ($109.50 in chips) 
Seat 5: UnBent022 ($101.50 in chips) 
Seat 6: Igor DoUrden ($108.38 in chips) 
Seat 7: PacPacBum ($116.05 in chips) 
Seat 8: Filojoes ($139.62 in chips) 
Seat 9: er13to ($127.23 in chips) 
PacPacBum: posts small blind $0.50
Filojoes: posts big blind $1
*** HOLE CARDS ***
Dealt to matiko09 [3h 2s]
er13to: folds 
blackw0lf_03: folds 
Rocky6434: folds 
matiko09: folds 
UnBent022: raises $1.50 to $2.50
Igor DoUrden: folds 
PacPacBum: raises $5.50 to $8
Filojoes: raises $12 to $20
UnBent022: folds 
PacPacBum: calls $12
*** FLOP *** [9d Qh 8s]
PacPacBum: checks 
Filojoes: checks 
*** TURN *** [9d Qh 8s] [3d]
PacPacBum: bets $21.91
Filojoes: calls $21.91
*** RIVER *** [9d Qh 8s 3d] [Kh]
PacPacBum: checks 
Filojoes: checks 
*** SHOW DOWN ***
PacPacBum: shows [7s 6s] (high card King)
Filojoes: shows [Qs Ah] (a pair of Queens)
Filojoes collected $83.52 from pot
*** SUMMARY ***
Total pot $86.32 | Rake $2.80 
Board [9d Qh 8s 3d Kh]
Seat 1: blackw0lf_03 folded before Flop (didn't bet)
Seat 2: Rocky6434 folded before Flop (didn't bet)
Seat 4: matiko09 folded before Flop (didn't bet)
Seat 5: UnBent022 folded before Flop
Seat 6: Igor DoUrden (button) folded before Flop (didn't bet)
Seat 7: PacPacBum (small blind) showed [7s 6s] and lost with high card King
Seat 8: Filojoes (big blind) showed [Qs Ah] and won ($83.52) with a pair of Queens
Seat 9: er13to folded before Flop (didn't bet)





PokerStars Hand #150127160230:  Hold'em No Limit ($0.50/$1.00 USD) - 2016/03/10 14:01:01 CET [2016/03/10 8:01:01 ET]
Table 'Leuschneria II' 9-max Seat #8 is the button
Seat 1: SHARKFIN168 ($125.12 in chips) 
Seat 2: blackw0lf_03 ($104 in chips) 
Seat 3: Spid1 ($112.54 in chips) 
Seat 5: RMilPoker ($226.20 in chips) 
Seat 6: matiko09 ($110.11 in chips) 
Seat 7: Plz3betMe ($40.57 in chips) 
Seat 8: UnBent022 ($100 in chips) 
Seat 9: ki11u ($100 in chips) 
ki11u: posts small blind $0.50
SHARKFIN168: posts big blind $1
*** HOLE CARDS ***
Dealt to matiko09 [3h 5s]
blackw0lf_03: folds 
Spid1: folds 
RMilPoker: folds 
matiko09: folds 
Plz3betMe: folds 
UnBent022: raises $1 to $2
ki11u: folds 
SHARKFIN168: calls $1
*** FLOP *** [9h Ad 2s]
SHARKFIN168: checks 
UnBent022: bets $2.97
SHARKFIN168: calls $2.97
*** TURN *** [9h Ad 2s] [Tc]
SHARKFIN168: checks 
UnBent022: checks 
*** RIVER *** [9h Ad 2s Tc] [7h]
SHARKFIN168: bets $5
UnBent022: calls $5
*** SHOW DOWN ***
SHARKFIN168: shows [6c 9c] (a pair of Nines)
UnBent022: shows [8s Ts] (a pair of Tens)
UnBent022 collected $19.52 from pot
*** SUMMARY ***
Total pot $20.44 | Rake $0.92 
Board [9h Ad 2s Tc 7h]
Seat 1: SHARKFIN168 (big blind) showed [6c 9c] and lost with a pair of Nines
Seat 2: blackw0lf_03 folded before Flop (didn't bet)
Seat 3: Spid1 folded before Flop (didn't bet)
Seat 5: RMilPoker folded before Flop (didn't bet)
Seat 6: matiko09 folded before Flop (didn't bet)
Seat 7: Plz3betMe folded before Flop (didn't bet)
Seat 8: UnBent022 (button) showed [8s Ts] and won ($19.52) with a pair of Tens
Seat 9: ki11u (small blind) folded before Flop





PokerStars Hand #150127167660:  Hold'em No Limit ($1/$2 USD) - 2016/03/10 14:01:14 CET [2016/03/10 8:01:14 ET]
Table 'Chandra II' 9-max Seat #1 is the button
Seat 1: Gamz11 ($200 in chips) 
Seat 2: PacPacBum ($222.84 in chips) 
Seat 3: uonlylive1ce ($208 in chips) 
Seat 4: tipner ($203 in chips) 
Seat 5: uibting ($195.32 in chips) 
Seat 7: johnvu2016 ($191 in chips) 
Seat 8: matiko09 ($216.68 in chips) 
Seat 9: o.miro ($344.35 in chips) 
PacPacBum: posts small blind $1
uonlylive1ce: posts big blind $2
*** HOLE CARDS ***
Dealt to matiko09 [9c Qc]
tipner: folds 
uibting: folds 
johnvu2016: raises $4 to $6
matiko09: folds 
o.miro: folds 
Gamz11: calls $6
PacPacBum: folds 
uonlylive1ce: calls $4
*** FLOP *** [As 7h 6c]
uonlylive1ce: checks 
johnvu2016: checks 
Gamz11: bets $10.70
uonlylive1ce: folds 
johnvu2016: calls $10.70
*** TURN *** [As 7h 6c] [Kd]
johnvu2016: checks 
Gamz11: bets $26.62
johnvu2016: folds 
Uncalled bet ($26.62) returned to Gamz11
Gamz11 collected $38.58 from pot
*** SUMMARY ***
Total pot $40.40 | Rake $1.82 
Board [As 7h 6c Kd]
Seat 1: Gamz11 (button) collected ($38.58)
Seat 2: PacPacBum (small blind) folded before Flop
Seat 3: uonlylive1ce (big blind) folded on the Flop
Seat 4: tipner folded before Flop (didn't bet)
Seat 5: uibting folded before Flop (didn't bet)
Seat 7: johnvu2016 folded on the Turn
Seat 8: matiko09 folded before Flop (didn't bet)
Seat 9: o.miro folded before Flop (didn't bet)





PokerStars Hand #150127170933:  Hold'em No Limit ($0.50/$1.00 USD) - 2016/03/10 14:01:20 CET [2016/03/10 8:01:20 ET]
Table 'Opik' 9-max Seat #2 is the button
Seat 1: 172140 ($106.90 in chips) 
Seat 2: vrnMike ($100 in chips) 
Seat 3: Filojoes ($102.30 in chips) 
Seat 4: white huck ($79.54 in chips) 
Seat 5: matiko09 ($113.77 in chips) 
Seat 6: FroggyPlay ($101.50 in chips) 
Seat 7: pardama ($101.50 in chips) 
Seat 8: Komandantes ($100 in chips) 
Filojoes: posts small blind $0.50
white huck: posts big blind $1
*** HOLE CARDS ***
Dealt to matiko09 [Ts 2h]
matiko09: folds 
FroggyPlay: raises $2 to $3
pardama: folds 
Komandantes: folds 
172140: raises $6 to $9
vrnMike: calls $9
Filojoes: folds 
white huck: folds 
FroggyPlay: calls $6
*** FLOP *** [Jh 8d 6h]
FroggyPlay: checks 
172140: bets $14
vrnMike: calls $14
FroggyPlay: folds 
*** TURN *** [Jh 8d 6h] [9s]
172140: bets $27
vrnMike: raises $50 to $77 and is all-in
172140: calls $50
*** RIVER *** [Jh 8d 6h 9s] [5s]
*** SHOW DOWN ***
172140: shows [Qd Qs] (a pair of Queens)
vrnMike: shows [Jd Jc] (three of a kind, Jacks)
vrnMike collected $207.70 from pot
*** SUMMARY ***
Total pot $210.50 | Rake $2.80 
Board [Jh 8d 6h 9s 5s]
Seat 1: 172140 showed [Qd Qs] and lost with a pair of Queens
Seat 2: vrnMike (button) showed [Jd Jc] and won ($207.70) with three of a kind, Jacks
Seat 3: Filojoes (small blind) folded before Flop
Seat 4: white huck (big blind) folded before Flop
Seat 5: matiko09 folded before Flop (didn't bet)
Seat 6: FroggyPlay folded on the Flop
Seat 7: pardama folded before Flop (didn't bet)
Seat 8: Komandantes folded before Flop (didn't bet)





PokerStars Hand #150127171093:  Hold'em No Limit ($1/$2 USD) - 2016/03/10 14:01:21 CET [2016/03/10 8:01:21 ET]
Table 'Solstice II' 9-max Seat #6 is the button
Seat 1: azzad2007 ($264.55 in chips) 
Seat 2: o.miro ($200 in chips) 
Seat 3: PacPacBum ($200 in chips) 
Seat 4: ki11u ($203 in chips) 
Seat 6: Gamz11 ($221.18 in chips) 
Seat 7: uonlylive1ce ($202.96 in chips) 
Seat 8: matiko09 ($200 in chips) 
Seat 9: zhang0204 ($226.68 in chips) 
uonlylive1ce: posts small blind $1
matiko09: posts big blind $2
*** HOLE CARDS ***
Dealt to matiko09 [Ks Kh]
zhang0204: folds 
azzad2007: folds 
o.miro: folds 
PacPacBum: folds 
ki11u: folds 
Gamz11: raises $2.92 to $4.92
uonlylive1ce: raises $13.08 to $18
matiko09: raises $22 to $40
Gamz11: folds 
uonlylive1ce: raises $162.96 to $202.96 and is all-in
matiko09: calls $160 and is all-in
Uncalled bet ($2.96) returned to uonlylive1ce
*** FLOP *** [2s 5c 4d]
*** TURN *** [2s 5c 4d] [7h]
*** RIVER *** [2s 5c 4d 7h] [5h]
*** SHOW DOWN ***
uonlylive1ce: shows [Ad Ac] (two pair, Aces and Fives)
matiko09: mucks hand 
uonlylive1ce collected $402.12 from pot
*** SUMMARY ***
Total pot $404.92 | Rake $2.80 
Board [2s 5c 4d 7h 5h]
Seat 1: azzad2007 folded before Flop (didn't bet)
Seat 2: o.miro folded before Flop (didn't bet)
Seat 3: PacPacBum folded before Flop (didn't bet)
Seat 4: ki11u folded before Flop (didn't bet)
Seat 6: Gamz11 (button) folded before Flop
Seat 7: uonlylive1ce (small blind) showed [Ad Ac] and won ($402.12) with two pair, Aces and Fives
Seat 8: matiko09 (big blind) mucked [Ks Kh]
Seat 9: zhang0204 folded before Flop (didn't bet)





PokerStars Hand #150127190044:  Hold'em No Limit ($0.50/$1.00 USD) - 2016/03/10 14:01:55 CET [2016/03/10 8:01:55 ET]
Table 'Virton' 9-max Seat #9 is the button
Seat 1: Mukhin1 ($100 in chips) 
Seat 2: lfranklin23 ($80 in chips) 
Seat 3: tommy78910 ($50 in chips) 
Seat 4: matiko09 ($100 in chips) 
Seat 5: tipner ($100 in chips) 
Seat 6: mervynaa ($60.63 in chips) 
Seat 7: Spid1 ($100 in chips) 
Seat 8: pardama ($100 in chips) 
Seat 9: vrnMike ($100 in chips) 
Mukhin1: posts small blind $0.50
lfranklin23: posts big blind $1
*** HOLE CARDS ***
Dealt to matiko09 [5d 8s]
tommy78910: folds 
matiko09: folds 
tipner: folds 
mervynaa: calls $1
Spid1: folds 
pardama: raises $3 to $4
vrnMike: folds 
Mukhin1: folds 
lfranklin23: folds 
mervynaa: calls $3
*** FLOP *** [As Jc 2c]
mervynaa: checks 
pardama: bets $4.53
mervynaa: folds 
Uncalled bet ($4.53) returned to pardama
pardama collected $9.07 from pot
pardama: doesn't show hand 
*** SUMMARY ***
Total pot $9.50 | Rake $0.43 
Board [As Jc 2c]
Seat 1: Mukhin1 (small blind) folded before Flop
Seat 2: lfranklin23 (big blind) folded before Flop
Seat 3: tommy78910 folded before Flop (didn't bet)
Seat 4: matiko09 folded before Flop (didn't bet)
Seat 5: tipner folded before Flop (didn't bet)
Seat 6: mervynaa folded on the Flop
Seat 7: Spid1 folded before Flop (didn't bet)
Seat 8: pardama collected ($9.07)
Seat 9: vrnMike (button) folded before Flop (didn't bet)





PokerStars Hand #150127192151:  Hold'em No Limit ($0.50/$1.00 USD) - 2016/03/10 14:01:58 CET [2016/03/10 8:01:58 ET]
Table 'Leuschneria II' 9-max Seat #9 is the button
Seat 1: SHARKFIN168 ($115.15 in chips) 
Seat 2: blackw0lf_03 ($104 in chips) 
Seat 3: Spid1 ($112.54 in chips) 
Seat 5: RMilPoker ($226.20 in chips) 
Seat 6: matiko09 ($110.11 in chips) 
Seat 7: Plz3betMe ($40.57 in chips) 
Seat 8: UnBent022 ($109.55 in chips) 
Seat 9: ki11u ($100 in chips) 
SHARKFIN168: posts small blind $0.50
blackw0lf_03: posts big blind $1
*** HOLE CARDS ***
Dealt to matiko09 [4s Ah]
Spid1: raises $2 to $3
RMilPoker: folds 
matiko09: folds 
Plz3betMe: folds 
UnBent022: folds 
ki11u: folds 
SHARKFIN168: folds 
blackw0lf_03: folds 
Uncalled bet ($2) returned to Spid1
Spid1 collected $2.50 from pot
Spid1: doesn't show hand 
*** SUMMARY ***
Total pot $2.50 | Rake $0 
Seat 1: SHARKFIN168 (small blind) folded before Flop
Seat 2: blackw0lf_03 (big blind) folded before Flop
Seat 3: Spid1 collected ($2.50)
Seat 5: RMilPoker folded before Flop (didn't bet)
Seat 6: matiko09 folded before Flop (didn't bet)
Seat 7: Plz3betMe folded before Flop (didn't bet)
Seat 8: UnBent022 folded before Flop (didn't bet)
Seat 9: ki11u (button) folded before Flop (didn't bet)





PokerStars Hand #150127192937:  Hold'em No Limit ($0.50/$1.00 USD) - 2016/03/10 14:02:00 CET [2016/03/10 8:02:00 ET]
Table 'Prudentia II' 9-max Seat #1 is the button
Seat 1: oddjob008 ($83.39 in chips) 
Seat 2: PacPacBum ($100 in chips) 
Seat 3: Filojoes ($103.35 in chips) 
Seat 4: tinghai858 ($113.69 in chips) 
Seat 5: ilaviiitech ($100 in chips) 
Seat 6: Spid1 ($102.50 in chips) 
Seat 7: flk.Dasas ($100 in chips) 
Seat 9: matiko09 ($123.50 in chips) 
PacPacBum: posts small blind $0.50
Filojoes: posts big blind $1
*** HOLE CARDS ***
Dealt to matiko09 [Kc 3c]
tinghai858: raises $1 to $2
ilaviiitech: folds 
Spid1: folds 
flk.Dasas: folds 
matiko09: folds 
oddjob008: folds 
PacPacBum: folds 
Filojoes: folds 
Uncalled bet ($1) returned to tinghai858
tinghai858 collected $2.50 from pot
tinghai858: doesn't show hand 
*** SUMMARY ***
Total pot $2.50 | Rake $0 
Seat 1: oddjob008 (button) folded before Flop (didn't bet)
Seat 2: PacPacBum (small blind) folded before Flop
Seat 3: Filojoes (big blind) folded before Flop
Seat 4: tinghai858 collected ($2.50)
Seat 5: ilaviiitech folded before Flop (didn't bet)
Seat 6: Spid1 folded before Flop (didn't bet)
Seat 7: flk.Dasas folded before Flop (didn't bet)
Seat 9: matiko09 folded before Flop (didn't bet)





PokerStars Hand #150127197985:  Hold'em No Limit ($0.25/$0.50 USD) - 2016/03/10 14:02:09 CET [2016/03/10 8:02:09 ET]
Table 'Aegina' 9-max Seat #8 is the button
Seat 1: Cmacher18 ($47.80 in chips) 
Seat 2: Spid1 ($105.21 in chips) 
Seat 3: MyMilkCans=D ($129.85 in chips) 
Seat 4: digimatical ($138.49 in chips) 
Seat 5: universpok22 ($50.53 in chips) 
Seat 6: matiko09 ($73.22 in chips) 
Seat 7: Gummio ($117.87 in chips) 
Seat 8: ardo888 ($166.72 in chips) 
Cmacher18: posts small blind $0.25
Spid1: posts big blind $0.50
universpok22: posts big blind $0.50
Cmacher18: posts the ante $0.10
Spid1: posts the ante $0.10
MyMilkCans=D: posts the ante $0.10
digimatical: posts the ante $0.10
universpok22: posts the ante $0.10
matiko09: posts the ante $0.10
Gummio: posts the ante $0.10
ardo888: posts the ante $0.10
*** HOLE CARDS ***
Dealt to matiko09 [3c 7h]
MyMilkCans=D: folds 
digimatical: raises $0.50 to $1
universpok22: folds 
matiko09: folds 
Gummio: folds 
ardo888: calls $1
Cmacher18: raises $2 to $3
Spid1: folds 
digimatical: calls $2
ardo888: calls $2
*** FLOP *** [Jd As 6h]
Cmacher18: checks 
digimatical: checks 
ardo888: checks 
*** TURN *** [Jd As 6h] [Qd]
Cmacher18: bets $5
digimatical: folds 
ardo888: folds 
Uncalled bet ($5) returned to Cmacher18
Cmacher18 collected $10.31 from pot
*** SUMMARY ***
Total pot $10.80 | Rake $0.49 
Board [Jd As 6h Qd]
Seat 1: Cmacher18 (small blind) collected ($10.31)
Seat 2: Spid1 (big blind) folded before Flop
Seat 3: MyMilkCans=D folded before Flop (didn't bet)
Seat 4: digimatical folded on the Turn
Seat 5: universpok22 folded before Flop
Seat 6: matiko09 folded before Flop (didn't bet)
Seat 7: Gummio folded before Flop (didn't bet)
Seat 8: ardo888 (button) folded on the Turn





PokerStars Hand #150127202889:  Hold'em No Limit ($0.50/$1.00 USD) - 2016/03/10 14:02:18 CET [2016/03/10 8:02:18 ET]
Table 'Leuschneria II' 9-max Seat #1 is the button
Seat 1: SHARKFIN168 ($114.65 in chips) 
Seat 2: blackw0lf_03 ($103 in chips) 
Seat 3: Spid1 ($114.04 in chips) 
Seat 5: RMilPoker ($226.20 in chips) 
Seat 6: matiko09 ($110.11 in chips) 
Seat 7: Plz3betMe ($40.57 in chips) 
Seat 8: UnBent022 ($109.55 in chips) 
Seat 9: ki11u ($100 in chips) 
blackw0lf_03: posts small blind $0.50
Spid1: posts big blind $1
*** HOLE CARDS ***
Dealt to matiko09 [6c 7d]
RMilPoker: folds 
matiko09: folds 
Plz3betMe: folds 
UnBent022: folds 
ki11u: folds 
SHARKFIN168: folds 
blackw0lf_03: folds 
Uncalled bet ($0.50) returned to Spid1
Spid1 collected $1 from pot
Spid1: doesn't show hand 
*** SUMMARY ***
Total pot $1 | Rake $0 
Seat 1: SHARKFIN168 (button) folded before Flop (didn't bet)
Seat 2: blackw0lf_03 (small blind) folded before Flop
Seat 3: Spid1 (big blind) collected ($1)
Seat 5: RMilPoker folded before Flop (didn't bet)
Seat 6: matiko09 folded before Flop (didn't bet)
Seat 7: Plz3betMe folded before Flop (didn't bet)
Seat 8: UnBent022 folded before Flop (didn't bet)
Seat 9: ki11u folded before Flop (didn't bet)





PokerStars Hand #150127207697:  Hold'em No Limit ($0.50/$1.00 USD) - 2016/03/10 14:02:27 CET [2016/03/10 8:02:27 ET]
Table 'Iguassu' 9-max Seat #7 is the button
Seat 1: blackw0lf_03 ($100 in chips) 
Seat 2: Rocky6434 ($34.30 in chips) 
Seat 4: matiko09 ($109.50 in chips) 
Seat 5: UnBent022 ($100 in chips) 
Seat 6: Igor DoUrden ($108.38 in chips) 
Seat 7: PacPacBum ($100 in chips) 
Seat 8: Filojoes ($181.23 in chips) 
Seat 9: er13to ($127.23 in chips) 
Filojoes: posts small blind $0.50
er13to: posts big blind $1
*** HOLE CARDS ***
Dealt to matiko09 [2d 7d]
blackw0lf_03: folds 
Rocky6434: raises $1 to $2
matiko09: folds 
UnBent022: folds 
Igor DoUrden: folds 
PacPacBum: folds 
Filojoes: calls $1.50
er13to: folds 
*** FLOP *** [4s 5h 7c]
Filojoes: bets $4.30
Rocky6434: folds 
Uncalled bet ($4.30) returned to Filojoes
Filojoes collected $4.78 from pot
Filojoes: doesn't show hand 
*** SUMMARY ***
Total pot $5 | Rake $0.22 
Board [4s 5h 7c]
Seat 1: blackw0lf_03 folded before Flop (didn't bet)
Seat 2: Rocky6434 folded on the Flop
Seat 4: matiko09 folded before Flop (didn't bet)
Seat 5: UnBent022 folded before Flop (didn't bet)
Seat 6: Igor DoUrden folded before Flop (didn't bet)
Seat 7: PacPacBum (button) folded before Flop (didn't bet)
Seat 8: Filojoes (small blind) collected ($4.78)
Seat 9: er13to (big blind) folded before Flop





PokerStars Hand #150127207910:  Hold'em No Limit ($1/$2 USD) - 2016/03/10 14:02:27 CET [2016/03/10 8:02:27 ET]
Table 'Solstice II' 9-max Seat #7 is the button
Seat 1: azzad2007 ($264.55 in chips) 
Seat 2: o.miro ($200 in chips) 
Seat 3: PacPacBum ($200 in chips) 
Seat 4: ki11u ($203 in chips) 
Seat 6: Gamz11 ($216.26 in chips) 
Seat 7: uonlylive1ce ($405.08 in chips) 
Seat 8: matiko09 ($200 in chips) 
Seat 9: zhang0204 ($226.68 in chips) 
matiko09: posts small blind $1
zhang0204: posts big blind $2
*** HOLE CARDS ***
Dealt to matiko09 [8s Ac]
azzad2007: folds 
o.miro: folds 
PacPacBum: folds 
ki11u: folds 
Gamz11: folds 
uonlylive1ce: folds 
matiko09: raises $3 to $5
zhang0204: calls $3
*** FLOP *** [Kd Qd 2c]
matiko09: checks 
zhang0204: bets $6
matiko09: folds 
Uncalled bet ($6) returned to zhang0204
zhang0204 collected $9.55 from pot
zhang0204: doesn't show hand 
*** SUMMARY ***
Total pot $10 | Rake $0.45 
Board [Kd Qd 2c]
Seat 1: azzad2007 folded before Flop (didn't bet)
Seat 2: o.miro folded before Flop (didn't bet)
Seat 3: PacPacBum folded before Flop (didn't bet)
Seat 4: ki11u folded before Flop (didn't bet)
Seat 6: Gamz11 folded before Flop (didn't bet)
Seat 7: uonlylive1ce (button) folded before Flop (didn't bet)
Seat 8: matiko09 (small blind) folded on the Flop
Seat 9: zhang0204 (big blind) collected ($9.55)





PokerStars Hand #150127210331:  Hold'em No Limit ($1/$2 USD) - 2016/03/10 14:02:31 CET [2016/03/10 8:02:31 ET]
Table 'Tauris II' 9-max Seat #6 is the button
Seat 1: matiko09 ($200 in chips) 
Seat 2: stds st ($151.79 in chips) 
Seat 3: PacPacBum ($272.54 in chips) 
Seat 4: neomorf ($812.12 in chips) 
Seat 5: tipner ($200 in chips) 
Seat 6: uonlylive1ce ($200 in chips) 
Seat 7: Gamz11 ($200 in chips) 
Seat 8: scout326 ($215.07 in chips) 
Seat 9: darren1031 ($129.06 in chips) 
Gamz11: posts small blind $1
scout326: posts big blind $2
*** HOLE CARDS ***
Dealt to matiko09 [5h 7c]
darren1031: folds 
matiko09: folds 
stds st: folds 
PacPacBum: folds 
neomorf: folds 
tipner: raises $2 to $4
uonlylive1ce: folds 
Gamz11: folds 
scout326: calls $2
*** FLOP *** [6s Kh Kc]
scout326: checks 
tipner: checks 
*** TURN *** [6s Kh Kc] [2d]
scout326: checks 
tipner: checks 
*** RIVER *** [6s Kh Kc 2d] [Kd]
scout326: checks 
tipner: checks 
*** SHOW DOWN ***
scout326: shows [5c 3c] (three of a kind, Kings)
tipner: shows [8d 7d] (three of a kind, Kings - Eight kicker)
tipner collected $8.60 from pot
*** SUMMARY ***
Total pot $9 | Rake $0.40 
Board [6s Kh Kc 2d Kd]
Seat 1: matiko09 folded before Flop (didn't bet)
Seat 2: stds st folded before Flop (didn't bet)
Seat 3: PacPacBum folded before Flop (didn't bet)
Seat 4: neomorf folded before Flop (didn't bet)
Seat 5: tipner showed [8d 7d] and won ($8.60) with three of a kind, Kings
Seat 6: uonlylive1ce (button) folded before Flop (didn't bet)
Seat 7: Gamz11 (small blind) folded before Flop
Seat 8: scout326 (big blind) showed [5c 3c] and lost with three of a kind, Kings
Seat 9: darren1031 folded before Flop (didn't bet)





PokerStars Hand #150127216374:  Hold'em No Limit ($0.50/$1.00 USD) - 2016/03/10 14:02:42 CET [2016/03/10 8:02:42 ET]
Table 'Leuschneria II' 9-max Seat #2 is the button
Seat 1: SHARKFIN168 ($114.65 in chips) 
Seat 2: blackw0lf_03 ($102.50 in chips) 
Seat 3: Spid1 ($114.54 in chips) 
Seat 5: RMilPoker ($226.20 in chips) 
Seat 6: matiko09 ($110.11 in chips) 
Seat 7: Plz3betMe ($40.57 in chips) 
Seat 8: UnBent022 ($109.55 in chips) 
Seat 9: ki11u ($100 in chips) 
Spid1: posts small blind $0.50
RMilPoker: posts big blind $1
*** HOLE CARDS ***
Dealt to matiko09 [8h 8c]
matiko09: raises $2 to $3
Plz3betMe: calls $3
UnBent022: folds 
ki11u: folds 
SHARKFIN168: folds 
blackw0lf_03: folds 
Spid1: folds 
RMilPoker: folds 
*** FLOP *** [6d 5h 5s]
matiko09: checks 
Plz3betMe: bets $4.77
matiko09: calls $4.77
*** TURN *** [6d 5h 5s] [3c]
matiko09: checks 
Plz3betMe: checks 
*** RIVER *** [6d 5h 5s 3c] [6c]
matiko09: checks 
Plz3betMe: checks 
*** SHOW DOWN ***
matiko09: shows [8h 8c] (two pair, Eights and Sixes)
Plz3betMe: mucks hand 
matiko09 collected $16.27 from pot
*** SUMMARY ***
Total pot $17.04 | Rake $0.77 
Board [6d 5h 5s 3c 6c]
Seat 1: SHARKFIN168 folded before Flop (didn't bet)
Seat 2: blackw0lf_03 (button) folded before Flop (didn't bet)
Seat 3: Spid1 (small blind) folded before Flop
Seat 5: RMilPoker (big blind) folded before Flop
Seat 6: matiko09 showed [8h 8c] and won ($16.27) with two pair, Eights and Sixes
Seat 7: Plz3betMe mucked [Ac Ks]
Seat 8: UnBent022 folded before Flop (didn't bet)
Seat 9: ki11u folded before Flop (didn't bet)





PokerStars Hand #150127217240:  Hold'em No Limit ($0.50/$1.00 USD) - 2016/03/10 14:02:43 CET [2016/03/10 8:02:43 ET]
Table 'Opik' 9-max Seat #3 is the button
Seat 1: 172140 ($6.90 in chips) 
Seat 2: vrnMike ($207.70 in chips) 
Seat 3: Filojoes ($101.80 in chips) 
Seat 4: white huck ($78.54 in chips) 
Seat 5: matiko09 ($113.77 in chips) 
Seat 6: FroggyPlay ($100 in chips) 
Seat 7: pardama ($101.50 in chips) 
Seat 8: Komandantes ($100 in chips) 
white huck: posts small blind $0.50
matiko09: posts big blind $1
*** HOLE CARDS ***
Dealt to matiko09 [Js 5c]
FroggyPlay: folds 
pardama: folds 
Komandantes: raises $2 to $3
172140: folds 
vrnMike: raises $6 to $9
Filojoes: folds 
white huck: folds 
matiko09: folds 
Komandantes: folds 
Uncalled bet ($6) returned to vrnMike
vrnMike collected $7.50 from pot
*** SUMMARY ***
Total pot $7.50 | Rake $0 
Seat 1: 172140 folded before Flop (didn't bet)
Seat 2: vrnMike collected ($7.50)
Seat 3: Filojoes (button) folded before Flop (didn't bet)
Seat 4: white huck (small blind) folded before Flop
Seat 5: matiko09 (big blind) folded before Flop
Seat 6: FroggyPlay folded before Flop (didn't bet)
Seat 7: pardama folded before Flop (didn't bet)
Seat 8: Komandantes folded before Flop





PokerStars Hand #150127221066:  Hold'em No Limit ($0.50/$1.00 USD) - 2016/03/10 14:02:50 CET [2016/03/10 8:02:50 ET]
Table 'Prudentia II' 9-max Seat #2 is the button
Seat 1: oddjob008 ($83.39 in chips) 
Seat 2: PacPacBum ($100 in chips) 
Seat 3: Filojoes ($102.35 in chips) 
Seat 4: tinghai858 ($115.19 in chips) 
Seat 5: ilaviiitech ($100 in chips) 
Seat 6: Spid1 ($102.50 in chips) 
Seat 7: flk.Dasas ($100 in chips) 
Seat 9: matiko09 ($123.50 in chips) 
Filojoes: posts small blind $0.50
tinghai858: posts big blind $1
*** HOLE CARDS ***
Dealt to matiko09 [Ks 2h]
ilaviiitech: folds 
Spid1: raises $2 to $3
flk.Dasas: folds 
matiko09: folds 
oddjob008: folds 
PacPacBum: folds 
Filojoes: folds 
tinghai858: calls $2
*** FLOP *** [4s 8h 3h]
tinghai858: bets $1
Spid1: raises $5 to $6
tinghai858: folds 
Uncalled bet ($5) returned to Spid1
Spid1 collected $8.12 from pot
Spid1: doesn't show hand 
*** SUMMARY ***
Total pot $8.50 | Rake $0.38 
Board [4s 8h 3h]
Seat 1: oddjob008 folded before Flop (didn't bet)
Seat 2: PacPacBum (button) folded before Flop (didn't bet)
Seat 3: Filojoes (small blind) folded before Flop
Seat 4: tinghai858 (big blind) folded on the Flop
Seat 5: ilaviiitech folded before Flop (didn't bet)
Seat 6: Spid1 collected ($8.12)
Seat 7: flk.Dasas folded before Flop (didn't bet)
Seat 9: matiko09 folded before Flop (didn't bet)





PokerStars Hand #150127225879:  Hold'em No Limit ($1/$2 USD) - 2016/03/10 14:02:59 CET [2016/03/10 8:02:59 ET]
Table 'Chandra II' 9-max Seat #2 is the button
Seat 1: Gamz11 ($221.88 in chips) 
Seat 2: PacPacBum ($221.84 in chips) 
Seat 3: uonlylive1ce ($202 in chips) 
Seat 4: tipner ($203 in chips) 
Seat 5: uibting ($195.32 in chips) 
Seat 7: johnvu2016 ($174.30 in chips) 
Seat 8: matiko09 ($216.68 in chips) 
Seat 9: o.miro ($344.35 in chips) 
uonlylive1ce: posts small blind $1
tipner: posts big blind $2
*** HOLE CARDS ***
Dealt to matiko09 [6h 9h]
uibting: raises $4 to $6
johnvu2016: folds 
matiko09: folds 
o.miro: folds 
Gamz11: folds 
PacPacBum: folds 
uonlylive1ce: folds 
tipner: folds 
Uncalled bet ($4) returned to uibting
uibting collected $5 from pot
*** SUMMARY ***
Total pot $5 | Rake $0 
Seat 1: Gamz11 folded before Flop (didn't bet)
Seat 2: PacPacBum (button) folded before Flop (didn't bet)
Seat 3: uonlylive1ce (small blind) folded before Flop
Seat 4: tipner (big blind) folded before Flop
Seat 5: uibting collected ($5)
Seat 7: johnvu2016 folded before Flop (didn't bet)
Seat 8: matiko09 folded before Flop (didn't bet)
Seat 9: o.miro folded before Flop (didn't bet)





PokerStars Hand #150127227030:  Hold'em No Limit ($0.50/$1.00 USD) - 2016/03/10 14:03:01 CET [2016/03/10 8:03:01 ET]
Table 'Virton' 9-max Seat #1 is the button
Seat 1: Mukhin1 ($100 in chips) 
Seat 2: lfranklin23 ($79 in chips) 
Seat 3: tommy78910 ($50 in chips) 
Seat 4: matiko09 ($100 in chips) 
Seat 5: tipner ($100 in chips) 
Seat 6: mervynaa ($56.63 in chips) 
Seat 7: Spid1 ($100 in chips) 
Seat 8: pardama ($105.07 in chips) 
Seat 9: vrnMike ($100 in chips) 
lfranklin23: posts small blind $0.50
tommy78910: posts big blind $1
*** HOLE CARDS ***
Dealt to matiko09 [5c Th]
matiko09: folds 
tipner: folds 
mervynaa: folds 
Spid1: folds 
pardama: folds 
vrnMike: folds 
Mukhin1: raises $1.30 to $2.30
lfranklin23: folds 
tommy78910: folds 
Uncalled bet ($1.30) returned to Mukhin1
Mukhin1 collected $2.50 from pot
Mukhin1: doesn't show hand 
*** SUMMARY ***
Total pot $2.50 | Rake $0 
Seat 1: Mukhin1 (button) collected ($2.50)
Seat 2: lfranklin23 (small blind) folded before Flop
Seat 3: tommy78910 (big blind) folded before Flop
Seat 4: matiko09 folded before Flop (didn't bet)
Seat 5: tipner folded before Flop (didn't bet)
Seat 6: mervynaa folded before Flop (didn't bet)
Seat 7: Spid1 folded before Flop (didn't bet)
Seat 8: pardama folded before Flop (didn't bet)
Seat 9: vrnMike folded before Flop (didn't bet)





PokerStars Hand #150127237231:  Hold'em No Limit ($0.50/$1.00 USD) - 2016/03/10 14:03:19 CET [2016/03/10 8:03:19 ET]
Table 'Opik' 9-max Seat #4 is the button
Seat 1: 172140 ($6.90 in chips) 
Seat 2: vrnMike ($212.20 in chips) 
Seat 3: Filojoes ($101.80 in chips) 
Seat 4: white huck ($78.04 in chips) 
Seat 5: matiko09 ($112.77 in chips) 
Seat 6: FroggyPlay ($100 in chips) 
Seat 7: pardama ($101.50 in chips) 
Seat 8: Komandantes ($100 in chips) 
matiko09: posts small blind $0.50
FroggyPlay: posts big blind $1
*** HOLE CARDS ***
Dealt to matiko09 [3h Ks]
pardama: folds 
Komandantes: folds 
172140: folds 
vrnMike: folds 
Filojoes: raises $1.50 to $2.50
172140 leaves the table
white huck: folds 
matiko09: folds 
FroggyPlay: folds 
Uncalled bet ($1.50) returned to Filojoes
Filojoes collected $2.50 from pot
Filojoes: doesn't show hand 
*** SUMMARY ***
Total pot $2.50 | Rake $0 
Seat 1: 172140 folded before Flop (didn't bet)
Seat 2: vrnMike folded before Flop (didn't bet)
Seat 3: Filojoes collected ($2.50)
Seat 4: white huck (button) folded before Flop (didn't bet)
Seat 5: matiko09 (small blind) folded before Flop
Seat 6: FroggyPlay (big blind) folded before Flop
Seat 7: pardama folded before Flop (didn't bet)
Seat 8: Komandantes folded before Flop (didn't bet)





PokerStars Hand #150127242000:  Hold'em No Limit ($1/$2 USD) - 2016/03/10 14:03:27 CET [2016/03/10 8:03:27 ET]
Table 'Solstice II' 9-max Seat #8 is the button
Seat 1: azzad2007 ($264.55 in chips) 
Seat 2: o.miro ($200 in chips) 
Seat 3: PacPacBum ($200 in chips) 
Seat 4: ki11u ($203 in chips) 
Seat 5: eKCimann 666 ($414.27 in chips) 
Seat 6: Gamz11 ($216.26 in chips) 
Seat 7: uonlylive1ce ($405.08 in chips) 
Seat 8: matiko09 ($200 in chips) 
Seat 9: zhang0204 ($231.23 in chips) 
zhang0204: posts small blind $1
azzad2007: posts big blind $2
*** HOLE CARDS ***
Dealt to matiko09 [Kc Tc]
o.miro: folds 
PacPacBum: folds 
ki11u: folds 
eKCimann 666: raises $5 to $7
Gamz11: folds 
uonlylive1ce: folds 
matiko09: calls $7
zhang0204: folds 
azzad2007: folds 
*** FLOP *** [Td Qs 9c]
eKCimann 666: bets $16.24
matiko09: folds 
Uncalled bet ($16.24) returned to eKCimann 666
eKCimann 666 collected $16.24 from pot
eKCimann 666: doesn't show hand 
*** SUMMARY ***
Total pot $17 | Rake $0.76 
Board [Td Qs 9c]
Seat 1: azzad2007 (big blind) folded before Flop
Seat 2: o.miro folded before Flop (didn't bet)
Seat 3: PacPacBum folded before Flop (didn't bet)
Seat 4: ki11u folded before Flop (didn't bet)
Seat 5: eKCimann 666 collected ($16.24)
Seat 6: Gamz11 folded before Flop (didn't bet)
Seat 7: uonlylive1ce folded before Flop (didn't bet)
Seat 8: matiko09 (button) folded on the Flop
Seat 9: zhang0204 (small blind) folded before Flop





PokerStars Hand #150127242828:  Hold'em No Limit ($1/$2 USD) - 2016/03/10 14:03:29 CET [2016/03/10 8:03:29 ET]
Table 'Chandra II' 9-max Seat #3 is the button
Seat 1: Gamz11 ($221.88 in chips) 
Seat 2: PacPacBum ($221.84 in chips) 
Seat 3: uonlylive1ce ($201 in chips) 
Seat 4: tipner ($201 in chips) 
Seat 5: uibting ($198.32 in chips) 
Seat 7: johnvu2016 ($174.30 in chips) 
Seat 8: matiko09 ($216.68 in chips) 
Seat 9: o.miro ($344.35 in chips) 
tipner: posts small blind $1
uibting: posts big blind $2
*** HOLE CARDS ***
Dealt to matiko09 [Jc 7s]
johnvu2016: folds 
matiko09: folds 
o.miro: folds 
Gamz11: raises $4 to $6
PacPacBum: folds 
uonlylive1ce: folds 
stds st leaves the table
ki11u joins the table at seat #6 
tipner: folds 
uibting: folds 
Uncalled bet ($4) returned to Gamz11
Gamz11 collected $5 from pot
*** SUMMARY ***
Total pot $5 | Rake $0 
Seat 1: Gamz11 collected ($5)
Seat 2: PacPacBum folded before Flop (didn't bet)
Seat 3: uonlylive1ce (button) folded before Flop (didn't bet)
Seat 4: tipner (small blind) folded before Flop
Seat 5: uibting (big blind) folded before Flop
Seat 7: johnvu2016 folded before Flop (didn't bet)
Seat 8: matiko09 folded before Flop (didn't bet)
Seat 9: o.miro folded before Flop (didn't bet)





PokerStars Hand #150127244237:  Hold'em No Limit ($0.50/$1.00 USD) - 2016/03/10 14:03:31 CET [2016/03/10 8:03:31 ET]
Table 'Iguassu' 9-max Seat #8 is the button
Seat 1: blackw0lf_03 ($100 in chips) 
Seat 2: Rocky6434 ($32.30 in chips) 
Seat 4: matiko09 ($109.50 in chips) 
Seat 5: UnBent022 ($100 in chips) 
Seat 6: Igor DoUrden ($108.38 in chips) 
Seat 7: PacPacBum ($100 in chips) 
Seat 8: Filojoes ($184.01 in chips) 
Seat 9: er13to ($126.23 in chips) 
er13to: posts small blind $0.50
blackw0lf_03: posts big blind $1
*** HOLE CARDS ***
Dealt to matiko09 [5s 9d]
Rocky6434: folds 
matiko09: folds 
UnBent022: folds 
Igor DoUrden: folds 
PacPacBum: folds 
Filojoes: folds 
er13to: folds 
Uncalled bet ($0.50) returned to blackw0lf_03
blackw0lf_03 collected $1 from pot
blackw0lf_03: doesn't show hand 
*** SUMMARY ***
Total pot $1 | Rake $0 
Seat 1: blackw0lf_03 (big blind) collected ($1)
Seat 2: Rocky6434 folded before Flop (didn't bet)
Seat 4: matiko09 folded before Flop (didn't bet)
Seat 5: UnBent022 folded before Flop (didn't bet)
Seat 6: Igor DoUrden folded before Flop (didn't bet)
Seat 7: PacPacBum folded before Flop (didn't bet)
Seat 8: Filojoes (button) folded before Flop (didn't bet)
Seat 9: er13to (small blind) folded before Flop





PokerStars Hand #150127249462:  Hold'em No Limit ($0.50/$1.00 USD) - 2016/03/10 14:03:41 CET [2016/03/10 8:03:41 ET]
Table 'Opik' 9-max Seat #5 is the button
Seat 2: vrnMike ($212.20 in chips) 
Seat 3: Filojoes ($103.30 in chips) 
Seat 4: white huck ($78.04 in chips) 
Seat 5: matiko09 ($112.27 in chips) 
Seat 6: FroggyPlay ($100 in chips) 
Seat 7: pardama ($101.50 in chips) 
Seat 8: Komandantes ($100 in chips) 
FroggyPlay: posts small blind $0.50
pardama: posts big blind $1
*** HOLE CARDS ***
Dealt to matiko09 [Kd 6c]
Komandantes: folds 
vrnMike: folds 
Filojoes: folds 
white huck: folds 
matiko09: folds 
FroggyPlay: raises $2 to $3
pardama: calls $2
*** FLOP *** [9c 6h Kc]
FroggyPlay: checks 
pardama: bets $3
StarsAbove joins the table at seat #1 
FroggyPlay: calls $3
*** TURN *** [9c 6h Kc] [5s]
FroggyPlay: checks 
pardama: bets $8.02
FroggyPlay: calls $8.02
*** RIVER *** [9c 6h Kc 5s] [3c]
FroggyPlay: checks 
pardama: bets $12
FroggyPlay: folds 
Uncalled bet ($12) returned to pardama
pardama collected $26.78 from pot
pardama: doesn't show hand 
*** SUMMARY ***
Total pot $28.04 | Rake $1.26 
Board [9c 6h Kc 5s 3c]
Seat 2: vrnMike folded before Flop (didn't bet)
Seat 3: Filojoes folded before Flop (didn't bet)
Seat 4: white huck folded before Flop (didn't bet)
Seat 5: matiko09 (button) folded before Flop (didn't bet)
Seat 6: FroggyPlay (small blind) folded on the River
Seat 7: pardama (big blind) collected ($26.78)
Seat 8: Komandantes folded before Flop (didn't bet)





PokerStars Hand #150127252723:  Hold'em No Limit ($0.50/$1.00 USD) - 2016/03/10 14:03:46 CET [2016/03/10 8:03:46 ET]
Table 'Virton' 9-max Seat #2 is the button
Seat 1: Mukhin1 ($101.50 in chips) 
Seat 2: lfranklin23 ($78.50 in chips) 
Seat 3: tommy78910 ($49 in chips) 
Seat 4: matiko09 ($100 in chips) 
Seat 5: tipner ($100 in chips) 
Seat 6: mervynaa ($56.63 in chips) 
Seat 7: Spid1 ($100 in chips) 
Seat 8: pardama ($105.07 in chips) 
Seat 9: vrnMike ($100 in chips) 
tommy78910: posts small blind $0.50
matiko09: posts big blind $1
*** HOLE CARDS ***
Dealt to matiko09 [4h 8c]
tipner: folds 
mervynaa: folds 
Spid1: folds 
pardama: raises $1.50 to $2.50
vrnMike: folds 
Mukhin1: folds 
lfranklin23: folds 
tommy78910: calls $2
matiko09: folds 
*** FLOP *** [2s 2c Jc]
tommy78910: checks 
pardama: bets $2.86
tommy78910: folds 
Uncalled bet ($2.86) returned to pardama
pardama collected $5.73 from pot
pardama: doesn't show hand 
*** SUMMARY ***
Total pot $6 | Rake $0.27 
Board [2s 2c Jc]
Seat 1: Mukhin1 folded before Flop (didn't bet)
Seat 2: lfranklin23 (button) folded before Flop (didn't bet)
Seat 3: tommy78910 (small blind) folded on the Flop
Seat 4: matiko09 (big blind) folded before Flop
Seat 5: tipner folded before Flop (didn't bet)
Seat 6: mervynaa folded before Flop (didn't bet)
Seat 7: Spid1 folded before Flop (didn't bet)
Seat 8: pardama collected ($5.73)
Seat 9: vrnMike folded before Flop (didn't bet)





PokerStars Hand #150127257068:  Hold'em No Limit ($1/$2 USD) - 2016/03/10 14:03:54 CET [2016/03/10 8:03:54 ET]
Table 'Tauris II' 9-max Seat #7 is the button
Seat 1: matiko09 ($200 in chips) 
Seat 2: stds st ($151.79 in chips) 
Seat 3: PacPacBum ($272.54 in chips) 
Seat 4: neomorf ($812.12 in chips) 
Seat 5: tipner ($204.60 in chips) 
Seat 6: uonlylive1ce ($200 in chips) 
Seat 7: Gamz11 ($200 in chips) 
Seat 8: scout326 ($211.07 in chips) 
Seat 9: darren1031 ($129.06 in chips) 
scout326: posts small blind $1
darren1031: posts big blind $2
*** HOLE CARDS ***
Dealt to matiko09 [6d 7s]
matiko09: folds 
stds st: folds 
PacPacBum: folds 
neomorf: folds 
tipner: folds 
uonlylive1ce: folds 
Gamz11: raises $2.92 to $4.92
scout326: folds 
darren1031: folds 
Uncalled bet ($2.92) returned to Gamz11
Gamz11 collected $5 from pot
*** SUMMARY ***
Total pot $5 | Rake $0 
Seat 1: matiko09 folded before Flop (didn't bet)
Seat 2: stds st folded before Flop (didn't bet)
Seat 3: PacPacBum folded before Flop (didn't bet)
Seat 4: neomorf folded before Flop (didn't bet)
Seat 5: tipner folded before Flop (didn't bet)
Seat 6: uonlylive1ce folded before Flop (didn't bet)
Seat 7: Gamz11 (button) collected ($5)
Seat 8: scout326 (small blind) folded before Flop
Seat 9: darren1031 (big blind) folded before Flop





PokerStars Hand #150127258457:  Hold'em No Limit ($0.50/$1.00 USD) - 2016/03/10 14:03:57 CET [2016/03/10 8:03:57 ET]
Table 'Prudentia II' 9-max Seat #3 is the button
Seat 1: oddjob008 ($83.39 in chips) 
Seat 2: PacPacBum ($100 in chips) 
Seat 3: Filojoes ($101.85 in chips) 
Seat 4: tinghai858 ($111.19 in chips) 
Seat 5: ilaviiitech ($100 in chips) 
Seat 6: Spid1 ($106.62 in chips) 
Seat 7: flk.Dasas ($100 in chips) 
Seat 9: matiko09 ($123.50 in chips) 
tinghai858: posts small blind $0.50
ilaviiitech: posts big blind $1
*** HOLE CARDS ***
Dealt to matiko09 [Kd 7h]
Spid1: folds 
flk.Dasas: folds 
matiko09: folds 
oddjob008: raises $1.65 to $2.65
PacPacBum: folds 
Filojoes: folds 
tinghai858: calls $2.15
ilaviiitech: folds 
*** FLOP *** [8s Ac 8h]
tinghai858: bets $1
oddjob008: calls $1
*** TURN *** [8s Ac 8h] [Jd]
tinghai858: bets $1
oddjob008: calls $1
*** RIVER *** [8s Ac 8h Jd] [Th]
tinghai858: bets $1
oddjob008: raises $5 to $6
tinghai858: folds 
Uncalled bet ($5) returned to oddjob008
oddjob008 collected $11.75 from pot
oddjob008: doesn't show hand 
*** SUMMARY ***
Total pot $12.30 | Rake $0.55 
Board [8s Ac 8h Jd Th]
Seat 1: oddjob008 collected ($11.75)
Seat 2: PacPacBum folded before Flop (didn't bet)
Seat 3: Filojoes (button) folded before Flop (didn't bet)
Seat 4: tinghai858 (small blind) folded on the River
Seat 5: ilaviiitech (big blind) folded before Flop
Seat 6: Spid1 folded before Flop (didn't bet)
Seat 7: flk.Dasas folded before Flop (didn't bet)
Seat 9: matiko09 folded before Flop (didn't bet)





PokerStars Hand #150127261819:  Hold'em No Limit ($0.50/$1.00 USD) - 2016/03/10 14:04:03 CET [2016/03/10 8:04:03 ET]
Table 'Leuschneria II' 9-max Seat #3 is the button
Seat 1: SHARKFIN168 ($114.65 in chips) 
Seat 2: blackw0lf_03 ($102.50 in chips) 
Seat 3: Spid1 ($114.04 in chips) 
Seat 5: RMilPoker ($225.20 in chips) 
Seat 6: matiko09 ($118.61 in chips) 
Seat 7: Plz3betMe ($40 in chips) 
Seat 8: UnBent022 ($109.55 in chips) 
Seat 9: ki11u ($100 in chips) 
RMilPoker: posts small blind $0.50
matiko09: posts big blind $1
*** HOLE CARDS ***
Dealt to matiko09 [8c Jh]
Plz3betMe: folds 
UnBent022: folds 
ki11u: folds 
SHARKFIN168: raises $2 to $3
blackw0lf_03: raises $6 to $9
Spid1: folds 
RMilPoker: folds 
matiko09: folds 
SHARKFIN168: calls $6
*** FLOP *** [Js Kh 3s]
SHARKFIN168: checks 
blackw0lf_03: bets $10.80
SHARKFIN168: calls $10.80
*** TURN *** [Js Kh 3s] [5d]
SHARKFIN168: checks 
blackw0lf_03: checks 
*** RIVER *** [Js Kh 3s 5d] [Kc]
SHARKFIN168: checks 
blackw0lf_03: checks 
*** SHOW DOWN ***
SHARKFIN168: shows [Qh Ah] (a pair of Kings)
blackw0lf_03: shows [7s 7h] (two pair, Kings and Sevens)
blackw0lf_03 collected $39.25 from pot
*** SUMMARY ***
Total pot $41.10 | Rake $1.85 
Board [Js Kh 3s 5d Kc]
Seat 1: SHARKFIN168 showed [Qh Ah] and lost with a pair of Kings
Seat 2: blackw0lf_03 showed [7s 7h] and won ($39.25) with two pair, Kings and Sevens
Seat 3: Spid1 (button) folded before Flop (didn't bet)
Seat 5: RMilPoker (small blind) folded before Flop
Seat 6: matiko09 (big blind) folded before Flop
Seat 7: Plz3betMe folded before Flop (didn't bet)
Seat 8: UnBent022 folded before Flop (didn't bet)
Seat 9: ki11u folded before Flop (didn't bet)





PokerStars Hand #150127262888:  Hold'em No Limit ($1/$2 USD) - 2016/03/10 14:04:05 CET [2016/03/10 8:04:05 ET]
Table 'Chandra II' 9-max Seat #4 is the button
Seat 1: Gamz11 ($224.88 in chips) 
Seat 2: PacPacBum ($221.84 in chips) 
Seat 3: uonlylive1ce ($201 in chips) 
Seat 4: tipner ($200 in chips) 
Seat 5: uibting ($196.32 in chips) 
Seat 6: ki11u ($200 in chips) 
Seat 7: johnvu2016 ($174.30 in chips) 
Seat 8: matiko09 ($216.68 in chips) 
Seat 9: o.miro ($344.35 in chips) 
uibting: posts small blind $1
ki11u: posts big blind $2
*** HOLE CARDS ***
Dealt to matiko09 [5d 9h]
johnvu2016: folds 
matiko09: folds 
o.miro: folds 
Gamz11: folds 
PacPacBum: raises $2.08 to $4.08
uonlylive1ce: folds 
tipner: folds 
uibting: folds 
ki11u: calls $2.08
*** FLOP *** [7s 6c Js]
ki11u: checks 
PacPacBum: bets $3.06
ki11u: raises $12.94 to $16
PacPacBum: folds 
Uncalled bet ($12.94) returned to ki11u
ki11u collected $14.59 from pot
ki11u: doesn't show hand 
*** SUMMARY ***
Total pot $15.28 | Rake $0.69 
Board [7s 6c Js]
Seat 1: Gamz11 folded before Flop (didn't bet)
Seat 2: PacPacBum folded on the Flop
Seat 3: uonlylive1ce folded before Flop (didn't bet)
Seat 4: tipner (button) folded before Flop (didn't bet)
Seat 5: uibting (small blind) folded before Flop
Seat 6: ki11u (big blind) collected ($14.59)
Seat 7: johnvu2016 folded before Flop (didn't bet)
Seat 8: matiko09 folded before Flop (didn't bet)
Seat 9: o.miro folded before Flop (didn't bet)





PokerStars Hand #150127264606:  Hold'em No Limit ($0.25/$0.50 USD) - 2016/03/10 14:04:08 CET [2016/03/10 8:04:08 ET]
Table 'Aegina' 9-max Seat #1 is the button
Seat 1: Cmacher18 ($55.01 in chips) 
Seat 2: Spid1 ($104.61 in chips) 
Seat 3: MyMilkCans=D ($129.75 in chips) 
Seat 4: digimatical ($135.39 in chips) 
Seat 5: universpok22 ($49.93 in chips) 
Seat 6: matiko09 ($73.12 in chips) 
Seat 7: Gummio ($117.77 in chips) 
Seat 8: ardo888 ($163.62 in chips) 
Spid1: posts small blind $0.25
MyMilkCans=D: posts big blind $0.50
Cmacher18: posts the ante $0.10
Spid1: posts the ante $0.10
MyMilkCans=D: posts the ante $0.10
digimatical: posts the ante $0.10
universpok22: posts the ante $0.10
matiko09: posts the ante $0.10
Gummio: posts the ante $0.10
ardo888: posts the ante $0.10
*** HOLE CARDS ***
Dealt to matiko09 [Ks Ad]
digimatical: folds 
universpok22: calls $0.50
matiko09: raises $1.50 to $2
Gummio: folds 
ardo888: folds 
Cmacher18: folds 
Spid1: folds 
MyMilkCans=D: folds 
universpok22: calls $1.50
*** FLOP *** [Ah Jc Qh]
universpok22: checks 
matiko09: bets $3
universpok22: folds 
Uncalled bet ($3) returned to matiko09
matiko09 collected $5.30 from pot
matiko09: doesn't show hand 
*** SUMMARY ***
Total pot $5.55 | Rake $0.25 
Board [Ah Jc Qh]
Seat 1: Cmacher18 (button) folded before Flop (didn't bet)
Seat 2: Spid1 (small blind) folded before Flop
Seat 3: MyMilkCans=D (big blind) folded before Flop
Seat 4: digimatical folded before Flop (didn't bet)
Seat 5: universpok22 folded on the Flop
Seat 6: matiko09 collected ($5.30)
Seat 7: Gummio folded before Flop (didn't bet)
Seat 8: ardo888 folded before Flop (didn't bet)





PokerStars Hand #150127268268:  Hold'em No Limit ($0.50/$1.00 USD) - 2016/03/10 14:04:14 CET [2016/03/10 8:04:14 ET]
Table 'Iguassu' 9-max Seat #9 is the button
Seat 1: blackw0lf_03 ($100.50 in chips) 
Seat 2: Rocky6434 ($32.30 in chips) 
Seat 4: matiko09 ($109.50 in chips) 
Seat 5: UnBent022 ($100 in chips) 
Seat 6: Igor DoUrden ($108.38 in chips) 
Seat 7: PacPacBum ($100 in chips) 
Seat 8: Filojoes ($184.01 in chips) 
Seat 9: er13to ($125.73 in chips) 
blackw0lf_03: posts small blind $0.50
Rocky6434: posts big blind $1
*** HOLE CARDS ***
Dealt to matiko09 [Td Js]
matiko09: folds 
UnBent022: folds 
Igor DoUrden: folds 
PacPacBum: folds 
Filojoes: folds 
er13to: folds 
blackw0lf_03: raises $1.50 to $2.50
Rocky6434: folds 
Uncalled bet ($1.50) returned to blackw0lf_03
blackw0lf_03 collected $2 from pot
blackw0lf_03: doesn't show hand 
*** SUMMARY ***
Total pot $2 | Rake $0 
Seat 1: blackw0lf_03 (small blind) collected ($2)
Seat 2: Rocky6434 (big blind) folded before Flop
Seat 4: matiko09 folded before Flop (didn't bet)
Seat 5: UnBent022 folded before Flop (didn't bet)
Seat 6: Igor DoUrden folded before Flop (didn't bet)
Seat 7: PacPacBum folded before Flop (didn't bet)
Seat 8: Filojoes folded before Flop (didn't bet)
Seat 9: er13to (button) folded before Flop (didn't bet)





