PokerStars Hand #152883486626:  Hold'em No Limit ($0.50/$1.00 USD) - 2016/05/05 15:21:13 CET [2016/05/05 9:21:13 ET]
Table 'Lictoria II' 9-max Seat #8 is the button
Seat 1: St.LaCoste ($100 in chips) 
Seat 2: Dantist1122 ($126.96 in chips) 
Seat 3: Krinica2009 ($101.50 in chips) 
Seat 4: Ying59 ($41.40 in chips) 
Seat 5: sanpidk ($100 in chips) 
Seat 6: gabi_igna ($116.22 in chips) 
Seat 7: Painkiller72 ($203.80 in chips) 
Seat 8: matiko09 ($100 in chips) 
Seat 9: Kukuryzka ($128.37 in chips) 
Kukuryzka: posts small blind $0.50
St.LaCoste: posts big blind $1
*** HOLE CARDS ***
Dealt to matiko09 [7s Ks]
Dantist1122: folds 
Krinica2009: folds 
Ying59: folds 
sanpidk: folds 
gabi_igna: raises $2 to $3
Painkiller72: folds 
matiko09: folds 
Kukuryzka: folds 
St.LaCoste: folds 
Uncalled bet ($2) returned to gabi_igna
gabi_igna collected $2.50 from pot
gabi_igna: doesn't show hand 
*** SUMMARY ***
Total pot $2.50 | Rake $0 
Seat 1: St.LaCoste (big blind) folded before Flop
Seat 2: Dantist1122 folded before Flop (didn't bet)
Seat 3: Krinica2009 folded before Flop (didn't bet)
Seat 4: Ying59 folded before Flop (didn't bet)
Seat 5: sanpidk folded before Flop (didn't bet)
Seat 6: gabi_igna collected ($2.50)
Seat 7: Painkiller72 folded before Flop (didn't bet)
Seat 8: matiko09 (button) folded before Flop (didn't bet)
Seat 9: Kukuryzka (small blind) folded before Flop





PokerStars Hand #152883494858:  Hold'em No Limit ($0.50/$1.00 USD) - 2016/05/05 15:21:28 CET [2016/05/05 9:21:28 ET]
Table 'Chimaera II' 9-max Seat #9 is the button
Seat 2: Spid1 ($100 in chips) 
Seat 3: matiko09 ($100 in chips) 
Seat 5: Butchers31 ($46.83 in chips) 
Seat 6: Painkiller72 ($100 in chips) 
Seat 7: Hypoaroused ($203.55 in chips) 
Seat 8: 2damnstr8 ($95 in chips) 
Seat 9: kamillo91 ($46.88 in chips) 
Spid1: posts small blind $0.50
matiko09: posts big blind $1
RiverJazz: sits out 
*** HOLE CARDS ***
Dealt to matiko09 [2c 9s]
Butchers31: raises $2 to $3
Painkiller72: folds 
Hypoaroused: folds 
2damnstr8: calls $3
kamillo91: calls $3
Spid1: folds 
matiko09: folds 
*** FLOP *** [Ts Qs 7d]
Butchers31: bets $4.99
2damnstr8: calls $4.99
kamillo91: calls $4.99
*** TURN *** [Ts Qs 7d] [2d]
Butchers31: checks 
2damnstr8: bets $18.40
kamillo91: folds 
Butchers31: calls $18.40
*** RIVER *** [Ts Qs 7d 2d] [As]
Butchers31: checks 
2damnstr8: bets $29.88
Butchers31: calls $20.44 and is all-in
Uncalled bet ($9.44) returned to 2damnstr8
*** SHOW DOWN ***
2damnstr8: shows [Ah Js] (a pair of Aces)
Butchers31: shows [Ac Td] (two pair, Aces and Tens)
Butchers31 collected $100.65 from pot
*** SUMMARY ***
Total pot $103.15 | Rake $2.50 
Board [Ts Qs 7d 2d As]
Seat 2: Spid1 (small blind) folded before Flop
Seat 3: matiko09 (big blind) folded before Flop
Seat 5: Butchers31 showed [Ac Td] and won ($100.65) with two pair, Aces and Tens
Seat 6: Painkiller72 folded before Flop (didn't bet)
Seat 7: Hypoaroused folded before Flop (didn't bet)
Seat 8: 2damnstr8 showed [Ah Js] and lost with a pair of Aces
Seat 9: kamillo91 (button) folded on the Turn





PokerStars Hand #152883497646:  Hold'em No Limit ($0.50/$1.00 USD) - 2016/05/05 15:21:33 CET [2016/05/05 9:21:33 ET]
Table 'Pyxis III' 9-max Seat #3 is the button
Seat 1: sanpidk ($108 in chips) 
Seat 2: 50CandyJoe ($102.80 in chips) 
Seat 3: Xxth3nutzxX ($94 in chips) 
Seat 4: Sloeve ($100 in chips) 
Seat 5: darren1031 ($95.65 in chips) 
Seat 6: kamillo91 ($44 in chips) 
Seat 8: matiko09 ($103.18 in chips) 
Seat 9: Hypoaroused ($95.50 in chips) 
Sloeve: posts small blind $0.50
darren1031: posts big blind $1
*** HOLE CARDS ***
Dealt to matiko09 [2s Qd]
kamillo91: folds 
matiko09: folds 
Hypoaroused: folds 
sanpidk: raises $1.50 to $2.50
50CandyJoe: folds 
Xxth3nutzxX: folds 
Sloeve: folds 
darren1031: folds 
Uncalled bet ($1.50) returned to sanpidk
sanpidk collected $2.50 from pot
sanpidk: doesn't show hand 
*** SUMMARY ***
Total pot $2.50 | Rake $0 
Seat 1: sanpidk collected ($2.50)
Seat 2: 50CandyJoe folded before Flop (didn't bet)
Seat 3: Xxth3nutzxX (button) folded before Flop (didn't bet)
Seat 4: Sloeve (small blind) folded before Flop
Seat 5: darren1031 (big blind) folded before Flop
Seat 6: kamillo91 folded before Flop (didn't bet)
Seat 8: matiko09 folded before Flop (didn't bet)
Seat 9: Hypoaroused folded before Flop (didn't bet)





PokerStars Hand #152883499656:  Hold'em No Limit ($0.50/$1.00 USD) - 2016/05/05 15:21:36 CET [2016/05/05 9:21:36 ET]
Table 'Belisana' 9-max Seat #7 is the button
Seat 1: djammusic ($67.17 in chips) 
Seat 2: ipashutapkom ($196.07 in chips) 
Seat 3: Dickyxxx ($100 in chips) 
Seat 4: Kukuryzka ($100 in chips) 
Seat 5: nickreason17 ($107.52 in chips) 
Seat 7: matiko09 ($112.32 in chips) 
Seat 8: Spid1 ($141.76 in chips) 
Seat 9: michelle070 ($54.60 in chips) 
Spid1: posts small blind $0.50
michelle070: posts big blind $1
*** HOLE CARDS ***
Dealt to matiko09 [Qh 8c]
djammusic: folds 
ipashutapkom: folds 
Dickyxxx: folds 
Kukuryzka: folds 
nickreason17: folds 
matiko09: raises $2 to $3
Spid1: folds 
michelle070: folds 
Uncalled bet ($2) returned to matiko09
matiko09 collected $2.50 from pot
matiko09: doesn't show hand 
*** SUMMARY ***
Total pot $2.50 | Rake $0 
Seat 1: djammusic folded before Flop (didn't bet)
Seat 2: ipashutapkom folded before Flop (didn't bet)
Seat 3: Dickyxxx folded before Flop (didn't bet)
Seat 4: Kukuryzka folded before Flop (didn't bet)
Seat 5: nickreason17 folded before Flop (didn't bet)
Seat 7: matiko09 (button) collected ($2.50)
Seat 8: Spid1 (small blind) folded before Flop
Seat 9: michelle070 (big blind) folded before Flop





PokerStars Hand #152883500268:  Hold'em No Limit ($0.50/$1.00 USD) - 2016/05/05 15:21:37 CET [2016/05/05 9:21:37 ET]
Table 'Kacivelia II' 9-max Seat #6 is the button
Seat 2: thecurv ($111.16 in chips) 
Seat 3: 50CandyJoe ($100 in chips) 
Seat 4: matiko09 ($100 in chips) 
Seat 5: Painkiller72 ($119 in chips) 
Seat 6: kop7777 ($79 in chips) 
Seat 7: KovIFish89 ($100 in chips) 
Seat 8: sanpidk ($100 in chips) 
KovIFish89: posts small blind $0.50
sanpidk: posts big blind $1
ipashutapkom: sits out 
Spid1: sits out 
*** HOLE CARDS ***
Dealt to matiko09 [2h 8c]
thecurv: folds 
50CandyJoe: folds 
matiko09: folds 
Painkiller72: folds 
kop7777: raises $2 to $3
KovIFish89: folds 
sanpidk: folds 
Uncalled bet ($2) returned to kop7777
kop7777 collected $2.50 from pot
*** SUMMARY ***
Total pot $2.50 | Rake $0 
Seat 2: thecurv folded before Flop (didn't bet)
Seat 3: 50CandyJoe folded before Flop (didn't bet)
Seat 4: matiko09 folded before Flop (didn't bet)
Seat 5: Painkiller72 folded before Flop (didn't bet)
Seat 6: kop7777 (button) collected ($2.50)
Seat 7: KovIFish89 (small blind) folded before Flop
Seat 8: sanpidk (big blind) folded before Flop





PokerStars Hand #152883504207:  Hold'em No Limit ($0.50/$1.00 USD) - 2016/05/05 15:21:44 CET [2016/05/05 9:21:44 ET]
Table 'Natascha' 9-max Seat #1 is the button
Seat 1: ronald3737 ($142.40 in chips) 
Seat 2: matiko09 ($129.55 in chips) 
Seat 5: Dickyxxx ($148.26 in chips) 
Seat 6: gabi_igna ($147.12 in chips) 
Seat 7: torkkdnm ($138.54 in chips) 
Seat 9: guoweiAA ($236.20 in chips) 
matiko09: posts small blind $0.50
kamillo91 joins the table at seat #8 
bjonlyking has timed out while being disconnected
bjonlyking: is sitting out 
Dickyxxx: posts big blind $1
*** HOLE CARDS ***
Dealt to matiko09 [Qc 4h]
gabi_igna: folds 
bjonlyking is disconnected 
torkkdnm: folds 
guoweiAA: folds 
ronald3737: folds 
matiko09: folds 
Uncalled bet ($0.50) returned to Dickyxxx
Dickyxxx collected $1 from pot
Dickyxxx: doesn't show hand 
*** SUMMARY ***
Total pot $1 | Rake $0 
Seat 1: ronald3737 (button) folded before Flop (didn't bet)
Seat 2: matiko09 (small blind) folded before Flop
Seat 5: Dickyxxx (big blind) collected ($1)
Seat 6: gabi_igna folded before Flop (didn't bet)
Seat 7: torkkdnm folded before Flop (didn't bet)
Seat 9: guoweiAA folded before Flop (didn't bet)





PokerStars Hand #152883509544:  Hold'em No Limit ($0.50/$1.00 USD) - 2016/05/05 15:21:54 CET [2016/05/05 9:21:54 ET]
Table 'Belisana' 9-max Seat #8 is the button
Seat 1: djammusic ($67.17 in chips) 
Seat 2: ipashutapkom ($196.07 in chips) 
Seat 3: Dickyxxx ($100 in chips) 
Seat 4: Kukuryzka ($100 in chips) 
Seat 5: nickreason17 ($107.52 in chips) 
Seat 7: matiko09 ($113.82 in chips) 
Seat 8: Spid1 ($141.26 in chips) 
Seat 9: michelle070 ($53.60 in chips) 
michelle070: posts small blind $0.50
djammusic: posts big blind $1
*** HOLE CARDS ***
Dealt to matiko09 [4d 9c]
ipashutapkom: folds 
Dickyxxx: folds 
Kukuryzka: folds 
nickreason17: folds 
matiko09: folds 
Spid1: folds 
michelle070: calls $0.50
djammusic: checks 
*** FLOP *** [Ac 4s Ks]
michelle070: bets $1
djammusic: folds 
Uncalled bet ($1) returned to michelle070
michelle070 collected $1.90 from pot
michelle070: doesn't show hand 
*** SUMMARY ***
Total pot $2 | Rake $0.10 
Board [Ac 4s Ks]
Seat 1: djammusic (big blind) folded on the Flop
Seat 2: ipashutapkom folded before Flop (didn't bet)
Seat 3: Dickyxxx folded before Flop (didn't bet)
Seat 4: Kukuryzka folded before Flop (didn't bet)
Seat 5: nickreason17 folded before Flop (didn't bet)
Seat 7: matiko09 folded before Flop (didn't bet)
Seat 8: Spid1 (button) folded before Flop (didn't bet)
Seat 9: michelle070 (small blind) collected ($1.90)





PokerStars Hand #152883510324:  Hold'em No Limit ($1/$2 USD) - 2016/05/05 15:21:55 CET [2016/05/05 9:21:55 ET]
Table 'Samitchell' 9-max Seat #5 is the button
Seat 1: T0ny Adams ($76.54 in chips) 
Seat 2: nickreason17 ($215 in chips) 
Seat 3: gabi_igna ($366.87 in chips) 
Seat 5: Spid1 ($202.45 in chips) 
Seat 6: matiko09 ($201 in chips) 
Seat 7: patpaty ($168.30 in chips) 
Seat 8: kblkxls ($104.85 in chips) 
Seat 9: IseeUcards ($281.63 in chips) 
matiko09: posts small blind $1
patpaty: posts big blind $2
*** HOLE CARDS ***
Dealt to matiko09 [As Ad]
kblkxls: folds 
IseeUcards: raises $4 to $6
T0ny Adams: folds 
nickreason17: folds 
gabi_igna: folds 
Spid1: folds 
matiko09: calls $5
patpaty: calls $4
*** FLOP *** [Jh Qh 5s]
matiko09: bets $12
patpaty: folds 
IseeUcards: calls $12
*** TURN *** [Jh Qh 5s] [Jd]
matiko09: bets $26
IseeUcards: folds 
Uncalled bet ($26) returned to matiko09
matiko09 collected $39.90 from pot
matiko09: doesn't show hand 
*** SUMMARY ***
Total pot $42 | Rake $2.10 
Board [Jh Qh 5s Jd]
Seat 1: T0ny Adams folded before Flop (didn't bet)
Seat 2: nickreason17 folded before Flop (didn't bet)
Seat 3: gabi_igna folded before Flop (didn't bet)
Seat 5: Spid1 (button) folded before Flop (didn't bet)
Seat 6: matiko09 (small blind) collected ($39.90)
Seat 7: patpaty (big blind) folded on the Flop
Seat 8: kblkxls folded before Flop (didn't bet)
Seat 9: IseeUcards folded on the Turn





PokerStars Hand #152883514833:  Hold'em No Limit ($0.50/$1.00 USD) - 2016/05/05 15:22:03 CET [2016/05/05 9:22:03 ET]
Table 'Pyxis III' 9-max Seat #4 is the button
Seat 1: sanpidk ($109.50 in chips) 
Seat 2: 50CandyJoe ($102.80 in chips) 
Seat 3: Xxth3nutzxX ($94 in chips) 
Seat 4: Sloeve ($100 in chips) 
Seat 5: darren1031 ($94.65 in chips) 
Seat 6: kamillo91 ($44 in chips) 
Seat 8: matiko09 ($103.18 in chips) 
Seat 9: Hypoaroused ($95.50 in chips) 
darren1031: posts small blind $0.50
kamillo91: posts big blind $1
nickreason17: sits out 
*** HOLE CARDS ***
Dealt to matiko09 [9h 7c]
matiko09: folds 
Hypoaroused: calls $1
sanpidk: folds 
50CandyJoe: folds 
Xxth3nutzxX: folds 
Sloeve: folds 
darren1031: folds 
kamillo91: checks 
*** FLOP *** [Tc 4s 2s]
kamillo91: checks 
Hypoaroused: checks 
*** TURN *** [Tc 4s 2s] [4h]
kamillo91: checks 
Hypoaroused: bets $2.38
kamillo91: folds 
Uncalled bet ($2.38) returned to Hypoaroused
Hypoaroused collected $2.38 from pot
*** SUMMARY ***
Total pot $2.50 | Rake $0.12 
Board [Tc 4s 2s 4h]
Seat 1: sanpidk folded before Flop (didn't bet)
Seat 2: 50CandyJoe folded before Flop (didn't bet)
Seat 3: Xxth3nutzxX folded before Flop (didn't bet)
Seat 4: Sloeve (button) folded before Flop (didn't bet)
Seat 5: darren1031 (small blind) folded before Flop
Seat 6: kamillo91 (big blind) folded on the Turn
Seat 8: matiko09 folded before Flop (didn't bet)
Seat 9: Hypoaroused collected ($2.38)





PokerStars Hand #152883514287:  Hold'em No Limit ($0.50/$1.00 USD) - 2016/05/05 15:22:03 CET [2016/05/05 9:22:03 ET]
Table 'Kacivelia II' 9-max Seat #7 is the button
Seat 2: thecurv ($111.16 in chips) 
Seat 3: 50CandyJoe ($100 in chips) 
Seat 4: matiko09 ($100 in chips) 
Seat 5: Painkiller72 ($119 in chips) 
Seat 6: kop7777 ($80.50 in chips) 
Seat 7: KovIFish89 ($100 in chips) 
Seat 8: sanpidk ($100 in chips) 
Seat 9: ipashutapkom ($100 in chips) 
sanpidk: posts small blind $0.50
ipashutapkom: posts big blind $1
Spid1: sits out 
*** HOLE CARDS ***
Dealt to matiko09 [Qh 8d]
thecurv: folds 
50CandyJoe: folds 
matiko09: folds 
Painkiller72: folds 
kop7777: raises $2 to $3
KovIFish89: folds 
sanpidk: folds 
ipashutapkom: folds 
Uncalled bet ($2) returned to kop7777
kop7777 collected $2.50 from pot
*** SUMMARY ***
Total pot $2.50 | Rake $0 
Seat 2: thecurv folded before Flop (didn't bet)
Seat 3: 50CandyJoe folded before Flop (didn't bet)
Seat 4: matiko09 folded before Flop (didn't bet)
Seat 5: Painkiller72 folded before Flop (didn't bet)
Seat 6: kop7777 collected ($2.50)
Seat 7: KovIFish89 (button) folded before Flop (didn't bet)
Seat 8: sanpidk (small blind) folded before Flop
Seat 9: ipashutapkom (big blind) folded before Flop





PokerStars Hand #152883527314:  Hold'em No Limit ($0.50/$1.00 USD) - 2016/05/05 15:22:26 CET [2016/05/05 9:22:26 ET]
Table 'Belisana' 9-max Seat #9 is the button
Seat 1: djammusic ($66.17 in chips) 
Seat 2: ipashutapkom ($196.07 in chips) 
Seat 3: Dickyxxx ($100 in chips) 
Seat 4: Kukuryzka ($100 in chips) 
Seat 5: nickreason17 ($107.52 in chips) 
Seat 7: matiko09 ($113.82 in chips) 
Seat 8: Spid1 ($141.26 in chips) 
Seat 9: michelle070 ($54.50 in chips) 
djammusic: posts small blind $0.50
ipashutapkom: posts big blind $1
*** HOLE CARDS ***
Dealt to matiko09 [7h 4s]
Dickyxxx: folds 
Kukuryzka: folds 
nickreason17: raises $1.50 to $2.50
matiko09: folds 
Spid1: folds 
michelle070: folds 
djammusic: raises $5 to $7.50
ipashutapkom: folds 
nickreason17: calls $5
*** FLOP *** [7s 6h 9d]
djammusic: bets $8
nickreason17: calls $8
*** TURN *** [7s 6h 9d] [Kh]
djammusic: checks 
nickreason17: bets $20
djammusic: raises $30.67 to $50.67 and is all-in
nickreason17: calls $30.67
*** FIRST RIVER *** [7s 6h 9d Kh] [2d]
*** SECOND RIVER *** [7s 6h 9d Kh] [Jd]
*** FIRST SHOW DOWN ***
djammusic: shows [Ad Kc] (a pair of Kings)
nickreason17: shows [9h 8h] (a pair of Nines)
djammusic collected $65.42 from pot
*** SECOND SHOW DOWN ***
djammusic: shows [Ad Kc] (a pair of Kings)
nickreason17: shows [9h 8h] (a pair of Nines)
djammusic collected $65.42 from pot
*** SUMMARY ***
Total pot $133.34 | Rake $2.50 
Hand was run twice
FIRST Board [7s 6h 9d Kh 2d]
SECOND Board [7s 6h 9d Kh Jd]
Seat 1: djammusic (small blind) showed [Ad Kc] and won ($65.42) with a pair of Kings, and won ($65.42) with a pair of Kings
Seat 2: ipashutapkom (big blind) folded before Flop
Seat 3: Dickyxxx folded before Flop (didn't bet)
Seat 4: Kukuryzka folded before Flop (didn't bet)
Seat 5: nickreason17 showed [9h 8h] and lost with a pair of Nines, and lost with a pair of Nines
Seat 7: matiko09 folded before Flop (didn't bet)
Seat 8: Spid1 folded before Flop (didn't bet)
Seat 9: michelle070 (button) folded before Flop (didn't bet)





PokerStars Hand #152883528035:  Hold'em No Limit ($0.50/$1.00 USD) - 2016/05/05 15:22:27 CET [2016/05/05 9:22:27 ET]
Table 'Priska II' 9-max Seat #1 is the button
Seat 1: Spid1 ($100 in chips) 
Seat 2: Kukuryzka ($100 in chips) 
Seat 3: matiko09 ($100 in chips) 
Seat 4: Painkiller72 ($150.11 in chips) 
Seat 5: nickreason17 ($128 in chips) 
Seat 7: stockbridge8 ($97.95 in chips) 
Seat 8: pohorc21 ($67.22 in chips) 
Seat 9: torkkdnm ($105.05 in chips) 
Kukuryzka: posts small blind $0.50
matiko09: posts big blind $1
OneTwo81: sits out 
*** HOLE CARDS ***
Dealt to matiko09 [2s 4h]
Painkiller72: folds 
nickreason17: folds 
stockbridge8: raises $2 to $3
pohorc21: folds 
torkkdnm: calls $3
Spid1: folds 
Kukuryzka: folds 
matiko09: folds 
*** FLOP *** [Kc 3s 4s]
stockbridge8: bets $3.56
torkkdnm: folds 
Uncalled bet ($3.56) returned to stockbridge8
stockbridge8 collected $7.12 from pot
stockbridge8: doesn't show hand 
*** SUMMARY ***
Total pot $7.50 | Rake $0.38 
Board [Kc 3s 4s]
Seat 1: Spid1 (button) folded before Flop (didn't bet)
Seat 2: Kukuryzka (small blind) folded before Flop
Seat 3: matiko09 (big blind) folded before Flop
Seat 4: Painkiller72 folded before Flop (didn't bet)
Seat 5: nickreason17 folded before Flop (didn't bet)
Seat 7: stockbridge8 collected ($7.12)
Seat 8: pohorc21 folded before Flop (didn't bet)
Seat 9: torkkdnm folded on the Flop





PokerStars Hand #152883533666:  Hold'em No Limit ($0.50/$1.00 USD) - 2016/05/05 15:22:37 CET [2016/05/05 9:22:37 ET]
Table 'Lictoria II' 9-max Seat #9 is the button
Seat 1: St.LaCoste ($100 in chips) 
Seat 2: Dantist1122 ($126.96 in chips) 
Seat 3: Krinica2009 ($101.50 in chips) 
Seat 4: Ying59 ($41.40 in chips) 
Seat 5: sanpidk ($100 in chips) 
Seat 6: gabi_igna ($117.72 in chips) 
Seat 7: Painkiller72 ($203.80 in chips) 
Seat 8: matiko09 ($100 in chips) 
Seat 9: Kukuryzka ($127.87 in chips) 
St.LaCoste: posts small blind $0.50
Dantist1122: posts big blind $1
*** HOLE CARDS ***
Dealt to matiko09 [6s 9h]
Krinica2009: raises $1.50 to $2.50
Ying59: folds 
sanpidk: folds 
gabi_igna: folds 
Painkiller72: folds 
matiko09: folds 
Kukuryzka: folds 
St.LaCoste: folds 
Dantist1122: folds 
Uncalled bet ($1.50) returned to Krinica2009
Krinica2009 collected $2.50 from pot
Krinica2009: doesn't show hand 
*** SUMMARY ***
Total pot $2.50 | Rake $0 
Seat 1: St.LaCoste (small blind) folded before Flop
Seat 2: Dantist1122 (big blind) folded before Flop
Seat 3: Krinica2009 collected ($2.50)
Seat 4: Ying59 folded before Flop (didn't bet)
Seat 5: sanpidk folded before Flop (didn't bet)
Seat 6: gabi_igna folded before Flop (didn't bet)
Seat 7: Painkiller72 folded before Flop (didn't bet)
Seat 8: matiko09 folded before Flop (didn't bet)
Seat 9: Kukuryzka (button) folded before Flop (didn't bet)





PokerStars Hand #152883534320:  Hold'em No Limit ($0.50/$1.00 USD) - 2016/05/05 15:22:38 CET [2016/05/05 9:22:38 ET]
Table 'Kacivelia II' 9-max Seat #8 is the button
Seat 1: Spid1 ($100 in chips) 
Seat 2: thecurv ($111.16 in chips) 
Seat 3: 50CandyJoe ($100 in chips) 
Seat 4: matiko09 ($100 in chips) 
Seat 5: Painkiller72 ($119 in chips) 
Seat 6: kop7777 ($82 in chips) 
Seat 7: KovIFish89 ($100 in chips) 
Seat 8: sanpidk ($100 in chips) 
Seat 9: ipashutapkom ($99 in chips) 
ipashutapkom: posts small blind $0.50
Spid1: posts big blind $1
*** HOLE CARDS ***
Dealt to matiko09 [9c 3s]
thecurv: raises $1 to $2
50CandyJoe: folds 
matiko09: folds 
Painkiller72: calls $2
kop7777: folds 
KovIFish89: folds 
sanpidk: folds 
ipashutapkom: folds 
Spid1: folds 
*** FLOP *** [3h 5s As]
thecurv: checks 
Painkiller72: checks 
*** TURN *** [3h 5s As] [7h]
thecurv: checks 
Painkiller72: checks 
*** RIVER *** [3h 5s As 7h] [9s]
thecurv: checks 
Painkiller72: bets $3.65
thecurv: folds 
Uncalled bet ($3.65) returned to Painkiller72
Painkiller72 collected $5.22 from pot
Painkiller72: doesn't show hand 
*** SUMMARY ***
Total pot $5.50 | Rake $0.28 
Board [3h 5s As 7h 9s]
Seat 1: Spid1 (big blind) folded before Flop
Seat 2: thecurv folded on the River
Seat 3: 50CandyJoe folded before Flop (didn't bet)
Seat 4: matiko09 folded before Flop (didn't bet)
Seat 5: Painkiller72 collected ($5.22)
Seat 6: kop7777 folded before Flop (didn't bet)
Seat 7: KovIFish89 folded before Flop (didn't bet)
Seat 8: sanpidk (button) folded before Flop (didn't bet)
Seat 9: ipashutapkom (small blind) folded before Flop





PokerStars Hand #152883536897:  Hold'em No Limit ($0.50/$1.00 USD) - 2016/05/05 15:22:42 CET [2016/05/05 9:22:42 ET]
Table 'Natascha' 9-max Seat #2 is the button
Seat 1: ronald3737 ($142.40 in chips) 
Seat 2: matiko09 ($129.05 in chips) 
Seat 5: Dickyxxx ($148.76 in chips) 
Seat 6: gabi_igna ($147.12 in chips) 
Seat 7: torkkdnm ($138.54 in chips) 
Seat 9: guoweiAA ($236.20 in chips) 
Dickyxxx: posts small blind $0.50
gabi_igna: posts big blind $1
kamillo91: sits out 
*** HOLE CARDS ***
Dealt to matiko09 [Tc Ah]
torkkdnm: folds 
guoweiAA: folds 
ronald3737: folds 
matiko09: raises $1.27 to $2.27
Dickyxxx: folds 
gabi_igna: calls $1.27
*** FLOP *** [2c Ks Js]
gabi_igna: checks 
matiko09: bets $3.11
gabi_igna: calls $3.11
*** TURN *** [2c Ks Js] [3h]
gabi_igna: checks 
matiko09: checks 
*** RIVER *** [2c Ks Js 3h] [9c]
gabi_igna: bets $7
matiko09: folds 
Uncalled bet ($7) returned to gabi_igna
gabi_igna collected $10.70 from pot
gabi_igna: doesn't show hand 
bjonlyking is disconnected 
*** SUMMARY ***
Total pot $11.26 | Rake $0.56 
Board [2c Ks Js 3h 9c]
Seat 1: ronald3737 folded before Flop (didn't bet)
Seat 2: matiko09 (button) folded on the River
Seat 5: Dickyxxx (small blind) folded before Flop
Seat 6: gabi_igna (big blind) collected ($10.70)
Seat 7: torkkdnm folded before Flop (didn't bet)
Seat 9: guoweiAA folded before Flop (didn't bet)





PokerStars Hand #152883543340:  Hold'em No Limit ($0.50/$1.00 USD) - 2016/05/05 15:22:54 CET [2016/05/05 9:22:54 ET]
Table 'Chimaera II' 9-max Seat #2 is the button
Seat 2: Spid1 ($100 in chips) 
Seat 3: matiko09 ($100 in chips) 
Seat 4: RiverJazz ($100 in chips) 
Seat 5: Butchers31 ($100.65 in chips) 
Seat 6: Painkiller72 ($100 in chips) 
Seat 7: Hypoaroused ($203.55 in chips) 
Seat 8: 2damnstr8 ($48.17 in chips) 
Seat 9: kamillo91 ($38.89 in chips) 
matiko09: posts small blind $0.50
RiverJazz: posts big blind $1
*** HOLE CARDS ***
Dealt to matiko09 [6h Js]
Butchers31: folds 
Painkiller72: raises $1.50 to $2.50
Hypoaroused: folds 
2damnstr8: folds 
kamillo91: folds 
Spid1: folds 
matiko09: folds 
RiverJazz: folds 
Uncalled bet ($1.50) returned to Painkiller72
Painkiller72 collected $2.50 from pot
Painkiller72: doesn't show hand 
*** SUMMARY ***
Total pot $2.50 | Rake $0 
Seat 2: Spid1 (button) folded before Flop (didn't bet)
Seat 3: matiko09 (small blind) folded before Flop
Seat 4: RiverJazz (big blind) folded before Flop
Seat 5: Butchers31 folded before Flop (didn't bet)
Seat 6: Painkiller72 collected ($2.50)
Seat 7: Hypoaroused folded before Flop (didn't bet)
Seat 8: 2damnstr8 folded before Flop (didn't bet)
Seat 9: kamillo91 folded before Flop (didn't bet)





PokerStars Hand #152883544021:  Hold'em No Limit ($1/$2 USD) - 2016/05/05 15:22:55 CET [2016/05/05 9:22:55 ET]
Table 'Samitchell' 9-max Seat #6 is the button
Seat 1: T0ny Adams ($76.54 in chips) 
Seat 2: nickreason17 ($215 in chips) 
Seat 3: gabi_igna ($366.87 in chips) 
Seat 5: Spid1 ($202.45 in chips) 
Seat 6: matiko09 ($222.90 in chips) 
Seat 7: patpaty ($162.30 in chips) 
Seat 8: kblkxls ($104.85 in chips) 
Seat 9: IseeUcards ($263.63 in chips) 
patpaty: posts small blind $1
kblkxls: posts big blind $2
Fitzyferret: sits out 
*** HOLE CARDS ***
Dealt to matiko09 [7h Th]
IseeUcards: folds 
T0ny Adams: raises $2.68 to $4.68
nickreason17: folds 
gabi_igna: folds 
Spid1: folds 
matiko09: folds 
patpaty: folds 
kblkxls: calls $2.68
*** FLOP *** [3h 4d Ts]
kblkxls: checks 
T0ny Adams: bets $6.17
kblkxls: folds 
Uncalled bet ($6.17) returned to T0ny Adams
T0ny Adams collected $9.84 from pot
T0ny Adams: doesn't show hand 
*** SUMMARY ***
Total pot $10.36 | Rake $0.52 
Board [3h 4d Ts]
Seat 1: T0ny Adams collected ($9.84)
Seat 2: nickreason17 folded before Flop (didn't bet)
Seat 3: gabi_igna folded before Flop (didn't bet)
Seat 5: Spid1 folded before Flop (didn't bet)
Seat 6: matiko09 (button) folded before Flop (didn't bet)
Seat 7: patpaty (small blind) folded before Flop
Seat 8: kblkxls (big blind) folded on the Flop
Seat 9: IseeUcards folded before Flop (didn't bet)





PokerStars Hand #152883554831:  Hold'em No Limit ($0.50/$1.00 USD) - 2016/05/05 15:23:14 CET [2016/05/05 9:23:14 ET]
Table 'Pyxis III' 9-max Seat #5 is the button
Seat 1: sanpidk ($109.50 in chips) 
Seat 2: 50CandyJoe ($102.80 in chips) 
Seat 3: Xxth3nutzxX ($94 in chips) 
Seat 4: Sloeve ($100 in chips) 
Seat 5: darren1031 ($94.15 in chips) 
Seat 6: kamillo91 ($43 in chips) 
Seat 7: nickreason17 ($100 in chips) 
Seat 8: matiko09 ($103.18 in chips) 
Seat 9: Hypoaroused ($96.88 in chips) 
kamillo91: posts small blind $0.50
nickreason17: posts big blind $1
*** HOLE CARDS ***
Dealt to matiko09 [9s Ks]
matiko09: folds 
Hypoaroused: folds 
sanpidk: folds 
50CandyJoe: raises $2 to $3
Xxth3nutzxX: folds 
Sloeve: raises $7.50 to $10.50
darren1031: calls $10.50
kamillo91: folds 
nickreason17: folds 
50CandyJoe: calls $7.50
*** FLOP *** [Qs Jd Tc]
50CandyJoe: checks 
Sloeve: bets $20
darren1031: folds 
50CandyJoe: folds 
Uncalled bet ($20) returned to Sloeve
Sloeve collected $31.35 from pot
Sloeve: doesn't show hand 
*** SUMMARY ***
Total pot $33 | Rake $1.65 
Board [Qs Jd Tc]
Seat 1: sanpidk folded before Flop (didn't bet)
Seat 2: 50CandyJoe folded on the Flop
Seat 3: Xxth3nutzxX folded before Flop (didn't bet)
Seat 4: Sloeve collected ($31.35)
Seat 5: darren1031 (button) folded on the Flop
Seat 6: kamillo91 (small blind) folded before Flop
Seat 7: nickreason17 (big blind) folded before Flop
Seat 8: matiko09 folded before Flop (didn't bet)
Seat 9: Hypoaroused folded before Flop (didn't bet)





PokerStars Hand #152883560064:  Hold'em No Limit ($0.50/$1.00 USD) - 2016/05/05 15:23:24 CET [2016/05/05 9:23:24 ET]
Table 'Natascha' 9-max Seat #5 is the button
Seat 1: ronald3737 ($142.40 in chips) 
Seat 2: matiko09 ($123.67 in chips) 
Seat 5: Dickyxxx ($148.26 in chips) 
Seat 6: gabi_igna ($152.44 in chips) 
Seat 7: torkkdnm ($138.54 in chips) 
Seat 8: kamillo91 ($80 in chips) 
Seat 9: guoweiAA ($236.20 in chips) 
gabi_igna: posts small blind $0.50
torkkdnm: posts big blind $1
kamillo91: posts big blind $1
*** HOLE CARDS ***
Dealt to matiko09 [Js Jd]
kamillo91: checks 
guoweiAA: folds 
ronald3737: raises $3 to $4
matiko09: calls $4
Dickyxxx: calls $4
gabi_igna: folds 
torkkdnm: folds 
kamillo91: folds 
*** FLOP *** [Ks 3h 9c]
ronald3737: bets $7
matiko09: calls $7
Dickyxxx: folds 
*** TURN *** [Ks 3h 9c] [2s]
ronald3737: checks 
matiko09: checks 
*** RIVER *** [Ks 3h 9c 2s] [9h]
ronald3737: checks 
matiko09: checks 
*** SHOW DOWN ***
ronald3737: shows [7d 6d] (a pair of Nines)
matiko09: shows [Js Jd] (two pair, Jacks and Nines)
matiko09 collected $27.08 from pot
*** SUMMARY ***
Total pot $28.50 | Rake $1.42 
Board [Ks 3h 9c 2s 9h]
Seat 1: ronald3737 showed [7d 6d] and lost with a pair of Nines
Seat 2: matiko09 showed [Js Jd] and won ($27.08) with two pair, Jacks and Nines
Seat 5: Dickyxxx (button) folded on the Flop
Seat 6: gabi_igna (small blind) folded before Flop
Seat 7: torkkdnm (big blind) folded before Flop
Seat 8: kamillo91 folded before Flop
Seat 9: guoweiAA folded before Flop (didn't bet)





PokerStars Hand #152883562459:  Hold'em No Limit ($0.50/$1.00 USD) - 2016/05/05 15:23:28 CET [2016/05/05 9:23:28 ET]
Table 'Lictoria II' 9-max Seat #1 is the button
Seat 1: St.LaCoste ($100 in chips) 
Seat 2: Dantist1122 ($125.96 in chips) 
Seat 3: Krinica2009 ($103 in chips) 
Seat 4: Ying59 ($41.40 in chips) 
Seat 5: sanpidk ($100 in chips) 
Seat 6: gabi_igna ($117.72 in chips) 
Seat 7: Painkiller72 ($203.80 in chips) 
Seat 8: matiko09 ($100 in chips) 
Seat 9: Kukuryzka ($127.87 in chips) 
Dantist1122: posts small blind $0.50
Krinica2009: posts big blind $1
*** HOLE CARDS ***
Dealt to matiko09 [2c Qd]
Ying59: folds 
sanpidk: folds 
gabi_igna: folds 
Painkiller72: folds 
matiko09: folds 
Kukuryzka: raises $1.50 to $2.50
St.LaCoste: folds 
Dantist1122: folds 
Krinica2009: folds 
Uncalled bet ($1.50) returned to Kukuryzka
Kukuryzka collected $2.50 from pot
Kukuryzka: doesn't show hand 
*** SUMMARY ***
Total pot $2.50 | Rake $0 
Seat 1: St.LaCoste (button) folded before Flop (didn't bet)
Seat 2: Dantist1122 (small blind) folded before Flop
Seat 3: Krinica2009 (big blind) folded before Flop
Seat 4: Ying59 folded before Flop (didn't bet)
Seat 5: sanpidk folded before Flop (didn't bet)
Seat 6: gabi_igna folded before Flop (didn't bet)
Seat 7: Painkiller72 folded before Flop (didn't bet)
Seat 8: matiko09 folded before Flop (didn't bet)
Seat 9: Kukuryzka collected ($2.50)





PokerStars Hand #152883563745:  Hold'em No Limit ($0.50/$1.00 USD) - 2016/05/05 15:23:30 CET [2016/05/05 9:23:30 ET]
Table 'Chimaera II' 9-max Seat #3 is the button
Seat 2: Spid1 ($100 in chips) 
Seat 3: matiko09 ($100 in chips) 
Seat 4: RiverJazz ($100 in chips) 
Seat 5: Butchers31 ($100.65 in chips) 
Seat 6: Painkiller72 ($101.50 in chips) 
Seat 7: Hypoaroused ($203.55 in chips) 
Seat 8: 2damnstr8 ($48.17 in chips) 
Seat 9: kamillo91 ($38.89 in chips) 
RiverJazz: posts small blind $0.50
Butchers31: posts big blind $1
*** HOLE CARDS ***
Dealt to matiko09 [7s 4c]
Painkiller72: folds 
Hypoaroused: calls $1
2damnstr8: folds 
kamillo91: folds 
Spid1: folds 
matiko09: folds 
RiverJazz: folds 
Butchers31: checks 
*** FLOP *** [Kh Ac 8c]
Butchers31: checks 
Hypoaroused: checks 
*** TURN *** [Kh Ac 8c] [6d]
Butchers31: bets $1.19
Hypoaroused: calls $1.19
*** RIVER *** [Kh Ac 8c 6d] [7c]
Butchers31: checks 
Hypoaroused: checks 
*** SHOW DOWN ***
Butchers31: shows [Kd 8s] (two pair, Kings and Eights)
Hypoaroused: mucks hand 
Butchers31 collected $4.64 from pot
*** SUMMARY ***
Total pot $4.88 | Rake $0.24 
Board [Kh Ac 8c 6d 7c]
Seat 2: Spid1 folded before Flop (didn't bet)
Seat 3: matiko09 (button) folded before Flop (didn't bet)
Seat 4: RiverJazz (small blind) folded before Flop
Seat 5: Butchers31 (big blind) showed [Kd 8s] and won ($4.64) with two pair, Kings and Eights
Seat 6: Painkiller72 folded before Flop (didn't bet)
Seat 7: Hypoaroused mucked [8h Th]
Seat 8: 2damnstr8 folded before Flop (didn't bet)
Seat 9: kamillo91 folded before Flop (didn't bet)





PokerStars Hand #152883564380:  Hold'em No Limit ($1/$2 USD) - 2016/05/05 15:23:31 CET [2016/05/05 9:23:31 ET]
Table 'Tololo' 9-max Seat #3 is the button
Seat 1: Kukuryzka ($200 in chips) 
Seat 2: gabi_igna ($275.69 in chips) 
Seat 3: nickreason17 ($208 in chips) 
Seat 4: mooose100 ($352.33 in chips) 
Seat 5: matiko09 ($200 in chips) 
Seat 6: Xagua ($154.12 in chips) 
Seat 7: IseeUcards ($204.61 in chips) 
Seat 8: TonnaMunz ($234.66 in chips) 
mooose100: posts small blind $1
matiko09: posts big blind $2
Fitzyferret: sits out 
*** HOLE CARDS ***
Dealt to matiko09 [6h 3h]
Xagua: raises $3 to $5
IseeUcards: folds 
TonnaMunz: folds 
Kukuryzka: folds 
gabi_igna: raises $11 to $16
nickreason17: folds 
mooose100: folds 
matiko09: folds 
Xagua: calls $11
*** FLOP *** [3c 2d Ts]
Xagua: checks 
gabi_igna: bets $16
Xagua: folds 
Uncalled bet ($16) returned to gabi_igna
gabi_igna collected $33.25 from pot
gabi_igna: doesn't show hand 
*** SUMMARY ***
Total pot $35 | Rake $1.75 
Board [3c 2d Ts]
Seat 1: Kukuryzka folded before Flop (didn't bet)
Seat 2: gabi_igna collected ($33.25)
Seat 3: nickreason17 (button) folded before Flop (didn't bet)
Seat 4: mooose100 (small blind) folded before Flop
Seat 5: matiko09 (big blind) folded before Flop
Seat 6: Xagua folded on the Flop
Seat 7: IseeUcards folded before Flop (didn't bet)
Seat 8: TonnaMunz folded before Flop (didn't bet)





PokerStars Hand #152883568418:  Hold'em No Limit ($1/$2 USD) - 2016/05/05 15:23:38 CET [2016/05/05 9:23:38 ET]
Table 'Lundia' 9-max Seat #7 is the button
Seat 2: patpaty ($185.60 in chips) 
Seat 3: IseeUcards ($416.77 in chips) 
Seat 4: kblkxls ($263.65 in chips) 
Seat 5: nickreason17 ($215 in chips) 
Seat 6: Spid1 ($244.50 in chips) 
Seat 7: matiko09 ($200 in chips) 
Seat 8: Durnichka ($78 in chips) 
Seat 9: gabi_igna ($227.41 in chips) 
Durnichka: posts small blind $1
gabi_igna: posts big blind $2
Fitzyferret: sits out 
*** HOLE CARDS ***
Dealt to matiko09 [2s Jh]
patpaty: calls $2
IseeUcards: folds 
kblkxls: raises $4 to $6
nickreason17: folds 
Spid1: folds 
matiko09: folds 
Durnichka: folds 
gabi_igna: folds 
patpaty: calls $4
*** FLOP *** [Qh Ad 6c]
patpaty: checks 
kblkxls: checks 
*** TURN *** [Qh Ad 6c] [8c]
patpaty: bets $2
kblkxls: calls $2
*** RIVER *** [Qh Ad 6c 8c] [5s]
patpaty: bets $6
kblkxls: calls $6
*** SHOW DOWN ***
patpaty: shows [Jd Kh] (high card Ace)
kblkxls: shows [Qs Jc] (a pair of Queens)
kblkxls collected $29.45 from pot
*** SUMMARY ***
Total pot $31 | Rake $1.55 
Board [Qh Ad 6c 8c 5s]
Seat 2: patpaty showed [Jd Kh] and lost with high card Ace
Seat 3: IseeUcards folded before Flop (didn't bet)
Seat 4: kblkxls showed [Qs Jc] and won ($29.45) with a pair of Queens
Seat 5: nickreason17 folded before Flop (didn't bet)
Seat 6: Spid1 folded before Flop (didn't bet)
Seat 7: matiko09 (button) folded before Flop (didn't bet)
Seat 8: Durnichka (small blind) folded before Flop
Seat 9: gabi_igna (big blind) folded before Flop





PokerStars Hand #152883570645:  Hold'em No Limit ($1/$2 USD) - 2016/05/05 15:23:42 CET [2016/05/05 9:23:42 ET]
Table 'Samitchell' 9-max Seat #7 is the button
Seat 1: T0ny Adams ($81.70 in chips) 
Seat 2: nickreason17 ($215 in chips) 
Seat 3: gabi_igna ($366.87 in chips) 
Seat 5: Spid1 ($202.45 in chips) 
Seat 6: matiko09 ($222.90 in chips) 
Seat 7: patpaty ($161.30 in chips) 
Seat 8: kblkxls ($100.17 in chips) 
Seat 9: IseeUcards ($263.63 in chips) 
kblkxls: posts small blind $1
IseeUcards: posts big blind $2
Fitzyferret: sits out 
*** HOLE CARDS ***
Dealt to matiko09 [4d 3d]
T0ny Adams: folds 
nickreason17: folds 
gabi_igna: folds 
Spid1: folds 
matiko09: folds 
patpaty: folds 
kblkxls: calls $1
IseeUcards: checks 
*** FLOP *** [Ad Qs 7d]
kblkxls: checks 
IseeUcards: checks 
*** TURN *** [Ad Qs 7d] [8h]
kblkxls: bets $3
IseeUcards: folds 
Uncalled bet ($3) returned to kblkxls
kblkxls collected $3.80 from pot
kblkxls: doesn't show hand 
*** SUMMARY ***
Total pot $4 | Rake $0.20 
Board [Ad Qs 7d 8h]
Seat 1: T0ny Adams folded before Flop (didn't bet)
Seat 2: nickreason17 folded before Flop (didn't bet)
Seat 3: gabi_igna folded before Flop (didn't bet)
Seat 5: Spid1 folded before Flop (didn't bet)
Seat 6: matiko09 folded before Flop (didn't bet)
Seat 7: patpaty (button) folded before Flop (didn't bet)
Seat 8: kblkxls (small blind) collected ($3.80)
Seat 9: IseeUcards (big blind) folded on the Turn





PokerStars Hand #152883575677:  Hold'em No Limit ($0.50/$1.00 USD) - 2016/05/05 15:23:51 CET [2016/05/05 9:23:51 ET]
Table 'Priska II' 9-max Seat #2 is the button
Seat 1: Spid1 ($100 in chips) 
Seat 2: Kukuryzka ($99.50 in chips) 
Seat 3: matiko09 ($100 in chips) 
Seat 4: Painkiller72 ($150.11 in chips) 
Seat 5: nickreason17 ($128 in chips) 
Seat 7: stockbridge8 ($102.07 in chips) 
Seat 8: pohorc21 ($67.22 in chips) 
Seat 9: torkkdnm ($102.05 in chips) 
matiko09: posts small blind $0.50
Painkiller72: posts big blind $1
OneTwo81: sits out 
*** HOLE CARDS ***
Dealt to matiko09 [Js 7d]
nickreason17: folds 
stockbridge8: folds 
pohorc21: calls $1
torkkdnm: raises $1 to $2
Spid1: folds 
Kukuryzka: calls $2
matiko09: folds 
Painkiller72: calls $1
pohorc21: calls $1
*** FLOP *** [9d 8d 2c]
Painkiller72: checks 
pohorc21: checks 
torkkdnm: checks 
Kukuryzka: checks 
*** TURN *** [9d 8d 2c] [Kc]
Painkiller72: bets $5.65
pohorc21: calls $5.65
torkkdnm: folds 
Kukuryzka: folds 
*** RIVER *** [9d 8d 2c Kc] [4s]
Painkiller72: bets $13.16
pohorc21: folds 
Uncalled bet ($13.16) returned to Painkiller72
Painkiller72 collected $18.81 from pot
Painkiller72: doesn't show hand 
*** SUMMARY ***
Total pot $19.80 | Rake $0.99 
Board [9d 8d 2c Kc 4s]
Seat 1: Spid1 folded before Flop (didn't bet)
Seat 2: Kukuryzka (button) folded on the Turn
Seat 3: matiko09 (small blind) folded before Flop
Seat 4: Painkiller72 (big blind) collected ($18.81)
Seat 5: nickreason17 folded before Flop (didn't bet)
Seat 7: stockbridge8 folded before Flop (didn't bet)
Seat 8: pohorc21 folded on the River
Seat 9: torkkdnm folded on the Turn





PokerStars Hand #152883577449:  Hold'em No Limit ($0.50/$1.00 USD) - 2016/05/05 15:23:54 CET [2016/05/05 9:23:54 ET]
Table 'Lictoria II' 9-max Seat #2 is the button
Seat 1: St.LaCoste ($100 in chips) 
Seat 2: Dantist1122 ($125.46 in chips) 
Seat 3: Krinica2009 ($102 in chips) 
Seat 4: Ying59 ($41.40 in chips) 
Seat 5: sanpidk ($100 in chips) 
Seat 6: gabi_igna ($117.72 in chips) 
Seat 7: Painkiller72 ($203.80 in chips) 
Seat 8: matiko09 ($100 in chips) 
Seat 9: Kukuryzka ($129.37 in chips) 
Krinica2009: posts small blind $0.50
Ying59: posts big blind $1
*** HOLE CARDS ***
Dealt to matiko09 [5c 6c]
sanpidk: raises $2 to $3
gabi_igna: folds 
Painkiller72: folds 
matiko09: folds 
Kukuryzka: folds 
St.LaCoste: raises $6 to $9
Dantist1122: folds 
Krinica2009: folds 
Ying59: folds 
sanpidk: folds 
Uncalled bet ($6) returned to St.LaCoste
St.LaCoste collected $7.50 from pot
St.LaCoste: doesn't show hand 
*** SUMMARY ***
Total pot $7.50 | Rake $0 
Seat 1: St.LaCoste collected ($7.50)
Seat 2: Dantist1122 (button) folded before Flop (didn't bet)
Seat 3: Krinica2009 (small blind) folded before Flop
Seat 4: Ying59 (big blind) folded before Flop
Seat 5: sanpidk folded before Flop
Seat 6: gabi_igna folded before Flop (didn't bet)
Seat 7: Painkiller72 folded before Flop (didn't bet)
Seat 8: matiko09 folded before Flop (didn't bet)
Seat 9: Kukuryzka folded before Flop (didn't bet)





PokerStars Hand #152883581536:  Hold'em No Limit ($0.50/$1.00 USD) - 2016/05/05 15:24:02 CET [2016/05/05 9:24:02 ET]
Table 'Belisana' 9-max Seat #1 is the button
Seat 1: djammusic ($130.84 in chips) 
Seat 2: ipashutapkom ($195.07 in chips) 
Seat 3: Dickyxxx ($100 in chips) 
Seat 4: Kukuryzka ($100 in chips) 
Seat 5: nickreason17 ($100 in chips) 
Seat 7: matiko09 ($113.82 in chips) 
Seat 8: Spid1 ($141.26 in chips) 
Seat 9: michelle070 ($54.50 in chips) 
ipashutapkom: posts small blind $0.50
Dickyxxx: posts big blind $1
*** HOLE CARDS ***
Dealt to matiko09 [6s Kc]
Kukuryzka: folds 
nickreason17 said, "krasava"
nickreason17: folds 
matiko09: folds 
Spid1: folds 
michelle070: calls $1
djammusic: folds 
ipashutapkom: raises $3.26 to $4.26
Dickyxxx: folds 
michelle070: folds 
Uncalled bet ($3.26) returned to ipashutapkom
ipashutapkom collected $3 from pot
ipashutapkom: doesn't show hand 
*** SUMMARY ***
Total pot $3 | Rake $0 
Seat 1: djammusic (button) folded before Flop (didn't bet)
Seat 2: ipashutapkom (small blind) collected ($3)
Seat 3: Dickyxxx (big blind) folded before Flop
Seat 4: Kukuryzka folded before Flop (didn't bet)
Seat 5: nickreason17 folded before Flop (didn't bet)
Seat 7: matiko09 folded before Flop (didn't bet)
Seat 8: Spid1 folded before Flop (didn't bet)
Seat 9: michelle070 folded before Flop





PokerStars Hand #152883584485:  Hold'em No Limit ($0.50/$1.00 USD) - 2016/05/05 15:24:07 CET [2016/05/05 9:24:07 ET]
Table 'Chimaera II' 9-max Seat #4 is the button
Seat 2: Spid1 ($100 in chips) 
Seat 3: matiko09 ($100 in chips) 
Seat 4: RiverJazz ($100 in chips) 
Seat 5: Butchers31 ($103.10 in chips) 
Seat 6: Painkiller72 ($101.50 in chips) 
Seat 7: Hypoaroused ($201.36 in chips) 
Seat 8: 2damnstr8 ($48.17 in chips) 
Seat 9: kamillo91 ($38.89 in chips) 
Butchers31: posts small blind $0.50
Painkiller72: posts big blind $1
*** HOLE CARDS ***
Dealt to matiko09 [6h Ah]
Hypoaroused: folds 
2damnstr8: folds 
kamillo91: folds 
Spid1: folds 
matiko09: raises $1.50 to $2.50
RiverJazz: folds 
Butchers31: folds 
Painkiller72: folds 
Uncalled bet ($1.50) returned to matiko09
matiko09 collected $2.50 from pot
matiko09: doesn't show hand 
*** SUMMARY ***
Total pot $2.50 | Rake $0 
Seat 2: Spid1 folded before Flop (didn't bet)
Seat 3: matiko09 collected ($2.50)
Seat 4: RiverJazz (button) folded before Flop (didn't bet)
Seat 5: Butchers31 (small blind) folded before Flop
Seat 6: Painkiller72 (big blind) folded before Flop
Seat 7: Hypoaroused folded before Flop (didn't bet)
Seat 8: 2damnstr8 folded before Flop (didn't bet)
Seat 9: kamillo91 folded before Flop (didn't bet)





PokerStars Hand #152883590682:  Hold'em No Limit ($0.50/$1.00 USD) - 2016/05/05 15:24:18 CET [2016/05/05 9:24:18 ET]
Table 'Pyxis III' 9-max Seat #6 is the button
Seat 1: sanpidk ($109.50 in chips) 
Seat 2: 50CandyJoe ($100 in chips) 
Seat 3: Xxth3nutzxX ($94 in chips) 
Seat 4: Sloeve ($120.85 in chips) 
Seat 5: darren1031 ($83.65 in chips) 
Seat 6: kamillo91 ($42.50 in chips) 
Seat 7: nickreason17 ($100 in chips) 
Seat 8: matiko09 ($103.18 in chips) 
Seat 9: Hypoaroused ($96.88 in chips) 
nickreason17: posts small blind $0.50
matiko09: posts big blind $1
*** HOLE CARDS ***
Dealt to matiko09 [5s 2h]
Hypoaroused: folds 
sanpidk: folds 
50CandyJoe: folds 
Xxth3nutzxX: folds 
Sloeve: folds 
darren1031: folds 
kamillo91: raises $2 to $3
nickreason17: folds 
matiko09: folds 
Uncalled bet ($2) returned to kamillo91
kamillo91 collected $2.50 from pot
kamillo91: doesn't show hand 
*** SUMMARY ***
Total pot $2.50 | Rake $0 
Seat 1: sanpidk folded before Flop (didn't bet)
Seat 2: 50CandyJoe folded before Flop (didn't bet)
Seat 3: Xxth3nutzxX folded before Flop (didn't bet)
Seat 4: Sloeve folded before Flop (didn't bet)
Seat 5: darren1031 folded before Flop (didn't bet)
Seat 6: kamillo91 (button) collected ($2.50)
Seat 7: nickreason17 (small blind) folded before Flop
Seat 8: matiko09 (big blind) folded before Flop
Seat 9: Hypoaroused folded before Flop (didn't bet)





PokerStars Hand #152883594905:  Hold'em No Limit ($0.50/$1.00 USD) - 2016/05/05 15:24:25 CET [2016/05/05 9:24:25 ET]
Table 'Lictoria II' 9-max Seat #3 is the button
Seat 1: St.LaCoste ($104.50 in chips) 
Seat 2: Dantist1122 ($125.46 in chips) 
Seat 3: Krinica2009 ($101.50 in chips) 
Seat 4: Ying59 ($40.40 in chips) 
Seat 5: sanpidk ($100 in chips) 
Seat 6: gabi_igna ($117.72 in chips) 
Seat 7: Painkiller72 ($203.80 in chips) 
Seat 8: matiko09 ($100 in chips) 
Seat 9: Kukuryzka ($129.37 in chips) 
Ying59: posts small blind $0.50
sanpidk: posts big blind $1
*** HOLE CARDS ***
Dealt to matiko09 [6h 4s]
gabi_igna: folds 
Painkiller72: raises $1.50 to $2.50
matiko09: folds 
Kukuryzka: folds 
St.LaCoste: folds 
Dantist1122: folds 
Krinica2009: calls $2.50
Ying59: folds 
sanpidk: folds 
*** FLOP *** [4c Js Ad]
Painkiller72: bets $4.32
Krinica2009: calls $4.32
*** TURN *** [4c Js Ad] [Tc]
Painkiller72: checks 
Krinica2009: bets $11
Painkiller72: raises $22.19 to $33.19
Krinica2009: raises $22.19 to $55.38
Painkiller72: raises $125.14 to $180.52
Krinica2009: calls $39.30 and is all-in
Uncalled bet ($85.84) returned to Painkiller72
*** RIVER *** [4c Js Ad Tc] [3h]
*** SHOW DOWN ***
Painkiller72: shows [Qc Kh] (a straight, Ten to Ace)
Krinica2009: shows [Qs Kc] (a straight, Ten to Ace)
Painkiller72 collected $101 from pot
Krinica2009 collected $101 from pot
*** SUMMARY ***
Total pot $204.50 | Rake $2.50 
Board [4c Js Ad Tc 3h]
Seat 1: St.LaCoste folded before Flop (didn't bet)
Seat 2: Dantist1122 folded before Flop (didn't bet)
Seat 3: Krinica2009 (button) showed [Qs Kc] and won ($101) with a straight, Ten to Ace
Seat 4: Ying59 (small blind) folded before Flop
Seat 5: sanpidk (big blind) folded before Flop
Seat 6: gabi_igna folded before Flop (didn't bet)
Seat 7: Painkiller72 showed [Qc Kh] and won ($101) with a straight, Ten to Ace
Seat 8: matiko09 folded before Flop (didn't bet)
Seat 9: Kukuryzka folded before Flop (didn't bet)





PokerStars Hand #152883595402:  Hold'em No Limit ($1/$2 USD) - 2016/05/05 15:24:26 CET [2016/05/05 9:24:26 ET]
Table 'Tololo' 9-max Seat #4 is the button
Seat 1: Kukuryzka ($200 in chips) 
Seat 2: gabi_igna ($292.94 in chips) 
Seat 3: nickreason17 ($208 in chips) 
Seat 4: mooose100 ($351.33 in chips) 
Seat 5: matiko09 ($200 in chips) 
Seat 6: Xagua ($138.12 in chips) 
Seat 7: IseeUcards ($204.61 in chips) 
Seat 8: TonnaMunz ($234.66 in chips) 
matiko09: posts small blind $1
Xagua: posts big blind $2
Fitzyferret: sits out 
*** HOLE CARDS ***
Dealt to matiko09 [Kh 6h]
IseeUcards: folds 
TonnaMunz: folds 
Kukuryzka: folds 
gabi_igna: folds 
nickreason17: raises $3 to $5
mooose100: calls $5
matiko09: folds 
Xagua: calls $3
*** FLOP *** [5h 3c Td]
Xagua: checks 
nickreason17: bets $8
mooose100: calls $8
Xagua: folds 
*** TURN *** [5h 3c Td] [Qc]
nickreason17: bets $23
mooose100 has timed out
mooose100: folds 
Uncalled bet ($23) returned to nickreason17
nickreason17 collected $30.40 from pot
*** SUMMARY ***
Total pot $32 | Rake $1.60 
Board [5h 3c Td Qc]
Seat 1: Kukuryzka folded before Flop (didn't bet)
Seat 2: gabi_igna folded before Flop (didn't bet)
Seat 3: nickreason17 collected ($30.40)
Seat 4: mooose100 (button) folded on the Turn
Seat 5: matiko09 (small blind) folded before Flop
Seat 6: Xagua (big blind) folded on the Flop
Seat 7: IseeUcards folded before Flop (didn't bet)
Seat 8: TonnaMunz folded before Flop (didn't bet)





PokerStars Hand #152883600446:  Hold'em No Limit ($0.50/$1.00 USD) - 2016/05/05 15:24:35 CET [2016/05/05 9:24:35 ET]
Table 'Kacivelia II' 9-max Seat #9 is the button
Seat 1: Spid1 ($100 in chips) 
Seat 2: thecurv ($109.16 in chips) 
Seat 3: 50CandyJoe ($100 in chips) 
Seat 4: matiko09 ($100 in chips) 
Seat 5: Painkiller72 ($122.22 in chips) 
Seat 6: kop7777 ($82 in chips) 
Seat 7: KovIFish89 ($100 in chips) 
Seat 8: sanpidk ($100 in chips) 
Seat 9: ipashutapkom ($98.50 in chips) 
Spid1: posts small blind $0.50
thecurv: posts big blind $1
*** HOLE CARDS ***
Dealt to matiko09 [Qs 6s]
50CandyJoe: folds 
matiko09: folds 
Painkiller72: folds 
kop7777: folds 
KovIFish89: folds 
sanpidk: raises $1.50 to $2.50
ipashutapkom: folds 
Spid1: folds 
thecurv: folds 
Uncalled bet ($1.50) returned to sanpidk
sanpidk collected $2.50 from pot
sanpidk: doesn't show hand 
*** SUMMARY ***
Total pot $2.50 | Rake $0 
Seat 1: Spid1 (small blind) folded before Flop
Seat 2: thecurv (big blind) folded before Flop
Seat 3: 50CandyJoe folded before Flop (didn't bet)
Seat 4: matiko09 folded before Flop (didn't bet)
Seat 5: Painkiller72 folded before Flop (didn't bet)
Seat 6: kop7777 folded before Flop (didn't bet)
Seat 7: KovIFish89 folded before Flop (didn't bet)
Seat 8: sanpidk collected ($2.50)
Seat 9: ipashutapkom (button) folded before Flop (didn't bet)





PokerStars Hand #152883602215:  Hold'em No Limit ($1/$2 USD) - 2016/05/05 15:24:38 CET [2016/05/05 9:24:38 ET]
Table 'Samitchell' 9-max Seat #8 is the button
Seat 1: T0ny Adams ($81.70 in chips) 
Seat 2: nickreason17 ($215 in chips) 
Seat 3: gabi_igna ($366.87 in chips) 
Seat 5: Spid1 ($202.45 in chips) 
Seat 6: matiko09 ($222.90 in chips) 
Seat 7: patpaty ($161.30 in chips) 
Seat 8: kblkxls ($101.97 in chips) 
Seat 9: IseeUcards ($261.63 in chips) 
IseeUcards: posts small blind $1
T0ny Adams: posts big blind $2
Fitzyferret: sits out 
*** HOLE CARDS ***
Dealt to matiko09 [5c 7d]
nickreason17: folds 
gabi_igna: raises $2 to $4
Spid1: folds 
matiko09: folds 
patpaty: calls $4
kblkxls: folds 
IseeUcards: folds 
T0ny Adams: folds 
*** FLOP *** [Ac 7c 7h]
gabi_igna: bets $6
patpaty: folds 
Uncalled bet ($6) returned to gabi_igna
gabi_igna collected $10.45 from pot
gabi_igna: doesn't show hand 
*** SUMMARY ***
Total pot $11 | Rake $0.55 
Board [Ac 7c 7h]
Seat 1: T0ny Adams (big blind) folded before Flop
Seat 2: nickreason17 folded before Flop (didn't bet)
Seat 3: gabi_igna collected ($10.45)
Seat 5: Spid1 folded before Flop (didn't bet)
Seat 6: matiko09 folded before Flop (didn't bet)
Seat 7: patpaty folded on the Flop
Seat 8: kblkxls (button) folded before Flop (didn't bet)
Seat 9: IseeUcards (small blind) folded before Flop





PokerStars Hand #152883602602:  Hold'em No Limit ($0.50/$1.00 USD) - 2016/05/05 15:24:39 CET [2016/05/05 9:24:39 ET]
Table 'Belisana' 9-max Seat #2 is the button
Seat 1: djammusic ($130.84 in chips) 
Seat 2: ipashutapkom ($197.07 in chips) 
Seat 3: Dickyxxx ($100 in chips) 
Seat 4: Kukuryzka ($100 in chips) 
Seat 5: nickreason17 ($100 in chips) 
Seat 7: matiko09 ($113.82 in chips) 
Seat 8: Spid1 ($141.26 in chips) 
Seat 9: michelle070 ($53.50 in chips) 
Dickyxxx: posts small blind $0.50
Kukuryzka: posts big blind $1
*** HOLE CARDS ***
Dealt to matiko09 [As 4d]
nickreason17: folds 
matiko09: folds 
Spid1: folds 
michelle070: calls $1
djammusic: folds 
ipashutapkom: raises $3.26 to $4.26
Dickyxxx: folds 
Kukuryzka: folds 
michelle070: calls $3.26
*** FLOP *** [8c 4h 9c]
michelle070: checks 
ipashutapkom: checks 
*** TURN *** [8c 4h 9c] [Ad]
michelle070: bets $1
ipashutapkom: raises $13 to $14
michelle070: calls $13
*** RIVER *** [8c 4h 9c Ad] [Jh]
michelle070: checks 
ipashutapkom: bets $11.55
michelle070: folds 
Uncalled bet ($11.55) returned to ipashutapkom
ipashutapkom collected $36.12 from pot
ipashutapkom: doesn't show hand 
*** SUMMARY ***
Total pot $38.02 | Rake $1.90 
Board [8c 4h 9c Ad Jh]
Seat 1: djammusic folded before Flop (didn't bet)
Seat 2: ipashutapkom (button) collected ($36.12)
Seat 3: Dickyxxx (small blind) folded before Flop
Seat 4: Kukuryzka (big blind) folded before Flop
Seat 5: nickreason17 folded before Flop (didn't bet)
Seat 7: matiko09 folded before Flop (didn't bet)
Seat 8: Spid1 folded before Flop (didn't bet)
Seat 9: michelle070 folded on the River





PokerStars Hand #152883603013:  Hold'em No Limit ($0.50/$1.00 USD) - 2016/05/05 15:24:40 CET [2016/05/05 9:24:40 ET]
Table 'Natascha' 9-max Seat #6 is the button
Seat 1: ronald3737 ($131.40 in chips) 
Seat 2: matiko09 ($139.75 in chips) 
Seat 5: Dickyxxx ($144.26 in chips) 
Seat 6: gabi_igna ($151.94 in chips) 
Seat 7: torkkdnm ($137.54 in chips) 
Seat 8: kamillo91 ($79 in chips) 
Seat 9: guoweiAA ($236.20 in chips) 
torkkdnm: posts small blind $0.50
kamillo91: posts big blind $1
*** HOLE CARDS ***
Dealt to matiko09 [2d 4h]
guoweiAA: raises $2 to $3
ronald3737: folds 
matiko09: folds 
Dickyxxx: folds 
gabi_igna: folds 
torkkdnm: folds 
kamillo91: folds 
Uncalled bet ($2) returned to guoweiAA
guoweiAA collected $2.50 from pot
guoweiAA: doesn't show hand 
*** SUMMARY ***
Total pot $2.50 | Rake $0 
Seat 1: ronald3737 folded before Flop (didn't bet)
Seat 2: matiko09 folded before Flop (didn't bet)
Seat 5: Dickyxxx folded before Flop (didn't bet)
Seat 6: gabi_igna (button) folded before Flop (didn't bet)
Seat 7: torkkdnm (small blind) folded before Flop
Seat 8: kamillo91 (big blind) folded before Flop
Seat 9: guoweiAA collected ($2.50)





PokerStars Hand #152883603631:  Hold'em No Limit ($0.50/$1.00 USD) - 2016/05/05 15:24:41 CET [2016/05/05 9:24:41 ET]
Table 'Chimaera II' 9-max Seat #5 is the button
Seat 2: Spid1 ($100 in chips) 
Seat 3: matiko09 ($101.50 in chips) 
Seat 4: RiverJazz ($100 in chips) 
Seat 5: Butchers31 ($102.60 in chips) 
Seat 6: Painkiller72 ($100.50 in chips) 
Seat 7: Hypoaroused ($201.36 in chips) 
Seat 8: 2damnstr8 ($48.17 in chips) 
Seat 9: kamillo91 ($38.89 in chips) 
Painkiller72: posts small blind $0.50
Hypoaroused: posts big blind $1
*** HOLE CARDS ***
Dealt to matiko09 [4d As]
2damnstr8: folds 
kamillo91: folds 
Spid1: folds 
matiko09: folds 
RiverJazz: raises $2 to $3
Butchers31: folds 
Painkiller72: raises $6 to $9
Hypoaroused: folds 
RiverJazz: folds 
Uncalled bet ($6) returned to Painkiller72
Painkiller72 collected $7 from pot
Painkiller72: doesn't show hand 
*** SUMMARY ***
Total pot $7 | Rake $0 
Seat 2: Spid1 folded before Flop (didn't bet)
Seat 3: matiko09 folded before Flop (didn't bet)
Seat 4: RiverJazz folded before Flop
Seat 5: Butchers31 (button) folded before Flop (didn't bet)
Seat 6: Painkiller72 (small blind) collected ($7)
Seat 7: Hypoaroused (big blind) folded before Flop
Seat 8: 2damnstr8 folded before Flop (didn't bet)
Seat 9: kamillo91 folded before Flop (didn't bet)





PokerStars Hand #152883604616:  Hold'em No Limit ($0.50/$1.00 USD) - 2016/05/05 15:24:42 CET [2016/05/05 9:24:42 ET]
Table 'Pyxis III' 9-max Seat #7 is the button
Seat 1: sanpidk ($109.50 in chips) 
Seat 2: 50CandyJoe ($100 in chips) 
Seat 3: Xxth3nutzxX ($94 in chips) 
Seat 4: Sloeve ($120.85 in chips) 
Seat 5: darren1031 ($83.65 in chips) 
Seat 6: kamillo91 ($44 in chips) 
Seat 7: nickreason17 ($100 in chips) 
Seat 8: matiko09 ($102.18 in chips) 
Seat 9: Hypoaroused ($96.88 in chips) 
matiko09: posts small blind $0.50
Hypoaroused: posts big blind $1
*** HOLE CARDS ***
Dealt to matiko09 [7h 6d]
sanpidk: folds 
50CandyJoe: raises $2 to $3
Xxth3nutzxX: folds 
Sloeve: folds 
darren1031: calls $3
kamillo91: folds 
nickreason17: folds 
matiko09: folds 
Hypoaroused: folds 
*** FLOP *** [7d Qc 7s]
50CandyJoe: bets $3.56
darren1031: calls $3.56
*** TURN *** [7d Qc 7s] [9h]
50CandyJoe: checks 
darren1031: bets $7
50CandyJoe: calls $7
*** RIVER *** [7d Qc 7s 9h] [6c]
50CandyJoe: checks 
darren1031: checks 
*** SHOW DOWN ***
50CandyJoe: shows [Qd Td] (two pair, Queens and Sevens)
darren1031: shows [Th Qs] (two pair, Queens and Sevens)
50CandyJoe collected $13.60 from pot
darren1031 collected $13.59 from pot
*** SUMMARY ***
Total pot $28.62 | Rake $1.43 
Board [7d Qc 7s 9h 6c]
Seat 1: sanpidk folded before Flop (didn't bet)
Seat 2: 50CandyJoe showed [Qd Td] and won ($13.60) with two pair, Queens and Sevens
Seat 3: Xxth3nutzxX folded before Flop (didn't bet)
Seat 4: Sloeve folded before Flop (didn't bet)
Seat 5: darren1031 showed [Th Qs] and won ($13.59) with two pair, Queens and Sevens
Seat 6: kamillo91 folded before Flop (didn't bet)
Seat 7: nickreason17 (button) folded before Flop (didn't bet)
Seat 8: matiko09 (small blind) folded before Flop
Seat 9: Hypoaroused (big blind) folded before Flop





PokerStars Hand #152883607314:  Hold'em No Limit ($1/$2 USD) - 2016/05/05 15:24:47 CET [2016/05/05 9:24:47 ET]
Table 'Lundia' 9-max Seat #8 is the button
Seat 1: Fitzyferret ($200 in chips) 
Seat 2: patpaty ($171.60 in chips) 
Seat 3: IseeUcards ($416.77 in chips) 
Seat 4: kblkxls ($279.10 in chips) 
Seat 5: nickreason17 ($215 in chips) 
Seat 6: Spid1 ($244.50 in chips) 
Seat 7: matiko09 ($200 in chips) 
Seat 8: Durnichka ($77 in chips) 
Seat 9: gabi_igna ($225.41 in chips) 
gabi_igna: posts small blind $1
Fitzyferret: posts big blind $2
*** HOLE CARDS ***
Dealt to matiko09 [Jc Kh]
patpaty: folds 
IseeUcards: folds 
kblkxls: folds 
nickreason17: folds 
Spid1: folds 
matiko09: raises $3 to $5
Durnichka: folds 
gabi_igna: folds 
Fitzyferret: raises $13.40 to $18.40
matiko09: folds 
Uncalled bet ($13.40) returned to Fitzyferret
Fitzyferret collected $11 from pot
Fitzyferret: doesn't show hand 
*** SUMMARY ***
Total pot $11 | Rake $0 
Seat 1: Fitzyferret (big blind) collected ($11)
Seat 2: patpaty folded before Flop (didn't bet)
Seat 3: IseeUcards folded before Flop (didn't bet)
Seat 4: kblkxls folded before Flop (didn't bet)
Seat 5: nickreason17 folded before Flop (didn't bet)
Seat 6: Spid1 folded before Flop (didn't bet)
Seat 7: matiko09 folded before Flop
Seat 8: Durnichka (button) folded before Flop (didn't bet)
Seat 9: gabi_igna (small blind) folded before Flop





PokerStars Hand #152883619557:  Hold'em No Limit ($0.50/$1.00 USD) - 2016/05/05 15:25:09 CET [2016/05/05 9:25:09 ET]
Table 'Kacivelia II' 9-max Seat #1 is the button
Seat 1: Spid1 ($100 in chips) 
Seat 2: thecurv ($108.16 in chips) 
Seat 3: 50CandyJoe ($100 in chips) 
Seat 4: matiko09 ($100 in chips) 
Seat 5: Painkiller72 ($122.22 in chips) 
Seat 6: kop7777 ($82 in chips) 
Seat 7: KovIFish89 ($100 in chips) 
Seat 8: sanpidk ($101.50 in chips) 
Seat 9: ipashutapkom ($98.50 in chips) 
thecurv: posts small blind $0.50
50CandyJoe: posts big blind $1
*** HOLE CARDS ***
Dealt to matiko09 [Tc 2c]
matiko09: folds 
Painkiller72: folds 
kop7777: raises $2 to $3
KovIFish89: calls $3
sanpidk: folds 
ipashutapkom: folds 
Spid1: folds 
thecurv: folds 
50CandyJoe: calls $2
*** FLOP *** [As 8d 3h]
50CandyJoe: checks 
kop7777: checks 
KovIFish89: checks 
*** TURN *** [As 8d 3h] [7s]
50CandyJoe: checks 
kop7777: bets $5
KovIFish89: folds 
50CandyJoe: folds 
Uncalled bet ($5) returned to kop7777
kop7777 collected $9.02 from pot
*** SUMMARY ***
Total pot $9.50 | Rake $0.48 
Board [As 8d 3h 7s]
Seat 1: Spid1 (button) folded before Flop (didn't bet)
Seat 2: thecurv (small blind) folded before Flop
Seat 3: 50CandyJoe (big blind) folded on the Turn
Seat 4: matiko09 folded before Flop (didn't bet)
Seat 5: Painkiller72 folded before Flop (didn't bet)
Seat 6: kop7777 collected ($9.02)
Seat 7: KovIFish89 folded on the Turn
Seat 8: sanpidk folded before Flop (didn't bet)
Seat 9: ipashutapkom folded before Flop (didn't bet)





PokerStars Hand #152883622298:  Hold'em No Limit ($0.50/$1.00 USD) - 2016/05/05 15:25:14 CET [2016/05/05 9:25:14 ET]
Table 'Natascha' 9-max Seat #7 is the button
Seat 1: ronald3737 ($131.40 in chips) 
Seat 2: matiko09 ($139.75 in chips) 
Seat 5: Dickyxxx ($144.26 in chips) 
Seat 6: gabi_igna ($151.94 in chips) 
Seat 7: torkkdnm ($137.04 in chips) 
Seat 8: kamillo91 ($78 in chips) 
Seat 9: guoweiAA ($237.70 in chips) 
kamillo91: posts small blind $0.50
guoweiAA: posts big blind $1
bjonlyking has timed out while being disconnected
bjonlyking: is sitting out 
*** HOLE CARDS ***
Dealt to matiko09 [4s 9c]
ronald3737: folds 
bjonlyking is disconnected 
matiko09: folds 
Dickyxxx: folds 
gabi_igna: raises $1.50 to $2.50
torkkdnm: folds 
kamillo91: folds 
guoweiAA: folds 
Uncalled bet ($1.50) returned to gabi_igna
gabi_igna collected $2.50 from pot
gabi_igna: doesn't show hand 
*** SUMMARY ***
Total pot $2.50 | Rake $0 
Seat 1: ronald3737 folded before Flop (didn't bet)
Seat 2: matiko09 folded before Flop (didn't bet)
Seat 5: Dickyxxx folded before Flop (didn't bet)
Seat 6: gabi_igna collected ($2.50)
Seat 7: torkkdnm (button) folded before Flop (didn't bet)
Seat 8: kamillo91 (small blind) folded before Flop
Seat 9: guoweiAA (big blind) folded before Flop





PokerStars Hand #152883622157:  Hold'em No Limit ($0.50/$1.00 USD) - 2016/05/05 15:25:14 CET [2016/05/05 9:25:14 ET]
Table 'Chimaera II' 9-max Seat #6 is the button
Seat 2: Spid1 ($100 in chips) 
Seat 3: matiko09 ($101.50 in chips) 
Seat 4: RiverJazz ($100 in chips) 
Seat 5: Butchers31 ($102.60 in chips) 
Seat 6: Painkiller72 ($104.50 in chips) 
Seat 7: Hypoaroused ($200.36 in chips) 
Seat 8: 2damnstr8 ($48.17 in chips) 
Seat 9: kamillo91 ($38.89 in chips) 
Hypoaroused: posts small blind $0.50
2damnstr8: posts big blind $1
*** HOLE CARDS ***
Dealt to matiko09 [8d 7h]
kamillo91: folds 
Spid1: folds 
matiko09: folds 
RiverJazz: raises $2 to $3
Butchers31: folds 
Painkiller72: calls $3
Hypoaroused: folds 
2damnstr8: folds 
*** FLOP *** [Ts Jh Tc]
RiverJazz: bets $5
Painkiller72: calls $5
*** TURN *** [Ts Jh Tc] [8s]
RiverJazz: checks 
Painkiller72: bets $11.63
RiverJazz: folds 
Uncalled bet ($11.63) returned to Painkiller72
Painkiller72 collected $16.62 from pot
Painkiller72: doesn't show hand 
*** SUMMARY ***
Total pot $17.50 | Rake $0.88 
Board [Ts Jh Tc 8s]
Seat 2: Spid1 folded before Flop (didn't bet)
Seat 3: matiko09 folded before Flop (didn't bet)
Seat 4: RiverJazz folded on the Turn
Seat 5: Butchers31 folded before Flop (didn't bet)
Seat 6: Painkiller72 (button) collected ($16.62)
Seat 7: Hypoaroused (small blind) folded before Flop
Seat 8: 2damnstr8 (big blind) folded before Flop
Seat 9: kamillo91 folded before Flop (didn't bet)





PokerStars Hand #152883627923:  Hold'em No Limit ($1/$2 USD) - 2016/05/05 15:25:24 CET [2016/05/05 9:25:24 ET]
Table 'Samitchell' 9-max Seat #9 is the button
Seat 1: T0ny Adams ($79.70 in chips) 
Seat 3: gabi_igna ($373.32 in chips) 
Seat 5: Spid1 ($202.45 in chips) 
Seat 6: matiko09 ($222.90 in chips) 
Seat 7: patpaty ($157.30 in chips) 
Seat 8: kblkxls ($101.97 in chips) 
Seat 9: IseeUcards ($260.63 in chips) 
T0ny Adams: posts small blind $1
nickreason17: is sitting out 
gabi_igna: posts big blind $2
Fitzyferret: sits out 
*** HOLE CARDS ***
Dealt to matiko09 [Jd Qs]
nickreason17 leaves the table
Spid1: folds 
Kukuryzka joins the table at seat #2 
Kukuryzka leaves the table
matiko09: raises $3 to $5
patpaty: folds 
kblkxls: folds 
IseeUcards: folds 
13Ghosts joins the table at seat #2 
T0ny Adams: raises $7.50 to $12.50
gabi_igna: folds 
matiko09: folds 
Uncalled bet ($7.50) returned to T0ny Adams
T0ny Adams collected $12 from pot
T0ny Adams: doesn't show hand 
*** SUMMARY ***
Total pot $12 | Rake $0 
Seat 1: T0ny Adams (small blind) collected ($12)
Seat 3: gabi_igna (big blind) folded before Flop
Seat 5: Spid1 folded before Flop (didn't bet)
Seat 6: matiko09 folded before Flop
Seat 7: patpaty folded before Flop (didn't bet)
Seat 8: kblkxls folded before Flop (didn't bet)
Seat 9: IseeUcards (button) folded before Flop (didn't bet)





PokerStars Hand #152883630922:  Hold'em No Limit ($0.50/$1.00 USD) - 2016/05/05 15:25:29 CET [2016/05/05 9:25:29 ET]
Table 'Priska II' 9-max Seat #3 is the button
Seat 1: Spid1 ($100 in chips) 
Seat 2: Kukuryzka ($100 in chips) 
Seat 3: matiko09 ($100 in chips) 
Seat 4: Painkiller72 ($161.27 in chips) 
Seat 5: nickreason17 ($128 in chips) 
Seat 7: stockbridge8 ($102.07 in chips) 
Seat 8: pohorc21 ($59.57 in chips) 
Seat 9: torkkdnm ($100.05 in chips) 
Painkiller72: posts small blind $0.50
nickreason17: posts big blind $1
OneTwo81: sits out 
*** HOLE CARDS ***
Dealt to matiko09 [4c Ac]
stockbridge8: folds 
pohorc21: calls $1
torkkdnm: folds 
Spid1: folds 
Kukuryzka: raises $3 to $4
matiko09: raises $7 to $11
Painkiller72: folds 
nickreason17: folds 
pohorc21: calls $10
Kukuryzka: calls $7
*** FLOP *** [5d Jh 8c]
pohorc21: checks 
Kukuryzka: checks 
matiko09: checks 
*** TURN *** [5d Jh 8c] [Th]
pohorc21: bets $16
Kukuryzka: folds 
matiko09: folds 
Uncalled bet ($16) returned to pohorc21
pohorc21 collected $32.78 from pot
pohorc21: doesn't show hand 
*** SUMMARY ***
Total pot $34.50 | Rake $1.72 
Board [5d Jh 8c Th]
Seat 1: Spid1 folded before Flop (didn't bet)
Seat 2: Kukuryzka folded on the Turn
Seat 3: matiko09 (button) folded on the Turn
Seat 4: Painkiller72 (small blind) folded before Flop
Seat 5: nickreason17 (big blind) folded before Flop
Seat 7: stockbridge8 folded before Flop (didn't bet)
Seat 8: pohorc21 collected ($32.78)
Seat 9: torkkdnm folded before Flop (didn't bet)





PokerStars Hand #152883635834:  Hold'em No Limit ($0.50/$1.00 USD) - 2016/05/05 15:25:38 CET [2016/05/05 9:25:38 ET]
Table 'Belisana' 9-max Seat #3 is the button
Seat 1: djammusic ($130.84 in chips) 
Seat 2: ipashutapkom ($214.93 in chips) 
Seat 3: Dickyxxx ($100 in chips) 
Seat 4: Kukuryzka ($99 in chips) 
Seat 5: nickreason17 ($100 in chips) 
Seat 6: ihami ($40 in chips) 
Seat 7: matiko09 ($113.82 in chips) 
Seat 8: Spid1 ($141.26 in chips) 
Seat 9: michelle070 ($35.24 in chips) 
Kukuryzka: posts small blind $0.50
nickreason17: posts big blind $1
*** HOLE CARDS ***
Dealt to matiko09 [7h Ks]
ihami: folds 
matiko09: folds 
Spid1: raises $2 to $3
michelle070: calls $3
djammusic: folds 
ipashutapkom: folds 
Dickyxxx: folds 
Kukuryzka: folds 
nickreason17: calls $2
*** FLOP *** [3d 4c Kc]
nickreason17: checks 
Spid1: checks 
michelle070: bets $1
nickreason17: calls $1
Spid1: calls $1
*** TURN *** [3d 4c Kc] [6d]
nickreason17: checks 
Spid1: checks 
michelle070: checks 
*** RIVER *** [3d 4c Kc 6d] [7c]
nickreason17: checks 
Spid1: checks 
michelle070: checks 
*** SHOW DOWN ***
nickreason17: shows [8c 8h] (a pair of Eights)
Spid1: mucks hand 
michelle070: mucks hand 
nickreason17 collected $11.88 from pot
*** SUMMARY ***
Total pot $12.50 | Rake $0.62 
Board [3d 4c Kc 6d 7c]
Seat 1: djammusic folded before Flop (didn't bet)
Seat 2: ipashutapkom folded before Flop (didn't bet)
Seat 3: Dickyxxx (button) folded before Flop (didn't bet)
Seat 4: Kukuryzka (small blind) folded before Flop
Seat 5: nickreason17 (big blind) showed [8c 8h] and won ($11.88) with a pair of Eights
Seat 6: ihami folded before Flop (didn't bet)
Seat 7: matiko09 folded before Flop (didn't bet)
Seat 8: Spid1 mucked [4s As]
Seat 9: michelle070 mucked [4h Jh]





PokerStars Hand #152883636788:  Hold'em No Limit ($0.50/$1.00 USD) - 2016/05/05 15:25:40 CET [2016/05/05 9:25:40 ET]
Table 'Lictoria II' 9-max Seat #4 is the button
Seat 1: St.LaCoste ($104.50 in chips) 
Seat 2: Dantist1122 ($125.46 in chips) 
Seat 3: Krinica2009 ($101 in chips) 
Seat 4: Ying59 ($39.90 in chips) 
Seat 5: sanpidk ($100 in chips) 
Seat 6: gabi_igna ($117.72 in chips) 
Seat 7: Painkiller72 ($203.30 in chips) 
Seat 8: matiko09 ($100 in chips) 
Seat 9: Kukuryzka ($129.37 in chips) 
sanpidk: posts small blind $0.50
gabi_igna: posts big blind $1
*** HOLE CARDS ***
Dealt to matiko09 [6c Jh]
Painkiller72: folds 
matiko09: folds 
Kukuryzka: folds 
St.LaCoste: folds 
Dantist1122: folds 
Krinica2009: raises $2 to $3
Ying59: folds 
sanpidk: calls $2.50
gabi_igna: folds 
*** FLOP *** [Qc 4c 4s]
sanpidk: checks 
Krinica2009: bets $4
sanpidk: calls $4
*** TURN *** [Qc 4c 4s] [Kc]
sanpidk: checks 
Krinica2009: checks 
*** RIVER *** [Qc 4c 4s Kc] [4h]
sanpidk: checks 
Krinica2009: checks 
*** SHOW DOWN ***
sanpidk: shows [6h 6d] (a full house, Fours full of Sixes)
Krinica2009: mucks hand 
sanpidk collected $14.25 from pot
*** SUMMARY ***
Total pot $15 | Rake $0.75 
Board [Qc 4c 4s Kc 4h]
Seat 1: St.LaCoste folded before Flop (didn't bet)
Seat 2: Dantist1122 folded before Flop (didn't bet)
Seat 3: Krinica2009 mucked [Js Ad]
Seat 4: Ying59 (button) folded before Flop (didn't bet)
Seat 5: sanpidk (small blind) showed [6h 6d] and won ($14.25) with a full house, Fours full of Sixes
Seat 6: gabi_igna (big blind) folded before Flop
Seat 7: Painkiller72 folded before Flop (didn't bet)
Seat 8: matiko09 folded before Flop (didn't bet)
Seat 9: Kukuryzka folded before Flop (didn't bet)





PokerStars Hand #152883647829:  Hold'em No Limit ($1/$2 USD) - 2016/05/05 15:26:00 CET [2016/05/05 9:26:00 ET]
Table 'Lundia' 9-max Seat #9 is the button
Seat 1: Fitzyferret ($206 in chips) 
Seat 2: patpaty ($171.60 in chips) 
Seat 3: IseeUcards ($416.77 in chips) 
Seat 4: kblkxls ($279.10 in chips) 
Seat 5: nickreason17 ($215 in chips) 
Seat 6: Spid1 ($244.50 in chips) 
Seat 7: matiko09 ($200 in chips) 
Seat 8: Durnichka ($77 in chips) 
Seat 9: gabi_igna ($224.41 in chips) 
Fitzyferret: posts small blind $1
patpaty: posts big blind $2
*** HOLE CARDS ***
Dealt to matiko09 [6s Jh]
IseeUcards: folds 
kblkxls: folds 
nickreason17: folds 
Spid1: folds 
matiko09: folds 
Durnichka: folds 
gabi_igna: raises $3 to $5
Fitzyferret: folds 
patpaty: calls $3
*** FLOP *** [Qs Kd Kh]
patpaty: checks 
gabi_igna: bets $6
patpaty: folds 
Uncalled bet ($6) returned to gabi_igna
gabi_igna collected $10.45 from pot
gabi_igna: doesn't show hand 
*** SUMMARY ***
Total pot $11 | Rake $0.55 
Board [Qs Kd Kh]
Seat 1: Fitzyferret (small blind) folded before Flop
Seat 2: patpaty (big blind) folded on the Flop
Seat 3: IseeUcards folded before Flop (didn't bet)
Seat 4: kblkxls folded before Flop (didn't bet)
Seat 5: nickreason17 folded before Flop (didn't bet)
Seat 6: Spid1 folded before Flop (didn't bet)
Seat 7: matiko09 folded before Flop (didn't bet)
Seat 8: Durnichka folded before Flop (didn't bet)
Seat 9: gabi_igna (button) collected ($10.45)





PokerStars Hand #152883648870:  Hold'em No Limit ($1/$2 USD) - 2016/05/05 15:26:01 CET [2016/05/05 9:26:01 ET]
Table 'Tololo' 9-max Seat #5 is the button
Seat 1: Kukuryzka ($200 in chips) 
Seat 2: gabi_igna ($292.94 in chips) 
Seat 3: nickreason17 ($225.40 in chips) 
Seat 4: mooose100 ($338.33 in chips) 
Seat 5: matiko09 ($200 in chips) 
Seat 6: Xagua ($133.12 in chips) 
Seat 7: IseeUcards ($204.61 in chips) 
Seat 8: TonnaMunz ($234.66 in chips) 
Xagua: posts small blind $1
IseeUcards: posts big blind $2
Fitzyferret: sits out 
*** HOLE CARDS ***
Dealt to matiko09 [Td 2h]
TonnaMunz: raises $2.96 to $4.96
Kukuryzka: folds 
gabi_igna: raises $13.04 to $18
nickreason17: folds 
mooose100: folds 
matiko09: folds 
Xagua: folds 
IseeUcards: folds 
TonnaMunz: calls $13.04
*** FLOP *** [2d 3c 4d]
TonnaMunz: checks 
gabi_igna: bets $20
TonnaMunz: folds 
Uncalled bet ($20) returned to gabi_igna
gabi_igna collected $37.05 from pot
gabi_igna: doesn't show hand 
*** SUMMARY ***
Total pot $39 | Rake $1.95 
Board [2d 3c 4d]
Seat 1: Kukuryzka folded before Flop (didn't bet)
Seat 2: gabi_igna collected ($37.05)
Seat 3: nickreason17 folded before Flop (didn't bet)
Seat 4: mooose100 folded before Flop (didn't bet)
Seat 5: matiko09 (button) folded before Flop (didn't bet)
Seat 6: Xagua (small blind) folded before Flop
Seat 7: IseeUcards (big blind) folded before Flop
Seat 8: TonnaMunz folded on the Flop





PokerStars Hand #152883648835:  Hold'em No Limit ($0.50/$1.00 USD) - 2016/05/05 15:26:01 CET [2016/05/05 9:26:01 ET]
Table 'Pyxis III' 9-max Seat #8 is the button
Seat 1: sanpidk ($109.50 in chips) 
Seat 2: 50CandyJoe ($100.04 in chips) 
Seat 3: Xxth3nutzxX ($94 in chips) 
Seat 4: Sloeve ($120.85 in chips) 
Seat 5: darren1031 ($83.68 in chips) 
Seat 6: kamillo91 ($44 in chips) 
Seat 7: nickreason17 ($100 in chips) 
Seat 8: matiko09 ($101.68 in chips) 
Seat 9: Hypoaroused ($95.88 in chips) 
Hypoaroused: posts small blind $0.50
sanpidk: posts big blind $1
*** HOLE CARDS ***
Dealt to matiko09 [Ad 5h]
50CandyJoe: folds 
Xxth3nutzxX: folds 
Sloeve: folds 
darren1031: calls $1
kamillo91: folds 
nickreason17: folds 
matiko09: raises $2 to $3
Hypoaroused: folds 
sanpidk: folds 
darren1031: raises $4 to $7
matiko09: folds 
Uncalled bet ($4) returned to darren1031
darren1031 collected $7.50 from pot
*** SUMMARY ***
Total pot $7.50 | Rake $0 
Seat 1: sanpidk (big blind) folded before Flop
Seat 2: 50CandyJoe folded before Flop (didn't bet)
Seat 3: Xxth3nutzxX folded before Flop (didn't bet)
Seat 4: Sloeve folded before Flop (didn't bet)
Seat 5: darren1031 collected ($7.50)
Seat 6: kamillo91 folded before Flop (didn't bet)
Seat 7: nickreason17 folded before Flop (didn't bet)
Seat 8: matiko09 (button) folded before Flop
Seat 9: Hypoaroused (small blind) folded before Flop





PokerStars Hand #152883650131:  Hold'em No Limit ($0.50/$1.00 USD) - 2016/05/05 15:26:04 CET [2016/05/05 9:26:04 ET]
Table 'Chimaera II' 9-max Seat #7 is the button
Seat 2: Spid1 ($100 in chips) 
Seat 3: matiko09 ($101.50 in chips) 
Seat 4: RiverJazz ($100 in chips) 
Seat 5: Butchers31 ($102.60 in chips) 
Seat 6: Painkiller72 ($113.12 in chips) 
Seat 7: Hypoaroused ($199.86 in chips) 
Seat 8: 2damnstr8 ($47.17 in chips) 
Seat 9: kamillo91 ($38.89 in chips) 
2damnstr8: posts small blind $0.50
kamillo91: posts big blind $1
*** HOLE CARDS ***
Dealt to matiko09 [7s 9c]
Spid1: folds 
matiko09: folds 
RiverJazz: folds 
Butchers31: folds 
Painkiller72: raises $1.50 to $2.50
Hypoaroused: calls $2.50
2damnstr8: raises $12.25 to $14.75
kamillo91: calls $13.75
Painkiller72: folds 
Hypoaroused: folds 
*** FLOP *** [3d 2h 8c]
2damnstr8: bets $32.42 and is all-in
kamillo91: calls $24.14 and is all-in
Uncalled bet ($8.28) returned to 2damnstr8
*** TURN *** [3d 2h 8c] [9s]
*** RIVER *** [3d 2h 8c 9s] [5s]
*** SHOW DOWN ***
2damnstr8: shows [6s 6c] (a pair of Sixes)
kamillo91: shows [Js Jd] (a pair of Jacks)
kamillo91 collected $80.28 from pot
*** SUMMARY ***
Total pot $82.78 | Rake $2.50 
Board [3d 2h 8c 9s 5s]
Seat 2: Spid1 folded before Flop (didn't bet)
Seat 3: matiko09 folded before Flop (didn't bet)
Seat 4: RiverJazz folded before Flop (didn't bet)
Seat 5: Butchers31 folded before Flop (didn't bet)
Seat 6: Painkiller72 folded before Flop
Seat 7: Hypoaroused (button) folded before Flop
Seat 8: 2damnstr8 (small blind) showed [6s 6c] and lost with a pair of Sixes
Seat 9: kamillo91 (big blind) showed [Js Jd] and won ($80.28) with a pair of Jacks





PokerStars Hand #152883657005:  Hold'em No Limit ($0.50/$1.00 USD) - 2016/05/05 15:26:16 CET [2016/05/05 9:26:16 ET]
Table 'Natascha' 9-max Seat #8 is the button
Seat 1: ronald3737 ($131.40 in chips) 
Seat 2: matiko09 ($139.75 in chips) 
Seat 5: Dickyxxx ($144.26 in chips) 
Seat 6: gabi_igna ($153.44 in chips) 
Seat 7: torkkdnm ($137.04 in chips) 
Seat 8: kamillo91 ($77.50 in chips) 
Seat 9: guoweiAA ($236.70 in chips) 
guoweiAA: posts small blind $0.50
ronald3737: posts big blind $1
maxxmeister: sits out 
*** HOLE CARDS ***
Dealt to matiko09 [Ts 7c]
matiko09: folds 
Dickyxxx: folds 
gabi_igna: folds 
torkkdnm has timed out
torkkdnm: folds 
kamillo91: folds 
guoweiAA: folds 
Uncalled bet ($0.50) returned to ronald3737
ronald3737 collected $1 from pot
ronald3737: doesn't show hand 
*** SUMMARY ***
Total pot $1 | Rake $0 
Seat 1: ronald3737 (big blind) collected ($1)
Seat 2: matiko09 folded before Flop (didn't bet)
Seat 5: Dickyxxx folded before Flop (didn't bet)
Seat 6: gabi_igna folded before Flop (didn't bet)
Seat 7: torkkdnm folded before Flop (didn't bet)
Seat 8: kamillo91 (button) folded before Flop (didn't bet)
Seat 9: guoweiAA (small blind) folded before Flop





PokerStars Hand #152883664200:  Hold'em No Limit ($0.50/$1.00 USD) - 2016/05/05 15:26:29 CET [2016/05/05 9:26:29 ET]
Table 'Kacivelia II' 9-max Seat #2 is the button
Seat 1: Spid1 ($100 in chips) 
Seat 2: thecurv ($107.66 in chips) 
Seat 3: 50CandyJoe ($100 in chips) 
Seat 4: matiko09 ($100 in chips) 
Seat 5: Painkiller72 ($122.22 in chips) 
Seat 6: kop7777 ($88.02 in chips) 
Seat 7: KovIFish89 ($100 in chips) 
Seat 8: sanpidk ($101.50 in chips) 
Seat 9: ipashutapkom ($98.50 in chips) 
50CandyJoe: posts small blind $0.50
matiko09: posts big blind $1
*** HOLE CARDS ***
Dealt to matiko09 [Kd 6c]
Painkiller72: folds 
kop7777: raises $1 to $2
KovIFish89: folds 
sanpidk: folds 
ipashutapkom: folds 
Spid1: folds 
thecurv: calls $2
50CandyJoe: folds 
matiko09: folds 
*** FLOP *** [8c 9h 7h]
kop7777: checks 
thecurv: bets $3.91
kop7777: folds 
Uncalled bet ($3.91) returned to thecurv
thecurv collected $5.22 from pot
thecurv: doesn't show hand 
*** SUMMARY ***
Total pot $5.50 | Rake $0.28 
Board [8c 9h 7h]
Seat 1: Spid1 folded before Flop (didn't bet)
Seat 2: thecurv (button) collected ($5.22)
Seat 3: 50CandyJoe (small blind) folded before Flop
Seat 4: matiko09 (big blind) folded before Flop
Seat 5: Painkiller72 folded before Flop (didn't bet)
Seat 6: kop7777 folded on the Flop
Seat 7: KovIFish89 folded before Flop (didn't bet)
Seat 8: sanpidk folded before Flop (didn't bet)
Seat 9: ipashutapkom folded before Flop (didn't bet)





PokerStars Hand #152883670105:  Hold'em No Limit ($0.50/$1.00 USD) - 2016/05/05 15:26:39 CET [2016/05/05 9:26:39 ET]
Table 'Belisana' 9-max Seat #4 is the button
Seat 1: djammusic ($130.84 in chips) 
Seat 2: ipashutapkom ($214.93 in chips) 
Seat 3: Dickyxxx ($100 in chips) 
Seat 4: Kukuryzka ($100 in chips) 
Seat 5: nickreason17 ($107.88 in chips) 
Seat 6: ihami ($40 in chips) 
Seat 7: matiko09 ($113.82 in chips) 
Seat 8: Spid1 ($137.26 in chips) 
Seat 9: michelle070 ($31.24 in chips) 
nickreason17: posts small blind $0.50
ihami: posts big blind $1
*** HOLE CARDS ***
Dealt to matiko09 [2c 5d]
matiko09: folds 
Spid1: folds 
michelle070: calls $1
djammusic: folds 
ipashutapkom: folds 
Dickyxxx: folds 
Kukuryzka: folds 
nickreason17: folds 
ihami: checks 
*** FLOP *** [Ac 9c Qh]
ihami: checks 
michelle070: bets $1
ihami: folds 
Uncalled bet ($1) returned to michelle070
michelle070 collected $2.38 from pot
michelle070: doesn't show hand 
*** SUMMARY ***
Total pot $2.50 | Rake $0.12 
Board [Ac 9c Qh]
Seat 1: djammusic folded before Flop (didn't bet)
Seat 2: ipashutapkom folded before Flop (didn't bet)
Seat 3: Dickyxxx folded before Flop (didn't bet)
Seat 4: Kukuryzka (button) folded before Flop (didn't bet)
Seat 5: nickreason17 (small blind) folded before Flop
Seat 6: ihami (big blind) folded on the Flop
Seat 7: matiko09 folded before Flop (didn't bet)
Seat 8: Spid1 folded before Flop (didn't bet)
Seat 9: michelle070 collected ($2.38)





PokerStars Hand #152883671365:  Hold'em No Limit ($0.50/$1.00 USD) - 2016/05/05 15:26:41 CET [2016/05/05 9:26:41 ET]
Table 'Pyxis III' 9-max Seat #9 is the button
Seat 1: sanpidk ($108.50 in chips) 
Seat 2: 50CandyJoe ($100.04 in chips) 
Seat 3: Xxth3nutzxX ($94 in chips) 
Seat 4: Sloeve ($120.85 in chips) 
Seat 5: darren1031 ($88.18 in chips) 
Seat 6: kamillo91 ($44 in chips) 
Seat 7: nickreason17 ($100 in chips) 
Seat 8: matiko09 ($100 in chips) 
Seat 9: Hypoaroused ($95.38 in chips) 
sanpidk: posts small blind $0.50
50CandyJoe: posts big blind $1
*** HOLE CARDS ***
Dealt to matiko09 [Td 3c]
Xxth3nutzxX: calls $1
Sloeve: folds 
darren1031: folds 
kamillo91: folds 
nickreason17: folds 
matiko09: folds 
Hypoaroused: folds 
sanpidk: raises $4 to $5
50CandyJoe: folds 
Xxth3nutzxX: calls $4
*** FLOP *** [Qc 7c 3s]
sanpidk: bets $9.96
Xxth3nutzxX: folds 
Uncalled bet ($9.96) returned to sanpidk
sanpidk collected $10.45 from pot
sanpidk: doesn't show hand 
*** SUMMARY ***
Total pot $11 | Rake $0.55 
Board [Qc 7c 3s]
Seat 1: sanpidk (small blind) collected ($10.45)
Seat 2: 50CandyJoe (big blind) folded before Flop
Seat 3: Xxth3nutzxX folded on the Flop
Seat 4: Sloeve folded before Flop (didn't bet)
Seat 5: darren1031 folded before Flop (didn't bet)
Seat 6: kamillo91 folded before Flop (didn't bet)
Seat 7: nickreason17 folded before Flop (didn't bet)
Seat 8: matiko09 folded before Flop (didn't bet)
Seat 9: Hypoaroused (button) folded before Flop (didn't bet)





PokerStars Hand #152883674124:  Hold'em No Limit ($1/$2 USD) - 2016/05/05 15:26:46 CET [2016/05/05 9:26:46 ET]
Table 'Samitchell' 9-max Seat #1 is the button
Seat 1: T0ny Adams ($86.70 in chips) 
Seat 3: gabi_igna ($371.32 in chips) 
Seat 4: Fitzyferret ($383.69 in chips) 
Seat 5: Spid1 ($202.45 in chips) 
Seat 6: matiko09 ($217.90 in chips) 
Seat 7: patpaty ($157.30 in chips) 
Seat 8: kblkxls ($101.97 in chips) 
Seat 9: IseeUcards ($260.63 in chips) 
13Ghosts will be allowed to play after the button
gabi_igna: posts small blind $1
Fitzyferret: posts big blind $2
*** HOLE CARDS ***
Dealt to matiko09 [Qc 4c]
Spid1: folds 
matiko09: folds 
patpaty: folds 
kblkxls: folds 
IseeUcards: folds 
T0ny Adams: raises $2.28 to $4.28
gabi_igna: folds 
Fitzyferret: raises $9.56 to $13.84
T0ny Adams: folds 
Uncalled bet ($9.56) returned to Fitzyferret
Fitzyferret collected $9.56 from pot
Fitzyferret: doesn't show hand 
*** SUMMARY ***
Total pot $9.56 | Rake $0 
Seat 1: T0ny Adams (button) folded before Flop
Seat 3: gabi_igna (small blind) folded before Flop
Seat 4: Fitzyferret (big blind) collected ($9.56)
Seat 5: Spid1 folded before Flop (didn't bet)
Seat 6: matiko09 folded before Flop (didn't bet)
Seat 7: patpaty folded before Flop (didn't bet)
Seat 8: kblkxls folded before Flop (didn't bet)
Seat 9: IseeUcards folded before Flop (didn't bet)





PokerStars Hand #152883678613:  Hold'em No Limit ($0.50/$1.00 USD) - 2016/05/05 15:26:54 CET [2016/05/05 9:26:54 ET]
Table 'Lictoria II' 9-max Seat #5 is the button
Seat 1: St.LaCoste ($104.50 in chips) 
Seat 2: Dantist1122 ($125.46 in chips) 
Seat 3: Krinica2009 ($100 in chips) 
Seat 4: Ying59 ($39.90 in chips) 
Seat 5: sanpidk ($107.25 in chips) 
Seat 6: gabi_igna ($116.72 in chips) 
Seat 7: Painkiller72 ($203.30 in chips) 
Seat 8: matiko09 ($100 in chips) 
Seat 9: Kukuryzka ($129.37 in chips) 
gabi_igna: posts small blind $0.50
Painkiller72: posts big blind $1
*** HOLE CARDS ***
Dealt to matiko09 [7s Qd]
matiko09: folds 
Kukuryzka: folds 
St.LaCoste: raises $2 to $3
Dantist1122: folds 
Krinica2009: folds 
Ying59: folds 
sanpidk: folds 
gabi_igna: folds 
Painkiller72: folds 
Uncalled bet ($2) returned to St.LaCoste
St.LaCoste collected $2.50 from pot
St.LaCoste: doesn't show hand 
*** SUMMARY ***
Total pot $2.50 | Rake $0 
Seat 1: St.LaCoste collected ($2.50)
Seat 2: Dantist1122 folded before Flop (didn't bet)
Seat 3: Krinica2009 folded before Flop (didn't bet)
Seat 4: Ying59 folded before Flop (didn't bet)
Seat 5: sanpidk (button) folded before Flop (didn't bet)
Seat 6: gabi_igna (small blind) folded before Flop
Seat 7: Painkiller72 (big blind) folded before Flop
Seat 8: matiko09 folded before Flop (didn't bet)
Seat 9: Kukuryzka folded before Flop (didn't bet)





PokerStars Hand #152883678654:  Hold'em No Limit ($0.50/$1.00 USD) - 2016/05/05 15:26:54 CET [2016/05/05 9:26:54 ET]
Table 'Priska II' 9-max Seat #4 is the button
Seat 1: Spid1 ($100 in chips) 
Seat 2: Kukuryzka ($100 in chips) 
Seat 3: matiko09 ($100 in chips) 
Seat 4: Painkiller72 ($160.77 in chips) 
Seat 5: nickreason17 ($127 in chips) 
Seat 6: OneTwo81 ($100 in chips) 
Seat 7: stockbridge8 ($102.07 in chips) 
Seat 8: pohorc21 ($81.35 in chips) 
Seat 9: torkkdnm ($100.05 in chips) 
nickreason17: posts small blind $0.50
OneTwo81: posts big blind $1
*** HOLE CARDS ***
Dealt to matiko09 [5c Jh]
stockbridge8: folds 
pohorc21: folds 
torkkdnm: raises $2 to $3
Spid1: folds 
Kukuryzka: folds 
matiko09: folds 
Painkiller72: folds 
nickreason17: folds 
OneTwo81: folds 
Uncalled bet ($2) returned to torkkdnm
torkkdnm collected $2.50 from pot
*** SUMMARY ***
Total pot $2.50 | Rake $0 
Seat 1: Spid1 folded before Flop (didn't bet)
Seat 2: Kukuryzka folded before Flop (didn't bet)
Seat 3: matiko09 folded before Flop (didn't bet)
Seat 4: Painkiller72 (button) folded before Flop (didn't bet)
Seat 5: nickreason17 (small blind) folded before Flop
Seat 6: OneTwo81 (big blind) folded before Flop
Seat 7: stockbridge8 folded before Flop (didn't bet)
Seat 8: pohorc21 folded before Flop (didn't bet)
Seat 9: torkkdnm collected ($2.50)





PokerStars Hand #152883681281:  Hold'em No Limit ($1/$2 USD) - 2016/05/05 15:26:59 CET [2016/05/05 9:26:59 ET]
Table 'Lundia' 9-max Seat #1 is the button
Seat 1: Fitzyferret ($205 in chips) 
Seat 2: patpaty ($166.60 in chips) 
Seat 3: IseeUcards ($416.77 in chips) 
Seat 4: kblkxls ($279.10 in chips) 
Seat 5: nickreason17 ($215 in chips) 
Seat 6: Spid1 ($244.50 in chips) 
Seat 7: matiko09 ($200 in chips) 
Seat 8: Durnichka ($77 in chips) 
Seat 9: gabi_igna ($229.86 in chips) 
patpaty: posts small blind $1
IseeUcards: posts big blind $2
*** HOLE CARDS ***
Dealt to matiko09 [Ah Ac]
kblkxls: folds 
nickreason17: folds 
Spid1: folds 
kblkxls leaves the table
matiko09: raises $3 to $5
Durnichka: folds 
gabi_igna: folds 
Fitzyferret: folds 
patpaty: folds 
IseeUcards: folds 
Uncalled bet ($3) returned to matiko09
matiko09 collected $5 from pot
matiko09: doesn't show hand 
*** SUMMARY ***
Total pot $5 | Rake $0 
Seat 1: Fitzyferret (button) folded before Flop (didn't bet)
Seat 2: patpaty (small blind) folded before Flop
Seat 3: IseeUcards (big blind) folded before Flop
Seat 4: kblkxls folded before Flop (didn't bet)
Seat 5: nickreason17 folded before Flop (didn't bet)
Seat 6: Spid1 folded before Flop (didn't bet)
Seat 7: matiko09 collected ($5)
Seat 8: Durnichka folded before Flop (didn't bet)
Seat 9: gabi_igna folded before Flop (didn't bet)





PokerStars Hand #152883684650:  Hold'em No Limit (€1/€2 EUR) - 2016/05/05 15:27:05 CET [2016/05/05 9:27:05 ET]
Table 'Bessel II' 9-max Seat #5 is the button
Seat 1: Soloaces224 (€158.67 in chips) 
Seat 2: Fitzyferret (€289.70 in chips) 
Seat 3: IseeUcards (€564.93 in chips) 
Seat 4: 93robin93 (€74 in chips) 
Seat 5: Painkiller72 (€200 in chips) 
Seat 6: Spid1 (€200 in chips) 
Seat 7: matiko09 (€203 in chips) 
Spid1: posts small blind €1
matiko09: posts big blind €2
KovIFish89: sits out 
Ravnica11: sits out 
*** HOLE CARDS ***
Dealt to matiko09 [2s 6d]
Soloaces224: folds 
Fitzyferret: folds 
IseeUcards: folds 
93robin93: calls €2
Painkiller72: raises €5 to €7
Spid1: folds 
matiko09: folds 
93robin93: calls €5
*** FLOP *** [7c Js 5h]
93robin93: checks 
Painkiller72: bets €11.30
93robin93: calls €11.30
*** TURN *** [7c Js 5h] [9h]
93robin93: bets €55.70 and is all-in
Painkiller72: calls €55.70
*** RIVER *** [7c Js 5h 9h] [4s]
*** SHOW DOWN ***
93robin93: shows [9d Td] (a pair of Nines)
Painkiller72: shows [As Jh] (a pair of Jacks)
Painkiller72 collected €148.50 from pot
*** SUMMARY ***
Total pot €151 | Rake €2.50 
Board [7c Js 5h 9h 4s]
Seat 1: Soloaces224 folded before Flop (didn't bet)
Seat 2: Fitzyferret folded before Flop (didn't bet)
Seat 3: IseeUcards folded before Flop (didn't bet)
Seat 4: 93robin93 showed [9d Td] and lost with a pair of Nines
Seat 5: Painkiller72 (button) showed [As Jh] and won (€148.50) with a pair of Jacks
Seat 6: Spid1 (small blind) folded before Flop
Seat 7: matiko09 (big blind) folded before Flop





PokerStars Hand #152883685496:  Hold'em No Limit ($1/$2 USD) - 2016/05/05 15:27:06 CET [2016/05/05 9:27:06 ET]
Table 'Tololo' 9-max Seat #6 is the button
Seat 1: Kukuryzka ($200 in chips) 
Seat 2: gabi_igna ($311.99 in chips) 
Seat 3: nickreason17 ($225.40 in chips) 
Seat 4: mooose100 ($338.33 in chips) 
Seat 5: matiko09 ($200 in chips) 
Seat 6: Xagua ($132.12 in chips) 
Seat 7: IseeUcards ($202.61 in chips) 
Seat 8: TonnaMunz ($216.66 in chips) 
IseeUcards: posts small blind $1
TonnaMunz: posts big blind $2
Fitzyferret: sits out 
*** HOLE CARDS ***
Dealt to matiko09 [7c Qh]
Kukuryzka: folds 
gabi_igna: raises $4 to $6
nickreason17: folds 
mooose100: calls $6
matiko09: folds 
Xagua: folds 
IseeUcards: folds 
TonnaMunz: folds 
*** FLOP *** [4d 8d Kd]
gabi_igna: bets $8
mooose100: calls $8
*** TURN *** [4d 8d Kd] [2s]
gabi_igna: checks 
mooose100: bets $14.72
gabi_igna: folds 
Uncalled bet ($14.72) returned to mooose100
mooose100 collected $29.45 from pot
mooose100: doesn't show hand 
*** SUMMARY ***
Total pot $31 | Rake $1.55 
Board [4d 8d Kd 2s]
Seat 1: Kukuryzka folded before Flop (didn't bet)
Seat 2: gabi_igna folded on the Turn
Seat 3: nickreason17 folded before Flop (didn't bet)
Seat 4: mooose100 collected ($29.45)
Seat 5: matiko09 folded before Flop (didn't bet)
Seat 6: Xagua (button) folded before Flop (didn't bet)
Seat 7: IseeUcards (small blind) folded before Flop
Seat 8: TonnaMunz (big blind) folded before Flop





PokerStars Hand #152883688411:  Hold'em No Limit ($0.50/$1.00 USD) - 2016/05/05 15:27:12 CET [2016/05/05 9:27:12 ET]
Table 'Chimaera II' 9-max Seat #8 is the button
Seat 2: Spid1 ($100 in chips) 
Seat 3: matiko09 ($101.50 in chips) 
Seat 4: RiverJazz ($100 in chips) 
Seat 5: Butchers31 ($102.60 in chips) 
Seat 6: Painkiller72 ($110.62 in chips) 
Seat 7: Hypoaroused ($197.36 in chips) 
Seat 8: 2damnstr8 ($8.28 in chips) 
Seat 9: kamillo91 ($80.28 in chips) 
kamillo91: posts small blind $0.50
Spid1: posts big blind $1
*** HOLE CARDS ***
Dealt to matiko09 [7c 3d]
matiko09: folds 
RiverJazz: folds 
Butchers31: folds 
Painkiller72: folds 
Hypoaroused: raises $2.50 to $3.50
2damnstr8: folds 
kamillo91: folds 
Spid1: folds 
Uncalled bet ($2.50) returned to Hypoaroused
Hypoaroused collected $2.50 from pot
*** SUMMARY ***
Total pot $2.50 | Rake $0 
Seat 2: Spid1 (big blind) folded before Flop
Seat 3: matiko09 folded before Flop (didn't bet)
Seat 4: RiverJazz folded before Flop (didn't bet)
Seat 5: Butchers31 folded before Flop (didn't bet)
Seat 6: Painkiller72 folded before Flop (didn't bet)
Seat 7: Hypoaroused collected ($2.50)
Seat 8: 2damnstr8 (button) folded before Flop (didn't bet)
Seat 9: kamillo91 (small blind) folded before Flop





PokerStars Hand #152883692654:  Hold'em No Limit ($0.50/$1.00 USD) - 2016/05/05 15:27:19 CET [2016/05/05 9:27:19 ET]
Table 'Natascha' 9-max Seat #9 is the button
Seat 1: ronald3737 ($131.90 in chips) 
Seat 2: matiko09 ($139.75 in chips) 
Seat 5: Dickyxxx ($144.26 in chips) 
Seat 6: gabi_igna ($153.44 in chips) 
Seat 7: torkkdnm ($137.04 in chips) 
Seat 8: kamillo91 ($77.50 in chips) 
Seat 9: guoweiAA ($236.20 in chips) 
ronald3737: posts small blind $0.50
matiko09: posts big blind $1
bjonlyking: sits out 
maxxmeister: sits out 
*** HOLE CARDS ***
Dealt to matiko09 [4c 9h]
Dickyxxx: folds 
gabi_igna: folds 
torkkdnm: folds 
kamillo91: folds 
guoweiAA: folds 
ronald3737: raises $1 to $2
matiko09: folds 
Uncalled bet ($1) returned to ronald3737
ronald3737 collected $2 from pot
ronald3737: doesn't show hand 
*** SUMMARY ***
Total pot $2 | Rake $0 
Seat 1: ronald3737 (small blind) collected ($2)
Seat 2: matiko09 (big blind) folded before Flop
Seat 5: Dickyxxx folded before Flop (didn't bet)
Seat 6: gabi_igna folded before Flop (didn't bet)
Seat 7: torkkdnm folded before Flop (didn't bet)
Seat 8: kamillo91 folded before Flop (didn't bet)
Seat 9: guoweiAA (button) folded before Flop (didn't bet)





PokerStars Hand #152883694063:  Hold'em No Limit ($0.50/$1.00 USD) - 2016/05/05 15:27:22 CET [2016/05/05 9:27:22 ET]
Table 'Belisana' 9-max Seat #5 is the button
Seat 1: djammusic ($130.84 in chips) 
Seat 2: ipashutapkom ($214.93 in chips) 
Seat 3: Dickyxxx ($100 in chips) 
Seat 4: Kukuryzka ($100 in chips) 
Seat 5: nickreason17 ($107.38 in chips) 
Seat 6: ihami ($39 in chips) 
Seat 7: matiko09 ($113.82 in chips) 
Seat 8: Spid1 ($137.26 in chips) 
Seat 9: michelle070 ($32.62 in chips) 
ihami: posts small blind $0.50
matiko09: posts big blind $1
*** HOLE CARDS ***
Dealt to matiko09 [4d 3h]
Spid1: folds 
michelle070: raises $1 to $2
djammusic: folds 
ipashutapkom: folds 
Dickyxxx: folds 
Kukuryzka: folds 
nickreason17: folds 
ihami: folds 
matiko09: folds 
Uncalled bet ($1) returned to michelle070
michelle070 collected $2.50 from pot
michelle070: doesn't show hand 
*** SUMMARY ***
Total pot $2.50 | Rake $0 
Seat 1: djammusic folded before Flop (didn't bet)
Seat 2: ipashutapkom folded before Flop (didn't bet)
Seat 3: Dickyxxx folded before Flop (didn't bet)
Seat 4: Kukuryzka folded before Flop (didn't bet)
Seat 5: nickreason17 (button) folded before Flop (didn't bet)
Seat 6: ihami (small blind) folded before Flop
Seat 7: matiko09 (big blind) folded before Flop
Seat 8: Spid1 folded before Flop (didn't bet)
Seat 9: michelle070 collected ($2.50)





PokerStars Hand #152883696692:  Hold'em No Limit ($0.50/$1.00 USD) - 2016/05/05 15:27:27 CET [2016/05/05 9:27:27 ET]
Table 'Kacivelia II' 9-max Seat #3 is the button
Seat 1: Spid1 ($100 in chips) 
Seat 2: thecurv ($110.88 in chips) 
Seat 3: 50CandyJoe ($100 in chips) 
Seat 4: matiko09 ($100 in chips) 
Seat 5: Painkiller72 ($122.22 in chips) 
Seat 6: kop7777 ($86.02 in chips) 
Seat 7: KovIFish89 ($100 in chips) 
Seat 8: sanpidk ($101.50 in chips) 
Seat 9: ipashutapkom ($98.50 in chips) 
matiko09: posts small blind $0.50
Painkiller72: posts big blind $1
*** HOLE CARDS ***
Dealt to matiko09 [Ts 5h]
kop7777: folds 
KovIFish89: folds 
sanpidk: folds 
ipashutapkom: folds 
Spid1: folds 
thecurv: folds 
50CandyJoe: raises $1 to $2
matiko09: folds 
Painkiller72: folds 
Uncalled bet ($1) returned to 50CandyJoe
50CandyJoe collected $2.50 from pot
50CandyJoe: doesn't show hand 
*** SUMMARY ***
Total pot $2.50 | Rake $0 
Seat 1: Spid1 folded before Flop (didn't bet)
Seat 2: thecurv folded before Flop (didn't bet)
Seat 3: 50CandyJoe (button) collected ($2.50)
Seat 4: matiko09 (small blind) folded before Flop
Seat 5: Painkiller72 (big blind) folded before Flop
Seat 6: kop7777 folded before Flop (didn't bet)
Seat 7: KovIFish89 folded before Flop (didn't bet)
Seat 8: sanpidk folded before Flop (didn't bet)
Seat 9: ipashutapkom folded before Flop (didn't bet)





PokerStars Hand #152883698622:  Hold'em No Limit ($1/$2 USD) - 2016/05/05 15:27:30 CET [2016/05/05 9:27:30 ET]
Table 'Samitchell' 9-max Seat #3 is the button
Seat 1: T0ny Adams ($82.42 in chips) 
Seat 3: gabi_igna ($370.32 in chips) 
Seat 4: Fitzyferret ($388.97 in chips) 
Seat 5: Spid1 ($202.45 in chips) 
Seat 6: matiko09 ($217.90 in chips) 
Seat 7: patpaty ($157.30 in chips) 
Seat 8: kblkxls ($101.97 in chips) 
Seat 9: IseeUcards ($260.63 in chips) 
Fitzyferret: posts small blind $1
Spid1: posts big blind $2
13Ghosts: sits out 
*** HOLE CARDS ***
Dealt to matiko09 [5s 4c]
matiko09: folds 
patpaty: folds 
kblkxls: folds 
IseeUcards: folds 
T0ny Adams: folds 
gabi_igna: raises $3 to $5
Fitzyferret: folds 
Spid1: calls $3
*** FLOP *** [3s 6d 7d]
Spid1: checks 
gabi_igna: bets $6
Spid1: folds 
Uncalled bet ($6) returned to gabi_igna
gabi_igna collected $10.45 from pot
gabi_igna: doesn't show hand 
*** SUMMARY ***
Total pot $11 | Rake $0.55 
Board [3s 6d 7d]
Seat 1: T0ny Adams folded before Flop (didn't bet)
Seat 3: gabi_igna (button) collected ($10.45)
Seat 4: Fitzyferret (small blind) folded before Flop
Seat 5: Spid1 (big blind) folded on the Flop
Seat 6: matiko09 folded before Flop (didn't bet)
Seat 7: patpaty folded before Flop (didn't bet)
Seat 8: kblkxls folded before Flop (didn't bet)
Seat 9: IseeUcards folded before Flop (didn't bet)





PokerStars Hand #152883702100:  Hold'em No Limit ($0.50/$1.00 USD) - 2016/05/05 15:27:36 CET [2016/05/05 9:27:36 ET]
Table 'Pyxis III' 9-max Seat #1 is the button
Seat 1: sanpidk ($113.95 in chips) 
Seat 2: 50CandyJoe ($100 in chips) 
Seat 3: Xxth3nutzxX ($89 in chips) 
Seat 4: Sloeve ($120.85 in chips) 
Seat 5: darren1031 ($88.18 in chips) 
Seat 6: kamillo91 ($44 in chips) 
Seat 7: nickreason17 ($100 in chips) 
Seat 8: matiko09 ($100 in chips) 
Seat 9: Hypoaroused ($95.38 in chips) 
50CandyJoe: posts small blind $0.50
Xxth3nutzxX: posts big blind $1
*** HOLE CARDS ***
Dealt to matiko09 [5d 6h]
Sloeve: folds 
darren1031: folds 
kamillo91: folds 
nickreason17: folds 
matiko09: folds 
Hypoaroused: folds 
sanpidk: raises $1.24 to $2.24
50CandyJoe: folds 
Xxth3nutzxX: folds 
Uncalled bet ($1.24) returned to sanpidk
sanpidk collected $2.50 from pot
sanpidk: doesn't show hand 
*** SUMMARY ***
Total pot $2.50 | Rake $0 
Seat 1: sanpidk (button) collected ($2.50)
Seat 2: 50CandyJoe (small blind) folded before Flop
Seat 3: Xxth3nutzxX (big blind) folded before Flop
Seat 4: Sloeve folded before Flop (didn't bet)
Seat 5: darren1031 folded before Flop (didn't bet)
Seat 6: kamillo91 folded before Flop (didn't bet)
Seat 7: nickreason17 folded before Flop (didn't bet)
Seat 8: matiko09 folded before Flop (didn't bet)
Seat 9: Hypoaroused folded before Flop (didn't bet)





PokerStars Hand #152883702447:  Hold'em No Limit ($0.50/$1.00 USD) - 2016/05/05 15:27:37 CET [2016/05/05 9:27:37 ET]
Table 'Priska II' 9-max Seat #5 is the button
Seat 1: Spid1 ($100 in chips) 
Seat 2: Kukuryzka ($100 in chips) 
Seat 3: matiko09 ($100 in chips) 
Seat 4: Painkiller72 ($160.77 in chips) 
Seat 5: nickreason17 ($126.50 in chips) 
Seat 6: OneTwo81 ($99 in chips) 
Seat 7: stockbridge8 ($102.07 in chips) 
Seat 8: pohorc21 ($81.35 in chips) 
Seat 9: torkkdnm ($101.55 in chips) 
OneTwo81: posts small blind $0.50
stockbridge8: posts big blind $1
*** HOLE CARDS ***
Dealt to matiko09 [Qd 7c]
pohorc21: calls $1
torkkdnm: folds 
Spid1: folds 
Kukuryzka: folds 
matiko09: folds 
Painkiller72: folds 
nickreason17: folds 
OneTwo81: calls $0.50
stockbridge8: checks 
*** FLOP *** [Qc 2s 2d]
OneTwo81: checks 
stockbridge8: checks 
pohorc21: checks 
*** TURN *** [Qc 2s 2d] [6c]
OneTwo81: bets $2
stockbridge8: raises $2 to $4
pohorc21: folds 
OneTwo81: calls $2
*** RIVER *** [Qc 2s 2d 6c] [9c]
OneTwo81: bets $10
stockbridge8: folds 
Uncalled bet ($10) returned to OneTwo81
OneTwo81 collected $10.45 from pot
OneTwo81: doesn't show hand 
*** SUMMARY ***
Total pot $11 | Rake $0.55 
Board [Qc 2s 2d 6c 9c]
Seat 1: Spid1 folded before Flop (didn't bet)
Seat 2: Kukuryzka folded before Flop (didn't bet)
Seat 3: matiko09 folded before Flop (didn't bet)
Seat 4: Painkiller72 folded before Flop (didn't bet)
Seat 5: nickreason17 (button) folded before Flop (didn't bet)
Seat 6: OneTwo81 (small blind) collected ($10.45)
Seat 7: stockbridge8 (big blind) folded on the River
Seat 8: pohorc21 folded on the Turn
Seat 9: torkkdnm folded before Flop (didn't bet)





PokerStars Hand #152883702822:  Hold'em No Limit ($0.50/$1.00 USD) - 2016/05/05 15:27:37 CET [2016/05/05 9:27:37 ET]
Table 'Lictoria II' 9-max Seat #6 is the button
Seat 1: St.LaCoste ($106 in chips) 
Seat 2: Dantist1122 ($125.46 in chips) 
Seat 3: Krinica2009 ($100 in chips) 
Seat 4: Ying59 ($39.90 in chips) 
Seat 5: sanpidk ($107.25 in chips) 
Seat 6: gabi_igna ($116.22 in chips) 
Seat 7: Painkiller72 ($202.30 in chips) 
Seat 8: matiko09 ($100 in chips) 
Seat 9: Kukuryzka ($129.37 in chips) 
Painkiller72: posts small blind $0.50
matiko09: posts big blind $1
*** HOLE CARDS ***
Dealt to matiko09 [2s Ad]
Kukuryzka: folds 
St.LaCoste: folds 
Dantist1122: folds 
Krinica2009: raises $2 to $3
Ying59: folds 
sanpidk: folds 
gabi_igna: folds 
Painkiller72: folds 
matiko09: folds 
Uncalled bet ($2) returned to Krinica2009
Krinica2009 collected $2.50 from pot
Krinica2009: doesn't show hand 
*** SUMMARY ***
Total pot $2.50 | Rake $0 
Seat 1: St.LaCoste folded before Flop (didn't bet)
Seat 2: Dantist1122 folded before Flop (didn't bet)
Seat 3: Krinica2009 collected ($2.50)
Seat 4: Ying59 folded before Flop (didn't bet)
Seat 5: sanpidk folded before Flop (didn't bet)
Seat 6: gabi_igna (button) folded before Flop (didn't bet)
Seat 7: Painkiller72 (small blind) folded before Flop
Seat 8: matiko09 (big blind) folded before Flop
Seat 9: Kukuryzka folded before Flop (didn't bet)





PokerStars Hand #152883702893:  Hold'em No Limit ($1/$2 USD) - 2016/05/05 15:27:38 CET [2016/05/05 9:27:38 ET]
Table 'Lundia' 9-max Seat #2 is the button
Seat 1: Fitzyferret ($205 in chips) 
Seat 2: patpaty ($165.60 in chips) 
Seat 3: IseeUcards ($414.77 in chips) 
Seat 6: Spid1 ($244.50 in chips) 
Seat 7: matiko09 ($203 in chips) 
Seat 8: Durnichka ($77 in chips) 
Seat 9: gabi_igna ($229.86 in chips) 
IseeUcards: posts small blind $1
nickreason17: is sitting out 
Spid1: posts big blind $2
*** HOLE CARDS ***
Dealt to matiko09 [As Th]
nickreason17 leaves the table
matiko09: folds 
Durnichka: folds 
gabi_igna: folds 
Iggso joins the table at seat #4 
Fitzyferret: folds 
patpaty: folds 
Iggso leaves the table
IseeUcards: raises $4 to $6
Spid1: folds 
Uncalled bet ($4) returned to IseeUcards
IseeUcards collected $4 from pot
IseeUcards: doesn't show hand 
*** SUMMARY ***
Total pot $4 | Rake $0 
Seat 1: Fitzyferret folded before Flop (didn't bet)
Seat 2: patpaty (button) folded before Flop (didn't bet)
Seat 3: IseeUcards (small blind) collected ($4)
Seat 6: Spid1 (big blind) folded before Flop
Seat 7: matiko09 folded before Flop (didn't bet)
Seat 8: Durnichka folded before Flop (didn't bet)
Seat 9: gabi_igna folded before Flop (didn't bet)





PokerStars Hand #152883704794:  Hold'em No Limit ($0.50/$1.00 USD) - 2016/05/05 15:27:41 CET [2016/05/05 9:27:41 ET]
Table 'Belisana' 9-max Seat #6 is the button
Seat 1: djammusic ($130.84 in chips) 
Seat 2: ipashutapkom ($214.93 in chips) 
Seat 3: Dickyxxx ($100 in chips) 
Seat 4: Kukuryzka ($100 in chips) 
Seat 5: nickreason17 ($107.38 in chips) 
Seat 6: ihami ($38.50 in chips) 
Seat 7: matiko09 ($112.82 in chips) 
Seat 8: Spid1 ($137.26 in chips) 
Seat 9: michelle070 ($34.12 in chips) 
matiko09: posts small blind $0.50
Spid1: posts big blind $1
*** HOLE CARDS ***
Dealt to matiko09 [3h Js]
michelle070: raises $1 to $2
djammusic: folds 
ipashutapkom: folds 
Dickyxxx: folds 
Kukuryzka: raises $6 to $8
nickreason17: folds 
ihami: folds 
matiko09: folds 
Spid1: folds 
michelle070: calls $6
*** FLOP *** [Jh 5c 5s]
michelle070: checks 
Kukuryzka: checks 
*** TURN *** [Jh 5c 5s] [2d]
michelle070: checks 
Kukuryzka: checks 
*** RIVER *** [Jh 5c 5s 2d] [3s]
michelle070: checks 
Kukuryzka: checks 
*** SHOW DOWN ***
michelle070: shows [Qs Ks] (a pair of Fives)
Kukuryzka: shows [Tc Ac] (a pair of Fives - Ace kicker)
Kukuryzka collected $16.62 from pot
*** SUMMARY ***
Total pot $17.50 | Rake $0.88 
Board [Jh 5c 5s 2d 3s]
Seat 1: djammusic folded before Flop (didn't bet)
Seat 2: ipashutapkom folded before Flop (didn't bet)
Seat 3: Dickyxxx folded before Flop (didn't bet)
Seat 4: Kukuryzka showed [Tc Ac] and won ($16.62) with a pair of Fives
Seat 5: nickreason17 folded before Flop (didn't bet)
Seat 6: ihami (button) folded before Flop (didn't bet)
Seat 7: matiko09 (small blind) folded before Flop
Seat 8: Spid1 (big blind) folded before Flop
Seat 9: michelle070 showed [Qs Ks] and lost with a pair of Fives





PokerStars Hand #152883715061:  Hold'em No Limit ($0.50/$1.00 USD) - 2016/05/05 15:27:59 CET [2016/05/05 9:27:59 ET]
Table 'Pyxis III' 9-max Seat #2 is the button
Seat 1: sanpidk ($115.45 in chips) 
Seat 2: 50CandyJoe ($100 in chips) 
Seat 3: Xxth3nutzxX ($100 in chips) 
Seat 4: Sloeve ($120.85 in chips) 
Seat 5: darren1031 ($88.18 in chips) 
Seat 6: kamillo91 ($44 in chips) 
Seat 7: nickreason17 ($100 in chips) 
Seat 8: matiko09 ($100 in chips) 
Seat 9: Hypoaroused ($95.38 in chips) 
Xxth3nutzxX: posts small blind $0.50
Sloeve: posts big blind $1
*** HOLE CARDS ***
Dealt to matiko09 [Jc Th]
darren1031: folds 
kamillo91: folds 
nickreason17: folds 
matiko09: folds 
Hypoaroused: folds 
sanpidk: raises $1.50 to $2.50
50CandyJoe: folds 
Xxth3nutzxX: folds 
Sloeve: folds 
Uncalled bet ($1.50) returned to sanpidk
sanpidk collected $2.50 from pot
sanpidk: doesn't show hand 
*** SUMMARY ***
Total pot $2.50 | Rake $0 
Seat 1: sanpidk collected ($2.50)
Seat 2: 50CandyJoe (button) folded before Flop (didn't bet)
Seat 3: Xxth3nutzxX (small blind) folded before Flop
Seat 4: Sloeve (big blind) folded before Flop
Seat 5: darren1031 folded before Flop (didn't bet)
Seat 6: kamillo91 folded before Flop (didn't bet)
Seat 7: nickreason17 folded before Flop (didn't bet)
Seat 8: matiko09 folded before Flop (didn't bet)
Seat 9: Hypoaroused folded before Flop (didn't bet)





PokerStars Hand #152883714944:  Hold'em No Limit ($0.50/$1.00 USD) - 2016/05/05 15:27:59 CET [2016/05/05 9:27:59 ET]
Table 'Chimaera II' 9-max Seat #9 is the button
Seat 2: Spid1 ($100 in chips) 
Seat 3: matiko09 ($101.50 in chips) 
Seat 4: RiverJazz ($100 in chips) 
Seat 5: Butchers31 ($102.60 in chips) 
Seat 6: Painkiller72 ($110.62 in chips) 
Seat 7: Hypoaroused ($198.86 in chips) 
Seat 8: 2damnstr8 ($8.28 in chips) 
Seat 9: kamillo91 ($79.78 in chips) 
Spid1: posts small blind $0.50
matiko09: posts big blind $1
*** HOLE CARDS ***
Dealt to matiko09 [7h Tc]
RiverJazz: folds 
Butchers31 has timed out
Butchers31: folds 
Painkiller72: folds 
Hypoaroused: folds 
2damnstr8: raises $7.28 to $8.28 and is all-in
kamillo91: folds 
Spid1: folds 
matiko09: folds 
Uncalled bet ($7.28) returned to 2damnstr8
2damnstr8 collected $2.50 from pot
2damnstr8: doesn't show hand 
*** SUMMARY ***
Total pot $2.50 | Rake $0 
Seat 2: Spid1 (small blind) folded before Flop
Seat 3: matiko09 (big blind) folded before Flop
Seat 4: RiverJazz folded before Flop (didn't bet)
Seat 5: Butchers31 folded before Flop (didn't bet)
Seat 6: Painkiller72 folded before Flop (didn't bet)
Seat 7: Hypoaroused folded before Flop (didn't bet)
Seat 8: 2damnstr8 collected ($2.50)
Seat 9: kamillo91 (button) folded before Flop (didn't bet)





PokerStars Hand #152883715976:  Hold'em No Limit ($0.50/$1.00 USD) - 2016/05/05 15:28:01 CET [2016/05/05 9:28:01 ET]
Table 'Natascha' 9-max Seat #1 is the button
Seat 1: ronald3737 ($132.90 in chips) 
Seat 2: matiko09 ($138.75 in chips) 
Seat 3: bjonlyking ($100 in chips) 
Seat 5: Dickyxxx ($144.26 in chips) 
Seat 6: gabi_igna ($153.44 in chips) 
Seat 7: torkkdnm ($137.04 in chips) 
Seat 8: kamillo91 ($77.50 in chips) 
Seat 9: guoweiAA ($236.20 in chips) 
matiko09: posts small blind $0.50
bjonlyking is disconnected 
bjonlyking is connected 
bjonlyking: posts big blind $1
maxxmeister: sits out 
*** HOLE CARDS ***
Dealt to matiko09 [8c Jh]
Dickyxxx: raises $2 to $3
gabi_igna: folds 
maxxmeister leaves the table
St.LaCoste joins the table at seat #4 
torkkdnm: raises $7 to $10
kamillo91: folds 
guoweiAA: folds 
ronald3737: folds 
matiko09: folds 
bjonlyking: folds 
Dickyxxx: calls $7
*** FLOP *** [4h 6h Ac]
Dickyxxx: checks 
torkkdnm: bets $13
Dickyxxx: folds 
Uncalled bet ($13) returned to torkkdnm
torkkdnm collected $20.42 from pot
*** SUMMARY ***
Total pot $21.50 | Rake $1.08 
Board [4h 6h Ac]
Seat 1: ronald3737 (button) folded before Flop (didn't bet)
Seat 2: matiko09 (small blind) folded before Flop
Seat 3: bjonlyking (big blind) folded before Flop
Seat 5: Dickyxxx folded on the Flop
Seat 6: gabi_igna folded before Flop (didn't bet)
Seat 7: torkkdnm collected ($20.42)
Seat 8: kamillo91 folded before Flop (didn't bet)
Seat 9: guoweiAA folded before Flop (didn't bet)





PokerStars Hand #152883716689:  Hold'em No Limit ($1/$2 USD) - 2016/05/05 15:28:02 CET [2016/05/05 9:28:02 ET]
Table 'Lundia' 9-max Seat #3 is the button
Seat 1: Fitzyferret ($205 in chips) 
Seat 2: patpaty ($165.60 in chips) 
Seat 3: IseeUcards ($416.77 in chips) 
Seat 6: Spid1 ($242.50 in chips) 
Seat 7: matiko09 ($203 in chips) 
Seat 8: Durnichka ($77 in chips) 
Seat 9: gabi_igna ($229.86 in chips) 
Spid1: posts small blind $1
matiko09: posts big blind $2
*** HOLE CARDS ***
Dealt to matiko09 [Qd Qh]
Durnichka: folds 
gabi_igna: folds 
Fitzyferret: folds 
patpaty: folds 
IseeUcards: folds 
KovIFish89 joins the table at seat #4 
Spid1: raises $3 to $5
matiko09: raises $11 to $16
Spid1: folds 
Uncalled bet ($11) returned to matiko09
matiko09 collected $10 from pot
matiko09: doesn't show hand 
*** SUMMARY ***
Total pot $10 | Rake $0 
Seat 1: Fitzyferret folded before Flop (didn't bet)
Seat 2: patpaty folded before Flop (didn't bet)
Seat 3: IseeUcards (button) folded before Flop (didn't bet)
Seat 6: Spid1 (small blind) folded before Flop
Seat 7: matiko09 (big blind) collected ($10)
Seat 8: Durnichka folded before Flop (didn't bet)
Seat 9: gabi_igna folded before Flop (didn't bet)





PokerStars Hand #152883716574:  Hold'em No Limit ($0.50/$1.00 USD) - 2016/05/05 15:28:02 CET [2016/05/05 9:28:02 ET]
Table 'Lictoria II' 9-max Seat #7 is the button
Seat 1: St.LaCoste ($106 in chips) 
Seat 2: Dantist1122 ($125.46 in chips) 
Seat 3: Krinica2009 ($101.50 in chips) 
Seat 4: Ying59 ($39.90 in chips) 
Seat 5: sanpidk ($107.25 in chips) 
Seat 6: gabi_igna ($116.22 in chips) 
Seat 7: Painkiller72 ($201.80 in chips) 
Seat 8: matiko09 ($100 in chips) 
Seat 9: Kukuryzka ($129.37 in chips) 
matiko09: posts small blind $0.50
Kukuryzka: posts big blind $1
*** HOLE CARDS ***
Dealt to matiko09 [4s 2d]
St.LaCoste: folds 
Dantist1122: folds 
Krinica2009: folds 
Ying59: folds 
sanpidk: folds 
gabi_igna: folds 
Painkiller72: folds 
matiko09: folds 
Uncalled bet ($0.50) returned to Kukuryzka
Kukuryzka collected $1 from pot
Kukuryzka: doesn't show hand 
*** SUMMARY ***
Total pot $1 | Rake $0 
Seat 1: St.LaCoste folded before Flop (didn't bet)
Seat 2: Dantist1122 folded before Flop (didn't bet)
Seat 3: Krinica2009 folded before Flop (didn't bet)
Seat 4: Ying59 folded before Flop (didn't bet)
Seat 5: sanpidk folded before Flop (didn't bet)
Seat 6: gabi_igna folded before Flop (didn't bet)
Seat 7: Painkiller72 (button) folded before Flop (didn't bet)
Seat 8: matiko09 (small blind) folded before Flop
Seat 9: Kukuryzka (big blind) collected ($1)





PokerStars Hand #152883717783:  Hold'em No Limit ($1/$2 USD) - 2016/05/05 15:28:04 CET [2016/05/05 9:28:04 ET]
Table 'Tololo' 9-max Seat #7 is the button
Seat 1: Kukuryzka ($200 in chips) 
Seat 2: gabi_igna ($297.99 in chips) 
Seat 3: nickreason17 ($225.40 in chips) 
Seat 4: mooose100 ($353.78 in chips) 
Seat 5: matiko09 ($200 in chips) 
Seat 6: Xagua ($132.12 in chips) 
Seat 7: IseeUcards ($201.61 in chips) 
Seat 8: TonnaMunz ($214.66 in chips) 
Seat 9: Fitzyferret ($229.46 in chips) 
TonnaMunz: posts small blind $1
Fitzyferret: posts big blind $2
*** HOLE CARDS ***
Dealt to matiko09 [As 2h]
Kukuryzka: folds 
gabi_igna: folds 
nickreason17: folds 
mooose100: calls $2
matiko09: folds 
Xagua: folds 
IseeUcards: folds 
TonnaMunz: folds 
Fitzyferret: checks 
*** FLOP *** [8h Js Ks]
Fitzyferret: checks 
mooose100: bets $4.75
Fitzyferret: calls $4.75
*** TURN *** [8h Js Ks] [5d]
Fitzyferret: checks 
mooose100: checks 
*** RIVER *** [8h Js Ks 5d] [8s]
Fitzyferret: bets $12
mooose100: folds 
Uncalled bet ($12) returned to Fitzyferret
Fitzyferret collected $13.78 from pot
Fitzyferret: doesn't show hand 
*** SUMMARY ***
Total pot $14.50 | Rake $0.72 
Board [8h Js Ks 5d 8s]
Seat 1: Kukuryzka folded before Flop (didn't bet)
Seat 2: gabi_igna folded before Flop (didn't bet)
Seat 3: nickreason17 folded before Flop (didn't bet)
Seat 4: mooose100 folded on the River
Seat 5: matiko09 folded before Flop (didn't bet)
Seat 6: Xagua folded before Flop (didn't bet)
Seat 7: IseeUcards (button) folded before Flop (didn't bet)
Seat 8: TonnaMunz (small blind) folded before Flop
Seat 9: Fitzyferret (big blind) collected ($13.78)





PokerStars Hand #152883722761:  Hold'em No Limit ($1/$2 USD) - 2016/05/05 15:28:13 CET [2016/05/05 9:28:13 ET]
Table 'Samitchell' 9-max Seat #4 is the button
Seat 1: T0ny Adams ($82.42 in chips) 
Seat 3: gabi_igna ($375.77 in chips) 
Seat 4: Fitzyferret ($387.97 in chips) 
Seat 5: Spid1 ($200 in chips) 
Seat 6: matiko09 ($217.90 in chips) 
Seat 7: patpaty ($157.30 in chips) 
Seat 8: kblkxls ($101.97 in chips) 
Seat 9: IseeUcards ($260.63 in chips) 
Spid1: posts small blind $1
matiko09: posts big blind $2
13Ghosts: sits out 
*** HOLE CARDS ***
Dealt to matiko09 [Jh 4c]
patpaty: folds 
kblkxls: folds 
IseeUcards: folds 
T0ny Adams: folds 
gabi_igna: folds 
Fitzyferret: raises $2.60 to $4.60
Spid1: folds 
matiko09: folds 
Uncalled bet ($2.60) returned to Fitzyferret
Fitzyferret collected $5 from pot
Fitzyferret: doesn't show hand 
*** SUMMARY ***
Total pot $5 | Rake $0 
Seat 1: T0ny Adams folded before Flop (didn't bet)
Seat 3: gabi_igna folded before Flop (didn't bet)
Seat 4: Fitzyferret (button) collected ($5)
Seat 5: Spid1 (small blind) folded before Flop
Seat 6: matiko09 (big blind) folded before Flop
Seat 7: patpaty folded before Flop (didn't bet)
Seat 8: kblkxls folded before Flop (didn't bet)
Seat 9: IseeUcards folded before Flop (didn't bet)





PokerStars Hand #152883729933:  Hold'em No Limit (€1/€2 EUR) - 2016/05/05 15:28:26 CET [2016/05/05 9:28:26 ET]
Table 'Bessel II' 9-max Seat #6 is the button
Seat 1: Soloaces224 (€158.67 in chips) 
Seat 2: Fitzyferret (€289.70 in chips) 
Seat 3: IseeUcards (€564.93 in chips) 
Seat 5: Painkiller72 (€274.50 in chips) 
Seat 6: Spid1 (€200 in chips) 
Seat 7: matiko09 (€201 in chips) 
Seat 8: KovIFish89 (€200 in chips) 
matiko09: posts small blind €1
KovIFish89: posts big blind €2
Ravnica11: sits out 
*** HOLE CARDS ***
Dealt to matiko09 [3h Ad]
93robin93 leaves the table
Soloaces224: folds 
Fitzyferret: raises €3.24 to €5.24
IseeUcards: folds 
Painkiller72: folds 
Ravnica11 leaves the table
Spid1: folds 
nickreason17 joins the table at seat #9 
nickreason17 leaves the table
matiko09: folds 
KovIFish89: folds 
Uncalled bet (€3.24) returned to Fitzyferret
Fitzyferret collected €5 from pot
Fitzyferret: doesn't show hand 
*** SUMMARY ***
Total pot €5 | Rake €0 
Seat 1: Soloaces224 folded before Flop (didn't bet)
Seat 2: Fitzyferret collected (€5)
Seat 3: IseeUcards folded before Flop (didn't bet)
Seat 5: Painkiller72 folded before Flop (didn't bet)
Seat 6: Spid1 (button) folded before Flop (didn't bet)
Seat 7: matiko09 (small blind) folded before Flop
Seat 8: KovIFish89 (big blind) folded before Flop





PokerStars Hand #152883731815:  Hold'em No Limit ($0.50/$1.00 USD) - 2016/05/05 15:28:29 CET [2016/05/05 9:28:29 ET]
Table 'Belisana' 9-max Seat #7 is the button
Seat 1: djammusic ($130.84 in chips) 
Seat 2: ipashutapkom ($214.93 in chips) 
Seat 3: Dickyxxx ($100 in chips) 
Seat 4: Kukuryzka ($108.62 in chips) 
Seat 5: nickreason17 ($107.38 in chips) 
Seat 6: ihami ($38.50 in chips) 
Seat 7: matiko09 ($112.32 in chips) 
Seat 8: Spid1 ($136.26 in chips) 
Seat 9: michelle070 ($26.12 in chips) 
Spid1: posts small blind $0.50
michelle070: posts big blind $1
*** HOLE CARDS ***
Dealt to matiko09 [2c Jd]
djammusic: folds 
ipashutapkom: folds 
Dickyxxx: folds 
Kukuryzka: folds 
nickreason17: folds 
ihami: folds 
matiko09: folds 
Spid1: folds 
Uncalled bet ($0.50) returned to michelle070
michelle070 collected $1 from pot
michelle070: doesn't show hand 
*** SUMMARY ***
Total pot $1 | Rake $0 
Seat 1: djammusic folded before Flop (didn't bet)
Seat 2: ipashutapkom folded before Flop (didn't bet)
Seat 3: Dickyxxx folded before Flop (didn't bet)
Seat 4: Kukuryzka folded before Flop (didn't bet)
Seat 5: nickreason17 folded before Flop (didn't bet)
Seat 6: ihami folded before Flop (didn't bet)
Seat 7: matiko09 (button) folded before Flop (didn't bet)
Seat 8: Spid1 (small blind) folded before Flop
Seat 9: michelle070 (big blind) collected ($1)





PokerStars Hand #152883731858:  Hold'em No Limit ($1/$2 USD) - 2016/05/05 15:28:29 CET [2016/05/05 9:28:29 ET]
Table 'Lundia' 9-max Seat #6 is the button
Seat 1: Fitzyferret ($205 in chips) 
Seat 2: patpaty ($165.60 in chips) 
Seat 3: IseeUcards ($416.77 in chips) 
Seat 6: Spid1 ($237.50 in chips) 
Seat 7: matiko09 ($208 in chips) 
Seat 8: Durnichka ($77 in chips) 
Seat 9: gabi_igna ($229.86 in chips) 
matiko09: posts small blind $1
Durnichka: posts big blind $2
KovIFish89: sits out 
*** HOLE CARDS ***
Dealt to matiko09 [Jh Js]
gabi_igna: folds 
Fitzyferret: raises $3.24 to $5.24
patpaty: folds 
IseeUcards: folds 
Spid1: raises $12.76 to $18
matiko09: folds 
Durnichka: folds 
Fitzyferret: folds 
Uncalled bet ($12.76) returned to Spid1
Spid1 collected $13.48 from pot
Spid1: doesn't show hand 
*** SUMMARY ***
Total pot $13.48 | Rake $0 
Seat 1: Fitzyferret folded before Flop
Seat 2: patpaty folded before Flop (didn't bet)
Seat 3: IseeUcards folded before Flop (didn't bet)
Seat 6: Spid1 (button) collected ($13.48)
Seat 7: matiko09 (small blind) folded before Flop
Seat 8: Durnichka (big blind) folded before Flop
Seat 9: gabi_igna folded before Flop (didn't bet)





PokerStars Hand #152883732317:  Hold'em No Limit ($0.50/$1.00 USD) - 2016/05/05 15:28:30 CET [2016/05/05 9:28:30 ET]
Table 'Lictoria II' 9-max Seat #8 is the button
Seat 1: St.LaCoste ($106 in chips) 
Seat 2: Dantist1122 ($125.46 in chips) 
Seat 3: Krinica2009 ($101.50 in chips) 
Seat 4: Ying59 ($39.90 in chips) 
Seat 5: sanpidk ($107.25 in chips) 
Seat 6: gabi_igna ($116.22 in chips) 
Seat 7: Painkiller72 ($201.80 in chips) 
Seat 8: matiko09 ($100 in chips) 
Seat 9: Kukuryzka ($129.87 in chips) 
Kukuryzka: posts small blind $0.50
St.LaCoste: posts big blind $1
*** HOLE CARDS ***
Dealt to matiko09 [8c 2s]
Dantist1122: folds 
Krinica2009: folds 
Ying59: raises $1 to $2
sanpidk: folds 
gabi_igna: folds 
Painkiller72: folds 
matiko09: folds 
Kukuryzka: raises $5 to $7
St.LaCoste: folds 
Ying59: calls $5
*** FLOP *** [Kh Qh Ts]
Kukuryzka: checks 
Ying59: checks 
*** TURN *** [Kh Qh Ts] [Kc]
Kukuryzka: checks 
Ying59: checks 
*** RIVER *** [Kh Qh Ts Kc] [Ad]
Kukuryzka: checks 
Ying59: checks 
*** SHOW DOWN ***
Kukuryzka: shows [9h 9d] (two pair, Kings and Nines)
Ying59: shows [Ac 9s] (two pair, Aces and Kings)
Ying59 collected $14.25 from pot
*** SUMMARY ***
Total pot $15 | Rake $0.75 
Board [Kh Qh Ts Kc Ad]
Seat 1: St.LaCoste (big blind) folded before Flop
Seat 2: Dantist1122 folded before Flop (didn't bet)
Seat 3: Krinica2009 folded before Flop (didn't bet)
Seat 4: Ying59 showed [Ac 9s] and won ($14.25) with two pair, Aces and Kings
Seat 5: sanpidk folded before Flop (didn't bet)
Seat 6: gabi_igna folded before Flop (didn't bet)
Seat 7: Painkiller72 folded before Flop (didn't bet)
Seat 8: matiko09 (button) folded before Flop (didn't bet)
Seat 9: Kukuryzka (small blind) showed [9h 9d] and lost with two pair, Kings and Nines





PokerStars Hand #152883733004:  Hold'em No Limit ($0.50/$1.00 USD) - 2016/05/05 15:28:31 CET [2016/05/05 9:28:31 ET]
Table 'Pyxis III' 9-max Seat #3 is the button
Seat 1: sanpidk ($116.95 in chips) 
Seat 2: 50CandyJoe ($100 in chips) 
Seat 3: Xxth3nutzxX ($99.50 in chips) 
Seat 4: Sloeve ($119.85 in chips) 
Seat 5: darren1031 ($88.18 in chips) 
Seat 6: kamillo91 ($44 in chips) 
Seat 7: nickreason17 ($100 in chips) 
Seat 8: matiko09 ($100 in chips) 
Seat 9: Hypoaroused ($95.38 in chips) 
Sloeve: posts small blind $0.50
darren1031: posts big blind $1
*** HOLE CARDS ***
Dealt to matiko09 [Kc Jh]
kamillo91: folds 
nickreason17: folds 
matiko09: folds 
Hypoaroused: folds 
sanpidk: raises $1.50 to $2.50
50CandyJoe: folds 
Xxth3nutzxX: folds 
Sloeve: folds 
darren1031: calls $1.50
*** FLOP *** [Kd 6c 8s]
darren1031: checks 
sanpidk: bets $3.50
darren1031: calls $3.50
*** TURN *** [Kd 6c 8s] [3h]
darren1031: checks 
sanpidk: checks 
*** RIVER *** [Kd 6c 8s 3h] [3d]
darren1031: bets $8
sanpidk: calls $8
*** SHOW DOWN ***
darren1031: shows [Th Ad] (a pair of Threes)
sanpidk: shows [8c 7c] (two pair, Eights and Threes)
sanpidk collected $27.08 from pot
*** SUMMARY ***
Total pot $28.50 | Rake $1.42 
Board [Kd 6c 8s 3h 3d]
Seat 1: sanpidk showed [8c 7c] and won ($27.08) with two pair, Eights and Threes
Seat 2: 50CandyJoe folded before Flop (didn't bet)
Seat 3: Xxth3nutzxX (button) folded before Flop (didn't bet)
Seat 4: Sloeve (small blind) folded before Flop
Seat 5: darren1031 (big blind) showed [Th Ad] and lost with a pair of Threes
Seat 6: kamillo91 folded before Flop (didn't bet)
Seat 7: nickreason17 folded before Flop (didn't bet)
Seat 8: matiko09 folded before Flop (didn't bet)
Seat 9: Hypoaroused folded before Flop (didn't bet)





PokerStars Hand #152883736598:  Hold'em No Limit ($0.50/$1.00 USD) - 2016/05/05 15:28:38 CET [2016/05/05 9:28:38 ET]
Table 'Kacivelia II' 9-max Seat #4 is the button
Seat 1: Spid1 ($100 in chips) 
Seat 2: thecurv ($110.88 in chips) 
Seat 3: 50CandyJoe ($101.50 in chips) 
Seat 4: matiko09 ($100 in chips) 
Seat 5: Painkiller72 ($121.22 in chips) 
Seat 6: kop7777 ($86.02 in chips) 
Seat 7: KovIFish89 ($100 in chips) 
Seat 8: sanpidk ($101.50 in chips) 
Seat 9: ipashutapkom ($98.50 in chips) 
Painkiller72: posts small blind $0.50
kop7777: posts big blind $1
*** HOLE CARDS ***
Dealt to matiko09 [Js As]
KovIFish89: folds 
sanpidk: folds 
ipashutapkom: folds 
Spid1: raises $2 to $3
thecurv: folds 
50CandyJoe: folds 
matiko09: calls $3
Painkiller72: folds 
kop7777: calls $2
*** FLOP *** [Qs Qd Jh]
kop7777: checks 
Spid1: bets $6
matiko09: calls $6
kop7777: folds 
*** TURN *** [Qs Qd Jh] [Jc]
Spid1: checks 
matiko09: checks 
*** RIVER *** [Qs Qd Jh Jc] [3c]
Spid1: bets $14.50
matiko09: folds 
Uncalled bet ($14.50) returned to Spid1
Spid1 collected $20.42 from pot
Spid1: doesn't show hand 
*** SUMMARY ***
Total pot $21.50 | Rake $1.08 
Board [Qs Qd Jh Jc 3c]
Seat 1: Spid1 collected ($20.42)
Seat 2: thecurv folded before Flop (didn't bet)
Seat 3: 50CandyJoe folded before Flop (didn't bet)
Seat 4: matiko09 (button) folded on the River
Seat 5: Painkiller72 (small blind) folded before Flop
Seat 6: kop7777 (big blind) folded on the Flop
Seat 7: KovIFish89 folded before Flop (didn't bet)
Seat 8: sanpidk folded before Flop (didn't bet)
Seat 9: ipashutapkom folded before Flop (didn't bet)





PokerStars Hand #152883743635:  Hold'em No Limit ($1/$2 USD) - 2016/05/05 15:28:51 CET [2016/05/05 9:28:51 ET]
Table 'Samitchell' 9-max Seat #5 is the button
Seat 1: T0ny Adams ($82.42 in chips) 
Seat 3: gabi_igna ($375.77 in chips) 
Seat 4: Fitzyferret ($390.97 in chips) 
Seat 5: Spid1 ($200 in chips) 
Seat 6: matiko09 ($215.90 in chips) 
Seat 7: patpaty ($157.30 in chips) 
Seat 8: kblkxls ($101.97 in chips) 
Seat 9: IseeUcards ($260.63 in chips) 
matiko09: posts small blind $1
patpaty: posts big blind $2
13Ghosts: sits out 
*** HOLE CARDS ***
Dealt to matiko09 [5c 5s]
kblkxls: folds 
IseeUcards: folds 
T0ny Adams: folds 
gabi_igna: folds 
Fitzyferret: folds 
Spid1: folds 
matiko09: raises $3 to $5
patpaty: folds 
Uncalled bet ($3) returned to matiko09
matiko09 collected $4 from pot
matiko09: doesn't show hand 
*** SUMMARY ***
Total pot $4 | Rake $0 
Seat 1: T0ny Adams folded before Flop (didn't bet)
Seat 3: gabi_igna folded before Flop (didn't bet)
Seat 4: Fitzyferret folded before Flop (didn't bet)
Seat 5: Spid1 (button) folded before Flop (didn't bet)
Seat 6: matiko09 (small blind) collected ($4)
Seat 7: patpaty (big blind) folded before Flop
Seat 8: kblkxls folded before Flop (didn't bet)
Seat 9: IseeUcards folded before Flop (didn't bet)





PokerStars Hand #152883744704:  Hold'em No Limit ($0.50/$1.00 USD) - 2016/05/05 15:28:52 CET [2016/05/05 9:28:52 ET]
Table 'Chimaera II' 9-max Seat #2 is the button
Seat 2: Spid1 ($100 in chips) 
Seat 3: matiko09 ($100.50 in chips) 
Seat 4: RiverJazz ($100 in chips) 
Seat 5: Butchers31 ($102.60 in chips) 
Seat 6: Painkiller72 ($110.62 in chips) 
Seat 7: Hypoaroused ($198.86 in chips) 
Seat 8: 2damnstr8 ($9.78 in chips) 
Seat 9: kamillo91 ($79.78 in chips) 
matiko09: posts small blind $0.50
RiverJazz: posts big blind $1
*** HOLE CARDS ***
Dealt to matiko09 [Kh 9d]
Butchers31: folds 
Painkiller72: folds 
Hypoaroused: folds 
2damnstr8: raises $8.78 to $9.78 and is all-in
kamillo91: folds 
Spid1: folds 
matiko09: folds 
RiverJazz: calls $8.78
*** FLOP *** [Jh 6c Js]
*** TURN *** [Jh 6c Js] [8h]
*** RIVER *** [Jh 6c Js 8h] [4h]
*** SHOW DOWN ***
RiverJazz: shows [Ts Tc] (two pair, Jacks and Tens)
2damnstr8: shows [2s Ac] (a pair of Jacks)
RiverJazz collected $19.06 from pot
*** SUMMARY ***
Total pot $20.06 | Rake $1 
Board [Jh 6c Js 8h 4h]
Seat 2: Spid1 (button) folded before Flop (didn't bet)
Seat 3: matiko09 (small blind) folded before Flop
Seat 4: RiverJazz (big blind) showed [Ts Tc] and won ($19.06) with two pair, Jacks and Tens
Seat 5: Butchers31 folded before Flop (didn't bet)
Seat 6: Painkiller72 folded before Flop (didn't bet)
Seat 7: Hypoaroused folded before Flop (didn't bet)
Seat 8: 2damnstr8 showed [2s Ac] and lost with a pair of Jacks
Seat 9: kamillo91 folded before Flop (didn't bet)





PokerStars Hand #152883749808:  Hold'em No Limit (€1/€2 EUR) - 2016/05/05 15:29:01 CET [2016/05/05 9:29:01 ET]
Table 'Bessel II' 9-max Seat #7 is the button
Seat 1: Soloaces224 (€158.67 in chips) 
Seat 2: Fitzyferret (€292.70 in chips) 
Seat 3: IseeUcards (€564.93 in chips) 
Seat 5: Painkiller72 (€274.50 in chips) 
Seat 6: Spid1 (€200 in chips) 
Seat 7: matiko09 (€200 in chips) 
Seat 8: KovIFish89 (€200 in chips) 
KovIFish89: posts small blind €1
Soloaces224: posts big blind €2
*** HOLE CARDS ***
Dealt to matiko09 [5h 6h]
Fitzyferret: folds 
IseeUcards: folds 
Painkiller72: folds 
Spid1: folds 
matiko09: raises €2.54 to €4.54
KovIFish89: folds 
Soloaces224: calls €2.54
*** FLOP *** [2s 8s 6d]
Soloaces224: checks 
matiko09: bets €4.98
Soloaces224: calls €4.98
*** TURN *** [2s 8s 6d] [3s]
Soloaces224: bets €9.52
matiko09: folds 
Uncalled bet (€9.52) returned to Soloaces224
Soloaces224 collected €19.04 from pot
Soloaces224: doesn't show hand 
*** SUMMARY ***
Total pot €20.04 | Rake €1 
Board [2s 8s 6d 3s]
Seat 1: Soloaces224 (big blind) collected (€19.04)
Seat 2: Fitzyferret folded before Flop (didn't bet)
Seat 3: IseeUcards folded before Flop (didn't bet)
Seat 5: Painkiller72 folded before Flop (didn't bet)
Seat 6: Spid1 folded before Flop (didn't bet)
Seat 7: matiko09 (button) folded on the Turn
Seat 8: KovIFish89 (small blind) folded before Flop





PokerStars Hand #152883750747:  Hold'em No Limit ($0.50/$1.00 USD) - 2016/05/05 15:29:03 CET [2016/05/05 9:29:03 ET]
Table 'Belisana' 9-max Seat #8 is the button
Seat 1: djammusic ($130.84 in chips) 
Seat 2: ipashutapkom ($214.93 in chips) 
Seat 3: Dickyxxx ($100 in chips) 
Seat 4: Kukuryzka ($108.62 in chips) 
Seat 5: nickreason17 ($107.38 in chips) 
Seat 6: ihami ($38.50 in chips) 
Seat 7: matiko09 ($112.32 in chips) 
Seat 8: Spid1 ($135.76 in chips) 
Seat 9: michelle070 ($26.62 in chips) 
michelle070: posts small blind $0.50
djammusic: posts big blind $1
*** HOLE CARDS ***
Dealt to matiko09 [9h 5s]
ipashutapkom: raises $1.26 to $2.26
Dickyxxx: folds 
Kukuryzka: folds 
nickreason17: folds 
ihami: folds 
matiko09: folds 
Spid1: folds 
michelle070: calls $1.76
djammusic: folds 
*** FLOP *** [9s Ac Jc]
michelle070: bets $6
ipashutapkom: calls $6
*** TURN *** [9s Ac Jc] [3d]
michelle070: bets $5
ipashutapkom: raises $201.67 to $206.67 and is all-in
michelle070: calls $13.36 and is all-in
Uncalled bet ($188.31) returned to ipashutapkom
*** RIVER *** [9s Ac Jc 3d] [2c]
*** SHOW DOWN ***
michelle070: shows [6s As] (a pair of Aces)
ipashutapkom: shows [Qh Ah] (a pair of Aces - Queen kicker)
ipashutapkom collected $51.74 from pot
*** SUMMARY ***
Total pot $54.24 | Rake $2.50 
Board [9s Ac Jc 3d 2c]
Seat 1: djammusic (big blind) folded before Flop
Seat 2: ipashutapkom showed [Qh Ah] and won ($51.74) with a pair of Aces
Seat 3: Dickyxxx folded before Flop (didn't bet)
Seat 4: Kukuryzka folded before Flop (didn't bet)
Seat 5: nickreason17 folded before Flop (didn't bet)
Seat 6: ihami folded before Flop (didn't bet)
Seat 7: matiko09 folded before Flop (didn't bet)
Seat 8: Spid1 (button) folded before Flop (didn't bet)
Seat 9: michelle070 (small blind) showed [6s As] and lost with a pair of Aces





PokerStars Hand #152883751399:  Hold'em No Limit ($0.50/$1.00 USD) - 2016/05/05 15:29:04 CET [2016/05/05 9:29:04 ET]
Table 'Priska II' 9-max Seat #6 is the button
Seat 1: Spid1 ($100 in chips) 
Seat 2: Kukuryzka ($100 in chips) 
Seat 3: matiko09 ($100 in chips) 
Seat 4: Painkiller72 ($160.77 in chips) 
Seat 5: nickreason17 ($126.50 in chips) 
Seat 6: OneTwo81 ($104.45 in chips) 
Seat 7: stockbridge8 ($97.07 in chips) 
Seat 8: pohorc21 ($80.35 in chips) 
Seat 9: torkkdnm ($101.55 in chips) 
stockbridge8: posts small blind $0.50
pohorc21: posts big blind $1
*** HOLE CARDS ***
Dealt to matiko09 [3d Js]
torkkdnm: folds 
Spid1: folds 
Kukuryzka: folds 
matiko09: folds 
Painkiller72: raises $1.50 to $2.50
nickreason17: folds 
OneTwo81: calls $2.50
stockbridge8: folds 
pohorc21: calls $1.50
*** FLOP *** [Jh 4d 2c]
pohorc21: checks 
Painkiller72: bets $5.32
OneTwo81: folds 
pohorc21: calls $5.32
*** TURN *** [Jh 4d 2c] [2d]
pohorc21: checks 
Painkiller72: checks 
*** RIVER *** [Jh 4d 2c 2d] [Ks]
pohorc21: checks 
Painkiller72: checks 
*** SHOW DOWN ***
pohorc21: shows [Ad 3s] (a pair of Deuces)
Painkiller72: shows [Ah Qh] (a pair of Deuces - Ace+King+Queen kicker)
Painkiller72 collected $17.71 from pot
*** SUMMARY ***
Total pot $18.64 | Rake $0.93 
Board [Jh 4d 2c 2d Ks]
Seat 1: Spid1 folded before Flop (didn't bet)
Seat 2: Kukuryzka folded before Flop (didn't bet)
Seat 3: matiko09 folded before Flop (didn't bet)
Seat 4: Painkiller72 showed [Ah Qh] and won ($17.71) with a pair of Deuces
Seat 5: nickreason17 folded before Flop (didn't bet)
Seat 6: OneTwo81 (button) folded on the Flop
Seat 7: stockbridge8 (small blind) folded before Flop
Seat 8: pohorc21 (big blind) showed [Ad 3s] and lost with a pair of Deuces
Seat 9: torkkdnm folded before Flop (didn't bet)





PokerStars Hand #152883756425:  Hold'em No Limit ($1/$2 USD) - 2016/05/05 15:29:13 CET [2016/05/05 9:29:13 ET]
Table 'Samitchell' 9-max Seat #6 is the button
Seat 1: T0ny Adams ($82.42 in chips) 
Seat 3: gabi_igna ($375.77 in chips) 
Seat 4: Fitzyferret ($390.97 in chips) 
Seat 5: Spid1 ($200 in chips) 
Seat 6: matiko09 ($217.90 in chips) 
Seat 7: patpaty ($155.30 in chips) 
Seat 9: IseeUcards ($260.63 in chips) 
patpaty: posts small blind $1
kblkxls: is sitting out 
IseeUcards: posts big blind $2
13Ghosts: sits out 
*** HOLE CARDS ***
Dealt to matiko09 [Tc Td]
T0ny Adams: raises $2.68 to $4.68
gabi_igna: folds 
Fitzyferret: folds 
Spid1: folds 
matiko09: calls $4.68
patpaty: folds 
IseeUcards: folds 
*** FLOP *** [3c Ad Qd]
kblkxls leaves the table
Kukuryzka joins the table at seat #8 
T0ny Adams: checks 
matiko09: checks 
*** TURN *** [3c Ad Qd] [5s]
Kukuryzka leaves the table
T0ny Adams: bets $4
matiko09: folds 
Uncalled bet ($4) returned to T0ny Adams
T0ny Adams collected $11.74 from pot
T0ny Adams: doesn't show hand 
*** SUMMARY ***
Total pot $12.36 | Rake $0.62 
Board [3c Ad Qd 5s]
Seat 1: T0ny Adams collected ($11.74)
Seat 3: gabi_igna folded before Flop (didn't bet)
Seat 4: Fitzyferret folded before Flop (didn't bet)
Seat 5: Spid1 folded before Flop (didn't bet)
Seat 6: matiko09 (button) folded on the Turn
Seat 7: patpaty (small blind) folded before Flop
Seat 9: IseeUcards (big blind) folded before Flop





PokerStars Hand #152883761431:  Hold'em No Limit ($0.50/$1.00 USD) - 2016/05/05 15:29:23 CET [2016/05/05 9:29:23 ET]
Table 'Lictoria II' 9-max Seat #9 is the button
Seat 1: St.LaCoste ($105 in chips) 
Seat 2: Dantist1122 ($125.46 in chips) 
Seat 3: Krinica2009 ($101.50 in chips) 
Seat 4: Ying59 ($47.15 in chips) 
Seat 5: sanpidk ($107.25 in chips) 
Seat 6: gabi_igna ($116.22 in chips) 
Seat 7: Painkiller72 ($201.80 in chips) 
Seat 8: matiko09 ($100 in chips) 
Seat 9: Kukuryzka ($122.87 in chips) 
St.LaCoste: posts small blind $0.50
Dantist1122: posts big blind $1
*** HOLE CARDS ***
Dealt to matiko09 [8h 3h]
Krinica2009: folds 
Ying59: folds 
sanpidk: folds 
gabi_igna: folds 
Painkiller72: folds 
matiko09: folds 
Kukuryzka: raises $1 to $2
St.LaCoste: folds 
Dantist1122: calls $1
*** FLOP *** [4s 4h Qh]
Dantist1122: checks 
Kukuryzka: bets $3.21
Dantist1122: folds 
Uncalled bet ($3.21) returned to Kukuryzka
Kukuryzka collected $4.28 from pot
Kukuryzka: doesn't show hand 
*** SUMMARY ***
Total pot $4.50 | Rake $0.22 
Board [4s 4h Qh]
Seat 1: St.LaCoste (small blind) folded before Flop
Seat 2: Dantist1122 (big blind) folded on the Flop
Seat 3: Krinica2009 folded before Flop (didn't bet)
Seat 4: Ying59 folded before Flop (didn't bet)
Seat 5: sanpidk folded before Flop (didn't bet)
Seat 6: gabi_igna folded before Flop (didn't bet)
Seat 7: Painkiller72 folded before Flop (didn't bet)
Seat 8: matiko09 folded before Flop (didn't bet)
Seat 9: Kukuryzka (button) collected ($4.28)





PokerStars Hand #152883761568:  Hold'em No Limit ($1/$2 USD) - 2016/05/05 15:29:23 CET [2016/05/05 9:29:23 ET]
Table 'Lundia' 9-max Seat #7 is the button
Seat 1: Fitzyferret ($200 in chips) 
Seat 2: patpaty ($165.60 in chips) 
Seat 3: IseeUcards ($416.77 in chips) 
Seat 6: Spid1 ($245.74 in chips) 
Seat 7: matiko09 ($207 in chips) 
Seat 8: Durnichka ($75 in chips) 
Seat 9: gabi_igna ($229.86 in chips) 
Durnichka: posts small blind $1
gabi_igna: posts big blind $2
KovIFish89: sits out 
*** HOLE CARDS ***
Dealt to matiko09 [9h Kd]
Fitzyferret: folds 
patpaty: raises $2 to $4
IseeUcards: folds 
Spid1: folds 
matiko09: folds 
Durnichka: folds 
gabi_igna: folds 
Uncalled bet ($2) returned to patpaty
patpaty collected $5 from pot
patpaty: doesn't show hand 
*** SUMMARY ***
Total pot $5 | Rake $0 
Seat 1: Fitzyferret folded before Flop (didn't bet)
Seat 2: patpaty collected ($5)
Seat 3: IseeUcards folded before Flop (didn't bet)
Seat 6: Spid1 folded before Flop (didn't bet)
Seat 7: matiko09 (button) folded before Flop (didn't bet)
Seat 8: Durnichka (small blind) folded before Flop
Seat 9: gabi_igna (big blind) folded before Flop





PokerStars Hand #152883766615:  Hold'em No Limit ($0.50/$1.00 USD) - 2016/05/05 15:29:32 CET [2016/05/05 9:29:32 ET]
Table 'Chimaera II' 9-max Seat #3 is the button
Seat 2: Spid1 ($100 in chips) 
Seat 3: matiko09 ($100 in chips) 
Seat 4: RiverJazz ($109.28 in chips) 
Seat 5: Butchers31 ($102.60 in chips) 
Seat 6: Painkiller72 ($110.62 in chips) 
Seat 7: Hypoaroused ($198.86 in chips) 
Seat 9: kamillo91 ($79.78 in chips) 
RiverJazz: posts small blind $0.50
Butchers31: posts big blind $1
*** HOLE CARDS ***
Dealt to matiko09 [7s 9d]
2damnstr8 leaves the table
Dantist1122 joins the table at seat #8 
Painkiller72: folds 
Hypoaroused: folds 
kamillo91: raises $2 to $3
Spid1: folds 
matiko09: folds 
RiverJazz: folds 
Butchers31: raises $2 to $5
kamillo91: calls $2
*** FLOP *** [3c Ac Ts]
Butchers31: bets $4.99
kamillo91: folds 
Uncalled bet ($4.99) returned to Butchers31
Butchers31 collected $9.98 from pot
Butchers31: doesn't show hand 
*** SUMMARY ***
Total pot $10.50 | Rake $0.52 
Board [3c Ac Ts]
Seat 2: Spid1 folded before Flop (didn't bet)
Seat 3: matiko09 (button) folded before Flop (didn't bet)
Seat 4: RiverJazz (small blind) folded before Flop
Seat 5: Butchers31 (big blind) collected ($9.98)
Seat 6: Painkiller72 folded before Flop (didn't bet)
Seat 7: Hypoaroused folded before Flop (didn't bet)
Seat 9: kamillo91 folded on the Flop





PokerStars Hand #152883774325:  Hold'em No Limit ($1/$2 USD) - 2016/05/05 15:29:45 CET [2016/05/05 9:29:45 ET]
Table 'Lundia' 9-max Seat #8 is the button
Seat 1: Fitzyferret ($200 in chips) 
Seat 2: patpaty ($168.60 in chips) 
Seat 3: IseeUcards ($416.77 in chips) 
Seat 6: Spid1 ($245.74 in chips) 
Seat 7: matiko09 ($207 in chips) 
Seat 8: Durnichka ($74 in chips) 
Seat 9: gabi_igna ($227.86 in chips) 
gabi_igna: posts small blind $1
Fitzyferret: posts big blind $2
KovIFish89: sits out 
*** HOLE CARDS ***
Dealt to matiko09 [7d 6d]
patpaty: folds 
IseeUcards: folds 
Spid1: folds 
matiko09: raises $3 to $5
Durnichka: folds 
gabi_igna: folds 
Fitzyferret: folds 
Uncalled bet ($3) returned to matiko09
matiko09 collected $5 from pot
matiko09: doesn't show hand 
*** SUMMARY ***
Total pot $5 | Rake $0 
Seat 1: Fitzyferret (big blind) folded before Flop
Seat 2: patpaty folded before Flop (didn't bet)
Seat 3: IseeUcards folded before Flop (didn't bet)
Seat 6: Spid1 folded before Flop (didn't bet)
Seat 7: matiko09 collected ($5)
Seat 8: Durnichka (button) folded before Flop (didn't bet)
Seat 9: gabi_igna (small blind) folded before Flop





PokerStars Hand #152883774616:  Hold'em No Limit ($1/$2 USD) - 2016/05/05 15:29:46 CET [2016/05/05 9:29:46 ET]
Table 'Tololo' 9-max Seat #8 is the button
Seat 1: Kukuryzka ($200 in chips) 
Seat 2: gabi_igna ($297.99 in chips) 
Seat 3: nickreason17 ($225.40 in chips) 
Seat 4: mooose100 ($347.03 in chips) 
Seat 5: matiko09 ($200 in chips) 
Seat 6: Xagua ($132.12 in chips) 
Seat 7: IseeUcards ($201.61 in chips) 
Seat 8: TonnaMunz ($213.66 in chips) 
Seat 9: Fitzyferret ($236.49 in chips) 
Fitzyferret: posts small blind $1
Kukuryzka: posts big blind $2
*** HOLE CARDS ***
Dealt to matiko09 [5s 5d]
gabi_igna: folds 
nickreason17: folds 
mooose100: folds 
matiko09: raises $3 to $5
Xagua: folds 
IseeUcards: folds 
TonnaMunz: folds 
Fitzyferret: folds 
Kukuryzka: folds 
Uncalled bet ($3) returned to matiko09
matiko09 collected $5 from pot
matiko09: doesn't show hand 
*** SUMMARY ***
Total pot $5 | Rake $0 
Seat 1: Kukuryzka (big blind) folded before Flop
Seat 2: gabi_igna folded before Flop (didn't bet)
Seat 3: nickreason17 folded before Flop (didn't bet)
Seat 4: mooose100 folded before Flop (didn't bet)
Seat 5: matiko09 collected ($5)
Seat 6: Xagua folded before Flop (didn't bet)
Seat 7: IseeUcards folded before Flop (didn't bet)
Seat 8: TonnaMunz (button) folded before Flop (didn't bet)
Seat 9: Fitzyferret (small blind) folded before Flop





PokerStars Hand #152883781992:  Hold'em No Limit ($1/$2 USD) - 2016/05/05 15:29:59 CET [2016/05/05 9:29:59 ET]
Table 'Samitchell' 9-max Seat #7 is the button
Seat 2: 13Ghosts ($200 in chips) 
Seat 3: gabi_igna ($375.77 in chips) 
Seat 4: Fitzyferret ($390.97 in chips) 
Seat 5: Spid1 ($200 in chips) 
Seat 6: matiko09 ($213.22 in chips) 
Seat 7: patpaty ($154.30 in chips) 
Seat 9: IseeUcards ($258.63 in chips) 
IseeUcards: posts small blind $1
T0ny Adams: is sitting out 
13Ghosts: posts big blind $2
*** HOLE CARDS ***
Dealt to matiko09 [8d 6d]
gabi_igna: folds 
Fitzyferret: folds 
Spid1: folds 
T0ny Adams leaves the table
Kukuryzka joins the table at seat #8 
KovIFish89 joins the table at seat #1 
matiko09: raises $3 to $5
patpaty: folds 
IseeUcards: folds 
13Ghosts: calls $3
*** FLOP *** [3d 3c Jh]
13Ghosts: checks 
matiko09: bets $6.79
13Ghosts: calls $6.79
*** TURN *** [3d 3c Jh] [9c]
13Ghosts: bets $14.24
matiko09: folds 
Uncalled bet ($14.24) returned to 13Ghosts
13Ghosts collected $23.35 from pot
13Ghosts: doesn't show hand 
*** SUMMARY ***
Total pot $24.58 | Rake $1.23 
Board [3d 3c Jh 9c]
Seat 2: 13Ghosts (big blind) collected ($23.35)
Seat 3: gabi_igna folded before Flop (didn't bet)
Seat 4: Fitzyferret folded before Flop (didn't bet)
Seat 5: Spid1 folded before Flop (didn't bet)
Seat 6: matiko09 folded on the Turn
Seat 7: patpaty (button) folded before Flop (didn't bet)
Seat 9: IseeUcards (small blind) folded before Flop





PokerStars Hand #152883784972:  Hold'em No Limit ($1/$2 USD) - 2016/05/05 15:30:04 CET [2016/05/05 9:30:04 ET]
Table 'Tololo' 9-max Seat #9 is the button
Seat 1: Kukuryzka ($198 in chips) 
Seat 2: gabi_igna ($297.99 in chips) 
Seat 3: nickreason17 ($225.40 in chips) 
Seat 4: mooose100 ($347.03 in chips) 
Seat 5: matiko09 ($203 in chips) 
Seat 6: Xagua ($132.12 in chips) 
Seat 7: IseeUcards ($201.61 in chips) 
Seat 8: TonnaMunz ($213.66 in chips) 
Seat 9: Fitzyferret ($235.49 in chips) 
Kukuryzka: posts small blind $1
gabi_igna: posts big blind $2
*** HOLE CARDS ***
Dealt to matiko09 [9s 5c]
nickreason17: folds 
mooose100: folds 
matiko09: folds 
Xagua: folds 
IseeUcards: folds 
TonnaMunz: raises $2.96 to $4.96
Fitzyferret: folds 
Kukuryzka: folds 
gabi_igna: folds 
Uncalled bet ($2.96) returned to TonnaMunz
TonnaMunz collected $5 from pot
TonnaMunz: doesn't show hand 
*** SUMMARY ***
Total pot $5 | Rake $0 
Seat 1: Kukuryzka (small blind) folded before Flop
Seat 2: gabi_igna (big blind) folded before Flop
Seat 3: nickreason17 folded before Flop (didn't bet)
Seat 4: mooose100 folded before Flop (didn't bet)
Seat 5: matiko09 folded before Flop (didn't bet)
Seat 6: Xagua folded before Flop (didn't bet)
Seat 7: IseeUcards folded before Flop (didn't bet)
Seat 8: TonnaMunz collected ($5)
Seat 9: Fitzyferret (button) folded before Flop (didn't bet)





PokerStars Hand #152883786400:  Hold'em No Limit ($0.50/$1.00 USD) - 2016/05/05 15:30:06 CET [2016/05/05 9:30:06 ET]
Table 'Pyxis III' 9-max Seat #4 is the button
Seat 1: sanpidk ($130.03 in chips) 
Seat 2: 50CandyJoe ($100 in chips) 
Seat 3: Xxth3nutzxX ($99.50 in chips) 
Seat 4: Sloeve ($119.35 in chips) 
Seat 5: darren1031 ($80 in chips) 
Seat 6: kamillo91 ($44 in chips) 
Seat 7: nickreason17 ($100 in chips) 
Seat 8: matiko09 ($100 in chips) 
Seat 9: Hypoaroused ($95.38 in chips) 
darren1031: posts small blind $0.50
kamillo91: posts big blind $1
*** HOLE CARDS ***
Dealt to matiko09 [8s 6c]
nickreason17: folds 
nickreason17 leaves the table
matiko09: folds 
Hypoaroused: folds 
sanpidk: folds 
Painkiller72 joins the table at seat #7 
50CandyJoe: folds 
Xxth3nutzxX: folds 
Sloeve: folds 
darren1031: folds 
Uncalled bet ($0.50) returned to kamillo91
kamillo91 collected $1 from pot
kamillo91: doesn't show hand 
*** SUMMARY ***
Total pot $1 | Rake $0 
Seat 1: sanpidk folded before Flop (didn't bet)
Seat 2: 50CandyJoe folded before Flop (didn't bet)
Seat 3: Xxth3nutzxX folded before Flop (didn't bet)
Seat 4: Sloeve (button) folded before Flop (didn't bet)
Seat 5: darren1031 (small blind) folded before Flop
Seat 6: kamillo91 (big blind) collected ($1)
Seat 7: nickreason17 folded before Flop (didn't bet)
Seat 8: matiko09 folded before Flop (didn't bet)
Seat 9: Hypoaroused folded before Flop (didn't bet)





PokerStars Hand #152883787302:  Hold'em No Limit ($0.50/$1.00 USD) - 2016/05/05 15:30:08 CET [2016/05/05 9:30:08 ET]
Table 'Natascha' 9-max Seat #2 is the button
Seat 1: ronald3737 ($132.90 in chips) 
Seat 2: matiko09 ($138.25 in chips) 
Seat 3: bjonlyking ($99 in chips) 
Seat 5: Dickyxxx ($134.26 in chips) 
Seat 6: gabi_igna ($153.44 in chips) 
Seat 7: torkkdnm ($147.46 in chips) 
Seat 8: kamillo91 ($77.50 in chips) 
bjonlyking: posts small blind $0.50
Dickyxxx: posts big blind $1
*** HOLE CARDS ***
Dealt to matiko09 [Tc Js]
gabi_igna: folds 
torkkdnm: folds 
kamillo91: folds 
ronald3737: raises $1 to $2
matiko09: folds 
bjonlyking: calls $1.50
Dickyxxx: calls $1
*** FLOP *** [3h 5h 6s]
bjonlyking: checks 
Dickyxxx: checks 
St.LaCoste leaves the table
ronald3737: bets $3
sanpidk joins the table at seat #4 
bjonlyking: calls $3
Dickyxxx: folds 
*** TURN *** [3h 5h 6s] [Ad]
bjonlyking: bets $7
ronald3737: raises $9 to $16
bjonlyking: calls $9
*** RIVER *** [3h 5h 6s Ad] [6c]
bjonlyking: checks 
ronald3737: bets $24
bjonlyking: calls $24
*** SHOW DOWN ***
ronald3737: shows [7s Ks] (a pair of Sixes)
bjonlyking: shows [7c Ac] (two pair, Aces and Sixes)
bjonlyking collected $89.50 from pot
*** SUMMARY ***
Total pot $92 | Rake $2.50 
Board [3h 5h 6s Ad 6c]
Seat 1: ronald3737 showed [7s Ks] and lost with a pair of Sixes
Seat 2: matiko09 (button) folded before Flop (didn't bet)
Seat 3: bjonlyking (small blind) showed [7c Ac] and won ($89.50) with two pair, Aces and Sixes
Seat 5: Dickyxxx (big blind) folded on the Flop
Seat 6: gabi_igna folded before Flop (didn't bet)
Seat 7: torkkdnm folded before Flop (didn't bet)
Seat 8: kamillo91 folded before Flop (didn't bet)





PokerStars Hand #152883787631:  Hold'em No Limit ($0.50/$1.00 USD) - 2016/05/05 15:30:09 CET [2016/05/05 9:30:09 ET]
Table 'Belisana' 9-max Seat #1 is the button
Seat 1: djammusic ($129.84 in chips) 
Seat 2: ipashutapkom ($240.05 in chips) 
Seat 3: Dickyxxx ($100 in chips) 
Seat 4: Kukuryzka ($108.62 in chips) 
Seat 5: nickreason17 ($107.38 in chips) 
Seat 6: ihami ($38.50 in chips) 
Seat 7: matiko09 ($112.32 in chips) 
Seat 8: Spid1 ($135.76 in chips) 
ipashutapkom: posts small blind $0.50
Dickyxxx: posts big blind $1
*** HOLE CARDS ***
Dealt to matiko09 [2s Ks]
Kukuryzka: folds 
nickreason17: folds 
ihami: folds 
matiko09: folds 
Spid1: folds 
djammusic: folds 
ipashutapkom: folds 
Uncalled bet ($0.50) returned to Dickyxxx
Dickyxxx collected $1 from pot
Dickyxxx: doesn't show hand 
*** SUMMARY ***
Total pot $1 | Rake $0 
Seat 1: djammusic (button) folded before Flop (didn't bet)
Seat 2: ipashutapkom (small blind) folded before Flop
Seat 3: Dickyxxx (big blind) collected ($1)
Seat 4: Kukuryzka folded before Flop (didn't bet)
Seat 5: nickreason17 folded before Flop (didn't bet)
Seat 6: ihami folded before Flop (didn't bet)
Seat 7: matiko09 folded before Flop (didn't bet)
Seat 8: Spid1 folded before Flop (didn't bet)





PokerStars Hand #152883791341:  Hold'em No Limit ($1/$2 USD) - 2016/05/05 15:30:15 CET [2016/05/05 9:30:15 ET]
Table 'Lundia' 9-max Seat #9 is the button
Seat 1: Fitzyferret ($200 in chips) 
Seat 2: patpaty ($168.60 in chips) 
Seat 3: IseeUcards ($416.77 in chips) 
Seat 6: Spid1 ($245.74 in chips) 
Seat 7: matiko09 ($210 in chips) 
Seat 8: Durnichka ($74 in chips) 
Seat 9: gabi_igna ($226.86 in chips) 
Fitzyferret: posts small blind $1
patpaty: posts big blind $2
KovIFish89: sits out 
*** HOLE CARDS ***
Dealt to matiko09 [3s Jd]
IseeUcards: folds 
Spid1: folds 
matiko09: folds 
Durnichka: folds 
gabi_igna: raises $3 to $5
Fitzyferret: raises $13.80 to $18.80
patpaty: folds 
gabi_igna: calls $13.80
*** FLOP *** [Ts Ac 9h]
Fitzyferret: bets $20
gabi_igna: folds 
Uncalled bet ($20) returned to Fitzyferret
Fitzyferret collected $37.62 from pot
Fitzyferret: doesn't show hand 
*** SUMMARY ***
Total pot $39.60 | Rake $1.98 
Board [Ts Ac 9h]
Seat 1: Fitzyferret (small blind) collected ($37.62)
Seat 2: patpaty (big blind) folded before Flop
Seat 3: IseeUcards folded before Flop (didn't bet)
Seat 6: Spid1 folded before Flop (didn't bet)
Seat 7: matiko09 folded before Flop (didn't bet)
Seat 8: Durnichka folded before Flop (didn't bet)
Seat 9: gabi_igna (button) folded on the Flop





PokerStars Hand #152883801316:  Hold'em No Limit ($0.50/$1.00 USD) - 2016/05/05 15:30:33 CET [2016/05/05 9:30:33 ET]
Table 'Pyxis III' 9-max Seat #5 is the button
Seat 1: sanpidk ($130.03 in chips) 
Seat 2: 50CandyJoe ($100 in chips) 
Seat 3: Xxth3nutzxX ($99.50 in chips) 
Seat 4: Sloeve ($119.35 in chips) 
Seat 5: darren1031 ($80 in chips) 
Seat 6: kamillo91 ($44.50 in chips) 
Seat 7: Painkiller72 ($138.78 in chips) 
Seat 8: matiko09 ($100 in chips) 
Seat 9: Hypoaroused ($95.38 in chips) 
kamillo91: posts small blind $0.50
Painkiller72: posts big blind $1
*** HOLE CARDS ***
Dealt to matiko09 [Jc Qs]
matiko09: folds 
Hypoaroused: calls $1
sanpidk: folds 
50CandyJoe: folds 
Xxth3nutzxX: calls $1
Sloeve: folds 
darren1031: calls $1
kamillo91: folds 
Painkiller72: checks 
*** FLOP *** [Ah 4s Th]
Painkiller72: checks 
Hypoaroused: checks 
Xxth3nutzxX: checks 
darren1031: checks 
*** TURN *** [Ah 4s Th] [4d]
Painkiller72: checks 
Hypoaroused: checks 
Xxth3nutzxX: checks 
darren1031: bets $3
Painkiller72: folds 
Hypoaroused: folds 
Xxth3nutzxX: folds 
Uncalled bet ($3) returned to darren1031
darren1031 collected $4.28 from pot
darren1031: doesn't show hand 
*** SUMMARY ***
Total pot $4.50 | Rake $0.22 
Board [Ah 4s Th 4d]
Seat 1: sanpidk folded before Flop (didn't bet)
Seat 2: 50CandyJoe folded before Flop (didn't bet)
Seat 3: Xxth3nutzxX folded on the Turn
Seat 4: Sloeve folded before Flop (didn't bet)
Seat 5: darren1031 (button) collected ($4.28)
Seat 6: kamillo91 (small blind) folded before Flop
Seat 7: Painkiller72 (big blind) folded on the Turn
Seat 8: matiko09 folded before Flop (didn't bet)
Seat 9: Hypoaroused folded on the Turn





PokerStars Hand #152883801472:  Hold'em No Limit ($0.50/$1.00 USD) - 2016/05/05 15:30:33 CET [2016/05/05 9:30:33 ET]
Table 'Lictoria II' 9-max Seat #1 is the button
Seat 1: St.LaCoste ($104.50 in chips) 
Seat 2: Dantist1122 ($123.46 in chips) 
Seat 3: Krinica2009 ($101.50 in chips) 
Seat 4: Ying59 ($47.15 in chips) 
Seat 5: sanpidk ($107.25 in chips) 
Seat 6: gabi_igna ($116.22 in chips) 
Seat 7: Painkiller72 ($201.80 in chips) 
Seat 8: matiko09 ($100 in chips) 
Seat 9: Kukuryzka ($125.15 in chips) 
Dantist1122: posts small blind $0.50
Krinica2009: posts big blind $1
*** HOLE CARDS ***
Dealt to matiko09 [6s 4s]
Ying59: raises $1 to $2
sanpidk: folds 
gabi_igna: folds 
Painkiller72: folds 
matiko09: folds 
Kukuryzka: folds 
St.LaCoste: raises $7.34 to $9.34
Dantist1122: folds 
Krinica2009: folds 
Ying59: folds 
Uncalled bet ($7.34) returned to St.LaCoste
St.LaCoste collected $5.50 from pot
St.LaCoste: doesn't show hand 
*** SUMMARY ***
Total pot $5.50 | Rake $0 
Seat 1: St.LaCoste (button) collected ($5.50)
Seat 2: Dantist1122 (small blind) folded before Flop
Seat 3: Krinica2009 (big blind) folded before Flop
Seat 4: Ying59 folded before Flop
Seat 5: sanpidk folded before Flop (didn't bet)
Seat 6: gabi_igna folded before Flop (didn't bet)
Seat 7: Painkiller72 folded before Flop (didn't bet)
Seat 8: matiko09 folded before Flop (didn't bet)
Seat 9: Kukuryzka folded before Flop (didn't bet)





PokerStars Hand #152883801946:  Hold'em No Limit ($1/$2 USD) - 2016/05/05 15:30:34 CET [2016/05/05 9:30:34 ET]
Table 'Tololo' 9-max Seat #1 is the button
Seat 1: Kukuryzka ($200 in chips) 
Seat 2: gabi_igna ($295.99 in chips) 
Seat 3: nickreason17 ($225.40 in chips) 
Seat 4: mooose100 ($347.03 in chips) 
Seat 5: matiko09 ($203 in chips) 
Seat 6: Xagua ($132.12 in chips) 
Seat 7: IseeUcards ($201.61 in chips) 
Seat 8: TonnaMunz ($216.66 in chips) 
Seat 9: Fitzyferret ($235.49 in chips) 
gabi_igna: posts small blind $1
nickreason17: posts big blind $2
*** HOLE CARDS ***
Dealt to matiko09 [4s As]
mooose100: calls $2
matiko09: folds 
Xagua: folds 
IseeUcards: folds 
TonnaMunz: raises $6 to $8
Fitzyferret: folds 
Kukuryzka: folds 
gabi_igna: folds 
nickreason17: folds 
mooose100: calls $6
*** FLOP *** [6s Th 7h]
mooose100: checks 
TonnaMunz: bets $18
mooose100: calls $18
*** TURN *** [6s Th 7h] [Qs]
mooose100: bets $52.25
TonnaMunz: calls $52.25
*** RIVER *** [6s Th 7h Qs] [6h]
mooose100: checks 
TonnaMunz: bets $138.41 and is all-in
mooose100: calls $138.41
*** SHOW DOWN ***
TonnaMunz: shows [7d 7c] (a full house, Sevens full of Sixes)
mooose100: mucks hand 
TonnaMunz collected $433.57 from pot
*** SUMMARY ***
Total pot $436.32 | Rake $2.75 
Board [6s Th 7h Qs 6h]
Seat 1: Kukuryzka (button) folded before Flop (didn't bet)
Seat 2: gabi_igna (small blind) folded before Flop
Seat 3: nickreason17 (big blind) folded before Flop
Seat 4: mooose100 mucked [Jh Qh]
Seat 5: matiko09 folded before Flop (didn't bet)
Seat 6: Xagua folded before Flop (didn't bet)
Seat 7: IseeUcards folded before Flop (didn't bet)
Seat 8: TonnaMunz showed [7d 7c] and won ($433.57) with a full house, Sevens full of Sixes
Seat 9: Fitzyferret folded before Flop (didn't bet)





PokerStars Hand #152883802159:  Hold'em No Limit ($0.50/$1.00 USD) - 2016/05/05 15:30:35 CET [2016/05/05 9:30:35 ET]
Table 'Belisana' 9-max Seat #2 is the button
Seat 1: djammusic ($129.84 in chips) 
Seat 2: ipashutapkom ($239.55 in chips) 
Seat 3: Dickyxxx ($100.50 in chips) 
Seat 4: Kukuryzka ($108.62 in chips) 
Seat 5: nickreason17 ($107.38 in chips) 
Seat 6: ihami ($38.50 in chips) 
Seat 7: matiko09 ($112.32 in chips) 
Seat 8: Spid1 ($135.76 in chips) 
Dickyxxx: posts small blind $0.50
Kukuryzka: posts big blind $1
*** HOLE CARDS ***
Dealt to matiko09 [3c 5c]
nickreason17: folds 
ihami: folds 
matiko09: folds 
Spid1: folds 
djammusic: raises $1.50 to $2.50
ipashutapkom: raises $5 to $7.50
Dickyxxx: folds 
Kukuryzka: folds 
djammusic: calls $5
*** FLOP *** [8h 8s 7s]
djammusic: checks 
ipashutapkom: bets $6.01
djammusic: folds 
Uncalled bet ($6.01) returned to ipashutapkom
ipashutapkom collected $15.68 from pot
ipashutapkom: doesn't show hand 
*** SUMMARY ***
Total pot $16.50 | Rake $0.82 
Board [8h 8s 7s]
Seat 1: djammusic folded on the Flop
Seat 2: ipashutapkom (button) collected ($15.68)
Seat 3: Dickyxxx (small blind) folded before Flop
Seat 4: Kukuryzka (big blind) folded before Flop
Seat 5: nickreason17 folded before Flop (didn't bet)
Seat 6: ihami folded before Flop (didn't bet)
Seat 7: matiko09 folded before Flop (didn't bet)
Seat 8: Spid1 folded before Flop (didn't bet)





PokerStars Hand #152883803906:  Hold'em No Limit ($0.50/$1.00 USD) - 2016/05/05 15:30:38 CET [2016/05/05 9:30:38 ET]
Table 'Kacivelia II' 9-max Seat #5 is the button
Seat 1: Spid1 ($111.42 in chips) 
Seat 2: thecurv ($110.88 in chips) 
Seat 3: 50CandyJoe ($101.50 in chips) 
Seat 4: matiko09 ($100 in chips) 
Seat 5: Painkiller72 ($120.72 in chips) 
Seat 6: kop7777 ($83.02 in chips) 
Seat 7: KovIFish89 ($100 in chips) 
Seat 8: sanpidk ($101.50 in chips) 
Seat 9: ipashutapkom ($98.50 in chips) 
kop7777: posts small blind $0.50
KovIFish89: posts big blind $1
*** HOLE CARDS ***
Dealt to matiko09 [Tc Ac]
sanpidk: raises $1.50 to $2.50
ipashutapkom: folds 
Spid1: folds 
thecurv: folds 
50CandyJoe: folds 
matiko09: folds 
Painkiller72: folds 
kop7777: folds 
KovIFish89: folds 
Uncalled bet ($1.50) returned to sanpidk
sanpidk collected $2.50 from pot
sanpidk: doesn't show hand 
*** SUMMARY ***
Total pot $2.50 | Rake $0 
Seat 1: Spid1 folded before Flop (didn't bet)
Seat 2: thecurv folded before Flop (didn't bet)
Seat 3: 50CandyJoe folded before Flop (didn't bet)
Seat 4: matiko09 folded before Flop (didn't bet)
Seat 5: Painkiller72 (button) folded before Flop (didn't bet)
Seat 6: kop7777 (small blind) folded before Flop
Seat 7: KovIFish89 (big blind) folded before Flop
Seat 8: sanpidk collected ($2.50)
Seat 9: ipashutapkom folded before Flop (didn't bet)





PokerStars Hand #152883807692:  Hold'em No Limit ($0.50/$1.00 USD) - 2016/05/05 15:30:44 CET [2016/05/05 9:30:44 ET]
Table 'Priska II' 9-max Seat #7 is the button
Seat 1: Spid1 ($100 in chips) 
Seat 2: Kukuryzka ($100 in chips) 
Seat 3: matiko09 ($100 in chips) 
Seat 4: Painkiller72 ($170.66 in chips) 
Seat 5: nickreason17 ($126.50 in chips) 
Seat 6: OneTwo81 ($101.95 in chips) 
Seat 7: stockbridge8 ($96.57 in chips) 
Seat 8: pohorc21 ($72.53 in chips) 
Seat 9: torkkdnm ($101.55 in chips) 
pohorc21: posts small blind $0.50
torkkdnm: posts big blind $1
*** HOLE CARDS ***
Dealt to matiko09 [3c 8d]
Spid1: folds 
Kukuryzka: folds 
matiko09: folds 
Painkiller72: folds 
nickreason17: folds 
OneTwo81: calls $1
stockbridge8: raises $2 to $3
pohorc21: calls $2.50
torkkdnm: folds 
OneTwo81: folds 
*** FLOP *** [Kh Td 6s]
pohorc21: bets $4
stockbridge8: calls $4
*** TURN *** [Kh Td 6s] [Qh]
pohorc21: checks 
stockbridge8: bets $7.60
pohorc21: folds 
Uncalled bet ($7.60) returned to stockbridge8
stockbridge8 collected $15.20 from pot
stockbridge8: doesn't show hand 
*** SUMMARY ***
Total pot $16 | Rake $0.80 
Board [Kh Td 6s Qh]
Seat 1: Spid1 folded before Flop (didn't bet)
Seat 2: Kukuryzka folded before Flop (didn't bet)
Seat 3: matiko09 folded before Flop (didn't bet)
Seat 4: Painkiller72 folded before Flop (didn't bet)
Seat 5: nickreason17 folded before Flop (didn't bet)
Seat 6: OneTwo81 folded before Flop
Seat 7: stockbridge8 (button) collected ($15.20)
Seat 8: pohorc21 (small blind) folded on the Turn
Seat 9: torkkdnm (big blind) folded before Flop





PokerStars Hand #152883812811:  Hold'em No Limit (€1/€2 EUR) - 2016/05/05 15:30:53 CET [2016/05/05 9:30:53 ET]
Table 'Bessel II' 9-max Seat #8 is the button
Seat 1: Soloaces224 (€168.19 in chips) 
Seat 2: Fitzyferret (€292.70 in chips) 
Seat 3: IseeUcards (€564.93 in chips) 
Seat 5: Painkiller72 (€274.50 in chips) 
Seat 6: Spid1 (€200 in chips) 
Seat 7: matiko09 (€200 in chips) 
Seat 8: KovIFish89 (€200 in chips) 
Soloaces224: posts small blind €1
Fitzyferret: posts big blind €2
*** HOLE CARDS ***
Dealt to matiko09 [Js 6c]
IseeUcards: folds 
Painkiller72: folds 
Spid1 has timed out
Spid1: folds 
matiko09: folds 
KovIFish89: raises €2 to €4
Soloaces224: folds 
Fitzyferret: folds 
Uncalled bet (€2) returned to KovIFish89
KovIFish89 collected €5 from pot
KovIFish89: doesn't show hand 
*** SUMMARY ***
Total pot €5 | Rake €0 
Seat 1: Soloaces224 (small blind) folded before Flop
Seat 2: Fitzyferret (big blind) folded before Flop
Seat 3: IseeUcards folded before Flop (didn't bet)
Seat 5: Painkiller72 folded before Flop (didn't bet)
Seat 6: Spid1 folded before Flop (didn't bet)
Seat 7: matiko09 folded before Flop (didn't bet)
Seat 8: KovIFish89 (button) collected (€5)





PokerStars Hand #152883816708:  Hold'em No Limit ($0.50/$1.00 USD) - 2016/05/05 15:31:00 CET [2016/05/05 9:31:00 ET]
Table 'Chimaera II' 9-max Seat #4 is the button
Seat 2: Spid1 ($100 in chips) 
Seat 3: matiko09 ($100 in chips) 
Seat 4: RiverJazz ($108.78 in chips) 
Seat 5: Butchers31 ($107.58 in chips) 
Seat 6: Painkiller72 ($110.62 in chips) 
Seat 7: Hypoaroused ($198.86 in chips) 
Seat 9: kamillo91 ($74.78 in chips) 
Butchers31: posts small blind $0.50
Painkiller72: posts big blind $1
Dantist1122: sits out 
*** HOLE CARDS ***
Dealt to matiko09 [As 2d]
Hypoaroused: folds 
kamillo91: folds 
Spid1: folds 
matiko09: folds 
RiverJazz: raises $1.50 to $2.50
Butchers31: folds 
Painkiller72: folds 
Uncalled bet ($1.50) returned to RiverJazz
RiverJazz collected $2.50 from pot
RiverJazz: doesn't show hand 
*** SUMMARY ***
Total pot $2.50 | Rake $0 
Seat 2: Spid1 folded before Flop (didn't bet)
Seat 3: matiko09 folded before Flop (didn't bet)
Seat 4: RiverJazz (button) collected ($2.50)
Seat 5: Butchers31 (small blind) folded before Flop
Seat 6: Painkiller72 (big blind) folded before Flop
Seat 7: Hypoaroused folded before Flop (didn't bet)
Seat 9: kamillo91 folded before Flop (didn't bet)





PokerStars Hand #152883822202:  Hold'em No Limit ($0.50/$1.00 USD) - 2016/05/05 15:31:10 CET [2016/05/05 9:31:10 ET]
Table 'Kacivelia II' 9-max Seat #6 is the button
Seat 1: Spid1 ($111.42 in chips) 
Seat 2: thecurv ($110.88 in chips) 
Seat 3: 50CandyJoe ($101.50 in chips) 
Seat 4: matiko09 ($100 in chips) 
Seat 5: Painkiller72 ($120.72 in chips) 
Seat 6: kop7777 ($82.52 in chips) 
Seat 7: KovIFish89 ($100 in chips) 
Seat 8: sanpidk ($103 in chips) 
Seat 9: ipashutapkom ($98.50 in chips) 
KovIFish89: posts small blind $0.50
sanpidk: posts big blind $1
*** HOLE CARDS ***
Dealt to matiko09 [6c 4h]
ipashutapkom: folds 
Spid1: raises $2 to $3
thecurv: folds 
50CandyJoe: folds 
matiko09: folds 
Painkiller72: folds 
kop7777: calls $3
KovIFish89: calls $2.50
sanpidk: calls $2
*** FLOP *** [7d 7c 3h]
KovIFish89: checks 
sanpidk: checks 
Spid1: checks 
kop7777: checks 
*** TURN *** [7d 7c 3h] [3s]
KovIFish89: checks 
sanpidk: checks 
Spid1: checks 
kop7777: checks 
*** RIVER *** [7d 7c 3h 3s] [2h]
KovIFish89: checks 
sanpidk: checks 
Spid1: checks 
kop7777: checks 
*** SHOW DOWN ***
KovIFish89: shows [2d 2c] (a full house, Deuces full of Sevens)
sanpidk: mucks hand 
Spid1: mucks hand 
kop7777: mucks hand 
KovIFish89 collected $11.40 from pot
*** SUMMARY ***
Total pot $12 | Rake $0.60 
Board [7d 7c 3h 3s 2h]
Seat 1: Spid1 mucked [9d 8d]
Seat 2: thecurv folded before Flop (didn't bet)
Seat 3: 50CandyJoe folded before Flop (didn't bet)
Seat 4: matiko09 folded before Flop (didn't bet)
Seat 5: Painkiller72 folded before Flop (didn't bet)
Seat 6: kop7777 (button) mucked [9h Jd]
Seat 7: KovIFish89 (small blind) showed [2d 2c] and won ($11.40) with a full house, Deuces full of Sevens
Seat 8: sanpidk (big blind) mucked [Js As]
Seat 9: ipashutapkom folded before Flop (didn't bet)





PokerStars Hand #152883825254:  Hold'em No Limit ($1/$2 USD) - 2016/05/05 15:31:15 CET [2016/05/05 9:31:15 ET]
Table 'Lundia' 9-max Seat #1 is the button
Seat 1: Fitzyferret ($218.82 in chips) 
Seat 2: patpaty ($166.60 in chips) 
Seat 3: IseeUcards ($416.77 in chips) 
Seat 6: Spid1 ($245.74 in chips) 
Seat 7: matiko09 ($210 in chips) 
Seat 8: Durnichka ($74 in chips) 
Seat 9: gabi_igna ($208.06 in chips) 
patpaty: posts small blind $1
IseeUcards: posts big blind $2
KovIFish89: sits out 
*** HOLE CARDS ***
Dealt to matiko09 [Th 4s]
Spid1: raises $4 to $6
matiko09: folds 
Durnichka: folds 
gabi_igna: folds 
Fitzyferret: folds 
patpaty: folds 
IseeUcards: folds 
Uncalled bet ($4) returned to Spid1
Spid1 collected $5 from pot
Spid1: doesn't show hand 
*** SUMMARY ***
Total pot $5 | Rake $0 
Seat 1: Fitzyferret (button) folded before Flop (didn't bet)
Seat 2: patpaty (small blind) folded before Flop
Seat 3: IseeUcards (big blind) folded before Flop
Seat 6: Spid1 collected ($5)
Seat 7: matiko09 folded before Flop (didn't bet)
Seat 8: Durnichka folded before Flop (didn't bet)
Seat 9: gabi_igna folded before Flop (didn't bet)





PokerStars Hand #152883826969:  Hold'em No Limit ($0.50/$1.00 USD) - 2016/05/05 15:31:18 CET [2016/05/05 9:31:18 ET]
Table 'Lictoria II' 9-max Seat #2 is the button
Seat 1: St.LaCoste ($108 in chips) 
Seat 2: Dantist1122 ($122.96 in chips) 
Seat 3: Krinica2009 ($100.50 in chips) 
Seat 4: Ying59 ($45.15 in chips) 
Seat 5: sanpidk ($107.25 in chips) 
Seat 6: gabi_igna ($116.22 in chips) 
Seat 7: Painkiller72 ($201.80 in chips) 
Seat 8: matiko09 ($100 in chips) 
Seat 9: Kukuryzka ($125.15 in chips) 
Krinica2009: posts small blind $0.50
Ying59: posts big blind $1
*** HOLE CARDS ***
Dealt to matiko09 [Qs 6d]
sanpidk: folds 
gabi_igna: raises $2 to $3
Painkiller72: folds 
matiko09: folds 
Kukuryzka: folds 
St.LaCoste: folds 
Dantist1122: folds 
Krinica2009: calls $2.50
Ying59: folds 
*** FLOP *** [8h 5c 2s]
Krinica2009: checks 
gabi_igna: checks 
*** TURN *** [8h 5c 2s] [9c]
Krinica2009: bets $4
gabi_igna: calls $4
*** RIVER *** [8h 5c 2s 9c] [3s]
Krinica2009: checks 
gabi_igna: checks 
*** SHOW DOWN ***
Krinica2009: shows [Kd 7d] (high card King)
gabi_igna: shows [Kc As] (high card Ace)
gabi_igna collected $14.25 from pot
*** SUMMARY ***
Total pot $15 | Rake $0.75 
Board [8h 5c 2s 9c 3s]
Seat 1: St.LaCoste folded before Flop (didn't bet)
Seat 2: Dantist1122 (button) folded before Flop (didn't bet)
Seat 3: Krinica2009 (small blind) showed [Kd 7d] and lost with high card King
Seat 4: Ying59 (big blind) folded before Flop
Seat 5: sanpidk folded before Flop (didn't bet)
Seat 6: gabi_igna showed [Kc As] and won ($14.25) with high card Ace
Seat 7: Painkiller72 folded before Flop (didn't bet)
Seat 8: matiko09 folded before Flop (didn't bet)
Seat 9: Kukuryzka folded before Flop (didn't bet)





PokerStars Hand #152883830750:  Hold'em No Limit ($1/$2 USD) - 2016/05/05 15:31:25 CET [2016/05/05 9:31:25 ET]
Table 'Samitchell' 9-max Seat #9 is the button
Seat 2: 13Ghosts ($211.56 in chips) 
Seat 3: gabi_igna ($375.77 in chips) 
Seat 4: Fitzyferret ($390.97 in chips) 
Seat 5: Spid1 ($200 in chips) 
Seat 6: matiko09 ($201.43 in chips) 
Seat 7: patpaty ($154.30 in chips) 
Seat 9: IseeUcards ($257.63 in chips) 
KovIFish89 will be allowed to play after the button
13Ghosts: posts small blind $1
gabi_igna: posts big blind $2
Kukuryzka: sits out 
*** HOLE CARDS ***
Dealt to matiko09 [7d 2h]
Fitzyferret: folds 
Kukuryzka leaves the table
Spid1: folds 
matiko09: folds 
patpaty: calls $2
IseeUcards: folds 
13Ghosts: folds 
gabi_igna: checks 
*** FLOP *** [Qh Td 5h]
gabi_igna: checks 
patpaty: bets $2
gabi_igna: calls $2
*** TURN *** [Qh Td 5h] [8s]
gabi_igna: checks 
patpaty: checks 
*** RIVER *** [Qh Td 5h 8s] [4s]
Hex0gen joins the table at seat #8 
gabi_igna: checks 
patpaty: checks 
*** SHOW DOWN ***
gabi_igna: shows [Kh Ts] (a pair of Tens)
patpaty: mucks hand 
gabi_igna collected $8.55 from pot
*** SUMMARY ***
Total pot $9 | Rake $0.45 
Board [Qh Td 5h 8s 4s]
Seat 2: 13Ghosts (small blind) folded before Flop
Seat 3: gabi_igna (big blind) showed [Kh Ts] and won ($8.55) with a pair of Tens
Seat 4: Fitzyferret folded before Flop (didn't bet)
Seat 5: Spid1 folded before Flop (didn't bet)
Seat 6: matiko09 folded before Flop (didn't bet)
Seat 7: patpaty mucked [Ah 4c]
Seat 9: IseeUcards (button) folded before Flop (didn't bet)





PokerStars Hand #152883834490:  Hold'em No Limit (€1/€2 EUR) - 2016/05/05 15:31:32 CET [2016/05/05 9:31:32 ET]
Table 'Bessel II' 9-max Seat #1 is the button
Seat 1: Soloaces224 (€167.19 in chips) 
Seat 2: Fitzyferret (€290.70 in chips) 
Seat 3: IseeUcards (€564.93 in chips) 
Seat 5: Painkiller72 (€274.50 in chips) 
Seat 7: matiko09 (€200 in chips) 
Seat 8: KovIFish89 (€203 in chips) 
Fitzyferret: posts small blind €1
IseeUcards: posts big blind €2
*** HOLE CARDS ***
Dealt to matiko09 [Jc 5d]
Painkiller72: folds 
matiko09: folds 
KovIFish89: raises €3 to €5
Soloaces224: folds 
Fitzyferret: folds 
IseeUcards: folds 
Uncalled bet (€3) returned to KovIFish89
KovIFish89 collected €5 from pot
KovIFish89: doesn't show hand 
*** SUMMARY ***
Total pot €5 | Rake €0 
Seat 1: Soloaces224 (button) folded before Flop (didn't bet)
Seat 2: Fitzyferret (small blind) folded before Flop
Seat 3: IseeUcards (big blind) folded before Flop
Seat 5: Painkiller72 folded before Flop (didn't bet)
Seat 7: matiko09 folded before Flop (didn't bet)
Seat 8: KovIFish89 collected (€5)





PokerStars Hand #152883837543:  Hold'em No Limit ($0.50/$1.00 USD) - 2016/05/05 15:31:37 CET [2016/05/05 9:31:37 ET]
Table 'Priska II' 9-max Seat #8 is the button
Seat 1: Spid1 ($100 in chips) 
Seat 2: Kukuryzka ($100 in chips) 
Seat 3: matiko09 ($100 in chips) 
Seat 4: Painkiller72 ($170.66 in chips) 
Seat 5: nickreason17 ($126.50 in chips) 
Seat 6: OneTwo81 ($100.95 in chips) 
Seat 7: stockbridge8 ($104.77 in chips) 
Seat 8: pohorc21 ($65.53 in chips) 
Seat 9: torkkdnm ($100.55 in chips) 
torkkdnm: posts small blind $0.50
Spid1: posts big blind $1
*** HOLE CARDS ***
Dealt to matiko09 [Jh 9d]
Kukuryzka: folds 
matiko09: folds 
Painkiller72: folds 
nickreason17: raises $1.50 to $2.50
OneTwo81: folds 
stockbridge8: folds 
pohorc21: calls $2.50
torkkdnm: folds 
Spid1: folds 
*** FLOP *** [Qh 4h 7c]
nickreason17: bets $3.25
pohorc21: folds 
Uncalled bet ($3.25) returned to nickreason17
nickreason17 collected $6.18 from pot
*** SUMMARY ***
Total pot $6.50 | Rake $0.32 
Board [Qh 4h 7c]
Seat 1: Spid1 (big blind) folded before Flop
Seat 2: Kukuryzka folded before Flop (didn't bet)
Seat 3: matiko09 folded before Flop (didn't bet)
Seat 4: Painkiller72 folded before Flop (didn't bet)
Seat 5: nickreason17 collected ($6.18)
Seat 6: OneTwo81 folded before Flop (didn't bet)
Seat 7: stockbridge8 folded before Flop (didn't bet)
Seat 8: pohorc21 (button) folded on the Flop
Seat 9: torkkdnm (small blind) folded before Flop





PokerStars Hand #152883844141:  Hold'em No Limit ($0.50/$1.00 USD) - 2016/05/05 15:31:49 CET [2016/05/05 9:31:49 ET]
Table 'Natascha' 9-max Seat #3 is the button
Seat 1: ronald3737 ($87.90 in chips) 
Seat 2: matiko09 ($138.25 in chips) 
Seat 3: bjonlyking ($143.50 in chips) 
Seat 5: Dickyxxx ($132.26 in chips) 
Seat 6: gabi_igna ($153.44 in chips) 
Seat 7: torkkdnm ($147.46 in chips) 
Seat 8: kamillo91 ($77.50 in chips) 
Seat 9: guoweiAA ($236.20 in chips) 
sanpidk will be allowed to play after the button
Dickyxxx: posts small blind $0.50
gabi_igna: posts big blind $1
*** HOLE CARDS ***
Dealt to matiko09 [Qh Jc]
torkkdnm: folds 
kamillo91: folds 
guoweiAA: folds 
ronald3737: folds 
matiko09: raises $1.50 to $2.50
bjonlyking: folds 
Dickyxxx: folds 
gabi_igna: folds 
Uncalled bet ($1.50) returned to matiko09
matiko09 collected $2.50 from pot
matiko09: doesn't show hand 
*** SUMMARY ***
Total pot $2.50 | Rake $0 
Seat 1: ronald3737 folded before Flop (didn't bet)
Seat 2: matiko09 collected ($2.50)
Seat 3: bjonlyking (button) folded before Flop (didn't bet)
Seat 5: Dickyxxx (small blind) folded before Flop
Seat 6: gabi_igna (big blind) folded before Flop
Seat 7: torkkdnm folded before Flop (didn't bet)
Seat 8: kamillo91 folded before Flop (didn't bet)
Seat 9: guoweiAA folded before Flop (didn't bet)





PokerStars Hand #152883847547:  Hold'em No Limit ($0.50/$1.00 USD) - 2016/05/05 15:31:55 CET [2016/05/05 9:31:55 ET]
Table 'Chimaera II' 9-max Seat #5 is the button
Seat 2: Spid1 ($100 in chips) 
Seat 3: matiko09 ($100 in chips) 
Seat 4: RiverJazz ($110.28 in chips) 
Seat 5: Butchers31 ($107.08 in chips) 
Seat 6: Painkiller72 ($109.62 in chips) 
Seat 7: Hypoaroused ($198.86 in chips) 
Seat 9: kamillo91 ($74.78 in chips) 
Painkiller72: posts small blind $0.50
Hypoaroused: posts big blind $1
Dantist1122: sits out 
*** HOLE CARDS ***
Dealt to matiko09 [2s 5d]
kamillo91: folds 
Spid1: folds 
matiko09: folds 
RiverJazz: folds 
Butchers31: raises $1 to $2
Painkiller72: folds 
Hypoaroused: folds 
Uncalled bet ($1) returned to Butchers31
Butchers31 collected $2.50 from pot
Butchers31: doesn't show hand 
*** SUMMARY ***
Total pot $2.50 | Rake $0 
Seat 2: Spid1 folded before Flop (didn't bet)
Seat 3: matiko09 folded before Flop (didn't bet)
Seat 4: RiverJazz folded before Flop (didn't bet)
Seat 5: Butchers31 (button) collected ($2.50)
Seat 6: Painkiller72 (small blind) folded before Flop
Seat 7: Hypoaroused (big blind) folded before Flop
Seat 9: kamillo91 folded before Flop (didn't bet)





PokerStars Hand #152883849682:  Hold'em No Limit ($1/$2 USD) - 2016/05/05 15:31:59 CET [2016/05/05 9:31:59 ET]
Table 'Lundia' 9-max Seat #2 is the button
Seat 1: Fitzyferret ($218.82 in chips) 
Seat 2: patpaty ($165.60 in chips) 
Seat 3: IseeUcards ($414.77 in chips) 
Seat 4: KovIFish89 ($200 in chips) 
Seat 6: Spid1 ($248.74 in chips) 
Seat 7: matiko09 ($210 in chips) 
Seat 8: Durnichka ($74 in chips) 
Seat 9: gabi_igna ($208.06 in chips) 
IseeUcards: posts small blind $1
KovIFish89: posts big blind $2
*** HOLE CARDS ***
Dealt to matiko09 [Ts 4s]
Spid1: folds 
matiko09: folds 
Durnichka: folds 
gabi_igna: folds 
Fitzyferret: raises $2.60 to $4.60
patpaty: folds 
IseeUcards: folds 
KovIFish89: folds 
Uncalled bet ($2.60) returned to Fitzyferret
Fitzyferret collected $5 from pot
Fitzyferret: doesn't show hand 
*** SUMMARY ***
Total pot $5 | Rake $0 
Seat 1: Fitzyferret collected ($5)
Seat 2: patpaty (button) folded before Flop (didn't bet)
Seat 3: IseeUcards (small blind) folded before Flop
Seat 4: KovIFish89 (big blind) folded before Flop
Seat 6: Spid1 folded before Flop (didn't bet)
Seat 7: matiko09 folded before Flop (didn't bet)
Seat 8: Durnichka folded before Flop (didn't bet)
Seat 9: gabi_igna folded before Flop (didn't bet)





PokerStars Hand #152883852217:  Hold'em No Limit ($0.50/$1.00 USD) - 2016/05/05 15:32:03 CET [2016/05/05 9:32:03 ET]
Table 'Pyxis III' 9-max Seat #6 is the button
Seat 1: sanpidk ($130.03 in chips) 
Seat 2: 50CandyJoe ($100 in chips) 
Seat 3: Xxth3nutzxX ($98.50 in chips) 
Seat 4: Sloeve ($119.35 in chips) 
Seat 5: darren1031 ($83.28 in chips) 
Seat 6: kamillo91 ($44 in chips) 
Seat 7: Painkiller72 ($137.78 in chips) 
Seat 8: matiko09 ($100 in chips) 
Seat 9: Hypoaroused ($94.38 in chips) 
Painkiller72: posts small blind $0.50
matiko09: posts big blind $1
*** HOLE CARDS ***
Dealt to matiko09 [Kd 9s]
Hypoaroused: folds 
sanpidk: folds 
50CandyJoe: folds 
Xxth3nutzxX: folds 
Sloeve: folds 
darren1031: folds 
kamillo91: raises $2 to $3
Painkiller72: folds 
matiko09: folds 
Uncalled bet ($2) returned to kamillo91
kamillo91 collected $2.50 from pot
kamillo91: doesn't show hand 
*** SUMMARY ***
Total pot $2.50 | Rake $0 
Seat 1: sanpidk folded before Flop (didn't bet)
Seat 2: 50CandyJoe folded before Flop (didn't bet)
Seat 3: Xxth3nutzxX folded before Flop (didn't bet)
Seat 4: Sloeve folded before Flop (didn't bet)
Seat 5: darren1031 folded before Flop (didn't bet)
Seat 6: kamillo91 (button) collected ($2.50)
Seat 7: Painkiller72 (small blind) folded before Flop
Seat 8: matiko09 (big blind) folded before Flop
Seat 9: Hypoaroused folded before Flop (didn't bet)





PokerStars Hand #152883852134:  Hold'em No Limit ($0.50/$1.00 USD) - 2016/05/05 15:32:03 CET [2016/05/05 9:32:03 ET]
Table 'Priska II' 9-max Seat #9 is the button
Seat 1: Spid1 ($100 in chips) 
Seat 2: Kukuryzka ($100 in chips) 
Seat 3: matiko09 ($100 in chips) 
Seat 4: Painkiller72 ($170.66 in chips) 
Seat 6: OneTwo81 ($100.95 in chips) 
Seat 7: stockbridge8 ($104.77 in chips) 
Seat 8: pohorc21 ($63.03 in chips) 
Seat 9: torkkdnm ($100.05 in chips) 
Spid1: posts small blind $0.50
Kukuryzka: posts big blind $1
*** HOLE CARDS ***
Dealt to matiko09 [Th Kh]
matiko09: raises $2 to $3
Painkiller72: folds 
OneTwo81: folds 
stockbridge8: folds 
pohorc21: calls $3
torkkdnm: folds 
Spid1: folds 
Kukuryzka: folds 
*** FLOP *** [Jh Ts 5c]
matiko09: checks 
pohorc21: checks 
*** TURN *** [Jh Ts 5c] [Ad]
matiko09: checks 
pohorc21: checks 
*** RIVER *** [Jh Ts 5c Ad] [2d]
matiko09: checks 
pohorc21: checks 
*** SHOW DOWN ***
matiko09: shows [Th Kh] (a pair of Tens)
pohorc21: mucks hand 
matiko09 collected $7.12 from pot
*** SUMMARY ***
Total pot $7.50 | Rake $0.38 
Board [Jh Ts 5c Ad 2d]
Seat 1: Spid1 (small blind) folded before Flop
Seat 2: Kukuryzka (big blind) folded before Flop
Seat 3: matiko09 showed [Th Kh] and won ($7.12) with a pair of Tens
Seat 4: Painkiller72 folded before Flop (didn't bet)
Seat 6: OneTwo81 folded before Flop (didn't bet)
Seat 7: stockbridge8 folded before Flop (didn't bet)
Seat 8: pohorc21 mucked [Qc 9s]
Seat 9: torkkdnm (button) folded before Flop (didn't bet)





PokerStars Hand #152883856398:  Hold'em No Limit ($0.50/$1.00 USD) - 2016/05/05 15:32:11 CET [2016/05/05 9:32:11 ET]
Table 'Chimaera II' 9-max Seat #6 is the button
Seat 2: Spid1 ($100 in chips) 
Seat 3: matiko09 ($100 in chips) 
Seat 4: RiverJazz ($110.28 in chips) 
Seat 5: Butchers31 ($108.58 in chips) 
Seat 6: Painkiller72 ($109.12 in chips) 
Seat 7: Hypoaroused ($197.86 in chips) 
Seat 8: Dantist1122 ($100 in chips) 
Seat 9: kamillo91 ($74.78 in chips) 
Hypoaroused: posts small blind $0.50
Dantist1122: posts big blind $1
*** HOLE CARDS ***
Dealt to matiko09 [2h 7s]
kamillo91: folds 
Spid1: folds 
matiko09: folds 
RiverJazz: folds 
Butchers31: folds 
Painkiller72: folds 
Hypoaroused: folds 
Uncalled bet ($0.50) returned to Dantist1122
Dantist1122 collected $1 from pot
Dantist1122: doesn't show hand 
*** SUMMARY ***
Total pot $1 | Rake $0 
Seat 2: Spid1 folded before Flop (didn't bet)
Seat 3: matiko09 folded before Flop (didn't bet)
Seat 4: RiverJazz folded before Flop (didn't bet)
Seat 5: Butchers31 folded before Flop (didn't bet)
Seat 6: Painkiller72 (button) folded before Flop (didn't bet)
Seat 7: Hypoaroused (small blind) folded before Flop
Seat 8: Dantist1122 (big blind) collected ($1)
Seat 9: kamillo91 folded before Flop (didn't bet)





PokerStars Hand #152883860193:  Hold'em No Limit ($0.50/$1.00 USD) - 2016/05/05 15:32:17 CET [2016/05/05 9:32:17 ET]
Table 'Natascha' 9-max Seat #5 is the button
Seat 1: ronald3737 ($87.90 in chips) 
Seat 2: matiko09 ($139.75 in chips) 
Seat 3: bjonlyking ($143.50 in chips) 
Seat 5: Dickyxxx ($131.76 in chips) 
Seat 6: gabi_igna ($152.44 in chips) 
Seat 7: torkkdnm ($147.46 in chips) 
Seat 8: kamillo91 ($77.50 in chips) 
Seat 9: guoweiAA ($236.20 in chips) 
gabi_igna: posts small blind $0.50
torkkdnm: posts big blind $1
sanpidk: sits out 
*** HOLE CARDS ***
Dealt to matiko09 [7h 2s]
kamillo91: folds 
guoweiAA: folds 
ronald3737: raises $1 to $2
matiko09: folds 
bjonlyking is disconnected 
bjonlyking has timed out while disconnected
bjonlyking: folds 
Dickyxxx: folds 
gabi_igna: folds 
torkkdnm: calls $1
*** FLOP *** [3d 5s Ks]
torkkdnm: checks 
ronald3737: checks 
*** TURN *** [3d 5s Ks] [Kh]
torkkdnm: checks 
ronald3737: checks 
*** RIVER *** [3d 5s Ks Kh] [2c]
torkkdnm: checks 
ronald3737: checks 
*** SHOW DOWN ***
torkkdnm: shows [8d Jd] (a pair of Kings)
ronald3737: mucks hand 
torkkdnm collected $4.28 from pot
*** SUMMARY ***
Total pot $4.50 | Rake $0.22 
Board [3d 5s Ks Kh 2c]
Seat 1: ronald3737 mucked [9s Td]
Seat 2: matiko09 folded before Flop (didn't bet)
Seat 3: bjonlyking folded before Flop (didn't bet)
Seat 5: Dickyxxx (button) folded before Flop (didn't bet)
Seat 6: gabi_igna (small blind) folded before Flop
Seat 7: torkkdnm (big blind) showed [8d Jd] and won ($4.28) with a pair of Kings
Seat 8: kamillo91 folded before Flop (didn't bet)
Seat 9: guoweiAA folded before Flop (didn't bet)





PokerStars Hand #152883860383:  Hold'em No Limit ($1/$2 USD) - 2016/05/05 15:32:17 CET [2016/05/05 9:32:17 ET]
Table 'Tololo' 9-max Seat #2 is the button
Seat 1: Kukuryzka ($200 in chips) 
Seat 2: gabi_igna ($294.99 in chips) 
Seat 3: nickreason17 ($223.40 in chips) 
Seat 4: mooose100 ($130.37 in chips) 
Seat 5: matiko09 ($203 in chips) 
Seat 6: Xagua ($132.12 in chips) 
Seat 7: IseeUcards ($201.61 in chips) 
Seat 8: TonnaMunz ($433.57 in chips) 
Seat 9: Fitzyferret ($235.49 in chips) 
nickreason17: posts small blind $1
mooose100: posts big blind $2
*** HOLE CARDS ***
Dealt to matiko09 [8h Td]
matiko09: folds 
Xagua: folds 
IseeUcards: folds 
TonnaMunz: folds 
Fitzyferret: folds 
Kukuryzka: folds 
TonnaMunz said, ";)"
gabi_igna: raises $3 to $5
nickreason17: folds 
mooose100: calls $3
*** FLOP *** [7h 3d Qc]
mooose100: checks 
gabi_igna: bets $6
mooose100: calls $6
*** TURN *** [7h 3d Qc] [9c]
mooose100: checks 
gabi_igna: bets $12
mooose100: calls $12
*** RIVER *** [7h 3d Qc 9c] [9h]
mooose100: checks 
gabi_igna: bets $26
mooose100: calls $26
*** SHOW DOWN ***
gabi_igna: shows [8d 4h] (a pair of Nines)
mooose100: shows [Tc Qs] (two pair, Queens and Nines)
mooose100 collected $96.25 from pot
*** SUMMARY ***
Total pot $99 | Rake $2.75 
Board [7h 3d Qc 9c 9h]
Seat 1: Kukuryzka folded before Flop (didn't bet)
Seat 2: gabi_igna (button) showed [8d 4h] and lost with a pair of Nines
Seat 3: nickreason17 (small blind) folded before Flop
Seat 4: mooose100 (big blind) showed [Tc Qs] and won ($96.25) with two pair, Queens and Nines
Seat 5: matiko09 folded before Flop (didn't bet)
Seat 6: Xagua folded before Flop (didn't bet)
Seat 7: IseeUcards folded before Flop (didn't bet)
Seat 8: TonnaMunz folded before Flop (didn't bet)
Seat 9: Fitzyferret folded before Flop (didn't bet)





PokerStars Hand #152883861001:  Hold'em No Limit ($0.50/$1.00 USD) - 2016/05/05 15:32:18 CET [2016/05/05 9:32:18 ET]
Table 'Lictoria II' 9-max Seat #3 is the button
Seat 1: St.LaCoste ($108 in chips) 
Seat 2: Dantist1122 ($122.96 in chips) 
Seat 3: Krinica2009 ($100 in chips) 
Seat 4: Ying59 ($44.15 in chips) 
Seat 5: sanpidk ($107.25 in chips) 
Seat 6: gabi_igna ($123.47 in chips) 
Seat 7: Painkiller72 ($201.80 in chips) 
Seat 8: matiko09 ($100 in chips) 
Seat 9: Kukuryzka ($125.15 in chips) 
Ying59: posts small blind $0.50
sanpidk: posts big blind $1
*** HOLE CARDS ***
Dealt to matiko09 [9s Qs]
gabi_igna: raises $2 to $3
Painkiller72: folds 
matiko09: folds 
Kukuryzka: folds 
St.LaCoste: folds 
Dantist1122: folds 
Krinica2009: calls $3
Ying59: folds 
sanpidk: folds 
*** FLOP *** [Kh 9c 9h]
gabi_igna: bets $4
Krinica2009: folds 
Uncalled bet ($4) returned to gabi_igna
gabi_igna collected $7.12 from pot
gabi_igna: doesn't show hand 
*** SUMMARY ***
Total pot $7.50 | Rake $0.38 
Board [Kh 9c 9h]
Seat 1: St.LaCoste folded before Flop (didn't bet)
Seat 2: Dantist1122 folded before Flop (didn't bet)
Seat 3: Krinica2009 (button) folded on the Flop
Seat 4: Ying59 (small blind) folded before Flop
Seat 5: sanpidk (big blind) folded before Flop
Seat 6: gabi_igna collected ($7.12)
Seat 7: Painkiller72 folded before Flop (didn't bet)
Seat 8: matiko09 folded before Flop (didn't bet)
Seat 9: Kukuryzka folded before Flop (didn't bet)





PokerStars Hand #152883864936:  Hold'em No Limit ($1/$2 USD) - 2016/05/05 15:32:25 CET [2016/05/05 9:32:25 ET]
Table 'Samitchell' 9-max Seat #2 is the button
Seat 2: 13Ghosts ($210.56 in chips) 
Seat 3: gabi_igna ($380.32 in chips) 
Seat 4: Fitzyferret ($390.97 in chips) 
Seat 5: Spid1 ($200 in chips) 
Seat 6: matiko09 ($201.43 in chips) 
Seat 7: patpaty ($150.30 in chips) 
Seat 9: IseeUcards ($257.63 in chips) 
gabi_igna: posts small blind $1
Fitzyferret: posts big blind $2
Hex0gen: sits out 
KovIFish89: sits out 
*** HOLE CARDS ***
Dealt to matiko09 [As 4h]
Spid1: folds 
matiko09: folds 
patpaty: folds 
IseeUcards: folds 
13Ghosts: raises $2.78 to $4.78
gabi_igna: raises $13.22 to $18
Fitzyferret: folds 
13Ghosts: calls $13.22
*** FLOP *** [5s Qc 4d]
gabi_igna: bets $20
13Ghosts: calls $20
*** TURN *** [5s Qc 4d] [3h]
gabi_igna: bets $44
13Ghosts: calls $44
*** RIVER *** [5s Qc 4d 3h] [5d]
gabi_igna: checks 
13Ghosts: checks 
*** SHOW DOWN ***
gabi_igna: shows [Js Ad] (a pair of Fives)
13Ghosts: shows [7d 7c] (two pair, Sevens and Fives)
13Ghosts collected $163.25 from pot
*** SUMMARY ***
Total pot $166 | Rake $2.75 
Board [5s Qc 4d 3h 5d]
Seat 2: 13Ghosts (button) showed [7d 7c] and won ($163.25) with two pair, Sevens and Fives
Seat 3: gabi_igna (small blind) showed [Js Ad] and lost with a pair of Fives
Seat 4: Fitzyferret (big blind) folded before Flop
Seat 5: Spid1 folded before Flop (didn't bet)
Seat 6: matiko09 folded before Flop (didn't bet)
Seat 7: patpaty folded before Flop (didn't bet)
Seat 9: IseeUcards folded before Flop (didn't bet)





PokerStars Hand #152883867887:  Hold'em No Limit ($1/$2 USD) - 2016/05/05 15:32:31 CET [2016/05/05 9:32:31 ET]
Table 'Lundia' 9-max Seat #3 is the button
Seat 1: Fitzyferret ($221.82 in chips) 
Seat 2: patpaty ($165.60 in chips) 
Seat 3: IseeUcards ($413.77 in chips) 
Seat 4: KovIFish89 ($200 in chips) 
Seat 6: Spid1 ($248.74 in chips) 
Seat 7: matiko09 ($210 in chips) 
Seat 8: Durnichka ($74 in chips) 
Seat 9: gabi_igna ($208.06 in chips) 
KovIFish89: posts small blind $1
Spid1: posts big blind $2
*** HOLE CARDS ***
Dealt to matiko09 [8h 3d]
matiko09: folds 
Durnichka: raises $3 to $5
gabi_igna: folds 
Fitzyferret: folds 
patpaty: folds 
IseeUcards: folds 
KovIFish89: folds 
Spid1: folds 
Uncalled bet ($3) returned to Durnichka
Durnichka collected $5 from pot
Durnichka: doesn't show hand 
*** SUMMARY ***
Total pot $5 | Rake $0 
Seat 1: Fitzyferret folded before Flop (didn't bet)
Seat 2: patpaty folded before Flop (didn't bet)
Seat 3: IseeUcards (button) folded before Flop (didn't bet)
Seat 4: KovIFish89 (small blind) folded before Flop
Seat 6: Spid1 (big blind) folded before Flop
Seat 7: matiko09 folded before Flop (didn't bet)
Seat 8: Durnichka collected ($5)
Seat 9: gabi_igna folded before Flop (didn't bet)





PokerStars Hand #152883870022:  Hold'em No Limit ($0.50/$1.00 USD) - 2016/05/05 15:32:34 CET [2016/05/05 9:32:34 ET]
Table 'Chimaera II' 9-max Seat #7 is the button
Seat 2: Spid1 ($100 in chips) 
Seat 3: matiko09 ($100 in chips) 
Seat 4: RiverJazz ($110.28 in chips) 
Seat 5: Butchers31 ($108.58 in chips) 
Seat 6: Painkiller72 ($109.12 in chips) 
Seat 7: Hypoaroused ($197.36 in chips) 
Seat 8: Dantist1122 ($100.50 in chips) 
Seat 9: kamillo91 ($74.78 in chips) 
Dantist1122: posts small blind $0.50
kamillo91: posts big blind $1
*** HOLE CARDS ***
Dealt to matiko09 [Th 8d]
Spid1: folds 
matiko09: folds 
RiverJazz: folds 
Butchers31: folds 
Painkiller72: raises $1.50 to $2.50
Hypoaroused: folds 
Dantist1122: folds 
kamillo91: folds 
Uncalled bet ($1.50) returned to Painkiller72
Painkiller72 collected $2.50 from pot
Painkiller72: doesn't show hand 
*** SUMMARY ***
Total pot $2.50 | Rake $0 
Seat 2: Spid1 folded before Flop (didn't bet)
Seat 3: matiko09 folded before Flop (didn't bet)
Seat 4: RiverJazz folded before Flop (didn't bet)
Seat 5: Butchers31 folded before Flop (didn't bet)
Seat 6: Painkiller72 collected ($2.50)
Seat 7: Hypoaroused (button) folded before Flop (didn't bet)
Seat 8: Dantist1122 (small blind) folded before Flop
Seat 9: kamillo91 (big blind) folded before Flop





PokerStars Hand #152883869867:  Hold'em No Limit ($0.50/$1.00 USD) - 2016/05/05 15:32:34 CET [2016/05/05 9:32:34 ET]
Table 'Belisana' 9-max Seat #3 is the button
Seat 1: djammusic ($122.34 in chips) 
Seat 2: ipashutapkom ($247.73 in chips) 
Seat 3: Dickyxxx ($100 in chips) 
Seat 4: Kukuryzka ($107.62 in chips) 
Seat 7: matiko09 ($112.32 in chips) 
Seat 8: Spid1 ($135.76 in chips) 
Kukuryzka: posts small blind $0.50
nickreason17: is sitting out 
ihami: is sitting out 
matiko09: posts big blind $1
*** HOLE CARDS ***
Dealt to matiko09 [Qh 3h]
Spid1: folds 
djammusic: folds 
ipashutapkom: folds 
Dickyxxx: folds 
Kukuryzka: raises $1.50 to $2.50
matiko09: folds 
Uncalled bet ($1.50) returned to Kukuryzka
Kukuryzka collected $2 from pot
Kukuryzka: doesn't show hand 
*** SUMMARY ***
Total pot $2 | Rake $0 
Seat 1: djammusic folded before Flop (didn't bet)
Seat 2: ipashutapkom folded before Flop (didn't bet)
Seat 3: Dickyxxx (button) folded before Flop (didn't bet)
Seat 4: Kukuryzka (small blind) collected ($2)
Seat 7: matiko09 (big blind) folded before Flop
Seat 8: Spid1 folded before Flop (didn't bet)





PokerStars Hand #152883873212:  Hold'em No Limit ($0.50/$1.00 USD) - 2016/05/05 15:32:40 CET [2016/05/05 9:32:40 ET]
Table 'Pyxis III' 9-max Seat #7 is the button
Seat 1: sanpidk ($130.03 in chips) 
Seat 2: 50CandyJoe ($100 in chips) 
Seat 3: Xxth3nutzxX ($98.50 in chips) 
Seat 4: Sloeve ($119.35 in chips) 
Seat 5: darren1031 ($83.28 in chips) 
Seat 6: kamillo91 ($45.50 in chips) 
Seat 7: Painkiller72 ($137.28 in chips) 
Seat 8: matiko09 ($100 in chips) 
Seat 9: Hypoaroused ($94.38 in chips) 
matiko09: posts small blind $0.50
Hypoaroused: posts big blind $1
*** HOLE CARDS ***
Dealt to matiko09 [5d 6h]
sanpidk: raises $2 to $3
50CandyJoe: folds 
Xxth3nutzxX: folds 
Sloeve: calls $3
darren1031: folds 
kamillo91: calls $3
Painkiller72: folds 
matiko09: folds 
Hypoaroused: calls $2
*** FLOP *** [9d Qs As]
Hypoaroused: checks 
sanpidk: checks 
Sloeve: checks 
kamillo91: bets $4
Hypoaroused: folds 
sanpidk: calls $4
Sloeve: folds 
*** TURN *** [9d Qs As] [Qd]
sanpidk: checks 
kamillo91: bets $8
sanpidk: raises $115.03 to $123.03 and is all-in
kamillo91: calls $30.50 and is all-in
Uncalled bet ($84.53) returned to sanpidk
*** RIVER *** [9d Qs As Qd] [Ks]
*** SHOW DOWN ***
sanpidk: shows [Jc Qh] (three of a kind, Queens)
kamillo91: shows [Jd Qc] (three of a kind, Queens)
sanpidk collected $47.50 from pot
kamillo91 collected $47.50 from pot
*** SUMMARY ***
Total pot $97.50 | Rake $2.50 
Board [9d Qs As Qd Ks]
Seat 1: sanpidk showed [Jc Qh] and won ($47.50) with three of a kind, Queens
Seat 2: 50CandyJoe folded before Flop (didn't bet)
Seat 3: Xxth3nutzxX folded before Flop (didn't bet)
Seat 4: Sloeve folded on the Flop
Seat 5: darren1031 folded before Flop (didn't bet)
Seat 6: kamillo91 showed [Jd Qc] and won ($47.50) with three of a kind, Queens
Seat 7: Painkiller72 (button) folded before Flop (didn't bet)
Seat 8: matiko09 (small blind) folded before Flop
Seat 9: Hypoaroused (big blind) folded on the Flop





PokerStars Hand #152883878332:  Hold'em No Limit ($0.50/$1.00 USD) - 2016/05/05 15:32:49 CET [2016/05/05 9:32:49 ET]
Table 'Priska II' 9-max Seat #1 is the button
Seat 1: Spid1 ($100 in chips) 
Seat 2: Kukuryzka ($99 in chips) 
Seat 3: matiko09 ($104.12 in chips) 
Seat 4: Painkiller72 ($170.66 in chips) 
Seat 5: nickreason17 ($130.18 in chips) 
Seat 6: OneTwo81 ($100.95 in chips) 
Seat 7: stockbridge8 ($104.77 in chips) 
Seat 8: pohorc21 ($60.03 in chips) 
Seat 9: torkkdnm ($100.05 in chips) 
Kukuryzka: posts small blind $0.50
matiko09: posts big blind $1
*** HOLE CARDS ***
Dealt to matiko09 [Kc 3d]
Painkiller72: folds 
nickreason17: folds 
OneTwo81: folds 
stockbridge8: raises $2 to $3
pohorc21: folds 
torkkdnm: folds 
Spid1: folds 
Kukuryzka: folds 
matiko09: folds 
Uncalled bet ($2) returned to stockbridge8
stockbridge8 collected $2.50 from pot
stockbridge8: doesn't show hand 
*** SUMMARY ***
Total pot $2.50 | Rake $0 
Seat 1: Spid1 (button) folded before Flop (didn't bet)
Seat 2: Kukuryzka (small blind) folded before Flop
Seat 3: matiko09 (big blind) folded before Flop
Seat 4: Painkiller72 folded before Flop (didn't bet)
Seat 5: nickreason17 folded before Flop (didn't bet)
Seat 6: OneTwo81 folded before Flop (didn't bet)
Seat 7: stockbridge8 collected ($2.50)
Seat 8: pohorc21 folded before Flop (didn't bet)
Seat 9: torkkdnm folded before Flop (didn't bet)





PokerStars Hand #152883880681:  Hold'em No Limit ($0.50/$1.00 USD) - 2016/05/05 15:32:53 CET [2016/05/05 9:32:53 ET]
Table 'Lictoria II' 9-max Seat #4 is the button
Seat 1: St.LaCoste ($108 in chips) 
Seat 2: Dantist1122 ($122.96 in chips) 
Seat 3: Krinica2009 ($100 in chips) 
Seat 4: Ying59 ($43.65 in chips) 
Seat 5: sanpidk ($106.25 in chips) 
Seat 6: gabi_igna ($127.59 in chips) 
Seat 7: Painkiller72 ($201.80 in chips) 
Seat 8: matiko09 ($100 in chips) 
Seat 9: Kukuryzka ($125.15 in chips) 
sanpidk: posts small blind $0.50
gabi_igna: posts big blind $1
*** HOLE CARDS ***
Dealt to matiko09 [Tc 2c]
Painkiller72: folds 
matiko09: folds 
Kukuryzka: folds 
St.LaCoste: raises $2 to $3
Dantist1122: folds 
Krinica2009: folds 
Ying59: folds 
sanpidk: folds 
gabi_igna: folds 
Uncalled bet ($2) returned to St.LaCoste
St.LaCoste collected $2.50 from pot
St.LaCoste: doesn't show hand 
*** SUMMARY ***
Total pot $2.50 | Rake $0 
Seat 1: St.LaCoste collected ($2.50)
Seat 2: Dantist1122 folded before Flop (didn't bet)
Seat 3: Krinica2009 folded before Flop (didn't bet)
Seat 4: Ying59 (button) folded before Flop (didn't bet)
Seat 5: sanpidk (small blind) folded before Flop
Seat 6: gabi_igna (big blind) folded before Flop
Seat 7: Painkiller72 folded before Flop (didn't bet)
Seat 8: matiko09 folded before Flop (didn't bet)
Seat 9: Kukuryzka folded before Flop (didn't bet)





PokerStars Hand #152883881826:  Hold'em No Limit ($0.50/$1.00 USD) - 2016/05/05 15:32:55 CET [2016/05/05 9:32:55 ET]
Table 'Belisana' 9-max Seat #4 is the button
Seat 2: ipashutapkom ($247.73 in chips) 
Seat 3: Dickyxxx ($100 in chips) 
Seat 4: Kukuryzka ($108.62 in chips) 
Seat 7: matiko09 ($111.32 in chips) 
matiko09: posts small blind $0.50
Spid1: is sitting out 
djammusic: is sitting out 
ipashutapkom: posts big blind $1
*** HOLE CARDS ***
Dealt to matiko09 [Ad 6h]
Spid1 leaves the table
djammusic leaves the table
Dickyxxx: folds 
gabi_igna joins the table at seat #8 
Kukuryzka: raises $1 to $2
matiko09: folds 
ipashutapkom: folds 
Uncalled bet ($1) returned to Kukuryzka
Kukuryzka collected $2.50 from pot
Kukuryzka: doesn't show hand 
*** SUMMARY ***
Total pot $2.50 | Rake $0 
Seat 2: ipashutapkom (big blind) folded before Flop
Seat 3: Dickyxxx folded before Flop (didn't bet)
Seat 4: Kukuryzka (button) collected ($2.50)
Seat 7: matiko09 (small blind) folded before Flop





PokerStars Hand #152883882318:  Hold'em No Limit ($0.50/$1.00 USD) - 2016/05/05 15:32:56 CET [2016/05/05 9:32:56 ET]
Table 'Chimaera II' 9-max Seat #8 is the button
Seat 3: matiko09 ($100 in chips) 
Seat 4: RiverJazz ($110.28 in chips) 
Seat 5: Butchers31 ($108.58 in chips) 
Seat 6: Painkiller72 ($110.62 in chips) 
Seat 7: Hypoaroused ($197.36 in chips) 
Seat 8: Dantist1122 ($100 in chips) 
Seat 9: kamillo91 ($73.78 in chips) 
kamillo91: posts small blind $0.50
ihami was removed from the table for failing to post
Spid1: is sitting out 
matiko09: posts big blind $1
*** HOLE CARDS ***
Dealt to matiko09 [5c 9c]
Spid1 leaves the table
ipashutapkom joins the table at seat #1 
RiverJazz: folds 
Butchers31: folds 
ipashutapkom leaves the table
Painkiller72: folds 
Hypoaroused: folds 
nickreason17 joins the table at seat #1 
Dantist1122: folds 
kamillo91: folds 
Uncalled bet ($0.50) returned to matiko09
matiko09 collected $1 from pot
matiko09: doesn't show hand 
*** SUMMARY ***
Total pot $1 | Rake $0 
Seat 3: matiko09 (big blind) collected ($1)
Seat 4: RiverJazz folded before Flop (didn't bet)
Seat 5: Butchers31 folded before Flop (didn't bet)
Seat 6: Painkiller72 folded before Flop (didn't bet)
Seat 7: Hypoaroused folded before Flop (didn't bet)
Seat 8: Dantist1122 (button) folded before Flop (didn't bet)
Seat 9: kamillo91 (small blind) folded before Flop





PokerStars Hand #152883887624:  Hold'em No Limit ($0.50/$1.00 USD) - 2016/05/05 15:33:06 CET [2016/05/05 9:33:06 ET]
Table 'Kacivelia II' 9-max Seat #7 is the button
Seat 1: Spid1 ($108.42 in chips) 
Seat 2: thecurv ($110.88 in chips) 
Seat 3: 50CandyJoe ($101.50 in chips) 
Seat 4: matiko09 ($100 in chips) 
Seat 5: Painkiller72 ($120.72 in chips) 
Seat 6: kop7777 ($79.52 in chips) 
Seat 7: KovIFish89 ($108.40 in chips) 
Seat 8: sanpidk ($100 in chips) 
Seat 9: ipashutapkom ($98.50 in chips) 
sanpidk: posts small blind $0.50
ipashutapkom: posts big blind $1
*** HOLE CARDS ***
Dealt to matiko09 [9d 8s]
Spid1: folds 
thecurv: folds 
50CandyJoe: folds 
matiko09: folds 
Painkiller72: folds 
kop7777: folds 
kop7777 leaves the table
Kukuryzka joins the table at seat #6 
KovIFish89: raises $1 to $2
sanpidk: raises $6 to $8
Kukuryzka leaves the table
ipashutapkom: folds 
vrnMike joins the table at seat #6 
vrnMike leaves the table
KovIFish89: calls $6
*** FLOP *** [5s 7h 5c]
sanpidk: bets $10.76
KovIFish89: folds 
Uncalled bet ($10.76) returned to sanpidk
sanpidk collected $16.15 from pot
sanpidk: doesn't show hand 
*** SUMMARY ***
Total pot $17 | Rake $0.85 
Board [5s 7h 5c]
Seat 1: Spid1 folded before Flop (didn't bet)
Seat 2: thecurv folded before Flop (didn't bet)
Seat 3: 50CandyJoe folded before Flop (didn't bet)
Seat 4: matiko09 folded before Flop (didn't bet)
Seat 5: Painkiller72 folded before Flop (didn't bet)
Seat 6: kop7777 folded before Flop (didn't bet)
Seat 7: KovIFish89 (button) folded on the Flop
Seat 8: sanpidk (small blind) collected ($16.15)
Seat 9: ipashutapkom (big blind) folded before Flop





PokerStars Hand #152883891784:  Hold'em No Limit ($0.50/$1.00 USD) - 2016/05/05 15:33:13 CET [2016/05/05 9:33:13 ET]
Table 'Belisana' 9-max Seat #7 is the button
Seat 2: ipashutapkom ($246.73 in chips) 
Seat 3: Dickyxxx ($100 in chips) 
Seat 4: Kukuryzka ($110.12 in chips) 
Seat 7: matiko09 ($110.82 in chips) 
gabi_igna will be allowed to play after the button
ipashutapkom: posts small blind $0.50
Dickyxxx: posts big blind $1
*** HOLE CARDS ***
Dealt to matiko09 [9c 8s]
Kukuryzka: folds 
matiko09: folds 
Kukuryzka leaves the table
sanpidk joins the table at seat #4 
ipashutapkom: folds 
Uncalled bet ($0.50) returned to Dickyxxx
sanpidk leaves the table
Dickyxxx collected $1 from pot
Dickyxxx: doesn't show hand 
*** SUMMARY ***
Total pot $1 | Rake $0 
Seat 2: ipashutapkom (small blind) folded before Flop
Seat 3: Dickyxxx (big blind) collected ($1)
Seat 4: Kukuryzka folded before Flop (didn't bet)
Seat 7: matiko09 (button) folded before Flop (didn't bet)





PokerStars Hand #152883892587:  Hold'em No Limit ($0.50/$1.00 USD) - 2016/05/05 15:33:15 CET [2016/05/05 9:33:15 ET]
Table 'Priska II' 9-max Seat #2 is the button
Seat 1: Spid1 ($100 in chips) 
Seat 2: Kukuryzka ($100 in chips) 
Seat 3: matiko09 ($103.12 in chips) 
Seat 4: Painkiller72 ($170.66 in chips) 
Seat 5: nickreason17 ($130.18 in chips) 
Seat 6: OneTwo81 ($100.95 in chips) 
Seat 7: stockbridge8 ($106.27 in chips) 
Seat 8: pohorc21 ($60.03 in chips) 
Seat 9: torkkdnm ($100.05 in chips) 
matiko09: posts small blind $0.50
Painkiller72: posts big blind $1
*** HOLE CARDS ***
Dealt to matiko09 [8c 3h]
nickreason17: folds 
OneTwo81: calls $1
stockbridge8: folds 
pohorc21: folds 
torkkdnm: raises $4 to $5
Spid1: folds 
Kukuryzka: folds 
matiko09: folds 
Painkiller72: folds 
OneTwo81: folds 
Uncalled bet ($4) returned to torkkdnm
torkkdnm collected $3.50 from pot
*** SUMMARY ***
Total pot $3.50 | Rake $0 
Seat 1: Spid1 folded before Flop (didn't bet)
Seat 2: Kukuryzka (button) folded before Flop (didn't bet)
Seat 3: matiko09 (small blind) folded before Flop
Seat 4: Painkiller72 (big blind) folded before Flop
Seat 5: nickreason17 folded before Flop (didn't bet)
Seat 6: OneTwo81 folded before Flop
Seat 7: stockbridge8 folded before Flop (didn't bet)
Seat 8: pohorc21 folded before Flop (didn't bet)
Seat 9: torkkdnm collected ($3.50)





PokerStars Hand #152883892932:  Hold'em No Limit ($1/$2 USD) - 2016/05/05 15:33:15 CET [2016/05/05 9:33:15 ET]
Table 'Lundia' 9-max Seat #4 is the button
Seat 1: Fitzyferret ($221.82 in chips) 
Seat 2: patpaty ($165.60 in chips) 
Seat 3: IseeUcards ($413.77 in chips) 
Seat 4: KovIFish89 ($200 in chips) 
Seat 6: Spid1 ($246.74 in chips) 
Seat 7: matiko09 ($210 in chips) 
Seat 8: Durnichka ($77 in chips) 
Seat 9: gabi_igna ($208.06 in chips) 
Spid1: posts small blind $1
matiko09: posts big blind $2
*** HOLE CARDS ***
Dealt to matiko09 [8h Kd]
Durnichka: folds 
gabi_igna: folds 
Fitzyferret: folds 
patpaty: folds 
IseeUcards: folds 
KovIFish89: raises $2 to $4
Spid1: folds 
matiko09: calls $2
*** FLOP *** [Ks 7h 7d]
matiko09: checks 
KovIFish89: bets $5
matiko09: calls $5
*** TURN *** [Ks 7h 7d] [4c]
matiko09: checks 
KovIFish89: bets $12.03
matiko09: calls $12.03
*** RIVER *** [Ks 7h 7d 4c] [5s]
matiko09: checks 
KovIFish89: bets $25
matiko09: folds 
Uncalled bet ($25) returned to KovIFish89
KovIFish89 collected $40.91 from pot
KovIFish89: doesn't show hand 
*** SUMMARY ***
Total pot $43.06 | Rake $2.15 
Board [Ks 7h 7d 4c 5s]
Seat 1: Fitzyferret folded before Flop (didn't bet)
Seat 2: patpaty folded before Flop (didn't bet)
Seat 3: IseeUcards folded before Flop (didn't bet)
Seat 4: KovIFish89 (button) collected ($40.91)
Seat 6: Spid1 (small blind) folded before Flop
Seat 7: matiko09 (big blind) folded on the River
Seat 8: Durnichka folded before Flop (didn't bet)
Seat 9: gabi_igna folded before Flop (didn't bet)





PokerStars Hand #152883894047:  Hold'em No Limit ($0.50/$1.00 USD) - 2016/05/05 15:33:17 CET [2016/05/05 9:33:17 ET]
Table 'Lictoria II' 9-max Seat #5 is the button
Seat 1: St.LaCoste ($109.50 in chips) 
Seat 2: Dantist1122 ($122.96 in chips) 
Seat 3: Krinica2009 ($100 in chips) 
Seat 4: Ying59 ($43.65 in chips) 
Seat 5: sanpidk ($105.75 in chips) 
Seat 6: gabi_igna ($126.59 in chips) 
Seat 7: Painkiller72 ($201.80 in chips) 
Seat 8: matiko09 ($100 in chips) 
Seat 9: Kukuryzka ($125.15 in chips) 
gabi_igna: posts small blind $0.50
Painkiller72: posts big blind $1
*** HOLE CARDS ***
Dealt to matiko09 [Qs Kc]
matiko09: folds 
Kukuryzka: folds 
St.LaCoste: folds 
Dantist1122: folds 
Krinica2009: folds 
Ying59: folds 
sanpidk: folds 
gabi_igna: raises $2 to $3
Painkiller72: folds 
Uncalled bet ($2) returned to gabi_igna
gabi_igna collected $2 from pot
gabi_igna: doesn't show hand 
*** SUMMARY ***
Total pot $2 | Rake $0 
Seat 1: St.LaCoste folded before Flop (didn't bet)
Seat 2: Dantist1122 folded before Flop (didn't bet)
Seat 3: Krinica2009 folded before Flop (didn't bet)
Seat 4: Ying59 folded before Flop (didn't bet)
Seat 5: sanpidk (button) folded before Flop (didn't bet)
Seat 6: gabi_igna (small blind) collected ($2)
Seat 7: Painkiller72 (big blind) folded before Flop
Seat 8: matiko09 folded before Flop (didn't bet)
Seat 9: Kukuryzka folded before Flop (didn't bet)





PokerStars Hand #152883903978:  Hold'em No Limit ($1/$2 USD) - 2016/05/05 15:33:35 CET [2016/05/05 9:33:35 ET]
Table 'Tololo' 9-max Seat #3 is the button
Seat 1: Kukuryzka ($200 in chips) 
Seat 2: gabi_igna ($245.99 in chips) 
Seat 3: nickreason17 ($222.40 in chips) 
Seat 4: mooose100 ($177.62 in chips) 
Seat 5: matiko09 ($203 in chips) 
Seat 6: Xagua ($132.12 in chips) 
Seat 7: IseeUcards ($201.61 in chips) 
Seat 8: TonnaMunz ($433.57 in chips) 
Seat 9: Fitzyferret ($235.49 in chips) 
mooose100: posts small blind $1
matiko09: posts big blind $2
*** HOLE CARDS ***
Dealt to matiko09 [Kc Ks]
Xagua: folds 
IseeUcards: folds 
TonnaMunz: folds 
Fitzyferret: folds 
Kukuryzka: raises $4 to $6
gabi_igna: folds 
nickreason17: folds 
mooose100: calls $5
matiko09: raises $18 to $24
Kukuryzka: folds 
mooose100: folds 
Uncalled bet ($18) returned to matiko09
matiko09 collected $18 from pot
matiko09: doesn't show hand 
*** SUMMARY ***
Total pot $18 | Rake $0 
Seat 1: Kukuryzka folded before Flop
Seat 2: gabi_igna folded before Flop (didn't bet)
Seat 3: nickreason17 (button) folded before Flop (didn't bet)
Seat 4: mooose100 (small blind) folded before Flop
Seat 5: matiko09 (big blind) collected ($18)
Seat 6: Xagua folded before Flop (didn't bet)
Seat 7: IseeUcards folded before Flop (didn't bet)
Seat 8: TonnaMunz folded before Flop (didn't bet)
Seat 9: Fitzyferret folded before Flop (didn't bet)





PokerStars Hand #152883906170:  Hold'em No Limit ($0.50/$1.00 USD) - 2016/05/05 15:33:39 CET [2016/05/05 9:33:39 ET]
Table 'Glarona II' 9-max Seat #9 is the button
Seat 1: KovIFish89 ($100.50 in chips) 
Seat 2: matiko09 ($100 in chips) 
Seat 4: Yuzu Hiragi ($40 in chips) 
Seat 5: Painkiller72 ($100 in chips) 
Seat 6: chirikow ($67.94 in chips) 
Seat 9: antfurto ($80 in chips) 
KovIFish89: posts small blind $0.50
matiko09: posts big blind $1
Kukuryzka: sits out 
Yuzu Hiragi: posts big blind $1
Dantist1122: sits out 
ipashutapkom: sits out 
*** HOLE CARDS ***
Dealt to matiko09 [5s Qc]
Yuzu Hiragi: raises $2 to $3
Painkiller72: folds 
chirikow: folds 
antfurto: folds 
KovIFish89: folds 
matiko09: folds 
Uncalled bet ($2) returned to Yuzu Hiragi
Yuzu Hiragi collected $2.50 from pot
Yuzu Hiragi: doesn't show hand 
*** SUMMARY ***
Total pot $2.50 | Rake $0 
Seat 1: KovIFish89 (small blind) folded before Flop
Seat 2: matiko09 (big blind) folded before Flop
Seat 4: Yuzu Hiragi collected ($2.50)
Seat 5: Painkiller72 folded before Flop (didn't bet)
Seat 6: chirikow folded before Flop (didn't bet)
Seat 9: antfurto (button) folded before Flop (didn't bet)





PokerStars Hand #152883910154:  Hold'em No Limit ($0.50/$1.00 USD) - 2016/05/05 15:33:46 CET [2016/05/05 9:33:46 ET]
Table 'Chimaera II' 9-max Seat #9 is the button
Seat 3: matiko09 ($100.50 in chips) 
Seat 5: Butchers31 ($108.58 in chips) 
Seat 6: Painkiller72 ($110.62 in chips) 
Seat 7: Hypoaroused ($197.36 in chips) 
Seat 8: Dantist1122 ($100 in chips) 
Seat 9: kamillo91 ($73.28 in chips) 
nickreason17 will be allowed to play after the button
matiko09: posts small blind $0.50
RiverJazz: is sitting out 
Butchers31: posts big blind $1
*** HOLE CARDS ***
Dealt to matiko09 [2s 7h]
Painkiller72: folds 
Hypoaroused: calls $1
Dantist1122: folds 
kamillo91: folds 
matiko09: folds 
Butchers31: checks 
*** FLOP *** [8d Qh 6h]
Butchers31: checks 
Hypoaroused: checks 
*** TURN *** [8d Qh 6h] [7c]
Butchers31: checks 
Hypoaroused: checks 
*** RIVER *** [8d Qh 6h 7c] [Js]
Butchers31: checks 
Hypoaroused: checks 
*** SHOW DOWN ***
Butchers31: shows [Kd Qd] (a pair of Queens)
Hypoaroused: mucks hand 
Butchers31 collected $2.38 from pot
*** SUMMARY ***
Total pot $2.50 | Rake $0.12 
Board [8d Qh 6h 7c Js]
Seat 3: matiko09 (small blind) folded before Flop
Seat 5: Butchers31 (big blind) showed [Kd Qd] and won ($2.38) with a pair of Queens
Seat 6: Painkiller72 folded before Flop (didn't bet)
Seat 7: Hypoaroused mucked [Kc Ah]
Seat 8: Dantist1122 folded before Flop (didn't bet)
Seat 9: kamillo91 (button) folded before Flop (didn't bet)





PokerStars Hand #152883913384:  Hold'em No Limit ($0.50/$1.00 USD) - 2016/05/05 15:33:51 CET [2016/05/05 9:33:51 ET]
Table 'Natascha' 9-max Seat #6 is the button
Seat 1: ronald3737 ($85.90 in chips) 
Seat 2: matiko09 ($139.75 in chips) 
Seat 5: Dickyxxx ($131.76 in chips) 
Seat 6: gabi_igna ($151.94 in chips) 
Seat 7: torkkdnm ($149.74 in chips) 
Seat 8: kamillo91 ($77.50 in chips) 
Seat 9: guoweiAA ($236.20 in chips) 
torkkdnm: posts small blind $0.50
kamillo91: posts big blind $1
sanpidk: sits out 
*** HOLE CARDS ***
Dealt to matiko09 [6h 2s]
guoweiAA: folds 
ronald3737: raises $1 to $2
matiko09: folds 
Dickyxxx: folds 
gabi_igna: folds 
torkkdnm: folds 
kamillo91: calls $1
*** FLOP *** [7s Ah Ac]
kamillo91: checks 
ronald3737: checks 
*** TURN *** [7s Ah Ac] [Kc]
kamillo91: checks 
ronald3737: bets $3
kamillo91: folds 
Uncalled bet ($3) returned to ronald3737
ronald3737 collected $4.28 from pot
ronald3737: doesn't show hand 
*** SUMMARY ***
Total pot $4.50 | Rake $0.22 
Board [7s Ah Ac Kc]
Seat 1: ronald3737 collected ($4.28)
Seat 2: matiko09 folded before Flop (didn't bet)
Seat 5: Dickyxxx folded before Flop (didn't bet)
Seat 6: gabi_igna (button) folded before Flop (didn't bet)
Seat 7: torkkdnm (small blind) folded before Flop
Seat 8: kamillo91 (big blind) folded on the Turn
Seat 9: guoweiAA folded before Flop (didn't bet)





PokerStars Hand #152883915848:  Hold'em No Limit ($0.50/$1.00 USD) - 2016/05/05 15:33:56 CET [2016/05/05 9:33:56 ET]
Table 'Priska II' 9-max Seat #3 is the button
Seat 1: Spid1 ($100 in chips) 
Seat 2: Kukuryzka ($100 in chips) 
Seat 3: matiko09 ($102.62 in chips) 
Seat 4: Painkiller72 ($169.66 in chips) 
Seat 5: nickreason17 ($130.18 in chips) 
Seat 6: OneTwo81 ($99.95 in chips) 
Seat 7: stockbridge8 ($106.27 in chips) 
Seat 8: pohorc21 ($60.03 in chips) 
Seat 9: torkkdnm ($102.55 in chips) 
Painkiller72: posts small blind $0.50
nickreason17: posts big blind $1
*** HOLE CARDS ***
Dealt to matiko09 [4c Qh]
OneTwo81: folds 
stockbridge8: folds 
pohorc21: raises $1 to $2
torkkdnm: folds 
Spid1: calls $2
Kukuryzka: folds 
matiko09: folds 
Painkiller72: folds 
nickreason17: folds 
*** FLOP *** [Ks Kh Kd]
pohorc21: checks 
Spid1: checks 
*** TURN *** [Ks Kh Kd] [Tc]
pohorc21: checks 
Spid1: checks 
*** RIVER *** [Ks Kh Kd Tc] [4h]
pohorc21: bets $3
Spid1: calls $3
*** SHOW DOWN ***
pohorc21: shows [6h Ac] (three of a kind, Kings)
Spid1: shows [8h 8c] (a full house, Kings full of Eights)
Spid1 collected $10.92 from pot
*** SUMMARY ***
Total pot $11.50 | Rake $0.58 
Board [Ks Kh Kd Tc 4h]
Seat 1: Spid1 showed [8h 8c] and won ($10.92) with a full house, Kings full of Eights
Seat 2: Kukuryzka folded before Flop (didn't bet)
Seat 3: matiko09 (button) folded before Flop (didn't bet)
Seat 4: Painkiller72 (small blind) folded before Flop
Seat 5: nickreason17 (big blind) folded before Flop
Seat 6: OneTwo81 folded before Flop (didn't bet)
Seat 7: stockbridge8 folded before Flop (didn't bet)
Seat 8: pohorc21 showed [6h Ac] and lost with three of a kind, Kings
Seat 9: torkkdnm folded before Flop (didn't bet)





PokerStars Hand #152883918404:  Hold'em No Limit ($1/$2 USD) - 2016/05/05 15:34:00 CET [2016/05/05 9:34:00 ET]
Table 'Samitchell' 9-max Seat #3 is the button
Seat 2: 13Ghosts ($291.81 in chips) 
Seat 3: gabi_igna ($298.32 in chips) 
Seat 4: Fitzyferret ($388.97 in chips) 
Seat 5: Spid1 ($200 in chips) 
Seat 6: matiko09 ($201.43 in chips) 
Seat 7: patpaty ($150.30 in chips) 
Seat 9: IseeUcards ($257.63 in chips) 
Fitzyferret: posts small blind $1
Spid1: posts big blind $2
Hex0gen: sits out 
KovIFish89: sits out 
*** HOLE CARDS ***
Dealt to matiko09 [Tc Kh]
13Ghosts said, "^^"
matiko09: folds 
13Ghosts said, "thief"
patpaty: folds 
IseeUcards: folds 
gabi_igna said, "(y)"
13Ghosts: raises $4 to $6
gabi_igna: raises $12 to $18
Fitzyferret: folds 
Spid1: folds 
13Ghosts: folds 
Uncalled bet ($12) returned to gabi_igna
gabi_igna collected $15 from pot
gabi_igna: doesn't show hand 
*** SUMMARY ***
Total pot $15 | Rake $0 
Seat 2: 13Ghosts folded before Flop
Seat 3: gabi_igna (button) collected ($15)
Seat 4: Fitzyferret (small blind) folded before Flop
Seat 5: Spid1 (big blind) folded before Flop
Seat 6: matiko09 folded before Flop (didn't bet)
Seat 7: patpaty folded before Flop (didn't bet)
Seat 9: IseeUcards folded before Flop (didn't bet)





PokerStars Hand #152883921459:  Hold'em No Limit ($0.50/$1.00 USD) - 2016/05/05 15:34:06 CET [2016/05/05 9:34:06 ET]
Table 'Lictoria II' 9-max Seat #6 is the button
Seat 1: St.LaCoste ($109.50 in chips) 
Seat 2: Dantist1122 ($122.96 in chips) 
Seat 3: Krinica2009 ($100 in chips) 
Seat 4: Ying59 ($43.65 in chips) 
Seat 5: sanpidk ($105.75 in chips) 
Seat 6: gabi_igna ($127.59 in chips) 
Seat 7: Painkiller72 ($200.80 in chips) 
Seat 8: matiko09 ($100 in chips) 
Seat 9: Kukuryzka ($125.15 in chips) 
Painkiller72: posts small blind $0.50
matiko09: posts big blind $1
*** HOLE CARDS ***
Dealt to matiko09 [8d 2h]
Kukuryzka: folds 
St.LaCoste: raises $2 to $3
Dantist1122: folds 
Krinica2009: folds 
Ying59: calls $3
sanpidk: folds 
gabi_igna: folds 
Painkiller72: folds 
matiko09: folds 
*** FLOP *** [5c Td 4h]
St.LaCoste: bets $2.13
Ying59: calls $2.13
*** TURN *** [5c Td 4h] [Ts]
St.LaCoste: checks 
Ying59: bets $3
St.LaCoste: calls $3
*** RIVER *** [5c Td 4h Ts] [9s]
St.LaCoste: checks 
Ying59: checks 
*** SHOW DOWN ***
St.LaCoste: shows [Ad Jh] (a pair of Tens)
Ying59: shows [6s 4c] (two pair, Tens and Fours)
Ying59 collected $16.87 from pot
*** SUMMARY ***
Total pot $17.76 | Rake $0.89 
Board [5c Td 4h Ts 9s]
Seat 1: St.LaCoste showed [Ad Jh] and lost with a pair of Tens
Seat 2: Dantist1122 folded before Flop (didn't bet)
Seat 3: Krinica2009 folded before Flop (didn't bet)
Seat 4: Ying59 showed [6s 4c] and won ($16.87) with two pair, Tens and Fours
Seat 5: sanpidk folded before Flop (didn't bet)
Seat 6: gabi_igna (button) folded before Flop (didn't bet)
Seat 7: Painkiller72 (small blind) folded before Flop
Seat 8: matiko09 (big blind) folded before Flop
Seat 9: Kukuryzka folded before Flop (didn't bet)





PokerStars Hand #152883923394:  Hold'em No Limit ($0.50/$1.00 USD) - 2016/05/05 15:34:09 CET [2016/05/05 9:34:09 ET]
Table 'Chimaera II' 9-max Seat #3 is the button
Seat 3: matiko09 ($100 in chips) 
Seat 5: Butchers31 ($109.96 in chips) 
Seat 7: Hypoaroused ($196.36 in chips) 
Seat 8: Dantist1122 ($100 in chips) 
Seat 9: kamillo91 ($73.28 in chips) 
Butchers31: posts small blind $0.50
Painkiller72: is sitting out 
Hypoaroused: posts big blind $1
Painkiller72 leaves the table
nickreason17: sits out 
*** HOLE CARDS ***
Dealt to matiko09 [9c 6c]
Dantist1122: folds 
vrnMike joins the table at seat #2 
kamillo91: folds 
matiko09: raises $1.27 to $2.27
nickreason17 leaves the table
Butchers31: folds 
ipashutapkom joins the table at seat #1 
Hypoaroused: folds 
Uncalled bet ($1.27) returned to matiko09
matiko09 collected $2.50 from pot
matiko09: doesn't show hand 
*** SUMMARY ***
Total pot $2.50 | Rake $0 
Seat 3: matiko09 (button) collected ($2.50)
Seat 5: Butchers31 (small blind) folded before Flop
Seat 7: Hypoaroused (big blind) folded before Flop
Seat 8: Dantist1122 folded before Flop (didn't bet)
Seat 9: kamillo91 folded before Flop (didn't bet)





PokerStars Hand #152883925690:  Hold'em No Limit ($0.50/$1.00 USD) - 2016/05/05 15:34:13 CET [2016/05/05 9:34:13 ET]
Table 'Glarona II' 9-max Seat #1 is the button
Seat 1: KovIFish89 ($100 in chips) 
Seat 2: matiko09 ($100 in chips) 
Seat 3: Kukuryzka ($100 in chips) 
Seat 4: Yuzu Hiragi ($41.50 in chips) 
Seat 5: Painkiller72 ($100 in chips) 
Seat 6: chirikow ($67.94 in chips) 
Seat 9: antfurto ($80 in chips) 
matiko09: posts small blind $0.50
Kukuryzka: posts big blind $1
Dantist1122: sits out 
ipashutapkom: sits out 
*** HOLE CARDS ***
Dealt to matiko09 [Ad Ac]
Yuzu Hiragi: folds 
Painkiller72: raises $1.50 to $2.50
Yuzu Hiragi leaves the table
chirikow: folds 
antfurto: folds 
Mukhin1 joins the table at seat #4 
KovIFish89: folds 
matiko09: raises $6.50 to $9
Kukuryzka: folds 
Painkiller72: calls $6.50
*** FLOP *** [8h 6h 2c]
matiko09: bets $10
Painkiller72: calls $10
*** TURN *** [8h 6h 2c] [Qh]
matiko09: bets $22
Painkiller72: calls $22
*** RIVER *** [8h 6h 2c Qh] [Qs]
matiko09: checks 
Painkiller72: checks 
*** SHOW DOWN ***
matiko09: shows [Ad Ac] (two pair, Aces and Queens)
Painkiller72: mucks hand 
matiko09 collected $80.50 from pot
*** SUMMARY ***
Total pot $83 | Rake $2.50 
Board [8h 6h 2c Qh Qs]
Seat 1: KovIFish89 (button) folded before Flop (didn't bet)
Seat 2: matiko09 (small blind) showed [Ad Ac] and won ($80.50) with two pair, Aces and Queens
Seat 3: Kukuryzka (big blind) folded before Flop
Seat 4: Yuzu Hiragi folded before Flop (didn't bet)
Seat 5: Painkiller72 mucked [Kd Ah]
Seat 6: chirikow folded before Flop (didn't bet)
Seat 9: antfurto folded before Flop (didn't bet)





PokerStars Hand #152883926857:  Hold'em No Limit ($1/$2 USD) - 2016/05/05 15:34:15 CET [2016/05/05 9:34:15 ET]
Table 'Lundia' 9-max Seat #6 is the button
Seat 1: Fitzyferret ($221.82 in chips) 
Seat 2: patpaty ($165.60 in chips) 
Seat 3: IseeUcards ($413.77 in chips) 
Seat 4: KovIFish89 ($219.88 in chips) 
Seat 6: Spid1 ($245.74 in chips) 
Seat 7: matiko09 ($200 in chips) 
Seat 8: Durnichka ($77 in chips) 
Seat 9: gabi_igna ($208.06 in chips) 
matiko09: posts small blind $1
Durnichka: posts big blind $2
*** HOLE CARDS ***
Dealt to matiko09 [Jc Ad]
gabi_igna: folds 
Fitzyferret: folds 
patpaty: folds 
IseeUcards: folds 
KovIFish89: folds 
Spid1: folds 
matiko09: raises $3 to $5
Durnichka: calls $3
*** FLOP *** [Ac 5d 7d]
matiko09: bets $6.18
Durnichka: calls $6.18
*** TURN *** [Ac 5d 7d] [4s]
matiko09: bets $12
Durnichka: calls $12
*** RIVER *** [Ac 5d 7d 4s] [4c]
matiko09: checks 
Durnichka: checks 
*** SHOW DOWN ***
matiko09: shows [Jc Ad] (two pair, Aces and Fours)
Durnichka: mucks hand 
matiko09 collected $44.04 from pot
*** SUMMARY ***
Total pot $46.36 | Rake $2.32 
Board [Ac 5d 7d 4s 4c]
Seat 1: Fitzyferret folded before Flop (didn't bet)
Seat 2: patpaty folded before Flop (didn't bet)
Seat 3: IseeUcards folded before Flop (didn't bet)
Seat 4: KovIFish89 folded before Flop (didn't bet)
Seat 6: Spid1 (button) folded before Flop (didn't bet)
Seat 7: matiko09 (small blind) showed [Jc Ad] and won ($44.04) with two pair, Aces and Fours
Seat 8: Durnichka (big blind) mucked [9d As]
Seat 9: gabi_igna folded before Flop (didn't bet)





PokerStars Hand #152883927098:  Hold'em No Limit ($0.50/$1.00 USD) - 2016/05/05 15:34:16 CET [2016/05/05 9:34:16 ET]
Table 'Pyxis III' 9-max Seat #8 is the button
Seat 1: sanpidk ($132.03 in chips) 
Seat 2: 50CandyJoe ($100 in chips) 
Seat 3: Xxth3nutzxX ($98.50 in chips) 
Seat 4: Sloeve ($116.35 in chips) 
Seat 5: darren1031 ($83.28 in chips) 
Seat 6: kamillo91 ($47.50 in chips) 
Seat 7: Painkiller72 ($137.28 in chips) 
Seat 8: matiko09 ($100 in chips) 
Seat 9: Hypoaroused ($91.38 in chips) 
Hypoaroused: posts small blind $0.50
sanpidk: posts big blind $1
*** HOLE CARDS ***
Dealt to matiko09 [2d 2c]
50CandyJoe: raises $2 to $3
Xxth3nutzxX: calls $3
Sloeve: folds 
darren1031: folds 
kamillo91: folds 
Painkiller72: folds 
matiko09: calls $3
Hypoaroused: calls $2.50
sanpidk: raises $14.50 to $17.50
50CandyJoe: calls $14.50
Xxth3nutzxX: calls $14.50
matiko09: folds 
Hypoaroused: calls $14.50
*** FLOP *** [7d 4h 5c]
Hypoaroused: checks 
sanpidk: bets $24.76
50CandyJoe: folds 
Xxth3nutzxX: folds 
Hypoaroused: folds 
Uncalled bet ($24.76) returned to sanpidk
sanpidk collected $70.50 from pot
sanpidk: doesn't show hand 
*** SUMMARY ***
Total pot $73 | Rake $2.50 
Board [7d 4h 5c]
Seat 1: sanpidk (big blind) collected ($70.50)
Seat 2: 50CandyJoe folded on the Flop
Seat 3: Xxth3nutzxX folded on the Flop
Seat 4: Sloeve folded before Flop (didn't bet)
Seat 5: darren1031 folded before Flop (didn't bet)
Seat 6: kamillo91 folded before Flop (didn't bet)
Seat 7: Painkiller72 folded before Flop (didn't bet)
Seat 8: matiko09 (button) folded before Flop
Seat 9: Hypoaroused (small blind) folded on the Flop





PokerStars Hand #152883927899:  Hold'em No Limit ($1/$2 USD) - 2016/05/05 15:34:17 CET [2016/05/05 9:34:17 ET]
Table 'Tololo' 9-max Seat #4 is the button
Seat 1: Kukuryzka ($200 in chips) 
Seat 2: gabi_igna ($245.99 in chips) 
Seat 3: nickreason17 ($222.40 in chips) 
Seat 4: mooose100 ($171.62 in chips) 
Seat 5: matiko09 ($215 in chips) 
Seat 6: Xagua ($132.12 in chips) 
Seat 7: IseeUcards ($201.61 in chips) 
Seat 8: TonnaMunz ($433.57 in chips) 
Seat 9: Fitzyferret ($235.49 in chips) 
matiko09: posts small blind $1
Xagua: posts big blind $2
*** HOLE CARDS ***
Dealt to matiko09 [Qd 6c]
IseeUcards: folds 
TonnaMunz: folds 
Fitzyferret: raises $3.24 to $5.24
Kukuryzka: folds 
gabi_igna: folds 
nickreason17: folds 
mooose100: calls $5.24
matiko09: folds 
Xagua: calls $3.24
*** FLOP *** [8c Kc 3h]
Xagua: checks 
Fitzyferret: bets $8
mooose100: calls $8
Xagua: folds 
*** TURN *** [8c Kc 3h] [5h]
Fitzyferret: checks 
mooose100: bets $31.08
Fitzyferret: calls $31.08
*** RIVER *** [8c Kc 3h 5h] [2d]
Fitzyferret: checks 
mooose100: bets $92.13
Fitzyferret: folds 
Uncalled bet ($92.13) returned to mooose100
mooose100 collected $92.13 from pot
mooose100: doesn't show hand 
*** SUMMARY ***
Total pot $94.88 | Rake $2.75 
Board [8c Kc 3h 5h 2d]
Seat 1: Kukuryzka folded before Flop (didn't bet)
Seat 2: gabi_igna folded before Flop (didn't bet)
Seat 3: nickreason17 folded before Flop (didn't bet)
Seat 4: mooose100 (button) collected ($92.13)
Seat 5: matiko09 (small blind) folded before Flop
Seat 6: Xagua (big blind) folded on the Flop
Seat 7: IseeUcards folded before Flop (didn't bet)
Seat 8: TonnaMunz folded before Flop (didn't bet)
Seat 9: Fitzyferret folded on the River





PokerStars Hand #152883928854:  Hold'em No Limit ($0.50/$1.00 USD) - 2016/05/05 15:34:19 CET [2016/05/05 9:34:19 ET]
Table 'Kacivelia II' 9-max Seat #8 is the button
Seat 1: Spid1 ($108.42 in chips) 
Seat 2: thecurv ($110.88 in chips) 
Seat 3: 50CandyJoe ($101.50 in chips) 
Seat 4: matiko09 ($100 in chips) 
Seat 5: Painkiller72 ($120.72 in chips) 
Seat 7: KovIFish89 ($100.40 in chips) 
Seat 8: sanpidk ($108.15 in chips) 
Seat 9: ipashutapkom ($97.50 in chips) 
ipashutapkom: posts small blind $0.50
Spid1: posts big blind $1
*** HOLE CARDS ***
Dealt to matiko09 [3d Kd]
thecurv: folds 
50CandyJoe: folds 
matiko09: folds 
Painkiller72: folds 
KovIFish89: folds 
sanpidk: folds 
ipashutapkom: raises $1.26 to $2.26
Spid1: folds 
Uncalled bet ($1.26) returned to ipashutapkom
ipashutapkom collected $2 from pot
ipashutapkom: doesn't show hand 
*** SUMMARY ***
Total pot $2 | Rake $0 
Seat 1: Spid1 (big blind) folded before Flop
Seat 2: thecurv folded before Flop (didn't bet)
Seat 3: 50CandyJoe folded before Flop (didn't bet)
Seat 4: matiko09 folded before Flop (didn't bet)
Seat 5: Painkiller72 folded before Flop (didn't bet)
Seat 7: KovIFish89 folded before Flop (didn't bet)
Seat 8: sanpidk (button) folded before Flop (didn't bet)
Seat 9: ipashutapkom (small blind) collected ($2)





PokerStars Hand #152883938544:  Hold'em No Limit ($1/$2 USD) - 2016/05/05 15:34:36 CET [2016/05/05 9:34:36 ET]
Table 'Samitchell' 9-max Seat #4 is the button
Seat 2: 13Ghosts ($285.81 in chips) 
Seat 3: gabi_igna ($307.32 in chips) 
Seat 4: Fitzyferret ($387.97 in chips) 
Seat 5: Spid1 ($200 in chips) 
Seat 6: matiko09 ($201.43 in chips) 
Seat 7: patpaty ($150.30 in chips) 
Seat 9: IseeUcards ($257.63 in chips) 
Spid1: posts small blind $1
matiko09: posts big blind $2
Hex0gen: sits out 
KovIFish89: sits out 
*** HOLE CARDS ***
Dealt to matiko09 [5h 3h]
patpaty: folds 
IseeUcards: folds 
13Ghosts: folds 
gabi_igna: folds 
Fitzyferret: raises $2.60 to $4.60
Spid1: folds 
matiko09: folds 
Uncalled bet ($2.60) returned to Fitzyferret
Fitzyferret collected $5 from pot
Fitzyferret: doesn't show hand 
*** SUMMARY ***
Total pot $5 | Rake $0 
Seat 2: 13Ghosts folded before Flop (didn't bet)
Seat 3: gabi_igna folded before Flop (didn't bet)
Seat 4: Fitzyferret (button) collected ($5)
Seat 5: Spid1 (small blind) folded before Flop
Seat 6: matiko09 (big blind) folded before Flop
Seat 7: patpaty folded before Flop (didn't bet)
Seat 9: IseeUcards folded before Flop (didn't bet)





PokerStars Hand #152883942126:  Hold'em No Limit ($0.50/$1.00 USD) - 2016/05/05 15:34:43 CET [2016/05/05 9:34:43 ET]
Table 'Priska II' 9-max Seat #4 is the button
Seat 1: Spid1 ($105.92 in chips) 
Seat 2: Kukuryzka ($100 in chips) 
Seat 3: matiko09 ($102.62 in chips) 
Seat 4: Painkiller72 ($169.16 in chips) 
Seat 5: nickreason17 ($129.18 in chips) 
Seat 6: OneTwo81 ($99.95 in chips) 
Seat 7: stockbridge8 ($106.27 in chips) 
Seat 8: pohorc21 ($55.03 in chips) 
Seat 9: torkkdnm ($102.55 in chips) 
nickreason17: posts small blind $0.50
OneTwo81: posts big blind $1
*** HOLE CARDS ***
Dealt to matiko09 [5h Qd]
stockbridge8: folds 
pohorc21: folds 
torkkdnm: folds 
Spid1: folds 
Kukuryzka: folds 
matiko09: folds 
Painkiller72: raises $1 to $2
nickreason17: folds 
OneTwo81: calls $1
*** FLOP *** [3c 2s 3d]
OneTwo81: checks 
Painkiller72: checks 
*** TURN *** [3c 2s 3d] [Qh]
OneTwo81: checks 
Painkiller72: checks 
*** RIVER *** [3c 2s 3d Qh] [3h]
OneTwo81: bets $4
Painkiller72: folds 
Uncalled bet ($4) returned to OneTwo81
OneTwo81 collected $4.28 from pot
OneTwo81: doesn't show hand 
*** SUMMARY ***
Total pot $4.50 | Rake $0.22 
Board [3c 2s 3d Qh 3h]
Seat 1: Spid1 folded before Flop (didn't bet)
Seat 2: Kukuryzka folded before Flop (didn't bet)
Seat 3: matiko09 folded before Flop (didn't bet)
Seat 4: Painkiller72 (button) folded on the River
Seat 5: nickreason17 (small blind) folded before Flop
Seat 6: OneTwo81 (big blind) collected ($4.28)
Seat 7: stockbridge8 folded before Flop (didn't bet)
Seat 8: pohorc21 folded before Flop (didn't bet)
Seat 9: torkkdnm folded before Flop (didn't bet)





PokerStars Hand #152883942538:  Hold'em No Limit ($0.50/$1.00 USD) - 2016/05/05 15:34:44 CET [2016/05/05 9:34:44 ET]
Table 'Chimaera II' 9-max Seat #5 is the button
Seat 3: matiko09 ($101.50 in chips) 
Seat 5: Butchers31 ($109.46 in chips) 
Seat 7: Hypoaroused ($195.36 in chips) 
Seat 9: kamillo91 ($73.28 in chips) 
Hypoaroused: posts small blind $0.50
Dantist1122: is sitting out 
Dantist1122 leaves the table
kamillo91: posts big blind $1
vrnMike: sits out 
*** HOLE CARDS ***
Dealt to matiko09 [9c 8s]
CI58 joins the table at seat #6 
matiko09: folds 
Butchers31: raises $2.50 to $3.50
Hypoaroused: folds 
kamillo91: folds 
Uncalled bet ($2.50) returned to Butchers31
Butchers31 collected $2.50 from pot
Butchers31: doesn't show hand 
*** SUMMARY ***
Total pot $2.50 | Rake $0 
Seat 3: matiko09 folded before Flop (didn't bet)
Seat 5: Butchers31 (button) collected ($2.50)
Seat 7: Hypoaroused (small blind) folded before Flop
Seat 9: kamillo91 (big blind) folded before Flop





PokerStars Hand #152883958817:  Hold'em No Limit ($1/$2 USD) - 2016/05/05 15:35:12 CET [2016/05/05 9:35:12 ET]
Table 'Samitchell' 9-max Seat #5 is the button
Seat 2: 13Ghosts ($285.81 in chips) 
Seat 3: gabi_igna ($307.32 in chips) 
Seat 4: Fitzyferret ($390.97 in chips) 
Seat 5: Spid1 ($200 in chips) 
Seat 6: matiko09 ($200 in chips) 
Seat 7: patpaty ($150.30 in chips) 
Seat 9: IseeUcards ($257.63 in chips) 
matiko09: posts small blind $1
patpaty: posts big blind $2
Hex0gen: sits out 
KovIFish89: sits out 
*** HOLE CARDS ***
Dealt to matiko09 [3s 4s]
IseeUcards: folds 
13Ghosts: folds 
gabi_igna: folds 
Fitzyferret: folds 
Spid1: folds 
matiko09: folds 
Uncalled bet ($1) returned to patpaty
patpaty collected $2 from pot
patpaty: doesn't show hand 
*** SUMMARY ***
Total pot $2 | Rake $0 
Seat 2: 13Ghosts folded before Flop (didn't bet)
Seat 3: gabi_igna folded before Flop (didn't bet)
Seat 4: Fitzyferret folded before Flop (didn't bet)
Seat 5: Spid1 (button) folded before Flop (didn't bet)
Seat 6: matiko09 (small blind) folded before Flop
Seat 7: patpaty (big blind) collected ($2)
Seat 9: IseeUcards folded before Flop (didn't bet)





PokerStars Hand #152883958908:  Hold'em No Limit ($0.50/$1.00 USD) - 2016/05/05 15:35:13 CET [2016/05/05 9:35:13 ET]
Table 'Natascha' 9-max Seat #7 is the button
Seat 1: ronald3737 ($88.18 in chips) 
Seat 2: matiko09 ($139.75 in chips) 
Seat 5: Dickyxxx ($131.76 in chips) 
Seat 6: gabi_igna ($151.94 in chips) 
Seat 7: torkkdnm ($149.24 in chips) 
Seat 8: kamillo91 ($75.50 in chips) 
Seat 9: guoweiAA ($236.20 in chips) 
kamillo91: posts small blind $0.50
guoweiAA: posts big blind $1
sanpidk: sits out 
*** HOLE CARDS ***
Dealt to matiko09 [6c 2h]
ronald3737: folds 
matiko09: folds 
Dickyxxx: folds 
gabi_igna: raises $1.50 to $2.50
torkkdnm: folds 
kamillo91: folds 
guoweiAA: folds 
Uncalled bet ($1.50) returned to gabi_igna
gabi_igna collected $2.50 from pot
gabi_igna: doesn't show hand 
*** SUMMARY ***
Total pot $2.50 | Rake $0 
Seat 1: ronald3737 folded before Flop (didn't bet)
Seat 2: matiko09 folded before Flop (didn't bet)
Seat 5: Dickyxxx folded before Flop (didn't bet)
Seat 6: gabi_igna collected ($2.50)
Seat 7: torkkdnm (button) folded before Flop (didn't bet)
Seat 8: kamillo91 (small blind) folded before Flop
Seat 9: guoweiAA (big blind) folded before Flop





PokerStars Hand #152883963080:  Hold'em No Limit ($1/$2 USD) - 2016/05/05 15:35:20 CET [2016/05/05 9:35:20 ET]
Table 'Lundia' 9-max Seat #7 is the button
Seat 1: Fitzyferret ($221.82 in chips) 
Seat 2: patpaty ($165.60 in chips) 
Seat 3: IseeUcards ($413.77 in chips) 
Seat 4: KovIFish89 ($219.88 in chips) 
Seat 6: Spid1 ($245.74 in chips) 
Seat 7: matiko09 ($220.86 in chips) 
Seat 8: Durnichka ($80 in chips) 
Seat 9: gabi_igna ($208.06 in chips) 
Durnichka: posts small blind $1
gabi_igna: posts big blind $2
*** HOLE CARDS ***
Dealt to matiko09 [6s Jc]
Fitzyferret: folds 
patpaty: folds 
IseeUcards: folds 
KovIFish89: raises $3 to $5
Spid1: folds 
matiko09: folds 
Durnichka: folds 
gabi_igna: folds 
Uncalled bet ($3) returned to KovIFish89
KovIFish89 collected $5 from pot
KovIFish89: doesn't show hand 
*** SUMMARY ***
Total pot $5 | Rake $0 
Seat 1: Fitzyferret folded before Flop (didn't bet)
Seat 2: patpaty folded before Flop (didn't bet)
Seat 3: IseeUcards folded before Flop (didn't bet)
Seat 4: KovIFish89 collected ($5)
Seat 6: Spid1 folded before Flop (didn't bet)
Seat 7: matiko09 (button) folded before Flop (didn't bet)
Seat 8: Durnichka (small blind) folded before Flop
Seat 9: gabi_igna (big blind) folded before Flop





PokerStars Hand #152883970704:  Hold'em No Limit ($1/$2 USD) - 2016/05/05 15:35:33 CET [2016/05/05 9:35:33 ET]
Table 'Samitchell' 9-max Seat #6 is the button
Seat 2: 13Ghosts ($285.81 in chips) 
Seat 3: gabi_igna ($307.32 in chips) 
Seat 4: Fitzyferret ($390.97 in chips) 
Seat 5: Spid1 ($200 in chips) 
Seat 6: matiko09 ($200 in chips) 
Seat 7: patpaty ($151.30 in chips) 
Seat 8: Hex0gen ($200 in chips) 
Seat 9: IseeUcards ($257.63 in chips) 
patpaty: posts small blind $1
Hex0gen: posts big blind $2
KovIFish89: sits out 
*** HOLE CARDS ***
Dealt to matiko09 [Tc 5d]
IseeUcards: folds 
13Ghosts: folds 
gabi_igna: folds 
Fitzyferret: raises $2.60 to $4.60
Spid1: folds 
matiko09: folds 
patpaty: folds 
Hex0gen: calls $2.60
*** FLOP *** [3h Th 8d]
Hex0gen: checks 
Fitzyferret: checks 
*** TURN *** [3h Th 8d] [5s]
Hex0gen: checks 
Fitzyferret: checks 
*** RIVER *** [3h Th 8d 5s] [8s]
Hex0gen: checks 
Fitzyferret: checks 
*** SHOW DOWN ***
Hex0gen: shows [2d Kc] (a pair of Eights)
Fitzyferret: shows [5c 6c] (two pair, Eights and Fives)
Fitzyferret collected $9.69 from pot
*** SUMMARY ***
Total pot $10.20 | Rake $0.51 
Board [3h Th 8d 5s 8s]
Seat 2: 13Ghosts folded before Flop (didn't bet)
Seat 3: gabi_igna folded before Flop (didn't bet)
Seat 4: Fitzyferret showed [5c 6c] and won ($9.69) with two pair, Eights and Fives
Seat 5: Spid1 folded before Flop (didn't bet)
Seat 6: matiko09 (button) folded before Flop (didn't bet)
Seat 7: patpaty (small blind) folded before Flop
Seat 8: Hex0gen (big blind) showed [2d Kc] and lost with a pair of Eights
Seat 9: IseeUcards folded before Flop (didn't bet)





PokerStars Hand #152883972336:  Hold'em No Limit ($0.50/$1.00 USD) - 2016/05/05 15:35:36 CET [2016/05/05 9:35:36 ET]
Table 'Priska II' 9-max Seat #5 is the button
Seat 1: Spid1 ($105.92 in chips) 
Seat 2: Kukuryzka ($100 in chips) 
Seat 3: matiko09 ($102.62 in chips) 
Seat 4: Painkiller72 ($167.16 in chips) 
Seat 5: nickreason17 ($128.68 in chips) 
Seat 6: OneTwo81 ($102.23 in chips) 
Seat 7: stockbridge8 ($106.27 in chips) 
Seat 8: pohorc21 ($55.03 in chips) 
Seat 9: torkkdnm ($102.55 in chips) 
OneTwo81: posts small blind $0.50
stockbridge8: posts big blind $1
*** HOLE CARDS ***
Dealt to matiko09 [Td 9d]
pohorc21: raises $1 to $2
torkkdnm: folds 
Spid1: folds 
Kukuryzka: folds 
matiko09: calls $2
Painkiller72: folds 
nickreason17: calls $2
OneTwo81: calls $1.50
stockbridge8: calls $1
*** FLOP *** [4c Kc Th]
OneTwo81: checks 
stockbridge8: checks 
pohorc21: checks 
matiko09: checks 
nickreason17: checks 
*** TURN *** [4c Kc Th] [3c]
OneTwo81: checks 
stockbridge8: checks 
pohorc21: bets $5
matiko09: calls $5
nickreason17: raises $10 to $15
OneTwo81: folds 
stockbridge8: folds 
pohorc21: calls $10
matiko09: folds 
*** RIVER *** [4c Kc Th 3c] [5s]
pohorc21: checks 
nickreason17: bets $21.37
pohorc21: calls $21.37
*** SHOW DOWN ***
nickreason17: shows [Jc 8c] (a flush, King high)
pohorc21: mucks hand 
nickreason17 collected $85.24 from pot
*** SUMMARY ***
Total pot $87.74 | Rake $2.50 
Board [4c Kc Th 3c 5s]
Seat 1: Spid1 folded before Flop (didn't bet)
Seat 2: Kukuryzka folded before Flop (didn't bet)
Seat 3: matiko09 folded on the Turn
Seat 4: Painkiller72 folded before Flop (didn't bet)
Seat 5: nickreason17 (button) showed [Jc 8c] and won ($85.24) with a flush, King high
Seat 6: OneTwo81 (small blind) folded on the Turn
Seat 7: stockbridge8 (big blind) folded on the Turn
Seat 8: pohorc21 mucked [Kd As]
Seat 9: torkkdnm folded before Flop (didn't bet)





PokerStars Hand #152883979050:  Hold'em No Limit ($1/$2 USD) - 2016/05/05 15:35:48 CET [2016/05/05 9:35:48 ET]
Table 'Lundia' 9-max Seat #8 is the button
Seat 1: Fitzyferret ($221.82 in chips) 
Seat 2: patpaty ($165.60 in chips) 
Seat 3: IseeUcards ($413.77 in chips) 
Seat 4: KovIFish89 ($222.88 in chips) 
Seat 6: Spid1 ($245.74 in chips) 
Seat 7: matiko09 ($220.86 in chips) 
Seat 8: Durnichka ($79 in chips) 
Seat 9: gabi_igna ($206.06 in chips) 
gabi_igna: posts small blind $1
Fitzyferret: posts big blind $2
*** HOLE CARDS ***
Dealt to matiko09 [6c 2s]
patpaty: folds 
IseeUcards: folds 
KovIFish89: folds 
Spid1: folds 
matiko09: folds 
Durnichka: folds 
gabi_igna: raises $4 to $6
Fitzyferret: folds 
Uncalled bet ($4) returned to gabi_igna
gabi_igna collected $4 from pot
gabi_igna: doesn't show hand 
*** SUMMARY ***
Total pot $4 | Rake $0 
Seat 1: Fitzyferret (big blind) folded before Flop
Seat 2: patpaty folded before Flop (didn't bet)
Seat 3: IseeUcards folded before Flop (didn't bet)
Seat 4: KovIFish89 folded before Flop (didn't bet)
Seat 6: Spid1 folded before Flop (didn't bet)
Seat 7: matiko09 folded before Flop (didn't bet)
Seat 8: Durnichka (button) folded before Flop (didn't bet)
Seat 9: gabi_igna (small blind) collected ($4)





PokerStars Hand #152883981797:  Hold'em No Limit ($0.50/$1.00 USD) - 2016/05/05 15:35:53 CET [2016/05/05 9:35:53 ET]
Table 'Natascha' 9-max Seat #8 is the button
Seat 1: ronald3737 ($88.18 in chips) 
Seat 2: matiko09 ($139.75 in chips) 
Seat 5: Dickyxxx ($131.76 in chips) 
Seat 6: gabi_igna ($153.44 in chips) 
Seat 7: torkkdnm ($149.24 in chips) 
Seat 8: kamillo91 ($75 in chips) 
Seat 9: guoweiAA ($235.20 in chips) 
guoweiAA: posts small blind $0.50
ronald3737: posts big blind $1
sanpidk: sits out 
*** HOLE CARDS ***
Dealt to matiko09 [Jd 6c]
matiko09: folds 
Dickyxxx: folds 
gabi_igna: folds 
torkkdnm: folds 
kamillo91: folds 
guoweiAA: folds 
Uncalled bet ($0.50) returned to ronald3737
ronald3737 collected $1 from pot
ronald3737: doesn't show hand 
*** SUMMARY ***
Total pot $1 | Rake $0 
Seat 1: ronald3737 (big blind) collected ($1)
Seat 2: matiko09 folded before Flop (didn't bet)
Seat 5: Dickyxxx folded before Flop (didn't bet)
Seat 6: gabi_igna folded before Flop (didn't bet)
Seat 7: torkkdnm folded before Flop (didn't bet)
Seat 8: kamillo91 (button) folded before Flop (didn't bet)
Seat 9: guoweiAA (small blind) folded before Flop





PokerStars Hand #152883990259:  Hold'em No Limit ($0.50/$1.00 USD) - 2016/05/05 15:36:08 CET [2016/05/05 9:36:08 ET]
Table 'Pyxis III' 9-max Seat #9 is the button
Seat 1: sanpidk ($185.03 in chips) 
Seat 2: 50CandyJoe ($100 in chips) 
Seat 3: Xxth3nutzxX ($81 in chips) 
Seat 4: Sloeve ($116.35 in chips) 
Seat 5: darren1031 ($83.28 in chips) 
Seat 6: kamillo91 ($47.50 in chips) 
Seat 7: Painkiller72 ($137.28 in chips) 
Seat 8: matiko09 ($100 in chips) 
Seat 9: Hypoaroused ($100 in chips) 
sanpidk: posts small blind $0.50
50CandyJoe: posts big blind $1
*** HOLE CARDS ***
Dealt to matiko09 [2h 6d]
Xxth3nutzxX: folds 
Sloeve: folds 
darren1031: folds 
kamillo91: folds 
Painkiller72: folds 
matiko09: folds 
Hypoaroused: folds 
sanpidk: raises $1.50 to $2.50
50CandyJoe: calls $1.50
*** FLOP *** [5s 9h Qd]
sanpidk: checks 
50CandyJoe: checks 
*** TURN *** [5s 9h Qd] [6h]
Xxth3nutzxX leaves the table
sanpidk: checks 
ipashutapkom joins the table at seat #3 
50CandyJoe: bets $2.37
sanpidk: folds 
Uncalled bet ($2.37) returned to 50CandyJoe
50CandyJoe collected $4.75 from pot
50CandyJoe: doesn't show hand 
*** SUMMARY ***
Total pot $5 | Rake $0.25 
Board [5s 9h Qd 6h]
Seat 1: sanpidk (small blind) folded on the Turn
Seat 2: 50CandyJoe (big blind) collected ($4.75)
Seat 3: Xxth3nutzxX folded before Flop (didn't bet)
Seat 4: Sloeve folded before Flop (didn't bet)
Seat 5: darren1031 folded before Flop (didn't bet)
Seat 6: kamillo91 folded before Flop (didn't bet)
Seat 7: Painkiller72 folded before Flop (didn't bet)
Seat 8: matiko09 folded before Flop (didn't bet)
Seat 9: Hypoaroused (button) folded before Flop (didn't bet)





PokerStars Hand #152883990150:  Hold'em No Limit ($0.50/$1.00 USD) - 2016/05/05 15:36:08 CET [2016/05/05 9:36:08 ET]
Table 'Lictoria II' 9-max Seat #7 is the button
Seat 1: St.LaCoste ($101.37 in chips) 
Seat 2: Dantist1122 ($122.96 in chips) 
Seat 3: Krinica2009 ($100 in chips) 
Seat 4: Ying59 ($52.39 in chips) 
Seat 5: sanpidk ($105.75 in chips) 
Seat 6: gabi_igna ($127.59 in chips) 
Seat 7: Painkiller72 ($200.30 in chips) 
Seat 8: matiko09 ($100 in chips) 
Seat 9: Kukuryzka ($125.15 in chips) 
matiko09: posts small blind $0.50
Kukuryzka: posts big blind $1
*** HOLE CARDS ***
Dealt to matiko09 [3s Ts]
St.LaCoste: folds 
Dantist1122: folds 
Krinica2009: folds 
Ying59: raises $1 to $2
sanpidk: folds 
gabi_igna: folds 
Painkiller72: folds 
matiko09: folds 
Kukuryzka: folds 
Uncalled bet ($1) returned to Ying59
Ying59 collected $2.50 from pot
*** SUMMARY ***
Total pot $2.50 | Rake $0 
Seat 1: St.LaCoste folded before Flop (didn't bet)
Seat 2: Dantist1122 folded before Flop (didn't bet)
Seat 3: Krinica2009 folded before Flop (didn't bet)
Seat 4: Ying59 collected ($2.50)
Seat 5: sanpidk folded before Flop (didn't bet)
Seat 6: gabi_igna folded before Flop (didn't bet)
Seat 7: Painkiller72 (button) folded before Flop (didn't bet)
Seat 8: matiko09 (small blind) folded before Flop
Seat 9: Kukuryzka (big blind) folded before Flop





PokerStars Hand #152883990255:  Hold'em No Limit ($0.50/$1.00 USD) - 2016/05/05 15:36:08 CET [2016/05/05 9:36:08 ET]
Table 'Glarona II' 9-max Seat #2 is the button
Seat 1: KovIFish89 ($100 in chips) 
Seat 2: matiko09 ($139.50 in chips) 
Seat 3: Kukuryzka ($99 in chips) 
Seat 4: Mukhin1 ($100 in chips) 
Seat 5: Painkiller72 ($100 in chips) 
Seat 6: chirikow ($67.94 in chips) 
Seat 9: antfurto ($80 in chips) 
Kukuryzka: posts small blind $0.50
Mukhin1: posts big blind $1
Dantist1122: sits out 
ipashutapkom: sits out 
*** HOLE CARDS ***
Dealt to matiko09 [5c Kc]
Painkiller72: folds 
chirikow: raises $1.70 to $2.70
antfurto: folds 
KovIFish89: folds 
matiko09: folds 
Kukuryzka: calls $2.20
Mukhin1: folds 
*** FLOP *** [6s Kd Qh]
Kukuryzka: checks 
chirikow: checks 
*** TURN *** [6s Kd Qh] [2d]
Kukuryzka: checks 
chirikow: checks 
*** RIVER *** [6s Kd Qh 2d] [9h]
Kukuryzka: checks 
chirikow: checks 
*** SHOW DOWN ***
Kukuryzka: shows [7h 7d] (a pair of Sevens)
chirikow: shows [Jc Jd] (a pair of Jacks)
chirikow collected $6.08 from pot
*** SUMMARY ***
Total pot $6.40 | Rake $0.32 
Board [6s Kd Qh 2d 9h]
Seat 1: KovIFish89 folded before Flop (didn't bet)
Seat 2: matiko09 (button) folded before Flop (didn't bet)
Seat 3: Kukuryzka (small blind) showed [7h 7d] and lost with a pair of Sevens
Seat 4: Mukhin1 (big blind) folded before Flop
Seat 5: Painkiller72 folded before Flop (didn't bet)
Seat 6: chirikow showed [Jc Jd] and won ($6.08) with a pair of Jacks
Seat 9: antfurto folded before Flop (didn't bet)





PokerStars Hand #152883996646:  Hold'em No Limit ($0.50/$1.00 USD) - 2016/05/05 15:36:20 CET [2016/05/05 9:36:20 ET]
Table 'Natascha' 9-max Seat #9 is the button
Seat 1: ronald3737 ($88.68 in chips) 
Seat 2: matiko09 ($139.75 in chips) 
Seat 5: Dickyxxx ($131.76 in chips) 
Seat 6: gabi_igna ($153.44 in chips) 
Seat 7: torkkdnm ($149.24 in chips) 
Seat 8: kamillo91 ($75 in chips) 
Seat 9: guoweiAA ($234.70 in chips) 
ronald3737: posts small blind $0.50
matiko09: posts big blind $1
sanpidk: sits out 
*** HOLE CARDS ***
Dealt to matiko09 [2s 7h]
Dickyxxx: folds 
gabi_igna: folds 
torkkdnm: folds 
kamillo91: calls $1
guoweiAA: folds 
ronald3737: raises $3 to $4
matiko09: folds 
kamillo91: calls $3
*** FLOP *** [8d 8h 3h]
ronald3737: bets $6
kamillo91: calls $6
*** TURN *** [8d 8h 3h] [7d]
ronald3737: bets $12
kamillo91: calls $12
*** RIVER *** [8d 8h 3h 7d] [Qh]
ronald3737: bets $66.68 and is all-in
kamillo91: folds 
Uncalled bet ($66.68) returned to ronald3737
ronald3737 collected $42.75 from pot
ronald3737: doesn't show hand 
*** SUMMARY ***
Total pot $45 | Rake $2.25 
Board [8d 8h 3h 7d Qh]
Seat 1: ronald3737 (small blind) collected ($42.75)
Seat 2: matiko09 (big blind) folded before Flop
Seat 5: Dickyxxx folded before Flop (didn't bet)
Seat 6: gabi_igna folded before Flop (didn't bet)
Seat 7: torkkdnm folded before Flop (didn't bet)
Seat 8: kamillo91 folded on the River
Seat 9: guoweiAA (button) folded before Flop (didn't bet)





PokerStars Hand #152883998775:  Hold'em No Limit ($1/$2 USD) - 2016/05/05 15:36:23 CET [2016/05/05 9:36:23 ET]
Table 'Lundia' 9-max Seat #9 is the button
Seat 1: Fitzyferret ($219.82 in chips) 
Seat 2: patpaty ($165.60 in chips) 
Seat 3: IseeUcards ($413.77 in chips) 
Seat 4: KovIFish89 ($222.88 in chips) 
Seat 6: Spid1 ($245.74 in chips) 
Seat 7: matiko09 ($220.86 in chips) 
Seat 8: Durnichka ($79 in chips) 
Seat 9: gabi_igna ($208.06 in chips) 
Fitzyferret: posts small blind $1
patpaty: posts big blind $2
*** HOLE CARDS ***
Dealt to matiko09 [Ah 8s]
IseeUcards: folds 
KovIFish89: folds 
Spid1: folds 
matiko09: raises $3 to $5
Durnichka: folds 
gabi_igna: raises $13 to $18
Fitzyferret: folds 
patpaty: folds 
matiko09: folds 
Uncalled bet ($13) returned to gabi_igna
gabi_igna collected $13 from pot
gabi_igna: doesn't show hand 
*** SUMMARY ***
Total pot $13 | Rake $0 
Seat 1: Fitzyferret (small blind) folded before Flop
Seat 2: patpaty (big blind) folded before Flop
Seat 3: IseeUcards folded before Flop (didn't bet)
Seat 4: KovIFish89 folded before Flop (didn't bet)
Seat 6: Spid1 folded before Flop (didn't bet)
Seat 7: matiko09 folded before Flop
Seat 8: Durnichka folded before Flop (didn't bet)
Seat 9: gabi_igna (button) collected ($13)





PokerStars Hand #152883999794:  Hold'em No Limit ($1/$2 USD) - 2016/05/05 15:36:25 CET [2016/05/05 9:36:25 ET]
Table 'Tololo' 9-max Seat #5 is the button
Seat 1: Kukuryzka ($200 in chips) 
Seat 2: gabi_igna ($245.99 in chips) 
Seat 3: nickreason17 ($222.40 in chips) 
Seat 4: mooose100 ($219.43 in chips) 
Seat 5: matiko09 ($214 in chips) 
Seat 6: Xagua ($126.88 in chips) 
Seat 7: IseeUcards ($201.61 in chips) 
Seat 8: TonnaMunz ($433.57 in chips) 
Seat 9: Fitzyferret ($200 in chips) 
Xagua: posts small blind $1
IseeUcards: posts big blind $2
*** HOLE CARDS ***
Dealt to matiko09 [9c 7s]
TonnaMunz: folds 
Fitzyferret: raises $3.24 to $5.24
Kukuryzka: folds 
gabi_igna: folds 
nickreason17: folds 
mooose100: calls $5.24
matiko09: folds 
Xagua: folds 
IseeUcards: calls $3.24
*** FLOP *** [6c 3d Kc]
IseeUcards: checks 
Fitzyferret: bets $8
mooose100: folds 
IseeUcards: folds 
Uncalled bet ($8) returned to Fitzyferret
Fitzyferret collected $15.88 from pot
Fitzyferret: doesn't show hand 
*** SUMMARY ***
Total pot $16.72 | Rake $0.84 
Board [6c 3d Kc]
Seat 1: Kukuryzka folded before Flop (didn't bet)
Seat 2: gabi_igna folded before Flop (didn't bet)
Seat 3: nickreason17 folded before Flop (didn't bet)
Seat 4: mooose100 folded on the Flop
Seat 5: matiko09 (button) folded before Flop (didn't bet)
Seat 6: Xagua (small blind) folded before Flop
Seat 7: IseeUcards (big blind) folded on the Flop
Seat 8: TonnaMunz folded before Flop (didn't bet)
Seat 9: Fitzyferret collected ($15.88)





PokerStars Hand #152884008680:  Hold'em No Limit ($0.50/$1.00 USD) - 2016/05/05 15:36:41 CET [2016/05/05 9:36:41 ET]
Table 'Lictoria II' 9-max Seat #8 is the button
Seat 1: St.LaCoste ($101.37 in chips) 
Seat 2: Dantist1122 ($122.96 in chips) 
Seat 3: Krinica2009 ($100 in chips) 
Seat 4: Ying59 ($53.89 in chips) 
Seat 5: sanpidk ($105.75 in chips) 
Seat 6: gabi_igna ($127.59 in chips) 
Seat 7: Painkiller72 ($200.30 in chips) 
Seat 8: matiko09 ($100 in chips) 
Seat 9: Kukuryzka ($124.15 in chips) 
Kukuryzka: posts small blind $0.50
St.LaCoste: posts big blind $1
*** HOLE CARDS ***
Dealt to matiko09 [Qc 2s]
Dantist1122: folds 
Krinica2009: folds 
Ying59: raises $1 to $2
sanpidk: folds 
gabi_igna: folds 
Painkiller72: folds 
matiko09: folds 
Kukuryzka: folds 
St.LaCoste: folds 
Uncalled bet ($1) returned to Ying59
Ying59 collected $2.50 from pot
*** SUMMARY ***
Total pot $2.50 | Rake $0 
Seat 1: St.LaCoste (big blind) folded before Flop
Seat 2: Dantist1122 folded before Flop (didn't bet)
Seat 3: Krinica2009 folded before Flop (didn't bet)
Seat 4: Ying59 collected ($2.50)
Seat 5: sanpidk folded before Flop (didn't bet)
Seat 6: gabi_igna folded before Flop (didn't bet)
Seat 7: Painkiller72 folded before Flop (didn't bet)
Seat 8: matiko09 (button) folded before Flop (didn't bet)
Seat 9: Kukuryzka (small blind) folded before Flop





PokerStars Hand #152884016652:  Hold'em No Limit ($0.50/$1.00 USD) - 2016/05/05 15:36:55 CET [2016/05/05 9:36:55 ET]
Table 'Pyxis III' 9-max Seat #1 is the button
Seat 1: sanpidk ($182.53 in chips) 
Seat 2: 50CandyJoe ($102.25 in chips) 
Seat 4: Sloeve ($116.35 in chips) 
Seat 5: darren1031 ($83.28 in chips) 
Seat 6: kamillo91 ($47.50 in chips) 
Seat 7: Painkiller72 ($137.28 in chips) 
Seat 8: matiko09 ($100 in chips) 
Seat 9: Hypoaroused ($100 in chips) 
50CandyJoe: posts small blind $0.50
Sloeve: posts big blind $1
*** HOLE CARDS ***
Dealt to matiko09 [Qh Ah]
darren1031: calls $1
kamillo91: folds 
Painkiller72: folds 
ipashutapkom leaves the table
matiko09: raises $3 to $4
Hypoaroused: calls $4
sanpidk: folds 
50CandyJoe: folds 
Sloeve: folds 
darren1031: calls $3
*** FLOP *** [5c Th 7c]
darren1031: checks 
matiko09: checks 
Hypoaroused: bets $8
maxxmeister joins the table at seat #3 
darren1031: folds 
matiko09: folds 
Uncalled bet ($8) returned to Hypoaroused
Hypoaroused collected $12.82 from pot
*** SUMMARY ***
Total pot $13.50 | Rake $0.68 
Board [5c Th 7c]
Seat 1: sanpidk (button) folded before Flop (didn't bet)
Seat 2: 50CandyJoe (small blind) folded before Flop
Seat 4: Sloeve (big blind) folded before Flop
Seat 5: darren1031 folded on the Flop
Seat 6: kamillo91 folded before Flop (didn't bet)
Seat 7: Painkiller72 folded before Flop (didn't bet)
Seat 8: matiko09 folded on the Flop
Seat 9: Hypoaroused collected ($12.82)





PokerStars Hand #152884025774:  Hold'em No Limit ($1/$2 USD) - 2016/05/05 15:37:11 CET [2016/05/05 9:37:11 ET]
Table 'Samitchell' 9-max Seat #7 is the button
Seat 2: 13Ghosts ($285.81 in chips) 
Seat 3: gabi_igna ($307.32 in chips) 
Seat 4: Fitzyferret ($396.06 in chips) 
Seat 5: Spid1 ($200 in chips) 
Seat 6: matiko09 ($200 in chips) 
Seat 7: patpaty ($150.30 in chips) 
Seat 8: Hex0gen ($200 in chips) 
Seat 9: IseeUcards ($257.63 in chips) 
Hex0gen: posts small blind $1
IseeUcards: posts big blind $2
KovIFish89: sits out 
*** HOLE CARDS ***
Dealt to matiko09 [Kd 2c]
13Ghosts: folds 
gabi_igna: folds 
Fitzyferret: folds 
Spid1: folds 
matiko09: folds 
patpaty: raises $2 to $4
Hex0gen: folds 
IseeUcards: folds 
Uncalled bet ($2) returned to patpaty
patpaty collected $5 from pot
patpaty: doesn't show hand 
*** SUMMARY ***
Total pot $5 | Rake $0 
Seat 2: 13Ghosts folded before Flop (didn't bet)
Seat 3: gabi_igna folded before Flop (didn't bet)
Seat 4: Fitzyferret folded before Flop (didn't bet)
Seat 5: Spid1 folded before Flop (didn't bet)
Seat 6: matiko09 folded before Flop (didn't bet)
Seat 7: patpaty (button) collected ($5)
Seat 8: Hex0gen (small blind) folded before Flop
Seat 9: IseeUcards (big blind) folded before Flop





PokerStars Hand #152884026474:  Hold'em No Limit ($0.50/$1.00 USD) - 2016/05/05 15:37:13 CET [2016/05/05 9:37:13 ET]
Table 'Glarona II' 9-max Seat #3 is the button
Seat 1: KovIFish89 ($100 in chips) 
Seat 2: matiko09 ($139.50 in chips) 
Seat 3: Kukuryzka ($100 in chips) 
Seat 4: Mukhin1 ($100 in chips) 
Seat 5: Painkiller72 ($100 in chips) 
Seat 6: chirikow ($71.32 in chips) 
Seat 9: antfurto ($80 in chips) 
Mukhin1: posts small blind $0.50
Painkiller72: posts big blind $1
Dantist1122: sits out 
ipashutapkom: sits out 
*** HOLE CARDS ***
Dealt to matiko09 [5s Ts]
chirikow: folds 
antfurto: raises $2 to $3
KovIFish89: folds 
matiko09: folds 
Kukuryzka: folds 
Mukhin1: folds 
Painkiller72: folds 
Uncalled bet ($2) returned to antfurto
antfurto collected $2.50 from pot
antfurto: doesn't show hand 
*** SUMMARY ***
Total pot $2.50 | Rake $0 
Seat 1: KovIFish89 folded before Flop (didn't bet)
Seat 2: matiko09 folded before Flop (didn't bet)
Seat 3: Kukuryzka (button) folded before Flop (didn't bet)
Seat 4: Mukhin1 (small blind) folded before Flop
Seat 5: Painkiller72 (big blind) folded before Flop
Seat 6: chirikow folded before Flop (didn't bet)
Seat 9: antfurto collected ($2.50)





PokerStars Hand #152884026893:  Hold'em No Limit ($1/$2 USD) - 2016/05/05 15:37:13 CET [2016/05/05 9:37:13 ET]
Table 'Lundia' 9-max Seat #1 is the button
Seat 1: Fitzyferret ($218.82 in chips) 
Seat 2: patpaty ($163.60 in chips) 
Seat 3: IseeUcards ($413.77 in chips) 
Seat 4: KovIFish89 ($222.88 in chips) 
Seat 6: Spid1 ($245.74 in chips) 
Seat 7: matiko09 ($215.86 in chips) 
Seat 8: Durnichka ($79 in chips) 
Seat 9: gabi_igna ($216.06 in chips) 
patpaty: posts small blind $1
IseeUcards: posts big blind $2
*** HOLE CARDS ***
Dealt to matiko09 [8s Ks]
KovIFish89: folds 
Spid1: folds 
matiko09: folds 
Durnichka: folds 
gabi_igna: folds 
Fitzyferret: raises $2.60 to $4.60
patpaty: folds 
IseeUcards: calls $2.60
*** FLOP *** [Ad 3c Ac]
IseeUcards: checks 
Fitzyferret: checks 
*** TURN *** [Ad 3c Ac] [Tc]
IseeUcards: checks 
Fitzyferret: checks 
*** RIVER *** [Ad 3c Ac Tc] [9c]
IseeUcards: checks 
Fitzyferret: bets $5.08
IseeUcards: folds 
Uncalled bet ($5.08) returned to Fitzyferret
Fitzyferret collected $9.69 from pot
Fitzyferret: doesn't show hand 
*** SUMMARY ***
Total pot $10.20 | Rake $0.51 
Board [Ad 3c Ac Tc 9c]
Seat 1: Fitzyferret (button) collected ($9.69)
Seat 2: patpaty (small blind) folded before Flop
Seat 3: IseeUcards (big blind) folded on the River
Seat 4: KovIFish89 folded before Flop (didn't bet)
Seat 6: Spid1 folded before Flop (didn't bet)
Seat 7: matiko09 folded before Flop (didn't bet)
Seat 8: Durnichka folded before Flop (didn't bet)
Seat 9: gabi_igna folded before Flop (didn't bet)





PokerStars Hand #152884031323:  Hold'em No Limit ($0.50/$1.00 USD) - 2016/05/05 15:37:21 CET [2016/05/05 9:37:21 ET]
Table 'Lictoria II' 9-max Seat #9 is the button
Seat 1: St.LaCoste ($100.37 in chips) 
Seat 2: Dantist1122 ($122.96 in chips) 
Seat 3: Krinica2009 ($100 in chips) 
Seat 4: Ying59 ($55.39 in chips) 
Seat 5: sanpidk ($105.75 in chips) 
Seat 6: gabi_igna ($127.59 in chips) 
Seat 7: Painkiller72 ($200.30 in chips) 
Seat 8: matiko09 ($100 in chips) 
Seat 9: Kukuryzka ($123.65 in chips) 
St.LaCoste: posts small blind $0.50
Dantist1122: posts big blind $1
*** HOLE CARDS ***
Dealt to matiko09 [As 4c]
Krinica2009: raises $2 to $3
Ying59: calls $3
sanpidk: raises $10 to $13
gabi_igna: folds 
Painkiller72: folds 
matiko09: folds 
Kukuryzka: folds 
St.LaCoste: folds 
Dantist1122: folds 
Krinica2009: folds 
Ying59: calls $10
*** FLOP *** [Ah Jh Qd]
Ying59: checks 
sanpidk: checks 
*** TURN *** [Ah Jh Qd] [4h]
Ying59: checks 
sanpidk: checks 
*** RIVER *** [Ah Jh Qd 4h] [Jd]
Ying59: bets $14.49
sanpidk: raises $78.26 to $92.75 and is all-in
Ying59: calls $27.90 and is all-in
Uncalled bet ($50.36) returned to sanpidk
*** SHOW DOWN ***
sanpidk: shows [Jc Kc] (three of a kind, Jacks)
Ying59: shows [Qh Kh] (a flush, Ace high)
Ying59 collected $112.78 from pot
*** SUMMARY ***
Total pot $115.28 | Rake $2.50 
Board [Ah Jh Qd 4h Jd]
Seat 1: St.LaCoste (small blind) folded before Flop
Seat 2: Dantist1122 (big blind) folded before Flop
Seat 3: Krinica2009 folded before Flop
Seat 4: Ying59 showed [Qh Kh] and won ($112.78) with a flush, Ace high
Seat 5: sanpidk showed [Jc Kc] and lost with three of a kind, Jacks
Seat 6: gabi_igna folded before Flop (didn't bet)
Seat 7: Painkiller72 folded before Flop (didn't bet)
Seat 8: matiko09 folded before Flop (didn't bet)
Seat 9: Kukuryzka (button) folded before Flop (didn't bet)





PokerStars Hand #152884033173:  Hold'em No Limit ($0.50/$1.00 USD) - 2016/05/05 15:37:24 CET [2016/05/05 9:37:24 ET]
Table 'Priska II' 9-max Seat #6 is the button
Seat 1: Spid1 ($105.92 in chips) 
Seat 2: Kukuryzka ($100 in chips) 
Seat 3: matiko09 ($100 in chips) 
Seat 4: Painkiller72 ($167.16 in chips) 
Seat 5: nickreason17 ($175.55 in chips) 
Seat 6: OneTwo81 ($100.23 in chips) 
Seat 7: stockbridge8 ($104.27 in chips) 
Seat 8: pohorc21 ($16.66 in chips) 
Seat 9: torkkdnm ($102.55 in chips) 
stockbridge8: posts small blind $0.50
pohorc21: posts big blind $1
*** HOLE CARDS ***
Dealt to matiko09 [6d Th]
torkkdnm: folds 
Spid1: raises $2 to $3
Kukuryzka: folds 
matiko09: folds 
pohorc21 said, "posranec"
Painkiller72: calls $3
nickreason17: folds 
OneTwo81: calls $3
stockbridge8: folds 
pohorc21: folds 
*** FLOP *** [7s 7c 5d]
Spid1: bets $7
Painkiller72: folds 
OneTwo81: folds 
Uncalled bet ($7) returned to Spid1
Spid1 collected $9.98 from pot
Spid1: doesn't show hand 
*** SUMMARY ***
Total pot $10.50 | Rake $0.52 
Board [7s 7c 5d]
Seat 1: Spid1 collected ($9.98)
Seat 2: Kukuryzka folded before Flop (didn't bet)
Seat 3: matiko09 folded before Flop (didn't bet)
Seat 4: Painkiller72 folded on the Flop
Seat 5: nickreason17 folded before Flop (didn't bet)
Seat 6: OneTwo81 (button) folded on the Flop
Seat 7: stockbridge8 (small blind) folded before Flop
Seat 8: pohorc21 (big blind) folded before Flop
Seat 9: torkkdnm folded before Flop (didn't bet)





PokerStars Hand #152884038039:  Hold'em No Limit ($1/$2 USD) - 2016/05/05 15:37:33 CET [2016/05/05 9:37:33 ET]
Table 'Tololo' 9-max Seat #6 is the button
Seat 1: Kukuryzka ($200 in chips) 
Seat 2: gabi_igna ($245.99 in chips) 
Seat 3: nickreason17 ($222.40 in chips) 
Seat 4: mooose100 ($214.19 in chips) 
Seat 5: matiko09 ($214 in chips) 
Seat 6: Xagua ($125.88 in chips) 
Seat 7: IseeUcards ($200 in chips) 
Seat 8: TonnaMunz ($433.57 in chips) 
Seat 9: Fitzyferret ($210.64 in chips) 
IseeUcards: posts small blind $1
TonnaMunz: posts big blind $2
*** HOLE CARDS ***
Dealt to matiko09 [Js 5d]
Fitzyferret: folds 
Kukuryzka: folds 
gabi_igna: raises $4 to $6
nickreason17: raises $14 to $20
mooose100: folds 
matiko09: folds 
Xagua: folds 
IseeUcards: folds 
TonnaMunz: folds 
gabi_igna: folds 
Uncalled bet ($14) returned to nickreason17
nickreason17 collected $15 from pot
*** SUMMARY ***
Total pot $15 | Rake $0 
Seat 1: Kukuryzka folded before Flop (didn't bet)
Seat 2: gabi_igna folded before Flop
Seat 3: nickreason17 collected ($15)
Seat 4: mooose100 folded before Flop (didn't bet)
Seat 5: matiko09 folded before Flop (didn't bet)
Seat 6: Xagua (button) folded before Flop (didn't bet)
Seat 7: IseeUcards (small blind) folded before Flop
Seat 8: TonnaMunz (big blind) folded before Flop
Seat 9: Fitzyferret folded before Flop (didn't bet)





PokerStars Hand #152884040502:  Hold'em No Limit ($0.50/$1.00 USD) - 2016/05/05 15:37:37 CET [2016/05/05 9:37:37 ET]
Table 'Glarona II' 9-max Seat #4 is the button
Seat 1: KovIFish89 ($100 in chips) 
Seat 2: matiko09 ($139.50 in chips) 
Seat 3: Kukuryzka ($100 in chips) 
Seat 4: Mukhin1 ($100 in chips) 
Seat 5: Painkiller72 ($100 in chips) 
Seat 6: chirikow ($71.32 in chips) 
Seat 9: antfurto ($81.50 in chips) 
Painkiller72: posts small blind $0.50
chirikow: posts big blind $1
Dantist1122: sits out 
ipashutapkom: sits out 
*** HOLE CARDS ***
Dealt to matiko09 [Ac 6s]
antfurto: folds 
KovIFish89: folds 
matiko09: folds 
Kukuryzka: folds 
Mukhin1: raises $1.30 to $2.30
Painkiller72: folds 
chirikow: folds 
Uncalled bet ($1.30) returned to Mukhin1
Mukhin1 collected $2.50 from pot
Mukhin1: doesn't show hand 
*** SUMMARY ***
Total pot $2.50 | Rake $0 
Seat 1: KovIFish89 folded before Flop (didn't bet)
Seat 2: matiko09 folded before Flop (didn't bet)
Seat 3: Kukuryzka folded before Flop (didn't bet)
Seat 4: Mukhin1 (button) collected ($2.50)
Seat 5: Painkiller72 (small blind) folded before Flop
Seat 6: chirikow (big blind) folded before Flop
Seat 9: antfurto folded before Flop (didn't bet)





PokerStars Hand #152884042792:  Hold'em No Limit ($1/$2 USD) - 2016/05/05 15:37:41 CET [2016/05/05 9:37:41 ET]
Table 'Samitchell' 9-max Seat #8 is the button
Seat 1: KovIFish89 ($200 in chips) 
Seat 2: 13Ghosts ($285.81 in chips) 
Seat 3: gabi_igna ($307.32 in chips) 
Seat 4: Fitzyferret ($396.06 in chips) 
Seat 5: Spid1 ($200 in chips) 
Seat 6: matiko09 ($200 in chips) 
Seat 7: patpaty ($153.30 in chips) 
Seat 8: Hex0gen ($199 in chips) 
Seat 9: IseeUcards ($255.63 in chips) 
IseeUcards: posts small blind $1
KovIFish89: posts big blind $2
*** HOLE CARDS ***
Dealt to matiko09 [8c 3h]
13Ghosts: folds 
gabi_igna: folds 
Fitzyferret: folds 
Spid1: folds 
matiko09: folds 
patpaty: calls $2
Hex0gen: folds 
IseeUcards: folds 
KovIFish89: checks 
*** FLOP *** [Qh 4d Ts]
KovIFish89: checks 
patpaty: checks 
*** TURN *** [Qh 4d Ts] [4s]
KovIFish89: bets $3
patpaty: calls $3
*** RIVER *** [Qh 4d Ts 4s] [2c]
KovIFish89: bets $5
patpaty: folds 
Uncalled bet ($5) returned to KovIFish89
KovIFish89 collected $10.45 from pot
KovIFish89: doesn't show hand 
*** SUMMARY ***
Total pot $11 | Rake $0.55 
Board [Qh 4d Ts 4s 2c]
Seat 1: KovIFish89 (big blind) collected ($10.45)
Seat 2: 13Ghosts folded before Flop (didn't bet)
Seat 3: gabi_igna folded before Flop (didn't bet)
Seat 4: Fitzyferret folded before Flop (didn't bet)
Seat 5: Spid1 folded before Flop (didn't bet)
Seat 6: matiko09 folded before Flop (didn't bet)
Seat 7: patpaty folded on the River
Seat 8: Hex0gen (button) folded before Flop (didn't bet)
Seat 9: IseeUcards (small blind) folded before Flop





PokerStars Hand #152884048292:  Hold'em No Limit ($0.50/$1.00 USD) - 2016/05/05 15:37:51 CET [2016/05/05 9:37:51 ET]
Table 'Natascha' 9-max Seat #1 is the button
Seat 1: ronald3737 ($109.43 in chips) 
Seat 2: matiko09 ($138.75 in chips) 
Seat 3: bjonlyking ($143.50 in chips) 
Seat 5: Dickyxxx ($131.76 in chips) 
Seat 6: gabi_igna ($153.44 in chips) 
Seat 7: torkkdnm ($149.24 in chips) 
Seat 8: kamillo91 ($53 in chips) 
Seat 9: guoweiAA ($234.70 in chips) 
matiko09: posts small blind $0.50
bjonlyking: posts big blind $1
sanpidk: sits out 
*** HOLE CARDS ***
Dealt to matiko09 [9h 4c]
Dickyxxx: folds 
gabi_igna: folds 
torkkdnm: folds 
kamillo91: calls $1
guoweiAA: folds 
ronald3737: calls $1
matiko09: folds 
bjonlyking: checks 
*** FLOP *** [Kc 6h 7c]
bjonlyking: checks 
kamillo91: checks 
ronald3737: checks 
*** TURN *** [Kc 6h 7c] [8d]
bjonlyking: checks 
kamillo91: checks 
ronald3737: checks 
*** RIVER *** [Kc 6h 7c 8d] [Kh]
bjonlyking: checks 
kamillo91: checks 
ronald3737: checks 
*** SHOW DOWN ***
bjonlyking: shows [Td 7d] (two pair, Kings and Sevens)
kamillo91: mucks hand 
ronald3737: mucks hand 
bjonlyking collected $3.32 from pot
*** SUMMARY ***
Total pot $3.50 | Rake $0.18 
Board [Kc 6h 7c 8d Kh]
Seat 1: ronald3737 (button) mucked [4s Ad]
Seat 2: matiko09 (small blind) folded before Flop
Seat 3: bjonlyking (big blind) showed [Td 7d] and won ($3.32) with two pair, Kings and Sevens
Seat 5: Dickyxxx folded before Flop (didn't bet)
Seat 6: gabi_igna folded before Flop (didn't bet)
Seat 7: torkkdnm folded before Flop (didn't bet)
Seat 8: kamillo91 mucked [9c Js]
Seat 9: guoweiAA folded before Flop (didn't bet)





PokerStars Hand #152884053119:  Hold'em No Limit ($0.50/$1.00 USD) - 2016/05/05 15:38:00 CET [2016/05/05 9:38:00 ET]
Table 'Priska II' 9-max Seat #7 is the button
Seat 1: Spid1 ($112.90 in chips) 
Seat 2: Kukuryzka ($100 in chips) 
Seat 3: matiko09 ($100 in chips) 
Seat 4: Painkiller72 ($164.16 in chips) 
Seat 5: nickreason17 ($175.55 in chips) 
Seat 6: OneTwo81 ($97.23 in chips) 
Seat 7: stockbridge8 ($103.77 in chips) 
Seat 8: pohorc21 ($15.66 in chips) 
Seat 9: torkkdnm ($102.55 in chips) 
pohorc21: posts small blind $0.50
torkkdnm: posts big blind $1
*** HOLE CARDS ***
Dealt to matiko09 [Kh Kd]
Spid1: folds 
Kukuryzka: folds 
matiko09: raises $2 to $3
Painkiller72: folds 
nickreason17: folds 
OneTwo81: folds 
stockbridge8: folds 
pohorc21: folds 
torkkdnm: folds 
Uncalled bet ($2) returned to matiko09
matiko09 collected $2.50 from pot
matiko09: doesn't show hand 
*** SUMMARY ***
Total pot $2.50 | Rake $0 
Seat 1: Spid1 folded before Flop (didn't bet)
Seat 2: Kukuryzka folded before Flop (didn't bet)
Seat 3: matiko09 collected ($2.50)
Seat 4: Painkiller72 folded before Flop (didn't bet)
Seat 5: nickreason17 folded before Flop (didn't bet)
Seat 6: OneTwo81 folded before Flop (didn't bet)
Seat 7: stockbridge8 (button) folded before Flop (didn't bet)
Seat 8: pohorc21 (small blind) folded before Flop
Seat 9: torkkdnm (big blind) folded before Flop





PokerStars Hand #152884055351:  Hold'em No Limit ($1/$2 USD) - 2016/05/05 15:38:04 CET [2016/05/05 9:38:04 ET]
Table 'Tololo' 9-max Seat #7 is the button
Seat 1: Kukuryzka ($200 in chips) 
Seat 2: gabi_igna ($239.99 in chips) 
Seat 3: nickreason17 ($231.40 in chips) 
Seat 4: mooose100 ($214.19 in chips) 
Seat 5: matiko09 ($214 in chips) 
Seat 6: Xagua ($125.88 in chips) 
Seat 7: IseeUcards ($200 in chips) 
Seat 8: TonnaMunz ($431.57 in chips) 
Seat 9: Fitzyferret ($210.64 in chips) 
TonnaMunz: posts small blind $1
Fitzyferret: posts big blind $2
*** HOLE CARDS ***
Dealt to matiko09 [3d Tc]
Kukuryzka: raises $4 to $6
gabi_igna: folds 
nickreason17: raises $12 to $18
mooose100: folds 
matiko09: folds 
Xagua: folds 
IseeUcards: folds 
TonnaMunz: folds 
Fitzyferret: folds 
Kukuryzka: folds 
Uncalled bet ($12) returned to nickreason17
nickreason17 collected $15 from pot
*** SUMMARY ***
Total pot $15 | Rake $0 
Seat 1: Kukuryzka folded before Flop
Seat 2: gabi_igna folded before Flop (didn't bet)
Seat 3: nickreason17 collected ($15)
Seat 4: mooose100 folded before Flop (didn't bet)
Seat 5: matiko09 folded before Flop (didn't bet)
Seat 6: Xagua folded before Flop (didn't bet)
Seat 7: IseeUcards (button) folded before Flop (didn't bet)
Seat 8: TonnaMunz (small blind) folded before Flop
Seat 9: Fitzyferret (big blind) folded before Flop





PokerStars Hand #152884056876:  Hold'em No Limit ($0.50/$1.00 USD) - 2016/05/05 15:38:07 CET [2016/05/05 9:38:07 ET]
Table 'Pyxis III' 9-max Seat #2 is the button
Seat 1: sanpidk ($182.53 in chips) 
Seat 2: 50CandyJoe ($101.75 in chips) 
Seat 4: Sloeve ($115.35 in chips) 
Seat 5: darren1031 ($80 in chips) 
Seat 6: kamillo91 ($47.50 in chips) 
Seat 7: Painkiller72 ($137.28 in chips) 
Seat 8: matiko09 ($100 in chips) 
Seat 9: Hypoaroused ($108.82 in chips) 
maxxmeister will be allowed to play after the button
Sloeve: posts small blind $0.50
darren1031: posts big blind $1
*** HOLE CARDS ***
Dealt to matiko09 [9c 7h]
kamillo91: calls $1
Painkiller72: folds 
matiko09: folds 
Hypoaroused: calls $1
sanpidk: folds 
50CandyJoe: calls $1
Sloeve: calls $0.50
darren1031: checks 
*** FLOP *** [6h 5h 3h]
Sloeve: checks 
maxxmeister leaves the table
vrnMike joins the table at seat #3 
darren1031: checks 
kamillo91: checks 
Hypoaroused: bets $4.75
50CandyJoe: raises $13.82 to $18.57
Sloeve: folds 
darren1031: folds 
kamillo91: folds 
Hypoaroused: raises $89.25 to $107.82 and is all-in
50CandyJoe: calls $82.18 and is all-in
Uncalled bet ($7.07) returned to Hypoaroused
*** TURN *** [6h 5h 3h] [Ts]
*** RIVER *** [6h 5h 3h Ts] [Kh]
*** SHOW DOWN ***
Hypoaroused: shows [Th Jh] (a flush, King high)
50CandyJoe: shows [8h 4h] (a flush, King high - lower cards)
Hypoaroused collected $204 from pot
*** SUMMARY ***
Total pot $206.50 | Rake $2.50 
Board [6h 5h 3h Ts Kh]
Seat 1: sanpidk folded before Flop (didn't bet)
Seat 2: 50CandyJoe (button) showed [8h 4h] and lost with a flush, King high
Seat 4: Sloeve (small blind) folded on the Flop
Seat 5: darren1031 (big blind) folded on the Flop
Seat 6: kamillo91 folded on the Flop
Seat 7: Painkiller72 folded before Flop (didn't bet)
Seat 8: matiko09 folded before Flop (didn't bet)
Seat 9: Hypoaroused showed [Th Jh] and won ($204) with a flush, King high





PokerStars Hand #152884061946:  Hold'em No Limit ($0.50/$1.00 USD) - 2016/05/05 15:38:16 CET [2016/05/05 9:38:16 ET]
Table 'Glarona II' 9-max Seat #5 is the button
Seat 1: KovIFish89 ($100 in chips) 
Seat 2: matiko09 ($139.50 in chips) 
Seat 3: Kukuryzka ($100 in chips) 
Seat 4: Mukhin1 ($101.50 in chips) 
Seat 5: Painkiller72 ($100 in chips) 
Seat 6: chirikow ($70.32 in chips) 
Seat 7: Dantist1122 ($100 in chips) 
Seat 9: antfurto ($81.50 in chips) 
chirikow: posts small blind $0.50
Dantist1122: posts big blind $1
ipashutapkom: sits out 
*** HOLE CARDS ***
Dealt to matiko09 [Qc Ah]
antfurto: folds 
KovIFish89: raises $2 to $3
matiko09: calls $3
Kukuryzka: folds 
antfurto leaves the table
Mukhin1: folds 
Painkiller72 has timed out
Painkiller72: folds 
chirikow: folds 
Dantist1122: folds 
*** FLOP *** [4d Jh 6s]
mycka86 joins the table at seat #9 
KovIFish89: checks 
matiko09: bets $4.63
KovIFish89: calls $4.63
*** TURN *** [4d Jh 6s] [6d]
KovIFish89: checks 
matiko09: checks 
*** RIVER *** [4d Jh 6s 6d] [6h]
KovIFish89: bets $9
matiko09: folds 
Uncalled bet ($9) returned to KovIFish89
KovIFish89 collected $15.92 from pot
KovIFish89: doesn't show hand 
*** SUMMARY ***
Total pot $16.76 | Rake $0.84 
Board [4d Jh 6s 6d 6h]
Seat 1: KovIFish89 collected ($15.92)
Seat 2: matiko09 folded on the River
Seat 3: Kukuryzka folded before Flop (didn't bet)
Seat 4: Mukhin1 folded before Flop (didn't bet)
Seat 5: Painkiller72 (button) folded before Flop (didn't bet)
Seat 6: chirikow (small blind) folded before Flop
Seat 7: Dantist1122 (big blind) folded before Flop
Seat 9: antfurto folded before Flop (didn't bet)





PokerStars Hand #152884066622:  Hold'em No Limit ($0.50/$1.00 USD) - 2016/05/05 15:38:24 CET [2016/05/05 9:38:24 ET]
Table 'Priska II' 9-max Seat #8 is the button
Seat 1: Spid1 ($112.90 in chips) 
Seat 2: Kukuryzka ($100 in chips) 
Seat 3: matiko09 ($101.50 in chips) 
Seat 4: Painkiller72 ($164.16 in chips) 
Seat 5: nickreason17 ($175.55 in chips) 
Seat 6: OneTwo81 ($97.23 in chips) 
Seat 7: stockbridge8 ($103.77 in chips) 
Seat 8: pohorc21 ($15.16 in chips) 
Seat 9: torkkdnm ($101.55 in chips) 
torkkdnm: posts small blind $0.50
Spid1: posts big blind $1
*** HOLE CARDS ***
Dealt to matiko09 [Qd 5h]
Kukuryzka: folds 
matiko09: folds 
Painkiller72: folds 
nickreason17: folds 
OneTwo81: folds 
stockbridge8: raises $2 to $3
pohorc21: folds 
torkkdnm: raises $7 to $10
Spid1: folds 
stockbridge8: calls $7
*** FLOP *** [Jh Th 2c]
torkkdnm: bets $16
stockbridge8: folds 
Uncalled bet ($16) returned to torkkdnm
torkkdnm collected $19.95 from pot
*** SUMMARY ***
Total pot $21 | Rake $1.05 
Board [Jh Th 2c]
Seat 1: Spid1 (big blind) folded before Flop
Seat 2: Kukuryzka folded before Flop (didn't bet)
Seat 3: matiko09 folded before Flop (didn't bet)
Seat 4: Painkiller72 folded before Flop (didn't bet)
Seat 5: nickreason17 folded before Flop (didn't bet)
Seat 6: OneTwo81 folded before Flop (didn't bet)
Seat 7: stockbridge8 folded on the Flop
Seat 8: pohorc21 (button) folded before Flop (didn't bet)
Seat 9: torkkdnm (small blind) collected ($19.95)





PokerStars Hand #152884071997:  Hold'em No Limit ($1/$2 USD) - 2016/05/05 15:38:33 CET [2016/05/05 9:38:33 ET]
Table 'Lundia' 9-max Seat #2 is the button
Seat 1: Fitzyferret ($223.91 in chips) 
Seat 2: patpaty ($162.60 in chips) 
Seat 3: IseeUcards ($409.17 in chips) 
Seat 4: KovIFish89 ($222.88 in chips) 
Seat 6: Spid1 ($245.74 in chips) 
Seat 7: matiko09 ($215.86 in chips) 
Seat 8: Durnichka ($79 in chips) 
Seat 9: gabi_igna ($216.06 in chips) 
IseeUcards: posts small blind $1
KovIFish89: posts big blind $2
*** HOLE CARDS ***
Dealt to matiko09 [2d 9s]
Spid1: folds 
matiko09: folds 
Durnichka: raises $3 to $5
gabi_igna: calls $5
Fitzyferret: folds 
patpaty: calls $5
IseeUcards: folds 
KovIFish89: folds 
*** FLOP *** [7c As Qc]
Durnichka: checks 
gabi_igna: checks 
patpaty: bets $2
Durnichka: calls $2
gabi_igna: folds 
*** TURN *** [7c As Qc] [5h]
Durnichka: checks 
patpaty: bets $2
Durnichka: calls $2
*** RIVER *** [7c As Qc 5h] [5s]
Durnichka: checks 
patpaty: bets $10
Durnichka: calls $10
*** SHOW DOWN ***
patpaty: shows [Jd Ac] (two pair, Aces and Fives)
Durnichka: mucks hand 
patpaty collected $43.70 from pot
*** SUMMARY ***
Total pot $46 | Rake $2.30 
Board [7c As Qc 5h 5s]
Seat 1: Fitzyferret folded before Flop (didn't bet)
Seat 2: patpaty (button) showed [Jd Ac] and won ($43.70) with two pair, Aces and Fives
Seat 3: IseeUcards (small blind) folded before Flop
Seat 4: KovIFish89 (big blind) folded before Flop
Seat 6: Spid1 folded before Flop (didn't bet)
Seat 7: matiko09 folded before Flop (didn't bet)
Seat 8: Durnichka mucked [Qs Kh]
Seat 9: gabi_igna folded on the Flop





PokerStars Hand #152884072384:  Hold'em No Limit ($1/$2 USD) - 2016/05/05 15:38:34 CET [2016/05/05 9:38:34 ET]
Table 'Tololo' 9-max Seat #8 is the button
Seat 1: Kukuryzka ($200 in chips) 
Seat 2: gabi_igna ($239.99 in chips) 
Seat 3: nickreason17 ($240.40 in chips) 
Seat 4: mooose100 ($214.19 in chips) 
Seat 5: matiko09 ($214 in chips) 
Seat 6: Xagua ($125.88 in chips) 
Seat 7: IseeUcards ($200 in chips) 
Seat 8: TonnaMunz ($430.57 in chips) 
Seat 9: Fitzyferret ($208.64 in chips) 
Fitzyferret: posts small blind $1
Kukuryzka: posts big blind $2
*** HOLE CARDS ***
Dealt to matiko09 [Qs 2c]
gabi_igna: folds 
nickreason17: folds 
mooose100: folds 
matiko09: folds 
Xagua: raises $4 to $6
IseeUcards: folds 
TonnaMunz: folds 
Fitzyferret: folds 
Kukuryzka: folds 
Uncalled bet ($4) returned to Xagua
Xagua collected $5 from pot
Xagua: doesn't show hand 
*** SUMMARY ***
Total pot $5 | Rake $0 
Seat 1: Kukuryzka (big blind) folded before Flop
Seat 2: gabi_igna folded before Flop (didn't bet)
Seat 3: nickreason17 folded before Flop (didn't bet)
Seat 4: mooose100 folded before Flop (didn't bet)
Seat 5: matiko09 folded before Flop (didn't bet)
Seat 6: Xagua collected ($5)
Seat 7: IseeUcards folded before Flop (didn't bet)
Seat 8: TonnaMunz (button) folded before Flop (didn't bet)
Seat 9: Fitzyferret (small blind) folded before Flop





PokerStars Hand #152884075812:  Hold'em No Limit ($1/$2 USD) - 2016/05/05 15:38:40 CET [2016/05/05 9:38:40 ET]
Table 'Samitchell' 9-max Seat #9 is the button
Seat 1: KovIFish89 ($205.45 in chips) 
Seat 2: 13Ghosts ($285.81 in chips) 
Seat 3: gabi_igna ($307.32 in chips) 
Seat 4: Fitzyferret ($396.06 in chips) 
Seat 5: Spid1 ($200 in chips) 
Seat 6: matiko09 ($200 in chips) 
Seat 7: patpaty ($148.30 in chips) 
Seat 8: Hex0gen ($200 in chips) 
Seat 9: IseeUcards ($254.63 in chips) 
KovIFish89: posts small blind $1
13Ghosts: posts big blind $2
*** HOLE CARDS ***
Dealt to matiko09 [3c Ah]
gabi_igna: folds 
Fitzyferret: folds 
Spid1: folds 
matiko09: folds 
patpaty: raises $2 to $4
Hex0gen: folds 
IseeUcards: folds 
KovIFish89: folds 
13Ghosts: folds 
Uncalled bet ($2) returned to patpaty
patpaty collected $5 from pot
patpaty: doesn't show hand 
*** SUMMARY ***
Total pot $5 | Rake $0 
Seat 1: KovIFish89 (small blind) folded before Flop
Seat 2: 13Ghosts (big blind) folded before Flop
Seat 3: gabi_igna folded before Flop (didn't bet)
Seat 4: Fitzyferret folded before Flop (didn't bet)
Seat 5: Spid1 folded before Flop (didn't bet)
Seat 6: matiko09 folded before Flop (didn't bet)
Seat 7: patpaty collected ($5)
Seat 8: Hex0gen folded before Flop (didn't bet)
Seat 9: IseeUcards (button) folded before Flop (didn't bet)





PokerStars Hand #152884094504:  Hold'em No Limit ($0.50/$1.00 USD) - 2016/05/05 15:39:13 CET [2016/05/05 9:39:13 ET]
Table 'Natascha' 9-max Seat #2 is the button
Seat 1: ronald3737 ($108.43 in chips) 
Seat 2: matiko09 ($138.25 in chips) 
Seat 3: bjonlyking ($145.82 in chips) 
Seat 4: sanpidk ($100 in chips) 
Seat 5: Dickyxxx ($131.76 in chips) 
Seat 6: gabi_igna ($153.44 in chips) 
Seat 7: torkkdnm ($149.24 in chips) 
Seat 8: kamillo91 ($52 in chips) 
Seat 9: guoweiAA ($234.70 in chips) 
bjonlyking: posts small blind $0.50
sanpidk: posts big blind $1
*** HOLE CARDS ***
Dealt to matiko09 [Kc 4d]
Dickyxxx: folds 
gabi_igna: folds 
torkkdnm: folds 
kamillo91: folds 
guoweiAA: folds 
ronald3737: raises $1 to $2
matiko09: folds 
bjonlyking: folds 
sanpidk: folds 
Uncalled bet ($1) returned to ronald3737
ronald3737 collected $2.50 from pot
ronald3737: doesn't show hand 
*** SUMMARY ***
Total pot $2.50 | Rake $0 
Seat 1: ronald3737 collected ($2.50)
Seat 2: matiko09 (button) folded before Flop (didn't bet)
Seat 3: bjonlyking (small blind) folded before Flop
Seat 4: sanpidk (big blind) folded before Flop
Seat 5: Dickyxxx folded before Flop (didn't bet)
Seat 6: gabi_igna folded before Flop (didn't bet)
Seat 7: torkkdnm folded before Flop (didn't bet)
Seat 8: kamillo91 folded before Flop (didn't bet)
Seat 9: guoweiAA folded before Flop (didn't bet)





PokerStars Hand #152884094570:  Hold'em No Limit ($0.50/$1.00 USD) - 2016/05/05 15:39:14 CET [2016/05/05 9:39:14 ET]
Table 'Lictoria II' 9-max Seat #1 is the button
Seat 1: St.LaCoste ($100 in chips) 
Seat 2: Dantist1122 ($121.96 in chips) 
Seat 3: Krinica2009 ($100 in chips) 
Seat 4: Ying59 ($112.78 in chips) 
Seat 5: sanpidk ($100 in chips) 
Seat 6: gabi_igna ($127.59 in chips) 
Seat 7: Painkiller72 ($200.30 in chips) 
Seat 8: matiko09 ($100 in chips) 
Seat 9: Kukuryzka ($123.65 in chips) 
Dantist1122: posts small blind $0.50
Krinica2009: posts big blind $1
*** HOLE CARDS ***
Dealt to matiko09 [2c 7c]
Ying59: folds 
sanpidk: folds 
gabi_igna: raises $2 to $3
Painkiller72: folds 
matiko09: folds 
Kukuryzka: folds 
St.LaCoste: folds 
Dantist1122: folds 
Krinica2009: folds 
Uncalled bet ($2) returned to gabi_igna
gabi_igna collected $2.50 from pot
gabi_igna: doesn't show hand 
*** SUMMARY ***
Total pot $2.50 | Rake $0 
Seat 1: St.LaCoste (button) folded before Flop (didn't bet)
Seat 2: Dantist1122 (small blind) folded before Flop
Seat 3: Krinica2009 (big blind) folded before Flop
Seat 4: Ying59 folded before Flop (didn't bet)
Seat 5: sanpidk folded before Flop (didn't bet)
Seat 6: gabi_igna collected ($2.50)
Seat 7: Painkiller72 folded before Flop (didn't bet)
Seat 8: matiko09 folded before Flop (didn't bet)
Seat 9: Kukuryzka folded before Flop (didn't bet)





PokerStars Hand #152884096356:  Hold'em No Limit ($1/$2 USD) - 2016/05/05 15:39:17 CET [2016/05/05 9:39:17 ET]
Table 'Tololo' 9-max Seat #9 is the button
Seat 1: Kukuryzka ($198 in chips) 
Seat 2: gabi_igna ($239.99 in chips) 
Seat 3: nickreason17 ($240.40 in chips) 
Seat 4: mooose100 ($214.19 in chips) 
Seat 5: matiko09 ($214 in chips) 
Seat 6: Xagua ($128.88 in chips) 
Seat 7: IseeUcards ($200 in chips) 
Seat 8: TonnaMunz ($430.57 in chips) 
Seat 9: Fitzyferret ($207.64 in chips) 
Kukuryzka: posts small blind $1
gabi_igna: posts big blind $2
*** HOLE CARDS ***
Dealt to matiko09 [Td 9c]
nickreason17: raises $3 to $5
mooose100: folds 
matiko09: folds 
Xagua: folds 
IseeUcards: folds 
TonnaMunz: folds 
Fitzyferret: calls $5
Kukuryzka: folds 
gabi_igna: folds 
*** FLOP *** [9s 7c 7h]
nickreason17: checks 
Fitzyferret: checks 
*** TURN *** [9s 7c 7h] [6d]
nickreason17: checks 
Fitzyferret: checks 
*** RIVER *** [9s 7c 7h 6d] [2s]
nickreason17: checks 
Fitzyferret: checks 
*** SHOW DOWN ***
nickreason17: shows [Ac Qd] (a pair of Sevens)
Fitzyferret: mucks hand 
nickreason17 collected $12.35 from pot
*** SUMMARY ***
Total pot $13 | Rake $0.65 
Board [9s 7c 7h 6d 2s]
Seat 1: Kukuryzka (small blind) folded before Flop
Seat 2: gabi_igna (big blind) folded before Flop
Seat 3: nickreason17 showed [Ac Qd] and won ($12.35) with a pair of Sevens
Seat 4: mooose100 folded before Flop (didn't bet)
Seat 5: matiko09 folded before Flop (didn't bet)
Seat 6: Xagua folded before Flop (didn't bet)
Seat 7: IseeUcards folded before Flop (didn't bet)
Seat 8: TonnaMunz folded before Flop (didn't bet)
Seat 9: Fitzyferret (button) mucked [Kh Qh]





PokerStars Hand #152884102936:  Hold'em No Limit ($0.50/$1.00 USD) - 2016/05/05 15:39:28 CET [2016/05/05 9:39:28 ET]
Table 'Priska II' 9-max Seat #9 is the button
Seat 1: Spid1 ($111.90 in chips) 
Seat 2: Kukuryzka ($100 in chips) 
Seat 3: matiko09 ($101.50 in chips) 
Seat 4: Painkiller72 ($164.16 in chips) 
Seat 5: nickreason17 ($175.55 in chips) 
Seat 6: OneTwo81 ($97.23 in chips) 
Seat 7: stockbridge8 ($93.77 in chips) 
Seat 8: pohorc21 ($15.16 in chips) 
Seat 9: torkkdnm ($111.50 in chips) 
Spid1: posts small blind $0.50
Kukuryzka: posts big blind $1
*** HOLE CARDS ***
Dealt to matiko09 [7c 7d]
matiko09: raises $2 to $3
Painkiller72: folds 
nickreason17: folds 
OneTwo81: folds 
stockbridge8: folds 
pohorc21: folds 
torkkdnm: folds 
Spid1: folds 
Kukuryzka: folds 
Uncalled bet ($2) returned to matiko09
matiko09 collected $2.50 from pot
matiko09: doesn't show hand 
*** SUMMARY ***
Total pot $2.50 | Rake $0 
Seat 1: Spid1 (small blind) folded before Flop
Seat 2: Kukuryzka (big blind) folded before Flop
Seat 3: matiko09 collected ($2.50)
Seat 4: Painkiller72 folded before Flop (didn't bet)
Seat 5: nickreason17 folded before Flop (didn't bet)
Seat 6: OneTwo81 folded before Flop (didn't bet)
Seat 7: stockbridge8 folded before Flop (didn't bet)
Seat 8: pohorc21 folded before Flop (didn't bet)
Seat 9: torkkdnm (button) folded before Flop (didn't bet)





PokerStars Hand #152884104705:  Hold'em No Limit ($1/$2 USD) - 2016/05/05 15:39:32 CET [2016/05/05 9:39:32 ET]
Table 'Samitchell' 9-max Seat #1 is the button
Seat 1: KovIFish89 ($204.45 in chips) 
Seat 2: 13Ghosts ($283.81 in chips) 
Seat 3: gabi_igna ($307.32 in chips) 
Seat 4: Fitzyferret ($396.06 in chips) 
Seat 5: Spid1 ($200 in chips) 
Seat 6: matiko09 ($200 in chips) 
Seat 7: patpaty ($151.30 in chips) 
Seat 8: Hex0gen ($200 in chips) 
Seat 9: IseeUcards ($254.63 in chips) 
13Ghosts: posts small blind $1
gabi_igna: posts big blind $2
*** HOLE CARDS ***
Dealt to matiko09 [Js Jc]
Fitzyferret: raises $3.24 to $5.24
Spid1: folds 
matiko09: calls $5.24
patpaty: calls $5.24
Hex0gen: folds 
IseeUcards: folds 
KovIFish89: folds 
13Ghosts: folds 
gabi_igna: folds 
*** FLOP *** [7s 3c Ac]
Fitzyferret: checks 
matiko09: checks 
patpaty: bets $6
Fitzyferret: calls $6
matiko09: folds 
*** TURN *** [7s 3c Ac] [3d]
Fitzyferret: checks 
patpaty: bets $14
Fitzyferret: folds 
Uncalled bet ($14) returned to patpaty
patpaty collected $29.18 from pot
patpaty: doesn't show hand 
*** SUMMARY ***
Total pot $30.72 | Rake $1.54 
Board [7s 3c Ac 3d]
Seat 1: KovIFish89 (button) folded before Flop (didn't bet)
Seat 2: 13Ghosts (small blind) folded before Flop
Seat 3: gabi_igna (big blind) folded before Flop
Seat 4: Fitzyferret folded on the Turn
Seat 5: Spid1 folded before Flop (didn't bet)
Seat 6: matiko09 folded on the Flop
Seat 7: patpaty collected ($29.18)
Seat 8: Hex0gen folded before Flop (didn't bet)
Seat 9: IseeUcards folded before Flop (didn't bet)





PokerStars Hand #152884108819:  Hold'em No Limit ($0.50/$1.00 USD) - 2016/05/05 15:39:39 CET [2016/05/05 9:39:39 ET]
Table 'Natascha' 9-max Seat #3 is the button
Seat 1: ronald3737 ($109.93 in chips) 
Seat 2: matiko09 ($138.25 in chips) 
Seat 3: bjonlyking ($145.32 in chips) 
Seat 4: sanpidk ($100 in chips) 
Seat 5: Dickyxxx ($131.76 in chips) 
Seat 6: gabi_igna ($153.44 in chips) 
Seat 7: torkkdnm ($149.24 in chips) 
Seat 8: kamillo91 ($52 in chips) 
Seat 9: guoweiAA ($234.70 in chips) 
sanpidk: posts small blind $0.50
Dickyxxx: posts big blind $1
*** HOLE CARDS ***
Dealt to matiko09 [6h 4h]
gabi_igna: folds 
torkkdnm: folds 
kamillo91: folds 
guoweiAA: folds 
ronald3737: folds 
matiko09: folds 
bjonlyking: calls $1
sanpidk: folds 
Dickyxxx: checks 
*** FLOP *** [Qs 8c Ad]
Dickyxxx: checks 
bjonlyking: checks 
*** TURN *** [Qs 8c Ad] [9h]
Dickyxxx: checks 
bjonlyking: bets $2
Dickyxxx: folds 
Uncalled bet ($2) returned to bjonlyking
bjonlyking collected $2.38 from pot
*** SUMMARY ***
Total pot $2.50 | Rake $0.12 
Board [Qs 8c Ad 9h]
Seat 1: ronald3737 folded before Flop (didn't bet)
Seat 2: matiko09 folded before Flop (didn't bet)
Seat 3: bjonlyking (button) collected ($2.38)
Seat 4: sanpidk (small blind) folded before Flop
Seat 5: Dickyxxx (big blind) folded on the Turn
Seat 6: gabi_igna folded before Flop (didn't bet)
Seat 7: torkkdnm folded before Flop (didn't bet)
Seat 8: kamillo91 folded before Flop (didn't bet)
Seat 9: guoweiAA folded before Flop (didn't bet)





PokerStars Hand #152884114744:  Hold'em No Limit ($0.50/$1.00 USD) - 2016/05/05 15:39:49 CET [2016/05/05 9:39:49 ET]
Table 'Lictoria II' 9-max Seat #2 is the button
Seat 1: St.LaCoste ($100 in chips) 
Seat 2: Dantist1122 ($121.46 in chips) 
Seat 3: Krinica2009 ($100 in chips) 
Seat 4: Ying59 ($112.78 in chips) 
Seat 5: sanpidk ($100 in chips) 
Seat 6: gabi_igna ($129.09 in chips) 
Seat 7: Painkiller72 ($200.30 in chips) 
Seat 8: matiko09 ($100 in chips) 
Seat 9: Kukuryzka ($123.65 in chips) 
Krinica2009: posts small blind $0.50
Ying59: posts big blind $1
*** HOLE CARDS ***
Dealt to matiko09 [5c 2s]
sanpidk: folds 
gabi_igna: folds 
Painkiller72: folds 
matiko09: folds 
Kukuryzka: raises $2 to $3
St.LaCoste: calls $3
Dantist1122: folds 
Krinica2009: folds 
Ying59: calls $2
*** FLOP *** [6c Th 9s]
Ying59: bets $4.51
Kukuryzka: calls $4.51
St.LaCoste: folds 
*** TURN *** [6c Th 9s] [Ad]
Ying59: checks 
Kukuryzka: bets $12.31
Ying59: calls $12.31
*** RIVER *** [6c Th 9s Ad] [5h]
Ying59: checks 
Kukuryzka: checks 
*** SHOW DOWN ***
Ying59: shows [Jc Qh] (high card Ace)
Kukuryzka: shows [Kd Js] (high card Ace - King kicker)
Kukuryzka collected $40.98 from pot
*** SUMMARY ***
Total pot $43.14 | Rake $2.16 
Board [6c Th 9s Ad 5h]
Seat 1: St.LaCoste folded on the Flop
Seat 2: Dantist1122 (button) folded before Flop (didn't bet)
Seat 3: Krinica2009 (small blind) folded before Flop
Seat 4: Ying59 (big blind) showed [Jc Qh] and lost with high card Ace
Seat 5: sanpidk folded before Flop (didn't bet)
Seat 6: gabi_igna folded before Flop (didn't bet)
Seat 7: Painkiller72 folded before Flop (didn't bet)
Seat 8: matiko09 folded before Flop (didn't bet)
Seat 9: Kukuryzka showed [Kd Js] and won ($40.98) with high card Ace





PokerStars Hand #152884115550:  Hold'em No Limit ($0.50/$1.00 USD) - 2016/05/05 15:39:51 CET [2016/05/05 9:39:51 ET]
Table 'Pyxis III' 9-max Seat #4 is the button
Seat 1: sanpidk ($182.53 in chips) 
Seat 2: 50CandyJoe ($100 in chips) 
Seat 4: Sloeve ($114.35 in chips) 
Seat 5: darren1031 ($80 in chips) 
Seat 6: kamillo91 ($46.50 in chips) 
Seat 7: Painkiller72 ($137.28 in chips) 
Seat 8: matiko09 ($100 in chips) 
Seat 9: Hypoaroused ($211.07 in chips) 
darren1031: posts small blind $0.50
kamillo91: posts big blind $1
vrnMike: sits out 
*** HOLE CARDS ***
Dealt to matiko09 [9c 2c]
Painkiller72: raises $1.50 to $2.50
matiko09: folds 
Hypoaroused: calls $2.50
sanpidk: calls $2.50
50CandyJoe: folds 
Sloeve: folds 
darren1031: folds 
kamillo91: folds 
*** FLOP *** [5d Qc 4h]
Painkiller72: bets $5.98
Hypoaroused: folds 
sanpidk: folds 
Uncalled bet ($5.98) returned to Painkiller72
Painkiller72 collected $8.55 from pot
Painkiller72: doesn't show hand 
*** SUMMARY ***
Total pot $9 | Rake $0.45 
Board [5d Qc 4h]
Seat 1: sanpidk folded on the Flop
Seat 2: 50CandyJoe folded before Flop (didn't bet)
Seat 4: Sloeve (button) folded before Flop (didn't bet)
Seat 5: darren1031 (small blind) folded before Flop
Seat 6: kamillo91 (big blind) folded before Flop
Seat 7: Painkiller72 collected ($8.55)
Seat 8: matiko09 folded before Flop (didn't bet)
Seat 9: Hypoaroused folded on the Flop





PokerStars Hand #152884123091:  Hold'em No Limit ($0.50/$1.00 USD) - 2016/05/05 15:40:04 CET [2016/05/05 9:40:04 ET]
Table 'Glarona II' 9-max Seat #6 is the button
Seat 1: KovIFish89 ($108.29 in chips) 
Seat 2: matiko09 ($131.87 in chips) 
Seat 3: Kukuryzka ($100 in chips) 
Seat 4: Mukhin1 ($101.50 in chips) 
Seat 5: Painkiller72 ($100 in chips) 
Seat 6: chirikow ($69.82 in chips) 
Seat 7: Dantist1122 ($100 in chips) 
Seat 8: ipashutapkom ($74 in chips) 
Dantist1122: posts small blind $0.50
ipashutapkom: posts big blind $1
mycka86: sits out 
*** HOLE CARDS ***
Dealt to matiko09 [4h Jd]
KovIFish89: folds 
matiko09: folds 
Kukuryzka: folds 
Mukhin1: folds 
Painkiller72: folds 
chirikow: folds 
KovIFish89 leaves the table
Dantist1122: raises $1.05 to $2.05
ipashutapkom: raises $4.10 to $6.15
Dantist1122: folds 
Uncalled bet ($4.10) returned to ipashutapkom
ipashutapkom collected $4.10 from pot
ipashutapkom: doesn't show hand 
*** SUMMARY ***
Total pot $4.10 | Rake $0 
Seat 1: KovIFish89 folded before Flop (didn't bet)
Seat 2: matiko09 folded before Flop (didn't bet)
Seat 3: Kukuryzka folded before Flop (didn't bet)
Seat 4: Mukhin1 folded before Flop (didn't bet)
Seat 5: Painkiller72 folded before Flop (didn't bet)
Seat 6: chirikow (button) folded before Flop (didn't bet)
Seat 7: Dantist1122 (small blind) folded before Flop
Seat 8: ipashutapkom (big blind) collected ($4.10)





PokerStars Hand #152884125974:  Hold'em No Limit ($1/$2 USD) - 2016/05/05 15:40:09 CET [2016/05/05 9:40:09 ET]
Table 'Lundia' 9-max Seat #3 is the button
Seat 1: Fitzyferret ($223.91 in chips) 
Seat 2: patpaty ($187.30 in chips) 
Seat 3: IseeUcards ($408.17 in chips) 
Seat 4: KovIFish89 ($220.88 in chips) 
Seat 6: Spid1 ($245.74 in chips) 
Seat 7: matiko09 ($215.86 in chips) 
Seat 8: Durnichka ($60 in chips) 
Seat 9: gabi_igna ($211.06 in chips) 
KovIFish89: posts small blind $1
Spid1: posts big blind $2
*** HOLE CARDS ***
Dealt to matiko09 [6s 4h]
matiko09: folds 
Durnichka: folds 
Kukuryzka joins the table at seat #5 
Kukuryzka leaves the table
gabi_igna: folds 
Fitzyferret: folds 
patpaty: raises $2 to $4
IseeUcards: folds 
KovIFish89: folds 
Spid1: folds 
Uncalled bet ($2) returned to patpaty
patpaty collected $5 from pot
patpaty: doesn't show hand 
*** SUMMARY ***
Total pot $5 | Rake $0 
Seat 1: Fitzyferret folded before Flop (didn't bet)
Seat 2: patpaty collected ($5)
Seat 3: IseeUcards (button) folded before Flop (didn't bet)
Seat 4: KovIFish89 (small blind) folded before Flop
Seat 6: Spid1 (big blind) folded before Flop
Seat 7: matiko09 folded before Flop (didn't bet)
Seat 8: Durnichka folded before Flop (didn't bet)
Seat 9: gabi_igna folded before Flop (didn't bet)





PokerStars Hand #152884131825:  Hold'em No Limit ($0.50/$1.00 USD) - 2016/05/05 15:40:20 CET [2016/05/05 9:40:20 ET]
Table 'Priska II' 9-max Seat #1 is the button
Seat 1: Spid1 ($111.40 in chips) 
Seat 2: Kukuryzka ($99 in chips) 
Seat 3: matiko09 ($103 in chips) 
Seat 4: Painkiller72 ($164.16 in chips) 
Seat 5: nickreason17 ($175.55 in chips) 
Seat 6: OneTwo81 ($97.23 in chips) 
Seat 7: stockbridge8 ($93.77 in chips) 
Seat 8: pohorc21 ($76.65 in chips) 
Seat 9: torkkdnm ($111.50 in chips) 
Kukuryzka: posts small blind $0.50
matiko09: posts big blind $1
*** HOLE CARDS ***
Dealt to matiko09 [2d Qh]
Painkiller72: folds 
nickreason17: folds 
OneTwo81: folds 
stockbridge8: folds 
pohorc21: raises $7.50 to $8.50
torkkdnm: folds 
Spid1: folds 
Kukuryzka: calls $8
matiko09: folds 
*** FLOP *** [2h 8s 5s]
Kukuryzka: checks 
pohorc21: bets $17
Kukuryzka: raises $25.55 to $42.55
pohorc21 is disconnected 
pohorc21 is connected 
pohorc21: folds 
Uncalled bet ($25.55) returned to Kukuryzka
Kukuryzka collected $49.50 from pot
Kukuryzka: doesn't show hand 
*** SUMMARY ***
Total pot $52 | Rake $2.50 
Board [2h 8s 5s]
Seat 1: Spid1 (button) folded before Flop (didn't bet)
Seat 2: Kukuryzka (small blind) collected ($49.50)
Seat 3: matiko09 (big blind) folded before Flop
Seat 4: Painkiller72 folded before Flop (didn't bet)
Seat 5: nickreason17 folded before Flop (didn't bet)
Seat 6: OneTwo81 folded before Flop (didn't bet)
Seat 7: stockbridge8 folded before Flop (didn't bet)
Seat 8: pohorc21 folded on the Flop
Seat 9: torkkdnm folded before Flop (didn't bet)





PokerStars Hand #152884138068:  Hold'em No Limit ($1/$2 USD) - 2016/05/05 15:40:31 CET [2016/05/05 9:40:31 ET]
Table 'Lundia' 9-max Seat #4 is the button
Seat 1: Fitzyferret ($223.91 in chips) 
Seat 2: patpaty ($190.30 in chips) 
Seat 3: IseeUcards ($408.17 in chips) 
Seat 4: KovIFish89 ($219.88 in chips) 
Seat 6: Spid1 ($243.74 in chips) 
Seat 7: matiko09 ($215.86 in chips) 
Seat 8: Durnichka ($60 in chips) 
Seat 9: gabi_igna ($211.06 in chips) 
Spid1: posts small blind $1
matiko09: posts big blind $2
*** HOLE CARDS ***
Dealt to matiko09 [Tc 7s]
Durnichka: folds 
gabi_igna: folds 
Fitzyferret: folds 
patpaty: folds 
IseeUcards: folds 
KovIFish89: raises $3 to $5
Spid1: folds 
matiko09: folds 
Uncalled bet ($3) returned to KovIFish89
KovIFish89 collected $5 from pot
KovIFish89: doesn't show hand 
*** SUMMARY ***
Total pot $5 | Rake $0 
Seat 1: Fitzyferret folded before Flop (didn't bet)
Seat 2: patpaty folded before Flop (didn't bet)
Seat 3: IseeUcards folded before Flop (didn't bet)
Seat 4: KovIFish89 (button) collected ($5)
Seat 6: Spid1 (small blind) folded before Flop
Seat 7: matiko09 (big blind) folded before Flop
Seat 8: Durnichka folded before Flop (didn't bet)
Seat 9: gabi_igna folded before Flop (didn't bet)





PokerStars Hand #152884138552:  Hold'em No Limit ($1/$2 USD) - 2016/05/05 15:40:32 CET [2016/05/05 9:40:32 ET]
Table 'Tololo' 9-max Seat #1 is the button
Seat 1: Kukuryzka ($200 in chips) 
Seat 2: gabi_igna ($237.99 in chips) 
Seat 3: nickreason17 ($247.75 in chips) 
Seat 4: mooose100 ($214.19 in chips) 
Seat 5: matiko09 ($214 in chips) 
Seat 6: Xagua ($128.88 in chips) 
Seat 7: IseeUcards ($200 in chips) 
Seat 8: TonnaMunz ($430.57 in chips) 
Seat 9: Fitzyferret ($202.64 in chips) 
gabi_igna: posts small blind $1
nickreason17: posts big blind $2
*** HOLE CARDS ***
Dealt to matiko09 [Ah 4c]
mooose100: folds 
matiko09: folds 
Xagua: folds 
IseeUcards: folds 
TonnaMunz: folds 
Fitzyferret: folds 
Kukuryzka: folds 
gabi_igna: raises $4 to $6
nickreason17: calls $4
*** FLOP *** [2c 4s 4d]
gabi_igna: checks 
nickreason17: checks 
*** TURN *** [2c 4s 4d] [3c]
gabi_igna: bets $6
nickreason17: folds 
Uncalled bet ($6) returned to gabi_igna
gabi_igna collected $11.40 from pot
gabi_igna: doesn't show hand 
*** SUMMARY ***
Total pot $12 | Rake $0.60 
Board [2c 4s 4d 3c]
Seat 1: Kukuryzka (button) folded before Flop (didn't bet)
Seat 2: gabi_igna (small blind) collected ($11.40)
Seat 3: nickreason17 (big blind) folded on the Turn
Seat 4: mooose100 folded before Flop (didn't bet)
Seat 5: matiko09 folded before Flop (didn't bet)
Seat 6: Xagua folded before Flop (didn't bet)
Seat 7: IseeUcards folded before Flop (didn't bet)
Seat 8: TonnaMunz folded before Flop (didn't bet)
Seat 9: Fitzyferret folded before Flop (didn't bet)





PokerStars Hand #152884141733:  Hold'em No Limit ($0.50/$1.00 USD) - 2016/05/05 15:40:37 CET [2016/05/05 9:40:37 ET]
Table 'Natascha' 9-max Seat #4 is the button
Seat 1: ronald3737 ($109.93 in chips) 
Seat 2: matiko09 ($138.25 in chips) 
Seat 3: bjonlyking ($146.70 in chips) 
Seat 4: sanpidk ($100 in chips) 
Seat 5: Dickyxxx ($130.76 in chips) 
Seat 6: gabi_igna ($153.44 in chips) 
Seat 7: torkkdnm ($149.24 in chips) 
Seat 8: kamillo91 ($52 in chips) 
Seat 9: guoweiAA ($234.70 in chips) 
Dickyxxx: posts small blind $0.50
gabi_igna: posts big blind $1
*** HOLE CARDS ***
Dealt to matiko09 [5h 4s]
torkkdnm: folds 
kamillo91: folds 
guoweiAA: folds 
ronald3737: folds 
matiko09: folds 
bjonlyking: folds 
sanpidk: raises $1.24 to $2.24
Dickyxxx: folds 
gabi_igna: calls $1.24
*** FLOP *** [8s 8d Js]
gabi_igna: checks 
sanpidk: bets $3
gabi_igna: raises $8 to $11
sanpidk: calls $8
*** TURN *** [8s 8d Js] [Jh]
gabi_igna: checks 
sanpidk: checks 
*** RIVER *** [8s 8d Js Jh] [Jd]
gabi_igna: checks 
sanpidk: bets $19
gabi_igna: folds 
Uncalled bet ($19) returned to sanpidk
sanpidk collected $25.63 from pot
sanpidk: doesn't show hand 
*** SUMMARY ***
Total pot $26.98 | Rake $1.35 
Board [8s 8d Js Jh Jd]
Seat 1: ronald3737 folded before Flop (didn't bet)
Seat 2: matiko09 folded before Flop (didn't bet)
Seat 3: bjonlyking folded before Flop (didn't bet)
Seat 4: sanpidk (button) collected ($25.63)
Seat 5: Dickyxxx (small blind) folded before Flop
Seat 6: gabi_igna (big blind) folded on the River
Seat 7: torkkdnm folded before Flop (didn't bet)
Seat 8: kamillo91 folded before Flop (didn't bet)
Seat 9: guoweiAA folded before Flop (didn't bet)





PokerStars Hand #152884146591:  Hold'em No Limit ($0.50/$1.00 USD) - 2016/05/05 15:40:46 CET [2016/05/05 9:40:46 ET]
Table 'Pyxis III' 9-max Seat #5 is the button
Seat 1: sanpidk ($180.03 in chips) 
Seat 2: 50CandyJoe ($100 in chips) 
Seat 4: Sloeve ($114.35 in chips) 
Seat 5: darren1031 ($80 in chips) 
Seat 6: kamillo91 ($45.50 in chips) 
Seat 8: matiko09 ($100 in chips) 
Seat 9: Hypoaroused ($208.57 in chips) 
kamillo91: posts small blind $0.50
Painkiller72: is sitting out 
matiko09: posts big blind $1
Painkiller72 leaves the table
vrnMike: sits out 
*** HOLE CARDS ***
Dealt to matiko09 [6d Td]
Hypoaroused: folds 
sanpidk: raises $2 to $3
mycka86 joins the table at seat #7 
50CandyJoe: folds 
Sloeve: folds 
darren1031: folds 
kamillo91: folds 
matiko09: folds 
Uncalled bet ($2) returned to sanpidk
sanpidk collected $2.50 from pot
sanpidk: doesn't show hand 
*** SUMMARY ***
Total pot $2.50 | Rake $0 
Seat 1: sanpidk collected ($2.50)
Seat 2: 50CandyJoe folded before Flop (didn't bet)
Seat 4: Sloeve folded before Flop (didn't bet)
Seat 5: darren1031 (button) folded before Flop (didn't bet)
Seat 6: kamillo91 (small blind) folded before Flop
Seat 8: matiko09 (big blind) folded before Flop
Seat 9: Hypoaroused folded before Flop (didn't bet)





PokerStars Hand #152884151460:  Hold'em No Limit ($1/$2 USD) - 2016/05/05 15:40:54 CET [2016/05/05 9:40:54 ET]
Table 'Samitchell' 9-max Seat #2 is the button
Seat 1: KovIFish89 ($204.45 in chips) 
Seat 2: 13Ghosts ($282.81 in chips) 
Seat 3: gabi_igna ($305.32 in chips) 
Seat 4: Fitzyferret ($384.82 in chips) 
Seat 5: Spid1 ($200 in chips) 
Seat 6: matiko09 ($200 in chips) 
Seat 7: patpaty ($169.24 in chips) 
Seat 8: Hex0gen ($200 in chips) 
Seat 9: IseeUcards ($254.63 in chips) 
gabi_igna: posts small blind $1
Fitzyferret: posts big blind $2
*** HOLE CARDS ***
Dealt to matiko09 [8c As]
Spid1: folds 
matiko09: folds 
patpaty: raises $2 to $4
Hex0gen: calls $4
IseeUcards: folds 
KovIFish89: calls $4
13Ghosts: calls $4
gabi_igna: raises $22 to $26
Fitzyferret: folds 
patpaty: folds 
Hex0gen: folds 
KovIFish89: folds 
13Ghosts: folds 
Uncalled bet ($22) returned to gabi_igna
gabi_igna collected $22 from pot
gabi_igna: doesn't show hand 
*** SUMMARY ***
Total pot $22 | Rake $0 
Seat 1: KovIFish89 folded before Flop
Seat 2: 13Ghosts (button) folded before Flop
Seat 3: gabi_igna (small blind) collected ($22)
Seat 4: Fitzyferret (big blind) folded before Flop
Seat 5: Spid1 folded before Flop (didn't bet)
Seat 6: matiko09 folded before Flop (didn't bet)
Seat 7: patpaty folded before Flop
Seat 8: Hex0gen folded before Flop
Seat 9: IseeUcards folded before Flop (didn't bet)





PokerStars Hand #152884155760:  Hold'em No Limit ($1/$2 USD) - 2016/05/05 15:41:02 CET [2016/05/05 9:41:02 ET]
Table 'Lundia' 9-max Seat #6 is the button
Seat 1: Fitzyferret ($223.91 in chips) 
Seat 2: patpaty ($190.30 in chips) 
Seat 3: IseeUcards ($408.17 in chips) 
Seat 4: KovIFish89 ($222.88 in chips) 
Seat 6: Spid1 ($242.74 in chips) 
Seat 7: matiko09 ($213.86 in chips) 
Seat 8: Durnichka ($60 in chips) 
Seat 9: gabi_igna ($211.06 in chips) 
matiko09: posts small blind $1
Durnichka: posts big blind $2
*** HOLE CARDS ***
Dealt to matiko09 [Tc 6c]
gabi_igna: folds 
Fitzyferret: folds 
patpaty: folds 
IseeUcards: folds 
KovIFish89: folds 
Spid1: raises $3 to $5
matiko09: folds 
Durnichka: calls $3
*** FLOP *** [8h Kd 3s]
Durnichka: checks 
Spid1: bets $7
antfurto joins the table at seat #5 
Durnichka: folds 
Uncalled bet ($7) returned to Spid1
Spid1 collected $10.45 from pot
antfurto leaves the table
Spid1: doesn't show hand 
*** SUMMARY ***
Total pot $11 | Rake $0.55 
Board [8h Kd 3s]
Seat 1: Fitzyferret folded before Flop (didn't bet)
Seat 2: patpaty folded before Flop (didn't bet)
Seat 3: IseeUcards folded before Flop (didn't bet)
Seat 4: KovIFish89 folded before Flop (didn't bet)
Seat 6: Spid1 (button) collected ($10.45)
Seat 7: matiko09 (small blind) folded before Flop
Seat 8: Durnichka (big blind) folded on the Flop
Seat 9: gabi_igna folded before Flop (didn't bet)





PokerStars Hand #152884160668:  Hold'em No Limit ($0.50/$1.00 USD) - 2016/05/05 15:41:11 CET [2016/05/05 9:41:11 ET]
Table 'Pyxis III' 9-max Seat #6 is the button
Seat 1: sanpidk ($181.53 in chips) 
Seat 2: 50CandyJoe ($100 in chips) 
Seat 4: Sloeve ($114.35 in chips) 
Seat 5: darren1031 ($80 in chips) 
Seat 6: kamillo91 ($45 in chips) 
Seat 8: matiko09 ($100 in chips) 
Seat 9: Hypoaroused ($208.57 in chips) 
mycka86 will be allowed to play after the button
matiko09: posts small blind $0.50
Hypoaroused: posts big blind $1
vrnMike: sits out 
*** HOLE CARDS ***
Dealt to matiko09 [2h 5s]
sanpidk: folds 
50CandyJoe: raises $2 to $3
Sloeve: calls $3
darren1031: folds 
kamillo91: folds 
matiko09: folds 
Hypoaroused: calls $2
*** FLOP *** [3h 5d 9h]
Hypoaroused: checks 
50CandyJoe: checks 
Sloeve: checks 
*** TURN *** [3h 5d 9h] [9d]
Hypoaroused: bets $9.02
50CandyJoe: folds 
Sloeve: calls $9.02
*** RIVER *** [3h 5d 9h 9d] [Qh]
Hypoaroused: checks 
Sloeve: checks 
*** SHOW DOWN ***
Hypoaroused: shows [4c 5h] (two pair, Nines and Fives)
Sloeve: shows [Td Qd] (two pair, Queens and Nines)
Sloeve collected $26.16 from pot
*** SUMMARY ***
Total pot $27.54 | Rake $1.38 
Board [3h 5d 9h 9d Qh]
Seat 1: sanpidk folded before Flop (didn't bet)
Seat 2: 50CandyJoe folded on the Turn
Seat 4: Sloeve showed [Td Qd] and won ($26.16) with two pair, Queens and Nines
Seat 5: darren1031 folded before Flop (didn't bet)
Seat 6: kamillo91 (button) folded before Flop (didn't bet)
Seat 8: matiko09 (small blind) folded before Flop
Seat 9: Hypoaroused (big blind) showed [4c 5h] and lost with two pair, Nines and Fives





PokerStars Hand #152884161742:  Hold'em No Limit ($0.50/$1.00 USD) - 2016/05/05 15:41:13 CET [2016/05/05 9:41:13 ET]
Table 'Lictoria II' 9-max Seat #3 is the button
Seat 1: St.LaCoste ($100 in chips) 
Seat 2: Dantist1122 ($121.46 in chips) 
Seat 3: Krinica2009 ($100 in chips) 
Seat 4: Ying59 ($92.96 in chips) 
Seat 5: sanpidk ($100 in chips) 
Seat 6: gabi_igna ($129.09 in chips) 
Seat 7: Painkiller72 ($200.30 in chips) 
Seat 8: matiko09 ($100 in chips) 
Seat 9: Kukuryzka ($144.81 in chips) 
Ying59: posts small blind $0.50
sanpidk: posts big blind $1
*** HOLE CARDS ***
Dealt to matiko09 [8s 7c]
gabi_igna: raises $2 to $3
Painkiller72: folds 
matiko09: folds 
Kukuryzka: folds 
St.LaCoste: folds 
Dantist1122: folds 
Krinica2009: calls $3
Ying59: folds 
sanpidk: folds 
*** FLOP *** [Ac 6s 9d]
gabi_igna: checks 
Krinica2009: bets $4
gabi_igna: raises $8 to $12
Krinica2009: calls $8
*** TURN *** [Ac 6s 9d] [Qs]
gabi_igna: checks 
Krinica2009: bets $14
gabi_igna: folds 
Uncalled bet ($14) returned to Krinica2009
Krinica2009 collected $29.92 from pot
Krinica2009: doesn't show hand 
*** SUMMARY ***
Total pot $31.50 | Rake $1.58 
Board [Ac 6s 9d Qs]
Seat 1: St.LaCoste folded before Flop (didn't bet)
Seat 2: Dantist1122 folded before Flop (didn't bet)
Seat 3: Krinica2009 (button) collected ($29.92)
Seat 4: Ying59 (small blind) folded before Flop
Seat 5: sanpidk (big blind) folded before Flop
Seat 6: gabi_igna folded on the Turn
Seat 7: Painkiller72 folded before Flop (didn't bet)
Seat 8: matiko09 folded before Flop (didn't bet)
Seat 9: Kukuryzka folded before Flop (didn't bet)





PokerStars Hand #152884162387:  Hold'em No Limit ($1/$2 USD) - 2016/05/05 15:41:14 CET [2016/05/05 9:41:14 ET]
Table 'Tololo' 9-max Seat #2 is the button
Seat 1: Kukuryzka ($200 in chips) 
Seat 2: gabi_igna ($243.39 in chips) 
Seat 3: nickreason17 ($241.75 in chips) 
Seat 4: mooose100 ($214.19 in chips) 
Seat 5: matiko09 ($214 in chips) 
Seat 6: Xagua ($128.88 in chips) 
Seat 7: IseeUcards ($200 in chips) 
Seat 8: TonnaMunz ($430.57 in chips) 
Seat 9: Fitzyferret ($202.64 in chips) 
nickreason17: posts small blind $1
mooose100: posts big blind $2
*** HOLE CARDS ***
Dealt to matiko09 [Qd 8s]
matiko09: folds 
Xagua: folds 
IseeUcards: folds 
TonnaMunz: folds 
Fitzyferret: folds 
Kukuryzka: folds 
gabi_igna: folds 
nickreason17: calls $1
mooose100: raises $4 to $6
nickreason17: calls $4
*** FLOP *** [4c Jh 8h]
nickreason17: checks 
mooose100: bets $11.40
nickreason17: folds 
Uncalled bet ($11.40) returned to mooose100
mooose100 collected $11.40 from pot
mooose100: doesn't show hand 
*** SUMMARY ***
Total pot $12 | Rake $0.60 
Board [4c Jh 8h]
Seat 1: Kukuryzka folded before Flop (didn't bet)
Seat 2: gabi_igna (button) folded before Flop (didn't bet)
Seat 3: nickreason17 (small blind) folded on the Flop
Seat 4: mooose100 (big blind) collected ($11.40)
Seat 5: matiko09 folded before Flop (didn't bet)
Seat 6: Xagua folded before Flop (didn't bet)
Seat 7: IseeUcards folded before Flop (didn't bet)
Seat 8: TonnaMunz folded before Flop (didn't bet)
Seat 9: Fitzyferret folded before Flop (didn't bet)





PokerStars Hand #152884181058:  Hold'em No Limit ($1/$2 USD) - 2016/05/05 15:41:47 CET [2016/05/05 9:41:47 ET]
Table 'Lundia' 9-max Seat #7 is the button
Seat 1: Fitzyferret ($223.91 in chips) 
Seat 2: patpaty ($190.30 in chips) 
Seat 3: IseeUcards ($408.17 in chips) 
Seat 4: KovIFish89 ($222.88 in chips) 
Seat 6: Spid1 ($248.19 in chips) 
Seat 7: matiko09 ($212.86 in chips) 
Seat 8: Durnichka ($80 in chips) 
Seat 9: gabi_igna ($211.06 in chips) 
Durnichka: posts small blind $1
gabi_igna: posts big blind $2
*** HOLE CARDS ***
Dealt to matiko09 [9c 6h]
Fitzyferret: folds 
patpaty: raises $2 to $4
IseeUcards: folds 
KovIFish89: folds 
Spid1: folds 
matiko09: folds 
Durnichka: folds 
gabi_igna: folds 
Uncalled bet ($2) returned to patpaty
patpaty collected $5 from pot
patpaty: doesn't show hand 
*** SUMMARY ***
Total pot $5 | Rake $0 
Seat 1: Fitzyferret folded before Flop (didn't bet)
Seat 2: patpaty collected ($5)
Seat 3: IseeUcards folded before Flop (didn't bet)
Seat 4: KovIFish89 folded before Flop (didn't bet)
Seat 6: Spid1 folded before Flop (didn't bet)
Seat 7: matiko09 (button) folded before Flop (didn't bet)
Seat 8: Durnichka (small blind) folded before Flop
Seat 9: gabi_igna (big blind) folded before Flop





PokerStars Hand #152884186661:  Hold'em No Limit ($0.50/$1.00 USD) - 2016/05/05 15:41:57 CET [2016/05/05 9:41:57 ET]
Table 'Natascha' 9-max Seat #5 is the button
Seat 1: ronald3737 ($109.93 in chips) 
Seat 2: matiko09 ($138.25 in chips) 
Seat 3: bjonlyking ($146.70 in chips) 
Seat 4: sanpidk ($112.39 in chips) 
Seat 5: Dickyxxx ($130.26 in chips) 
Seat 6: gabi_igna ($140.20 in chips) 
Seat 7: torkkdnm ($149.24 in chips) 
Seat 8: kamillo91 ($52 in chips) 
Seat 9: guoweiAA ($234.70 in chips) 
gabi_igna: posts small blind $0.50
torkkdnm: posts big blind $1
*** HOLE CARDS ***
Dealt to matiko09 [8c 9d]
kamillo91: folds 
guoweiAA: folds 
ronald3737: folds 
matiko09: folds 
bjonlyking: raises $2 to $3
sanpidk: folds 
Dickyxxx: folds 
gabi_igna: folds 
torkkdnm: folds 
Uncalled bet ($2) returned to bjonlyking
bjonlyking collected $2.50 from pot
*** SUMMARY ***
Total pot $2.50 | Rake $0 
Seat 1: ronald3737 folded before Flop (didn't bet)
Seat 2: matiko09 folded before Flop (didn't bet)
Seat 3: bjonlyking collected ($2.50)
Seat 4: sanpidk folded before Flop (didn't bet)
Seat 5: Dickyxxx (button) folded before Flop (didn't bet)
Seat 6: gabi_igna (small blind) folded before Flop
Seat 7: torkkdnm (big blind) folded before Flop
Seat 8: kamillo91 folded before Flop (didn't bet)
Seat 9: guoweiAA folded before Flop (didn't bet)





PokerStars Hand #152884190677:  Hold'em No Limit ($1/$2 USD) - 2016/05/05 15:42:04 CET [2016/05/05 9:42:04 ET]
Table 'Tololo' 9-max Seat #3 is the button
Seat 1: Kukuryzka ($200 in chips) 
Seat 2: gabi_igna ($243.39 in chips) 
Seat 3: nickreason17 ($235.75 in chips) 
Seat 4: mooose100 ($219.59 in chips) 
Seat 5: matiko09 ($214 in chips) 
Seat 6: Xagua ($128.88 in chips) 
Seat 7: IseeUcards ($200 in chips) 
Seat 8: TonnaMunz ($430.57 in chips) 
Seat 9: Fitzyferret ($202.64 in chips) 
mooose100: posts small blind $1
matiko09: posts big blind $2
*** HOLE CARDS ***
Dealt to matiko09 [3s 4s]
Xagua: raises $3 to $5
IseeUcards: folds 
TonnaMunz: folds 
Fitzyferret: folds 
Kukuryzka: folds 
gabi_igna: folds 
nickreason17: calls $5
mooose100: folds 
matiko09: folds 
*** FLOP *** [Jh 9h Td]
Xagua: bets $6
nickreason17: calls $6
*** TURN *** [Jh 9h Td] [7s]
Xagua: bets $8
nickreason17: calls $8
*** RIVER *** [Jh 9h Td 7s] [Qd]
Xagua: checks 
nickreason17: checks 
*** SHOW DOWN ***
Xagua: shows [9c 9s] (three of a kind, Nines)
nickreason17: mucks hand 
Xagua collected $38.95 from pot
*** SUMMARY ***
Total pot $41 | Rake $2.05 
Board [Jh 9h Td 7s Qd]
Seat 1: Kukuryzka folded before Flop (didn't bet)
Seat 2: gabi_igna folded before Flop (didn't bet)
Seat 3: nickreason17 (button) mucked [Qs Js]
Seat 4: mooose100 (small blind) folded before Flop
Seat 5: matiko09 (big blind) folded before Flop
Seat 6: Xagua showed [9c 9s] and won ($38.95) with three of a kind, Nines
Seat 7: IseeUcards folded before Flop (didn't bet)
Seat 8: TonnaMunz folded before Flop (didn't bet)
Seat 9: Fitzyferret folded before Flop (didn't bet)





PokerStars Hand #152884197702:  Hold'em No Limit ($0.50/$1.00 USD) - 2016/05/05 15:42:16 CET [2016/05/05 9:42:16 ET]
Table 'Pyxis III' 9-max Seat #8 is the button
Seat 1: sanpidk ($181.53 in chips) 
Seat 2: 50CandyJoe ($100 in chips) 
Seat 4: Sloeve ($128.49 in chips) 
Seat 5: darren1031 ($80 in chips) 
Seat 6: kamillo91 ($45 in chips) 
Seat 8: matiko09 ($100 in chips) 
Seat 9: Hypoaroused ($196.55 in chips) 
Hypoaroused: posts small blind $0.50
sanpidk: posts big blind $1
vrnMike: sits out 
mycka86: sits out 
*** HOLE CARDS ***
Dealt to matiko09 [2h As]
50CandyJoe: folds 
Sloeve has timed out
Sloeve: folds 
darren1031: raises $2 to $3
kamillo91: folds 
matiko09: folds 
Hypoaroused: calls $2.50
sanpidk: folds 
*** FLOP *** [Tc Qc 2d]
Hypoaroused: bets $3.32
darren1031: raises $4.68 to $8
Hypoaroused: calls $4.68
*** TURN *** [Tc Qc 2d] [Ks]
Hypoaroused: checks 
darren1031: checks 
*** RIVER *** [Tc Qc 2d Ks] [Ah]
Hypoaroused: checks 
darren1031: checks 
*** SHOW DOWN ***
Hypoaroused: shows [9d Qd] (a pair of Queens)
darren1031: shows [6d Ad] (a pair of Aces)
darren1031 collected $21.85 from pot
*** SUMMARY ***
Total pot $23 | Rake $1.15 
Board [Tc Qc 2d Ks Ah]
Seat 1: sanpidk (big blind) folded before Flop
Seat 2: 50CandyJoe folded before Flop (didn't bet)
Seat 4: Sloeve folded before Flop (didn't bet)
Seat 5: darren1031 showed [6d Ad] and won ($21.85) with a pair of Aces
Seat 6: kamillo91 folded before Flop (didn't bet)
Seat 8: matiko09 (button) folded before Flop (didn't bet)
Seat 9: Hypoaroused (small blind) showed [9d Qd] and lost with a pair of Queens





PokerStars Hand #152884200653:  Hold'em No Limit ($1/$2 USD) - 2016/05/05 15:42:22 CET [2016/05/05 9:42:22 ET]
Table 'Lundia' 9-max Seat #8 is the button
Seat 1: Fitzyferret ($223.91 in chips) 
Seat 2: patpaty ($193.30 in chips) 
Seat 3: IseeUcards ($408.17 in chips) 
Seat 4: KovIFish89 ($222.88 in chips) 
Seat 6: Spid1 ($248.19 in chips) 
Seat 7: matiko09 ($212.86 in chips) 
Seat 8: Durnichka ($79 in chips) 
Seat 9: gabi_igna ($209.06 in chips) 
gabi_igna: posts small blind $1
Fitzyferret: posts big blind $2
*** HOLE CARDS ***
Dealt to matiko09 [Ks 7d]
patpaty: folds 
IseeUcards: folds 
KovIFish89: folds 
Spid1: folds 
matiko09: folds 
Durnichka: folds 
gabi_igna: raises $4 to $6
Fitzyferret: raises $12 to $18
gabi_igna: calls $12
*** FLOP *** [7s Jc 4s]
gabi_igna: checks 
Fitzyferret: checks 
*** TURN *** [7s Jc 4s] [As]
gabi_igna: bets $24
Fitzyferret: calls $24
*** RIVER *** [7s Jc 4s As] [Kc]
gabi_igna: checks 
Fitzyferret: checks 
*** SHOW DOWN ***
gabi_igna: shows [Qs 8s] (a flush, Ace high)
Fitzyferret: mucks hand 
gabi_igna collected $81.25 from pot
*** SUMMARY ***
Total pot $84 | Rake $2.75 
Board [7s Jc 4s As Kc]
Seat 1: Fitzyferret (big blind) mucked [Ad 5c]
Seat 2: patpaty folded before Flop (didn't bet)
Seat 3: IseeUcards folded before Flop (didn't bet)
Seat 4: KovIFish89 folded before Flop (didn't bet)
Seat 6: Spid1 folded before Flop (didn't bet)
Seat 7: matiko09 folded before Flop (didn't bet)
Seat 8: Durnichka (button) folded before Flop (didn't bet)
Seat 9: gabi_igna (small blind) showed [Qs 8s] and won ($81.25) with a flush, Ace high





PokerStars Hand #152884208171:  Hold'em No Limit ($0.50/$1.00 USD) - 2016/05/05 15:42:35 CET [2016/05/05 9:42:35 ET]
Table 'Calypso II' 9-max Seat #6 is the button
Seat 1: nickreason17 ($105.24 in chips) 
Seat 2: torkkdnm ($100 in chips) 
Seat 3: gabi_igna ($110.59 in chips) 
Seat 4: sanpidk ($100 in chips) 
Seat 5: LighTingSSSS ($69.29 in chips) 
Seat 6: WTAPSVG ($135.15 in chips) 
Seat 7: ipashutapkom ($89.83 in chips) 
Seat 8: matiko09 ($100 in chips) 
Seat 9: chrisauy ($86.61 in chips) 
ipashutapkom: posts small blind $0.50
matiko09: posts big blind $1
*** HOLE CARDS ***
Dealt to matiko09 [4h As]
chrisauy: calls $1
nickreason17: folds 
torkkdnm: folds 
gabi_igna: folds 
sanpidk: folds 
LighTingSSSS: calls $1
WTAPSVG: calls $1
ipashutapkom: folds 
matiko09: checks 
*** FLOP *** [9s 7h Ks]
matiko09: checks 
chrisauy: bets $3
LighTingSSSS: calls $3
WTAPSVG: calls $3
matiko09: folds 
*** TURN *** [9s 7h Ks] [3c]
chrisauy: bets $11
LighTingSSSS: calls $11
WTAPSVG: folds 
*** RIVER *** [9s 7h Ks 3c] [6s]
chrisauy: checks 
LighTingSSSS: checks 
*** SHOW DOWN ***
chrisauy: shows [4d Ad] (high card Ace)
LighTingSSSS: shows [Kd 2d] (a pair of Kings)
LighTingSSSS collected $33.72 from pot
*** SUMMARY ***
Total pot $35.50 | Rake $1.78 
Board [9s 7h Ks 3c 6s]
Seat 1: nickreason17 folded before Flop (didn't bet)
Seat 2: torkkdnm folded before Flop (didn't bet)
Seat 3: gabi_igna folded before Flop (didn't bet)
Seat 4: sanpidk folded before Flop (didn't bet)
Seat 5: LighTingSSSS showed [Kd 2d] and won ($33.72) with a pair of Kings
Seat 6: WTAPSVG (button) folded on the Turn
Seat 7: ipashutapkom (small blind) folded before Flop
Seat 8: matiko09 (big blind) folded on the Flop
Seat 9: chrisauy showed [4d Ad] and lost with high card Ace





PokerStars Hand #152884208920:  Hold'em No Limit ($0.50/$1.00 USD) - 2016/05/05 15:42:36 CET [2016/05/05 9:42:36 ET]
Table 'Natascha' 9-max Seat #6 is the button
Seat 1: ronald3737 ($109.93 in chips) 
Seat 2: matiko09 ($138.25 in chips) 
Seat 3: bjonlyking ($148.20 in chips) 
Seat 4: sanpidk ($112.39 in chips) 
Seat 5: Dickyxxx ($130.26 in chips) 
Seat 6: gabi_igna ($139.70 in chips) 
Seat 7: torkkdnm ($148.24 in chips) 
Seat 8: kamillo91 ($52 in chips) 
Seat 9: guoweiAA ($234.70 in chips) 
torkkdnm: posts small blind $0.50
kamillo91: posts big blind $1
*** HOLE CARDS ***
Dealt to matiko09 [7c 9c]
guoweiAA: folds 
ronald3737: folds 
matiko09: folds 
bjonlyking: folds 
sanpidk: folds 
Dickyxxx: folds 
gabi_igna: raises $1.50 to $2.50
torkkdnm: folds 
kamillo91: calls $1.50
*** FLOP *** [6c 5s As]
kamillo91: bets $3
gabi_igna: raises $6 to $9
kamillo91: folds 
Uncalled bet ($6) returned to gabi_igna
gabi_igna collected $10.92 from pot
gabi_igna: doesn't show hand 
*** SUMMARY ***
Total pot $11.50 | Rake $0.58 
Board [6c 5s As]
Seat 1: ronald3737 folded before Flop (didn't bet)
Seat 2: matiko09 folded before Flop (didn't bet)
Seat 3: bjonlyking folded before Flop (didn't bet)
Seat 4: sanpidk folded before Flop (didn't bet)
Seat 5: Dickyxxx folded before Flop (didn't bet)
Seat 6: gabi_igna (button) collected ($10.92)
Seat 7: torkkdnm (small blind) folded before Flop
Seat 8: kamillo91 (big blind) folded on the Flop
Seat 9: guoweiAA folded before Flop (didn't bet)





PokerStars Hand #152884208519:  Hold'em No Limit ($0.50/$1.00 USD) - 2016/05/05 15:42:36 CET [2016/05/05 9:42:36 ET]
Table 'Lictoria II' 9-max Seat #4 is the button
Seat 1: St.LaCoste ($100 in chips) 
Seat 2: Dantist1122 ($121.46 in chips) 
Seat 3: Krinica2009 ($114.92 in chips) 
Seat 4: Ying59 ($92.46 in chips) 
Seat 5: sanpidk ($100 in chips) 
Seat 6: gabi_igna ($114.09 in chips) 
Seat 7: Painkiller72 ($200.30 in chips) 
Seat 8: matiko09 ($100 in chips) 
Seat 9: Kukuryzka ($144.81 in chips) 
sanpidk: posts small blind $0.50
gabi_igna: posts big blind $1
*** HOLE CARDS ***
Dealt to matiko09 [6s Ah]
Painkiller72: raises $1.50 to $2.50
matiko09: folds 
Kukuryzka: folds 
St.LaCoste: folds 
Dantist1122: folds 
Krinica2009: folds 
Ying59: folds 
sanpidk: calls $2
gabi_igna: calls $1.50
*** FLOP *** [3h 2d Tc]
sanpidk: checks 
gabi_igna: checks 
Painkiller72: bets $4.98
sanpidk: folds 
gabi_igna: folds 
Uncalled bet ($4.98) returned to Painkiller72
Painkiller72 collected $7.12 from pot
Painkiller72: doesn't show hand 
*** SUMMARY ***
Total pot $7.50 | Rake $0.38 
Board [3h 2d Tc]
Seat 1: St.LaCoste folded before Flop (didn't bet)
Seat 2: Dantist1122 folded before Flop (didn't bet)
Seat 3: Krinica2009 folded before Flop (didn't bet)
Seat 4: Ying59 (button) folded before Flop (didn't bet)
Seat 5: sanpidk (small blind) folded on the Flop
Seat 6: gabi_igna (big blind) folded on the Flop
Seat 7: Painkiller72 collected ($7.12)
Seat 8: matiko09 folded before Flop (didn't bet)
Seat 9: Kukuryzka folded before Flop (didn't bet)





PokerStars Hand #152884211321:  Hold'em No Limit ($0.50/$1.00 USD) - 2016/05/05 15:42:41 CET [2016/05/05 9:42:41 ET]
Table 'Musa II' 9-max Seat #6 is the button
Seat 1: KovIFish89 ($100 in chips) 
Seat 2: maxxmeister ($106.18 in chips) 
Seat 3: vrnMike ($100 in chips) 
Seat 4: sanpidk ($112.50 in chips) 
Seat 6: cnn123 ($46.50 in chips) 
Seat 7: Painkiller72 ($100 in chips) 
Seat 8: matiko09 ($100 in chips) 
Seat 9: antfurto ($100 in chips) 
Painkiller72: posts small blind $0.50
matiko09: posts big blind $1
Chin41178: sits out 
*** HOLE CARDS ***
Dealt to matiko09 [3c 3d]
antfurto: folds 
KovIFish89: raises $2 to $3
maxxmeister: folds 
vrnMike: folds 
sanpidk: calls $3
cnn123: calls $3
Painkiller72: folds 
matiko09: calls $2
*** FLOP *** [4s 2c 6h]
matiko09: checks 
KovIFish89: bets $7
sanpidk: calls $7
cnn123: calls $7
matiko09: calls $7
*** TURN *** [4s 2c 6h] [8c]
matiko09: checks 
KovIFish89: checks 
sanpidk: checks 
cnn123: bets $20
matiko09: folds 
KovIFish89: raises $20 to $40
sanpidk: folds 
cnn123: calls $16.50 and is all-in
Uncalled bet ($3.50) returned to KovIFish89
*** RIVER *** [4s 2c 6h 8c] [3h]
*** SHOW DOWN ***
KovIFish89: shows [Kh Ks] (a pair of Kings)
cnn123: shows [Ts Td] (a pair of Tens)
KovIFish89 collected $111 from pot
*** SUMMARY ***
Total pot $113.50 | Rake $2.50 
Board [4s 2c 6h 8c 3h]
Seat 1: KovIFish89 showed [Kh Ks] and won ($111) with a pair of Kings
Seat 2: maxxmeister folded before Flop (didn't bet)
Seat 3: vrnMike folded before Flop (didn't bet)
Seat 4: sanpidk folded on the Turn
Seat 6: cnn123 (button) showed [Ts Td] and lost with a pair of Tens
Seat 7: Painkiller72 (small blind) folded before Flop
Seat 8: matiko09 (big blind) folded on the Turn
Seat 9: antfurto folded before Flop (didn't bet)





PokerStars Hand #152884224079:  Hold'em No Limit ($1/$2 USD) - 2016/05/05 15:43:03 CET [2016/05/05 9:43:03 ET]
Table 'Tololo' 9-max Seat #4 is the button
Seat 1: Kukuryzka ($200 in chips) 
Seat 2: gabi_igna ($243.39 in chips) 
Seat 3: nickreason17 ($216.75 in chips) 
Seat 4: mooose100 ($218.59 in chips) 
Seat 5: matiko09 ($212 in chips) 
Seat 6: Xagua ($148.83 in chips) 
Seat 7: IseeUcards ($200 in chips) 
Seat 8: TonnaMunz ($430.57 in chips) 
Seat 9: Fitzyferret ($202.64 in chips) 
matiko09: posts small blind $1
Xagua: posts big blind $2
*** HOLE CARDS ***
Dealt to matiko09 [Kh Qs]
IseeUcards: folds 
TonnaMunz: folds 
Fitzyferret: raises $3.24 to $5.24
Kukuryzka: folds 
gabi_igna: folds 
nickreason17: folds 
mooose100: folds 
matiko09: folds 
Xagua: folds 
Uncalled bet ($3.24) returned to Fitzyferret
Fitzyferret collected $5 from pot
Fitzyferret: doesn't show hand 
*** SUMMARY ***
Total pot $5 | Rake $0 
Seat 1: Kukuryzka folded before Flop (didn't bet)
Seat 2: gabi_igna folded before Flop (didn't bet)
Seat 3: nickreason17 folded before Flop (didn't bet)
Seat 4: mooose100 (button) folded before Flop (didn't bet)
Seat 5: matiko09 (small blind) folded before Flop
Seat 6: Xagua (big blind) folded before Flop
Seat 7: IseeUcards folded before Flop (didn't bet)
Seat 8: TonnaMunz folded before Flop (didn't bet)
Seat 9: Fitzyferret collected ($5)





PokerStars Hand #152884235485:  Hold'em No Limit ($0.50/$1.00 USD) - 2016/05/05 15:43:24 CET [2016/05/05 9:43:24 ET]
Table 'Natascha' 9-max Seat #7 is the button
Seat 1: ronald3737 ($109.93 in chips) 
Seat 2: matiko09 ($138.25 in chips) 
Seat 3: bjonlyking ($148.20 in chips) 
Seat 4: sanpidk ($112.39 in chips) 
Seat 5: Dickyxxx ($130.26 in chips) 
Seat 6: gabi_igna ($145.12 in chips) 
Seat 7: torkkdnm ($147.74 in chips) 
Seat 8: kamillo91 ($46.50 in chips) 
Seat 9: guoweiAA ($234.70 in chips) 
kamillo91: posts small blind $0.50
guoweiAA: posts big blind $1
*** HOLE CARDS ***
Dealt to matiko09 [As Js]
ronald3737: folds 
matiko09: raises $2 to $3
bjonlyking: folds 
sanpidk: folds 
Dickyxxx: folds 
gabi_igna: raises $6 to $9
torkkdnm: folds 
kamillo91: folds 
guoweiAA: folds 
matiko09: folds 
Uncalled bet ($6) returned to gabi_igna
gabi_igna collected $7.50 from pot
gabi_igna: doesn't show hand 
*** SUMMARY ***
Total pot $7.50 | Rake $0 
Seat 1: ronald3737 folded before Flop (didn't bet)
Seat 2: matiko09 folded before Flop
Seat 3: bjonlyking folded before Flop (didn't bet)
Seat 4: sanpidk folded before Flop (didn't bet)
Seat 5: Dickyxxx folded before Flop (didn't bet)
Seat 6: gabi_igna collected ($7.50)
Seat 7: torkkdnm (button) folded before Flop (didn't bet)
Seat 8: kamillo91 (small blind) folded before Flop
Seat 9: guoweiAA (big blind) folded before Flop





PokerStars Hand #152884237440:  Hold'em No Limit ($0.50/$1.00 USD) - 2016/05/05 15:43:27 CET [2016/05/05 9:43:27 ET]
Table 'Lictoria II' 9-max Seat #5 is the button
Seat 1: St.LaCoste ($100 in chips) 
Seat 2: Dantist1122 ($121.46 in chips) 
Seat 3: Krinica2009 ($114.92 in chips) 
Seat 4: Ying59 ($92.46 in chips) 
Seat 5: sanpidk ($100 in chips) 
Seat 6: gabi_igna ($111.59 in chips) 
Seat 7: Painkiller72 ($204.92 in chips) 
Seat 8: matiko09 ($100 in chips) 
Seat 9: Kukuryzka ($144.81 in chips) 
gabi_igna: posts small blind $0.50
Painkiller72: posts big blind $1
*** HOLE CARDS ***
Dealt to matiko09 [9h 5c]
matiko09: folds 
Kukuryzka: folds 
St.LaCoste: folds 
Dantist1122: folds 
Krinica2009: raises $2 to $3
Ying59: calls $3
sanpidk: raises $10 to $13
gabi_igna: folds 
Painkiller72: folds 
Krinica2009: folds 
Ying59: folds 
Uncalled bet ($10) returned to sanpidk
sanpidk collected $10.50 from pot
sanpidk: doesn't show hand 
*** SUMMARY ***
Total pot $10.50 | Rake $0 
Seat 1: St.LaCoste folded before Flop (didn't bet)
Seat 2: Dantist1122 folded before Flop (didn't bet)
Seat 3: Krinica2009 folded before Flop
Seat 4: Ying59 folded before Flop
Seat 5: sanpidk (button) collected ($10.50)
Seat 6: gabi_igna (small blind) folded before Flop
Seat 7: Painkiller72 (big blind) folded before Flop
Seat 8: matiko09 folded before Flop (didn't bet)
Seat 9: Kukuryzka folded before Flop (didn't bet)





PokerStars Hand #152884245961:  Hold'em No Limit ($1/$2 USD) - 2016/05/05 15:43:42 CET [2016/05/05 9:43:42 ET]
Table 'Tololo' 9-max Seat #5 is the button
Seat 1: Kukuryzka ($200 in chips) 
Seat 2: gabi_igna ($243.39 in chips) 
Seat 3: nickreason17 ($216.75 in chips) 
Seat 4: mooose100 ($218.59 in chips) 
Seat 5: matiko09 ($211 in chips) 
Seat 6: Xagua ($146.83 in chips) 
Seat 9: Fitzyferret ($205.64 in chips) 
Xagua: posts small blind $1
IseeUcards: is sitting out 
IseeUcards leaves the table
TonnaMunz: is sitting out 
Fitzyferret: posts big blind $2
*** HOLE CARDS ***
Dealt to matiko09 [9h 8c]
TonnaMunz leaves the table
Kukuryzka: folds 
Iggso joins the table at seat #7 
gabi_igna: folds 
nickreason17: folds 
13Ghosts joins the table at seat #8 
mooose100: folds 
matiko09: folds 
Xagua: folds 
Uncalled bet ($1) returned to Fitzyferret
Fitzyferret collected $2 from pot
Fitzyferret: doesn't show hand 
*** SUMMARY ***
Total pot $2 | Rake $0 
Seat 1: Kukuryzka folded before Flop (didn't bet)
Seat 2: gabi_igna folded before Flop (didn't bet)
Seat 3: nickreason17 folded before Flop (didn't bet)
Seat 4: mooose100 folded before Flop (didn't bet)
Seat 5: matiko09 (button) folded before Flop (didn't bet)
Seat 6: Xagua (small blind) folded before Flop
Seat 9: Fitzyferret (big blind) collected ($2)





PokerStars Hand #152884248996:  Hold'em No Limit ($0.50/$1.00 USD) - 2016/05/05 15:43:47 CET [2016/05/05 9:43:47 ET]
Table 'Luthera' 9-max Seat #2 is the button
Seat 1: MrMattkk ($73 in chips) 
Seat 2: Spid1 ($100 in chips) 
Seat 3: ipashutapkom ($99 in chips) 
Seat 4: matiko09 ($100 in chips) 
Seat 5: Painkiller72 ($100 in chips) 
Seat 9: vrnMike ($100 in chips) 
ipashutapkom: posts small blind $0.50
matiko09: posts big blind $1
Dantist1122: sits out 
Chin41178: sits out 
*** HOLE CARDS ***
Dealt to matiko09 [7c 4s]
Painkiller72: folds 
vrnMike: folds 
MrMattkk: raises $2 to $3
Spid1: folds 
ipashutapkom: folds 
matiko09: folds 
Uncalled bet ($2) returned to MrMattkk
MrMattkk collected $2.50 from pot
MrMattkk: doesn't show hand 
*** SUMMARY ***
Total pot $2.50 | Rake $0 
Seat 1: MrMattkk collected ($2.50)
Seat 2: Spid1 (button) folded before Flop (didn't bet)
Seat 3: ipashutapkom (small blind) folded before Flop
Seat 4: matiko09 (big blind) folded before Flop
Seat 5: Painkiller72 folded before Flop (didn't bet)
Seat 9: vrnMike folded before Flop (didn't bet)





PokerStars Hand #152884250088:  Hold'em No Limit ($1/$2 USD) - 2016/05/05 15:43:49 CET [2016/05/05 9:43:49 ET]
Table 'Lundia' 9-max Seat #9 is the button
Seat 1: Fitzyferret ($200 in chips) 
Seat 2: patpaty ($193.30 in chips) 
Seat 3: IseeUcards ($408.17 in chips) 
Seat 4: KovIFish89 ($222.88 in chips) 
Seat 6: Spid1 ($248.19 in chips) 
Seat 7: matiko09 ($212.86 in chips) 
Seat 8: Durnichka ($79 in chips) 
Seat 9: gabi_igna ($248.31 in chips) 
Fitzyferret: posts small blind $1
patpaty: posts big blind $2
*** HOLE CARDS ***
Dealt to matiko09 [6d 9d]
IseeUcards: folds 
KovIFish89: folds 
Spid1: folds 
matiko09: folds 
Durnichka: folds 
gabi_igna: raises $3 to $5
Fitzyferret: raises $13.80 to $18.80
patpaty: folds 
gabi_igna: calls $13.80
*** FLOP *** [2h 6h 7d]
Fitzyferret: checks 
zmOe84 joins the table at seat #5 
gabi_igna: bets $12
Fitzyferret: calls $12
*** TURN *** [2h 6h 7d] [Qc]
Fitzyferret: checks 
gabi_igna: bets $32
Fitzyferret: folds 
Uncalled bet ($32) returned to gabi_igna
gabi_igna collected $60.85 from pot
gabi_igna: doesn't show hand 
*** SUMMARY ***
Total pot $63.60 | Rake $2.75 
Board [2h 6h 7d Qc]
Seat 1: Fitzyferret (small blind) folded on the Turn
Seat 2: patpaty (big blind) folded before Flop
Seat 3: IseeUcards folded before Flop (didn't bet)
Seat 4: KovIFish89 folded before Flop (didn't bet)
Seat 6: Spid1 folded before Flop (didn't bet)
Seat 7: matiko09 folded before Flop (didn't bet)
Seat 8: Durnichka folded before Flop (didn't bet)
Seat 9: gabi_igna (button) collected ($60.85)





PokerStars Hand #152884251106:  Hold'em No Limit ($0.50/$1.00 USD) - 2016/05/05 15:43:51 CET [2016/05/05 9:43:51 ET]
Table 'Pyxis III' 9-max Seat #9 is the button
Seat 1: sanpidk ($180.53 in chips) 
Seat 2: 50CandyJoe ($100 in chips) 
Seat 5: darren1031 ($90.85 in chips) 
Seat 6: kamillo91 ($45 in chips) 
Seat 8: matiko09 ($100 in chips) 
Seat 9: Hypoaroused ($185.55 in chips) 
sanpidk: posts small blind $0.50
50CandyJoe: posts big blind $1
vrnMike: sits out 
mycka86: sits out 
*** HOLE CARDS ***
Dealt to matiko09 [Ts 5c]
darren1031: folds 
kamillo91: folds 
matiko09: folds 
Hypoaroused: raises $2.50 to $3.50
sanpidk: folds 
50CandyJoe: folds 
Uncalled bet ($2.50) returned to Hypoaroused
Hypoaroused collected $2.50 from pot
*** SUMMARY ***
Total pot $2.50 | Rake $0 
Seat 1: sanpidk (small blind) folded before Flop
Seat 2: 50CandyJoe (big blind) folded before Flop
Seat 5: darren1031 folded before Flop (didn't bet)
Seat 6: kamillo91 folded before Flop (didn't bet)
Seat 8: matiko09 folded before Flop (didn't bet)
Seat 9: Hypoaroused (button) collected ($2.50)





PokerStars Hand #152884254712:  Hold'em No Limit ($0.50/$1.00 USD) - 2016/05/05 15:43:57 CET [2016/05/05 9:43:57 ET]
Table 'Musa II' 9-max Seat #7 is the button
Seat 1: KovIFish89 ($164.50 in chips) 
Seat 2: maxxmeister ($106.18 in chips) 
Seat 3: vrnMike ($100 in chips) 
Seat 4: sanpidk ($102.50 in chips) 
Seat 7: Painkiller72 ($100 in chips) 
Seat 8: matiko09 ($100 in chips) 
Seat 9: antfurto ($100 in chips) 
matiko09: posts small blind $0.50
antfurto: posts big blind $1
Chin41178: sits out 
*** HOLE CARDS ***
Dealt to matiko09 [Ac Ad]
KovIFish89: raises $2 to $3
maxxmeister: folds 
vrnMike: folds 
sanpidk: folds 
Painkiller72: folds 
matiko09: raises $7 to $10
antfurto: folds 
KovIFish89: calls $7
*** FLOP *** [9h 6c Qs]
matiko09: checks 
KovIFish89: bets $9.97
matiko09: calls $9.97
*** TURN *** [9h 6c Qs] [9s]
matiko09: checks 
KovIFish89: checks 
*** RIVER *** [9h 6c Qs 9s] [8c]
matiko09: bets $25
KovIFish89: raises $62.50 to $87.50
matiko09: folds 
Uncalled bet ($62.50) returned to KovIFish89
KovIFish89 collected $88.44 from pot
KovIFish89: doesn't show hand 
*** SUMMARY ***
Total pot $90.94 | Rake $2.50 
Board [9h 6c Qs 9s 8c]
Seat 1: KovIFish89 collected ($88.44)
Seat 2: maxxmeister folded before Flop (didn't bet)
Seat 3: vrnMike folded before Flop (didn't bet)
Seat 4: sanpidk folded before Flop (didn't bet)
Seat 7: Painkiller72 (button) folded before Flop (didn't bet)
Seat 8: matiko09 (small blind) folded on the River
Seat 9: antfurto (big blind) folded before Flop





PokerStars Hand #152884260546:  Hold'em No Limit ($0.50/$1.00 USD) - 2016/05/05 15:44:08 CET [2016/05/05 9:44:08 ET]
Table 'Calypso II' 9-max Seat #7 is the button
Seat 1: nickreason17 ($105.24 in chips) 
Seat 2: torkkdnm ($100 in chips) 
Seat 3: gabi_igna ($110.59 in chips) 
Seat 4: sanpidk ($100 in chips) 
Seat 5: LighTingSSSS ($88.01 in chips) 
Seat 6: WTAPSVG ($131.15 in chips) 
Seat 7: ipashutapkom ($89.33 in chips) 
Seat 8: matiko09 ($100 in chips) 
Seat 9: chrisauy ($71.61 in chips) 
matiko09: posts small blind $0.50
chrisauy: posts big blind $1
*** HOLE CARDS ***
Dealt to matiko09 [2c 8s]
nickreason17: folds 
torkkdnm: raises $2 to $3
gabi_igna: folds 
sanpidk: folds 
LighTingSSSS: folds 
WTAPSVG: calls $3
ipashutapkom: folds 
matiko09: folds 
chrisauy: raises $8 to $11
torkkdnm: calls $8
WTAPSVG: folds 
*** FLOP *** [8h 7h 5c]
chrisauy: bets $24
torkkdnm: folds 
Uncalled bet ($24) returned to chrisauy
chrisauy collected $24.22 from pot
chrisauy: doesn't show hand 
*** SUMMARY ***
Total pot $25.50 | Rake $1.28 
Board [8h 7h 5c]
Seat 1: nickreason17 folded before Flop (didn't bet)
Seat 2: torkkdnm folded on the Flop
Seat 3: gabi_igna folded before Flop (didn't bet)
Seat 4: sanpidk folded before Flop (didn't bet)
Seat 5: LighTingSSSS folded before Flop (didn't bet)
Seat 6: WTAPSVG folded before Flop
Seat 7: ipashutapkom (button) folded before Flop (didn't bet)
Seat 8: matiko09 (small blind) folded before Flop
Seat 9: chrisauy (big blind) collected ($24.22)





PokerStars Hand #152884263042:  Hold'em No Limit ($0.50/$1.00 USD) - 2016/05/05 15:44:12 CET [2016/05/05 9:44:12 ET]
Table 'Natascha' 9-max Seat #8 is the button
Seat 1: ronald3737 ($109.93 in chips) 
Seat 2: matiko09 ($135.25 in chips) 
Seat 3: bjonlyking ($148.20 in chips) 
Seat 4: sanpidk ($112.39 in chips) 
Seat 5: Dickyxxx ($130.26 in chips) 
Seat 6: gabi_igna ($149.62 in chips) 
Seat 7: torkkdnm ($147.74 in chips) 
Seat 8: kamillo91 ($46 in chips) 
Seat 9: guoweiAA ($233.70 in chips) 
guoweiAA: posts small blind $0.50
ronald3737: posts big blind $1
*** HOLE CARDS ***
Dealt to matiko09 [Js 7c]
matiko09: folds 
bjonlyking: folds 
sanpidk: folds 
Dickyxxx: folds 
gabi_igna: folds 
torkkdnm: raises $2 to $3
kamillo91: folds 
guoweiAA: folds 
ronald3737: folds 
Uncalled bet ($2) returned to torkkdnm
torkkdnm collected $2.50 from pot
*** SUMMARY ***
Total pot $2.50 | Rake $0 
Seat 1: ronald3737 (big blind) folded before Flop
Seat 2: matiko09 folded before Flop (didn't bet)
Seat 3: bjonlyking folded before Flop (didn't bet)
Seat 4: sanpidk folded before Flop (didn't bet)
Seat 5: Dickyxxx folded before Flop (didn't bet)
Seat 6: gabi_igna folded before Flop (didn't bet)
Seat 7: torkkdnm collected ($2.50)
Seat 8: kamillo91 (button) folded before Flop (didn't bet)
Seat 9: guoweiAA (small blind) folded before Flop





PokerStars Hand #152884265880:  Hold'em No Limit ($1/$2 USD) - 2016/05/05 15:44:17 CET [2016/05/05 9:44:17 ET]
Table 'Tololo' 9-max Seat #6 is the button
Seat 1: Kukuryzka ($200 in chips) 
Seat 2: gabi_igna ($243.39 in chips) 
Seat 3: nickreason17 ($216.75 in chips) 
Seat 4: mooose100 ($218.59 in chips) 
Seat 5: matiko09 ($211 in chips) 
Seat 6: Xagua ($145.83 in chips) 
Seat 9: Fitzyferret ($206.64 in chips) 
Iggso will be allowed to play after the button
Fitzyferret: posts small blind $1
Kukuryzka: posts big blind $2
*** HOLE CARDS ***
Dealt to matiko09 [6c 8d]
gabi_igna: folds 
nickreason17: folds 
mooose100: folds 
matiko09: folds 
Xagua: raises $3 to $5
Fitzyferret: raises $13 to $18
Kukuryzka: folds 
Xagua: calls $13
*** FLOP *** [Ah 4s 2s]
Fitzyferret: bets $19
Xagua: folds 
Uncalled bet ($19) returned to Fitzyferret
Fitzyferret collected $36.10 from pot
Fitzyferret: doesn't show hand 
13Ghosts leaves the table
*** SUMMARY ***
Total pot $38 | Rake $1.90 
Board [Ah 4s 2s]
Seat 1: Kukuryzka (big blind) folded before Flop
Seat 2: gabi_igna folded before Flop (didn't bet)
Seat 3: nickreason17 folded before Flop (didn't bet)
Seat 4: mooose100 folded before Flop (didn't bet)
Seat 5: matiko09 folded before Flop (didn't bet)
Seat 6: Xagua (button) folded on the Flop
Seat 9: Fitzyferret (small blind) collected ($36.10)





PokerStars Hand #152884266735:  Hold'em No Limit ($0.50/$1.00 USD) - 2016/05/05 15:44:19 CET [2016/05/05 9:44:19 ET]
Table 'Luthera' 9-max Seat #3 is the button
Seat 1: MrMattkk ($74.50 in chips) 
Seat 2: Spid1 ($100 in chips) 
Seat 3: ipashutapkom ($98.50 in chips) 
Seat 4: matiko09 ($100 in chips) 
Seat 5: Painkiller72 ($100 in chips) 
Seat 9: vrnMike ($100 in chips) 
matiko09: posts small blind $0.50
Painkiller72: posts big blind $1
Dantist1122: sits out 
Chin41178: sits out 
*** HOLE CARDS ***
Dealt to matiko09 [7s Ks]
vrnMike: folds 
MrMattkk: folds 
Spid1: folds 
xdrKush420x joins the table at seat #8 
ipashutapkom: folds 
matiko09: raises $1.50 to $2.50
Painkiller72: calls $1.50
*** FLOP *** [Jh 4s Jd]
matiko09: bets $3.09
Painkiller72: folds 
Uncalled bet ($3.09) returned to matiko09
matiko09 collected $4.75 from pot
matiko09: doesn't show hand 
*** SUMMARY ***
Total pot $5 | Rake $0.25 
Board [Jh 4s Jd]
Seat 1: MrMattkk folded before Flop (didn't bet)
Seat 2: Spid1 folded before Flop (didn't bet)
Seat 3: ipashutapkom (button) folded before Flop (didn't bet)
Seat 4: matiko09 (small blind) collected ($4.75)
Seat 5: Painkiller72 (big blind) folded on the Flop
Seat 9: vrnMike folded before Flop (didn't bet)





PokerStars Hand #152884269089:  Hold'em No Limit ($0.50/$1.00 USD) - 2016/05/05 15:44:23 CET [2016/05/05 9:44:23 ET]
Table 'Pyxis III' 9-max Seat #1 is the button
Seat 1: sanpidk ($180.03 in chips) 
Seat 2: 50CandyJoe ($100 in chips) 
Seat 3: vrnMike ($100 in chips) 
Seat 5: darren1031 ($90.85 in chips) 
Seat 6: kamillo91 ($45 in chips) 
Seat 8: matiko09 ($100 in chips) 
Seat 9: Hypoaroused ($187.05 in chips) 
50CandyJoe: posts small blind $0.50
vrnMike: posts big blind $1
mycka86: sits out 
*** HOLE CARDS ***
Dealt to matiko09 [7h 7s]
darren1031: folds 
kamillo91: folds 
matiko09: raises $2 to $3
Hypoaroused: folds 
sanpidk: folds 
50CandyJoe: calls $2.50
vrnMike: folds 
*** FLOP *** [5d 2d Jc]
50CandyJoe: checks 
matiko09: bets $4
50CandyJoe: calls $4
*** TURN *** [5d 2d Jc] [7d]
50CandyJoe: checks 
matiko09: bets $8
50CandyJoe: folds 
Uncalled bet ($8) returned to matiko09
matiko09 collected $14.25 from pot
matiko09: doesn't show hand 
*** SUMMARY ***
Total pot $15 | Rake $0.75 
Board [5d 2d Jc 7d]
Seat 1: sanpidk (button) folded before Flop (didn't bet)
Seat 2: 50CandyJoe (small blind) folded on the Turn
Seat 3: vrnMike (big blind) folded before Flop
Seat 5: darren1031 folded before Flop (didn't bet)
Seat 6: kamillo91 folded before Flop (didn't bet)
Seat 8: matiko09 collected ($14.25)
Seat 9: Hypoaroused folded before Flop (didn't bet)





PokerStars Hand #152884271295:  Hold'em No Limit ($0.50/$1.00 USD) - 2016/05/05 15:44:27 CET [2016/05/05 9:44:27 ET]
Table 'Lictoria II' 9-max Seat #6 is the button
Seat 1: St.LaCoste ($100 in chips) 
Seat 2: Dantist1122 ($121.46 in chips) 
Seat 3: Krinica2009 ($111.92 in chips) 
Seat 4: Ying59 ($89.46 in chips) 
Seat 5: sanpidk ($107.50 in chips) 
Seat 6: gabi_igna ($111.09 in chips) 
Seat 7: Painkiller72 ($203.92 in chips) 
Seat 8: matiko09 ($100 in chips) 
Seat 9: Kukuryzka ($144.81 in chips) 
Painkiller72: posts small blind $0.50
matiko09: posts big blind $1
*** HOLE CARDS ***
Dealt to matiko09 [Kd Ad]
Kukuryzka: folds 
St.LaCoste: folds 
Dantist1122: folds 
Krinica2009: folds 
Ying59: raises $1 to $2
sanpidk: calls $2
gabi_igna: folds 
Painkiller72: folds 
matiko09: raises $8 to $10
Ying59: folds 
sanpidk: folds 
Uncalled bet ($8) returned to matiko09
matiko09 collected $6.50 from pot
matiko09: doesn't show hand 
*** SUMMARY ***
Total pot $6.50 | Rake $0 
Seat 1: St.LaCoste folded before Flop (didn't bet)
Seat 2: Dantist1122 folded before Flop (didn't bet)
Seat 3: Krinica2009 folded before Flop (didn't bet)
Seat 4: Ying59 folded before Flop
Seat 5: sanpidk folded before Flop
Seat 6: gabi_igna (button) folded before Flop (didn't bet)
Seat 7: Painkiller72 (small blind) folded before Flop
Seat 8: matiko09 (big blind) collected ($6.50)
Seat 9: Kukuryzka folded before Flop (didn't bet)





PokerStars Hand #152884279902:  Hold'em No Limit ($0.50/$1.00 USD) - 2016/05/05 15:44:42 CET [2016/05/05 9:44:42 ET]
Table 'Priska II' 9-max Seat #2 is the button
Seat 1: Spid1 ($111.40 in chips) 
Seat 2: Kukuryzka ($123 in chips) 
Seat 3: matiko09 ($102 in chips) 
Seat 4: Painkiller72 ($164.16 in chips) 
Seat 5: nickreason17 ($175.55 in chips) 
Seat 6: OneTwo81 ($97.23 in chips) 
Seat 7: stockbridge8 ($93.77 in chips) 
Seat 8: pohorc21 ($51.15 in chips) 
Seat 9: torkkdnm ($111.50 in chips) 
matiko09: posts small blind $0.50
Painkiller72: posts big blind $1
*** HOLE CARDS ***
Dealt to matiko09 [8d 5c]
nickreason17: folds 
OneTwo81: folds 
stockbridge8: folds 
pohorc21: folds 
torkkdnm: folds 
Spid1: folds 
Kukuryzka: folds 
matiko09: folds 
Uncalled bet ($0.50) returned to Painkiller72
Painkiller72 collected $1 from pot
Painkiller72: doesn't show hand 
*** SUMMARY ***
Total pot $1 | Rake $0 
Seat 1: Spid1 folded before Flop (didn't bet)
Seat 2: Kukuryzka (button) folded before Flop (didn't bet)
Seat 3: matiko09 (small blind) folded before Flop
Seat 4: Painkiller72 (big blind) collected ($1)
Seat 5: nickreason17 folded before Flop (didn't bet)
Seat 6: OneTwo81 folded before Flop (didn't bet)
Seat 7: stockbridge8 folded before Flop (didn't bet)
Seat 8: pohorc21 folded before Flop (didn't bet)
Seat 9: torkkdnm folded before Flop (didn't bet)





PokerStars Hand #152884287286:  Hold'em No Limit ($0.50/$1.00 USD) - 2016/05/05 15:44:54 CET [2016/05/05 9:44:54 ET]
Table 'Natascha' 9-max Seat #9 is the button
Seat 1: ronald3737 ($108.93 in chips) 
Seat 2: matiko09 ($135.25 in chips) 
Seat 3: bjonlyking ($148.20 in chips) 
Seat 4: sanpidk ($112.39 in chips) 
Seat 5: Dickyxxx ($130.26 in chips) 
Seat 6: gabi_igna ($149.62 in chips) 
Seat 7: torkkdnm ($149.24 in chips) 
Seat 8: kamillo91 ($46 in chips) 
Seat 9: guoweiAA ($233.20 in chips) 
ronald3737: posts small blind $0.50
matiko09: posts big blind $1
*** HOLE CARDS ***
Dealt to matiko09 [Kd 6d]
bjonlyking: folds 
sanpidk: folds 
Dickyxxx: folds 
gabi_igna: folds 
torkkdnm: folds 
kamillo91: folds 
guoweiAA: raises $2 to $3
ronald3737: folds 
matiko09: calls $2
*** FLOP *** [7h Kh Tc]
matiko09: checks 
guoweiAA: bets $4
matiko09: calls $4
*** TURN *** [7h Kh Tc] [5c]
matiko09: checks 
guoweiAA: checks 
*** RIVER *** [7h Kh Tc 5c] [Js]
matiko09: bets $7
guoweiAA: folds 
Uncalled bet ($7) returned to matiko09
matiko09 collected $13.78 from pot
matiko09: doesn't show hand 
*** SUMMARY ***
Total pot $14.50 | Rake $0.72 
Board [7h Kh Tc 5c Js]
Seat 1: ronald3737 (small blind) folded before Flop
Seat 2: matiko09 (big blind) collected ($13.78)
Seat 3: bjonlyking folded before Flop (didn't bet)
Seat 4: sanpidk folded before Flop (didn't bet)
Seat 5: Dickyxxx folded before Flop (didn't bet)
Seat 6: gabi_igna folded before Flop (didn't bet)
Seat 7: torkkdnm folded before Flop (didn't bet)
Seat 8: kamillo91 folded before Flop (didn't bet)
Seat 9: guoweiAA (button) folded on the River





PokerStars Hand #152884299870:  Hold'em No Limit ($0.50/$1.00 USD) - 2016/05/05 15:45:16 CET [2016/05/05 9:45:16 ET]
Table 'Luthera' 9-max Seat #4 is the button
Seat 1: MrMattkk ($74.50 in chips) 
Seat 2: Spid1 ($100 in chips) 
Seat 3: ipashutapkom ($98.50 in chips) 
Seat 4: matiko09 ($102.25 in chips) 
Seat 5: Painkiller72 ($100 in chips) 
Seat 7: Chin41178 ($100 in chips) 
Seat 9: vrnMike ($100 in chips) 
Painkiller72: posts small blind $0.50
Chin41178: posts big blind $1
xdrKush420x: sits out 
*** HOLE CARDS ***
Dealt to matiko09 [Ac 6h]
vrnMike: folds 
MrMattkk: folds 
Spid1: folds 
ipashutapkom: folds 
matiko09: raises $1.27 to $2.27
Painkiller72: folds 
Chin41178: folds 
Uncalled bet ($1.27) returned to matiko09
matiko09 collected $2.50 from pot
matiko09: doesn't show hand 
*** SUMMARY ***
Total pot $2.50 | Rake $0 
Seat 1: MrMattkk folded before Flop (didn't bet)
Seat 2: Spid1 folded before Flop (didn't bet)
Seat 3: ipashutapkom folded before Flop (didn't bet)
Seat 4: matiko09 (button) collected ($2.50)
Seat 5: Painkiller72 (small blind) folded before Flop
Seat 7: Chin41178 (big blind) folded before Flop
Seat 9: vrnMike folded before Flop (didn't bet)





PokerStars Hand #152884300403:  Hold'em No Limit ($0.50/$1.00 USD) - 2016/05/05 15:45:17 CET [2016/05/05 9:45:17 ET]
Table 'Lictoria II' 9-max Seat #7 is the button
Seat 1: St.LaCoste ($100 in chips) 
Seat 2: Dantist1122 ($121.46 in chips) 
Seat 3: Krinica2009 ($111.92 in chips) 
Seat 4: Ying59 ($87.46 in chips) 
Seat 5: sanpidk ($105.50 in chips) 
Seat 6: gabi_igna ($111.09 in chips) 
Seat 7: Painkiller72 ($203.42 in chips) 
Seat 8: matiko09 ($104.50 in chips) 
Seat 9: Kukuryzka ($144.81 in chips) 
matiko09: posts small blind $0.50
Kukuryzka: posts big blind $1
*** HOLE CARDS ***
Dealt to matiko09 [Th 8s]
St.LaCoste: folds 
Dantist1122: folds 
Krinica2009: raises $2 to $3
Ying59: folds 
sanpidk: calls $3
gabi_igna: folds 
Painkiller72: raises $10 to $13
matiko09: folds 
Kukuryzka: folds 
Krinica2009: folds 
sanpidk: calls $10
*** FLOP *** [5c 4s 9h]
sanpidk: checks 
Painkiller72: bets $15
sanpidk: calls $15
*** TURN *** [5c 4s 9h] [Jc]
sanpidk: checks 
Painkiller72: checks 
*** RIVER *** [5c 4s 9h Jc] [Qd]
sanpidk: bets $38
Painkiller72: folds 
Uncalled bet ($38) returned to sanpidk
sanpidk collected $58 from pot
sanpidk: doesn't show hand 
*** SUMMARY ***
Total pot $60.50 | Rake $2.50 
Board [5c 4s 9h Jc Qd]
Seat 1: St.LaCoste folded before Flop (didn't bet)
Seat 2: Dantist1122 folded before Flop (didn't bet)
Seat 3: Krinica2009 folded before Flop
Seat 4: Ying59 folded before Flop (didn't bet)
Seat 5: sanpidk collected ($58)
Seat 6: gabi_igna folded before Flop (didn't bet)
Seat 7: Painkiller72 (button) folded on the River
Seat 8: matiko09 (small blind) folded before Flop
Seat 9: Kukuryzka (big blind) folded before Flop





PokerStars Hand #152884304929:  Hold'em No Limit ($0.50/$1.00 USD) - 2016/05/05 15:45:25 CET [2016/05/05 9:45:25 ET]
Table 'Priska II' 9-max Seat #3 is the button
Seat 1: Spid1 ($111.40 in chips) 
Seat 2: Kukuryzka ($123 in chips) 
Seat 3: matiko09 ($101.50 in chips) 
Seat 4: Painkiller72 ($164.66 in chips) 
Seat 5: nickreason17 ($175.55 in chips) 
Seat 6: OneTwo81 ($97.23 in chips) 
Seat 7: stockbridge8 ($93.77 in chips) 
Seat 8: pohorc21 ($51.15 in chips) 
Seat 9: torkkdnm ($111.50 in chips) 
Painkiller72: posts small blind $0.50
nickreason17: posts big blind $1
*** HOLE CARDS ***
Dealt to matiko09 [9d 2c]
OneTwo81: calls $1
stockbridge8: folds 
pohorc21: folds 
torkkdnm: folds 
Spid1: folds 
Kukuryzka: folds 
matiko09: folds 
Painkiller72: folds 
nickreason17: checks 
*** FLOP *** [8c 3c Jc]
nickreason17: checks 
OneTwo81: checks 
*** TURN *** [8c 3c Jc] [Qc]
nickreason17: checks 
OneTwo81: bets $2
nickreason17: folds 
Uncalled bet ($2) returned to OneTwo81
OneTwo81 collected $2.38 from pot
OneTwo81: doesn't show hand 
*** SUMMARY ***
Total pot $2.50 | Rake $0.12 
Board [8c 3c Jc Qc]
Seat 1: Spid1 folded before Flop (didn't bet)
Seat 2: Kukuryzka folded before Flop (didn't bet)
Seat 3: matiko09 (button) folded before Flop (didn't bet)
Seat 4: Painkiller72 (small blind) folded before Flop
Seat 5: nickreason17 (big blind) folded on the Turn
Seat 6: OneTwo81 collected ($2.38)
Seat 7: stockbridge8 folded before Flop (didn't bet)
Seat 8: pohorc21 folded before Flop (didn't bet)
Seat 9: torkkdnm folded before Flop (didn't bet)





PokerStars Hand #152884308077:  Hold'em No Limit ($1/$2 USD) - 2016/05/05 15:45:31 CET [2016/05/05 9:45:31 ET]
Table 'Lundia' 9-max Seat #1 is the button
Seat 1: Fitzyferret ($200 in chips) 
Seat 2: patpaty ($191.30 in chips) 
Seat 4: KovIFish89 ($222.88 in chips) 
Seat 6: Spid1 ($248.19 in chips) 
Seat 7: matiko09 ($212.86 in chips) 
Seat 8: Durnichka ($79 in chips) 
Seat 9: gabi_igna ($278.36 in chips) 
patpaty: posts small blind $1
IseeUcards: is sitting out 
KovIFish89: posts big blind $2
zmOe84: sits out 
*** HOLE CARDS ***
Dealt to matiko09 [Tc Jd]
IseeUcards leaves the table
Spid1: folds 
Painkiller72 joins the table at seat #3 
matiko09: folds 
Durnichka: folds 
gabi_igna: folds 
Fitzyferret: folds 
patpaty: calls $1
KovIFish89: checks 
*** FLOP *** [Jc 7s Ad]
patpaty: checks 
KovIFish89: checks 
*** TURN *** [Jc 7s Ad] [7d]
patpaty: bets $2
KovIFish89: folds 
Uncalled bet ($2) returned to patpaty
patpaty collected $3.80 from pot
patpaty: doesn't show hand 
*** SUMMARY ***
Total pot $4 | Rake $0.20 
Board [Jc 7s Ad 7d]
Seat 1: Fitzyferret (button) folded before Flop (didn't bet)
Seat 2: patpaty (small blind) collected ($3.80)
Seat 4: KovIFish89 (big blind) folded on the Turn
Seat 6: Spid1 folded before Flop (didn't bet)
Seat 7: matiko09 folded before Flop (didn't bet)
Seat 8: Durnichka folded before Flop (didn't bet)
Seat 9: gabi_igna folded before Flop (didn't bet)





PokerStars Hand #152884310121:  Hold'em No Limit ($1/$2 USD) - 2016/05/05 15:45:34 CET [2016/05/05 9:45:34 ET]
Table 'Tololo' 9-max Seat #9 is the button
Seat 1: Kukuryzka ($198 in chips) 
Seat 2: gabi_igna ($243.39 in chips) 
Seat 3: nickreason17 ($216.75 in chips) 
Seat 4: mooose100 ($218.59 in chips) 
Seat 5: matiko09 ($211 in chips) 
Seat 6: Xagua ($127.83 in chips) 
Seat 9: Fitzyferret ($224.74 in chips) 
Kukuryzka: posts small blind $1
gabi_igna: posts big blind $2
Iggso: sits out 
*** HOLE CARDS ***
Dealt to matiko09 [2d Qc]
KovIFish89 joins the table at seat #8 
nickreason17: folds 
mooose100 has timed out
mooose100: folds 
matiko09: folds 
Xagua: folds 
Fitzyferret: folds 
Kukuryzka: folds 
Uncalled bet ($1) returned to gabi_igna
gabi_igna collected $2 from pot
gabi_igna: doesn't show hand 
*** SUMMARY ***
Total pot $2 | Rake $0 
Seat 1: Kukuryzka (small blind) folded before Flop
Seat 2: gabi_igna (big blind) collected ($2)
Seat 3: nickreason17 folded before Flop (didn't bet)
Seat 4: mooose100 folded before Flop (didn't bet)
Seat 5: matiko09 folded before Flop (didn't bet)
Seat 6: Xagua folded before Flop (didn't bet)
Seat 9: Fitzyferret (button) folded before Flop (didn't bet)





PokerStars Hand #152884309914:  Hold'em No Limit ($0.50/$1.00 USD) - 2016/05/05 15:45:34 CET [2016/05/05 9:45:34 ET]
Table 'Calypso II' 9-max Seat #8 is the button
Seat 1: nickreason17 ($105.24 in chips) 
Seat 2: torkkdnm ($100 in chips) 
Seat 3: gabi_igna ($110.59 in chips) 
Seat 4: sanpidk ($100 in chips) 
Seat 5: LighTingSSSS ($88.01 in chips) 
Seat 6: WTAPSVG ($128.15 in chips) 
Seat 7: ipashutapkom ($89.33 in chips) 
Seat 8: matiko09 ($100 in chips) 
Seat 9: chrisauy ($84.83 in chips) 
chrisauy: posts small blind $0.50
nickreason17: posts big blind $1
*** HOLE CARDS ***
Dealt to matiko09 [Kh Ts]
torkkdnm: folds 
gabi_igna: folds 
sanpidk: folds 
LighTingSSSS: folds 
WTAPSVG: folds 
ipashutapkom: folds 
matiko09: raises $1.27 to $2.27
chrisauy: calls $1.77
nickreason17: calls $1.27
*** FLOP *** [Qd Qs 7h]
chrisauy: checks 
nickreason17: checks 
matiko09: bets $4
chrisauy: folds 
nickreason17: calls $4
*** TURN *** [Qd Qs 7h] [Tc]
nickreason17: checks 
matiko09: checks 
*** RIVER *** [Qd Qs 7h Tc] [3h]
nickreason17: checks 
matiko09: checks 
*** SHOW DOWN ***
nickreason17: shows [7s As] (two pair, Queens and Sevens)
matiko09: shows [Kh Ts] (two pair, Queens and Tens)
matiko09 collected $14.07 from pot
*** SUMMARY ***
Total pot $14.81 | Rake $0.74 
Board [Qd Qs 7h Tc 3h]
Seat 1: nickreason17 (big blind) showed [7s As] and lost with two pair, Queens and Sevens
Seat 2: torkkdnm folded before Flop (didn't bet)
Seat 3: gabi_igna folded before Flop (didn't bet)
Seat 4: sanpidk folded before Flop (didn't bet)
Seat 5: LighTingSSSS folded before Flop (didn't bet)
Seat 6: WTAPSVG folded before Flop (didn't bet)
Seat 7: ipashutapkom folded before Flop (didn't bet)
Seat 8: matiko09 (button) showed [Kh Ts] and won ($14.07) with two pair, Queens and Tens
Seat 9: chrisauy (small blind) folded on the Flop





PokerStars Hand #152884319659:  Hold'em No Limit ($0.50/$1.00 USD) - 2016/05/05 15:45:51 CET [2016/05/05 9:45:51 ET]
Table 'Musa II' 9-max Seat #8 is the button
Seat 1: KovIFish89 ($207.97 in chips) 
Seat 2: maxxmeister ($106.18 in chips) 
Seat 3: vrnMike ($100 in chips) 
Seat 4: sanpidk ($102.50 in chips) 
Seat 6: cnn123 ($50 in chips) 
Seat 7: Painkiller72 ($100 in chips) 
Seat 8: matiko09 ($100 in chips) 
Seat 9: antfurto ($99 in chips) 
antfurto: posts small blind $0.50
KovIFish89: posts big blind $1
Chin41178: sits out 
*** HOLE CARDS ***
Dealt to matiko09 [Ah 6c]
maxxmeister: folds 
maxxmeister leaves the table
vrnMike: folds 
sanpidk: raises $2 to $3
cnn123: folds 
ICE-MB-1980 joins the table at seat #2 
Painkiller72: folds 
matiko09: folds 
antfurto: folds 
KovIFish89: folds 
Uncalled bet ($2) returned to sanpidk
sanpidk collected $2.50 from pot
sanpidk: doesn't show hand 
*** SUMMARY ***
Total pot $2.50 | Rake $0 
Seat 1: KovIFish89 (big blind) folded before Flop
Seat 2: maxxmeister folded before Flop (didn't bet)
Seat 3: vrnMike folded before Flop (didn't bet)
Seat 4: sanpidk collected ($2.50)
Seat 6: cnn123 folded before Flop (didn't bet)
Seat 7: Painkiller72 folded before Flop (didn't bet)
Seat 8: matiko09 (button) folded before Flop (didn't bet)
Seat 9: antfurto (small blind) folded before Flop





PokerStars Hand #152884327045:  Hold'em No Limit ($0.50/$1.00 USD) - 2016/05/05 15:46:04 CET [2016/05/05 9:46:04 ET]
Table 'Luthera' 9-max Seat #5 is the button
Seat 1: MrMattkk ($74.50 in chips) 
Seat 2: Spid1 ($100 in chips) 
Seat 3: ipashutapkom ($98.50 in chips) 
Seat 4: matiko09 ($103.75 in chips) 
Seat 5: Painkiller72 ($100 in chips) 
Seat 7: Chin41178 ($99 in chips) 
Seat 8: xdrKush420x ($100 in chips) 
Seat 9: vrnMike ($100 in chips) 
Chin41178: posts small blind $0.50
xdrKush420x: posts big blind $1
*** HOLE CARDS ***
Dealt to matiko09 [2c 5d]
vrnMike: folds 
MrMattkk: raises $2 to $3
Spid1: folds 
ipashutapkom: folds 
matiko09: folds 
Painkiller72: folds 
Chin41178: folds 
xdrKush420x: calls $2
*** FLOP *** [8h 8d 6h]
xdrKush420x: checks 
MrMattkk: bets $3.09
xdrKush420x: folds 
Uncalled bet ($3.09) returned to MrMattkk
MrMattkk collected $6.18 from pot
MrMattkk: doesn't show hand 
*** SUMMARY ***
Total pot $6.50 | Rake $0.32 
Board [8h 8d 6h]
Seat 1: MrMattkk collected ($6.18)
Seat 2: Spid1 folded before Flop (didn't bet)
Seat 3: ipashutapkom folded before Flop (didn't bet)
Seat 4: matiko09 folded before Flop (didn't bet)
Seat 5: Painkiller72 (button) folded before Flop (didn't bet)
Seat 7: Chin41178 (small blind) folded before Flop
Seat 8: xdrKush420x (big blind) folded on the Flop
Seat 9: vrnMike folded before Flop (didn't bet)





PokerStars Hand #152884327300:  Hold'em No Limit ($0.50/$1.00 USD) - 2016/05/05 15:46:04 CET [2016/05/05 9:46:04 ET]
Table 'Pyxis III' 9-max Seat #2 is the button
Seat 1: sanpidk ($180.03 in chips) 
Seat 2: 50CandyJoe ($100 in chips) 
Seat 3: vrnMike ($100 in chips) 
Seat 5: darren1031 ($90.85 in chips) 
Seat 6: kamillo91 ($45 in chips) 
Seat 8: matiko09 ($107.25 in chips) 
Seat 9: Hypoaroused ($187.05 in chips) 
vrnMike: posts small blind $0.50
darren1031: posts big blind $1
mycka86: sits out 
*** HOLE CARDS ***
Dealt to matiko09 [Qc Ts]
kamillo91: raises $2 to $3
matiko09: folds 
Hypoaroused: folds 
sanpidk: folds 
50CandyJoe: folds 
vrnMike: calls $2.50
darren1031: folds 
*** FLOP *** [Kd As 7d]
vrnMike: checks 
kamillo91: bets $4
vrnMike: calls $4
*** TURN *** [Kd As 7d] [Tc]
vrnMike: checks 
kamillo91: bets $7
vrnMike: raises $20 to $27
kamillo91: calls $20
*** RIVER *** [Kd As 7d Tc] [3s]
vrnMike: bets $40
kamillo91: calls $11 and is all-in
Uncalled bet ($29) returned to vrnMike
*** SHOW DOWN ***
vrnMike: shows [Th Ah] (two pair, Aces and Tens)
kamillo91: shows [Js Qs] (a straight, Ten to Ace)
kamillo91 collected $88.50 from pot
*** SUMMARY ***
Total pot $91 | Rake $2.50 
Board [Kd As 7d Tc 3s]
Seat 1: sanpidk folded before Flop (didn't bet)
Seat 2: 50CandyJoe (button) folded before Flop (didn't bet)
Seat 3: vrnMike (small blind) showed [Th Ah] and lost with two pair, Aces and Tens
Seat 5: darren1031 (big blind) folded before Flop
Seat 6: kamillo91 showed [Js Qs] and won ($88.50) with a straight, Ten to Ace
Seat 8: matiko09 folded before Flop (didn't bet)
Seat 9: Hypoaroused folded before Flop (didn't bet)





PokerStars Hand #152884327904:  Hold'em No Limit ($1/$2 USD) - 2016/05/05 15:46:06 CET [2016/05/05 9:46:06 ET]
Table 'Tololo' 9-max Seat #1 is the button
Seat 1: Kukuryzka ($200 in chips) 
Seat 2: gabi_igna ($244.39 in chips) 
Seat 3: nickreason17 ($216.75 in chips) 
Seat 4: mooose100 ($218.59 in chips) 
Seat 5: matiko09 ($211 in chips) 
Seat 6: Xagua ($127.83 in chips) 
Seat 9: Fitzyferret ($224.74 in chips) 
gabi_igna: posts small blind $1
nickreason17: posts big blind $2
Iggso: sits out 
KovIFish89: sits out 
*** HOLE CARDS ***
Dealt to matiko09 [Td 5d]
mooose100: calls $2
matiko09: folds 
Xagua: calls $2
Fitzyferret: raises $10 to $12
Kukuryzka: folds 
gabi_igna: calls $11
nickreason17: folds 
mooose100: calls $10
Xagua: folds 
*** FLOP *** [9c 6d Ac]
gabi_igna: checks 
mooose100: checks 
Fitzyferret: checks 
*** TURN *** [9c 6d Ac] [As]
gabi_igna: checks 
mooose100: bets $38
Fitzyferret: calls $38
gabi_igna: folds 
*** RIVER *** [9c 6d Ac As] [7d]
mooose100: checks 
Fitzyferret: checks 
*** SHOW DOWN ***
mooose100: shows [2s 2c] (two pair, Aces and Deuces)
Fitzyferret: shows [Ad 8d] (three of a kind, Aces)
Fitzyferret collected $113.25 from pot
*** SUMMARY ***
Total pot $116 | Rake $2.75 
Board [9c 6d Ac As 7d]
Seat 1: Kukuryzka (button) folded before Flop (didn't bet)
Seat 2: gabi_igna (small blind) folded on the Turn
Seat 3: nickreason17 (big blind) folded before Flop
Seat 4: mooose100 showed [2s 2c] and lost with two pair, Aces and Deuces
Seat 5: matiko09 folded before Flop (didn't bet)
Seat 6: Xagua folded before Flop
Seat 9: Fitzyferret showed [Ad 8d] and won ($113.25) with three of a kind, Aces





PokerStars Hand #152884337687:  Hold'em No Limit ($0.50/$1.00 USD) - 2016/05/05 15:46:23 CET [2016/05/05 9:46:23 ET]
Table 'Musa II' 9-max Seat #9 is the button
Seat 1: KovIFish89 ($206.97 in chips) 
Seat 2: ICE-MB-1980 ($65 in chips) 
Seat 3: vrnMike ($100 in chips) 
Seat 4: sanpidk ($104 in chips) 
Seat 6: cnn123 ($50 in chips) 
Seat 7: Painkiller72 ($100 in chips) 
Seat 8: matiko09 ($100 in chips) 
Seat 9: antfurto ($98.50 in chips) 
KovIFish89: posts small blind $0.50
ICE-MB-1980: posts big blind $1
Chin41178: sits out 
*** HOLE CARDS ***
Dealt to matiko09 [6s 3h]
vrnMike: folds 
sanpidk: raises $2 to $3
cnn123: calls $3
Painkiller72: folds 
matiko09: folds 
antfurto: folds 
KovIFish89: folds 
ICE-MB-1980: folds 
*** FLOP *** [7c 8d 7d]
ICE-MB-1980 leaves the table
sanpidk: bets $5
cnn123: calls $5
*** TURN *** [7c 8d 7d] [4s]
St.LaCoste joins the table at seat #2 
sanpidk: checks 
cnn123: bets $10
sanpidk: folds 
Uncalled bet ($10) returned to cnn123
cnn123 collected $16.62 from pot
cnn123: doesn't show hand 
*** SUMMARY ***
Total pot $17.50 | Rake $0.88 
Board [7c 8d 7d 4s]
Seat 1: KovIFish89 (small blind) folded before Flop
Seat 2: ICE-MB-1980 (big blind) folded before Flop
Seat 3: vrnMike folded before Flop (didn't bet)
Seat 4: sanpidk folded on the Turn
Seat 6: cnn123 collected ($16.62)
Seat 7: Painkiller72 folded before Flop (didn't bet)
Seat 8: matiko09 folded before Flop (didn't bet)
Seat 9: antfurto (button) folded before Flop (didn't bet)





PokerStars Hand #152884339420:  Hold'em No Limit ($0.50/$1.00 USD) - 2016/05/05 15:46:26 CET [2016/05/05 9:46:26 ET]
Table 'Priska II' 9-max Seat #4 is the button
Seat 1: Spid1 ($111.40 in chips) 
Seat 2: Kukuryzka ($123 in chips) 
Seat 3: matiko09 ($101.50 in chips) 
Seat 4: Painkiller72 ($164.16 in chips) 
Seat 5: nickreason17 ($174.55 in chips) 
Seat 6: OneTwo81 ($98.61 in chips) 
Seat 7: stockbridge8 ($93.77 in chips) 
Seat 8: pohorc21 ($51.15 in chips) 
Seat 9: torkkdnm ($111.50 in chips) 
nickreason17: posts small blind $0.50
OneTwo81: posts big blind $1
*** HOLE CARDS ***
Dealt to matiko09 [2c 3s]
stockbridge8: raises $2 to $3
pohorc21: raises $29 to $32
torkkdnm: folds 
Spid1: folds 
Kukuryzka: folds 
matiko09: folds 
Painkiller72: folds 
nickreason17: folds 
OneTwo81: folds 
stockbridge8: folds 
Uncalled bet ($29) returned to pohorc21
pohorc21 collected $7.50 from pot
pohorc21: doesn't show hand 
*** SUMMARY ***
Total pot $7.50 | Rake $0 
Seat 1: Spid1 folded before Flop (didn't bet)
Seat 2: Kukuryzka folded before Flop (didn't bet)
Seat 3: matiko09 folded before Flop (didn't bet)
Seat 4: Painkiller72 (button) folded before Flop (didn't bet)
Seat 5: nickreason17 (small blind) folded before Flop
Seat 6: OneTwo81 (big blind) folded before Flop
Seat 7: stockbridge8 folded before Flop
Seat 8: pohorc21 collected ($7.50)
Seat 9: torkkdnm folded before Flop (didn't bet)





PokerStars Hand #152884343453:  Hold'em No Limit ($0.50/$1.00 USD) - 2016/05/05 15:46:33 CET [2016/05/05 9:46:33 ET]
Table 'Natascha' 9-max Seat #1 is the button
Seat 1: ronald3737 ($108.43 in chips) 
Seat 2: matiko09 ($142.03 in chips) 
Seat 3: bjonlyking ($148.20 in chips) 
Seat 4: sanpidk ($112.39 in chips) 
Seat 5: Dickyxxx ($130.26 in chips) 
Seat 6: gabi_igna ($149.62 in chips) 
Seat 7: torkkdnm ($149.24 in chips) 
Seat 8: kamillo91 ($46 in chips) 
Seat 9: guoweiAA ($226.20 in chips) 
matiko09: posts small blind $0.50
bjonlyking: posts big blind $1
*** HOLE CARDS ***
Dealt to matiko09 [3c 5h]
sanpidk: folds 
Dickyxxx: folds 
gabi_igna: folds 
torkkdnm: raises $2 to $3
kamillo91: calls $3
guoweiAA: folds 
ronald3737: folds 
matiko09: folds 
bjonlyking: calls $2
*** FLOP *** [7c 9h Ac]
bjonlyking: checks 
torkkdnm: checks 
kamillo91: checks 
*** TURN *** [7c 9h Ac] [Qs]
bjonlyking: checks 
torkkdnm: checks 
kamillo91: checks 
*** RIVER *** [7c 9h Ac Qs] [9d]
bjonlyking: checks 
torkkdnm: checks 
kamillo91: checks 
*** SHOW DOWN ***
bjonlyking: shows [Ts 8s] (a pair of Nines)
torkkdnm: shows [Ks Jc] (a pair of Nines - Ace+King kicker)
kamillo91: shows [Kc Js] (a pair of Nines)
torkkdnm collected $4.51 from pot
kamillo91 collected $4.51 from pot
*** SUMMARY ***
Total pot $9.50 | Rake $0.48 
Board [7c 9h Ac Qs 9d]
Seat 1: ronald3737 (button) folded before Flop (didn't bet)
Seat 2: matiko09 (small blind) folded before Flop
Seat 3: bjonlyking (big blind) showed [Ts 8s] and lost with a pair of Nines
Seat 4: sanpidk folded before Flop (didn't bet)
Seat 5: Dickyxxx folded before Flop (didn't bet)
Seat 6: gabi_igna folded before Flop (didn't bet)
Seat 7: torkkdnm showed [Ks Jc] and won ($4.51) with a pair of Nines
Seat 8: kamillo91 showed [Kc Js] and won ($4.51) with a pair of Nines
Seat 9: guoweiAA folded before Flop (didn't bet)





PokerStars Hand #152884343573:  Hold'em No Limit (€0.50/€1.00 EUR) - 2016/05/05 15:46:33 CET [2016/05/05 9:46:33 ET]
Table 'Carol II' 9-max Seat #9 is the button
Seat 1: vrnMike (€113.85 in chips) 
Seat 2: matiko09 (€100 in chips) 
Seat 5: Painkiller72 (€102.28 in chips) 
Seat 6: drissmouzou (€87.15 in chips) 
Seat 7: Spid1 (€101 in chips) 
Seat 9: Racushniak (€100 in chips) 
vrnMike: posts small blind €0.50
matiko09: posts big blind €1
Merlin_1905: sits out 
*** HOLE CARDS ***
Dealt to matiko09 [Qc 3s]
Painkiller72: folds 
drissmouzou: folds 
Spid1: folds 
Racushniak: folds 
vrnMike: raises €1.50 to €2.50
nickreason17 joins the table at seat #3 
matiko09: folds 
Uncalled bet (€1.50) returned to vrnMike
vrnMike collected €2 from pot
*** SUMMARY ***
Total pot €2 | Rake €0 
Seat 1: vrnMike (small blind) collected (€2)
Seat 2: matiko09 (big blind) folded before Flop
Seat 5: Painkiller72 folded before Flop (didn't bet)
Seat 6: drissmouzou folded before Flop (didn't bet)
Seat 7: Spid1 folded before Flop (didn't bet)
Seat 9: Racushniak (button) folded before Flop (didn't bet)





PokerStars Hand #152884350311:  Hold'em No Limit ($0.50/$1.00 USD) - 2016/05/05 15:46:45 CET [2016/05/05 9:46:45 ET]
Table 'Luthera' 9-max Seat #7 is the button
Seat 1: MrMattkk ($77.68 in chips) 
Seat 2: Spid1 ($100 in chips) 
Seat 3: ipashutapkom ($98.50 in chips) 
Seat 4: matiko09 ($103.75 in chips) 
Seat 5: Painkiller72 ($100 in chips) 
Seat 7: Chin41178 ($98.50 in chips) 
Seat 8: xdrKush420x ($97 in chips) 
Seat 9: vrnMike ($100 in chips) 
xdrKush420x: posts small blind $0.50
vrnMike: posts big blind $1
*** HOLE CARDS ***
Dealt to matiko09 [5d 7d]
MrMattkk: calls $1
Spid1: folds 
ipashutapkom: raises $1.26 to $2.26
matiko09: folds 
Painkiller72: folds 
Chin41178: folds 
xdrKush420x: folds 
vrnMike: folds 
MrMattkk: calls $1.26
*** FLOP *** [Qh 2d Jh]
MrMattkk: checks 
ipashutapkom: bets $1.83
MrMattkk: folds 
Uncalled bet ($1.83) returned to ipashutapkom
ipashutapkom collected $5.72 from pot
ipashutapkom: doesn't show hand 
*** SUMMARY ***
Total pot $6.02 | Rake $0.30 
Board [Qh 2d Jh]
Seat 1: MrMattkk folded on the Flop
Seat 2: Spid1 folded before Flop (didn't bet)
Seat 3: ipashutapkom collected ($5.72)
Seat 4: matiko09 folded before Flop (didn't bet)
Seat 5: Painkiller72 folded before Flop (didn't bet)
Seat 7: Chin41178 (button) folded before Flop (didn't bet)
Seat 8: xdrKush420x (small blind) folded before Flop
Seat 9: vrnMike (big blind) folded before Flop





PokerStars Hand #152884351070:  Hold'em No Limit ($1/$2 USD) - 2016/05/05 15:46:46 CET [2016/05/05 9:46:46 ET]
Table 'Lundia' 9-max Seat #2 is the button
Seat 1: Fitzyferret ($200 in chips) 
Seat 2: patpaty ($193.10 in chips) 
Seat 4: KovIFish89 ($220.88 in chips) 
Seat 5: zmOe84 ($200 in chips) 
Seat 6: Spid1 ($248.19 in chips) 
Seat 7: matiko09 ($212.86 in chips) 
Seat 8: Durnichka ($79 in chips) 
Seat 9: gabi_igna ($278.36 in chips) 
Painkiller72 will be allowed to play after the button
KovIFish89: posts small blind $1
zmOe84: posts big blind $2
*** HOLE CARDS ***
Dealt to matiko09 [As Td]
Spid1: folds 
matiko09: folds 
Durnichka: folds 
gabi_igna: folds 
Fitzyferret: folds 
patpaty: folds 
KovIFish89: folds 
Uncalled bet ($1) returned to zmOe84
zmOe84 collected $2 from pot
zmOe84: doesn't show hand 
*** SUMMARY ***
Total pot $2 | Rake $0 
Seat 1: Fitzyferret folded before Flop (didn't bet)
Seat 2: patpaty (button) folded before Flop (didn't bet)
Seat 4: KovIFish89 (small blind) folded before Flop
Seat 5: zmOe84 (big blind) collected ($2)
Seat 6: Spid1 folded before Flop (didn't bet)
Seat 7: matiko09 folded before Flop (didn't bet)
Seat 8: Durnichka folded before Flop (didn't bet)
Seat 9: gabi_igna folded before Flop (didn't bet)





PokerStars Hand #152884356704:  Hold'em No Limit ($0.50/$1.00 USD) - 2016/05/05 15:46:56 CET [2016/05/05 9:46:56 ET]
Table 'Calypso II' 9-max Seat #9 is the button
Seat 1: nickreason17 ($100 in chips) 
Seat 2: torkkdnm ($100 in chips) 
Seat 3: gabi_igna ($110.59 in chips) 
Seat 4: sanpidk ($100 in chips) 
Seat 5: LighTingSSSS ($88.01 in chips) 
Seat 6: WTAPSVG ($128.15 in chips) 
Seat 7: ipashutapkom ($89.33 in chips) 
Seat 8: matiko09 ($107.80 in chips) 
Seat 9: chrisauy ($82.56 in chips) 
nickreason17: posts small blind $0.50
torkkdnm: posts big blind $1
*** HOLE CARDS ***
Dealt to matiko09 [4c Jh]
gabi_igna: folds 
sanpidk: folds 
LighTingSSSS: folds 
WTAPSVG: folds 
ipashutapkom: folds 
matiko09: folds 
chrisauy: raises $2 to $3
nickreason17: folds 
torkkdnm: calls $2
*** FLOP *** [Kd 5s Ad]
torkkdnm: checks 
chrisauy: bets $4
torkkdnm: raises $12 to $16
chrisauy: raises $24 to $40
torkkdnm: raises $57 to $97 and is all-in
chrisauy: folds 
Uncalled bet ($57) returned to torkkdnm
torkkdnm collected $84 from pot
*** SUMMARY ***
Total pot $86.50 | Rake $2.50 
Board [Kd 5s Ad]
Seat 1: nickreason17 (small blind) folded before Flop
Seat 2: torkkdnm (big blind) collected ($84)
Seat 3: gabi_igna folded before Flop (didn't bet)
Seat 4: sanpidk folded before Flop (didn't bet)
Seat 5: LighTingSSSS folded before Flop (didn't bet)
Seat 6: WTAPSVG folded before Flop (didn't bet)
Seat 7: ipashutapkom folded before Flop (didn't bet)
Seat 8: matiko09 folded before Flop (didn't bet)
Seat 9: chrisauy (button) folded on the Flop





PokerStars Hand #152884360186:  Hold'em No Limit ($0.50/$1.00 USD) - 2016/05/05 15:47:02 CET [2016/05/05 9:47:02 ET]
Table 'Musa II' 9-max Seat #1 is the button
Seat 1: KovIFish89 ($206.47 in chips) 
Seat 3: vrnMike ($100 in chips) 
Seat 4: sanpidk ($100 in chips) 
Seat 6: cnn123 ($58.62 in chips) 
Seat 7: Painkiller72 ($100 in chips) 
Seat 8: matiko09 ($100 in chips) 
Seat 9: antfurto ($98.50 in chips) 
St.LaCoste will be allowed to play after the button
vrnMike: posts small blind $0.50
sanpidk: posts big blind $1
Chin41178: sits out 
*** HOLE CARDS ***
Dealt to matiko09 [8c Jd]
cnn123: raises $2 to $3
Painkiller72: folds 
matiko09: folds 
antfurto: folds 
KovIFish89: folds 
vrnMike: folds 
sanpidk: folds 
Uncalled bet ($2) returned to cnn123
cnn123 collected $2.50 from pot
cnn123: doesn't show hand 
St.LaCoste leaves the table
*** SUMMARY ***
Total pot $2.50 | Rake $0 
Seat 1: KovIFish89 (button) folded before Flop (didn't bet)
Seat 3: vrnMike (small blind) folded before Flop
Seat 4: sanpidk (big blind) folded before Flop
Seat 6: cnn123 collected ($2.50)
Seat 7: Painkiller72 folded before Flop (didn't bet)
Seat 8: matiko09 folded before Flop (didn't bet)
Seat 9: antfurto folded before Flop (didn't bet)





PokerStars Hand #152884365194:  Hold'em No Limit ($0.50/$1.00 USD) - 2016/05/05 15:47:04 CET [2016/05/05 9:47:04 ET]
Table 'Lictoria II' 9-max Seat #8 is the button
Seat 1: St.LaCoste ($100 in chips) 
Seat 2: Dantist1122 ($121.46 in chips) 
Seat 3: Krinica2009 ($108.92 in chips) 
Seat 4: Ying59 ($87.46 in chips) 
Seat 5: sanpidk ($135.50 in chips) 
Seat 6: gabi_igna ($111.09 in chips) 
Seat 7: Painkiller72 ($175.42 in chips) 
Seat 8: matiko09 ($104 in chips) 
Seat 9: Kukuryzka ($143.81 in chips) 
Kukuryzka: posts small blind $0.50
St.LaCoste: posts big blind $1
*** HOLE CARDS ***
Dealt to matiko09 [Jd Tc]
Dantist1122: raises $2 to $3
Krinica2009: folds 
Ying59: folds 
sanpidk: folds 
gabi_igna: folds 
Painkiller72: folds 
matiko09: folds 
Kukuryzka: folds 
St.LaCoste: folds 
Uncalled bet ($2) returned to Dantist1122
Dantist1122 collected $2.50 from pot
Dantist1122: doesn't show hand 
*** SUMMARY ***
Total pot $2.50 | Rake $0 
Seat 1: St.LaCoste (big blind) folded before Flop
Seat 2: Dantist1122 collected ($2.50)
Seat 3: Krinica2009 folded before Flop (didn't bet)
Seat 4: Ying59 folded before Flop (didn't bet)
Seat 5: sanpidk folded before Flop (didn't bet)
Seat 6: gabi_igna folded before Flop (didn't bet)
Seat 7: Painkiller72 folded before Flop (didn't bet)
Seat 8: matiko09 (button) folded before Flop (didn't bet)
Seat 9: Kukuryzka (small blind) folded before Flop





PokerStars Hand #152884365415:  Hold'em No Limit (€0.50/€1.00 EUR) - 2016/05/05 15:47:05 CET [2016/05/05 9:47:05 ET]
Table 'Carol II' 9-max Seat #1 is the button
Seat 1: vrnMike (€114.85 in chips) 
Seat 2: matiko09 (€100 in chips) 
Seat 4: Merlin_1905 (€40 in chips) 
Seat 5: Painkiller72 (€102.28 in chips) 
Seat 6: drissmouzou (€87.15 in chips) 
Seat 7: Spid1 (€101 in chips) 
Seat 9: Racushniak (€100 in chips) 
matiko09: posts small blind €0.50
Merlin_1905: posts big blind €1
*** HOLE CARDS ***
Dealt to matiko09 [2s Qh]
Painkiller72: folds 
drissmouzou: raises €1 to €2
Spid1: folds 
Racushniak: calls €2
vrnMike: folds 
matiko09: folds 
Merlin_1905: calls €1
*** FLOP *** [8s 6c Kc]
drissmouzou said, ":D:'("
Merlin_1905: checks 
drissmouzou: bets €2
Racushniak: raises €4 to €6
Merlin_1905: folds 
drissmouzou: calls €4
*** TURN *** [8s 6c Kc] [9d]
drissmouzou: checks 
Racushniak: bets €9.66
drissmouzou: calls €9.66
*** RIVER *** [8s 6c Kc 9d] [7h]
drissmouzou: bets €17.96
Racushniak: calls €17.96
*** SHOW DOWN ***
drissmouzou: shows [7d Kd] (two pair, Kings and Sevens)
Racushniak: shows [4c 5c] (a straight, Five to Nine)
Racushniak collected €71.49 from pot
*** SUMMARY ***
Total pot €73.74 | Rake €2.25 
Board [8s 6c Kc 9d 7h]
Seat 1: vrnMike (button) folded before Flop (didn't bet)
Seat 2: matiko09 (small blind) folded before Flop
Seat 4: Merlin_1905 (big blind) folded on the Flop
Seat 5: Painkiller72 folded before Flop (didn't bet)
Seat 6: drissmouzou showed [7d Kd] and lost with two pair, Kings and Sevens
Seat 7: Spid1 folded before Flop (didn't bet)
Seat 9: Racushniak showed [4c 5c] and won (€71.49) with a straight, Five to Nine





PokerStars Hand #152884369722:  Hold'em No Limit ($0.50/$1.00 USD) - 2016/05/05 15:47:13 CET [2016/05/05 9:47:13 ET]
Table 'Priska II' 9-max Seat #5 is the button
Seat 1: Spid1 ($111.40 in chips) 
Seat 2: Kukuryzka ($123 in chips) 
Seat 3: matiko09 ($101.50 in chips) 
Seat 4: Painkiller72 ($164.16 in chips) 
Seat 5: nickreason17 ($174.05 in chips) 
Seat 6: OneTwo81 ($97.61 in chips) 
Seat 7: stockbridge8 ($90.77 in chips) 
Seat 8: pohorc21 ($55.65 in chips) 
Seat 9: torkkdnm ($111.50 in chips) 
OneTwo81: posts small blind $0.50
stockbridge8: posts big blind $1
*** HOLE CARDS ***
Dealt to matiko09 [9d Jc]
pohorc21: folds 
torkkdnm: folds 
Spid1: folds 
Kukuryzka: folds 
matiko09: folds 
Painkiller72: folds 
nickreason17: raises $1 to $2
OneTwo81: folds 
stockbridge8: folds 
Uncalled bet ($1) returned to nickreason17
nickreason17 collected $2.50 from pot
*** SUMMARY ***
Total pot $2.50 | Rake $0 
Seat 1: Spid1 folded before Flop (didn't bet)
Seat 2: Kukuryzka folded before Flop (didn't bet)
Seat 3: matiko09 folded before Flop (didn't bet)
Seat 4: Painkiller72 folded before Flop (didn't bet)
Seat 5: nickreason17 (button) collected ($2.50)
Seat 6: OneTwo81 (small blind) folded before Flop
Seat 7: stockbridge8 (big blind) folded before Flop
Seat 8: pohorc21 folded before Flop (didn't bet)
Seat 9: torkkdnm folded before Flop (didn't bet)





PokerStars Hand #152884377211:  Hold'em No Limit ($1/$2 USD) - 2016/05/05 15:47:19 CET [2016/05/05 9:47:19 ET]
Table 'Euporie II' 9-max Seat #5 is the button
Seat 5: Nuskatko1986 ($116.76 in chips) 
Seat 6: glanza_mike ($200 in chips) 
Seat 7: matiko09 ($200 in chips) 
Seat 8: Painkiller72 ($200 in chips) 
glanza_mike: posts small blind $1
matiko09: posts big blind $2
Durnichka: sits out 
*** HOLE CARDS ***
Dealt to matiko09 [Kd 7s]
Painkiller72: raises $3 to $5
Nuskatko1986: folds 
glanza_mike: folds 
matiko09: folds 
Uncalled bet ($3) returned to Painkiller72
Painkiller72 collected $5 from pot
Painkiller72: doesn't show hand 
*** SUMMARY ***
Total pot $5 | Rake $0 
Seat 5: Nuskatko1986 (button) folded before Flop (didn't bet)
Seat 6: glanza_mike (small blind) folded before Flop
Seat 7: matiko09 (big blind) folded before Flop
Seat 8: Painkiller72 collected ($5)





PokerStars Hand #152884381108:  Hold'em No Limit ($1/$2 USD) - 2016/05/05 15:47:26 CET [2016/05/05 9:47:26 ET]
Table 'Lundia' 9-max Seat #4 is the button
Seat 1: Fitzyferret ($200 in chips) 
Seat 2: patpaty ($193.10 in chips) 
Seat 4: KovIFish89 ($219.88 in chips) 
Seat 5: zmOe84 ($201 in chips) 
Seat 6: Spid1 ($248.19 in chips) 
Seat 7: matiko09 ($212.86 in chips) 
Seat 8: Durnichka ($79 in chips) 
Seat 9: gabi_igna ($278.36 in chips) 
zmOe84: posts small blind $1
Spid1: posts big blind $2
Painkiller72: sits out 
*** HOLE CARDS ***
Dealt to matiko09 [Kc 8d]
matiko09: folds 
Durnichka: folds 
gabi_igna: folds 
Fitzyferret: folds 
patpaty: folds 
KovIFish89: folds 
zmOe84: calls $1
Spid1: raises $6 to $8
zmOe84: calls $6
*** FLOP *** [4c Qh Kd]
zmOe84: checks 
Spid1: bets $8
zmOe84: folds 
Uncalled bet ($8) returned to Spid1
Spid1 collected $15.20 from pot
Spid1: doesn't show hand 
*** SUMMARY ***
Total pot $16 | Rake $0.80 
Board [4c Qh Kd]
Seat 1: Fitzyferret folded before Flop (didn't bet)
Seat 2: patpaty folded before Flop (didn't bet)
Seat 4: KovIFish89 (button) folded before Flop (didn't bet)
Seat 5: zmOe84 (small blind) folded on the Flop
Seat 6: Spid1 (big blind) collected ($15.20)
Seat 7: matiko09 folded before Flop (didn't bet)
Seat 8: Durnichka folded before Flop (didn't bet)
Seat 9: gabi_igna folded before Flop (didn't bet)





PokerStars Hand #152884387949:  Hold'em No Limit ($0.50/$1.00 USD) - 2016/05/05 15:47:31 CET [2016/05/05 9:47:31 ET]
Table 'Pyxis III' 9-max Seat #3 is the button
Seat 1: sanpidk ($180.03 in chips) 
Seat 2: 50CandyJoe ($100 in chips) 
Seat 3: vrnMike ($100 in chips) 
Seat 5: darren1031 ($89.85 in chips) 
Seat 6: kamillo91 ($88.50 in chips) 
Seat 8: matiko09 ($107.25 in chips) 
Seat 9: Hypoaroused ($187.05 in chips) 
Sloeve will be allowed to play after the button
darren1031: posts small blind $0.50
kamillo91: posts big blind $1
mycka86: sits out 
*** HOLE CARDS ***
Dealt to matiko09 [3h 5d]
matiko09: folds 
Hypoaroused: folds 
sanpidk: raises $2 to $3
50CandyJoe: folds 
vrnMike: folds 
darren1031: calls $2.50
kamillo91: folds 
*** FLOP *** [7h 9h Td]
darren1031: checks 
sanpidk: checks 
*** TURN *** [7h 9h Td] [As]
darren1031: bets $4
sanpidk: calls $4
*** RIVER *** [7h 9h Td As] [Jh]
darren1031: checks 
sanpidk: checks 
*** SHOW DOWN ***
darren1031: shows [9c Ad] (two pair, Aces and Nines)
sanpidk: mucks hand 
darren1031 collected $14.25 from pot
*** SUMMARY ***
Total pot $15 | Rake $0.75 
Board [7h 9h Td As Jh]
Seat 1: sanpidk mucked [Ac Qs]
Seat 2: 50CandyJoe folded before Flop (didn't bet)
Seat 3: vrnMike (button) folded before Flop (didn't bet)
Seat 5: darren1031 (small blind) showed [9c Ad] and won ($14.25) with two pair, Aces and Nines
Seat 6: kamillo91 (big blind) folded before Flop
Seat 8: matiko09 folded before Flop (didn't bet)
Seat 9: Hypoaroused folded before Flop (didn't bet)





PokerStars Hand #152884390222:  Hold'em No Limit ($1/$2 USD) - 2016/05/05 15:47:35 CET [2016/05/05 9:47:35 ET]
Table 'Euporie II' 9-max Seat #6 is the button
Seat 5: Nuskatko1986 ($116.76 in chips) 
Seat 6: glanza_mike ($200 in chips) 
Seat 7: matiko09 ($200 in chips) 
Seat 8: Painkiller72 ($203 in chips) 
matiko09: posts small blind $1
Painkiller72: posts big blind $2
Durnichka: sits out 
*** HOLE CARDS ***
Dealt to matiko09 [Ks Jh]
A91baer joins the table at seat #4 
nickreason17 joins the table at seat #2 
Nuskatko1986: folds 
glanza_mike: raises $4 to $6
Spid1 joins the table at seat #3 
matiko09: folds 
Painkiller72: folds 
Uncalled bet ($4) returned to glanza_mike
glanza_mike collected $5 from pot
glanza_mike: doesn't show hand 
*** SUMMARY ***
Total pot $5 | Rake $0 
Seat 5: Nuskatko1986 folded before Flop (didn't bet)
Seat 6: glanza_mike (button) collected ($5)
Seat 7: matiko09 (small blind) folded before Flop
Seat 8: Painkiller72 (big blind) folded before Flop





PokerStars Hand #152884391464:  Hold'em No Limit ($0.50/$1.00 USD) - 2016/05/05 15:47:37 CET [2016/05/05 9:47:37 ET]
Table 'Luthera' 9-max Seat #8 is the button
Seat 1: MrMattkk ($75.42 in chips) 
Seat 2: Spid1 ($100 in chips) 
Seat 3: ipashutapkom ($101.96 in chips) 
Seat 4: matiko09 ($103.75 in chips) 
Seat 5: Painkiller72 ($100 in chips) 
Seat 7: Chin41178 ($98.50 in chips) 
Seat 8: xdrKush420x ($96.50 in chips) 
Seat 9: vrnMike ($100 in chips) 
vrnMike: posts small blind $0.50
MrMattkk: posts big blind $1
*** HOLE CARDS ***
Dealt to matiko09 [4d Kd]
Spid1: folds 
ipashutapkom: folds 
matiko09: folds 
Painkiller72: folds 
Chin41178: folds 
xdrKush420x: folds 
vrnMike: raises $2 to $3
MrMattkk: folds 
Uncalled bet ($2) returned to vrnMike
vrnMike collected $2 from pot
*** SUMMARY ***
Total pot $2 | Rake $0 
Seat 1: MrMattkk (big blind) folded before Flop
Seat 2: Spid1 folded before Flop (didn't bet)
Seat 3: ipashutapkom folded before Flop (didn't bet)
Seat 4: matiko09 folded before Flop (didn't bet)
Seat 5: Painkiller72 folded before Flop (didn't bet)
Seat 7: Chin41178 folded before Flop (didn't bet)
Seat 8: xdrKush420x (button) folded before Flop (didn't bet)
Seat 9: vrnMike (small blind) collected ($2)





PokerStars Hand #152884393154:  Hold'em No Limit ($0.50/$1.00 USD) - 2016/05/05 15:47:38 CET [2016/05/05 9:47:38 ET]
Table 'Lictoria II' 9-max Seat #9 is the button
Seat 1: St.LaCoste ($100 in chips) 
Seat 3: Krinica2009 ($108.92 in chips) 
Seat 4: Ying59 ($87.46 in chips) 
Seat 5: sanpidk ($135.50 in chips) 
Seat 6: gabi_igna ($111.09 in chips) 
Seat 7: Painkiller72 ($175.42 in chips) 
Seat 8: matiko09 ($104 in chips) 
Seat 9: Kukuryzka ($143.31 in chips) 
St.LaCoste: posts small blind $0.50
Dantist1122: is sitting out 
Krinica2009: posts big blind $1
*** HOLE CARDS ***
Dealt to matiko09 [Ac Th]
Ying59: folds 
sanpidk: folds 
gabi_igna: raises $2 to $3
Painkiller72: folds 
matiko09: folds 
Kukuryzka: folds 
St.LaCoste: folds 
Krinica2009: calls $2
*** FLOP *** [7d Kd Ad]
Krinica2009: checks 
gabi_igna: checks 
*** TURN *** [7d Kd Ad] [2d]
Krinica2009: checks 
gabi_igna: checks 
*** RIVER *** [7d Kd Ad 2d] [Jh]
Krinica2009: bets $6.18
gabi_igna: calls $6.18
*** SHOW DOWN ***
Krinica2009: shows [7c 4s] (a pair of Sevens)
gabi_igna: shows [Js Ah] (two pair, Aces and Jacks)
gabi_igna collected $17.92 from pot
*** SUMMARY ***
Total pot $18.86 | Rake $0.94 
Board [7d Kd Ad 2d Jh]
Seat 1: St.LaCoste (small blind) folded before Flop
Seat 3: Krinica2009 (big blind) showed [7c 4s] and lost with a pair of Sevens
Seat 4: Ying59 folded before Flop (didn't bet)
Seat 5: sanpidk folded before Flop (didn't bet)
Seat 6: gabi_igna showed [Js Ah] and won ($17.92) with two pair, Aces and Jacks
Seat 7: Painkiller72 folded before Flop (didn't bet)
Seat 8: matiko09 folded before Flop (didn't bet)
Seat 9: Kukuryzka (button) folded before Flop (didn't bet)





PokerStars Hand #152884393824:  Hold'em No Limit ($0.50/$1.00 USD) - 2016/05/05 15:47:39 CET [2016/05/05 9:47:39 ET]
Table 'Musa II' 9-max Seat #3 is the button
Seat 1: KovIFish89 ($206.47 in chips) 
Seat 3: vrnMike ($100 in chips) 
Seat 4: sanpidk ($100 in chips) 
Seat 5: Chin41178 ($100 in chips) 
Seat 6: cnn123 ($60.12 in chips) 
Seat 7: Painkiller72 ($100 in chips) 
Seat 8: matiko09 ($100 in chips) 
Seat 9: antfurto ($98.50 in chips) 
sanpidk: posts small blind $0.50
Chin41178: posts big blind $1
*** HOLE CARDS ***
Dealt to matiko09 [Ah 4d]
cnn123: folds 
Painkiller72: folds 
matiko09: folds 
antfurto: folds 
KovIFish89: raises $1.50 to $2.50
vrnMike: folds 
sanpidk: folds 
Chin41178: folds 
Uncalled bet ($1.50) returned to KovIFish89
KovIFish89 collected $2.50 from pot
KovIFish89: doesn't show hand 
*** SUMMARY ***
Total pot $2.50 | Rake $0 
Seat 1: KovIFish89 collected ($2.50)
Seat 3: vrnMike (button) folded before Flop (didn't bet)
Seat 4: sanpidk (small blind) folded before Flop
Seat 5: Chin41178 (big blind) folded before Flop
Seat 6: cnn123 folded before Flop (didn't bet)
Seat 7: Painkiller72 folded before Flop (didn't bet)
Seat 8: matiko09 folded before Flop (didn't bet)
Seat 9: antfurto folded before Flop (didn't bet)





PokerStars Hand #152884395454:  Hold'em No Limit ($0.50/$1.00 USD) - 2016/05/05 15:47:40 CET [2016/05/05 9:47:40 ET]
Table 'Priska II' 9-max Seat #6 is the button
Seat 1: Spid1 ($111.40 in chips) 
Seat 2: Kukuryzka ($123 in chips) 
Seat 3: matiko09 ($101.50 in chips) 
Seat 4: Painkiller72 ($164.16 in chips) 
Seat 5: nickreason17 ($175.55 in chips) 
Seat 6: OneTwo81 ($97.11 in chips) 
Seat 7: stockbridge8 ($89.77 in chips) 
Seat 8: pohorc21 ($55.65 in chips) 
Seat 9: torkkdnm ($111.50 in chips) 
stockbridge8: posts small blind $0.50
pohorc21: posts big blind $1
*** HOLE CARDS ***
Dealt to matiko09 [Jc Kd]
torkkdnm: folds 
Spid1: raises $2 to $3
Kukuryzka: calls $3
matiko09: folds 
Painkiller72: folds 
nickreason17: folds 
OneTwo81: folds 
stockbridge8: folds 
pohorc21: calls $2
*** FLOP *** [3d Th 9h]
pohorc21: checks 
Spid1: checks 
Kukuryzka: bets $6.76
pohorc21: folds 
Spid1: folds 
Uncalled bet ($6.76) returned to Kukuryzka
Kukuryzka collected $9.02 from pot
Kukuryzka: doesn't show hand 
*** SUMMARY ***
Total pot $9.50 | Rake $0.48 
Board [3d Th 9h]
Seat 1: Spid1 folded on the Flop
Seat 2: Kukuryzka collected ($9.02)
Seat 3: matiko09 folded before Flop (didn't bet)
Seat 4: Painkiller72 folded before Flop (didn't bet)
Seat 5: nickreason17 folded before Flop (didn't bet)
Seat 6: OneTwo81 (button) folded before Flop (didn't bet)
Seat 7: stockbridge8 (small blind) folded before Flop
Seat 8: pohorc21 (big blind) folded on the Flop
Seat 9: torkkdnm folded before Flop (didn't bet)





PokerStars Hand #152884402824:  Hold'em No Limit ($0.50/$1.00 USD) - 2016/05/05 15:47:52 CET [2016/05/05 9:47:52 ET]
Table 'Natascha' 9-max Seat #2 is the button
Seat 1: ronald3737 ($108.43 in chips) 
Seat 2: matiko09 ($141.53 in chips) 
Seat 3: bjonlyking ($145.20 in chips) 
Seat 4: sanpidk ($112.39 in chips) 
Seat 5: Dickyxxx ($130.26 in chips) 
Seat 6: gabi_igna ($149.62 in chips) 
Seat 7: torkkdnm ($150.75 in chips) 
Seat 8: kamillo91 ($47.51 in chips) 
Seat 9: guoweiAA ($226.20 in chips) 
bjonlyking: posts small blind $0.50
sanpidk: posts big blind $1
*** HOLE CARDS ***
Dealt to matiko09 [Ks 9s]
Dickyxxx: folds 
gabi_igna: folds 
torkkdnm: folds 
kamillo91: folds 
guoweiAA: folds 
ronald3737: folds 
matiko09: raises $1.27 to $2.27
bjonlyking: calls $1.77
sanpidk: raises $8.23 to $10.50
matiko09: calls $8.23
bjonlyking: calls $8.23
*** FLOP *** [5s Td Qd]
bjonlyking: checks 
sanpidk: bets $15
matiko09: folds 
bjonlyking: folds 
Uncalled bet ($15) returned to sanpidk
sanpidk collected $29.92 from pot
sanpidk: doesn't show hand 
*** SUMMARY ***
Total pot $31.50 | Rake $1.58 
Board [5s Td Qd]
Seat 1: ronald3737 folded before Flop (didn't bet)
Seat 2: matiko09 (button) folded on the Flop
Seat 3: bjonlyking (small blind) folded on the Flop
Seat 4: sanpidk (big blind) collected ($29.92)
Seat 5: Dickyxxx folded before Flop (didn't bet)
Seat 6: gabi_igna folded before Flop (didn't bet)
Seat 7: torkkdnm folded before Flop (didn't bet)
Seat 8: kamillo91 folded before Flop (didn't bet)
Seat 9: guoweiAA folded before Flop (didn't bet)





PokerStars Hand #152884412667:  Hold'em No Limit ($1/$2 USD) - 2016/05/05 15:48:08 CET [2016/05/05 9:48:08 ET]
Table 'Tololo' 9-max Seat #2 is the button
Seat 1: Kukuryzka ($200 in chips) 
Seat 2: gabi_igna ($232.39 in chips) 
Seat 3: nickreason17 ($214.75 in chips) 
Seat 4: mooose100 ($168.59 in chips) 
Seat 5: matiko09 ($211 in chips) 
Seat 6: Xagua ($125.83 in chips) 
Seat 9: Fitzyferret ($287.99 in chips) 
nickreason17: posts small blind $1
mooose100: posts big blind $2
Iggso: sits out 
KovIFish89: sits out 
*** HOLE CARDS ***
Dealt to matiko09 [Kh Ts]
matiko09: folds 
Xagua: folds 
Fitzyferret: folds 
Kukuryzka: raises $3 to $5
gabi_igna: raises $13 to $18
nickreason17: folds 
mooose100: folds 
Kukuryzka: folds 
Uncalled bet ($13) returned to gabi_igna
gabi_igna collected $13 from pot
gabi_igna: doesn't show hand 
*** SUMMARY ***
Total pot $13 | Rake $0 
Seat 1: Kukuryzka folded before Flop
Seat 2: gabi_igna (button) collected ($13)
Seat 3: nickreason17 (small blind) folded before Flop
Seat 4: mooose100 (big blind) folded before Flop
Seat 5: matiko09 folded before Flop (didn't bet)
Seat 6: Xagua folded before Flop (didn't bet)
Seat 9: Fitzyferret folded before Flop (didn't bet)





PokerStars Hand #152884413617:  Hold'em No Limit (€0.50/€1.00 EUR) - 2016/05/05 15:48:09 CET [2016/05/05 9:48:09 ET]
Table 'Carol II' 9-max Seat #2 is the button
Seat 1: vrnMike (€114.85 in chips) 
Seat 2: matiko09 (€100 in chips) 
Seat 4: Merlin_1905 (€38 in chips) 
Seat 5: Painkiller72 (€102.28 in chips) 
Seat 6: drissmouzou (€51.53 in chips) 
Seat 7: Spid1 (€101 in chips) 
Seat 9: Racushniak (€135.87 in chips) 
Merlin_1905: posts small blind €0.50
Painkiller72: posts big blind €1
*** HOLE CARDS ***
Dealt to matiko09 [9h Ks]
Racushniak said, "8)"
drissmouzou: folds 
Spid1: folds 
Racushniak: folds 
vrnMike: folds 
Racushniak said, "(^^^)"
drissmouzou said, "8)"
matiko09: raises €1.27 to €2.27
Merlin_1905: folds 
Painkiller72: folds 
Uncalled bet (€1.27) returned to matiko09
matiko09 collected €2.50 from pot
matiko09: doesn't show hand 
*** SUMMARY ***
Total pot €2.50 | Rake €0 
Seat 1: vrnMike folded before Flop (didn't bet)
Seat 2: matiko09 (button) collected (€2.50)
Seat 4: Merlin_1905 (small blind) folded before Flop
Seat 5: Painkiller72 (big blind) folded before Flop
Seat 6: drissmouzou folded before Flop (didn't bet)
Seat 7: Spid1 folded before Flop (didn't bet)
Seat 9: Racushniak folded before Flop (didn't bet)





PokerStars Hand #152884413523:  Hold'em No Limit ($1/$2 USD) - 2016/05/05 15:48:09 CET [2016/05/05 9:48:09 ET]
Table 'Euporie II' 9-max Seat #7 is the button
Seat 1: Durnichka ($81.95 in chips) 
Seat 4: A91baer ($200 in chips) 
Seat 5: Nuskatko1986 ($116.76 in chips) 
Seat 6: glanza_mike ($203 in chips) 
Seat 7: matiko09 ($200 in chips) 
Seat 8: Painkiller72 ($201 in chips) 
Painkiller72: posts small blind $1
Durnichka: posts big blind $2
nickreason17: sits out 
Spid1: sits out 
A91baer: posts big blind $2
*** HOLE CARDS ***
Dealt to matiko09 [6d 3c]
A91baer: checks 
Nuskatko1986: calls $2
glanza_mike: raises $8 to $10
matiko09: folds 
Painkiller72: folds 
Durnichka: folds 
A91baer: calls $8
Nuskatko1986: calls $8
*** FLOP *** [Td Jd Ad]
A91baer: checks 
Nuskatko1986: bets $10
glanza_mike: calls $10
A91baer: calls $10
*** TURN *** [Td Jd Ad] [Ts]
A91baer: checks 
Fitzyferret leaves the table
T0ny Adams joins the table at seat #9 
Nuskatko1986: bets $18
glanza_mike: calls $18
A91baer: folds 
*** RIVER *** [Td Jd Ad Ts] [9d]
Nuskatko1986: bets $78.76 and is all-in
glanza_mike: folds 
Uncalled bet ($78.76) returned to Nuskatko1986
Nuskatko1986 collected $96.25 from pot
Nuskatko1986: doesn't show hand 
*** SUMMARY ***
Total pot $99 | Rake $2.75 
Board [Td Jd Ad Ts 9d]
Seat 1: Durnichka (big blind) folded before Flop
Seat 4: A91baer folded on the Turn
Seat 5: Nuskatko1986 collected ($96.25)
Seat 6: glanza_mike folded on the River
Seat 7: matiko09 (button) folded before Flop (didn't bet)
Seat 8: Painkiller72 (small blind) folded before Flop





PokerStars Hand #152884414969:  Hold'em No Limit ($0.50/$1.00 USD) - 2016/05/05 15:48:11 CET [2016/05/05 9:48:11 ET]
Table 'Musa II' 9-max Seat #4 is the button
Seat 1: KovIFish89 ($207.97 in chips) 
Seat 3: vrnMike ($100 in chips) 
Seat 4: sanpidk ($100 in chips) 
Seat 5: Chin41178 ($99 in chips) 
Seat 6: cnn123 ($60.12 in chips) 
Seat 7: Painkiller72 ($100 in chips) 
Seat 8: matiko09 ($100 in chips) 
Seat 9: antfurto ($98.50 in chips) 
Chin41178: posts small blind $0.50
cnn123: posts big blind $1
*** HOLE CARDS ***
Dealt to matiko09 [8s 3d]
Painkiller72: folds 
matiko09: folds 
antfurto: raises $2 to $3
KovIFish89: folds 
vrnMike: folds 
sanpidk: folds 
Chin41178: folds 
cnn123: calls $2
*** FLOP *** [7h 4d Kc]
cnn123: checks 
antfurto: bets $4
cnn123: folds 
Uncalled bet ($4) returned to antfurto
antfurto collected $6.18 from pot
antfurto: doesn't show hand 
*** SUMMARY ***
Total pot $6.50 | Rake $0.32 
Board [7h 4d Kc]
Seat 1: KovIFish89 folded before Flop (didn't bet)
Seat 3: vrnMike folded before Flop (didn't bet)
Seat 4: sanpidk (button) folded before Flop (didn't bet)
Seat 5: Chin41178 (small blind) folded before Flop
Seat 6: cnn123 (big blind) folded on the Flop
Seat 7: Painkiller72 folded before Flop (didn't bet)
Seat 8: matiko09 folded before Flop (didn't bet)
Seat 9: antfurto collected ($6.18)





PokerStars Hand #152884418428:  Hold'em No Limit ($0.50/$1.00 USD) - 2016/05/05 15:48:18 CET [2016/05/05 9:48:18 ET]
Table 'Luthera' 9-max Seat #9 is the button
Seat 1: MrMattkk ($74.42 in chips) 
Seat 2: Spid1 ($100 in chips) 
Seat 3: ipashutapkom ($101.96 in chips) 
Seat 4: matiko09 ($103.75 in chips) 
Seat 5: Painkiller72 ($100 in chips) 
Seat 7: Chin41178 ($98.50 in chips) 
Seat 8: xdrKush420x ($96.50 in chips) 
Seat 9: vrnMike ($101 in chips) 
MrMattkk: posts small blind $0.50
Spid1: posts big blind $1
*** HOLE CARDS ***
Dealt to matiko09 [9s 6s]
ipashutapkom: folds 
matiko09: folds 
Painkiller72: folds 
Chin41178: folds 
xdrKush420x: folds 
vrnMike: folds 
MrMattkk: calls $0.50
Spid1: raises $7 to $8
MrMattkk: folds 
Uncalled bet ($7) returned to Spid1
Spid1 collected $2 from pot
Spid1: doesn't show hand 
*** SUMMARY ***
Total pot $2 | Rake $0 
Seat 1: MrMattkk (small blind) folded before Flop
Seat 2: Spid1 (big blind) collected ($2)
Seat 3: ipashutapkom folded before Flop (didn't bet)
Seat 4: matiko09 folded before Flop (didn't bet)
Seat 5: Painkiller72 folded before Flop (didn't bet)
Seat 7: Chin41178 folded before Flop (didn't bet)
Seat 8: xdrKush420x folded before Flop (didn't bet)
Seat 9: vrnMike (button) folded before Flop (didn't bet)





PokerStars Hand #152884419066:  Hold'em No Limit ($1/$2 USD) - 2016/05/05 15:48:19 CET [2016/05/05 9:48:19 ET]
Table 'Lundia' 9-max Seat #5 is the button
Seat 1: Fitzyferret ($200 in chips) 
Seat 2: patpaty ($193.10 in chips) 
Seat 4: KovIFish89 ($219.88 in chips) 
Seat 5: zmOe84 ($193 in chips) 
Seat 6: Spid1 ($255.39 in chips) 
Seat 7: matiko09 ($212.86 in chips) 
Seat 8: Durnichka ($79 in chips) 
Seat 9: gabi_igna ($278.36 in chips) 
Spid1: posts small blind $1
matiko09: posts big blind $2
Painkiller72: sits out 
*** HOLE CARDS ***
Dealt to matiko09 [4c 8s]
Durnichka: folds 
gabi_igna: folds 
Fitzyferret: folds 
patpaty: folds 
KovIFish89: folds 
zmOe84: folds 
Spid1: raises $3 to $5
matiko09: folds 
Uncalled bet ($3) returned to Spid1
Spid1 collected $4 from pot
Spid1: doesn't show hand 
*** SUMMARY ***
Total pot $4 | Rake $0 
Seat 1: Fitzyferret folded before Flop (didn't bet)
Seat 2: patpaty folded before Flop (didn't bet)
Seat 4: KovIFish89 folded before Flop (didn't bet)
Seat 5: zmOe84 (button) folded before Flop (didn't bet)
Seat 6: Spid1 (small blind) collected ($4)
Seat 7: matiko09 (big blind) folded before Flop
Seat 8: Durnichka folded before Flop (didn't bet)
Seat 9: gabi_igna folded before Flop (didn't bet)





PokerStars Hand #152884424558:  Hold'em No Limit ($0.50/$1.00 USD) - 2016/05/05 15:48:28 CET [2016/05/05 9:48:28 ET]
Table 'Priska II' 9-max Seat #7 is the button
Seat 1: Spid1 ($108.40 in chips) 
Seat 2: Kukuryzka ($129.02 in chips) 
Seat 3: matiko09 ($101.50 in chips) 
Seat 4: Painkiller72 ($164.16 in chips) 
Seat 5: nickreason17 ($175.55 in chips) 
Seat 6: OneTwo81 ($97.11 in chips) 
Seat 7: stockbridge8 ($89.27 in chips) 
Seat 8: pohorc21 ($52.65 in chips) 
Seat 9: torkkdnm ($111.50 in chips) 
pohorc21: posts small blind $0.50
torkkdnm: posts big blind $1
*** HOLE CARDS ***
Dealt to matiko09 [5d 9s]
Spid1: folds 
Kukuryzka: folds 
matiko09: folds 
Painkiller72: folds 
nickreason17: folds 
OneTwo81: folds 
stockbridge8: folds 
pohorc21: calls $0.50
torkkdnm: raises $3 to $4
pohorc21: calls $3
*** FLOP *** [Jd Td 9d]
pohorc21: checks 
torkkdnm: bets $4
pohorc21: raises $16 to $20
torkkdnm: folds 
Uncalled bet ($16) returned to pohorc21
pohorc21 collected $15.20 from pot
pohorc21: doesn't show hand 
*** SUMMARY ***
Total pot $16 | Rake $0.80 
Board [Jd Td 9d]
Seat 1: Spid1 folded before Flop (didn't bet)
Seat 2: Kukuryzka folded before Flop (didn't bet)
Seat 3: matiko09 folded before Flop (didn't bet)
Seat 4: Painkiller72 folded before Flop (didn't bet)
Seat 5: nickreason17 folded before Flop (didn't bet)
Seat 6: OneTwo81 folded before Flop (didn't bet)
Seat 7: stockbridge8 (button) folded before Flop (didn't bet)
Seat 8: pohorc21 (small blind) collected ($15.20)
Seat 9: torkkdnm (big blind) folded on the Flop





PokerStars Hand #152884425569:  Hold'em No Limit ($0.50/$1.00 USD) - 2016/05/05 15:48:30 CET [2016/05/05 9:48:30 ET]
Table 'Calypso II' 9-max Seat #1 is the button
Seat 1: nickreason17 ($100 in chips) 
Seat 2: torkkdnm ($141 in chips) 
Seat 3: gabi_igna ($110.59 in chips) 
Seat 4: sanpidk ($100 in chips) 
Seat 5: LighTingSSSS ($88.01 in chips) 
Seat 6: WTAPSVG ($128.15 in chips) 
Seat 7: ipashutapkom ($89.33 in chips) 
Seat 8: matiko09 ($107.80 in chips) 
Seat 9: chrisauy ($39.56 in chips) 
torkkdnm: posts small blind $0.50
gabi_igna: posts big blind $1
*** HOLE CARDS ***
Dealt to matiko09 [Qd 3s]
sanpidk: raises $2 to $3
LighTingSSSS: folds 
WTAPSVG: folds 
ipashutapkom: folds 
matiko09: folds 
chrisauy: folds 
nickreason17: folds 
torkkdnm: folds 
gabi_igna: folds 
Uncalled bet ($2) returned to sanpidk
sanpidk collected $2.50 from pot
sanpidk: doesn't show hand 
*** SUMMARY ***
Total pot $2.50 | Rake $0 
Seat 1: nickreason17 (button) folded before Flop (didn't bet)
Seat 2: torkkdnm (small blind) folded before Flop
Seat 3: gabi_igna (big blind) folded before Flop
Seat 4: sanpidk collected ($2.50)
Seat 5: LighTingSSSS folded before Flop (didn't bet)
Seat 6: WTAPSVG folded before Flop (didn't bet)
Seat 7: ipashutapkom folded before Flop (didn't bet)
Seat 8: matiko09 folded before Flop (didn't bet)
Seat 9: chrisauy folded before Flop (didn't bet)





PokerStars Hand #152884427421:  Hold'em No Limit (€0.50/€1.00 EUR) - 2016/05/05 15:48:33 CET [2016/05/05 9:48:33 ET]
Table 'Carol II' 9-max Seat #4 is the button
Seat 1: vrnMike (€114.85 in chips) 
Seat 2: matiko09 (€101.50 in chips) 
Seat 4: Merlin_1905 (€37.50 in chips) 
Seat 5: Painkiller72 (€101.28 in chips) 
Seat 6: drissmouzou (€51.53 in chips) 
Seat 7: Spid1 (€101 in chips) 
Seat 9: Racushniak (€135.87 in chips) 
Painkiller72: posts small blind €0.50
drissmouzou said, "chance"
drissmouzou: posts big blind €1
*** HOLE CARDS ***
Dealt to matiko09 [2s 9s]
Spid1: folds 
Racushniak: folds 
vrnMike: folds 
matiko09: folds 
Merlin_1905: folds 
Painkiller72: raises €2 to €3
drissmouzou: calls €2
*** FLOP *** [3s 5c 8s]
Painkiller72: checks 
drissmouzou: bets €2.85
Painkiller72: folds 
Uncalled bet (€2.85) returned to drissmouzou
drissmouzou collected €5.70 from pot
drissmouzou: doesn't show hand 
*** SUMMARY ***
Total pot €6 | Rake €0.30 
Board [3s 5c 8s]
Seat 1: vrnMike folded before Flop (didn't bet)
Seat 2: matiko09 folded before Flop (didn't bet)
Seat 4: Merlin_1905 (button) folded before Flop (didn't bet)
Seat 5: Painkiller72 (small blind) folded on the Flop
Seat 6: drissmouzou (big blind) collected (€5.70)
Seat 7: Spid1 folded before Flop (didn't bet)
Seat 9: Racushniak folded before Flop (didn't bet)





PokerStars Hand #152884428591:  Hold'em No Limit ($1/$2 USD) - 2016/05/05 15:48:35 CET [2016/05/05 9:48:35 ET]
Table 'Tololo' 9-max Seat #3 is the button
Seat 1: Kukuryzka ($200 in chips) 
Seat 2: gabi_igna ($240.39 in chips) 
Seat 3: nickreason17 ($213.75 in chips) 
Seat 4: mooose100 ($166.59 in chips) 
Seat 5: matiko09 ($211 in chips) 
Seat 6: Xagua ($125.83 in chips) 
Seat 9: Fitzyferret ($287.99 in chips) 
mooose100: posts small blind $1
matiko09: posts big blind $2
Iggso: sits out 
KovIFish89: sits out 
*** HOLE CARDS ***
Dealt to matiko09 [Ah 7c]
Xagua: folds 
Fitzyferret: folds 
Kukuryzka: raises $4 to $6
gabi_igna: folds 
nickreason17: folds 
mooose100: folds 
matiko09: folds 
Uncalled bet ($4) returned to Kukuryzka
Kukuryzka collected $5 from pot
Kukuryzka: doesn't show hand 
*** SUMMARY ***
Total pot $5 | Rake $0 
Seat 1: Kukuryzka collected ($5)
Seat 2: gabi_igna folded before Flop (didn't bet)
Seat 3: nickreason17 (button) folded before Flop (didn't bet)
Seat 4: mooose100 (small blind) folded before Flop
Seat 5: matiko09 (big blind) folded before Flop
Seat 6: Xagua folded before Flop (didn't bet)
Seat 9: Fitzyferret folded before Flop (didn't bet)





PokerStars Hand #152884430187:  Hold'em No Limit ($0.50/$1.00 USD) - 2016/05/05 15:48:38 CET [2016/05/05 9:48:38 ET]
Table 'Pyxis III' 9-max Seat #5 is the button
Seat 1: sanpidk ($173.03 in chips) 
Seat 2: 50CandyJoe ($100 in chips) 
Seat 3: vrnMike ($100 in chips) 
Seat 4: Sloeve ($128.49 in chips) 
Seat 5: darren1031 ($97.10 in chips) 
Seat 6: kamillo91 ($87.50 in chips) 
Seat 7: mycka86 ($100 in chips) 
Seat 8: matiko09 ($107.25 in chips) 
Seat 9: Hypoaroused ($187.05 in chips) 
kamillo91: posts small blind $0.50
mycka86: posts big blind $1
Sloeve: posts small & big blinds $1.50
*** HOLE CARDS ***
Dealt to matiko09 [2s Ks]
matiko09: folds 
Hypoaroused: calls $1
sanpidk: raises $4.50 to $5.50
50CandyJoe: folds 
vrnMike: folds 
Sloeve has timed out
Sloeve: folds 
darren1031: folds 
kamillo91: folds 
mycka86: folds 
Hypoaroused: calls $4.50
*** FLOP *** [6h 9h Jd]
Hypoaroused: checks 
sanpidk: bets $9.90
Hypoaroused: calls $9.90
*** TURN *** [6h 9h Jd] [3c]
Hypoaroused: checks 
50CandyJoe leaves the table
sanpidk: bets $23.90
Hypoaroused: folds 
Uncalled bet ($23.90) returned to sanpidk
sanpidk collected $32.11 from pot
sanpidk: doesn't show hand 
*** SUMMARY ***
Total pot $33.80 | Rake $1.69 
Board [6h 9h Jd 3c]
Seat 1: sanpidk collected ($32.11)
Seat 2: 50CandyJoe folded before Flop (didn't bet)
Seat 3: vrnMike folded before Flop (didn't bet)
Seat 4: Sloeve folded before Flop
Seat 5: darren1031 (button) folded before Flop (didn't bet)
Seat 6: kamillo91 (small blind) folded before Flop
Seat 7: mycka86 (big blind) folded before Flop
Seat 8: matiko09 folded before Flop (didn't bet)
Seat 9: Hypoaroused folded on the Turn





PokerStars Hand #152884430129:  Hold'em No Limit ($0.50/$1.00 USD) - 2016/05/05 15:48:38 CET [2016/05/05 9:48:38 ET]
Table 'Lictoria II' 9-max Seat #1 is the button
Seat 1: St.LaCoste ($100 in chips) 
Seat 3: Krinica2009 ($100 in chips) 
Seat 4: Ying59 ($87.46 in chips) 
Seat 5: sanpidk ($135.50 in chips) 
Seat 6: gabi_igna ($119.83 in chips) 
Seat 7: Painkiller72 ($175.42 in chips) 
Seat 8: matiko09 ($104 in chips) 
Seat 9: Kukuryzka ($143.31 in chips) 
Krinica2009: posts small blind $0.50
Ying59: posts big blind $1
*** HOLE CARDS ***
Dealt to matiko09 [7s Ah]
sanpidk: folds 
gabi_igna: folds 
Painkiller72: folds 
matiko09: folds 
Kukuryzka: folds 
St.LaCoste: folds 
Krinica2009: raises $2 to $3
Ying59: calls $2
*** FLOP *** [5d Qh Jc]
Krinica2009: checks 
Ying59: checks 
*** TURN *** [5d Qh Jc] [7h]
Krinica2009: checks 
Ying59: checks 
*** RIVER *** [5d Qh Jc 7h] [8d]
Krinica2009: checks 
Ying59: checks 
*** SHOW DOWN ***
Krinica2009: shows [Kd 6d] (high card King)
Ying59: shows [6c 6s] (a pair of Sixes)
Ying59 collected $5.70 from pot
*** SUMMARY ***
Total pot $6 | Rake $0.30 
Board [5d Qh Jc 7h 8d]
Seat 1: St.LaCoste (button) folded before Flop (didn't bet)
Seat 3: Krinica2009 (small blind) showed [Kd 6d] and lost with high card King
Seat 4: Ying59 (big blind) showed [6c 6s] and won ($5.70) with a pair of Sixes
Seat 5: sanpidk folded before Flop (didn't bet)
Seat 6: gabi_igna folded before Flop (didn't bet)
Seat 7: Painkiller72 folded before Flop (didn't bet)
Seat 8: matiko09 folded before Flop (didn't bet)
Seat 9: Kukuryzka folded before Flop (didn't bet)





PokerStars Hand #152884432320:  Hold'em No Limit ($0.50/$1.00 USD) - 2016/05/05 15:48:42 CET [2016/05/05 9:48:42 ET]
Table 'Musa II' 9-max Seat #5 is the button
Seat 1: KovIFish89 ($207.97 in chips) 
Seat 3: vrnMike ($100 in chips) 
Seat 4: sanpidk ($100 in chips) 
Seat 5: Chin41178 ($98.50 in chips) 
Seat 6: cnn123 ($57.12 in chips) 
Seat 7: Painkiller72 ($100 in chips) 
Seat 8: matiko09 ($100 in chips) 
Seat 9: antfurto ($101.68 in chips) 
cnn123: posts small blind $0.50
Painkiller72: posts big blind $1
*** HOLE CARDS ***
Dealt to matiko09 [Qc 7c]
matiko09: folds 
antfurto: folds 
KovIFish89: folds 
vrnMike: folds 
sanpidk: raises $1.50 to $2.50
Chin41178: folds 
cnn123: calls $2
Painkiller72: folds 
*** FLOP *** [2c Ac 3s]
cnn123: checks 
sanpidk: bets $3.50
cnn123: folds 
Uncalled bet ($3.50) returned to sanpidk
sanpidk collected $5.70 from pot
sanpidk: doesn't show hand 
*** SUMMARY ***
Total pot $6 | Rake $0.30 
Board [2c Ac 3s]
Seat 1: KovIFish89 folded before Flop (didn't bet)
Seat 3: vrnMike folded before Flop (didn't bet)
Seat 4: sanpidk collected ($5.70)
Seat 5: Chin41178 (button) folded before Flop (didn't bet)
Seat 6: cnn123 (small blind) folded on the Flop
Seat 7: Painkiller72 (big blind) folded before Flop
Seat 8: matiko09 folded before Flop (didn't bet)
Seat 9: antfurto folded before Flop (didn't bet)





PokerStars Hand #152884440941:  Hold'em No Limit ($1/$2 USD) - 2016/05/05 15:48:57 CET [2016/05/05 9:48:57 ET]
Table 'Lundia' 9-max Seat #6 is the button
Seat 1: Fitzyferret ($200 in chips) 
Seat 2: patpaty ($193.10 in chips) 
Seat 4: KovIFish89 ($219.88 in chips) 
Seat 5: zmOe84 ($193 in chips) 
Seat 6: Spid1 ($257.39 in chips) 
Seat 7: matiko09 ($210.86 in chips) 
Seat 8: Durnichka ($79 in chips) 
Seat 9: gabi_igna ($278.36 in chips) 
matiko09: posts small blind $1
Durnichka: posts big blind $2
Painkiller72: sits out 
*** HOLE CARDS ***
Dealt to matiko09 [Kd 2s]
gabi_igna: folds 
Fitzyferret: folds 
patpaty: folds 
KovIFish89: folds 
zmOe84: folds 
Spid1: raises $3 to $5
matiko09: folds 
Durnichka: raises $9 to $14
Spid1: folds 
Uncalled bet ($9) returned to Durnichka
Durnichka collected $11 from pot
Durnichka: doesn't show hand 
*** SUMMARY ***
Total pot $11 | Rake $0 
Seat 1: Fitzyferret folded before Flop (didn't bet)
Seat 2: patpaty folded before Flop (didn't bet)
Seat 4: KovIFish89 folded before Flop (didn't bet)
Seat 5: zmOe84 folded before Flop (didn't bet)
Seat 6: Spid1 (button) folded before Flop
Seat 7: matiko09 (small blind) folded before Flop
Seat 8: Durnichka (big blind) collected ($11)
Seat 9: gabi_igna folded before Flop (didn't bet)





PokerStars Hand #152884443740:  Hold'em No Limit ($1/$2 USD) - 2016/05/05 15:49:01 CET [2016/05/05 9:49:01 ET]
Table 'Tololo' 9-max Seat #4 is the button
Seat 1: Kukuryzka ($203 in chips) 
Seat 2: gabi_igna ($240.39 in chips) 
Seat 3: nickreason17 ($213.75 in chips) 
Seat 4: mooose100 ($200 in chips) 
Seat 5: matiko09 ($209 in chips) 
Seat 6: Xagua ($125.83 in chips) 
Seat 9: Fitzyferret ($287.99 in chips) 
matiko09: posts small blind $1
Xagua: posts big blind $2
Iggso: sits out 
KovIFish89: sits out 
*** HOLE CARDS ***
Dealt to matiko09 [2h 9s]
Fitzyferret: folds 
Kukuryzka: folds 
gabi_igna: folds 
nickreason17: raises $3 to $5
mooose100: calls $5
matiko09: folds 
Xagua: folds 
*** FLOP *** [As 4c 5s]
nickreason17: checks 
mooose100: bets $12.35
nickreason17: calls $12.35
*** TURN *** [As 4c 5s] [9h]
nickreason17: checks 
mooose100: checks 
*** RIVER *** [As 4c 5s 9h] [Th]
nickreason17: checks 
mooose100: checks 
*** SHOW DOWN ***
nickreason17: shows [Ac Jd] (a pair of Aces)
mooose100: mucks hand 
nickreason17 collected $35.82 from pot
*** SUMMARY ***
Total pot $37.70 | Rake $1.88 
Board [As 4c 5s 9h Th]
Seat 1: Kukuryzka folded before Flop (didn't bet)
Seat 2: gabi_igna folded before Flop (didn't bet)
Seat 3: nickreason17 showed [Ac Jd] and won ($35.82) with a pair of Aces
Seat 4: mooose100 (button) mucked [Jh Ts]
Seat 5: matiko09 (small blind) folded before Flop
Seat 6: Xagua (big blind) folded before Flop
Seat 9: Fitzyferret folded before Flop (didn't bet)





PokerStars Hand #152884443896:  Hold'em No Limit ($0.50/$1.00 USD) - 2016/05/05 15:49:02 CET [2016/05/05 9:49:02 ET]
Table 'Natascha' 9-max Seat #3 is the button
Seat 1: ronald3737 ($108.43 in chips) 
Seat 2: matiko09 ($131.03 in chips) 
Seat 3: bjonlyking ($134.70 in chips) 
Seat 4: sanpidk ($131.81 in chips) 
Seat 6: gabi_igna ($149.62 in chips) 
Seat 7: torkkdnm ($150.75 in chips) 
Seat 8: kamillo91 ($47.51 in chips) 
Seat 9: guoweiAA ($226.20 in chips) 
sanpidk: posts small blind $0.50
Dickyxxx: is sitting out 
Dickyxxx leaves the table
gabi_igna: posts big blind $1
*** HOLE CARDS ***
Dealt to matiko09 [9s 4d]
torkkdnm: folds 
nickreason17 joins the table at seat #5 
kamillo91: folds 
guoweiAA: folds 
ronald3737: folds 
matiko09: folds 
bjonlyking: folds 
sanpidk: folds 
Uncalled bet ($0.50) returned to gabi_igna
gabi_igna collected $1 from pot
gabi_igna: doesn't show hand 
*** SUMMARY ***
Total pot $1 | Rake $0 
Seat 1: ronald3737 folded before Flop (didn't bet)
Seat 2: matiko09 folded before Flop (didn't bet)
Seat 3: bjonlyking (button) folded before Flop (didn't bet)
Seat 4: sanpidk (small blind) folded before Flop
Seat 6: gabi_igna (big blind) collected ($1)
Seat 7: torkkdnm folded before Flop (didn't bet)
Seat 8: kamillo91 folded before Flop (didn't bet)
Seat 9: guoweiAA folded before Flop (didn't bet)





PokerStars Hand #152884445125:  Hold'em No Limit ($0.50/$1.00 USD) - 2016/05/05 15:49:04 CET [2016/05/05 9:49:04 ET]
Table 'Calypso II' 9-max Seat #2 is the button
Seat 1: nickreason17 ($100 in chips) 
Seat 2: torkkdnm ($140.50 in chips) 
Seat 3: gabi_igna ($109.59 in chips) 
Seat 4: sanpidk ($101.50 in chips) 
Seat 5: LighTingSSSS ($88.01 in chips) 
Seat 6: WTAPSVG ($128.15 in chips) 
Seat 7: ipashutapkom ($89.33 in chips) 
Seat 8: matiko09 ($107.80 in chips) 
Seat 9: chrisauy ($39.56 in chips) 
gabi_igna: posts small blind $0.50
sanpidk: posts big blind $1
*** HOLE CARDS ***
Dealt to matiko09 [9s 6c]
LighTingSSSS: folds 
WTAPSVG: raises $1.15 to $2.15
ipashutapkom: folds 
matiko09: folds 
chrisauy: calls $2.15
nickreason17: raises $7.85 to $10
torkkdnm: folds 
gabi_igna: folds 
sanpidk: folds 
WTAPSVG: folds 
chrisauy: folds 
Uncalled bet ($7.85) returned to nickreason17
chrisauy leaves the table
nickreason17 collected $7.95 from pot
Hayer ana joins the table at seat #9 
*** SUMMARY ***
Total pot $7.95 | Rake $0 
Seat 1: nickreason17 collected ($7.95)
Seat 2: torkkdnm (button) folded before Flop (didn't bet)
Seat 3: gabi_igna (small blind) folded before Flop
Seat 4: sanpidk (big blind) folded before Flop
Seat 5: LighTingSSSS folded before Flop (didn't bet)
Seat 6: WTAPSVG folded before Flop
Seat 7: ipashutapkom folded before Flop (didn't bet)
Seat 8: matiko09 folded before Flop (didn't bet)
Seat 9: chrisauy folded before Flop





PokerStars Hand #152884445938:  Hold'em No Limit ($0.50/$1.00 USD) - 2016/05/05 15:49:05 CET [2016/05/05 9:49:05 ET]
Table 'Luthera' 9-max Seat #1 is the button
Seat 1: MrMattkk ($73.42 in chips) 
Seat 2: Spid1 ($101 in chips) 
Seat 3: ipashutapkom ($101.96 in chips) 
Seat 4: matiko09 ($103.75 in chips) 
Seat 5: Painkiller72 ($100 in chips) 
Seat 7: Chin41178 ($98.50 in chips) 
Seat 8: xdrKush420x ($96.50 in chips) 
Seat 9: vrnMike ($101 in chips) 
Spid1: posts small blind $0.50
ipashutapkom: posts big blind $1
*** HOLE CARDS ***
Dealt to matiko09 [4h 3c]
matiko09: folds 
Painkiller72: folds 
Chin41178: folds 
xdrKush420x: raises $2 to $3
vrnMike: folds 
MrMattkk: folds 
Spid1: folds 
ipashutapkom: folds 
Uncalled bet ($2) returned to xdrKush420x
xdrKush420x collected $2.50 from pot
*** SUMMARY ***
Total pot $2.50 | Rake $0 
Seat 1: MrMattkk (button) folded before Flop (didn't bet)
Seat 2: Spid1 (small blind) folded before Flop
Seat 3: ipashutapkom (big blind) folded before Flop
Seat 4: matiko09 folded before Flop (didn't bet)
Seat 5: Painkiller72 folded before Flop (didn't bet)
Seat 7: Chin41178 folded before Flop (didn't bet)
Seat 8: xdrKush420x collected ($2.50)
Seat 9: vrnMike folded before Flop (didn't bet)





PokerStars Hand #152884448218:  Hold'em No Limit (€0.50/€1.00 EUR) - 2016/05/05 15:49:09 CET [2016/05/05 9:49:09 ET]
Table 'Carol II' 9-max Seat #5 is the button
Seat 1: vrnMike (€114.85 in chips) 
Seat 2: matiko09 (€101.50 in chips) 
Seat 4: Merlin_1905 (€37.50 in chips) 
Seat 5: Painkiller72 (€100 in chips) 
Seat 6: drissmouzou (€54.23 in chips) 
Seat 7: Spid1 (€101 in chips) 
Seat 9: Racushniak (€135.87 in chips) 
drissmouzou: posts small blind €0.50
Spid1: posts big blind €1
*** HOLE CARDS ***
Dealt to matiko09 [8s 9s]
drissmouzou said, "(tilt)(tilt)"
Racushniak: folds 
vrnMike: raises €1 to €2
matiko09: calls €2
Merlin_1905: calls €2
drissmouzou said, "<:)<:)"
Painkiller72: folds 
drissmouzou: folds 
Spid1: folds 
*** FLOP *** [6c Jh 5d]
vrnMike: bets €6
matiko09: folds 
Merlin_1905: raises €6 to €12
vrnMike: raises €24.50 to €36.50
Merlin_1905: calls €23.50 and is all-in
Uncalled bet (€1) returned to vrnMike
*** TURN *** [6c Jh 5d] [Th]
*** RIVER *** [6c Jh 5d Th] [2d]
*** SHOW DOWN ***
vrnMike: shows [Ks Kd] (a pair of Kings)
Merlin_1905: shows [Ad As] (a pair of Aces)
Merlin_1905 collected €76.25 from pot
*** SUMMARY ***
Total pot €78.50 | Rake €2.25 
Board [6c Jh 5d Th 2d]
Seat 1: vrnMike showed [Ks Kd] and lost with a pair of Kings
Seat 2: matiko09 folded on the Flop
Seat 4: Merlin_1905 showed [Ad As] and won (€76.25) with a pair of Aces
Seat 5: Painkiller72 (button) folded before Flop (didn't bet)
Seat 6: drissmouzou (small blind) folded before Flop
Seat 7: Spid1 (big blind) folded before Flop
Seat 9: Racushniak folded before Flop (didn't bet)





PokerStars Hand #152884454435:  Hold'em No Limit ($0.50/$1.00 USD) - 2016/05/05 15:49:20 CET [2016/05/05 9:49:20 ET]
Table 'Lictoria II' 9-max Seat #3 is the button
Seat 1: St.LaCoste ($100 in chips) 
Seat 3: Krinica2009 ($100 in chips) 
Seat 4: Ying59 ($90.16 in chips) 
Seat 5: sanpidk ($135.50 in chips) 
Seat 6: gabi_igna ($119.83 in chips) 
Seat 7: Painkiller72 ($175.42 in chips) 
Seat 8: matiko09 ($104 in chips) 
Seat 9: Kukuryzka ($143.31 in chips) 
Ying59: posts small blind $0.50
sanpidk: posts big blind $1
*** HOLE CARDS ***
Dealt to matiko09 [3h Qh]
gabi_igna: folds 
Painkiller72: raises $1.50 to $2.50
matiko09: folds 
Kukuryzka: folds 
St.LaCoste: folds 
Krinica2009: folds 
Ying59: folds 
sanpidk: folds 
Uncalled bet ($1.50) returned to Painkiller72
Painkiller72 collected $2.50 from pot
Painkiller72: doesn't show hand 
*** SUMMARY ***
Total pot $2.50 | Rake $0 
Seat 1: St.LaCoste folded before Flop (didn't bet)
Seat 3: Krinica2009 (button) folded before Flop (didn't bet)
Seat 4: Ying59 (small blind) folded before Flop
Seat 5: sanpidk (big blind) folded before Flop
Seat 6: gabi_igna folded before Flop (didn't bet)
Seat 7: Painkiller72 collected ($2.50)
Seat 8: matiko09 folded before Flop (didn't bet)
Seat 9: Kukuryzka folded before Flop (didn't bet)





PokerStars Hand #152884454830:  Hold'em No Limit ($0.50/$1.00 USD) - 2016/05/05 15:49:21 CET [2016/05/05 9:49:21 ET]
Table 'Priska II' 9-max Seat #8 is the button
Seat 1: Spid1 ($108.40 in chips) 
Seat 2: Kukuryzka ($129.02 in chips) 
Seat 3: matiko09 ($101.50 in chips) 
Seat 4: Painkiller72 ($164.16 in chips) 
Seat 5: nickreason17 ($175.55 in chips) 
Seat 6: OneTwo81 ($97.11 in chips) 
Seat 7: stockbridge8 ($89.27 in chips) 
Seat 8: pohorc21 ($59.85 in chips) 
Seat 9: torkkdnm ($103.50 in chips) 
torkkdnm: posts small blind $0.50
Spid1: posts big blind $1
*** HOLE CARDS ***
Dealt to matiko09 [4h Kc]
Kukuryzka: folds 
matiko09: folds 
Painkiller72: raises $1.50 to $2.50
nickreason17: folds 
OneTwo81: folds 
stockbridge8: folds 
pohorc21: calls $2.50
torkkdnm: folds 
Spid1: folds 
*** FLOP *** [Ad 8h As]
Painkiller72: bets $4.32
pohorc21: calls $4.32
*** TURN *** [Ad 8h As] [Qh]
Painkiller72: checks 
pohorc21: checks 
*** RIVER *** [Ad 8h As Qh] [Kh]
Painkiller72: checks 
pohorc21: bets $14
Painkiller72: folds 
Uncalled bet ($14) returned to pohorc21
pohorc21 collected $14.38 from pot
*** SUMMARY ***
Total pot $15.14 | Rake $0.76 
Board [Ad 8h As Qh Kh]
Seat 1: Spid1 (big blind) folded before Flop
Seat 2: Kukuryzka folded before Flop (didn't bet)
Seat 3: matiko09 folded before Flop (didn't bet)
Seat 4: Painkiller72 folded on the River
Seat 5: nickreason17 folded before Flop (didn't bet)
Seat 6: OneTwo81 folded before Flop (didn't bet)
Seat 7: stockbridge8 folded before Flop (didn't bet)
Seat 8: pohorc21 (button) collected ($14.38)
Seat 9: torkkdnm (small blind) folded before Flop





PokerStars Hand #152884455584:  Hold'em No Limit ($0.50/$1.00 USD) - 2016/05/05 15:49:22 CET [2016/05/05 9:49:22 ET]
Table 'Natascha' 9-max Seat #4 is the button
Seat 1: ronald3737 ($108.43 in chips) 
Seat 2: matiko09 ($131.03 in chips) 
Seat 3: bjonlyking ($134.70 in chips) 
Seat 4: sanpidk ($131.31 in chips) 
Seat 6: gabi_igna ($150.12 in chips) 
Seat 7: torkkdnm ($150.75 in chips) 
Seat 8: kamillo91 ($47.51 in chips) 
Seat 9: guoweiAA ($226.20 in chips) 
gabi_igna: posts small blind $0.50
torkkdnm: posts big blind $1
*** HOLE CARDS ***
Dealt to matiko09 [Td 6h]
kamillo91: raises $2 to $3
guoweiAA: folds 
ronald3737: calls $3
matiko09: folds 
bjonlyking: calls $3
sanpidk: folds 
gabi_igna: folds 
torkkdnm: folds 
*** FLOP *** [Qd Qc 9s]
kamillo91: bets $5
ronald3737: folds 
bjonlyking: calls $5
*** TURN *** [Qd Qc 9s] [7d]
kamillo91: bets $5
bjonlyking: folds 
Uncalled bet ($5) returned to kamillo91
kamillo91 collected $19.48 from pot
kamillo91: doesn't show hand 
*** SUMMARY ***
Total pot $20.50 | Rake $1.02 
Board [Qd Qc 9s 7d]
Seat 1: ronald3737 folded on the Flop
Seat 2: matiko09 folded before Flop (didn't bet)
Seat 3: bjonlyking folded on the Turn
Seat 4: sanpidk (button) folded before Flop (didn't bet)
Seat 6: gabi_igna (small blind) folded before Flop
Seat 7: torkkdnm (big blind) folded before Flop
Seat 8: kamillo91 collected ($19.48)
Seat 9: guoweiAA folded before Flop (didn't bet)





PokerStars Hand #152884455604:  Hold'em No Limit ($0.50/$1.00 USD) - 2016/05/05 15:49:22 CET [2016/05/05 9:49:22 ET]
Table 'Musa II' 9-max Seat #6 is the button
Seat 1: KovIFish89 ($207.97 in chips) 
Seat 3: vrnMike ($100 in chips) 
Seat 4: sanpidk ($103.20 in chips) 
Seat 5: Chin41178 ($98.50 in chips) 
Seat 6: cnn123 ($54.62 in chips) 
Seat 7: Painkiller72 ($100 in chips) 
Seat 8: matiko09 ($100 in chips) 
Seat 9: antfurto ($101.68 in chips) 
Painkiller72: posts small blind $0.50
matiko09: posts big blind $1
*** HOLE CARDS ***
Dealt to matiko09 [2d 5s]
antfurto: folds 
KovIFish89: folds 
vrnMike: raises $1 to $2
sanpidk: calls $2
Chin41178: folds 
cnn123: calls $2
Painkiller72: folds 
matiko09: folds 
*** FLOP *** [Qc Kc Jc]
vrnMike: checks 
sanpidk: checks 
cnn123: bets $4
vrnMike: folds 
sanpidk: folds 
Uncalled bet ($4) returned to cnn123
cnn123 collected $7.12 from pot
*** SUMMARY ***
Total pot $7.50 | Rake $0.38 
Board [Qc Kc Jc]
Seat 1: KovIFish89 folded before Flop (didn't bet)
Seat 3: vrnMike folded on the Flop
Seat 4: sanpidk folded on the Flop
Seat 5: Chin41178 folded before Flop (didn't bet)
Seat 6: cnn123 (button) collected ($7.12)
Seat 7: Painkiller72 (small blind) folded before Flop
Seat 8: matiko09 (big blind) folded before Flop
Seat 9: antfurto folded before Flop (didn't bet)





PokerStars Hand #152884459087:  Hold'em No Limit ($1/$2 USD) - 2016/05/05 15:49:28 CET [2016/05/05 9:49:28 ET]
Table 'Lundia' 9-max Seat #7 is the button
Seat 1: Fitzyferret ($200 in chips) 
Seat 2: patpaty ($193.10 in chips) 
Seat 4: KovIFish89 ($219.88 in chips) 
Seat 5: zmOe84 ($193 in chips) 
Seat 6: Spid1 ($252.39 in chips) 
Seat 7: matiko09 ($209.86 in chips) 
Seat 8: Durnichka ($85 in chips) 
Seat 9: gabi_igna ($278.36 in chips) 
Durnichka: posts small blind $1
gabi_igna: posts big blind $2
Painkiller72: sits out 
*** HOLE CARDS ***
Dealt to matiko09 [Jc Jh]
Fitzyferret: folds 
patpaty: folds 
KovIFish89: raises $4 to $6
zmOe84: folds 
Spid1: folds 
matiko09: calls $6
Durnichka: folds 
gabi_igna: folds 
*** FLOP *** [Jd Ks 3s]
KovIFish89: bets $9
matiko09: calls $9
*** TURN *** [Jd Ks 3s] [8d]
KovIFish89: checks 
matiko09: bets $23
KovIFish89: calls $23
*** RIVER *** [Jd Ks 3s 8d] [Ac]
KovIFish89: checks 
matiko09: bets $54
KovIFish89: folds 
Uncalled bet ($54) returned to matiko09
matiko09 collected $76.25 from pot
matiko09: doesn't show hand 
*** SUMMARY ***
Total pot $79 | Rake $2.75 
Board [Jd Ks 3s 8d Ac]
Seat 1: Fitzyferret folded before Flop (didn't bet)
Seat 2: patpaty folded before Flop (didn't bet)
Seat 4: KovIFish89 folded on the River
Seat 5: zmOe84 folded before Flop (didn't bet)
Seat 6: Spid1 folded before Flop (didn't bet)
Seat 7: matiko09 (button) collected ($76.25)
Seat 8: Durnichka (small blind) folded before Flop
Seat 9: gabi_igna (big blind) folded before Flop





PokerStars Hand #152884461707:  Hold'em No Limit ($0.50/$1.00 USD) - 2016/05/05 15:49:33 CET [2016/05/05 9:49:33 ET]
Table 'Luthera' 9-max Seat #2 is the button
Seat 1: MrMattkk ($73.42 in chips) 
Seat 2: Spid1 ($100.50 in chips) 
Seat 3: ipashutapkom ($100.96 in chips) 
Seat 4: matiko09 ($103.75 in chips) 
Seat 5: Painkiller72 ($100 in chips) 
Seat 7: Chin41178 ($98.50 in chips) 
Seat 8: xdrKush420x ($98 in chips) 
Seat 9: vrnMike ($101 in chips) 
ipashutapkom: posts small blind $0.50
matiko09: posts big blind $1
*** HOLE CARDS ***
Dealt to matiko09 [2h 5d]
Painkiller72: folds 
Chin41178: folds 
xdrKush420x: folds 
vrnMike: folds 
MrMattkk: folds 
Spid1: folds 
ipashutapkom: raises $1.26 to $2.26
matiko09: folds 
Uncalled bet ($1.26) returned to ipashutapkom
ipashutapkom collected $2 from pot
ipashutapkom: doesn't show hand 
*** SUMMARY ***
Total pot $2 | Rake $0 
Seat 1: MrMattkk folded before Flop (didn't bet)
Seat 2: Spid1 (button) folded before Flop (didn't bet)
Seat 3: ipashutapkom (small blind) collected ($2)
Seat 4: matiko09 (big blind) folded before Flop
Seat 5: Painkiller72 folded before Flop (didn't bet)
Seat 7: Chin41178 folded before Flop (didn't bet)
Seat 8: xdrKush420x folded before Flop (didn't bet)
Seat 9: vrnMike folded before Flop (didn't bet)





PokerStars Hand #152884467127:  Hold'em No Limit ($0.50/$1.00 USD) - 2016/05/05 15:49:42 CET [2016/05/05 9:49:42 ET]
Table 'Lictoria II' 9-max Seat #4 is the button
Seat 1: St.LaCoste ($100 in chips) 
Seat 3: Krinica2009 ($100 in chips) 
Seat 4: Ying59 ($89.66 in chips) 
Seat 5: sanpidk ($134.50 in chips) 
Seat 6: gabi_igna ($119.83 in chips) 
Seat 7: Painkiller72 ($176.92 in chips) 
Seat 8: matiko09 ($104 in chips) 
Seat 9: Kukuryzka ($143.31 in chips) 
sanpidk: posts small blind $0.50
gabi_igna: posts big blind $1
*** HOLE CARDS ***
Dealt to matiko09 [3s 7s]
Painkiller72: raises $1.50 to $2.50
matiko09: folds 
Kukuryzka: folds 
St.LaCoste: folds 
Krinica2009: raises $9.50 to $12
Ying59: folds 
sanpidk: folds 
gabi_igna: folds 
Painkiller72: folds 
Uncalled bet ($9.50) returned to Krinica2009
Krinica2009 collected $6.50 from pot
Krinica2009: doesn't show hand 
*** SUMMARY ***
Total pot $6.50 | Rake $0 
Seat 1: St.LaCoste folded before Flop (didn't bet)
Seat 3: Krinica2009 collected ($6.50)
Seat 4: Ying59 (button) folded before Flop (didn't bet)
Seat 5: sanpidk (small blind) folded before Flop
Seat 6: gabi_igna (big blind) folded before Flop
Seat 7: Painkiller72 folded before Flop
Seat 8: matiko09 folded before Flop (didn't bet)
Seat 9: Kukuryzka folded before Flop (didn't bet)





PokerStars Hand #152884472641:  Hold'em No Limit ($1/$2 USD) - 2016/05/05 15:49:52 CET [2016/05/05 9:49:52 ET]
Table 'Euporie II' 9-max Seat #8 is the button
Seat 1: Durnichka ($79.95 in chips) 
Seat 2: nickreason17 ($200 in chips) 
Seat 4: A91baer ($180 in chips) 
Seat 5: Nuskatko1986 ($175.01 in chips) 
Seat 6: glanza_mike ($200 in chips) 
Seat 7: matiko09 ($200 in chips) 
Seat 8: Painkiller72 ($200 in chips) 
T0ny Adams will be allowed to play after the button
Durnichka: posts small blind $1
nickreason17: posts big blind $2
Spid1: sits out 
*** HOLE CARDS ***
Dealt to matiko09 [6c Kh]
A91baer: folds 
Nuskatko1986: calls $2
glanza_mike: raises $5 to $7
matiko09: folds 
Painkiller72: folds 
Durnichka: raises $31 to $38
nickreason17: folds 
Nuskatko1986: folds 
glanza_mike: folds 
Uncalled bet ($31) returned to Durnichka
Durnichka collected $18 from pot
Durnichka: doesn't show hand 
*** SUMMARY ***
Total pot $18 | Rake $0 
Seat 1: Durnichka (small blind) collected ($18)
Seat 2: nickreason17 (big blind) folded before Flop
Seat 4: A91baer folded before Flop (didn't bet)
Seat 5: Nuskatko1986 folded before Flop
Seat 6: glanza_mike folded before Flop
Seat 7: matiko09 folded before Flop (didn't bet)
Seat 8: Painkiller72 (button) folded before Flop (didn't bet)





PokerStars Hand #152884473222:  Hold'em No Limit ($1/$2 USD) - 2016/05/05 15:49:53 CET [2016/05/05 9:49:53 ET]
Table 'Tololo' 9-max Seat #5 is the button
Seat 1: Kukuryzka ($203 in chips) 
Seat 2: gabi_igna ($240.39 in chips) 
Seat 3: nickreason17 ($232.22 in chips) 
Seat 4: mooose100 ($182.65 in chips) 
Seat 5: matiko09 ($208 in chips) 
Seat 6: Xagua ($123.83 in chips) 
Seat 7: Iggso ($204.45 in chips) 
Seat 9: Fitzyferret ($287.99 in chips) 
Xagua: posts small blind $1
Iggso: posts big blind $2
KovIFish89: sits out 
*** HOLE CARDS ***
Dealt to matiko09 [Td 5d]
Fitzyferret: folds 
Kukuryzka: folds 
gabi_igna: folds 
nickreason17: folds 
mooose100: folds 
matiko09: folds 
Xagua: calls $1
Iggso: checks 
*** FLOP *** [9d Qd 4c]
Xagua: checks 
Iggso: bets $2.39
Xagua: folds 
Uncalled bet ($2.39) returned to Iggso
Iggso collected $3.80 from pot
Iggso: doesn't show hand 
*** SUMMARY ***
Total pot $4 | Rake $0.20 
Board [9d Qd 4c]
Seat 1: Kukuryzka folded before Flop (didn't bet)
Seat 2: gabi_igna folded before Flop (didn't bet)
Seat 3: nickreason17 folded before Flop (didn't bet)
Seat 4: mooose100 folded before Flop (didn't bet)
Seat 5: matiko09 (button) folded before Flop (didn't bet)
Seat 6: Xagua (small blind) folded on the Flop
Seat 7: Iggso (big blind) collected ($3.80)
Seat 9: Fitzyferret folded before Flop (didn't bet)





PokerStars Hand #152884473341:  Hold'em No Limit (€0.50/€1.00 EUR) - 2016/05/05 15:49:53 CET [2016/05/05 9:49:53 ET]
Table 'Carol II' 9-max Seat #6 is the button
Seat 1: vrnMike (€100 in chips) 
Seat 2: matiko09 (€100 in chips) 
Seat 4: Merlin_1905 (€76.25 in chips) 
Seat 5: Painkiller72 (€100 in chips) 
Seat 6: drissmouzou (€53.73 in chips) 
Seat 7: Spid1 (€100 in chips) 
Seat 9: Racushniak (€135.87 in chips) 
Spid1: posts small blind €0.50
Racushniak: posts big blind €1
*** HOLE CARDS ***
Dealt to matiko09 [6c Ts]
vrnMike: folds 
matiko09: folds 
Merlin_1905: folds 
Painkiller72: folds 
drissmouzou: raises €4 to €5
Spid1: folds 
Racushniak: folds 
Uncalled bet (€4) returned to drissmouzou
drissmouzou said, "<3"
drissmouzou collected €2.50 from pot
drissmouzou: doesn't show hand 
*** SUMMARY ***
Total pot €2.50 | Rake €0 
Seat 1: vrnMike folded before Flop (didn't bet)
Seat 2: matiko09 folded before Flop (didn't bet)
Seat 4: Merlin_1905 folded before Flop (didn't bet)
Seat 5: Painkiller72 folded before Flop (didn't bet)
Seat 6: drissmouzou (button) collected (€2.50)
Seat 7: Spid1 (small blind) folded before Flop
Seat 9: Racushniak (big blind) folded before Flop





PokerStars Hand #152884477298:  Hold'em No Limit ($0.50/$1.00 USD) - 2016/05/05 15:50:00 CET [2016/05/05 9:50:00 ET]
Table 'Luthera' 9-max Seat #3 is the button
Seat 1: MrMattkk ($73.42 in chips) 
Seat 2: Spid1 ($100.50 in chips) 
Seat 3: ipashutapkom ($101.96 in chips) 
Seat 4: matiko09 ($102.75 in chips) 
Seat 5: Painkiller72 ($100 in chips) 
Seat 7: Chin41178 ($98.50 in chips) 
Seat 8: xdrKush420x ($98 in chips) 
Seat 9: vrnMike ($101 in chips) 
matiko09: posts small blind $0.50
Painkiller72: posts big blind $1
*** HOLE CARDS ***
Dealt to matiko09 [Qh 5s]
Chin41178: folds 
xdrKush420x: folds 
vrnMike: folds 
MrMattkk: folds 
Spid1: folds 
ipashutapkom: raises $1.26 to $2.26
matiko09: folds 
Painkiller72: folds 
Uncalled bet ($1.26) returned to ipashutapkom
ipashutapkom collected $2.50 from pot
ipashutapkom: doesn't show hand 
*** SUMMARY ***
Total pot $2.50 | Rake $0 
Seat 1: MrMattkk folded before Flop (didn't bet)
Seat 2: Spid1 folded before Flop (didn't bet)
Seat 3: ipashutapkom (button) collected ($2.50)
Seat 4: matiko09 (small blind) folded before Flop
Seat 5: Painkiller72 (big blind) folded before Flop
Seat 7: Chin41178 folded before Flop (didn't bet)
Seat 8: xdrKush420x folded before Flop (didn't bet)
Seat 9: vrnMike folded before Flop (didn't bet)





PokerStars Hand #152884485075:  Hold'em No Limit ($0.50/$1.00 USD) - 2016/05/05 15:50:14 CET [2016/05/05 9:50:14 ET]
Table 'Calypso II' 9-max Seat #3 is the button
Seat 1: nickreason17 ($105.80 in chips) 
Seat 2: torkkdnm ($140.50 in chips) 
Seat 3: gabi_igna ($109.09 in chips) 
Seat 4: sanpidk ($100.50 in chips) 
Seat 5: LighTingSSSS ($88.01 in chips) 
Seat 6: WTAPSVG ($126 in chips) 
Seat 7: ipashutapkom ($89.33 in chips) 
Seat 8: matiko09 ($107.80 in chips) 
sanpidk: posts small blind $0.50
LighTingSSSS: posts big blind $1
Hayer ana: is sitting out 
Hayer ana leaves the table
*** HOLE CARDS ***
Dealt to matiko09 [Ad 6c]
WTAPSVG: folds 
ipashutapkom: folds 
matiko09: folds 
nickreason17: folds 
torkkdnm: folds 
maxxmeister joins the table at seat #9 
gabi_igna: folds 
sanpidk: folds 
Uncalled bet ($0.50) returned to LighTingSSSS
LighTingSSSS collected $1 from pot
LighTingSSSS: doesn't show hand 
*** SUMMARY ***
Total pot $1 | Rake $0 
Seat 1: nickreason17 folded before Flop (didn't bet)
Seat 2: torkkdnm folded before Flop (didn't bet)
Seat 3: gabi_igna (button) folded before Flop (didn't bet)
Seat 4: sanpidk (small blind) folded before Flop
Seat 5: LighTingSSSS (big blind) collected ($1)
Seat 6: WTAPSVG folded before Flop (didn't bet)
Seat 7: ipashutapkom folded before Flop (didn't bet)
Seat 8: matiko09 folded before Flop (didn't bet)





PokerStars Hand #152884486229:  Hold'em No Limit (€0.50/€1.00 EUR) - 2016/05/05 15:50:16 CET [2016/05/05 9:50:16 ET]
Table 'Carol II' 9-max Seat #7 is the button
Seat 1: vrnMike (€100 in chips) 
Seat 2: matiko09 (€100 in chips) 
Seat 4: Merlin_1905 (€76.25 in chips) 
Seat 5: Painkiller72 (€100 in chips) 
Seat 6: drissmouzou (€55.23 in chips) 
Seat 7: Spid1 (€100 in chips) 
Seat 9: Racushniak (€134.87 in chips) 
Racushniak: posts small blind €0.50
vrnMike: posts big blind €1
*** HOLE CARDS ***
Dealt to matiko09 [7h Js]
matiko09: folds 
Merlin_1905: folds 
Painkiller72: raises €1.50 to €2.50
drissmouzou: folds 
Spid1: folds 
Racushniak: folds 
vrnMike: folds 
Uncalled bet (€1.50) returned to Painkiller72
Painkiller72 collected €2.50 from pot
Painkiller72: doesn't show hand 
*** SUMMARY ***
Total pot €2.50 | Rake €0 
Seat 1: vrnMike (big blind) folded before Flop
Seat 2: matiko09 folded before Flop (didn't bet)
Seat 4: Merlin_1905 folded before Flop (didn't bet)
Seat 5: Painkiller72 collected (€2.50)
Seat 6: drissmouzou folded before Flop (didn't bet)
Seat 7: Spid1 (button) folded before Flop (didn't bet)
Seat 9: Racushniak (small blind) folded before Flop





PokerStars Hand #152884486883:  Hold'em No Limit ($0.50/$1.00 USD) - 2016/05/05 15:50:17 CET [2016/05/05 9:50:17 ET]
Table 'Priska II' 9-max Seat #9 is the button
Seat 1: Spid1 ($107.40 in chips) 
Seat 2: Kukuryzka ($129.02 in chips) 
Seat 3: matiko09 ($101.50 in chips) 
Seat 4: Painkiller72 ($157.34 in chips) 
Seat 5: nickreason17 ($175.55 in chips) 
Seat 6: OneTwo81 ($97.11 in chips) 
Seat 7: stockbridge8 ($89.27 in chips) 
Seat 8: pohorc21 ($67.41 in chips) 
Seat 9: torkkdnm ($103 in chips) 
Spid1: posts small blind $0.50
Kukuryzka: posts big blind $1
*** HOLE CARDS ***
Dealt to matiko09 [Jh 7c]
matiko09: folds 
Painkiller72: folds 
nickreason17: folds 
OneTwo81: calls $1
stockbridge8: folds 
pohorc21: folds 
torkkdnm: folds 
Spid1: raises $4 to $5
Kukuryzka: folds 
OneTwo81: calls $4
*** FLOP *** [6d Td 8s]
Spid1: bets $6
OneTwo81: folds 
Uncalled bet ($6) returned to Spid1
Spid1 collected $10.45 from pot
Spid1: doesn't show hand 
*** SUMMARY ***
Total pot $11 | Rake $0.55 
Board [6d Td 8s]
Seat 1: Spid1 (small blind) collected ($10.45)
Seat 2: Kukuryzka (big blind) folded before Flop
Seat 3: matiko09 folded before Flop (didn't bet)
Seat 4: Painkiller72 folded before Flop (didn't bet)
Seat 5: nickreason17 folded before Flop (didn't bet)
Seat 6: OneTwo81 folded on the Flop
Seat 7: stockbridge8 folded before Flop (didn't bet)
Seat 8: pohorc21 folded before Flop (didn't bet)
Seat 9: torkkdnm (button) folded before Flop (didn't bet)





PokerStars Hand #152884488213:  Hold'em No Limit ($0.50/$1.00 USD) - 2016/05/05 15:50:19 CET [2016/05/05 9:50:19 ET]
Table 'Musa II' 9-max Seat #7 is the button
Seat 1: KovIFish89 ($207.97 in chips) 
Seat 3: vrnMike ($100 in chips) 
Seat 4: sanpidk ($101.20 in chips) 
Seat 5: Chin41178 ($98.50 in chips) 
Seat 6: cnn123 ($59.74 in chips) 
Seat 7: Painkiller72 ($100 in chips) 
Seat 8: matiko09 ($100 in chips) 
Seat 9: antfurto ($101.68 in chips) 
matiko09: posts small blind $0.50
antfurto: posts big blind $1
*** HOLE CARDS ***
Dealt to matiko09 [5h Jh]
KovIFish89: folds 
vrnMike: raises $1 to $2
koutani7 joins the table at seat #2 
sanpidk: folds 
Chin41178: folds 
cnn123: folds 
Painkiller72: folds 
matiko09: folds 
antfurto: calls $1
*** FLOP *** [Ac Kh 8s]
antfurto: bets $3
vrnMike: calls $3
*** TURN *** [Ac Kh 8s] [5c]
antfurto: bets $6
vrnMike: calls $6
*** RIVER *** [Ac Kh 8s 5c] [Qs]
antfurto: checks 
vrnMike: checks 
*** SHOW DOWN ***
antfurto: shows [5d 6d] (a pair of Fives)
vrnMike: shows [As Jc] (a pair of Aces)
vrnMike collected $21.38 from pot
*** SUMMARY ***
Total pot $22.50 | Rake $1.12 
Board [Ac Kh 8s 5c Qs]
Seat 1: KovIFish89 folded before Flop (didn't bet)
Seat 3: vrnMike showed [As Jc] and won ($21.38) with a pair of Aces
Seat 4: sanpidk folded before Flop (didn't bet)
Seat 5: Chin41178 folded before Flop (didn't bet)
Seat 6: cnn123 folded before Flop (didn't bet)
Seat 7: Painkiller72 (button) folded before Flop (didn't bet)
Seat 8: matiko09 (small blind) folded before Flop
Seat 9: antfurto (big blind) showed [5d 6d] and lost with a pair of Fives





PokerStars Hand #152884491968:  Hold'em No Limit ($0.50/$1.00 USD) - 2016/05/05 15:50:26 CET [2016/05/05 9:50:26 ET]
Table 'Lictoria II' 9-max Seat #5 is the button
Seat 1: St.LaCoste ($100 in chips) 
Seat 3: Krinica2009 ($104 in chips) 
Seat 4: Ying59 ($89.66 in chips) 
Seat 5: sanpidk ($134 in chips) 
Seat 6: gabi_igna ($118.83 in chips) 
Seat 7: Painkiller72 ($174.42 in chips) 
Seat 8: matiko09 ($104 in chips) 
Seat 9: Kukuryzka ($143.31 in chips) 
gabi_igna: posts small blind $0.50
Painkiller72: posts big blind $1
*** HOLE CARDS ***
Dealt to matiko09 [Qs 9d]
matiko09: folds 
Kukuryzka: folds 
St.LaCoste: folds 
Krinica2009: folds 
Ying59: folds 
sanpidk: raises $1.24 to $2.24
gabi_igna: raises $6.76 to $9
Painkiller72: folds 
sanpidk: folds 
Uncalled bet ($6.76) returned to gabi_igna
gabi_igna collected $5.48 from pot
gabi_igna: doesn't show hand 
*** SUMMARY ***
Total pot $5.48 | Rake $0 
Seat 1: St.LaCoste folded before Flop (didn't bet)
Seat 3: Krinica2009 folded before Flop (didn't bet)
Seat 4: Ying59 folded before Flop (didn't bet)
Seat 5: sanpidk (button) folded before Flop
Seat 6: gabi_igna (small blind) collected ($5.48)
Seat 7: Painkiller72 (big blind) folded before Flop
Seat 8: matiko09 folded before Flop (didn't bet)
Seat 9: Kukuryzka folded before Flop (didn't bet)





PokerStars Hand #152884492638:  Hold'em No Limit ($1/$2 USD) - 2016/05/05 15:50:27 CET [2016/05/05 9:50:27 ET]
Table 'Tololo' 9-max Seat #6 is the button
Seat 1: Kukuryzka ($203 in chips) 
Seat 2: gabi_igna ($240.39 in chips) 
Seat 3: nickreason17 ($232.22 in chips) 
Seat 4: mooose100 ($182.65 in chips) 
Seat 5: matiko09 ($208 in chips) 
Seat 6: Xagua ($121.83 in chips) 
Seat 7: Iggso ($206.25 in chips) 
Seat 8: KovIFish89 ($200 in chips) 
Seat 9: Fitzyferret ($287.99 in chips) 
Iggso: posts small blind $1
KovIFish89: posts big blind $2
*** HOLE CARDS ***
Dealt to matiko09 [9s 4c]
Fitzyferret: folds 
Kukuryzka: folds 
gabi_igna: folds 
nickreason17: folds 
mooose100: raises $4 to $6
matiko09: folds 
Xagua: folds 
Iggso: folds 
KovIFish89: folds 
Uncalled bet ($4) returned to mooose100
mooose100 collected $5 from pot
mooose100: doesn't show hand 
*** SUMMARY ***
Total pot $5 | Rake $0 
Seat 1: Kukuryzka folded before Flop (didn't bet)
Seat 2: gabi_igna folded before Flop (didn't bet)
Seat 3: nickreason17 folded before Flop (didn't bet)
Seat 4: mooose100 collected ($5)
Seat 5: matiko09 folded before Flop (didn't bet)
Seat 6: Xagua (button) folded before Flop (didn't bet)
Seat 7: Iggso (small blind) folded before Flop
Seat 8: KovIFish89 (big blind) folded before Flop
Seat 9: Fitzyferret folded before Flop (didn't bet)





PokerStars Hand #152884494068:  Hold'em No Limit ($1/$2 USD) - 2016/05/05 15:50:29 CET [2016/05/05 9:50:29 ET]
Table 'Euporie II' 9-max Seat #1 is the button
Seat 1: Durnichka ($90.95 in chips) 
Seat 2: nickreason17 ($200 in chips) 
Seat 3: Spid1 ($202 in chips) 
Seat 4: A91baer ($180 in chips) 
Seat 5: Nuskatko1986 ($173.01 in chips) 
Seat 6: glanza_mike ($200 in chips) 
Seat 7: matiko09 ($200 in chips) 
Seat 8: Painkiller72 ($200 in chips) 
nickreason17: posts small blind $1
Spid1: posts big blind $2
T0ny Adams: sits out 
*** HOLE CARDS ***
Dealt to matiko09 [Ks Kd]
A91baer: folds 
Nuskatko1986: calls $2
glanza_mike: folds 
matiko09: raises $6 to $8
Painkiller72: folds 
Durnichka: folds 
nickreason17: folds 
Spid1: folds 
Nuskatko1986: folds 
Uncalled bet ($6) returned to matiko09
matiko09 collected $7 from pot
matiko09: doesn't show hand 
*** SUMMARY ***
Total pot $7 | Rake $0 
Seat 1: Durnichka (button) folded before Flop (didn't bet)
Seat 2: nickreason17 (small blind) folded before Flop
Seat 3: Spid1 (big blind) folded before Flop
Seat 4: A91baer folded before Flop (didn't bet)
Seat 5: Nuskatko1986 folded before Flop
Seat 6: glanza_mike folded before Flop (didn't bet)
Seat 7: matiko09 collected ($7)
Seat 8: Painkiller72 folded before Flop (didn't bet)





PokerStars Hand #152884495021:  Hold'em No Limit ($0.50/$1.00 USD) - 2016/05/05 15:50:31 CET [2016/05/05 9:50:31 ET]
Table 'Luthera' 9-max Seat #4 is the button
Seat 1: MrMattkk ($73.42 in chips) 
Seat 2: Spid1 ($100.50 in chips) 
Seat 3: ipashutapkom ($103.46 in chips) 
Seat 4: matiko09 ($102.25 in chips) 
Seat 5: Painkiller72 ($100 in chips) 
Seat 7: Chin41178 ($98.50 in chips) 
Seat 8: xdrKush420x ($98 in chips) 
Seat 9: vrnMike ($101 in chips) 
Painkiller72: posts small blind $0.50
Chin41178: posts big blind $1
*** HOLE CARDS ***
Dealt to matiko09 [5h 6h]
xdrKush420x: folds 
vrnMike: folds 
MrMattkk: raises $2 to $3
Spid1: folds 
ipashutapkom: folds 
matiko09: folds 
Painkiller72: folds 
Chin41178: folds 
Uncalled bet ($2) returned to MrMattkk
MrMattkk collected $2.50 from pot
MrMattkk: doesn't show hand 
*** SUMMARY ***
Total pot $2.50 | Rake $0 
Seat 1: MrMattkk collected ($2.50)
Seat 2: Spid1 folded before Flop (didn't bet)
Seat 3: ipashutapkom folded before Flop (didn't bet)
Seat 4: matiko09 (button) folded before Flop (didn't bet)
Seat 5: Painkiller72 (small blind) folded before Flop
Seat 7: Chin41178 (big blind) folded before Flop
Seat 8: xdrKush420x folded before Flop (didn't bet)
Seat 9: vrnMike folded before Flop (didn't bet)





PokerStars Hand #152884500693:  Hold'em No Limit ($0.50/$1.00 USD) - 2016/05/05 15:50:41 CET [2016/05/05 9:50:41 ET]
Table 'Calypso II' 9-max Seat #4 is the button
Seat 1: nickreason17 ($105.80 in chips) 
Seat 2: torkkdnm ($140.50 in chips) 
Seat 3: gabi_igna ($109.09 in chips) 
Seat 4: sanpidk ($100 in chips) 
Seat 5: LighTingSSSS ($88.51 in chips) 
Seat 6: WTAPSVG ($126 in chips) 
Seat 7: ipashutapkom ($89.33 in chips) 
Seat 8: matiko09 ($107.80 in chips) 
LighTingSSSS: posts small blind $0.50
WTAPSVG: posts big blind $1
maxxmeister: sits out 
*** HOLE CARDS ***
Dealt to matiko09 [8c 5d]
ipashutapkom: folds 
matiko09: folds 
nickreason17: folds 
torkkdnm: folds 
gabi_igna: folds 
sanpidk: raises $1.24 to $2.24
LighTingSSSS: folds 
WTAPSVG: raises $3.76 to $6
sanpidk: raises $9.50 to $15.50
WTAPSVG: calls $9.50
*** FLOP *** [3s Kh 9d]
WTAPSVG: checks 
sanpidk: bets $14.87
WTAPSVG: calls $14.87
*** TURN *** [3s Kh 9d] [4h]
WTAPSVG: checks 
sanpidk: bets $21.38
WTAPSVG: calls $21.38
*** RIVER *** [3s Kh 9d 4h] [Td]
WTAPSVG: checks 
sanpidk: checks 
*** SHOW DOWN ***
WTAPSVG: shows [Qd Kd] (a pair of Kings)
sanpidk: mucks hand 
WTAPSVG collected $101.50 from pot
*** SUMMARY ***
Total pot $104 | Rake $2.50 
Board [3s Kh 9d 4h Td]
Seat 1: nickreason17 folded before Flop (didn't bet)
Seat 2: torkkdnm folded before Flop (didn't bet)
Seat 3: gabi_igna folded before Flop (didn't bet)
Seat 4: sanpidk (button) mucked [6d As]
Seat 5: LighTingSSSS (small blind) folded before Flop
Seat 6: WTAPSVG (big blind) showed [Qd Kd] and won ($101.50) with a pair of Kings
Seat 7: ipashutapkom folded before Flop (didn't bet)
Seat 8: matiko09 folded before Flop (didn't bet)





PokerStars Hand #152884501231:  Hold'em No Limit (€0.50/€1.00 EUR) - 2016/05/05 15:50:42 CET [2016/05/05 9:50:42 ET]
Table 'Carol II' 9-max Seat #9 is the button
Seat 1: vrnMike (€100 in chips) 
Seat 2: matiko09 (€100 in chips) 
Seat 4: Merlin_1905 (€76.25 in chips) 
Seat 5: Painkiller72 (€101.50 in chips) 
Seat 6: drissmouzou (€55.23 in chips) 
Seat 7: Spid1 (€100 in chips) 
Seat 9: Racushniak (€134.37 in chips) 
vrnMike: posts small blind €0.50
matiko09: posts big blind €1
*** HOLE CARDS ***
Dealt to matiko09 [Qc 9h]
Merlin_1905: folds 
Painkiller72: folds 
drissmouzou: raises €2 to €3
Spid1: folds 
Racushniak: folds 
vrnMike: folds 
matiko09: folds 
Uncalled bet (€2) returned to drissmouzou
drissmouzou collected €2.50 from pot
drissmouzou: doesn't show hand 
*** SUMMARY ***
Total pot €2.50 | Rake €0 
Seat 1: vrnMike (small blind) folded before Flop
Seat 2: matiko09 (big blind) folded before Flop
Seat 4: Merlin_1905 folded before Flop (didn't bet)
Seat 5: Painkiller72 folded before Flop (didn't bet)
Seat 6: drissmouzou collected (€2.50)
Seat 7: Spid1 folded before Flop (didn't bet)
Seat 9: Racushniak (button) folded before Flop (didn't bet)





PokerStars Hand #152884505080:  Hold'em No Limit ($0.50/$1.00 USD) - 2016/05/05 15:50:49 CET [2016/05/05 9:50:49 ET]
Table 'Pyxis III' 9-max Seat #6 is the button
Seat 1: sanpidk ($189.74 in chips) 
Seat 3: vrnMike ($100 in chips) 
Seat 5: darren1031 ($97.10 in chips) 
Seat 6: kamillo91 ($87 in chips) 
Seat 7: mycka86 ($100 in chips) 
Seat 8: matiko09 ($107.25 in chips) 
Seat 9: Hypoaroused ($171.65 in chips) 
mycka86: posts small blind $0.50
matiko09: posts big blind $1
*** HOLE CARDS ***
Dealt to matiko09 [2s 3s]
Hypoaroused: calls $1
sanpidk: folds 
vrnMike: folds 
darren1031: folds 
kamillo91: folds 
mycka86: calls $0.50
matiko09: checks 
*** FLOP *** [Jd 7h 7s]
mycka86: bets $2.20
matiko09: folds 
Hypoaroused: calls $2.20
*** TURN *** [Jd 7h 7s] [9d]
mycka86: checks 
Hypoaroused: bets $3.51
mycka86: folds 
Uncalled bet ($3.51) returned to Hypoaroused
Hypoaroused collected $7.03 from pot
*** SUMMARY ***
Total pot $7.40 | Rake $0.37 
Board [Jd 7h 7s 9d]
Seat 1: sanpidk folded before Flop (didn't bet)
Seat 3: vrnMike folded before Flop (didn't bet)
Seat 5: darren1031 folded before Flop (didn't bet)
Seat 6: kamillo91 (button) folded before Flop (didn't bet)
Seat 7: mycka86 (small blind) folded on the Turn
Seat 8: matiko09 (big blind) folded on the Flop
Seat 9: Hypoaroused collected ($7.03)





PokerStars Hand #152884506130:  Hold'em No Limit ($0.50/$1.00 USD) - 2016/05/05 15:50:50 CET [2016/05/05 9:50:50 ET]
Table 'Natascha' 9-max Seat #6 is the button
Seat 1: ronald3737 ($105.43 in chips) 
Seat 2: matiko09 ($131.03 in chips) 
Seat 3: bjonlyking ($126.70 in chips) 
Seat 4: sanpidk ($131.31 in chips) 
Seat 6: gabi_igna ($149.62 in chips) 
Seat 7: torkkdnm ($149.75 in chips) 
Seat 8: kamillo91 ($58.99 in chips) 
Seat 9: guoweiAA ($226.20 in chips) 
torkkdnm: posts small blind $0.50
kamillo91: posts big blind $1
*** HOLE CARDS ***
Dealt to matiko09 [5c Qh]
guoweiAA: raises $2 to $3
ronald3737: folds 
matiko09: folds 
bjonlyking: folds 
sanpidk: calls $3
gabi_igna: folds 
torkkdnm: folds 
kamillo91: calls $2
*** FLOP *** [Tc Ah 3h]
kamillo91: checks 
guoweiAA: bets $6
sanpidk: folds 
kamillo91: folds 
Uncalled bet ($6) returned to guoweiAA
guoweiAA collected $9.02 from pot
guoweiAA: doesn't show hand 
*** SUMMARY ***
Total pot $9.50 | Rake $0.48 
Board [Tc Ah 3h]
Seat 1: ronald3737 folded before Flop (didn't bet)
Seat 2: matiko09 folded before Flop (didn't bet)
Seat 3: bjonlyking folded before Flop (didn't bet)
Seat 4: sanpidk folded on the Flop
Seat 6: gabi_igna (button) folded before Flop (didn't bet)
Seat 7: torkkdnm (small blind) folded before Flop
Seat 8: kamillo91 (big blind) folded on the Flop
Seat 9: guoweiAA collected ($9.02)





PokerStars Hand #152884506421:  Hold'em No Limit ($0.50/$1.00 USD) - 2016/05/05 15:50:51 CET [2016/05/05 9:50:51 ET]
Table 'Priska II' 9-max Seat #1 is the button
Seat 1: Spid1 ($112.85 in chips) 
Seat 2: Kukuryzka ($128.02 in chips) 
Seat 3: matiko09 ($101.50 in chips) 
Seat 4: Painkiller72 ($157.34 in chips) 
Seat 5: nickreason17 ($175.55 in chips) 
Seat 6: OneTwo81 ($92.11 in chips) 
Seat 7: stockbridge8 ($89.27 in chips) 
Seat 8: pohorc21 ($67.41 in chips) 
Seat 9: torkkdnm ($103 in chips) 
Kukuryzka: posts small blind $0.50
matiko09: posts big blind $1
*** HOLE CARDS ***
Dealt to matiko09 [4h Qs]
Painkiller72: folds 
nickreason17: folds 
OneTwo81: folds 
stockbridge8: folds 
pohorc21: folds 
torkkdnm: raises $1.50 to $2.50
Spid1: folds 
Kukuryzka: folds 
matiko09: folds 
Uncalled bet ($1.50) returned to torkkdnm
torkkdnm collected $2.50 from pot
*** SUMMARY ***
Total pot $2.50 | Rake $0 
Seat 1: Spid1 (button) folded before Flop (didn't bet)
Seat 2: Kukuryzka (small blind) folded before Flop
Seat 3: matiko09 (big blind) folded before Flop
Seat 4: Painkiller72 folded before Flop (didn't bet)
Seat 5: nickreason17 folded before Flop (didn't bet)
Seat 6: OneTwo81 folded before Flop (didn't bet)
Seat 7: stockbridge8 folded before Flop (didn't bet)
Seat 8: pohorc21 folded before Flop (didn't bet)
Seat 9: torkkdnm collected ($2.50)





PokerStars Hand #152884512130:  Hold'em No Limit ($1/$2 USD) - 2016/05/05 15:51:01 CET [2016/05/05 9:51:01 ET]
Table 'Euporie II' 9-max Seat #2 is the button
Seat 1: Durnichka ($90.95 in chips) 
Seat 2: nickreason17 ($200 in chips) 
Seat 3: Spid1 ($200 in chips) 
Seat 4: A91baer ($180 in chips) 
Seat 5: Nuskatko1986 ($171.01 in chips) 
Seat 6: glanza_mike ($200 in chips) 
Seat 7: matiko09 ($205 in chips) 
Seat 8: Painkiller72 ($200 in chips) 
Spid1: posts small blind $1
A91baer: posts big blind $2
T0ny Adams: sits out 
*** HOLE CARDS ***
Dealt to matiko09 [6d 8c]
Nuskatko1986: folds 
glanza_mike: folds 
matiko09: folds 
Painkiller72: folds 
Durnichka: folds 
nickreason17: folds 
Spid1: folds 
Uncalled bet ($1) returned to A91baer
A91baer collected $2 from pot
A91baer leaves the table
*** SUMMARY ***
Total pot $2 | Rake $0 
Seat 1: Durnichka folded before Flop (didn't bet)
Seat 2: nickreason17 (button) folded before Flop (didn't bet)
Seat 3: Spid1 (small blind) folded before Flop
Seat 4: A91baer (big blind) collected ($2)
Seat 5: Nuskatko1986 folded before Flop (didn't bet)
Seat 6: glanza_mike folded before Flop (didn't bet)
Seat 7: matiko09 folded before Flop (didn't bet)
Seat 8: Painkiller72 folded before Flop (didn't bet)





PokerStars Hand #152884512324:  Hold'em No Limit (€0.50/€1.00 EUR) - 2016/05/05 15:51:01 CET [2016/05/05 9:51:01 ET]
Table 'Carol II' 9-max Seat #1 is the button
Seat 1: vrnMike (€100 in chips) 
Seat 2: matiko09 (€100 in chips) 
Seat 4: Merlin_1905 (€76.25 in chips) 
Seat 5: Painkiller72 (€101.50 in chips) 
Seat 6: drissmouzou (€56.73 in chips) 
Seat 7: Spid1 (€100 in chips) 
Seat 9: Racushniak (€134.37 in chips) 
matiko09: posts small blind €0.50
Merlin_1905: posts big blind €1
*** HOLE CARDS ***
Dealt to matiko09 [Kh Kc]
Painkiller72: folds 
drissmouzou: raises €2 to €3
Spid1: folds 
Racushniak: folds 
vrnMike: calls €3
matiko09: raises €10 to €13
Merlin_1905: folds 
drissmouzou: folds 
vrnMike: folds 
Uncalled bet (€10) returned to matiko09
matiko09 collected €10 from pot
matiko09: doesn't show hand 
*** SUMMARY ***
Total pot €10 | Rake €0 
Seat 1: vrnMike (button) folded before Flop
Seat 2: matiko09 (small blind) collected (€10)
Seat 4: Merlin_1905 (big blind) folded before Flop
Seat 5: Painkiller72 folded before Flop (didn't bet)
Seat 6: drissmouzou folded before Flop
Seat 7: Spid1 folded before Flop (didn't bet)
Seat 9: Racushniak folded before Flop (didn't bet)





PokerStars Hand #152884512910:  Hold'em No Limit ($1/$2 USD) - 2016/05/05 15:51:02 CET [2016/05/05 9:51:02 ET]
Table 'Tololo' 9-max Seat #7 is the button
Seat 1: Kukuryzka ($203 in chips) 
Seat 2: gabi_igna ($240.39 in chips) 
Seat 3: nickreason17 ($232.22 in chips) 
Seat 4: mooose100 ($185.65 in chips) 
Seat 5: matiko09 ($208 in chips) 
Seat 6: Xagua ($121.83 in chips) 
Seat 7: Iggso ($205.25 in chips) 
Seat 8: KovIFish89 ($200 in chips) 
Seat 9: Fitzyferret ($287.99 in chips) 
KovIFish89: posts small blind $1
Fitzyferret: posts big blind $2
*** HOLE CARDS ***
Dealt to matiko09 [2s 4c]
Kukuryzka: folds 
gabi_igna: folds 
nickreason17: folds 
mooose100: folds 
matiko09: folds 
Xagua: folds 
Iggso: folds 
KovIFish89: raises $4 to $6
Fitzyferret: raises $12 to $18
KovIFish89: calls $12
*** FLOP *** [9h 6c Ts]
KovIFish89: checks 
Fitzyferret: bets $20
KovIFish89: calls $20
*** TURN *** [9h 6c Ts] [2d]
KovIFish89: checks 
Fitzyferret: bets $40
KovIFish89: folds 
Uncalled bet ($40) returned to Fitzyferret
Fitzyferret collected $73.25 from pot
Fitzyferret: doesn't show hand 
*** SUMMARY ***
Total pot $76 | Rake $2.75 
Board [9h 6c Ts 2d]
Seat 1: Kukuryzka folded before Flop (didn't bet)
Seat 2: gabi_igna folded before Flop (didn't bet)
Seat 3: nickreason17 folded before Flop (didn't bet)
Seat 4: mooose100 folded before Flop (didn't bet)
Seat 5: matiko09 folded before Flop (didn't bet)
Seat 6: Xagua folded before Flop (didn't bet)
Seat 7: Iggso (button) folded before Flop (didn't bet)
Seat 8: KovIFish89 (small blind) folded on the Turn
Seat 9: Fitzyferret (big blind) collected ($73.25)





PokerStars Hand #152884516339:  Hold'em No Limit ($0.50/$1.00 USD) - 2016/05/05 15:51:08 CET [2016/05/05 9:51:08 ET]
Table 'Lictoria II' 9-max Seat #6 is the button
Seat 1: St.LaCoste ($100 in chips) 
Seat 3: Krinica2009 ($104 in chips) 
Seat 4: Ying59 ($89.66 in chips) 
Seat 5: sanpidk ($131.76 in chips) 
Seat 6: gabi_igna ($122.07 in chips) 
Seat 7: Painkiller72 ($173.42 in chips) 
Seat 8: matiko09 ($104 in chips) 
Seat 9: Kukuryzka ($143.31 in chips) 
Painkiller72: posts small blind $0.50
matiko09: posts big blind $1
*** HOLE CARDS ***
Dealt to matiko09 [Ts 9h]
Kukuryzka: folds 
St.LaCoste: folds 
Krinica2009: folds 
Ying59: folds 
sanpidk: raises $1.50 to $2.50
gabi_igna: folds 
Painkiller72: raises $6 to $8.50
matiko09: folds 
sanpidk: calls $6
*** FLOP *** [4c Qd 4h]
Painkiller72: checks 
sanpidk: checks 
*** TURN *** [4c Qd 4h] [Ad]
Painkiller72: bets $11
sanpidk: calls $11
*** RIVER *** [4c Qd 4h Ad] [8s]
Painkiller72: checks 
sanpidk: checks 
*** SHOW DOWN ***
Painkiller72: shows [9c 9s] (two pair, Nines and Fours)
sanpidk: shows [Ks Qc] (two pair, Queens and Fours)
sanpidk collected $38 from pot
*** SUMMARY ***
Total pot $40 | Rake $2 
Board [4c Qd 4h Ad 8s]
Seat 1: St.LaCoste folded before Flop (didn't bet)
Seat 3: Krinica2009 folded before Flop (didn't bet)
Seat 4: Ying59 folded before Flop (didn't bet)
Seat 5: sanpidk showed [Ks Qc] and won ($38) with two pair, Queens and Fours
Seat 6: gabi_igna (button) folded before Flop (didn't bet)
Seat 7: Painkiller72 (small blind) showed [9c 9s] and lost with two pair, Nines and Fours
Seat 8: matiko09 (big blind) folded before Flop
Seat 9: Kukuryzka folded before Flop (didn't bet)





PokerStars Hand #152884517588:  Hold'em No Limit ($1/$2 USD) - 2016/05/05 15:51:10 CET [2016/05/05 9:51:10 ET]
Table 'Samitchell' 9-max Seat #9 is the button
Seat 1: KovIFish89 ($207.15 in chips) 
Seat 2: matiko09 ($200 in chips) 
Seat 3: gabi_igna ($311.32 in chips) 
Seat 4: Fitzyferret ($372.22 in chips) 
Seat 5: Spid1 ($204.60 in chips) 
Seat 6: nickreason17 ($212 in chips) 
Seat 7: patpaty ($171.84 in chips) 
Seat 8: Hex0gen ($199 in chips) 
Seat 9: kblkxls ($119.22 in chips) 
KovIFish89: posts small blind $1
matiko09: posts big blind $2
*** HOLE CARDS ***
Dealt to matiko09 [8d 6d]
gabi_igna: raises $4 to $6
Fitzyferret: folds 
Spid1: folds 
nickreason17: folds 
patpaty: folds 
Hex0gen: folds 
kblkxls: folds 
KovIFish89: folds 
matiko09: folds 
Uncalled bet ($4) returned to gabi_igna
gabi_igna collected $5 from pot
gabi_igna: doesn't show hand 
*** SUMMARY ***
Total pot $5 | Rake $0 
Seat 1: KovIFish89 (small blind) folded before Flop
Seat 2: matiko09 (big blind) folded before Flop
Seat 3: gabi_igna collected ($5)
Seat 4: Fitzyferret folded before Flop (didn't bet)
Seat 5: Spid1 folded before Flop (didn't bet)
Seat 6: nickreason17 folded before Flop (didn't bet)
Seat 7: patpaty folded before Flop (didn't bet)
Seat 8: Hex0gen folded before Flop (didn't bet)
Seat 9: kblkxls (button) folded before Flop (didn't bet)





PokerStars Hand #152884518154:  Hold'em No Limit ($0.50/$1.00 USD) - 2016/05/05 15:51:11 CET [2016/05/05 9:51:11 ET]
Table 'Luthera' 9-max Seat #5 is the button
Seat 1: MrMattkk ($74.92 in chips) 
Seat 2: Spid1 ($100.50 in chips) 
Seat 3: ipashutapkom ($103.46 in chips) 
Seat 4: matiko09 ($102.25 in chips) 
Seat 5: Painkiller72 ($100 in chips) 
Seat 7: Chin41178 ($97.50 in chips) 
Seat 8: xdrKush420x ($98 in chips) 
Seat 9: vrnMike ($101 in chips) 
Chin41178: posts small blind $0.50
xdrKush420x: posts big blind $1
*** HOLE CARDS ***
Dealt to matiko09 [2h 9h]
vrnMike: folds 
MrMattkk: folds 
Spid1: folds 
ipashutapkom: raises $1.26 to $2.26
matiko09: folds 
Painkiller72: folds 
Chin41178: folds 
xdrKush420x: folds 
Uncalled bet ($1.26) returned to ipashutapkom
ipashutapkom collected $2.50 from pot
ipashutapkom: doesn't show hand 
*** SUMMARY ***
Total pot $2.50 | Rake $0 
Seat 1: MrMattkk folded before Flop (didn't bet)
Seat 2: Spid1 folded before Flop (didn't bet)
Seat 3: ipashutapkom collected ($2.50)
Seat 4: matiko09 folded before Flop (didn't bet)
Seat 5: Painkiller72 (button) folded before Flop (didn't bet)
Seat 7: Chin41178 (small blind) folded before Flop
Seat 8: xdrKush420x (big blind) folded before Flop
Seat 9: vrnMike folded before Flop (didn't bet)





PokerStars Hand #152884519356:  Hold'em No Limit ($0.50/$1.00 USD) - 2016/05/05 15:51:13 CET [2016/05/05 9:51:13 ET]
Table 'Musa II' 9-max Seat #8 is the button
Seat 1: KovIFish89 ($207.97 in chips) 
Seat 3: vrnMike ($110.38 in chips) 
Seat 4: sanpidk ($101.20 in chips) 
Seat 5: Chin41178 ($98.50 in chips) 
Seat 6: cnn123 ($59.74 in chips) 
Seat 7: Painkiller72 ($100 in chips) 
Seat 8: matiko09 ($100 in chips) 
Seat 9: antfurto ($90.68 in chips) 
antfurto: posts small blind $0.50
KovIFish89: posts big blind $1
koutani7: sits out 
*** HOLE CARDS ***
Dealt to matiko09 [3h 6h]
vrnMike: folds 
sanpidk: folds 
Chin41178: folds 
cnn123: folds 
Painkiller72: folds 
matiko09: folds 
antfurto: folds 
Uncalled bet ($0.50) returned to KovIFish89
KovIFish89 collected $1 from pot
KovIFish89: doesn't show hand 
*** SUMMARY ***
Total pot $1 | Rake $0 
Seat 1: KovIFish89 (big blind) collected ($1)
Seat 3: vrnMike folded before Flop (didn't bet)
Seat 4: sanpidk folded before Flop (didn't bet)
Seat 5: Chin41178 folded before Flop (didn't bet)
Seat 6: cnn123 folded before Flop (didn't bet)
Seat 7: Painkiller72 folded before Flop (didn't bet)
Seat 8: matiko09 (button) folded before Flop (didn't bet)
Seat 9: antfurto (small blind) folded before Flop





PokerStars Hand #152884523680:  Hold'em No Limit ($0.50/$1.00 USD) - 2016/05/05 15:51:21 CET [2016/05/05 9:51:21 ET]
Table 'Priska II' 9-max Seat #2 is the button
Seat 1: Spid1 ($112.85 in chips) 
Seat 2: Kukuryzka ($127.52 in chips) 
Seat 3: matiko09 ($100.50 in chips) 
Seat 4: Painkiller72 ($157.34 in chips) 
Seat 5: nickreason17 ($175.55 in chips) 
Seat 6: OneTwo81 ($92.11 in chips) 
Seat 7: stockbridge8 ($89.27 in chips) 
Seat 8: pohorc21 ($67.41 in chips) 
Seat 9: torkkdnm ($104.50 in chips) 
matiko09: posts small blind $0.50
Painkiller72: posts big blind $1
*** HOLE CARDS ***
Dealt to matiko09 [7s Tc]
nickreason17: raises $1.50 to $2.50
OneTwo81: folds 
stockbridge8: folds 
pohorc21: folds 
torkkdnm: folds 
Spid1: folds 
Kukuryzka: raises $7.50 to $10
matiko09: folds 
Painkiller72: folds 
nickreason17: folds 
Uncalled bet ($7.50) returned to Kukuryzka
Kukuryzka collected $6.50 from pot
Kukuryzka: doesn't show hand 
*** SUMMARY ***
Total pot $6.50 | Rake $0 
Seat 1: Spid1 folded before Flop (didn't bet)
Seat 2: Kukuryzka (button) collected ($6.50)
Seat 3: matiko09 (small blind) folded before Flop
Seat 4: Painkiller72 (big blind) folded before Flop
Seat 5: nickreason17 folded before Flop
Seat 6: OneTwo81 folded before Flop (didn't bet)
Seat 7: stockbridge8 folded before Flop (didn't bet)
Seat 8: pohorc21 folded before Flop (didn't bet)
Seat 9: torkkdnm folded before Flop (didn't bet)





PokerStars Hand #152884532244:  Hold'em No Limit ($0.50/$1.00 USD) - 2016/05/05 15:51:36 CET [2016/05/05 9:51:36 ET]
Table 'Luthera' 9-max Seat #7 is the button
Seat 1: MrMattkk ($74.92 in chips) 
Seat 2: Spid1 ($100.50 in chips) 
Seat 3: ipashutapkom ($104.96 in chips) 
Seat 4: matiko09 ($102.25 in chips) 
Seat 5: Painkiller72 ($100 in chips) 
Seat 7: Chin41178 ($97 in chips) 
Seat 8: xdrKush420x ($97 in chips) 
Seat 9: vrnMike ($101 in chips) 
xdrKush420x: posts small blind $0.50
vrnMike: posts big blind $1
*** HOLE CARDS ***
Dealt to matiko09 [8s 3s]
MrMattkk: calls $1
Spid1: folds 
ipashutapkom: raises $3.50 to $4.50
matiko09: folds 
Painkiller72: folds 
Chin41178: folds 
xdrKush420x: folds 
vrnMike: folds 
MrMattkk: calls $3.50
*** FLOP *** [4c Ts 9s]
MrMattkk: checks 
ipashutapkom: bets $9.19
MrMattkk: calls $9.19
*** TURN *** [4c Ts 9s] [As]
MrMattkk: checks 
ipashutapkom: bets $19.88
MrMattkk: raises $41.35 to $61.23 and is all-in
ipashutapkom: folds 
Uncalled bet ($41.35) returned to MrMattkk
MrMattkk collected $66.14 from pot
MrMattkk: doesn't show hand 
*** SUMMARY ***
Total pot $68.64 | Rake $2.50 
Board [4c Ts 9s As]
Seat 1: MrMattkk collected ($66.14)
Seat 2: Spid1 folded before Flop (didn't bet)
Seat 3: ipashutapkom folded on the Turn
Seat 4: matiko09 folded before Flop (didn't bet)
Seat 5: Painkiller72 folded before Flop (didn't bet)
Seat 7: Chin41178 (button) folded before Flop (didn't bet)
Seat 8: xdrKush420x (small blind) folded before Flop
Seat 9: vrnMike (big blind) folded before Flop





PokerStars Hand #152884532613:  Hold'em No Limit ($1/$2 USD) - 2016/05/05 15:51:37 CET [2016/05/05 9:51:37 ET]
Table 'Euporie II' 9-max Seat #3 is the button
Seat 1: Durnichka ($90.95 in chips) 
Seat 2: nickreason17 ($200 in chips) 
Seat 3: Spid1 ($200 in chips) 
Seat 5: Nuskatko1986 ($171.01 in chips) 
Seat 6: glanza_mike ($200 in chips) 
Seat 7: matiko09 ($205 in chips) 
Seat 8: Painkiller72 ($200 in chips) 
Nuskatko1986: posts small blind $1
glanza_mike: posts big blind $2
T0ny Adams: sits out 
*** HOLE CARDS ***
Dealt to matiko09 [Js 9c]
matiko09: folds 
Painkiller72: folds 
Durnichka: raises $3 to $5
nickreason17: folds 
Spid1: folds 
Nuskatko1986: calls $4
Kukuryzka joins the table at seat #4 
glanza_mike: calls $3
*** FLOP *** [3h Qd 6h]
Nuskatko1986: checks 
glanza_mike: checks 
Durnichka: bets $5
Nuskatko1986: calls $5
glanza_mike: raises $12.50 to $17.50
Durnichka: calls $12.50
Nuskatko1986: folds 
*** TURN *** [3h Qd 6h] [Ad]
glanza_mike: bets $37.88
Durnichka: raises $30.57 to $68.45 and is all-in
glanza_mike said, "fking drown u skortstacking piece of SH1T"
glanza_mike: calls $30.57
*** RIVER *** [3h Qd 6h Ad] [4d]
*** SHOW DOWN ***
glanza_mike: shows [4c 5c] (a pair of Fours)
Durnichka: shows [Qh Qc] (three of a kind, Queens)
Durnichka collected $189.15 from pot
*** SUMMARY ***
Total pot $191.90 | Rake $2.75 
Board [3h Qd 6h Ad 4d]
Seat 1: Durnichka showed [Qh Qc] and won ($189.15) with three of a kind, Queens
Seat 2: nickreason17 folded before Flop (didn't bet)
Seat 3: Spid1 (button) folded before Flop (didn't bet)
Seat 5: Nuskatko1986 (small blind) folded on the Flop
Seat 6: glanza_mike (big blind) showed [4c 5c] and lost with a pair of Fours
Seat 7: matiko09 folded before Flop (didn't bet)
Seat 8: Painkiller72 folded before Flop (didn't bet)





PokerStars Hand #152884534696:  Hold'em No Limit ($1/$2 USD) - 2016/05/05 15:51:40 CET [2016/05/05 9:51:40 ET]
Table 'Lundia' 9-max Seat #8 is the button
Seat 1: Fitzyferret ($200 in chips) 
Seat 2: patpaty ($193.10 in chips) 
Seat 4: KovIFish89 ($200 in chips) 
Seat 5: zmOe84 ($193 in chips) 
Seat 6: Spid1 ($252.39 in chips) 
Seat 7: matiko09 ($248.11 in chips) 
Seat 8: Durnichka ($84 in chips) 
Seat 9: gabi_igna ($276.36 in chips) 
gabi_igna: posts small blind $1
Fitzyferret: posts big blind $2
Painkiller72: sits out 
*** HOLE CARDS ***
Dealt to matiko09 [9d Td]
patpaty: folds 
KovIFish89: folds 
zmOe84: folds 
Spid1: folds 
matiko09: raises $3 to $5
Durnichka: folds 
gabi_igna: folds 
Fitzyferret: folds 
Uncalled bet ($3) returned to matiko09
matiko09 collected $5 from pot
matiko09: doesn't show hand 
*** SUMMARY ***
Total pot $5 | Rake $0 
Seat 1: Fitzyferret (big blind) folded before Flop
Seat 2: patpaty folded before Flop (didn't bet)
Seat 4: KovIFish89 folded before Flop (didn't bet)
Seat 5: zmOe84 folded before Flop (didn't bet)
Seat 6: Spid1 folded before Flop (didn't bet)
Seat 7: matiko09 collected ($5)
Seat 8: Durnichka (button) folded before Flop (didn't bet)
Seat 9: gabi_igna (small blind) folded before Flop





PokerStars Hand #152884534740:  Hold'em No Limit ($0.50/$1.00 USD) - 2016/05/05 15:51:40 CET [2016/05/05 9:51:40 ET]
Table 'Musa II' 9-max Seat #9 is the button
Seat 1: KovIFish89 ($208.47 in chips) 
Seat 2: koutani7 ($100 in chips) 
Seat 3: vrnMike ($110.38 in chips) 
Seat 4: sanpidk ($101.20 in chips) 
Seat 5: Chin41178 ($98.50 in chips) 
Seat 6: cnn123 ($59.74 in chips) 
Seat 7: Painkiller72 ($100 in chips) 
Seat 8: matiko09 ($100 in chips) 
Seat 9: antfurto ($90.18 in chips) 
KovIFish89: posts small blind $0.50
koutani7: posts big blind $1
*** HOLE CARDS ***
Dealt to matiko09 [Td Js]
vrnMike: folds 
sanpidk: folds 
Chin41178: folds 
cnn123: raises $2 to $3
Painkiller72: folds 
matiko09: folds 
antfurto: folds 
KovIFish89: folds 
koutani7: folds 
Uncalled bet ($2) returned to cnn123
cnn123 collected $2.50 from pot
cnn123: doesn't show hand 
*** SUMMARY ***
Total pot $2.50 | Rake $0 
Seat 1: KovIFish89 (small blind) folded before Flop
Seat 2: koutani7 (big blind) folded before Flop
Seat 3: vrnMike folded before Flop (didn't bet)
Seat 4: sanpidk folded before Flop (didn't bet)
Seat 5: Chin41178 folded before Flop (didn't bet)
Seat 6: cnn123 collected ($2.50)
Seat 7: Painkiller72 folded before Flop (didn't bet)
Seat 8: matiko09 folded before Flop (didn't bet)
Seat 9: antfurto (button) folded before Flop (didn't bet)





PokerStars Hand #152884534915:  Hold'em No Limit (€0.50/€1.00 EUR) - 2016/05/05 15:51:41 CET [2016/05/05 9:51:41 ET]
Table 'Carol II' 9-max Seat #2 is the button
Seat 1: vrnMike (€100 in chips) 
Seat 2: matiko09 (€107 in chips) 
Seat 4: Merlin_1905 (€75.25 in chips) 
Seat 5: Painkiller72 (€101.50 in chips) 
Seat 6: drissmouzou (€53.73 in chips) 
Seat 7: Spid1 (€100 in chips) 
Seat 9: Racushniak (€134.37 in chips) 
Merlin_1905: posts small blind €0.50
Painkiller72: posts big blind €1
*** HOLE CARDS ***
Dealt to matiko09 [6s 3d]
drissmouzou: folds 
Spid1: folds 
Racushniak: folds 
vrnMike: folds 
matiko09: folds 
Merlin_1905: calls €0.50
drissmouzou leaves the table
Painkiller72: checks 
*** FLOP *** [9h As Ac]
Kukuryzka joins the table at seat #6 
Merlin_1905: checks 
Painkiller72: checks 
*** TURN *** [9h As Ac] [9d]
Merlin_1905: bets €1
Painkiller72: folds 
Uncalled bet (€1) returned to Merlin_1905
Merlin_1905 collected €1.90 from pot
Merlin_1905: doesn't show hand 
*** SUMMARY ***
Total pot €2 | Rake €0.10 
Board [9h As Ac 9d]
Seat 1: vrnMike folded before Flop (didn't bet)
Seat 2: matiko09 (button) folded before Flop (didn't bet)
Seat 4: Merlin_1905 (small blind) collected (€1.90)
Seat 5: Painkiller72 (big blind) folded on the Turn
Seat 6: drissmouzou folded before Flop (didn't bet)
Seat 7: Spid1 folded before Flop (didn't bet)
Seat 9: Racushniak folded before Flop (didn't bet)





PokerStars Hand #152884537800:  Hold'em No Limit ($0.50/$1.00 USD) - 2016/05/05 15:51:46 CET [2016/05/05 9:51:46 ET]
Table 'Pyxis III' 9-max Seat #7 is the button
Seat 1: sanpidk ($189.74 in chips) 
Seat 3: vrnMike ($100 in chips) 
Seat 5: darren1031 ($97.10 in chips) 
Seat 6: kamillo91 ($87 in chips) 
Seat 7: mycka86 ($100 in chips) 
Seat 8: matiko09 ($106.25 in chips) 
Seat 9: Hypoaroused ($175.48 in chips) 
matiko09: posts small blind $0.50
Hypoaroused: posts big blind $1
*** HOLE CARDS ***
Dealt to matiko09 [3h 6d]
sanpidk: folds 
vrnMike: folds 
darren1031: folds 
kamillo91: folds 
mycka86: raises $1.10 to $2.10
matiko09: folds 
SPmaka joins the table at seat #2 
Hypoaroused: folds 
Uncalled bet ($1.10) returned to mycka86
mycka86 collected $2.50 from pot
*** SUMMARY ***
Total pot $2.50 | Rake $0 
Seat 1: sanpidk folded before Flop (didn't bet)
Seat 3: vrnMike folded before Flop (didn't bet)
Seat 5: darren1031 folded before Flop (didn't bet)
Seat 6: kamillo91 folded before Flop (didn't bet)
Seat 7: mycka86 (button) collected ($2.50)
Seat 8: matiko09 (small blind) folded before Flop
Seat 9: Hypoaroused (big blind) folded before Flop





PokerStars Hand #152884542072:  Hold'em No Limit ($0.50/$1.00 USD) - 2016/05/05 15:51:53 CET [2016/05/05 9:51:53 ET]
Table 'Natascha' 9-max Seat #7 is the button
Seat 1: ronald3737 ($105.43 in chips) 
Seat 2: matiko09 ($131.03 in chips) 
Seat 3: bjonlyking ($126.70 in chips) 
Seat 4: sanpidk ($128.31 in chips) 
Seat 6: gabi_igna ($149.62 in chips) 
Seat 7: torkkdnm ($149.25 in chips) 
Seat 8: kamillo91 ($55.99 in chips) 
Seat 9: guoweiAA ($232.22 in chips) 
kamillo91: posts small blind $0.50
guoweiAA: posts big blind $1
*** HOLE CARDS ***
Dealt to matiko09 [9s 5s]
ronald3737: raises $1 to $2
matiko09: folds 
bjonlyking: folds 
sanpidk: folds 
gabi_igna: folds 
torkkdnm: folds 
kamillo91: raises $2 to $4
guoweiAA: folds 
ronald3737: calls $2
*** FLOP *** [8c 8d 3s]
kamillo91: checks 
ronald3737: bets $6
kamillo91: calls $6
*** TURN *** [8c 8d 3s] [As]
kamillo91: bets $4
ronald3737: calls $4
*** RIVER *** [8c 8d 3s As] [6s]
kamillo91: bets $5
ronald3737: calls $5
*** SHOW DOWN ***
kamillo91: shows [Ks Kc] (two pair, Kings and Eights)
ronald3737: shows [Tc Ad] (two pair, Aces and Eights)
ronald3737 collected $37.05 from pot
*** SUMMARY ***
Total pot $39 | Rake $1.95 
Board [8c 8d 3s As 6s]
Seat 1: ronald3737 showed [Tc Ad] and won ($37.05) with two pair, Aces and Eights
Seat 2: matiko09 folded before Flop (didn't bet)
Seat 3: bjonlyking folded before Flop (didn't bet)
Seat 4: sanpidk folded before Flop (didn't bet)
Seat 6: gabi_igna folded before Flop (didn't bet)
Seat 7: torkkdnm (button) folded before Flop (didn't bet)
Seat 8: kamillo91 (small blind) showed [Ks Kc] and lost with two pair, Kings and Eights
Seat 9: guoweiAA (big blind) folded before Flop





PokerStars Hand #152884542117:  Hold'em No Limit ($1/$2 USD) - 2016/05/05 15:51:53 CET [2016/05/05 9:51:53 ET]
Table 'Samitchell' 9-max Seat #1 is the button
Seat 1: KovIFish89 ($206.15 in chips) 
Seat 2: matiko09 ($200 in chips) 
Seat 3: gabi_igna ($314.32 in chips) 
Seat 4: Fitzyferret ($372.22 in chips) 
Seat 5: Spid1 ($204.60 in chips) 
Seat 6: nickreason17 ($212 in chips) 
Seat 7: patpaty ($171.84 in chips) 
Seat 8: Hex0gen ($199 in chips) 
Seat 9: kblkxls ($119.22 in chips) 
matiko09: posts small blind $1
gabi_igna: posts big blind $2
*** HOLE CARDS ***
Dealt to matiko09 [2h Qd]
Fitzyferret: folds 
Spid1: folds 
nickreason17: folds 
patpaty: folds 
Hex0gen: folds 
Hex0gen leaves the table
kblkxls: folds 
KovIFish89: folds 
WolleMalone joins the table at seat #8 
matiko09: folds 
Uncalled bet ($1) returned to gabi_igna
gabi_igna collected $2 from pot
gabi_igna: doesn't show hand 
*** SUMMARY ***
Total pot $2 | Rake $0 
Seat 1: KovIFish89 (button) folded before Flop (didn't bet)
Seat 2: matiko09 (small blind) folded before Flop
Seat 3: gabi_igna (big blind) collected ($2)
Seat 4: Fitzyferret folded before Flop (didn't bet)
Seat 5: Spid1 folded before Flop (didn't bet)
Seat 6: nickreason17 folded before Flop (didn't bet)
Seat 7: patpaty folded before Flop (didn't bet)
Seat 8: Hex0gen folded before Flop (didn't bet)
Seat 9: kblkxls folded before Flop (didn't bet)





PokerStars Hand #152884549508:  Hold'em No Limit ($0.50/$1.00 USD) - 2016/05/05 15:52:06 CET [2016/05/05 9:52:06 ET]
Table 'Priska II' 9-max Seat #3 is the button
Seat 1: Spid1 ($112.85 in chips) 
Seat 2: Kukuryzka ($131.52 in chips) 
Seat 3: matiko09 ($100 in chips) 
Seat 4: Painkiller72 ($156.34 in chips) 
Seat 5: nickreason17 ($173.05 in chips) 
Seat 6: OneTwo81 ($92.11 in chips) 
Seat 7: stockbridge8 ($89.27 in chips) 
Seat 8: pohorc21 ($67.41 in chips) 
Seat 9: torkkdnm ($104.50 in chips) 
Painkiller72: posts small blind $0.50
nickreason17: posts big blind $1
*** HOLE CARDS ***
Dealt to matiko09 [6d Ac]
OneTwo81: folds 
stockbridge8: folds 
OneTwo81 leaves the table
St.LaCoste joins the table at seat #6 
pohorc21: calls $1
torkkdnm: raises $3 to $4
Spid1: folds 
Kukuryzka: folds 
matiko09: folds 
Painkiller72: folds 
nickreason17: folds 
pohorc21: calls $3
*** FLOP *** [3c Ks 2c]
pohorc21: bets $5
torkkdnm: folds 
Uncalled bet ($5) returned to pohorc21
pohorc21 collected $9.02 from pot
pohorc21: doesn't show hand 
*** SUMMARY ***
Total pot $9.50 | Rake $0.48 
Board [3c Ks 2c]
Seat 1: Spid1 folded before Flop (didn't bet)
Seat 2: Kukuryzka folded before Flop (didn't bet)
Seat 3: matiko09 (button) folded before Flop (didn't bet)
Seat 4: Painkiller72 (small blind) folded before Flop
Seat 5: nickreason17 (big blind) folded before Flop
Seat 6: OneTwo81 folded before Flop (didn't bet)
Seat 7: stockbridge8 folded before Flop (didn't bet)
Seat 8: pohorc21 collected ($9.02)
Seat 9: torkkdnm folded on the Flop





PokerStars Hand #152884551032:  Hold'em No Limit ($0.50/$1.00 USD) - 2016/05/05 15:52:09 CET [2016/05/05 9:52:09 ET]
Table 'Musa II' 9-max Seat #1 is the button
Seat 1: KovIFish89 ($207.97 in chips) 
Seat 2: koutani7 ($99 in chips) 
Seat 3: vrnMike ($110.38 in chips) 
Seat 4: sanpidk ($101.20 in chips) 
Seat 5: Chin41178 ($98.50 in chips) 
Seat 6: cnn123 ($61.24 in chips) 
Seat 7: Painkiller72 ($100 in chips) 
Seat 8: matiko09 ($100 in chips) 
Seat 9: antfurto ($90.18 in chips) 
koutani7: posts small blind $0.50
vrnMike: posts big blind $1
*** HOLE CARDS ***
Dealt to matiko09 [Qc 7s]
sanpidk: folds 
Chin41178: raises $2 to $3
cnn123: folds 
Painkiller72: folds 
matiko09: folds 
antfurto: folds 
KovIFish89: folds 
koutani7: folds 
vrnMike: folds 
Uncalled bet ($2) returned to Chin41178
Chin41178 collected $2.50 from pot
Chin41178: doesn't show hand 
*** SUMMARY ***
Total pot $2.50 | Rake $0 
Seat 1: KovIFish89 (button) folded before Flop (didn't bet)
Seat 2: koutani7 (small blind) folded before Flop
Seat 3: vrnMike (big blind) folded before Flop
Seat 4: sanpidk folded before Flop (didn't bet)
Seat 5: Chin41178 collected ($2.50)
Seat 6: cnn123 folded before Flop (didn't bet)
Seat 7: Painkiller72 folded before Flop (didn't bet)
Seat 8: matiko09 folded before Flop (didn't bet)
Seat 9: antfurto folded before Flop (didn't bet)





PokerStars Hand #152884555243:  Hold'em No Limit ($0.50/$1.00 USD) - 2016/05/05 15:52:16 CET [2016/05/05 9:52:16 ET]
Table 'Pyxis III' 9-max Seat #8 is the button
Seat 1: sanpidk ($189.74 in chips) 
Seat 3: vrnMike ($100 in chips) 
Seat 5: darren1031 ($97.10 in chips) 
Seat 6: kamillo91 ($87 in chips) 
Seat 7: mycka86 ($101.50 in chips) 
Seat 8: matiko09 ($105.75 in chips) 
Seat 9: Hypoaroused ($174.48 in chips) 
Hypoaroused: posts small blind $0.50
sanpidk: posts big blind $1
SPmaka: sits out 
*** HOLE CARDS ***
Dealt to matiko09 [8d Td]
vrnMike: folds 
darren1031: folds 
kamillo91: folds 
mycka86: raises $1.10 to $2.10
matiko09: folds 
Hypoaroused: calls $1.60
sanpidk: calls $1.10
*** FLOP *** [6c Ad 4c]
Hypoaroused: checks 
sanpidk: checks 
mycka86: bets $4.50
Hypoaroused: folds 
sanpidk: folds 
Uncalled bet ($4.50) returned to mycka86
mycka86 collected $5.98 from pot
*** SUMMARY ***
Total pot $6.30 | Rake $0.32 
Board [6c Ad 4c]
Seat 1: sanpidk (big blind) folded on the Flop
Seat 3: vrnMike folded before Flop (didn't bet)
Seat 5: darren1031 folded before Flop (didn't bet)
Seat 6: kamillo91 folded before Flop (didn't bet)
Seat 7: mycka86 collected ($5.98)
Seat 8: matiko09 (button) folded before Flop (didn't bet)
Seat 9: Hypoaroused (small blind) folded on the Flop





PokerStars Hand #152884556964:  Hold'em No Limit ($1/$2 USD) - 2016/05/05 15:52:19 CET [2016/05/05 9:52:19 ET]
Table 'Tololo' 9-max Seat #8 is the button
Seat 1: Kukuryzka ($203 in chips) 
Seat 2: gabi_igna ($240.39 in chips) 
Seat 3: nickreason17 ($232.22 in chips) 
Seat 4: mooose100 ($185.65 in chips) 
Seat 5: matiko09 ($208 in chips) 
Seat 6: Xagua ($121.83 in chips) 
Seat 7: Iggso ($205.25 in chips) 
Seat 8: KovIFish89 ($200 in chips) 
Seat 9: Fitzyferret ($323.24 in chips) 
Fitzyferret: posts small blind $1
Kukuryzka: posts big blind $2
*** HOLE CARDS ***
Dealt to matiko09 [7d 3h]
gabi_igna: folds 
nickreason17: folds 
mooose100: calls $2
matiko09: folds 
Xagua: raises $3 to $5
Iggso: folds 
KovIFish89: folds 
Fitzyferret: folds 
Kukuryzka: folds 
mooose100: folds 
Uncalled bet ($3) returned to Xagua
Xagua collected $7 from pot
Xagua: doesn't show hand 
*** SUMMARY ***
Total pot $7 | Rake $0 
Seat 1: Kukuryzka (big blind) folded before Flop
Seat 2: gabi_igna folded before Flop (didn't bet)
Seat 3: nickreason17 folded before Flop (didn't bet)
Seat 4: mooose100 folded before Flop
Seat 5: matiko09 folded before Flop (didn't bet)
Seat 6: Xagua collected ($7)
Seat 7: Iggso folded before Flop (didn't bet)
Seat 8: KovIFish89 (button) folded before Flop (didn't bet)
Seat 9: Fitzyferret (small blind) folded before Flop





PokerStars Hand #152884558350:  Hold'em No Limit ($1/$2 USD) - 2016/05/05 15:52:22 CET [2016/05/05 9:52:22 ET]
Table 'Lundia' 9-max Seat #9 is the button
Seat 1: Fitzyferret ($200 in chips) 
Seat 2: patpaty ($193.10 in chips) 
Seat 4: KovIFish89 ($200 in chips) 
Seat 5: zmOe84 ($193 in chips) 
Seat 6: Spid1 ($252.39 in chips) 
Seat 7: matiko09 ($251.11 in chips) 
Seat 8: Durnichka ($84 in chips) 
Seat 9: gabi_igna ($275.36 in chips) 
Fitzyferret: posts small blind $1
patpaty: posts big blind $2
Painkiller72: sits out 
*** HOLE CARDS ***
Dealt to matiko09 [As 6c]
KovIFish89: folds 
zmOe84: folds 
Spid1: folds 
matiko09: folds 
Durnichka: folds 
gabi_igna: folds 
Fitzyferret: folds 
Uncalled bet ($1) returned to patpaty
patpaty collected $2 from pot
patpaty: doesn't show hand 
*** SUMMARY ***
Total pot $2 | Rake $0 
Seat 1: Fitzyferret (small blind) folded before Flop
Seat 2: patpaty (big blind) collected ($2)
Seat 4: KovIFish89 folded before Flop (didn't bet)
Seat 5: zmOe84 folded before Flop (didn't bet)
Seat 6: Spid1 folded before Flop (didn't bet)
Seat 7: matiko09 folded before Flop (didn't bet)
Seat 8: Durnichka folded before Flop (didn't bet)
Seat 9: gabi_igna (button) folded before Flop (didn't bet)





PokerStars Hand #152884559901:  Hold'em No Limit ($1/$2 USD) - 2016/05/05 15:52:24 CET [2016/05/05 9:52:24 ET]
Table 'Samitchell' 9-max Seat #2 is the button
Seat 1: KovIFish89 ($206.15 in chips) 
Seat 2: matiko09 ($200 in chips) 
Seat 3: gabi_igna ($315.32 in chips) 
Seat 4: Fitzyferret ($372.22 in chips) 
Seat 5: Spid1 ($204.60 in chips) 
Seat 6: nickreason17 ($212 in chips) 
Seat 7: patpaty ($171.84 in chips) 
Seat 9: kblkxls ($119.22 in chips) 
gabi_igna: posts small blind $1
Fitzyferret: posts big blind $2
WolleMalone: sits out 
*** HOLE CARDS ***
Dealt to matiko09 [3h 4s]
Spid1: folds 
nickreason17: folds 
patpaty: folds 
kblkxls: raises $4 to $6
KovIFish89: folds 
matiko09: folds 
gabi_igna: folds 
Fitzyferret: folds 
Uncalled bet ($4) returned to kblkxls
kblkxls collected $5 from pot
kblkxls: doesn't show hand 
*** SUMMARY ***
Total pot $5 | Rake $0 
Seat 1: KovIFish89 folded before Flop (didn't bet)
Seat 2: matiko09 (button) folded before Flop (didn't bet)
Seat 3: gabi_igna (small blind) folded before Flop
Seat 4: Fitzyferret (big blind) folded before Flop
Seat 5: Spid1 folded before Flop (didn't bet)
Seat 6: nickreason17 folded before Flop (didn't bet)
Seat 7: patpaty folded before Flop (didn't bet)
Seat 9: kblkxls collected ($5)





PokerStars Hand #152884563087:  Hold'em No Limit (€0.50/€1.00 EUR) - 2016/05/05 15:52:30 CET [2016/05/05 9:52:30 ET]
Table 'Carol II' 9-max Seat #4 is the button
Seat 1: vrnMike (€100 in chips) 
Seat 2: matiko09 (€107 in chips) 
Seat 4: Merlin_1905 (€76.15 in chips) 
Seat 5: Painkiller72 (€100.50 in chips) 
Seat 6: Kukuryzka (€100 in chips) 
Seat 7: Spid1 (€100 in chips) 
Seat 9: Racushniak (€134.37 in chips) 
Painkiller72: posts small blind €0.50
Kukuryzka: posts big blind €1
*** HOLE CARDS ***
Dealt to matiko09 [8d Js]
Spid1: folds 
Racushniak: folds 
vrnMike: raises €1 to €2
matiko09: folds 
Merlin_1905: folds 
Painkiller72: folds 
Kukuryzka: calls €1
*** FLOP *** [7h Ts 9c]
Kukuryzka: checks 
vrnMike: bets €2
Kukuryzka: calls €2
*** TURN *** [7h Ts 9c] [6c]
Kukuryzka: checks 
vrnMike: bets €10
Kukuryzka: folds 
Uncalled bet (€10) returned to vrnMike
vrnMike collected €8.08 from pot
*** SUMMARY ***
Total pot €8.50 | Rake €0.42 
Board [7h Ts 9c 6c]
Seat 1: vrnMike collected (€8.08)
Seat 2: matiko09 folded before Flop (didn't bet)
Seat 4: Merlin_1905 (button) folded before Flop (didn't bet)
Seat 5: Painkiller72 (small blind) folded before Flop
Seat 6: Kukuryzka (big blind) folded on the Turn
Seat 7: Spid1 folded before Flop (didn't bet)
Seat 9: Racushniak folded before Flop (didn't bet)





PokerStars Hand #152884568631:  Hold'em No Limit ($0.50/$1.00 USD) - 2016/05/05 15:52:39 CET [2016/05/05 9:52:39 ET]
Table 'Musa II' 9-max Seat #2 is the button
Seat 1: KovIFish89 ($207.97 in chips) 
Seat 2: koutani7 ($98.50 in chips) 
Seat 3: vrnMike ($109.38 in chips) 
Seat 4: sanpidk ($101.20 in chips) 
Seat 5: Chin41178 ($100 in chips) 
Seat 6: cnn123 ($61.24 in chips) 
Seat 7: Painkiller72 ($100 in chips) 
Seat 8: matiko09 ($100 in chips) 
Seat 9: antfurto ($90.18 in chips) 
vrnMike: posts small blind $0.50
sanpidk: posts big blind $1
*** HOLE CARDS ***
Dealt to matiko09 [Ac 4h]
Chin41178: folds 
cnn123: folds 
Painkiller72: folds 
matiko09: folds 
antfurto: folds 
KovIFish89: raises $1.50 to $2.50
koutani7: folds 
vrnMike: folds 
sanpidk: folds 
Uncalled bet ($1.50) returned to KovIFish89
KovIFish89 collected $2.50 from pot
KovIFish89: doesn't show hand 
*** SUMMARY ***
Total pot $2.50 | Rake $0 
Seat 1: KovIFish89 collected ($2.50)
Seat 2: koutani7 (button) folded before Flop (didn't bet)
Seat 3: vrnMike (small blind) folded before Flop
Seat 4: sanpidk (big blind) folded before Flop
Seat 5: Chin41178 folded before Flop (didn't bet)
Seat 6: cnn123 folded before Flop (didn't bet)
Seat 7: Painkiller72 folded before Flop (didn't bet)
Seat 8: matiko09 folded before Flop (didn't bet)
Seat 9: antfurto folded before Flop (didn't bet)





PokerStars Hand #152884569708:  Hold'em No Limit ($1/$2 USD) - 2016/05/05 15:52:41 CET [2016/05/05 9:52:41 ET]
Table 'Lundia' 9-max Seat #1 is the button
Seat 1: Fitzyferret ($200 in chips) 
Seat 2: patpaty ($194.10 in chips) 
Seat 3: Painkiller72 ($200 in chips) 
Seat 4: KovIFish89 ($200 in chips) 
Seat 5: zmOe84 ($193 in chips) 
Seat 6: Spid1 ($252.39 in chips) 
Seat 7: matiko09 ($251.11 in chips) 
Seat 8: Durnichka ($84 in chips) 
Seat 9: gabi_igna ($275.36 in chips) 
patpaty: posts small blind $1
Painkiller72: posts big blind $2
*** HOLE CARDS ***
Dealt to matiko09 [9c 5d]
KovIFish89: folds 
zmOe84: folds 
Spid1: folds 
matiko09: folds 
Durnichka: folds 
gabi_igna: folds 
Fitzyferret: raises $2.60 to $4.60
patpaty: folds 
Painkiller72: folds 
Uncalled bet ($2.60) returned to Fitzyferret
Fitzyferret collected $5 from pot
Fitzyferret: doesn't show hand 
*** SUMMARY ***
Total pot $5 | Rake $0 
Seat 1: Fitzyferret (button) collected ($5)
Seat 2: patpaty (small blind) folded before Flop
Seat 3: Painkiller72 (big blind) folded before Flop
Seat 4: KovIFish89 folded before Flop (didn't bet)
Seat 5: zmOe84 folded before Flop (didn't bet)
Seat 6: Spid1 folded before Flop (didn't bet)
Seat 7: matiko09 folded before Flop (didn't bet)
Seat 8: Durnichka folded before Flop (didn't bet)
Seat 9: gabi_igna folded before Flop (didn't bet)





PokerStars Hand #152884573264:  Hold'em No Limit ($1/$2 USD) - 2016/05/05 15:52:48 CET [2016/05/05 9:52:48 ET]
Table 'Tololo' 9-max Seat #9 is the button
Seat 1: Kukuryzka ($201 in chips) 
Seat 2: gabi_igna ($240.39 in chips) 
Seat 3: nickreason17 ($232.22 in chips) 
Seat 4: mooose100 ($183.65 in chips) 
Seat 5: matiko09 ($208 in chips) 
Seat 6: Xagua ($126.83 in chips) 
Seat 7: Iggso ($205.25 in chips) 
Seat 8: KovIFish89 ($200 in chips) 
Seat 9: Fitzyferret ($322.24 in chips) 
Kukuryzka: posts small blind $1
gabi_igna: posts big blind $2
*** HOLE CARDS ***
Dealt to matiko09 [Kh Jc]
nickreason17: folds 
mooose100: folds 
matiko09: folds 
Xagua: folds 
Iggso: folds 
KovIFish89: raises $3 to $5
Fitzyferret: folds 
Kukuryzka: folds 
gabi_igna: folds 
Uncalled bet ($3) returned to KovIFish89
KovIFish89 collected $5 from pot
KovIFish89: doesn't show hand 
*** SUMMARY ***
Total pot $5 | Rake $0 
Seat 1: Kukuryzka (small blind) folded before Flop
Seat 2: gabi_igna (big blind) folded before Flop
Seat 3: nickreason17 folded before Flop (didn't bet)
Seat 4: mooose100 folded before Flop (didn't bet)
Seat 5: matiko09 folded before Flop (didn't bet)
Seat 6: Xagua folded before Flop (didn't bet)
Seat 7: Iggso folded before Flop (didn't bet)
Seat 8: KovIFish89 collected ($5)
Seat 9: Fitzyferret (button) folded before Flop (didn't bet)





PokerStars Hand #152884577031:  Hold'em No Limit ($0.50/$1.00 USD) - 2016/05/05 15:52:54 CET [2016/05/05 9:52:54 ET]
Table 'Lictoria II' 9-max Seat #7 is the button
Seat 1: St.LaCoste ($100 in chips) 
Seat 3: Krinica2009 ($104 in chips) 
Seat 4: Ying59 ($89.66 in chips) 
Seat 5: sanpidk ($150.26 in chips) 
Seat 6: gabi_igna ($122.07 in chips) 
Seat 7: Painkiller72 ($153.92 in chips) 
Seat 8: matiko09 ($103 in chips) 
Seat 9: Kukuryzka ($143.31 in chips) 
matiko09: posts small blind $0.50
Kukuryzka: posts big blind $1
*** HOLE CARDS ***
Dealt to matiko09 [Jc 3s]
St.LaCoste: raises $2 to $3
Krinica2009: folds 
Ying59: folds 
sanpidk: folds 
gabi_igna: folds 
Painkiller72: folds 
matiko09: folds 
Kukuryzka: folds 
Uncalled bet ($2) returned to St.LaCoste
St.LaCoste collected $2.50 from pot
St.LaCoste: doesn't show hand 
*** SUMMARY ***
Total pot $2.50 | Rake $0 
Seat 1: St.LaCoste collected ($2.50)
Seat 3: Krinica2009 folded before Flop (didn't bet)
Seat 4: Ying59 folded before Flop (didn't bet)
Seat 5: sanpidk folded before Flop (didn't bet)
Seat 6: gabi_igna folded before Flop (didn't bet)
Seat 7: Painkiller72 (button) folded before Flop (didn't bet)
Seat 8: matiko09 (small blind) folded before Flop
Seat 9: Kukuryzka (big blind) folded before Flop





PokerStars Hand #152884581776:  Hold'em No Limit ($0.50/$1.00 USD) - 2016/05/05 15:53:03 CET [2016/05/05 9:53:03 ET]
Table 'Calypso II' 9-max Seat #5 is the button
Seat 1: nickreason17 ($105.80 in chips) 
Seat 2: torkkdnm ($140.50 in chips) 
Seat 3: gabi_igna ($109.09 in chips) 
Seat 4: sanpidk ($100 in chips) 
Seat 5: LighTingSSSS ($88.01 in chips) 
Seat 6: WTAPSVG ($175.75 in chips) 
Seat 7: ipashutapkom ($89.33 in chips) 
Seat 8: matiko09 ($107.80 in chips) 
WTAPSVG: posts small blind $0.50
ipashutapkom: posts big blind $1
maxxmeister: sits out 
*** HOLE CARDS ***
Dealt to matiko09 [9s 8s]
matiko09: folds 
nickreason17: folds 
torkkdnm: raises $2 to $3
gabi_igna: folds 
sanpidk: folds 
LighTingSSSS: calls $3
WTAPSVG: folds 
ipashutapkom: folds 
*** FLOP *** [Jh 5d 8d]
torkkdnm: checks 
LighTingSSSS: bets $4
torkkdnm: folds 
Uncalled bet ($4) returned to LighTingSSSS
LighTingSSSS collected $7.12 from pot
LighTingSSSS: doesn't show hand 
*** SUMMARY ***
Total pot $7.50 | Rake $0.38 
Board [Jh 5d 8d]
Seat 1: nickreason17 folded before Flop (didn't bet)
Seat 2: torkkdnm folded on the Flop
Seat 3: gabi_igna folded before Flop (didn't bet)
Seat 4: sanpidk folded before Flop (didn't bet)
Seat 5: LighTingSSSS (button) collected ($7.12)
Seat 6: WTAPSVG (small blind) folded before Flop
Seat 7: ipashutapkom (big blind) folded before Flop
Seat 8: matiko09 folded before Flop (didn't bet)





PokerStars Hand #152884582405:  Hold'em No Limit (€0.50/€1.00 EUR) - 2016/05/05 15:53:04 CET [2016/05/05 9:53:04 ET]
Table 'Nenetta III' 9-max Seat #7 is the button
Seat 4: puppet1509 (€40 in chips) 
Seat 5: Painkiller72 (€100 in chips) 
Seat 6: drissmouzou (€57.91 in chips) 
Seat 7: Spid1 (€100 in chips) 
Seat 8: St.LaCoste (€100 in chips) 
Seat 9: matiko09 (€100 in chips) 
St.LaCoste: posts small blind €0.50
matiko09: posts big blind €1
Racushniak: sits out 
puppet1509: posts big blind €1
*** HOLE CARDS ***
Dealt to matiko09 [5h Qc]
puppet1509: checks 
Painkiller72: folds 
drissmouzou: folds 
Spid1: raises €4 to €5
St.LaCoste: raises €8 to €13
matiko09: folds 
puppet1509: folds 
Spid1: folds 
Uncalled bet (€8) returned to St.LaCoste
St.LaCoste collected €12 from pot
St.LaCoste: doesn't show hand 
*** SUMMARY ***
Total pot €12 | Rake €0 
Seat 4: puppet1509 folded before Flop
Seat 5: Painkiller72 folded before Flop (didn't bet)
Seat 6: drissmouzou folded before Flop (didn't bet)
Seat 7: Spid1 (button) folded before Flop
Seat 8: St.LaCoste (small blind) collected (€12)
Seat 9: matiko09 (big blind) folded before Flop





PokerStars Hand #152884582982:  Hold'em No Limit ($0.50/$1.00 USD) - 2016/05/05 15:53:05 CET [2016/05/05 9:53:05 ET]
Table 'Luthera' 9-max Seat #8 is the button
Seat 1: MrMattkk ($107.49 in chips) 
Seat 2: Spid1 ($100.50 in chips) 
Seat 3: ipashutapkom ($71.39 in chips) 
Seat 4: matiko09 ($102.25 in chips) 
Seat 5: Painkiller72 ($100 in chips) 
Seat 7: Chin41178 ($97 in chips) 
Seat 8: xdrKush420x ($96.50 in chips) 
Seat 9: vrnMike ($100 in chips) 
vrnMike: posts small blind $0.50
MrMattkk: posts big blind $1
*** HOLE CARDS ***
Dealt to matiko09 [2h Ad]
Spid1: folds 
ipashutapkom: folds 
matiko09: folds 
Painkiller72: folds 
Chin41178: folds 
xdrKush420x: folds 
vrnMike: folds 
Uncalled bet ($0.50) returned to MrMattkk
MrMattkk collected $1 from pot
MrMattkk: doesn't show hand 
*** SUMMARY ***
Total pot $1 | Rake $0 
Seat 1: MrMattkk (big blind) collected ($1)
Seat 2: Spid1 folded before Flop (didn't bet)
Seat 3: ipashutapkom folded before Flop (didn't bet)
Seat 4: matiko09 folded before Flop (didn't bet)
Seat 5: Painkiller72 folded before Flop (didn't bet)
Seat 7: Chin41178 folded before Flop (didn't bet)
Seat 8: xdrKush420x (button) folded before Flop (didn't bet)
Seat 9: vrnMike (small blind) folded before Flop





PokerStars Hand #152884582891:  Hold'em No Limit ($0.50/$1.00 USD) - 2016/05/05 15:53:05 CET [2016/05/05 9:53:05 ET]
Table 'Pyxis III' 9-max Seat #9 is the button
Seat 1: sanpidk ($187.64 in chips) 
Seat 2: SPmaka ($100 in chips) 
Seat 3: vrnMike ($100 in chips) 
Seat 5: darren1031 ($97.10 in chips) 
Seat 6: kamillo91 ($87 in chips) 
Seat 7: mycka86 ($105.38 in chips) 
Seat 8: matiko09 ($105.75 in chips) 
Seat 9: Hypoaroused ($172.38 in chips) 
sanpidk: posts small blind $0.50
SPmaka: posts big blind $1
*** HOLE CARDS ***
Dealt to matiko09 [3c Qd]
vrnMike: folds 
darren1031: folds 
kamillo91 has timed out
kamillo91: folds 
mycka86: folds 
matiko09: folds 
Hypoaroused: folds 
sanpidk: raises $1.50 to $2.50
SPmaka: calls $1.50
*** FLOP *** [4d 4s 2d]
sanpidk: checks 
SPmaka: checks 
*** TURN *** [4d 4s 2d] [4h]
sanpidk: checks 
SPmaka: checks 
*** RIVER *** [4d 4s 2d 4h] [Qh]
sanpidk: bets $3
SPmaka: folds 
Uncalled bet ($3) returned to sanpidk
sanpidk collected $4.75 from pot
sanpidk: doesn't show hand 
*** SUMMARY ***
Total pot $5 | Rake $0.25 
Board [4d 4s 2d 4h Qh]
Seat 1: sanpidk (small blind) collected ($4.75)
Seat 2: SPmaka (big blind) folded on the River
Seat 3: vrnMike folded before Flop (didn't bet)
Seat 5: darren1031 folded before Flop (didn't bet)
Seat 6: kamillo91 folded before Flop (didn't bet)
Seat 7: mycka86 folded before Flop (didn't bet)
Seat 8: matiko09 folded before Flop (didn't bet)
Seat 9: Hypoaroused (button) folded before Flop (didn't bet)





PokerStars Hand #152884585523:  Hold'em No Limit ($1/$2 USD) - 2016/05/05 15:53:09 CET [2016/05/05 9:53:09 ET]
Table 'Samitchell' 9-max Seat #3 is the button
Seat 1: KovIFish89 ($206.15 in chips) 
Seat 2: matiko09 ($200 in chips) 
Seat 3: gabi_igna ($314.32 in chips) 
Seat 4: Fitzyferret ($370.22 in chips) 
Seat 5: Spid1 ($204.60 in chips) 
Seat 6: nickreason17 ($212 in chips) 
Seat 7: patpaty ($171.84 in chips) 
Seat 9: kblkxls ($122.22 in chips) 
Fitzyferret: posts small blind $1
Spid1: posts big blind $2
WolleMalone: sits out 
*** HOLE CARDS ***
Dealt to matiko09 [Js 2c]
nickreason17: folds 
patpaty: calls $2
kblkxls: raises $6 to $8
KovIFish89: raises $11 to $19
matiko09: folds 
gabi_igna: folds 
Fitzyferret: folds 
Spid1: folds 
patpaty: folds 
kblkxls: calls $11
*** FLOP *** [9h 3s 5h]
kblkxls: bets $35
KovIFish89: folds 
Uncalled bet ($35) returned to kblkxls
kblkxls collected $40.85 from pot
kblkxls: doesn't show hand 
*** SUMMARY ***
Total pot $43 | Rake $2.15 
Board [9h 3s 5h]
Seat 1: KovIFish89 folded on the Flop
Seat 2: matiko09 folded before Flop (didn't bet)
Seat 3: gabi_igna (button) folded before Flop (didn't bet)
Seat 4: Fitzyferret (small blind) folded before Flop
Seat 5: Spid1 (big blind) folded before Flop
Seat 6: nickreason17 folded before Flop (didn't bet)
Seat 7: patpaty folded before Flop
Seat 9: kblkxls collected ($40.85)





PokerStars Hand #152884587249:  Hold'em No Limit ($0.50/$1.00 USD) - 2016/05/05 15:53:12 CET [2016/05/05 9:53:12 ET]
Table 'Natascha' 9-max Seat #8 is the button
Seat 1: ronald3737 ($123.48 in chips) 
Seat 2: matiko09 ($131.03 in chips) 
Seat 3: bjonlyking ($126.70 in chips) 
Seat 4: sanpidk ($128.31 in chips) 
Seat 6: gabi_igna ($149.62 in chips) 
Seat 7: torkkdnm ($149.25 in chips) 
Seat 8: kamillo91 ($36.99 in chips) 
Seat 9: guoweiAA ($231.22 in chips) 
guoweiAA: posts small blind $0.50
ronald3737: posts big blind $1
*** HOLE CARDS ***
Dealt to matiko09 [7s 3c]
matiko09: folds 
bjonlyking: folds 
sanpidk: folds 
gabi_igna: folds 
torkkdnm: raises $2 to $3
kamillo91: folds 
guoweiAA: folds 
ronald3737: calls $2
*** FLOP *** [3d 5c 8c]
ronald3737: checks 
torkkdnm: bets $4
ronald3737: folds 
Uncalled bet ($4) returned to torkkdnm
torkkdnm collected $6.18 from pot
*** SUMMARY ***
Total pot $6.50 | Rake $0.32 
Board [3d 5c 8c]
Seat 1: ronald3737 (big blind) folded on the Flop
Seat 2: matiko09 folded before Flop (didn't bet)
Seat 3: bjonlyking folded before Flop (didn't bet)
Seat 4: sanpidk folded before Flop (didn't bet)
Seat 6: gabi_igna folded before Flop (didn't bet)
Seat 7: torkkdnm collected ($6.18)
Seat 8: kamillo91 (button) folded before Flop (didn't bet)
Seat 9: guoweiAA (small blind) folded before Flop





PokerStars Hand #152884588466:  Hold'em No Limit (€0.50/€1.00 EUR) - 2016/05/05 15:53:14 CET [2016/05/05 9:53:14 ET]
Table 'Carol II' 9-max Seat #5 is the button
Seat 1: vrnMike (€104.08 in chips) 
Seat 2: matiko09 (€107 in chips) 
Seat 4: Merlin_1905 (€76.15 in chips) 
Seat 5: Painkiller72 (€100 in chips) 
Seat 6: Kukuryzka (€100 in chips) 
Seat 7: Spid1 (€100 in chips) 
Seat 9: Racushniak (€134.37 in chips) 
Kukuryzka: posts small blind €0.50
Spid1: posts big blind €1
*** HOLE CARDS ***
Dealt to matiko09 [8d 4h]
Racushniak: raises €2 to €3
vrnMike: raises €6.50 to €9.50
matiko09: folds 
Merlin_1905: calls €9.50
Painkiller72: folds 
Dantist1122 leaves the table
Kukuryzka: folds 
Spid1: folds 
Racushniak: calls €6.50
*** FLOP *** [6d 2s 6s]
Racushniak: checks 
sanpidk joins the table at seat #8 
vrnMike: bets €14.50
Merlin_1905: folds 
Racushniak: calls €14.50
*** TURN *** [6d 2s 6s] [Ts]
Racushniak: checks 
vrnMike: checks 
*** RIVER *** [6d 2s 6s Ts] [9c]
Racushniak: checks 
vrnMike: bets €20
Racushniak: raises €90.37 to €110.37 and is all-in
vrnMike: calls €60.08 and is all-in
Uncalled bet (€30.29) returned to Racushniak
*** SHOW DOWN ***
Racushniak: shows [9s Js] (a flush, Jack high)
vrnMike: shows [Kd Ks] (two pair, Kings and Sixes)
Racushniak collected €216.91 from pot
*** SUMMARY ***
Total pot €219.16 | Rake €2.25 
Board [6d 2s 6s Ts 9c]
Seat 1: vrnMike showed [Kd Ks] and lost with two pair, Kings and Sixes
Seat 2: matiko09 folded before Flop (didn't bet)
Seat 4: Merlin_1905 folded on the Flop
Seat 5: Painkiller72 (button) folded before Flop (didn't bet)
Seat 6: Kukuryzka (small blind) folded before Flop
Seat 7: Spid1 (big blind) folded before Flop
Seat 9: Racushniak showed [9s Js] and won (€216.91) with a flush, Jack high





PokerStars Hand #152884588248:  Hold'em No Limit ($1/$2 USD) - 2016/05/05 15:53:14 CET [2016/05/05 9:53:14 ET]
Table 'Lundia' 9-max Seat #2 is the button
Seat 1: Fitzyferret ($203 in chips) 
Seat 2: patpaty ($193.10 in chips) 
Seat 3: Painkiller72 ($200 in chips) 
Seat 4: KovIFish89 ($200 in chips) 
Seat 5: zmOe84 ($193 in chips) 
Seat 6: Spid1 ($252.39 in chips) 
Seat 7: matiko09 ($251.11 in chips) 
Seat 8: Durnichka ($84 in chips) 
Seat 9: gabi_igna ($275.36 in chips) 
Painkiller72: posts small blind $1
KovIFish89: posts big blind $2
*** HOLE CARDS ***
Dealt to matiko09 [6c 2h]
zmOe84: folds 
Spid1: folds 
matiko09: folds 
Durnichka: folds 
gabi_igna: folds 
Fitzyferret: raises $2.60 to $4.60
patpaty: calls $4.60
Painkiller72: folds 
KovIFish89: calls $2.60
*** FLOP *** [3s 9d 7c]
KovIFish89: checks 
Fitzyferret: checks 
patpaty: checks 
*** TURN *** [3s 9d 7c] [8s]
KovIFish89: bets $10
Fitzyferret: calls $10
patpaty: folds 
*** RIVER *** [3s 9d 7c 8s] [4d]
KovIFish89: bets $28
Fitzyferret: folds 
Uncalled bet ($28) returned to KovIFish89
KovIFish89 collected $33.06 from pot
KovIFish89: doesn't show hand 
*** SUMMARY ***
Total pot $34.80 | Rake $1.74 
Board [3s 9d 7c 8s 4d]
Seat 1: Fitzyferret folded on the River
Seat 2: patpaty (button) folded on the Turn
Seat 3: Painkiller72 (small blind) folded before Flop
Seat 4: KovIFish89 (big blind) collected ($33.06)
Seat 5: zmOe84 folded before Flop (didn't bet)
Seat 6: Spid1 folded before Flop (didn't bet)
Seat 7: matiko09 folded before Flop (didn't bet)
Seat 8: Durnichka folded before Flop (didn't bet)
Seat 9: gabi_igna folded before Flop (didn't bet)





PokerStars Hand #152884593705:  Hold'em No Limit ($0.50/$1.00 USD) - 2016/05/05 15:53:23 CET [2016/05/05 9:53:23 ET]
Table 'Lictoria II' 9-max Seat #8 is the button
Seat 1: St.LaCoste ($101.50 in chips) 
Seat 3: Krinica2009 ($104 in chips) 
Seat 4: Ying59 ($89.66 in chips) 
Seat 5: sanpidk ($150.26 in chips) 
Seat 6: gabi_igna ($122.07 in chips) 
Seat 7: Painkiller72 ($153.92 in chips) 
Seat 8: matiko09 ($102.50 in chips) 
Seat 9: Kukuryzka ($142.31 in chips) 
Kukuryzka: posts small blind $0.50
St.LaCoste: posts big blind $1
*** HOLE CARDS ***
Dealt to matiko09 [2h 9c]
Krinica2009: folds 
Ying59: raises $1 to $2
sanpidk: folds 
gabi_igna: raises $6 to $8
Painkiller72: folds 
matiko09: folds 
Kukuryzka: folds 
St.LaCoste: folds 
Ying59: calls $6
*** FLOP *** [2s 8c Ac]
Ying59: checks 
gabi_igna: bets $10
Ying59: calls $10
*** TURN *** [2s 8c Ac] [7d]
Ying59: checks 
gabi_igna: bets $22
Ying59: calls $22
*** RIVER *** [2s 8c Ac 7d] [Qc]
Ying59: bets $32
gabi_igna: raises $32 to $64
Ying59: calls $17.66 and is all-in
Uncalled bet ($14.34) returned to gabi_igna
*** SHOW DOWN ***
gabi_igna: shows [Tc Kc] (a flush, Ace high)
Ying59: mucks hand 
gabi_igna collected $178.32 from pot
*** SUMMARY ***
Total pot $180.82 | Rake $2.50 
Board [2s 8c Ac 7d Qc]
Seat 1: St.LaCoste (big blind) folded before Flop
Seat 3: Krinica2009 folded before Flop (didn't bet)
Seat 4: Ying59 mucked [As Qh]
Seat 5: sanpidk folded before Flop (didn't bet)
Seat 6: gabi_igna showed [Tc Kc] and won ($178.32) with a flush, Ace high
Seat 7: Painkiller72 folded before Flop (didn't bet)
Seat 8: matiko09 (button) folded before Flop (didn't bet)
Seat 9: Kukuryzka (small blind) folded before Flop





PokerStars Hand #152884594900:  Hold'em No Limit ($1/$2 USD) - 2016/05/05 15:53:26 CET [2016/05/05 9:53:26 ET]
Table 'Tololo' 9-max Seat #1 is the button
Seat 1: Kukuryzka ($200 in chips) 
Seat 2: gabi_igna ($238.39 in chips) 
Seat 3: nickreason17 ($232.22 in chips) 
Seat 4: mooose100 ($183.65 in chips) 
Seat 5: matiko09 ($208 in chips) 
Seat 6: Xagua ($126.83 in chips) 
Seat 7: Iggso ($205.25 in chips) 
Seat 8: KovIFish89 ($203 in chips) 
Seat 9: Fitzyferret ($322.24 in chips) 
gabi_igna: posts small blind $1
nickreason17: posts big blind $2
*** HOLE CARDS ***
Dealt to matiko09 [Qd Qh]
mooose100: calls $2
matiko09: raises $6 to $8
Xagua: folds 
Iggso: folds 
KovIFish89: folds 
Fitzyferret: folds 
Kukuryzka: folds 
gabi_igna: folds 
nickreason17: folds 
mooose100: folds 
Uncalled bet ($6) returned to matiko09
matiko09 collected $7 from pot
matiko09: doesn't show hand 
*** SUMMARY ***
Total pot $7 | Rake $0 
Seat 1: Kukuryzka (button) folded before Flop (didn't bet)
Seat 2: gabi_igna (small blind) folded before Flop
Seat 3: nickreason17 (big blind) folded before Flop
Seat 4: mooose100 folded before Flop
Seat 5: matiko09 collected ($7)
Seat 6: Xagua folded before Flop (didn't bet)
Seat 7: Iggso folded before Flop (didn't bet)
Seat 8: KovIFish89 folded before Flop (didn't bet)
Seat 9: Fitzyferret folded before Flop (didn't bet)





PokerStars Hand #152884595547:  Hold'em No Limit ($0.50/$1.00 USD) - 2016/05/05 15:53:27 CET [2016/05/05 9:53:27 ET]
Table 'Priska II' 9-max Seat #4 is the button
Seat 1: Spid1 ($112.85 in chips) 
Seat 2: Kukuryzka ($131.52 in chips) 
Seat 3: matiko09 ($100 in chips) 
Seat 4: Painkiller72 ($155.84 in chips) 
Seat 5: nickreason17 ($172.05 in chips) 
Seat 6: St.LaCoste ($100 in chips) 
Seat 7: stockbridge8 ($89.27 in chips) 
Seat 8: pohorc21 ($72.43 in chips) 
Seat 9: torkkdnm ($100.50 in chips) 
nickreason17: posts small blind $0.50
St.LaCoste: posts big blind $1
*** HOLE CARDS ***
Dealt to matiko09 [5h Qc]
stockbridge8: folds 
pohorc21: calls $1
torkkdnm: raises $3 to $4
Spid1: folds 
Kukuryzka: folds 
matiko09: folds 
Painkiller72: folds 
nickreason17: folds 
St.LaCoste: folds 
pohorc21: calls $3
*** FLOP *** [7h 8s 6s]
pohorc21: bets $9
torkkdnm: calls $9
*** TURN *** [7h 8s 6s] [2h]
pohorc21: bets $26
torkkdnm: raises $61.50 to $87.50 and is all-in
pohorc21: calls $33.43 and is all-in
Uncalled bet ($28.07) returned to torkkdnm
*** RIVER *** [7h 8s 6s 2h] [7d]
*** SHOW DOWN ***
pohorc21: shows [Tc 8c] (two pair, Eights and Sevens)
torkkdnm: shows [9h 8h] (two pair, Eights and Sevens - lower kicker)
pohorc21 collected $143.86 from pot
*** SUMMARY ***
Total pot $146.36 | Rake $2.50 
Board [7h 8s 6s 2h 7d]
Seat 1: Spid1 folded before Flop (didn't bet)
Seat 2: Kukuryzka folded before Flop (didn't bet)
Seat 3: matiko09 folded before Flop (didn't bet)
Seat 4: Painkiller72 (button) folded before Flop (didn't bet)
Seat 5: nickreason17 (small blind) folded before Flop
Seat 6: St.LaCoste (big blind) folded before Flop
Seat 7: stockbridge8 folded before Flop (didn't bet)
Seat 8: pohorc21 showed [Tc 8c] and won ($143.86) with two pair, Eights and Sevens
Seat 9: torkkdnm showed [9h 8h] and lost with two pair, Eights and Sevens





PokerStars Hand #152884598575:  Hold'em No Limit ($0.50/$1.00 USD) - 2016/05/05 15:53:32 CET [2016/05/05 9:53:32 ET]
Table 'Luthera' 9-max Seat #9 is the button
Seat 1: MrMattkk ($107.99 in chips) 
Seat 2: Spid1 ($100.50 in chips) 
Seat 3: ipashutapkom ($71.39 in chips) 
Seat 4: matiko09 ($102.25 in chips) 
Seat 5: Painkiller72 ($100 in chips) 
Seat 7: Chin41178 ($97 in chips) 
Seat 8: xdrKush420x ($96.50 in chips) 
Seat 9: vrnMike ($100 in chips) 
MrMattkk: posts small blind $0.50
Spid1: posts big blind $1
*** HOLE CARDS ***
Dealt to matiko09 [Jh 4c]
ipashutapkom: folds 
matiko09: folds 
Painkiller72 has timed out
Painkiller72: folds 
Chin41178: folds 
xdrKush420x: folds 
vrnMike: folds 
MrMattkk: folds 
Uncalled bet ($0.50) returned to Spid1
Spid1 collected $1 from pot
Spid1: doesn't show hand 
*** SUMMARY ***
Total pot $1 | Rake $0 
Seat 1: MrMattkk (small blind) folded before Flop
Seat 2: Spid1 (big blind) collected ($1)
Seat 3: ipashutapkom folded before Flop (didn't bet)
Seat 4: matiko09 folded before Flop (didn't bet)
Seat 5: Painkiller72 folded before Flop (didn't bet)
Seat 7: Chin41178 folded before Flop (didn't bet)
Seat 8: xdrKush420x folded before Flop (didn't bet)
Seat 9: vrnMike (button) folded before Flop (didn't bet)





PokerStars Hand #152884603675:  Hold'em No Limit ($0.50/$1.00 USD) - 2016/05/05 15:53:41 CET [2016/05/05 9:53:41 ET]
Table 'Musa II' 9-max Seat #3 is the button
Seat 1: KovIFish89 ($209.47 in chips) 
Seat 2: koutani7 ($98.50 in chips) 
Seat 3: vrnMike ($108.88 in chips) 
Seat 4: sanpidk ($100.20 in chips) 
Seat 5: Chin41178 ($100 in chips) 
Seat 6: cnn123 ($61.24 in chips) 
Seat 7: Painkiller72 ($100 in chips) 
Seat 8: matiko09 ($100 in chips) 
Seat 9: antfurto ($90.18 in chips) 
sanpidk: posts small blind $0.50
Chin41178: posts big blind $1
*** HOLE CARDS ***
Dealt to matiko09 [2c 4d]
cnn123: raises $2 to $3
Painkiller72: calls $3
matiko09: folds 
antfurto: folds 
KovIFish89: folds 
koutani7: folds 
vrnMike: folds 
sanpidk: folds 
Chin41178: folds 
*** FLOP *** [Ac 6d 7s]
cnn123: bets $5
Painkiller72: calls $5
*** TURN *** [Ac 6d 7s] [Tc]
cnn123: bets $9
Painkiller72: calls $9
*** RIVER *** [Ac 6d 7s Tc] [Jd]
cnn123: bets $20
Painkiller72: folds 
Uncalled bet ($20) returned to cnn123
cnn123 collected $33.72 from pot
*** SUMMARY ***
Total pot $35.50 | Rake $1.78 
Board [Ac 6d 7s Tc Jd]
Seat 1: KovIFish89 folded before Flop (didn't bet)
Seat 2: koutani7 folded before Flop (didn't bet)
Seat 3: vrnMike (button) folded before Flop (didn't bet)
Seat 4: sanpidk (small blind) folded before Flop
Seat 5: Chin41178 (big blind) folded before Flop
Seat 6: cnn123 collected ($33.72)
Seat 7: Painkiller72 folded on the River
Seat 8: matiko09 folded before Flop (didn't bet)
Seat 9: antfurto folded before Flop (didn't bet)





PokerStars Hand #152884605407:  Hold'em No Limit ($1/$2 USD) - 2016/05/05 15:53:44 CET [2016/05/05 9:53:44 ET]
Table 'Euporie II' 9-max Seat #5 is the button
Seat 1: Durnichka ($189.15 in chips) 
Seat 2: nickreason17 ($200 in chips) 
Seat 3: Spid1 ($200 in chips) 
Seat 5: Nuskatko1986 ($161.01 in chips) 
Seat 6: glanza_mike ($200 in chips) 
Seat 7: matiko09 ($205 in chips) 
Seat 8: Painkiller72 ($200 in chips) 
glanza_mike: posts small blind $1
matiko09: posts big blind $2
T0ny Adams: sits out 
Kukuryzka: sits out 
*** HOLE CARDS ***
Dealt to matiko09 [6s 8d]
Painkiller72 has timed out
Painkiller72: folds 
Durnichka: folds 
nickreason17: folds 
Spid1: folds 
Nuskatko1986: calls $2
glanza_mike: raises $5 to $7
matiko09: folds 
Nuskatko1986: folds 
Uncalled bet ($5) returned to glanza_mike
glanza_mike collected $6 from pot
glanza_mike: doesn't show hand 
*** SUMMARY ***
Total pot $6 | Rake $0 
Seat 1: Durnichka folded before Flop (didn't bet)
Seat 2: nickreason17 folded before Flop (didn't bet)
Seat 3: Spid1 folded before Flop (didn't bet)
Seat 5: Nuskatko1986 (button) folded before Flop
Seat 6: glanza_mike (small blind) collected ($6)
Seat 7: matiko09 (big blind) folded before Flop
Seat 8: Painkiller72 folded before Flop (didn't bet)





PokerStars Hand #152884613275:  Hold'em No Limit ($1/$2 USD) - 2016/05/05 15:53:58 CET [2016/05/05 9:53:58 ET]
Table 'Tololo' 9-max Seat #2 is the button
Seat 1: Kukuryzka ($200 in chips) 
Seat 2: gabi_igna ($237.39 in chips) 
Seat 3: nickreason17 ($230.22 in chips) 
Seat 4: mooose100 ($181.65 in chips) 
Seat 5: matiko09 ($213 in chips) 
Seat 6: Xagua ($126.83 in chips) 
Seat 7: Iggso ($205.25 in chips) 
Seat 8: KovIFish89 ($203 in chips) 
Seat 9: Fitzyferret ($322.24 in chips) 
nickreason17: posts small blind $1
mooose100: posts big blind $2
*** HOLE CARDS ***
Dealt to matiko09 [9h Jd]
matiko09: folds 
Xagua: folds 
Iggso: raises $4 to $6
KovIFish89: folds 
Fitzyferret: folds 
Kukuryzka: folds 
gabi_igna: folds 
nickreason17: folds 
mooose100: folds 
Uncalled bet ($4) returned to Iggso
Iggso collected $5 from pot
Iggso: doesn't show hand 
*** SUMMARY ***
Total pot $5 | Rake $0 
Seat 1: Kukuryzka folded before Flop (didn't bet)
Seat 2: gabi_igna (button) folded before Flop (didn't bet)
Seat 3: nickreason17 (small blind) folded before Flop
Seat 4: mooose100 (big blind) folded before Flop
Seat 5: matiko09 folded before Flop (didn't bet)
Seat 6: Xagua folded before Flop (didn't bet)
Seat 7: Iggso collected ($5)
Seat 8: KovIFish89 folded before Flop (didn't bet)
Seat 9: Fitzyferret folded before Flop (didn't bet)





PokerStars Hand #152884613178:  Hold'em No Limit (€0.50/€1.00 EUR) - 2016/05/05 15:53:58 CET [2016/05/05 9:53:58 ET]
Table 'Nenetta III' 9-max Seat #8 is the button
Seat 3: Racushniak (€100 in chips) 
Seat 4: puppet1509 (€39 in chips) 
Seat 5: Painkiller72 (€100 in chips) 
Seat 6: drissmouzou (€57.91 in chips) 
Seat 7: Spid1 (€100 in chips) 
Seat 8: St.LaCoste (€107 in chips) 
Seat 9: matiko09 (€100 in chips) 
matiko09: posts small blind €0.50
Racushniak: posts big blind €1
*** HOLE CARDS ***
Dealt to matiko09 [Jh Kc]
puppet1509: folds 
Painkiller72: folds 
drissmouzou: raises €5 to €6
Spid1: folds 
drissmouzou said, "lool"
St.LaCoste: folds 
matiko09: folds 
Racushniak: folds 
Uncalled bet (€5) returned to drissmouzou
drissmouzou collected €2.50 from pot
drissmouzou: doesn't show hand 
*** SUMMARY ***
Total pot €2.50 | Rake €0 
Seat 3: Racushniak (big blind) folded before Flop
Seat 4: puppet1509 folded before Flop (didn't bet)
Seat 5: Painkiller72 folded before Flop (didn't bet)
Seat 6: drissmouzou collected (€2.50)
Seat 7: Spid1 folded before Flop (didn't bet)
Seat 8: St.LaCoste (button) folded before Flop (didn't bet)
Seat 9: matiko09 (small blind) folded before Flop





PokerStars Hand #152884615052:  Hold'em No Limit ($0.50/$1.00 USD) - 2016/05/05 15:54:01 CET [2016/05/05 9:54:01 ET]
Table 'Calypso II' 9-max Seat #6 is the button
Seat 1: nickreason17 ($105.80 in chips) 
Seat 2: torkkdnm ($137.50 in chips) 
Seat 3: gabi_igna ($109.09 in chips) 
Seat 4: sanpidk ($100 in chips) 
Seat 5: LighTingSSSS ($92.13 in chips) 
Seat 6: WTAPSVG ($175.25 in chips) 
Seat 7: ipashutapkom ($88.33 in chips) 
Seat 8: matiko09 ($107.80 in chips) 
ipashutapkom: posts small blind $0.50
matiko09: posts big blind $1
maxxmeister: sits out 
*** HOLE CARDS ***
Dealt to matiko09 [8s 3h]
nickreason17: folds 
torkkdnm: raises $2 to $3
gabi_igna: folds 
sanpidk: folds 
LighTingSSSS has timed out
LighTingSSSS: folds 
WTAPSVG: folds 
ipashutapkom: folds 
matiko09: folds 
Uncalled bet ($2) returned to torkkdnm
torkkdnm collected $2.50 from pot
*** SUMMARY ***
Total pot $2.50 | Rake $0 
Seat 1: nickreason17 folded before Flop (didn't bet)
Seat 2: torkkdnm collected ($2.50)
Seat 3: gabi_igna folded before Flop (didn't bet)
Seat 4: sanpidk folded before Flop (didn't bet)
Seat 5: LighTingSSSS folded before Flop (didn't bet)
Seat 6: WTAPSVG (button) folded before Flop (didn't bet)
Seat 7: ipashutapkom (small blind) folded before Flop
Seat 8: matiko09 (big blind) folded before Flop





PokerStars Hand #152884615689:  Hold'em No Limit ($1/$2 USD) - 2016/05/05 15:54:02 CET [2016/05/05 9:54:02 ET]
Table 'Samitchell' 9-max Seat #4 is the button
Seat 1: KovIFish89 ($200 in chips) 
Seat 2: matiko09 ($200 in chips) 
Seat 3: gabi_igna ($314.32 in chips) 
Seat 4: Fitzyferret ($369.22 in chips) 
Seat 5: Spid1 ($202.60 in chips) 
Seat 6: nickreason17 ($212 in chips) 
Seat 7: patpaty ($169.84 in chips) 
Seat 9: kblkxls ($144.07 in chips) 
Spid1: posts small blind $1
nickreason17: posts big blind $2
WolleMalone: sits out 
*** HOLE CARDS ***
Dealt to matiko09 [Ks 6c]
patpaty: calls $2
kblkxls: folds 
KovIFish89: folds 
matiko09: folds 
gabi_igna: folds 
Fitzyferret: folds 
Spid1: raises $10 to $12
nickreason17: folds 
patpaty: folds 
Uncalled bet ($10) returned to Spid1
Spid1 collected $6 from pot
Spid1: doesn't show hand 
*** SUMMARY ***
Total pot $6 | Rake $0 
Seat 1: KovIFish89 folded before Flop (didn't bet)
Seat 2: matiko09 folded before Flop (didn't bet)
Seat 3: gabi_igna folded before Flop (didn't bet)
Seat 4: Fitzyferret (button) folded before Flop (didn't bet)
Seat 5: Spid1 (small blind) collected ($6)
Seat 6: nickreason17 (big blind) folded before Flop
Seat 7: patpaty folded before Flop
Seat 9: kblkxls folded before Flop (didn't bet)





PokerStars Hand #152884622630:  Hold'em No Limit ($0.50/$1.00 USD) - 2016/05/05 15:54:15 CET [2016/05/05 9:54:15 ET]
Table 'Luthera' 9-max Seat #1 is the button
Seat 1: MrMattkk ($107.49 in chips) 
Seat 2: Spid1 ($101 in chips) 
Seat 3: ipashutapkom ($71.39 in chips) 
Seat 4: matiko09 ($102.25 in chips) 
Seat 5: Painkiller72 ($100 in chips) 
Seat 7: Chin41178 ($97 in chips) 
Seat 8: xdrKush420x ($96.50 in chips) 
Seat 9: vrnMike ($100 in chips) 
Spid1: posts small blind $0.50
ipashutapkom: posts big blind $1
Dantist1122: sits out 
*** HOLE CARDS ***
Dealt to matiko09 [Ac Qc]
matiko09: raises $2 to $3
Painkiller72: folds 
Chin41178: calls $3
xdrKush420x: folds 
vrnMike: folds 
MrMattkk: calls $3
Spid1: folds 
ipashutapkom: calls $2
*** FLOP *** [6d 6h 4h]
ipashutapkom: checks 
matiko09: checks 
Chin41178: bets $6
MrMattkk: calls $6
ipashutapkom: folds 
matiko09: folds 
*** TURN *** [6d 6h 4h] [5d]
Chin41178: checks 
MrMattkk: checks 
*** RIVER *** [6d 6h 4h 5d] [5h]
Chin41178: checks 
MrMattkk: checks 
*** SHOW DOWN ***
Chin41178: shows [9c 9h] (two pair, Nines and Sixes)
MrMattkk: mucks hand 
Chin41178 collected $23.28 from pot
*** SUMMARY ***
Total pot $24.50 | Rake $1.22 
Board [6d 6h 4h 5d 5h]
Seat 1: MrMattkk (button) mucked [Ad 4d]
Seat 2: Spid1 (small blind) folded before Flop
Seat 3: ipashutapkom (big blind) folded on the Flop
Seat 4: matiko09 folded on the Flop
Seat 5: Painkiller72 folded before Flop (didn't bet)
Seat 7: Chin41178 showed [9c 9h] and won ($23.28) with two pair, Nines and Sixes
Seat 8: xdrKush420x folded before Flop (didn't bet)
Seat 9: vrnMike folded before Flop (didn't bet)





PokerStars Hand #152884625009:  Hold'em No Limit ($1/$2 USD) - 2016/05/05 15:54:19 CET [2016/05/05 9:54:19 ET]
Table 'Tololo' 9-max Seat #3 is the button
Seat 1: Kukuryzka ($200 in chips) 
Seat 2: gabi_igna ($237.39 in chips) 
Seat 3: nickreason17 ($229.22 in chips) 
Seat 4: mooose100 ($179.65 in chips) 
Seat 5: matiko09 ($213 in chips) 
Seat 6: Xagua ($126.83 in chips) 
Seat 7: Iggso ($208.25 in chips) 
Seat 8: KovIFish89 ($203 in chips) 
Seat 9: Fitzyferret ($322.24 in chips) 
mooose100: posts small blind $1
matiko09: posts big blind $2
*** HOLE CARDS ***
Dealt to matiko09 [Js Ad]
Xagua has timed out
Xagua: folds 
Iggso: folds 
KovIFish89: folds 
Fitzyferret: folds 
Kukuryzka: folds 
gabi_igna: folds 
nickreason17: folds 
mooose100: calls $1
matiko09: raises $6 to $8
mooose100: calls $6
*** FLOP *** [Jh Ks Tc]
mooose100: bets $7.60
matiko09: calls $7.60
*** TURN *** [Jh Ks Tc] [7d]
mooose100: bets $29.64
matiko09: folds 
Uncalled bet ($29.64) returned to mooose100
mooose100 collected $29.64 from pot
mooose100: doesn't show hand 
*** SUMMARY ***
Total pot $31.20 | Rake $1.56 
Board [Jh Ks Tc 7d]
Seat 1: Kukuryzka folded before Flop (didn't bet)
Seat 2: gabi_igna folded before Flop (didn't bet)
Seat 3: nickreason17 (button) folded before Flop (didn't bet)
Seat 4: mooose100 (small blind) collected ($29.64)
Seat 5: matiko09 (big blind) folded on the Turn
Seat 6: Xagua folded before Flop (didn't bet)
Seat 7: Iggso folded before Flop (didn't bet)
Seat 8: KovIFish89 folded before Flop (didn't bet)
Seat 9: Fitzyferret folded before Flop (didn't bet)





PokerStars Hand #152884626038:  Hold'em No Limit ($0.50/$1.00 USD) - 2016/05/05 15:54:21 CET [2016/05/05 9:54:21 ET]
Table 'Pyxis III' 9-max Seat #1 is the button
Seat 1: sanpidk ($189.89 in chips) 
Seat 2: SPmaka ($97.50 in chips) 
Seat 3: vrnMike ($100 in chips) 
Seat 5: darren1031 ($97.10 in chips) 
Seat 6: kamillo91 ($87 in chips) 
Seat 7: mycka86 ($105.38 in chips) 
Seat 8: matiko09 ($105.75 in chips) 
Seat 9: Hypoaroused ($172.38 in chips) 
SPmaka: posts small blind $0.50
vrnMike: posts big blind $1
*** HOLE CARDS ***
Dealt to matiko09 [Jc Qh]
darren1031: folds 
kamillo91: folds 
mycka86: folds 
matiko09: raises $2 to $3
Hypoaroused: folds 
sanpidk: folds 
SPmaka: folds 
vrnMike: folds 
Uncalled bet ($2) returned to matiko09
matiko09 collected $2.50 from pot
matiko09: doesn't show hand 
*** SUMMARY ***
Total pot $2.50 | Rake $0 
Seat 1: sanpidk (button) folded before Flop (didn't bet)
Seat 2: SPmaka (small blind) folded before Flop
Seat 3: vrnMike (big blind) folded before Flop
Seat 5: darren1031 folded before Flop (didn't bet)
Seat 6: kamillo91 folded before Flop (didn't bet)
Seat 7: mycka86 folded before Flop (didn't bet)
Seat 8: matiko09 collected ($2.50)
Seat 9: Hypoaroused folded before Flop (didn't bet)





PokerStars Hand #152884629910:  Hold'em No Limit (€0.50/€1.00 EUR) - 2016/05/05 15:54:28 CET [2016/05/05 9:54:28 ET]
Table 'Nenetta III' 9-max Seat #9 is the button
Seat 3: Racushniak (€100 in chips) 
Seat 4: puppet1509 (€39 in chips) 
Seat 5: Painkiller72 (€100 in chips) 
Seat 6: drissmouzou (€59.41 in chips) 
Seat 7: Spid1 (€100 in chips) 
Seat 8: St.LaCoste (€107 in chips) 
Seat 9: matiko09 (€100 in chips) 
Racushniak: posts small blind €0.50
puppet1509: posts big blind €1
*** HOLE CARDS ***
Dealt to matiko09 [Td 4d]
Painkiller72: folds 
drissmouzou: folds 
Spid1: raises €2 to €3
St.LaCoste: folds 
FroggyPlay joins the table at seat #1 
matiko09: folds 
Racushniak: folds 
puppet1509: folds 
Uncalled bet (€2) returned to Spid1
Spid1 collected €2.50 from pot
Spid1: doesn't show hand 
*** SUMMARY ***
Total pot €2.50 | Rake €0 
Seat 3: Racushniak (small blind) folded before Flop
Seat 4: puppet1509 (big blind) folded before Flop
Seat 5: Painkiller72 folded before Flop (didn't bet)
Seat 6: drissmouzou folded before Flop (didn't bet)
Seat 7: Spid1 collected (€2.50)
Seat 8: St.LaCoste folded before Flop (didn't bet)
Seat 9: matiko09 (button) folded before Flop (didn't bet)





PokerStars Hand #152884633505:  Hold'em No Limit ($1/$2 USD) - 2016/05/05 15:54:34 CET [2016/05/05 9:54:34 ET]
Table 'Lundia' 9-max Seat #3 is the button
Seat 1: Fitzyferret ($200 in chips) 
Seat 2: patpaty ($188.50 in chips) 
Seat 3: Painkiller72 ($200 in chips) 
Seat 4: KovIFish89 ($218.46 in chips) 
Seat 5: zmOe84 ($193 in chips) 
Seat 6: Spid1 ($252.39 in chips) 
Seat 7: matiko09 ($251.11 in chips) 
Seat 8: Durnichka ($84 in chips) 
Seat 9: gabi_igna ($275.36 in chips) 
KovIFish89: posts small blind $1
zmOe84: posts big blind $2
*** HOLE CARDS ***
Dealt to matiko09 [3c 6s]
Spid1: folds 
matiko09: folds 
Durnichka: folds 
gabi_igna: folds 
Fitzyferret: folds 
patpaty: calls $2
Painkiller72: folds 
KovIFish89: calls $1
zmOe84: checks 
*** FLOP *** [7s Kd Js]
KovIFish89: checks 
zmOe84: bets $4
patpaty: folds 
KovIFish89: calls $4
*** TURN *** [7s Kd Js] [5d]
KovIFish89: checks 
zmOe84: bets $10
KovIFish89: calls $10
*** RIVER *** [7s Kd Js 5d] [5c]
KovIFish89: checks 
zmOe84: checks 
*** SHOW DOWN ***
KovIFish89: shows [Kh 6d] (two pair, Kings and Fives)
zmOe84: mucks hand 
KovIFish89 collected $32.30 from pot
*** SUMMARY ***
Total pot $34 | Rake $1.70 
Board [7s Kd Js 5d 5c]
Seat 1: Fitzyferret folded before Flop (didn't bet)
Seat 2: patpaty folded on the Flop
Seat 3: Painkiller72 (button) folded before Flop (didn't bet)
Seat 4: KovIFish89 (small blind) showed [Kh 6d] and won ($32.30) with two pair, Kings and Fives
Seat 5: zmOe84 (big blind) mucked [Jh 6h]
Seat 6: Spid1 folded before Flop (didn't bet)
Seat 7: matiko09 folded before Flop (didn't bet)
Seat 8: Durnichka folded before Flop (didn't bet)
Seat 9: gabi_igna folded before Flop (didn't bet)





PokerStars Hand #152884635980:  Hold'em No Limit ($1/$2 USD) - 2016/05/05 15:54:38 CET [2016/05/05 9:54:38 ET]
Table 'Euporie II' 9-max Seat #6 is the button
Seat 1: Durnichka ($189.15 in chips) 
Seat 2: nickreason17 ($200 in chips) 
Seat 3: Spid1 ($200 in chips) 
Seat 5: Nuskatko1986 ($159.01 in chips) 
Seat 6: glanza_mike ($204 in chips) 
Seat 7: matiko09 ($203 in chips) 
Seat 8: Painkiller72 ($200 in chips) 
matiko09: posts small blind $1
Painkiller72: posts big blind $2
T0ny Adams: sits out 
Kukuryzka: sits out 
*** HOLE CARDS ***
Dealt to matiko09 [Ts 4d]
Durnichka: folds 
nickreason17: raises $3 to $5
Spid1: folds 
Nuskatko1986: folds 
glanza_mike: folds 
matiko09: folds 
Painkiller72: folds 
Uncalled bet ($3) returned to nickreason17
nickreason17 collected $5 from pot
*** SUMMARY ***
Total pot $5 | Rake $0 
Seat 1: Durnichka folded before Flop (didn't bet)
Seat 2: nickreason17 collected ($5)
Seat 3: Spid1 folded before Flop (didn't bet)
Seat 5: Nuskatko1986 folded before Flop (didn't bet)
Seat 6: glanza_mike (button) folded before Flop (didn't bet)
Seat 7: matiko09 (small blind) folded before Flop
Seat 8: Painkiller72 (big blind) folded before Flop





PokerStars Hand #152884639546:  Hold'em No Limit ($0.50/$1.00 USD) - 2016/05/05 15:54:45 CET [2016/05/05 9:54:45 ET]
Table 'Pyxis III' 9-max Seat #2 is the button
Seat 1: sanpidk ($189.89 in chips) 
Seat 2: SPmaka ($97 in chips) 
Seat 3: vrnMike ($100 in chips) 
Seat 5: darren1031 ($97.10 in chips) 
Seat 6: kamillo91 ($87 in chips) 
Seat 7: mycka86 ($105.38 in chips) 
Seat 8: matiko09 ($107.25 in chips) 
Seat 9: Hypoaroused ($172.38 in chips) 
vrnMike: posts small blind $0.50
darren1031: posts big blind $1
*** HOLE CARDS ***
Dealt to matiko09 [5h Qs]
kamillo91: calls $1
mycka86: folds 
matiko09: folds 
Hypoaroused: folds 
sanpidk: folds 
SPmaka: folds 
vrnMike: calls $0.50
darren1031: checks 
*** FLOP *** [Js 8h 5s]
vrnMike: checks 
darren1031: checks 
kamillo91: bets $3
vrnMike: folds 
darren1031: folds 
Uncalled bet ($3) returned to kamillo91
kamillo91 collected $2.85 from pot
kamillo91: doesn't show hand 
*** SUMMARY ***
Total pot $3 | Rake $0.15 
Board [Js 8h 5s]
Seat 1: sanpidk folded before Flop (didn't bet)
Seat 2: SPmaka (button) folded before Flop (didn't bet)
Seat 3: vrnMike (small blind) folded on the Flop
Seat 5: darren1031 (big blind) folded on the Flop
Seat 6: kamillo91 collected ($2.85)
Seat 7: mycka86 folded before Flop (didn't bet)
Seat 8: matiko09 folded before Flop (didn't bet)
Seat 9: Hypoaroused folded before Flop (didn't bet)





PokerStars Hand #152884643626:  Hold'em No Limit ($1/$2 USD) - 2016/05/05 15:54:52 CET [2016/05/05 9:54:52 ET]
Table 'Samitchell' 9-max Seat #5 is the button
Seat 1: KovIFish89 ($200 in chips) 
Seat 2: matiko09 ($200 in chips) 
Seat 3: gabi_igna ($314.32 in chips) 
Seat 4: Fitzyferret ($369.22 in chips) 
Seat 5: Spid1 ($206.60 in chips) 
Seat 6: nickreason17 ($210 in chips) 
Seat 7: patpaty ($167.84 in chips) 
Seat 9: kblkxls ($144.07 in chips) 
nickreason17: posts small blind $1
patpaty: posts big blind $2
WolleMalone: sits out 
*** HOLE CARDS ***
Dealt to matiko09 [9c 3d]
kblkxls has timed out
kblkxls: folds 
KovIFish89: folds 
matiko09: folds 
gabi_igna: folds 
Fitzyferret: folds 
Spid1: raises $3 to $5
kblkxls said, "sorry about that"
nickreason17: folds 
patpaty: calls $3
*** FLOP *** [9d Jc Qd]
patpaty: checks 
Spid1: bets $9
patpaty: calls $9
*** TURN *** [9d Jc Qd] [7s]
patpaty: checks 
Spid1: bets $19
patpaty: folds 
Uncalled bet ($19) returned to Spid1
Spid1 collected $27.55 from pot
Spid1: doesn't show hand 
*** SUMMARY ***
Total pot $29 | Rake $1.45 
Board [9d Jc Qd 7s]
Seat 1: KovIFish89 folded before Flop (didn't bet)
Seat 2: matiko09 folded before Flop (didn't bet)
Seat 3: gabi_igna folded before Flop (didn't bet)
Seat 4: Fitzyferret folded before Flop (didn't bet)
Seat 5: Spid1 (button) collected ($27.55)
Seat 6: nickreason17 (small blind) folded before Flop
Seat 7: patpaty (big blind) folded on the Turn
Seat 9: kblkxls folded before Flop (didn't bet)





PokerStars Hand #152884649300:  Hold'em No Limit ($0.50/$1.00 USD) - 2016/05/05 15:55:01 CET [2016/05/05 9:55:01 ET]
Table 'Lictoria II' 9-max Seat #9 is the button
Seat 1: St.LaCoste ($100.50 in chips) 
Seat 2: Dantist1122 ($122.96 in chips) 
Seat 3: Krinica2009 ($104 in chips) 
Seat 5: sanpidk ($150.26 in chips) 
Seat 6: gabi_igna ($210.73 in chips) 
Seat 7: Painkiller72 ($153.92 in chips) 
Seat 8: matiko09 ($102.50 in chips) 
Seat 9: Kukuryzka ($141.81 in chips) 
St.LaCoste: posts small blind $0.50
Dantist1122: posts big blind $1
*** HOLE CARDS ***
Dealt to matiko09 [Ad 5h]
Krinica2009: folds 
sanpidk: folds 
gabi_igna: folds 
Ying59 leaves the table
Painkiller72: folds 
matiko09: folds 
Kukuryzka: folds 
St.LaCoste: folds 
Uncalled bet ($0.50) returned to Dantist1122
Dantist1122 collected $1 from pot
Dantist1122: doesn't show hand 
*** SUMMARY ***
Total pot $1 | Rake $0 
Seat 1: St.LaCoste (small blind) folded before Flop
Seat 2: Dantist1122 (big blind) collected ($1)
Seat 3: Krinica2009 folded before Flop (didn't bet)
Seat 5: sanpidk folded before Flop (didn't bet)
Seat 6: gabi_igna folded before Flop (didn't bet)
Seat 7: Painkiller72 folded before Flop (didn't bet)
Seat 8: matiko09 folded before Flop (didn't bet)
Seat 9: Kukuryzka (button) folded before Flop (didn't bet)





PokerStars Hand #152884650475:  Hold'em No Limit (€0.50/€1.00 EUR) - 2016/05/05 15:55:04 CET [2016/05/05 9:55:04 ET]
Table 'Nenetta III' 9-max Seat #3 is the button
Seat 3: Racushniak (€100 in chips) 
Seat 4: puppet1509 (€38 in chips) 
Seat 5: Painkiller72 (€100 in chips) 
Seat 6: drissmouzou (€59.41 in chips) 
Seat 7: Spid1 (€101.50 in chips) 
Seat 8: St.LaCoste (€107 in chips) 
Seat 9: matiko09 (€100 in chips) 
puppet1509: posts small blind €0.50
Painkiller72: posts big blind €1
FroggyPlay: sits out 
*** HOLE CARDS ***
Dealt to matiko09 [Ks 2c]
drissmouzou: folds 
Spid1: folds 
St.LaCoste: folds 
drissmouzou leaves the table
matiko09: folds 
sanpidk joins the table at seat #6 
Racushniak: folds 
puppet1509: folds 
Uncalled bet (€0.50) returned to Painkiller72
Painkiller72 collected €1 from pot
Painkiller72: doesn't show hand 
*** SUMMARY ***
Total pot €1 | Rake €0 
Seat 3: Racushniak (button) folded before Flop (didn't bet)
Seat 4: puppet1509 (small blind) folded before Flop
Seat 5: Painkiller72 (big blind) collected (€1)
Seat 6: drissmouzou folded before Flop (didn't bet)
Seat 7: Spid1 folded before Flop (didn't bet)
Seat 8: St.LaCoste folded before Flop (didn't bet)
Seat 9: matiko09 folded before Flop (didn't bet)





PokerStars Hand #152884654347:  Hold'em No Limit (€0.50/€1.00 EUR) - 2016/05/05 15:55:10 CET [2016/05/05 9:55:10 ET]
Table 'Carol II' 9-max Seat #6 is the button
Seat 1: vrnMike (€100 in chips) 
Seat 2: matiko09 (€107 in chips) 
Seat 4: Merlin_1905 (€66.65 in chips) 
Seat 5: Painkiller72 (€100 in chips) 
Seat 6: Kukuryzka (€99.50 in chips) 
Seat 7: Spid1 (€100 in chips) 
Seat 8: sanpidk (€100 in chips) 
Seat 9: Racushniak (€247.20 in chips) 
Spid1: posts small blind €0.50
sanpidk: posts big blind €1
*** HOLE CARDS ***
Dealt to matiko09 [9d Kd]
Racushniak: folds 
vrnMike: folds 
matiko09: folds 
Merlin_1905: folds 
Painkiller72: raises €1.50 to €2.50
Kukuryzka: folds 
Spid1: folds 
sanpidk: raises €6.50 to €9
Painkiller72: calls €6.50
*** FLOP *** [Ts Qd 8h]
sanpidk: bets €11
Painkiller72: folds 
Uncalled bet (€11) returned to sanpidk
sanpidk collected €17.58 from pot
sanpidk: doesn't show hand 
*** SUMMARY ***
Total pot €18.50 | Rake €0.92 
Board [Ts Qd 8h]
Seat 1: vrnMike folded before Flop (didn't bet)
Seat 2: matiko09 folded before Flop (didn't bet)
Seat 4: Merlin_1905 folded before Flop (didn't bet)
Seat 5: Painkiller72 folded on the Flop
Seat 6: Kukuryzka (button) folded before Flop (didn't bet)
Seat 7: Spid1 (small blind) folded before Flop
Seat 8: sanpidk (big blind) collected (€17.58)
Seat 9: Racushniak folded before Flop (didn't bet)





PokerStars Hand #152884658826:  Hold'em No Limit ($1/$2 USD) - 2016/05/05 15:55:20 CET [2016/05/05 9:55:20 ET]
Table 'Euporie II' 9-max Seat #7 is the button
Seat 1: Durnichka ($189.15 in chips) 
Seat 2: nickreason17 ($203 in chips) 
Seat 3: Spid1 ($200 in chips) 
Seat 5: Nuskatko1986 ($159.01 in chips) 
Seat 6: glanza_mike ($204 in chips) 
Seat 7: matiko09 ($202 in chips) 
Seat 8: Painkiller72 ($200 in chips) 
Seat 9: T0ny Adams ($83.75 in chips) 
Painkiller72: posts small blind $1
T0ny Adams: posts big blind $2
Kukuryzka: sits out 
*** HOLE CARDS ***
Dealt to matiko09 [5c Jd]
Durnichka: folds 
nickreason17: folds 
Spid1: folds 
Nuskatko1986: folds 
glanza_mike: raises $4 to $6
matiko09: folds 
Painkiller72: folds 
T0ny Adams: folds 
Uncalled bet ($4) returned to glanza_mike
glanza_mike collected $5 from pot
glanza_mike: doesn't show hand 
*** SUMMARY ***
Total pot $5 | Rake $0 
Seat 1: Durnichka folded before Flop (didn't bet)
Seat 2: nickreason17 folded before Flop (didn't bet)
Seat 3: Spid1 folded before Flop (didn't bet)
Seat 5: Nuskatko1986 folded before Flop (didn't bet)
Seat 6: glanza_mike collected ($5)
Seat 7: matiko09 (button) folded before Flop (didn't bet)
Seat 8: Painkiller72 (small blind) folded before Flop
Seat 9: T0ny Adams (big blind) folded before Flop





PokerStars Hand #152884661821:  Hold'em No Limit ($0.50/$1.00 USD) - 2016/05/05 15:55:26 CET [2016/05/05 9:55:26 ET]
Table 'Calypso II' 9-max Seat #7 is the button
Seat 1: nickreason17 ($105.80 in chips) 
Seat 2: torkkdnm ($139 in chips) 
Seat 3: gabi_igna ($109.09 in chips) 
Seat 4: sanpidk ($100 in chips) 
Seat 5: LighTingSSSS ($92.13 in chips) 
Seat 6: WTAPSVG ($175.25 in chips) 
Seat 7: ipashutapkom ($87.83 in chips) 
Seat 8: matiko09 ($106.80 in chips) 
Seat 9: maxxmeister ($100 in chips) 
matiko09: posts small blind $0.50
maxxmeister: posts big blind $1
*** HOLE CARDS ***
Dealt to matiko09 [Th 7d]
nickreason17: folds 
torkkdnm: folds 
gabi_igna: folds 
sanpidk: folds 
LighTingSSSS: folds 
WTAPSVG: folds 
ipashutapkom: raises $1.26 to $2.26
matiko09: folds 
maxxmeister: calls $1.26
*** FLOP *** [6d Jd 5d]
maxxmeister: checks 
ipashutapkom: bets $1.52
maxxmeister: calls $1.52
*** TURN *** [6d Jd 5d] [Td]
maxxmeister: checks 
ipashutapkom: checks 
*** RIVER *** [6d Jd 5d Td] [8h]
maxxmeister: checks 
ipashutapkom: bets $5.13
maxxmeister: folds 
Uncalled bet ($5.13) returned to ipashutapkom
ipashutapkom collected $7.66 from pot
ipashutapkom: doesn't show hand 
*** SUMMARY ***
Total pot $8.06 | Rake $0.40 
Board [6d Jd 5d Td 8h]
Seat 1: nickreason17 folded before Flop (didn't bet)
Seat 2: torkkdnm folded before Flop (didn't bet)
Seat 3: gabi_igna folded before Flop (didn't bet)
Seat 4: sanpidk folded before Flop (didn't bet)
Seat 5: LighTingSSSS folded before Flop (didn't bet)
Seat 6: WTAPSVG folded before Flop (didn't bet)
Seat 7: ipashutapkom (button) collected ($7.66)
Seat 8: matiko09 (small blind) folded before Flop
Seat 9: maxxmeister (big blind) folded on the River





PokerStars Hand #152884662231:  Hold'em No Limit ($1/$2 USD) - 2016/05/05 15:55:27 CET [2016/05/05 9:55:27 ET]
Table 'Tololo' 9-max Seat #4 is the button
Seat 1: Kukuryzka ($200 in chips) 
Seat 2: gabi_igna ($237.39 in chips) 
Seat 3: nickreason17 ($229.22 in chips) 
Seat 4: mooose100 ($193.69 in chips) 
Seat 5: matiko09 ($200 in chips) 
Seat 6: Xagua ($126.83 in chips) 
Seat 7: Iggso ($208.25 in chips) 
Seat 8: KovIFish89 ($203 in chips) 
Seat 9: Fitzyferret ($322.24 in chips) 
matiko09: posts small blind $1
Xagua: posts big blind $2
*** HOLE CARDS ***
Dealt to matiko09 [Jc 4c]
Iggso: folds 
KovIFish89: folds 
Fitzyferret: folds 
Iggso leaves the table
Kukuryzka: raises $4 to $6
gabi_igna: folds 
nickreason17: calls $6
mooose100: folds 
matiko09: folds 
Xagua: calls $4
*** FLOP *** [5h Jh 5d]
Xagua: checks 
Kukuryzka: bets $13.54
nickreason17: folds 
Xagua: folds 
Uncalled bet ($13.54) returned to Kukuryzka
Kukuryzka collected $18.05 from pot
Kukuryzka: doesn't show hand 
*** SUMMARY ***
Total pot $19 | Rake $0.95 
Board [5h Jh 5d]
Seat 1: Kukuryzka collected ($18.05)
Seat 2: gabi_igna folded before Flop (didn't bet)
Seat 3: nickreason17 folded on the Flop
Seat 4: mooose100 (button) folded before Flop (didn't bet)
Seat 5: matiko09 (small blind) folded before Flop
Seat 6: Xagua (big blind) folded on the Flop
Seat 7: Iggso folded before Flop (didn't bet)
Seat 8: KovIFish89 folded before Flop (didn't bet)
Seat 9: Fitzyferret folded before Flop (didn't bet)





PokerStars Hand #152884662831:  Hold'em No Limit (€0.50/€1.00 EUR) - 2016/05/05 15:55:28 CET [2016/05/05 9:55:28 ET]
Table 'Nenetta III' 9-max Seat #4 is the button
Seat 3: Racushniak (€100 in chips) 
Seat 4: puppet1509 (€37.50 in chips) 
Seat 5: Painkiller72 (€100.50 in chips) 
Seat 6: sanpidk (€100 in chips) 
Seat 7: Spid1 (€101.50 in chips) 
Seat 8: St.LaCoste (€107 in chips) 
Seat 9: matiko09 (€100 in chips) 
Painkiller72: posts small blind €0.50
sanpidk: posts big blind €1
FroggyPlay: sits out 
*** HOLE CARDS ***
Dealt to matiko09 [As 3s]
Spid1: folds 
St.LaCoste: folds 
matiko09: raises €2 to €3
Racushniak: raises €6 to €9
puppet1509: folds 
Painkiller72: folds 
sanpidk: folds 
matiko09: raises €10 to €19
Racushniak: folds 
Uncalled bet (€10) returned to matiko09
matiko09 collected €19.50 from pot
matiko09: doesn't show hand 
*** SUMMARY ***
Total pot €19.50 | Rake €0 
Seat 3: Racushniak folded before Flop
Seat 4: puppet1509 (button) folded before Flop (didn't bet)
Seat 5: Painkiller72 (small blind) folded before Flop
Seat 6: sanpidk (big blind) folded before Flop
Seat 7: Spid1 folded before Flop (didn't bet)
Seat 8: St.LaCoste folded before Flop (didn't bet)
Seat 9: matiko09 collected (€19.50)





PokerStars Hand #152884663396:  Hold'em No Limit ($0.50/$1.00 USD) - 2016/05/05 15:55:30 CET [2016/05/05 9:55:30 ET]
Table 'Musa II' 9-max Seat #4 is the button
Seat 1: KovIFish89 ($209.47 in chips) 
Seat 2: koutani7 ($98.50 in chips) 
Seat 3: vrnMike ($108.88 in chips) 
Seat 4: sanpidk ($100 in chips) 
Seat 5: Chin41178 ($99 in chips) 
Seat 6: cnn123 ($77.96 in chips) 
Seat 7: Painkiller72 ($100 in chips) 
Seat 8: matiko09 ($100 in chips) 
Seat 9: antfurto ($90.18 in chips) 
Chin41178: posts small blind $0.50
cnn123: posts big blind $1
*** HOLE CARDS ***
Dealt to matiko09 [6s 6d]
Painkiller72: folds 
matiko09: raises $2 to $3
antfurto: folds 
KovIFish89: folds 
koutani7: folds 
vrnMike: folds 
sanpidk: folds 
Chin41178: folds 
cnn123: folds 
Uncalled bet ($2) returned to matiko09
matiko09 collected $2.50 from pot
matiko09: doesn't show hand 
*** SUMMARY ***
Total pot $2.50 | Rake $0 
Seat 1: KovIFish89 folded before Flop (didn't bet)
Seat 2: koutani7 folded before Flop (didn't bet)
Seat 3: vrnMike folded before Flop (didn't bet)
Seat 4: sanpidk (button) folded before Flop (didn't bet)
Seat 5: Chin41178 (small blind) folded before Flop
Seat 6: cnn123 (big blind) folded before Flop
Seat 7: Painkiller72 folded before Flop (didn't bet)
Seat 8: matiko09 collected ($2.50)
Seat 9: antfurto folded before Flop (didn't bet)





PokerStars Hand #152884664181:  Hold'em No Limit ($0.50/$1.00 USD) - 2016/05/05 15:55:31 CET [2016/05/05 9:55:31 ET]
Table 'Priska II' 9-max Seat #5 is the button
Seat 1: Spid1 ($112.85 in chips) 
Seat 2: Kukuryzka ($131.52 in chips) 
Seat 3: matiko09 ($100 in chips) 
Seat 4: Painkiller72 ($155.84 in chips) 
Seat 5: nickreason17 ($171.55 in chips) 
Seat 6: St.LaCoste ($100 in chips) 
Seat 7: stockbridge8 ($89.27 in chips) 
Seat 8: pohorc21 ($143.86 in chips) 
Seat 9: torkkdnm ($100 in chips) 
St.LaCoste: posts small blind $0.50
stockbridge8: posts big blind $1
*** HOLE CARDS ***
Dealt to matiko09 [Js 4c]
pohorc21: folds 
torkkdnm: folds 
Spid1: folds 
Kukuryzka: folds 
matiko09: folds 
Painkiller72: folds 
nickreason17: raises $1 to $2
St.LaCoste: folds 
stockbridge8: folds 
Uncalled bet ($1) returned to nickreason17
nickreason17 collected $2.50 from pot
*** SUMMARY ***
Total pot $2.50 | Rake $0 
Seat 1: Spid1 folded before Flop (didn't bet)
Seat 2: Kukuryzka folded before Flop (didn't bet)
Seat 3: matiko09 folded before Flop (didn't bet)
Seat 4: Painkiller72 folded before Flop (didn't bet)
Seat 5: nickreason17 (button) collected ($2.50)
Seat 6: St.LaCoste (small blind) folded before Flop
Seat 7: stockbridge8 (big blind) folded before Flop
Seat 8: pohorc21 folded before Flop (didn't bet)
Seat 9: torkkdnm folded before Flop (didn't bet)





PokerStars Hand #152884667262:  Hold'em No Limit ($0.50/$1.00 USD) - 2016/05/05 15:55:37 CET [2016/05/05 9:55:37 ET]
Table 'Lictoria II' 9-max Seat #1 is the button
Seat 1: St.LaCoste ($100 in chips) 
Seat 2: Dantist1122 ($123.46 in chips) 
Seat 3: Krinica2009 ($104 in chips) 
Seat 5: sanpidk ($150.26 in chips) 
Seat 6: gabi_igna ($210.73 in chips) 
Seat 7: Painkiller72 ($153.92 in chips) 
Seat 8: matiko09 ($102.50 in chips) 
Seat 9: Kukuryzka ($141.81 in chips) 
Dantist1122: posts small blind $0.50
Krinica2009: posts big blind $1
*** HOLE CARDS ***
Dealt to matiko09 [2h Tc]
sanpidk: folds 
gabi_igna: folds 
Hayer ana joins the table at seat #4 
Painkiller72: folds 
matiko09: folds 
Kukuryzka: folds 
St.LaCoste: folds 
Dantist1122: raises $2 to $3
Krinica2009: calls $2
*** FLOP *** [Js 2c 7s]
Hayer ana leaves the table
Dantist1122: checks 
Krinica2009: bets $3.79
mycka86 joins the table at seat #4 
Dantist1122: folds 
Uncalled bet ($3.79) returned to Krinica2009
Krinica2009 collected $5.70 from pot
Krinica2009: doesn't show hand 
*** SUMMARY ***
Total pot $6 | Rake $0.30 
Board [Js 2c 7s]
Seat 1: St.LaCoste (button) folded before Flop (didn't bet)
Seat 2: Dantist1122 (small blind) folded on the Flop
Seat 3: Krinica2009 (big blind) collected ($5.70)
Seat 5: sanpidk folded before Flop (didn't bet)
Seat 6: gabi_igna folded before Flop (didn't bet)
Seat 7: Painkiller72 folded before Flop (didn't bet)
Seat 8: matiko09 folded before Flop (didn't bet)
Seat 9: Kukuryzka folded before Flop (didn't bet)





PokerStars Hand #152884672912:  Hold'em No Limit ($0.50/$1.00 USD) - 2016/05/05 15:55:49 CET [2016/05/05 9:55:49 ET]
Table 'Pyxis III' 9-max Seat #3 is the button
Seat 1: sanpidk ($189.89 in chips) 
Seat 2: SPmaka ($97 in chips) 
Seat 3: vrnMike ($100 in chips) 
Seat 5: darren1031 ($96.10 in chips) 
Seat 6: kamillo91 ($88.85 in chips) 
Seat 7: mycka86 ($105.38 in chips) 
Seat 8: matiko09 ($107.25 in chips) 
Seat 9: Hypoaroused ($172.38 in chips) 
darren1031: posts small blind $0.50
kamillo91: posts big blind $1
*** HOLE CARDS ***
Dealt to matiko09 [3h Qd]
mycka86: folds 
matiko09: folds 
Hypoaroused: folds 
sanpidk: folds 
SPmaka: raises $1 to $2
vrnMike: folds 
darren1031: calls $1.50
kamillo91: calls $1
*** FLOP *** [As 2s Tc]
darren1031: checks 
kamillo91: checks 
SPmaka: bets $2.85
darren1031: raises $2.85 to $5.70
kamillo91: folds 
SPmaka: calls $2.85
*** TURN *** [As 2s Tc] [8h]
darren1031: bets $8.26
SPmaka: folds 
Uncalled bet ($8.26) returned to darren1031
darren1031 collected $16.53 from pot
*** SUMMARY ***
Total pot $17.40 | Rake $0.87 
Board [As 2s Tc 8h]
Seat 1: sanpidk folded before Flop (didn't bet)
Seat 2: SPmaka folded on the Turn
Seat 3: vrnMike (button) folded before Flop (didn't bet)
Seat 5: darren1031 (small blind) collected ($16.53)
Seat 6: kamillo91 (big blind) folded on the Flop
Seat 7: mycka86 folded before Flop (didn't bet)
Seat 8: matiko09 folded before Flop (didn't bet)
Seat 9: Hypoaroused folded before Flop (didn't bet)





PokerStars Hand #152884676170:  Hold'em No Limit ($0.50/$1.00 USD) - 2016/05/05 15:55:56 CET [2016/05/05 9:55:56 ET]
Table 'Musa II' 9-max Seat #5 is the button
Seat 1: KovIFish89 ($209.47 in chips) 
Seat 2: koutani7 ($98.50 in chips) 
Seat 3: vrnMike ($108.88 in chips) 
Seat 4: sanpidk ($100 in chips) 
Seat 5: Chin41178 ($98.50 in chips) 
Seat 6: cnn123 ($76.96 in chips) 
Seat 7: Painkiller72 ($100 in chips) 
Seat 8: matiko09 ($101.50 in chips) 
Seat 9: antfurto ($90.18 in chips) 
cnn123: posts small blind $0.50
Painkiller72: posts big blind $1
*** HOLE CARDS ***
Dealt to matiko09 [Ac Js]
matiko09: raises $2 to $3
antfurto: folds 
KovIFish89: folds 
koutani7: folds 
vrnMike: folds 
sanpidk: folds 
Chin41178: folds 
cnn123: folds 
Painkiller72: folds 
Uncalled bet ($2) returned to matiko09
matiko09 collected $2.50 from pot
matiko09: doesn't show hand 
*** SUMMARY ***
Total pot $2.50 | Rake $0 
Seat 1: KovIFish89 folded before Flop (didn't bet)
Seat 2: koutani7 folded before Flop (didn't bet)
Seat 3: vrnMike folded before Flop (didn't bet)
Seat 4: sanpidk folded before Flop (didn't bet)
Seat 5: Chin41178 (button) folded before Flop (didn't bet)
Seat 6: cnn123 (small blind) folded before Flop
Seat 7: Painkiller72 (big blind) folded before Flop
Seat 8: matiko09 collected ($2.50)
Seat 9: antfurto folded before Flop (didn't bet)





PokerStars Hand #152884676826:  Hold'em No Limit ($1/$2 USD) - 2016/05/05 15:55:57 CET [2016/05/05 9:55:57 ET]
Table 'Lundia' 9-max Seat #4 is the button
Seat 1: Fitzyferret ($200 in chips) 
Seat 2: patpaty ($186.50 in chips) 
Seat 3: Painkiller72 ($200 in chips) 
Seat 4: KovIFish89 ($234.76 in chips) 
Seat 5: zmOe84 ($177 in chips) 
Seat 6: Spid1 ($252.39 in chips) 
Seat 7: matiko09 ($251.11 in chips) 
Seat 8: Durnichka ($84 in chips) 
Seat 9: gabi_igna ($275.36 in chips) 
zmOe84: posts small blind $1
Spid1: posts big blind $2
*** HOLE CARDS ***
Dealt to matiko09 [7d Js]
matiko09: folds 
Durnichka: folds 
gabi_igna: folds 
Fitzyferret: folds 
patpaty: raises $6 to $8
Painkiller72: folds 
KovIFish89: folds 
zmOe84: folds 
Spid1: folds 
Uncalled bet ($6) returned to patpaty
patpaty collected $5 from pot
patpaty: doesn't show hand 
*** SUMMARY ***
Total pot $5 | Rake $0 
Seat 1: Fitzyferret folded before Flop (didn't bet)
Seat 2: patpaty collected ($5)
Seat 3: Painkiller72 folded before Flop (didn't bet)
Seat 4: KovIFish89 (button) folded before Flop (didn't bet)
Seat 5: zmOe84 (small blind) folded before Flop
Seat 6: Spid1 (big blind) folded before Flop
Seat 7: matiko09 folded before Flop (didn't bet)
Seat 8: Durnichka folded before Flop (didn't bet)
Seat 9: gabi_igna folded before Flop (didn't bet)





PokerStars Hand #152884680120:  Hold'em No Limit ($0.50/$1.00 USD) - 2016/05/05 15:56:04 CET [2016/05/05 9:56:04 ET]
Table 'Luthera' 9-max Seat #2 is the button
Seat 1: MrMattkk ($98.49 in chips) 
Seat 2: Spid1 ($100.50 in chips) 
Seat 3: ipashutapkom ($68.39 in chips) 
Seat 4: matiko09 ($100 in chips) 
Seat 5: Painkiller72 ($100 in chips) 
Seat 7: Chin41178 ($111.28 in chips) 
Seat 8: xdrKush420x ($96.50 in chips) 
Seat 9: vrnMike ($100 in chips) 
ipashutapkom: posts small blind $0.50
matiko09: posts big blind $1
Dantist1122: sits out 
*** HOLE CARDS ***
Dealt to matiko09 [Ah Ac]
Painkiller72: folds 
Chin41178: folds 
xdrKush420x: folds 
vrnMike: folds 
MrMattkk: calls $1
Spid1: folds 
ipashutapkom: raises $4.26 to $5.26
matiko09: calls $4.26
MrMattkk: folds 
*** FLOP *** [3c 5h Qd]
ipashutapkom: checks 
matiko09: bets $7
ipashutapkom: calls $7
*** TURN *** [3c 5h Qd] [Qh]
ipashutapkom: checks 
matiko09: bets $12
ipashutapkom: folds 
Uncalled bet ($12) returned to matiko09
matiko09 collected $24.24 from pot
matiko09: doesn't show hand 
*** SUMMARY ***
Total pot $25.52 | Rake $1.28 
Board [3c 5h Qd Qh]
Seat 1: MrMattkk folded before Flop
Seat 2: Spid1 (button) folded before Flop (didn't bet)
Seat 3: ipashutapkom (small blind) folded on the Turn
Seat 4: matiko09 (big blind) collected ($24.24)
Seat 5: Painkiller72 folded before Flop (didn't bet)
Seat 7: Chin41178 folded before Flop (didn't bet)
Seat 8: xdrKush420x folded before Flop (didn't bet)
Seat 9: vrnMike folded before Flop (didn't bet)





PokerStars Hand #152884679782:  Hold'em No Limit ($1/$2 USD) - 2016/05/05 15:56:04 CET [2016/05/05 9:56:04 ET]
Table 'Tololo' 9-max Seat #5 is the button
Seat 1: Kukuryzka ($212.05 in chips) 
Seat 2: gabi_igna ($237.39 in chips) 
Seat 3: nickreason17 ($223.22 in chips) 
Seat 4: mooose100 ($193.69 in chips) 
Seat 5: matiko09 ($200 in chips) 
Seat 6: Xagua ($120.83 in chips) 
Seat 8: KovIFish89 ($203 in chips) 
Seat 9: Fitzyferret ($322.24 in chips) 
Xagua: posts small blind $1
KovIFish89: posts big blind $2
*** HOLE CARDS ***
Dealt to matiko09 [Ah Ad]
Fitzyferret: raises $3.24 to $5.24
Kukuryzka: calls $5.24
gabi_igna: folds 
nickreason17: folds 
mooose100: calls $5.24
matiko09: raises $18.76 to $24
Xagua: folds 
KovIFish89: folds 
Fitzyferret: folds 
Kukuryzka: calls $18.76
mooose100: calls $18.76
*** FLOP *** [7s Jc 7d]
Kukuryzka: checks 
mooose100: bets $77.49
matiko09: calls $77.49
Kukuryzka: raises $110.56 to $188.05 and is all-in
mooose100: folds 
matiko09: calls $98.51 and is all-in
Uncalled bet ($12.05) returned to Kukuryzka
*** TURN *** [7s Jc 7d] [Jd]
*** RIVER *** [7s Jc 7d Jd] [Kh]
*** SHOW DOWN ***
Kukuryzka: shows [As Ac] (two pair, Aces and Jacks)
matiko09: shows [Ah Ad] (two pair, Aces and Jacks)
Kukuryzka collected $253.49 from pot
matiko09 collected $253.49 from pot
*** SUMMARY ***
Total pot $509.73 | Rake $2.75 
Board [7s Jc 7d Jd Kh]
Seat 1: Kukuryzka showed [As Ac] and won ($253.49) with two pair, Aces and Jacks
Seat 2: gabi_igna folded before Flop (didn't bet)
Seat 3: nickreason17 folded before Flop (didn't bet)
Seat 4: mooose100 folded on the Flop
Seat 5: matiko09 (button) showed [Ah Ad] and won ($253.49) with two pair, Aces and Jacks
Seat 6: Xagua (small blind) folded before Flop
Seat 8: KovIFish89 (big blind) folded before Flop
Seat 9: Fitzyferret folded before Flop





PokerStars Hand #152884680421:  Hold'em No Limit ($0.50/$1.00 USD) - 2016/05/05 15:56:05 CET [2016/05/05 9:56:05 ET]
Table 'Priska II' 9-max Seat #6 is the button
Seat 1: Spid1 ($112.85 in chips) 
Seat 2: Kukuryzka ($131.52 in chips) 
Seat 3: matiko09 ($100 in chips) 
Seat 4: Painkiller72 ($155.84 in chips) 
Seat 5: nickreason17 ($173.05 in chips) 
Seat 6: St.LaCoste ($100 in chips) 
Seat 7: stockbridge8 ($88.27 in chips) 
Seat 8: pohorc21 ($143.86 in chips) 
Seat 9: torkkdnm ($100 in chips) 
stockbridge8: posts small blind $0.50
pohorc21: posts big blind $1
*** HOLE CARDS ***
Dealt to matiko09 [8c 4s]
torkkdnm: folds 
Spid1: folds 
Kukuryzka: raises $2 to $3
matiko09: folds 
Painkiller72: folds 
nickreason17: folds 
St.LaCoste: calls $3
stockbridge8: folds 
pohorc21 is connected 
pohorc21: calls $2
*** FLOP *** [6d 9c 2d]
pohorc21: checks 
Kukuryzka: checks 
St.LaCoste: checks 
*** TURN *** [6d 9c 2d] [Ad]
pohorc21: checks 
Kukuryzka: checks 
St.LaCoste: bets $6.39
pohorc21: folds 
Kukuryzka: folds 
Uncalled bet ($6.39) returned to St.LaCoste
St.LaCoste collected $9.02 from pot
St.LaCoste: doesn't show hand 
*** SUMMARY ***
Total pot $9.50 | Rake $0.48 
Board [6d 9c 2d Ad]
Seat 1: Spid1 folded before Flop (didn't bet)
Seat 2: Kukuryzka folded on the Turn
Seat 3: matiko09 folded before Flop (didn't bet)
Seat 4: Painkiller72 folded before Flop (didn't bet)
Seat 5: nickreason17 folded before Flop (didn't bet)
Seat 6: St.LaCoste (button) collected ($9.02)
Seat 7: stockbridge8 (small blind) folded before Flop
Seat 8: pohorc21 (big blind) folded on the Turn
Seat 9: torkkdnm folded before Flop (didn't bet)





PokerStars Hand #152884680977:  Hold'em No Limit ($1/$2 USD) - 2016/05/05 15:56:06 CET [2016/05/05 9:56:06 ET]
Table 'Euporie II' 9-max Seat #8 is the button
Seat 2: nickreason17 ($203 in chips) 
Seat 3: Spid1 ($200 in chips) 
Seat 5: Nuskatko1986 ($159.01 in chips) 
Seat 6: glanza_mike ($207 in chips) 
Seat 7: matiko09 ($202 in chips) 
Seat 8: Painkiller72 ($200 in chips) 
Seat 9: T0ny Adams ($81.75 in chips) 
T0ny Adams: posts small blind $1
Durnichka: is sitting out 
nickreason17: posts big blind $2
Kukuryzka: sits out 
*** HOLE CARDS ***
Dealt to matiko09 [Ad 6d]
Spid1: raises $4 to $6
Nuskatko1986: folds 
glanza_mike: folds 
Durnichka leaves the table
matiko09: folds 
gabi_igna joins the table at seat #1 
Painkiller72: folds 
T0ny Adams: folds 
nickreason17: folds 
Uncalled bet ($4) returned to Spid1
Spid1 collected $5 from pot
Spid1: doesn't show hand 
*** SUMMARY ***
Total pot $5 | Rake $0 
Seat 2: nickreason17 (big blind) folded before Flop
Seat 3: Spid1 collected ($5)
Seat 5: Nuskatko1986 folded before Flop (didn't bet)
Seat 6: glanza_mike folded before Flop (didn't bet)
Seat 7: matiko09 folded before Flop (didn't bet)
Seat 8: Painkiller72 (button) folded before Flop (didn't bet)
Seat 9: T0ny Adams (small blind) folded before Flop





PokerStars Hand #152884685719:  Hold'em No Limit ($1/$2 USD) - 2016/05/05 15:56:16 CET [2016/05/05 9:56:16 ET]
Table 'Samitchell' 9-max Seat #6 is the button
Seat 1: KovIFish89 ($200 in chips) 
Seat 2: matiko09 ($200 in chips) 
Seat 3: gabi_igna ($314.32 in chips) 
Seat 4: Fitzyferret ($369.22 in chips) 
Seat 5: Spid1 ($220.15 in chips) 
Seat 6: nickreason17 ($209 in chips) 
Seat 7: patpaty ($153.84 in chips) 
Seat 8: WolleMalone ($200 in chips) 
Seat 9: kblkxls ($144.07 in chips) 
patpaty: posts small blind $1
WolleMalone: posts big blind $2
*** HOLE CARDS ***
Dealt to matiko09 [Jh 7h]
kblkxls: folds 
KovIFish89: folds 
matiko09: folds 
gabi_igna: folds 
Fitzyferret: folds 
Spid1: folds 
nickreason17: raises $2 to $4
patpaty: folds 
WolleMalone: folds 
Uncalled bet ($2) returned to nickreason17
nickreason17 collected $5 from pot
*** SUMMARY ***
Total pot $5 | Rake $0 
Seat 1: KovIFish89 folded before Flop (didn't bet)
Seat 2: matiko09 folded before Flop (didn't bet)
Seat 3: gabi_igna folded before Flop (didn't bet)
Seat 4: Fitzyferret folded before Flop (didn't bet)
Seat 5: Spid1 folded before Flop (didn't bet)
Seat 6: nickreason17 (button) collected ($5)
Seat 7: patpaty (small blind) folded before Flop
Seat 8: WolleMalone (big blind) folded before Flop
Seat 9: kblkxls folded before Flop (didn't bet)





PokerStars Hand #152884688074:  Hold'em No Limit (€0.50/€1.00 EUR) - 2016/05/05 15:56:21 CET [2016/05/05 9:56:21 ET]
Table 'Carol II' 9-max Seat #7 is the button
Seat 1: vrnMike (€100 in chips) 
Seat 2: matiko09 (€107 in chips) 
Seat 4: Merlin_1905 (€66.65 in chips) 
Seat 5: Painkiller72 (€100 in chips) 
Seat 6: Kukuryzka (€99.50 in chips) 
Seat 7: Spid1 (€100 in chips) 
Seat 8: sanpidk (€108.58 in chips) 
Seat 9: Racushniak (€247.20 in chips) 
sanpidk: posts small blind €0.50
Racushniak: posts big blind €1
*** HOLE CARDS ***
Dealt to matiko09 [Jd Th]
vrnMike: folds 
matiko09: folds 
Merlin_1905: folds 
Painkiller72: raises €1.50 to €2.50
Kukuryzka: folds 
Spid1: folds 
sanpidk: folds 
Racushniak: folds 
Uncalled bet (€1.50) returned to Painkiller72
Painkiller72 collected €2.50 from pot
Painkiller72: doesn't show hand 
*** SUMMARY ***
Total pot €2.50 | Rake €0 
Seat 1: vrnMike folded before Flop (didn't bet)
Seat 2: matiko09 folded before Flop (didn't bet)
Seat 4: Merlin_1905 folded before Flop (didn't bet)
Seat 5: Painkiller72 collected (€2.50)
Seat 6: Kukuryzka folded before Flop (didn't bet)
Seat 7: Spid1 (button) folded before Flop (didn't bet)
Seat 8: sanpidk (small blind) folded before Flop
Seat 9: Racushniak (big blind) folded before Flop





PokerStars Hand #152884689570:  Hold'em No Limit ($0.50/$1.00 USD) - 2016/05/05 15:56:24 CET [2016/05/05 9:56:24 ET]
Table 'Musa II' 9-max Seat #6 is the button
Seat 1: KovIFish89 ($209.47 in chips) 
Seat 2: koutani7 ($98.50 in chips) 
Seat 3: vrnMike ($108.88 in chips) 
Seat 4: sanpidk ($100 in chips) 
Seat 5: Chin41178 ($98.50 in chips) 
Seat 6: cnn123 ($76.46 in chips) 
Seat 7: Painkiller72 ($100 in chips) 
Seat 8: matiko09 ($103 in chips) 
Seat 9: antfurto ($90.18 in chips) 
Painkiller72: posts small blind $0.50
matiko09: posts big blind $1
*** HOLE CARDS ***
Dealt to matiko09 [6c 5s]
antfurto: raises $2 to $3
KovIFish89: raises $6 to $9
koutani7: folds 
vrnMike: folds 
sanpidk: folds 
Chin41178: calls $9
cnn123: folds 
Painkiller72: folds 
matiko09: folds 
antfurto: calls $6
*** FLOP *** [3c 6s 9d]
antfurto: bets $21.93
KovIFish89: folds 
Chin41178: calls $21.93
*** TURN *** [3c 6s 9d] [2d]
antfurto: bets $59.25 and is all-in
Chin41178: folds 
Uncalled bet ($59.25) returned to antfurto
antfurto collected $69.86 from pot
antfurto: doesn't show hand 
*** SUMMARY ***
Total pot $72.36 | Rake $2.50 
Board [3c 6s 9d 2d]
Seat 1: KovIFish89 folded on the Flop
Seat 2: koutani7 folded before Flop (didn't bet)
Seat 3: vrnMike folded before Flop (didn't bet)
Seat 4: sanpidk folded before Flop (didn't bet)
Seat 5: Chin41178 folded on the Turn
Seat 6: cnn123 (button) folded before Flop (didn't bet)
Seat 7: Painkiller72 (small blind) folded before Flop
Seat 8: matiko09 (big blind) folded before Flop
Seat 9: antfurto collected ($69.86)





PokerStars Hand #152884693623:  Hold'em No Limit ($0.50/$1.00 USD) - 2016/05/05 15:56:32 CET [2016/05/05 9:56:32 ET]
Table 'Calypso II' 9-max Seat #8 is the button
Seat 1: nickreason17 ($105.80 in chips) 
Seat 2: torkkdnm ($139 in chips) 
Seat 3: gabi_igna ($109.09 in chips) 
Seat 4: sanpidk ($100 in chips) 
Seat 5: LighTingSSSS ($92.13 in chips) 
Seat 6: WTAPSVG ($175.25 in chips) 
Seat 7: ipashutapkom ($91.71 in chips) 
Seat 8: matiko09 ($106.30 in chips) 
Seat 9: maxxmeister ($100 in chips) 
maxxmeister: posts small blind $0.50
nickreason17: posts big blind $1
*** HOLE CARDS ***
Dealt to matiko09 [4c 7s]
torkkdnm: folds 
gabi_igna: folds 
sanpidk: folds 
LighTingSSSS: folds 
WTAPSVG: folds 
ipashutapkom: folds 
matiko09: folds 
maxxmeister: folds 
Uncalled bet ($0.50) returned to nickreason17
nickreason17 collected $1 from pot
*** SUMMARY ***
Total pot $1 | Rake $0 
Seat 1: nickreason17 (big blind) collected ($1)
Seat 2: torkkdnm folded before Flop (didn't bet)
Seat 3: gabi_igna folded before Flop (didn't bet)
Seat 4: sanpidk folded before Flop (didn't bet)
Seat 5: LighTingSSSS folded before Flop (didn't bet)
Seat 6: WTAPSVG folded before Flop (didn't bet)
Seat 7: ipashutapkom folded before Flop (didn't bet)
Seat 8: matiko09 (button) folded before Flop (didn't bet)
Seat 9: maxxmeister (small blind) folded before Flop





PokerStars Hand #152884694365:  Hold'em No Limit (€0.50/€1.00 EUR) - 2016/05/05 15:56:34 CET [2016/05/05 9:56:34 ET]
Table 'Nenetta III' 9-max Seat #5 is the button
Seat 3: Racushniak (€100 in chips) 
Seat 4: puppet1509 (€37.50 in chips) 
Seat 5: Painkiller72 (€100 in chips) 
Seat 6: sanpidk (€100 in chips) 
Seat 7: Spid1 (€101.50 in chips) 
Seat 8: St.LaCoste (€107 in chips) 
Seat 9: matiko09 (€110.50 in chips) 
sanpidk: posts small blind €0.50
Spid1: posts big blind €1
FroggyPlay: sits out 
*** HOLE CARDS ***
Dealt to matiko09 [Th 9s]
St.LaCoste: folds 
matiko09: folds 
Racushniak: folds 
puppet1509: folds 
Painkiller72: folds 
sanpidk: folds 
Uncalled bet (€0.50) returned to Spid1
Spid1 collected €1 from pot
Spid1: doesn't show hand 
*** SUMMARY ***
Total pot €1 | Rake €0 
Seat 3: Racushniak folded before Flop (didn't bet)
Seat 4: puppet1509 folded before Flop (didn't bet)
Seat 5: Painkiller72 (button) folded before Flop (didn't bet)
Seat 6: sanpidk (small blind) folded before Flop
Seat 7: Spid1 (big blind) collected (€1)
Seat 8: St.LaCoste folded before Flop (didn't bet)
Seat 9: matiko09 folded before Flop (didn't bet)





PokerStars Hand #152884698851:  Hold'em No Limit ($1/$2 USD) - 2016/05/05 15:56:43 CET [2016/05/05 9:56:43 ET]
Table 'Lundia' 9-max Seat #5 is the button
Seat 1: Fitzyferret ($200 in chips) 
Seat 2: patpaty ($189.50 in chips) 
Seat 3: Painkiller72 ($200 in chips) 
Seat 4: KovIFish89 ($234.76 in chips) 
Seat 5: zmOe84 ($200 in chips) 
Seat 6: Spid1 ($250.39 in chips) 
Seat 7: matiko09 ($251.11 in chips) 
Seat 8: Durnichka ($84 in chips) 
Seat 9: gabi_igna ($275.36 in chips) 
Spid1: posts small blind $1
matiko09: posts big blind $2
*** HOLE CARDS ***
Dealt to matiko09 [2d Tc]
Durnichka: folds 
gabi_igna: folds 
Fitzyferret: folds 
patpaty: calls $2
Painkiller72: raises $7 to $9
KovIFish89: folds 
zmOe84: folds 
Spid1: folds 
matiko09: folds 
patpaty: calls $7
*** FLOP *** [2c 2s Kd]
patpaty: checks 
Painkiller72: bets $13.96
patpaty: calls $13.96
*** TURN *** [2c 2s Kd] [8s]
patpaty: checks 
Painkiller72: checks 
*** RIVER *** [2c 2s Kd 8s] [7d]
patpaty: bets $18
Painkiller72: calls $18
*** SHOW DOWN ***
patpaty: shows [9c 9d] (two pair, Nines and Deuces)
Painkiller72: mucks hand 
patpaty collected $82.17 from pot
*** SUMMARY ***
Total pot $84.92 | Rake $2.75 
Board [2c 2s Kd 8s 7d]
Seat 1: Fitzyferret folded before Flop (didn't bet)
Seat 2: patpaty showed [9c 9d] and won ($82.17) with two pair, Nines and Deuces
Seat 3: Painkiller72 mucked [8d Qd]
Seat 4: KovIFish89 folded before Flop (didn't bet)
Seat 5: zmOe84 (button) folded before Flop (didn't bet)
Seat 6: Spid1 (small blind) folded before Flop
Seat 7: matiko09 (big blind) folded before Flop
Seat 8: Durnichka folded before Flop (didn't bet)
Seat 9: gabi_igna folded before Flop (didn't bet)





PokerStars Hand #152884700149:  Hold'em No Limit ($1/$2 USD) - 2016/05/05 15:56:46 CET [2016/05/05 9:56:46 ET]
Table 'Euporie II' 9-max Seat #9 is the button
Seat 2: nickreason17 ($201 in chips) 
Seat 4: Kukuryzka ($200 in chips) 
Seat 5: Nuskatko1986 ($159.01 in chips) 
Seat 6: glanza_mike ($207 in chips) 
Seat 7: matiko09 ($202 in chips) 
Seat 8: Painkiller72 ($200 in chips) 
Seat 9: T0ny Adams ($80.75 in chips) 
gabi_igna will be allowed to play after the button
nickreason17: posts small blind $1
Spid1: is sitting out 
Kukuryzka: posts big blind $2
*** HOLE CARDS ***
Dealt to matiko09 [5s 2h]
Spid1 leaves the table
Nuskatko1986: calls $2
glanza_mike: folds 
matiko09: folds 
Painkiller72: folds 
T0ny Adams: folds 
nickreason17: calls $1
Kukuryzka: checks 
*** FLOP *** [Js Tc 6s]
nickreason17: checks 
Kukuryzka: bets $5
Nuskatko1986: calls $5
nickreason17: calls $5
*** TURN *** [Js Tc 6s] [Ad]
nickreason17: checks 
Kukuryzka: checks 
Nuskatko1986: checks 
*** RIVER *** [Js Tc 6s Ad] [Qs]
nickreason17: checks 
Kukuryzka: checks 
Nuskatko1986: bets $28
nickreason17: folds 
Kukuryzka: folds 
Uncalled bet ($28) returned to Nuskatko1986
Nuskatko1986 collected $19.95 from pot
Nuskatko1986: doesn't show hand 
*** SUMMARY ***
Total pot $21 | Rake $1.05 
Board [Js Tc 6s Ad Qs]
Seat 2: nickreason17 (small blind) folded on the River
Seat 4: Kukuryzka (big blind) folded on the River
Seat 5: Nuskatko1986 collected ($19.95)
Seat 6: glanza_mike folded before Flop (didn't bet)
Seat 7: matiko09 folded before Flop (didn't bet)
Seat 8: Painkiller72 folded before Flop (didn't bet)
Seat 9: T0ny Adams (button) folded before Flop (didn't bet)





PokerStars Hand #152884701249:  Hold'em No Limit (€0.50/€1.00 EUR) - 2016/05/05 15:56:48 CET [2016/05/05 9:56:48 ET]
Table 'Ohio II' 9-max Seat #5 is the button
Seat 3: matiko09 (€100 in chips) 
Seat 5: Painkiller72 (€100 in chips) 
Seat 9: drissmouzou (€55.80 in chips) 
drissmouzou: posts small blind €0.50
Spid1: is sitting out 
maxxmeister: is sitting out 
matiko09: posts big blind €1
*** HOLE CARDS ***
Dealt to matiko09 [9h Ac]
Spid1 leaves the table
Painkiller72: raises €1 to €2
drissmouzou: folds 
matiko09: calls €1
*** FLOP *** [Ks Jc 5c]
matiko09: checks 
Painkiller72: checks 
*** TURN *** [Ks Jc 5c] [6c]
matiko09: bets €2.78
Painkiller72: folds 
Uncalled bet (€2.78) returned to matiko09
matiko09 collected €4.28 from pot
matiko09: doesn't show hand 
*** SUMMARY ***
Total pot €4.50 | Rake €0.22 
Board [Ks Jc 5c 6c]
Seat 3: matiko09 (big blind) collected (€4.28)
Seat 5: Painkiller72 (button) folded on the Turn
Seat 9: drissmouzou (small blind) folded before Flop





PokerStars Hand #152884703320:  Hold'em No Limit ($0.50/$1.00 USD) - 2016/05/05 15:56:52 CET [2016/05/05 9:56:52 ET]
Table 'Lictoria II' 9-max Seat #2 is the button
Seat 1: St.LaCoste ($100 in chips) 
Seat 2: Dantist1122 ($120.46 in chips) 
Seat 3: Krinica2009 ($106.70 in chips) 
Seat 4: mycka86 ($100 in chips) 
Seat 5: sanpidk ($150.26 in chips) 
Seat 6: gabi_igna ($210.73 in chips) 
Seat 7: Painkiller72 ($153.92 in chips) 
Seat 8: matiko09 ($102.50 in chips) 
Seat 9: Kukuryzka ($141.81 in chips) 
Krinica2009: posts small blind $0.50
mycka86: posts big blind $1
*** HOLE CARDS ***
Dealt to matiko09 [9h Kc]
sanpidk: folds 
gabi_igna: folds 
Painkiller72: folds 
matiko09: folds 
Kukuryzka: folds 
St.LaCoste: folds 
Dantist1122: raises $1.50 to $2.50
Krinica2009: folds 
mycka86: folds 
Uncalled bet ($1.50) returned to Dantist1122
Dantist1122 collected $2.50 from pot
Dantist1122: doesn't show hand 
*** SUMMARY ***
Total pot $2.50 | Rake $0 
Seat 1: St.LaCoste folded before Flop (didn't bet)
Seat 2: Dantist1122 (button) collected ($2.50)
Seat 3: Krinica2009 (small blind) folded before Flop
Seat 4: mycka86 (big blind) folded before Flop
Seat 5: sanpidk folded before Flop (didn't bet)
Seat 6: gabi_igna folded before Flop (didn't bet)
Seat 7: Painkiller72 folded before Flop (didn't bet)
Seat 8: matiko09 folded before Flop (didn't bet)
Seat 9: Kukuryzka folded before Flop (didn't bet)





PokerStars Hand #152884706739:  Hold'em No Limit ($0.50/$1.00 USD) - 2016/05/05 15:56:59 CET [2016/05/05 9:56:59 ET]
Table 'Calypso II' 9-max Seat #9 is the button
Seat 1: nickreason17 ($106.30 in chips) 
Seat 2: torkkdnm ($139 in chips) 
Seat 3: gabi_igna ($109.09 in chips) 
Seat 4: sanpidk ($100 in chips) 
Seat 5: LighTingSSSS ($92.13 in chips) 
Seat 6: WTAPSVG ($175.25 in chips) 
Seat 7: ipashutapkom ($91.71 in chips) 
Seat 8: matiko09 ($106.30 in chips) 
Seat 9: maxxmeister ($100 in chips) 
nickreason17: posts small blind $0.50
torkkdnm: posts big blind $1
*** HOLE CARDS ***
Dealt to matiko09 [6d 4d]
gabi_igna: folds 
sanpidk: folds 
LighTingSSSS: folds 
WTAPSVG: folds 
ipashutapkom: folds 
matiko09: folds 
maxxmeister: folds 
nickreason17: folds 
Uncalled bet ($0.50) returned to torkkdnm
torkkdnm collected $1 from pot
*** SUMMARY ***
Total pot $1 | Rake $0 
Seat 1: nickreason17 (small blind) folded before Flop
Seat 2: torkkdnm (big blind) collected ($1)
Seat 3: gabi_igna folded before Flop (didn't bet)
Seat 4: sanpidk folded before Flop (didn't bet)
Seat 5: LighTingSSSS folded before Flop (didn't bet)
Seat 6: WTAPSVG folded before Flop (didn't bet)
Seat 7: ipashutapkom folded before Flop (didn't bet)
Seat 8: matiko09 folded before Flop (didn't bet)
Seat 9: maxxmeister (button) folded before Flop (didn't bet)





PokerStars Hand #152884708572:  Hold'em No Limit ($1/$2 USD) - 2016/05/05 15:57:03 CET [2016/05/05 9:57:03 ET]
Table 'Samitchell' 9-max Seat #7 is the button
Seat 1: KovIFish89 ($200 in chips) 
Seat 2: matiko09 ($200 in chips) 
Seat 3: gabi_igna ($314.32 in chips) 
Seat 4: Fitzyferret ($369.22 in chips) 
Seat 5: Spid1 ($220.15 in chips) 
Seat 6: nickreason17 ($212 in chips) 
Seat 7: patpaty ($152.84 in chips) 
Seat 8: WolleMalone ($200 in chips) 
Seat 9: kblkxls ($144.07 in chips) 
WolleMalone: posts small blind $1
kblkxls: posts big blind $2
*** HOLE CARDS ***
Dealt to matiko09 [Ah Qc]
KovIFish89: folds 
matiko09: raises $3 to $5
gabi_igna: folds 
Fitzyferret: folds 
Spid1: folds 
nickreason17: raises $12 to $17
patpaty: folds 
WolleMalone: folds 
kblkxls: folds 
matiko09: folds 
Uncalled bet ($12) returned to nickreason17
nickreason17 collected $13 from pot
*** SUMMARY ***
Total pot $13 | Rake $0 
Seat 1: KovIFish89 folded before Flop (didn't bet)
Seat 2: matiko09 folded before Flop
Seat 3: gabi_igna folded before Flop (didn't bet)
Seat 4: Fitzyferret folded before Flop (didn't bet)
Seat 5: Spid1 folded before Flop (didn't bet)
Seat 6: nickreason17 collected ($13)
Seat 7: patpaty (button) folded before Flop (didn't bet)
Seat 8: WolleMalone (small blind) folded before Flop
Seat 9: kblkxls (big blind) folded before Flop





PokerStars Hand #152884708931:  Hold'em No Limit ($1/$2 USD) - 2016/05/05 15:57:04 CET [2016/05/05 9:57:04 ET]
Table 'Tatry II' 9-max Seat #9 is the button
Seat 1: glanza_mike ($212.55 in chips) 
Seat 3: matiko09 ($200 in chips) 
Seat 4: WolleMalone ($206.40 in chips) 
Seat 5: Painkiller72 ($200 in chips) 
Seat 9: korol702 ($124.90 in chips) 
glanza_mike: posts small blind $1
Spid1: is sitting out 
matiko09: posts big blind $2
Kukuryzka: sits out 
nickreason17: sits out 
*** HOLE CARDS ***
Dealt to matiko09 [Tc 7h]
Spid1 leaves the table
WolleMalone: raises $3 to $5
Painkiller72: folds 
T0ny Adams joins the table at seat #2 
korol702: folds 
glanza_mike: folds 
matiko09: folds 
Uncalled bet ($3) returned to WolleMalone
WolleMalone collected $5 from pot
WolleMalone: doesn't show hand 
*** SUMMARY ***
Total pot $5 | Rake $0 
Seat 1: glanza_mike (small blind) folded before Flop
Seat 3: matiko09 (big blind) folded before Flop
Seat 4: WolleMalone collected ($5)
Seat 5: Painkiller72 folded before Flop (didn't bet)
Seat 9: korol702 (button) folded before Flop (didn't bet)





PokerStars Hand #152884716130:  Hold'em No Limit ($0.50/$1.00 USD) - 2016/05/05 15:57:18 CET [2016/05/05 9:57:18 ET]
Table 'Calypso II' 9-max Seat #1 is the button
Seat 1: nickreason17 ($105.80 in chips) 
Seat 2: torkkdnm ($139.50 in chips) 
Seat 3: gabi_igna ($109.09 in chips) 
Seat 4: sanpidk ($100 in chips) 
Seat 5: LighTingSSSS ($92.13 in chips) 
Seat 6: WTAPSVG ($175.25 in chips) 
Seat 7: ipashutapkom ($91.71 in chips) 
Seat 8: matiko09 ($106.30 in chips) 
Seat 9: maxxmeister ($100 in chips) 
torkkdnm: posts small blind $0.50
gabi_igna: posts big blind $1
*** HOLE CARDS ***
Dealt to matiko09 [Jc Kc]
sanpidk: folds 
LighTingSSSS: folds 
WTAPSVG: folds 
ipashutapkom: folds 
matiko09: raises $2 to $3
maxxmeister: folds 
nickreason17: folds 
torkkdnm: folds 
gabi_igna: folds 
Uncalled bet ($2) returned to matiko09
matiko09 collected $2.50 from pot
matiko09: doesn't show hand 
*** SUMMARY ***
Total pot $2.50 | Rake $0 
Seat 1: nickreason17 (button) folded before Flop (didn't bet)
Seat 2: torkkdnm (small blind) folded before Flop
Seat 3: gabi_igna (big blind) folded before Flop
Seat 4: sanpidk folded before Flop (didn't bet)
Seat 5: LighTingSSSS folded before Flop (didn't bet)
Seat 6: WTAPSVG folded before Flop (didn't bet)
Seat 7: ipashutapkom folded before Flop (didn't bet)
Seat 8: matiko09 collected ($2.50)
Seat 9: maxxmeister folded before Flop (didn't bet)





PokerStars Hand #152884721056:  Hold'em No Limit (€0.50/€1.00 EUR) - 2016/05/05 15:57:28 CET [2016/05/05 9:57:28 ET]
Table 'Carol II' 9-max Seat #8 is the button
Seat 1: vrnMike (€100 in chips) 
Seat 2: matiko09 (€107 in chips) 
Seat 4: Merlin_1905 (€66.65 in chips) 
Seat 5: Painkiller72 (€101.50 in chips) 
Seat 6: Kukuryzka (€99.50 in chips) 
Seat 7: Spid1 (€100 in chips) 
Seat 8: sanpidk (€108.08 in chips) 
Seat 9: Racushniak (€246.20 in chips) 
Racushniak: posts small blind €0.50
vrnMike: posts big blind €1
*** HOLE CARDS ***
Dealt to matiko09 [4h 6c]
matiko09: folds 
Merlin_1905: raises €2 to €3
Painkiller72: folds 
Kukuryzka: folds 
Spid1: folds 
sanpidk: folds 
Racushniak: folds 
vrnMike: raises €10 to €13
Merlin_1905: calls €10
*** FLOP *** [Tc Js 3h]
vrnMike: bets €87 and is all-in
Merlin_1905: calls €53.65 and is all-in
Uncalled bet (€33.35) returned to vrnMike
*** TURN *** [Tc Js 3h] [4s]
*** RIVER *** [Tc Js 3h 4s] [2s]
*** SHOW DOWN ***
vrnMike: shows [Kd Ac] (high card Ace)
Merlin_1905: shows [5c 5s] (a pair of Fives)
Merlin_1905 collected €131.55 from pot
*** SUMMARY ***
Total pot €133.80 | Rake €2.25 
Board [Tc Js 3h 4s 2s]
Seat 1: vrnMike (big blind) showed [Kd Ac] and lost with high card Ace
Seat 2: matiko09 folded before Flop (didn't bet)
Seat 4: Merlin_1905 showed [5c 5s] and won (€131.55) with a pair of Fives
Seat 5: Painkiller72 folded before Flop (didn't bet)
Seat 6: Kukuryzka folded before Flop (didn't bet)
Seat 7: Spid1 folded before Flop (didn't bet)
Seat 8: sanpidk (button) folded before Flop (didn't bet)
Seat 9: Racushniak (small blind) folded before Flop





PokerStars Hand #152884721666:  Hold'em No Limit ($0.50/$1.00 USD) - 2016/05/05 15:57:30 CET [2016/05/05 9:57:30 ET]
Table 'Pyxis III' 9-max Seat #5 is the button
Seat 1: sanpidk ($189.89 in chips) 
Seat 2: SPmaka ($89.30 in chips) 
Seat 3: vrnMike ($100 in chips) 
Seat 5: darren1031 ($104.93 in chips) 
Seat 6: kamillo91 ($86.85 in chips) 
Seat 7: mycka86 ($105.38 in chips) 
Seat 8: matiko09 ($107.25 in chips) 
Seat 9: Hypoaroused ($172.38 in chips) 
kamillo91: posts small blind $0.50
mycka86: posts big blind $1
*** HOLE CARDS ***
Dealt to matiko09 [9s 6c]
matiko09: folds 
Hypoaroused: folds 
sanpidk: raises $2 to $3
SPmaka: folds 
vrnMike: raises $6 to $9
darren1031: folds 
kamillo91: folds 
mycka86: folds 
sanpidk: calls $6
*** FLOP *** [7d Jc 3h]
sanpidk: checks 
vrnMike: bets $6.50
sanpidk: calls $6.50
*** TURN *** [7d Jc 3h] [Qc]
sanpidk: checks 
vrnMike: checks 
*** RIVER *** [7d Jc 3h Qc] [4c]
sanpidk: bets $16
vrnMike: raises $68.50 to $84.50 and is all-in
sanpidk: calls $68.50
*** SHOW DOWN ***
vrnMike: shows [9c 8c] (a flush, Queen high)
sanpidk: shows [Kc Ac] (a flush, Ace high)
sanpidk collected $199 from pot
*** SUMMARY ***
Total pot $201.50 | Rake $2.50 
Board [7d Jc 3h Qc 4c]
Seat 1: sanpidk showed [Kc Ac] and won ($199) with a flush, Ace high
Seat 2: SPmaka folded before Flop (didn't bet)
Seat 3: vrnMike showed [9c 8c] and lost with a flush, Queen high
Seat 5: darren1031 (button) folded before Flop (didn't bet)
Seat 6: kamillo91 (small blind) folded before Flop
Seat 7: mycka86 (big blind) folded before Flop
Seat 8: matiko09 folded before Flop (didn't bet)
Seat 9: Hypoaroused folded before Flop (didn't bet)





PokerStars Hand #152884722069:  Hold'em No Limit ($0.50/$1.00 USD) - 2016/05/05 15:57:30 CET [2016/05/05 9:57:30 ET]
Table 'Lictoria II' 9-max Seat #3 is the button
Seat 1: St.LaCoste ($100 in chips) 
Seat 2: Dantist1122 ($121.96 in chips) 
Seat 3: Krinica2009 ($106.20 in chips) 
Seat 4: mycka86 ($100 in chips) 
Seat 5: sanpidk ($150.26 in chips) 
Seat 6: gabi_igna ($210.73 in chips) 
Seat 7: Painkiller72 ($153.92 in chips) 
Seat 8: matiko09 ($102.50 in chips) 
Seat 9: Kukuryzka ($141.81 in chips) 
mycka86: posts small blind $0.50
sanpidk: posts big blind $1
*** HOLE CARDS ***
Dealt to matiko09 [9s 7d]
gabi_igna: folds 
Painkiller72: folds 
matiko09: folds 
Kukuryzka: folds 
St.LaCoste: folds 
Dantist1122: folds 
Krinica2009: folds 
mycka86: raises $1.75 to $2.75
sanpidk: folds 
Uncalled bet ($1.75) returned to mycka86
mycka86 collected $2 from pot
*** SUMMARY ***
Total pot $2 | Rake $0 
Seat 1: St.LaCoste folded before Flop (didn't bet)
Seat 2: Dantist1122 folded before Flop (didn't bet)
Seat 3: Krinica2009 (button) folded before Flop (didn't bet)
Seat 4: mycka86 (small blind) collected ($2)
Seat 5: sanpidk (big blind) folded before Flop
Seat 6: gabi_igna folded before Flop (didn't bet)
Seat 7: Painkiller72 folded before Flop (didn't bet)
Seat 8: matiko09 folded before Flop (didn't bet)
Seat 9: Kukuryzka folded before Flop (didn't bet)





PokerStars Hand #152884722231:  Hold'em No Limit ($1/$2 USD) - 2016/05/05 15:57:31 CET [2016/05/05 9:57:31 ET]
Table 'Tatry II' 9-max Seat #1 is the button
Seat 1: glanza_mike ($211.55 in chips) 
Seat 3: matiko09 ($200 in chips) 
Seat 4: WolleMalone ($209.40 in chips) 
Seat 5: Painkiller72 ($200 in chips) 
Seat 9: korol702 ($124.90 in chips) 
T0ny Adams will be allowed to play after the button
matiko09: posts small blind $1
WolleMalone: posts big blind $2
Kukuryzka: sits out 
nickreason17: sits out 
*** HOLE CARDS ***
Dealt to matiko09 [2c Ts]
Painkiller72: folds 
korol702: calls $2
glanza_mike: raises $5 to $7
matiko09: folds 
WolleMalone: calls $5
korol702: calls $5
*** FLOP *** [4d 2h Ah]
WolleMalone: checks 
korol702: checks 
glanza_mike: checks 
*** TURN *** [4d 2h Ah] [Td]
WolleMalone: bets $14
korol702: folds 
glanza_mike: calls $14
*** RIVER *** [4d 2h Ah Td] [5c]
WolleMalone: checks 
glanza_mike: bets $33.50
WolleMalone: folds 
Uncalled bet ($33.50) returned to glanza_mike
glanza_mike collected $47.50 from pot
glanza_mike: doesn't show hand 
*** SUMMARY ***
Total pot $50 | Rake $2.50 
Board [4d 2h Ah Td 5c]
Seat 1: glanza_mike (button) collected ($47.50)
Seat 3: matiko09 (small blind) folded before Flop
Seat 4: WolleMalone (big blind) folded on the River
Seat 5: Painkiller72 folded before Flop (didn't bet)
Seat 9: korol702 folded on the Turn





PokerStars Hand #152884727009:  Hold'em No Limit (€0.50/€1.00 EUR) - 2016/05/05 15:57:40 CET [2016/05/05 9:57:40 ET]
Table 'Ohio II' 9-max Seat #9 is the button
Seat 3: matiko09 (€102.28 in chips) 
Seat 5: Painkiller72 (€100 in chips) 
Seat 9: drissmouzou (€55.30 in chips) 
maxxmeister will be allowed to play after the button
matiko09: posts small blind €0.50
Painkiller72: posts big blind €1
*** HOLE CARDS ***
Dealt to matiko09 [4h Ac]
drissmouzou: calls €1
matiko09: calls €0.50
Painkiller72: checks 
*** FLOP *** [8c 2s Ah]
matiko09: checks 
Painkiller72: checks 
drissmouzou: bets €2.85
matiko09: calls €2.85
Painkiller72: folds 
*** TURN *** [8c 2s Ah] [Qh]
matiko09: checks 
drissmouzou: checks 
*** RIVER *** [8c 2s Ah Qh] [5h]
matiko09: bets €2.56
drissmouzou: calls €2.56
*** SHOW DOWN ***
matiko09: shows [4h Ac] (a pair of Aces)
drissmouzou: mucks hand 
matiko09 collected €13.13 from pot
*** SUMMARY ***
Total pot €13.82 | Rake €0.69 
Board [8c 2s Ah Qh 5h]
Seat 3: matiko09 (small blind) showed [4h Ac] and won (€13.13) with a pair of Aces
Seat 5: Painkiller72 (big blind) folded on the Flop
Seat 9: drissmouzou (button) mucked [Js Jd]





PokerStars Hand #152884730499:  Hold'em No Limit ($0.50/$1.00 USD) - 2016/05/05 15:57:48 CET [2016/05/05 9:57:48 ET]
Table 'Calypso II' 9-max Seat #2 is the button
Seat 1: nickreason17 ($105.80 in chips) 
Seat 2: torkkdnm ($139 in chips) 
Seat 3: gabi_igna ($108.09 in chips) 
Seat 5: LighTingSSSS ($92.13 in chips) 
Seat 6: WTAPSVG ($175.25 in chips) 
Seat 7: ipashutapkom ($91.71 in chips) 
Seat 8: matiko09 ($107.80 in chips) 
Seat 9: maxxmeister ($100 in chips) 
gabi_igna: posts small blind $0.50
sanpidk: is sitting out 
LighTingSSSS: posts big blind $1
*** HOLE CARDS ***
Dealt to matiko09 [3h Tc]
sanpidk leaves the table
WTAPSVG: raises $1.50 to $2.50
ipashutapkom: folds 
mycka86 joins the table at seat #4 
matiko09: folds 
maxxmeister: folds 
nickreason17: folds 
torkkdnm: folds 
gabi_igna: folds 
LighTingSSSS: folds 
Uncalled bet ($1.50) returned to WTAPSVG
WTAPSVG collected $2.50 from pot
*** SUMMARY ***
Total pot $2.50 | Rake $0 
Seat 1: nickreason17 folded before Flop (didn't bet)
Seat 2: torkkdnm (button) folded before Flop (didn't bet)
Seat 3: gabi_igna (small blind) folded before Flop
Seat 5: LighTingSSSS (big blind) folded before Flop
Seat 6: WTAPSVG collected ($2.50)
Seat 7: ipashutapkom folded before Flop (didn't bet)
Seat 8: matiko09 folded before Flop (didn't bet)
Seat 9: maxxmeister folded before Flop (didn't bet)





PokerStars Hand #152884733335:  Hold'em No Limit ($1/$2 USD) - 2016/05/05 15:57:53 CET [2016/05/05 9:57:53 ET]
Table 'Lundia' 9-max Seat #6 is the button
Seat 1: Fitzyferret ($200 in chips) 
Seat 2: patpaty ($230.71 in chips) 
Seat 3: Painkiller72 ($200 in chips) 
Seat 4: KovIFish89 ($234.76 in chips) 
Seat 5: zmOe84 ($200 in chips) 
Seat 6: Spid1 ($249.39 in chips) 
Seat 7: matiko09 ($249.11 in chips) 
Seat 8: Durnichka ($84 in chips) 
Seat 9: gabi_igna ($275.36 in chips) 
matiko09: posts small blind $1
Durnichka: posts big blind $2
*** HOLE CARDS ***
Dealt to matiko09 [2d Th]
gabi_igna: folds 
Fitzyferret: raises $3.24 to $5.24
patpaty: folds 
Painkiller72: folds 
KovIFish89: folds 
zmOe84: folds 
Spid1: folds 
matiko09: folds 
Durnichka: folds 
Uncalled bet ($3.24) returned to Fitzyferret
Fitzyferret collected $5 from pot
Fitzyferret: doesn't show hand 
*** SUMMARY ***
Total pot $5 | Rake $0 
Seat 1: Fitzyferret collected ($5)
Seat 2: patpaty folded before Flop (didn't bet)
Seat 3: Painkiller72 folded before Flop (didn't bet)
Seat 4: KovIFish89 folded before Flop (didn't bet)
Seat 5: zmOe84 folded before Flop (didn't bet)
Seat 6: Spid1 (button) folded before Flop (didn't bet)
Seat 7: matiko09 (small blind) folded before Flop
Seat 8: Durnichka (big blind) folded before Flop
Seat 9: gabi_igna folded before Flop (didn't bet)





PokerStars Hand #152884735926:  Hold'em No Limit ($0.50/$1.00 USD) - 2016/05/05 15:57:59 CET [2016/05/05 9:57:59 ET]
Table 'Musa II' 9-max Seat #7 is the button
Seat 1: KovIFish89 ($200.47 in chips) 
Seat 2: koutani7 ($98.50 in chips) 
Seat 3: vrnMike ($108.88 in chips) 
Seat 4: sanpidk ($100 in chips) 
Seat 5: Chin41178 ($67.57 in chips) 
Seat 6: cnn123 ($76.46 in chips) 
Seat 7: Painkiller72 ($100 in chips) 
Seat 8: matiko09 ($102 in chips) 
Seat 9: antfurto ($129.11 in chips) 
matiko09: posts small blind $0.50
antfurto: posts big blind $1
*** HOLE CARDS ***
Dealt to matiko09 [Qs 3s]
KovIFish89: raises $2 to $3
koutani7: folds 
vrnMike: folds 
antfurto said, "aa =)"
sanpidk: folds 
Chin41178: folds 
cnn123: folds 
Painkiller72: folds 
matiko09: folds 
antfurto: folds 
Uncalled bet ($2) returned to KovIFish89
KovIFish89 collected $2.50 from pot
KovIFish89: doesn't show hand 
*** SUMMARY ***
Total pot $2.50 | Rake $0 
Seat 1: KovIFish89 collected ($2.50)
Seat 2: koutani7 folded before Flop (didn't bet)
Seat 3: vrnMike folded before Flop (didn't bet)
Seat 4: sanpidk folded before Flop (didn't bet)
Seat 5: Chin41178 folded before Flop (didn't bet)
Seat 6: cnn123 folded before Flop (didn't bet)
Seat 7: Painkiller72 (button) folded before Flop (didn't bet)
Seat 8: matiko09 (small blind) folded before Flop
Seat 9: antfurto (big blind) folded before Flop





PokerStars Hand #152884738325:  Hold'em No Limit ($1/$2 USD) - 2016/05/05 15:58:03 CET [2016/05/05 9:58:03 ET]
Table 'Tololo' 9-max Seat #6 is the button
Seat 1: Kukuryzka ($265.54 in chips) 
Seat 2: gabi_igna ($237.39 in chips) 
Seat 3: nickreason17 ($223.22 in chips) 
Seat 4: mooose100 ($92.20 in chips) 
Seat 5: matiko09 ($253.49 in chips) 
Seat 6: Xagua ($119.83 in chips) 
Seat 8: KovIFish89 ($201 in chips) 
Seat 9: Fitzyferret ($317 in chips) 
KovIFish89: posts small blind $1
Fitzyferret: posts big blind $2
*** HOLE CARDS ***
Dealt to matiko09 [4c 3d]
Kukuryzka: folds 
gabi_igna: folds 
nickreason17: folds 
mooose100: folds 
matiko09: folds 
Xagua: raises $3 to $5
KovIFish89: folds 
Fitzyferret: calls $3
*** FLOP *** [8d Ks Th]
Fitzyferret: checks 
Xagua: checks 
*** TURN *** [8d Ks Th] [6c]
Fitzyferret: bets $7.62
Xagua: calls $7.62
*** RIVER *** [8d Ks Th 6c] [5s]
Fitzyferret: bets $22
Xagua: folds 
Uncalled bet ($22) returned to Fitzyferret
Fitzyferret collected $24.93 from pot
Fitzyferret: doesn't show hand 
*** SUMMARY ***
Total pot $26.24 | Rake $1.31 
Board [8d Ks Th 6c 5s]
Seat 1: Kukuryzka folded before Flop (didn't bet)
Seat 2: gabi_igna folded before Flop (didn't bet)
Seat 3: nickreason17 folded before Flop (didn't bet)
Seat 4: mooose100 folded before Flop (didn't bet)
Seat 5: matiko09 folded before Flop (didn't bet)
Seat 6: Xagua (button) folded on the River
Seat 8: KovIFish89 (small blind) folded before Flop
Seat 9: Fitzyferret (big blind) collected ($24.93)





PokerStars Hand #152884742643:  Hold'em No Limit ($0.50/$1.00 USD) - 2016/05/05 15:58:12 CET [2016/05/05 9:58:12 ET]
Table 'Luthera' 9-max Seat #3 is the button
Seat 1: MrMattkk ($97.49 in chips) 
Seat 2: Spid1 ($100.50 in chips) 
Seat 3: ipashutapkom ($56.13 in chips) 
Seat 4: matiko09 ($111.98 in chips) 
Seat 5: Painkiller72 ($100 in chips) 
Seat 7: Chin41178 ($111.28 in chips) 
Seat 8: xdrKush420x ($96.50 in chips) 
Seat 9: vrnMike ($100 in chips) 
matiko09: posts small blind $0.50
Painkiller72: posts big blind $1
Dantist1122: sits out 
*** HOLE CARDS ***
Dealt to matiko09 [8d 2s]
Chin41178: folds 
xdrKush420x: raises $2 to $3
vrnMike: folds 
MrMattkk: folds 
Spid1: folds 
ipashutapkom: folds 
matiko09: folds 
Painkiller72: folds 
Uncalled bet ($2) returned to xdrKush420x
xdrKush420x collected $2.50 from pot
*** SUMMARY ***
Total pot $2.50 | Rake $0 
Seat 1: MrMattkk folded before Flop (didn't bet)
Seat 2: Spid1 folded before Flop (didn't bet)
Seat 3: ipashutapkom (button) folded before Flop (didn't bet)
Seat 4: matiko09 (small blind) folded before Flop
Seat 5: Painkiller72 (big blind) folded before Flop
Seat 7: Chin41178 folded before Flop (didn't bet)
Seat 8: xdrKush420x collected ($2.50)
Seat 9: vrnMike folded before Flop (didn't bet)





PokerStars Hand #152884742857:  Hold'em No Limit ($0.50/$1.00 USD) - 2016/05/05 15:58:13 CET [2016/05/05 9:58:13 ET]
Table 'Calypso II' 9-max Seat #3 is the button
Seat 1: nickreason17 ($105.80 in chips) 
Seat 2: torkkdnm ($139 in chips) 
Seat 3: gabi_igna ($107.59 in chips) 
Seat 5: LighTingSSSS ($91.13 in chips) 
Seat 6: WTAPSVG ($176.75 in chips) 
Seat 7: ipashutapkom ($91.71 in chips) 
Seat 8: matiko09 ($107.80 in chips) 
Seat 9: maxxmeister ($100 in chips) 
mycka86 will be allowed to play after the button
LighTingSSSS: posts small blind $0.50
WTAPSVG: posts big blind $1
*** HOLE CARDS ***
Dealt to matiko09 [Ad 3c]
ipashutapkom: folds 
matiko09: folds 
maxxmeister: folds 
nickreason17: folds 
torkkdnm: folds 
gabi_igna: folds 
LighTingSSSS: folds 
Uncalled bet ($0.50) returned to WTAPSVG
WTAPSVG collected $1 from pot
*** SUMMARY ***
Total pot $1 | Rake $0 
Seat 1: nickreason17 folded before Flop (didn't bet)
Seat 2: torkkdnm folded before Flop (didn't bet)
Seat 3: gabi_igna (button) folded before Flop (didn't bet)
Seat 5: LighTingSSSS (small blind) folded before Flop
Seat 6: WTAPSVG (big blind) collected ($1)
Seat 7: ipashutapkom folded before Flop (didn't bet)
Seat 8: matiko09 folded before Flop (didn't bet)
Seat 9: maxxmeister folded before Flop (didn't bet)





PokerStars Hand #152884743007:  Hold'em No Limit ($0.50/$1.00 USD) - 2016/05/05 15:58:13 CET [2016/05/05 9:58:13 ET]
Table 'Lictoria II' 9-max Seat #4 is the button
Seat 1: St.LaCoste ($100 in chips) 
Seat 2: Dantist1122 ($121.96 in chips) 
Seat 3: Krinica2009 ($106.20 in chips) 
Seat 4: mycka86 ($101 in chips) 
Seat 5: sanpidk ($149.26 in chips) 
Seat 6: gabi_igna ($210.73 in chips) 
Seat 7: Painkiller72 ($153.92 in chips) 
Seat 8: matiko09 ($102.50 in chips) 
Seat 9: Kukuryzka ($141.81 in chips) 
sanpidk: posts small blind $0.50
gabi_igna: posts big blind $1
*** HOLE CARDS ***
Dealt to matiko09 [Qh 4c]
Painkiller72: folds 
matiko09: folds 
Kukuryzka: folds 
St.LaCoste: folds 
Dantist1122: folds 
Krinica2009: raises $2 to $3
mycka86: folds 
sanpidk: folds 
gabi_igna: raises $6.50 to $9.50
Krinica2009: calls $6.50
*** FLOP *** [2h 8c 2d]
gabi_igna: bets $9
Krinica2009: calls $9
*** TURN *** [2h 8c 2d] [Kh]
gabi_igna: bets $19
Krinica2009: folds 
Uncalled bet ($19) returned to gabi_igna
gabi_igna collected $35.62 from pot
gabi_igna: doesn't show hand 
*** SUMMARY ***
Total pot $37.50 | Rake $1.88 
Board [2h 8c 2d Kh]
Seat 1: St.LaCoste folded before Flop (didn't bet)
Seat 2: Dantist1122 folded before Flop (didn't bet)
Seat 3: Krinica2009 folded on the Turn
Seat 4: mycka86 (button) folded before Flop (didn't bet)
Seat 5: sanpidk (small blind) folded before Flop
Seat 6: gabi_igna (big blind) collected ($35.62)
Seat 7: Painkiller72 folded before Flop (didn't bet)
Seat 8: matiko09 folded before Flop (didn't bet)
Seat 9: Kukuryzka folded before Flop (didn't bet)





PokerStars Hand #152884746191:  Hold'em No Limit ($1/$2 USD) - 2016/05/05 15:58:19 CET [2016/05/05 9:58:19 ET]
Table 'Samitchell' 9-max Seat #8 is the button
Seat 1: KovIFish89 ($200 in chips) 
Seat 2: matiko09 ($200 in chips) 
Seat 3: gabi_igna ($314.32 in chips) 
Seat 4: Fitzyferret ($369.22 in chips) 
Seat 5: Spid1 ($220.15 in chips) 
Seat 6: nickreason17 ($220 in chips) 
Seat 7: patpaty ($152.84 in chips) 
Seat 8: WolleMalone ($200 in chips) 
Seat 9: kblkxls ($142.07 in chips) 
kblkxls: posts small blind $1
KovIFish89: posts big blind $2
*** HOLE CARDS ***
Dealt to matiko09 [Kd 8c]
matiko09: folds 
gabi_igna: folds 
Fitzyferret: raises $3.24 to $5.24
Spid1: folds 
nickreason17: folds 
patpaty: folds 
WolleMalone: folds 
kblkxls: folds 
KovIFish89: folds 
Uncalled bet ($3.24) returned to Fitzyferret
Fitzyferret collected $5 from pot
Fitzyferret: doesn't show hand 
*** SUMMARY ***
Total pot $5 | Rake $0 
Seat 1: KovIFish89 (big blind) folded before Flop
Seat 2: matiko09 folded before Flop (didn't bet)
Seat 3: gabi_igna folded before Flop (didn't bet)
Seat 4: Fitzyferret collected ($5)
Seat 5: Spid1 folded before Flop (didn't bet)
Seat 6: nickreason17 folded before Flop (didn't bet)
Seat 7: patpaty folded before Flop (didn't bet)
Seat 8: WolleMalone (button) folded before Flop (didn't bet)
Seat 9: kblkxls (small blind) folded before Flop





PokerStars Hand #152884747156:  Hold'em No Limit ($1/$2 USD) - 2016/05/05 15:58:21 CET [2016/05/05 9:58:21 ET]
Table 'Euporie II' 9-max Seat #2 is the button
Seat 2: nickreason17 ($200 in chips) 
Seat 4: Kukuryzka ($200 in chips) 
Seat 5: Nuskatko1986 ($171.96 in chips) 
Seat 6: glanza_mike ($207 in chips) 
Seat 7: matiko09 ($202 in chips) 
Seat 8: Painkiller72 ($200 in chips) 
Seat 9: T0ny Adams ($80.75 in chips) 
Kukuryzka: posts small blind $1
Nuskatko1986: posts big blind $2
gabi_igna: sits out 
*** HOLE CARDS ***
Dealt to matiko09 [Td 3s]
glanza_mike: raises $4 to $6
matiko09: folds 
Painkiller72: folds 
T0ny Adams: folds 
nickreason17: folds 
Kukuryzka: folds 
Nuskatko1986: folds 
Uncalled bet ($4) returned to glanza_mike
glanza_mike collected $5 from pot
glanza_mike: doesn't show hand 
*** SUMMARY ***
Total pot $5 | Rake $0 
Seat 2: nickreason17 (button) folded before Flop (didn't bet)
Seat 4: Kukuryzka (small blind) folded before Flop
Seat 5: Nuskatko1986 (big blind) folded before Flop
Seat 6: glanza_mike collected ($5)
Seat 7: matiko09 folded before Flop (didn't bet)
Seat 8: Painkiller72 folded before Flop (didn't bet)
Seat 9: T0ny Adams folded before Flop (didn't bet)





PokerStars Hand #152884747721:  Hold'em No Limit ($1/$2 USD) - 2016/05/05 15:58:22 CET [2016/05/05 9:58:22 ET]
Table 'Lundia' 9-max Seat #7 is the button
Seat 1: Fitzyferret ($203 in chips) 
Seat 2: patpaty ($230.71 in chips) 
Seat 3: Painkiller72 ($200 in chips) 
Seat 4: KovIFish89 ($234.76 in chips) 
Seat 5: zmOe84 ($200 in chips) 
Seat 6: Spid1 ($249.39 in chips) 
Seat 7: matiko09 ($248.11 in chips) 
Seat 8: Durnichka ($82 in chips) 
Seat 9: gabi_igna ($275.36 in chips) 
Durnichka: posts small blind $1
gabi_igna: posts big blind $2
*** HOLE CARDS ***
Dealt to matiko09 [Th 7c]
Fitzyferret: raises $3.24 to $5.24
patpaty: calls $5.24
Painkiller72: calls $5.24
KovIFish89: folds 
zmOe84: calls $5.24
Spid1: folds 
matiko09: folds 
Durnichka: folds 
gabi_igna: calls $3.24
*** FLOP *** [5s Ad 6d]
gabi_igna: checks 
Fitzyferret: bets $18
patpaty: folds 
Painkiller72: folds 
zmOe84: folds 
gabi_igna: folds 
Uncalled bet ($18) returned to Fitzyferret
Fitzyferret collected $25.84 from pot
Fitzyferret: doesn't show hand 
*** SUMMARY ***
Total pot $27.20 | Rake $1.36 
Board [5s Ad 6d]
Seat 1: Fitzyferret collected ($25.84)
Seat 2: patpaty folded on the Flop
Seat 3: Painkiller72 folded on the Flop
Seat 4: KovIFish89 folded before Flop (didn't bet)
Seat 5: zmOe84 folded on the Flop
Seat 6: Spid1 folded before Flop (didn't bet)
Seat 7: matiko09 (button) folded before Flop (didn't bet)
Seat 8: Durnichka (small blind) folded before Flop
Seat 9: gabi_igna (big blind) folded on the Flop





PokerStars Hand #152884749224:  Hold'em No Limit ($0.50/$1.00 USD) - 2016/05/05 15:58:26 CET [2016/05/05 9:58:26 ET]
Table 'Musa II' 9-max Seat #8 is the button
Seat 1: KovIFish89 ($201.97 in chips) 
Seat 2: koutani7 ($98.50 in chips) 
Seat 3: vrnMike ($108.88 in chips) 
Seat 4: sanpidk ($100 in chips) 
Seat 5: Chin41178 ($67.57 in chips) 
Seat 6: cnn123 ($76.46 in chips) 
Seat 7: Painkiller72 ($100 in chips) 
Seat 8: matiko09 ($101.50 in chips) 
Seat 9: antfurto ($128.11 in chips) 
antfurto: posts small blind $0.50
KovIFish89: posts big blind $1
*** HOLE CARDS ***
Dealt to matiko09 [7d 5c]
koutani7: folds 
vrnMike: folds 
sanpidk: folds 
Chin41178: folds 
cnn123: folds 
Painkiller72: folds 
matiko09: folds 
antfurto: folds 
Uncalled bet ($0.50) returned to KovIFish89
KovIFish89 collected $1 from pot
KovIFish89: doesn't show hand 
*** SUMMARY ***
Total pot $1 | Rake $0 
Seat 1: KovIFish89 (big blind) collected ($1)
Seat 2: koutani7 folded before Flop (didn't bet)
Seat 3: vrnMike folded before Flop (didn't bet)
Seat 4: sanpidk folded before Flop (didn't bet)
Seat 5: Chin41178 folded before Flop (didn't bet)
Seat 6: cnn123 folded before Flop (didn't bet)
Seat 7: Painkiller72 folded before Flop (didn't bet)
Seat 8: matiko09 (button) folded before Flop (didn't bet)
Seat 9: antfurto (small blind) folded before Flop





PokerStars Hand #152884751313:  Hold'em No Limit ($0.50/$1.00 USD) - 2016/05/05 15:58:30 CET [2016/05/05 9:58:30 ET]
Table 'Priska II' 9-max Seat #7 is the button
Seat 1: Spid1 ($112.85 in chips) 
Seat 2: Kukuryzka ($128.52 in chips) 
Seat 3: matiko09 ($100 in chips) 
Seat 4: Painkiller72 ($155.84 in chips) 
Seat 5: nickreason17 ($173.05 in chips) 
Seat 6: St.LaCoste ($106.02 in chips) 
Seat 7: stockbridge8 ($87.77 in chips) 
Seat 8: pohorc21 ($140.86 in chips) 
Seat 9: torkkdnm ($100 in chips) 
pohorc21: posts small blind $0.50
torkkdnm: posts big blind $1
*** HOLE CARDS ***
Dealt to matiko09 [Kc Qs]
Spid1: folds 
Kukuryzka: folds 
matiko09: raises $2 to $3
Painkiller72: folds 
nickreason17: folds 
St.LaCoste: folds 
stockbridge8: folds 
pohorc21: calls $2.50
torkkdnm: calls $2
*** FLOP *** [7d 8h Jd]
pohorc21: bets $9
torkkdnm: folds 
matiko09: folds 
Uncalled bet ($9) returned to pohorc21
pohorc21 collected $8.55 from pot
pohorc21: doesn't show hand 
*** SUMMARY ***
Total pot $9 | Rake $0.45 
Board [7d 8h Jd]
Seat 1: Spid1 folded before Flop (didn't bet)
Seat 2: Kukuryzka folded before Flop (didn't bet)
Seat 3: matiko09 folded on the Flop
Seat 4: Painkiller72 folded before Flop (didn't bet)
Seat 5: nickreason17 folded before Flop (didn't bet)
Seat 6: St.LaCoste folded before Flop (didn't bet)
Seat 7: stockbridge8 (button) folded before Flop (didn't bet)
Seat 8: pohorc21 (small blind) collected ($8.55)
Seat 9: torkkdnm (big blind) folded on the Flop





PokerStars Hand #152884752554:  Hold'em No Limit ($0.50/$1.00 USD) - 2016/05/05 15:58:32 CET [2016/05/05 9:58:32 ET]
Table 'Luthera' 9-max Seat #4 is the button
Seat 1: MrMattkk ($97.49 in chips) 
Seat 2: Spid1 ($100.50 in chips) 
Seat 3: ipashutapkom ($56.13 in chips) 
Seat 4: matiko09 ($111.48 in chips) 
Seat 5: Painkiller72 ($100 in chips) 
Seat 6: Dantist1122 ($100 in chips) 
Seat 7: Chin41178 ($111.28 in chips) 
Seat 8: xdrKush420x ($98 in chips) 
Seat 9: vrnMike ($100 in chips) 
Painkiller72: posts small blind $0.50
Dantist1122: posts big blind $1
*** HOLE CARDS ***
Dealt to matiko09 [9d 5s]
Chin41178: folds 
xdrKush420x: folds 
vrnMike: folds 
MrMattkk: raises $2 to $3
Spid1: folds 
ipashutapkom: folds 
matiko09: folds 
Painkiller72: folds 
Dantist1122: folds 
Uncalled bet ($2) returned to MrMattkk
MrMattkk collected $2.50 from pot
*** SUMMARY ***
Total pot $2.50 | Rake $0 
Seat 1: MrMattkk collected ($2.50)
Seat 2: Spid1 folded before Flop (didn't bet)
Seat 3: ipashutapkom folded before Flop (didn't bet)
Seat 4: matiko09 (button) folded before Flop (didn't bet)
Seat 5: Painkiller72 (small blind) folded before Flop
Seat 6: Dantist1122 (big blind) folded before Flop
Seat 7: Chin41178 folded before Flop (didn't bet)
Seat 8: xdrKush420x folded before Flop (didn't bet)
Seat 9: vrnMike folded before Flop (didn't bet)





PokerStars Hand #152884755656:  Hold'em No Limit ($1/$2 USD) - 2016/05/05 15:58:39 CET [2016/05/05 9:58:39 ET]
Table 'Euporie II' 9-max Seat #4 is the button
Seat 2: nickreason17 ($200 in chips) 
Seat 4: Kukuryzka ($199 in chips) 
Seat 5: Nuskatko1986 ($169.96 in chips) 
Seat 6: glanza_mike ($210 in chips) 
Seat 7: matiko09 ($202 in chips) 
Seat 8: Painkiller72 ($200 in chips) 
Seat 9: T0ny Adams ($80.75 in chips) 
Nuskatko1986: posts small blind $1
glanza_mike: posts big blind $2
gabi_igna: sits out 
*** HOLE CARDS ***
Dealt to matiko09 [5c 9s]
matiko09: folds 
Painkiller72: folds 
T0ny Adams: folds 
nickreason17: folds 
Kukuryzka: folds 
Nuskatko1986: folds 
Uncalled bet ($1) returned to glanza_mike
glanza_mike collected $2 from pot
glanza_mike: doesn't show hand 
*** SUMMARY ***
Total pot $2 | Rake $0 
Seat 2: nickreason17 folded before Flop (didn't bet)
Seat 4: Kukuryzka (button) folded before Flop (didn't bet)
Seat 5: Nuskatko1986 (small blind) folded before Flop
Seat 6: glanza_mike (big blind) collected ($2)
Seat 7: matiko09 folded before Flop (didn't bet)
Seat 8: Painkiller72 folded before Flop (didn't bet)
Seat 9: T0ny Adams folded before Flop (didn't bet)





PokerStars Hand #152884756309:  Hold'em No Limit ($0.50/$1.00 USD) - 2016/05/05 15:58:40 CET [2016/05/05 9:58:40 ET]
Table 'Calypso II' 9-max Seat #5 is the button
Seat 1: nickreason17 ($105.80 in chips) 
Seat 2: torkkdnm ($139 in chips) 
Seat 3: gabi_igna ($107.59 in chips) 
Seat 5: LighTingSSSS ($90.63 in chips) 
Seat 6: WTAPSVG ($177.25 in chips) 
Seat 8: matiko09 ($107.80 in chips) 
Seat 9: maxxmeister ($100 in chips) 
WTAPSVG: posts small blind $0.50
ipashutapkom: is sitting out 
matiko09: posts big blind $1
mycka86: sits out 
*** HOLE CARDS ***
Dealt to matiko09 [4h Tc]
ipashutapkom leaves the table
Hayer ana joins the table at seat #7 
maxxmeister: raises $2 to $3
nickreason17: folds 
Hayer ana leaves the table
sanpidk joins the table at seat #7 
torkkdnm: folds 
gabi_igna: calls $3
LighTingSSSS: folds 
WTAPSVG: calls $2.50
matiko09: folds 
*** FLOP *** [Jd 8s 5d]
WTAPSVG: checks 
maxxmeister: bets $6
gabi_igna: folds 
WTAPSVG: calls $6
*** TURN *** [Jd 8s 5d] [As]
WTAPSVG: checks 
maxxmeister: checks 
*** RIVER *** [Jd 8s 5d As] [Ah]
WTAPSVG: checks 
maxxmeister: bets $8
WTAPSVG: folds 
Uncalled bet ($8) returned to maxxmeister
maxxmeister collected $20.90 from pot
maxxmeister: doesn't show hand 
*** SUMMARY ***
Total pot $22 | Rake $1.10 
Board [Jd 8s 5d As Ah]
Seat 1: nickreason17 folded before Flop (didn't bet)
Seat 2: torkkdnm folded before Flop (didn't bet)
Seat 3: gabi_igna folded on the Flop
Seat 5: LighTingSSSS (button) folded before Flop (didn't bet)
Seat 6: WTAPSVG (small blind) folded on the River
Seat 8: matiko09 (big blind) folded before Flop
Seat 9: maxxmeister collected ($20.90)





PokerStars Hand #152884757687:  Hold'em No Limit (€0.50/€1.00 EUR) - 2016/05/05 15:58:43 CET [2016/05/05 9:58:43 ET]
Table 'Carol II' 9-max Seat #1 is the button
Seat 1: vrnMike (€100 in chips) 
Seat 2: matiko09 (€107 in chips) 
Seat 4: Merlin_1905 (€131.55 in chips) 
Seat 5: Painkiller72 (€101.50 in chips) 
Seat 6: Kukuryzka (€99.50 in chips) 
Seat 7: Spid1 (€100 in chips) 
Seat 8: sanpidk (€108.08 in chips) 
matiko09: posts small blind €0.50
Merlin_1905: posts big blind €1
*** HOLE CARDS ***
Dealt to matiko09 [3d 7d]
Painkiller72: folds 
Kukuryzka: folds 
Spid1: folds 
sanpidk: folds 
vrnMike: raises €2 to €3
matiko09: folds 
Merlin_1905: calls €2
*** FLOP *** [4h 5d As]
Merlin_1905: checks 
vrnMike: checks 
*** TURN *** [4h 5d As] [6d]
Merlin_1905: bets €3
vrnMike: folds 
Uncalled bet (€3) returned to Merlin_1905
Merlin_1905 collected €6.18 from pot
Merlin_1905: doesn't show hand 
*** SUMMARY ***
Total pot €6.50 | Rake €0.32 
Board [4h 5d As 6d]
Seat 1: vrnMike (button) folded on the Turn
Seat 2: matiko09 (small blind) folded before Flop
Seat 4: Merlin_1905 (big blind) collected (€6.18)
Seat 5: Painkiller72 folded before Flop (didn't bet)
Seat 6: Kukuryzka folded before Flop (didn't bet)
Seat 7: Spid1 folded before Flop (didn't bet)
Seat 8: sanpidk folded before Flop (didn't bet)





PokerStars Hand #152884763787:  Hold'em No Limit ($0.50/$1.00 USD) - 2016/05/05 15:58:55 CET [2016/05/05 9:58:55 ET]
Table 'Musa II' 9-max Seat #9 is the button
Seat 1: KovIFish89 ($202.47 in chips) 
Seat 2: koutani7 ($98.50 in chips) 
Seat 3: vrnMike ($108.88 in chips) 
Seat 4: sanpidk ($100 in chips) 
Seat 5: Chin41178 ($67.57 in chips) 
Seat 6: cnn123 ($76.46 in chips) 
Seat 7: Painkiller72 ($100 in chips) 
Seat 8: matiko09 ($101.50 in chips) 
Seat 9: antfurto ($127.61 in chips) 
KovIFish89: posts small blind $0.50
koutani7: posts big blind $1
*** HOLE CARDS ***
Dealt to matiko09 [Ks 5h]
vrnMike: folds 
sanpidk: folds 
Chin41178: folds 
cnn123: folds 
Painkiller72: folds 
matiko09: folds 
antfurto: folds 
antfurto leaves the table
KovIFish89: folds 
Uncalled bet ($0.50) returned to koutani7
koutani7 collected $1 from pot
koutani7: doesn't show hand 
*** SUMMARY ***
Total pot $1 | Rake $0 
Seat 1: KovIFish89 (small blind) folded before Flop
Seat 2: koutani7 (big blind) collected ($1)
Seat 3: vrnMike folded before Flop (didn't bet)
Seat 4: sanpidk folded before Flop (didn't bet)
Seat 5: Chin41178 folded before Flop (didn't bet)
Seat 6: cnn123 folded before Flop (didn't bet)
Seat 7: Painkiller72 folded before Flop (didn't bet)
Seat 8: matiko09 folded before Flop (didn't bet)
Seat 9: antfurto (button) folded before Flop (didn't bet)





PokerStars Hand #152884766478:  Hold'em No Limit ($0.50/$1.00 USD) - 2016/05/05 15:59:00 CET [2016/05/05 9:59:00 ET]
Table 'Luthera' 9-max Seat #5 is the button
Seat 1: MrMattkk ($98.99 in chips) 
Seat 2: Spid1 ($100.50 in chips) 
Seat 3: ipashutapkom ($56.13 in chips) 
Seat 4: matiko09 ($111.48 in chips) 
Seat 5: Painkiller72 ($100 in chips) 
Seat 6: Dantist1122 ($100 in chips) 
Seat 7: Chin41178 ($111.28 in chips) 
Seat 8: xdrKush420x ($98 in chips) 
Seat 9: vrnMike ($100 in chips) 
Dantist1122: posts small blind $0.50
Chin41178: posts big blind $1
*** HOLE CARDS ***
Dealt to matiko09 [Jc 6s]
xdrKush420x: folds 
vrnMike: folds 
MrMattkk: folds 
Spid1: folds 
ipashutapkom: folds 
matiko09: folds 
Painkiller72: folds 
Dantist1122: raises $1.05 to $2.05
Chin41178: folds 
Uncalled bet ($1.05) returned to Dantist1122
Dantist1122 collected $2 from pot
Dantist1122: doesn't show hand 
*** SUMMARY ***
Total pot $2 | Rake $0 
Seat 1: MrMattkk folded before Flop (didn't bet)
Seat 2: Spid1 folded before Flop (didn't bet)
Seat 3: ipashutapkom folded before Flop (didn't bet)
Seat 4: matiko09 folded before Flop (didn't bet)
Seat 5: Painkiller72 (button) folded before Flop (didn't bet)
Seat 6: Dantist1122 (small blind) collected ($2)
Seat 7: Chin41178 (big blind) folded before Flop
Seat 8: xdrKush420x folded before Flop (didn't bet)
Seat 9: vrnMike folded before Flop (didn't bet)





PokerStars Hand #152884769312:  Hold'em No Limit ($1/$2 USD) - 2016/05/05 15:59:06 CET [2016/05/05 9:59:06 ET]
Table 'Samitchell' 9-max Seat #9 is the button
Seat 1: KovIFish89 ($200 in chips) 
Seat 2: matiko09 ($200 in chips) 
Seat 3: gabi_igna ($314.32 in chips) 
Seat 4: Fitzyferret ($372.22 in chips) 
Seat 5: Spid1 ($220.15 in chips) 
Seat 6: nickreason17 ($220 in chips) 
Seat 7: patpaty ($152.84 in chips) 
Seat 8: WolleMalone ($200 in chips) 
Seat 9: kblkxls ($141.07 in chips) 
KovIFish89: posts small blind $1
matiko09: posts big blind $2
*** HOLE CARDS ***
Dealt to matiko09 [Jd 3h]
gabi_igna: folds 
Fitzyferret: folds 
Spid1: raises $4 to $6
nickreason17: folds 
patpaty: folds 
WolleMalone: folds 
kblkxls: folds 
KovIFish89: folds 
matiko09: folds 
Uncalled bet ($4) returned to Spid1
Spid1 collected $5 from pot
Spid1: doesn't show hand 
*** SUMMARY ***
Total pot $5 | Rake $0 
Seat 1: KovIFish89 (small blind) folded before Flop
Seat 2: matiko09 (big blind) folded before Flop
Seat 3: gabi_igna folded before Flop (didn't bet)
Seat 4: Fitzyferret folded before Flop (didn't bet)
Seat 5: Spid1 collected ($5)
Seat 6: nickreason17 folded before Flop (didn't bet)
Seat 7: patpaty folded before Flop (didn't bet)
Seat 8: WolleMalone folded before Flop (didn't bet)
Seat 9: kblkxls (button) folded before Flop (didn't bet)





PokerStars Hand #152884769964:  Hold'em No Limit ($1/$2 USD) - 2016/05/05 15:59:08 CET [2016/05/05 9:59:08 ET]
Table 'Euporie II' 9-max Seat #5 is the button
Seat 2: nickreason17 ($200 in chips) 
Seat 4: Kukuryzka ($199 in chips) 
Seat 5: Nuskatko1986 ($168.96 in chips) 
Seat 6: glanza_mike ($211 in chips) 
Seat 7: matiko09 ($202 in chips) 
Seat 8: Painkiller72 ($200 in chips) 
Seat 9: T0ny Adams ($80.75 in chips) 
glanza_mike: posts small blind $1
matiko09: posts big blind $2
gabi_igna: sits out 
*** HOLE CARDS ***
Dealt to matiko09 [Tc 2s]
Painkiller72: folds 
T0ny Adams: folds 
nickreason17: folds 
Kukuryzka: folds 
Nuskatko1986: calls $2
glanza_mike: raises $5 to $7
matiko09: folds 
Nuskatko1986: calls $5
*** FLOP *** [5c 2d 4c]
glanza_mike: checks 
Nuskatko1986: bets $32
glanza_mike: folds 
Uncalled bet ($32) returned to Nuskatko1986
Nuskatko1986 collected $15.20 from pot
Nuskatko1986: doesn't show hand 
*** SUMMARY ***
Total pot $16 | Rake $0.80 
Board [5c 2d 4c]
Seat 2: nickreason17 folded before Flop (didn't bet)
Seat 4: Kukuryzka folded before Flop (didn't bet)
Seat 5: Nuskatko1986 (button) collected ($15.20)
Seat 6: glanza_mike (small blind) folded on the Flop
Seat 7: matiko09 (big blind) folded before Flop
Seat 8: Painkiller72 folded before Flop (didn't bet)
Seat 9: T0ny Adams folded before Flop (didn't bet)





PokerStars Hand #152884774707:  Hold'em No Limit ($0.50/$1.00 USD) - 2016/05/05 15:59:17 CET [2016/05/05 9:59:17 ET]
Table 'Pyxis III' 9-max Seat #6 is the button
Seat 1: sanpidk ($288.89 in chips) 
Seat 2: SPmaka ($89.30 in chips) 
Seat 3: vrnMike ($100 in chips) 
Seat 4: Sloeve ($126.99 in chips) 
Seat 5: darren1031 ($104.93 in chips) 
Seat 6: kamillo91 ($86.35 in chips) 
Seat 7: mycka86 ($104.38 in chips) 
Seat 8: matiko09 ($107.25 in chips) 
Seat 9: Hypoaroused ($172.38 in chips) 
mycka86: posts small blind $0.50
matiko09: posts big blind $1
Sloeve: posts small & big blinds $1.50
*** HOLE CARDS ***
Dealt to matiko09 [9s 7d]
Hypoaroused: folds 
sanpidk: folds 
SPmaka: raises $1 to $2
vrnMike: folds 
Sloeve: calls $1
darren1031: folds 
kamillo91: calls $2
mycka86: folds 
matiko09: folds 
*** FLOP *** [3h Ts 7h]
SPmaka: bets $3.80
Sloeve: folds 
kamillo91: folds 
Uncalled bet ($3.80) returned to SPmaka
SPmaka collected $7.60 from pot
SPmaka: doesn't show hand 
*** SUMMARY ***
Total pot $8 | Rake $0.40 
Board [3h Ts 7h]
Seat 1: sanpidk folded before Flop (didn't bet)
Seat 2: SPmaka collected ($7.60)
Seat 3: vrnMike folded before Flop (didn't bet)
Seat 4: Sloeve folded on the Flop
Seat 5: darren1031 folded before Flop (didn't bet)
Seat 6: kamillo91 (button) folded on the Flop
Seat 7: mycka86 (small blind) folded before Flop
Seat 8: matiko09 (big blind) folded before Flop
Seat 9: Hypoaroused folded before Flop (didn't bet)





PokerStars Hand #152884774614:  Hold'em No Limit ($1/$2 USD) - 2016/05/05 15:59:17 CET [2016/05/05 9:59:17 ET]
Table 'Tatry II' 9-max Seat #3 is the button
Seat 1: glanza_mike ($238.05 in chips) 
Seat 3: matiko09 ($200 in chips) 
Seat 4: WolleMalone ($200 in chips) 
Seat 5: Painkiller72 ($200 in chips) 
Seat 9: korol702 ($117.90 in chips) 
WolleMalone: posts small blind $1
Painkiller72: posts big blind $2
Kukuryzka: sits out 
nickreason17: sits out 
T0ny Adams: sits out 
*** HOLE CARDS ***
Dealt to matiko09 [4c 2s]
korol702: calls $2
glanza_mike: folds 
matiko09: folds 
WolleMalone: folds 
Painkiller72: raises $5 to $7
korol702: calls $5
*** FLOP *** [8s 7c Qh]
Painkiller72: checks 
korol702: checks 
*** TURN *** [8s 7c Qh] [Ks]
Painkiller72: checks 
korol702: checks 
*** RIVER *** [8s 7c Qh Ks] [Ah]
Painkiller72: checks 
korol702: checks 
*** SHOW DOWN ***
Painkiller72: shows [4s As] (a pair of Aces)
korol702: mucks hand 
Painkiller72 collected $14.25 from pot
*** SUMMARY ***
Total pot $15 | Rake $0.75 
Board [8s 7c Qh Ks Ah]
Seat 1: glanza_mike folded before Flop (didn't bet)
Seat 3: matiko09 (button) folded before Flop (didn't bet)
Seat 4: WolleMalone (small blind) folded before Flop
Seat 5: Painkiller72 (big blind) showed [4s As] and won ($14.25) with a pair of Aces
Seat 9: korol702 mucked [Jh 5h]





PokerStars Hand #152884774457:  Hold'em No Limit ($0.50/$1.00 USD) - 2016/05/05 15:59:17 CET [2016/05/05 9:59:17 ET]
Table 'Priska II' 9-max Seat #8 is the button
Seat 2: Kukuryzka ($128.52 in chips) 
Seat 3: matiko09 ($100 in chips) 
Seat 4: Painkiller72 ($155.84 in chips) 
Seat 5: nickreason17 ($173.05 in chips) 
Seat 6: St.LaCoste ($106.02 in chips) 
Seat 7: stockbridge8 ($87.77 in chips) 
Seat 8: pohorc21 ($146.41 in chips) 
Seat 9: torkkdnm ($100 in chips) 
torkkdnm: posts small blind $0.50
Spid1: is sitting out 
Kukuryzka: posts big blind $1
*** HOLE CARDS ***
Dealt to matiko09 [Jh Ts]
Spid1 leaves the table
matiko09: folds 
sanpidk joins the table at seat #1 
Painkiller72: folds 
nickreason17: folds 
St.LaCoste: raises $2 to $3
stockbridge8: folds 
pohorc21: folds 
torkkdnm: folds 
Kukuryzka: folds 
Uncalled bet ($2) returned to St.LaCoste
St.LaCoste collected $2.50 from pot
St.LaCoste: doesn't show hand 
*** SUMMARY ***
Total pot $2.50 | Rake $0 
Seat 2: Kukuryzka (big blind) folded before Flop
Seat 3: matiko09 folded before Flop (didn't bet)
Seat 4: Painkiller72 folded before Flop (didn't bet)
Seat 5: nickreason17 folded before Flop (didn't bet)
Seat 6: St.LaCoste collected ($2.50)
Seat 7: stockbridge8 folded before Flop (didn't bet)
Seat 8: pohorc21 (button) folded before Flop (didn't bet)
Seat 9: torkkdnm (small blind) folded before Flop





PokerStars Hand #152884780789:  Hold'em No Limit ($0.50/$1.00 USD) - 2016/05/05 15:59:30 CET [2016/05/05 9:59:30 ET]
Table 'Musa II' 9-max Seat #1 is the button
Seat 1: KovIFish89 ($201.97 in chips) 
Seat 2: koutani7 ($99 in chips) 
Seat 3: vrnMike ($108.88 in chips) 
Seat 4: sanpidk ($100 in chips) 
Seat 5: Chin41178 ($67.57 in chips) 
Seat 6: cnn123 ($76.46 in chips) 
Seat 7: Painkiller72 ($100 in chips) 
Seat 8: matiko09 ($101.50 in chips) 
koutani7: posts small blind $0.50
vrnMike: posts big blind $1
*** HOLE CARDS ***
Dealt to matiko09 [As Kc]
sanpidk: raises $2 to $3
Chin41178: folds 
cnn123: folds 
Painkiller72: folds 
matiko09: calls $3
KovIFish89: folds 
koutani7: folds 
vrnMike: folds 
*** FLOP *** [Qd 2s 5s]
sanpidk: checks 
matiko09: bets $4.63
sanpidk: folds 
Uncalled bet ($4.63) returned to matiko09
matiko09 collected $7.12 from pot
matiko09: doesn't show hand 
*** SUMMARY ***
Total pot $7.50 | Rake $0.38 
Board [Qd 2s 5s]
Seat 1: KovIFish89 (button) folded before Flop (didn't bet)
Seat 2: koutani7 (small blind) folded before Flop
Seat 3: vrnMike (big blind) folded before Flop
Seat 4: sanpidk folded on the Flop
Seat 5: Chin41178 folded before Flop (didn't bet)
Seat 6: cnn123 folded before Flop (didn't bet)
Seat 7: Painkiller72 folded before Flop (didn't bet)
Seat 8: matiko09 collected ($7.12)





PokerStars Hand #152884783832:  Hold'em No Limit ($1/$2 USD) - 2016/05/05 15:59:36 CET [2016/05/05 9:59:36 ET]
Table 'Tololo' 9-max Seat #8 is the button
Seat 1: Kukuryzka ($265.54 in chips) 
Seat 2: gabi_igna ($237.39 in chips) 
Seat 3: nickreason17 ($223.22 in chips) 
Seat 5: matiko09 ($253.49 in chips) 
Seat 6: Xagua ($107.21 in chips) 
Seat 8: KovIFish89 ($200 in chips) 
Seat 9: Fitzyferret ($329.31 in chips) 
Fitzyferret: posts small blind $1
Kukuryzka: posts big blind $2
*** HOLE CARDS ***
Dealt to matiko09 [6h 2d]
gabi_igna: folds 
nickreason17: folds 
matiko09: folds 
Xagua: raises $3 to $5
KovIFish89: raises $12 to $17
Fitzyferret: folds 
Kukuryzka: folds 
Xagua: folds 
Uncalled bet ($12) returned to KovIFish89
KovIFish89 collected $13 from pot
KovIFish89: doesn't show hand 
*** SUMMARY ***
Total pot $13 | Rake $0 
Seat 1: Kukuryzka (big blind) folded before Flop
Seat 2: gabi_igna folded before Flop (didn't bet)
Seat 3: nickreason17 folded before Flop (didn't bet)
Seat 5: matiko09 folded before Flop (didn't bet)
Seat 6: Xagua folded before Flop
Seat 8: KovIFish89 (button) collected ($13)
Seat 9: Fitzyferret (small blind) folded before Flop





PokerStars Hand #152884784683:  Hold'em No Limit (€0.50/€1.00 EUR) - 2016/05/05 15:59:38 CET [2016/05/05 9:59:38 ET]
Table 'Carol II' 9-max Seat #2 is the button
Seat 1: vrnMike (€100 in chips) 
Seat 2: matiko09 (€106.50 in chips) 
Seat 4: Merlin_1905 (€134.73 in chips) 
Seat 5: Painkiller72 (€101.50 in chips) 
Seat 6: Kukuryzka (€99.50 in chips) 
Seat 7: Spid1 (€100 in chips) 
Seat 8: sanpidk (€108.08 in chips) 
Merlin_1905: posts small blind €0.50
Painkiller72: posts big blind €1
*** HOLE CARDS ***
Dealt to matiko09 [8d Js]
Kukuryzka: folds 
Spid1: folds 
sanpidk: folds 
vrnMike: folds 
matiko09: raises €1.27 to €2.27
Merlin_1905: calls €1.77
Painkiller72: folds 
*** FLOP *** [Qc 2h Jd]
Merlin_1905: bets €3
matiko09: calls €3
*** TURN *** [Qc 2h Jd] [Qh]
Merlin_1905: bets €5
matiko09: calls €5
*** RIVER *** [Qc 2h Jd Qh] [9s]
Merlin_1905: checks 
matiko09: checks 
*** SHOW DOWN ***
Merlin_1905: shows [Ad 2c] (two pair, Queens and Deuces)
matiko09: shows [8d Js] (two pair, Queens and Jacks)
matiko09 collected €20.46 from pot
*** SUMMARY ***
Total pot €21.54 | Rake €1.08 
Board [Qc 2h Jd Qh 9s]
Seat 1: vrnMike folded before Flop (didn't bet)
Seat 2: matiko09 (button) showed [8d Js] and won (€20.46) with two pair, Queens and Jacks
Seat 4: Merlin_1905 (small blind) showed [Ad 2c] and lost with two pair, Queens and Deuces
Seat 5: Painkiller72 (big blind) folded before Flop
Seat 6: Kukuryzka folded before Flop (didn't bet)
Seat 7: Spid1 folded before Flop (didn't bet)
Seat 8: sanpidk folded before Flop (didn't bet)





PokerStars Hand #152884785490:  Hold'em No Limit ($0.50/$1.00 USD) - 2016/05/05 15:59:39 CET [2016/05/05 9:59:39 ET]
Table 'Luthera' 9-max Seat #6 is the button
Seat 1: MrMattkk ($98.99 in chips) 
Seat 2: Spid1 ($100.50 in chips) 
Seat 3: ipashutapkom ($56.13 in chips) 
Seat 4: matiko09 ($111.48 in chips) 
Seat 5: Painkiller72 ($100 in chips) 
Seat 6: Dantist1122 ($101 in chips) 
Seat 7: Chin41178 ($110.28 in chips) 
Seat 8: xdrKush420x ($98 in chips) 
Seat 9: vrnMike ($100 in chips) 
Chin41178: posts small blind $0.50
xdrKush420x: posts big blind $1
*** HOLE CARDS ***
Dealt to matiko09 [3d Kd]
vrnMike: raises $1 to $2
MrMattkk: calls $2
Spid1: folds 
ipashutapkom: folds 
matiko09: folds 
Painkiller72: folds 
Dantist1122: folds 
Chin41178: folds 
xdrKush420x: calls $1
*** FLOP *** [6s 9c 2d]
xdrKush420x: checks 
vrnMike: checks 
MrMattkk: checks 
*** TURN *** [6s 9c 2d] [9h]
xdrKush420x: checks 
vrnMike: checks 
MrMattkk: checks 
*** RIVER *** [6s 9c 2d 9h] [5s]
xdrKush420x: checks 
vrnMike: checks 
MrMattkk: checks 
*** SHOW DOWN ***
xdrKush420x: shows [8d Ks] (a pair of Nines)
vrnMike: shows [Ac Qs] (a pair of Nines - Ace kicker)
MrMattkk: mucks hand 
vrnMike collected $6.18 from pot
*** SUMMARY ***
Total pot $6.50 | Rake $0.32 
Board [6s 9c 2d 9h 5s]
Seat 1: MrMattkk mucked [Ad 7d]
Seat 2: Spid1 folded before Flop (didn't bet)
Seat 3: ipashutapkom folded before Flop (didn't bet)
Seat 4: matiko09 folded before Flop (didn't bet)
Seat 5: Painkiller72 folded before Flop (didn't bet)
Seat 6: Dantist1122 (button) folded before Flop (didn't bet)
Seat 7: Chin41178 (small blind) folded before Flop
Seat 8: xdrKush420x (big blind) showed [8d Ks] and lost with a pair of Nines
Seat 9: vrnMike showed [Ac Qs] and won ($6.18) with a pair of Nines





PokerStars Hand #152884789247:  Hold'em No Limit ($1/$2 USD) - 2016/05/05 15:59:47 CET [2016/05/05 9:59:47 ET]
Table 'Lundia' 9-max Seat #8 is the button
Seat 1: Fitzyferret ($223.60 in chips) 
Seat 2: patpaty ($225.47 in chips) 
Seat 3: Painkiller72 ($200 in chips) 
Seat 4: KovIFish89 ($234.76 in chips) 
Seat 5: zmOe84 ($194.76 in chips) 
Seat 6: Spid1 ($249.39 in chips) 
Seat 7: matiko09 ($248.11 in chips) 
Seat 8: Durnichka ($81 in chips) 
Seat 9: gabi_igna ($270.12 in chips) 
gabi_igna: posts small blind $1
Fitzyferret: posts big blind $2
*** HOLE CARDS ***
Dealt to matiko09 [Jh 4d]
patpaty: folds 
Painkiller72: folds 
KovIFish89: folds 
zmOe84: folds 
Spid1: folds 
matiko09: folds 
Durnichka: raises $3 to $5
gabi_igna: folds 
Fitzyferret: raises $11 to $16
Durnichka: folds 
Uncalled bet ($11) returned to Fitzyferret
Fitzyferret collected $11 from pot
Fitzyferret: doesn't show hand 
*** SUMMARY ***
Total pot $11 | Rake $0 
Seat 1: Fitzyferret (big blind) collected ($11)
Seat 2: patpaty folded before Flop (didn't bet)
Seat 3: Painkiller72 folded before Flop (didn't bet)
Seat 4: KovIFish89 folded before Flop (didn't bet)
Seat 5: zmOe84 folded before Flop (didn't bet)
Seat 6: Spid1 folded before Flop (didn't bet)
Seat 7: matiko09 folded before Flop (didn't bet)
Seat 8: Durnichka (button) folded before Flop
Seat 9: gabi_igna (small blind) folded before Flop





PokerStars Hand #152884791442:  Hold'em No Limit ($1/$2 USD) - 2016/05/05 15:59:52 CET [2016/05/05 9:59:52 ET]
Table 'Samitchell' 9-max Seat #1 is the button
Seat 1: KovIFish89 ($200 in chips) 
Seat 2: matiko09 ($200 in chips) 
Seat 3: gabi_igna ($314.32 in chips) 
Seat 4: Fitzyferret ($372.22 in chips) 
Seat 5: Spid1 ($223.15 in chips) 
Seat 6: nickreason17 ($220 in chips) 
Seat 7: patpaty ($152.84 in chips) 
Seat 8: WolleMalone ($200 in chips) 
Seat 9: kblkxls ($141.07 in chips) 
matiko09: posts small blind $1
gabi_igna: posts big blind $2
*** HOLE CARDS ***
Dealt to matiko09 [5c 9h]
Fitzyferret: folds 
Spid1: folds 
nickreason17: folds 
patpaty: folds 
WolleMalone: folds 
kblkxls: raises $2 to $4
KovIFish89: folds 
matiko09: folds 
gabi_igna: calls $2
*** FLOP *** [4c 3d 6s]
gabi_igna: checks 
kblkxls: checks 
*** TURN *** [4c 3d 6s] [2c]
gabi_igna: bets $6
kblkxls: folds 
Uncalled bet ($6) returned to gabi_igna
gabi_igna collected $8.55 from pot
gabi_igna: doesn't show hand 
*** SUMMARY ***
Total pot $9 | Rake $0.45 
Board [4c 3d 6s 2c]
Seat 1: KovIFish89 (button) folded before Flop (didn't bet)
Seat 2: matiko09 (small blind) folded before Flop
Seat 3: gabi_igna (big blind) collected ($8.55)
Seat 4: Fitzyferret folded before Flop (didn't bet)
Seat 5: Spid1 folded before Flop (didn't bet)
Seat 6: nickreason17 folded before Flop (didn't bet)
Seat 7: patpaty folded before Flop (didn't bet)
Seat 8: WolleMalone folded before Flop (didn't bet)
Seat 9: kblkxls folded on the Turn





PokerStars Hand #152884796701:  Hold'em No Limit ($0.50/$1.00 USD) - 2016/05/05 16:00:02 CET [2016/05/05 10:00:02 ET]
Table 'Priska II' 9-max Seat #9 is the button
Seat 2: Kukuryzka ($127.52 in chips) 
Seat 3: matiko09 ($100 in chips) 
Seat 4: Painkiller72 ($155.84 in chips) 
Seat 5: nickreason17 ($173.05 in chips) 
Seat 6: St.LaCoste ($107.52 in chips) 
Seat 7: stockbridge8 ($87.77 in chips) 
Seat 8: pohorc21 ($146.41 in chips) 
Seat 9: torkkdnm ($100 in chips) 
sanpidk will be allowed to play after the button
Kukuryzka: posts small blind $0.50
matiko09: posts big blind $1
*** HOLE CARDS ***
Dealt to matiko09 [Jc 6d]
Painkiller72: raises $1.50 to $2.50
nickreason17: folds 
St.LaCoste: folds 
stockbridge8: folds 
pohorc21: calls $2.50
torkkdnm: folds 
Kukuryzka: folds 
matiko09: folds 
*** FLOP *** [Qh Ts 5s]
Painkiller72: checks 
pohorc21: bets $6
Painkiller72: calls $6
*** TURN *** [Qh Ts 5s] [7c]
Painkiller72: checks 
pohorc21: bets $9
Painkiller72: calls $9
*** RIVER *** [Qh Ts 5s 7c] [8d]
Painkiller72: checks 
pohorc21: checks 
*** SHOW DOWN ***
Painkiller72: shows [Kc Tc] (a pair of Tens)
pohorc21: mucks hand 
Painkiller72 collected $34.68 from pot
*** SUMMARY ***
Total pot $36.50 | Rake $1.82 
Board [Qh Ts 5s 7c 8d]
Seat 2: Kukuryzka (small blind) folded before Flop
Seat 3: matiko09 (big blind) folded before Flop
Seat 4: Painkiller72 showed [Kc Tc] and won ($34.68) with a pair of Tens
Seat 5: nickreason17 folded before Flop (didn't bet)
Seat 6: St.LaCoste folded before Flop (didn't bet)
Seat 7: stockbridge8 folded before Flop (didn't bet)
Seat 8: pohorc21 mucked [2c 2s]
Seat 9: torkkdnm (button) folded before Flop (didn't bet)





PokerStars Hand #152884797614:  Hold'em No Limit ($1/$2 USD) - 2016/05/05 16:00:03 CET [2016/05/05 10:00:03 ET]
Table 'Tololo' 9-max Seat #9 is the button
Seat 1: Kukuryzka ($263.54 in chips) 
Seat 2: gabi_igna ($237.39 in chips) 
Seat 3: nickreason17 ($223.22 in chips) 
Seat 5: matiko09 ($253.49 in chips) 
Seat 6: Xagua ($102.21 in chips) 
Seat 8: KovIFish89 ($208 in chips) 
Seat 9: Fitzyferret ($328.31 in chips) 
Kukuryzka: posts small blind $1
gabi_igna: posts big blind $2
*** HOLE CARDS ***
Dealt to matiko09 [Ts 6h]
nickreason17: folds 
matiko09: folds 
Xagua: folds 
KovIFish89: folds 
Fitzyferret: raises $2.60 to $4.60
Kukuryzka: folds 
gabi_igna: folds 
Uncalled bet ($2.60) returned to Fitzyferret
Fitzyferret collected $5 from pot
Fitzyferret: doesn't show hand 
*** SUMMARY ***
Total pot $5 | Rake $0 
Seat 1: Kukuryzka (small blind) folded before Flop
Seat 2: gabi_igna (big blind) folded before Flop
Seat 3: nickreason17 folded before Flop (didn't bet)
Seat 5: matiko09 folded before Flop (didn't bet)
Seat 6: Xagua folded before Flop (didn't bet)
Seat 8: KovIFish89 folded before Flop (didn't bet)
Seat 9: Fitzyferret (button) collected ($5)





PokerStars Hand #152884799108:  Hold'em No Limit ($1/$2 USD) - 2016/05/05 16:00:06 CET [2016/05/05 10:00:06 ET]
Table 'Tatry II' 9-max Seat #4 is the button
Seat 1: glanza_mike ($238.05 in chips) 
Seat 3: matiko09 ($200 in chips) 
Seat 4: WolleMalone ($200 in chips) 
Seat 5: Painkiller72 ($207.25 in chips) 
Seat 6: Kukuryzka ($200 in chips) 
Seat 9: korol702 ($110.90 in chips) 
Painkiller72: posts small blind $1
Kukuryzka: posts big blind $2
nickreason17: sits out 
T0ny Adams: sits out 
*** HOLE CARDS ***
Dealt to matiko09 [Jd 8s]
korol702: calls $2
glanza_mike: raises $5 to $7
matiko09: folds 
WolleMalone: raises $13 to $20
Painkiller72: folds 
Kukuryzka: folds 
korol702: calls $18
glanza_mike: calls $13
*** FLOP *** [3c 7d 6d]
korol702: bets $28
glanza_mike: calls $28
WolleMalone: folds 
*** TURN *** [3c 7d 6d] [4s]
korol702: bets $62.90 and is all-in
glanza_mike: calls $62.90
*** RIVER *** [3c 7d 6d 4s] [5h]
*** SHOW DOWN ***
korol702: shows [4d 5d] (a straight, Three to Seven)
glanza_mike: shows [6c Ac] (a straight, Three to Seven)
korol702 collected $121.03 from pot
glanza_mike collected $121.02 from pot
*** SUMMARY ***
Total pot $244.80 | Rake $2.75 
Board [3c 7d 6d 4s 5h]
Seat 1: glanza_mike showed [6c Ac] and won ($121.02) with a straight, Three to Seven
Seat 3: matiko09 folded before Flop (didn't bet)
Seat 4: WolleMalone (button) folded on the Flop
Seat 5: Painkiller72 (small blind) folded before Flop
Seat 6: Kukuryzka (big blind) folded before Flop
Seat 9: korol702 showed [4d 5d] and won ($121.03) with a straight, Three to Seven





PokerStars Hand #152884799349:  Hold'em No Limit ($0.50/$1.00 USD) - 2016/05/05 16:00:07 CET [2016/05/05 10:00:07 ET]
Table 'Pyxis III' 9-max Seat #7 is the button
Seat 1: sanpidk ($288.89 in chips) 
Seat 2: SPmaka ($94.90 in chips) 
Seat 3: vrnMike ($100 in chips) 
Seat 4: Sloeve ($124.49 in chips) 
Seat 5: darren1031 ($104.93 in chips) 
Seat 6: kamillo91 ($84.35 in chips) 
Seat 7: mycka86 ($103.88 in chips) 
Seat 8: matiko09 ($106.25 in chips) 
Seat 9: Hypoaroused ($172.38 in chips) 
matiko09: posts small blind $0.50
Hypoaroused: posts big blind $1
*** HOLE CARDS ***
Dealt to matiko09 [8s 2s]
sanpidk: folds 
SPmaka: raises $1 to $2
vrnMike: folds 
Sloeve: folds 
darren1031: raises $4 to $6
kamillo91: folds 
mycka86: folds 
matiko09: folds 
Hypoaroused: folds 
SPmaka: calls $4
*** FLOP *** [6c Js 7s]
SPmaka: checks 
darren1031: bets $7
SPmaka: calls $7
*** TURN *** [6c Js 7s] [5c]
SPmaka: checks 
darren1031: checks 
*** RIVER *** [6c Js 7s 5c] [Kc]
SPmaka: bets $13.06
darren1031: folds 
Uncalled bet ($13.06) returned to SPmaka
SPmaka collected $26.12 from pot
SPmaka: doesn't show hand 
*** SUMMARY ***
Total pot $27.50 | Rake $1.38 
Board [6c Js 7s 5c Kc]
Seat 1: sanpidk folded before Flop (didn't bet)
Seat 2: SPmaka collected ($26.12)
Seat 3: vrnMike folded before Flop (didn't bet)
Seat 4: Sloeve folded before Flop (didn't bet)
Seat 5: darren1031 folded on the River
Seat 6: kamillo91 folded before Flop (didn't bet)
Seat 7: mycka86 (button) folded before Flop (didn't bet)
Seat 8: matiko09 (small blind) folded before Flop
Seat 9: Hypoaroused (big blind) folded before Flop





PokerStars Hand #152884802025:  Hold'em No Limit ($0.50/$1.00 USD) - 2016/05/05 16:00:12 CET [2016/05/05 10:00:12 ET]
Table 'Musa II' 9-max Seat #2 is the button
Seat 1: KovIFish89 ($201.97 in chips) 
Seat 2: koutani7 ($98.50 in chips) 
Seat 3: vrnMike ($107.88 in chips) 
Seat 4: sanpidk ($100 in chips) 
Seat 5: Chin41178 ($67.57 in chips) 
Seat 6: cnn123 ($76.46 in chips) 
Seat 7: Painkiller72 ($100 in chips) 
Seat 8: matiko09 ($105.62 in chips) 
vrnMike: posts small blind $0.50
sanpidk: posts big blind $1
*** HOLE CARDS ***
Dealt to matiko09 [8d 2d]
Chin41178: folds 
cnn123: folds 
Painkiller72: folds 
FroggyPlay joins the table at seat #9 
matiko09: folds 
KovIFish89: raises $1.50 to $2.50
koutani7: folds 
vrnMike: folds 
sanpidk: folds 
Uncalled bet ($1.50) returned to KovIFish89
KovIFish89 collected $2.50 from pot
KovIFish89: doesn't show hand 
*** SUMMARY ***
Total pot $2.50 | Rake $0 
Seat 1: KovIFish89 collected ($2.50)
Seat 2: koutani7 (button) folded before Flop (didn't bet)
Seat 3: vrnMike (small blind) folded before Flop
Seat 4: sanpidk (big blind) folded before Flop
Seat 5: Chin41178 folded before Flop (didn't bet)
Seat 6: cnn123 folded before Flop (didn't bet)
Seat 7: Painkiller72 folded before Flop (didn't bet)
Seat 8: matiko09 folded before Flop (didn't bet)





PokerStars Hand #152884803752:  Hold'em No Limit ($1/$2 USD) - 2016/05/05 16:00:15 CET [2016/05/05 10:00:15 ET]
Table 'Euporie II' 9-max Seat #6 is the button
Seat 2: nickreason17 ($200 in chips) 
Seat 4: Kukuryzka ($199 in chips) 
Seat 5: Nuskatko1986 ($177.16 in chips) 
Seat 6: glanza_mike ($204 in chips) 
Seat 7: matiko09 ($200 in chips) 
Seat 8: Painkiller72 ($200 in chips) 
Seat 9: T0ny Adams ($80.75 in chips) 
matiko09: posts small blind $1
Painkiller72: posts big blind $2
gabi_igna: sits out 
*** HOLE CARDS ***
Dealt to matiko09 [4c Js]
T0ny Adams: raises $2.68 to $4.68
nickreason17: folds 
Kukuryzka: folds 
Nuskatko1986: folds 
glanza_mike: folds 
matiko09: folds 
Painkiller72: folds 
Uncalled bet ($2.68) returned to T0ny Adams
T0ny Adams collected $5 from pot
T0ny Adams: doesn't show hand 
*** SUMMARY ***
Total pot $5 | Rake $0 
Seat 2: nickreason17 folded before Flop (didn't bet)
Seat 4: Kukuryzka folded before Flop (didn't bet)
Seat 5: Nuskatko1986 folded before Flop (didn't bet)
Seat 6: glanza_mike (button) folded before Flop (didn't bet)
Seat 7: matiko09 (small blind) folded before Flop
Seat 8: Painkiller72 (big blind) folded before Flop
Seat 9: T0ny Adams collected ($5)





PokerStars Hand #152884806675:  Hold'em No Limit ($0.50/$1.00 USD) - 2016/05/05 16:00:21 CET [2016/05/05 10:00:21 ET]
Table 'Calypso II' 9-max Seat #6 is the button
Seat 1: nickreason17 ($105.80 in chips) 
Seat 2: torkkdnm ($139 in chips) 
Seat 3: gabi_igna ($104.59 in chips) 
Seat 5: LighTingSSSS ($90.63 in chips) 
Seat 6: WTAPSVG ($168.25 in chips) 
Seat 8: matiko09 ($106.80 in chips) 
Seat 9: maxxmeister ($111.90 in chips) 
sanpidk will be allowed to play after the button
matiko09: posts small blind $0.50
maxxmeister: posts big blind $1
mycka86: sits out 
*** HOLE CARDS ***
Dealt to matiko09 [Th Jc]
nickreason17: folds 
torkkdnm: raises $2 to $3
gabi_igna: folds 
LighTingSSSS: folds 
WTAPSVG is disconnected 
WTAPSVG has timed out while disconnected
WTAPSVG: folds 
matiko09: folds 
maxxmeister: folds 
Uncalled bet ($2) returned to torkkdnm
torkkdnm collected $2.50 from pot
*** SUMMARY ***
Total pot $2.50 | Rake $0 
Seat 1: nickreason17 folded before Flop (didn't bet)
Seat 2: torkkdnm collected ($2.50)
Seat 3: gabi_igna folded before Flop (didn't bet)
Seat 5: LighTingSSSS folded before Flop (didn't bet)
Seat 6: WTAPSVG (button) folded before Flop (didn't bet)
Seat 8: matiko09 (small blind) folded before Flop
Seat 9: maxxmeister (big blind) folded before Flop





PokerStars Hand #152884807992:  Hold'em No Limit ($1/$2 USD) - 2016/05/05 16:00:24 CET [2016/05/05 10:00:24 ET]
Table 'Lundia' 9-max Seat #9 is the button
Seat 1: Fitzyferret ($229.60 in chips) 
Seat 2: patpaty ($225.47 in chips) 
Seat 3: Painkiller72 ($200 in chips) 
Seat 4: KovIFish89 ($234.76 in chips) 
Seat 5: zmOe84 ($194.76 in chips) 
Seat 6: Spid1 ($249.39 in chips) 
Seat 7: matiko09 ($248.11 in chips) 
Seat 8: Durnichka ($76 in chips) 
Seat 9: gabi_igna ($269.12 in chips) 
Fitzyferret: posts small blind $1
patpaty: posts big blind $2
*** HOLE CARDS ***
Dealt to matiko09 [9c Td]
Painkiller72: folds 
KovIFish89: folds 
zmOe84: folds 
Spid1: folds 
matiko09: folds 
Durnichka: raises $3 to $5
gabi_igna: folds 
Fitzyferret: raises $11.55 to $16.55
patpaty: folds 
Durnichka: folds 
Uncalled bet ($11.55) returned to Fitzyferret
Fitzyferret collected $12 from pot
Fitzyferret: doesn't show hand 
*** SUMMARY ***
Total pot $12 | Rake $0 
Seat 1: Fitzyferret (small blind) collected ($12)
Seat 2: patpaty (big blind) folded before Flop
Seat 3: Painkiller72 folded before Flop (didn't bet)
Seat 4: KovIFish89 folded before Flop (didn't bet)
Seat 5: zmOe84 folded before Flop (didn't bet)
Seat 6: Spid1 folded before Flop (didn't bet)
Seat 7: matiko09 folded before Flop (didn't bet)
Seat 8: Durnichka folded before Flop
Seat 9: gabi_igna (button) folded before Flop (didn't bet)





PokerStars Hand #152884808147:  Hold'em No Limit ($1/$2 USD) - 2016/05/05 16:00:24 CET [2016/05/05 10:00:24 ET]
Table 'Samitchell' 9-max Seat #2 is the button
Seat 1: KovIFish89 ($200 in chips) 
Seat 2: matiko09 ($200 in chips) 
Seat 3: gabi_igna ($318.87 in chips) 
Seat 4: Fitzyferret ($372.22 in chips) 
Seat 5: Spid1 ($223.15 in chips) 
Seat 6: nickreason17 ($220 in chips) 
Seat 7: patpaty ($152.84 in chips) 
Seat 8: WolleMalone ($200 in chips) 
Seat 9: kblkxls ($137.07 in chips) 
gabi_igna: posts small blind $1
Fitzyferret: posts big blind $2
*** HOLE CARDS ***
Dealt to matiko09 [Qh Jc]
Spid1: folds 
nickreason17: folds 
patpaty: folds 
WolleMalone: folds 
kblkxls: folds 
KovIFish89: folds 
matiko09: raises $2.54 to $4.54
gabi_igna: folds 
Fitzyferret: calls $2.54
*** FLOP *** [Th 2h 2s]
Fitzyferret: checks 
matiko09: bets $6
Fitzyferret: calls $6
*** TURN *** [Th 2h 2s] [4s]
Fitzyferret: checks 
matiko09: checks 
*** RIVER *** [Th 2h 2s 4s] [Js]
Fitzyferret: bets $14
matiko09: calls $14
*** SHOW DOWN ***
Fitzyferret: shows [9h Jh] (two pair, Jacks and Deuces)
matiko09: shows [Qh Jc] (two pair, Jacks and Deuces - Queen kicker)
matiko09 collected $47.58 from pot
*** SUMMARY ***
Total pot $50.08 | Rake $2.50 
Board [Th 2h 2s 4s Js]
Seat 1: KovIFish89 folded before Flop (didn't bet)
Seat 2: matiko09 (button) showed [Qh Jc] and won ($47.58) with two pair, Jacks and Deuces
Seat 3: gabi_igna (small blind) folded before Flop
Seat 4: Fitzyferret (big blind) showed [9h Jh] and lost with two pair, Jacks and Deuces
Seat 5: Spid1 folded before Flop (didn't bet)
Seat 6: nickreason17 folded before Flop (didn't bet)
Seat 7: patpaty folded before Flop (didn't bet)
Seat 8: WolleMalone folded before Flop (didn't bet)
Seat 9: kblkxls folded before Flop (didn't bet)





PokerStars Hand #152884811173:  Hold'em No Limit ($1/$2 USD) - 2016/05/05 16:00:30 CET [2016/05/05 10:00:30 ET]
Table 'Tololo' 9-max Seat #1 is the button
Seat 1: Kukuryzka ($262.54 in chips) 
Seat 2: gabi_igna ($235.39 in chips) 
Seat 5: matiko09 ($253.49 in chips) 
Seat 6: Xagua ($102.21 in chips) 
Seat 8: KovIFish89 ($208 in chips) 
Seat 9: Fitzyferret ($331.31 in chips) 
gabi_igna: posts small blind $1
nickreason17: is sitting out 
matiko09: posts big blind $2
*** HOLE CARDS ***
Dealt to matiko09 [2h Kh]
Xagua: folds 
KovIFish89: folds 
Fitzyferret: raises $2.60 to $4.60
Kukuryzka: folds 
gabi_igna: folds 
matiko09: folds 
Uncalled bet ($2.60) returned to Fitzyferret
Fitzyferret collected $5 from pot
Fitzyferret: doesn't show hand 
*** SUMMARY ***
Total pot $5 | Rake $0 
Seat 1: Kukuryzka (button) folded before Flop (didn't bet)
Seat 2: gabi_igna (small blind) folded before Flop
Seat 5: matiko09 (big blind) folded before Flop
Seat 6: Xagua folded before Flop (didn't bet)
Seat 8: KovIFish89 folded before Flop (didn't bet)
Seat 9: Fitzyferret collected ($5)





PokerStars Hand #152884812500:  Hold'em No Limit (€0.50/€1.00 EUR) - 2016/05/05 16:00:33 CET [2016/05/05 10:00:33 ET]
Table 'Carol II' 9-max Seat #4 is the button
Seat 1: vrnMike (€100 in chips) 
Seat 2: matiko09 (€116.69 in chips) 
Seat 4: Merlin_1905 (€124.46 in chips) 
Seat 5: Painkiller72 (€100.50 in chips) 
Seat 8: sanpidk (€108.08 in chips) 
Painkiller72: posts small blind €0.50
Kukuryzka: is sitting out 
Spid1: is sitting out 
sanpidk: posts big blind €1
nickreason17: sits out 
*** HOLE CARDS ***
Dealt to matiko09 [Th 9d]
Spid1 leaves the table
vrnMike: folds 
matiko09: folds 
Merlin_1905: folds 
Painkiller72: folds 
Uncalled bet (€0.50) returned to sanpidk
sanpidk collected €1 from pot
sanpidk: doesn't show hand 
*** SUMMARY ***
Total pot €1 | Rake €0 
Seat 1: vrnMike folded before Flop (didn't bet)
Seat 2: matiko09 folded before Flop (didn't bet)
Seat 4: Merlin_1905 (button) folded before Flop (didn't bet)
Seat 5: Painkiller72 (small blind) folded before Flop
Seat 8: sanpidk (big blind) collected (€1)





PokerStars Hand #152884819855:  Hold'em No Limit ($0.50/$1.00 USD) - 2016/05/05 16:00:46 CET [2016/05/05 10:00:46 ET]
Table 'Musa II' 9-max Seat #3 is the button
Seat 1: KovIFish89 ($203.47 in chips) 
Seat 2: koutani7 ($98.50 in chips) 
Seat 3: vrnMike ($107.38 in chips) 
Seat 4: sanpidk ($100 in chips) 
Seat 5: Chin41178 ($67.57 in chips) 
Seat 6: cnn123 ($76.46 in chips) 
Seat 7: Painkiller72 ($100 in chips) 
Seat 8: matiko09 ($105.62 in chips) 
sanpidk: posts small blind $0.50
Chin41178: posts big blind $1
FroggyPlay: sits out 
*** HOLE CARDS ***
Dealt to matiko09 [Kh Qh]
cnn123: folds 
Painkiller72: folds 
matiko09: raises $2 to $3
KovIFish89: folds 
koutani7: folds 
vrnMike: folds 
sanpidk: folds 
Chin41178: folds 
Uncalled bet ($2) returned to matiko09
matiko09 collected $2.50 from pot
matiko09: doesn't show hand 
*** SUMMARY ***
Total pot $2.50 | Rake $0 
Seat 1: KovIFish89 folded before Flop (didn't bet)
Seat 2: koutani7 folded before Flop (didn't bet)
Seat 3: vrnMike (button) folded before Flop (didn't bet)
Seat 4: sanpidk (small blind) folded before Flop
Seat 5: Chin41178 (big blind) folded before Flop
Seat 6: cnn123 folded before Flop (didn't bet)
Seat 7: Painkiller72 folded before Flop (didn't bet)
Seat 8: matiko09 collected ($2.50)





PokerStars Hand #152884819724:  Hold'em No Limit ($1/$2 USD) - 2016/05/05 16:00:46 CET [2016/05/05 10:00:46 ET]
Table 'Euporie II' 9-max Seat #7 is the button
Seat 2: nickreason17 ($200 in chips) 
Seat 4: Kukuryzka ($199 in chips) 
Seat 5: Nuskatko1986 ($177.16 in chips) 
Seat 6: glanza_mike ($204 in chips) 
Seat 7: matiko09 ($200 in chips) 
Seat 8: Painkiller72 ($200 in chips) 
Seat 9: T0ny Adams ($83.75 in chips) 
Painkiller72: posts small blind $1
T0ny Adams: posts big blind $2
gabi_igna: sits out 
*** HOLE CARDS ***
Dealt to matiko09 [Ts Qh]
nickreason17: folds 
Kukuryzka: folds 
Nuskatko1986: folds 
glanza_mike: folds 
matiko09: raises $2.54 to $4.54
Painkiller72: folds 
T0ny Adams: calls $2.54
*** FLOP *** [6d 7c Td]
T0ny Adams: checks 
matiko09: bets $6
T0ny Adams: folds 
Uncalled bet ($6) returned to matiko09
matiko09 collected $9.58 from pot
matiko09: doesn't show hand 
*** SUMMARY ***
Total pot $10.08 | Rake $0.50 
Board [6d 7c Td]
Seat 2: nickreason17 folded before Flop (didn't bet)
Seat 4: Kukuryzka folded before Flop (didn't bet)
Seat 5: Nuskatko1986 folded before Flop (didn't bet)
Seat 6: glanza_mike folded before Flop (didn't bet)
Seat 7: matiko09 (button) collected ($9.58)
Seat 8: Painkiller72 (small blind) folded before Flop
Seat 9: T0ny Adams (big blind) folded on the Flop





PokerStars Hand #152884820272:  Hold'em No Limit (€0.50/€1.00 EUR) - 2016/05/05 16:00:47 CET [2016/05/05 10:00:47 ET]
Table 'Carol II' 9-max Seat #5 is the button
Seat 1: vrnMike (€100 in chips) 
Seat 2: matiko09 (€116.69 in chips) 
Seat 4: Merlin_1905 (€124.46 in chips) 
Seat 5: Painkiller72 (€100 in chips) 
Seat 8: sanpidk (€108.58 in chips) 
sanpidk: posts small blind €0.50
vrnMike: posts big blind €1
nickreason17: sits out 
*** HOLE CARDS ***
Dealt to matiko09 [Ts Kd]
matiko09: folds 
Merlin_1905: folds 
matiko09 leaves the table
Kukuryzka leaves the table
Painkiller72: raises €1 to €2
sanpidk: folds 
vrnMike: calls €1
*** FLOP *** [6s 5s Kh]
vrnMike: checks 
St.LaCoste joins the table at seat #6 
Painkiller72: bets €2.99
vrnMike: folds 
Uncalled bet (€2.99) returned to Painkiller72
Painkiller72 collected €4.28 from pot
Painkiller72: doesn't show hand 
*** SUMMARY ***
Total pot €4.50 | Rake €0.22 
Board [6s 5s Kh]
Seat 1: vrnMike (big blind) folded on the Flop
Seat 2: matiko09 folded before Flop (didn't bet)
Seat 4: Merlin_1905 folded before Flop (didn't bet)
Seat 5: Painkiller72 (button) collected (€4.28)
Seat 8: sanpidk (small blind) folded before Flop





PokerStars Hand #152884826330:  Hold'em No Limit ($1/$2 USD) - 2016/05/05 16:00:59 CET [2016/05/05 10:00:59 ET]
Table 'Lundia' 9-max Seat #1 is the button
Seat 1: Fitzyferret ($236.60 in chips) 
Seat 2: patpaty ($223.47 in chips) 
Seat 3: Painkiller72 ($200 in chips) 
Seat 4: KovIFish89 ($234.76 in chips) 
Seat 5: zmOe84 ($194.76 in chips) 
Seat 6: Spid1 ($249.39 in chips) 
Seat 7: matiko09 ($248.11 in chips) 
Seat 8: Durnichka ($71 in chips) 
Seat 9: gabi_igna ($269.12 in chips) 
patpaty: posts small blind $1
Painkiller72: posts big blind $2
*** HOLE CARDS ***
Dealt to matiko09 [9c 4d]
KovIFish89: folds 
zmOe84: folds 
Spid1: folds 
matiko09: folds 
Durnichka: folds 
gabi_igna: folds 
Fitzyferret: folds 
patpaty: folds 
Uncalled bet ($1) returned to Painkiller72
Painkiller72 collected $2 from pot
Painkiller72: doesn't show hand 
*** SUMMARY ***
Total pot $2 | Rake $0 
Seat 1: Fitzyferret (button) folded before Flop (didn't bet)
Seat 2: patpaty (small blind) folded before Flop
Seat 3: Painkiller72 (big blind) collected ($2)
Seat 4: KovIFish89 folded before Flop (didn't bet)
Seat 5: zmOe84 folded before Flop (didn't bet)
Seat 6: Spid1 folded before Flop (didn't bet)
Seat 7: matiko09 folded before Flop (didn't bet)
Seat 8: Durnichka folded before Flop (didn't bet)
Seat 9: gabi_igna folded before Flop (didn't bet)





PokerStars Hand #152884827982:  Hold'em No Limit ($0.50/$1.00 USD) - 2016/05/05 16:01:02 CET [2016/05/05 10:01:02 ET]
Table 'Luthera' 9-max Seat #7 is the button
Seat 1: MrMattkk ($96.99 in chips) 
Seat 2: Spid1 ($100.50 in chips) 
Seat 3: ipashutapkom ($56.13 in chips) 
Seat 4: matiko09 ($111.48 in chips) 
Seat 5: Painkiller72 ($100 in chips) 
Seat 6: Dantist1122 ($101 in chips) 
Seat 7: Chin41178 ($109.78 in chips) 
Seat 8: xdrKush420x ($96 in chips) 
Seat 9: vrnMike ($104.18 in chips) 
xdrKush420x: posts small blind $0.50
vrnMike: posts big blind $1
*** HOLE CARDS ***
Dealt to matiko09 [8h 2h]
MrMattkk: folds 
Spid1: raises $2 to $3
ipashutapkom: folds 
matiko09: folds 
Painkiller72: folds 
Dantist1122: folds 
Chin41178: calls $3
xdrKush420x: folds 
vrnMike: folds 
*** FLOP *** [6c Qh 5h]
Spid1: bets $5
Chin41178: calls $5
*** TURN *** [6c Qh 5h] [As]
Spid1: bets $11
Chin41178: folds 
Uncalled bet ($11) returned to Spid1
Spid1 collected $16.62 from pot
Spid1: doesn't show hand 
*** SUMMARY ***
Total pot $17.50 | Rake $0.88 
Board [6c Qh 5h As]
Seat 1: MrMattkk folded before Flop (didn't bet)
Seat 2: Spid1 collected ($16.62)
Seat 3: ipashutapkom folded before Flop (didn't bet)
Seat 4: matiko09 folded before Flop (didn't bet)
Seat 5: Painkiller72 folded before Flop (didn't bet)
Seat 6: Dantist1122 folded before Flop (didn't bet)
Seat 7: Chin41178 (button) folded on the Turn
Seat 8: xdrKush420x (small blind) folded before Flop
Seat 9: vrnMike (big blind) folded before Flop





PokerStars Hand #152884830923:  Hold'em No Limit ($0.50/$1.00 USD) - 2016/05/05 16:01:07 CET [2016/05/05 10:01:07 ET]
Table 'Priska II' 9-max Seat #2 is the button
Seat 2: Kukuryzka ($127.02 in chips) 
Seat 3: matiko09 ($100 in chips) 
Seat 4: Painkiller72 ($173.02 in chips) 
Seat 5: nickreason17 ($173.05 in chips) 
Seat 6: St.LaCoste ($107.52 in chips) 
Seat 7: stockbridge8 ($87.77 in chips) 
Seat 8: pohorc21 ($128.91 in chips) 
Seat 9: torkkdnm ($100 in chips) 
matiko09: posts small blind $0.50
Painkiller72: posts big blind $1
sanpidk: sits out 
*** HOLE CARDS ***
Dealt to matiko09 [Th 5c]
nickreason17: folds 
St.LaCoste: folds 
stockbridge8: folds 
pohorc21: calls $1
torkkdnm: folds 
Kukuryzka: folds 
matiko09: folds 
Painkiller72: checks 
*** FLOP *** [4s 8d Ac]
Painkiller72: checks 
pohorc21: checks 
*** TURN *** [4s 8d Ac] [9h]
Painkiller72: checks 
pohorc21: checks 
*** RIVER *** [4s 8d Ac 9h] [5h]
Painkiller72: checks 
pohorc21: checks 
*** SHOW DOWN ***
Painkiller72: shows [8h Ks] (a pair of Eights)
pohorc21: mucks hand 
Painkiller72 collected $2.38 from pot
*** SUMMARY ***
Total pot $2.50 | Rake $0.12 
Board [4s 8d Ac 9h 5h]
Seat 2: Kukuryzka (button) folded before Flop (didn't bet)
Seat 3: matiko09 (small blind) folded before Flop
Seat 4: Painkiller72 (big blind) showed [8h Ks] and won ($2.38) with a pair of Eights
Seat 5: nickreason17 folded before Flop (didn't bet)
Seat 6: St.LaCoste folded before Flop (didn't bet)
Seat 7: stockbridge8 folded before Flop (didn't bet)
Seat 8: pohorc21 mucked [7h Jh]
Seat 9: torkkdnm folded before Flop (didn't bet)





PokerStars Hand #152884832701:  Hold'em No Limit ($1/$2 USD) - 2016/05/05 16:01:10 CET [2016/05/05 10:01:10 ET]
Table 'Tololo' 9-max Seat #2 is the button
Seat 1: Kukuryzka ($262.54 in chips) 
Seat 2: gabi_igna ($234.39 in chips) 
Seat 5: matiko09 ($251.49 in chips) 
Seat 6: Xagua ($102.21 in chips) 
Seat 8: KovIFish89 ($208 in chips) 
Seat 9: Fitzyferret ($334.31 in chips) 
matiko09: posts small blind $1
Xagua: posts big blind $2
*** HOLE CARDS ***
Dealt to matiko09 [6c 5d]
KovIFish89: folds 
Fitzyferret: folds 
Kukuryzka: folds 
gabi_igna: raises $3 to $5
matiko09: folds 
Xagua: raises $97.21 to $102.21 and is all-in
gabi_igna: calls $97.21
*** FLOP *** [3c Jc Qc]
*** TURN *** [3c Jc Qc] [2d]
*** RIVER *** [3c Jc Qc 2d] [3d]
*** SHOW DOWN ***
Xagua: shows [Ah Ad] (two pair, Aces and Threes)
gabi_igna: mucks hand 
Xagua collected $202.67 from pot
*** SUMMARY ***
Total pot $205.42 | Rake $2.75 
Board [3c Jc Qc 2d 3d]
Seat 1: Kukuryzka folded before Flop (didn't bet)
Seat 2: gabi_igna (button) mucked [Th Tc]
Seat 5: matiko09 (small blind) folded before Flop
Seat 6: Xagua (big blind) showed [Ah Ad] and won ($202.67) with two pair, Aces and Threes
Seat 8: KovIFish89 folded before Flop (didn't bet)
Seat 9: Fitzyferret folded before Flop (didn't bet)





PokerStars Hand #152884836155:  Hold'em No Limit ($0.50/$1.00 USD) - 2016/05/05 16:01:17 CET [2016/05/05 10:01:17 ET]
Table 'Musa II' 9-max Seat #4 is the button
Seat 1: KovIFish89 ($203.47 in chips) 
Seat 2: koutani7 ($98.50 in chips) 
Seat 3: vrnMike ($107.38 in chips) 
Seat 4: sanpidk ($100 in chips) 
Seat 5: Chin41178 ($66.57 in chips) 
Seat 6: cnn123 ($76.46 in chips) 
Seat 7: Painkiller72 ($100 in chips) 
Seat 8: matiko09 ($107.12 in chips) 
Chin41178: posts small blind $0.50
cnn123: posts big blind $1
FroggyPlay: sits out 
*** HOLE CARDS ***
Dealt to matiko09 [3h 9s]
Painkiller72: folds 
matiko09: folds 
KovIFish89: raises $2 to $3
koutani7: calls $3
vrnMike: folds 
sanpidk: folds 
Chin41178: calls $2.50
cnn123: calls $2
*** FLOP *** [7h 9d Th]
Chin41178: bets $7
cnn123: folds 
KovIFish89: calls $7
koutani7: folds 
*** TURN *** [7h 9d Th] [3c]
Chin41178: bets $18
KovIFish89: folds 
Uncalled bet ($18) returned to Chin41178
Chin41178 collected $24.70 from pot
Chin41178: doesn't show hand 
*** SUMMARY ***
Total pot $26 | Rake $1.30 
Board [7h 9d Th 3c]
Seat 1: KovIFish89 folded on the Turn
Seat 2: koutani7 folded on the Flop
Seat 3: vrnMike folded before Flop (didn't bet)
Seat 4: sanpidk (button) folded before Flop (didn't bet)
Seat 5: Chin41178 (small blind) collected ($24.70)
Seat 6: cnn123 (big blind) folded on the Flop
Seat 7: Painkiller72 folded before Flop (didn't bet)
Seat 8: matiko09 folded before Flop (didn't bet)





PokerStars Hand #152884836167:  Hold'em No Limit ($1/$2 USD) - 2016/05/05 16:01:17 CET [2016/05/05 10:01:17 ET]
Table 'Lundia' 9-max Seat #2 is the button
Seat 1: Fitzyferret ($236.60 in chips) 
Seat 2: patpaty ($222.47 in chips) 
Seat 3: Painkiller72 ($201 in chips) 
Seat 4: KovIFish89 ($234.76 in chips) 
Seat 5: zmOe84 ($194.76 in chips) 
Seat 6: Spid1 ($249.39 in chips) 
Seat 7: matiko09 ($248.11 in chips) 
Seat 8: Durnichka ($71 in chips) 
Seat 9: gabi_igna ($269.12 in chips) 
Painkiller72: posts small blind $1
KovIFish89: posts big blind $2
*** HOLE CARDS ***
Dealt to matiko09 [4c Th]
zmOe84: folds 
Spid1: folds 
matiko09: folds 
Durnichka: raises $3 to $5
gabi_igna: folds 
Fitzyferret: folds 
patpaty: folds 
Painkiller72: folds 
KovIFish89: calls $3
*** FLOP *** [9c Ac 5h]
KovIFish89: checks 
Durnichka: bets $3.44
KovIFish89: calls $3.44
*** TURN *** [9c Ac 5h] [Jd]
KovIFish89: checks 
Durnichka: bets $13
KovIFish89: raises $22 to $35
Durnichka: calls $22
*** RIVER *** [9c Ac 5h Jd] [Kd]
KovIFish89: bets $30
Durnichka: folds 
Uncalled bet ($30) returned to KovIFish89
KovIFish89 collected $85.13 from pot
KovIFish89: doesn't show hand 
*** SUMMARY ***
Total pot $87.88 | Rake $2.75 
Board [9c Ac 5h Jd Kd]
Seat 1: Fitzyferret folded before Flop (didn't bet)
Seat 2: patpaty (button) folded before Flop (didn't bet)
Seat 3: Painkiller72 (small blind) folded before Flop
Seat 4: KovIFish89 (big blind) collected ($85.13)
Seat 5: zmOe84 folded before Flop (didn't bet)
Seat 6: Spid1 folded before Flop (didn't bet)
Seat 7: matiko09 folded before Flop (didn't bet)
Seat 8: Durnichka folded on the River
Seat 9: gabi_igna folded before Flop (didn't bet)





PokerStars Hand #152884841044:  Hold'em No Limit ($0.50/$1.00 USD) - 2016/05/05 16:01:25 CET [2016/05/05 10:01:25 ET]
Table 'Calypso II' 9-max Seat #8 is the button
Seat 1: nickreason17 ($105.80 in chips) 
Seat 2: torkkdnm ($140.50 in chips) 
Seat 3: gabi_igna ($104.59 in chips) 
Seat 5: LighTingSSSS ($90.63 in chips) 
Seat 8: matiko09 ($106.30 in chips) 
Seat 9: maxxmeister ($110.90 in chips) 
maxxmeister: posts small blind $0.50
nickreason17: posts big blind $1
mycka86: sits out 
sanpidk: sits out 
*** HOLE CARDS ***
Dealt to matiko09 [Qc 3d]
torkkdnm: folds 
gabi_igna: folds 
LighTingSSSS: folds 
matiko09: folds 
maxxmeister: raises $2.50 to $3.50
nickreason17: folds 
Uncalled bet ($2.50) returned to maxxmeister
maxxmeister collected $2 from pot
maxxmeister: doesn't show hand 
*** SUMMARY ***
Total pot $2 | Rake $0 
Seat 1: nickreason17 (big blind) folded before Flop
Seat 2: torkkdnm folded before Flop (didn't bet)
Seat 3: gabi_igna folded before Flop (didn't bet)
Seat 5: LighTingSSSS folded before Flop (didn't bet)
Seat 8: matiko09 (button) folded before Flop (didn't bet)
Seat 9: maxxmeister (small blind) collected ($2)





PokerStars Hand #152884849616:  Hold'em No Limit ($1/$2 USD) - 2016/05/05 16:01:41 CET [2016/05/05 10:01:41 ET]
Table 'Samitchell' 9-max Seat #3 is the button
Seat 1: KovIFish89 ($200 in chips) 
Seat 2: matiko09 ($223.04 in chips) 
Seat 3: gabi_igna ($317.87 in chips) 
Seat 4: Fitzyferret ($347.68 in chips) 
Seat 7: patpaty ($152.84 in chips) 
Seat 8: WolleMalone ($200 in chips) 
Seat 9: kblkxls ($137.07 in chips) 
Fitzyferret: posts small blind $1
Spid1: is sitting out 
nickreason17: is sitting out 
patpaty: posts big blind $2
*** HOLE CARDS ***
Dealt to matiko09 [Tc 9s]
Spid1 leaves the table
Kukuryzka joins the table at seat #5 
WolleMalone: raises $4 to $6
Kukuryzka leaves the table
kblkxls: folds 
nickreason17 leaves the table
KovIFish89: folds 
matiko09: folds 
chaps1988 joins the table at seat #5 
gabi_igna: folds 
Fitzyferret: folds 
patpaty: folds 
Uncalled bet ($4) returned to WolleMalone
WolleMalone collected $5 from pot
WolleMalone: doesn't show hand 
*** SUMMARY ***
Total pot $5 | Rake $0 
Seat 1: KovIFish89 folded before Flop (didn't bet)
Seat 2: matiko09 folded before Flop (didn't bet)
Seat 3: gabi_igna (button) folded before Flop (didn't bet)
Seat 4: Fitzyferret (small blind) folded before Flop
Seat 7: patpaty (big blind) folded before Flop
Seat 8: WolleMalone collected ($5)
Seat 9: kblkxls folded before Flop (didn't bet)





PokerStars Hand #152884850995:  Hold'em No Limit ($1/$2 USD) - 2016/05/05 16:01:43 CET [2016/05/05 10:01:43 ET]
Table 'Euporie II' 9-max Seat #8 is the button
Seat 1: gabi_igna ($200 in chips) 
Seat 2: nickreason17 ($200 in chips) 
Seat 4: Kukuryzka ($199 in chips) 
Seat 5: Nuskatko1986 ($177.16 in chips) 
Seat 6: glanza_mike ($204 in chips) 
Seat 7: matiko09 ($205.04 in chips) 
Seat 8: Painkiller72 ($200 in chips) 
Seat 9: T0ny Adams ($79.21 in chips) 
T0ny Adams: posts small blind $1
gabi_igna: posts big blind $2
*** HOLE CARDS ***
Dealt to matiko09 [7d Jc]
nickreason17: folds 
Kukuryzka: folds 
Nuskatko1986: calls $2
glanza_mike: folds 
matiko09: folds 
Painkiller72: folds 
chaps1988 joins the table at seat #3 
T0ny Adams: calls $1
gabi_igna: checks 
*** FLOP *** [Qs 6d Kh]
T0ny Adams: bets $4
gabi_igna: folds 
Nuskatko1986: folds 
Uncalled bet ($4) returned to T0ny Adams
T0ny Adams collected $5.70 from pot
T0ny Adams: doesn't show hand 
*** SUMMARY ***
Total pot $6 | Rake $0.30 
Board [Qs 6d Kh]
Seat 1: gabi_igna (big blind) folded on the Flop
Seat 2: nickreason17 folded before Flop (didn't bet)
Seat 4: Kukuryzka folded before Flop (didn't bet)
Seat 5: Nuskatko1986 folded on the Flop
Seat 6: glanza_mike folded before Flop (didn't bet)
Seat 7: matiko09 folded before Flop (didn't bet)
Seat 8: Painkiller72 (button) folded before Flop (didn't bet)
Seat 9: T0ny Adams (small blind) collected ($5.70)





PokerStars Hand #152884855459:  Hold'em No Limit ($1/$2 USD) - 2016/05/05 16:01:51 CET [2016/05/05 10:01:51 ET]
Table 'Tololo' 9-max Seat #5 is the button
Seat 1: Kukuryzka ($262.54 in chips) 
Seat 2: gabi_igna ($200 in chips) 
Seat 5: matiko09 ($250.49 in chips) 
Seat 6: Xagua ($202.67 in chips) 
Seat 8: KovIFish89 ($208 in chips) 
Seat 9: Fitzyferret ($334.31 in chips) 
Xagua: posts small blind $1
KovIFish89: posts big blind $2
*** HOLE CARDS ***
Dealt to matiko09 [Tc 6d]
Fitzyferret: folds 
Kukuryzka: folds 
gabi_igna: folds 
chaps1988 joins the table at seat #7 
matiko09: folds 
Xagua: folds 
Uncalled bet ($1) returned to KovIFish89
KovIFish89 collected $2 from pot
KovIFish89: doesn't show hand 
*** SUMMARY ***
Total pot $2 | Rake $0 
Seat 1: Kukuryzka folded before Flop (didn't bet)
Seat 2: gabi_igna folded before Flop (didn't bet)
Seat 5: matiko09 (button) folded before Flop (didn't bet)
Seat 6: Xagua (small blind) folded before Flop
Seat 8: KovIFish89 (big blind) collected ($2)
Seat 9: Fitzyferret folded before Flop (didn't bet)





PokerStars Hand #152884856342:  Hold'em No Limit ($1/$2 USD) - 2016/05/05 16:01:52 CET [2016/05/05 10:01:52 ET]
Table 'Tatry II' 9-max Seat #5 is the button
Seat 1: glanza_mike ($248.17 in chips) 
Seat 3: matiko09 ($200 in chips) 
Seat 4: WolleMalone ($200 in chips) 
Seat 5: Painkiller72 ($206.25 in chips) 
Seat 6: Kukuryzka ($198 in chips) 
Seat 7: nickreason17 ($200 in chips) 
Seat 9: korol702 ($121.03 in chips) 
Kukuryzka: posts small blind $1
nickreason17: posts big blind $2
T0ny Adams: sits out 
*** HOLE CARDS ***
Dealt to matiko09 [9s Jc]
chaps1988 joins the table at seat #8 
korol702: folds 
glanza_mike: folds 
matiko09: folds 
WolleMalone: raises $3 to $5
Painkiller72: folds 
Kukuryzka: folds 
nickreason17: folds 
Uncalled bet ($3) returned to WolleMalone
WolleMalone collected $5 from pot
WolleMalone: doesn't show hand 
*** SUMMARY ***
Total pot $5 | Rake $0 
Seat 1: glanza_mike folded before Flop (didn't bet)
Seat 3: matiko09 folded before Flop (didn't bet)
Seat 4: WolleMalone collected ($5)
Seat 5: Painkiller72 (button) folded before Flop (didn't bet)
Seat 6: Kukuryzka (small blind) folded before Flop
Seat 7: nickreason17 (big blind) folded before Flop
Seat 9: korol702 folded before Flop (didn't bet)





PokerStars Hand #152884860259:  Hold'em No Limit ($0.50/$1.00 USD) - 2016/05/05 16:01:59 CET [2016/05/05 10:01:59 ET]
Table 'Priska II' 9-max Seat #3 is the button
Seat 2: Kukuryzka ($127.02 in chips) 
Seat 3: matiko09 ($100 in chips) 
Seat 4: Painkiller72 ($174.40 in chips) 
Seat 5: nickreason17 ($173.05 in chips) 
Seat 6: St.LaCoste ($107.52 in chips) 
Seat 7: stockbridge8 ($87.77 in chips) 
Seat 8: pohorc21 ($127.91 in chips) 
Seat 9: torkkdnm ($100 in chips) 
Painkiller72: posts small blind $0.50
nickreason17: posts big blind $1
sanpidk: sits out 
*** HOLE CARDS ***
Dealt to matiko09 [7d 3d]
St.LaCoste: folds 
stockbridge8: raises $2 to $3
pohorc21: folds 
torkkdnm: folds 
Kukuryzka: folds 
matiko09: folds 
Painkiller72: folds 
nickreason17: folds 
Uncalled bet ($2) returned to stockbridge8
stockbridge8 collected $2.50 from pot
stockbridge8: doesn't show hand 
*** SUMMARY ***
Total pot $2.50 | Rake $0 
Seat 2: Kukuryzka folded before Flop (didn't bet)
Seat 3: matiko09 (button) folded before Flop (didn't bet)
Seat 4: Painkiller72 (small blind) folded before Flop
Seat 5: nickreason17 (big blind) folded before Flop
Seat 6: St.LaCoste folded before Flop (didn't bet)
Seat 7: stockbridge8 collected ($2.50)
Seat 8: pohorc21 folded before Flop (didn't bet)
Seat 9: torkkdnm folded before Flop (didn't bet)





PokerStars Hand #152884865366:  Hold'em No Limit ($1/$2 USD) - 2016/05/05 16:02:08 CET [2016/05/05 10:02:08 ET]
Table 'Tololo' 9-max Seat #6 is the button
Seat 1: Kukuryzka ($262.54 in chips) 
Seat 2: gabi_igna ($200 in chips) 
Seat 5: matiko09 ($250.49 in chips) 
Seat 6: Xagua ($201.67 in chips) 
Seat 8: KovIFish89 ($209 in chips) 
Seat 9: Fitzyferret ($334.31 in chips) 
chaps1988 will be allowed to play after the button
KovIFish89: posts small blind $1
Fitzyferret: posts big blind $2
*** HOLE CARDS ***
Dealt to matiko09 [3h Ah]
Kukuryzka: folds 
Kukuryzka leaves the table
gabi_igna: folds 
matiko09: raises $3 to $5
Xagua: calls $5
KovIFish89: raises $15 to $20
Fitzyferret: folds 
matiko09: folds 
Xagua: calls $15
*** FLOP *** [Ad Kd Ts]
KovIFish89: checks 
Xagua: bets $24
KovIFish89: calls $24
*** TURN *** [Ad Kd Ts] [7d]
KovIFish89: checks 
Xagua: checks 
*** RIVER *** [Ad Kd Ts 7d] [7s]
KovIFish89: checks 
Xagua: checks 
*** SHOW DOWN ***
KovIFish89: shows [Qd Ks] (two pair, Kings and Sevens)
Xagua: shows [Qc Ac] (two pair, Aces and Sevens)
Xagua collected $92.25 from pot
*** SUMMARY ***
Total pot $95 | Rake $2.75 
Board [Ad Kd Ts 7d 7s]
Seat 1: Kukuryzka folded before Flop (didn't bet)
Seat 2: gabi_igna folded before Flop (didn't bet)
Seat 5: matiko09 folded before Flop
Seat 6: Xagua (button) showed [Qc Ac] and won ($92.25) with two pair, Aces and Sevens
Seat 8: KovIFish89 (small blind) showed [Qd Ks] and lost with two pair, Kings and Sevens
Seat 9: Fitzyferret (big blind) folded before Flop





PokerStars Hand #152884867697:  Hold'em No Limit ($0.50/$1.00 USD) - 2016/05/05 16:02:12 CET [2016/05/05 10:02:12 ET]
Table 'Luthera' 9-max Seat #8 is the button
Seat 1: MrMattkk ($96.99 in chips) 
Seat 2: Spid1 ($109.12 in chips) 
Seat 3: ipashutapkom ($56.13 in chips) 
Seat 4: matiko09 ($111.48 in chips) 
Seat 5: Painkiller72 ($100 in chips) 
Seat 6: Dantist1122 ($101 in chips) 
Seat 7: Chin41178 ($101.78 in chips) 
Seat 8: xdrKush420x ($95.50 in chips) 
Seat 9: vrnMike ($103.18 in chips) 
vrnMike: posts small blind $0.50
MrMattkk: posts big blind $1
*** HOLE CARDS ***
Dealt to matiko09 [2c 8c]
Spid1: folds 
ipashutapkom: folds 
matiko09: folds 
Painkiller72: folds 
Dantist1122: folds 
Chin41178: raises $2 to $3
xdrKush420x: folds 
vrnMike: folds 
MrMattkk: calls $2
*** FLOP *** [Kc Qs 2s]
MrMattkk: checks 
Chin41178: checks 
*** TURN *** [Kc Qs 2s] [4s]
MrMattkk: checks 
Chin41178: checks 
*** RIVER *** [Kc Qs 2s 4s] [4c]
MrMattkk: checks 
Chin41178: checks 
*** SHOW DOWN ***
MrMattkk: shows [9d Jh] (a pair of Fours)
Chin41178: shows [Js Jd] (two pair, Jacks and Fours)
Chin41178 collected $6.18 from pot
*** SUMMARY ***
Total pot $6.50 | Rake $0.32 
Board [Kc Qs 2s 4s 4c]
Seat 1: MrMattkk (big blind) showed [9d Jh] and lost with a pair of Fours
Seat 2: Spid1 folded before Flop (didn't bet)
Seat 3: ipashutapkom folded before Flop (didn't bet)
Seat 4: matiko09 folded before Flop (didn't bet)
Seat 5: Painkiller72 folded before Flop (didn't bet)
Seat 6: Dantist1122 folded before Flop (didn't bet)
Seat 7: Chin41178 showed [Js Jd] and won ($6.18) with two pair, Jacks and Fours
Seat 8: xdrKush420x (button) folded before Flop (didn't bet)
Seat 9: vrnMike (small blind) folded before Flop





PokerStars Hand #152884868844:  Hold'em No Limit ($0.50/$1.00 USD) - 2016/05/05 16:02:14 CET [2016/05/05 10:02:14 ET]
Table 'Calypso II' 9-max Seat #9 is the button
Seat 1: nickreason17 ($104.80 in chips) 
Seat 2: torkkdnm ($140.50 in chips) 
Seat 3: gabi_igna ($104.59 in chips) 
Seat 5: LighTingSSSS ($90.63 in chips) 
Seat 8: matiko09 ($106.30 in chips) 
Seat 9: maxxmeister ($111.90 in chips) 
nickreason17: posts small blind $0.50
torkkdnm: posts big blind $1
mycka86: sits out 
sanpidk: sits out 
*** HOLE CARDS ***
Dealt to matiko09 [9h Ac]
gabi_igna: folds 
LighTingSSSS: folds 
matiko09: raises $1.50 to $2.50
maxxmeister: folds 
nickreason17: folds 
torkkdnm: folds 
Uncalled bet ($1.50) returned to matiko09
matiko09 collected $2.50 from pot
matiko09: doesn't show hand 
*** SUMMARY ***
Total pot $2.50 | Rake $0 
Seat 1: nickreason17 (small blind) folded before Flop
Seat 2: torkkdnm (big blind) folded before Flop
Seat 3: gabi_igna folded before Flop (didn't bet)
Seat 5: LighTingSSSS folded before Flop (didn't bet)
Seat 8: matiko09 collected ($2.50)
Seat 9: maxxmeister (button) folded before Flop (didn't bet)





PokerStars Hand #152884868804:  Hold'em No Limit ($0.50/$1.00 USD) - 2016/05/05 16:02:14 CET [2016/05/05 10:02:14 ET]
Table 'Pyxis III' 9-max Seat #8 is the button
Seat 1: sanpidk ($288.89 in chips) 
Seat 2: SPmaka ($108.02 in chips) 
Seat 3: vrnMike ($100 in chips) 
Seat 4: Sloeve ($124.49 in chips) 
Seat 5: darren1031 ($91.93 in chips) 
Seat 6: kamillo91 ($84.35 in chips) 
Seat 7: mycka86 ($103.88 in chips) 
Seat 8: matiko09 ($105.75 in chips) 
Seat 9: Hypoaroused ($171.38 in chips) 
Hypoaroused: posts small blind $0.50
sanpidk: posts big blind $1
*** HOLE CARDS ***
Dealt to matiko09 [Td 9c]
SPmaka: folds 
vrnMike: folds 
Sloeve: folds 
darren1031: folds 
kamillo91: folds 
mycka86: folds 
matiko09: raises $1.27 to $2.27
Hypoaroused: folds 
sanpidk: calls $1.27
*** FLOP *** [8d 4s 7c]
sanpidk: checks 
matiko09: bets $3.11
sanpidk: calls $3.11
*** TURN *** [8d 4s 7c] [8s]
sanpidk: checks 
matiko09: checks 
*** RIVER *** [8d 4s 7c 8s] [8h]
sanpidk: bets $8.50
matiko09: folds 
Uncalled bet ($8.50) returned to sanpidk
sanpidk collected $10.70 from pot
sanpidk: doesn't show hand 
*** SUMMARY ***
Total pot $11.26 | Rake $0.56 
Board [8d 4s 7c 8s 8h]
Seat 1: sanpidk (big blind) collected ($10.70)
Seat 2: SPmaka folded before Flop (didn't bet)
Seat 3: vrnMike folded before Flop (didn't bet)
Seat 4: Sloeve folded before Flop (didn't bet)
Seat 5: darren1031 folded before Flop (didn't bet)
Seat 6: kamillo91 folded before Flop (didn't bet)
Seat 7: mycka86 folded before Flop (didn't bet)
Seat 8: matiko09 (button) folded on the River
Seat 9: Hypoaroused (small blind) folded before Flop





PokerStars Hand #152884877102:  Hold'em No Limit ($1/$2 USD) - 2016/05/05 16:02:28 CET [2016/05/05 10:02:28 ET]
Table 'Samitchell' 9-max Seat #4 is the button
Seat 1: KovIFish89 ($200 in chips) 
Seat 2: matiko09 ($223.04 in chips) 
Seat 3: gabi_igna ($317.87 in chips) 
Seat 4: Fitzyferret ($346.68 in chips) 
Seat 7: patpaty ($150.84 in chips) 
Seat 8: WolleMalone ($203 in chips) 
Seat 9: kblkxls ($137.07 in chips) 
chaps1988 will be allowed to play after the button
patpaty: posts small blind $1
WolleMalone: posts big blind $2
*** HOLE CARDS ***
Dealt to matiko09 [6c Kh]
kblkxls: folds 
KovIFish89: folds 
matiko09: folds 
gabi_igna: folds 
Fitzyferret: raises $2.60 to $4.60
patpaty: folds 
WolleMalone: folds 
Uncalled bet ($2.60) returned to Fitzyferret
Fitzyferret collected $5 from pot
Fitzyferret: doesn't show hand 
*** SUMMARY ***
Total pot $5 | Rake $0 
Seat 1: KovIFish89 folded before Flop (didn't bet)
Seat 2: matiko09 folded before Flop (didn't bet)
Seat 3: gabi_igna folded before Flop (didn't bet)
Seat 4: Fitzyferret (button) collected ($5)
Seat 7: patpaty (small blind) folded before Flop
Seat 8: WolleMalone (big blind) folded before Flop
Seat 9: kblkxls folded before Flop (didn't bet)





PokerStars Hand #152884877112:  Hold'em No Limit ($1/$2 USD) - 2016/05/05 16:02:28 CET [2016/05/05 10:02:28 ET]
Table 'Tatry II' 9-max Seat #6 is the button
Seat 1: glanza_mike ($248.17 in chips) 
Seat 3: matiko09 ($200 in chips) 
Seat 4: WolleMalone ($203 in chips) 
Seat 5: Painkiller72 ($206.25 in chips) 
Seat 6: Kukuryzka ($200 in chips) 
Seat 7: nickreason17 ($200 in chips) 
Seat 8: chaps1988 ($200 in chips) 
Seat 9: korol702 ($121.03 in chips) 
nickreason17: posts small blind $1
chaps1988: posts big blind $2
T0ny Adams: sits out 
*** HOLE CARDS ***
Dealt to matiko09 [6c 9d]
korol702: folds 
glanza_mike: raises $4 to $6
matiko09: folds 
WolleMalone: folds 
Painkiller72: folds 
Kukuryzka: folds 
nickreason17: folds 
chaps1988: folds 
Uncalled bet ($4) returned to glanza_mike
glanza_mike collected $5 from pot
glanza_mike: doesn't show hand 
*** SUMMARY ***
Total pot $5 | Rake $0 
Seat 1: glanza_mike collected ($5)
Seat 3: matiko09 folded before Flop (didn't bet)
Seat 4: WolleMalone folded before Flop (didn't bet)
Seat 5: Painkiller72 folded before Flop (didn't bet)
Seat 6: Kukuryzka (button) folded before Flop (didn't bet)
Seat 7: nickreason17 (small blind) folded before Flop
Seat 8: chaps1988 (big blind) folded before Flop
Seat 9: korol702 folded before Flop (didn't bet)





PokerStars Hand #152884881586:  Hold'em No Limit ($0.50/$1.00 USD) - 2016/05/05 16:02:36 CET [2016/05/05 10:02:36 ET]
Table 'Priska II' 9-max Seat #4 is the button
Seat 2: Kukuryzka ($127.02 in chips) 
Seat 3: matiko09 ($100 in chips) 
Seat 4: Painkiller72 ($173.90 in chips) 
Seat 5: nickreason17 ($172.05 in chips) 
Seat 6: St.LaCoste ($107.52 in chips) 
Seat 7: stockbridge8 ($89.27 in chips) 
Seat 8: pohorc21 ($127.91 in chips) 
Seat 9: torkkdnm ($100 in chips) 
nickreason17: posts small blind $0.50
St.LaCoste: posts big blind $1
sanpidk: sits out 
*** HOLE CARDS ***
Dealt to matiko09 [Ks 4c]
stockbridge8: folds 
pohorc21: raises $6.50 to $7.50
torkkdnm: folds 
Kukuryzka: folds 
matiko09: folds 
Painkiller72: calls $7.50
nickreason17: folds 
St.LaCoste: folds 
*** FLOP *** [Qd 9d 6h]
pohorc21: bets $16
Painkiller72: folds 
Uncalled bet ($16) returned to pohorc21
pohorc21 collected $15.68 from pot
pohorc21: doesn't show hand 
*** SUMMARY ***
Total pot $16.50 | Rake $0.82 
Board [Qd 9d 6h]
Seat 2: Kukuryzka folded before Flop (didn't bet)
Seat 3: matiko09 folded before Flop (didn't bet)
Seat 4: Painkiller72 (button) folded on the Flop
Seat 5: nickreason17 (small blind) folded before Flop
Seat 6: St.LaCoste (big blind) folded before Flop
Seat 7: stockbridge8 folded before Flop (didn't bet)
Seat 8: pohorc21 collected ($15.68)
Seat 9: torkkdnm folded before Flop (didn't bet)





PokerStars Hand #152884884070:  Hold'em No Limit ($0.50/$1.00 USD) - 2016/05/05 16:02:40 CET [2016/05/05 10:02:40 ET]
Table 'Calypso II' 9-max Seat #1 is the button
Seat 1: nickreason17 ($104.30 in chips) 
Seat 2: torkkdnm ($139.50 in chips) 
Seat 3: gabi_igna ($104.59 in chips) 
Seat 5: LighTingSSSS ($90.63 in chips) 
Seat 8: matiko09 ($107.80 in chips) 
Seat 9: maxxmeister ($111.90 in chips) 
torkkdnm: posts small blind $0.50
gabi_igna: posts big blind $1
mycka86: sits out 
sanpidk: sits out 
*** HOLE CARDS ***
Dealt to matiko09 [7h 3h]
LighTingSSSS: folds 
matiko09: folds 
maxxmeister: folds 
nickreason17: folds 
torkkdnm: folds 
Uncalled bet ($0.50) returned to gabi_igna
gabi_igna collected $1 from pot
gabi_igna: doesn't show hand 
*** SUMMARY ***
Total pot $1 | Rake $0 
Seat 1: nickreason17 (button) folded before Flop (didn't bet)
Seat 2: torkkdnm (small blind) folded before Flop
Seat 3: gabi_igna (big blind) collected ($1)
Seat 5: LighTingSSSS folded before Flop (didn't bet)
Seat 8: matiko09 folded before Flop (didn't bet)
Seat 9: maxxmeister folded before Flop (didn't bet)





PokerStars Hand #152884887767:  Hold'em No Limit ($1/$2 USD) - 2016/05/05 16:02:47 CET [2016/05/05 10:02:47 ET]
Table 'Lundia' 9-max Seat #3 is the button
Seat 1: Fitzyferret ($236.60 in chips) 
Seat 2: patpaty ($222.47 in chips) 
Seat 3: Painkiller72 ($200 in chips) 
Seat 4: KovIFish89 ($276.45 in chips) 
Seat 5: zmOe84 ($194.76 in chips) 
Seat 6: Spid1 ($249.39 in chips) 
Seat 7: matiko09 ($248.11 in chips) 
Seat 8: Durnichka ($80 in chips) 
Seat 9: gabi_igna ($269.12 in chips) 
KovIFish89: posts small blind $1
zmOe84: posts big blind $2
*** HOLE CARDS ***
Dealt to matiko09 [2h Kc]
Spid1: folds 
matiko09: folds 
Durnichka: folds 
gabi_igna: raises $4 to $6
Fitzyferret: folds 
patpaty: folds 
Painkiller72: folds 
KovIFish89: calls $5
zmOe84: folds 
*** FLOP *** [5h 2d 7d]
KovIFish89: checks 
gabi_igna: checks 
*** TURN *** [5h 2d 7d] [Td]
KovIFish89: bets $8.86
gabi_igna: calls $8.86
*** RIVER *** [5h 2d 7d Td] [9h]
KovIFish89: checks 
gabi_igna: bets $18
KovIFish89: raises $44 to $62
gabi_igna: folds 
Uncalled bet ($44) returned to KovIFish89
KovIFish89 collected $64.97 from pot
KovIFish89: doesn't show hand 
*** SUMMARY ***
Total pot $67.72 | Rake $2.75 
Board [5h 2d 7d Td 9h]
Seat 1: Fitzyferret folded before Flop (didn't bet)
Seat 2: patpaty folded before Flop (didn't bet)
Seat 3: Painkiller72 (button) folded before Flop (didn't bet)
Seat 4: KovIFish89 (small blind) collected ($64.97)
Seat 5: zmOe84 (big blind) folded before Flop
Seat 6: Spid1 folded before Flop (didn't bet)
Seat 7: matiko09 folded before Flop (didn't bet)
Seat 8: Durnichka folded before Flop (didn't bet)
Seat 9: gabi_igna folded on the River





PokerStars Hand #152884890832:  Hold'em No Limit ($0.50/$1.00 USD) - 2016/05/05 16:02:52 CET [2016/05/05 10:02:52 ET]
Table 'Musa II' 9-max Seat #5 is the button
Seat 1: KovIFish89 ($193.47 in chips) 
Seat 2: koutani7 ($95.50 in chips) 
Seat 3: vrnMike ($107.38 in chips) 
Seat 4: sanpidk ($100 in chips) 
Seat 5: Chin41178 ($81.27 in chips) 
Seat 6: cnn123 ($73.46 in chips) 
Seat 8: matiko09 ($107.12 in chips) 
cnn123: posts small blind $0.50
Painkiller72: is sitting out 
Painkiller72 leaves the table
matiko09: posts big blind $1
FroggyPlay: sits out 
*** HOLE CARDS ***
Dealt to matiko09 [4s 5c]
Hayer ana joins the table at seat #7 
KovIFish89: folds 
Hayer ana leaves the table
koutani7: folds 
vrnMike: folds 
sanpidk: folds 
Chin41178: raises $2 to $3
cnn123: calls $2.50
matiko09: folds 
*** FLOP *** [Kd Qs 7d]
cnn123: checks 
Chin41178: bets $3.32
cnn123: calls $3.32
*** TURN *** [Kd Qs 7d] [As]
cnn123: checks 
Chin41178: bets $7
cnn123: folds 
Uncalled bet ($7) returned to Chin41178
Chin41178 collected $12.96 from pot
Chin41178: doesn't show hand 
*** SUMMARY ***
Total pot $13.64 | Rake $0.68 
Board [Kd Qs 7d As]
Seat 1: KovIFish89 folded before Flop (didn't bet)
Seat 2: koutani7 folded before Flop (didn't bet)
Seat 3: vrnMike folded before Flop (didn't bet)
Seat 4: sanpidk folded before Flop (didn't bet)
Seat 5: Chin41178 (button) collected ($12.96)
Seat 6: cnn123 (small blind) folded on the Turn
Seat 8: matiko09 (big blind) folded before Flop





PokerStars Hand #152884890629:  Hold'em No Limit ($1/$2 USD) - 2016/05/05 16:02:52 CET [2016/05/05 10:02:52 ET]
Table 'Tatry II' 9-max Seat #7 is the button
Seat 1: glanza_mike ($251.17 in chips) 
Seat 3: matiko09 ($200 in chips) 
Seat 4: WolleMalone ($203 in chips) 
Seat 5: Painkiller72 ($206.25 in chips) 
Seat 6: Kukuryzka ($200 in chips) 
Seat 7: nickreason17 ($200 in chips) 
Seat 8: chaps1988 ($200 in chips) 
Seat 9: korol702 ($121.03 in chips) 
chaps1988: posts small blind $1
korol702: posts big blind $2
T0ny Adams: sits out 
*** HOLE CARDS ***
Dealt to matiko09 [8d 3c]
glanza_mike: folds 
matiko09: folds 
WolleMalone: folds 
Painkiller72: folds 
Kukuryzka: folds 
nickreason17: raises $2 to $4
chaps1988: folds 
korol702: raises $4 to $8
nickreason17: calls $4
*** FLOP *** [2c 5s 6d]
korol702: bets $8
nickreason17: calls $8
*** TURN *** [2c 5s 6d] [6s]
korol702: checks 
nickreason17: checks 
*** RIVER *** [2c 5s 6d 6s] [5h]
korol702: checks 
nickreason17: checks 
*** SHOW DOWN ***
korol702: shows [7s 7h] (two pair, Sevens and Sixes)
nickreason17: mucks hand 
korol702 collected $31.35 from pot
*** SUMMARY ***
Total pot $33 | Rake $1.65 
Board [2c 5s 6d 6s 5h]
Seat 1: glanza_mike folded before Flop (didn't bet)
Seat 3: matiko09 folded before Flop (didn't bet)
Seat 4: WolleMalone folded before Flop (didn't bet)
Seat 5: Painkiller72 folded before Flop (didn't bet)
Seat 6: Kukuryzka folded before Flop (didn't bet)
Seat 7: nickreason17 (button) mucked [Qh As]
Seat 8: chaps1988 (small blind) folded before Flop
Seat 9: korol702 (big blind) showed [7s 7h] and won ($31.35) with two pair, Sevens and Sixes





PokerStars Hand #152884895566:  Hold'em No Limit ($1/$2 USD) - 2016/05/05 16:03:01 CET [2016/05/05 10:03:01 ET]
Table 'Euporie II' 9-max Seat #9 is the button
Seat 1: gabi_igna ($200 in chips) 
Seat 2: nickreason17 ($200 in chips) 
Seat 4: Kukuryzka ($199 in chips) 
Seat 5: Nuskatko1986 ($175.16 in chips) 
Seat 6: glanza_mike ($204 in chips) 
Seat 7: matiko09 ($205.04 in chips) 
Seat 8: Painkiller72 ($200 in chips) 
Seat 9: T0ny Adams ($82.91 in chips) 
gabi_igna: posts small blind $1
nickreason17: posts big blind $2
chaps1988: sits out 
*** HOLE CARDS ***
Dealt to matiko09 [4h 8h]
Kukuryzka: folds 
Nuskatko1986: calls $2
glanza_mike: folds 
matiko09: folds 
Painkiller72: raises $7 to $9
T0ny Adams: folds 
gabi_igna: folds 
nickreason17: folds 
Nuskatko1986: calls $7
*** FLOP *** [Kh Ac 5c]
Nuskatko1986: bets $10
Painkiller72: calls $10
*** TURN *** [Kh Ac 5c] [Jh]
Nuskatko1986: bets $24
Painkiller72: calls $24
*** RIVER *** [Kh Ac 5c Jh] [6d]
Nuskatko1986: bets $68
Painkiller72: calls $68
*** SHOW DOWN ***
Nuskatko1986: shows [Ks 5s] (two pair, Kings and Fives)
Painkiller72: shows [Js Ad] (two pair, Aces and Jacks)
Painkiller72 collected $222.25 from pot
*** SUMMARY ***
Total pot $225 | Rake $2.75 
Board [Kh Ac 5c Jh 6d]
Seat 1: gabi_igna (small blind) folded before Flop
Seat 2: nickreason17 (big blind) folded before Flop
Seat 4: Kukuryzka folded before Flop (didn't bet)
Seat 5: Nuskatko1986 showed [Ks 5s] and lost with two pair, Kings and Fives
Seat 6: glanza_mike folded before Flop (didn't bet)
Seat 7: matiko09 folded before Flop (didn't bet)
Seat 8: Painkiller72 showed [Js Ad] and won ($222.25) with two pair, Aces and Jacks
Seat 9: T0ny Adams (button) folded before Flop (didn't bet)





PokerStars Hand #152884895970:  Hold'em No Limit ($0.50/$1.00 USD) - 2016/05/05 16:03:01 CET [2016/05/05 10:03:01 ET]
Table 'Luthera' 9-max Seat #9 is the button
Seat 1: MrMattkk ($93.99 in chips) 
Seat 4: matiko09 ($111.48 in chips) 
Seat 5: Painkiller72 ($100 in chips) 
Seat 6: Dantist1122 ($101 in chips) 
Seat 7: Chin41178 ($104.96 in chips) 
Seat 8: xdrKush420x ($95.50 in chips) 
Seat 9: vrnMike ($102.68 in chips) 
MrMattkk: posts small blind $0.50
Spid1: is sitting out 
ipashutapkom: is sitting out 
matiko09: posts big blind $1
*** HOLE CARDS ***
Dealt to matiko09 [7d Ts]
ipashutapkom leaves the table
Spid1 leaves the table
Kukuryzka joins the table at seat #2 
sanpidk joins the table at seat #3 
Painkiller72: folds 
Dantist1122: folds 
Chin41178: folds 
xdrKush420x: raises $2.50 to $3.50
vrnMike: folds 
MrMattkk: folds 
matiko09: folds 
Uncalled bet ($2.50) returned to xdrKush420x
xdrKush420x collected $2.50 from pot
*** SUMMARY ***
Total pot $2.50 | Rake $0 
Seat 1: MrMattkk (small blind) folded before Flop
Seat 4: matiko09 (big blind) folded before Flop
Seat 5: Painkiller72 folded before Flop (didn't bet)
Seat 6: Dantist1122 folded before Flop (didn't bet)
Seat 7: Chin41178 folded before Flop (didn't bet)
Seat 8: xdrKush420x collected ($2.50)
Seat 9: vrnMike (button) folded before Flop (didn't bet)





PokerStars Hand #152884897884:  Hold'em No Limit ($0.50/$1.00 USD) - 2016/05/05 16:03:05 CET [2016/05/05 10:03:05 ET]
Table 'Calypso II' 9-max Seat #2 is the button
Seat 1: nickreason17 ($104.30 in chips) 
Seat 2: torkkdnm ($139 in chips) 
Seat 3: gabi_igna ($105.09 in chips) 
Seat 4: mycka86 ($100 in chips) 
Seat 5: LighTingSSSS ($90.63 in chips) 
Seat 8: matiko09 ($107.80 in chips) 
Seat 9: maxxmeister ($111.90 in chips) 
gabi_igna: posts small blind $0.50
mycka86: posts big blind $1
sanpidk: sits out 
*** HOLE CARDS ***
Dealt to matiko09 [9s 5s]
LighTingSSSS: raises $1 to $2
matiko09: folds 
maxxmeister: folds 
nickreason17: folds 
torkkdnm: folds 
gabi_igna: folds 
mycka86: raises $6 to $8
LighTingSSSS: calls $6
*** FLOP *** [5d 2h 6d]
mycka86: checks 
LighTingSSSS: bets $10
WTAPSVG is disconnected 
mycka86: raises $17 to $27
LighTingSSSS: raises $55.63 to $82.63 and is all-in
mycka86: calls $55.63
*** FIRST TURN *** [5d 2h 6d] [7h]
*** FIRST RIVER *** [5d 2h 6d 7h] [9d]
*** SECOND TURN *** [5d 2h 6d] [2d]
*** SECOND RIVER *** [5d 2h 6d 2d] [Jc]
*** FIRST SHOW DOWN ***
mycka86: shows [Jh Jd] (a pair of Jacks)
LighTingSSSS: shows [4c 4h] (a pair of Fours)
mycka86 collected $89.63 from pot
*** SECOND SHOW DOWN ***
mycka86: shows [Jh Jd] (a full house, Jacks full of Deuces)
LighTingSSSS: shows [4c 4h] (two pair, Fours and Deuces)
mycka86 collected $89.63 from pot
*** SUMMARY ***
Total pot $181.76 | Rake $2.50 
Hand was run twice
FIRST Board [5d 2h 6d 7h 9d]
SECOND Board [5d 2h 6d 2d Jc]
Seat 1: nickreason17 folded before Flop (didn't bet)
Seat 2: torkkdnm (button) folded before Flop (didn't bet)
Seat 3: gabi_igna (small blind) folded before Flop
Seat 4: mycka86 (big blind) showed [Jh Jd] and won ($89.63) with a pair of Jacks, and won ($89.63) with a full house, Jacks full of Deuces
Seat 5: LighTingSSSS showed [4c 4h] and lost with a pair of Fours, and lost with two pair, Fours and Deuces
Seat 8: matiko09 folded before Flop (didn't bet)
Seat 9: maxxmeister folded before Flop (didn't bet)





PokerStars Hand #152884903574:  Hold'em No Limit ($0.50/$1.00 USD) - 2016/05/05 16:03:14 CET [2016/05/05 10:03:14 ET]
Table 'Pyxis III' 9-max Seat #9 is the button
Seat 1: sanpidk ($294.21 in chips) 
Seat 2: SPmaka ($108.02 in chips) 
Seat 3: vrnMike ($100 in chips) 
Seat 4: Sloeve ($124.49 in chips) 
Seat 5: darren1031 ($91.93 in chips) 
Seat 6: kamillo91 ($84.35 in chips) 
Seat 7: mycka86 ($103.88 in chips) 
Seat 8: matiko09 ($100.37 in chips) 
Seat 9: Hypoaroused ($170.88 in chips) 
sanpidk: posts small blind $0.50
SPmaka: posts big blind $1
*** HOLE CARDS ***
Dealt to matiko09 [As 7c]
vrnMike: folds 
Sloeve: folds 
darren1031: folds 
kamillo91: folds 
mycka86: folds 
matiko09: folds 
Hypoaroused: folds 
sanpidk: folds 
Uncalled bet ($0.50) returned to SPmaka
SPmaka collected $1 from pot
SPmaka: doesn't show hand 
*** SUMMARY ***
Total pot $1 | Rake $0 
Seat 1: sanpidk (small blind) folded before Flop
Seat 2: SPmaka (big blind) collected ($1)
Seat 3: vrnMike folded before Flop (didn't bet)
Seat 4: Sloeve folded before Flop (didn't bet)
Seat 5: darren1031 folded before Flop (didn't bet)
Seat 6: kamillo91 folded before Flop (didn't bet)
Seat 7: mycka86 folded before Flop (didn't bet)
Seat 8: matiko09 folded before Flop (didn't bet)
Seat 9: Hypoaroused (button) folded before Flop (didn't bet)





PokerStars Hand #152884905769:  Hold'em No Limit ($1/$2 USD) - 2016/05/05 16:03:18 CET [2016/05/05 10:03:18 ET]
Table 'Samitchell' 9-max Seat #7 is the button
Seat 1: KovIFish89 ($200 in chips) 
Seat 2: matiko09 ($223.04 in chips) 
Seat 3: gabi_igna ($317.87 in chips) 
Seat 4: Fitzyferret ($349.68 in chips) 
Seat 7: patpaty ($149.84 in chips) 
Seat 8: WolleMalone ($201 in chips) 
Seat 9: kblkxls ($137.07 in chips) 
WolleMalone: posts small blind $1
kblkxls: posts big blind $2
chaps1988: sits out 
*** HOLE CARDS ***
Dealt to matiko09 [Kd 9h]
KovIFish89: folds 
matiko09: folds 
gabi_igna: folds 
Fitzyferret: folds 
patpaty: calls $2
WolleMalone: folds 
kblkxls: checks 
*** FLOP *** [7c 3c 8c]
kblkxls: bets $2
patpaty: raises $2 to $4
kblkxls: calls $2
*** TURN *** [7c 3c 8c] [3h]
kblkxls: checks 
patpaty: bets $6
kblkxls: calls $6
*** RIVER *** [7c 3c 8c 3h] [Jc]
kblkxls: checks 
patpaty: bets $10
kblkxls: folds 
Uncalled bet ($10) returned to patpaty
patpaty collected $23.75 from pot
patpaty: doesn't show hand 
*** SUMMARY ***
Total pot $25 | Rake $1.25 
Board [7c 3c 8c 3h Jc]
Seat 1: KovIFish89 folded before Flop (didn't bet)
Seat 2: matiko09 folded before Flop (didn't bet)
Seat 3: gabi_igna folded before Flop (didn't bet)
Seat 4: Fitzyferret folded before Flop (didn't bet)
Seat 7: patpaty (button) collected ($23.75)
Seat 8: WolleMalone (small blind) folded before Flop
Seat 9: kblkxls (big blind) folded on the River





PokerStars Hand #152884914777:  Hold'em No Limit ($0.50/$1.00 USD) - 2016/05/05 16:03:33 CET [2016/05/05 10:03:33 ET]
Table 'Priska II' 9-max Seat #5 is the button
Seat 2: Kukuryzka ($127.02 in chips) 
Seat 3: matiko09 ($100 in chips) 
Seat 4: Painkiller72 ($166.40 in chips) 
Seat 5: nickreason17 ($171.55 in chips) 
Seat 6: St.LaCoste ($106.52 in chips) 
Seat 7: stockbridge8 ($89.27 in chips) 
Seat 8: pohorc21 ($136.09 in chips) 
Seat 9: torkkdnm ($100 in chips) 
St.LaCoste: posts small blind $0.50
stockbridge8: posts big blind $1
sanpidk: sits out 
*** HOLE CARDS ***
Dealt to matiko09 [8s Jd]
pohorc21: raises $2.50 to $3.50
torkkdnm: folds 
Kukuryzka: folds 
matiko09: folds 
Painkiller72: folds 
nickreason17: folds 
St.LaCoste: folds 
stockbridge8: folds 
Uncalled bet ($2.50) returned to pohorc21
pohorc21 collected $2.50 from pot
pohorc21: doesn't show hand 
*** SUMMARY ***
Total pot $2.50 | Rake $0 
Seat 2: Kukuryzka folded before Flop (didn't bet)
Seat 3: matiko09 folded before Flop (didn't bet)
Seat 4: Painkiller72 folded before Flop (didn't bet)
Seat 5: nickreason17 (button) folded before Flop (didn't bet)
Seat 6: St.LaCoste (small blind) folded before Flop
Seat 7: stockbridge8 (big blind) folded before Flop
Seat 8: pohorc21 collected ($2.50)
Seat 9: torkkdnm folded before Flop (didn't bet)





PokerStars Hand #152884918402:  Hold'em No Limit ($0.50/$1.00 USD) - 2016/05/05 16:03:40 CET [2016/05/05 10:03:40 ET]
Table 'Luthera' 9-max Seat #1 is the button
Seat 1: MrMattkk ($93.49 in chips) 
Seat 4: matiko09 ($110.48 in chips) 
Seat 5: Painkiller72 ($100 in chips) 
Seat 6: Dantist1122 ($101 in chips) 
Seat 7: Chin41178 ($104.96 in chips) 
Seat 8: xdrKush420x ($97 in chips) 
Seat 9: vrnMike ($102.68 in chips) 
Kukuryzka will be allowed to play after the button
sanpidk will be allowed to play after the button
matiko09: posts small blind $0.50
Painkiller72: posts big blind $1
*** HOLE CARDS ***
Dealt to matiko09 [6h Qd]
Dantist1122: folds 
Chin41178: folds 
xdrKush420x: folds 
vrnMike: folds 
MrMattkk: raises $2 to $3
matiko09: folds 
Painkiller72: folds 
Uncalled bet ($2) returned to MrMattkk
MrMattkk collected $2.50 from pot
MrMattkk: doesn't show hand 
*** SUMMARY ***
Total pot $2.50 | Rake $0 
Seat 1: MrMattkk (button) collected ($2.50)
Seat 4: matiko09 (small blind) folded before Flop
Seat 5: Painkiller72 (big blind) folded before Flop
Seat 6: Dantist1122 folded before Flop (didn't bet)
Seat 7: Chin41178 folded before Flop (didn't bet)
Seat 8: xdrKush420x folded before Flop (didn't bet)
Seat 9: vrnMike folded before Flop (didn't bet)





PokerStars Hand #152884919489:  Hold'em No Limit ($0.50/$1.00 USD) - 2016/05/05 16:03:42 CET [2016/05/05 10:03:42 ET]
Table 'Musa II' 9-max Seat #6 is the button
Seat 1: KovIFish89 ($193.47 in chips) 
Seat 2: koutani7 ($95.50 in chips) 
Seat 3: vrnMike ($107.38 in chips) 
Seat 4: sanpidk ($100 in chips) 
Seat 5: Chin41178 ($87.91 in chips) 
Seat 6: cnn123 ($67.14 in chips) 
Seat 8: matiko09 ($106.12 in chips) 
Seat 9: FroggyPlay ($100 in chips) 
matiko09: posts small blind $0.50
FroggyPlay: posts big blind $1
*** HOLE CARDS ***
Dealt to matiko09 [As Qc]
KovIFish89: folds 
koutani7: folds 
vrnMike: folds 
sanpidk: folds 
Chin41178: folds 
cnn123: folds 
matiko09: raises $1.50 to $2.50
FroggyPlay: folds 
Uncalled bet ($1.50) returned to matiko09
matiko09 collected $2 from pot
matiko09: doesn't show hand 
*** SUMMARY ***
Total pot $2 | Rake $0 
Seat 1: KovIFish89 folded before Flop (didn't bet)
Seat 2: koutani7 folded before Flop (didn't bet)
Seat 3: vrnMike folded before Flop (didn't bet)
Seat 4: sanpidk folded before Flop (didn't bet)
Seat 5: Chin41178 folded before Flop (didn't bet)
Seat 6: cnn123 (button) folded before Flop (didn't bet)
Seat 8: matiko09 (small blind) collected ($2)
Seat 9: FroggyPlay (big blind) folded before Flop





PokerStars Hand #152884919572:  Hold'em No Limit ($1/$2 USD) - 2016/05/05 16:03:42 CET [2016/05/05 10:03:42 ET]
Table 'Tololo' 9-max Seat #8 is the button
Seat 4: mooose100 ($129.60 in chips) 
Seat 5: matiko09 ($245.49 in chips) 
Seat 6: Xagua ($249.92 in chips) 
Seat 8: KovIFish89 ($200 in chips) 
Seat 9: Fitzyferret ($332.31 in chips) 
Fitzyferret: posts small blind $1
gabi_igna: is sitting out 
mooose100: posts big blind $2
chaps1988: sits out 
*** HOLE CARDS ***
Dealt to matiko09 [Js 4h]
matiko09: folds 
Xagua: raises $3 to $5
KovIFish89: folds 
Fitzyferret: folds 
mooose100: calls $3
*** FLOP *** [Th 8h Ts]
mooose100: checks 
Xagua: checks 
*** TURN *** [Th 8h Ts] [Ks]
mooose100: checks 
Xagua: bets $6
mooose100: calls $6
*** RIVER *** [Th 8h Ts Ks] [5s]
mooose100: checks 
Xagua: bets $10
mooose100: folds 
Uncalled bet ($10) returned to Xagua
Xagua collected $21.85 from pot
Xagua: doesn't show hand 
*** SUMMARY ***
Total pot $23 | Rake $1.15 
Board [Th 8h Ts Ks 5s]
Seat 4: mooose100 (big blind) folded on the River
Seat 5: matiko09 folded before Flop (didn't bet)
Seat 6: Xagua collected ($21.85)
Seat 8: KovIFish89 (button) folded before Flop (didn't bet)
Seat 9: Fitzyferret (small blind) folded before Flop





PokerStars Hand #152884922716:  Hold'em No Limit ($0.50/$1.00 USD) - 2016/05/05 16:03:47 CET [2016/05/05 10:03:47 ET]
Table 'Pyxis III' 9-max Seat #1 is the button
Seat 1: sanpidk ($293.71 in chips) 
Seat 2: SPmaka ($108.52 in chips) 
Seat 3: vrnMike ($100 in chips) 
Seat 4: Sloeve ($124.49 in chips) 
Seat 5: darren1031 ($91.93 in chips) 
Seat 6: kamillo91 ($84.35 in chips) 
Seat 7: mycka86 ($103.88 in chips) 
Seat 8: matiko09 ($100.37 in chips) 
Seat 9: Hypoaroused ($170.88 in chips) 
SPmaka: posts small blind $0.50
vrnMike: posts big blind $1
*** HOLE CARDS ***
Dealt to matiko09 [3c 7s]
Sloeve: folds 
darren1031: calls $1
kamillo91: folds 
mycka86: folds 
matiko09: folds 
Hypoaroused: folds 
sanpidk: raises $3.50 to $4.50
SPmaka: folds 
vrnMike: folds 
darren1031: calls $3.50
*** FLOP *** [2h 9d 5h]
darren1031: checks 
sanpidk: bets $5.50
darren1031: folds 
Uncalled bet ($5.50) returned to sanpidk
sanpidk collected $9.98 from pot
sanpidk: doesn't show hand 
*** SUMMARY ***
Total pot $10.50 | Rake $0.52 
Board [2h 9d 5h]
Seat 1: sanpidk (button) collected ($9.98)
Seat 2: SPmaka (small blind) folded before Flop
Seat 3: vrnMike (big blind) folded before Flop
Seat 4: Sloeve folded before Flop (didn't bet)
Seat 5: darren1031 folded on the Flop
Seat 6: kamillo91 folded before Flop (didn't bet)
Seat 7: mycka86 folded before Flop (didn't bet)
Seat 8: matiko09 folded before Flop (didn't bet)
Seat 9: Hypoaroused folded before Flop (didn't bet)





PokerStars Hand #152884928108:  Hold'em No Limit ($0.50/$1.00 USD) - 2016/05/05 16:03:56 CET [2016/05/05 10:03:56 ET]
Table 'Musa II' 9-max Seat #8 is the button
Seat 1: KovIFish89 ($193.47 in chips) 
Seat 2: koutani7 ($95.50 in chips) 
Seat 3: vrnMike ($107.38 in chips) 
Seat 4: sanpidk ($100 in chips) 
Seat 5: Chin41178 ($87.91 in chips) 
Seat 6: cnn123 ($67.14 in chips) 
Seat 8: matiko09 ($107.12 in chips) 
Seat 9: FroggyPlay ($100 in chips) 
FroggyPlay: posts small blind $0.50
KovIFish89: posts big blind $1
*** HOLE CARDS ***
Dealt to matiko09 [Ac 7c]
koutani7: folds 
vrnMike: folds 
sanpidk: raises $2 to $3
Chin41178: folds 
cnn123: folds 
matiko09: folds 
FroggyPlay: folds 
KovIFish89: folds 
Uncalled bet ($2) returned to sanpidk
sanpidk collected $2.50 from pot
sanpidk: doesn't show hand 
*** SUMMARY ***
Total pot $2.50 | Rake $0 
Seat 1: KovIFish89 (big blind) folded before Flop
Seat 2: koutani7 folded before Flop (didn't bet)
Seat 3: vrnMike folded before Flop (didn't bet)
Seat 4: sanpidk collected ($2.50)
Seat 5: Chin41178 folded before Flop (didn't bet)
Seat 6: cnn123 folded before Flop (didn't bet)
Seat 8: matiko09 (button) folded before Flop (didn't bet)
Seat 9: FroggyPlay (small blind) folded before Flop





PokerStars Hand #152884929854:  Hold'em No Limit ($1/$2 USD) - 2016/05/05 16:03:59 CET [2016/05/05 10:03:59 ET]
Table 'Tatry II' 9-max Seat #8 is the button
Seat 1: glanza_mike ($251.17 in chips) 
Seat 3: matiko09 ($200 in chips) 
Seat 4: WolleMalone ($203 in chips) 
Seat 5: Painkiller72 ($206.25 in chips) 
Seat 6: Kukuryzka ($200 in chips) 
Seat 7: nickreason17 ($200 in chips) 
Seat 8: chaps1988 ($200 in chips) 
Seat 9: korol702 ($136.38 in chips) 
korol702: posts small blind $1
glanza_mike: posts big blind $2
T0ny Adams: sits out 
*** HOLE CARDS ***
Dealt to matiko09 [8h Kc]
matiko09: folds 
WolleMalone: folds 
Painkiller72: folds 
Kukuryzka: folds 
nickreason17: folds 
chaps1988: folds 
korol702: calls $1
glanza_mike: checks 
*** FLOP *** [6h Jc 2c]
korol702: checks 
glanza_mike: checks 
*** TURN *** [6h Jc 2c] [Ac]
korol702: checks 
glanza_mike: checks 
*** RIVER *** [6h Jc 2c Ac] [8c]
korol702: bets $2
glanza_mike: folds 
Uncalled bet ($2) returned to korol702
korol702 collected $3.80 from pot
korol702: doesn't show hand 
*** SUMMARY ***
Total pot $4 | Rake $0.20 
Board [6h Jc 2c Ac 8c]
Seat 1: glanza_mike (big blind) folded on the River
Seat 3: matiko09 folded before Flop (didn't bet)
Seat 4: WolleMalone folded before Flop (didn't bet)
Seat 5: Painkiller72 folded before Flop (didn't bet)
Seat 6: Kukuryzka folded before Flop (didn't bet)
Seat 7: nickreason17 folded before Flop (didn't bet)
Seat 8: chaps1988 (button) folded before Flop (didn't bet)
Seat 9: korol702 (small blind) collected ($3.80)





PokerStars Hand #152884932049:  Hold'em No Limit ($0.50/$1.00 USD) - 2016/05/05 16:04:03 CET [2016/05/05 10:04:03 ET]
Table 'Priska II' 9-max Seat #6 is the button
Seat 2: Kukuryzka ($127.02 in chips) 
Seat 3: matiko09 ($100 in chips) 
Seat 4: Painkiller72 ($166.40 in chips) 
Seat 5: nickreason17 ($171.55 in chips) 
Seat 6: St.LaCoste ($106.02 in chips) 
Seat 7: stockbridge8 ($88.27 in chips) 
Seat 8: pohorc21 ($137.59 in chips) 
Seat 9: torkkdnm ($100 in chips) 
stockbridge8: posts small blind $0.50
pohorc21: posts big blind $1
sanpidk: sits out 
*** HOLE CARDS ***
Dealt to matiko09 [Jc 2s]
torkkdnm: raises $2 to $3
Kukuryzka: folds 
matiko09: folds 
Painkiller72: folds 
nickreason17: folds 
St.LaCoste: folds 
stockbridge8: folds 
pohorc21: calls $2
*** FLOP *** [Td 9d 8h]
pohorc21: bets $6
torkkdnm: folds 
Uncalled bet ($6) returned to pohorc21
pohorc21 collected $6.18 from pot
pohorc21: doesn't show hand 
*** SUMMARY ***
Total pot $6.50 | Rake $0.32 
Board [Td 9d 8h]
Seat 2: Kukuryzka folded before Flop (didn't bet)
Seat 3: matiko09 folded before Flop (didn't bet)
Seat 4: Painkiller72 folded before Flop (didn't bet)
Seat 5: nickreason17 folded before Flop (didn't bet)
Seat 6: St.LaCoste (button) folded before Flop (didn't bet)
Seat 7: stockbridge8 (small blind) folded before Flop
Seat 8: pohorc21 (big blind) collected ($6.18)
Seat 9: torkkdnm folded on the Flop





PokerStars Hand #152884935956:  Hold'em No Limit ($0.50/$1.00 USD) - 2016/05/05 16:04:10 CET [2016/05/05 10:04:10 ET]
Table 'Luthera' 9-max Seat #4 is the button
Seat 1: MrMattkk ($94.99 in chips) 
Seat 4: matiko09 ($109.98 in chips) 
Seat 5: Painkiller72 ($100 in chips) 
Seat 6: Dantist1122 ($101 in chips) 
Seat 7: Chin41178 ($104.96 in chips) 
Seat 8: xdrKush420x ($97 in chips) 
Seat 9: vrnMike ($102.68 in chips) 
Painkiller72: posts small blind $0.50
Dantist1122: posts big blind $1
Kukuryzka: sits out 
sanpidk: sits out 
*** HOLE CARDS ***
Dealt to matiko09 [Jd 3d]
Chin41178: folds 
xdrKush420x: folds 
vrnMike: folds 
MrMattkk: raises $2 to $3
matiko09: folds 
Painkiller72: folds 
Dantist1122: folds 
Uncalled bet ($2) returned to MrMattkk
MrMattkk collected $2.50 from pot
MrMattkk: doesn't show hand 
*** SUMMARY ***
Total pot $2.50 | Rake $0 
Seat 1: MrMattkk collected ($2.50)
Seat 4: matiko09 (button) folded before Flop (didn't bet)
Seat 5: Painkiller72 (small blind) folded before Flop
Seat 6: Dantist1122 (big blind) folded before Flop
Seat 7: Chin41178 folded before Flop (didn't bet)
Seat 8: xdrKush420x folded before Flop (didn't bet)
Seat 9: vrnMike folded before Flop (didn't bet)





PokerStars Hand #152884944124:  Hold'em No Limit ($1/$2 USD) - 2016/05/05 16:04:24 CET [2016/05/05 10:04:24 ET]
Table 'Samitchell' 9-max Seat #8 is the button
Seat 1: KovIFish89 ($200 in chips) 
Seat 2: matiko09 ($223.04 in chips) 
Seat 3: gabi_igna ($317.87 in chips) 
Seat 4: Fitzyferret ($349.68 in chips) 
Seat 7: patpaty ($161.59 in chips) 
Seat 8: WolleMalone ($200 in chips) 
Seat 9: kblkxls ($125.07 in chips) 
kblkxls: posts small blind $1
KovIFish89: posts big blind $2
chaps1988: sits out 
*** HOLE CARDS ***
Dealt to matiko09 [7d Jh]
matiko09: folds 
gabi_igna: folds 
Fitzyferret: raises $2.60 to $4.60
patpaty: folds 
WolleMalone: calls $4.60
kblkxls: folds 
KovIFish89: folds 
*** FLOP *** [8d Kd 5d]
Fitzyferret: checks 
WolleMalone: bets $6
Fitzyferret: folds 
Uncalled bet ($6) returned to WolleMalone
WolleMalone collected $11.59 from pot
WolleMalone: doesn't show hand 
*** SUMMARY ***
Total pot $12.20 | Rake $0.61 
Board [8d Kd 5d]
Seat 1: KovIFish89 (big blind) folded before Flop
Seat 2: matiko09 folded before Flop (didn't bet)
Seat 3: gabi_igna folded before Flop (didn't bet)
Seat 4: Fitzyferret folded on the Flop
Seat 7: patpaty folded before Flop (didn't bet)
Seat 8: WolleMalone (button) collected ($11.59)
Seat 9: kblkxls (small blind) folded before Flop





PokerStars Hand #152884945730:  Hold'em No Limit ($1/$2 USD) - 2016/05/05 16:04:26 CET [2016/05/05 10:04:26 ET]
Table 'Lundia' 9-max Seat #4 is the button
Seat 1: Fitzyferret ($236.60 in chips) 
Seat 2: patpaty ($222.47 in chips) 
Seat 3: Painkiller72 ($200 in chips) 
Seat 4: KovIFish89 ($308.56 in chips) 
Seat 5: zmOe84 ($192.76 in chips) 
Seat 7: matiko09 ($248.11 in chips) 
Seat 8: Durnichka ($80 in chips) 
Seat 9: gabi_igna ($236.26 in chips) 
zmOe84: posts small blind $1
Spid1: is sitting out 
matiko09: posts big blind $2
*** HOLE CARDS ***
Dealt to matiko09 [8d 7d]
Spid1 leaves the table
Kukuryzka joins the table at seat #6 
Kukuryzka leaves the table
Durnichka: folds 
gabi_igna: raises $4 to $6
Fitzyferret: folds 
patpaty: calls $6
Painkiller72: folds 
KovIFish89: folds 
CI58 joins the table at seat #6 
zmOe84: folds 
matiko09: calls $4
*** FLOP *** [2c Th 3s]
matiko09: checks 
gabi_igna: bets $10
patpaty: folds 
matiko09: folds 
Uncalled bet ($10) returned to gabi_igna
gabi_igna collected $18.05 from pot
gabi_igna: doesn't show hand 
*** SUMMARY ***
Total pot $19 | Rake $0.95 
Board [2c Th 3s]
Seat 1: Fitzyferret folded before Flop (didn't bet)
Seat 2: patpaty folded on the Flop
Seat 3: Painkiller72 folded before Flop (didn't bet)
Seat 4: KovIFish89 (button) folded before Flop (didn't bet)
Seat 5: zmOe84 (small blind) folded before Flop
Seat 7: matiko09 (big blind) folded on the Flop
Seat 8: Durnichka folded before Flop (didn't bet)
Seat 9: gabi_igna collected ($18.05)





PokerStars Hand #152884945647:  Hold'em No Limit ($1/$2 USD) - 2016/05/05 16:04:26 CET [2016/05/05 10:04:26 ET]
Table 'Euporie II' 9-max Seat #1 is the button
Seat 1: gabi_igna ($200 in chips) 
Seat 2: nickreason17 ($200 in chips) 
Seat 3: chaps1988 ($200 in chips) 
Seat 4: Kukuryzka ($199 in chips) 
Seat 5: Nuskatko1986 ($64.16 in chips) 
Seat 6: glanza_mike ($204 in chips) 
Seat 7: matiko09 ($205.04 in chips) 
Seat 8: Painkiller72 ($311.25 in chips) 
Seat 9: T0ny Adams ($82.91 in chips) 
nickreason17: posts small blind $1
chaps1988: posts big blind $2
*** HOLE CARDS ***
Dealt to matiko09 [Jc Th]
Kukuryzka: folds 
Nuskatko1986: calls $2
glanza_mike: folds 
matiko09: folds 
Painkiller72: folds 
T0ny Adams: raises $7 to $9
gabi_igna: folds 
nickreason17: folds 
chaps1988: folds 
Nuskatko1986: folds 
Uncalled bet ($7) returned to T0ny Adams
T0ny Adams collected $7 from pot
T0ny Adams: doesn't show hand 
*** SUMMARY ***
Total pot $7 | Rake $0 
Seat 1: gabi_igna (button) folded before Flop (didn't bet)
Seat 2: nickreason17 (small blind) folded before Flop
Seat 3: chaps1988 (big blind) folded before Flop
Seat 4: Kukuryzka folded before Flop (didn't bet)
Seat 5: Nuskatko1986 folded before Flop
Seat 6: glanza_mike folded before Flop (didn't bet)
Seat 7: matiko09 folded before Flop (didn't bet)
Seat 8: Painkiller72 folded before Flop (didn't bet)
Seat 9: T0ny Adams collected ($7)





PokerStars Hand #152884946636:  Hold'em No Limit ($0.50/$1.00 USD) - 2016/05/05 16:04:28 CET [2016/05/05 10:04:28 ET]
Table 'Musa II' 9-max Seat #9 is the button
Seat 1: KovIFish89 ($192.47 in chips) 
Seat 2: koutani7 ($95.50 in chips) 
Seat 3: vrnMike ($107.38 in chips) 
Seat 4: sanpidk ($101.50 in chips) 
Seat 5: Chin41178 ($87.91 in chips) 
Seat 6: cnn123 ($67.14 in chips) 
Seat 8: matiko09 ($107.12 in chips) 
Seat 9: FroggyPlay ($100 in chips) 
KovIFish89: posts small blind $0.50
koutani7: posts big blind $1
*** HOLE CARDS ***
Dealt to matiko09 [8s Tc]
vrnMike: folds 
plaindaft1 joins the table at seat #7 
sanpidk: folds 
Chin41178: folds 
cnn123: raises $2 to $3
matiko09: folds 
FroggyPlay: folds 
KovIFish89: folds 
koutani7: raises $6 to $9
cnn123: calls $6
*** FLOP *** [4h Ts 9h]
koutani7: bets $12
cnn123: calls $12
*** TURN *** [4h Ts 9h] [7s]
koutani7: checks 
cnn123: bets $22
koutani7: folds 
Uncalled bet ($22) returned to cnn123
cnn123 collected $40.38 from pot
cnn123: doesn't show hand 
*** SUMMARY ***
Total pot $42.50 | Rake $2.12 
Board [4h Ts 9h 7s]
Seat 1: KovIFish89 (small blind) folded before Flop
Seat 2: koutani7 (big blind) folded on the Turn
Seat 3: vrnMike folded before Flop (didn't bet)
Seat 4: sanpidk folded before Flop (didn't bet)
Seat 5: Chin41178 folded before Flop (didn't bet)
Seat 6: cnn123 collected ($40.38)
Seat 8: matiko09 folded before Flop (didn't bet)
Seat 9: FroggyPlay (button) folded before Flop (didn't bet)





PokerStars Hand #152884946986:  Hold'em No Limit ($0.50/$1.00 USD) - 2016/05/05 16:04:28 CET [2016/05/05 10:04:28 ET]
Table 'Luthera' 9-max Seat #5 is the button
Seat 1: MrMattkk ($96.49 in chips) 
Seat 4: matiko09 ($109.98 in chips) 
Seat 5: Painkiller72 ($100 in chips) 
Seat 6: Dantist1122 ($100 in chips) 
Seat 7: Chin41178 ($104.96 in chips) 
Seat 8: xdrKush420x ($97 in chips) 
Seat 9: vrnMike ($102.68 in chips) 
Dantist1122: posts small blind $0.50
Chin41178: posts big blind $1
Kukuryzka: sits out 
sanpidk: sits out 
*** HOLE CARDS ***
Dealt to matiko09 [7d 8d]
xdrKush420x: folds 
vrnMike: folds 
MrMattkk: folds 
matiko09: raises $1.50 to $2.50
Painkiller72: folds 
Dantist1122: folds 
Chin41178: folds 
Uncalled bet ($1.50) returned to matiko09
matiko09 collected $2.50 from pot
matiko09: doesn't show hand 
*** SUMMARY ***
Total pot $2.50 | Rake $0 
Seat 1: MrMattkk folded before Flop (didn't bet)
Seat 4: matiko09 collected ($2.50)
Seat 5: Painkiller72 (button) folded before Flop (didn't bet)
Seat 6: Dantist1122 (small blind) folded before Flop
Seat 7: Chin41178 (big blind) folded before Flop
Seat 8: xdrKush420x folded before Flop (didn't bet)
Seat 9: vrnMike folded before Flop (didn't bet)





PokerStars Hand #152884955136:  Hold'em No Limit ($0.50/$1.00 USD) - 2016/05/05 16:04:42 CET [2016/05/05 10:04:42 ET]
Table 'Luthera' 9-max Seat #6 is the button
Seat 1: MrMattkk ($96.49 in chips) 
Seat 4: matiko09 ($111.48 in chips) 
Seat 5: Painkiller72 ($100 in chips) 
Seat 6: Dantist1122 ($100 in chips) 
Seat 7: Chin41178 ($103.96 in chips) 
Seat 8: xdrKush420x ($97 in chips) 
Seat 9: vrnMike ($102.68 in chips) 
Chin41178: posts small blind $0.50
xdrKush420x: posts big blind $1
Kukuryzka: sits out 
sanpidk: sits out 
*** HOLE CARDS ***
Dealt to matiko09 [6c 9c]
vrnMike: raises $1 to $2
MrMattkk: folds 
matiko09: folds 
Painkiller72: folds 
Dantist1122: folds 
Chin41178: folds 
xdrKush420x: calls $1
*** FLOP *** [8s Tc Qs]
xdrKush420x: bets $1.54
vrnMike: calls $1.54
*** TURN *** [8s Tc Qs] [Jh]
xdrKush420x: checks 
vrnMike: bets $14.50
xdrKush420x: folds 
Uncalled bet ($14.50) returned to vrnMike
vrnMike collected $7.20 from pot
*** SUMMARY ***
Total pot $7.58 | Rake $0.38 
Board [8s Tc Qs Jh]
Seat 1: MrMattkk folded before Flop (didn't bet)
Seat 4: matiko09 folded before Flop (didn't bet)
Seat 5: Painkiller72 folded before Flop (didn't bet)
Seat 6: Dantist1122 (button) folded before Flop (didn't bet)
Seat 7: Chin41178 (small blind) folded before Flop
Seat 8: xdrKush420x (big blind) folded on the Turn
Seat 9: vrnMike collected ($7.20)





PokerStars Hand #152884958041:  Hold'em No Limit ($0.50/$1.00 USD) - 2016/05/05 16:04:47 CET [2016/05/05 10:04:47 ET]
Table 'Priska II' 9-max Seat #7 is the button
Seat 2: Kukuryzka ($127.02 in chips) 
Seat 3: matiko09 ($100 in chips) 
Seat 4: Painkiller72 ($166.40 in chips) 
Seat 5: nickreason17 ($171.55 in chips) 
Seat 6: St.LaCoste ($106.02 in chips) 
Seat 7: stockbridge8 ($87.77 in chips) 
Seat 8: pohorc21 ($140.77 in chips) 
Seat 9: torkkdnm ($100 in chips) 
pohorc21: posts small blind $0.50
torkkdnm: posts big blind $1
sanpidk: sits out 
*** HOLE CARDS ***
Dealt to matiko09 [5h 8d]
Kukuryzka: raises $2 to $3
matiko09: folds 
Painkiller72: folds 
nickreason17: folds 
St.LaCoste: folds 
stockbridge8: folds 
pohorc21: folds 
torkkdnm: folds 
Uncalled bet ($2) returned to Kukuryzka
pohorc21 leaves the table
Kukuryzka collected $2.50 from pot
Kukuryzka: doesn't show hand 
*** SUMMARY ***
Total pot $2.50 | Rake $0 
Seat 2: Kukuryzka collected ($2.50)
Seat 3: matiko09 folded before Flop (didn't bet)
Seat 4: Painkiller72 folded before Flop (didn't bet)
Seat 5: nickreason17 folded before Flop (didn't bet)
Seat 6: St.LaCoste folded before Flop (didn't bet)
Seat 7: stockbridge8 (button) folded before Flop (didn't bet)
Seat 8: pohorc21 (small blind) folded before Flop
Seat 9: torkkdnm (big blind) folded before Flop





PokerStars Hand #152884959399:  Hold'em No Limit ($0.50/$1.00 USD) - 2016/05/05 16:04:49 CET [2016/05/05 10:04:49 ET]
Table 'Pyxis III' 9-max Seat #2 is the button
Seat 1: sanpidk ($299.19 in chips) 
Seat 2: SPmaka ($108.02 in chips) 
Seat 3: vrnMike ($100 in chips) 
Seat 4: Sloeve ($124.49 in chips) 
Seat 5: darren1031 ($87.43 in chips) 
Seat 6: kamillo91 ($84.35 in chips) 
Seat 7: mycka86 ($103.88 in chips) 
Seat 8: matiko09 ($100.37 in chips) 
Seat 9: Hypoaroused ($170.88 in chips) 
vrnMike: posts small blind $0.50
Sloeve: posts big blind $1
*** HOLE CARDS ***
Dealt to matiko09 [6h Td]
darren1031: folds 
kamillo91: raises $2 to $3
mycka86: folds 
matiko09: folds 
Hypoaroused: folds 
sanpidk: calls $3
SPmaka: folds 
vrnMike: folds 
Sloeve: folds 
*** FLOP *** [5d Kd 9h]
kamillo91: bets $3
sanpidk: calls $3
*** TURN *** [5d Kd 9h] [As]
kamillo91: checks 
sanpidk: bets $7
kamillo91: calls $7
*** RIVER *** [5d Kd 9h As] [Qh]
kamillo91: checks 
sanpidk: checks 
*** SHOW DOWN ***
kamillo91: shows [Qs Ac] (two pair, Aces and Queens)
sanpidk: mucks hand 
kamillo91 collected $26.12 from pot
*** SUMMARY ***
Total pot $27.50 | Rake $1.38 
Board [5d Kd 9h As Qh]
Seat 1: sanpidk mucked [Jh Kc]
Seat 2: SPmaka (button) folded before Flop (didn't bet)
Seat 3: vrnMike (small blind) folded before Flop
Seat 4: Sloeve (big blind) folded before Flop
Seat 5: darren1031 folded before Flop (didn't bet)
Seat 6: kamillo91 showed [Qs Ac] and won ($26.12) with two pair, Aces and Queens
Seat 7: mycka86 folded before Flop (didn't bet)
Seat 8: matiko09 folded before Flop (didn't bet)
Seat 9: Hypoaroused folded before Flop (didn't bet)





PokerStars Hand #152884963749:  Hold'em No Limit ($1/$2 USD) - 2016/05/05 16:04:57 CET [2016/05/05 10:04:57 ET]
Table 'Tololo' 9-max Seat #9 is the button
Seat 4: mooose100 ($118.60 in chips) 
Seat 5: matiko09 ($245.49 in chips) 
Seat 6: Xagua ($260.77 in chips) 
Seat 8: KovIFish89 ($200 in chips) 
Seat 9: Fitzyferret ($331.31 in chips) 
gabi_igna will be allowed to play after the button
mooose100: posts small blind $1
matiko09: posts big blind $2
chaps1988: sits out 
*** HOLE CARDS ***
Dealt to matiko09 [5c Kc]
Xagua: folds 
KovIFish89: folds 
Fitzyferret: folds 
mooose100: calls $1
matiko09: raises $6 to $8
mooose100: calls $6
*** FLOP *** [Th 4c 9c]
mooose100: checks 
matiko09: bets $9.88
mooose100: calls $9.88
*** TURN *** [Th 4c 9c] [Qd]
mooose100: checks 
matiko09: bets $24
Kukuryzka joins the table at seat #1 
mooose100: calls $24
*** RIVER *** [Th 4c 9c Qd] [7h]
mooose100: checks 
matiko09: checks 
*** SHOW DOWN ***
mooose100: shows [Kh Tc] (a pair of Tens)
matiko09: mucks hand 
mooose100 collected $81.01 from pot
*** SUMMARY ***
Total pot $83.76 | Rake $2.75 
Board [Th 4c 9c Qd 7h]
Seat 4: mooose100 (small blind) showed [Kh Tc] and won ($81.01) with a pair of Tens
Seat 5: matiko09 (big blind) mucked [5c Kc]
Seat 6: Xagua folded before Flop (didn't bet)
Seat 8: KovIFish89 folded before Flop (didn't bet)
Seat 9: Fitzyferret (button) folded before Flop (didn't bet)





PokerStars Hand #152884968595:  Hold'em No Limit ($1/$2 USD) - 2016/05/05 16:05:05 CET [2016/05/05 10:05:05 ET]
Table 'Tatry II' 9-max Seat #9 is the button
Seat 1: glanza_mike ($249.17 in chips) 
Seat 2: T0ny Adams ($89.40 in chips) 
Seat 3: matiko09 ($200 in chips) 
Seat 4: WolleMalone ($203 in chips) 
Seat 5: Painkiller72 ($206.25 in chips) 
Seat 6: Kukuryzka ($200 in chips) 
Seat 7: nickreason17 ($200 in chips) 
Seat 8: chaps1988 ($200 in chips) 
Seat 9: korol702 ($138.18 in chips) 
glanza_mike: posts small blind $1
T0ny Adams: posts big blind $2
*** HOLE CARDS ***
Dealt to matiko09 [Ad Ac]
matiko09: raises $3 to $5
WolleMalone: folds 
Painkiller72: folds 
Kukuryzka: folds 
nickreason17: folds 
chaps1988: folds 
korol702: folds 
glanza_mike: folds 
T0ny Adams: folds 
Uncalled bet ($3) returned to matiko09
matiko09 collected $5 from pot
matiko09: doesn't show hand 
*** SUMMARY ***
Total pot $5 | Rake $0 
Seat 1: glanza_mike (small blind) folded before Flop
Seat 2: T0ny Adams (big blind) folded before Flop
Seat 3: matiko09 collected ($5)
Seat 4: WolleMalone folded before Flop (didn't bet)
Seat 5: Painkiller72 folded before Flop (didn't bet)
Seat 6: Kukuryzka folded before Flop (didn't bet)
Seat 7: nickreason17 folded before Flop (didn't bet)
Seat 8: chaps1988 folded before Flop (didn't bet)
Seat 9: korol702 (button) folded before Flop (didn't bet)





PokerStars Hand #152884973876:  Hold'em No Limit ($1/$2 USD) - 2016/05/05 16:05:14 CET [2016/05/05 10:05:14 ET]
Table 'Lundia' 9-max Seat #5 is the button
Seat 1: Fitzyferret ($236.60 in chips) 
Seat 2: patpaty ($216.47 in chips) 
Seat 3: Painkiller72 ($200 in chips) 
Seat 4: KovIFish89 ($308.56 in chips) 
Seat 5: zmOe84 ($191.76 in chips) 
Seat 7: matiko09 ($242.11 in chips) 
Seat 9: gabi_igna ($248.31 in chips) 
CI58 will be allowed to play after the button
matiko09: posts small blind $1
gabi_igna: posts big blind $2
*** HOLE CARDS ***
Dealt to matiko09 [As 4h]
Fitzyferret: folds 
patpaty: folds 
Painkiller72: folds 
KovIFish89: folds 
zmOe84: calls $2
matiko09: calls $1
gabi_igna: checks 
*** FLOP *** [Jc 5c Qc]
matiko09: checks 
gabi_igna: checks 
zmOe84: bets $4
matiko09: folds 
gabi_igna: raises $12 to $16
zmOe84: folds 
Uncalled bet ($12) returned to gabi_igna
gabi_igna collected $13.30 from pot
gabi_igna: doesn't show hand 
*** SUMMARY ***
Total pot $14 | Rake $0.70 
Board [Jc 5c Qc]
Seat 1: Fitzyferret folded before Flop (didn't bet)
Seat 2: patpaty folded before Flop (didn't bet)
Seat 3: Painkiller72 folded before Flop (didn't bet)
Seat 4: KovIFish89 folded before Flop (didn't bet)
Seat 5: zmOe84 (button) folded on the Flop
Seat 7: matiko09 (small blind) folded on the Flop
Seat 9: gabi_igna (big blind) collected ($13.30)





PokerStars Hand #152884976131:  Hold'em No Limit ($0.50/$1.00 USD) - 2016/05/05 16:05:18 CET [2016/05/05 10:05:18 ET]
Table 'Priska II' 9-max Seat #9 is the button
Seat 2: Kukuryzka ($128.52 in chips) 
Seat 3: matiko09 ($100 in chips) 
Seat 4: Painkiller72 ($166.40 in chips) 
Seat 5: nickreason17 ($171.55 in chips) 
Seat 6: St.LaCoste ($106.02 in chips) 
Seat 7: stockbridge8 ($87.77 in chips) 
Seat 9: torkkdnm ($100 in chips) 
sanpidk will be allowed to play after the button
Kukuryzka: posts small blind $0.50
matiko09: posts big blind $1
*** HOLE CARDS ***
Dealt to matiko09 [Ah Qh]
Painkiller72: folds 
nickreason17: folds 
St.LaCoste: folds 
stockbridge8: folds 
torkkdnm: raises $1 to $2
Kukuryzka: folds 
matiko09: raises $6 to $8
janarr5 joins the table at seat #8 
torkkdnm: folds 
Uncalled bet ($6) returned to matiko09
matiko09 collected $4.50 from pot
matiko09: doesn't show hand 
*** SUMMARY ***
Total pot $4.50 | Rake $0 
Seat 2: Kukuryzka (small blind) folded before Flop
Seat 3: matiko09 (big blind) collected ($4.50)
Seat 4: Painkiller72 folded before Flop (didn't bet)
Seat 5: nickreason17 folded before Flop (didn't bet)
Seat 6: St.LaCoste folded before Flop (didn't bet)
Seat 7: stockbridge8 folded before Flop (didn't bet)
Seat 9: torkkdnm (button) folded before Flop





PokerStars Hand #152884977281:  Hold'em No Limit ($1/$2 USD) - 2016/05/05 16:05:20 CET [2016/05/05 10:05:20 ET]
Table 'Samitchell' 9-max Seat #9 is the button
Seat 1: KovIFish89 ($200 in chips) 
Seat 2: matiko09 ($223.04 in chips) 
Seat 3: gabi_igna ($317.87 in chips) 
Seat 4: Fitzyferret ($345.08 in chips) 
Seat 7: patpaty ($161.59 in chips) 
Seat 8: WolleMalone ($206.99 in chips) 
Seat 9: kblkxls ($124.07 in chips) 
KovIFish89: posts small blind $1
matiko09: posts big blind $2
chaps1988: sits out 
*** HOLE CARDS ***
Dealt to matiko09 [4s Js]
gabi_igna: folds 
Fitzyferret: folds 
patpaty: folds 
WolleMalone: folds 
kblkxls: raises $2 to $4
KovIFish89: raises $11 to $15
matiko09: folds 
kblkxls: folds 
Uncalled bet ($11) returned to KovIFish89
KovIFish89 collected $10 from pot
KovIFish89: doesn't show hand 
*** SUMMARY ***
Total pot $10 | Rake $0 
Seat 1: KovIFish89 (small blind) collected ($10)
Seat 2: matiko09 (big blind) folded before Flop
Seat 3: gabi_igna folded before Flop (didn't bet)
Seat 4: Fitzyferret folded before Flop (didn't bet)
Seat 7: patpaty folded before Flop (didn't bet)
Seat 8: WolleMalone folded before Flop (didn't bet)
Seat 9: kblkxls (button) folded before Flop





PokerStars Hand #152884980912:  Hold'em No Limit ($0.50/$1.00 USD) - 2016/05/05 16:05:26 CET [2016/05/05 10:05:26 ET]
Table 'Musa II' 9-max Seat #1 is the button
Seat 1: KovIFish89 ($191.97 in chips) 
Seat 2: koutani7 ($74.50 in chips) 
Seat 3: vrnMike ($107.38 in chips) 
Seat 4: sanpidk ($101.50 in chips) 
Seat 5: Chin41178 ($87.91 in chips) 
Seat 6: cnn123 ($86.52 in chips) 
Seat 8: matiko09 ($107.12 in chips) 
Seat 9: FroggyPlay ($100 in chips) 
koutani7: posts small blind $0.50
vrnMike: posts big blind $1
plaindaft1: sits out 
*** HOLE CARDS ***
Dealt to matiko09 [Td Ad]
sanpidk: folds 
Chin41178: folds 
cnn123: folds 
matiko09: raises $2 to $3
FroggyPlay: folds 
KovIFish89: folds 
koutani7: folds 
vrnMike: folds 
Uncalled bet ($2) returned to matiko09
matiko09 collected $2.50 from pot
matiko09: doesn't show hand 
*** SUMMARY ***
Total pot $2.50 | Rake $0 
Seat 1: KovIFish89 (button) folded before Flop (didn't bet)
Seat 2: koutani7 (small blind) folded before Flop
Seat 3: vrnMike (big blind) folded before Flop
Seat 4: sanpidk folded before Flop (didn't bet)
Seat 5: Chin41178 folded before Flop (didn't bet)
Seat 6: cnn123 folded before Flop (didn't bet)
Seat 8: matiko09 collected ($2.50)
Seat 9: FroggyPlay folded before Flop (didn't bet)





PokerStars Hand #152884982940:  Hold'em No Limit ($1/$2 USD) - 2016/05/05 16:05:29 CET [2016/05/05 10:05:29 ET]
Table 'Euporie II' 9-max Seat #2 is the button
Seat 1: gabi_igna ($200 in chips) 
Seat 2: nickreason17 ($200 in chips) 
Seat 3: chaps1988 ($200 in chips) 
Seat 4: Kukuryzka ($199 in chips) 
Seat 5: Nuskatko1986 ($62.16 in chips) 
Seat 6: glanza_mike ($204 in chips) 
Seat 7: matiko09 ($205.04 in chips) 
Seat 8: Painkiller72 ($311.25 in chips) 
Seat 9: T0ny Adams ($87.91 in chips) 
chaps1988: posts small blind $1
Kukuryzka: posts big blind $2
*** HOLE CARDS ***
Dealt to matiko09 [As 3c]
Nuskatko1986: calls $2
glanza_mike: folds 
matiko09: folds 
Painkiller72: folds 
T0ny Adams: raises $7 to $9
gabi_igna: folds 
nickreason17: folds 
chaps1988: folds 
Kukuryzka: folds 
Nuskatko1986: folds 
Uncalled bet ($7) returned to T0ny Adams
T0ny Adams collected $7 from pot
T0ny Adams: doesn't show hand 
*** SUMMARY ***
Total pot $7 | Rake $0 
Seat 1: gabi_igna folded before Flop (didn't bet)
Seat 2: nickreason17 (button) folded before Flop (didn't bet)
Seat 3: chaps1988 (small blind) folded before Flop
Seat 4: Kukuryzka (big blind) folded before Flop
Seat 5: Nuskatko1986 folded before Flop
Seat 6: glanza_mike folded before Flop (didn't bet)
Seat 7: matiko09 folded before Flop (didn't bet)
Seat 8: Painkiller72 folded before Flop (didn't bet)
Seat 9: T0ny Adams collected ($7)





PokerStars Hand #152884986163:  Hold'em No Limit ($1/$2 USD) - 2016/05/05 16:05:35 CET [2016/05/05 10:05:35 ET]
Table 'Tatry II' 9-max Seat #1 is the button
Seat 1: glanza_mike ($248.17 in chips) 
Seat 2: T0ny Adams ($87.40 in chips) 
Seat 3: matiko09 ($203 in chips) 
Seat 4: WolleMalone ($203 in chips) 
Seat 5: Painkiller72 ($206.25 in chips) 
Seat 6: Kukuryzka ($200 in chips) 
Seat 7: nickreason17 ($200 in chips) 
Seat 8: chaps1988 ($200 in chips) 
Seat 9: korol702 ($138.18 in chips) 
T0ny Adams: posts small blind $1
matiko09: posts big blind $2
*** HOLE CARDS ***
Dealt to matiko09 [8h 4c]
WolleMalone: folds 
Painkiller72: folds 
Kukuryzka: folds 
nickreason17: folds 
chaps1988: folds 
korol702: raises $4 to $6
glanza_mike: folds 
T0ny Adams: folds 
matiko09: folds 
Uncalled bet ($4) returned to korol702
korol702 collected $5 from pot
korol702: doesn't show hand 
*** SUMMARY ***
Total pot $5 | Rake $0 
Seat 1: glanza_mike (button) folded before Flop (didn't bet)
Seat 2: T0ny Adams (small blind) folded before Flop
Seat 3: matiko09 (big blind) folded before Flop
Seat 4: WolleMalone folded before Flop (didn't bet)
Seat 5: Painkiller72 folded before Flop (didn't bet)
Seat 6: Kukuryzka folded before Flop (didn't bet)
Seat 7: nickreason17 folded before Flop (didn't bet)
Seat 8: chaps1988 folded before Flop (didn't bet)
Seat 9: korol702 collected ($5)





PokerStars Hand #152884996574:  Hold'em No Limit ($1/$2 USD) - 2016/05/05 16:05:52 CET [2016/05/05 10:05:52 ET]
Table 'Tololo' 9-max Seat #4 is the button
Seat 4: mooose100 ($157.73 in chips) 
Seat 5: matiko09 ($203.61 in chips) 
Seat 6: Xagua ($260.77 in chips) 
Seat 8: KovIFish89 ($200 in chips) 
Seat 9: Fitzyferret ($331.31 in chips) 
matiko09: posts small blind $1
Xagua: posts big blind $2
chaps1988: sits out 
Kukuryzka: sits out 
gabi_igna: sits out 
*** HOLE CARDS ***
Dealt to matiko09 [2h Ac]
KovIFish89: folds 
Fitzyferret: folds 
mooose100: raises $4 to $6
matiko09: folds 
Xagua: calls $4
*** FLOP *** [3h Jc Tc]
Xagua: checks 
mooose100: bets $6.17
Xagua: calls $6.17
*** TURN *** [3h Jc Tc] [Ad]
Xagua: checks 
mooose100: checks 
*** RIVER *** [3h Jc Tc Ad] [Kc]
Xagua: checks 
mooose100: bets $12.03
Xagua: folds 
Uncalled bet ($12.03) returned to mooose100
mooose100 collected $24.07 from pot
mooose100: doesn't show hand 
*** SUMMARY ***
Total pot $25.34 | Rake $1.27 
Board [3h Jc Tc Ad Kc]
Seat 4: mooose100 (button) collected ($24.07)
Seat 5: matiko09 (small blind) folded before Flop
Seat 6: Xagua (big blind) folded on the River
Seat 8: KovIFish89 folded before Flop (didn't bet)
Seat 9: Fitzyferret folded before Flop (didn't bet)





PokerStars Hand #152884999007:  Hold'em No Limit ($0.50/$1.00 USD) - 2016/05/05 16:05:56 CET [2016/05/05 10:05:56 ET]
Table 'Luthera' 9-max Seat #7 is the button
Seat 1: MrMattkk ($96.49 in chips) 
Seat 4: matiko09 ($111.48 in chips) 
Seat 5: Painkiller72 ($100 in chips) 
Seat 6: Dantist1122 ($100 in chips) 
Seat 7: Chin41178 ($103.46 in chips) 
Seat 8: xdrKush420x ($93.46 in chips) 
Seat 9: vrnMike ($106.34 in chips) 
xdrKush420x: posts small blind $0.50
vrnMike: posts big blind $1
Kukuryzka: sits out 
sanpidk: sits out 
*** HOLE CARDS ***
Dealt to matiko09 [7c Ad]
MrMattkk: folds 
matiko09: folds 
Painkiller72: folds 
Dantist1122: folds 
Chin41178: folds 
xdrKush420x: raises $2 to $3
vrnMike: folds 
Uncalled bet ($2) returned to xdrKush420x
xdrKush420x collected $2 from pot
*** SUMMARY ***
Total pot $2 | Rake $0 
Seat 1: MrMattkk folded before Flop (didn't bet)
Seat 4: matiko09 folded before Flop (didn't bet)
Seat 5: Painkiller72 folded before Flop (didn't bet)
Seat 6: Dantist1122 folded before Flop (didn't bet)
Seat 7: Chin41178 (button) folded before Flop (didn't bet)
Seat 8: xdrKush420x (small blind) collected ($2)
Seat 9: vrnMike (big blind) folded before Flop





PokerStars Hand #152885001267:  Hold'em No Limit ($1/$2 USD) - 2016/05/05 16:06:00 CET [2016/05/05 10:06:00 ET]
Table 'Tatry II' 9-max Seat #2 is the button
Seat 1: glanza_mike ($248.17 in chips) 
Seat 2: T0ny Adams ($86.40 in chips) 
Seat 3: matiko09 ($201 in chips) 
Seat 4: WolleMalone ($203 in chips) 
Seat 5: Painkiller72 ($206.25 in chips) 
Seat 6: Kukuryzka ($200 in chips) 
Seat 7: nickreason17 ($200 in chips) 
Seat 8: chaps1988 ($200 in chips) 
Seat 9: korol702 ($141.18 in chips) 
matiko09: posts small blind $1
WolleMalone: posts big blind $2
*** HOLE CARDS ***
Dealt to matiko09 [Kh Tc]
Painkiller72: folds 
Kukuryzka: raises $4 to $6
nickreason17: folds 
chaps1988: folds 
korol702: folds 
glanza_mike: folds 
T0ny Adams: folds 
matiko09: folds 
WolleMalone: calls $4
*** FLOP *** [2c 9h Ad]
WolleMalone: checks 
Kukuryzka: checks 
*** TURN *** [2c 9h Ad] [Td]
WolleMalone: checks 
Kukuryzka: bets $8
WolleMalone: folds 
Uncalled bet ($8) returned to Kukuryzka
Kukuryzka collected $12.35 from pot
Kukuryzka: doesn't show hand 
*** SUMMARY ***
Total pot $13 | Rake $0.65 
Board [2c 9h Ad Td]
Seat 1: glanza_mike folded before Flop (didn't bet)
Seat 2: T0ny Adams (button) folded before Flop (didn't bet)
Seat 3: matiko09 (small blind) folded before Flop
Seat 4: WolleMalone (big blind) folded on the Turn
Seat 5: Painkiller72 folded before Flop (didn't bet)
Seat 6: Kukuryzka collected ($12.35)
Seat 7: nickreason17 folded before Flop (didn't bet)
Seat 8: chaps1988 folded before Flop (didn't bet)
Seat 9: korol702 folded before Flop (didn't bet)





PokerStars Hand #152885003975:  Hold'em No Limit ($1/$2 USD) - 2016/05/05 16:06:05 CET [2016/05/05 10:06:05 ET]
Table 'Samitchell' 9-max Seat #1 is the button
Seat 1: KovIFish89 ($206 in chips) 
Seat 2: matiko09 ($221.04 in chips) 
Seat 3: gabi_igna ($317.87 in chips) 
Seat 4: Fitzyferret ($345.08 in chips) 
Seat 7: patpaty ($161.59 in chips) 
Seat 8: WolleMalone ($206.99 in chips) 
Seat 9: kblkxls ($120.07 in chips) 
matiko09: posts small blind $1
gabi_igna: posts big blind $2
chaps1988: sits out 
*** HOLE CARDS ***
Dealt to matiko09 [5c 8d]
Fitzyferret: folds 
patpaty: folds 
Zhalgasai joins the table at seat #6 
WolleMalone: folds 
kblkxls: folds 
KovIFish89: folds 
matiko09: folds 
Uncalled bet ($1) returned to gabi_igna
gabi_igna collected $2 from pot
gabi_igna: doesn't show hand 
*** SUMMARY ***
Total pot $2 | Rake $0 
Seat 1: KovIFish89 (button) folded before Flop (didn't bet)
Seat 2: matiko09 (small blind) folded before Flop
Seat 3: gabi_igna (big blind) collected ($2)
Seat 4: Fitzyferret folded before Flop (didn't bet)
Seat 7: patpaty folded before Flop (didn't bet)
Seat 8: WolleMalone folded before Flop (didn't bet)
Seat 9: kblkxls folded before Flop (didn't bet)





PokerStars Hand #152885005271:  Hold'em No Limit ($0.50/$1.00 USD) - 2016/05/05 16:06:07 CET [2016/05/05 10:06:07 ET]
Table 'Pyxis III' 9-max Seat #3 is the button
Seat 1: sanpidk ($286.19 in chips) 
Seat 2: SPmaka ($108.02 in chips) 
Seat 3: vrnMike ($100 in chips) 
Seat 4: Sloeve ($123.49 in chips) 
Seat 5: darren1031 ($87.43 in chips) 
Seat 6: kamillo91 ($97.47 in chips) 
Seat 7: mycka86 ($103.88 in chips) 
Seat 8: matiko09 ($100.37 in chips) 
Seat 9: Hypoaroused ($170.88 in chips) 
Sloeve: posts small blind $0.50
darren1031: posts big blind $1
*** HOLE CARDS ***
Dealt to matiko09 [4c 6c]
kamillo91: folds 
mycka86: folds 
matiko09: folds 
Hypoaroused: folds 
Hypoaroused leaves the table
sanpidk: folds 
SPmaka: folds 
vrnMike: folds 
maxxmeister joins the table at seat #9 
Sloeve: raises $2 to $3
darren1031: raises $5 to $8
Sloeve: raises $14 to $22
darren1031: raises $65.43 to $87.43 and is all-in
Sloeve: calls $65.43
*** FLOP *** [Td 9d 9s]
*** TURN *** [Td 9d 9s] [5d]
*** RIVER *** [Td 9d 9s 5d] [Tc]
*** SHOW DOWN ***
Sloeve: shows [Ad Qc] (two pair, Tens and Nines)
darren1031: shows [Qs As] (two pair, Tens and Nines)
Sloeve collected $86.18 from pot
darren1031 collected $86.18 from pot
*** SUMMARY ***
Total pot $174.86 | Rake $2.50 
Board [Td 9d 9s 5d Tc]
Seat 1: sanpidk folded before Flop (didn't bet)
Seat 2: SPmaka folded before Flop (didn't bet)
Seat 3: vrnMike (button) folded before Flop (didn't bet)
Seat 4: Sloeve (small blind) showed [Ad Qc] and won ($86.18) with two pair, Tens and Nines
Seat 5: darren1031 (big blind) showed [Qs As] and won ($86.18) with two pair, Tens and Nines
Seat 6: kamillo91 folded before Flop (didn't bet)
Seat 7: mycka86 folded before Flop (didn't bet)
Seat 8: matiko09 folded before Flop (didn't bet)
Seat 9: Hypoaroused folded before Flop (didn't bet)





PokerStars Hand #152885007866:  Hold'em No Limit ($1/$2 USD) - 2016/05/05 16:06:11 CET [2016/05/05 10:06:11 ET]
Table 'Euporie II' 9-max Seat #3 is the button
Seat 1: gabi_igna ($200 in chips) 
Seat 2: nickreason17 ($200 in chips) 
Seat 3: chaps1988 ($200 in chips) 
Seat 4: Kukuryzka ($200 in chips) 
Seat 5: Nuskatko1986 ($60.16 in chips) 
Seat 6: glanza_mike ($204 in chips) 
Seat 7: matiko09 ($205.04 in chips) 
Seat 8: Painkiller72 ($311.25 in chips) 
Seat 9: T0ny Adams ($92.91 in chips) 
Kukuryzka: posts small blind $1
Nuskatko1986: posts big blind $2
*** HOLE CARDS ***
Dealt to matiko09 [As 5s]
glanza_mike: folds 
matiko09: folds 
Painkiller72: raises $3 to $5
T0ny Adams: folds 
gabi_igna: folds 
nickreason17: folds 
chaps1988: folds 
Kukuryzka: folds 
Nuskatko1986: calls $3
*** FLOP *** [6d 3d 7d]
Nuskatko1986: checks 
Painkiller72: checks 
*** TURN *** [6d 3d 7d] [5d]
Nuskatko1986: checks 
Painkiller72: checks 
*** RIVER *** [6d 3d 7d 5d] [Kd]
Nuskatko1986: bets $22
Painkiller72: folds 
Uncalled bet ($22) returned to Nuskatko1986
Nuskatko1986 collected $10.45 from pot
Nuskatko1986: doesn't show hand 
*** SUMMARY ***
Total pot $11 | Rake $0.55 
Board [6d 3d 7d 5d Kd]
Seat 1: gabi_igna folded before Flop (didn't bet)
Seat 2: nickreason17 folded before Flop (didn't bet)
Seat 3: chaps1988 (button) folded before Flop (didn't bet)
Seat 4: Kukuryzka (small blind) folded before Flop
Seat 5: Nuskatko1986 (big blind) collected ($10.45)
Seat 6: glanza_mike folded before Flop (didn't bet)
Seat 7: matiko09 folded before Flop (didn't bet)
Seat 8: Painkiller72 folded on the River
Seat 9: T0ny Adams folded before Flop (didn't bet)





PokerStars Hand #152885009548:  Hold'em No Limit ($0.50/$1.00 USD) - 2016/05/05 16:06:14 CET [2016/05/05 10:06:14 ET]
Table 'Musa II' 9-max Seat #2 is the button
Seat 1: KovIFish89 ($191.97 in chips) 
Seat 2: koutani7 ($74 in chips) 
Seat 3: vrnMike ($106.38 in chips) 
Seat 4: sanpidk ($101.50 in chips) 
Seat 5: Chin41178 ($87.91 in chips) 
Seat 6: cnn123 ($86.52 in chips) 
Seat 8: matiko09 ($108.62 in chips) 
Seat 9: FroggyPlay ($100 in chips) 
vrnMike: posts small blind $0.50
sanpidk: posts big blind $1
plaindaft1: sits out 
*** HOLE CARDS ***
Dealt to matiko09 [Td Kh]
Chin41178: folds 
cnn123: folds 
matiko09: folds 
FroggyPlay: folds 
KovIFish89: folds 
koutani7: raises $2 to $3
vrnMike: folds 
sanpidk: folds 
Uncalled bet ($2) returned to koutani7
koutani7 collected $2.50 from pot
koutani7: doesn't show hand 
*** SUMMARY ***
Total pot $2.50 | Rake $0 
Seat 1: KovIFish89 folded before Flop (didn't bet)
Seat 2: koutani7 (button) collected ($2.50)
Seat 3: vrnMike (small blind) folded before Flop
Seat 4: sanpidk (big blind) folded before Flop
Seat 5: Chin41178 folded before Flop (didn't bet)
Seat 6: cnn123 folded before Flop (didn't bet)
Seat 8: matiko09 folded before Flop (didn't bet)
Seat 9: FroggyPlay folded before Flop (didn't bet)





PokerStars Hand #152885010724:  Hold'em No Limit ($0.50/$1.00 USD) - 2016/05/05 16:06:16 CET [2016/05/05 10:06:16 ET]
Table 'Priska II' 9-max Seat #2 is the button
Seat 2: Kukuryzka ($128.02 in chips) 
Seat 3: matiko09 ($102.50 in chips) 
Seat 7: stockbridge8 ($87.77 in chips) 
Seat 9: torkkdnm ($100 in chips) 
matiko09: posts small blind $0.50
Painkiller72: is sitting out 
nickreason17: is sitting out 
Painkiller72 leaves the table
St.LaCoste: is sitting out 
stockbridge8: posts big blind $1
janarr5: sits out 
sanpidk: sits out 
*** HOLE CARDS ***
Dealt to matiko09 [Kh Kd]
St.LaCoste leaves the table
nickreason17 leaves the table
mycka86 joins the table at seat #4 
torkkdnm: folds 
Kukuryzka: folds 
matiko09: raises $1.50 to $2.50
stockbridge8: folds 
Uncalled bet ($1.50) returned to matiko09
matiko09 collected $2 from pot
matiko09: doesn't show hand 
*** SUMMARY ***
Total pot $2 | Rake $0 
Seat 2: Kukuryzka (button) folded before Flop (didn't bet)
Seat 3: matiko09 (small blind) collected ($2)
Seat 7: stockbridge8 (big blind) folded before Flop
Seat 9: torkkdnm folded before Flop (didn't bet)





PokerStars Hand #152885016953:  Hold'em No Limit ($1/$2 USD) - 2016/05/05 16:06:27 CET [2016/05/05 10:06:27 ET]
Table 'Samitchell' 9-max Seat #2 is the button
Seat 1: KovIFish89 ($206 in chips) 
Seat 2: matiko09 ($220.04 in chips) 
Seat 3: gabi_igna ($318.87 in chips) 
Seat 4: Fitzyferret ($345.08 in chips) 
Seat 7: patpaty ($161.59 in chips) 
Seat 8: WolleMalone ($206.99 in chips) 
Seat 9: kblkxls ($120.07 in chips) 
gabi_igna: posts small blind $1
Fitzyferret: posts big blind $2
chaps1988: sits out 
Zhalgasai: sits out 
*** HOLE CARDS ***
Dealt to matiko09 [3d 3s]
patpaty: calls $2
WolleMalone: folds 
kblkxls: raises $4 to $6
KovIFish89: calls $6
matiko09: calls $6
gabi_igna: folds 
Fitzyferret: folds 
patpaty: calls $4
*** FLOP *** [Jc As Jd]
patpaty: bets $2
kblkxls: calls $2
KovIFish89: raises $13 to $15
matiko09: folds 
patpaty: folds 
kblkxls: folds [Ah]
Uncalled bet ($13) returned to KovIFish89
KovIFish89 collected $31.35 from pot
KovIFish89: doesn't show hand 
*** SUMMARY ***
Total pot $33 | Rake $1.65 
Board [Jc As Jd]
Seat 1: KovIFish89 collected ($31.35)
Seat 2: matiko09 (button) folded on the Flop
Seat 3: gabi_igna (small blind) folded before Flop
Seat 4: Fitzyferret (big blind) folded before Flop
Seat 7: patpaty folded on the Flop
Seat 8: WolleMalone folded before Flop (didn't bet)
Seat 9: kblkxls folded on the Flop





PokerStars Hand #152885021387:  Hold'em No Limit ($1/$2 USD) - 2016/05/05 16:06:34 CET [2016/05/05 10:06:34 ET]
Table 'Lundia' 9-max Seat #7 is the button
Seat 1: Fitzyferret ($236.60 in chips) 
Seat 2: patpaty ($216.47 in chips) 
Seat 3: Painkiller72 ($200 in chips) 
Seat 4: KovIFish89 ($308.56 in chips) 
Seat 5: zmOe84 ($185.76 in chips) 
Seat 7: matiko09 ($240.11 in chips) 
Seat 9: gabi_igna ($255.61 in chips) 
gabi_igna: posts small blind $1
Fitzyferret: posts big blind $2
CI58: sits out 
*** HOLE CARDS ***
Dealt to matiko09 [7c Ts]
patpaty: folds 
Painkiller72: folds 
KovIFish89: folds 
Durnichka leaves the table
chaps1988 joins the table at seat #8 
zmOe84: folds 
matiko09: folds 
gabi_igna: raises $4 to $6
Fitzyferret: folds 
Uncalled bet ($4) returned to gabi_igna
gabi_igna collected $4 from pot
gabi_igna: doesn't show hand 
*** SUMMARY ***
Total pot $4 | Rake $0 
Seat 1: Fitzyferret (big blind) folded before Flop
Seat 2: patpaty folded before Flop (didn't bet)
Seat 3: Painkiller72 folded before Flop (didn't bet)
Seat 4: KovIFish89 folded before Flop (didn't bet)
Seat 5: zmOe84 folded before Flop (didn't bet)
Seat 7: matiko09 (button) folded before Flop (didn't bet)
Seat 9: gabi_igna (small blind) collected ($4)





PokerStars Hand #152885021651:  Hold'em No Limit ($0.50/$1.00 USD) - 2016/05/05 16:06:35 CET [2016/05/05 10:06:35 ET]
Table 'Priska II' 9-max Seat #3 is the button
Seat 2: Kukuryzka ($128.02 in chips) 
Seat 3: matiko09 ($103.50 in chips) 
Seat 7: stockbridge8 ($86.77 in chips) 
Seat 8: janarr5 ($100 in chips) 
Seat 9: torkkdnm ($100 in chips) 
mycka86 will be allowed to play after the button
stockbridge8: posts small blind $0.50
janarr5: posts big blind $1
sanpidk: sits out 
*** HOLE CARDS ***
Dealt to matiko09 [7s 6d]
torkkdnm: folds 
Kukuryzka: folds 
matiko09: folds 
Mr.Iraq007 joins the table at seat #5 
stockbridge8: folds 
Uncalled bet ($0.50) returned to janarr5
janarr5 collected $1 from pot
janarr5: doesn't show hand 
*** SUMMARY ***
Total pot $1 | Rake $0 
Seat 2: Kukuryzka folded before Flop (didn't bet)
Seat 3: matiko09 (button) folded before Flop (didn't bet)
Seat 7: stockbridge8 (small blind) folded before Flop
Seat 8: janarr5 (big blind) collected ($1)
Seat 9: torkkdnm folded before Flop (didn't bet)





PokerStars Hand #152885024404:  Hold'em No Limit ($0.50/$1.00 USD) - 2016/05/05 16:06:39 CET [2016/05/05 10:06:39 ET]
Table 'Luthera' 9-max Seat #8 is the button
Seat 1: MrMattkk ($96.49 in chips) 
Seat 4: matiko09 ($111.48 in chips) 
Seat 5: Painkiller72 ($100 in chips) 
Seat 6: Dantist1122 ($100 in chips) 
Seat 7: Chin41178 ($103.46 in chips) 
Seat 8: xdrKush420x ($94.46 in chips) 
Seat 9: vrnMike ($105.34 in chips) 
vrnMike: posts small blind $0.50
MrMattkk: posts big blind $1
Kukuryzka: sits out 
sanpidk: sits out 
*** HOLE CARDS ***
Dealt to matiko09 [Kh Td]
matiko09: folds 
Painkiller72: folds 
Dantist1122: raises $2 to $3
Chin41178: folds 
xdrKush420x: folds 
vrnMike: calls $2.50
MrMattkk: folds 
*** FLOP *** [Ks 4h Jc]
vrnMike: checks 
Dantist1122: bets $5.12
vrnMike: calls $5.12
*** TURN *** [Ks 4h Jc] [6c]
vrnMike: checks 
Dantist1122: checks 
*** RIVER *** [Ks 4h Jc 6c] [3d]
vrnMike: bets $10
Dantist1122: folds 
Uncalled bet ($10) returned to vrnMike
vrnMike collected $16.38 from pot
*** SUMMARY ***
Total pot $17.24 | Rake $0.86 
Board [Ks 4h Jc 6c 3d]
Seat 1: MrMattkk (big blind) folded before Flop
Seat 4: matiko09 folded before Flop (didn't bet)
Seat 5: Painkiller72 folded before Flop (didn't bet)
Seat 6: Dantist1122 folded on the River
Seat 7: Chin41178 folded before Flop (didn't bet)
Seat 8: xdrKush420x (button) folded before Flop (didn't bet)
Seat 9: vrnMike (small blind) collected ($16.38)





PokerStars Hand #152885027796:  Hold'em No Limit ($1/$2 USD) - 2016/05/05 16:06:45 CET [2016/05/05 10:06:45 ET]
Table 'Tololo' 9-max Seat #5 is the button
Seat 4: mooose100 ($169.63 in chips) 
Seat 5: matiko09 ($202.61 in chips) 
Seat 6: Xagua ($248.60 in chips) 
Seat 7: chaps1988 ($225.60 in chips) 
Seat 8: KovIFish89 ($200 in chips) 
Seat 9: Fitzyferret ($331.31 in chips) 
Xagua: posts small blind $1
chaps1988: posts big blind $2
Kukuryzka: sits out 
gabi_igna: sits out 
*** HOLE CARDS ***
Dealt to matiko09 [2c Ks]
KovIFish89: folds 
Fitzyferret: raises $2.60 to $4.60
mooose100: calls $4.60
matiko09: folds 
Xagua: calls $3.60
chaps1988: folds 
*** FLOP *** [7s Tc Jc]
Xagua: checks 
Fitzyferret: checks 
mooose100: checks 
*** TURN *** [7s Tc Jc] [2s]
Xagua: checks 
Fitzyferret: bets $13
mooose100: folds 
Xagua: folds 
Uncalled bet ($13) returned to Fitzyferret
Fitzyferret collected $15.01 from pot
Fitzyferret: doesn't show hand 
*** SUMMARY ***
Total pot $15.80 | Rake $0.79 
Board [7s Tc Jc 2s]
Seat 4: mooose100 folded on the Turn
Seat 5: matiko09 (button) folded before Flop (didn't bet)
Seat 6: Xagua (small blind) folded on the Turn
Seat 7: chaps1988 (big blind) folded before Flop
Seat 8: KovIFish89 folded before Flop (didn't bet)
Seat 9: Fitzyferret collected ($15.01)





PokerStars Hand #152885034428:  Hold'em No Limit ($0.50/$1.00 USD) - 2016/05/05 16:06:56 CET [2016/05/05 10:06:56 ET]
Table 'Musa II' 9-max Seat #3 is the button
Seat 1: KovIFish89 ($191.97 in chips) 
Seat 2: koutani7 ($75.50 in chips) 
Seat 3: vrnMike ($105.88 in chips) 
Seat 4: sanpidk ($100.50 in chips) 
Seat 5: Chin41178 ($87.91 in chips) 
Seat 6: cnn123 ($86.52 in chips) 
Seat 8: matiko09 ($108.62 in chips) 
Seat 9: FroggyPlay ($100 in chips) 
sanpidk: posts small blind $0.50
Chin41178: posts big blind $1
plaindaft1: sits out 
*** HOLE CARDS ***
Dealt to matiko09 [Tc 4c]
cnn123: raises $2 to $3
matiko09: folds 
FroggyPlay: folds 
KovIFish89: folds 
koutani7: folds 
vrnMike: folds 
sanpidk: folds 
Chin41178: folds 
Uncalled bet ($2) returned to cnn123
cnn123 collected $2.50 from pot
cnn123: doesn't show hand 
*** SUMMARY ***
Total pot $2.50 | Rake $0 
Seat 1: KovIFish89 folded before Flop (didn't bet)
Seat 2: koutani7 folded before Flop (didn't bet)
Seat 3: vrnMike (button) folded before Flop (didn't bet)
Seat 4: sanpidk (small blind) folded before Flop
Seat 5: Chin41178 (big blind) folded before Flop
Seat 6: cnn123 collected ($2.50)
Seat 8: matiko09 folded before Flop (didn't bet)
Seat 9: FroggyPlay folded before Flop (didn't bet)





PokerStars Hand #152885037605:  Hold'em No Limit ($0.50/$1.00 USD) - 2016/05/05 16:07:02 CET [2016/05/05 10:07:02 ET]
Table 'Priska II' 9-max Seat #7 is the button
Seat 2: Kukuryzka ($128.02 in chips) 
Seat 3: matiko09 ($103.50 in chips) 
Seat 5: Mr.Iraq007 ($100 in chips) 
Seat 7: stockbridge8 ($86.27 in chips) 
Seat 8: janarr5 ($100.50 in chips) 
Seat 9: torkkdnm ($100 in chips) 
janarr5: posts small blind $0.50
torkkdnm: posts big blind $1
sanpidk: sits out 
mycka86: sits out 
Mr.Iraq007: posts big blind $1
*** HOLE CARDS ***
Dealt to matiko09 [7c Th]
Kukuryzka: folds 
matiko09: folds 
Mr.Iraq007: raises $2 to $3
stockbridge8: folds 
janarr5: folds 
JorgeAndino joins the table at seat #6 
torkkdnm: folds 
Uncalled bet ($2) returned to Mr.Iraq007
Mr.Iraq007 collected $2.50 from pot
*** SUMMARY ***
Total pot $2.50 | Rake $0 
Seat 2: Kukuryzka folded before Flop (didn't bet)
Seat 3: matiko09 folded before Flop (didn't bet)
Seat 5: Mr.Iraq007 collected ($2.50)
Seat 7: stockbridge8 (button) folded before Flop (didn't bet)
Seat 8: janarr5 (small blind) folded before Flop
Seat 9: torkkdnm (big blind) folded before Flop





PokerStars Hand #152885041587:  Hold'em No Limit ($0.50/$1.00 USD) - 2016/05/05 16:07:09 CET [2016/05/05 10:07:09 ET]
Table 'Pyxis III' 9-max Seat #4 is the button
Seat 1: sanpidk ($286.19 in chips) 
Seat 2: SPmaka ($108.02 in chips) 
Seat 3: vrnMike ($100 in chips) 
Seat 4: Sloeve ($122.24 in chips) 
Seat 5: darren1031 ($86.18 in chips) 
Seat 6: kamillo91 ($97.47 in chips) 
Seat 7: mycka86 ($103.88 in chips) 
Seat 8: matiko09 ($100.37 in chips) 
darren1031: posts small blind $0.50
kamillo91: posts big blind $1
maxxmeister: sits out 
*** HOLE CARDS ***
Dealt to matiko09 [8s 7s]
mycka86: raises $2 to $3
matiko09: folds 
sanpidk: calls $3
SPmaka: folds 
vrnMike: folds 
Sloeve: folds 
darren1031: raises $4 to $7
kamillo91: folds 
mycka86: calls $4
sanpidk: calls $4
*** FLOP *** [5s 8h 3c]
darren1031: bets $15
mycka86: folds 
sanpidk: folds 
Uncalled bet ($15) returned to darren1031
darren1031 collected $20.90 from pot
darren1031: doesn't show hand 
*** SUMMARY ***
Total pot $22 | Rake $1.10 
Board [5s 8h 3c]
Seat 1: sanpidk folded on the Flop
Seat 2: SPmaka folded before Flop (didn't bet)
Seat 3: vrnMike folded before Flop (didn't bet)
Seat 4: Sloeve (button) folded before Flop (didn't bet)
Seat 5: darren1031 (small blind) collected ($20.90)
Seat 6: kamillo91 (big blind) folded before Flop
Seat 7: mycka86 folded on the Flop
Seat 8: matiko09 folded before Flop (didn't bet)





PokerStars Hand #152885043983:  Hold'em No Limit ($1/$2 USD) - 2016/05/05 16:07:13 CET [2016/05/05 10:07:13 ET]
Table 'Tatry II' 9-max Seat #3 is the button
Seat 1: glanza_mike ($248.17 in chips) 
Seat 2: T0ny Adams ($86.40 in chips) 
Seat 3: matiko09 ($200 in chips) 
Seat 4: WolleMalone ($200 in chips) 
Seat 5: Painkiller72 ($206.25 in chips) 
Seat 6: Kukuryzka ($206.35 in chips) 
Seat 7: nickreason17 ($200 in chips) 
Seat 8: chaps1988 ($200 in chips) 
Seat 9: korol702 ($141.18 in chips) 
WolleMalone: posts small blind $1
Painkiller72: posts big blind $2
*** HOLE CARDS ***
Dealt to matiko09 [8d 5d]
Kukuryzka: folds 
nickreason17: folds 
chaps1988: folds 
korol702: raises $4 to $6
glanza_mike: folds 
T0ny Adams: folds 
matiko09: folds 
WolleMalone: folds 
Painkiller72: calls $4
*** FLOP *** [Td As 4d]
Painkiller72: checks 
korol702: bets $4
Painkiller72: calls $4
*** TURN *** [Td As 4d] [7s]
Painkiller72: checks 
korol702: bets $6
Painkiller72: raises $22.36 to $28.36
korol702: calls $22.36
*** RIVER *** [Td As 4d 7s] [6c]
Painkiller72: bets $62.47
korol702: raises $40.35 to $102.82 and is all-in
Painkiller72: calls $40.35
*** SHOW DOWN ***
korol702: shows [Qh Ad] (a pair of Aces)
Painkiller72: shows [Ah 7d] (two pair, Aces and Sevens)
Painkiller72 collected $280.61 from pot
*** SUMMARY ***
Total pot $283.36 | Rake $2.75 
Board [Td As 4d 7s 6c]
Seat 1: glanza_mike folded before Flop (didn't bet)
Seat 2: T0ny Adams folded before Flop (didn't bet)
Seat 3: matiko09 (button) folded before Flop (didn't bet)
Seat 4: WolleMalone (small blind) folded before Flop
Seat 5: Painkiller72 (big blind) showed [Ah 7d] and won ($280.61) with two pair, Aces and Sevens
Seat 6: Kukuryzka folded before Flop (didn't bet)
Seat 7: nickreason17 folded before Flop (didn't bet)
Seat 8: chaps1988 folded before Flop (didn't bet)
Seat 9: korol702 showed [Qh Ad] and lost with a pair of Aces





PokerStars Hand #152885047000:  Hold'em No Limit ($1/$2 USD) - 2016/05/05 16:07:18 CET [2016/05/05 10:07:18 ET]
Table 'Lundia' 9-max Seat #9 is the button
Seat 1: Fitzyferret ($234.60 in chips) 
Seat 2: patpaty ($216.47 in chips) 
Seat 3: Painkiller72 ($200 in chips) 
Seat 4: KovIFish89 ($308.56 in chips) 
Seat 5: zmOe84 ($185.76 in chips) 
Seat 7: matiko09 ($240.11 in chips) 
Seat 9: gabi_igna ($257.61 in chips) 
Fitzyferret: posts small blind $1
patpaty: posts big blind $2
CI58: sits out 
chaps1988: sits out 
*** HOLE CARDS ***
Dealt to matiko09 [4d Js]
Painkiller72: folds 
KovIFish89: folds 
zmOe84: folds 
matiko09: folds 
gabi_igna: raises $2 to $4
Fitzyferret: raises $13 to $17
patpaty: folds 
gabi_igna: calls $13
*** FLOP *** [3s 2d 5d]
Fitzyferret: checks 
gabi_igna: checks 
*** TURN *** [3s 2d 5d] [4s]
Fitzyferret: checks 
gabi_igna: checks 
*** RIVER *** [3s 2d 5d 4s] [9d]
Fitzyferret: checks 
gabi_igna: checks 
*** SHOW DOWN ***
Fitzyferret: shows [Kh Kd] (a pair of Kings)
gabi_igna: mucks hand 
Fitzyferret collected $34.20 from pot
*** SUMMARY ***
Total pot $36 | Rake $1.80 
Board [3s 2d 5d 4s 9d]
Seat 1: Fitzyferret (small blind) showed [Kh Kd] and won ($34.20) with a pair of Kings
Seat 2: patpaty (big blind) folded before Flop
Seat 3: Painkiller72 folded before Flop (didn't bet)
Seat 4: KovIFish89 folded before Flop (didn't bet)
Seat 5: zmOe84 folded before Flop (didn't bet)
Seat 7: matiko09 folded before Flop (didn't bet)
Seat 9: gabi_igna (button) mucked [Jh Qs]





PokerStars Hand #152885052012:  Hold'em No Limit ($1/$2 USD) - 2016/05/05 16:07:26 CET [2016/05/05 10:07:26 ET]
Table 'Euporie II' 9-max Seat #4 is the button
Seat 1: gabi_igna ($200 in chips) 
Seat 2: nickreason17 ($200 in chips) 
Seat 3: chaps1988 ($200 in chips) 
Seat 4: Kukuryzka ($199 in chips) 
Seat 5: Nuskatko1986 ($65.61 in chips) 
Seat 6: glanza_mike ($204 in chips) 
Seat 7: matiko09 ($205.04 in chips) 
Seat 8: Painkiller72 ($306.25 in chips) 
Seat 9: T0ny Adams ($92.91 in chips) 
Nuskatko1986: posts small blind $1
glanza_mike: posts big blind $2
*** HOLE CARDS ***
Dealt to matiko09 [6d Kd]
matiko09: folds 
Painkiller72: folds 
T0ny Adams: folds 
gabi_igna: folds 
nickreason17: folds 
chaps1988: raises $2.50 to $4.50
Kukuryzka: folds 
Nuskatko1986: folds 
glanza_mike: calls $2.50
*** FLOP *** [2d 5s 9c]
glanza_mike: checks 
chaps1988: checks 
*** TURN *** [2d 5s 9c] [3c]
glanza_mike: checks 
chaps1988: checks 
*** RIVER *** [2d 5s 9c 3c] [Qc]
glanza_mike: checks 
chaps1988: checks 
*** SHOW DOWN ***
glanza_mike: shows [3s As] (a pair of Threes)
chaps1988: mucks hand 
glanza_mike collected $9.50 from pot
*** SUMMARY ***
Total pot $10 | Rake $0.50 
Board [2d 5s 9c 3c Qc]
Seat 1: gabi_igna folded before Flop (didn't bet)
Seat 2: nickreason17 folded before Flop (didn't bet)
Seat 3: chaps1988 mucked [Ah Jd]
Seat 4: Kukuryzka (button) folded before Flop (didn't bet)
Seat 5: Nuskatko1986 (small blind) folded before Flop
Seat 6: glanza_mike (big blind) showed [3s As] and won ($9.50) with a pair of Threes
Seat 7: matiko09 folded before Flop (didn't bet)
Seat 8: Painkiller72 folded before Flop (didn't bet)
Seat 9: T0ny Adams folded before Flop (didn't bet)





PokerStars Hand #152885057279:  Hold'em No Limit ($0.50/$1.00 USD) - 2016/05/05 16:07:35 CET [2016/05/05 10:07:35 ET]
Table 'Musa II' 9-max Seat #4 is the button
Seat 1: KovIFish89 ($191.97 in chips) 
Seat 2: koutani7 ($75.50 in chips) 
Seat 3: vrnMike ($105.88 in chips) 
Seat 4: sanpidk ($100 in chips) 
Seat 5: Chin41178 ($86.91 in chips) 
Seat 6: cnn123 ($88.02 in chips) 
Seat 8: matiko09 ($108.62 in chips) 
Seat 9: FroggyPlay ($100 in chips) 
Chin41178: posts small blind $0.50
cnn123: posts big blind $1
plaindaft1: sits out 
*** HOLE CARDS ***
Dealt to matiko09 [Qd 6s]
matiko09: folds 
FroggyPlay: folds 
KovIFish89: folds 
koutani7: raises $2 to $3
vrnMike: folds 
sanpidk: folds 
Chin41178: folds 
cnn123: folds 
Uncalled bet ($2) returned to koutani7
koutani7 collected $2.50 from pot
koutani7: doesn't show hand 
*** SUMMARY ***
Total pot $2.50 | Rake $0 
Seat 1: KovIFish89 folded before Flop (didn't bet)
Seat 2: koutani7 collected ($2.50)
Seat 3: vrnMike folded before Flop (didn't bet)
Seat 4: sanpidk (button) folded before Flop (didn't bet)
Seat 5: Chin41178 (small blind) folded before Flop
Seat 6: cnn123 (big blind) folded before Flop
Seat 8: matiko09 folded before Flop (didn't bet)
Seat 9: FroggyPlay folded before Flop (didn't bet)





PokerStars Hand #152885059508:  Hold'em No Limit ($0.50/$1.00 USD) - 2016/05/05 16:07:39 CET [2016/05/05 10:07:39 ET]
Table 'Priska II' 9-max Seat #8 is the button
Seat 1: sanpidk ($100 in chips) 
Seat 2: Kukuryzka ($128.02 in chips) 
Seat 3: matiko09 ($103.50 in chips) 
Seat 5: Mr.Iraq007 ($101.50 in chips) 
Seat 7: stockbridge8 ($86.27 in chips) 
Seat 8: janarr5 ($100 in chips) 
Seat 9: torkkdnm ($100 in chips) 
torkkdnm: posts small blind $0.50
sanpidk: posts big blind $1
mycka86: sits out 
JorgeAndino: sits out 
*** HOLE CARDS ***
Dealt to matiko09 [7d 4d]
Kukuryzka: folds 
Kukuryzka leaves the table
nickreason17 joins the table at seat #2 
matiko09: folds 
Mr.Iraq007: folds 
stockbridge8: folds 
janarr5: folds 
torkkdnm: folds 
Uncalled bet ($0.50) returned to sanpidk
sanpidk collected $1 from pot
sanpidk: doesn't show hand 
*** SUMMARY ***
Total pot $1 | Rake $0 
Seat 1: sanpidk (big blind) collected ($1)
Seat 2: Kukuryzka folded before Flop (didn't bet)
Seat 3: matiko09 folded before Flop (didn't bet)
Seat 5: Mr.Iraq007 folded before Flop (didn't bet)
Seat 7: stockbridge8 folded before Flop (didn't bet)
Seat 8: janarr5 (button) folded before Flop (didn't bet)
Seat 9: torkkdnm (small blind) folded before Flop





PokerStars Hand #152885066027:  Hold'em No Limit ($0.50/$1.00 USD) - 2016/05/05 16:07:50 CET [2016/05/05 10:07:50 ET]
Table 'Musa II' 9-max Seat #5 is the button
Seat 1: KovIFish89 ($191.97 in chips) 
Seat 2: koutani7 ($77 in chips) 
Seat 3: vrnMike ($105.88 in chips) 
Seat 4: sanpidk ($100 in chips) 
Seat 5: Chin41178 ($86.41 in chips) 
Seat 6: cnn123 ($87.02 in chips) 
Seat 7: plaindaft1 ($100 in chips) 
Seat 8: matiko09 ($108.62 in chips) 
Seat 9: FroggyPlay ($100 in chips) 
cnn123: posts small blind $0.50
plaindaft1: posts big blind $1
*** HOLE CARDS ***
Dealt to matiko09 [6d 9h]
matiko09: folds 
FroggyPlay: folds 
KovIFish89: folds 
koutani7: folds 
vrnMike: folds 
sanpidk: raises $1.50 to $2.50
Chin41178: folds 
cnn123: folds 
plaindaft1: calls $1.50
*** FLOP *** [7d Tc Ac]
plaindaft1: checks 
sanpidk: bets $3.50
plaindaft1: folds 
Uncalled bet ($3.50) returned to sanpidk
sanpidk collected $5.22 from pot
sanpidk: doesn't show hand 
*** SUMMARY ***
Total pot $5.50 | Rake $0.28 
Board [7d Tc Ac]
Seat 1: KovIFish89 folded before Flop (didn't bet)
Seat 2: koutani7 folded before Flop (didn't bet)
Seat 3: vrnMike folded before Flop (didn't bet)
Seat 4: sanpidk collected ($5.22)
Seat 5: Chin41178 (button) folded before Flop (didn't bet)
Seat 6: cnn123 (small blind) folded before Flop
Seat 7: plaindaft1 (big blind) folded on the Flop
Seat 8: matiko09 folded before Flop (didn't bet)
Seat 9: FroggyPlay folded before Flop (didn't bet)





PokerStars Hand #152885069154:  Hold'em No Limit ($0.50/$1.00 USD) - 2016/05/05 16:07:55 CET [2016/05/05 10:07:55 ET]
Table 'Luthera' 9-max Seat #9 is the button
Seat 1: MrMattkk ($95.49 in chips) 
Seat 2: Kukuryzka ($100 in chips) 
Seat 4: matiko09 ($111.48 in chips) 
Seat 5: Painkiller72 ($100 in chips) 
Seat 6: Dantist1122 ($100 in chips) 
Seat 7: Chin41178 ($103.46 in chips) 
Seat 8: xdrKush420x ($94.46 in chips) 
Seat 9: vrnMike ($113.60 in chips) 
MrMattkk: posts small blind $0.50
Kukuryzka: posts big blind $1
sanpidk: sits out 
*** HOLE CARDS ***
Dealt to matiko09 [Jc 2d]
matiko09: folds 
Painkiller72: folds 
Dantist1122: folds 
Chin41178: folds 
xdrKush420x: raises $2 to $3
vrnMike: folds 
MrMattkk: calls $2.50
Kukuryzka: calls $2
*** FLOP *** [3c 7d 9d]
MrMattkk: bets $3
Kukuryzka: calls $3
xdrKush420x: calls $3
*** TURN *** [3c 7d 9d] [Qc]
MrMattkk: checks 
Kukuryzka: checks 
xdrKush420x: bets $6.15
MrMattkk: folds 
Kukuryzka: folds 
Uncalled bet ($6.15) returned to xdrKush420x
xdrKush420x collected $17.10 from pot
*** SUMMARY ***
Total pot $18 | Rake $0.90 
Board [3c 7d 9d Qc]
Seat 1: MrMattkk (small blind) folded on the Turn
Seat 2: Kukuryzka (big blind) folded on the Turn
Seat 4: matiko09 folded before Flop (didn't bet)
Seat 5: Painkiller72 folded before Flop (didn't bet)
Seat 6: Dantist1122 folded before Flop (didn't bet)
Seat 7: Chin41178 folded before Flop (didn't bet)
Seat 8: xdrKush420x collected ($17.10)
Seat 9: vrnMike (button) folded before Flop (didn't bet)





PokerStars Hand #152885077611:  Hold'em No Limit ($1/$2 USD) - 2016/05/05 16:08:10 CET [2016/05/05 10:08:10 ET]
Table 'Tololo' 9-max Seat #6 is the button
Seat 4: mooose100 ($165.03 in chips) 
Seat 5: matiko09 ($202.61 in chips) 
Seat 6: Xagua ($244 in chips) 
Seat 7: chaps1988 ($223.60 in chips) 
Seat 8: KovIFish89 ($200 in chips) 
Seat 9: Fitzyferret ($341.72 in chips) 
chaps1988: posts small blind $1
KovIFish89: posts big blind $2
Kukuryzka: sits out 
gabi_igna: sits out 
*** HOLE CARDS ***
Dealt to matiko09 [7h Ah]
Fitzyferret: folds 
mooose100: calls $2
matiko09: raises $6 to $8
Xagua: folds 
chaps1988: raises $18 to $26
KovIFish89: folds 
mooose100: folds 
matiko09: folds 
Uncalled bet ($18) returned to chaps1988
chaps1988 collected $20 from pot
*** SUMMARY ***
Total pot $20 | Rake $0 
Seat 4: mooose100 folded before Flop
Seat 5: matiko09 folded before Flop
Seat 6: Xagua (button) folded before Flop (didn't bet)
Seat 7: chaps1988 (small blind) collected ($20)
Seat 8: KovIFish89 (big blind) folded before Flop
Seat 9: Fitzyferret folded before Flop (didn't bet)





PokerStars Hand #152885081206:  Hold'em No Limit ($0.50/$1.00 USD) - 2016/05/05 16:08:16 CET [2016/05/05 10:08:16 ET]
Table 'Vela' 9-max Seat #4 is the button
Seat 1: mycka86 ($104.50 in chips) 
Seat 2: nickreason17 ($207.09 in chips) 
Seat 3: dviryo ($452.32 in chips) 
Seat 4: Hayer ana ($99.50 in chips) 
Seat 5: sanpidk ($100 in chips) 
Seat 6: matiko09 ($100 in chips) 
Seat 7: KovIFish89 ($106.38 in chips) 
Seat 8: vrnMike ($100 in chips) 
Seat 9: CI58 ($100 in chips) 
sanpidk: posts small blind $0.50
matiko09: posts big blind $1
*** HOLE CARDS ***
Dealt to matiko09 [8c 3c]
KovIFish89: folds 
vrnMike: folds 
CI58: folds 
mycka86: folds 
nickreason17: folds 
dviryo has timed out
dviryo: folds 
Hayer ana: folds 
sanpidk: raises $1.50 to $2.50
matiko09: folds 
Uncalled bet ($1.50) returned to sanpidk
sanpidk collected $2 from pot
sanpidk: doesn't show hand 
*** SUMMARY ***
Total pot $2 | Rake $0 
Seat 1: mycka86 folded before Flop (didn't bet)
Seat 2: nickreason17 folded before Flop (didn't bet)
Seat 3: dviryo folded before Flop (didn't bet)
Seat 4: Hayer ana (button) folded before Flop (didn't bet)
Seat 5: sanpidk (small blind) collected ($2)
Seat 6: matiko09 (big blind) folded before Flop
Seat 7: KovIFish89 folded before Flop (didn't bet)
Seat 8: vrnMike folded before Flop (didn't bet)
Seat 9: CI58 folded before Flop (didn't bet)





PokerStars Hand #152885082157:  Hold'em No Limit ($1/$2 USD) - 2016/05/05 16:08:18 CET [2016/05/05 10:08:18 ET]
Table 'Samitchell' 9-max Seat #3 is the button
Seat 1: KovIFish89 ($229.35 in chips) 
Seat 2: matiko09 ($214.04 in chips) 
Seat 3: gabi_igna ($317.87 in chips) 
Seat 4: Fitzyferret ($343.08 in chips) 
Seat 5: chaps1988 ($275.17 in chips) 
Seat 7: patpaty ($153.59 in chips) 
Seat 8: WolleMalone ($206.99 in chips) 
Seat 9: kblkxls ($112.07 in chips) 
Fitzyferret: posts small blind $1
chaps1988: posts big blind $2
Zhalgasai: sits out 
*** HOLE CARDS ***
Dealt to matiko09 [Qs As]
patpaty: folds 
WolleMalone: folds 
kblkxls: calls $2
KovIFish89: folds 
matiko09: raises $6 to $8
gabi_igna: folds 
Fitzyferret: raises $18.80 to $26.80
chaps1988: folds 
kblkxls: folds 
matiko09: calls $18.80
*** FLOP *** [Jc 5h 4h]
Fitzyferret: checks 
matiko09: checks 
*** TURN *** [Jc 5h 4h] [2c]
Fitzyferret: checks 
matiko09: checks 
*** RIVER *** [Jc 5h 4h 2c] [9d]
Fitzyferret: bets $38
matiko09: folds 
Uncalled bet ($38) returned to Fitzyferret
Fitzyferret collected $54.85 from pot
Fitzyferret: doesn't show hand 
*** SUMMARY ***
Total pot $57.60 | Rake $2.75 
Board [Jc 5h 4h 2c 9d]
Seat 1: KovIFish89 folded before Flop (didn't bet)
Seat 2: matiko09 folded on the River
Seat 3: gabi_igna (button) folded before Flop (didn't bet)
Seat 4: Fitzyferret (small blind) collected ($54.85)
Seat 5: chaps1988 (big blind) folded before Flop
Seat 7: patpaty folded before Flop (didn't bet)
Seat 8: WolleMalone folded before Flop (didn't bet)
Seat 9: kblkxls folded before Flop





PokerStars Hand #152885084727:  Hold'em No Limit ($0.50/$1.00 USD) - 2016/05/05 16:08:22 CET [2016/05/05 10:08:22 ET]
Table 'Pyxis III' 9-max Seat #5 is the button
Seat 1: sanpidk ($279.19 in chips) 
Seat 2: SPmaka ($108.02 in chips) 
Seat 3: vrnMike ($100 in chips) 
Seat 4: Sloeve ($122.24 in chips) 
Seat 5: darren1031 ($100.08 in chips) 
Seat 6: kamillo91 ($96.47 in chips) 
Seat 7: mycka86 ($100 in chips) 
Seat 8: matiko09 ($100.37 in chips) 
kamillo91: posts small blind $0.50
mycka86: posts big blind $1
maxxmeister: sits out 
*** HOLE CARDS ***
Dealt to matiko09 [2h 9h]
matiko09: folds 
sanpidk: folds 
SPmaka: folds 
vrnMike: folds 
Sloeve: folds 
darren1031: folds 
kamillo91: folds 
Uncalled bet ($0.50) returned to mycka86
mycka86 collected $1 from pot
*** SUMMARY ***
Total pot $1 | Rake $0 
Seat 1: sanpidk folded before Flop (didn't bet)
Seat 2: SPmaka folded before Flop (didn't bet)
Seat 3: vrnMike folded before Flop (didn't bet)
Seat 4: Sloeve folded before Flop (didn't bet)
Seat 5: darren1031 (button) folded before Flop (didn't bet)
Seat 6: kamillo91 (small blind) folded before Flop
Seat 7: mycka86 (big blind) collected ($1)
Seat 8: matiko09 folded before Flop (didn't bet)





PokerStars Hand #152885085318:  Hold'em No Limit ($1/$2 USD) - 2016/05/05 16:08:23 CET [2016/05/05 10:08:23 ET]
Table 'Lundia' 9-max Seat #1 is the button
Seat 1: Fitzyferret ($251.80 in chips) 
Seat 2: patpaty ($214.47 in chips) 
Seat 3: Painkiller72 ($200 in chips) 
Seat 4: KovIFish89 ($308.56 in chips) 
Seat 5: zmOe84 ($185.76 in chips) 
Seat 7: matiko09 ($240.11 in chips) 
Seat 9: gabi_igna ($240.61 in chips) 
patpaty: posts small blind $1
Painkiller72: posts big blind $2
CI58: sits out 
chaps1988: sits out 
*** HOLE CARDS ***
Dealt to matiko09 [Tc 9c]
KovIFish89: folds 
zmOe84: folds 
matiko09: raises $3 to $5
gabi_igna: folds 
Fitzyferret: folds 
patpaty: folds 
Painkiller72: raises $13 to $18
matiko09: folds 
Uncalled bet ($13) returned to Painkiller72
Painkiller72 collected $11 from pot
Painkiller72: doesn't show hand 
*** SUMMARY ***
Total pot $11 | Rake $0 
Seat 1: Fitzyferret (button) folded before Flop (didn't bet)
Seat 2: patpaty (small blind) folded before Flop
Seat 3: Painkiller72 (big blind) collected ($11)
Seat 4: KovIFish89 folded before Flop (didn't bet)
Seat 5: zmOe84 folded before Flop (didn't bet)
Seat 7: matiko09 folded before Flop
Seat 9: gabi_igna folded before Flop (didn't bet)





PokerStars Hand #152885092939:  Hold'em No Limit ($1/$2 USD) - 2016/05/05 16:08:36 CET [2016/05/05 10:08:36 ET]
Table 'Euporie II' 9-max Seat #5 is the button
Seat 1: gabi_igna ($200 in chips) 
Seat 2: nickreason17 ($200 in chips) 
Seat 3: chaps1988 ($200 in chips) 
Seat 4: Kukuryzka ($199 in chips) 
Seat 5: Nuskatko1986 ($64.61 in chips) 
Seat 6: glanza_mike ($209 in chips) 
Seat 7: matiko09 ($205.04 in chips) 
Seat 8: Painkiller72 ($306.25 in chips) 
Seat 9: T0ny Adams ($92.91 in chips) 
glanza_mike: posts small blind $1
matiko09: posts big blind $2
*** HOLE CARDS ***
Dealt to matiko09 [Tc Td]
Painkiller72: folds 
T0ny Adams: folds 
gabi_igna: folds 
nickreason17: folds 
chaps1988: folds 
Kukuryzka: folds 
Nuskatko1986: calls $2
glanza_mike: raises $5 to $7
matiko09: calls $5
Nuskatko1986: folds 
*** FLOP *** [8d 6s Qh]
glanza_mike: checks 
matiko09: bets $9.88
glanza_mike: folds 
Uncalled bet ($9.88) returned to matiko09
matiko09 collected $15.20 from pot
matiko09: doesn't show hand 
*** SUMMARY ***
Total pot $16 | Rake $0.80 
Board [8d 6s Qh]
Seat 1: gabi_igna folded before Flop (didn't bet)
Seat 2: nickreason17 folded before Flop (didn't bet)
Seat 3: chaps1988 folded before Flop (didn't bet)
Seat 4: Kukuryzka folded before Flop (didn't bet)
Seat 5: Nuskatko1986 (button) folded before Flop
Seat 6: glanza_mike (small blind) folded on the Flop
Seat 7: matiko09 (big blind) collected ($15.20)
Seat 8: Painkiller72 folded before Flop (didn't bet)
Seat 9: T0ny Adams folded before Flop (didn't bet)





PokerStars Hand #152885099147:  Hold'em No Limit ($0.50/$1.00 USD) - 2016/05/05 16:08:46 CET [2016/05/05 10:08:46 ET]
Table 'Pyxis III' 9-max Seat #6 is the button
Seat 1: sanpidk ($279.19 in chips) 
Seat 2: SPmaka ($108.02 in chips) 
Seat 3: vrnMike ($100 in chips) 
Seat 4: Sloeve ($122.24 in chips) 
Seat 5: darren1031 ($100.08 in chips) 
Seat 6: kamillo91 ($95.97 in chips) 
Seat 7: mycka86 ($100.50 in chips) 
Seat 8: matiko09 ($100.37 in chips) 
mycka86: posts small blind $0.50
matiko09: posts big blind $1
maxxmeister: sits out 
*** HOLE CARDS ***
Dealt to matiko09 [5d 9d]
sanpidk: folds 
SPmaka: folds 
vrnMike: raises $1 to $2
Sloeve: folds 
darren1031: folds 
kamillo91: folds 
mycka86: folds 
matiko09: folds 
Uncalled bet ($1) returned to vrnMike
vrnMike collected $2.50 from pot
*** SUMMARY ***
Total pot $2.50 | Rake $0 
Seat 1: sanpidk folded before Flop (didn't bet)
Seat 2: SPmaka folded before Flop (didn't bet)
Seat 3: vrnMike collected ($2.50)
Seat 4: Sloeve folded before Flop (didn't bet)
Seat 5: darren1031 folded before Flop (didn't bet)
Seat 6: kamillo91 (button) folded before Flop (didn't bet)
Seat 7: mycka86 (small blind) folded before Flop
Seat 8: matiko09 (big blind) folded before Flop





PokerStars Hand #152885100101:  Hold'em No Limit ($0.50/$1.00 USD) - 2016/05/05 16:08:48 CET [2016/05/05 10:08:48 ET]
Table 'Musa II' 9-max Seat #6 is the button
Seat 1: KovIFish89 ($191.97 in chips) 
Seat 2: koutani7 ($77 in chips) 
Seat 3: vrnMike ($105.88 in chips) 
Seat 4: sanpidk ($102.72 in chips) 
Seat 5: Chin41178 ($86.41 in chips) 
Seat 6: cnn123 ($86.52 in chips) 
Seat 7: plaindaft1 ($97.50 in chips) 
Seat 8: matiko09 ($108.62 in chips) 
Seat 9: FroggyPlay ($100 in chips) 
plaindaft1: posts small blind $0.50
matiko09: posts big blind $1
*** HOLE CARDS ***
Dealt to matiko09 [9h 4h]
FroggyPlay: folds 
KovIFish89: folds 
koutani7: raises $2 to $3
vrnMike: raises $6 to $9
sanpidk: folds 
Chin41178: calls $9
cnn123: folds 
plaindaft1: folds 
matiko09: folds 
koutani7: folds 
*** FLOP *** [Jc 3h 3c]
vrnMike: bets $13.50
Chin41178: calls $13.50
*** TURN *** [Jc 3h 3c] [Kd]
vrnMike: bets $18
Chin41178: raises $21 to $39
vrnMike: raises $44.38 to $83.38 and is all-in
Chin41178: calls $24.91 and is all-in
Uncalled bet ($19.47) returned to vrnMike
*** FIRST RIVER *** [Jc 3h 3c Kd] [Qd]
*** SECOND RIVER *** [Jc 3h 3c Kd] [Tc]
*** FIRST SHOW DOWN ***
vrnMike: shows [Ac Ad] (two pair, Aces and Threes)
Chin41178: shows [Td Jd] (two pair, Jacks and Threes)
vrnMike collected $87.41 from pot
*** SECOND SHOW DOWN ***
vrnMike: shows [Ac Ad] (two pair, Aces and Threes)
Chin41178: shows [Td Jd] (two pair, Jacks and Tens)
vrnMike collected $87.41 from pot
*** SUMMARY ***
Total pot $177.32 | Rake $2.50 
Hand was run twice
FIRST Board [Jc 3h 3c Kd Qd]
SECOND Board [Jc 3h 3c Kd Tc]
Seat 1: KovIFish89 folded before Flop (didn't bet)
Seat 2: koutani7 folded before Flop
Seat 3: vrnMike showed [Ac Ad] and won ($87.41) with two pair, Aces and Threes, and won ($87.41) with two pair, Aces and Threes
Seat 4: sanpidk folded before Flop (didn't bet)
Seat 5: Chin41178 showed [Td Jd] and lost with two pair, Jacks and Threes, and lost with two pair, Jacks and Tens
Seat 6: cnn123 (button) folded before Flop (didn't bet)
Seat 7: plaindaft1 (small blind) folded before Flop
Seat 8: matiko09 (big blind) folded before Flop
Seat 9: FroggyPlay folded before Flop (didn't bet)





PokerStars Hand #152885101332:  Hold'em No Limit ($1/$2 USD) - 2016/05/05 16:08:50 CET [2016/05/05 10:08:50 ET]
Table 'Tololo' 9-max Seat #7 is the button
Seat 4: mooose100 ($163.03 in chips) 
Seat 5: matiko09 ($200 in chips) 
Seat 6: Xagua ($244 in chips) 
Seat 7: chaps1988 ($235.60 in chips) 
Seat 8: KovIFish89 ($200 in chips) 
Seat 9: Fitzyferret ($341.72 in chips) 
KovIFish89: posts small blind $1
Fitzyferret: posts big blind $2
Kukuryzka: sits out 
gabi_igna: sits out 
*** HOLE CARDS ***
Dealt to matiko09 [Th Js]
mooose100: calls $2
matiko09: raises $6 to $8
Xagua: folds 
chaps1988: folds 
KovIFish89: folds 
Fitzyferret: folds 
mooose100: calls $6
*** FLOP *** [7h Ah Ks]
mooose100: checks 
matiko09: bets $10
mooose100: calls $10
*** TURN *** [7h Ah Ks] [Td]
mooose100: checks 
matiko09: checks 
*** RIVER *** [7h Ah Ks Td] [Jd]
mooose100: checks 
matiko09: bets $10
mooose100: calls $10
*** SHOW DOWN ***
matiko09: shows [Th Js] (two pair, Jacks and Tens)
mooose100: shows [Jh Ad] (two pair, Aces and Jacks)
mooose100 collected $56.25 from pot
*** SUMMARY ***
Total pot $59 | Rake $2.75 
Board [7h Ah Ks Td Jd]
Seat 4: mooose100 showed [Jh Ad] and won ($56.25) with two pair, Aces and Jacks
Seat 5: matiko09 showed [Th Js] and lost with two pair, Jacks and Tens
Seat 6: Xagua folded before Flop (didn't bet)
Seat 7: chaps1988 (button) folded before Flop (didn't bet)
Seat 8: KovIFish89 (small blind) folded before Flop
Seat 9: Fitzyferret (big blind) folded before Flop





PokerStars Hand #152885104635:  Hold'em No Limit ($1/$2 USD) - 2016/05/05 16:08:55 CET [2016/05/05 10:08:55 ET]
Table 'Lundia' 9-max Seat #2 is the button
Seat 1: Fitzyferret ($251.80 in chips) 
Seat 2: patpaty ($213.47 in chips) 
Seat 3: Painkiller72 ($206 in chips) 
Seat 4: KovIFish89 ($308.56 in chips) 
Seat 5: zmOe84 ($185.76 in chips) 
Seat 7: matiko09 ($235.11 in chips) 
Seat 9: gabi_igna ($240.61 in chips) 
Painkiller72: posts small blind $1
KovIFish89: posts big blind $2
CI58: sits out 
chaps1988: sits out 
*** HOLE CARDS ***
Dealt to matiko09 [2h 4d]
zmOe84: folds 
matiko09: folds 
gabi_igna: folds 
Fitzyferret: raises $2.60 to $4.60
patpaty: raises $2.60 to $7.20
Painkiller72: calls $6.20
KovIFish89: folds 
Fitzyferret: calls $2.60
*** FLOP *** [Jh Tc 2s]
Painkiller72: checks 
Fitzyferret: checks 
patpaty: bets $10
Painkiller72: calls $10
Fitzyferret: folds 
*** TURN *** [Jh Tc 2s] [9h]
Painkiller72: checks 
patpaty: bets $10
Painkiller72: calls $10
*** RIVER *** [Jh Tc 2s 9h] [Kh]
Painkiller72: checks 
patpaty: bets $10
Painkiller72: raises $50 to $60
patpaty: folds 
Uncalled bet ($50) returned to Painkiller72
Painkiller72 collected $80.85 from pot
Painkiller72: doesn't show hand 
*** SUMMARY ***
Total pot $83.60 | Rake $2.75 
Board [Jh Tc 2s 9h Kh]
Seat 1: Fitzyferret folded on the Flop
Seat 2: patpaty (button) folded on the River
Seat 3: Painkiller72 (small blind) collected ($80.85)
Seat 4: KovIFish89 (big blind) folded before Flop
Seat 5: zmOe84 folded before Flop (didn't bet)
Seat 7: matiko09 folded before Flop (didn't bet)
Seat 9: gabi_igna folded before Flop (didn't bet)





PokerStars Hand #152885110183:  Hold'em No Limit ($0.50/$1.00 USD) - 2016/05/05 16:09:05 CET [2016/05/05 10:09:05 ET]
Table 'Vela' 9-max Seat #5 is the button
Seat 1: mycka86 ($104.50 in chips) 
Seat 2: nickreason17 ($207.09 in chips) 
Seat 3: dviryo ($452.32 in chips) 
Seat 4: Hayer ana ($99.50 in chips) 
Seat 5: sanpidk ($101 in chips) 
Seat 6: matiko09 ($100 in chips) 
Seat 7: KovIFish89 ($106.38 in chips) 
Seat 8: vrnMike ($100 in chips) 
Seat 9: CI58 ($100 in chips) 
matiko09: posts small blind $0.50
KovIFish89: posts big blind $1
*** HOLE CARDS ***
Dealt to matiko09 [6d 9d]
vrnMike: folds 
CI58: folds 
mycka86: folds 
nickreason17: folds 
dviryo: raises $1 to $2
Hayer ana: folds 
sanpidk: folds 
matiko09: folds 
KovIFish89: folds 
Uncalled bet ($1) returned to dviryo
dviryo collected $2.50 from pot
*** SUMMARY ***
Total pot $2.50 | Rake $0 
Seat 1: mycka86 folded before Flop (didn't bet)
Seat 2: nickreason17 folded before Flop (didn't bet)
Seat 3: dviryo collected ($2.50)
Seat 4: Hayer ana folded before Flop (didn't bet)
Seat 5: sanpidk (button) folded before Flop (didn't bet)
Seat 6: matiko09 (small blind) folded before Flop
Seat 7: KovIFish89 (big blind) folded before Flop
Seat 8: vrnMike folded before Flop (didn't bet)
Seat 9: CI58 folded before Flop (didn't bet)





PokerStars Hand #152885116956:  Hold'em No Limit ($0.50/$1.00 USD) - 2016/05/05 16:09:16 CET [2016/05/05 10:09:16 ET]
Table 'Pyxis III' 9-max Seat #7 is the button
Seat 1: sanpidk ($279.19 in chips) 
Seat 2: SPmaka ($108.02 in chips) 
Seat 3: vrnMike ($101.50 in chips) 
Seat 4: Sloeve ($122.24 in chips) 
Seat 5: darren1031 ($100.08 in chips) 
Seat 6: kamillo91 ($95.97 in chips) 
Seat 7: mycka86 ($100 in chips) 
Seat 8: matiko09 ($100 in chips) 
Seat 9: maxxmeister ($100 in chips) 
matiko09: posts small blind $0.50
maxxmeister: posts big blind $1
*** HOLE CARDS ***
Dealt to matiko09 [Qc Ah]
sanpidk: raises $2 to $3
SPmaka: folds 
vrnMike: folds 
Sloeve: folds 
darren1031: calls $3
kamillo91: calls $3
mycka86: folds 
matiko09: raises $12 to $15
maxxmeister: folds 
sanpidk: folds 
darren1031: raises $17 to $32
kamillo91: folds 
matiko09: folds 
Uncalled bet ($17) returned to darren1031
darren1031 collected $37 from pot
*** SUMMARY ***
Total pot $37 | Rake $0 
Seat 1: sanpidk folded before Flop
Seat 2: SPmaka folded before Flop (didn't bet)
Seat 3: vrnMike folded before Flop (didn't bet)
Seat 4: Sloeve folded before Flop (didn't bet)
Seat 5: darren1031 collected ($37)
Seat 6: kamillo91 folded before Flop
Seat 7: mycka86 (button) folded before Flop (didn't bet)
Seat 8: matiko09 (small blind) folded before Flop
Seat 9: maxxmeister (big blind) folded before Flop





PokerStars Hand #152885120033:  Hold'em No Limit ($0.50/$1.00 USD) - 2016/05/05 16:09:21 CET [2016/05/05 10:09:21 ET]
Table 'Luthera' 9-max Seat #1 is the button
Seat 1: MrMattkk ($89.49 in chips) 
Seat 2: Kukuryzka ($100 in chips) 
Seat 3: sanpidk ($100 in chips) 
Seat 4: matiko09 ($111.48 in chips) 
Seat 5: Painkiller72 ($100 in chips) 
Seat 6: Dantist1122 ($100 in chips) 
Seat 7: Chin41178 ($103.46 in chips) 
Seat 8: xdrKush420x ($105.56 in chips) 
Seat 9: vrnMike ($113.60 in chips) 
Kukuryzka: posts small blind $0.50
sanpidk: posts big blind $1
*** HOLE CARDS ***
Dealt to matiko09 [8d Kd]
matiko09: folds 
Painkiller72: raises $1.50 to $2.50
Dantist1122: folds 
Chin41178: folds 
xdrKush420x: folds 
vrnMike: folds 
MrMattkk: raises $4.50 to $7
Kukuryzka: folds 
sanpidk: folds 
Painkiller72: raises $13 to $20
MrMattkk: folds 
Uncalled bet ($13) returned to Painkiller72
Painkiller72 collected $15.50 from pot
Painkiller72: doesn't show hand 
*** SUMMARY ***
Total pot $15.50 | Rake $0 
Seat 1: MrMattkk (button) folded before Flop
Seat 2: Kukuryzka (small blind) folded before Flop
Seat 3: sanpidk (big blind) folded before Flop
Seat 4: matiko09 folded before Flop (didn't bet)
Seat 5: Painkiller72 collected ($15.50)
Seat 6: Dantist1122 folded before Flop (didn't bet)
Seat 7: Chin41178 folded before Flop (didn't bet)
Seat 8: xdrKush420x folded before Flop (didn't bet)
Seat 9: vrnMike folded before Flop (didn't bet)





PokerStars Hand #152885123780:  Hold'em No Limit ($1/$2 USD) - 2016/05/05 16:09:28 CET [2016/05/05 10:09:28 ET]
Table 'Tatry II' 9-max Seat #4 is the button
Seat 1: glanza_mike ($248.17 in chips) 
Seat 2: T0ny Adams ($86.40 in chips) 
Seat 3: matiko09 ($200 in chips) 
Seat 4: WolleMalone ($200 in chips) 
Seat 5: Painkiller72 ($345.68 in chips) 
Seat 6: Kukuryzka ($206.35 in chips) 
Seat 7: nickreason17 ($200 in chips) 
Seat 8: chaps1988 ($200 in chips) 
Painkiller72: posts small blind $1
Kukuryzka: posts big blind $2
*** HOLE CARDS ***
Dealt to matiko09 [Qh Js]
nickreason17: folds 
chaps1988: folds 
glanza_mike: folds 
T0ny Adams: folds 
korol702 leaves the table
nickreason17 leaves the table
matiko09: raises $3 to $5
WolleMalone: folds 
Painkiller72: folds 
gabi_igna joins the table at seat #7 
Kukuryzka: folds 
Uncalled bet ($3) returned to matiko09
matiko09 collected $5 from pot
matiko09: doesn't show hand 
*** SUMMARY ***
Total pot $5 | Rake $0 
Seat 1: glanza_mike folded before Flop (didn't bet)
Seat 2: T0ny Adams folded before Flop (didn't bet)
Seat 3: matiko09 collected ($5)
Seat 4: WolleMalone (button) folded before Flop (didn't bet)
Seat 5: Painkiller72 (small blind) folded before Flop
Seat 6: Kukuryzka (big blind) folded before Flop
Seat 7: nickreason17 folded before Flop (didn't bet)
Seat 8: chaps1988 folded before Flop (didn't bet)





PokerStars Hand #152885128936:  Hold'em No Limit ($0.50/$1.00 USD) - 2016/05/05 16:09:37 CET [2016/05/05 10:09:37 ET]
Table 'Vela' 9-max Seat #6 is the button
Seat 1: mycka86 ($104.50 in chips) 
Seat 2: nickreason17 ($207.09 in chips) 
Seat 3: dviryo ($453.82 in chips) 
Seat 4: Hayer ana ($99.50 in chips) 
Seat 5: sanpidk ($101 in chips) 
Seat 6: matiko09 ($100 in chips) 
Seat 7: KovIFish89 ($105.38 in chips) 
Seat 8: vrnMike ($100 in chips) 
Seat 9: CI58 ($100 in chips) 
KovIFish89: posts small blind $0.50
vrnMike: posts big blind $1
*** HOLE CARDS ***
Dealt to matiko09 [Jh 2d]
CI58: raises $2 to $3
mycka86: folds 
nickreason17: folds 
dviryo: folds 
Hayer ana: folds 
sanpidk: folds 
matiko09: folds 
KovIFish89: folds 
vrnMike: folds 
Uncalled bet ($2) returned to CI58
CI58 collected $2.50 from pot
CI58: doesn't show hand 
*** SUMMARY ***
Total pot $2.50 | Rake $0 
Seat 1: mycka86 folded before Flop (didn't bet)
Seat 2: nickreason17 folded before Flop (didn't bet)
Seat 3: dviryo folded before Flop (didn't bet)
Seat 4: Hayer ana folded before Flop (didn't bet)
Seat 5: sanpidk folded before Flop (didn't bet)
Seat 6: matiko09 (button) folded before Flop (didn't bet)
Seat 7: KovIFish89 (small blind) folded before Flop
Seat 8: vrnMike (big blind) folded before Flop
Seat 9: CI58 collected ($2.50)





PokerStars Hand #152885129656:  Hold'em No Limit ($1/$2 USD) - 2016/05/05 16:09:38 CET [2016/05/05 10:09:38 ET]
Table 'Euporie II' 9-max Seat #6 is the button
Seat 1: gabi_igna ($200 in chips) 
Seat 2: nickreason17 ($200 in chips) 
Seat 3: chaps1988 ($200 in chips) 
Seat 4: Kukuryzka ($199 in chips) 
Seat 5: Nuskatko1986 ($62.61 in chips) 
Seat 6: glanza_mike ($202 in chips) 
Seat 7: matiko09 ($213.24 in chips) 
Seat 8: Painkiller72 ($306.25 in chips) 
Seat 9: T0ny Adams ($92.91 in chips) 
matiko09: posts small blind $1
Painkiller72: posts big blind $2
*** HOLE CARDS ***
Dealt to matiko09 [Jh Ks]
T0ny Adams: folds 
gabi_igna: folds 
nickreason17: folds 
chaps1988: folds 
Kukuryzka: folds 
Nuskatko1986: folds 
glanza_mike: folds 
matiko09: raises $3 to $5
Painkiller72: calls $3
*** FLOP *** [Kc Kd 8d]
matiko09: bets $6.18
Painkiller72: folds 
Uncalled bet ($6.18) returned to matiko09
matiko09 collected $9.50 from pot
matiko09: doesn't show hand 
*** SUMMARY ***
Total pot $10 | Rake $0.50 
Board [Kc Kd 8d]
Seat 1: gabi_igna folded before Flop (didn't bet)
Seat 2: nickreason17 folded before Flop (didn't bet)
Seat 3: chaps1988 folded before Flop (didn't bet)
Seat 4: Kukuryzka folded before Flop (didn't bet)
Seat 5: Nuskatko1986 folded before Flop (didn't bet)
Seat 6: glanza_mike (button) folded before Flop (didn't bet)
Seat 7: matiko09 (small blind) collected ($9.50)
Seat 8: Painkiller72 (big blind) folded on the Flop
Seat 9: T0ny Adams folded before Flop (didn't bet)





PokerStars Hand #152885140676:  Hold'em No Limit ($0.50/$1.00 USD) - 2016/05/05 16:09:56 CET [2016/05/05 10:09:56 ET]
Table 'Musa II' 9-max Seat #7 is the button
Seat 1: KovIFish89 ($191.97 in chips) 
Seat 2: koutani7 ($74 in chips) 
Seat 3: vrnMike ($194.29 in chips) 
Seat 4: sanpidk ($102.72 in chips) 
Seat 6: cnn123 ($86.52 in chips) 
Seat 7: plaindaft1 ($97 in chips) 
Seat 8: matiko09 ($107.62 in chips) 
Seat 9: FroggyPlay ($100 in chips) 
matiko09: posts small blind $0.50
FroggyPlay: posts big blind $1
*** HOLE CARDS ***
Dealt to matiko09 [2s Qs]
Chin41178 leaves the table
KovIFish89: folds 
St.LaCoste joins the table at seat #5 
koutani7: folds 
vrnMike: raises $1 to $2
sanpidk: folds 
cnn123: folds 
plaindaft1: calls $2
matiko09: folds 
FroggyPlay: calls $1
*** FLOP *** [5h Qd Jd]
FroggyPlay: checks 
vrnMike: checks 
plaindaft1: checks 
*** TURN *** [5h Qd Jd] [3c]
FroggyPlay: checks 
vrnMike: checks 
plaindaft1: checks 
*** RIVER *** [5h Qd Jd 3c] [Ks]
FroggyPlay: checks 
vrnMike: checks 
plaindaft1: bets $6.18
St.LaCoste leaves the table
Hayer ana joins the table at seat #5 
FroggyPlay: folds 
Hayer ana leaves the table
vrnMike: folds 
Uncalled bet ($6.18) returned to plaindaft1
plaindaft1 collected $6.18 from pot
plaindaft1: doesn't show hand 
*** SUMMARY ***
Total pot $6.50 | Rake $0.32 
Board [5h Qd Jd 3c Ks]
Seat 1: KovIFish89 folded before Flop (didn't bet)
Seat 2: koutani7 folded before Flop (didn't bet)
Seat 3: vrnMike folded on the River
Seat 4: sanpidk folded before Flop (didn't bet)
Seat 6: cnn123 folded before Flop (didn't bet)
Seat 7: plaindaft1 (button) collected ($6.18)
Seat 8: matiko09 (small blind) folded before Flop
Seat 9: FroggyPlay (big blind) folded on the River





PokerStars Hand #152885144667:  Hold'em No Limit ($0.50/$1.00 USD) - 2016/05/05 16:10:03 CET [2016/05/05 10:10:03 ET]
Table 'Vela' 9-max Seat #7 is the button
Seat 1: mycka86 ($104.50 in chips) 
Seat 2: nickreason17 ($207.09 in chips) 
Seat 3: dviryo ($453.82 in chips) 
Seat 4: Hayer ana ($99.50 in chips) 
Seat 5: sanpidk ($101 in chips) 
Seat 6: matiko09 ($100 in chips) 
Seat 7: KovIFish89 ($104.88 in chips) 
Seat 8: vrnMike ($100 in chips) 
Seat 9: CI58 ($101.50 in chips) 
vrnMike: posts small blind $0.50
CI58: posts big blind $1
*** HOLE CARDS ***
Dealt to matiko09 [Qs 9h]
mycka86: folds 
nickreason17: folds 
dviryo: raises $2 to $3
Hayer ana: folds 
sanpidk: folds 
matiko09: folds 
KovIFish89: folds 
vrnMike: folds 
CI58: calls $2
*** FLOP *** [5s Ts 5d]
CI58: checks 
dviryo: checks 
*** TURN *** [5s Ts 5d] [8s]
CI58: checks 
dviryo: checks 
*** RIVER *** [5s Ts 5d 8s] [6h]
CI58: checks 
dviryo: checks 
*** SHOW DOWN ***
CI58: shows [3d 3c] (two pair, Fives and Threes)
dviryo: mucks hand 
CI58 collected $6.18 from pot
*** SUMMARY ***
Total pot $6.50 | Rake $0.32 
Board [5s Ts 5d 8s 6h]
Seat 1: mycka86 folded before Flop (didn't bet)
Seat 2: nickreason17 folded before Flop (didn't bet)
Seat 3: dviryo mucked [Jd Ah]
Seat 4: Hayer ana folded before Flop (didn't bet)
Seat 5: sanpidk folded before Flop (didn't bet)
Seat 6: matiko09 folded before Flop (didn't bet)
Seat 7: KovIFish89 (button) folded before Flop (didn't bet)
Seat 8: vrnMike (small blind) folded before Flop
Seat 9: CI58 (big blind) showed [3d 3c] and won ($6.18) with two pair, Fives and Threes





PokerStars Hand #152885152388:  Hold'em No Limit ($1/$2 USD) - 2016/05/05 16:10:16 CET [2016/05/05 10:10:16 ET]
Table 'Tatry II' 9-max Seat #5 is the button
Seat 1: glanza_mike ($248.17 in chips) 
Seat 2: T0ny Adams ($86.40 in chips) 
Seat 3: matiko09 ($203 in chips) 
Seat 4: WolleMalone ($200 in chips) 
Seat 5: Painkiller72 ($344.68 in chips) 
Seat 6: Kukuryzka ($204.35 in chips) 
Seat 7: gabi_igna ($200 in chips) 
Seat 8: chaps1988 ($200 in chips) 
Kukuryzka: posts small blind $1
gabi_igna: posts big blind $2
*** HOLE CARDS ***
Dealt to matiko09 [Qd 7c]
chaps1988: folds 
glanza_mike: folds 
T0ny Adams: folds 
matiko09: folds 
korol702 joins the table at seat #9 
WolleMalone: raises $3 to $5
Painkiller72: folds 
Kukuryzka: folds 
gabi_igna: calls $3
*** FLOP *** [Jh 2h Qc]
gabi_igna: checks 
WolleMalone: bets $5
gabi_igna: calls $5
*** TURN *** [Jh 2h Qc] [3h]
gabi_igna: bets $14
WolleMalone: calls $14
*** RIVER *** [Jh 2h Qc 3h] [6s]
gabi_igna: bets $32
WolleMalone: raises $144 to $176 and is all-in
gabi_igna: folds 
Uncalled bet ($144) returned to WolleMalone
WolleMalone collected $110.25 from pot
WolleMalone: doesn't show hand 
*** SUMMARY ***
Total pot $113 | Rake $2.75 
Board [Jh 2h Qc 3h 6s]
Seat 1: glanza_mike folded before Flop (didn't bet)
Seat 2: T0ny Adams folded before Flop (didn't bet)
Seat 3: matiko09 folded before Flop (didn't bet)
Seat 4: WolleMalone collected ($110.25)
Seat 5: Painkiller72 (button) folded before Flop (didn't bet)
Seat 6: Kukuryzka (small blind) folded before Flop
Seat 7: gabi_igna (big blind) folded on the River
Seat 8: chaps1988 folded before Flop (didn't bet)





PokerStars Hand #152885153032:  Hold'em No Limit ($0.50/$1.00 USD) - 2016/05/05 16:10:17 CET [2016/05/05 10:10:17 ET]
Table 'Luthera' 9-max Seat #2 is the button
Seat 1: MrMattkk ($82.49 in chips) 
Seat 2: Kukuryzka ($99.50 in chips) 
Seat 3: sanpidk ($100 in chips) 
Seat 4: matiko09 ($111.48 in chips) 
Seat 5: Painkiller72 ($108.50 in chips) 
Seat 6: Dantist1122 ($100 in chips) 
Seat 7: Chin41178 ($103.46 in chips) 
Seat 9: vrnMike ($113.60 in chips) 
sanpidk: posts small blind $0.50
matiko09: posts big blind $1
*** HOLE CARDS ***
Dealt to matiko09 [7s Ts]
Painkiller72: folds 
Dantist1122: folds 
Chin41178: folds 
vrnMike: folds 
MrMattkk: raises $2 to $3
Kukuryzka: folds 
sanpidk: folds 
matiko09: folds 
Uncalled bet ($2) returned to MrMattkk
MrMattkk collected $2.50 from pot
MrMattkk: doesn't show hand 
*** SUMMARY ***
Total pot $2.50 | Rake $0 
Seat 1: MrMattkk collected ($2.50)
Seat 2: Kukuryzka (button) folded before Flop (didn't bet)
Seat 3: sanpidk (small blind) folded before Flop
Seat 4: matiko09 (big blind) folded before Flop
Seat 5: Painkiller72 folded before Flop (didn't bet)
Seat 6: Dantist1122 folded before Flop (didn't bet)
Seat 7: Chin41178 folded before Flop (didn't bet)
Seat 9: vrnMike folded before Flop (didn't bet)





PokerStars Hand #152885154015:  Hold'em No Limit ($1/$2 USD) - 2016/05/05 16:10:18 CET [2016/05/05 10:10:18 ET]
Table 'Euporie II' 9-max Seat #7 is the button
Seat 1: gabi_igna ($200 in chips) 
Seat 2: nickreason17 ($200 in chips) 
Seat 3: chaps1988 ($200 in chips) 
Seat 4: Kukuryzka ($199 in chips) 
Seat 5: Nuskatko1986 ($62.61 in chips) 
Seat 6: glanza_mike ($202 in chips) 
Seat 7: matiko09 ($217.74 in chips) 
Seat 8: Painkiller72 ($301.25 in chips) 
Seat 9: T0ny Adams ($92.91 in chips) 
Painkiller72: posts small blind $1
T0ny Adams: posts big blind $2
*** HOLE CARDS ***
Dealt to matiko09 [6h 4c]
gabi_igna: raises $4 to $6
nickreason17: folds 
chaps1988: folds 
Kukuryzka: folds 
Nuskatko1986: calls $6
glanza_mike: folds 
matiko09: folds 
Painkiller72: folds 
T0ny Adams: folds 
*** FLOP *** [3s 9d 3c]
gabi_igna: checks 
Nuskatko1986: bets $18
gabi_igna: raises $176 to $194 and is all-in
Nuskatko1986: calls $38.61 and is all-in
Uncalled bet ($137.39) returned to gabi_igna
*** TURN *** [3s 9d 3c] [4h]
*** RIVER *** [3s 9d 3c 4h] [3d]
*** SHOW DOWN ***
gabi_igna: shows [Ah Kc] (three of a kind, Threes)
Nuskatko1986: shows [Kh Ad] (three of a kind, Threes)
gabi_igna collected $62.74 from pot
Nuskatko1986 collected $62.73 from pot
*** SUMMARY ***
Total pot $128.22 | Rake $2.75 
Board [3s 9d 3c 4h 3d]
Seat 1: gabi_igna showed [Ah Kc] and won ($62.74) with three of a kind, Threes
Seat 2: nickreason17 folded before Flop (didn't bet)
Seat 3: chaps1988 folded before Flop (didn't bet)
Seat 4: Kukuryzka folded before Flop (didn't bet)
Seat 5: Nuskatko1986 showed [Kh Ad] and won ($62.73) with three of a kind, Threes
Seat 6: glanza_mike folded before Flop (didn't bet)
Seat 7: matiko09 (button) folded before Flop (didn't bet)
Seat 8: Painkiller72 (small blind) folded before Flop
Seat 9: T0ny Adams (big blind) folded before Flop





PokerStars Hand #152885158091:  Hold'em No Limit ($1/$2 USD) - 2016/05/05 16:10:25 CET [2016/05/05 10:10:25 ET]
Table 'Tololo' 9-max Seat #8 is the button
Seat 1: Kukuryzka ($262.54 in chips) 
Seat 4: mooose100 ($191.28 in chips) 
Seat 5: matiko09 ($200 in chips) 
Seat 6: Xagua ($244 in chips) 
Seat 7: chaps1988 ($235.60 in chips) 
Seat 8: KovIFish89 ($200 in chips) 
Seat 9: Fitzyferret ($339.72 in chips) 
Fitzyferret: posts small blind $1
Kukuryzka: posts big blind $2
gabi_igna: sits out 
*** HOLE CARDS ***
Dealt to matiko09 [7s 2c]
mooose100: calls $2
matiko09: folds 
Xagua: folds 
chaps1988: folds 
KovIFish89: folds 
Fitzyferret: raises $7.25 to $9.25
Kukuryzka: calls $7.25
mooose100: calls $7.25
*** FLOP *** [2h 3c 7h]
Fitzyferret: bets $19
Kukuryzka: calls $19
mooose100: folds 
*** TURN *** [2h 3c 7h] [As]
Fitzyferret: bets $32
Kukuryzka: folds 
Uncalled bet ($32) returned to Fitzyferret
Fitzyferret collected $63 from pot
Fitzyferret: doesn't show hand 
*** SUMMARY ***
Total pot $65.75 | Rake $2.75 
Board [2h 3c 7h As]
Seat 1: Kukuryzka (big blind) folded on the Turn
Seat 4: mooose100 folded on the Flop
Seat 5: matiko09 folded before Flop (didn't bet)
Seat 6: Xagua folded before Flop (didn't bet)
Seat 7: chaps1988 folded before Flop (didn't bet)
Seat 8: KovIFish89 (button) folded before Flop (didn't bet)
Seat 9: Fitzyferret (small blind) collected ($63)





PokerStars Hand #152885165995:  Hold'em No Limit ($1/$2 USD) - 2016/05/05 16:10:39 CET [2016/05/05 10:10:39 ET]
Table 'Samitchell' 9-max Seat #4 is the button
Seat 1: KovIFish89 ($229.35 in chips) 
Seat 2: matiko09 ($200 in chips) 
Seat 3: gabi_igna ($317.87 in chips) 
Seat 4: Fitzyferret ($371.13 in chips) 
Seat 5: chaps1988 ($273.17 in chips) 
Seat 6: Zhalgasai ($100 in chips) 
Seat 7: patpaty ($153.59 in chips) 
Seat 8: WolleMalone ($206.99 in chips) 
Seat 9: kblkxls ($110.07 in chips) 
chaps1988: posts small blind $1
Zhalgasai: posts big blind $2
*** HOLE CARDS ***
Dealt to matiko09 [Qh Ks]
patpaty: calls $2
WolleMalone: folds 
kblkxls: folds 
KovIFish89: folds 
matiko09: raises $6 to $8
gabi_igna: folds 
Fitzyferret: folds 
chaps1988: folds 
Zhalgasai: folds 
patpaty: calls $6
*** FLOP *** [4c 5h 6c]
patpaty: checks 
matiko09: checks 
*** TURN *** [4c 5h 6c] [3h]
patpaty: bets $2
matiko09: folds 
Uncalled bet ($2) returned to patpaty
patpaty collected $18.05 from pot
patpaty: doesn't show hand 
*** SUMMARY ***
Total pot $19 | Rake $0.95 
Board [4c 5h 6c 3h]
Seat 1: KovIFish89 folded before Flop (didn't bet)
Seat 2: matiko09 folded on the Turn
Seat 3: gabi_igna folded before Flop (didn't bet)
Seat 4: Fitzyferret (button) folded before Flop (didn't bet)
Seat 5: chaps1988 (small blind) folded before Flop
Seat 6: Zhalgasai (big blind) folded before Flop
Seat 7: patpaty collected ($18.05)
Seat 8: WolleMalone folded before Flop (didn't bet)
Seat 9: kblkxls folded before Flop (didn't bet)





PokerStars Hand #152885173263:  Hold'em No Limit ($0.50/$1.00 USD) - 2016/05/05 16:10:51 CET [2016/05/05 10:10:51 ET]
Table 'Pyxis III' 9-max Seat #8 is the button
Seat 1: sanpidk ($276.19 in chips) 
Seat 2: SPmaka ($108.02 in chips) 
Seat 3: vrnMike ($101.50 in chips) 
Seat 4: Sloeve ($122.24 in chips) 
Seat 5: darren1031 ($122.08 in chips) 
Seat 6: kamillo91 ($92.97 in chips) 
Seat 7: mycka86 ($100 in chips) 
Seat 8: matiko09 ($100 in chips) 
Seat 9: maxxmeister ($100 in chips) 
maxxmeister: posts small blind $0.50
sanpidk: posts big blind $1
*** HOLE CARDS ***
Dealt to matiko09 [4s Qd]
SPmaka: folds 
vrnMike: folds 
Sloeve: folds 
darren1031: calls $1
kamillo91: folds 
mycka86: raises $3.50 to $4.50
matiko09: folds 
maxxmeister: folds 
sanpidk: folds 
darren1031: calls $3.50
*** FLOP *** [Jh 7s 3d]
darren1031: checks 
mycka86: bets $5.48
darren1031: calls $5.48
*** TURN *** [Jh 7s 3d] [5s]
darren1031: checks 
mycka86: checks 
*** RIVER *** [Jh 7s 3d 5s] [9h]
darren1031: bets $10.19
mycka86: folds 
Uncalled bet ($10.19) returned to darren1031
darren1031 collected $20.39 from pot
*** SUMMARY ***
Total pot $21.46 | Rake $1.07 
Board [Jh 7s 3d 5s 9h]
Seat 1: sanpidk (big blind) folded before Flop
Seat 2: SPmaka folded before Flop (didn't bet)
Seat 3: vrnMike folded before Flop (didn't bet)
Seat 4: Sloeve folded before Flop (didn't bet)
Seat 5: darren1031 collected ($20.39)
Seat 6: kamillo91 folded before Flop (didn't bet)
Seat 7: mycka86 folded on the River
Seat 8: matiko09 (button) folded before Flop (didn't bet)
Seat 9: maxxmeister (small blind) folded before Flop





PokerStars Hand #152885174748:  Hold'em No Limit ($0.50/$1.00 USD) - 2016/05/05 16:10:53 CET [2016/05/05 10:10:53 ET]
Table 'Luthera' 9-max Seat #3 is the button
Seat 1: MrMattkk ($83.99 in chips) 
Seat 2: Kukuryzka ($99.50 in chips) 
Seat 3: sanpidk ($100 in chips) 
Seat 4: matiko09 ($110.48 in chips) 
Seat 5: Painkiller72 ($108.50 in chips) 
Seat 6: Dantist1122 ($100 in chips) 
Seat 7: Chin41178 ($103.46 in chips) 
Seat 9: vrnMike ($113.60 in chips) 
matiko09: posts small blind $0.50
Painkiller72: posts big blind $1
*** HOLE CARDS ***
Dealt to matiko09 [6d 9s]
Dantist1122: folds 
Chin41178: folds 
vrnMike: folds 
MrMattkk: calls $1
Kukuryzka: folds 
sanpidk: folds 
matiko09: folds 
Painkiller72: checks 
*** FLOP *** [Kc Jc 3c]
Painkiller72: checks 
MrMattkk: bets $2
Painkiller72: folds 
Uncalled bet ($2) returned to MrMattkk
MrMattkk collected $2.38 from pot
MrMattkk: doesn't show hand 
*** SUMMARY ***
Total pot $2.50 | Rake $0.12 
Board [Kc Jc 3c]
Seat 1: MrMattkk collected ($2.38)
Seat 2: Kukuryzka folded before Flop (didn't bet)
Seat 3: sanpidk (button) folded before Flop (didn't bet)
Seat 4: matiko09 (small blind) folded before Flop
Seat 5: Painkiller72 (big blind) folded on the Flop
Seat 6: Dantist1122 folded before Flop (didn't bet)
Seat 7: Chin41178 folded before Flop (didn't bet)
Seat 9: vrnMike folded before Flop (didn't bet)





PokerStars Hand #152885175207:  Hold'em No Limit ($0.50/$1.00 USD) - 2016/05/05 16:10:54 CET [2016/05/05 10:10:54 ET]
Table 'Vela' 9-max Seat #8 is the button
Seat 1: mycka86 ($104.50 in chips) 
Seat 2: nickreason17 ($207.09 in chips) 
Seat 3: dviryo ($450.82 in chips) 
Seat 4: Hayer ana ($99.50 in chips) 
Seat 5: sanpidk ($101 in chips) 
Seat 6: matiko09 ($100 in chips) 
Seat 7: KovIFish89 ($104.88 in chips) 
Seat 8: vrnMike ($100 in chips) 
Seat 9: CI58 ($104.68 in chips) 
CI58: posts small blind $0.50
mycka86: posts big blind $1
*** HOLE CARDS ***
Dealt to matiko09 [7s 2h]
nickreason17: raises $1.50 to $2.50
dviryo: folds 
Hayer ana: calls $2.50
sanpidk: folds 
matiko09: folds 
KovIFish89: folds 
vrnMike: folds 
CI58: folds 
mycka86: calls $1.50
*** FLOP *** [Ks Ah Qh]
mycka86: checks 
nickreason17: bets $5
Hayer ana: calls $5
mycka86: folds 
*** TURN *** [Ks Ah Qh] [2c]
nickreason17: bets $12.82
Hayer ana: calls $12.82
*** RIVER *** [Ks Ah Qh 2c] [As]
nickreason17: bets $31.09
Hayer ana: calls $31.09
*** SHOW DOWN ***
nickreason17: shows [Kh Kd] (a full house, Kings full of Aces)
Hayer ana: shows [Qd Ad] (a full house, Aces full of Queens)
Hayer ana collected $103.32 from pot
*** SUMMARY ***
Total pot $105.82 | Rake $2.50 
Board [Ks Ah Qh 2c As]
Seat 1: mycka86 (big blind) folded on the Flop
Seat 2: nickreason17 showed [Kh Kd] and lost with a full house, Kings full of Aces
Seat 3: dviryo folded before Flop (didn't bet)
Seat 4: Hayer ana showed [Qd Ad] and won ($103.32) with a full house, Aces full of Queens
Seat 5: sanpidk folded before Flop (didn't bet)
Seat 6: matiko09 folded before Flop (didn't bet)
Seat 7: KovIFish89 folded before Flop (didn't bet)
Seat 8: vrnMike (button) folded before Flop (didn't bet)
Seat 9: CI58 (small blind) folded before Flop





PokerStars Hand #152885183190:  Hold'em No Limit ($1/$2 USD) - 2016/05/05 16:11:08 CET [2016/05/05 10:11:08 ET]
Table 'Lundia' 9-max Seat #3 is the button
Seat 1: Fitzyferret ($244.60 in chips) 
Seat 2: patpaty ($176.27 in chips) 
Seat 3: Painkiller72 ($249.65 in chips) 
Seat 4: KovIFish89 ($306.56 in chips) 
Seat 5: zmOe84 ($185.76 in chips) 
Seat 7: matiko09 ($235.11 in chips) 
Seat 9: gabi_igna ($240.61 in chips) 
KovIFish89: posts small blind $1
zmOe84: posts big blind $2
CI58: sits out 
chaps1988: sits out 
*** HOLE CARDS ***
Dealt to matiko09 [Td 4c]
matiko09: folds 
gabi_igna: folds 
Fitzyferret: folds 
patpaty: folds 
Painkiller72: raises $2 to $4
KovIFish89: calls $3
zmOe84: calls $2
*** FLOP *** [6d Kd Jc]
KovIFish89: bets $8
zmOe84: calls $8
Painkiller72: calls $8
*** TURN *** [6d Kd Jc] [5d]
KovIFish89: checks 
zmOe84: checks 
Painkiller72: checks 
*** RIVER *** [6d Kd Jc 5d] [Qc]
KovIFish89: checks 
zmOe84: checks 
Painkiller72: checks 
*** SHOW DOWN ***
KovIFish89: shows [Kh 8h] (a pair of Kings)
zmOe84: mucks hand 
Painkiller72: shows [8c Kc] (a pair of Kings)
KovIFish89 collected $17.10 from pot
Painkiller72 collected $17.10 from pot
*** SUMMARY ***
Total pot $36 | Rake $1.80 
Board [6d Kd Jc 5d Qc]
Seat 1: Fitzyferret folded before Flop (didn't bet)
Seat 2: patpaty folded before Flop (didn't bet)
Seat 3: Painkiller72 (button) showed [8c Kc] and won ($17.10) with a pair of Kings
Seat 4: KovIFish89 (small blind) showed [Kh 8h] and won ($17.10) with a pair of Kings
Seat 5: zmOe84 (big blind) mucked [Qh 9c]
Seat 7: matiko09 folded before Flop (didn't bet)
Seat 9: gabi_igna folded before Flop (didn't bet)





PokerStars Hand #152885188572:  Hold'em No Limit ($1/$2 USD) - 2016/05/05 16:11:17 CET [2016/05/05 10:11:17 ET]
Table 'Euporie II' 9-max Seat #8 is the button
Seat 1: gabi_igna ($200.13 in chips) 
Seat 2: nickreason17 ($200 in chips) 
Seat 4: Kukuryzka ($199 in chips) 
Seat 5: Nuskatko1986 ($62.73 in chips) 
Seat 6: glanza_mike ($202 in chips) 
Seat 7: matiko09 ($217.74 in chips) 
Seat 8: Painkiller72 ($300.25 in chips) 
Seat 9: T0ny Adams ($90.91 in chips) 
T0ny Adams: posts small blind $1
gabi_igna: posts big blind $2
*** HOLE CARDS ***
Dealt to matiko09 [Qc As]
nickreason17: raises $3 to $5
Kukuryzka: folds 
Nuskatko1986 has timed out
Nuskatko1986: folds 
glanza_mike: folds 
matiko09: calls $5
Painkiller72: folds 
T0ny Adams: folds 
gabi_igna: folds 
*** FLOP *** [9c 3h 6s]
nickreason17: bets $6.50
matiko09: folds 
Uncalled bet ($6.50) returned to nickreason17
nickreason17 collected $12.35 from pot
*** SUMMARY ***
Total pot $13 | Rake $0.65 
Board [9c 3h 6s]
Seat 1: gabi_igna (big blind) folded before Flop
Seat 2: nickreason17 collected ($12.35)
Seat 4: Kukuryzka folded before Flop (didn't bet)
Seat 5: Nuskatko1986 folded before Flop (didn't bet)
Seat 6: glanza_mike folded before Flop (didn't bet)
Seat 7: matiko09 folded on the Flop
Seat 8: Painkiller72 (button) folded before Flop (didn't bet)
Seat 9: T0ny Adams (small blind) folded before Flop





PokerStars Hand #152885189732:  Hold'em No Limit ($0.50/$1.00 USD) - 2016/05/05 16:11:19 CET [2016/05/05 10:11:19 ET]
Table 'Musa II' 9-max Seat #8 is the button
Seat 1: KovIFish89 ($191.97 in chips) 
Seat 2: koutani7 ($100 in chips) 
Seat 3: vrnMike ($192.29 in chips) 
Seat 4: sanpidk ($102.72 in chips) 
Seat 6: cnn123 ($86.52 in chips) 
Seat 7: plaindaft1 ($101.18 in chips) 
Seat 8: matiko09 ($107.12 in chips) 
Seat 9: FroggyPlay ($100 in chips) 
FroggyPlay: posts small blind $0.50
nickreason17 joins the table at seat #5 
KovIFish89: posts big blind $1
*** HOLE CARDS ***
Dealt to matiko09 [5d Ks]
koutani7: folds 
vrnMike: folds 
sanpidk: folds 
cnn123: folds 
plaindaft1: folds 
matiko09: folds 
FroggyPlay: folds 
Uncalled bet ($0.50) returned to KovIFish89
KovIFish89 collected $1 from pot
KovIFish89: doesn't show hand 
*** SUMMARY ***
Total pot $1 | Rake $0 
Seat 1: KovIFish89 (big blind) collected ($1)
Seat 2: koutani7 folded before Flop (didn't bet)
Seat 3: vrnMike folded before Flop (didn't bet)
Seat 4: sanpidk folded before Flop (didn't bet)
Seat 6: cnn123 folded before Flop (didn't bet)
Seat 7: plaindaft1 folded before Flop (didn't bet)
Seat 8: matiko09 (button) folded before Flop (didn't bet)
Seat 9: FroggyPlay (small blind) folded before Flop





PokerStars Hand #152885206076:  Hold'em No Limit ($1/$2 USD) - 2016/05/05 16:11:36 CET [2016/05/05 10:11:36 ET]
Table 'Samitchell' 9-max Seat #6 is the button
Seat 1: KovIFish89 ($229.35 in chips) 
Seat 2: matiko09 ($200 in chips) 
Seat 3: gabi_igna ($317.87 in chips) 
Seat 4: Fitzyferret ($371.13 in chips) 
Seat 6: Zhalgasai ($98 in chips) 
Seat 7: patpaty ($163.64 in chips) 
Seat 8: WolleMalone ($206.99 in chips) 
Seat 9: kblkxls ($110.07 in chips) 
patpaty: posts small blind $1
WolleMalone: posts big blind $2
*** HOLE CARDS ***
Dealt to matiko09 [3c 2c]
kblkxls: folds 
KovIFish89: folds 
matiko09: folds 
gabi_igna: folds 
Fitzyferret: folds 
Zhalgasai: folds 
patpaty: calls $1
WolleMalone: raises $5 to $7
patpaty: calls $5
*** FLOP *** [Jh Kd 2s]
patpaty: checks 
WolleMalone: bets $9
patpaty: folds 
Uncalled bet ($9) returned to WolleMalone
WolleMalone collected $13.30 from pot
WolleMalone: doesn't show hand 
*** SUMMARY ***
Total pot $14 | Rake $0.70 
Board [Jh Kd 2s]
Seat 1: KovIFish89 folded before Flop (didn't bet)
Seat 2: matiko09 folded before Flop (didn't bet)
Seat 3: gabi_igna folded before Flop (didn't bet)
Seat 4: Fitzyferret folded before Flop (didn't bet)
Seat 6: Zhalgasai (button) folded before Flop (didn't bet)
Seat 7: patpaty (small blind) folded on the Flop
Seat 8: WolleMalone (big blind) collected ($13.30)
Seat 9: kblkxls folded before Flop (didn't bet)





PokerStars Hand #152885208304:  Hold'em No Limit ($0.50/$1.00 USD) - 2016/05/05 16:11:40 CET [2016/05/05 10:11:40 ET]
Table 'Musa II' 9-max Seat #9 is the button
Seat 1: KovIFish89 ($192.47 in chips) 
Seat 2: koutani7 ($100 in chips) 
Seat 3: vrnMike ($192.29 in chips) 
Seat 4: sanpidk ($102.72 in chips) 
Seat 6: cnn123 ($86.52 in chips) 
Seat 7: plaindaft1 ($101.18 in chips) 
Seat 8: matiko09 ($107.12 in chips) 
Seat 9: FroggyPlay ($100 in chips) 
KovIFish89: posts small blind $0.50
koutani7: posts big blind $1
nickreason17: sits out 
*** HOLE CARDS ***
Dealt to matiko09 [3s Qh]
vrnMike: raises $1 to $2
sanpidk: folds 
cnn123: raises $2 to $4
plaindaft1: folds 
matiko09: folds 
FroggyPlay: folds 
KovIFish89: folds 
koutani7: calls $3
vrnMike: raises $12 to $16
cnn123: calls $12
koutani7: folds 
*** FLOP *** [4s 2h 4c]
vrnMike: bets $18.50
cnn123: folds 
Uncalled bet ($18.50) returned to vrnMike
vrnMike collected $34.68 from pot
*** SUMMARY ***
Total pot $36.50 | Rake $1.82 
Board [4s 2h 4c]
Seat 1: KovIFish89 (small blind) folded before Flop
Seat 2: koutani7 (big blind) folded before Flop
Seat 3: vrnMike collected ($34.68)
Seat 4: sanpidk folded before Flop (didn't bet)
Seat 6: cnn123 folded on the Flop
Seat 7: plaindaft1 folded before Flop (didn't bet)
Seat 8: matiko09 folded before Flop (didn't bet)
Seat 9: FroggyPlay (button) folded before Flop (didn't bet)





PokerStars Hand #152885214988:  Hold'em No Limit ($0.50/$1.00 USD) - 2016/05/05 16:11:51 CET [2016/05/05 10:11:51 ET]
Table 'Luthera' 9-max Seat #4 is the button
Seat 1: MrMattkk ($85.37 in chips) 
Seat 2: Kukuryzka ($99.50 in chips) 
Seat 3: sanpidk ($100 in chips) 
Seat 4: matiko09 ($109.98 in chips) 
Seat 5: Painkiller72 ($107.50 in chips) 
Seat 6: Dantist1122 ($100 in chips) 
Seat 7: Chin41178 ($103.46 in chips) 
Seat 9: vrnMike ($113.60 in chips) 
Painkiller72: posts small blind $0.50
Dantist1122: posts big blind $1
*** HOLE CARDS ***
Dealt to matiko09 [8c Ac]
Chin41178: folds 
vrnMike: folds 
MrMattkk: folds 
Kukuryzka: folds 
sanpidk: folds 
matiko09: raises $1.27 to $2.27
Painkiller72: folds 
Dantist1122: folds 
Uncalled bet ($1.27) returned to matiko09
matiko09 collected $2.50 from pot
matiko09: doesn't show hand 
*** SUMMARY ***
Total pot $2.50 | Rake $0 
Seat 1: MrMattkk folded before Flop (didn't bet)
Seat 2: Kukuryzka folded before Flop (didn't bet)
Seat 3: sanpidk folded before Flop (didn't bet)
Seat 4: matiko09 (button) collected ($2.50)
Seat 5: Painkiller72 (small blind) folded before Flop
Seat 6: Dantist1122 (big blind) folded before Flop
Seat 7: Chin41178 folded before Flop (didn't bet)
Seat 9: vrnMike folded before Flop (didn't bet)





PokerStars Hand #152885217812:  Hold'em No Limit ($1/$2 USD) - 2016/05/05 16:11:56 CET [2016/05/05 10:11:56 ET]
Table 'Tololo' 9-max Seat #9 is the button
Seat 1: Kukuryzka ($234.29 in chips) 
Seat 2: gabi_igna ($200 in chips) 
Seat 4: mooose100 ($182.03 in chips) 
Seat 5: matiko09 ($200 in chips) 
Seat 6: Xagua ($244 in chips) 
Seat 8: KovIFish89 ($200 in chips) 
Seat 9: Fitzyferret ($374.47 in chips) 
Kukuryzka: posts small blind $1
gabi_igna: posts big blind $2
nickreason17: sits out 
*** HOLE CARDS ***
Dealt to matiko09 [Ah 2c]
mooose100: folds 
matiko09: folds 
Xagua: raises $3 to $5
KovIFish89: folds 
Fitzyferret: folds 
Kukuryzka: folds 
gabi_igna: calls $3
*** FLOP *** [9c Ac Kc]
gabi_igna: checks 
Xagua: checks 
*** TURN *** [9c Ac Kc] [2s]
gabi_igna: bets $6
Xagua: calls $6
*** RIVER *** [9c Ac Kc 2s] [2h]
gabi_igna: bets $14
Xagua: calls $14
*** SHOW DOWN ***
gabi_igna: shows [Ad 8d] (two pair, Aces and Deuces)
Xagua: mucks hand 
gabi_igna collected $48.45 from pot
*** SUMMARY ***
Total pot $51 | Rake $2.55 
Board [9c Ac Kc 2s 2h]
Seat 1: Kukuryzka (small blind) folded before Flop
Seat 2: gabi_igna (big blind) showed [Ad 8d] and won ($48.45) with two pair, Aces and Deuces
Seat 4: mooose100 folded before Flop (didn't bet)
Seat 5: matiko09 folded before Flop (didn't bet)
Seat 6: Xagua mucked [Ks Qs]
Seat 8: KovIFish89 folded before Flop (didn't bet)
Seat 9: Fitzyferret (button) folded before Flop (didn't bet)





PokerStars Hand #152885227619:  Hold'em No Limit ($1/$2 USD) - 2016/05/05 16:12:13 CET [2016/05/05 10:12:13 ET]
Table 'Euporie II' 9-max Seat #9 is the button
Seat 1: gabi_igna ($200 in chips) 
Seat 2: nickreason17 ($207.35 in chips) 
Seat 4: Kukuryzka ($199 in chips) 
Seat 6: glanza_mike ($202 in chips) 
Seat 7: matiko09 ($212.74 in chips) 
Seat 8: Painkiller72 ($300.25 in chips) 
Seat 9: T0ny Adams ($89.91 in chips) 
gabi_igna: posts small blind $1
nickreason17: posts big blind $2
*** HOLE CARDS ***
Dealt to matiko09 [Jc 5d]
Kukuryzka: folds 
glanza_mike: folds 
matiko09: folds 
Painkiller72: folds 
T0ny Adams: folds 
gabi_igna: raises $4 to $6
nickreason17: folds 
Uncalled bet ($4) returned to gabi_igna
gabi_igna collected $4 from pot
gabi_igna: doesn't show hand 
*** SUMMARY ***
Total pot $4 | Rake $0 
Seat 1: gabi_igna (small blind) collected ($4)
Seat 2: nickreason17 (big blind) folded before Flop
Seat 4: Kukuryzka folded before Flop (didn't bet)
Seat 6: glanza_mike folded before Flop (didn't bet)
Seat 7: matiko09 folded before Flop (didn't bet)
Seat 8: Painkiller72 folded before Flop (didn't bet)
Seat 9: T0ny Adams (button) folded before Flop (didn't bet)





PokerStars Hand #152885231054:  Hold'em No Limit ($0.50/$1.00 USD) - 2016/05/05 16:12:18 CET [2016/05/05 10:12:18 ET]
Table 'Luthera' 9-max Seat #5 is the button
Seat 1: MrMattkk ($85.37 in chips) 
Seat 2: Kukuryzka ($99.50 in chips) 
Seat 3: sanpidk ($100 in chips) 
Seat 4: matiko09 ($111.48 in chips) 
Seat 5: Painkiller72 ($107 in chips) 
Seat 6: Dantist1122 ($100 in chips) 
Seat 7: Chin41178 ($103.46 in chips) 
Seat 9: vrnMike ($113.60 in chips) 
Dantist1122: posts small blind $0.50
Chin41178: posts big blind $1
*** HOLE CARDS ***
Dealt to matiko09 [3s 6h]
vrnMike: folds 
MrMattkk: calls $1
Kukuryzka: folds 
sanpidk: folds 
matiko09: folds 
Painkiller72: raises $3.50 to $4.50
Dantist1122: folds 
Chin41178: folds 
MrMattkk: folds 
Uncalled bet ($3.50) returned to Painkiller72
Painkiller72 collected $3.50 from pot
Painkiller72: doesn't show hand 
*** SUMMARY ***
Total pot $3.50 | Rake $0 
Seat 1: MrMattkk folded before Flop
Seat 2: Kukuryzka folded before Flop (didn't bet)
Seat 3: sanpidk folded before Flop (didn't bet)
Seat 4: matiko09 folded before Flop (didn't bet)
Seat 5: Painkiller72 (button) collected ($3.50)
Seat 6: Dantist1122 (small blind) folded before Flop
Seat 7: Chin41178 (big blind) folded before Flop
Seat 9: vrnMike folded before Flop (didn't bet)





PokerStars Hand #152885231707:  Hold'em No Limit ($1/$2 USD) - 2016/05/05 16:12:19 CET [2016/05/05 10:12:19 ET]
Table 'Samitchell' 9-max Seat #7 is the button
Seat 1: KovIFish89 ($229.35 in chips) 
Seat 2: matiko09 ($200 in chips) 
Seat 3: gabi_igna ($317.87 in chips) 
Seat 4: Fitzyferret ($371.13 in chips) 
Seat 6: Zhalgasai ($98 in chips) 
Seat 7: patpaty ($156.64 in chips) 
Seat 8: WolleMalone ($213.29 in chips) 
Seat 9: kblkxls ($110.07 in chips) 
WolleMalone: posts small blind $1
kblkxls: posts big blind $2
*** HOLE CARDS ***
Dealt to matiko09 [8c Qh]
KovIFish89: folds 
matiko09: folds 
gabi_igna: folds 
Fitzyferret: folds 
Zhalgasai: folds 
patpaty: raises $2 to $4
WolleMalone: folds 
kblkxls: calls $2
*** FLOP *** [2s 8d Ah]
kblkxls: checks 
patpaty: bets $2
kblkxls: calls $2
*** TURN *** [2s 8d Ah] [Jc]
kblkxls: checks 
patpaty: checks 
*** RIVER *** [2s 8d Ah Jc] [Kc]
kblkxls: bets $4
patpaty: calls $4
*** SHOW DOWN ***
kblkxls: shows [8s 7c] (a pair of Eights)
patpaty: shows [Td Th] (a pair of Tens)
patpaty collected $19.95 from pot
*** SUMMARY ***
Total pot $21 | Rake $1.05 
Board [2s 8d Ah Jc Kc]
Seat 1: KovIFish89 folded before Flop (didn't bet)
Seat 2: matiko09 folded before Flop (didn't bet)
Seat 3: gabi_igna folded before Flop (didn't bet)
Seat 4: Fitzyferret folded before Flop (didn't bet)
Seat 6: Zhalgasai folded before Flop (didn't bet)
Seat 7: patpaty (button) showed [Td Th] and won ($19.95) with a pair of Tens
Seat 8: WolleMalone (small blind) folded before Flop
Seat 9: kblkxls (big blind) showed [8s 7c] and lost with a pair of Eights





PokerStars Hand #152885232095:  Hold'em No Limit ($0.50/$1.00 USD) - 2016/05/05 16:12:20 CET [2016/05/05 10:12:20 ET]
Table 'Musa II' 9-max Seat #1 is the button
Seat 1: KovIFish89 ($191.97 in chips) 
Seat 2: koutani7 ($96 in chips) 
Seat 3: vrnMike ($210.97 in chips) 
Seat 4: sanpidk ($102.72 in chips) 
Seat 6: cnn123 ($70.52 in chips) 
Seat 7: plaindaft1 ($101.18 in chips) 
Seat 8: matiko09 ($107.12 in chips) 
Seat 9: FroggyPlay ($100 in chips) 
koutani7: posts small blind $0.50
vrnMike: posts big blind $1
nickreason17: sits out 
*** HOLE CARDS ***
Dealt to matiko09 [4c 5s]
sanpidk: folds 
cnn123: folds 
plaindaft1: calls $1
matiko09: folds 
FroggyPlay: folds 
KovIFish89: folds 
koutani7: folds 
vrnMike: checks 
*** FLOP *** [9d Th 4h]
vrnMike: checks 
plaindaft1: checks 
*** TURN *** [9d Th 4h] [7s]
vrnMike: bets $5
plaindaft1: calls $5
*** RIVER *** [9d Th 4h 7s] [7d]
vrnMike: bets $20
plaindaft1: raises $20 to $40
vrnMike: folds 
Uncalled bet ($20) returned to plaindaft1
plaindaft1 collected $50 from pot
plaindaft1: doesn't show hand 
*** SUMMARY ***
Total pot $52.50 | Rake $2.50 
Board [9d Th 4h 7s 7d]
Seat 1: KovIFish89 (button) folded before Flop (didn't bet)
Seat 2: koutani7 (small blind) folded before Flop
Seat 3: vrnMike (big blind) folded on the River
Seat 4: sanpidk folded before Flop (didn't bet)
Seat 6: cnn123 folded before Flop (didn't bet)
Seat 7: plaindaft1 collected ($50)
Seat 8: matiko09 folded before Flop (didn't bet)
Seat 9: FroggyPlay folded before Flop (didn't bet)





PokerStars Hand #152885239193:  Hold'em No Limit ($0.50/$1.00 USD) - 2016/05/05 16:12:32 CET [2016/05/05 10:12:32 ET]
Table 'Pyxis III' 9-max Seat #9 is the button
Seat 1: sanpidk ($275.19 in chips) 
Seat 2: SPmaka ($108.02 in chips) 
Seat 3: vrnMike ($101.50 in chips) 
Seat 4: Sloeve ($122.24 in chips) 
Seat 5: darren1031 ($132.49 in chips) 
Seat 6: kamillo91 ($92.97 in chips) 
Seat 7: mycka86 ($100 in chips) 
Seat 8: matiko09 ($100 in chips) 
Seat 9: maxxmeister ($100 in chips) 
sanpidk: posts small blind $0.50
SPmaka: posts big blind $1
*** HOLE CARDS ***
Dealt to matiko09 [4h 5c]
vrnMike: folds 
Sloeve: folds 
darren1031 has timed out
darren1031: folds 
kamillo91: folds 
mycka86: folds 
matiko09: folds 
maxxmeister: raises $2 to $3
sanpidk: folds 
SPmaka: folds 
Uncalled bet ($2) returned to maxxmeister
maxxmeister collected $2.50 from pot
maxxmeister: doesn't show hand 
*** SUMMARY ***
Total pot $2.50 | Rake $0 
Seat 1: sanpidk (small blind) folded before Flop
Seat 2: SPmaka (big blind) folded before Flop
Seat 3: vrnMike folded before Flop (didn't bet)
Seat 4: Sloeve folded before Flop (didn't bet)
Seat 5: darren1031 folded before Flop (didn't bet)
Seat 6: kamillo91 folded before Flop (didn't bet)
Seat 7: mycka86 folded before Flop (didn't bet)
Seat 8: matiko09 folded before Flop (didn't bet)
Seat 9: maxxmeister (button) collected ($2.50)





PokerStars Hand #152885239781:  Hold'em No Limit ($1/$2 USD) - 2016/05/05 16:12:33 CET [2016/05/05 10:12:33 ET]
Table 'Lundia' 9-max Seat #4 is the button
Seat 1: Fitzyferret ($244.60 in chips) 
Seat 2: patpaty ($176.27 in chips) 
Seat 3: Painkiller72 ($254.75 in chips) 
Seat 4: KovIFish89 ($311.66 in chips) 
Seat 5: zmOe84 ($173.76 in chips) 
Seat 6: CI58 ($200 in chips) 
Seat 7: matiko09 ($235.11 in chips) 
Seat 9: gabi_igna ($240.61 in chips) 
zmOe84: posts small blind $1
CI58: posts big blind $2
*** HOLE CARDS ***
Dealt to matiko09 [5h 4s]
matiko09: folds 
gabi_igna: folds 
Fitzyferret: folds 
patpaty: raises $2 to $4
Painkiller72: raises $11 to $15
KovIFish89: folds 
zmOe84: folds 
CI58: folds 
patpaty: folds 
Uncalled bet ($11) returned to Painkiller72
Painkiller72 collected $11 from pot
Painkiller72: doesn't show hand 
*** SUMMARY ***
Total pot $11 | Rake $0 
Seat 1: Fitzyferret folded before Flop (didn't bet)
Seat 2: patpaty folded before Flop
Seat 3: Painkiller72 collected ($11)
Seat 4: KovIFish89 (button) folded before Flop (didn't bet)
Seat 5: zmOe84 (small blind) folded before Flop
Seat 6: CI58 (big blind) folded before Flop
Seat 7: matiko09 folded before Flop (didn't bet)
Seat 9: gabi_igna folded before Flop (didn't bet)





PokerStars Hand #152885245984:  Hold'em No Limit ($1/$2 USD) - 2016/05/05 16:12:44 CET [2016/05/05 10:12:44 ET]
Table 'Euporie II' 9-max Seat #1 is the button
Seat 1: gabi_igna ($202 in chips) 
Seat 2: nickreason17 ($205.35 in chips) 
Seat 4: Kukuryzka ($199 in chips) 
Seat 5: Nuskatko1986 ($62.73 in chips) 
Seat 6: glanza_mike ($202 in chips) 
Seat 7: matiko09 ($212.74 in chips) 
Seat 8: Painkiller72 ($300.25 in chips) 
Seat 9: T0ny Adams ($89.91 in chips) 
nickreason17: posts small blind $1
Kukuryzka: posts big blind $2
*** HOLE CARDS ***
Dealt to matiko09 [Th 8c]
Nuskatko1986: calls $2
glanza_mike: folds 
matiko09: folds 
Painkiller72: folds 
T0ny Adams: folds 
gabi_igna: folds 
nickreason17: folds 
Kukuryzka: checks 
*** FLOP *** [5h 9s 9d]
Kukuryzka: checks 
Nuskatko1986: checks 
*** TURN *** [5h 9s 9d] [6c]
Kukuryzka: checks 
Nuskatko1986: checks 
*** RIVER *** [5h 9s 9d 6c] [3s]
Kukuryzka: checks 
Nuskatko1986: checks 
*** SHOW DOWN ***
Kukuryzka: shows [3d Ah] (two pair, Nines and Threes)
Nuskatko1986: mucks hand 
Kukuryzka collected $4.75 from pot
*** SUMMARY ***
Total pot $5 | Rake $0.25 
Board [5h 9s 9d 6c 3s]
Seat 1: gabi_igna (button) folded before Flop (didn't bet)
Seat 2: nickreason17 (small blind) folded before Flop
Seat 4: Kukuryzka (big blind) showed [3d Ah] and won ($4.75) with two pair, Nines and Threes
Seat 5: Nuskatko1986 mucked [7h Qh]
Seat 6: glanza_mike folded before Flop (didn't bet)
Seat 7: matiko09 folded before Flop (didn't bet)
Seat 8: Painkiller72 folded before Flop (didn't bet)
Seat 9: T0ny Adams folded before Flop (didn't bet)





PokerStars Hand #152885245898:  Hold'em No Limit ($1/$2 USD) - 2016/05/05 16:12:44 CET [2016/05/05 10:12:44 ET]
Table 'Tatry II' 9-max Seat #6 is the button
Seat 1: glanza_mike ($248.17 in chips) 
Seat 2: T0ny Adams ($86.40 in chips) 
Seat 3: matiko09 ($203 in chips) 
Seat 4: WolleMalone ($254.25 in chips) 
Seat 5: Painkiller72 ($344.68 in chips) 
Seat 6: Kukuryzka ($203.35 in chips) 
Seat 7: gabi_igna ($200 in chips) 
Seat 9: korol702 ($147.89 in chips) 
gabi_igna: posts small blind $1
korol702: posts big blind $2
*** HOLE CARDS ***
Dealt to matiko09 [Ac Tc]
glanza_mike: folds 
T0ny Adams: folds 
matiko09: raises $3 to $5
WolleMalone: folds 
Painkiller72: folds 
Kukuryzka: folds 
gabi_igna: folds 
korol702: calls $3
*** FLOP *** [Jd 9s Ks]
korol702: checks 
matiko09: checks 
*** TURN *** [Jd 9s Ks] [Td]
korol702: checks 
matiko09: checks 
*** RIVER *** [Jd 9s Ks Td] [5h]
korol702: checks 
matiko09: checks 
*** SHOW DOWN ***
korol702: shows [6c 4s] (high card King)
matiko09: shows [Ac Tc] (a pair of Tens)
matiko09 collected $10.45 from pot
*** SUMMARY ***
Total pot $11 | Rake $0.55 
Board [Jd 9s Ks Td 5h]
Seat 1: glanza_mike folded before Flop (didn't bet)
Seat 2: T0ny Adams folded before Flop (didn't bet)
Seat 3: matiko09 showed [Ac Tc] and won ($10.45) with a pair of Tens
Seat 4: WolleMalone folded before Flop (didn't bet)
Seat 5: Painkiller72 folded before Flop (didn't bet)
Seat 6: Kukuryzka (button) folded before Flop (didn't bet)
Seat 7: gabi_igna (small blind) folded before Flop
Seat 9: korol702 (big blind) showed [6c 4s] and lost with high card King





PokerStars Hand #152885250366:  Hold'em No Limit ($0.50/$1.00 USD) - 2016/05/05 16:12:51 CET [2016/05/05 10:12:51 ET]
Table 'Luthera' 9-max Seat #6 is the button
Seat 1: MrMattkk ($84.37 in chips) 
Seat 2: Kukuryzka ($99.50 in chips) 
Seat 3: sanpidk ($100 in chips) 
Seat 4: matiko09 ($111.48 in chips) 
Seat 5: Painkiller72 ($109.50 in chips) 
Seat 6: Dantist1122 ($100 in chips) 
Seat 7: Chin41178 ($102.46 in chips) 
Seat 9: vrnMike ($113.60 in chips) 
Chin41178: posts small blind $0.50
vrnMike: posts big blind $1
*** HOLE CARDS ***
Dealt to matiko09 [Kc 8s]
MrMattkk: raises $2 to $3
Kukuryzka: folds 
sanpidk: folds 
matiko09: folds 
Painkiller72: folds 
Dantist1122: folds 
Chin41178: folds 
vrnMike: folds 
Uncalled bet ($2) returned to MrMattkk
MrMattkk collected $2.50 from pot
MrMattkk: doesn't show hand 
*** SUMMARY ***
Total pot $2.50 | Rake $0 
Seat 1: MrMattkk collected ($2.50)
Seat 2: Kukuryzka folded before Flop (didn't bet)
Seat 3: sanpidk folded before Flop (didn't bet)
Seat 4: matiko09 folded before Flop (didn't bet)
Seat 5: Painkiller72 folded before Flop (didn't bet)
Seat 6: Dantist1122 (button) folded before Flop (didn't bet)
Seat 7: Chin41178 (small blind) folded before Flop
Seat 9: vrnMike (big blind) folded before Flop





PokerStars Hand #152885254317:  Hold'em No Limit ($0.50/$1.00 USD) - 2016/05/05 16:12:58 CET [2016/05/05 10:12:58 ET]
Table 'Vela' 9-max Seat #9 is the button
Seat 1: mycka86 ($102 in chips) 
Seat 2: nickreason17 ($155.68 in chips) 
Seat 3: dviryo ($450.82 in chips) 
Seat 4: Hayer ana ($151.41 in chips) 
Seat 5: sanpidk ($101 in chips) 
Seat 6: matiko09 ($100 in chips) 
Seat 7: KovIFish89 ($104.88 in chips) 
Seat 8: vrnMike ($100 in chips) 
Seat 9: CI58 ($104.18 in chips) 
mycka86: posts small blind $0.50
nickreason17: posts big blind $1
*** HOLE CARDS ***
Dealt to matiko09 [5c Kc]
dviryo: folds 
Hayer ana: folds 
nickreason17 said, "nice"
sanpidk: folds 
matiko09: folds 
KovIFish89: folds 
vrnMike: folds 
CI58: folds 
mycka86: raises $1.75 to $2.75
nickreason17: calls $1.75
*** FLOP *** [7d 6d As]
mycka86: checks 
nickreason17: bets $2.75
mycka86: calls $2.75
*** TURN *** [7d 6d As] [Tc]
mycka86: checks 
nickreason17: bets $20
mycka86: folds 
Uncalled bet ($20) returned to nickreason17
nickreason17 collected $10.45 from pot
*** SUMMARY ***
Total pot $11 | Rake $0.55 
Board [7d 6d As Tc]
Seat 1: mycka86 (small blind) folded on the Turn
Seat 2: nickreason17 (big blind) collected ($10.45)
Seat 3: dviryo folded before Flop (didn't bet)
Seat 4: Hayer ana folded before Flop (didn't bet)
Seat 5: sanpidk folded before Flop (didn't bet)
Seat 6: matiko09 folded before Flop (didn't bet)
Seat 7: KovIFish89 folded before Flop (didn't bet)
Seat 8: vrnMike folded before Flop (didn't bet)
Seat 9: CI58 (button) folded before Flop (didn't bet)





PokerStars Hand #152885261666:  Hold'em No Limit ($1/$2 USD) - 2016/05/05 16:13:10 CET [2016/05/05 10:13:10 ET]
Table 'Lundia' 9-max Seat #5 is the button
Seat 1: Fitzyferret ($244.60 in chips) 
Seat 2: patpaty ($172.27 in chips) 
Seat 3: Painkiller72 ($261.75 in chips) 
Seat 4: KovIFish89 ($311.66 in chips) 
Seat 5: zmOe84 ($172.76 in chips) 
Seat 6: CI58 ($200 in chips) 
Seat 7: matiko09 ($235.11 in chips) 
Seat 9: gabi_igna ($240.61 in chips) 
CI58: posts small blind $1
matiko09: posts big blind $2
*** HOLE CARDS ***
Dealt to matiko09 [8c 9h]
gabi_igna: folds 
Fitzyferret: folds 
patpaty: folds 
Painkiller72: folds 
KovIFish89: folds 
zmOe84: folds 
CI58: folds 
Uncalled bet ($1) returned to matiko09
matiko09 collected $2 from pot
matiko09: doesn't show hand 
*** SUMMARY ***
Total pot $2 | Rake $0 
Seat 1: Fitzyferret folded before Flop (didn't bet)
Seat 2: patpaty folded before Flop (didn't bet)
Seat 3: Painkiller72 folded before Flop (didn't bet)
Seat 4: KovIFish89 folded before Flop (didn't bet)
Seat 5: zmOe84 (button) folded before Flop (didn't bet)
Seat 6: CI58 (small blind) folded before Flop
Seat 7: matiko09 (big blind) collected ($2)
Seat 9: gabi_igna folded before Flop (didn't bet)





PokerStars Hand #152885261772:  Hold'em No Limit ($1/$2 USD) - 2016/05/05 16:13:10 CET [2016/05/05 10:13:10 ET]
Table 'Tololo' 9-max Seat #1 is the button
Seat 1: Kukuryzka ($233.29 in chips) 
Seat 2: gabi_igna ($223.45 in chips) 
Seat 3: nickreason17 ($223.22 in chips) 
Seat 4: mooose100 ($182.03 in chips) 
Seat 5: matiko09 ($200 in chips) 
Seat 6: Xagua ($219 in chips) 
Seat 8: KovIFish89 ($200 in chips) 
Seat 9: Fitzyferret ($374.47 in chips) 
gabi_igna: posts small blind $1
nickreason17: posts big blind $2
*** HOLE CARDS ***
Dealt to matiko09 [Ts 8d]
mooose100: folds 
matiko09: folds 
Xagua: raises $3 to $5
KovIFish89: folds 
Fitzyferret: folds 
Kukuryzka: folds 
gabi_igna: folds 
nickreason17: folds 
Uncalled bet ($3) returned to Xagua
Xagua collected $5 from pot
Xagua: doesn't show hand 
*** SUMMARY ***
Total pot $5 | Rake $0 
Seat 1: Kukuryzka (button) folded before Flop (didn't bet)
Seat 2: gabi_igna (small blind) folded before Flop
Seat 3: nickreason17 (big blind) folded before Flop
Seat 4: mooose100 folded before Flop (didn't bet)
Seat 5: matiko09 folded before Flop (didn't bet)
Seat 6: Xagua collected ($5)
Seat 8: KovIFish89 folded before Flop (didn't bet)
Seat 9: Fitzyferret folded before Flop (didn't bet)





PokerStars Hand #152885267106:  Hold'em No Limit ($0.50/$1.00 USD) - 2016/05/05 16:13:19 CET [2016/05/05 10:13:19 ET]
Table 'Luthera' 9-max Seat #7 is the button
Seat 1: MrMattkk ($85.87 in chips) 
Seat 2: Kukuryzka ($99.50 in chips) 
Seat 3: sanpidk ($100 in chips) 
Seat 4: matiko09 ($111.48 in chips) 
Seat 5: Painkiller72 ($109.50 in chips) 
Seat 6: Dantist1122 ($100 in chips) 
Seat 7: Chin41178 ($101.96 in chips) 
Seat 9: vrnMike ($112.60 in chips) 
vrnMike: posts small blind $0.50
MrMattkk: posts big blind $1
*** HOLE CARDS ***
Dealt to matiko09 [5s 8h]
Kukuryzka: folds 
sanpidk: folds 
matiko09: folds 
Painkiller72: folds 
Dantist1122: folds 
Chin41178: folds 
vrnMike: folds 
Uncalled bet ($0.50) returned to MrMattkk
MrMattkk collected $1 from pot
MrMattkk: doesn't show hand 
*** SUMMARY ***
Total pot $1 | Rake $0 
Seat 1: MrMattkk (big blind) collected ($1)
Seat 2: Kukuryzka folded before Flop (didn't bet)
Seat 3: sanpidk folded before Flop (didn't bet)
Seat 4: matiko09 folded before Flop (didn't bet)
Seat 5: Painkiller72 folded before Flop (didn't bet)
Seat 6: Dantist1122 folded before Flop (didn't bet)
Seat 7: Chin41178 (button) folded before Flop (didn't bet)
Seat 9: vrnMike (small blind) folded before Flop





PokerStars Hand #152885269971:  Hold'em No Limit ($0.50/$1.00 USD) - 2016/05/05 16:13:24 CET [2016/05/05 10:13:24 ET]
Table 'Pyxis III' 9-max Seat #1 is the button
Seat 1: sanpidk ($274.69 in chips) 
Seat 2: SPmaka ($107.02 in chips) 
Seat 3: vrnMike ($101.50 in chips) 
Seat 4: Sloeve ($122.24 in chips) 
Seat 6: kamillo91 ($92.97 in chips) 
Seat 7: mycka86 ($100 in chips) 
Seat 8: matiko09 ($100 in chips) 
Seat 9: maxxmeister ($101.50 in chips) 
SPmaka: posts small blind $0.50
vrnMike: posts big blind $1
*** HOLE CARDS ***
Dealt to matiko09 [6d 3d]
Sloeve: folds 
kamillo91: folds 
mycka86: raises $2 to $3
matiko09: folds 
maxxmeister: folds 
sanpidk: folds 
SPmaka: folds 
vrnMike: folds 
Uncalled bet ($2) returned to mycka86
mycka86 collected $2.50 from pot
*** SUMMARY ***
Total pot $2.50 | Rake $0 
Seat 1: sanpidk (button) folded before Flop (didn't bet)
Seat 2: SPmaka (small blind) folded before Flop
Seat 3: vrnMike (big blind) folded before Flop
Seat 4: Sloeve folded before Flop (didn't bet)
Seat 6: kamillo91 folded before Flop (didn't bet)
Seat 7: mycka86 collected ($2.50)
Seat 8: matiko09 folded before Flop (didn't bet)
Seat 9: maxxmeister folded before Flop (didn't bet)





PokerStars Hand #152885270641:  Hold'em No Limit ($1/$2 USD) - 2016/05/05 16:13:25 CET [2016/05/05 10:13:25 ET]
Table 'Samitchell' 9-max Seat #8 is the button
Seat 1: KovIFish89 ($229.35 in chips) 
Seat 2: matiko09 ($200 in chips) 
Seat 3: gabi_igna ($317.87 in chips) 
Seat 4: Fitzyferret ($371.13 in chips) 
Seat 6: Zhalgasai ($98 in chips) 
Seat 7: patpaty ($166.59 in chips) 
Seat 8: WolleMalone ($212.29 in chips) 
Seat 9: kblkxls ($100.07 in chips) 
kblkxls: posts small blind $1
KovIFish89: posts big blind $2
*** HOLE CARDS ***
Dealt to matiko09 [Kc 8h]
matiko09: folds 
gabi_igna: raises $4 to $6
Fitzyferret: folds 
Zhalgasai: folds 
patpaty: folds 
WolleMalone: raises $12 to $18
kblkxls: folds 
KovIFish89: folds 
gabi_igna: calls $12
*** FLOP *** [2c 5c 7h]
gabi_igna: checks 
WolleMalone: bets $19
gabi_igna: calls $19
*** TURN *** [2c 5c 7h] [Tc]
gabi_igna: checks 
WolleMalone: checks 
*** RIVER *** [2c 5c 7h Tc] [5d]
gabi_igna: bets $24
WolleMalone: folds 
Uncalled bet ($24) returned to gabi_igna
gabi_igna collected $74.25 from pot
gabi_igna: doesn't show hand 
*** SUMMARY ***
Total pot $77 | Rake $2.75 
Board [2c 5c 7h Tc 5d]
Seat 1: KovIFish89 (big blind) folded before Flop
Seat 2: matiko09 folded before Flop (didn't bet)
Seat 3: gabi_igna collected ($74.25)
Seat 4: Fitzyferret folded before Flop (didn't bet)
Seat 6: Zhalgasai folded before Flop (didn't bet)
Seat 7: patpaty folded before Flop (didn't bet)
Seat 8: WolleMalone (button) folded on the River
Seat 9: kblkxls (small blind) folded before Flop





PokerStars Hand #152885270510:  Hold'em No Limit ($1/$2 USD) - 2016/05/05 16:13:25 CET [2016/05/05 10:13:25 ET]
Table 'Tatry II' 9-max Seat #7 is the button
Seat 1: glanza_mike ($248.17 in chips) 
Seat 2: T0ny Adams ($86.40 in chips) 
Seat 3: matiko09 ($208.45 in chips) 
Seat 4: WolleMalone ($254.25 in chips) 
Seat 5: Painkiller72 ($344.68 in chips) 
Seat 6: Kukuryzka ($203.35 in chips) 
Seat 7: gabi_igna ($200 in chips) 
Seat 9: korol702 ($142.89 in chips) 
korol702: posts small blind $1
glanza_mike: posts big blind $2
*** HOLE CARDS ***
Dealt to matiko09 [3c 6c]
T0ny Adams: folds 
matiko09: folds 
WolleMalone: folds 
Painkiller72: folds 
Kukuryzka: raises $3 to $5
gabi_igna: raises $13 to $18
korol702: calls $17
glanza_mike: folds 
Kukuryzka: raises $47 to $65
gabi_igna: folds 
korol702: calls $47
*** FLOP *** [5c 7d 8d]
korol702: checks 
Kukuryzka: bets $138.35 and is all-in
korol702: folds 
Uncalled bet ($138.35) returned to Kukuryzka
Kukuryzka collected $147.25 from pot
Kukuryzka: doesn't show hand 
*** SUMMARY ***
Total pot $150 | Rake $2.75 
Board [5c 7d 8d]
Seat 1: glanza_mike (big blind) folded before Flop
Seat 2: T0ny Adams folded before Flop (didn't bet)
Seat 3: matiko09 folded before Flop (didn't bet)
Seat 4: WolleMalone folded before Flop (didn't bet)
Seat 5: Painkiller72 folded before Flop (didn't bet)
Seat 6: Kukuryzka collected ($147.25)
Seat 7: gabi_igna (button) folded before Flop
Seat 9: korol702 (small blind) folded on the Flop





PokerStars Hand #152885273709:  Hold'em No Limit ($0.50/$1.00 USD) - 2016/05/05 16:13:31 CET [2016/05/05 10:13:31 ET]
Table 'Musa II' 9-max Seat #2 is the button
Seat 1: KovIFish89 ($191.97 in chips) 
Seat 2: koutani7 ($95.50 in chips) 
Seat 3: vrnMike ($184.97 in chips) 
Seat 4: sanpidk ($102.72 in chips) 
Seat 6: cnn123 ($70.52 in chips) 
Seat 7: plaindaft1 ($125.18 in chips) 
Seat 8: matiko09 ($107.12 in chips) 
Seat 9: FroggyPlay ($100 in chips) 
vrnMike: posts small blind $0.50
sanpidk: posts big blind $1
nickreason17: sits out 
*** HOLE CARDS ***
Dealt to matiko09 [7h Kd]
cnn123: folds 
plaindaft1: calls $1
matiko09: folds 
FroggyPlay: folds 
KovIFish89: folds 
koutani7: folds 
vrnMike: calls $0.50
sanpidk: checks 
*** FLOP *** [9c 9d 8s]
vrnMike: bets $2.50
sanpidk: folds 
plaindaft1: folds 
Uncalled bet ($2.50) returned to vrnMike
vrnMike collected $2.85 from pot
*** SUMMARY ***
Total pot $3 | Rake $0.15 
Board [9c 9d 8s]
Seat 1: KovIFish89 folded before Flop (didn't bet)
Seat 2: koutani7 (button) folded before Flop (didn't bet)
Seat 3: vrnMike (small blind) collected ($2.85)
Seat 4: sanpidk (big blind) folded on the Flop
Seat 6: cnn123 folded before Flop (didn't bet)
Seat 7: plaindaft1 folded on the Flop
Seat 8: matiko09 folded before Flop (didn't bet)
Seat 9: FroggyPlay folded before Flop (didn't bet)





PokerStars Hand #152885277145:  Hold'em No Limit ($1/$2 USD) - 2016/05/05 16:13:36 CET [2016/05/05 10:13:36 ET]
Table 'Lundia' 9-max Seat #6 is the button
Seat 1: Fitzyferret ($244.60 in chips) 
Seat 2: patpaty ($172.27 in chips) 
Seat 3: Painkiller72 ($261.75 in chips) 
Seat 4: KovIFish89 ($311.66 in chips) 
Seat 5: zmOe84 ($172.76 in chips) 
Seat 6: CI58 ($200 in chips) 
Seat 7: matiko09 ($236.11 in chips) 
Seat 9: gabi_igna ($240.61 in chips) 
matiko09: posts small blind $1
gabi_igna: posts big blind $2
*** HOLE CARDS ***
Dealt to matiko09 [4s 6s]
Fitzyferret: folds 
patpaty: calls $2
Painkiller72: raises $7 to $9
KovIFish89: folds 
zmOe84: folds 
CI58: folds 
matiko09: folds 
gabi_igna: calls $7
patpaty: folds 
*** FLOP *** [Ts Jc 7s]
gabi_igna: checks 
Painkiller72: bets $13.96
gabi_igna: calls $13.96
*** TURN *** [Ts Jc 7s] [9d]
gabi_igna: checks 
Painkiller72: checks 
*** RIVER *** [Ts Jc 7s 9d] [3d]
gabi_igna: bets $36
Painkiller72: folds 
Uncalled bet ($36) returned to gabi_igna
gabi_igna collected $46.47 from pot
gabi_igna: doesn't show hand 
*** SUMMARY ***
Total pot $48.92 | Rake $2.45 
Board [Ts Jc 7s 9d 3d]
Seat 1: Fitzyferret folded before Flop (didn't bet)
Seat 2: patpaty folded before Flop
Seat 3: Painkiller72 folded on the River
Seat 4: KovIFish89 folded before Flop (didn't bet)
Seat 5: zmOe84 folded before Flop (didn't bet)
Seat 6: CI58 (button) folded before Flop (didn't bet)
Seat 7: matiko09 (small blind) folded before Flop
Seat 9: gabi_igna (big blind) collected ($46.47)





PokerStars Hand #152885280763:  Hold'em No Limit ($1/$2 USD) - 2016/05/05 16:13:42 CET [2016/05/05 10:13:42 ET]
Table 'Tololo' 9-max Seat #2 is the button
Seat 1: Kukuryzka ($233.29 in chips) 
Seat 2: gabi_igna ($222.45 in chips) 
Seat 3: nickreason17 ($221.22 in chips) 
Seat 4: mooose100 ($182.03 in chips) 
Seat 5: matiko09 ($200 in chips) 
Seat 6: Xagua ($222 in chips) 
Seat 8: KovIFish89 ($200 in chips) 
Seat 9: Fitzyferret ($374.47 in chips) 
nickreason17: posts small blind $1
mooose100: posts big blind $2
*** HOLE CARDS ***
Dealt to matiko09 [3s 7c]
matiko09: folds 
Xagua: raises $3 to $5
KovIFish89: folds 
Fitzyferret: calls $5
Kukuryzka: folds 
gabi_igna: folds 
nickreason17: folds 
mooose100: calls $3
*** FLOP *** [2h 8s Js]
mooose100: checks 
Xagua: checks 
Fitzyferret: checks 
*** TURN *** [2h 8s Js] [Jd]
mooose100: bets $7.60
Xagua: folds 
Fitzyferret: folds 
Uncalled bet ($7.60) returned to mooose100
mooose100 collected $15.20 from pot
mooose100: doesn't show hand 
*** SUMMARY ***
Total pot $16 | Rake $0.80 
Board [2h 8s Js Jd]
Seat 1: Kukuryzka folded before Flop (didn't bet)
Seat 2: gabi_igna (button) folded before Flop (didn't bet)
Seat 3: nickreason17 (small blind) folded before Flop
Seat 4: mooose100 (big blind) collected ($15.20)
Seat 5: matiko09 folded before Flop (didn't bet)
Seat 6: Xagua folded on the Turn
Seat 8: KovIFish89 folded before Flop (didn't bet)
Seat 9: Fitzyferret folded on the Turn





PokerStars Hand #152885284960:  Hold'em No Limit ($0.50/$1.00 USD) - 2016/05/05 16:13:50 CET [2016/05/05 10:13:50 ET]
Table 'Luthera' 9-max Seat #9 is the button
Seat 1: MrMattkk ($86.37 in chips) 
Seat 2: Kukuryzka ($99.50 in chips) 
Seat 3: sanpidk ($100 in chips) 
Seat 4: matiko09 ($111.48 in chips) 
Seat 5: Painkiller72 ($109.50 in chips) 
Seat 6: Dantist1122 ($100 in chips) 
Seat 7: Chin41178 ($101.96 in chips) 
Seat 9: vrnMike ($112.10 in chips) 
MrMattkk: posts small blind $0.50
Kukuryzka: posts big blind $1
*** HOLE CARDS ***
Dealt to matiko09 [3c Ah]
sanpidk: folds 
matiko09: folds 
Painkiller72: folds 
Dantist1122: folds 
Chin41178: folds 
vrnMike: raises $2 to $3
MrMattkk: calls $2.50
Kukuryzka: folds 
*** FLOP *** [5d 8c 9c]
MrMattkk: checks 
vrnMike: bets $5
MrMattkk: calls $5
*** TURN *** [5d 8c 9c] [9h]
MrMattkk: checks 
vrnMike: checks 
*** RIVER *** [5d 8c 9c 9h] [2s]
MrMattkk: bets $8.07
vrnMike: folds 
Uncalled bet ($8.07) returned to MrMattkk
MrMattkk collected $16.15 from pot
MrMattkk: doesn't show hand 
*** SUMMARY ***
Total pot $17 | Rake $0.85 
Board [5d 8c 9c 9h 2s]
Seat 1: MrMattkk (small blind) collected ($16.15)
Seat 2: Kukuryzka (big blind) folded before Flop
Seat 3: sanpidk folded before Flop (didn't bet)
Seat 4: matiko09 folded before Flop (didn't bet)
Seat 5: Painkiller72 folded before Flop (didn't bet)
Seat 6: Dantist1122 folded before Flop (didn't bet)
Seat 7: Chin41178 folded before Flop (didn't bet)
Seat 9: vrnMike (button) folded on the River





PokerStars Hand #152885287773:  Hold'em No Limit ($1/$2 USD) - 2016/05/05 16:13:54 CET [2016/05/05 10:13:54 ET]
Table 'Euporie II' 9-max Seat #2 is the button
Seat 1: gabi_igna ($202 in chips) 
Seat 2: nickreason17 ($204.35 in chips) 
Seat 4: Kukuryzka ($201.75 in chips) 
Seat 5: Nuskatko1986 ($60.73 in chips) 
Seat 6: glanza_mike ($202 in chips) 
Seat 7: matiko09 ($212.74 in chips) 
Seat 8: Painkiller72 ($300.25 in chips) 
Seat 9: T0ny Adams ($89.91 in chips) 
Kukuryzka: posts small blind $1
Nuskatko1986: posts big blind $2
*** HOLE CARDS ***
Dealt to matiko09 [Ks 5s]
glanza_mike: folds 
matiko09: folds 
Painkiller72: folds 
T0ny Adams: folds 
gabi_igna: folds 
nickreason17: raises $2 to $4
Kukuryzka: folds 
Nuskatko1986: calls $2
*** FLOP *** [Qs Qd 4s]
Nuskatko1986: checks 
nickreason17: bets $2.82
Nuskatko1986: calls $2.82
*** TURN *** [Qs Qd 4s] [9c]
Nuskatko1986: checks 
nickreason17: checks 
*** RIVER *** [Qs Qd 4s 9c] [Kh]
Nuskatko1986: checks 
nickreason17: bets $4.59
Nuskatko1986: folds 
Uncalled bet ($4.59) returned to nickreason17
nickreason17 collected $13.91 from pot
*** SUMMARY ***
Total pot $14.64 | Rake $0.73 
Board [Qs Qd 4s 9c Kh]
Seat 1: gabi_igna folded before Flop (didn't bet)
Seat 2: nickreason17 (button) collected ($13.91)
Seat 4: Kukuryzka (small blind) folded before Flop
Seat 5: Nuskatko1986 (big blind) folded on the River
Seat 6: glanza_mike folded before Flop (didn't bet)
Seat 7: matiko09 folded before Flop (didn't bet)
Seat 8: Painkiller72 folded before Flop (didn't bet)
Seat 9: T0ny Adams folded before Flop (didn't bet)





PokerStars Hand #152885291770:  Hold'em No Limit ($0.50/$1.00 USD) - 2016/05/05 16:14:01 CET [2016/05/05 10:14:01 ET]
Table 'Pyxis III' 9-max Seat #2 is the button
Seat 1: sanpidk ($274.69 in chips) 
Seat 2: SPmaka ($106.52 in chips) 
Seat 3: vrnMike ($100.50 in chips) 
Seat 4: Sloeve ($122.24 in chips) 
Seat 6: kamillo91 ($92.97 in chips) 
Seat 7: mycka86 ($101.50 in chips) 
Seat 8: matiko09 ($100 in chips) 
Seat 9: maxxmeister ($101.50 in chips) 
vrnMike: posts small blind $0.50
Sloeve: posts big blind $1
*** HOLE CARDS ***
Dealt to matiko09 [Kh Tc]
kamillo91 is disconnected 
kamillo91 has timed out while disconnected
kamillo91: folds 
mycka86: folds 
matiko09: folds 
maxxmeister: folds 
sanpidk: folds 
SPmaka: folds 
vrnMike: folds 
Uncalled bet ($0.50) returned to Sloeve
Sloeve collected $1 from pot
Sloeve: doesn't show hand 
*** SUMMARY ***
Total pot $1 | Rake $0 
Seat 1: sanpidk folded before Flop (didn't bet)
Seat 2: SPmaka (button) folded before Flop (didn't bet)
Seat 3: vrnMike (small blind) folded before Flop
Seat 4: Sloeve (big blind) collected ($1)
Seat 6: kamillo91 folded before Flop (didn't bet)
Seat 7: mycka86 folded before Flop (didn't bet)
Seat 8: matiko09 folded before Flop (didn't bet)
Seat 9: maxxmeister folded before Flop (didn't bet)





PokerStars Hand #152885294069:  Hold'em No Limit ($0.50/$1.00 USD) - 2016/05/05 16:14:05 CET [2016/05/05 10:14:05 ET]
Table 'Musa II' 9-max Seat #3 is the button
Seat 1: KovIFish89 ($191.97 in chips) 
Seat 2: koutani7 ($95.50 in chips) 
Seat 3: vrnMike ($186.82 in chips) 
Seat 4: sanpidk ($101.72 in chips) 
Seat 5: nickreason17 ($100 in chips) 
Seat 6: cnn123 ($70.52 in chips) 
Seat 7: plaindaft1 ($124.18 in chips) 
Seat 8: matiko09 ($107.12 in chips) 
Seat 9: FroggyPlay ($100 in chips) 
sanpidk: posts small blind $0.50
nickreason17: posts big blind $1
*** HOLE CARDS ***
Dealt to matiko09 [8c Ts]
cnn123: folds 
plaindaft1: folds 
matiko09: folds 
FroggyPlay: folds 
KovIFish89: folds 
koutani7: folds 
vrnMike: folds 
sanpidk: folds 
Uncalled bet ($0.50) returned to nickreason17
nickreason17 collected $1 from pot
*** SUMMARY ***
Total pot $1 | Rake $0 
Seat 1: KovIFish89 folded before Flop (didn't bet)
Seat 2: koutani7 folded before Flop (didn't bet)
Seat 3: vrnMike (button) folded before Flop (didn't bet)
Seat 4: sanpidk (small blind) folded before Flop
Seat 5: nickreason17 (big blind) collected ($1)
Seat 6: cnn123 folded before Flop (didn't bet)
Seat 7: plaindaft1 folded before Flop (didn't bet)
Seat 8: matiko09 folded before Flop (didn't bet)
Seat 9: FroggyPlay folded before Flop (didn't bet)





PokerStars Hand #152885298878:  Hold'em No Limit ($0.50/$1.00 USD) - 2016/05/05 16:14:13 CET [2016/05/05 10:14:13 ET]
Table 'Vela' 9-max Seat #1 is the button
Seat 1: mycka86 ($100 in chips) 
Seat 2: nickreason17 ($160.63 in chips) 
Seat 3: dviryo ($450.82 in chips) 
Seat 4: Hayer ana ($151.41 in chips) 
Seat 5: sanpidk ($101 in chips) 
Seat 6: matiko09 ($100 in chips) 
Seat 7: KovIFish89 ($104.88 in chips) 
Seat 8: vrnMike ($100 in chips) 
Seat 9: CI58 ($104.18 in chips) 
nickreason17: posts small blind $0.50
dviryo: posts big blind $1
*** HOLE CARDS ***
Dealt to matiko09 [6d 6h]
Hayer ana: folds 
sanpidk: folds 
matiko09: raises $2 to $3
KovIFish89: folds 
vrnMike: folds 
CI58: folds 
mycka86: folds 
nickreason17: folds 
dviryo: folds 
Uncalled bet ($2) returned to matiko09
matiko09 collected $2.50 from pot
matiko09: doesn't show hand 
*** SUMMARY ***
Total pot $2.50 | Rake $0 
Seat 1: mycka86 (button) folded before Flop (didn't bet)
Seat 2: nickreason17 (small blind) folded before Flop
Seat 3: dviryo (big blind) folded before Flop
Seat 4: Hayer ana folded before Flop (didn't bet)
Seat 5: sanpidk folded before Flop (didn't bet)
Seat 6: matiko09 collected ($2.50)
Seat 7: KovIFish89 folded before Flop (didn't bet)
Seat 8: vrnMike folded before Flop (didn't bet)
Seat 9: CI58 folded before Flop (didn't bet)





PokerStars Hand #152885308526:  Hold'em No Limit ($1/$2 USD) - 2016/05/05 16:14:29 CET [2016/05/05 10:14:29 ET]
Table 'Tatry II' 9-max Seat #9 is the button
Seat 1: glanza_mike ($246.17 in chips) 
Seat 3: matiko09 ($208.45 in chips) 
Seat 4: WolleMalone ($254.25 in chips) 
Seat 5: Painkiller72 ($344.68 in chips) 
Seat 6: Kukuryzka ($285.60 in chips) 
Seat 7: gabi_igna ($200 in chips) 
Seat 9: korol702 ($77.89 in chips) 
glanza_mike: posts small blind $1
T0ny Adams: is sitting out 
matiko09: posts big blind $2
*** HOLE CARDS ***
Dealt to matiko09 [5h 8s]
WolleMalone: folds 
Painkiller72: folds 
Kukuryzka: folds 
WolleMalone leaves the table
gabi_igna: folds 
korol702: folds 
PacPacBum joins the table at seat #4 
glanza_mike: raises $3 to $5
matiko09: folds 
Uncalled bet ($3) returned to glanza_mike
glanza_mike collected $4 from pot
glanza_mike: doesn't show hand 
*** SUMMARY ***
Total pot $4 | Rake $0 
Seat 1: glanza_mike (small blind) collected ($4)
Seat 3: matiko09 (big blind) folded before Flop
Seat 4: WolleMalone folded before Flop (didn't bet)
Seat 5: Painkiller72 folded before Flop (didn't bet)
Seat 6: Kukuryzka folded before Flop (didn't bet)
Seat 7: gabi_igna folded before Flop (didn't bet)
Seat 9: korol702 (button) folded before Flop (didn't bet)





PokerStars Hand #152885310911:  Hold'em No Limit ($0.50/$1.00 USD) - 2016/05/05 16:14:33 CET [2016/05/05 10:14:33 ET]
Table 'Musa II' 9-max Seat #4 is the button
Seat 1: KovIFish89 ($191.97 in chips) 
Seat 2: koutani7 ($95.50 in chips) 
Seat 3: vrnMike ($186.82 in chips) 
Seat 4: sanpidk ($101.22 in chips) 
Seat 5: nickreason17 ($100.50 in chips) 
Seat 6: cnn123 ($70.52 in chips) 
Seat 7: plaindaft1 ($124.18 in chips) 
Seat 8: matiko09 ($107.12 in chips) 
Seat 9: FroggyPlay ($100 in chips) 
nickreason17: posts small blind $0.50
cnn123: posts big blind $1
*** HOLE CARDS ***
Dealt to matiko09 [9d 3d]
plaindaft1: folds 
matiko09: folds 
FroggyPlay: raises $2.01 to $3.01
KovIFish89: folds 
koutani7: folds 
vrnMike: folds 
sanpidk: folds 
nickreason17: folds 
cnn123: calls $2.01
*** FLOP *** [Td 2s 3s]
cnn123: checks 
FroggyPlay: checks 
*** TURN *** [Td 2s 3s] [Qh]
cnn123: bets $5
FroggyPlay: folds 
Uncalled bet ($5) returned to cnn123
cnn123 collected $6.19 from pot
*** SUMMARY ***
Total pot $6.52 | Rake $0.33 
Board [Td 2s 3s Qh]
Seat 1: KovIFish89 folded before Flop (didn't bet)
Seat 2: koutani7 folded before Flop (didn't bet)
Seat 3: vrnMike folded before Flop (didn't bet)
Seat 4: sanpidk (button) folded before Flop (didn't bet)
Seat 5: nickreason17 (small blind) folded before Flop
Seat 6: cnn123 (big blind) collected ($6.19)
Seat 7: plaindaft1 folded before Flop (didn't bet)
Seat 8: matiko09 folded before Flop (didn't bet)
Seat 9: FroggyPlay folded on the Turn





PokerStars Hand #152885313199:  Hold'em No Limit ($1/$2 USD) - 2016/05/05 16:14:37 CET [2016/05/05 10:14:37 ET]
Table 'Samitchell' 9-max Seat #9 is the button
Seat 1: KovIFish89 ($227.35 in chips) 
Seat 2: matiko09 ($200 in chips) 
Seat 3: gabi_igna ($355.12 in chips) 
Seat 4: Fitzyferret ($371.13 in chips) 
Seat 5: chaps1988 ($272.17 in chips) 
Seat 6: Zhalgasai ($98 in chips) 
Seat 7: patpaty ($166.59 in chips) 
Seat 8: WolleMalone ($200 in chips) 
Seat 9: kblkxls ($99.07 in chips) 
KovIFish89: posts small blind $1
matiko09: posts big blind $2
*** HOLE CARDS ***
Dealt to matiko09 [Th 6s]
gabi_igna: folds 
Fitzyferret: folds 
chaps1988: folds 
Zhalgasai: folds 
patpaty: folds 
WolleMalone: folds 
kblkxls: calls $2
KovIFish89: folds 
matiko09: checks 
*** FLOP *** [5s Jd 3d]
matiko09: checks 
kblkxls: checks 
*** TURN *** [5s Jd 3d] [6d]
matiko09: bets $3.09
kblkxls: calls $3.09
*** RIVER *** [5s Jd 3d 6d] [Kd]
matiko09: checks 
kblkxls: bets $6
matiko09: folds 
Uncalled bet ($6) returned to kblkxls
kblkxls collected $10.62 from pot
kblkxls: doesn't show hand 
*** SUMMARY ***
Total pot $11.18 | Rake $0.56 
Board [5s Jd 3d 6d Kd]
Seat 1: KovIFish89 (small blind) folded before Flop
Seat 2: matiko09 (big blind) folded on the River
Seat 3: gabi_igna folded before Flop (didn't bet)
Seat 4: Fitzyferret folded before Flop (didn't bet)
Seat 5: chaps1988 folded before Flop (didn't bet)
Seat 6: Zhalgasai folded before Flop (didn't bet)
Seat 7: patpaty folded before Flop (didn't bet)
Seat 8: WolleMalone folded before Flop (didn't bet)
Seat 9: kblkxls (button) collected ($10.62)





PokerStars Hand #152885314683:  Hold'em No Limit ($1/$2 USD) - 2016/05/05 16:14:40 CET [2016/05/05 10:14:40 ET]
Table 'Tololo' 9-max Seat #3 is the button
Seat 1: Kukuryzka ($233.29 in chips) 
Seat 2: gabi_igna ($222.45 in chips) 
Seat 3: nickreason17 ($220.22 in chips) 
Seat 4: mooose100 ($192.23 in chips) 
Seat 5: matiko09 ($200 in chips) 
Seat 6: Xagua ($217 in chips) 
Seat 7: chaps1988 ($235.60 in chips) 
Seat 8: KovIFish89 ($200 in chips) 
Seat 9: Fitzyferret ($369.47 in chips) 
mooose100: posts small blind $1
matiko09: posts big blind $2
*** HOLE CARDS ***
Dealt to matiko09 [8d Ah]
Xagua: folds 
chaps1988: raises $4 to $6
KovIFish89: folds 
Fitzyferret: folds 
Kukuryzka: folds 
gabi_igna: folds 
nickreason17: folds 
mooose100: calls $5
matiko09: folds 
*** FLOP *** [Qs Th 7c]
mooose100: bets $13.30
chaps1988: raises $23.30 to $36.60
mooose100: calls $23.30
*** TURN *** [Qs Th 7c] [3d]
mooose100: checks 
chaps1988: bets $47.50
mooose100: folds 
Uncalled bet ($47.50) returned to chaps1988
chaps1988 collected $84.45 from pot
*** SUMMARY ***
Total pot $87.20 | Rake $2.75 
Board [Qs Th 7c 3d]
Seat 1: Kukuryzka folded before Flop (didn't bet)
Seat 2: gabi_igna folded before Flop (didn't bet)
Seat 3: nickreason17 (button) folded before Flop (didn't bet)
Seat 4: mooose100 (small blind) folded on the Turn
Seat 5: matiko09 (big blind) folded before Flop
Seat 6: Xagua folded before Flop (didn't bet)
Seat 7: chaps1988 collected ($84.45)
Seat 8: KovIFish89 folded before Flop (didn't bet)
Seat 9: Fitzyferret folded before Flop (didn't bet)





PokerStars Hand #152885315728:  Hold'em No Limit ($0.50/$1.00 USD) - 2016/05/05 16:14:41 CET [2016/05/05 10:14:41 ET]
Table 'Vela' 9-max Seat #2 is the button
Seat 1: mycka86 ($100 in chips) 
Seat 2: nickreason17 ($160.13 in chips) 
Seat 3: dviryo ($449.82 in chips) 
Seat 4: Hayer ana ($151.41 in chips) 
Seat 5: sanpidk ($101 in chips) 
Seat 6: matiko09 ($101.50 in chips) 
Seat 7: KovIFish89 ($104.88 in chips) 
Seat 8: vrnMike ($100 in chips) 
Seat 9: CI58 ($104.18 in chips) 
dviryo: posts small blind $0.50
Hayer ana: posts big blind $1
*** HOLE CARDS ***
Dealt to matiko09 [Ac 5c]
sanpidk: folds 
matiko09: folds 
KovIFish89: folds 
vrnMike: folds 
CI58: raises $2 to $3
mycka86: folds 
nickreason17: folds 
dviryo: calls $2.50
Hayer ana: calls $2
*** FLOP *** [As 3d Jc]
dviryo: checks 
Hayer ana: checks 
CI58: bets $5
dviryo: calls $5
Hayer ana: folds 
*** TURN *** [As 3d Jc] [6d]
dviryo: checks 
CI58: bets $11
dviryo: folds 
Uncalled bet ($11) returned to CI58
CI58 collected $18.05 from pot
*** SUMMARY ***
Total pot $19 | Rake $0.95 
Board [As 3d Jc 6d]
Seat 1: mycka86 folded before Flop (didn't bet)
Seat 2: nickreason17 (button) folded before Flop (didn't bet)
Seat 3: dviryo (small blind) folded on the Turn
Seat 4: Hayer ana (big blind) folded on the Flop
Seat 5: sanpidk folded before Flop (didn't bet)
Seat 6: matiko09 folded before Flop (didn't bet)
Seat 7: KovIFish89 folded before Flop (didn't bet)
Seat 8: vrnMike folded before Flop (didn't bet)
Seat 9: CI58 collected ($18.05)





PokerStars Hand #152885320542:  Hold'em No Limit ($0.50/$1.00 USD) - 2016/05/05 16:14:49 CET [2016/05/05 10:14:49 ET]
Table 'Luthera' 9-max Seat #1 is the button
Seat 1: MrMattkk ($94.52 in chips) 
Seat 2: Kukuryzka ($100 in chips) 
Seat 3: sanpidk ($100 in chips) 
Seat 4: matiko09 ($111.48 in chips) 
Seat 5: Painkiller72 ($109.50 in chips) 
Seat 6: Dantist1122 ($100 in chips) 
Seat 7: Chin41178 ($101.96 in chips) 
Seat 9: vrnMike ($104.10 in chips) 
Kukuryzka: posts small blind $0.50
sanpidk: posts big blind $1
*** HOLE CARDS ***
Dealt to matiko09 [2c Js]
matiko09: folds 
Painkiller72: folds 
Dantist1122: folds 
Chin41178: folds 
vrnMike: folds 
MrMattkk: folds 
Kukuryzka: raises $1.50 to $2.50
sanpidk: raises $5.50 to $8
Kukuryzka: calls $5.50
*** FLOP *** [Jh 6s 4s]
Kukuryzka: checks 
sanpidk: bets $9.50
Kukuryzka: folds 
Uncalled bet ($9.50) returned to sanpidk
sanpidk collected $15.20 from pot
sanpidk: doesn't show hand 
*** SUMMARY ***
Total pot $16 | Rake $0.80 
Board [Jh 6s 4s]
Seat 1: MrMattkk (button) folded before Flop (didn't bet)
Seat 2: Kukuryzka (small blind) folded on the Flop
Seat 3: sanpidk (big blind) collected ($15.20)
Seat 4: matiko09 folded before Flop (didn't bet)
Seat 5: Painkiller72 folded before Flop (didn't bet)
Seat 6: Dantist1122 folded before Flop (didn't bet)
Seat 7: Chin41178 folded before Flop (didn't bet)
Seat 9: vrnMike folded before Flop (didn't bet)





PokerStars Hand #152885324429:  Hold'em No Limit ($1/$2 USD) - 2016/05/05 16:14:56 CET [2016/05/05 10:14:56 ET]
Table 'Lundia' 9-max Seat #7 is the button
Seat 1: Fitzyferret ($244.60 in chips) 
Seat 2: patpaty ($170.27 in chips) 
Seat 3: Painkiller72 ($238.79 in chips) 
Seat 4: KovIFish89 ($311.66 in chips) 
Seat 5: zmOe84 ($172.76 in chips) 
Seat 6: CI58 ($200 in chips) 
Seat 7: matiko09 ($235.11 in chips) 
Seat 9: gabi_igna ($264.12 in chips) 
chaps1988 will be allowed to play after the button
gabi_igna: posts small blind $1
Fitzyferret: posts big blind $2
*** HOLE CARDS ***
Dealt to matiko09 [4s Qs]
patpaty: folds 
Painkiller72: folds 
KovIFish89: folds 
zmOe84: folds 
CI58: raises $2.50 to $4.50
matiko09: folds 
gabi_igna: folds 
Fitzyferret: calls $2.50
*** FLOP *** [Js Td 6s]
Fitzyferret: checks 
CI58: bets $4.75
Fitzyferret: calls $4.75
*** TURN *** [Js Td 6s] [5s]
Fitzyferret: checks 
CI58: checks 
*** RIVER *** [Js Td 6s 5s] [Qh]
Fitzyferret: checks 
CI58: bets $7.40
Fitzyferret: calls $7.40
*** SHOW DOWN ***
CI58: shows [Ac Kh] (a straight, Ten to Ace)
Fitzyferret: mucks hand 
CI58 collected $32.58 from pot
*** SUMMARY ***
Total pot $34.30 | Rake $1.72 
Board [Js Td 6s 5s Qh]
Seat 1: Fitzyferret (big blind) mucked [Jd Qc]
Seat 2: patpaty folded before Flop (didn't bet)
Seat 3: Painkiller72 folded before Flop (didn't bet)
Seat 4: KovIFish89 folded before Flop (didn't bet)
Seat 5: zmOe84 folded before Flop (didn't bet)
Seat 6: CI58 showed [Ac Kh] and won ($32.58) with a straight, Ten to Ace
Seat 7: matiko09 (button) folded before Flop (didn't bet)
Seat 9: gabi_igna (small blind) folded before Flop





PokerStars Hand #152885329122:  Hold'em No Limit ($1/$2 USD) - 2016/05/05 16:15:04 CET [2016/05/05 10:15:04 ET]
Table 'Tatry II' 9-max Seat #1 is the button
Seat 1: glanza_mike ($248.17 in chips) 
Seat 3: matiko09 ($206.45 in chips) 
Seat 4: PacPacBum ($200 in chips) 
Seat 5: Painkiller72 ($344.68 in chips) 
Seat 6: Kukuryzka ($285.60 in chips) 
Seat 7: gabi_igna ($200 in chips) 
Seat 9: korol702 ($77.89 in chips) 
T0ny Adams will be allowed to play after the button
matiko09: posts small blind $1
PacPacBum: posts big blind $2
chaps1988: sits out 
*** HOLE CARDS ***
Dealt to matiko09 [Qc 4s]
Painkiller72: folds 
Kukuryzka: folds 
gabi_igna: folds 
korol702: folds 
glanza_mike: raises $4 to $6
matiko09: folds 
PacPacBum: folds 
Uncalled bet ($4) returned to glanza_mike
glanza_mike collected $5 from pot
glanza_mike: doesn't show hand 
*** SUMMARY ***
Total pot $5 | Rake $0 
Seat 1: glanza_mike (button) collected ($5)
Seat 3: matiko09 (small blind) folded before Flop
Seat 4: PacPacBum (big blind) folded before Flop
Seat 5: Painkiller72 folded before Flop (didn't bet)
Seat 6: Kukuryzka folded before Flop (didn't bet)
Seat 7: gabi_igna folded before Flop (didn't bet)
Seat 9: korol702 folded before Flop (didn't bet)





PokerStars Hand #152885345029:  Hold'em No Limit ($0.50/$1.00 USD) - 2016/05/05 16:15:30 CET [2016/05/05 10:15:30 ET]
Table 'Musa II' 9-max Seat #5 is the button
Seat 1: KovIFish89 ($191.97 in chips) 
Seat 2: koutani7 ($95.50 in chips) 
Seat 3: vrnMike ($186.82 in chips) 
Seat 4: sanpidk ($101.22 in chips) 
Seat 5: nickreason17 ($100 in chips) 
Seat 6: cnn123 ($73.70 in chips) 
Seat 7: plaindaft1 ($124.18 in chips) 
Seat 8: matiko09 ($107.12 in chips) 
Seat 9: FroggyPlay ($100 in chips) 
cnn123: posts small blind $0.50
plaindaft1: posts big blind $1
*** HOLE CARDS ***
Dealt to matiko09 [8c 7c]
matiko09: raises $2 to $3
FroggyPlay: folds 
KovIFish89: folds 
koutani7: folds 
vrnMike: calls $3
sanpidk: folds 
nickreason17: raises $9 to $12
cnn123: folds 
plaindaft1: folds 
matiko09: folds 
vrnMike: folds 
Uncalled bet ($9) returned to nickreason17
nickreason17 collected $10.50 from pot
*** SUMMARY ***
Total pot $10.50 | Rake $0 
Seat 1: KovIFish89 folded before Flop (didn't bet)
Seat 2: koutani7 folded before Flop (didn't bet)
Seat 3: vrnMike folded before Flop
Seat 4: sanpidk folded before Flop (didn't bet)
Seat 5: nickreason17 (button) collected ($10.50)
Seat 6: cnn123 (small blind) folded before Flop
Seat 7: plaindaft1 (big blind) folded before Flop
Seat 8: matiko09 folded before Flop
Seat 9: FroggyPlay folded before Flop (didn't bet)





PokerStars Hand #152885347191:  Hold'em No Limit ($1/$2 USD) - 2016/05/05 16:15:34 CET [2016/05/05 10:15:34 ET]
Table 'Samitchell' 9-max Seat #1 is the button
Seat 1: KovIFish89 ($226.35 in chips) 
Seat 2: matiko09 ($200 in chips) 
Seat 3: gabi_igna ($355.12 in chips) 
Seat 4: Fitzyferret ($371.13 in chips) 
Seat 5: chaps1988 ($272.17 in chips) 
Seat 6: Zhalgasai ($98 in chips) 
Seat 7: patpaty ($166.59 in chips) 
Seat 8: WolleMalone ($200 in chips) 
Seat 9: kblkxls ($104.60 in chips) 
matiko09: posts small blind $1
gabi_igna: posts big blind $2
*** HOLE CARDS ***
Dealt to matiko09 [Tc Jh]
Fitzyferret: raises $3.24 to $5.24
chaps1988: folds 
Zhalgasai: folds 
patpaty: folds 
WolleMalone: folds 
kblkxls: folds 
KovIFish89: folds 
matiko09: folds 
gabi_igna: folds 
Uncalled bet ($3.24) returned to Fitzyferret
Fitzyferret collected $5 from pot
Fitzyferret: doesn't show hand 
*** SUMMARY ***
Total pot $5 | Rake $0 
Seat 1: KovIFish89 (button) folded before Flop (didn't bet)
Seat 2: matiko09 (small blind) folded before Flop
Seat 3: gabi_igna (big blind) folded before Flop
Seat 4: Fitzyferret collected ($5)
Seat 5: chaps1988 folded before Flop (didn't bet)
Seat 6: Zhalgasai folded before Flop (didn't bet)
Seat 7: patpaty folded before Flop (didn't bet)
Seat 8: WolleMalone folded before Flop (didn't bet)
Seat 9: kblkxls folded before Flop (didn't bet)





PokerStars Hand #152885353762:  Hold'em No Limit ($1/$2 USD) - 2016/05/05 16:15:45 CET [2016/05/05 10:15:45 ET]
Table 'Tatry II' 9-max Seat #3 is the button
Seat 1: glanza_mike ($251.17 in chips) 
Seat 3: matiko09 ($205.45 in chips) 
Seat 4: PacPacBum ($200 in chips) 
Seat 5: Painkiller72 ($344.68 in chips) 
Seat 6: Kukuryzka ($285.60 in chips) 
Seat 7: gabi_igna ($200 in chips) 
Seat 9: korol702 ($77.89 in chips) 
PacPacBum: posts small blind $1
Painkiller72: posts big blind $2
chaps1988: sits out 
T0ny Adams: sits out 
*** HOLE CARDS ***
Dealt to matiko09 [8d 2d]
Kukuryzka: folds 
gabi_igna: folds 
korol702: calls $2
glanza_mike: folds 
matiko09: folds 
PacPacBum: folds 
Painkiller72: raises $5 to $7
korol702: calls $5
*** FLOP *** [Ad 3d Jc]
Painkiller72: bets $9
korol702: calls $9
*** TURN *** [Ad 3d Jc] [6s]
Painkiller72: checks 
korol702: checks 
*** RIVER *** [Ad 3d Jc 6s] [3s]
Painkiller72: checks 
korol702: checks 
*** SHOW DOWN ***
Painkiller72: shows [Qs Kd] (a pair of Threes)
korol702: mucks hand 
Painkiller72 collected $31.35 from pot
*** SUMMARY ***
Total pot $33 | Rake $1.65 
Board [Ad 3d Jc 6s 3s]
Seat 1: glanza_mike folded before Flop (didn't bet)
Seat 3: matiko09 (button) folded before Flop (didn't bet)
Seat 4: PacPacBum (small blind) folded before Flop
Seat 5: Painkiller72 (big blind) showed [Qs Kd] and won ($31.35) with a pair of Threes
Seat 6: Kukuryzka folded before Flop (didn't bet)
Seat 7: gabi_igna folded before Flop (didn't bet)
Seat 9: korol702 mucked [9d Qd]





PokerStars Hand #152885354670:  Hold'em No Limit ($0.50/$1.00 USD) - 2016/05/05 16:15:46 CET [2016/05/05 10:15:46 ET]
Table 'Vela' 9-max Seat #3 is the button
Seat 1: mycka86 ($100 in chips) 
Seat 2: nickreason17 ($160.13 in chips) 
Seat 3: dviryo ($441.82 in chips) 
Seat 4: Hayer ana ($148.41 in chips) 
Seat 5: sanpidk ($101 in chips) 
Seat 6: matiko09 ($101.50 in chips) 
Seat 7: KovIFish89 ($104.88 in chips) 
Seat 8: vrnMike ($100 in chips) 
Seat 9: CI58 ($114.23 in chips) 
Hayer ana: posts small blind $0.50
sanpidk: posts big blind $1
*** HOLE CARDS ***
Dealt to matiko09 [Jd 9h]
matiko09: folds 
KovIFish89: folds 
vrnMike: folds 
CI58: folds 
mycka86: folds 
nickreason17: folds 
dviryo: folds 
Hayer ana: folds 
Uncalled bet ($0.50) returned to sanpidk
sanpidk collected $1 from pot
sanpidk: doesn't show hand 
*** SUMMARY ***
Total pot $1 | Rake $0 
Seat 1: mycka86 folded before Flop (didn't bet)
Seat 2: nickreason17 folded before Flop (didn't bet)
Seat 3: dviryo (button) folded before Flop (didn't bet)
Seat 4: Hayer ana (small blind) folded before Flop
Seat 5: sanpidk (big blind) collected ($1)
Seat 6: matiko09 folded before Flop (didn't bet)
Seat 7: KovIFish89 folded before Flop (didn't bet)
Seat 8: vrnMike folded before Flop (didn't bet)
Seat 9: CI58 folded before Flop (didn't bet)





PokerStars Hand #152885354546:  Hold'em No Limit ($1/$2 USD) - 2016/05/05 16:15:46 CET [2016/05/05 10:15:46 ET]
Table 'Euporie II' 9-max Seat #4 is the button
Seat 1: gabi_igna ($202 in chips) 
Seat 2: nickreason17 ($211.44 in chips) 
Seat 4: Kukuryzka ($200.75 in chips) 
Seat 5: Nuskatko1986 ($53.91 in chips) 
Seat 6: glanza_mike ($202 in chips) 
Seat 7: matiko09 ($212.74 in chips) 
Seat 8: Painkiller72 ($300.25 in chips) 
Seat 9: T0ny Adams ($89.91 in chips) 
Nuskatko1986: posts small blind $1
glanza_mike: posts big blind $2
chaps1988: sits out 
*** HOLE CARDS ***
Dealt to matiko09 [9d 2d]
matiko09: folds 
Painkiller72: folds 
T0ny Adams: folds 
gabi_igna: folds 
nickreason17: folds 
Kukuryzka: folds 
Nuskatko1986 has timed out
Nuskatko1986: folds 
Uncalled bet ($1) returned to glanza_mike
glanza_mike collected $2 from pot
glanza_mike: doesn't show hand 
*** SUMMARY ***
Total pot $2 | Rake $0 
Seat 1: gabi_igna folded before Flop (didn't bet)
Seat 2: nickreason17 folded before Flop (didn't bet)
Seat 4: Kukuryzka (button) folded before Flop (didn't bet)
Seat 5: Nuskatko1986 (small blind) folded before Flop
Seat 6: glanza_mike (big blind) collected ($2)
Seat 7: matiko09 folded before Flop (didn't bet)
Seat 8: Painkiller72 folded before Flop (didn't bet)
Seat 9: T0ny Adams folded before Flop (didn't bet)





PokerStars Hand #152885360845:  Hold'em No Limit ($1/$2 USD) - 2016/05/05 16:15:56 CET [2016/05/05 10:15:56 ET]
Table 'Samitchell' 9-max Seat #2 is the button
Seat 1: KovIFish89 ($226.35 in chips) 
Seat 2: matiko09 ($200 in chips) 
Seat 3: gabi_igna ($353.12 in chips) 
Seat 4: Fitzyferret ($374.13 in chips) 
Seat 5: chaps1988 ($272.17 in chips) 
Seat 6: Zhalgasai ($98 in chips) 
Seat 7: patpaty ($166.59 in chips) 
Seat 8: WolleMalone ($200 in chips) 
Seat 9: kblkxls ($104.60 in chips) 
gabi_igna: posts small blind $1
Fitzyferret: posts big blind $2
*** HOLE CARDS ***
Dealt to matiko09 [2h Ts]
chaps1988: folds 
Zhalgasai: folds 
patpaty: folds 
WolleMalone: folds 
kblkxls: folds 
KovIFish89: folds 
matiko09: folds 
gabi_igna: raises $4 to $6
Fitzyferret: folds 
Uncalled bet ($4) returned to gabi_igna
gabi_igna collected $4 from pot
gabi_igna: doesn't show hand 
*** SUMMARY ***
Total pot $4 | Rake $0 
Seat 1: KovIFish89 folded before Flop (didn't bet)
Seat 2: matiko09 (button) folded before Flop (didn't bet)
Seat 3: gabi_igna (small blind) collected ($4)
Seat 4: Fitzyferret (big blind) folded before Flop
Seat 5: chaps1988 folded before Flop (didn't bet)
Seat 6: Zhalgasai folded before Flop (didn't bet)
Seat 7: patpaty folded before Flop (didn't bet)
Seat 8: WolleMalone folded before Flop (didn't bet)
Seat 9: kblkxls folded before Flop (didn't bet)





PokerStars Hand #152885367650:  Hold'em No Limit ($1/$2 USD) - 2016/05/05 16:16:08 CET [2016/05/05 10:16:08 ET]
Table 'Tololo' 9-max Seat #4 is the button
Seat 1: Kukuryzka ($233.29 in chips) 
Seat 2: gabi_igna ($222.45 in chips) 
Seat 3: nickreason17 ($220.22 in chips) 
Seat 4: mooose100 ($149.63 in chips) 
Seat 5: matiko09 ($200 in chips) 
Seat 6: Xagua ($217 in chips) 
Seat 7: chaps1988 ($277.45 in chips) 
Seat 8: KovIFish89 ($200 in chips) 
Seat 9: Fitzyferret ($369.47 in chips) 
matiko09: posts small blind $1
Xagua: posts big blind $2
*** HOLE CARDS ***
Dealt to matiko09 [3d 8h]
chaps1988: folds 
KovIFish89: raises $4 to $6
Fitzyferret: folds 
Kukuryzka: folds 
gabi_igna: folds 
nickreason17: folds 
mooose100: folds 
matiko09: folds 
Xagua: calls $4
*** FLOP *** [7h 5d 4c]
Xagua: checks 
KovIFish89: bets $7
Xagua: folds 
Uncalled bet ($7) returned to KovIFish89
KovIFish89 collected $12.35 from pot
KovIFish89: doesn't show hand 
*** SUMMARY ***
Total pot $13 | Rake $0.65 
Board [7h 5d 4c]
Seat 1: Kukuryzka folded before Flop (didn't bet)
Seat 2: gabi_igna folded before Flop (didn't bet)
Seat 3: nickreason17 folded before Flop (didn't bet)
Seat 4: mooose100 (button) folded before Flop (didn't bet)
Seat 5: matiko09 (small blind) folded before Flop
Seat 6: Xagua (big blind) folded on the Flop
Seat 7: chaps1988 folded before Flop (didn't bet)
Seat 8: KovIFish89 collected ($12.35)
Seat 9: Fitzyferret folded before Flop (didn't bet)





PokerStars Hand #152885369399:  Hold'em No Limit ($0.50/$1.00 USD) - 2016/05/05 16:16:11 CET [2016/05/05 10:16:11 ET]
Table 'Luthera' 9-max Seat #2 is the button
Seat 1: MrMattkk ($94.52 in chips) 
Seat 2: Kukuryzka ($100 in chips) 
Seat 3: sanpidk ($107.20 in chips) 
Seat 4: matiko09 ($111.48 in chips) 
Seat 5: Painkiller72 ($109.50 in chips) 
Seat 6: Dantist1122 ($100 in chips) 
Seat 7: Chin41178 ($101.96 in chips) 
Seat 9: vrnMike ($104.10 in chips) 
sanpidk: posts small blind $0.50
matiko09: posts big blind $1
xdrKush420x: sits out 
*** HOLE CARDS ***
Dealt to matiko09 [5d 4h]
Painkiller72: folds 
Dantist1122: folds 
Chin41178: folds 
vrnMike: folds 
MrMattkk: folds 
Kukuryzka: raises $1 to $2
sanpidk: folds 
matiko09: folds 
Uncalled bet ($1) returned to Kukuryzka
Kukuryzka collected $2.50 from pot
Kukuryzka: doesn't show hand 
*** SUMMARY ***
Total pot $2.50 | Rake $0 
Seat 1: MrMattkk folded before Flop (didn't bet)
Seat 2: Kukuryzka (button) collected ($2.50)
Seat 3: sanpidk (small blind) folded before Flop
Seat 4: matiko09 (big blind) folded before Flop
Seat 5: Painkiller72 folded before Flop (didn't bet)
Seat 6: Dantist1122 folded before Flop (didn't bet)
Seat 7: Chin41178 folded before Flop (didn't bet)
Seat 9: vrnMike folded before Flop (didn't bet)





PokerStars Hand #152885373401:  Hold'em No Limit ($0.50/$1.00 USD) - 2016/05/05 16:16:18 CET [2016/05/05 10:16:18 ET]
Table 'Musa II' 9-max Seat #6 is the button
Seat 1: KovIFish89 ($191.97 in chips) 
Seat 2: koutani7 ($95.50 in chips) 
Seat 3: vrnMike ($183.82 in chips) 
Seat 4: sanpidk ($101.22 in chips) 
Seat 5: nickreason17 ($107.50 in chips) 
Seat 6: cnn123 ($73.20 in chips) 
Seat 7: plaindaft1 ($123.18 in chips) 
Seat 8: matiko09 ($104.12 in chips) 
Seat 9: FroggyPlay ($100 in chips) 
plaindaft1: posts small blind $0.50
matiko09: posts big blind $1
*** HOLE CARDS ***
Dealt to matiko09 [2c Th]
FroggyPlay: folds 
KovIFish89: folds 
koutani7: raises $2 to $3
vrnMike: folds 
sanpidk: folds 
nickreason17: folds 
cnn123: folds 
plaindaft1: folds 
matiko09: folds 
Uncalled bet ($2) returned to koutani7
koutani7 collected $2.50 from pot
koutani7: doesn't show hand 
*** SUMMARY ***
Total pot $2.50 | Rake $0 
Seat 1: KovIFish89 folded before Flop (didn't bet)
Seat 2: koutani7 collected ($2.50)
Seat 3: vrnMike folded before Flop (didn't bet)
Seat 4: sanpidk folded before Flop (didn't bet)
Seat 5: nickreason17 folded before Flop (didn't bet)
Seat 6: cnn123 (button) folded before Flop (didn't bet)
Seat 7: plaindaft1 (small blind) folded before Flop
Seat 8: matiko09 (big blind) folded before Flop
Seat 9: FroggyPlay folded before Flop (didn't bet)





PokerStars Hand #152885375136:  Hold'em No Limit ($0.50/$1.00 USD) - 2016/05/05 16:16:20 CET [2016/05/05 10:16:20 ET]
Table 'Vela' 9-max Seat #4 is the button
Seat 1: mycka86 ($100 in chips) 
Seat 2: nickreason17 ($160.13 in chips) 
Seat 3: dviryo ($441.82 in chips) 
Seat 4: Hayer ana ($147.91 in chips) 
Seat 5: sanpidk ($101.50 in chips) 
Seat 6: matiko09 ($101.50 in chips) 
Seat 7: KovIFish89 ($104.88 in chips) 
Seat 8: vrnMike ($100 in chips) 
Seat 9: CI58 ($114.23 in chips) 
sanpidk: posts small blind $0.50
matiko09: posts big blind $1
*** HOLE CARDS ***
Dealt to matiko09 [Kc 9h]
KovIFish89: folds 
vrnMike: folds 
CI58: raises $2 to $3
mycka86: folds 
nickreason17: folds 
dviryo: folds 
Hayer ana: folds 
sanpidk: folds 
matiko09: folds 
Uncalled bet ($2) returned to CI58
CI58 collected $2.50 from pot
CI58: doesn't show hand 
*** SUMMARY ***
Total pot $2.50 | Rake $0 
Seat 1: mycka86 folded before Flop (didn't bet)
Seat 2: nickreason17 folded before Flop (didn't bet)
Seat 3: dviryo folded before Flop (didn't bet)
Seat 4: Hayer ana (button) folded before Flop (didn't bet)
Seat 5: sanpidk (small blind) folded before Flop
Seat 6: matiko09 (big blind) folded before Flop
Seat 7: KovIFish89 folded before Flop (didn't bet)
Seat 8: vrnMike folded before Flop (didn't bet)
Seat 9: CI58 collected ($2.50)





PokerStars Hand #152885381246:  Hold'em No Limit ($1/$2 USD) - 2016/05/05 16:16:31 CET [2016/05/05 10:16:31 ET]
Table 'Tatry II' 9-max Seat #4 is the button
Seat 1: glanza_mike ($251.17 in chips) 
Seat 3: matiko09 ($205.45 in chips) 
Seat 4: PacPacBum ($200 in chips) 
Seat 5: Painkiller72 ($360.03 in chips) 
Seat 7: gabi_igna ($200 in chips) 
Seat 9: korol702 ($61.89 in chips) 
Painkiller72: posts small blind $1
Kukuryzka: is sitting out 
gabi_igna: posts big blind $2
chaps1988: sits out 
T0ny Adams: sits out 
*** HOLE CARDS ***
Dealt to matiko09 [Ad Jh]
korol702: calls $2
glanza_mike: raises $5 to $7
matiko09: raises $13 to $20
PacPacBum: folds 
Painkiller72: folds 
gabi_igna: folds 
korol702: folds 
glanza_mike: folds 
Uncalled bet ($13) returned to matiko09
matiko09 collected $19 from pot
matiko09: doesn't show hand 
*** SUMMARY ***
Total pot $19 | Rake $0 
Seat 1: glanza_mike folded before Flop
Seat 3: matiko09 collected ($19)
Seat 4: PacPacBum (button) folded before Flop (didn't bet)
Seat 5: Painkiller72 (small blind) folded before Flop
Seat 7: gabi_igna (big blind) folded before Flop
Seat 9: korol702 folded before Flop





PokerStars Hand #152885381886:  Hold'em No Limit ($1/$2 USD) - 2016/05/05 16:16:32 CET [2016/05/05 10:16:32 ET]
Table 'Samitchell' 9-max Seat #3 is the button
Seat 1: KovIFish89 ($226.35 in chips) 
Seat 2: matiko09 ($200 in chips) 
Seat 3: gabi_igna ($355.12 in chips) 
Seat 4: Fitzyferret ($372.13 in chips) 
Seat 5: chaps1988 ($272.17 in chips) 
Seat 6: Zhalgasai ($98 in chips) 
Seat 7: patpaty ($166.59 in chips) 
Seat 8: WolleMalone ($200 in chips) 
Seat 9: kblkxls ($104.60 in chips) 
Fitzyferret: posts small blind $1
chaps1988: posts big blind $2
*** HOLE CARDS ***
Dealt to matiko09 [4h 7c]
Zhalgasai: folds 
patpaty: folds 
WolleMalone: folds 
kblkxls: raises $2 to $4
KovIFish89: folds 
matiko09: folds 
gabi_igna: folds 
Fitzyferret: folds 
chaps1988: folds 
Uncalled bet ($2) returned to kblkxls
kblkxls collected $5 from pot
kblkxls: doesn't show hand 
*** SUMMARY ***
Total pot $5 | Rake $0 
Seat 1: KovIFish89 folded before Flop (didn't bet)
Seat 2: matiko09 folded before Flop (didn't bet)
Seat 3: gabi_igna (button) folded before Flop (didn't bet)
Seat 4: Fitzyferret (small blind) folded before Flop
Seat 5: chaps1988 (big blind) folded before Flop
Seat 6: Zhalgasai folded before Flop (didn't bet)
Seat 7: patpaty folded before Flop (didn't bet)
Seat 8: WolleMalone folded before Flop (didn't bet)
Seat 9: kblkxls collected ($5)





PokerStars Hand #152885386460:  Hold'em No Limit ($0.50/$1.00 USD) - 2016/05/05 16:16:39 CET [2016/05/05 10:16:39 ET]
Table 'Luthera' 9-max Seat #3 is the button
Seat 1: MrMattkk ($94.52 in chips) 
Seat 2: Kukuryzka ($101.50 in chips) 
Seat 3: sanpidk ($106.70 in chips) 
Seat 4: matiko09 ($110.48 in chips) 
Seat 5: Painkiller72 ($109.50 in chips) 
Seat 6: Dantist1122 ($100 in chips) 
Seat 7: Chin41178 ($101.96 in chips) 
Seat 9: vrnMike ($104.10 in chips) 
matiko09: posts small blind $0.50
Painkiller72: posts big blind $1
xdrKush420x: sits out 
*** HOLE CARDS ***
Dealt to matiko09 [8s Qd]
Dantist1122: folds 
Chin41178: folds 
vrnMike: folds 
MrMattkk: folds 
Kukuryzka: folds 
sanpidk: folds 
matiko09: folds 
Uncalled bet ($0.50) returned to Painkiller72
Painkiller72 collected $1 from pot
Painkiller72: doesn't show hand 
*** SUMMARY ***
Total pot $1 | Rake $0 
Seat 1: MrMattkk folded before Flop (didn't bet)
Seat 2: Kukuryzka folded before Flop (didn't bet)
Seat 3: sanpidk (button) folded before Flop (didn't bet)
Seat 4: matiko09 (small blind) folded before Flop
Seat 5: Painkiller72 (big blind) collected ($1)
Seat 6: Dantist1122 folded before Flop (didn't bet)
Seat 7: Chin41178 folded before Flop (didn't bet)
Seat 9: vrnMike folded before Flop (didn't bet)





PokerStars Hand #152885388903:  Hold'em No Limit ($1/$2 USD) - 2016/05/05 16:16:44 CET [2016/05/05 10:16:44 ET]
Table 'Lundia' 9-max Seat #9 is the button
Seat 1: Fitzyferret ($227.95 in chips) 
Seat 2: patpaty ($170.27 in chips) 
Seat 3: Painkiller72 ($238.79 in chips) 
Seat 4: KovIFish89 ($311.66 in chips) 
Seat 5: zmOe84 ($172.76 in chips) 
Seat 6: CI58 ($215.93 in chips) 
Seat 7: matiko09 ($235.11 in chips) 
Seat 9: gabi_igna ($263.12 in chips) 
Fitzyferret: posts small blind $1
patpaty: posts big blind $2
chaps1988: sits out 
*** HOLE CARDS ***
Dealt to matiko09 [4d Tc]
Painkiller72: folds 
KovIFish89: folds 
zmOe84: calls $2
CI58: folds 
matiko09: folds 
gabi_igna: folds 
Fitzyferret: raises $7.22 to $9.22
patpaty: folds 
zmOe84: calls $7.22
*** FLOP *** [Kd 5c 4s]
Fitzyferret: bets $8
zmOe84: calls $8
*** TURN *** [Kd 5c 4s] [Qh]
Fitzyferret: bets $20
zmOe84: folds 
Uncalled bet ($20) returned to Fitzyferret
Fitzyferret collected $34.62 from pot
Fitzyferret: doesn't show hand 
*** SUMMARY ***
Total pot $36.44 | Rake $1.82 
Board [Kd 5c 4s Qh]
Seat 1: Fitzyferret (small blind) collected ($34.62)
Seat 2: patpaty (big blind) folded before Flop
Seat 3: Painkiller72 folded before Flop (didn't bet)
Seat 4: KovIFish89 folded before Flop (didn't bet)
Seat 5: zmOe84 folded on the Turn
Seat 6: CI58 folded before Flop (didn't bet)
Seat 7: matiko09 folded before Flop (didn't bet)
Seat 9: gabi_igna (button) folded before Flop (didn't bet)





PokerStars Hand #152885392085:  Hold'em No Limit ($1/$2 USD) - 2016/05/05 16:16:49 CET [2016/05/05 10:16:49 ET]
Table 'Tololo' 9-max Seat #5 is the button
Seat 1: Kukuryzka ($233.29 in chips) 
Seat 2: gabi_igna ($222.45 in chips) 
Seat 3: nickreason17 ($220.22 in chips) 
Seat 4: mooose100 ($149.63 in chips) 
Seat 5: matiko09 ($200 in chips) 
Seat 6: Xagua ($211 in chips) 
Seat 7: chaps1988 ($277.45 in chips) 
Seat 8: KovIFish89 ($206.35 in chips) 
Seat 9: Fitzyferret ($369.47 in chips) 
Xagua: posts small blind $1
chaps1988: posts big blind $2
*** HOLE CARDS ***
Dealt to matiko09 [3h Jh]
KovIFish89: folds 
Fitzyferret: folds 
Kukuryzka: folds 
gabi_igna: folds 
nickreason17: folds 
mooose100: calls $2
matiko09: folds 
Xagua: calls $1
chaps1988: checks 
*** FLOP *** [9h 2h As]
Xagua: checks 
chaps1988: checks 
mooose100: checks 
*** TURN *** [9h 2h As] [5d]
Xagua: bets $4
chaps1988: folds 
mooose100: calls $4
*** RIVER *** [9h 2h As 5d] [9c]
Xagua: bets $6
mooose100: raises $25.30 to $31.30
Xagua: calls $25.30
*** SHOW DOWN ***
mooose100: shows [9d Td] (three of a kind, Nines)
Xagua: mucks hand 
mooose100 collected $73.85 from pot
*** SUMMARY ***
Total pot $76.60 | Rake $2.75 
Board [9h 2h As 5d 9c]
Seat 1: Kukuryzka folded before Flop (didn't bet)
Seat 2: gabi_igna folded before Flop (didn't bet)
Seat 3: nickreason17 folded before Flop (didn't bet)
Seat 4: mooose100 showed [9d Td] and won ($73.85) with three of a kind, Nines
Seat 5: matiko09 (button) folded before Flop (didn't bet)
Seat 6: Xagua (small blind) mucked [Ac Th]
Seat 7: chaps1988 (big blind) folded on the Turn
Seat 8: KovIFish89 folded before Flop (didn't bet)
Seat 9: Fitzyferret folded before Flop (didn't bet)





PokerStars Hand #152885394790:  Hold'em No Limit ($0.50/$1.00 USD) - 2016/05/05 16:16:53 CET [2016/05/05 10:16:53 ET]
Table 'Musa II' 9-max Seat #7 is the button
Seat 1: KovIFish89 ($191.97 in chips) 
Seat 2: koutani7 ($97 in chips) 
Seat 3: vrnMike ($183.82 in chips) 
Seat 4: sanpidk ($101.22 in chips) 
Seat 5: nickreason17 ($107.50 in chips) 
Seat 6: cnn123 ($73.20 in chips) 
Seat 7: plaindaft1 ($122.68 in chips) 
Seat 8: matiko09 ($103.12 in chips) 
Seat 9: FroggyPlay ($100 in chips) 
matiko09: posts small blind $0.50
FroggyPlay: posts big blind $1
*** HOLE CARDS ***
Dealt to matiko09 [3d 9c]
KovIFish89: folds 
koutani7: folds 
vrnMike: folds 
sanpidk: folds 
nickreason17: folds 
cnn123: raises $2 to $3
plaindaft1: folds 
matiko09: folds 
FroggyPlay: calls $2
*** FLOP *** [7s Th 4d]
FroggyPlay: checks 
cnn123: checks 
*** TURN *** [7s Th 4d] [3h]
FroggyPlay: checks 
cnn123: checks 
*** RIVER *** [7s Th 4d 3h] [3s]
FroggyPlay: checks 
cnn123: checks 
*** SHOW DOWN ***
FroggyPlay: shows [2s 2h] (two pair, Threes and Deuces)
cnn123: mucks hand 
FroggyPlay collected $6.18 from pot
*** SUMMARY ***
Total pot $6.50 | Rake $0.32 
Board [7s Th 4d 3h 3s]
Seat 1: KovIFish89 folded before Flop (didn't bet)
Seat 2: koutani7 folded before Flop (didn't bet)
Seat 3: vrnMike folded before Flop (didn't bet)
Seat 4: sanpidk folded before Flop (didn't bet)
Seat 5: nickreason17 folded before Flop (didn't bet)
Seat 6: cnn123 mucked [Ah Js]
Seat 7: plaindaft1 (button) folded before Flop (didn't bet)
Seat 8: matiko09 (small blind) folded before Flop
Seat 9: FroggyPlay (big blind) showed [2s 2h] and won ($6.18) with two pair, Threes and Deuces





PokerStars Hand #152885394687:  Hold'em No Limit ($1/$2 USD) - 2016/05/05 16:16:53 CET [2016/05/05 10:16:53 ET]
Table 'Euporie II' 9-max Seat #6 is the button
Seat 1: gabi_igna ($202 in chips) 
Seat 2: nickreason17 ($211.44 in chips) 
Seat 4: Kukuryzka ($200.75 in chips) 
Seat 6: glanza_mike ($203 in chips) 
Seat 7: matiko09 ($212.74 in chips) 
Seat 8: Painkiller72 ($300.25 in chips) 
Seat 9: T0ny Adams ($89.91 in chips) 
matiko09: posts small blind $1
Painkiller72: posts big blind $2
chaps1988: sits out 
*** HOLE CARDS ***
Dealt to matiko09 [7h 8s]
T0ny Adams: folds 
gabi_igna: raises $4 to $6
nickreason17: folds 
Kukuryzka: folds 
glanza_mike: folds 
matiko09: folds 
Painkiller72: folds 
Uncalled bet ($4) returned to gabi_igna
gabi_igna collected $5 from pot
gabi_igna: doesn't show hand 
*** SUMMARY ***
Total pot $5 | Rake $0 
Seat 1: gabi_igna collected ($5)
Seat 2: nickreason17 folded before Flop (didn't bet)
Seat 4: Kukuryzka folded before Flop (didn't bet)
Seat 6: glanza_mike (button) folded before Flop (didn't bet)
Seat 7: matiko09 (small blind) folded before Flop
Seat 8: Painkiller72 (big blind) folded before Flop
Seat 9: T0ny Adams folded before Flop (didn't bet)





PokerStars Hand #152885397250:  Hold'em No Limit ($0.50/$1.00 USD) - 2016/05/05 16:16:58 CET [2016/05/05 10:16:58 ET]
Table 'Luthera' 9-max Seat #4 is the button
Seat 1: MrMattkk ($94.52 in chips) 
Seat 2: Kukuryzka ($101.50 in chips) 
Seat 3: sanpidk ($106.70 in chips) 
Seat 4: matiko09 ($109.98 in chips) 
Seat 5: Painkiller72 ($110 in chips) 
Seat 6: Dantist1122 ($100 in chips) 
Seat 7: Chin41178 ($101.96 in chips) 
Seat 9: vrnMike ($104.10 in chips) 
Painkiller72: posts small blind $0.50
Dantist1122: posts big blind $1
xdrKush420x: sits out 
*** HOLE CARDS ***
Dealt to matiko09 [Kd 9d]
Chin41178: folds 
vrnMike: folds 
MrMattkk: raises $2 to $3
Kukuryzka: folds 
sanpidk: folds 
matiko09: folds 
Painkiller72: folds 
Dantist1122: folds 
Uncalled bet ($2) returned to MrMattkk
MrMattkk collected $2.50 from pot
MrMattkk: doesn't show hand 
*** SUMMARY ***
Total pot $2.50 | Rake $0 
Seat 1: MrMattkk collected ($2.50)
Seat 2: Kukuryzka folded before Flop (didn't bet)
Seat 3: sanpidk folded before Flop (didn't bet)
Seat 4: matiko09 (button) folded before Flop (didn't bet)
Seat 5: Painkiller72 (small blind) folded before Flop
Seat 6: Dantist1122 (big blind) folded before Flop
Seat 7: Chin41178 folded before Flop (didn't bet)
Seat 9: vrnMike folded before Flop (didn't bet)





PokerStars Hand #152885402483:  Hold'em No Limit ($1/$2 USD) - 2016/05/05 16:17:06 CET [2016/05/05 10:17:06 ET]
Table 'Samitchell' 9-max Seat #4 is the button
Seat 1: KovIFish89 ($226.35 in chips) 
Seat 2: matiko09 ($200 in chips) 
Seat 3: gabi_igna ($355.12 in chips) 
Seat 4: Fitzyferret ($371.13 in chips) 
Seat 5: chaps1988 ($270.17 in chips) 
Seat 6: Zhalgasai ($98 in chips) 
Seat 7: patpaty ($166.59 in chips) 
Seat 8: WolleMalone ($200 in chips) 
Seat 9: kblkxls ($107.60 in chips) 
chaps1988: posts small blind $1
Zhalgasai: posts big blind $2
*** HOLE CARDS ***
Dealt to matiko09 [6h 6d]
patpaty: folds 
WolleMalone: folds 
kblkxls: folds 
KovIFish89: folds 
matiko09: raises $3 to $5
gabi_igna: folds 
Fitzyferret: folds 
chaps1988: calls $4
Zhalgasai: folds 
*** FLOP *** [Ah 4d 2c]
chaps1988: checks 
matiko09: checks 
*** TURN *** [Ah 4d 2c] [Tc]
chaps1988: checks 
matiko09: checks 
*** RIVER *** [Ah 4d 2c Tc] [Jc]
chaps1988: bets $10.50
matiko09: folds 
Uncalled bet ($10.50) returned to chaps1988
chaps1988 collected $11.40 from pot
*** SUMMARY ***
Total pot $12 | Rake $0.60 
Board [Ah 4d 2c Tc Jc]
Seat 1: KovIFish89 folded before Flop (didn't bet)
Seat 2: matiko09 folded on the River
Seat 3: gabi_igna folded before Flop (didn't bet)
Seat 4: Fitzyferret (button) folded before Flop (didn't bet)
Seat 5: chaps1988 (small blind) collected ($11.40)
Seat 6: Zhalgasai (big blind) folded before Flop
Seat 7: patpaty folded before Flop (didn't bet)
Seat 8: WolleMalone folded before Flop (didn't bet)
Seat 9: kblkxls folded before Flop (didn't bet)





PokerStars Hand #152885403587:  Hold'em No Limit ($0.50/$1.00 USD) - 2016/05/05 16:17:08 CET [2016/05/05 10:17:08 ET]
Table 'Vela' 9-max Seat #5 is the button
Seat 1: mycka86 ($100 in chips) 
Seat 2: nickreason17 ($160.13 in chips) 
Seat 3: dviryo ($441.82 in chips) 
Seat 4: Hayer ana ($147.91 in chips) 
Seat 5: sanpidk ($101 in chips) 
Seat 6: matiko09 ($100.50 in chips) 
Seat 7: KovIFish89 ($104.88 in chips) 
Seat 8: vrnMike ($100 in chips) 
Seat 9: CI58 ($115.73 in chips) 
matiko09: posts small blind $0.50
KovIFish89: posts big blind $1
*** HOLE CARDS ***
Dealt to matiko09 [Kc 8s]
vrnMike: folds 
CI58: folds 
mycka86: folds 
nickreason17: folds 
dviryo: folds 
Hayer ana: raises $1.50 to $2.50
sanpidk: folds 
matiko09: folds 
KovIFish89: folds 
Uncalled bet ($1.50) returned to Hayer ana
Hayer ana collected $2.50 from pot
Hayer ana: doesn't show hand 
*** SUMMARY ***
Total pot $2.50 | Rake $0 
Seat 1: mycka86 folded before Flop (didn't bet)
Seat 2: nickreason17 folded before Flop (didn't bet)
Seat 3: dviryo folded before Flop (didn't bet)
Seat 4: Hayer ana collected ($2.50)
Seat 5: sanpidk (button) folded before Flop (didn't bet)
Seat 6: matiko09 (small blind) folded before Flop
Seat 7: KovIFish89 (big blind) folded before Flop
Seat 8: vrnMike folded before Flop (didn't bet)
Seat 9: CI58 folded before Flop (didn't bet)





PokerStars Hand #152885406311:  Hold'em No Limit ($1/$2 USD) - 2016/05/05 16:17:13 CET [2016/05/05 10:17:13 ET]
Table 'Tatry II' 9-max Seat #5 is the button
Seat 1: glanza_mike ($244.17 in chips) 
Seat 3: matiko09 ($217.45 in chips) 
Seat 4: PacPacBum ($200 in chips) 
Seat 5: Painkiller72 ($359.03 in chips) 
Seat 7: gabi_igna ($200 in chips) 
Seat 8: chaps1988 ($200 in chips) 
Seat 9: korol702 ($59.89 in chips) 
Kukuryzka will be allowed to play after the button
gabi_igna: posts small blind $1
chaps1988: posts big blind $2
T0ny Adams: sits out 
*** HOLE CARDS ***
Dealt to matiko09 [9s As]
korol702: calls $2
glanza_mike: folds 
matiko09: raises $5 to $7
PacPacBum: folds 
Painkiller72: folds 
gabi_igna: folds 
chaps1988: folds 
korol702: calls $5
*** FLOP *** [Kc 2d 4s]
korol702: checks 
matiko09: bets $8.39
korol702: calls $8.39
*** TURN *** [Kc 2d 4s] [Kh]
korol702: checks 
matiko09: checks 
*** RIVER *** [Kc 2d 4s Kh] [6c]
korol702: checks 
matiko09: checks 
*** SHOW DOWN ***
korol702: shows [4h Qh] (two pair, Kings and Fours)
matiko09: mucks hand 
korol702 collected $32.09 from pot
*** SUMMARY ***
Total pot $33.78 | Rake $1.69 
Board [Kc 2d 4s Kh 6c]
Seat 1: glanza_mike folded before Flop (didn't bet)
Seat 3: matiko09 mucked [9s As]
Seat 4: PacPacBum folded before Flop (didn't bet)
Seat 5: Painkiller72 (button) folded before Flop (didn't bet)
Seat 7: gabi_igna (small blind) folded before Flop
Seat 8: chaps1988 (big blind) folded before Flop
Seat 9: korol702 showed [4h Qh] and won ($32.09) with two pair, Kings and Fours





PokerStars Hand #152885410651:  Hold'em No Limit ($1/$2 USD) - 2016/05/05 16:17:20 CET [2016/05/05 10:17:20 ET]
Table 'Euporie II' 9-max Seat #7 is the button
Seat 1: gabi_igna ($205 in chips) 
Seat 2: nickreason17 ($211.44 in chips) 
Seat 4: Kukuryzka ($200.75 in chips) 
Seat 5: Nuskatko1986 ($52.91 in chips) 
Seat 6: glanza_mike ($203 in chips) 
Seat 7: matiko09 ($211.74 in chips) 
Seat 8: Painkiller72 ($298.25 in chips) 
Painkiller72: posts small blind $1
gabi_igna: posts big blind $2
chaps1988: sits out 
*** HOLE CARDS ***
Dealt to matiko09 [Td 2h]
nickreason17: raises $3 to $5
Kukuryzka: folds 
Nuskatko1986 has timed out
Nuskatko1986: folds 
glanza_mike: folds 
matiko09: folds 
Painkiller72: folds 
gabi_igna: folds 
Uncalled bet ($3) returned to nickreason17
nickreason17 collected $5 from pot
*** SUMMARY ***
Total pot $5 | Rake $0 
Seat 1: gabi_igna (big blind) folded before Flop
Seat 2: nickreason17 collected ($5)
Seat 4: Kukuryzka folded before Flop (didn't bet)
Seat 5: Nuskatko1986 folded before Flop (didn't bet)
Seat 6: glanza_mike folded before Flop (didn't bet)
Seat 7: matiko09 (button) folded before Flop (didn't bet)
Seat 8: Painkiller72 (small blind) folded before Flop





PokerStars Hand #152885415290:  Hold'em No Limit ($0.50/$1.00 USD) - 2016/05/05 16:17:28 CET [2016/05/05 10:17:28 ET]
Table 'Luthera' 9-max Seat #5 is the button
Seat 1: MrMattkk ($96.02 in chips) 
Seat 2: Kukuryzka ($101.50 in chips) 
Seat 3: sanpidk ($106.70 in chips) 
Seat 4: matiko09 ($109.98 in chips) 
Seat 5: Painkiller72 ($109.50 in chips) 
Seat 6: Dantist1122 ($100 in chips) 
Seat 7: Chin41178 ($101.96 in chips) 
Seat 9: vrnMike ($104.10 in chips) 
Dantist1122: posts small blind $0.50
Chin41178: posts big blind $1
xdrKush420x: sits out 
*** HOLE CARDS ***
Dealt to matiko09 [8d Ts]
vrnMike: folds 
MrMattkk: folds 
Kukuryzka: raises $2 to $3
sanpidk: folds 
matiko09: folds 
Painkiller72: folds 
Dantist1122: folds 
Chin41178: folds 
Uncalled bet ($2) returned to Kukuryzka
Kukuryzka collected $2.50 from pot
Kukuryzka: doesn't show hand 
*** SUMMARY ***
Total pot $2.50 | Rake $0 
Seat 1: MrMattkk folded before Flop (didn't bet)
Seat 2: Kukuryzka collected ($2.50)
Seat 3: sanpidk folded before Flop (didn't bet)
Seat 4: matiko09 folded before Flop (didn't bet)
Seat 5: Painkiller72 (button) folded before Flop (didn't bet)
Seat 6: Dantist1122 (small blind) folded before Flop
Seat 7: Chin41178 (big blind) folded before Flop
Seat 9: vrnMike folded before Flop (didn't bet)





PokerStars Hand #152885419721:  Hold'em No Limit ($0.50/$1.00 USD) - 2016/05/05 16:17:35 CET [2016/05/05 10:17:35 ET]
Table 'Vela' 9-max Seat #6 is the button
Seat 1: mycka86 ($100 in chips) 
Seat 2: nickreason17 ($160.13 in chips) 
Seat 4: Hayer ana ($149.41 in chips) 
Seat 5: sanpidk ($101 in chips) 
Seat 6: matiko09 ($100 in chips) 
Seat 7: KovIFish89 ($103.88 in chips) 
Seat 8: vrnMike ($100 in chips) 
Seat 9: CI58 ($115.73 in chips) 
KovIFish89: posts small blind $0.50
vrnMike: posts big blind $1
*** HOLE CARDS ***
Dealt to matiko09 [Ts 2h]
CI58: folds 
mycka86: folds 
nickreason17: raises $1.50 to $2.50
Hayer ana: folds 
sanpidk: raises $5.50 to $8
matiko09: folds 
KovIFish89: folds 
vrnMike: folds 
nickreason17: folds 
Uncalled bet ($5.50) returned to sanpidk
sanpidk collected $6.50 from pot
sanpidk: doesn't show hand 
*** SUMMARY ***
Total pot $6.50 | Rake $0 
Seat 1: mycka86 folded before Flop (didn't bet)
Seat 2: nickreason17 folded before Flop
Seat 4: Hayer ana folded before Flop (didn't bet)
Seat 5: sanpidk collected ($6.50)
Seat 6: matiko09 (button) folded before Flop (didn't bet)
Seat 7: KovIFish89 (small blind) folded before Flop
Seat 8: vrnMike (big blind) folded before Flop
Seat 9: CI58 folded before Flop (didn't bet)





PokerStars Hand #152885434545:  Hold'em No Limit ($0.50/$1.00 USD) - 2016/05/05 16:18:00 CET [2016/05/05 10:18:00 ET]
Table 'Vela' 9-max Seat #7 is the button
Seat 4: Hayer ana ($149.41 in chips) 
Seat 5: sanpidk ($105 in chips) 
Seat 6: matiko09 ($100 in chips) 
Seat 7: KovIFish89 ($103.38 in chips) 
Seat 8: vrnMike ($100 in chips) 
vrnMike: posts small blind $0.50
CI58: is sitting out 
mycka86: is sitting out 
nickreason17: is sitting out 
mycka86 leaves the table
Hayer ana: posts big blind $1
*** HOLE CARDS ***
Dealt to matiko09 [5s Ad]
nickreason17 leaves the table
sanpidk: raises $1.50 to $2.50
janarr5 joins the table at seat #1 
matiko09: folds 
KovIFish89: folds 
vrnMike: calls $2
Hayer ana: raises $8.50 to $11
CI58 leaves the table
sanpidk: calls $8.50
vrnMike: folds 
*** FLOP *** [Td 6h 4h]
Hayer ana: checks 
kl4ssic joins the table at seat #2 
sanpidk: checks 
*** TURN *** [Td 6h 4h] [Js]
Hayer ana: bets $12.33
sanpidk: calls $12.33
*** RIVER *** [Td 6h 4h Js] [4c]
atlantx joins the table at seat #9 
Hayer ana: bets $22.50
sanpidk: folds 
Uncalled bet ($22.50) returned to Hayer ana
Hayer ana collected $46.70 from pot
Hayer ana: doesn't show hand 
*** SUMMARY ***
Total pot $49.16 | Rake $2.46 
Board [Td 6h 4h Js 4c]
Seat 4: Hayer ana (big blind) collected ($46.70)
Seat 5: sanpidk folded on the River
Seat 6: matiko09 folded before Flop (didn't bet)
Seat 7: KovIFish89 (button) folded before Flop (didn't bet)
Seat 8: vrnMike (small blind) folded before Flop





PokerStars Hand #152885436926:  Hold'em No Limit ($1/$2 USD) - 2016/05/05 16:18:04 CET [2016/05/05 10:18:04 ET]
Table 'Samitchell' 9-max Seat #5 is the button
Seat 1: KovIFish89 ($226.35 in chips) 
Seat 2: matiko09 ($200 in chips) 
Seat 3: gabi_igna ($355.12 in chips) 
Seat 4: Fitzyferret ($371.13 in chips) 
Seat 5: chaps1988 ($276.57 in chips) 
Seat 6: Zhalgasai ($96 in chips) 
Seat 7: patpaty ($166.59 in chips) 
Seat 8: WolleMalone ($200 in chips) 
Seat 9: kblkxls ($107.60 in chips) 
Zhalgasai: posts small blind $1
patpaty: posts big blind $2
*** HOLE CARDS ***
Dealt to matiko09 [Jc Js]
WolleMalone: folds 
kblkxls: folds 
KovIFish89: folds 
matiko09: raises $3 to $5
gabi_igna: folds 
Fitzyferret: folds 
chaps1988: folds 
Zhalgasai: raises $7 to $12
patpaty: folds 
matiko09: calls $7
*** FLOP *** [Jd 7s Tc]
Zhalgasai: bets $12
matiko09: calls $12
*** TURN *** [Jd 7s Tc] [3d]
Zhalgasai: checks 
matiko09: bets $22
Zhalgasai: calls $22
*** RIVER *** [Jd 7s Tc 3d] [8s]
Zhalgasai: checks 
matiko09: bets $50
Zhalgasai: calls $50 and is all-in
*** SHOW DOWN ***
matiko09: shows [Jc Js] (three of a kind, Jacks)
Zhalgasai: mucks hand 
matiko09 collected $191.25 from pot
*** SUMMARY ***
Total pot $194 | Rake $2.75 
Board [Jd 7s Tc 3d 8s]
Seat 1: KovIFish89 folded before Flop (didn't bet)
Seat 2: matiko09 showed [Jc Js] and won ($191.25) with three of a kind, Jacks
Seat 3: gabi_igna folded before Flop (didn't bet)
Seat 4: Fitzyferret folded before Flop (didn't bet)
Seat 5: chaps1988 (button) folded before Flop (didn't bet)
Seat 6: Zhalgasai (small blind) mucked [Ad Ks]
Seat 7: patpaty (big blind) folded before Flop
Seat 8: WolleMalone folded before Flop (didn't bet)
Seat 9: kblkxls folded before Flop (didn't bet)





PokerStars Hand #152885439766:  Hold'em No Limit ($1/$2 USD) - 2016/05/05 16:18:08 CET [2016/05/05 10:18:08 ET]
Table 'Lundia' 9-max Seat #1 is the button
Seat 1: Fitzyferret ($245.35 in chips) 
Seat 2: patpaty ($168.27 in chips) 
Seat 3: Painkiller72 ($238.79 in chips) 
Seat 4: KovIFish89 ($311.66 in chips) 
Seat 5: zmOe84 ($155.54 in chips) 
Seat 6: CI58 ($215.93 in chips) 
Seat 7: matiko09 ($235.11 in chips) 
Seat 9: gabi_igna ($263.12 in chips) 
patpaty: posts small blind $1
Painkiller72: posts big blind $2
chaps1988: sits out 
*** HOLE CARDS ***
Dealt to matiko09 [4d As]
KovIFish89: folds 
zmOe84: folds 
CI58: raises $4 to $6
matiko09: folds 
gabi_igna: folds 
Fitzyferret: folds 
patpaty: folds 
Painkiller72: folds 
Uncalled bet ($4) returned to CI58
CI58 collected $5 from pot
*** SUMMARY ***
Total pot $5 | Rake $0 
Seat 1: Fitzyferret (button) folded before Flop (didn't bet)
Seat 2: patpaty (small blind) folded before Flop
Seat 3: Painkiller72 (big blind) folded before Flop
Seat 4: KovIFish89 folded before Flop (didn't bet)
Seat 5: zmOe84 folded before Flop (didn't bet)
Seat 6: CI58 collected ($5)
Seat 7: matiko09 folded before Flop (didn't bet)
Seat 9: gabi_igna folded before Flop (didn't bet)





PokerStars Hand #152885441932:  Hold'em No Limit ($1/$2 USD) - 2016/05/05 16:18:12 CET [2016/05/05 10:18:12 ET]
Table 'Tatry II' 9-max Seat #7 is the button
Seat 1: glanza_mike ($244.17 in chips) 
Seat 3: matiko09 ($202.06 in chips) 
Seat 4: PacPacBum ($200 in chips) 
Seat 5: Painkiller72 ($359.03 in chips) 
Seat 7: gabi_igna ($200 in chips) 
Seat 8: chaps1988 ($200 in chips) 
Seat 9: korol702 ($76.59 in chips) 
chaps1988: posts small blind $1
korol702: posts big blind $2
T0ny Adams: sits out 
Kukuryzka: sits out 
*** HOLE CARDS ***
Dealt to matiko09 [4h 3c]
glanza_mike: raises $4 to $6
matiko09: folds 
PacPacBum: folds 
Painkiller72: folds 
gabi_igna: folds 
chaps1988: folds 
korol702: calls $4
*** FLOP *** [As Ac 8c]
korol702: checks 
glanza_mike: bets $8.27
korol702: folds 
Uncalled bet ($8.27) returned to glanza_mike
glanza_mike collected $12.35 from pot
glanza_mike: doesn't show hand 
*** SUMMARY ***
Total pot $13 | Rake $0.65 
Board [As Ac 8c]
Seat 1: glanza_mike collected ($12.35)
Seat 3: matiko09 folded before Flop (didn't bet)
Seat 4: PacPacBum folded before Flop (didn't bet)
Seat 5: Painkiller72 folded before Flop (didn't bet)
Seat 7: gabi_igna (button) folded before Flop (didn't bet)
Seat 8: chaps1988 (small blind) folded before Flop
Seat 9: korol702 (big blind) folded on the Flop





PokerStars Hand #152885443249:  Hold'em No Limit ($1/$2 USD) - 2016/05/05 16:18:14 CET [2016/05/05 10:18:14 ET]
Table 'Euporie II' 9-max Seat #8 is the button
Seat 1: gabi_igna ($203 in chips) 
Seat 3: chaps1988 ($200 in chips) 
Seat 4: Kukuryzka ($200.75 in chips) 
Seat 6: glanza_mike ($203 in chips) 
Seat 7: matiko09 ($211.74 in chips) 
Seat 8: Painkiller72 ($297.25 in chips) 
T0ny Adams will be allowed to play after the button
gabi_igna: posts small blind $1
nickreason17: is sitting out 
chaps1988: posts big blind $2
*** HOLE CARDS ***
Dealt to matiko09 [Ac 8c]
nickreason17 leaves the table
Kukuryzka: folds 
glanza_mike: folds 
Kukuryzka leaves the table
matiko09: raises $3 to $5
Painkiller72: folds 
gabi_igna: folds 
chaps1988: folds 
Uncalled bet ($3) returned to matiko09
matiko09 collected $5 from pot
matiko09: doesn't show hand 
*** SUMMARY ***
Total pot $5 | Rake $0 
Seat 1: gabi_igna (small blind) folded before Flop
Seat 3: chaps1988 (big blind) folded before Flop
Seat 4: Kukuryzka folded before Flop (didn't bet)
Seat 6: glanza_mike folded before Flop (didn't bet)
Seat 7: matiko09 collected ($5)
Seat 8: Painkiller72 (button) folded before Flop (didn't bet)





PokerStars Hand #152885444179:  Hold'em No Limit ($0.50/$1.00 USD) - 2016/05/05 16:18:16 CET [2016/05/05 10:18:16 ET]
Table 'Musa II' 9-max Seat #8 is the button
Seat 1: KovIFish89 ($191.97 in chips) 
Seat 2: koutani7 ($97 in chips) 
Seat 3: vrnMike ($183.82 in chips) 
Seat 4: sanpidk ($101.22 in chips) 
Seat 5: nickreason17 ($107.50 in chips) 
Seat 6: cnn123 ($70.20 in chips) 
Seat 7: plaindaft1 ($122.68 in chips) 
Seat 8: matiko09 ($102.62 in chips) 
Seat 9: FroggyPlay ($103.18 in chips) 
FroggyPlay: posts small blind $0.50
KovIFish89: posts big blind $1
*** HOLE CARDS ***
Dealt to matiko09 [6d 6h]
koutani7: folds 
vrnMike: folds 
sanpidk: folds 
nickreason17: folds 
cnn123: folds 
plaindaft1: folds 
matiko09: raises $1.27 to $2.27
FroggyPlay: folds 
KovIFish89: calls $1.27
*** FLOP *** [7d 9h Jc]
KovIFish89: checks 
matiko09: checks 
*** TURN *** [7d 9h Jc] [4c]
KovIFish89: bets $3.19
matiko09: folds 
Uncalled bet ($3.19) returned to KovIFish89
KovIFish89 collected $4.79 from pot
KovIFish89: doesn't show hand 
*** SUMMARY ***
Total pot $5.04 | Rake $0.25 
Board [7d 9h Jc 4c]
Seat 1: KovIFish89 (big blind) collected ($4.79)
Seat 2: koutani7 folded before Flop (didn't bet)
Seat 3: vrnMike folded before Flop (didn't bet)
Seat 4: sanpidk folded before Flop (didn't bet)
Seat 5: nickreason17 folded before Flop (didn't bet)
Seat 6: cnn123 folded before Flop (didn't bet)
Seat 7: plaindaft1 folded before Flop (didn't bet)
Seat 8: matiko09 (button) folded on the Turn
Seat 9: FroggyPlay (small blind) folded before Flop





PokerStars Hand #152885446248:  Hold'em No Limit ($1/$2 USD) - 2016/05/05 16:18:19 CET [2016/05/05 10:18:19 ET]
Table 'Tololo' 9-max Seat #6 is the button
Seat 1: Kukuryzka ($233.29 in chips) 
Seat 2: gabi_igna ($222.45 in chips) 
Seat 3: nickreason17 ($220.22 in chips) 
Seat 4: mooose100 ($186.18 in chips) 
Seat 5: matiko09 ($200 in chips) 
Seat 6: Xagua ($173.70 in chips) 
Seat 7: chaps1988 ($275.45 in chips) 
Seat 8: KovIFish89 ($206.35 in chips) 
Seat 9: Fitzyferret ($369.47 in chips) 
chaps1988: posts small blind $1
KovIFish89: posts big blind $2
*** HOLE CARDS ***
Dealt to matiko09 [4d 4s]
Fitzyferret: folds 
Kukuryzka: folds 
gabi_igna: folds 
nickreason17: folds 
mooose100: folds 
matiko09: raises $3 to $5
Xagua: calls $5
chaps1988: folds 
KovIFish89: calls $3
*** FLOP *** [7h 6h 5d]
KovIFish89: checks 
matiko09: checks 
Xagua: checks 
*** TURN *** [7h 6h 5d] [Qh]
KovIFish89: checks 
matiko09: checks 
Xagua: bets $6
KovIFish89: calls $6
matiko09: folds 
*** RIVER *** [7h 6h 5d Qh] [Jh]
KovIFish89: checks 
Xagua: checks 
*** SHOW DOWN ***
KovIFish89: shows [4h 4c] (a flush, Queen high)
Xagua: mucks hand 
KovIFish89 collected $26.60 from pot
*** SUMMARY ***
Total pot $28 | Rake $1.40 
Board [7h 6h 5d Qh Jh]
Seat 1: Kukuryzka folded before Flop (didn't bet)
Seat 2: gabi_igna folded before Flop (didn't bet)
Seat 3: nickreason17 folded before Flop (didn't bet)
Seat 4: mooose100 folded before Flop (didn't bet)
Seat 5: matiko09 folded on the Turn
Seat 6: Xagua (button) mucked [2s Qs]
Seat 7: chaps1988 (small blind) folded before Flop
Seat 8: KovIFish89 (big blind) showed [4h 4c] and won ($26.60) with a flush, Queen high
Seat 9: Fitzyferret folded before Flop (didn't bet)





PokerStars Hand #152885451153:  Hold'em No Limit ($0.50/$1.00 USD) - 2016/05/05 16:18:28 CET [2016/05/05 10:18:28 ET]
Table 'Luthera' 9-max Seat #6 is the button
Seat 1: MrMattkk ($96.02 in chips) 
Seat 2: Kukuryzka ($103 in chips) 
Seat 3: sanpidk ($106.70 in chips) 
Seat 4: matiko09 ($109.98 in chips) 
Seat 5: Painkiller72 ($109.50 in chips) 
Seat 6: Dantist1122 ($100 in chips) 
Seat 7: Chin41178 ($100.96 in chips) 
Seat 8: xdrKush420x ($105.56 in chips) 
Seat 9: vrnMike ($104.10 in chips) 
Chin41178: posts small blind $0.50
xdrKush420x: posts big blind $1
*** HOLE CARDS ***
Dealt to matiko09 [9h 4c]
vrnMike: folds 
MrMattkk: raises $2 to $3
Kukuryzka: folds 
sanpidk: folds 
matiko09: folds 
Painkiller72: folds 
Dantist1122: folds 
Chin41178: calls $2.50
xdrKush420x: folds 
*** FLOP *** [3h 8c Td]
Chin41178: checks 
MrMattkk: bets $4
Chin41178: calls $4
*** TURN *** [3h 8c Td] [6s]
Chin41178: checks 
MrMattkk: checks 
*** RIVER *** [3h 8c Td 6s] [5d]
Chin41178: bets $8
MrMattkk: calls $8
*** SHOW DOWN ***
Chin41178: shows [9d Qd] (high card Queen)
MrMattkk: shows [Ts Js] (a pair of Tens)
MrMattkk collected $29.45 from pot
*** SUMMARY ***
Total pot $31 | Rake $1.55 
Board [3h 8c Td 6s 5d]
Seat 1: MrMattkk showed [Ts Js] and won ($29.45) with a pair of Tens
Seat 2: Kukuryzka folded before Flop (didn't bet)
Seat 3: sanpidk folded before Flop (didn't bet)
Seat 4: matiko09 folded before Flop (didn't bet)
Seat 5: Painkiller72 folded before Flop (didn't bet)
Seat 6: Dantist1122 (button) folded before Flop (didn't bet)
Seat 7: Chin41178 (small blind) showed [9d Qd] and lost with high card Queen
Seat 8: xdrKush420x (big blind) folded before Flop
Seat 9: vrnMike folded before Flop (didn't bet)





PokerStars Hand #152885453052:  Hold'em No Limit ($1/$2 USD) - 2016/05/05 16:18:31 CET [2016/05/05 10:18:31 ET]
Table 'Euporie II' 9-max Seat #1 is the button
Seat 1: gabi_igna ($202 in chips) 
Seat 3: chaps1988 ($200 in chips) 
Seat 5: Nuskatko1986 ($52.91 in chips) 
Seat 6: glanza_mike ($203 in chips) 
Seat 7: matiko09 ($214.74 in chips) 
Seat 8: Painkiller72 ($297.25 in chips) 
chaps1988: posts small blind $1
Nuskatko1986: posts big blind $2
*** HOLE CARDS ***
Dealt to matiko09 [4h Jc]
Khaine_CM joins the table at seat #4 
glanza_mike: folds 
matiko09: folds 
Khaine_CM leaves the table
Painkiller72: raises $3 to $5
gabi_igna: folds 
chaps1988: folds 
kblkxls joins the table at seat #2 
Nuskatko1986: calls $3
*** FLOP *** [5d 6c 7d]
Fitzyferret joins the table at seat #4 
Nuskatko1986: checks 
Painkiller72: checks 
*** TURN *** [5d 6c 7d] [6h]
Nuskatko1986: bets $4
Painkiller72: calls $4
*** RIVER *** [5d 6c 7d 6h] [Ks]
Nuskatko1986: bets $12
Painkiller72: folds 
Uncalled bet ($12) returned to Nuskatko1986
Nuskatko1986 collected $18.05 from pot
Nuskatko1986: doesn't show hand 
*** SUMMARY ***
Total pot $19 | Rake $0.95 
Board [5d 6c 7d 6h Ks]
Seat 1: gabi_igna (button) folded before Flop (didn't bet)
Seat 3: chaps1988 (small blind) folded before Flop
Seat 5: Nuskatko1986 (big blind) collected ($18.05)
Seat 6: glanza_mike folded before Flop (didn't bet)
Seat 7: matiko09 folded before Flop (didn't bet)
Seat 8: Painkiller72 folded on the River





PokerStars Hand #152885461491:  Hold'em No Limit ($1/$2 USD) - 2016/05/05 16:18:45 CET [2016/05/05 10:18:45 ET]
Table 'Lundia' 9-max Seat #2 is the button
Seat 1: Fitzyferret ($245.35 in chips) 
Seat 2: patpaty ($167.27 in chips) 
Seat 3: Painkiller72 ($236.79 in chips) 
Seat 4: KovIFish89 ($311.66 in chips) 
Seat 5: zmOe84 ($155.54 in chips) 
Seat 6: CI58 ($218.93 in chips) 
Seat 7: matiko09 ($235.11 in chips) 
Seat 9: gabi_igna ($263.12 in chips) 
Painkiller72: posts small blind $1
KovIFish89: posts big blind $2
chaps1988: sits out 
*** HOLE CARDS ***
Dealt to matiko09 [Th Kc]
zmOe84: calls $2
CI58: raises $6 to $8
matiko09: folds 
gabi_igna: folds 
Fitzyferret: folds 
patpaty: folds 
Painkiller72: folds 
KovIFish89: calls $6
zmOe84: calls $6
*** FLOP *** [6d 8s Qs]
KovIFish89: checks 
zmOe84: bets $12
CI58: folds 
KovIFish89: folds 
Uncalled bet ($12) returned to zmOe84
zmOe84 collected $23.75 from pot
zmOe84: doesn't show hand 
*** SUMMARY ***
Total pot $25 | Rake $1.25 
Board [6d 8s Qs]
Seat 1: Fitzyferret folded before Flop (didn't bet)
Seat 2: patpaty (button) folded before Flop (didn't bet)
Seat 3: Painkiller72 (small blind) folded before Flop
Seat 4: KovIFish89 (big blind) folded on the Flop
Seat 5: zmOe84 collected ($23.75)
Seat 6: CI58 folded on the Flop
Seat 7: matiko09 folded before Flop (didn't bet)
Seat 9: gabi_igna folded before Flop (didn't bet)





PokerStars Hand #152885465397:  Hold'em No Limit ($1/$2 USD) - 2016/05/05 16:18:51 CET [2016/05/05 10:18:51 ET]
Table 'Tatry II' 9-max Seat #8 is the button
Seat 1: glanza_mike ($250.52 in chips) 
Seat 3: matiko09 ($202.06 in chips) 
Seat 4: PacPacBum ($200 in chips) 
Seat 5: Painkiller72 ($359.03 in chips) 
Seat 7: gabi_igna ($200 in chips) 
Seat 8: chaps1988 ($200 in chips) 
Seat 9: korol702 ($70.59 in chips) 
korol702: posts small blind $1
glanza_mike: posts big blind $2
T0ny Adams: sits out 
Kukuryzka: sits out 
*** HOLE CARDS ***
Dealt to matiko09 [2d 7d]
matiko09: folds 
PacPacBum: folds 
Painkiller72: folds 
gabi_igna: raises $3 to $5
chaps1988: folds 
korol702: folds 
glanza_mike: folds 
Uncalled bet ($3) returned to gabi_igna
gabi_igna collected $5 from pot
*** SUMMARY ***
Total pot $5 | Rake $0 
Seat 1: glanza_mike (big blind) folded before Flop
Seat 3: matiko09 folded before Flop (didn't bet)
Seat 4: PacPacBum folded before Flop (didn't bet)
Seat 5: Painkiller72 folded before Flop (didn't bet)
Seat 7: gabi_igna collected ($5)
Seat 8: chaps1988 (button) folded before Flop (didn't bet)
Seat 9: korol702 (small blind) folded before Flop





PokerStars Hand #152885471753:  Hold'em No Limit ($0.50/$1.00 USD) - 2016/05/05 16:19:02 CET [2016/05/05 10:19:02 ET]
Table 'Musa II' 9-max Seat #9 is the button
Seat 1: KovIFish89 ($194.49 in chips) 
Seat 2: koutani7 ($97 in chips) 
Seat 3: vrnMike ($183.82 in chips) 
Seat 4: sanpidk ($101.22 in chips) 
Seat 5: nickreason17 ($107.50 in chips) 
Seat 6: cnn123 ($70.20 in chips) 
Seat 7: plaindaft1 ($122.68 in chips) 
Seat 8: matiko09 ($100.35 in chips) 
Seat 9: FroggyPlay ($102.68 in chips) 
KovIFish89: posts small blind $0.50
koutani7: posts big blind $1
*** HOLE CARDS ***
Dealt to matiko09 [2h As]
vrnMike: raises $1 to $2
sanpidk: folds 
nickreason17: folds 
cnn123: folds 
plaindaft1: folds 
matiko09: folds 
FroggyPlay: folds 
KovIFish89: folds 
koutani7: folds 
Uncalled bet ($1) returned to vrnMike
vrnMike collected $2.50 from pot
*** SUMMARY ***
Total pot $2.50 | Rake $0 
Seat 1: KovIFish89 (small blind) folded before Flop
Seat 2: koutani7 (big blind) folded before Flop
Seat 3: vrnMike collected ($2.50)
Seat 4: sanpidk folded before Flop (didn't bet)
Seat 5: nickreason17 folded before Flop (didn't bet)
Seat 6: cnn123 folded before Flop (didn't bet)
Seat 7: plaindaft1 folded before Flop (didn't bet)
Seat 8: matiko09 folded before Flop (didn't bet)
Seat 9: FroggyPlay (button) folded before Flop (didn't bet)





PokerStars Hand #152885476751:  Hold'em No Limit ($1/$2 USD) - 2016/05/05 16:19:10 CET [2016/05/05 10:19:10 ET]
Table 'Tatry II' 9-max Seat #9 is the button
Seat 1: glanza_mike ($248.52 in chips) 
Seat 2: T0ny Adams ($86.40 in chips) 
Seat 3: matiko09 ($202.06 in chips) 
Seat 4: PacPacBum ($200 in chips) 
Seat 5: Painkiller72 ($359.03 in chips) 
Seat 7: gabi_igna ($203 in chips) 
Seat 8: chaps1988 ($200 in chips) 
Seat 9: korol702 ($69.59 in chips) 
glanza_mike: posts small blind $1
T0ny Adams: posts big blind $2
Kukuryzka: sits out 
*** HOLE CARDS ***
Dealt to matiko09 [8c Th]
matiko09: folds 
PacPacBum: raises $2.08 to $4.08
Painkiller72: folds 
gabi_igna: folds 
chaps1988: folds 
korol702: calls $4.08
glanza_mike: folds 
T0ny Adams: folds 
*** FLOP *** [5s 8d 7h]
PacPacBum: checks 
korol702: bets $10
PacPacBum: folds 
Uncalled bet ($10) returned to korol702
korol702 collected $10.60 from pot
korol702: doesn't show hand 
*** SUMMARY ***
Total pot $11.16 | Rake $0.56 
Board [5s 8d 7h]
Seat 1: glanza_mike (small blind) folded before Flop
Seat 2: T0ny Adams (big blind) folded before Flop
Seat 3: matiko09 folded before Flop (didn't bet)
Seat 4: PacPacBum folded on the Flop
Seat 5: Painkiller72 folded before Flop (didn't bet)
Seat 7: gabi_igna folded before Flop (didn't bet)
Seat 8: chaps1988 folded before Flop (didn't bet)
Seat 9: korol702 (button) collected ($10.60)





PokerStars Hand #152885485941:  Hold'em No Limit ($0.50/$1.00 USD) - 2016/05/05 16:19:25 CET [2016/05/05 10:19:25 ET]
Table 'Musa II' 9-max Seat #1 is the button
Seat 1: KovIFish89 ($193.99 in chips) 
Seat 2: koutani7 ($96 in chips) 
Seat 3: vrnMike ($185.32 in chips) 
Seat 4: sanpidk ($101.22 in chips) 
Seat 5: nickreason17 ($107.50 in chips) 
Seat 6: cnn123 ($70.20 in chips) 
Seat 7: plaindaft1 ($122.68 in chips) 
Seat 8: matiko09 ($100.35 in chips) 
Seat 9: FroggyPlay ($102.68 in chips) 
koutani7: posts small blind $0.50
vrnMike: posts big blind $1
*** HOLE CARDS ***
Dealt to matiko09 [3d 2d]
sanpidk: folds 
nickreason17: folds 
cnn123: raises $2 to $3
plaindaft1: folds 
matiko09: folds 
FroggyPlay: folds 
KovIFish89: folds 
koutani7: folds 
vrnMike: folds 
Uncalled bet ($2) returned to cnn123
cnn123 collected $2.50 from pot
cnn123: doesn't show hand 
*** SUMMARY ***
Total pot $2.50 | Rake $0 
Seat 1: KovIFish89 (button) folded before Flop (didn't bet)
Seat 2: koutani7 (small blind) folded before Flop
Seat 3: vrnMike (big blind) folded before Flop
Seat 4: sanpidk folded before Flop (didn't bet)
Seat 5: nickreason17 folded before Flop (didn't bet)
Seat 6: cnn123 collected ($2.50)
Seat 7: plaindaft1 folded before Flop (didn't bet)
Seat 8: matiko09 folded before Flop (didn't bet)
Seat 9: FroggyPlay folded before Flop (didn't bet)





PokerStars Hand #152885485810:  Hold'em No Limit ($0.50/$1.00 USD) - 2016/05/05 16:19:25 CET [2016/05/05 10:19:25 ET]
Table 'Porzia' 9-max Seat #8 is the button
Seat 1: vrnMike ($144.50 in chips) 
Seat 2: matiko09 ($101.50 in chips) 
Seat 3: Chin41178 ($136.66 in chips) 
Seat 5: E_Sandnes ($104.74 in chips) 
Seat 7: gabi_igna ($190.34 in chips) 
Seat 8: PRINCE JULIO ($92.99 in chips) 
kl4ssic will be allowed to play after the button
vrnMike: posts small blind $0.50
matiko09: posts big blind $1
Khaine_CM: sits out 
janarr5: sits out 
*** HOLE CARDS ***
Dealt to matiko09 [5s Qd]
Chin41178: folds 
E_Sandnes: folds 
gabi_igna: raises $1.50 to $2.50
PRINCE JULIO: folds 
vrnMike: folds 
matiko09: folds 
Uncalled bet ($1.50) returned to gabi_igna
gabi_igna collected $2.50 from pot
gabi_igna: doesn't show hand 
*** SUMMARY ***
Total pot $2.50 | Rake $0 
Seat 1: vrnMike (small blind) folded before Flop
Seat 2: matiko09 (big blind) folded before Flop
Seat 3: Chin41178 folded before Flop (didn't bet)
Seat 5: E_Sandnes folded before Flop (didn't bet)
Seat 7: gabi_igna collected ($2.50)
Seat 8: PRINCE JULIO (button) folded before Flop (didn't bet)





PokerStars Hand #152885495879:  Hold'em No Limit ($0.50/$1.00 USD) - 2016/05/05 16:19:42 CET [2016/05/05 10:19:42 ET]
Table 'Porzia' 9-max Seat #1 is the button
Seat 1: vrnMike ($144 in chips) 
Seat 2: matiko09 ($100.50 in chips) 
Seat 3: Chin41178 ($136.66 in chips) 
Seat 5: E_Sandnes ($104.74 in chips) 
Seat 7: gabi_igna ($191.84 in chips) 
Seat 8: PRINCE JULIO ($92.99 in chips) 
matiko09: posts small blind $0.50
Chin41178: posts big blind $1
Khaine_CM: sits out 
janarr5: sits out 
kl4ssic: sits out 
*** HOLE CARDS ***
Dealt to matiko09 [6d 2d]
E_Sandnes: folds 
gabi_igna: folds 
PRINCE JULIO: folds 
vrnMike: raises $2 to $3
matiko09: folds 
Chin41178: folds 
Uncalled bet ($2) returned to vrnMike
vrnMike collected $2.50 from pot
*** SUMMARY ***
Total pot $2.50 | Rake $0 
Seat 1: vrnMike (button) collected ($2.50)
Seat 2: matiko09 (small blind) folded before Flop
Seat 3: Chin41178 (big blind) folded before Flop
Seat 5: E_Sandnes folded before Flop (didn't bet)
Seat 7: gabi_igna folded before Flop (didn't bet)
Seat 8: PRINCE JULIO folded before Flop (didn't bet)





PokerStars Hand #152885496089:  Hold'em No Limit ($1/$2 USD) - 2016/05/05 16:19:42 CET [2016/05/05 10:19:42 ET]
Table 'Euporie II' 9-max Seat #3 is the button
Seat 1: gabi_igna ($202 in chips) 
Seat 3: chaps1988 ($200 in chips) 
Seat 5: Nuskatko1986 ($61.96 in chips) 
Seat 6: glanza_mike ($203 in chips) 
Seat 7: matiko09 ($214.74 in chips) 
Seat 8: Painkiller72 ($288.25 in chips) 
Fitzyferret will be allowed to play after the button
Nuskatko1986: posts small blind $1
glanza_mike: posts big blind $2
T0ny Adams: sits out 
kblkxls: sits out 
*** HOLE CARDS ***
Dealt to matiko09 [3h 8h]
matiko09: folds 
Painkiller72: folds 
gabi_igna: folds 
chaps1988: raises $2 to $4
Nuskatko1986: calls $3
glanza_mike: raises $16 to $20
chaps1988: folds 
Nuskatko1986: folds 
Uncalled bet ($16) returned to glanza_mike
glanza_mike collected $12 from pot
glanza_mike: doesn't show hand 
*** SUMMARY ***
Total pot $12 | Rake $0 
Seat 1: gabi_igna folded before Flop (didn't bet)
Seat 3: chaps1988 (button) folded before Flop
Seat 5: Nuskatko1986 (small blind) folded before Flop
Seat 6: glanza_mike (big blind) collected ($12)
Seat 7: matiko09 folded before Flop (didn't bet)
Seat 8: Painkiller72 folded before Flop (didn't bet)





PokerStars Hand #152885500896:  Hold'em No Limit ($0.50/$1.00 USD) - 2016/05/05 16:19:50 CET [2016/05/05 10:19:50 ET]
Table 'Musa II' 9-max Seat #2 is the button
Seat 1: KovIFish89 ($193.99 in chips) 
Seat 2: koutani7 ($95.50 in chips) 
Seat 3: vrnMike ($184.32 in chips) 
Seat 4: sanpidk ($101.22 in chips) 
Seat 5: nickreason17 ($107.50 in chips) 
Seat 6: cnn123 ($71.70 in chips) 
Seat 7: plaindaft1 ($122.68 in chips) 
Seat 8: matiko09 ($100.35 in chips) 
Seat 9: FroggyPlay ($102.68 in chips) 
vrnMike: posts small blind $0.50
sanpidk: posts big blind $1
*** HOLE CARDS ***
Dealt to matiko09 [8s Ac]
nickreason17: folds 
cnn123: folds 
plaindaft1: folds 
matiko09: folds 
FroggyPlay: folds 
KovIFish89: folds 
koutani7: folds 
vrnMike: calls $0.50
sanpidk: checks 
*** FLOP *** [8h 5d 9s]
vrnMike: checks 
sanpidk: bets $2
vrnMike: calls $2
*** TURN *** [8h 5d 9s] [Js]
vrnMike: checks 
sanpidk: bets $4.50
vrnMike: folds 
Uncalled bet ($4.50) returned to sanpidk
sanpidk collected $5.70 from pot
sanpidk: doesn't show hand 
*** SUMMARY ***
Total pot $6 | Rake $0.30 
Board [8h 5d 9s Js]
Seat 1: KovIFish89 folded before Flop (didn't bet)
Seat 2: koutani7 (button) folded before Flop (didn't bet)
Seat 3: vrnMike (small blind) folded on the Turn
Seat 4: sanpidk (big blind) collected ($5.70)
Seat 5: nickreason17 folded before Flop (didn't bet)
Seat 6: cnn123 folded before Flop (didn't bet)
Seat 7: plaindaft1 folded before Flop (didn't bet)
Seat 8: matiko09 folded before Flop (didn't bet)
Seat 9: FroggyPlay folded before Flop (didn't bet)





PokerStars Hand #152885501351:  Hold'em No Limit ($1/$2 USD) - 2016/05/05 16:19:51 CET [2016/05/05 10:19:51 ET]
Table 'Tololo' 9-max Seat #7 is the button
Seat 1: Kukuryzka ($233.29 in chips) 
Seat 2: gabi_igna ($222.45 in chips) 
Seat 3: nickreason17 ($220.22 in chips) 
Seat 4: mooose100 ($186.18 in chips) 
Seat 5: matiko09 ($200 in chips) 
Seat 6: Xagua ($162.70 in chips) 
Seat 7: chaps1988 ($274.45 in chips) 
Seat 8: KovIFish89 ($221.95 in chips) 
Seat 9: Fitzyferret ($369.47 in chips) 
KovIFish89: posts small blind $1
Fitzyferret: posts big blind $2
*** HOLE CARDS ***
Dealt to matiko09 [3c Ac]
Kukuryzka: folds 
gabi_igna: folds 
nickreason17: folds 
mooose100: calls $2
matiko09: raises $6 to $8
Xagua: folds 
chaps1988: calls $8
KovIFish89: calls $7
Fitzyferret: folds 
mooose100: calls $6
*** FLOP *** [Qd 5d 2d]
KovIFish89: checks 
mooose100: bets $32.30
matiko09: folds 
chaps1988: folds 
KovIFish89: folds 
Uncalled bet ($32.30) returned to mooose100
mooose100 collected $32.30 from pot
mooose100: doesn't show hand 
*** SUMMARY ***
Total pot $34 | Rake $1.70 
Board [Qd 5d 2d]
Seat 1: Kukuryzka folded before Flop (didn't bet)
Seat 2: gabi_igna folded before Flop (didn't bet)
Seat 3: nickreason17 folded before Flop (didn't bet)
Seat 4: mooose100 collected ($32.30)
Seat 5: matiko09 folded on the Flop
Seat 6: Xagua folded before Flop (didn't bet)
Seat 7: chaps1988 (button) folded on the Flop
Seat 8: KovIFish89 (small blind) folded on the Flop
Seat 9: Fitzyferret (big blind) folded before Flop





PokerStars Hand #152885502905:  Hold'em No Limit ($0.50/$1.00 USD) - 2016/05/05 16:19:54 CET [2016/05/05 10:19:54 ET]
Table 'Luthera' 9-max Seat #7 is the button
Seat 1: MrMattkk ($110.47 in chips) 
Seat 2: Kukuryzka ($103 in chips) 
Seat 3: sanpidk ($106.70 in chips) 
Seat 4: matiko09 ($109.98 in chips) 
Seat 5: Painkiller72 ($109.50 in chips) 
Seat 6: Dantist1122 ($100 in chips) 
Seat 7: Chin41178 ($85.96 in chips) 
Seat 8: xdrKush420x ($104.56 in chips) 
Seat 9: vrnMike ($104.10 in chips) 
xdrKush420x: posts small blind $0.50
vrnMike: posts big blind $1
*** HOLE CARDS ***
Dealt to matiko09 [Qh 4h]
MrMattkk: calls $1
Kukuryzka: folds 
sanpidk: folds 
matiko09: folds 
Painkiller72: folds 
Dantist1122: folds 
Chin41178: folds 
xdrKush420x: folds 
vrnMike: checks 
*** FLOP *** [8c 5s Kh]
vrnMike: checks 
MrMattkk: bets $1
vrnMike: folds 
Uncalled bet ($1) returned to MrMattkk
MrMattkk collected $2.38 from pot
MrMattkk: doesn't show hand 
*** SUMMARY ***
Total pot $2.50 | Rake $0.12 
Board [8c 5s Kh]
Seat 1: MrMattkk collected ($2.38)
Seat 2: Kukuryzka folded before Flop (didn't bet)
Seat 3: sanpidk folded before Flop (didn't bet)
Seat 4: matiko09 folded before Flop (didn't bet)
Seat 5: Painkiller72 folded before Flop (didn't bet)
Seat 6: Dantist1122 folded before Flop (didn't bet)
Seat 7: Chin41178 (button) folded before Flop (didn't bet)
Seat 8: xdrKush420x (small blind) folded before Flop
Seat 9: vrnMike (big blind) folded on the Flop





PokerStars Hand #152885506324:  Hold'em No Limit ($1/$2 USD) - 2016/05/05 16:19:59 CET [2016/05/05 10:19:59 ET]
Table 'Lundia' 9-max Seat #3 is the button
Seat 1: Fitzyferret ($245.35 in chips) 
Seat 2: patpaty ($167.27 in chips) 
Seat 3: Painkiller72 ($235.79 in chips) 
Seat 4: KovIFish89 ($303.66 in chips) 
Seat 5: zmOe84 ($171.29 in chips) 
Seat 6: CI58 ($210.93 in chips) 
Seat 7: matiko09 ($235.11 in chips) 
Seat 9: gabi_igna ($263.12 in chips) 
KovIFish89: posts small blind $1
zmOe84: posts big blind $2
chaps1988: sits out 
*** HOLE CARDS ***
Dealt to matiko09 [4h 9h]
CI58: folds 
matiko09: folds 
gabi_igna: raises $4 to $6
Fitzyferret: folds 
patpaty: folds 
Painkiller72: folds 
KovIFish89: folds 
zmOe84: folds 
Uncalled bet ($4) returned to gabi_igna
gabi_igna collected $5 from pot
gabi_igna: doesn't show hand 
*** SUMMARY ***
Total pot $5 | Rake $0 
Seat 1: Fitzyferret folded before Flop (didn't bet)
Seat 2: patpaty folded before Flop (didn't bet)
Seat 3: Painkiller72 (button) folded before Flop (didn't bet)
Seat 4: KovIFish89 (small blind) folded before Flop
Seat 5: zmOe84 (big blind) folded before Flop
Seat 6: CI58 folded before Flop (didn't bet)
Seat 7: matiko09 folded before Flop (didn't bet)
Seat 9: gabi_igna collected ($5)





PokerStars Hand #152885508088:  Hold'em No Limit ($0.50/$1.00 USD) - 2016/05/05 16:20:02 CET [2016/05/05 10:20:02 ET]
Table 'Vela' 9-max Seat #8 is the button
Seat 4: Hayer ana ($172.78 in chips) 
Seat 6: matiko09 ($100 in chips) 
Seat 7: KovIFish89 ($103.38 in chips) 
Seat 8: vrnMike ($100 in chips) 
atlantx will be allowed to play after the button
janarr5 will be allowed to play after the button
kl4ssic will be allowed to play after the button
Hayer ana: posts small blind $0.50
sanpidk: is sitting out 
matiko09: posts big blind $1
*** HOLE CARDS ***
Dealt to matiko09 [4s 4h]
KovIFish89: folds 
vrnMike: raises $2 to $3
Hayer ana: folds 
matiko09: calls $2
*** FLOP *** [7d Ac 7s]
matiko09: checks 
vrnMike: checks 
*** TURN *** [7d Ac 7s] [8c]
matiko09: checks 
vrnMike: checks 
*** RIVER *** [7d Ac 7s 8c] [Th]
matiko09: checks 
vrnMike: bets $3
matiko09: folds 
Uncalled bet ($3) returned to vrnMike
vrnMike collected $6.18 from pot
*** SUMMARY ***
Total pot $6.50 | Rake $0.32 
Board [7d Ac 7s 8c Th]
Seat 4: Hayer ana (small blind) folded before Flop
Seat 6: matiko09 (big blind) folded on the River
Seat 7: KovIFish89 folded before Flop (didn't bet)
Seat 8: vrnMike (button) collected ($6.18)





PokerStars Hand #152885509956:  Hold'em No Limit ($1/$2 USD) - 2016/05/05 16:20:05 CET [2016/05/05 10:20:05 ET]
Table 'Tatry II' 9-max Seat #1 is the button
Seat 1: glanza_mike ($247.52 in chips) 
Seat 2: T0ny Adams ($84.40 in chips) 
Seat 3: matiko09 ($202.06 in chips) 
Seat 4: PacPacBum ($200 in chips) 
Seat 5: Painkiller72 ($359.03 in chips) 
Seat 7: gabi_igna ($203 in chips) 
Seat 8: chaps1988 ($200 in chips) 
Seat 9: korol702 ($76.11 in chips) 
T0ny Adams: posts small blind $1
matiko09: posts big blind $2
Kukuryzka: sits out 
*** HOLE CARDS ***
Dealt to matiko09 [Qc 4d]
PacPacBum: folds 
Painkiller72: raises $3 to $5
gabi_igna: folds 
chaps1988: folds 
korol702: folds 
glanza_mike: folds 
T0ny Adams: folds 
matiko09: folds 
Uncalled bet ($3) returned to Painkiller72
Painkiller72 collected $5 from pot
Painkiller72: doesn't show hand 
*** SUMMARY ***
Total pot $5 | Rake $0 
Seat 1: glanza_mike (button) folded before Flop (didn't bet)
Seat 2: T0ny Adams (small blind) folded before Flop
Seat 3: matiko09 (big blind) folded before Flop
Seat 4: PacPacBum folded before Flop (didn't bet)
Seat 5: Painkiller72 collected ($5)
Seat 7: gabi_igna folded before Flop (didn't bet)
Seat 8: chaps1988 folded before Flop (didn't bet)
Seat 9: korol702 folded before Flop (didn't bet)





PokerStars Hand #152885512018:  Hold'em No Limit ($0.50/$1.00 USD) - 2016/05/05 16:20:09 CET [2016/05/05 10:20:09 ET]
Table 'Porzia' 9-max Seat #2 is the button
Seat 1: vrnMike ($145.50 in chips) 
Seat 2: matiko09 ($100 in chips) 
Seat 3: Chin41178 ($135.66 in chips) 
Seat 4: Khaine_CM ($100 in chips) 
Seat 5: E_Sandnes ($104.74 in chips) 
Seat 7: gabi_igna ($191.84 in chips) 
Seat 8: PRINCE JULIO ($92.99 in chips) 
Chin41178: posts small blind $0.50
Khaine_CM: posts big blind $1
janarr5: sits out 
kl4ssic: sits out 
*** HOLE CARDS ***
Dealt to matiko09 [Tc 9d]
E_Sandnes: folds 
gabi_igna: folds 
PRINCE JULIO: raises $1.50 to $2.50
vrnMike: folds 
matiko09: folds 
Chin41178: folds 
Khaine_CM: folds 
Uncalled bet ($1.50) returned to PRINCE JULIO
Chin41178 leaves the table
PRINCE JULIO collected $2.50 from pot
PRINCE JULIO: doesn't show hand 
*** SUMMARY ***
Total pot $2.50 | Rake $0 
Seat 1: vrnMike folded before Flop (didn't bet)
Seat 2: matiko09 (button) folded before Flop (didn't bet)
Seat 3: Chin41178 (small blind) folded before Flop
Seat 4: Khaine_CM (big blind) folded before Flop
Seat 5: E_Sandnes folded before Flop (didn't bet)
Seat 7: gabi_igna folded before Flop (didn't bet)
Seat 8: PRINCE JULIO collected ($2.50)





PokerStars Hand #152885520132:  Hold'em No Limit ($1/$2 USD) - 2016/05/05 16:20:22 CET [2016/05/05 10:20:22 ET]
Table 'Samitchell' 9-max Seat #7 is the button
Seat 1: KovIFish89 ($226.35 in chips) 
Seat 2: matiko09 ($295.25 in chips) 
Seat 3: gabi_igna ($355.12 in chips) 
Seat 4: Fitzyferret ($371.13 in chips) 
Seat 5: chaps1988 ($276.57 in chips) 
Seat 7: patpaty ($164.59 in chips) 
Seat 8: WolleMalone ($200 in chips) 
Seat 9: kblkxls ($107.60 in chips) 
WolleMalone: posts small blind $1
kblkxls: posts big blind $2
*** HOLE CARDS ***
Dealt to matiko09 [2h 5s]
Zhalgasai leaves the table
KovIFish89: raises $4 to $6
matiko09: folds 
gabi_igna: folds 
Fitzyferret: folds 
chaps1988: folds 
patpaty: folds 
WolleMalone: calls $5
kblkxls: calls $4
*** FLOP *** [7h 4c 4s]
WolleMalone: checks 
kblkxls: bets $12
KovIFish89: calls $12
WolleMalone: folds 
*** TURN *** [7h 4c 4s] [3h]
PacPacBum joins the table at seat #6 
kblkxls: bets $25
KovIFish89: calls $25
*** RIVER *** [7h 4c 4s 3h] [Qc]
kblkxls: checks 
KovIFish89: checks 
*** SHOW DOWN ***
kblkxls: shows [Kd 7d] (two pair, Sevens and Fours)
KovIFish89: mucks hand 
kblkxls collected $89.25 from pot
*** SUMMARY ***
Total pot $92 | Rake $2.75 
Board [7h 4c 4s 3h Qc]
Seat 1: KovIFish89 mucked [6s 7s]
Seat 2: matiko09 folded before Flop (didn't bet)
Seat 3: gabi_igna folded before Flop (didn't bet)
Seat 4: Fitzyferret folded before Flop (didn't bet)
Seat 5: chaps1988 folded before Flop (didn't bet)
Seat 7: patpaty (button) folded before Flop (didn't bet)
Seat 8: WolleMalone (small blind) folded on the Flop
Seat 9: kblkxls (big blind) showed [Kd 7d] and won ($89.25) with two pair, Sevens and Fours





PokerStars Hand #152885521493:  Hold'em No Limit ($1/$2 USD) - 2016/05/05 16:20:25 CET [2016/05/05 10:20:25 ET]
Table 'Euporie II' 9-max Seat #5 is the button
Seat 1: gabi_igna ($202 in chips) 
Seat 3: chaps1988 ($200 in chips) 
Seat 5: Nuskatko1986 ($57.96 in chips) 
Seat 6: glanza_mike ($211 in chips) 
Seat 7: matiko09 ($214.74 in chips) 
Seat 8: Painkiller72 ($288.25 in chips) 
glanza_mike: posts small blind $1
matiko09: posts big blind $2
T0ny Adams: sits out 
kblkxls: sits out 
Fitzyferret: sits out 
*** HOLE CARDS ***
Dealt to matiko09 [3s 7d]
Painkiller72: folds 
gabi_igna: folds 
chaps1988: folds 
Nuskatko1986: folds 
glanza_mike: raises $3 to $5
matiko09: folds 
Uncalled bet ($3) returned to glanza_mike
glanza_mike collected $4 from pot
glanza_mike: doesn't show hand 
*** SUMMARY ***
Total pot $4 | Rake $0 
Seat 1: gabi_igna folded before Flop (didn't bet)
Seat 3: chaps1988 folded before Flop (didn't bet)
Seat 5: Nuskatko1986 (button) folded before Flop (didn't bet)
Seat 6: glanza_mike (small blind) collected ($4)
Seat 7: matiko09 (big blind) folded before Flop
Seat 8: Painkiller72 folded before Flop (didn't bet)





PokerStars Hand #152885523751:  Hold'em No Limit ($1/$2 USD) - 2016/05/05 16:20:28 CET [2016/05/05 10:20:28 ET]
Table 'Lundia' 9-max Seat #4 is the button
Seat 1: Fitzyferret ($245.35 in chips) 
Seat 2: patpaty ($167.27 in chips) 
Seat 3: Painkiller72 ($235.79 in chips) 
Seat 4: KovIFish89 ($302.66 in chips) 
Seat 5: zmOe84 ($169.29 in chips) 
Seat 6: CI58 ($210.93 in chips) 
Seat 7: matiko09 ($235.11 in chips) 
Seat 9: gabi_igna ($266.12 in chips) 
zmOe84: posts small blind $1
CI58: posts big blind $2
chaps1988: sits out 
*** HOLE CARDS ***
Dealt to matiko09 [8s As]
matiko09: folds 
gabi_igna: folds 
Fitzyferret: folds 
patpaty: folds 
Painkiller72: folds 
KovIFish89: folds 
zmOe84: folds 
Uncalled bet ($1) returned to CI58
CI58 collected $2 from pot
CI58: doesn't show hand 
*** SUMMARY ***
Total pot $2 | Rake $0 
Seat 1: Fitzyferret folded before Flop (didn't bet)
Seat 2: patpaty folded before Flop (didn't bet)
Seat 3: Painkiller72 folded before Flop (didn't bet)
Seat 4: KovIFish89 (button) folded before Flop (didn't bet)
Seat 5: zmOe84 (small blind) folded before Flop
Seat 6: CI58 (big blind) collected ($2)
Seat 7: matiko09 folded before Flop (didn't bet)
Seat 9: gabi_igna folded before Flop (didn't bet)





PokerStars Hand #152885529470:  Hold'em No Limit ($1/$2 USD) - 2016/05/05 16:20:38 CET [2016/05/05 10:20:38 ET]
Table 'Tatry II' 9-max Seat #2 is the button
Seat 1: glanza_mike ($247.52 in chips) 
Seat 2: T0ny Adams ($83.40 in chips) 
Seat 3: matiko09 ($200.06 in chips) 
Seat 4: PacPacBum ($200 in chips) 
Seat 5: Painkiller72 ($362.03 in chips) 
Seat 7: gabi_igna ($203 in chips) 
Seat 8: chaps1988 ($200 in chips) 
Seat 9: korol702 ($76.11 in chips) 
matiko09: posts small blind $1
PacPacBum: posts big blind $2
Kukuryzka: sits out 
*** HOLE CARDS ***
Dealt to matiko09 [6s 9c]
Painkiller72: folds 
gabi_igna: folds 
chaps1988: folds 
korol702: folds 
glanza_mike: folds 
T0ny Adams: raises $2.28 to $4.28
matiko09: folds 
PacPacBum: folds 
Uncalled bet ($2.28) returned to T0ny Adams
T0ny Adams collected $5 from pot
T0ny Adams: doesn't show hand 
*** SUMMARY ***
Total pot $5 | Rake $0 
Seat 1: glanza_mike folded before Flop (didn't bet)
Seat 2: T0ny Adams (button) collected ($5)
Seat 3: matiko09 (small blind) folded before Flop
Seat 4: PacPacBum (big blind) folded before Flop
Seat 5: Painkiller72 folded before Flop (didn't bet)
Seat 7: gabi_igna folded before Flop (didn't bet)
Seat 8: chaps1988 folded before Flop (didn't bet)
Seat 9: korol702 folded before Flop (didn't bet)





PokerStars Hand #152885530034:  Hold'em No Limit ($0.50/$1.00 USD) - 2016/05/05 16:20:39 CET [2016/05/05 10:20:39 ET]
Table 'Luthera' 9-max Seat #8 is the button
Seat 1: MrMattkk ($111.85 in chips) 
Seat 2: Kukuryzka ($103 in chips) 
Seat 3: sanpidk ($106.70 in chips) 
Seat 4: matiko09 ($109.98 in chips) 
Seat 5: Painkiller72 ($109.50 in chips) 
Seat 6: Dantist1122 ($100 in chips) 
Seat 7: Chin41178 ($85.96 in chips) 
Seat 8: xdrKush420x ($104.06 in chips) 
Seat 9: vrnMike ($103.10 in chips) 
vrnMike: posts small blind $0.50
MrMattkk: posts big blind $1
*** HOLE CARDS ***
Dealt to matiko09 [2d Qs]
Kukuryzka: folds 
sanpidk: folds 
matiko09: folds 
Painkiller72: folds 
Dantist1122: folds 
Chin41178: raises $2 to $3
xdrKush420x: folds 
vrnMike: folds 
MrMattkk: folds 
Uncalled bet ($2) returned to Chin41178
Chin41178 collected $2.50 from pot
Chin41178: doesn't show hand 
*** SUMMARY ***
Total pot $2.50 | Rake $0 
Seat 1: MrMattkk (big blind) folded before Flop
Seat 2: Kukuryzka folded before Flop (didn't bet)
Seat 3: sanpidk folded before Flop (didn't bet)
Seat 4: matiko09 folded before Flop (didn't bet)
Seat 5: Painkiller72 folded before Flop (didn't bet)
Seat 6: Dantist1122 folded before Flop (didn't bet)
Seat 7: Chin41178 collected ($2.50)
Seat 8: xdrKush420x (button) folded before Flop (didn't bet)
Seat 9: vrnMike (small blind) folded before Flop





PokerStars Hand #152885531298:  Hold'em No Limit ($0.50/$1.00 USD) - 2016/05/05 16:20:41 CET [2016/05/05 10:20:41 ET]
Table 'Musa II' 9-max Seat #3 is the button
Seat 1: KovIFish89 ($193.99 in chips) 
Seat 2: koutani7 ($95.50 in chips) 
Seat 3: vrnMike ($181.32 in chips) 
Seat 4: sanpidk ($103.92 in chips) 
Seat 6: cnn123 ($71.70 in chips) 
Seat 7: plaindaft1 ($122.68 in chips) 
Seat 8: matiko09 ($100.35 in chips) 
Seat 9: FroggyPlay ($102.68 in chips) 
sanpidk: posts small blind $0.50
nickreason17: is sitting out 
cnn123: posts big blind $1
*** HOLE CARDS ***
Dealt to matiko09 [3h 7d]
nickreason17 leaves the table
plaindaft1: folds 
matiko09: folds 
Khaine_CM joins the table at seat #5 
FroggyPlay: raises $2.01 to $3.01
KovIFish89: folds 
koutani7: folds 
vrnMike: folds 
sanpidk: folds 
cnn123: calls $2.01
*** FLOP *** [Qc Qd 2h]
cnn123: checks 
FroggyPlay: checks 
*** TURN *** [Qc Qd 2h] [5d]
cnn123: bets $5
FroggyPlay: calls $5
*** RIVER *** [Qc Qd 2h 5d] [3c]
cnn123: checks 
FroggyPlay: checks 
*** SHOW DOWN ***
cnn123: shows [Jc 9d] (a pair of Queens)
FroggyPlay: shows [Kd Td] (a pair of Queens - King kicker)
FroggyPlay collected $15.69 from pot
*** SUMMARY ***
Total pot $16.52 | Rake $0.83 
Board [Qc Qd 2h 5d 3c]
Seat 1: KovIFish89 folded before Flop (didn't bet)
Seat 2: koutani7 folded before Flop (didn't bet)
Seat 3: vrnMike (button) folded before Flop (didn't bet)
Seat 4: sanpidk (small blind) folded before Flop
Seat 6: cnn123 (big blind) showed [Jc 9d] and lost with a pair of Queens
Seat 7: plaindaft1 folded before Flop (didn't bet)
Seat 8: matiko09 folded before Flop (didn't bet)
Seat 9: FroggyPlay showed [Kd Td] and won ($15.69) with a pair of Queens





PokerStars Hand #152885533094:  Hold'em No Limit ($1/$2 USD) - 2016/05/05 16:20:44 CET [2016/05/05 10:20:44 ET]
Table 'Euporie II' 9-max Seat #6 is the button
Seat 1: gabi_igna ($202 in chips) 
Seat 3: chaps1988 ($200 in chips) 
Seat 5: Nuskatko1986 ($57.96 in chips) 
Seat 6: glanza_mike ($213 in chips) 
Seat 7: matiko09 ($212.74 in chips) 
Seat 8: Painkiller72 ($288.25 in chips) 
matiko09: posts small blind $1
Painkiller72: posts big blind $2
T0ny Adams: sits out 
kblkxls: sits out 
Fitzyferret: sits out 
*** HOLE CARDS ***
Dealt to matiko09 [6s Ac]
gabi_igna: folds 
chaps1988: raises $3 to $5
Nuskatko1986 has timed out
Nuskatko1986: folds 
glanza_mike: calls $5
matiko09: folds 
Painkiller72: folds 
*** FLOP *** [8c 5c 6c]
chaps1988: checks 
glanza_mike: bets $7.50
chaps1988: folds 
Uncalled bet ($7.50) returned to glanza_mike
glanza_mike collected $12.35 from pot
glanza_mike: doesn't show hand 
*** SUMMARY ***
Total pot $13 | Rake $0.65 
Board [8c 5c 6c]
Seat 1: gabi_igna folded before Flop (didn't bet)
Seat 3: chaps1988 folded on the Flop
Seat 5: Nuskatko1986 folded before Flop (didn't bet)
Seat 6: glanza_mike (button) collected ($12.35)
Seat 7: matiko09 (small blind) folded before Flop
Seat 8: Painkiller72 (big blind) folded before Flop





PokerStars Hand #152885535132:  Hold'em No Limit ($0.50/$1.00 USD) - 2016/05/05 16:20:47 CET [2016/05/05 10:20:47 ET]
Table 'Porzia' 9-max Seat #4 is the button
Seat 1: vrnMike ($145.50 in chips) 
Seat 2: matiko09 ($100 in chips) 
Seat 4: Khaine_CM ($100 in chips) 
Seat 5: E_Sandnes ($104.74 in chips) 
Seat 6: janarr5 ($100 in chips) 
Seat 7: gabi_igna ($191.84 in chips) 
Seat 8: PRINCE JULIO ($94.49 in chips) 
E_Sandnes: posts small blind $0.50
janarr5: posts big blind $1
kl4ssic: sits out 
*** HOLE CARDS ***
Dealt to matiko09 [7d 6c]
gabi_igna: folds 
PRINCE JULIO: folds 
vrnMike: folds 
matiko09: folds 
Khaine_CM: raises $1 to $2
sanpidk joins the table at seat #3 
E_Sandnes: folds 
janarr5: folds 
Uncalled bet ($1) returned to Khaine_CM
Khaine_CM collected $2.50 from pot
Khaine_CM: doesn't show hand 
*** SUMMARY ***
Total pot $2.50 | Rake $0 
Seat 1: vrnMike folded before Flop (didn't bet)
Seat 2: matiko09 folded before Flop (didn't bet)
Seat 4: Khaine_CM (button) collected ($2.50)
Seat 5: E_Sandnes (small blind) folded before Flop
Seat 6: janarr5 (big blind) folded before Flop
Seat 7: gabi_igna folded before Flop (didn't bet)
Seat 8: PRINCE JULIO folded before Flop (didn't bet)





PokerStars Hand #152885536616:  Hold'em No Limit ($1/$2 USD) - 2016/05/05 16:20:50 CET [2016/05/05 10:20:50 ET]
Table 'Lundia' 9-max Seat #5 is the button
Seat 1: Fitzyferret ($245.35 in chips) 
Seat 2: patpaty ($167.27 in chips) 
Seat 3: Painkiller72 ($235.79 in chips) 
Seat 4: KovIFish89 ($302.66 in chips) 
Seat 5: zmOe84 ($168.29 in chips) 
Seat 6: CI58 ($211.93 in chips) 
Seat 7: matiko09 ($235.11 in chips) 
Seat 9: gabi_igna ($266.12 in chips) 
CI58: posts small blind $1
matiko09: posts big blind $2
chaps1988: sits out 
*** HOLE CARDS ***
Dealt to matiko09 [Ad Qs]
gabi_igna: folds 
Fitzyferret: folds 
patpaty: calls $2
Painkiller72: folds 
KovIFish89: folds 
zmOe84: folds 
CI58: raises $8 to $10
matiko09: calls $8
patpaty: calls $8
*** FLOP *** [8c 6h Jd]
CI58: checks 
matiko09: checks 
patpaty: bets $10
CI58: calls $10
matiko09: folds 
*** TURN *** [8c 6h Jd] [4h]
CI58: checks 
patpaty: checks 
*** RIVER *** [8c 6h Jd 4h] [As]
CI58: checks 
patpaty: checks 
*** SHOW DOWN ***
CI58: shows [Qh Ah] (a pair of Aces)
patpaty: mucks hand 
CI58 collected $47.50 from pot
*** SUMMARY ***
Total pot $50 | Rake $2.50 
Board [8c 6h Jd 4h As]
Seat 1: Fitzyferret folded before Flop (didn't bet)
Seat 2: patpaty mucked [Jc Kc]
Seat 3: Painkiller72 folded before Flop (didn't bet)
Seat 4: KovIFish89 folded before Flop (didn't bet)
Seat 5: zmOe84 (button) folded before Flop (didn't bet)
Seat 6: CI58 (small blind) showed [Qh Ah] and won ($47.50) with a pair of Aces
Seat 7: matiko09 (big blind) folded on the Flop
Seat 9: gabi_igna folded before Flop (didn't bet)





PokerStars Hand #152885538465:  Hold'em No Limit ($0.50/$1.00 USD) - 2016/05/05 16:20:53 CET [2016/05/05 10:20:53 ET]
Table 'Natascha' 9-max Seat #5 is the button
Seat 1: ronald3737 ($210.62 in chips) 
Seat 2: Hayer ana ($106.05 in chips) 
Seat 3: JorgeAndino ($100 in chips) 
Seat 4: sanpidk ($158.51 in chips) 
Seat 5: Sundown100 ($34.50 in chips) 
Seat 6: gabi_igna ($103.12 in chips) 
Seat 7: matiko09 ($131.03 in chips) 
Seat 8: kamillo91 ($49.28 in chips) 
Seat 9: janarr5 ($100 in chips) 
gabi_igna: posts small blind $0.50
matiko09: posts big blind $1
*** HOLE CARDS ***
Dealt to matiko09 [8c Tc]
kamillo91: folds 
janarr5: folds 
ronald3737: raises $1 to $2
Hayer ana: folds 
JorgeAndino: folds 
sanpidk: calls $2
Sundown100: folds 
gabi_igna: folds 
matiko09: calls $1
*** FLOP *** [Td 3d 8d]
matiko09: bets $4.02
ronald3737: folds 
sanpidk: folds 
Uncalled bet ($4.02) returned to matiko09
matiko09 collected $6.18 from pot
matiko09: doesn't show hand 
*** SUMMARY ***
Total pot $6.50 | Rake $0.32 
Board [Td 3d 8d]
Seat 1: ronald3737 folded on the Flop
Seat 2: Hayer ana folded before Flop (didn't bet)
Seat 3: JorgeAndino folded before Flop (didn't bet)
Seat 4: sanpidk folded on the Flop
Seat 5: Sundown100 (button) folded before Flop (didn't bet)
Seat 6: gabi_igna (small blind) folded before Flop
Seat 7: matiko09 (big blind) collected ($6.18)
Seat 8: kamillo91 folded before Flop (didn't bet)
Seat 9: janarr5 folded before Flop (didn't bet)





PokerStars Hand #152885548269:  Hold'em No Limit ($1/$2 USD) - 2016/05/05 16:21:09 CET [2016/05/05 10:21:09 ET]
Table 'Tatry II' 9-max Seat #3 is the button
Seat 1: glanza_mike ($247.52 in chips) 
Seat 2: T0ny Adams ($86.40 in chips) 
Seat 3: matiko09 ($200 in chips) 
Seat 4: PacPacBum ($200 in chips) 
Seat 5: Painkiller72 ($362.03 in chips) 
Seat 7: gabi_igna ($203 in chips) 
Seat 8: chaps1988 ($200 in chips) 
Seat 9: korol702 ($76.11 in chips) 
PacPacBum: posts small blind $1
Painkiller72: posts big blind $2
Kukuryzka: sits out 
*** HOLE CARDS ***
Dealt to matiko09 [6d 2d]
gabi_igna: folds 
chaps1988: folds 
korol702: raises $2 to $4
glanza_mike: folds 
T0ny Adams: folds 
matiko09: folds 
PacPacBum: folds 
Painkiller72: calls $2
*** FLOP *** [5s Qs 3d]
Painkiller72: checks 
korol702: checks 
*** TURN *** [5s Qs 3d] [6h]
Painkiller72: bets $5.98
korol702: folds 
Uncalled bet ($5.98) returned to Painkiller72
Painkiller72 collected $8.55 from pot
Painkiller72: doesn't show hand 
*** SUMMARY ***
Total pot $9 | Rake $0.45 
Board [5s Qs 3d 6h]
Seat 1: glanza_mike folded before Flop (didn't bet)
Seat 2: T0ny Adams folded before Flop (didn't bet)
Seat 3: matiko09 (button) folded before Flop (didn't bet)
Seat 4: PacPacBum (small blind) folded before Flop
Seat 5: Painkiller72 (big blind) collected ($8.55)
Seat 7: gabi_igna folded before Flop (didn't bet)
Seat 8: chaps1988 folded before Flop (didn't bet)
Seat 9: korol702 folded on the Turn





PokerStars Hand #152885547939:  Hold'em No Limit ($0.50/$1.00 USD) - 2016/05/05 16:21:09 CET [2016/05/05 10:21:09 ET]
Table 'Vela' 9-max Seat #4 is the button
Seat 3: dviryo ($441.82 in chips) 
Seat 4: Hayer ana ($172.28 in chips) 
Seat 6: matiko09 ($100 in chips) 
Seat 7: KovIFish89 ($103.38 in chips) 
Seat 8: vrnMike ($103.18 in chips) 
sanpidk will be allowed to play after the button
matiko09: posts small blind $0.50
KovIFish89: posts big blind $1
janarr5: sits out 
kl4ssic: sits out 
dviryo: posts small & big blinds $1.50
*** HOLE CARDS ***
Dealt to matiko09 [9s 6s]
vrnMike: folds 
dviryo: checks 
Hayer ana: raises $3 to $4
matiko09: folds 
KovIFish89: folds 
dviryo: folds 
Uncalled bet ($3) returned to Hayer ana
Hayer ana collected $4 from pot
Hayer ana: doesn't show hand 
*** SUMMARY ***
Total pot $4 | Rake $0 
Seat 3: dviryo folded before Flop
Seat 4: Hayer ana (button) collected ($4)
Seat 6: matiko09 (small blind) folded before Flop
Seat 7: KovIFish89 (big blind) folded before Flop
Seat 8: vrnMike folded before Flop (didn't bet)





PokerStars Hand #152885994127:  Hold'em No Limit ($1/$2 USD) - 2016/05/05 16:33:31 CET [2016/05/05 10:33:31 ET]
Table 'Euporie II' 9-max Seat #5 is the button
Seat 1: gabi_igna ($203 in chips) 
Seat 2: kblkxls ($119.10 in chips) 
Seat 3: chaps1988 ($239.25 in chips) 
Seat 5: Nuskatko1986 ($43.87 in chips) 
Seat 6: Kukuryzka ($199.75 in chips) 
Seat 7: matiko09 ($211.74 in chips) 
Seat 8: Painkiller72 ($290.70 in chips) 
Seat 9: T0ny Adams ($76.23 in chips) 
Kukuryzka: posts small blind $1
matiko09: posts big blind $2
*** HOLE CARDS ***
Dealt to matiko09 [3h 5d]
Painkiller72: folds 
T0ny Adams: folds 
gabi_igna: folds 
kblkxls: raises $4 to $6
chaps1988: folds 
Nuskatko1986: calls $6
Kukuryzka: calls $5
matiko09: folds 
*** FLOP *** [2c Qs Jh]
Kukuryzka: checks 
kblkxls: bets $11
Nuskatko1986: folds 
Kukuryzka: folds 
Uncalled bet ($11) returned to kblkxls
kblkxls collected $19 from pot
kblkxls: doesn't show hand 
*** SUMMARY ***
Total pot $20 | Rake $1 
Board [2c Qs Jh]
Seat 1: gabi_igna folded before Flop (didn't bet)
Seat 2: kblkxls collected ($19)
Seat 3: chaps1988 folded before Flop (didn't bet)
Seat 5: Nuskatko1986 (button) folded on the Flop
Seat 6: Kukuryzka (small blind) folded on the Flop
Seat 7: matiko09 (big blind) folded before Flop
Seat 8: Painkiller72 folded before Flop (didn't bet)
Seat 9: T0ny Adams folded before Flop (didn't bet)





PokerStars Hand #152886005634:  Hold'em No Limit ($0.50/$1.00 USD) - 2016/05/05 16:33:50 CET [2016/05/05 10:33:50 ET]
Table 'Porzia' 9-max Seat #9 is the button
Seat 1: vrnMike ($160.50 in chips) 
Seat 2: matiko09 ($100 in chips) 
Seat 3: sanpidk ($116.32 in chips) 
Seat 4: Khaine_CM ($100 in chips) 
Seat 6: janarr5 ($113.47 in chips) 
Seat 7: gabi_igna ($190.06 in chips) 
Seat 8: PRINCE JULIO ($91.84 in chips) 
Seat 9: kl4ssic ($49.50 in chips) 
vrnMike: posts small blind $0.50
matiko09: posts big blind $1
*** HOLE CARDS ***
Dealt to matiko09 [Kh Ad]
sanpidk: folds 
Khaine_CM: folds 
janarr5: folds 
gabi_igna: folds 
PRINCE JULIO: folds 
kl4ssic: folds 
vrnMike: raises $1.50 to $2.50
matiko09: raises $6.50 to $9
vrnMike: folds 
Uncalled bet ($6.50) returned to matiko09
matiko09 collected $5 from pot
matiko09: doesn't show hand 
*** SUMMARY ***
Total pot $5 | Rake $0 
Seat 1: vrnMike (small blind) folded before Flop
Seat 2: matiko09 (big blind) collected ($5)
Seat 3: sanpidk folded before Flop (didn't bet)
Seat 4: Khaine_CM folded before Flop (didn't bet)
Seat 6: janarr5 folded before Flop (didn't bet)
Seat 7: gabi_igna folded before Flop (didn't bet)
Seat 8: PRINCE JULIO folded before Flop (didn't bet)
Seat 9: kl4ssic (button) folded before Flop (didn't bet)





PokerStars Hand #152886007405:  Hold'em No Limit ($1/$2 USD) - 2016/05/05 16:33:53 CET [2016/05/05 10:33:53 ET]
Table 'Samitchell' 9-max Seat #9 is the button
Seat 1: KovIFish89 ($220.50 in chips) 
Seat 2: matiko09 ($295.25 in chips) 
Seat 3: gabi_igna ($382.62 in chips) 
Seat 4: Fitzyferret ($365.13 in chips) 
Seat 5: chaps1988 ($277.12 in chips) 
Seat 6: PacPacBum ($200 in chips) 
Seat 7: patpaty ($155.04 in chips) 
Seat 9: kblkxls ($135.20 in chips) 
KovIFish89: posts small blind $1
matiko09: posts big blind $2
*** HOLE CARDS ***
Dealt to matiko09 [Jh 5h]
gabi_igna: folds 
Fitzyferret: folds 
chaps1988: folds 
PacPacBum: folds 
patpaty: raises $2 to $4
kblkxls: folds 
KovIFish89: folds 
matiko09: folds 
Uncalled bet ($2) returned to patpaty
patpaty collected $5 from pot
patpaty: doesn't show hand 
*** SUMMARY ***
Total pot $5 | Rake $0 
Seat 1: KovIFish89 (small blind) folded before Flop
Seat 2: matiko09 (big blind) folded before Flop
Seat 3: gabi_igna folded before Flop (didn't bet)
Seat 4: Fitzyferret folded before Flop (didn't bet)
Seat 5: chaps1988 folded before Flop (didn't bet)
Seat 6: PacPacBum folded before Flop (didn't bet)
Seat 7: patpaty collected ($5)
Seat 9: kblkxls (button) folded before Flop (didn't bet)





PokerStars Hand #152886008714:  Hold'em No Limit ($1/$2 USD) - 2016/05/05 16:33:55 CET [2016/05/05 10:33:55 ET]
Table 'Tololo' 9-max Seat #3 is the button
Seat 1: Kukuryzka ($227.29 in chips) 
Seat 2: gabi_igna ($243.15 in chips) 
Seat 3: Khaine_CM ($200 in chips) 
Seat 4: mooose100 ($151.26 in chips) 
Seat 5: matiko09 ($200 in chips) 
Seat 6: Xagua ($160.70 in chips) 
Seat 7: chaps1988 ($284.42 in chips) 
Seat 8: KovIFish89 ($227.85 in chips) 
mooose100: posts small blind $1
matiko09: posts big blind $2
*** HOLE CARDS ***
Dealt to matiko09 [9s Qd]
Xagua: folds 
chaps1988: folds 
KovIFish89: raises $4 to $6
Kukuryzka: folds 
gabi_igna: folds 
Khaine_CM: calls $6
mooose100: folds 
matiko09: folds 
*** FLOP *** [As Tc 6s]
KovIFish89: bets $9.49
Khaine_CM: calls $9.49
*** TURN *** [As Tc 6s] [Jh]
KovIFish89: checks 
Khaine_CM: bets $24
KovIFish89: raises $45 to $69
Khaine_CM: calls $45
*** RIVER *** [As Tc 6s Jh] [5s]
KovIFish89: bets $118
Khaine_CM: folds 
Uncalled bet ($118) returned to KovIFish89
KovIFish89 collected $169.23 from pot
KovIFish89: doesn't show hand 
*** SUMMARY ***
Total pot $171.98 | Rake $2.75 
Board [As Tc 6s Jh 5s]
Seat 1: Kukuryzka folded before Flop (didn't bet)
Seat 2: gabi_igna folded before Flop (didn't bet)
Seat 3: Khaine_CM (button) folded on the River
Seat 4: mooose100 (small blind) folded before Flop
Seat 5: matiko09 (big blind) folded before Flop
Seat 6: Xagua folded before Flop (didn't bet)
Seat 7: chaps1988 folded before Flop (didn't bet)
Seat 8: KovIFish89 collected ($169.23)





PokerStars Hand #152886022340:  Hold'em No Limit ($0.50/$1.00 USD) - 2016/05/05 16:34:18 CET [2016/05/05 10:34:18 ET]
Table 'Porzia' 9-max Seat #1 is the button
Seat 1: vrnMike ($158 in chips) 
Seat 2: matiko09 ($102.50 in chips) 
Seat 3: sanpidk ($116.32 in chips) 
Seat 4: Khaine_CM ($100 in chips) 
Seat 6: janarr5 ($113.47 in chips) 
Seat 7: gabi_igna ($190.06 in chips) 
Seat 8: PRINCE JULIO ($91.84 in chips) 
Seat 9: kl4ssic ($49.50 in chips) 
matiko09: posts small blind $0.50
sanpidk: posts big blind $1
*** HOLE CARDS ***
Dealt to matiko09 [3d 9s]
Khaine_CM: folds 
janarr5: folds 
gabi_igna: folds 
PRINCE JULIO: folds 
kl4ssic: folds 
vrnMike: raises $2 to $3
matiko09: folds 
sanpidk: folds 
Uncalled bet ($2) returned to vrnMike
vrnMike collected $2.50 from pot
*** SUMMARY ***
Total pot $2.50 | Rake $0 
Seat 1: vrnMike (button) collected ($2.50)
Seat 2: matiko09 (small blind) folded before Flop
Seat 3: sanpidk (big blind) folded before Flop
Seat 4: Khaine_CM folded before Flop (didn't bet)
Seat 6: janarr5 folded before Flop (didn't bet)
Seat 7: gabi_igna folded before Flop (didn't bet)
Seat 8: PRINCE JULIO folded before Flop (didn't bet)
Seat 9: kl4ssic folded before Flop (didn't bet)





PokerStars Hand #152886022498:  Hold'em No Limit ($1/$2 USD) - 2016/05/05 16:34:18 CET [2016/05/05 10:34:18 ET]
Table 'Samitchell' 9-max Seat #1 is the button
Seat 1: KovIFish89 ($219.50 in chips) 
Seat 2: matiko09 ($293.25 in chips) 
Seat 3: gabi_igna ($382.62 in chips) 
Seat 4: Fitzyferret ($365.13 in chips) 
Seat 5: chaps1988 ($277.12 in chips) 
Seat 6: PacPacBum ($200 in chips) 
Seat 7: patpaty ($158.04 in chips) 
Seat 9: kblkxls ($135.20 in chips) 
matiko09: posts small blind $1
gabi_igna: posts big blind $2
*** HOLE CARDS ***
Dealt to matiko09 [7d Qs]
Fitzyferret: folds 
chaps1988: folds 
PacPacBum: folds 
patpaty: folds 
kblkxls: raises $2 to $4
KovIFish89: folds 
matiko09: folds 
gabi_igna: calls $2
*** FLOP *** [2h 6d 8c]
gabi_igna: checks 
kblkxls: bets $6
gabi_igna: calls $6
*** TURN *** [2h 6d 8c] [4s]
gabi_igna: checks 
kblkxls: checks 
*** RIVER *** [2h 6d 8c 4s] [5h]
gabi_igna: bets $12
kblkxls said, "you have a straight"
kblkxls: folds 
Uncalled bet ($12) returned to gabi_igna
gabi_igna collected $19.95 from pot
gabi_igna: doesn't show hand 
*** SUMMARY ***
Total pot $21 | Rake $1.05 
Board [2h 6d 8c 4s 5h]
Seat 1: KovIFish89 (button) folded before Flop (didn't bet)
Seat 2: matiko09 (small blind) folded before Flop
Seat 3: gabi_igna (big blind) collected ($19.95)
Seat 4: Fitzyferret folded before Flop (didn't bet)
Seat 5: chaps1988 folded before Flop (didn't bet)
Seat 6: PacPacBum folded before Flop (didn't bet)
Seat 7: patpaty folded before Flop (didn't bet)
Seat 9: kblkxls folded on the River





PokerStars Hand #152886025644:  Hold'em No Limit (€1/€2 EUR) - 2016/05/05 16:34:23 CET [2016/05/05 10:34:23 ET]
Table 'Bessel II' 9-max Seat #5 is the button
Seat 1: Soloaces224 (€135.39 in chips) 
Seat 3: PacPacBum (€220.94 in chips) 
Seat 4: Zorken76 (€141.82 in chips) 
Seat 5: Kukuryzka (€200 in chips) 
Seat 6: glanza_mike (€200 in chips) 
Seat 7: matiko09 (€200 in chips) 
Seat 8: chaps1988 (€241.72 in chips) 
glanza_mike: posts small blind €1
matiko09: posts big blind €2
*** HOLE CARDS ***
Dealt to matiko09 [Ad 7c]
chaps1988: folds 
Soloaces224: folds 
PacPacBum: folds 
Zorken76: folds 
Kukuryzka: raises €2 to €4
glanza_mike: folds 
matiko09: calls €2
*** FLOP *** [Jc Qc 8c]
matiko09: checks 
Kukuryzka: checks 
*** TURN *** [Jc Qc 8c] [4c]
matiko09: bets €2.65
Kukuryzka: calls €2.65
*** RIVER *** [Jc Qc 8c 4c] [4d]
matiko09: checks 
Kukuryzka: bets €8
matiko09: folds 
Uncalled bet (€8) returned to Kukuryzka
Kukuryzka collected €13.58 from pot
Kukuryzka: doesn't show hand 
*** SUMMARY ***
Total pot €14.30 | Rake €0.72 
Board [Jc Qc 8c 4c 4d]
Seat 1: Soloaces224 folded before Flop (didn't bet)
Seat 3: PacPacBum folded before Flop (didn't bet)
Seat 4: Zorken76 folded before Flop (didn't bet)
Seat 5: Kukuryzka (button) collected (€13.58)
Seat 6: glanza_mike (small blind) folded before Flop
Seat 7: matiko09 (big blind) folded on the River
Seat 8: chaps1988 folded before Flop (didn't bet)





PokerStars Hand #152886029162:  Hold'em No Limit ($1/$2 USD) - 2016/05/05 16:34:29 CET [2016/05/05 10:34:29 ET]
Table 'Euporie II' 9-max Seat #6 is the button
Seat 1: gabi_igna ($203 in chips) 
Seat 2: kblkxls ($132.10 in chips) 
Seat 3: chaps1988 ($239.25 in chips) 
Seat 5: Nuskatko1986 ($37.87 in chips) 
Seat 6: Kukuryzka ($200 in chips) 
Seat 7: matiko09 ($209.74 in chips) 
Seat 8: Painkiller72 ($290.70 in chips) 
Seat 9: T0ny Adams ($76.23 in chips) 
matiko09: posts small blind $1
Painkiller72: posts big blind $2
*** HOLE CARDS ***
Dealt to matiko09 [6c 8d]
T0ny Adams: folds 
gabi_igna: folds 
kblkxls: folds 
chaps1988: folds 
Nuskatko1986: folds 
Kukuryzka: raises $2 to $4
matiko09: folds 
Painkiller72: calls $2
*** FLOP *** [Jc 5c Ac]
Painkiller72: checks 
Kukuryzka: checks 
*** TURN *** [Jc 5c Ac] [8c]
Painkiller72: checks 
Kukuryzka: checks 
*** RIVER *** [Jc 5c Ac 8c] [Qs]
Painkiller72: checks 
Kukuryzka: checks 
*** SHOW DOWN ***
Painkiller72: shows [As 7d] (a pair of Aces)
Kukuryzka: mucks hand 
Painkiller72 collected $8.55 from pot
*** SUMMARY ***
Total pot $9 | Rake $0.45 
Board [Jc 5c Ac 8c Qs]
Seat 1: gabi_igna folded before Flop (didn't bet)
Seat 2: kblkxls folded before Flop (didn't bet)
Seat 3: chaps1988 folded before Flop (didn't bet)
Seat 5: Nuskatko1986 folded before Flop (didn't bet)
Seat 6: Kukuryzka (button) mucked [9s 8s]
Seat 7: matiko09 (small blind) folded before Flop
Seat 8: Painkiller72 (big blind) showed [As 7d] and won ($8.55) with a pair of Aces
Seat 9: T0ny Adams folded before Flop (didn't bet)





PokerStars Hand #152886036240:  Hold'em No Limit ($0.50/$1.00 USD) - 2016/05/05 16:34:41 CET [2016/05/05 10:34:41 ET]
Table 'Porzia' 9-max Seat #2 is the button
Seat 1: vrnMike ($159.50 in chips) 
Seat 2: matiko09 ($102 in chips) 
Seat 3: sanpidk ($115.32 in chips) 
Seat 4: Khaine_CM ($100 in chips) 
Seat 6: janarr5 ($113.47 in chips) 
Seat 7: gabi_igna ($190.06 in chips) 
Seat 8: PRINCE JULIO ($91.84 in chips) 
Seat 9: kl4ssic ($49.50 in chips) 
sanpidk: posts small blind $0.50
Khaine_CM: posts big blind $1
*** HOLE CARDS ***
Dealt to matiko09 [Ad 4c]
janarr5 has timed out
janarr5: folds 
gabi_igna: folds 
PRINCE JULIO: folds 
kl4ssic: folds 
vrnMike: folds 
matiko09: raises $1.27 to $2.27
sanpidk: folds 
Khaine_CM: folds 
Uncalled bet ($1.27) returned to matiko09
matiko09 collected $2.50 from pot
matiko09: doesn't show hand 
*** SUMMARY ***
Total pot $2.50 | Rake $0 
Seat 1: vrnMike folded before Flop (didn't bet)
Seat 2: matiko09 (button) collected ($2.50)
Seat 3: sanpidk (small blind) folded before Flop
Seat 4: Khaine_CM (big blind) folded before Flop
Seat 6: janarr5 folded before Flop (didn't bet)
Seat 7: gabi_igna folded before Flop (didn't bet)
Seat 8: PRINCE JULIO folded before Flop (didn't bet)
Seat 9: kl4ssic folded before Flop (didn't bet)





PokerStars Hand #152886047164:  Hold'em No Limit (€1/€2 EUR) - 2016/05/05 16:35:00 CET [2016/05/05 10:35:00 ET]
Table 'Skat II' 9-max Seat #7 is the button
Seat 6: drissmouzou (€200.20 in chips) 
Seat 7: PacPacBum (€202.19 in chips) 
Seat 8: Painkiller72 (€205.97 in chips) 
Seat 9: matiko09 (€200 in chips) 
Painkiller72: posts small blind €1
matiko09: posts big blind €2
*** HOLE CARDS ***
Dealt to matiko09 [9h 7c]
drissmouzou: folds 
PacPacBum: raises €2.08 to €4.08
Painkiller72: folds 
matiko09: folds 
Uncalled bet (€2.08) returned to PacPacBum
PacPacBum collected €5 from pot
PacPacBum: doesn't show hand 
*** SUMMARY ***
Total pot €5 | Rake €0 
Seat 6: drissmouzou folded before Flop (didn't bet)
Seat 7: PacPacBum (button) collected (€5)
Seat 8: Painkiller72 (small blind) folded before Flop
Seat 9: matiko09 (big blind) folded before Flop





PokerStars Hand #152886049874:  Hold'em No Limit ($1/$2 USD) - 2016/05/05 16:35:04 CET [2016/05/05 10:35:04 ET]
Table 'Tatry II' 9-max Seat #1 is the button
Seat 1: glanza_mike ($237.87 in chips) 
Seat 2: T0ny Adams ($73.02 in chips) 
Seat 3: matiko09 ($200 in chips) 
Seat 4: PacPacBum ($209.57 in chips) 
Seat 5: Painkiller72 ($330.05 in chips) 
Seat 6: Kukuryzka ($279.60 in chips) 
Seat 7: gabi_igna ($203 in chips) 
Seat 8: chaps1988 ($251.62 in chips) 
Seat 9: korol702 ($133.64 in chips) 
T0ny Adams: posts small blind $1
matiko09: posts big blind $2
*** HOLE CARDS ***
Dealt to matiko09 [6h Td]
PacPacBum: folds 
Painkiller72: folds 
Kukuryzka: folds 
gabi_igna: folds 
chaps1988: folds 
korol702: raises $4 to $6
glanza_mike: folds 
T0ny Adams: folds 
matiko09: folds 
Uncalled bet ($4) returned to korol702
korol702 collected $5 from pot
korol702: doesn't show hand 
*** SUMMARY ***
Total pot $5 | Rake $0 
Seat 1: glanza_mike (button) folded before Flop (didn't bet)
Seat 2: T0ny Adams (small blind) folded before Flop
Seat 3: matiko09 (big blind) folded before Flop
Seat 4: PacPacBum folded before Flop (didn't bet)
Seat 5: Painkiller72 folded before Flop (didn't bet)
Seat 6: Kukuryzka folded before Flop (didn't bet)
Seat 7: gabi_igna folded before Flop (didn't bet)
Seat 8: chaps1988 folded before Flop (didn't bet)
Seat 9: korol702 collected ($5)





PokerStars Hand #152886057098:  Hold'em No Limit (€1/€2 EUR) - 2016/05/05 16:35:16 CET [2016/05/05 10:35:16 ET]
Table 'Bessel II' 9-max Seat #6 is the button
Seat 1: Soloaces224 (€135.39 in chips) 
Seat 3: PacPacBum (€220.94 in chips) 
Seat 4: Zorken76 (€141.82 in chips) 
Seat 5: Kukuryzka (€206.93 in chips) 
Seat 6: glanza_mike (€200 in chips) 
Seat 7: matiko09 (€200 in chips) 
Seat 8: chaps1988 (€241.72 in chips) 
matiko09: posts small blind €1
chaps1988: posts big blind €2
*** HOLE CARDS ***
Dealt to matiko09 [5s 8s]
Soloaces224: folds 
PacPacBum: folds 
Zorken76: folds 
Kukuryzka: folds 
glanza_mike: folds 
matiko09: folds 
Uncalled bet (€1) returned to chaps1988
chaps1988 collected €2 from pot
*** SUMMARY ***
Total pot €2 | Rake €0 
Seat 1: Soloaces224 folded before Flop (didn't bet)
Seat 3: PacPacBum folded before Flop (didn't bet)
Seat 4: Zorken76 folded before Flop (didn't bet)
Seat 5: Kukuryzka folded before Flop (didn't bet)
Seat 6: glanza_mike (button) folded before Flop (didn't bet)
Seat 7: matiko09 (small blind) folded before Flop
Seat 8: chaps1988 (big blind) collected (€2)





PokerStars Hand #152886060467:  Hold'em No Limit ($0.50/$1.00 USD) - 2016/05/05 16:35:22 CET [2016/05/05 10:35:22 ET]
Table 'Kraz II' 9-max Seat #7 is the button
Seat 1: KovIFish89 ($137.23 in chips) 
Seat 2: sanpidk ($149.33 in chips) 
Seat 3: Khaine_CM ($100 in chips) 
Seat 4: LRVAV7 ($134.63 in chips) 
Seat 5: Kukuryzka ($100 in chips) 
Seat 6: andy84lfc ($235.73 in chips) 
Seat 7: Dantist1122 ($125.15 in chips) 
Seat 8: Hayer ana ($100.50 in chips) 
Seat 9: matiko09 ($178.82 in chips) 
Hayer ana: posts small blind $0.50
matiko09: posts big blind $1
*** HOLE CARDS ***
Dealt to matiko09 [Td 2h]
KovIFish89: folds 
sanpidk: folds 
Khaine_CM: raises $2 to $3
LRVAV7: folds 
Kukuryzka: folds 
andy84lfc: folds 
Dantist1122: folds 
Hayer ana: folds 
matiko09: folds 
Uncalled bet ($2) returned to Khaine_CM
Khaine_CM collected $2.50 from pot
Khaine_CM: doesn't show hand 
*** SUMMARY ***
Total pot $2.50 | Rake $0 
Seat 1: KovIFish89 folded before Flop (didn't bet)
Seat 2: sanpidk folded before Flop (didn't bet)
Seat 3: Khaine_CM collected ($2.50)
Seat 4: LRVAV7 folded before Flop (didn't bet)
Seat 5: Kukuryzka folded before Flop (didn't bet)
Seat 6: andy84lfc folded before Flop (didn't bet)
Seat 7: Dantist1122 (button) folded before Flop (didn't bet)
Seat 8: Hayer ana (small blind) folded before Flop
Seat 9: matiko09 (big blind) folded before Flop





PokerStars Hand #152886062074:  Hold'em No Limit ($0.50/$1.00 USD) - 2016/05/05 16:35:24 CET [2016/05/05 10:35:24 ET]
Table 'Porzia' 9-max Seat #3 is the button
Seat 1: vrnMike ($159.50 in chips) 
Seat 2: matiko09 ($103.50 in chips) 
Seat 3: sanpidk ($114.82 in chips) 
Seat 4: Khaine_CM ($100 in chips) 
Seat 6: janarr5 ($113.47 in chips) 
Seat 7: gabi_igna ($190.06 in chips) 
Seat 8: PRINCE JULIO ($91.84 in chips) 
Seat 9: kl4ssic ($49.50 in chips) 
Khaine_CM: posts small blind $0.50
janarr5: posts big blind $1
*** HOLE CARDS ***
Dealt to matiko09 [4h 8h]
gabi_igna: folds 
PRINCE JULIO: folds 
kl4ssic: folds 
vrnMike: folds 
matiko09: folds 
sanpidk: folds 
Khaine_CM: raises $2 to $3
janarr5: folds 
Uncalled bet ($2) returned to Khaine_CM
Khaine_CM collected $2 from pot
Khaine_CM: doesn't show hand 
*** SUMMARY ***
Total pot $2 | Rake $0 
Seat 1: vrnMike folded before Flop (didn't bet)
Seat 2: matiko09 folded before Flop (didn't bet)
Seat 3: sanpidk (button) folded before Flop (didn't bet)
Seat 4: Khaine_CM (small blind) collected ($2)
Seat 6: janarr5 (big blind) folded before Flop
Seat 7: gabi_igna folded before Flop (didn't bet)
Seat 8: PRINCE JULIO folded before Flop (didn't bet)
Seat 9: kl4ssic folded before Flop (didn't bet)





PokerStars Hand #152886063242:  Hold'em No Limit (€1/€2 EUR) - 2016/05/05 16:35:26 CET [2016/05/05 10:35:26 ET]
Table 'Skat II' 9-max Seat #8 is the button
Seat 6: drissmouzou (€200.20 in chips) 
Seat 7: PacPacBum (€205.19 in chips) 
Seat 8: Painkiller72 (€204.97 in chips) 
Seat 9: matiko09 (€200 in chips) 
matiko09: posts small blind €1
drissmouzou: posts big blind €2
*** HOLE CARDS ***
Dealt to matiko09 [5d Td]
PacPacBum: raises €4 to €6
Painkiller72: folds 
matiko09: folds 
drissmouzou: folds 
Uncalled bet (€4) returned to PacPacBum
PacPacBum collected €5 from pot
PacPacBum: doesn't show hand 
*** SUMMARY ***
Total pot €5 | Rake €0 
Seat 6: drissmouzou (big blind) folded before Flop
Seat 7: PacPacBum collected (€5)
Seat 8: Painkiller72 (button) folded before Flop (didn't bet)
Seat 9: matiko09 (small blind) folded before Flop





PokerStars Hand #152886063112:  Hold'em No Limit ($1/$2 USD) - 2016/05/05 16:35:26 CET [2016/05/05 10:35:26 ET]
Table 'Samitchell' 9-max Seat #2 is the button
Seat 1: KovIFish89 ($219.50 in chips) 
Seat 2: matiko09 ($292.25 in chips) 
Seat 3: gabi_igna ($392.57 in chips) 
Seat 5: chaps1988 ($277.12 in chips) 
Seat 6: PacPacBum ($200 in chips) 
Seat 7: patpaty ($158.04 in chips) 
Seat 9: kblkxls ($125.20 in chips) 
gabi_igna: posts small blind $1
Fitzyferret: is sitting out 
chaps1988: posts big blind $2
*** HOLE CARDS ***
Dealt to matiko09 [8c 9c]
PacPacBum: folds 
patpaty: folds 
kblkxls: folds 
KovIFish89: folds 
matiko09: raises $2.54 to $4.54
gabi_igna: raises $13.46 to $18
chaps1988: folds 
matiko09: folds 
Uncalled bet ($13.46) returned to gabi_igna
gabi_igna collected $11.08 from pot
gabi_igna: doesn't show hand 
*** SUMMARY ***
Total pot $11.08 | Rake $0 
Seat 1: KovIFish89 folded before Flop (didn't bet)
Seat 2: matiko09 (button) folded before Flop
Seat 3: gabi_igna (small blind) collected ($11.08)
Seat 5: chaps1988 (big blind) folded before Flop
Seat 6: PacPacBum folded before Flop (didn't bet)
Seat 7: patpaty folded before Flop (didn't bet)
Seat 9: kblkxls folded before Flop (didn't bet)





PokerStars Hand #152886065502:  Hold'em No Limit ($1/$2 USD) - 2016/05/05 16:35:30 CET [2016/05/05 10:35:30 ET]
Table 'Euporie II' 9-max Seat #7 is the button
Seat 1: gabi_igna ($203 in chips) 
Seat 2: kblkxls ($132.10 in chips) 
Seat 3: chaps1988 ($239.25 in chips) 
Seat 5: Nuskatko1986 ($37.87 in chips) 
Seat 6: Kukuryzka ($200 in chips) 
Seat 7: matiko09 ($208.74 in chips) 
Seat 8: Painkiller72 ($295.25 in chips) 
Seat 9: T0ny Adams ($76.23 in chips) 
Painkiller72: posts small blind $1
T0ny Adams: posts big blind $2
*** HOLE CARDS ***
Dealt to matiko09 [Jc Qs]
gabi_igna: raises $4 to $6
kblkxls: folds 
chaps1988: folds 
Nuskatko1986: folds 
Kukuryzka: folds 
matiko09: folds 
Painkiller72: folds 
T0ny Adams: folds 
Uncalled bet ($4) returned to gabi_igna
gabi_igna collected $5 from pot
gabi_igna: doesn't show hand 
*** SUMMARY ***
Total pot $5 | Rake $0 
Seat 1: gabi_igna collected ($5)
Seat 2: kblkxls folded before Flop (didn't bet)
Seat 3: chaps1988 folded before Flop (didn't bet)
Seat 5: Nuskatko1986 folded before Flop (didn't bet)
Seat 6: Kukuryzka folded before Flop (didn't bet)
Seat 7: matiko09 (button) folded before Flop (didn't bet)
Seat 8: Painkiller72 (small blind) folded before Flop
Seat 9: T0ny Adams (big blind) folded before Flop





PokerStars Hand #152886067137:  Hold'em No Limit (€1/€2 EUR) - 2016/05/05 16:35:33 CET [2016/05/05 10:35:33 ET]
Table 'Bessel II' 9-max Seat #7 is the button
Seat 1: Soloaces224 (€135.39 in chips) 
Seat 3: PacPacBum (€220.94 in chips) 
Seat 4: Zorken76 (€141.82 in chips) 
Seat 5: Kukuryzka (€206.93 in chips) 
Seat 6: glanza_mike (€200 in chips) 
Seat 7: matiko09 (€200 in chips) 
Seat 8: chaps1988 (€242.72 in chips) 
chaps1988: posts small blind €1
Soloaces224: posts big blind €2
*** HOLE CARDS ***
Dealt to matiko09 [Td Qc]
PacPacBum: folds 
Zorken76: folds 
Kukuryzka: folds 
glanza_mike: raises €4 to €6
matiko09: folds 
chaps1988: folds 
Soloaces224: folds 
Uncalled bet (€4) returned to glanza_mike
glanza_mike collected €5 from pot
glanza_mike: doesn't show hand 
*** SUMMARY ***
Total pot €5 | Rake €0 
Seat 1: Soloaces224 (big blind) folded before Flop
Seat 3: PacPacBum folded before Flop (didn't bet)
Seat 4: Zorken76 folded before Flop (didn't bet)
Seat 5: Kukuryzka folded before Flop (didn't bet)
Seat 6: glanza_mike collected (€5)
Seat 7: matiko09 (button) folded before Flop (didn't bet)
Seat 8: chaps1988 (small blind) folded before Flop





PokerStars Hand #152886069200:  Hold'em No Limit ($1/$2 USD) - 2016/05/05 16:35:36 CET [2016/05/05 10:35:36 ET]
Table 'Tololo' 9-max Seat #4 is the button
Seat 1: Kukuryzka ($227.29 in chips) 
Seat 2: gabi_igna ($243.15 in chips) 
Seat 3: Khaine_CM ($200 in chips) 
Seat 4: mooose100 ($150.26 in chips) 
Seat 5: matiko09 ($200 in chips) 
Seat 6: Xagua ($160.70 in chips) 
Seat 7: chaps1988 ($284.42 in chips) 
Seat 8: KovIFish89 ($312.59 in chips) 
matiko09: posts small blind $1
Xagua: posts big blind $2
*** HOLE CARDS ***
Dealt to matiko09 [2s 7h]
chaps1988: folds 
KovIFish89: folds 
Kukuryzka: raises $4 to $6
gabi_igna: folds 
Khaine_CM: calls $6
mooose100: calls $6
matiko09: folds 
Xagua: calls $4
*** FLOP *** [3d Ks 5s]
Xagua: checks 
Kukuryzka: checks 
Khaine_CM: checks 
mooose100: checks 
*** TURN *** [3d Ks 5s] [Jd]
Xagua: checks 
Kukuryzka: bets $14
Khaine_CM: folds 
KovIFish89 leaves the table
myatiy 96 joins the table at seat #8 
mooose100: folds 
Xagua: folds 
Uncalled bet ($14) returned to Kukuryzka
Kukuryzka collected $23.75 from pot
Kukuryzka: doesn't show hand 
*** SUMMARY ***
Total pot $25 | Rake $1.25 
Board [3d Ks 5s Jd]
Seat 1: Kukuryzka collected ($23.75)
Seat 2: gabi_igna folded before Flop (didn't bet)
Seat 3: Khaine_CM folded on the Turn
Seat 4: mooose100 (button) folded on the Turn
Seat 5: matiko09 (small blind) folded before Flop
Seat 6: Xagua (big blind) folded on the Turn
Seat 7: chaps1988 folded before Flop (didn't bet)
Seat 8: KovIFish89 folded before Flop (didn't bet)





PokerStars Hand #152886069143:  Hold'em No Limit ($1/$2 USD) - 2016/05/05 16:35:36 CET [2016/05/05 10:35:36 ET]
Table 'Tatry II' 9-max Seat #2 is the button
Seat 1: glanza_mike ($237.87 in chips) 
Seat 2: T0ny Adams ($72.02 in chips) 
Seat 3: matiko09 ($200 in chips) 
Seat 4: PacPacBum ($209.57 in chips) 
Seat 5: Painkiller72 ($330.05 in chips) 
Seat 6: Kukuryzka ($279.60 in chips) 
Seat 7: gabi_igna ($203 in chips) 
Seat 8: chaps1988 ($251.62 in chips) 
Seat 9: korol702 ($136.64 in chips) 
matiko09: posts small blind $1
PacPacBum: posts big blind $2
*** HOLE CARDS ***
Dealt to matiko09 [Ks As]
Painkiller72: folds 
Kukuryzka: folds 
gabi_igna: folds 
chaps1988: folds 
korol702: folds 
glanza_mike: folds 
T0ny Adams: raises $2.28 to $4.28
matiko09: raises $9.72 to $14
PacPacBum: folds 
T0ny Adams: folds 
Uncalled bet ($9.72) returned to matiko09
matiko09 collected $10.56 from pot
matiko09: doesn't show hand 
*** SUMMARY ***
Total pot $10.56 | Rake $0 
Seat 1: glanza_mike folded before Flop (didn't bet)
Seat 2: T0ny Adams (button) folded before Flop
Seat 3: matiko09 (small blind) collected ($10.56)
Seat 4: PacPacBum (big blind) folded before Flop
Seat 5: Painkiller72 folded before Flop (didn't bet)
Seat 6: Kukuryzka folded before Flop (didn't bet)
Seat 7: gabi_igna folded before Flop (didn't bet)
Seat 8: chaps1988 folded before Flop (didn't bet)
Seat 9: korol702 folded before Flop (didn't bet)





PokerStars Hand #152886077078:  Hold'em No Limit ($1/$2 USD) - 2016/05/05 16:35:49 CET [2016/05/05 10:35:49 ET]
Table 'Euporie II' 9-max Seat #8 is the button
Seat 2: kblkxls ($132.10 in chips) 
Seat 3: chaps1988 ($239.25 in chips) 
Seat 5: Nuskatko1986 ($37.87 in chips) 
Seat 6: Kukuryzka ($200 in chips) 
Seat 7: matiko09 ($208.74 in chips) 
Seat 8: Painkiller72 ($294.25 in chips) 
Seat 9: T0ny Adams ($74.23 in chips) 
T0ny Adams: posts small blind $1
gabi_igna: is sitting out 
kblkxls: posts big blind $2
*** HOLE CARDS ***
Dealt to matiko09 [3s 3h]
gabi_igna leaves the table
chaps1988: folds 
PacPacBum joins the table at seat #1 
Nuskatko1986: calls $2
Kukuryzka: folds 
matiko09: calls $2
Painkiller72: folds 
T0ny Adams: folds 
kblkxls: raises $6 to $8
Nuskatko1986: calls $6
matiko09: calls $6
*** FLOP *** [Th Qs Kc]
kblkxls: bets $11
Nuskatko1986: calls $11
matiko09: folds 
*** TURN *** [Th Qs Kc] [5d]
kblkxls: checks 
Nuskatko1986: bets $18.87 and is all-in
kblkxls: folds 
Uncalled bet ($18.87) returned to Nuskatko1986
Nuskatko1986 collected $44.65 from pot
Nuskatko1986: doesn't show hand 
*** SUMMARY ***
Total pot $47 | Rake $2.35 
Board [Th Qs Kc 5d]
Seat 2: kblkxls (big blind) folded on the Turn
Seat 3: chaps1988 folded before Flop (didn't bet)
Seat 5: Nuskatko1986 collected ($44.65)
Seat 6: Kukuryzka folded before Flop (didn't bet)
Seat 7: matiko09 folded on the Flop
Seat 8: Painkiller72 (button) folded before Flop (didn't bet)
Seat 9: T0ny Adams (small blind) folded before Flop





PokerStars Hand #152886078697:  Hold'em No Limit (€1/€2 EUR) - 2016/05/05 16:35:52 CET [2016/05/05 10:35:52 ET]
Table 'Skat II' 9-max Seat #9 is the button
Seat 6: drissmouzou (€198.20 in chips) 
Seat 7: PacPacBum (€208.19 in chips) 
Seat 8: Painkiller72 (€204.97 in chips) 
Seat 9: matiko09 (€200 in chips) 
drissmouzou: posts small blind €1
PacPacBum: posts big blind €2
*** HOLE CARDS ***
Dealt to matiko09 [Qh 3s]
Painkiller72: folds 
matiko09: folds 
drissmouzou: raises €4 to €6
PacPacBum: raises €12 to €18
drissmouzou: folds 
Uncalled bet (€12) returned to PacPacBum
PacPacBum collected €12 from pot
PacPacBum: doesn't show hand 
*** SUMMARY ***
Total pot €12 | Rake €0 
Seat 6: drissmouzou (small blind) folded before Flop
Seat 7: PacPacBum (big blind) collected (€12)
Seat 8: Painkiller72 folded before Flop (didn't bet)
Seat 9: matiko09 (button) folded before Flop (didn't bet)





PokerStars Hand #152886078928:  Hold'em No Limit ($0.50/$1.00 USD) - 2016/05/05 16:35:52 CET [2016/05/05 10:35:52 ET]
Table 'Kraz II' 9-max Seat #8 is the button
Seat 1: KovIFish89 ($137.23 in chips) 
Seat 2: sanpidk ($149.33 in chips) 
Seat 3: Khaine_CM ($101.50 in chips) 
Seat 4: LRVAV7 ($134.63 in chips) 
Seat 5: Kukuryzka ($100 in chips) 
Seat 6: andy84lfc ($235.73 in chips) 
Seat 7: Dantist1122 ($125.15 in chips) 
Seat 8: Hayer ana ($100 in chips) 
Seat 9: matiko09 ($177.82 in chips) 
matiko09: posts small blind $0.50
KovIFish89: posts big blind $1
*** HOLE CARDS ***
Dealt to matiko09 [Tc 2d]
sanpidk: raises $2 to $3
Khaine_CM: folds 
LRVAV7: folds 
Kukuryzka: folds 
andy84lfc: folds 
Dantist1122: folds 
Hayer ana: folds 
matiko09: folds 
KovIFish89: folds 
Uncalled bet ($2) returned to sanpidk
sanpidk collected $2.50 from pot
sanpidk: doesn't show hand 
*** SUMMARY ***
Total pot $2.50 | Rake $0 
Seat 1: KovIFish89 (big blind) folded before Flop
Seat 2: sanpidk collected ($2.50)
Seat 3: Khaine_CM folded before Flop (didn't bet)
Seat 4: LRVAV7 folded before Flop (didn't bet)
Seat 5: Kukuryzka folded before Flop (didn't bet)
Seat 6: andy84lfc folded before Flop (didn't bet)
Seat 7: Dantist1122 folded before Flop (didn't bet)
Seat 8: Hayer ana (button) folded before Flop (didn't bet)
Seat 9: matiko09 (small blind) folded before Flop





PokerStars Hand #152886079440:  Hold'em No Limit ($0.50/$1.00 USD) - 2016/05/05 16:35:53 CET [2016/05/05 10:35:53 ET]
Table 'Porzia' 9-max Seat #4 is the button
Seat 1: vrnMike ($159.50 in chips) 
Seat 2: matiko09 ($103.50 in chips) 
Seat 3: sanpidk ($114.82 in chips) 
Seat 4: Khaine_CM ($101 in chips) 
Seat 6: janarr5 ($112.47 in chips) 
Seat 8: PRINCE JULIO ($91.84 in chips) 
Seat 9: kl4ssic ($49.50 in chips) 
janarr5: posts small blind $0.50
gabi_igna: is sitting out 
PRINCE JULIO: posts big blind $1
*** HOLE CARDS ***
Dealt to matiko09 [4h 6s]
gabi_igna leaves the table
kl4ssic: folds 
vrnMike: folds 
HITYESCA joins the table at seat #7 
E_Sandnes was removed from the table for failing to post
matiko09: folds 
sanpidk: folds 
Khaine_CM: folds 
janarr5: raises $2 to $3
CZECHMYSAK joins the table at seat #5 
PRINCE JULIO: calls $2
*** FLOP *** [Tc Ts Ah]
janarr5: bets $2.45
PRINCE JULIO: calls $2.45
*** TURN *** [Tc Ts Ah] [Qh]
janarr5: bets $8
PRINCE JULIO: calls $8
*** RIVER *** [Tc Ts Ah Qh] [8s]
janarr5: bets $18
PRINCE JULIO: calls $18
*** SHOW DOWN ***
janarr5: shows [Js Ks] (a straight, Ten to Ace)
PRINCE JULIO: mucks hand 
janarr5 collected $60.40 from pot
*** SUMMARY ***
Total pot $62.90 | Rake $2.50 
Board [Tc Ts Ah Qh 8s]
Seat 1: vrnMike folded before Flop (didn't bet)
Seat 2: matiko09 folded before Flop (didn't bet)
Seat 3: sanpidk folded before Flop (didn't bet)
Seat 4: Khaine_CM (button) folded before Flop (didn't bet)
Seat 6: janarr5 (small blind) showed [Js Ks] and won ($60.40) with a straight, Ten to Ace
Seat 8: PRINCE JULIO (big blind) mucked [Ad 4d]
Seat 9: kl4ssic folded before Flop (didn't bet)





PokerStars Hand #152886080117:  Hold'em No Limit (€1/€2 EUR) - 2016/05/05 16:35:54 CET [2016/05/05 10:35:54 ET]
Table 'Bessel II' 9-max Seat #8 is the button
Seat 1: Soloaces224 (€133.39 in chips) 
Seat 3: PacPacBum (€220.94 in chips) 
Seat 4: Zorken76 (€141.82 in chips) 
Seat 5: Kukuryzka (€206.93 in chips) 
Seat 6: glanza_mike (€203 in chips) 
Seat 7: matiko09 (€200 in chips) 
Seat 8: chaps1988 (€241.72 in chips) 
Soloaces224: posts small blind €1
PacPacBum: posts big blind €2
*** HOLE CARDS ***
Dealt to matiko09 [4h 2c]
Zorken76: folds 
Kukuryzka: raises €4 to €6
glanza_mike: folds 
matiko09: folds 
chaps1988: calls €6
Soloaces224: calls €5
PacPacBum: calls €4
*** FLOP *** [Jc 6d 4s]
Soloaces224: checks 
PacPacBum: checks 
Kukuryzka: checks 
chaps1988: bets €12
Soloaces224: folds 
PacPacBum: folds 
Kukuryzka: folds 
Uncalled bet (€12) returned to chaps1988
chaps1988 collected €22.80 from pot
*** SUMMARY ***
Total pot €24 | Rake €1.20 
Board [Jc 6d 4s]
Seat 1: Soloaces224 (small blind) folded on the Flop
Seat 3: PacPacBum (big blind) folded on the Flop
Seat 4: Zorken76 folded before Flop (didn't bet)
Seat 5: Kukuryzka folded on the Flop
Seat 6: glanza_mike folded before Flop (didn't bet)
Seat 7: matiko09 folded before Flop (didn't bet)
Seat 8: chaps1988 (button) collected (€22.80)





PokerStars Hand #152886091535:  Hold'em No Limit (€1/€2 EUR) - 2016/05/05 16:36:13 CET [2016/05/05 10:36:13 ET]
Table 'Skat II' 9-max Seat #6 is the button
Seat 6: drissmouzou (€192.20 in chips) 
Seat 7: PacPacBum (€214.19 in chips) 
Seat 8: Painkiller72 (€204.97 in chips) 
Seat 9: matiko09 (€200 in chips) 
PacPacBum: posts small blind €1
Painkiller72: posts big blind €2
*** HOLE CARDS ***
Dealt to matiko09 [Qs Jh]
matiko09: raises €3 to €5
drissmouzou: calls €5
PacPacBum: folds 
Painkiller72: calls €3
*** FLOP *** [2s 8d 2c]
Painkiller72: checks 
matiko09: bets €9
drissmouzou: raises €9 to €18
Painkiller72: folds 
matiko09: folds 
Uncalled bet (€9) returned to drissmouzou
Kukuryzka joins the table at seat #1 
Kukuryzka leaves the table
drissmouzou collected €32.85 from pot
drissmouzou: doesn't show hand 
*** SUMMARY ***
Total pot €34 | Rake €1.15 
Board [2s 8d 2c]
Seat 6: drissmouzou (button) collected (€32.85)
Seat 7: PacPacBum (small blind) folded before Flop
Seat 8: Painkiller72 (big blind) folded on the Flop
Seat 9: matiko09 folded on the Flop





PokerStars Hand #152886101291:  Hold'em No Limit ($1/$2 USD) - 2016/05/05 16:36:30 CET [2016/05/05 10:36:30 ET]
Table 'Samitchell' 9-max Seat #3 is the button
Seat 1: KovIFish89 ($219.50 in chips) 
Seat 2: matiko09 ($287.71 in chips) 
Seat 3: gabi_igna ($399.11 in chips) 
Seat 5: chaps1988 ($275.12 in chips) 
Seat 6: PacPacBum ($200 in chips) 
Seat 7: patpaty ($158.04 in chips) 
Seat 9: kblkxls ($125.20 in chips) 
chaps1988: posts small blind $1
PacPacBum: posts big blind $2
*** HOLE CARDS ***
Dealt to matiko09 [Qc 9d]
patpaty: folds 
kblkxls: folds 
KovIFish89: raises $4 to $6
matiko09: folds 
gabi_igna: folds 
chaps1988: folds 
PacPacBum: folds 
Uncalled bet ($4) returned to KovIFish89
KovIFish89 collected $5 from pot
KovIFish89: doesn't show hand 
*** SUMMARY ***
Total pot $5 | Rake $0 
Seat 1: KovIFish89 collected ($5)
Seat 2: matiko09 folded before Flop (didn't bet)
Seat 3: gabi_igna (button) folded before Flop (didn't bet)
Seat 5: chaps1988 (small blind) folded before Flop
Seat 6: PacPacBum (big blind) folded before Flop
Seat 7: patpaty folded before Flop (didn't bet)
Seat 9: kblkxls folded before Flop (didn't bet)





PokerStars Hand #152886104883:  Hold'em No Limit ($1/$2 USD) - 2016/05/05 16:36:36 CET [2016/05/05 10:36:36 ET]
Table 'Lundia' 9-max Seat #5 is the button
Seat 1: Fitzyferret ($210.70 in chips) 
Seat 2: patpaty ($289.27 in chips) 
Seat 3: Painkiller72 ($278.04 in chips) 
Seat 4: KovIFish89 ($322.91 in chips) 
Seat 5: zmOe84 ($141.29 in chips) 
Seat 6: CI58 ($249.78 in chips) 
Seat 7: matiko09 ($225.11 in chips) 
Seat 8: chaps1988 ($200 in chips) 
Seat 9: gabi_igna ($257.47 in chips) 
CI58: posts small blind $1
matiko09: posts big blind $2
*** HOLE CARDS ***
Dealt to matiko09 [5d 4d]
chaps1988: folds 
gabi_igna: raises $4 to $6
Fitzyferret: folds 
patpaty: folds 
Painkiller72: folds 
KovIFish89: folds 
zmOe84: folds 
CI58: folds 
KovIFish89 leaves the table
Kukuryzka joins the table at seat #4 
matiko09: folds 
Uncalled bet ($4) returned to gabi_igna
Kukuryzka leaves the table
gabi_igna collected $5 from pot
gabi_igna: doesn't show hand 
*** SUMMARY ***
Total pot $5 | Rake $0 
Seat 1: Fitzyferret folded before Flop (didn't bet)
Seat 2: patpaty folded before Flop (didn't bet)
Seat 3: Painkiller72 folded before Flop (didn't bet)
Seat 4: KovIFish89 folded before Flop (didn't bet)
Seat 5: zmOe84 (button) folded before Flop (didn't bet)
Seat 6: CI58 (small blind) folded before Flop
Seat 7: matiko09 (big blind) folded before Flop
Seat 8: chaps1988 folded before Flop (didn't bet)
Seat 9: gabi_igna collected ($5)





PokerStars Hand #152886105802:  Hold'em No Limit ($1/$2 USD) - 2016/05/05 16:36:37 CET [2016/05/05 10:36:37 ET]
Table 'Tatry II' 9-max Seat #3 is the button
Seat 1: glanza_mike ($237.87 in chips) 
Seat 2: T0ny Adams ($67.74 in chips) 
Seat 3: matiko09 ($206.28 in chips) 
Seat 4: PacPacBum ($207.57 in chips) 
Seat 5: Painkiller72 ($330.05 in chips) 
Seat 6: Kukuryzka ($279.60 in chips) 
Seat 7: gabi_igna ($203 in chips) 
Seat 8: chaps1988 ($251.62 in chips) 
Seat 9: korol702 ($136.64 in chips) 
PacPacBum: posts small blind $1
Painkiller72: posts big blind $2
*** HOLE CARDS ***
Dealt to matiko09 [6d Qh]
Kukuryzka: folds 
gabi_igna: folds 
chaps1988: raises $4 to $6
korol702: folds 
glanza_mike: folds 
T0ny Adams: folds 
matiko09: folds 
PacPacBum: folds 
Painkiller72: folds 
Uncalled bet ($4) returned to chaps1988
chaps1988 collected $5 from pot
*** SUMMARY ***
Total pot $5 | Rake $0 
Seat 1: glanza_mike folded before Flop (didn't bet)
Seat 2: T0ny Adams folded before Flop (didn't bet)
Seat 3: matiko09 (button) folded before Flop (didn't bet)
Seat 4: PacPacBum (small blind) folded before Flop
Seat 5: Painkiller72 (big blind) folded before Flop
Seat 6: Kukuryzka folded before Flop (didn't bet)
Seat 7: gabi_igna folded before Flop (didn't bet)
Seat 8: chaps1988 collected ($5)
Seat 9: korol702 folded before Flop (didn't bet)





PokerStars Hand #152886111328:  Hold'em No Limit (€1/€2 EUR) - 2016/05/05 16:36:46 CET [2016/05/05 10:36:46 ET]
Table 'Skat II' 9-max Seat #7 is the button
Seat 6: drissmouzou (€211.05 in chips) 
Seat 7: PacPacBum (€213.19 in chips) 
Seat 8: Painkiller72 (€200 in chips) 
Seat 9: matiko09 (€200 in chips) 
Painkiller72: posts small blind €1
matiko09: posts big blind €2
*** HOLE CARDS ***
Dealt to matiko09 [5c 3d]
drissmouzou: folds 
PacPacBum: folds 
Painkiller72: folds 
Uncalled bet (€1) returned to matiko09
matiko09 collected €2 from pot
matiko09: doesn't show hand 
*** SUMMARY ***
Total pot €2 | Rake €0 
Seat 6: drissmouzou folded before Flop (didn't bet)
Seat 7: PacPacBum (button) folded before Flop (didn't bet)
Seat 8: Painkiller72 (small blind) folded before Flop
Seat 9: matiko09 (big blind) collected (€2)





PokerStars Hand #152886112547:  Hold'em No Limit ($0.50/$1.00 USD) - 2016/05/05 16:36:48 CET [2016/05/05 10:36:48 ET]
Table 'Vela' 9-max Seat #4 is the button
Seat 1: janarr5 ($100 in chips) 
Seat 2: kl4ssic ($64.12 in chips) 
Seat 3: dviryo ($472.54 in chips) 
Seat 4: Hayer ana ($209.28 in chips) 
Seat 5: sanpidk ($101.50 in chips) 
Seat 6: matiko09 ($100 in chips) 
Seat 7: KovIFish89 ($129.38 in chips) 
Seat 8: vrnMike ($106 in chips) 
Seat 9: Dickyxxx ($225.66 in chips) 
sanpidk: posts small blind $0.50
matiko09: posts big blind $1
*** HOLE CARDS ***
Dealt to matiko09 [2d Ts]
KovIFish89: folds 
vrnMike: folds 
Dickyxxx: folds 
janarr5: folds 
kl4ssic: folds 
dviryo: folds 
Hayer ana: raises $1.50 to $2.50
sanpidk: folds 
matiko09: folds 
Uncalled bet ($1.50) returned to Hayer ana
KovIFish89 leaves the table
Hayer ana collected $2.50 from pot
Hayer ana: doesn't show hand 
*** SUMMARY ***
Total pot $2.50 | Rake $0 
Seat 1: janarr5 folded before Flop (didn't bet)
Seat 2: kl4ssic folded before Flop (didn't bet)
Seat 3: dviryo folded before Flop (didn't bet)
Seat 4: Hayer ana (button) collected ($2.50)
Seat 5: sanpidk (small blind) folded before Flop
Seat 6: matiko09 (big blind) folded before Flop
Seat 7: KovIFish89 folded before Flop (didn't bet)
Seat 8: vrnMike folded before Flop (didn't bet)
Seat 9: Dickyxxx folded before Flop (didn't bet)





PokerStars Hand #152886114305:  Hold'em No Limit ($0.50/$1.00 USD) - 2016/05/05 16:36:51 CET [2016/05/05 10:36:51 ET]
Table 'Kraz II' 9-max Seat #9 is the button
Seat 1: KovIFish89 ($136.23 in chips) 
Seat 2: sanpidk ($150.83 in chips) 
Seat 3: Khaine_CM ($101.50 in chips) 
Seat 4: LRVAV7 ($134.63 in chips) 
Seat 5: Kukuryzka ($100 in chips) 
Seat 6: andy84lfc ($235.73 in chips) 
Seat 7: Dantist1122 ($125.15 in chips) 
Seat 8: Hayer ana ($100 in chips) 
Seat 9: matiko09 ($177.32 in chips) 
KovIFish89: posts small blind $0.50
sanpidk: posts big blind $1
*** HOLE CARDS ***
Dealt to matiko09 [Jh Td]
Khaine_CM: folds 
LRVAV7: folds 
Kukuryzka: folds 
andy84lfc: folds 
Dantist1122: folds 
Hayer ana: raises $1.50 to $2.50
matiko09: folds 
KovIFish89: folds 
sanpidk: folds 
Uncalled bet ($1.50) returned to Hayer ana
Hayer ana collected $2.50 from pot
Hayer ana: doesn't show hand 
*** SUMMARY ***
Total pot $2.50 | Rake $0 
Seat 1: KovIFish89 (small blind) folded before Flop
Seat 2: sanpidk (big blind) folded before Flop
Seat 3: Khaine_CM folded before Flop (didn't bet)
Seat 4: LRVAV7 folded before Flop (didn't bet)
Seat 5: Kukuryzka folded before Flop (didn't bet)
Seat 6: andy84lfc folded before Flop (didn't bet)
Seat 7: Dantist1122 folded before Flop (didn't bet)
Seat 8: Hayer ana collected ($2.50)
Seat 9: matiko09 (button) folded before Flop (didn't bet)





PokerStars Hand #152886116370:  Hold'em No Limit ($0.50/$1.00 USD) - 2016/05/05 16:36:55 CET [2016/05/05 10:36:55 ET]
Table 'Porzia' 9-max Seat #6 is the button
Seat 1: vrnMike ($159.50 in chips) 
Seat 2: matiko09 ($103.50 in chips) 
Seat 3: sanpidk ($114.82 in chips) 
Seat 4: Khaine_CM ($101 in chips) 
Seat 5: CZECHMYSAK ($40 in chips) 
Seat 6: janarr5 ($141.42 in chips) 
Seat 8: PRINCE JULIO ($60.39 in chips) 
Seat 9: kl4ssic ($49.50 in chips) 
HITYESCA will be allowed to play after the button
PRINCE JULIO: posts small blind $0.50
kl4ssic: posts big blind $1
CZECHMYSAK: posts big blind $1
*** HOLE CARDS ***
Dealt to matiko09 [6d Jc]
vrnMike: folds 
matiko09: folds 
sanpidk: raises $3.50 to $4.50
Khaine_CM: folds 
CZECHMYSAK: folds 
janarr5: folds 
PRINCE JULIO: calls $4
kl4ssic: folds 
*** FLOP *** [2s 3d 9s]
PRINCE JULIO: checks 
sanpidk: bets $5.50
PRINCE JULIO: calls $5.50
*** TURN *** [2s 3d 9s] [Ah]
PRINCE JULIO: checks 
sanpidk: checks 
*** RIVER *** [2s 3d 9s Ah] [Ks]
PRINCE JULIO: bets $11
sanpidk: calls $11
*** SHOW DOWN ***
PRINCE JULIO: shows [2h 2d] (three of a kind, Deuces)
sanpidk: mucks hand 
PRINCE JULIO collected $41.80 from pot
*** SUMMARY ***
Total pot $44 | Rake $2.20 
Board [2s 3d 9s Ah Ks]
Seat 1: vrnMike folded before Flop (didn't bet)
Seat 2: matiko09 folded before Flop (didn't bet)
Seat 3: sanpidk mucked [7c Ac]
Seat 4: Khaine_CM folded before Flop (didn't bet)
Seat 5: CZECHMYSAK folded before Flop
Seat 6: janarr5 (button) folded before Flop (didn't bet)
Seat 8: PRINCE JULIO (small blind) showed [2h 2d] and won ($41.80) with three of a kind, Deuces
Seat 9: kl4ssic (big blind) folded before Flop





PokerStars Hand #152886122225:  Hold'em No Limit ($1/$2 USD) - 2016/05/05 16:37:04 CET [2016/05/05 10:37:04 ET]
Table 'Tatry II' 9-max Seat #4 is the button
Seat 1: glanza_mike ($237.87 in chips) 
Seat 2: T0ny Adams ($67.74 in chips) 
Seat 3: matiko09 ($206.28 in chips) 
Seat 4: PacPacBum ($206.57 in chips) 
Seat 5: Painkiller72 ($328.05 in chips) 
Seat 6: Kukuryzka ($279.60 in chips) 
Seat 7: gabi_igna ($203 in chips) 
Seat 8: chaps1988 ($254.62 in chips) 
Seat 9: korol702 ($136.64 in chips) 
Painkiller72: posts small blind $1
Kukuryzka: posts big blind $2
*** HOLE CARDS ***
Dealt to matiko09 [9h 2s]
gabi_igna: folds 
chaps1988: folds 
korol702: calls $2
glanza_mike: folds 
T0ny Adams: folds 
matiko09: folds 
PacPacBum: folds 
Painkiller72: folds 
Kukuryzka: checks 
*** FLOP *** [7s 2h 6d]
Kukuryzka: checks 
korol702: checks 
*** TURN *** [7s 2h 6d] [Jc]
Kukuryzka: checks 
korol702: checks 
*** RIVER *** [7s 2h 6d Jc] [2c]
Kukuryzka: checks 
korol702: checks 
*** SHOW DOWN ***
Kukuryzka: shows [5d 3s] (a pair of Deuces)
korol702: shows [5s 9s] (a pair of Deuces - Jack+Nine kicker)
korol702 collected $4.75 from pot
*** SUMMARY ***
Total pot $5 | Rake $0.25 
Board [7s 2h 6d Jc 2c]
Seat 1: glanza_mike folded before Flop (didn't bet)
Seat 2: T0ny Adams folded before Flop (didn't bet)
Seat 3: matiko09 folded before Flop (didn't bet)
Seat 4: PacPacBum (button) folded before Flop (didn't bet)
Seat 5: Painkiller72 (small blind) folded before Flop
Seat 6: Kukuryzka (big blind) showed [5d 3s] and lost with a pair of Deuces
Seat 7: gabi_igna folded before Flop (didn't bet)
Seat 8: chaps1988 folded before Flop (didn't bet)
Seat 9: korol702 showed [5s 9s] and won ($4.75) with a pair of Deuces





PokerStars Hand #152886123118:  Hold'em No Limit ($0.50/$1.00 USD) - 2016/05/05 16:37:06 CET [2016/05/05 10:37:06 ET]
Table 'Vela' 9-max Seat #5 is the button
Seat 1: janarr5 ($100 in chips) 
Seat 2: kl4ssic ($64.12 in chips) 
Seat 3: dviryo ($472.54 in chips) 
Seat 4: Hayer ana ($210.78 in chips) 
Seat 5: sanpidk ($101 in chips) 
Seat 6: matiko09 ($100 in chips) 
Seat 8: vrnMike ($106 in chips) 
Seat 9: Dickyxxx ($225.66 in chips) 
matiko09: posts small blind $0.50
vrnMike: posts big blind $1
*** HOLE CARDS ***
Dealt to matiko09 [8h Kc]
Dickyxxx: folds 
janarr5: folds 
kl4ssic: folds 
dviryo: folds 
Hayer ana: folds 
spgreek joins the table at seat #7 
sanpidk: raises $1.24 to $2.24
matiko09: folds 
vrnMike: folds 
Uncalled bet ($1.24) returned to sanpidk
sanpidk collected $2.50 from pot
sanpidk: doesn't show hand 
*** SUMMARY ***
Total pot $2.50 | Rake $0 
Seat 1: janarr5 folded before Flop (didn't bet)
Seat 2: kl4ssic folded before Flop (didn't bet)
Seat 3: dviryo folded before Flop (didn't bet)
Seat 4: Hayer ana folded before Flop (didn't bet)
Seat 5: sanpidk (button) collected ($2.50)
Seat 6: matiko09 (small blind) folded before Flop
Seat 8: vrnMike (big blind) folded before Flop
Seat 9: Dickyxxx folded before Flop (didn't bet)





PokerStars Hand #152886124486:  Hold'em No Limit ($1/$2 USD) - 2016/05/05 16:37:08 CET [2016/05/05 10:37:08 ET]
Table 'Samitchell' 9-max Seat #5 is the button
Seat 1: KovIFish89 ($222.50 in chips) 
Seat 2: matiko09 ($287.71 in chips) 
Seat 3: gabi_igna ($399.11 in chips) 
Seat 5: chaps1988 ($274.12 in chips) 
Seat 6: PacPacBum ($200 in chips) 
Seat 7: patpaty ($158.04 in chips) 
Seat 9: kblkxls ($125.20 in chips) 
PacPacBum: posts small blind $1
patpaty: posts big blind $2
*** HOLE CARDS ***
Dealt to matiko09 [9d 4s]
kblkxls: folds 
KovIFish89: raises $4 to $6
matiko09: folds 
gabi_igna: folds 
chaps1988: folds 
PacPacBum: folds 
patpaty: calls $4
*** FLOP *** [9c 8h 2c]
patpaty: checks 
KovIFish89: checks 
*** TURN *** [9c 8h 2c] [Ad]
patpaty: bets $10
KovIFish89: calls $10
*** RIVER *** [9c 8h 2c Ad] [6s]
patpaty: bets $34
KovIFish89: folds 
Uncalled bet ($34) returned to patpaty
patpaty collected $31.35 from pot
patpaty: doesn't show hand 
*** SUMMARY ***
Total pot $33 | Rake $1.65 
Board [9c 8h 2c Ad 6s]
Seat 1: KovIFish89 folded on the River
Seat 2: matiko09 folded before Flop (didn't bet)
Seat 3: gabi_igna folded before Flop (didn't bet)
Seat 5: chaps1988 (button) folded before Flop (didn't bet)
Seat 6: PacPacBum (small blind) folded before Flop
Seat 7: patpaty (big blind) collected ($31.35)
Seat 9: kblkxls folded before Flop (didn't bet)





PokerStars Hand #152886124746:  Hold'em No Limit (€1/€2 EUR) - 2016/05/05 16:37:09 CET [2016/05/05 10:37:09 ET]
Table 'Skat II' 9-max Seat #8 is the button
Seat 6: drissmouzou (€211.05 in chips) 
Seat 7: PacPacBum (€213.19 in chips) 
Seat 8: Painkiller72 (€200 in chips) 
Seat 9: matiko09 (€201 in chips) 
matiko09: posts small blind €1
drissmouzou: posts big blind €2
*** HOLE CARDS ***
Dealt to matiko09 [9s 7d]
PacPacBum: raises €3 to €5
Painkiller72: calls €5
matiko09: folds 
drissmouzou: raises €16 to €21
PacPacBum: folds 
Painkiller72: calls €16
*** FLOP *** [As 9h 2h]
drissmouzou: bets €23.42
Painkiller72: folds 
Uncalled bet (€23.42) returned to drissmouzou
drissmouzou collected €46.85 from pot
drissmouzou: doesn't show hand 
*** SUMMARY ***
Total pot €48 | Rake €1.15 
Board [As 9h 2h]
Seat 6: drissmouzou (big blind) collected (€46.85)
Seat 7: PacPacBum folded before Flop
Seat 8: Painkiller72 (button) folded on the Flop
Seat 9: matiko09 (small blind) folded before Flop





PokerStars Hand #152886125940:  Hold'em No Limit ($1/$2 USD) - 2016/05/05 16:37:10 CET [2016/05/05 10:37:10 ET]
Table 'Euporie II' 9-max Seat #9 is the button
Seat 2: kblkxls ($113.10 in chips) 
Seat 3: chaps1988 ($239.25 in chips) 
Seat 5: Nuskatko1986 ($63.52 in chips) 
Seat 6: Kukuryzka ($200 in chips) 
Seat 7: matiko09 ($200.74 in chips) 
Seat 8: Painkiller72 ($294.25 in chips) 
Seat 9: T0ny Adams ($73.23 in chips) 
PacPacBum will be allowed to play after the button
kblkxls: posts small blind $1
chaps1988: posts big blind $2
*** HOLE CARDS ***
Dealt to matiko09 [Jh Qd]
Nuskatko1986 has timed out
Nuskatko1986: folds 
Kukuryzka: folds 
matiko09: folds 
Painkiller72: folds 
T0ny Adams: raises $2.28 to $4.28
kblkxls: calls $3.28
chaps1988: folds 
*** FLOP *** [5s 8s 2c]
kblkxls: bets $7
T0ny Adams: raises $13 to $20
kblkxls: calls $13
*** TURN *** [5s 8s 2c] [4h]
kblkxls: checks 
T0ny Adams: bets $26
kblkxls: folds [8d]
Uncalled bet ($26) returned to T0ny Adams
T0ny Adams collected $48.03 from pot
T0ny Adams: doesn't show hand 
*** SUMMARY ***
Total pot $50.56 | Rake $2.53 
Board [5s 8s 2c 4h]
Seat 2: kblkxls (small blind) folded on the Turn
Seat 3: chaps1988 (big blind) folded before Flop
Seat 5: Nuskatko1986 folded before Flop (didn't bet)
Seat 6: Kukuryzka folded before Flop (didn't bet)
Seat 7: matiko09 folded before Flop (didn't bet)
Seat 8: Painkiller72 folded before Flop (didn't bet)
Seat 9: T0ny Adams (button) collected ($48.03)





PokerStars Hand #152886126346:  Hold'em No Limit ($0.50/$1.00 USD) - 2016/05/05 16:37:11 CET [2016/05/05 10:37:11 ET]
Table 'Amphitrite II' 9-max Seat #2 is the button
Seat 1: HITYESCA ($100 in chips) 
Seat 2: barakuda6236 ($80.68 in chips) 
Seat 3: kossof ($67.67 in chips) 
Seat 6: matiko09 ($100 in chips) 
Seat 7: sanpidk ($115.87 in chips) 
Seat 9: Dickyxxx ($105 in chips) 
kossof: posts small blind $0.50
CI58: is sitting out 
gabi_igna: is sitting out 
matiko09: posts big blind $1
*** HOLE CARDS ***
Dealt to matiko09 [Td 9h]
gabi_igna leaves the table
sanpidk: folds 
Dickyxxx: raises $2 to $3
HITYESCA: folds 
barakuda6236: folds 
kossof: folds 
$-Twackle-$ joins the table at seat #5 
matiko09: folds 
Uncalled bet ($2) returned to Dickyxxx
Dickyxxx collected $2.50 from pot
Dickyxxx: doesn't show hand 
*** SUMMARY ***
Total pot $2.50 | Rake $0 
Seat 1: HITYESCA folded before Flop (didn't bet)
Seat 2: barakuda6236 (button) folded before Flop (didn't bet)
Seat 3: kossof (small blind) folded before Flop
Seat 6: matiko09 (big blind) folded before Flop
Seat 7: sanpidk folded before Flop (didn't bet)
Seat 9: Dickyxxx collected ($2.50)





PokerStars Hand #152886127505:  Hold'em No Limit ($0.50/$1.00 USD) - 2016/05/05 16:37:13 CET [2016/05/05 10:37:13 ET]
Table 'Kraz II' 9-max Seat #1 is the button
Seat 1: KovIFish89 ($135.73 in chips) 
Seat 2: sanpidk ($149.83 in chips) 
Seat 3: Khaine_CM ($101.50 in chips) 
Seat 4: LRVAV7 ($134.63 in chips) 
Seat 5: Kukuryzka ($100 in chips) 
Seat 6: andy84lfc ($235.73 in chips) 
Seat 7: Dantist1122 ($125.15 in chips) 
Seat 8: Hayer ana ($101.50 in chips) 
Seat 9: matiko09 ($177.32 in chips) 
sanpidk: posts small blind $0.50
Khaine_CM: posts big blind $1
*** HOLE CARDS ***
Dealt to matiko09 [Th 6h]
LRVAV7: folds 
Kukuryzka: folds 
andy84lfc: folds 
Dantist1122: folds 
Hayer ana: folds 
matiko09: folds 
KovIFish89: folds 
KovIFish89 leaves the table
sanpidk: folds 
Uncalled bet ($0.50) returned to Khaine_CM
Khaine_CM collected $1 from pot
Khaine_CM: doesn't show hand 
*** SUMMARY ***
Total pot $1 | Rake $0 
Seat 1: KovIFish89 (button) folded before Flop (didn't bet)
Seat 2: sanpidk (small blind) folded before Flop
Seat 3: Khaine_CM (big blind) collected ($1)
Seat 4: LRVAV7 folded before Flop (didn't bet)
Seat 5: Kukuryzka folded before Flop (didn't bet)
Seat 6: andy84lfc folded before Flop (didn't bet)
Seat 7: Dantist1122 folded before Flop (didn't bet)
Seat 8: Hayer ana folded before Flop (didn't bet)
Seat 9: matiko09 folded before Flop (didn't bet)





PokerStars Hand #152886129310:  Hold'em No Limit ($1/$2 USD) - 2016/05/05 16:37:16 CET [2016/05/05 10:37:16 ET]
Table 'Lundia' 9-max Seat #6 is the button
Seat 1: Fitzyferret ($210.70 in chips) 
Seat 2: patpaty ($289.27 in chips) 
Seat 3: Painkiller72 ($278.04 in chips) 
Seat 5: zmOe84 ($141.29 in chips) 
Seat 6: CI58 ($248.78 in chips) 
Seat 7: matiko09 ($223.11 in chips) 
Seat 8: chaps1988 ($200 in chips) 
Seat 9: gabi_igna ($260.47 in chips) 
matiko09: posts small blind $1
chaps1988: posts big blind $2
*** HOLE CARDS ***
Dealt to matiko09 [9s Jh]
gabi_igna: folds 
Fitzyferret: folds 
patpaty: folds 
Painkiller72: raises $3 to $5
PacPacBum joins the table at seat #4 
zmOe84: folds 
CI58: folds 
matiko09: folds 
chaps1988: calls $3
*** FLOP *** [4d 2s 6d]
chaps1988: checks 
Painkiller72: bets $7.31
chaps1988: calls $7.31
*** TURN *** [4d 2s 6d] [8c]
chaps1988: checks 
Painkiller72: bets $17.03
chaps1988: calls $17.03
*** RIVER *** [4d 2s 6d 8c] [5h]
chaps1988: bets $45
Painkiller72: folds 
Uncalled bet ($45) returned to chaps1988
chaps1988 collected $56.93 from pot
*** SUMMARY ***
Total pot $59.68 | Rake $2.75 
Board [4d 2s 6d 8c 5h]
Seat 1: Fitzyferret folded before Flop (didn't bet)
Seat 2: patpaty folded before Flop (didn't bet)
Seat 3: Painkiller72 folded on the River
Seat 5: zmOe84 folded before Flop (didn't bet)
Seat 6: CI58 (button) folded before Flop (didn't bet)
Seat 7: matiko09 (small blind) folded before Flop
Seat 8: chaps1988 (big blind) collected ($56.93)
Seat 9: gabi_igna folded before Flop (didn't bet)





PokerStars Hand #152886130492:  Hold'em No Limit ($1/$2 USD) - 2016/05/05 16:37:18 CET [2016/05/05 10:37:18 ET]
Table 'Tololo' 9-max Seat #5 is the button
Seat 1: Kukuryzka ($245.04 in chips) 
Seat 2: gabi_igna ($243.15 in chips) 
Seat 3: Khaine_CM ($200 in chips) 
Seat 4: mooose100 ($144.26 in chips) 
Seat 5: matiko09 ($200 in chips) 
Seat 6: Xagua ($154.70 in chips) 
Seat 7: chaps1988 ($284.42 in chips) 
Xagua: posts small blind $1
chaps1988: posts big blind $2
myatiy 96: sits out 
*** HOLE CARDS ***
Dealt to matiko09 [9s 5s]
Kukuryzka: folds 
gabi_igna: raises $4 to $6
Khaine_CM: folds 
mooose100: calls $6
matiko09: folds 
Xagua: folds 
chaps1988: folds 
*** FLOP *** [8h 6d Jh]
gabi_igna: checks 
mooose100: bets $7.12
gabi_igna: calls $7.12
*** TURN *** [8h 6d Jh] [9d]
gabi_igna: checks 
mooose100: checks 
*** RIVER *** [8h 6d Jh 9d] [2c]
gabi_igna: checks 
mooose100: checks 
*** SHOW DOWN ***
gabi_igna: shows [7s 7h] (a pair of Sevens)
mooose100: shows [Td 8d] (a pair of Eights)
mooose100 collected $27.78 from pot
*** SUMMARY ***
Total pot $29.24 | Rake $1.46 
Board [8h 6d Jh 9d 2c]
Seat 1: Kukuryzka folded before Flop (didn't bet)
Seat 2: gabi_igna showed [7s 7h] and lost with a pair of Sevens
Seat 3: Khaine_CM folded before Flop (didn't bet)
Seat 4: mooose100 showed [Td 8d] and won ($27.78) with a pair of Eights
Seat 5: matiko09 (button) folded before Flop (didn't bet)
Seat 6: Xagua (small blind) folded before Flop
Seat 7: chaps1988 (big blind) folded before Flop





PokerStars Hand #152886137394:  Hold'em No Limit (€1/€2 EUR) - 2016/05/05 16:37:30 CET [2016/05/05 10:37:30 ET]
Table 'Bessel II' 9-max Seat #1 is the button
Seat 1: Soloaces224 (€127.39 in chips) 
Seat 3: PacPacBum (€214.94 in chips) 
Seat 4: Zorken76 (€141.82 in chips) 
Seat 5: Kukuryzka (€200.93 in chips) 
Seat 6: glanza_mike (€203 in chips) 
Seat 7: matiko09 (€200 in chips) 
Seat 8: chaps1988 (€258.52 in chips) 
PacPacBum: posts small blind €1
Zorken76: posts big blind €2
*** HOLE CARDS ***
Dealt to matiko09 [5h 3s]
Kukuryzka: folds 
glanza_mike: folds 
matiko09: folds 
chaps1988: folds 
Soloaces224: raises €4 to €6
PacPacBum: folds 
Zorken76: calls €4
*** FLOP *** [Th Ac 2d]
Zorken76: checks 
Soloaces224: checks 
*** TURN *** [Th Ac 2d] [Js]
Zorken76: bets €6
Soloaces224: calls €6
*** RIVER *** [Th Ac 2d Js] [Qh]
Zorken76: checks 
Soloaces224: checks 
*** SHOW DOWN ***
Zorken76: shows [Jc As] (two pair, Aces and Jacks)
Soloaces224: mucks hand 
Zorken76 collected €23.75 from pot
*** SUMMARY ***
Total pot €25 | Rake €1.25 
Board [Th Ac 2d Js Qh]
Seat 1: Soloaces224 (button) mucked [Qd 9d]
Seat 3: PacPacBum (small blind) folded before Flop
Seat 4: Zorken76 (big blind) showed [Jc As] and won (€23.75) with two pair, Aces and Jacks
Seat 5: Kukuryzka folded before Flop (didn't bet)
Seat 6: glanza_mike folded before Flop (didn't bet)
Seat 7: matiko09 folded before Flop (didn't bet)
Seat 8: chaps1988 folded before Flop (didn't bet)





PokerStars Hand #152886141670:  Hold'em No Limit ($0.50/$1.00 USD) - 2016/05/05 16:37:37 CET [2016/05/05 10:37:37 ET]
Table 'Vela' 9-max Seat #6 is the button
Seat 1: janarr5 ($100 in chips) 
Seat 2: kl4ssic ($64.12 in chips) 
Seat 3: dviryo ($472.54 in chips) 
Seat 4: Hayer ana ($210.78 in chips) 
Seat 5: sanpidk ($102.50 in chips) 
Seat 6: matiko09 ($100 in chips) 
Seat 8: vrnMike ($105 in chips) 
Seat 9: Dickyxxx ($225.66 in chips) 
spgreek will be allowed to play after the button
vrnMike: posts small blind $0.50
Dickyxxx: posts big blind $1
*** HOLE CARDS ***
Dealt to matiko09 [6s 3d]
janarr5: raises $2 to $3
kl4ssic: folds 
dviryo: folds 
Hayer ana: calls $3
sanpidk: folds 
matiko09: folds 
vrnMike: folds 
Dickyxxx: folds 
*** FLOP *** [Kc 9s 4c]
janarr5: checks 
Hayer ana: checks 
*** TURN *** [Kc 9s 4c] [6h]
janarr5: checks 
Hayer ana: bets $4.27
janarr5: folds 
Uncalled bet ($4.27) returned to Hayer ana
Hayer ana collected $7.12 from pot
Hayer ana: doesn't show hand 
*** SUMMARY ***
Total pot $7.50 | Rake $0.38 
Board [Kc 9s 4c 6h]
Seat 1: janarr5 folded on the Turn
Seat 2: kl4ssic folded before Flop (didn't bet)
Seat 3: dviryo folded before Flop (didn't bet)
Seat 4: Hayer ana collected ($7.12)
Seat 5: sanpidk folded before Flop (didn't bet)
Seat 6: matiko09 (button) folded before Flop (didn't bet)
Seat 8: vrnMike (small blind) folded before Flop
Seat 9: Dickyxxx (big blind) folded before Flop





PokerStars Hand #152886143299:  Hold'em No Limit ($0.50/$1.00 USD) - 2016/05/05 16:37:39 CET [2016/05/05 10:37:39 ET]
Table 'Kraz II' 9-max Seat #2 is the button
Seat 2: sanpidk ($149.33 in chips) 
Seat 3: Khaine_CM ($102 in chips) 
Seat 4: LRVAV7 ($134.63 in chips) 
Seat 5: Kukuryzka ($100 in chips) 
Seat 6: andy84lfc ($235.73 in chips) 
Seat 7: Dantist1122 ($125.15 in chips) 
Seat 8: Hayer ana ($101.50 in chips) 
Seat 9: matiko09 ($177.32 in chips) 
Khaine_CM: posts small blind $0.50
HITYESCA joins the table at seat #1 
LRVAV7: posts big blind $1
*** HOLE CARDS ***
Dealt to matiko09 [7d 5s]
Kukuryzka: folds 
andy84lfc: folds 
Dantist1122: folds 
Hayer ana: folds 
matiko09: folds 
sanpidk: raises $1.24 to $2.24
Khaine_CM: calls $1.74
LRVAV7: calls $1.24
*** FLOP *** [5d 6h 7s]
Khaine_CM: checks 
LRVAV7: checks 
sanpidk: checks 
*** TURN *** [5d 6h 7s] [7c]
Khaine_CM: checks 
LRVAV7: bets $6.38
sanpidk: folds 
Khaine_CM: folds 
Uncalled bet ($6.38) returned to LRVAV7
LRVAV7 collected $6.38 from pot
LRVAV7: doesn't show hand 
*** SUMMARY ***
Total pot $6.72 | Rake $0.34 
Board [5d 6h 7s 7c]
Seat 2: sanpidk (button) folded on the Turn
Seat 3: Khaine_CM (small blind) folded on the Turn
Seat 4: LRVAV7 (big blind) collected ($6.38)
Seat 5: Kukuryzka folded before Flop (didn't bet)
Seat 6: andy84lfc folded before Flop (didn't bet)
Seat 7: Dantist1122 folded before Flop (didn't bet)
Seat 8: Hayer ana folded before Flop (didn't bet)
Seat 9: matiko09 folded before Flop (didn't bet)





PokerStars Hand #152886144247:  Hold'em No Limit ($0.50/$1.00 USD) - 2016/05/05 16:37:41 CET [2016/05/05 10:37:41 ET]
Table 'Amphitrite II' 9-max Seat #3 is the button
Seat 1: HITYESCA ($100 in chips) 
Seat 2: barakuda6236 ($80.68 in chips) 
Seat 3: kossof ($67.17 in chips) 
Seat 6: matiko09 ($100 in chips) 
Seat 7: sanpidk ($115.87 in chips) 
Seat 9: Dickyxxx ($106.50 in chips) 
matiko09: posts small blind $0.50
sanpidk: posts big blind $1
*** HOLE CARDS ***
Dealt to matiko09 [3c 8h]
Dickyxxx: raises $2 to $3
HITYESCA: folds 
barakuda6236: folds 
kossof: folds 
matiko09: folds 
Lanza606 joins the table at seat #8 
sanpidk: calls $2
*** FLOP *** [2c 4h 2s]
sanpidk: checks 
Dickyxxx: bets $4.11
sanpidk: folds 
Uncalled bet ($4.11) returned to Dickyxxx
Dickyxxx collected $6.18 from pot
Dickyxxx: doesn't show hand 
*** SUMMARY ***
Total pot $6.50 | Rake $0.32 
Board [2c 4h 2s]
Seat 1: HITYESCA folded before Flop (didn't bet)
Seat 2: barakuda6236 folded before Flop (didn't bet)
Seat 3: kossof (button) folded before Flop (didn't bet)
Seat 6: matiko09 (small blind) folded before Flop
Seat 7: sanpidk (big blind) folded on the Flop
Seat 9: Dickyxxx collected ($6.18)





PokerStars Hand #152886146537:  Hold'em No Limit (€1/€2 EUR) - 2016/05/05 16:37:45 CET [2016/05/05 10:37:45 ET]
Table 'Skat II' 9-max Seat #9 is the button
Seat 6: drissmouzou (€236.90 in chips) 
Seat 7: PacPacBum (€208.19 in chips) 
Seat 8: Painkiller72 (€200 in chips) 
Seat 9: matiko09 (€200 in chips) 
drissmouzou: posts small blind €1
PacPacBum: posts big blind €2
*** HOLE CARDS ***
Dealt to matiko09 [9h Kd]
Painkiller72: folds 
matiko09: raises €2.54 to €4.54
drissmouzou: folds 
PacPacBum: raises €11.46 to €16
matiko09: folds 
Uncalled bet (€11.46) returned to PacPacBum
PacPacBum collected €10.08 from pot
PacPacBum: doesn't show hand 
*** SUMMARY ***
Total pot €10.08 | Rake €0 
Seat 6: drissmouzou (small blind) folded before Flop
Seat 7: PacPacBum (big blind) collected (€10.08)
Seat 8: Painkiller72 folded before Flop (didn't bet)
Seat 9: matiko09 (button) folded before Flop





PokerStars Hand #152886148439:  Hold'em No Limit ($0.50/$1.00 USD) - 2016/05/05 16:37:48 CET [2016/05/05 10:37:48 ET]
Table 'Porzia' 9-max Seat #8 is the button
Seat 1: vrnMike ($159.50 in chips) 
Seat 2: matiko09 ($103.50 in chips) 
Seat 3: sanpidk ($100 in chips) 
Seat 4: Khaine_CM ($101 in chips) 
Seat 5: CZECHMYSAK ($39 in chips) 
Seat 6: janarr5 ($141.42 in chips) 
Seat 8: PRINCE JULIO ($81.19 in chips) 
Seat 9: kl4ssic ($48.50 in chips) 
kl4ssic: posts small blind $0.50
vrnMike: posts big blind $1
HITYESCA: sits out 
*** HOLE CARDS ***
Dealt to matiko09 [4d 3h]
matiko09: folds 
sanpidk: folds 
Khaine_CM: folds 
CZECHMYSAK: folds 
janarr5: folds 
PRINCE JULIO: folds 
kl4ssic: folds 
Uncalled bet ($0.50) returned to vrnMike
vrnMike collected $1 from pot
*** SUMMARY ***
Total pot $1 | Rake $0 
Seat 1: vrnMike (big blind) collected ($1)
Seat 2: matiko09 folded before Flop (didn't bet)
Seat 3: sanpidk folded before Flop (didn't bet)
Seat 4: Khaine_CM folded before Flop (didn't bet)
Seat 5: CZECHMYSAK folded before Flop (didn't bet)
Seat 6: janarr5 folded before Flop (didn't bet)
Seat 8: PRINCE JULIO (button) folded before Flop (didn't bet)
Seat 9: kl4ssic (small blind) folded before Flop





PokerStars Hand #152886158778:  Hold'em No Limit ($1/$2 USD) - 2016/05/05 16:38:05 CET [2016/05/05 10:38:05 ET]
Table 'Tatry II' 9-max Seat #5 is the button
Seat 1: glanza_mike ($237.87 in chips) 
Seat 2: T0ny Adams ($67.74 in chips) 
Seat 3: matiko09 ($206.28 in chips) 
Seat 4: PacPacBum ($206.57 in chips) 
Seat 5: Painkiller72 ($327.05 in chips) 
Seat 6: Kukuryzka ($277.60 in chips) 
Seat 8: chaps1988 ($254.62 in chips) 
Seat 9: korol702 ($139.39 in chips) 
Kukuryzka: posts small blind $1
gabi_igna: is sitting out 
chaps1988: posts big blind $2
*** HOLE CARDS ***
Dealt to matiko09 [6c Qs]
gabi_igna leaves the table
korol702: calls $2
glanza_mike: raises $5 to $7
T0ny Adams: folds 
matiko09: folds 
Fitzyferret joins the table at seat #7 
PacPacBum: folds 
Painkiller72: folds 
Kukuryzka: folds 
chaps1988: folds 
korol702: calls $5
*** FLOP *** [3h 4d Qh]
korol702: checks 
glanza_mike: bets $8.07
korol702: calls $8.07
*** TURN *** [3h 4d Qh] [6h]
korol702: checks 
glanza_mike: checks 
*** RIVER *** [3h 4d Qh 6h] [Jd]
korol702: bets $12
glanza_mike: folds 
Uncalled bet ($12) returned to korol702
korol702 collected $31.48 from pot
korol702: doesn't show hand 
*** SUMMARY ***
Total pot $33.14 | Rake $1.66 
Board [3h 4d Qh 6h Jd]
Seat 1: glanza_mike folded on the River
Seat 2: T0ny Adams folded before Flop (didn't bet)
Seat 3: matiko09 folded before Flop (didn't bet)
Seat 4: PacPacBum folded before Flop (didn't bet)
Seat 5: Painkiller72 (button) folded before Flop (didn't bet)
Seat 6: Kukuryzka (small blind) folded before Flop
Seat 8: chaps1988 (big blind) folded before Flop
Seat 9: korol702 collected ($31.48)





PokerStars Hand #152886163725:  Hold'em No Limit (€1/€2 EUR) - 2016/05/05 16:38:13 CET [2016/05/05 10:38:13 ET]
Table 'Skat II' 9-max Seat #6 is the button
Seat 6: drissmouzou (€235.90 in chips) 
Seat 7: PacPacBum (€213.73 in chips) 
Seat 8: Painkiller72 (€200 in chips) 
Seat 9: matiko09 (€200 in chips) 
PacPacBum: posts small blind €1
Painkiller72: posts big blind €2
*** HOLE CARDS ***
Dealt to matiko09 [3s Ah]
matiko09: folds 
drissmouzou: raises €2 to €4
PacPacBum: folds 
Painkiller72: calls €2
*** FLOP *** [As 7h Kh]
Painkiller72: checks 
drissmouzou: checks 
*** TURN *** [As 7h Kh] [Ts]
Painkiller72: checks 
drissmouzou: bets €2
JoaquinMRuiz joins the table at seat #4 
Painkiller72: calls €2
*** RIVER *** [As 7h Kh Ts] [9d]
Painkiller72: checks 
drissmouzou: checks 
*** SHOW DOWN ***
Painkiller72: shows [5h 2h] (high card Ace)
drissmouzou: shows [Jh Jc] (a pair of Jacks)
drissmouzou collected €12.35 from pot
*** SUMMARY ***
Total pot €13 | Rake €0.65 
Board [As 7h Kh Ts 9d]
Seat 6: drissmouzou (button) showed [Jh Jc] and won (€12.35) with a pair of Jacks
Seat 7: PacPacBum (small blind) folded before Flop
Seat 8: Painkiller72 (big blind) showed [5h 2h] and lost with high card Ace
Seat 9: matiko09 folded before Flop (didn't bet)





PokerStars Hand #152886163913:  Hold'em No Limit ($1/$2 USD) - 2016/05/05 16:38:14 CET [2016/05/05 10:38:14 ET]
Table 'Tololo' 9-max Seat #6 is the button
Seat 1: Kukuryzka ($245.04 in chips) 
Seat 2: gabi_igna ($230.03 in chips) 
Seat 3: Khaine_CM ($200 in chips) 
Seat 4: mooose100 ($158.92 in chips) 
Seat 5: matiko09 ($200 in chips) 
Seat 6: Xagua ($153.70 in chips) 
Seat 7: chaps1988 ($282.42 in chips) 
Seat 8: myatiy 96 ($200 in chips) 
chaps1988: posts small blind $1
myatiy 96: posts big blind $2
*** HOLE CARDS ***
Dealt to matiko09 [5c Jd]
Kukuryzka: raises $4 to $6
gabi_igna: raises $12 to $18
Khaine_CM: folds 
mooose100: folds 
matiko09: folds 
Xagua: folds 
chaps1988: folds 
myatiy 96: folds 
Kukuryzka: calls $12
*** FLOP *** [7d 9h Th]
Kukuryzka: checks 
gabi_igna: checks 
*** TURN *** [7d 9h Th] [9d]
Kukuryzka: bets $22
gabi_igna: folds 
Uncalled bet ($22) returned to Kukuryzka
Kukuryzka collected $37.05 from pot
Kukuryzka: doesn't show hand 
*** SUMMARY ***
Total pot $39 | Rake $1.95 
Board [7d 9h Th 9d]
Seat 1: Kukuryzka collected ($37.05)
Seat 2: gabi_igna folded on the Turn
Seat 3: Khaine_CM folded before Flop (didn't bet)
Seat 4: mooose100 folded before Flop (didn't bet)
Seat 5: matiko09 folded before Flop (didn't bet)
Seat 6: Xagua (button) folded before Flop (didn't bet)
Seat 7: chaps1988 (small blind) folded before Flop
Seat 8: myatiy 96 (big blind) folded before Flop





PokerStars Hand #152886163990:  Hold'em No Limit ($0.50/$1.00 USD) - 2016/05/05 16:38:14 CET [2016/05/05 10:38:14 ET]
Table 'Porzia' 9-max Seat #1 is the button
Seat 1: vrnMike ($160 in chips) 
Seat 2: matiko09 ($103.50 in chips) 
Seat 3: sanpidk ($100 in chips) 
Seat 4: Khaine_CM ($101 in chips) 
Seat 5: CZECHMYSAK ($39 in chips) 
Seat 6: janarr5 ($141.42 in chips) 
Seat 8: PRINCE JULIO ($81.19 in chips) 
matiko09: posts small blind $0.50
sanpidk: posts big blind $1
HITYESCA: sits out 
*** HOLE CARDS ***
Dealt to matiko09 [Qd 5c]
Khaine_CM: folds 
CZECHMYSAK: folds 
janarr5: raises $2 to $3
PRINCE JULIO: folds 
vrnMike: folds 
matiko09: folds 
sanpidk: folds 
Uncalled bet ($2) returned to janarr5
janarr5 collected $2.50 from pot
janarr5: doesn't show hand 
*** SUMMARY ***
Total pot $2.50 | Rake $0 
Seat 1: vrnMike (button) folded before Flop (didn't bet)
Seat 2: matiko09 (small blind) folded before Flop
Seat 3: sanpidk (big blind) folded before Flop
Seat 4: Khaine_CM folded before Flop (didn't bet)
Seat 5: CZECHMYSAK folded before Flop (didn't bet)
Seat 6: janarr5 collected ($2.50)
Seat 8: PRINCE JULIO folded before Flop (didn't bet)





PokerStars Hand #152886167187:  Hold'em No Limit (€1/€2 EUR) - 2016/05/05 16:38:19 CET [2016/05/05 10:38:19 ET]
Table 'Bessel II' 9-max Seat #3 is the button
Seat 1: Soloaces224 (€115.39 in chips) 
Seat 3: PacPacBum (€213.94 in chips) 
Seat 4: Zorken76 (€153.57 in chips) 
Seat 5: Kukuryzka (€200.93 in chips) 
Seat 6: glanza_mike (€203 in chips) 
Seat 7: matiko09 (€200 in chips) 
Seat 8: chaps1988 (€258.52 in chips) 
Zorken76: posts small blind €1
Kukuryzka: posts big blind €2
*** HOLE CARDS ***
Dealt to matiko09 [5s 7h]
glanza_mike: folds 
matiko09: folds 
JoaquinMRuiz joins the table at seat #9 
chaps1988: folds 
Soloaces224: folds 
PacPacBum: folds 
Zorken76: folds 
Uncalled bet (€1) returned to Kukuryzka
Kukuryzka collected €2 from pot
Kukuryzka: doesn't show hand 
*** SUMMARY ***
Total pot €2 | Rake €0 
Seat 1: Soloaces224 folded before Flop (didn't bet)
Seat 3: PacPacBum (button) folded before Flop (didn't bet)
Seat 4: Zorken76 (small blind) folded before Flop
Seat 5: Kukuryzka (big blind) collected (€2)
Seat 6: glanza_mike folded before Flop (didn't bet)
Seat 7: matiko09 folded before Flop (didn't bet)
Seat 8: chaps1988 folded before Flop (didn't bet)





PokerStars Hand #152886173552:  Hold'em No Limit ($1/$2 USD) - 2016/05/05 16:38:30 CET [2016/05/05 10:38:30 ET]
Table 'Lundia' 9-max Seat #7 is the button
Seat 2: patpaty ($289.27 in chips) 
Seat 3: Painkiller72 ($248.70 in chips) 
Seat 5: zmOe84 ($141.29 in chips) 
Seat 6: CI58 ($248.78 in chips) 
Seat 7: matiko09 ($222.11 in chips) 
Seat 8: chaps1988 ($227.59 in chips) 
chaps1988: posts small blind $1
gabi_igna: is sitting out 
Fitzyferret: is sitting out 
patpaty: posts big blind $2
PacPacBum: sits out 
*** HOLE CARDS ***
Dealt to matiko09 [Js Kd]
gabi_igna leaves the table
Painkiller72: folds 
zmOe84: folds 
CI58: folds 
matiko09: raises $2.54 to $4.54
chaps1988: folds 
tepi_guy joins the table at seat #9 
patpaty: calls $2.54
*** FLOP *** [8s Qc Ad]
patpaty: bets $2
matiko09: raises $8 to $10
patpaty: folds 
Uncalled bet ($8) returned to matiko09
matiko09 collected $13.38 from pot
matiko09: doesn't show hand 
*** SUMMARY ***
Total pot $14.08 | Rake $0.70 
Board [8s Qc Ad]
Seat 2: patpaty (big blind) folded on the Flop
Seat 3: Painkiller72 folded before Flop (didn't bet)
Seat 5: zmOe84 folded before Flop (didn't bet)
Seat 6: CI58 folded before Flop (didn't bet)
Seat 7: matiko09 (button) collected ($13.38)
Seat 8: chaps1988 (small blind) folded before Flop





PokerStars Hand #152886177008:  Hold'em No Limit ($0.50/$1.00 USD) - 2016/05/05 16:38:35 CET [2016/05/05 10:38:35 ET]
Table 'Porzia' 9-max Seat #2 is the button
Seat 1: vrnMike ($160 in chips) 
Seat 2: matiko09 ($103 in chips) 
Seat 3: sanpidk ($100 in chips) 
Seat 4: Khaine_CM ($101 in chips) 
Seat 5: CZECHMYSAK ($39 in chips) 
Seat 6: janarr5 ($142.92 in chips) 
Seat 8: PRINCE JULIO ($81.19 in chips) 
Seat 9: kl4ssic ($48 in chips) 
sanpidk: posts small blind $0.50
Khaine_CM: posts big blind $1
HITYESCA: sits out 
*** HOLE CARDS ***
Dealt to matiko09 [6h Ts]
CZECHMYSAK: folds 
janarr5: raises $2 to $3
PRINCE JULIO: folds 
kl4ssic: calls $3
vrnMike: raises $8 to $11
matiko09: folds 
sanpidk: folds 
Khaine_CM: folds 
janarr5: raises $15 to $26
kl4ssic: folds 
vrnMike: calls $15
*** FLOP *** [Td 3h 5d]
janarr5: checks 
vrnMike: checks 
*** TURN *** [Td 3h 5d] [8s]
janarr5: checks 
vrnMike: checks 
*** RIVER *** [Td 3h 5d 8s] [4s]
janarr5: checks 
vrnMike: checks 
*** SHOW DOWN ***
janarr5: shows [Qh Qd] (a pair of Queens)
vrnMike: mucks hand 
janarr5 collected $54 from pot
*** SUMMARY ***
Total pot $56.50 | Rake $2.50 
Board [Td 3h 5d 8s 4s]
Seat 1: vrnMike mucked [Ac Kd]
Seat 2: matiko09 (button) folded before Flop (didn't bet)
Seat 3: sanpidk (small blind) folded before Flop
Seat 4: Khaine_CM (big blind) folded before Flop
Seat 5: CZECHMYSAK folded before Flop (didn't bet)
Seat 6: janarr5 showed [Qh Qd] and won ($54) with a pair of Queens
Seat 8: PRINCE JULIO folded before Flop (didn't bet)
Seat 9: kl4ssic folded before Flop





PokerStars Hand #152886177928:  Hold'em No Limit (€1/€2 EUR) - 2016/05/05 16:38:37 CET [2016/05/05 10:38:37 ET]
Table 'Bessel II' 9-max Seat #4 is the button
Seat 1: Soloaces224 (€115.39 in chips) 
Seat 3: PacPacBum (€213.94 in chips) 
Seat 4: Zorken76 (€152.57 in chips) 
Seat 5: Kukuryzka (€201.93 in chips) 
Seat 6: glanza_mike (€203 in chips) 
Seat 7: matiko09 (€200 in chips) 
Seat 8: chaps1988 (€258.52 in chips) 
Kukuryzka: posts small blind €1
glanza_mike: posts big blind €2
JoaquinMRuiz: sits out 
*** HOLE CARDS ***
Dealt to matiko09 [8s Tc]
matiko09: folds 
chaps1988: folds 
Soloaces224: folds 
PacPacBum: raises €2.08 to €4.08
Zorken76: folds 
Kukuryzka: raises €10.92 to €15
glanza_mike: folds 
PacPacBum: raises €21 to €36
Kukuryzka: folds 
Uncalled bet (€21) returned to PacPacBum
PacPacBum collected €32 from pot
PacPacBum: doesn't show hand 
*** SUMMARY ***
Total pot €32 | Rake €0 
Seat 1: Soloaces224 folded before Flop (didn't bet)
Seat 3: PacPacBum collected (€32)
Seat 4: Zorken76 (button) folded before Flop (didn't bet)
Seat 5: Kukuryzka (small blind) folded before Flop
Seat 6: glanza_mike (big blind) folded before Flop
Seat 7: matiko09 folded before Flop (didn't bet)
Seat 8: chaps1988 folded before Flop (didn't bet)





PokerStars Hand #152886180712:  Hold'em No Limit ($0.50/$1.00 USD) - 2016/05/05 16:38:42 CET [2016/05/05 10:38:42 ET]
Table 'Amphitrite II' 9-max Seat #6 is the button
Seat 1: HITYESCA ($100 in chips) 
Seat 2: barakuda6236 ($80.68 in chips) 
Seat 3: kossof ($67.17 in chips) 
Seat 6: matiko09 ($100 in chips) 
Seat 7: sanpidk ($112.87 in chips) 
Seat 8: Lanza606 ($40 in chips) 
Seat 9: Dickyxxx ($109.68 in chips) 
sanpidk: posts small blind $0.50
Lanza606: posts big blind $1
*** HOLE CARDS ***
Dealt to matiko09 [5c 8c]
Dickyxxx: raises $2 to $3
HITYESCA: folds 
barakuda6236: folds 
kossof: calls $3
matiko09: folds 
sanpidk: raises $10.50 to $13.50
Lanza606: folds 
Dickyxxx: folds 
kossof: folds 
Uncalled bet ($10.50) returned to sanpidk
sanpidk collected $10 from pot
sanpidk: doesn't show hand 
*** SUMMARY ***
Total pot $10 | Rake $0 
Seat 1: HITYESCA folded before Flop (didn't bet)
Seat 2: barakuda6236 folded before Flop (didn't bet)
Seat 3: kossof folded before Flop
Seat 6: matiko09 (button) folded before Flop (didn't bet)
Seat 7: sanpidk (small blind) collected ($10)
Seat 8: Lanza606 (big blind) folded before Flop
Seat 9: Dickyxxx folded before Flop





PokerStars Hand #152886180807:  Hold'em No Limit (€1/€2 EUR) - 2016/05/05 16:38:42 CET [2016/05/05 10:38:42 ET]
Table 'Skat II' 9-max Seat #7 is the button
Seat 6: drissmouzou (€242.25 in chips) 
Seat 7: PacPacBum (€212.73 in chips) 
Seat 8: Painkiller72 (€200 in chips) 
Seat 9: matiko09 (€200 in chips) 
Painkiller72: posts small blind €1
matiko09: posts big blind €2
JoaquinMRuiz: sits out 
*** HOLE CARDS ***
Dealt to matiko09 [2h Qs]
drissmouzou: folds 
PacPacBum: raises €3 to €5
Painkiller72: raises €13 to €18
matiko09: folds 
PacPacBum: folds 
Uncalled bet (€13) returned to Painkiller72
Painkiller72 collected €12 from pot
Painkiller72: doesn't show hand 
*** SUMMARY ***
Total pot €12 | Rake €0 
Seat 6: drissmouzou folded before Flop (didn't bet)
Seat 7: PacPacBum (button) folded before Flop
Seat 8: Painkiller72 (small blind) collected (€12)
Seat 9: matiko09 (big blind) folded before Flop





PokerStars Hand #152886184074:  Hold'em No Limit ($1/$2 USD) - 2016/05/05 16:38:47 CET [2016/05/05 10:38:47 ET]
Table 'Samitchell' 9-max Seat #6 is the button
Seat 1: KovIFish89 ($206.50 in chips) 
Seat 2: matiko09 ($287.71 in chips) 
Seat 3: gabi_igna ($399.11 in chips) 
Seat 5: chaps1988 ($274.12 in chips) 
Seat 6: PacPacBum ($200 in chips) 
Seat 7: patpaty ($173.39 in chips) 
Seat 9: kblkxls ($125.20 in chips) 
patpaty: posts small blind $1
kblkxls: posts big blind $2
*** HOLE CARDS ***
Dealt to matiko09 [3s Qc]
KovIFish89: folds 
KovIFish89 leaves the table
Kukuryzka joins the table at seat #1 
matiko09: folds 
gabi_igna: folds 
chaps1988: folds 
PacPacBum: folds 
patpaty: calls $1
kblkxls: checks 
*** FLOP *** [Ks 2d 7h]
patpaty: bets $2
kblkxls: folds 
Uncalled bet ($2) returned to patpaty
patpaty collected $3.80 from pot
patpaty: doesn't show hand 
*** SUMMARY ***
Total pot $4 | Rake $0.20 
Board [Ks 2d 7h]
Seat 1: KovIFish89 folded before Flop (didn't bet)
Seat 2: matiko09 folded before Flop (didn't bet)
Seat 3: gabi_igna folded before Flop (didn't bet)
Seat 5: chaps1988 folded before Flop (didn't bet)
Seat 6: PacPacBum (button) folded before Flop (didn't bet)
Seat 7: patpaty (small blind) collected ($3.80)
Seat 9: kblkxls (big blind) folded on the Flop





PokerStars Hand #152886191081:  Hold'em No Limit ($1/$2 USD) - 2016/05/05 16:38:59 CET [2016/05/05 10:38:59 ET]
Table 'Tololo' 9-max Seat #7 is the button
Seat 1: Kukuryzka ($264.09 in chips) 
Seat 2: gabi_igna ($212.03 in chips) 
Seat 3: Khaine_CM ($200 in chips) 
Seat 4: mooose100 ($158.92 in chips) 
Seat 5: matiko09 ($200 in chips) 
Seat 6: Xagua ($153.70 in chips) 
Seat 7: chaps1988 ($281.42 in chips) 
Seat 8: myatiy 96 ($200 in chips) 
myatiy 96: posts small blind $1
Kukuryzka: posts big blind $2
*** HOLE CARDS ***
Dealt to matiko09 [8s 6h]
gabi_igna: raises $4 to $6
Khaine_CM: folds 
mooose100: folds 
matiko09: folds 
Xagua: folds 
chaps1988: folds 
myatiy 96: folds 
Kukuryzka: folds 
Uncalled bet ($4) returned to gabi_igna
gabi_igna collected $5 from pot
*** SUMMARY ***
Total pot $5 | Rake $0 
Seat 1: Kukuryzka (big blind) folded before Flop
Seat 2: gabi_igna collected ($5)
Seat 3: Khaine_CM folded before Flop (didn't bet)
Seat 4: mooose100 folded before Flop (didn't bet)
Seat 5: matiko09 folded before Flop (didn't bet)
Seat 6: Xagua folded before Flop (didn't bet)
Seat 7: chaps1988 (button) folded before Flop (didn't bet)
Seat 8: myatiy 96 (small blind) folded before Flop





PokerStars Hand #152886193865:  Hold'em No Limit (€1/€2 EUR) - 2016/05/05 16:39:03 CET [2016/05/05 10:39:03 ET]
Table 'Skat II' 9-max Seat #8 is the button
Seat 4: JoaquinMRuiz (€200 in chips) 
Seat 6: drissmouzou (€242.25 in chips) 
Seat 7: PacPacBum (€207.73 in chips) 
Seat 8: Painkiller72 (€207 in chips) 
Seat 9: matiko09 (€200 in chips) 
matiko09: posts small blind €1
JoaquinMRuiz: posts big blind €2
*** HOLE CARDS ***
Dealt to matiko09 [Kd Js]
drissmouzou: folds 
PacPacBum: folds 
Painkiller72: folds 
matiko09: raises €3 to €5
JoaquinMRuiz: calls €3
*** FLOP *** [2s 5h 9h]
matiko09: checks 
JoaquinMRuiz: bets €5.98
matiko09: folds 
Uncalled bet (€5.98) returned to JoaquinMRuiz
JoaquinMRuiz collected €9.50 from pot
*** SUMMARY ***
Total pot €10 | Rake €0.50 
Board [2s 5h 9h]
Seat 4: JoaquinMRuiz (big blind) collected (€9.50)
Seat 6: drissmouzou folded before Flop (didn't bet)
Seat 7: PacPacBum folded before Flop (didn't bet)
Seat 8: Painkiller72 (button) folded before Flop (didn't bet)
Seat 9: matiko09 (small blind) folded on the Flop





PokerStars Hand #152886194479:  Hold'em No Limit ($0.50/$1.00 USD) - 2016/05/05 16:39:04 CET [2016/05/05 10:39:04 ET]
Table 'Kraz II' 9-max Seat #3 is the button
Seat 2: sanpidk ($147.09 in chips) 
Seat 3: Khaine_CM ($100 in chips) 
Seat 4: LRVAV7 ($138.77 in chips) 
Seat 5: Kukuryzka ($100 in chips) 
Seat 6: andy84lfc ($235.73 in chips) 
Seat 7: Dantist1122 ($125.15 in chips) 
Seat 8: Hayer ana ($101.50 in chips) 
Seat 9: matiko09 ($177.32 in chips) 
LRVAV7: posts small blind $0.50
Kukuryzka: posts big blind $1
HITYESCA: sits out 
*** HOLE CARDS ***
Dealt to matiko09 [Qc 2h]
andy84lfc: folds 
Dantist1122: raises $2 to $3
Hayer ana: calls $3
matiko09: folds 
sanpidk: folds 
Khaine_CM: calls $3
LRVAV7: folds 
Kukuryzka: folds 
*** FLOP *** [6d Ks Ts]
Dantist1122: checks 
Hayer ana: checks 
Khaine_CM: bets $7
Dantist1122: folds 
Hayer ana: folds 
Uncalled bet ($7) returned to Khaine_CM
Khaine_CM collected $9.98 from pot
Khaine_CM: doesn't show hand 
*** SUMMARY ***
Total pot $10.50 | Rake $0.52 
Board [6d Ks Ts]
Seat 2: sanpidk folded before Flop (didn't bet)
Seat 3: Khaine_CM (button) collected ($9.98)
Seat 4: LRVAV7 (small blind) folded before Flop
Seat 5: Kukuryzka (big blind) folded before Flop
Seat 6: andy84lfc folded before Flop (didn't bet)
Seat 7: Dantist1122 folded on the Flop
Seat 8: Hayer ana folded on the Flop
Seat 9: matiko09 folded before Flop (didn't bet)





PokerStars Hand #152886204566:  Hold'em No Limit ($1/$2 USD) - 2016/05/05 16:39:21 CET [2016/05/05 10:39:21 ET]
Table 'Samitchell' 9-max Seat #7 is the button
Seat 1: Kukuryzka ($200 in chips) 
Seat 2: matiko09 ($287.71 in chips) 
Seat 3: gabi_igna ($399.11 in chips) 
Seat 5: chaps1988 ($274.12 in chips) 
Seat 6: PacPacBum ($200 in chips) 
Seat 7: patpaty ($175.19 in chips) 
Seat 9: kblkxls ($123.20 in chips) 
kblkxls: posts small blind $1
Kukuryzka: posts big blind $2
*** HOLE CARDS ***
Dealt to matiko09 [Jd 5h]
matiko09: folds 
gabi_igna: folds 
chaps1988: folds 
PacPacBum: folds 
patpaty: calls $2
kblkxls: raises $6 to $8
Kukuryzka: calls $6
patpaty: calls $6
*** FLOP *** [7d Kd 5d]
kblkxls: bets $15
Kukuryzka: folds 
patpaty: folds 
Uncalled bet ($15) returned to kblkxls
kblkxls collected $22.80 from pot
kblkxls: doesn't show hand 
*** SUMMARY ***
Total pot $24 | Rake $1.20 
Board [7d Kd 5d]
Seat 1: Kukuryzka (big blind) folded on the Flop
Seat 2: matiko09 folded before Flop (didn't bet)
Seat 3: gabi_igna folded before Flop (didn't bet)
Seat 5: chaps1988 folded before Flop (didn't bet)
Seat 6: PacPacBum folded before Flop (didn't bet)
Seat 7: patpaty (button) folded on the Flop
Seat 9: kblkxls (small blind) collected ($22.80)





PokerStars Hand #152886207975:  Hold'em No Limit ($0.50/$1.00 USD) - 2016/05/05 16:39:27 CET [2016/05/05 10:39:27 ET]
Table 'Amphitrite II' 9-max Seat #7 is the button
Seat 1: HITYESCA ($100 in chips) 
Seat 2: barakuda6236 ($80.68 in chips) 
Seat 3: kossof ($64.17 in chips) 
Seat 6: matiko09 ($100 in chips) 
Seat 7: sanpidk ($119.87 in chips) 
Seat 8: Lanza606 ($39 in chips) 
Seat 9: Dickyxxx ($106.68 in chips) 
Lanza606: posts small blind $0.50
Dickyxxx: posts big blind $1
*** HOLE CARDS ***
Dealt to matiko09 [Qh 3h]
HITYESCA: folds 
barakuda6236: folds 
kossof: folds 
matiko09: folds 
sanpidk: folds 
Lanza606: calls $0.50
Dickyxxx: raises $3 to $4
Lanza606: calls $3
*** FLOP *** [7h 8h 4h]
Lanza606: checks 
Dickyxxx: checks 
*** TURN *** [7h 8h 4h] [Jd]
Lanza606: checks 
Dickyxxx: checks 
*** RIVER *** [7h 8h 4h Jd] [2s]
Lanza606: checks 
Dickyxxx: checks 
*** SHOW DOWN ***
Lanza606: shows [Kc 3c] (high card King)
Dickyxxx: shows [Ks Qc] (high card King - Queen kicker)
Dickyxxx collected $7.60 from pot
*** SUMMARY ***
Total pot $8 | Rake $0.40 
Board [7h 8h 4h Jd 2s]
Seat 1: HITYESCA folded before Flop (didn't bet)
Seat 2: barakuda6236 folded before Flop (didn't bet)
Seat 3: kossof folded before Flop (didn't bet)
Seat 6: matiko09 folded before Flop (didn't bet)
Seat 7: sanpidk (button) folded before Flop (didn't bet)
Seat 8: Lanza606 (small blind) showed [Kc 3c] and lost with high card King
Seat 9: Dickyxxx (big blind) showed [Ks Qc] and won ($7.60) with high card King





PokerStars Hand #152886209009:  Hold'em No Limit (€1/€2 EUR) - 2016/05/05 16:39:28 CET [2016/05/05 10:39:28 ET]
Table 'Bessel II' 9-max Seat #5 is the button
Seat 1: Soloaces224 (€115.39 in chips) 
Seat 3: PacPacBum (€230.94 in chips) 
Seat 4: Zorken76 (€152.57 in chips) 
Seat 5: Kukuryzka (€200 in chips) 
Seat 6: glanza_mike (€201 in chips) 
Seat 7: matiko09 (€200 in chips) 
Seat 8: chaps1988 (€258.52 in chips) 
glanza_mike: posts small blind €1
matiko09: posts big blind €2
JoaquinMRuiz: sits out 
*** HOLE CARDS ***
Dealt to matiko09 [8h Tc]
chaps1988: folds 
Soloaces224: folds 
PacPacBum: folds 
Zorken76: folds 
Kukuryzka: folds 
glanza_mike: raises €3 to €5
matiko09: folds 
Uncalled bet (€3) returned to glanza_mike
glanza_mike collected €4 from pot
glanza_mike: doesn't show hand 
*** SUMMARY ***
Total pot €4 | Rake €0 
Seat 1: Soloaces224 folded before Flop (didn't bet)
Seat 3: PacPacBum folded before Flop (didn't bet)
Seat 4: Zorken76 folded before Flop (didn't bet)
Seat 5: Kukuryzka (button) folded before Flop (didn't bet)
Seat 6: glanza_mike (small blind) collected (€4)
Seat 7: matiko09 (big blind) folded before Flop
Seat 8: chaps1988 folded before Flop (didn't bet)





PokerStars Hand #152886210950:  Hold'em No Limit ($1/$2 USD) - 2016/05/05 16:39:31 CET [2016/05/05 10:39:31 ET]
Table 'Lundia' 9-max Seat #8 is the button
Seat 2: patpaty ($282.73 in chips) 
Seat 3: Painkiller72 ($248.70 in chips) 
Seat 5: zmOe84 ($141.29 in chips) 
Seat 6: CI58 ($248.78 in chips) 
Seat 7: matiko09 ($228.95 in chips) 
Seat 8: chaps1988 ($226.59 in chips) 
patpaty: posts small blind $1
Painkiller72: posts big blind $2
PacPacBum: sits out 
*** HOLE CARDS ***
Dealt to matiko09 [5c 7h]
zmOe84: folds 
CI58: folds 
matiko09: folds 
chaps1988: folds 
patpaty: calls $1
Painkiller72: checks 
*** FLOP *** [Kc 4c 5h]
patpaty: checks 
Painkiller72: bets $2.66
patpaty: folds 
Uncalled bet ($2.66) returned to Painkiller72
Painkiller72 collected $3.80 from pot
Painkiller72: doesn't show hand 
*** SUMMARY ***
Total pot $4 | Rake $0.20 
Board [Kc 4c 5h]
Seat 2: patpaty (small blind) folded on the Flop
Seat 3: Painkiller72 (big blind) collected ($3.80)
Seat 5: zmOe84 folded before Flop (didn't bet)
Seat 6: CI58 folded before Flop (didn't bet)
Seat 7: matiko09 folded before Flop (didn't bet)
Seat 8: chaps1988 (button) folded before Flop (didn't bet)





PokerStars Hand #152886212782:  Hold'em No Limit ($0.50/$1.00 USD) - 2016/05/05 16:39:35 CET [2016/05/05 10:39:35 ET]
Table 'Vela' 9-max Seat #8 is the button
Seat 1: janarr5 ($100 in chips) 
Seat 2: kl4ssic ($64.12 in chips) 
Seat 3: dviryo ($472.54 in chips) 
Seat 4: Hayer ana ($214.90 in chips) 
Seat 5: sanpidk ($102.50 in chips) 
Seat 6: matiko09 ($100 in chips) 
Seat 7: spgreek ($80 in chips) 
Seat 8: vrnMike ($104.50 in chips) 
Seat 9: Dickyxxx ($224.66 in chips) 
Dickyxxx: posts small blind $0.50
janarr5: posts big blind $1
spgreek: posts big blind $1
*** HOLE CARDS ***
Dealt to matiko09 [Qh 4c]
kl4ssic: folds 
dviryo: folds 
Hayer ana: raises $2 to $3
sanpidk: folds 
matiko09: folds 
spgreek: folds 
vrnMike: folds 
Dickyxxx: folds 
janarr5: folds 
Uncalled bet ($2) returned to Hayer ana
Hayer ana collected $3.50 from pot
Hayer ana: doesn't show hand 
*** SUMMARY ***
Total pot $3.50 | Rake $0 
Seat 1: janarr5 (big blind) folded before Flop
Seat 2: kl4ssic folded before Flop (didn't bet)
Seat 3: dviryo folded before Flop (didn't bet)
Seat 4: Hayer ana collected ($3.50)
Seat 5: sanpidk folded before Flop (didn't bet)
Seat 6: matiko09 folded before Flop (didn't bet)
Seat 7: spgreek folded before Flop
Seat 8: vrnMike (button) folded before Flop (didn't bet)
Seat 9: Dickyxxx (small blind) folded before Flop





PokerStars Hand #152886214080:  Hold'em No Limit ($1/$2 USD) - 2016/05/05 16:39:37 CET [2016/05/05 10:39:37 ET]
Table 'Tololo' 9-max Seat #8 is the button
Seat 1: Kukuryzka ($262.09 in chips) 
Seat 3: Khaine_CM ($200 in chips) 
Seat 4: mooose100 ($158.92 in chips) 
Seat 5: matiko09 ($200 in chips) 
Seat 6: Xagua ($153.70 in chips) 
Seat 7: chaps1988 ($281.42 in chips) 
Seat 8: myatiy 96 ($200 in chips) 
Kukuryzka: posts small blind $1
gabi_igna: is sitting out 
Khaine_CM: posts big blind $2
*** HOLE CARDS ***
Dealt to matiko09 [3d 5c]
gabi_igna leaves the table
mooose100: folds 
matiko09: folds 
Xagua: folds 
chaps1988: folds 
myatiy 96: raises $3 to $5
Kukuryzka: folds 
Khaine_CM: calls $3
*** FLOP *** [9h 3c 3s]
Khaine_CM: checks 
myatiy 96: bets $5.22
tepi_guy joins the table at seat #2 
Khaine_CM: folds 
Uncalled bet ($5.22) returned to myatiy 96
myatiy 96 collected $10.45 from pot
myatiy 96: doesn't show hand 
*** SUMMARY ***
Total pot $11 | Rake $0.55 
Board [9h 3c 3s]
Seat 1: Kukuryzka (small blind) folded before Flop
Seat 3: Khaine_CM (big blind) folded on the Flop
Seat 4: mooose100 folded before Flop (didn't bet)
Seat 5: matiko09 folded before Flop (didn't bet)
Seat 6: Xagua folded before Flop (didn't bet)
Seat 7: chaps1988 folded before Flop (didn't bet)
Seat 8: myatiy 96 (button) collected ($10.45)





PokerStars Hand #152886214851:  Hold'em No Limit ($1/$2 USD) - 2016/05/05 16:39:38 CET [2016/05/05 10:39:38 ET]
Table 'Euporie II' 9-max Seat #2 is the button
Seat 2: kblkxls ($88.82 in chips) 
Seat 3: chaps1988 ($237.25 in chips) 
Seat 5: Nuskatko1986 ($63.52 in chips) 
Seat 6: Kukuryzka ($200 in chips) 
Seat 7: matiko09 ($200.74 in chips) 
Seat 8: Painkiller72 ($294.25 in chips) 
Seat 9: T0ny Adams ($96.98 in chips) 
chaps1988: posts small blind $1
Nuskatko1986: posts big blind $2
PacPacBum: sits out 
*** HOLE CARDS ***
Dealt to matiko09 [8h 8c]
Kukuryzka: raises $4 to $6
matiko09: calls $6
Painkiller72: folds 
T0ny Adams: folds 
kblkxls: folds 
chaps1988: folds 
Nuskatko1986: folds 
*** FLOP *** [4s 8s 4h]
Kukuryzka: bets $10.69
matiko09: calls $10.69
*** TURN *** [4s 8s 4h] [5s]
Kukuryzka: checks 
matiko09: bets $22.46
Kukuryzka: folds 
Uncalled bet ($22.46) returned to matiko09
matiko09 collected $34.56 from pot
matiko09: doesn't show hand 
*** SUMMARY ***
Total pot $36.38 | Rake $1.82 
Board [4s 8s 4h 5s]
Seat 2: kblkxls (button) folded before Flop (didn't bet)
Seat 3: chaps1988 (small blind) folded before Flop
Seat 5: Nuskatko1986 (big blind) folded before Flop
Seat 6: Kukuryzka folded on the Turn
Seat 7: matiko09 collected ($34.56)
Seat 8: Painkiller72 folded before Flop (didn't bet)
Seat 9: T0ny Adams folded before Flop (didn't bet)





PokerStars Hand #152886222891:  Hold'em No Limit (€1/€2 EUR) - 2016/05/05 16:39:51 CET [2016/05/05 10:39:51 ET]
Table 'Skat II' 9-max Seat #9 is the button
Seat 4: JoaquinMRuiz (€204.50 in chips) 
Seat 6: drissmouzou (€242.25 in chips) 
Seat 7: PacPacBum (€207.73 in chips) 
Seat 8: Painkiller72 (€207 in chips) 
Seat 9: matiko09 (€200 in chips) 
JoaquinMRuiz: posts small blind €1
drissmouzou: posts big blind €2
*** HOLE CARDS ***
Dealt to matiko09 [8h Ks]
PacPacBum: folds 
Painkiller72: folds 
matiko09: raises €2.54 to €4.54
JoaquinMRuiz: folds 
drissmouzou: folds 
Uncalled bet (€2.54) returned to matiko09
matiko09 collected €5 from pot
matiko09: doesn't show hand 
*** SUMMARY ***
Total pot €5 | Rake €0 
Seat 4: JoaquinMRuiz (small blind) folded before Flop
Seat 6: drissmouzou (big blind) folded before Flop
Seat 7: PacPacBum folded before Flop (didn't bet)
Seat 8: Painkiller72 folded before Flop (didn't bet)
Seat 9: matiko09 (button) collected (€5)





PokerStars Hand #152886224238:  Hold'em No Limit (€1/€2 EUR) - 2016/05/05 16:39:53 CET [2016/05/05 10:39:53 ET]
Table 'Bessel II' 9-max Seat #6 is the button
Seat 1: Soloaces224 (€115.39 in chips) 
Seat 3: PacPacBum (€230.94 in chips) 
Seat 4: Zorken76 (€152.57 in chips) 
Seat 5: Kukuryzka (€200 in chips) 
Seat 6: glanza_mike (€203 in chips) 
Seat 7: matiko09 (€200 in chips) 
Seat 8: chaps1988 (€258.52 in chips) 
matiko09: posts small blind €1
chaps1988: posts big blind €2
JoaquinMRuiz: sits out 
*** HOLE CARDS ***
Dealt to matiko09 [3c 4h]
Soloaces224: raises €4 to €6
PacPacBum: folds 
Zorken76: calls €6
Kukuryzka: folds 
glanza_mike: folds 
matiko09: folds 
chaps1988: folds 
*** FLOP *** [Jd Jc 8d]
Soloaces224: checks 
Zorken76: checks 
*** TURN *** [Jd Jc 8d] [2c]
Soloaces224: checks 
Zorken76: checks 
*** RIVER *** [Jd Jc 8d 2c] [2s]
Soloaces224: checks 
Zorken76: checks 
*** SHOW DOWN ***
Soloaces224: shows [Qh Kd] (two pair, Jacks and Deuces)
Zorken76: shows [Kc Ad] (two pair, Jacks and Deuces - Ace kicker)
Zorken76 collected €14.25 from pot
*** SUMMARY ***
Total pot €15 | Rake €0.75 
Board [Jd Jc 8d 2c 2s]
Seat 1: Soloaces224 showed [Qh Kd] and lost with two pair, Jacks and Deuces
Seat 3: PacPacBum folded before Flop (didn't bet)
Seat 4: Zorken76 showed [Kc Ad] and won (€14.25) with two pair, Jacks and Deuces
Seat 5: Kukuryzka folded before Flop (didn't bet)
Seat 6: glanza_mike (button) folded before Flop (didn't bet)
Seat 7: matiko09 (small blind) folded before Flop
Seat 8: chaps1988 (big blind) folded before Flop





PokerStars Hand #152886225953:  Hold'em No Limit ($1/$2 USD) - 2016/05/05 16:39:56 CET [2016/05/05 10:39:56 ET]
Table 'Tatry II' 9-max Seat #6 is the button
Seat 1: glanza_mike ($222.80 in chips) 
Seat 2: T0ny Adams ($67.74 in chips) 
Seat 3: matiko09 ($206.28 in chips) 
Seat 4: PacPacBum ($206.57 in chips) 
Seat 5: Painkiller72 ($327.05 in chips) 
Seat 6: Kukuryzka ($276.60 in chips) 
Seat 8: chaps1988 ($252.62 in chips) 
Seat 9: korol702 ($155.80 in chips) 
chaps1988: posts small blind $1
korol702: posts big blind $2
*** HOLE CARDS ***
Dealt to matiko09 [2s 8c]
glanza_mike: folds 
T0ny Adams: folds 
matiko09: folds 
PacPacBum: folds 
Painkiller72: folds 
Kukuryzka: folds 
chaps1988: folds 
Uncalled bet ($1) returned to korol702
korol702 collected $2 from pot
korol702: doesn't show hand 
*** SUMMARY ***
Total pot $2 | Rake $0 
Seat 1: glanza_mike folded before Flop (didn't bet)
Seat 2: T0ny Adams folded before Flop (didn't bet)
Seat 3: matiko09 folded before Flop (didn't bet)
Seat 4: PacPacBum folded before Flop (didn't bet)
Seat 5: Painkiller72 folded before Flop (didn't bet)
Seat 6: Kukuryzka (button) folded before Flop (didn't bet)
Seat 8: chaps1988 (small blind) folded before Flop
Seat 9: korol702 (big blind) collected ($2)





PokerStars Hand #152886227589:  Hold'em No Limit ($0.50/$1.00 USD) - 2016/05/05 16:39:59 CET [2016/05/05 10:39:59 ET]
Table 'Vela' 9-max Seat #9 is the button
Seat 1: janarr5 ($100 in chips) 
Seat 2: kl4ssic ($64.12 in chips) 
Seat 3: dviryo ($472.54 in chips) 
Seat 4: Hayer ana ($217.40 in chips) 
Seat 5: sanpidk ($102.50 in chips) 
Seat 6: matiko09 ($100 in chips) 
Seat 7: spgreek ($79 in chips) 
Seat 8: vrnMike ($104.50 in chips) 
Seat 9: Dickyxxx ($224.16 in chips) 
janarr5: posts small blind $0.50
kl4ssic: posts big blind $1
*** HOLE CARDS ***
Dealt to matiko09 [Ts Ah]
dviryo: folds 
Hayer ana: folds 
sanpidk: folds 
matiko09: raises $2 to $3
spgreek: folds 
vrnMike: folds 
Dickyxxx: folds 
janarr5: folds 
kl4ssic: folds 
Uncalled bet ($2) returned to matiko09
matiko09 collected $2.50 from pot
matiko09: doesn't show hand 
*** SUMMARY ***
Total pot $2.50 | Rake $0 
Seat 1: janarr5 (small blind) folded before Flop
Seat 2: kl4ssic (big blind) folded before Flop
Seat 3: dviryo folded before Flop (didn't bet)
Seat 4: Hayer ana folded before Flop (didn't bet)
Seat 5: sanpidk folded before Flop (didn't bet)
Seat 6: matiko09 collected ($2.50)
Seat 7: spgreek folded before Flop (didn't bet)
Seat 8: vrnMike folded before Flop (didn't bet)
Seat 9: Dickyxxx (button) folded before Flop (didn't bet)





PokerStars Hand #152886235195:  Hold'em No Limit ($0.50/$1.00 USD) - 2016/05/05 16:40:11 CET [2016/05/05 10:40:11 ET]
Table 'Amphitrite II' 9-max Seat #8 is the button
Seat 1: HITYESCA ($100 in chips) 
Seat 2: barakuda6236 ($80.68 in chips) 
Seat 3: kossof ($64.17 in chips) 
Seat 6: matiko09 ($100 in chips) 
Seat 7: sanpidk ($119.87 in chips) 
Seat 8: Lanza606 ($35 in chips) 
Seat 9: Dickyxxx ($110.28 in chips) 
Dickyxxx: posts small blind $0.50
HITYESCA: posts big blind $1
*** HOLE CARDS ***
Dealt to matiko09 [8d 3c]
barakuda6236: folds 
kossof: folds 
matiko09: folds 
sanpidk: raises $1.50 to $2.50
Lanza606: folds 
Dickyxxx: folds 
HITYESCA: folds 
Uncalled bet ($1.50) returned to sanpidk
sanpidk collected $2.50 from pot
sanpidk: doesn't show hand 
*** SUMMARY ***
Total pot $2.50 | Rake $0 
Seat 1: HITYESCA (big blind) folded before Flop
Seat 2: barakuda6236 folded before Flop (didn't bet)
Seat 3: kossof folded before Flop (didn't bet)
Seat 6: matiko09 folded before Flop (didn't bet)
Seat 7: sanpidk collected ($2.50)
Seat 8: Lanza606 (button) folded before Flop (didn't bet)
Seat 9: Dickyxxx (small blind) folded before Flop





PokerStars Hand #152886236461:  Hold'em No Limit (€1/€2 EUR) - 2016/05/05 16:40:14 CET [2016/05/05 10:40:14 ET]
Table 'Skat II' 9-max Seat #4 is the button
Seat 4: JoaquinMRuiz (€203.50 in chips) 
Seat 6: drissmouzou (€240.25 in chips) 
Seat 7: PacPacBum (€207.73 in chips) 
Seat 8: Painkiller72 (€207 in chips) 
Seat 9: matiko09 (€203 in chips) 
drissmouzou: posts small blind €1
PacPacBum: posts big blind €2
*** HOLE CARDS ***
Dealt to matiko09 [As 9c]
Painkiller72: raises €3 to €5
matiko09: folds 
JoaquinMRuiz: folds 
drissmouzou: folds 
PacPacBum: folds 
Uncalled bet (€3) returned to Painkiller72
Painkiller72 collected €5 from pot
Painkiller72: doesn't show hand 
*** SUMMARY ***
Total pot €5 | Rake €0 
Seat 4: JoaquinMRuiz (button) folded before Flop (didn't bet)
Seat 6: drissmouzou (small blind) folded before Flop
Seat 7: PacPacBum (big blind) folded before Flop
Seat 8: Painkiller72 collected (€5)
Seat 9: matiko09 folded before Flop (didn't bet)





PokerStars Hand #152886241916:  Hold'em No Limit ($1/$2 USD) - 2016/05/05 16:40:22 CET [2016/05/05 10:40:22 ET]
Table 'Tatry II' 9-max Seat #8 is the button
Seat 1: glanza_mike ($222.80 in chips) 
Seat 2: T0ny Adams ($67.74 in chips) 
Seat 3: matiko09 ($206.28 in chips) 
Seat 4: PacPacBum ($206.57 in chips) 
Seat 5: Painkiller72 ($327.05 in chips) 
Seat 6: Kukuryzka ($276.60 in chips) 
Seat 8: chaps1988 ($251.62 in chips) 
Seat 9: korol702 ($156.80 in chips) 
korol702: posts small blind $1
glanza_mike: posts big blind $2
*** HOLE CARDS ***
Dealt to matiko09 [8c 3h]
T0ny Adams: folds 
matiko09: folds 
PacPacBum: folds 
Painkiller72: folds 
Kukuryzka: folds 
chaps1988: folds 
korol702: raises $2 to $4
glanza_mike: calls $2
*** FLOP *** [6h Qh Ts]
korol702: bets $6
glanza_mike: folds 
Uncalled bet ($6) returned to korol702
korol702 collected $7.60 from pot
korol702: doesn't show hand 
*** SUMMARY ***
Total pot $8 | Rake $0.40 
Board [6h Qh Ts]
Seat 1: glanza_mike (big blind) folded on the Flop
Seat 2: T0ny Adams folded before Flop (didn't bet)
Seat 3: matiko09 folded before Flop (didn't bet)
Seat 4: PacPacBum folded before Flop (didn't bet)
Seat 5: Painkiller72 folded before Flop (didn't bet)
Seat 6: Kukuryzka folded before Flop (didn't bet)
Seat 8: chaps1988 (button) folded before Flop (didn't bet)
Seat 9: korol702 (small blind) collected ($7.60)





PokerStars Hand #152886245601:  Hold'em No Limit ($0.50/$1.00 USD) - 2016/05/05 16:40:28 CET [2016/05/05 10:40:28 ET]
Table 'Kraz II' 9-max Seat #4 is the button
Seat 2: sanpidk ($147.09 in chips) 
Seat 3: Khaine_CM ($106.98 in chips) 
Seat 4: LRVAV7 ($138.27 in chips) 
Seat 5: Kukuryzka ($99 in chips) 
Seat 6: andy84lfc ($235.73 in chips) 
Seat 7: Dantist1122 ($122.15 in chips) 
Seat 8: Hayer ana ($100 in chips) 
Seat 9: matiko09 ($177.32 in chips) 
Kukuryzka: posts small blind $0.50
andy84lfc: posts big blind $1
HITYESCA: sits out 
*** HOLE CARDS ***
Dealt to matiko09 [6s 3h]
Dantist1122: folds 
Hayer ana: folds 
matiko09: folds 
sanpidk: folds 
Khaine_CM: folds 
LRVAV7: folds 
Kukuryzka: folds 
Uncalled bet ($0.50) returned to andy84lfc
andy84lfc collected $1 from pot
*** SUMMARY ***
Total pot $1 | Rake $0 
Seat 2: sanpidk folded before Flop (didn't bet)
Seat 3: Khaine_CM folded before Flop (didn't bet)
Seat 4: LRVAV7 (button) folded before Flop (didn't bet)
Seat 5: Kukuryzka (small blind) folded before Flop
Seat 6: andy84lfc (big blind) collected ($1)
Seat 7: Dantist1122 folded before Flop (didn't bet)
Seat 8: Hayer ana folded before Flop (didn't bet)
Seat 9: matiko09 folded before Flop (didn't bet)





PokerStars Hand #152886247630:  Hold'em No Limit ($1/$2 USD) - 2016/05/05 16:40:32 CET [2016/05/05 10:40:32 ET]
Table 'Lundia' 9-max Seat #2 is the button
Seat 2: patpaty ($280.73 in chips) 
Seat 3: Painkiller72 ($250.50 in chips) 
Seat 4: PacPacBum ($200 in chips) 
Seat 5: zmOe84 ($141.29 in chips) 
Seat 6: CI58 ($248.78 in chips) 
Seat 7: matiko09 ($228.95 in chips) 
Seat 8: chaps1988 ($226.59 in chips) 
Painkiller72: posts small blind $1
PacPacBum: posts big blind $2
*** HOLE CARDS ***
Dealt to matiko09 [Ts 9h]
zmOe84: folds 
CI58: raises $4 to $6
matiko09: folds 
chaps1988: folds 
patpaty: folds 
Painkiller72: folds 
PacPacBum: raises $12 to $18
CI58: calls $12
*** FLOP *** [3h 3c Js]
PacPacBum: checks 
CI58: bets $17.57
PacPacBum: folds 
Uncalled bet ($17.57) returned to CI58
CI58 collected $35.15 from pot
CI58: doesn't show hand 
*** SUMMARY ***
Total pot $37 | Rake $1.85 
Board [3h 3c Js]
Seat 2: patpaty (button) folded before Flop (didn't bet)
Seat 3: Painkiller72 (small blind) folded before Flop
Seat 4: PacPacBum (big blind) folded on the Flop
Seat 5: zmOe84 folded before Flop (didn't bet)
Seat 6: CI58 collected ($35.15)
Seat 7: matiko09 folded before Flop (didn't bet)
Seat 8: chaps1988 folded before Flop (didn't bet)





PokerStars Hand #152886249779:  Hold'em No Limit ($1/$2 USD) - 2016/05/05 16:40:35 CET [2016/05/05 10:40:35 ET]
Table 'Samitchell' 9-max Seat #9 is the button
Seat 1: Kukuryzka ($200 in chips) 
Seat 2: matiko09 ($287.71 in chips) 
Seat 3: gabi_igna ($399.11 in chips) 
Seat 5: chaps1988 ($274.12 in chips) 
Seat 6: PacPacBum ($200 in chips) 
Seat 7: patpaty ($167.19 in chips) 
Seat 9: kblkxls ($138 in chips) 
Kukuryzka: posts small blind $1
matiko09: posts big blind $2
*** HOLE CARDS ***
Dealt to matiko09 [Js 2c]
gabi_igna: folds 
chaps1988: raises $4 to $6
PacPacBum: folds 
patpaty: folds 
kblkxls: folds 
Kukuryzka: folds 
matiko09: folds 
Uncalled bet ($4) returned to chaps1988
chaps1988 collected $5 from pot
*** SUMMARY ***
Total pot $5 | Rake $0 
Seat 1: Kukuryzka (small blind) folded before Flop
Seat 2: matiko09 (big blind) folded before Flop
Seat 3: gabi_igna folded before Flop (didn't bet)
Seat 5: chaps1988 collected ($5)
Seat 6: PacPacBum folded before Flop (didn't bet)
Seat 7: patpaty folded before Flop (didn't bet)
Seat 9: kblkxls (button) folded before Flop (didn't bet)





PokerStars Hand #152886249967:  Hold'em No Limit ($0.50/$1.00 USD) - 2016/05/05 16:40:36 CET [2016/05/05 10:40:36 ET]
Table 'Porzia' 9-max Seat #3 is the button
Seat 1: vrnMike ($134 in chips) 
Seat 2: matiko09 ($103 in chips) 
Seat 3: sanpidk ($100 in chips) 
Seat 4: Khaine_CM ($100 in chips) 
Seat 5: CZECHMYSAK ($39 in chips) 
Seat 6: janarr5 ($170.92 in chips) 
Seat 8: PRINCE JULIO ($81.19 in chips) 
Seat 9: kl4ssic ($45 in chips) 
Khaine_CM: posts small blind $0.50
CZECHMYSAK: posts big blind $1
HITYESCA: sits out 
*** HOLE CARDS ***
Dealt to matiko09 [Jd Ad]
janarr5: folds 
PRINCE JULIO: folds 
kl4ssic: folds 
vrnMike: folds 
matiko09: raises $1.50 to $2.50
sanpidk: folds 
Khaine_CM: folds 
CZECHMYSAK: calls $1.50
*** FLOP *** [2s 6s 9h]
CZECHMYSAK: checks 
matiko09: checks 
*** TURN *** [2s 6s 9h] [Td]
CZECHMYSAK: bets $2.61
matiko09: folds 
Uncalled bet ($2.61) returned to CZECHMYSAK
CZECHMYSAK collected $5.22 from pot
*** SUMMARY ***
Total pot $5.50 | Rake $0.28 
Board [2s 6s 9h Td]
Seat 1: vrnMike folded before Flop (didn't bet)
Seat 2: matiko09 folded on the Turn
Seat 3: sanpidk (button) folded before Flop (didn't bet)
Seat 4: Khaine_CM (small blind) folded before Flop
Seat 5: CZECHMYSAK (big blind) collected ($5.22)
Seat 6: janarr5 folded before Flop (didn't bet)
Seat 8: PRINCE JULIO folded before Flop (didn't bet)
Seat 9: kl4ssic folded before Flop (didn't bet)





PokerStars Hand #152886249999:  Hold'em No Limit ($0.50/$1.00 USD) - 2016/05/05 16:40:36 CET [2016/05/05 10:40:36 ET]
Table 'Amphitrite II' 9-max Seat #9 is the button
Seat 1: HITYESCA ($100 in chips) 
Seat 2: barakuda6236 ($80.68 in chips) 
Seat 3: kossof ($64.17 in chips) 
Seat 6: matiko09 ($100 in chips) 
Seat 7: sanpidk ($121.37 in chips) 
Seat 8: Lanza606 ($35 in chips) 
Seat 9: Dickyxxx ($109.78 in chips) 
HITYESCA: posts small blind $0.50
barakuda6236: posts big blind $1
*** HOLE CARDS ***
Dealt to matiko09 [Jd Ts]
kossof: folds 
matiko09: folds 
sanpidk: folds 
Lanza606: folds 
Dickyxxx: raises $2 to $3
HITYESCA: folds 
barakuda6236: folds 
Uncalled bet ($2) returned to Dickyxxx
Dickyxxx collected $2.50 from pot
Dickyxxx: doesn't show hand 
*** SUMMARY ***
Total pot $2.50 | Rake $0 
Seat 1: HITYESCA (small blind) folded before Flop
Seat 2: barakuda6236 (big blind) folded before Flop
Seat 3: kossof folded before Flop (didn't bet)
Seat 6: matiko09 folded before Flop (didn't bet)
Seat 7: sanpidk folded before Flop (didn't bet)
Seat 8: Lanza606 folded before Flop (didn't bet)
Seat 9: Dickyxxx (button) collected ($2.50)





PokerStars Hand #152886251213:  Hold'em No Limit ($0.50/$1.00 USD) - 2016/05/05 16:40:38 CET [2016/05/05 10:40:38 ET]
Table 'Vela' 9-max Seat #1 is the button
Seat 1: janarr5 ($100 in chips) 
Seat 2: kl4ssic ($63.12 in chips) 
Seat 3: dviryo ($472.54 in chips) 
Seat 4: Hayer ana ($217.40 in chips) 
Seat 5: sanpidk ($102.50 in chips) 
Seat 6: matiko09 ($101.50 in chips) 
Seat 7: spgreek ($79 in chips) 
Seat 8: vrnMike ($104.50 in chips) 
Seat 9: Dickyxxx ($224.16 in chips) 
kl4ssic: posts small blind $0.50
dviryo: posts big blind $1
*** HOLE CARDS ***
Dealt to matiko09 [9h 6d]
Hayer ana: folds 
sanpidk: folds 
matiko09: folds 
spgreek: folds 
vrnMike: folds 
Dickyxxx: folds 
janarr5: folds 
kl4ssic: raises $1.45 to $2.45
dviryo: raises $2.55 to $5
kl4ssic: calls $2.55
*** FLOP *** [3s 5d Kd]
kl4ssic: checks 
dviryo: bets $7
kl4ssic: folds 
Uncalled bet ($7) returned to dviryo
dviryo collected $9.50 from pot
*** SUMMARY ***
Total pot $10 | Rake $0.50 
Board [3s 5d Kd]
Seat 1: janarr5 (button) folded before Flop (didn't bet)
Seat 2: kl4ssic (small blind) folded on the Flop
Seat 3: dviryo (big blind) collected ($9.50)
Seat 4: Hayer ana folded before Flop (didn't bet)
Seat 5: sanpidk folded before Flop (didn't bet)
Seat 6: matiko09 folded before Flop (didn't bet)
Seat 7: spgreek folded before Flop (didn't bet)
Seat 8: vrnMike folded before Flop (didn't bet)
Seat 9: Dickyxxx folded before Flop (didn't bet)





PokerStars Hand #152886251400:  Hold'em No Limit (€1/€2 EUR) - 2016/05/05 16:40:38 CET [2016/05/05 10:40:38 ET]
Table 'Skat II' 9-max Seat #6 is the button
Seat 4: JoaquinMRuiz (€203.50 in chips) 
Seat 6: drissmouzou (€239.25 in chips) 
Seat 7: PacPacBum (€205.73 in chips) 
Seat 8: Painkiller72 (€210 in chips) 
Seat 9: matiko09 (€203 in chips) 
PacPacBum: posts small blind €1
Painkiller72: posts big blind €2
*** HOLE CARDS ***
Dealt to matiko09 [4d 2c]
matiko09: folds 
JoaquinMRuiz: raises €2.35 to €4.35
drissmouzou: folds 
PacPacBum: calls €3.35
Painkiller72: folds 
*** FLOP *** [8h 8d 3h]
PacPacBum: checks 
JoaquinMRuiz: checks 
*** TURN *** [8h 8d 3h] [Jc]
PacPacBum: checks 
JoaquinMRuiz: bets €6.40
PacPacBum: folds 
Uncalled bet (€6.40) returned to JoaquinMRuiz
JoaquinMRuiz collected €10.16 from pot
*** SUMMARY ***
Total pot €10.70 | Rake €0.54 
Board [8h 8d 3h Jc]
Seat 4: JoaquinMRuiz collected (€10.16)
Seat 6: drissmouzou (button) folded before Flop (didn't bet)
Seat 7: PacPacBum (small blind) folded on the Turn
Seat 8: Painkiller72 (big blind) folded before Flop
Seat 9: matiko09 folded before Flop (didn't bet)





PokerStars Hand #152886252739:  Hold'em No Limit (€1/€2 EUR) - 2016/05/05 16:40:40 CET [2016/05/05 10:40:40 ET]
Table 'Bessel II' 9-max Seat #7 is the button
Seat 1: Soloaces224 (€109.39 in chips) 
Seat 3: PacPacBum (€230.94 in chips) 
Seat 4: Zorken76 (€160.82 in chips) 
Seat 5: Kukuryzka (€200 in chips) 
Seat 6: glanza_mike (€203 in chips) 
Seat 7: matiko09 (€200 in chips) 
Seat 8: chaps1988 (€256.52 in chips) 
Seat 9: JoaquinMRuiz (€200 in chips) 
chaps1988: posts small blind €1
JoaquinMRuiz: posts big blind €2
*** HOLE CARDS ***
Dealt to matiko09 [7c Th]
Soloaces224: calls €2
PacPacBum: folds 
Zorken76: folds 
Kukuryzka: folds 
glanza_mike: folds 
matiko09: folds 
chaps1988: calls €1
JoaquinMRuiz: checks 
*** FLOP *** [5s 2h 9h]
chaps1988: checks 
JoaquinMRuiz: checks 
Soloaces224: bets €5.70
chaps1988: folds 
JoaquinMRuiz: folds 
Uncalled bet (€5.70) returned to Soloaces224
Soloaces224 collected €5.70 from pot
Soloaces224: doesn't show hand 
*** SUMMARY ***
Total pot €6 | Rake €0.30 
Board [5s 2h 9h]
Seat 1: Soloaces224 collected (€5.70)
Seat 3: PacPacBum folded before Flop (didn't bet)
Seat 4: Zorken76 folded before Flop (didn't bet)
Seat 5: Kukuryzka folded before Flop (didn't bet)
Seat 6: glanza_mike folded before Flop (didn't bet)
Seat 7: matiko09 (button) folded before Flop (didn't bet)
Seat 8: chaps1988 (small blind) folded on the Flop
Seat 9: JoaquinMRuiz (big blind) folded on the Flop





PokerStars Hand #152886253947:  Hold'em No Limit ($1/$2 USD) - 2016/05/05 16:40:42 CET [2016/05/05 10:40:42 ET]
Table 'Tololo' 9-max Seat #1 is the button
Seat 1: Kukuryzka ($261.09 in chips) 
Seat 3: Khaine_CM ($200 in chips) 
Seat 4: mooose100 ($158.92 in chips) 
Seat 5: matiko09 ($200 in chips) 
Seat 6: Xagua ($153.70 in chips) 
Seat 7: chaps1988 ($281.42 in chips) 
Seat 8: myatiy 96 ($205.45 in chips) 
Khaine_CM: posts small blind $1
mooose100: posts big blind $2
*** HOLE CARDS ***
Dealt to matiko09 [6h 2s]
matiko09: folds 
Xagua: folds 
chaps1988: folds 
myatiy 96: folds 
Kukuryzka: raises $2 to $4
Khaine_CM: folds 
mooose100: calls $2
*** FLOP *** [Ts Kd 6s]
mooose100: bets $4.27
Kukuryzka: folds 
Uncalled bet ($4.27) returned to mooose100
mooose100 collected $8.55 from pot
mooose100: doesn't show hand 
*** SUMMARY ***
Total pot $9 | Rake $0.45 
Board [Ts Kd 6s]
Seat 1: Kukuryzka (button) folded on the Flop
Seat 3: Khaine_CM (small blind) folded before Flop
Seat 4: mooose100 (big blind) collected ($8.55)
Seat 5: matiko09 folded before Flop (didn't bet)
Seat 6: Xagua folded before Flop (didn't bet)
Seat 7: chaps1988 folded before Flop (didn't bet)
Seat 8: myatiy 96 folded before Flop (didn't bet)





PokerStars Hand #152886262566:  Hold'em No Limit ($0.50/$1.00 USD) - 2016/05/05 16:40:56 CET [2016/05/05 10:40:56 ET]
Table 'Kraz II' 9-max Seat #5 is the button
Seat 2: sanpidk ($147.09 in chips) 
Seat 3: Khaine_CM ($106.98 in chips) 
Seat 4: LRVAV7 ($138.27 in chips) 
Seat 5: Kukuryzka ($100 in chips) 
Seat 6: andy84lfc ($236.23 in chips) 
Seat 7: Dantist1122 ($122.15 in chips) 
Seat 8: Hayer ana ($100 in chips) 
Seat 9: matiko09 ($177.32 in chips) 
andy84lfc: posts small blind $0.50
Dantist1122: posts big blind $1
HITYESCA: sits out 
*** HOLE CARDS ***
Dealt to matiko09 [2d Js]
Hayer ana: folds 
matiko09: folds 
sanpidk: folds 
Khaine_CM: folds 
LRVAV7: folds 
LRVAV7 leaves the table
CI58 joins the table at seat #4 
Kukuryzka: raises $1 to $2
andy84lfc: calls $1.50
Dantist1122: folds 
*** FLOP *** [Ah 3c 8s]
andy84lfc: bets $2.37
Kukuryzka: folds 
Uncalled bet ($2.37) returned to andy84lfc
andy84lfc collected $4.75 from pot
*** SUMMARY ***
Total pot $5 | Rake $0.25 
Board [Ah 3c 8s]
Seat 2: sanpidk folded before Flop (didn't bet)
Seat 3: Khaine_CM folded before Flop (didn't bet)
Seat 4: LRVAV7 folded before Flop (didn't bet)
Seat 5: Kukuryzka (button) folded on the Flop
Seat 6: andy84lfc (small blind) collected ($4.75)
Seat 7: Dantist1122 (big blind) folded before Flop
Seat 8: Hayer ana folded before Flop (didn't bet)
Seat 9: matiko09 folded before Flop (didn't bet)





PokerStars Hand #152886262937:  Hold'em No Limit ($1/$2 USD) - 2016/05/05 16:40:57 CET [2016/05/05 10:40:57 ET]
Table 'Euporie II' 9-max Seat #3 is the button
Seat 2: kblkxls ($88.82 in chips) 
Seat 3: chaps1988 ($236.25 in chips) 
Seat 5: Nuskatko1986 ($61.52 in chips) 
Seat 6: Kukuryzka ($200 in chips) 
Seat 7: matiko09 ($218.61 in chips) 
Seat 8: Painkiller72 ($294.25 in chips) 
Seat 9: T0ny Adams ($96.98 in chips) 
Nuskatko1986: posts small blind $1
Kukuryzka: posts big blind $2
PacPacBum: sits out 
*** HOLE CARDS ***
Dealt to matiko09 [8d 2h]
matiko09: folds 
Painkiller72: folds 
T0ny Adams: folds 
kblkxls: folds 
chaps1988: folds 
Nuskatko1986: folds 
Uncalled bet ($1) returned to Kukuryzka
Kukuryzka collected $2 from pot
Kukuryzka: doesn't show hand 
*** SUMMARY ***
Total pot $2 | Rake $0 
Seat 2: kblkxls folded before Flop (didn't bet)
Seat 3: chaps1988 (button) folded before Flop (didn't bet)
Seat 5: Nuskatko1986 (small blind) folded before Flop
Seat 6: Kukuryzka (big blind) collected ($2)
Seat 7: matiko09 folded before Flop (didn't bet)
Seat 8: Painkiller72 folded before Flop (didn't bet)
Seat 9: T0ny Adams folded before Flop (didn't bet)





PokerStars Hand #152886268173:  Hold'em No Limit ($1/$2 USD) - 2016/05/05 16:41:05 CET [2016/05/05 10:41:05 ET]
Table 'Samitchell' 9-max Seat #1 is the button
Seat 1: Kukuryzka ($199 in chips) 
Seat 2: matiko09 ($285.71 in chips) 
Seat 5: chaps1988 ($277.12 in chips) 
Seat 6: PacPacBum ($200 in chips) 
Seat 7: patpaty ($167.19 in chips) 
Seat 9: kblkxls ($138 in chips) 
matiko09: posts small blind $1
gabi_igna: is sitting out 
chaps1988: posts big blind $2
*** HOLE CARDS ***
Dealt to matiko09 [Qh 9h]
gabi_igna leaves the table
myatiy 96 joins the table at seat #3 
PacPacBum: folds 
myatiy 96 leaves the table
patpaty: folds 
kblkxls: folds 
han3bj joins the table at seat #3 
Kukuryzka: raises $2 to $4
matiko09: folds 
chaps1988: folds 
Uncalled bet ($2) returned to Kukuryzka
Kukuryzka collected $5 from pot
Kukuryzka: doesn't show hand 
*** SUMMARY ***
Total pot $5 | Rake $0 
Seat 1: Kukuryzka (button) collected ($5)
Seat 2: matiko09 (small blind) folded before Flop
Seat 5: chaps1988 (big blind) folded before Flop
Seat 6: PacPacBum folded before Flop (didn't bet)
Seat 7: patpaty folded before Flop (didn't bet)
Seat 9: kblkxls folded before Flop (didn't bet)





PokerStars Hand #152886270134:  Hold'em No Limit ($0.50/$1.00 USD) - 2016/05/05 16:41:08 CET [2016/05/05 10:41:08 ET]
Table 'Amphitrite II' 9-max Seat #1 is the button
Seat 1: HITYESCA ($100 in chips) 
Seat 2: barakuda6236 ($79.68 in chips) 
Seat 3: kossof ($64.17 in chips) 
Seat 6: matiko09 ($100 in chips) 
Seat 7: sanpidk ($121.37 in chips) 
Seat 8: Lanza606 ($35 in chips) 
Seat 9: Dickyxxx ($111.28 in chips) 
barakuda6236: posts small blind $0.50
kossof: posts big blind $1
*** HOLE CARDS ***
Dealt to matiko09 [7s Tc]
matiko09: folds 
sanpidk: folds 
Lanza606: folds 
Dickyxxx: folds 
HITYESCA: folds 
barakuda6236: folds 
Uncalled bet ($0.50) returned to kossof
kossof collected $1 from pot
*** SUMMARY ***
Total pot $1 | Rake $0 
Seat 1: HITYESCA (button) folded before Flop (didn't bet)
Seat 2: barakuda6236 (small blind) folded before Flop
Seat 3: kossof (big blind) collected ($1)
Seat 6: matiko09 folded before Flop (didn't bet)
Seat 7: sanpidk folded before Flop (didn't bet)
Seat 8: Lanza606 folded before Flop (didn't bet)
Seat 9: Dickyxxx folded before Flop (didn't bet)





PokerStars Hand #152886271252:  Hold'em No Limit ($1/$2 USD) - 2016/05/05 16:41:10 CET [2016/05/05 10:41:10 ET]
Table 'Tatry II' 9-max Seat #9 is the button
Seat 1: glanza_mike ($218.80 in chips) 
Seat 2: T0ny Adams ($67.74 in chips) 
Seat 3: matiko09 ($206.28 in chips) 
Seat 4: PacPacBum ($206.57 in chips) 
Seat 5: Painkiller72 ($327.05 in chips) 
Seat 6: Kukuryzka ($276.60 in chips) 
Seat 8: chaps1988 ($251.62 in chips) 
Seat 9: korol702 ($160.40 in chips) 
glanza_mike: posts small blind $1
T0ny Adams: posts big blind $2
*** HOLE CARDS ***
Dealt to matiko09 [9c Tc]
matiko09: raises $3 to $5
PacPacBum: raises $11 to $16
Painkiller72: folds 
Kukuryzka: folds 
chaps1988: folds 
korol702: folds 
glanza_mike: folds 
T0ny Adams: folds 
matiko09: folds 
Uncalled bet ($11) returned to PacPacBum
PacPacBum collected $13 from pot
PacPacBum: doesn't show hand 
*** SUMMARY ***
Total pot $13 | Rake $0 
Seat 1: glanza_mike (small blind) folded before Flop
Seat 2: T0ny Adams (big blind) folded before Flop
Seat 3: matiko09 folded before Flop
Seat 4: PacPacBum collected ($13)
Seat 5: Painkiller72 folded before Flop (didn't bet)
Seat 6: Kukuryzka folded before Flop (didn't bet)
Seat 8: chaps1988 folded before Flop (didn't bet)
Seat 9: korol702 (button) folded before Flop (didn't bet)





PokerStars Hand #152886272672:  Hold'em No Limit ($1/$2 USD) - 2016/05/05 16:41:13 CET [2016/05/05 10:41:13 ET]
Table 'Euporie II' 9-max Seat #5 is the button
Seat 2: kblkxls ($88.82 in chips) 
Seat 3: chaps1988 ($236.25 in chips) 
Seat 5: Nuskatko1986 ($60.52 in chips) 
Seat 6: Kukuryzka ($201 in chips) 
Seat 7: matiko09 ($218.61 in chips) 
Seat 8: Painkiller72 ($294.25 in chips) 
Seat 9: T0ny Adams ($96.98 in chips) 
Kukuryzka: posts small blind $1
matiko09: posts big blind $2
PacPacBum: sits out 
*** HOLE CARDS ***
Dealt to matiko09 [Qs Js]
Painkiller72: folds 
T0ny Adams: folds 
kblkxls: folds 
chaps1988: folds 
Nuskatko1986: folds 
Kukuryzka: folds 
Uncalled bet ($1) returned to matiko09
matiko09 collected $2 from pot
matiko09: doesn't show hand 
*** SUMMARY ***
Total pot $2 | Rake $0 
Seat 2: kblkxls folded before Flop (didn't bet)
Seat 3: chaps1988 folded before Flop (didn't bet)
Seat 5: Nuskatko1986 (button) folded before Flop (didn't bet)
Seat 6: Kukuryzka (small blind) folded before Flop
Seat 7: matiko09 (big blind) collected ($2)
Seat 8: Painkiller72 folded before Flop (didn't bet)
Seat 9: T0ny Adams folded before Flop (didn't bet)





PokerStars Hand #152886274175:  Hold'em No Limit ($0.50/$1.00 USD) - 2016/05/05 16:41:15 CET [2016/05/05 10:41:15 ET]
Table 'Porzia' 9-max Seat #4 is the button
Seat 1: vrnMike ($134 in chips) 
Seat 2: matiko09 ($100.50 in chips) 
Seat 3: sanpidk ($100 in chips) 
Seat 4: Khaine_CM ($100 in chips) 
Seat 5: CZECHMYSAK ($41.72 in chips) 
Seat 6: janarr5 ($170.92 in chips) 
Seat 8: PRINCE JULIO ($81.19 in chips) 
Seat 9: kl4ssic ($45 in chips) 
CZECHMYSAK: posts small blind $0.50
janarr5: posts big blind $1
HITYESCA: sits out 
*** HOLE CARDS ***
Dealt to matiko09 [Qh 6c]
PRINCE JULIO: calls $1
kl4ssic: folds 
vrnMike: folds 
matiko09: folds 
sanpidk: folds 
Khaine_CM: folds 
CZECHMYSAK: calls $0.50
janarr5: checks 
*** FLOP *** [Kd Qd Tc]
CZECHMYSAK: checks 
janarr5: checks 
PRINCE JULIO: checks 
*** TURN *** [Kd Qd Tc] [7c]
CZECHMYSAK: checks 
janarr5: checks 
PRINCE JULIO: checks 
*** RIVER *** [Kd Qd Tc 7c] [4c]
CZECHMYSAK: checks 
janarr5: checks 
PRINCE JULIO: checks 
*** SHOW DOWN ***
CZECHMYSAK: shows [7h 6h] (a pair of Sevens)
janarr5: shows [Qs 2h] (a pair of Queens)
PRINCE JULIO: mucks hand 
janarr5 collected $2.85 from pot
*** SUMMARY ***
Total pot $3 | Rake $0.15 
Board [Kd Qd Tc 7c 4c]
Seat 1: vrnMike folded before Flop (didn't bet)
Seat 2: matiko09 folded before Flop (didn't bet)
Seat 3: sanpidk folded before Flop (didn't bet)
Seat 4: Khaine_CM (button) folded before Flop (didn't bet)
Seat 5: CZECHMYSAK (small blind) showed [7h 6h] and lost with a pair of Sevens
Seat 6: janarr5 (big blind) showed [Qs 2h] and won ($2.85) with a pair of Queens
Seat 8: PRINCE JULIO mucked [2c 2s]
Seat 9: kl4ssic folded before Flop (didn't bet)





PokerStars Hand #152886280627:  Hold'em No Limit ($1/$2 USD) - 2016/05/05 16:41:26 CET [2016/05/05 10:41:26 ET]
Table 'Lundia' 9-max Seat #3 is the button
Seat 2: patpaty ($280.73 in chips) 
Seat 3: Painkiller72 ($249.50 in chips) 
Seat 4: PacPacBum ($200 in chips) 
Seat 5: zmOe84 ($141.29 in chips) 
Seat 6: CI58 ($265.93 in chips) 
Seat 7: matiko09 ($228.95 in chips) 
Seat 8: chaps1988 ($226.59 in chips) 
PacPacBum: posts small blind $1
zmOe84: posts big blind $2
*** HOLE CARDS ***
Dealt to matiko09 [As Kc]
CI58: raises $4 to $6
matiko09: calls $6
chaps1988: folds 
patpaty: folds 
Painkiller72: folds 
PacPacBum: folds 
zmOe84: calls $4
*** FLOP *** [8d 9h Td]
zmOe84: checks 
CI58: bets $10.83
matiko09: folds 
zmOe84: folds 
Uncalled bet ($10.83) returned to CI58
CI58 collected $18.05 from pot
CI58: doesn't show hand 
*** SUMMARY ***
Total pot $19 | Rake $0.95 
Board [8d 9h Td]
Seat 2: patpaty folded before Flop (didn't bet)
Seat 3: Painkiller72 (button) folded before Flop (didn't bet)
Seat 4: PacPacBum (small blind) folded before Flop
Seat 5: zmOe84 (big blind) folded on the Flop
Seat 6: CI58 collected ($18.05)
Seat 7: matiko09 folded on the Flop
Seat 8: chaps1988 folded before Flop (didn't bet)





PokerStars Hand #152886281992:  Hold'em No Limit ($0.50/$1.00 USD) - 2016/05/05 16:41:28 CET [2016/05/05 10:41:28 ET]
Table 'Vela' 9-max Seat #2 is the button
Seat 1: janarr5 ($100 in chips) 
Seat 2: kl4ssic ($58.12 in chips) 
Seat 3: dviryo ($477.04 in chips) 
Seat 4: Hayer ana ($217.40 in chips) 
Seat 5: sanpidk ($102.50 in chips) 
Seat 6: matiko09 ($101.50 in chips) 
Seat 7: spgreek ($79 in chips) 
Seat 8: vrnMike ($104.50 in chips) 
Seat 9: Dickyxxx ($224.16 in chips) 
dviryo: posts small blind $0.50
Hayer ana: posts big blind $1
*** HOLE CARDS ***
Dealt to matiko09 [Qc Jc]
sanpidk: raises $2 to $3
matiko09: folds 
spgreek: folds 
vrnMike: folds 
Dickyxxx: folds 
janarr5: raises $6 to $9
kl4ssic: folds 
dviryo: folds 
Hayer ana: folds 
sanpidk: calls $6
*** FLOP *** [7d Ac Js]
sanpidk: checks 
janarr5: bets $9
sanpidk: folds 
Uncalled bet ($9) returned to janarr5
janarr5 collected $18.52 from pot
janarr5: doesn't show hand 
*** SUMMARY ***
Total pot $19.50 | Rake $0.98 
Board [7d Ac Js]
Seat 1: janarr5 collected ($18.52)
Seat 2: kl4ssic (button) folded before Flop (didn't bet)
Seat 3: dviryo (small blind) folded before Flop
Seat 4: Hayer ana (big blind) folded before Flop
Seat 5: sanpidk folded on the Flop
Seat 6: matiko09 folded before Flop (didn't bet)
Seat 7: spgreek folded before Flop (didn't bet)
Seat 8: vrnMike folded before Flop (didn't bet)
Seat 9: Dickyxxx folded before Flop (didn't bet)





PokerStars Hand #152886284916:  Hold'em No Limit ($1/$2 USD) - 2016/05/05 16:41:32 CET [2016/05/05 10:41:32 ET]
Table 'Tololo' 9-max Seat #3 is the button
Seat 1: Kukuryzka ($257.09 in chips) 
Seat 3: Khaine_CM ($200 in chips) 
Seat 4: mooose100 ($163.47 in chips) 
Seat 5: matiko09 ($200 in chips) 
Seat 6: Xagua ($153.70 in chips) 
Seat 7: chaps1988 ($281.42 in chips) 
Seat 8: myatiy 96 ($205.45 in chips) 
mooose100: posts small blind $1
matiko09: posts big blind $2
*** HOLE CARDS ***
Dealt to matiko09 [7c 8c]
Xagua: folds 
chaps1988: folds 
myatiy 96: folds 
Kukuryzka: raises $3 to $5
Khaine_CM: folds 
mooose100: calls $4
matiko09: calls $3
*** FLOP *** [2d 5d 8h]
mooose100: checks 
matiko09: bets $9.26
Kukuryzka: folds 
mooose100: folds 
Uncalled bet ($9.26) returned to matiko09
matiko09 collected $14.25 from pot
matiko09: doesn't show hand 
*** SUMMARY ***
Total pot $15 | Rake $0.75 
Board [2d 5d 8h]
Seat 1: Kukuryzka folded on the Flop
Seat 3: Khaine_CM (button) folded before Flop (didn't bet)
Seat 4: mooose100 (small blind) folded on the Flop
Seat 5: matiko09 (big blind) collected ($14.25)
Seat 6: Xagua folded before Flop (didn't bet)
Seat 7: chaps1988 folded before Flop (didn't bet)
Seat 8: myatiy 96 folded before Flop (didn't bet)





PokerStars Hand #152886287356:  Hold'em No Limit ($1/$2 USD) - 2016/05/05 16:41:36 CET [2016/05/05 10:41:36 ET]
Table 'Euporie II' 9-max Seat #6 is the button
Seat 2: kblkxls ($88.82 in chips) 
Seat 3: chaps1988 ($236.25 in chips) 
Seat 5: Nuskatko1986 ($60.52 in chips) 
Seat 6: Kukuryzka ($200 in chips) 
Seat 7: matiko09 ($219.61 in chips) 
Seat 8: Painkiller72 ($294.25 in chips) 
Seat 9: T0ny Adams ($96.98 in chips) 
matiko09: posts small blind $1
Painkiller72: posts big blind $2
PacPacBum: sits out 
*** HOLE CARDS ***
Dealt to matiko09 [3c 4s]
T0ny Adams: folds 
kblkxls: folds 
chaps1988: folds 
Nuskatko1986: calls $2
Kukuryzka: folds 
matiko09: folds 
Painkiller72: checks 
*** FLOP *** [4d 8d 3d]
Painkiller72: checks 
Nuskatko1986: checks 
*** TURN *** [4d 8d 3d] [5c]
Painkiller72: checks 
Nuskatko1986: bets $2
Painkiller72: calls $2
*** RIVER *** [4d 8d 3d 5c] [3s]
Painkiller72: checks 
Nuskatko1986: bets $16
Painkiller72: folds 
Uncalled bet ($16) returned to Nuskatko1986
Nuskatko1986 collected $8.55 from pot
Nuskatko1986: doesn't show hand 
*** SUMMARY ***
Total pot $9 | Rake $0.45 
Board [4d 8d 3d 5c 3s]
Seat 2: kblkxls folded before Flop (didn't bet)
Seat 3: chaps1988 folded before Flop (didn't bet)
Seat 5: Nuskatko1986 collected ($8.55)
Seat 6: Kukuryzka (button) folded before Flop (didn't bet)
Seat 7: matiko09 (small blind) folded before Flop
Seat 8: Painkiller72 (big blind) folded on the River
Seat 9: T0ny Adams folded before Flop (didn't bet)





PokerStars Hand #152886289156:  Hold'em No Limit ($1/$2 USD) - 2016/05/05 16:41:39 CET [2016/05/05 10:41:39 ET]
Table 'Samitchell' 9-max Seat #2 is the button
Seat 1: Kukuryzka ($202 in chips) 
Seat 2: matiko09 ($284.71 in chips) 
Seat 5: chaps1988 ($275.12 in chips) 
Seat 6: PacPacBum ($200 in chips) 
Seat 7: patpaty ($167.19 in chips) 
Seat 9: kblkxls ($138 in chips) 
han3bj will be allowed to play after the button
chaps1988: posts small blind $1
PacPacBum: posts big blind $2
tepi_guy: sits out 
*** HOLE CARDS ***
Dealt to matiko09 [5h Qh]
patpaty: folds 
kblkxls: folds 
Kukuryzka: raises $4 to $6
matiko09: folds 
chaps1988: folds 
PacPacBum: folds 
Uncalled bet ($4) returned to Kukuryzka
Kukuryzka collected $5 from pot
Kukuryzka: doesn't show hand 
*** SUMMARY ***
Total pot $5 | Rake $0 
Seat 1: Kukuryzka collected ($5)
Seat 2: matiko09 (button) folded before Flop (didn't bet)
Seat 5: chaps1988 (small blind) folded before Flop
Seat 6: PacPacBum (big blind) folded before Flop
Seat 7: patpaty folded before Flop (didn't bet)
Seat 9: kblkxls folded before Flop (didn't bet)





PokerStars Hand #152886289924:  Hold'em No Limit (€1/€2 EUR) - 2016/05/05 16:41:40 CET [2016/05/05 10:41:40 ET]
Table 'Bessel II' 9-max Seat #8 is the button
Seat 1: Soloaces224 (€113.09 in chips) 
Seat 3: PacPacBum (€230.94 in chips) 
Seat 4: Zorken76 (€160.82 in chips) 
Seat 5: Kukuryzka (€200 in chips) 
Seat 6: glanza_mike (€203 in chips) 
Seat 7: matiko09 (€200 in chips) 
Seat 8: chaps1988 (€254.52 in chips) 
Seat 9: JoaquinMRuiz (€200 in chips) 
JoaquinMRuiz: posts small blind €1
Soloaces224: posts big blind €2
*** HOLE CARDS ***
Dealt to matiko09 [2d 8c]
PacPacBum: folds 
Zorken76: folds 
Kukuryzka: folds 
glanza_mike: folds 
matiko09: folds 
chaps1988: folds 
JoaquinMRuiz: folds 
Uncalled bet (€1) returned to Soloaces224
Soloaces224 collected €2 from pot
Soloaces224: doesn't show hand 
*** SUMMARY ***
Total pot €2 | Rake €0 
Seat 1: Soloaces224 (big blind) collected (€2)
Seat 3: PacPacBum folded before Flop (didn't bet)
Seat 4: Zorken76 folded before Flop (didn't bet)
Seat 5: Kukuryzka folded before Flop (didn't bet)
Seat 6: glanza_mike folded before Flop (didn't bet)
Seat 7: matiko09 folded before Flop (didn't bet)
Seat 8: chaps1988 (button) folded before Flop (didn't bet)
Seat 9: JoaquinMRuiz (small blind) folded before Flop





PokerStars Hand #152886293258:  Hold'em No Limit (€1/€2 EUR) - 2016/05/05 16:41:46 CET [2016/05/05 10:41:46 ET]
Table 'Skat II' 9-max Seat #7 is the button
Seat 4: JoaquinMRuiz (€209.31 in chips) 
Seat 6: drissmouzou (€239.25 in chips) 
Seat 7: PacPacBum (€201.38 in chips) 
Seat 8: Painkiller72 (€208 in chips) 
Seat 9: matiko09 (€203 in chips) 
Painkiller72: posts small blind €1
matiko09: posts big blind €2
*** HOLE CARDS ***
Dealt to matiko09 [7d Ah]
JoaquinMRuiz: folds 
drissmouzou: raises €2 to €4
PacPacBum: calls €4
Painkiller72: folds 
matiko09: calls €2
*** FLOP *** [Kh 9c 2s]
matiko09: checks 
drissmouzou: checks 
PacPacBum: checks 
*** TURN *** [Kh 9c 2s] [Jc]
matiko09: checks 
drissmouzou: bets €12.35
PacPacBum: folds 
matiko09: folds 
Uncalled bet (€12.35) returned to drissmouzou
drissmouzou collected €12.35 from pot
drissmouzou: doesn't show hand 
*** SUMMARY ***
Total pot €13 | Rake €0.65 
Board [Kh 9c 2s Jc]
Seat 4: JoaquinMRuiz folded before Flop (didn't bet)
Seat 6: drissmouzou collected (€12.35)
Seat 7: PacPacBum (button) folded on the Turn
Seat 8: Painkiller72 (small blind) folded before Flop
Seat 9: matiko09 (big blind) folded on the Turn





PokerStars Hand #152886294943:  Hold'em No Limit ($1/$2 USD) - 2016/05/05 16:41:49 CET [2016/05/05 10:41:49 ET]
Table 'Tatry II' 9-max Seat #1 is the button
Seat 1: glanza_mike ($217.80 in chips) 
Seat 2: T0ny Adams ($65.74 in chips) 
Seat 3: matiko09 ($201.28 in chips) 
Seat 4: PacPacBum ($214.57 in chips) 
Seat 5: Painkiller72 ($327.05 in chips) 
Seat 6: Kukuryzka ($276.60 in chips) 
Seat 8: chaps1988 ($251.62 in chips) 
Seat 9: korol702 ($160.40 in chips) 
T0ny Adams: posts small blind $1
matiko09: posts big blind $2
*** HOLE CARDS ***
Dealt to matiko09 [2c 5s]
PacPacBum: raises $2.08 to $4.08
Painkiller72: folds 
Kukuryzka: folds 
chaps1988: calls $4.08
korol702: folds 
glanza_mike: folds 
T0ny Adams: folds 
matiko09: folds 
*** FLOP *** [Td 3h 4s]
PacPacBum: checks 
chaps1988: bets $6
PacPacBum: calls $6
*** TURN *** [Td 3h 4s] [6h]
PacPacBum: checks 
chaps1988: checks 
*** RIVER *** [Td 3h 4s 6h] [Jd]
PacPacBum: checks 
chaps1988: checks 
*** SHOW DOWN ***
PacPacBum: shows [7d 7h] (a pair of Sevens)
chaps1988: shows [9d 9c] (a pair of Nines)
chaps1988 collected $22 from pot
*** SUMMARY ***
Total pot $23.16 | Rake $1.16 
Board [Td 3h 4s 6h Jd]
Seat 1: glanza_mike (button) folded before Flop (didn't bet)
Seat 2: T0ny Adams (small blind) folded before Flop
Seat 3: matiko09 (big blind) folded before Flop
Seat 4: PacPacBum showed [7d 7h] and lost with a pair of Sevens
Seat 5: Painkiller72 folded before Flop (didn't bet)
Seat 6: Kukuryzka folded before Flop (didn't bet)
Seat 8: chaps1988 showed [9d 9c] and won ($22) with a pair of Nines
Seat 9: korol702 folded before Flop (didn't bet)





PokerStars Hand #152886300332:  Hold'em No Limit ($0.50/$1.00 USD) - 2016/05/05 16:41:57 CET [2016/05/05 10:41:57 ET]
Table 'Kraz II' 9-max Seat #6 is the button
Seat 2: sanpidk ($147.09 in chips) 
Seat 3: Khaine_CM ($106.98 in chips) 
Seat 5: Kukuryzka ($100 in chips) 
Seat 6: andy84lfc ($238.98 in chips) 
Seat 7: Dantist1122 ($121.15 in chips) 
Seat 9: matiko09 ($177.32 in chips) 
Dantist1122: posts small blind $0.50
Hayer ana: is sitting out 
Hayer ana leaves the table
matiko09: posts big blind $1
HITYESCA: sits out 
CI58: sits out 
*** HOLE CARDS ***
Dealt to matiko09 [Qd Js]
myatiy 96 joins the table at seat #8 
sanpidk: folds 
Khaine_CM: folds 
Kukuryzka: folds 
andy84lfc: raises $2 to $3
Dantist1122: folds 
myatiy 96 leaves the table
matiko09: calls $2
*** FLOP *** [9s 6c 3h]
matiko09: checks 
178013 joins the table at seat #8 
andy84lfc: bets $3.09
matiko09: folds 
Uncalled bet ($3.09) returned to andy84lfc
andy84lfc collected $6.18 from pot
*** SUMMARY ***
Total pot $6.50 | Rake $0.32 
Board [9s 6c 3h]
Seat 2: sanpidk folded before Flop (didn't bet)
Seat 3: Khaine_CM folded before Flop (didn't bet)
Seat 5: Kukuryzka folded before Flop (didn't bet)
Seat 6: andy84lfc (button) collected ($6.18)
Seat 7: Dantist1122 (small blind) folded before Flop
Seat 9: matiko09 (big blind) folded on the Flop





PokerStars Hand #152886299884:  Hold'em No Limit ($1/$2 USD) - 2016/05/05 16:41:57 CET [2016/05/05 10:41:57 ET]
Table 'Samitchell' 9-max Seat #5 is the button
Seat 1: Kukuryzka ($205 in chips) 
Seat 2: matiko09 ($284.71 in chips) 
Seat 3: han3bj ($200 in chips) 
Seat 5: chaps1988 ($274.12 in chips) 
Seat 6: PacPacBum ($200 in chips) 
Seat 7: patpaty ($167.19 in chips) 
Seat 9: kblkxls ($138 in chips) 
PacPacBum: posts small blind $1
patpaty: posts big blind $2
tepi_guy: sits out 
han3bj: posts big blind $2
*** HOLE CARDS ***
Dealt to matiko09 [3s Ac]
kblkxls: folds 
Kukuryzka: folds 
matiko09: folds 
han3bj: raises $4 to $6
chaps1988: folds 
PacPacBum: folds 
patpaty: folds 
Uncalled bet ($4) returned to han3bj
han3bj collected $5 from pot
han3bj: doesn't show hand 
*** SUMMARY ***
Total pot $5 | Rake $0 
Seat 1: Kukuryzka folded before Flop (didn't bet)
Seat 2: matiko09 folded before Flop (didn't bet)
Seat 3: han3bj collected ($5)
Seat 5: chaps1988 (button) folded before Flop (didn't bet)
Seat 6: PacPacBum (small blind) folded before Flop
Seat 7: patpaty (big blind) folded before Flop
Seat 9: kblkxls folded before Flop (didn't bet)





PokerStars Hand #152886303927:  Hold'em No Limit ($1/$2 USD) - 2016/05/05 16:42:03 CET [2016/05/05 10:42:03 ET]
Table 'Tololo' 9-max Seat #4 is the button
Seat 1: Kukuryzka ($252.09 in chips) 
Seat 3: Khaine_CM ($200 in chips) 
Seat 4: mooose100 ($158.47 in chips) 
Seat 5: matiko09 ($209.25 in chips) 
Seat 6: Xagua ($153.70 in chips) 
Seat 7: chaps1988 ($281.42 in chips) 
Seat 8: myatiy 96 ($205.45 in chips) 
matiko09: posts small blind $1
Xagua: posts big blind $2
tepi_guy: sits out 
*** HOLE CARDS ***
Dealt to matiko09 [6c Kc]
chaps1988: folds 
myatiy 96: folds 
Kukuryzka: raises $4 to $6
Khaine_CM: folds 
mooose100: folds 
matiko09: folds 
Xagua: folds 
Uncalled bet ($4) returned to Kukuryzka
Kukuryzka collected $5 from pot
Kukuryzka: doesn't show hand 
*** SUMMARY ***
Total pot $5 | Rake $0 
Seat 1: Kukuryzka collected ($5)
Seat 3: Khaine_CM folded before Flop (didn't bet)
Seat 4: mooose100 (button) folded before Flop (didn't bet)
Seat 5: matiko09 (small blind) folded before Flop
Seat 6: Xagua (big blind) folded before Flop
Seat 7: chaps1988 folded before Flop (didn't bet)
Seat 8: myatiy 96 folded before Flop (didn't bet)





PokerStars Hand #152886304650:  Hold'em No Limit (€1/€2 EUR) - 2016/05/05 16:42:04 CET [2016/05/05 10:42:04 ET]
Table 'Bessel II' 9-max Seat #9 is the button
Seat 1: Soloaces224 (€114.09 in chips) 
Seat 3: PacPacBum (€230.94 in chips) 
Seat 4: Zorken76 (€160.82 in chips) 
Seat 5: Kukuryzka (€200 in chips) 
Seat 6: glanza_mike (€203 in chips) 
Seat 7: matiko09 (€200 in chips) 
Seat 8: chaps1988 (€254.52 in chips) 
Seat 9: JoaquinMRuiz (€200 in chips) 
Soloaces224: posts small blind €1
PacPacBum: posts big blind €2
*** HOLE CARDS ***
Dealt to matiko09 [6s Ks]
Zorken76: folds 
Kukuryzka: folds 
glanza_mike: folds 
matiko09: folds 
chaps1988: folds 
JoaquinMRuiz: folds 
Soloaces224: raises €4 to €6
PacPacBum: raises €12 to €18
Soloaces224: calls €12
*** FLOP *** [9s 2s 2h]
Soloaces224: bets €17.10
PacPacBum: raises €195.84 to €212.94 and is all-in
Soloaces224: calls €78.99 and is all-in
Uncalled bet (€116.85) returned to PacPacBum
*** TURN *** [9s 2s 2h] [3s]
*** RIVER *** [9s 2s 2h 3s] [4s]
*** SHOW DOWN ***
Soloaces224: shows [8s 7s] (a flush, Nine high)
PacPacBum: mucks hand 
Soloaces224 collected €225.68 from pot
*** SUMMARY ***
Total pot €228.18 | Rake €2.50 
Board [9s 2s 2h 3s 4s]
Seat 1: Soloaces224 (small blind) showed [8s 7s] and won (€225.68) with a flush, Nine high
Seat 3: PacPacBum (big blind) mucked [Jc Jd]
Seat 4: Zorken76 folded before Flop (didn't bet)
Seat 5: Kukuryzka folded before Flop (didn't bet)
Seat 6: glanza_mike folded before Flop (didn't bet)
Seat 7: matiko09 folded before Flop (didn't bet)
Seat 8: chaps1988 folded before Flop (didn't bet)
Seat 9: JoaquinMRuiz (button) folded before Flop (didn't bet)





PokerStars Hand #152886306185:  Hold'em No Limit ($0.50/$1.00 USD) - 2016/05/05 16:42:07 CET [2016/05/05 10:42:07 ET]
Table 'Porzia' 9-max Seat #5 is the button
Seat 1: vrnMike ($134 in chips) 
Seat 2: matiko09 ($100.50 in chips) 
Seat 3: sanpidk ($100 in chips) 
Seat 4: Khaine_CM ($100 in chips) 
Seat 5: CZECHMYSAK ($40.72 in chips) 
Seat 6: janarr5 ($172.77 in chips) 
Seat 7: HITYESCA ($100 in chips) 
Seat 8: PRINCE JULIO ($80.19 in chips) 
Seat 9: kl4ssic ($45 in chips) 
janarr5: posts small blind $0.50
HITYESCA: posts big blind $1
*** HOLE CARDS ***
Dealt to matiko09 [Ts 4s]
PRINCE JULIO: folds 
kl4ssic: folds 
vrnMike: folds 
matiko09: folds 
sanpidk: folds 
Khaine_CM: folds 
CZECHMYSAK: folds 
janarr5: folds 
Uncalled bet ($0.50) returned to HITYESCA
HITYESCA collected $1 from pot
HITYESCA: doesn't show hand 
*** SUMMARY ***
Total pot $1 | Rake $0 
Seat 1: vrnMike folded before Flop (didn't bet)
Seat 2: matiko09 folded before Flop (didn't bet)
Seat 3: sanpidk folded before Flop (didn't bet)
Seat 4: Khaine_CM folded before Flop (didn't bet)
Seat 5: CZECHMYSAK (button) folded before Flop (didn't bet)
Seat 6: janarr5 (small blind) folded before Flop
Seat 7: HITYESCA (big blind) collected ($1)
Seat 8: PRINCE JULIO folded before Flop (didn't bet)
Seat 9: kl4ssic folded before Flop (didn't bet)





PokerStars Hand #152886308882:  Hold'em No Limit ($1/$2 USD) - 2016/05/05 16:42:11 CET [2016/05/05 10:42:11 ET]
Table 'Lundia' 9-max Seat #4 is the button
Seat 2: patpaty ($280.73 in chips) 
Seat 3: Painkiller72 ($249.50 in chips) 
Seat 4: PacPacBum ($200 in chips) 
Seat 5: zmOe84 ($158.32 in chips) 
Seat 6: CI58 ($277.98 in chips) 
Seat 7: matiko09 ($222.95 in chips) 
Seat 8: chaps1988 ($226.59 in chips) 
zmOe84: posts small blind $1
CI58: posts big blind $2
tepi_guy: sits out 
*** HOLE CARDS ***
Dealt to matiko09 [4c Ac]
matiko09: folds 
chaps1988: folds 
patpaty: folds 
Painkiller72: raises $3 to $5
PacPacBum: folds 
zmOe84: folds 
CI58: raises $13 to $18
Painkiller72: folds 
Uncalled bet ($13) returned to CI58
CI58 collected $11 from pot
CI58: doesn't show hand 
*** SUMMARY ***
Total pot $11 | Rake $0 
Seat 2: patpaty folded before Flop (didn't bet)
Seat 3: Painkiller72 folded before Flop
Seat 4: PacPacBum (button) folded before Flop (didn't bet)
Seat 5: zmOe84 (small blind) folded before Flop
Seat 6: CI58 (big blind) collected ($11)
Seat 7: matiko09 folded before Flop (didn't bet)
Seat 8: chaps1988 folded before Flop (didn't bet)





PokerStars Hand #152886311196:  Hold'em No Limit ($1/$2 USD) - 2016/05/05 16:42:15 CET [2016/05/05 10:42:15 ET]
Table 'Samitchell' 9-max Seat #6 is the button
Seat 1: Kukuryzka ($205 in chips) 
Seat 2: matiko09 ($284.71 in chips) 
Seat 3: han3bj ($203 in chips) 
Seat 5: chaps1988 ($274.12 in chips) 
Seat 6: PacPacBum ($200 in chips) 
Seat 7: patpaty ($165.19 in chips) 
Seat 8: tepi_guy ($200 in chips) 
Seat 9: kblkxls ($138 in chips) 
patpaty: posts small blind $1
tepi_guy: posts big blind $2
*** HOLE CARDS ***
Dealt to matiko09 [7d 3d]
kblkxls: folds 
Kukuryzka: folds 
matiko09: folds 
han3bj: folds 
chaps1988: folds 
PacPacBum: raises $2.08 to $4.08
patpaty: calls $3.08
tepi_guy: folds 
*** FLOP *** [4d 5c Jd]
patpaty: checks 
PacPacBum: bets $3.37
patpaty: folds 
Uncalled bet ($3.37) returned to PacPacBum
PacPacBum collected $9.65 from pot
PacPacBum: doesn't show hand 
*** SUMMARY ***
Total pot $10.16 | Rake $0.51 
Board [4d 5c Jd]
Seat 1: Kukuryzka folded before Flop (didn't bet)
Seat 2: matiko09 folded before Flop (didn't bet)
Seat 3: han3bj folded before Flop (didn't bet)
Seat 5: chaps1988 folded before Flop (didn't bet)
Seat 6: PacPacBum (button) collected ($9.65)
Seat 7: patpaty (small blind) folded on the Flop
Seat 8: tepi_guy (big blind) folded before Flop
Seat 9: kblkxls folded before Flop (didn't bet)





PokerStars Hand #152886314475:  Hold'em No Limit ($1/$2 USD) - 2016/05/05 16:42:21 CET [2016/05/05 10:42:21 ET]
Table 'Tololo' 9-max Seat #5 is the button
Seat 1: Kukuryzka ($255.09 in chips) 
Seat 3: Khaine_CM ($200 in chips) 
Seat 4: mooose100 ($158.47 in chips) 
Seat 5: matiko09 ($208.25 in chips) 
Seat 6: Xagua ($151.70 in chips) 
Seat 7: chaps1988 ($281.42 in chips) 
Seat 8: myatiy 96 ($205.45 in chips) 
Xagua: posts small blind $1
chaps1988: posts big blind $2
tepi_guy: sits out 
*** HOLE CARDS ***
Dealt to matiko09 [Qs 5h]
myatiy 96: folds 
Kukuryzka: folds 
Khaine_CM: folds 
mooose100: folds 
matiko09: folds 
Xagua: folds 
Uncalled bet ($1) returned to chaps1988
chaps1988 collected $2 from pot
*** SUMMARY ***
Total pot $2 | Rake $0 
Seat 1: Kukuryzka folded before Flop (didn't bet)
Seat 3: Khaine_CM folded before Flop (didn't bet)
Seat 4: mooose100 folded before Flop (didn't bet)
Seat 5: matiko09 (button) folded before Flop (didn't bet)
Seat 6: Xagua (small blind) folded before Flop
Seat 7: chaps1988 (big blind) collected ($2)
Seat 8: myatiy 96 folded before Flop (didn't bet)





PokerStars Hand #152886319415:  Hold'em No Limit ($0.50/$1.00 USD) - 2016/05/05 16:42:29 CET [2016/05/05 10:42:29 ET]
Table 'Porzia' 9-max Seat #6 is the button
Seat 1: vrnMike ($134 in chips) 
Seat 2: matiko09 ($100.50 in chips) 
Seat 3: sanpidk ($100 in chips) 
Seat 4: Khaine_CM ($100 in chips) 
Seat 5: CZECHMYSAK ($40.72 in chips) 
Seat 6: janarr5 ($172.27 in chips) 
Seat 7: HITYESCA ($100.50 in chips) 
Seat 8: PRINCE JULIO ($80.19 in chips) 
Seat 9: kl4ssic ($45 in chips) 
HITYESCA: posts small blind $0.50
PRINCE JULIO: posts big blind $1
*** HOLE CARDS ***
Dealt to matiko09 [8d 8h]
kl4ssic: folds 
vrnMike: folds 
matiko09: raises $2 to $3
sanpidk: folds 
Khaine_CM: folds 
CZECHMYSAK: folds 
janarr5: folds 
HITYESCA: calls $2.50
PRINCE JULIO: folds 
*** FLOP *** [Jc Ah Qs]
HITYESCA: checks 
matiko09: checks 
*** TURN *** [Jc Ah Qs] [Ks]
HITYESCA: checks 
matiko09: checks 
*** RIVER *** [Jc Ah Qs Ks] [6d]
HITYESCA: checks 
matiko09: checks 
*** SHOW DOWN ***
HITYESCA: shows [Qc Ad] (two pair, Aces and Queens)
matiko09: mucks hand 
HITYESCA collected $6.65 from pot
*** SUMMARY ***
Total pot $7 | Rake $0.35 
Board [Jc Ah Qs Ks 6d]
Seat 1: vrnMike folded before Flop (didn't bet)
Seat 2: matiko09 mucked [8d 8h]
Seat 3: sanpidk folded before Flop (didn't bet)
Seat 4: Khaine_CM folded before Flop (didn't bet)
Seat 5: CZECHMYSAK folded before Flop (didn't bet)
Seat 6: janarr5 (button) folded before Flop (didn't bet)
Seat 7: HITYESCA (small blind) showed [Qc Ad] and won ($6.65) with two pair, Aces and Queens
Seat 8: PRINCE JULIO (big blind) folded before Flop
Seat 9: kl4ssic folded before Flop (didn't bet)





PokerStars Hand #152886322994:  Hold'em No Limit (€1/€2 EUR) - 2016/05/05 16:42:34 CET [2016/05/05 10:42:34 ET]
Table 'Skat II' 9-max Seat #8 is the button
Seat 4: JoaquinMRuiz (€209.31 in chips) 
Seat 6: drissmouzou (€247.60 in chips) 
Seat 7: PacPacBum (€200 in chips) 
Seat 8: Painkiller72 (€207 in chips) 
Seat 9: matiko09 (€200 in chips) 
matiko09: posts small blind €1
JoaquinMRuiz: posts big blind €2
*** HOLE CARDS ***
Dealt to matiko09 [Tc 2c]
drissmouzou: folds 
PacPacBum: folds 
Painkiller72: folds 
matiko09: folds 
Uncalled bet (€1) returned to JoaquinMRuiz
JoaquinMRuiz collected €2 from pot
*** SUMMARY ***
Total pot €2 | Rake €0 
Seat 4: JoaquinMRuiz (big blind) collected (€2)
Seat 6: drissmouzou folded before Flop (didn't bet)
Seat 7: PacPacBum folded before Flop (didn't bet)
Seat 8: Painkiller72 (button) folded before Flop (didn't bet)
Seat 9: matiko09 (small blind) folded before Flop





PokerStars Hand #152886323873:  Hold'em No Limit ($1/$2 USD) - 2016/05/05 16:42:36 CET [2016/05/05 10:42:36 ET]
Table 'Euporie II' 9-max Seat #7 is the button
Seat 2: kblkxls ($88.82 in chips) 
Seat 3: chaps1988 ($236.25 in chips) 
Seat 5: Nuskatko1986 ($65.07 in chips) 
Seat 6: Kukuryzka ($200 in chips) 
Seat 7: matiko09 ($218.61 in chips) 
Seat 8: Painkiller72 ($290.25 in chips) 
Seat 9: T0ny Adams ($96.98 in chips) 
Painkiller72: posts small blind $1
T0ny Adams: posts big blind $2
PacPacBum: sits out 
*** HOLE CARDS ***
Dealt to matiko09 [Qd Ks]
kblkxls: folds 
chaps1988: folds 
Nuskatko1986: folds 
Kukuryzka: raises $3 to $5
matiko09: raises $11 to $16
Painkiller72: folds 
T0ny Adams: folds 
Kukuryzka: folds 
Uncalled bet ($11) returned to matiko09
matiko09 collected $13 from pot
matiko09: doesn't show hand 
*** SUMMARY ***
Total pot $13 | Rake $0 
Seat 2: kblkxls folded before Flop (didn't bet)
Seat 3: chaps1988 folded before Flop (didn't bet)
Seat 5: Nuskatko1986 folded before Flop (didn't bet)
Seat 6: Kukuryzka folded before Flop
Seat 7: matiko09 (button) collected ($13)
Seat 8: Painkiller72 (small blind) folded before Flop
Seat 9: T0ny Adams (big blind) folded before Flop





PokerStars Hand #152886324364:  Hold'em No Limit ($1/$2 USD) - 2016/05/05 16:42:37 CET [2016/05/05 10:42:37 ET]
Table 'Tololo' 9-max Seat #6 is the button
Seat 1: Kukuryzka ($255.09 in chips) 
Seat 3: Khaine_CM ($200 in chips) 
Seat 4: mooose100 ($158.47 in chips) 
Seat 5: matiko09 ($208.25 in chips) 
Seat 6: Xagua ($150.70 in chips) 
Seat 7: chaps1988 ($282.42 in chips) 
Seat 8: myatiy 96 ($205.45 in chips) 
chaps1988: posts small blind $1
myatiy 96: posts big blind $2
tepi_guy: sits out 
*** HOLE CARDS ***
Dealt to matiko09 [Qs Qc]
Kukuryzka: folds 
Khaine_CM: raises $4 to $6
mooose100: folds 
matiko09: calls $6
Xagua: folds 
chaps1988: folds 
myatiy 96: calls $4
*** FLOP *** [6d As Ad]
myatiy 96: checks 
Khaine_CM: bets $12
matiko09: calls $12
myatiy 96: folds 
*** TURN *** [6d As Ad] [Ac]
Khaine_CM: checks 
matiko09: bets $20
Khaine_CM: folds 
Uncalled bet ($20) returned to matiko09
matiko09 collected $40.85 from pot
matiko09: doesn't show hand 
*** SUMMARY ***
Total pot $43 | Rake $2.15 
Board [6d As Ad Ac]
Seat 1: Kukuryzka folded before Flop (didn't bet)
Seat 3: Khaine_CM folded on the Turn
Seat 4: mooose100 folded before Flop (didn't bet)
Seat 5: matiko09 collected ($40.85)
Seat 6: Xagua (button) folded before Flop (didn't bet)
Seat 7: chaps1988 (small blind) folded before Flop
Seat 8: myatiy 96 (big blind) folded on the Flop





PokerStars Hand #152886326867:  Hold'em No Limit ($1/$2 USD) - 2016/05/05 16:42:41 CET [2016/05/05 10:42:41 ET]
Table 'Tatry II' 9-max Seat #2 is the button
Seat 1: glanza_mike ($217.80 in chips) 
Seat 2: T0ny Adams ($64.74 in chips) 
Seat 3: matiko09 ($200 in chips) 
Seat 4: PacPacBum ($204.49 in chips) 
Seat 5: Painkiller72 ($327.05 in chips) 
Seat 6: Kukuryzka ($276.60 in chips) 
Seat 8: chaps1988 ($263.54 in chips) 
Seat 9: korol702 ($160.40 in chips) 
matiko09: posts small blind $1
PacPacBum: posts big blind $2
*** HOLE CARDS ***
Dealt to matiko09 [Tc Kh]
Painkiller72: folds 
Kukuryzka: folds 
chaps1988: raises $3 to $5
korol702: folds 
glanza_mike: folds 
T0ny Adams: folds 
matiko09: folds 
PacPacBum: raises $11 to $16
chaps1988: folds 
Uncalled bet ($11) returned to PacPacBum
PacPacBum collected $11 from pot
PacPacBum: doesn't show hand 
*** SUMMARY ***
Total pot $11 | Rake $0 
Seat 1: glanza_mike folded before Flop (didn't bet)
Seat 2: T0ny Adams (button) folded before Flop (didn't bet)
Seat 3: matiko09 (small blind) folded before Flop
Seat 4: PacPacBum (big blind) collected ($11)
Seat 5: Painkiller72 folded before Flop (didn't bet)
Seat 6: Kukuryzka folded before Flop (didn't bet)
Seat 8: chaps1988 folded before Flop
Seat 9: korol702 folded before Flop (didn't bet)





PokerStars Hand #152886327347:  Hold'em No Limit ($0.50/$1.00 USD) - 2016/05/05 16:42:42 CET [2016/05/05 10:42:42 ET]
Table 'Kraz II' 9-max Seat #7 is the button
Seat 1: HITYESCA ($100 in chips) 
Seat 2: sanpidk ($147.09 in chips) 
Seat 3: Khaine_CM ($106.98 in chips) 
Seat 5: Kukuryzka ($100 in chips) 
Seat 6: andy84lfc ($242.16 in chips) 
Seat 7: Dantist1122 ($120.65 in chips) 
Seat 9: matiko09 ($174.32 in chips) 
178013 will be allowed to play after the button
matiko09: posts small blind $0.50
HITYESCA: posts big blind $1
CI58: sits out 
*** HOLE CARDS ***
Dealt to matiko09 [As Jh]
sanpidk: folds 
Khaine_CM: folds 
Kukuryzka: folds 
andy84lfc: folds 
Dantist1122: raises $1.05 to $2.05
matiko09: raises $6.45 to $8.50
HITYESCA: folds 
Dantist1122: folds 
Uncalled bet ($6.45) returned to matiko09
matiko09 collected $5.10 from pot
matiko09: doesn't show hand 
*** SUMMARY ***
Total pot $5.10 | Rake $0 
Seat 1: HITYESCA (big blind) folded before Flop
Seat 2: sanpidk folded before Flop (didn't bet)
Seat 3: Khaine_CM folded before Flop (didn't bet)
Seat 5: Kukuryzka folded before Flop (didn't bet)
Seat 6: andy84lfc folded before Flop (didn't bet)
Seat 7: Dantist1122 (button) folded before Flop
Seat 9: matiko09 (small blind) collected ($5.10)





PokerStars Hand #152886329549:  Hold'em No Limit ($1/$2 USD) - 2016/05/05 16:42:45 CET [2016/05/05 10:42:45 ET]
Table 'Lundia' 9-max Seat #5 is the button
Seat 2: patpaty ($280.73 in chips) 
Seat 3: Painkiller72 ($244.50 in chips) 
Seat 4: PacPacBum ($200 in chips) 
Seat 5: zmOe84 ($157.32 in chips) 
Seat 6: CI58 ($283.98 in chips) 
Seat 7: matiko09 ($222.95 in chips) 
Seat 8: chaps1988 ($226.59 in chips) 
CI58: posts small blind $1
matiko09: posts big blind $2
tepi_guy: sits out 
*** HOLE CARDS ***
Dealt to matiko09 [6s Jc]
chaps1988: folds 
patpaty: calls $2
Painkiller72: raises $7 to $9
PacPacBum: folds 
zmOe84: calls $9
CI58: folds 
matiko09: folds 
patpaty: calls $7
*** FLOP *** [2s 7h 6c]
patpaty: checks 
Painkiller72: checks 
zmOe84: checks 
*** TURN *** [2s 7h 6c] [4s]
patpaty: bets $6
Painkiller72: raises $20.25 to $26.25
zmOe84: raises $122.07 to $148.32 and is all-in
patpaty: folds 
Painkiller72: folds 
Uncalled bet ($122.07) returned to zmOe84
zmOe84 collected $85.75 from pot
zmOe84: doesn't show hand 
*** SUMMARY ***
Total pot $88.50 | Rake $2.75 
Board [2s 7h 6c 4s]
Seat 2: patpaty folded on the Turn
Seat 3: Painkiller72 folded on the Turn
Seat 4: PacPacBum folded before Flop (didn't bet)
Seat 5: zmOe84 (button) collected ($85.75)
Seat 6: CI58 (small blind) folded before Flop
Seat 7: matiko09 (big blind) folded before Flop
Seat 8: chaps1988 folded before Flop (didn't bet)





PokerStars Hand #152886333101:  Hold'em No Limit (€1/€2 EUR) - 2016/05/05 16:42:51 CET [2016/05/05 10:42:51 ET]
Table 'Skat II' 9-max Seat #9 is the button
Seat 4: JoaquinMRuiz (€210.31 in chips) 
Seat 6: drissmouzou (€247.60 in chips) 
Seat 7: PacPacBum (€200 in chips) 
Seat 8: Painkiller72 (€207 in chips) 
Seat 9: matiko09 (€200 in chips) 
JoaquinMRuiz: posts small blind €1
drissmouzou: posts big blind €2
*** HOLE CARDS ***
Dealt to matiko09 [2c 4c]
PacPacBum: folds 
Painkiller72: folds 
matiko09: folds 
JoaquinMRuiz: folds 
Uncalled bet (€1) returned to drissmouzou
drissmouzou collected €2 from pot
drissmouzou: doesn't show hand 
*** SUMMARY ***
Total pot €2 | Rake €0 
Seat 4: JoaquinMRuiz (small blind) folded before Flop
Seat 6: drissmouzou (big blind) collected (€2)
Seat 7: PacPacBum folded before Flop (didn't bet)
Seat 8: Painkiller72 folded before Flop (didn't bet)
Seat 9: matiko09 (button) folded before Flop (didn't bet)





PokerStars Hand #152886338953:  Hold'em No Limit ($1/$2 USD) - 2016/05/05 16:43:00 CET [2016/05/05 10:43:00 ET]
Table 'Samitchell' 9-max Seat #7 is the button
Seat 1: Kukuryzka ($205 in chips) 
Seat 2: matiko09 ($284.71 in chips) 
Seat 3: han3bj ($203 in chips) 
Seat 5: chaps1988 ($274.12 in chips) 
Seat 6: PacPacBum ($205.57 in chips) 
Seat 7: patpaty ($161.11 in chips) 
Seat 8: tepi_guy ($200 in chips) 
Seat 9: kblkxls ($138 in chips) 
tepi_guy: posts small blind $1
kblkxls: posts big blind $2
*** HOLE CARDS ***
Dealt to matiko09 [3c 6h]
Kukuryzka: folds 
matiko09: folds 
han3bj: folds 
chaps1988: folds 
PacPacBum: folds 
patpaty: folds 
tepi_guy: raises $3.40 to $5.40
kblkxls: raises $9.60 to $15
tepi_guy: folds 
Uncalled bet ($9.60) returned to kblkxls
kblkxls collected $10.80 from pot
kblkxls: doesn't show hand 
*** SUMMARY ***
Total pot $10.80 | Rake $0 
Seat 1: Kukuryzka folded before Flop (didn't bet)
Seat 2: matiko09 folded before Flop (didn't bet)
Seat 3: han3bj folded before Flop (didn't bet)
Seat 5: chaps1988 folded before Flop (didn't bet)
Seat 6: PacPacBum folded before Flop (didn't bet)
Seat 7: patpaty (button) folded before Flop (didn't bet)
Seat 8: tepi_guy (small blind) folded before Flop
Seat 9: kblkxls (big blind) collected ($10.80)





PokerStars Hand #152886344560:  Hold'em No Limit ($1/$2 USD) - 2016/05/05 16:43:10 CET [2016/05/05 10:43:10 ET]
Table 'Euporie II' 9-max Seat #8 is the button
Seat 1: PacPacBum ($200 in chips) 
Seat 2: kblkxls ($88.82 in chips) 
Seat 3: chaps1988 ($236.25 in chips) 
Seat 5: Nuskatko1986 ($65.07 in chips) 
Seat 6: Kukuryzka ($200 in chips) 
Seat 7: matiko09 ($226.61 in chips) 
Seat 8: Painkiller72 ($289.25 in chips) 
Seat 9: T0ny Adams ($94.98 in chips) 
T0ny Adams: posts small blind $1
PacPacBum: posts big blind $2
*** HOLE CARDS ***
Dealt to matiko09 [7h 4c]
kblkxls: folds 
chaps1988: folds 
Nuskatko1986 has timed out
Nuskatko1986: folds 
Kukuryzka: folds 
matiko09: folds 
Painkiller72: folds 
T0ny Adams: raises $2.50 to $4.50
PacPacBum: raises $8.50 to $13
T0ny Adams: folds 
Uncalled bet ($8.50) returned to PacPacBum
PacPacBum collected $9 from pot
PacPacBum: doesn't show hand 
*** SUMMARY ***
Total pot $9 | Rake $0 
Seat 1: PacPacBum (big blind) collected ($9)
Seat 2: kblkxls folded before Flop (didn't bet)
Seat 3: chaps1988 folded before Flop (didn't bet)
Seat 5: Nuskatko1986 folded before Flop (didn't bet)
Seat 6: Kukuryzka folded before Flop (didn't bet)
Seat 7: matiko09 folded before Flop (didn't bet)
Seat 8: Painkiller72 (button) folded before Flop (didn't bet)
Seat 9: T0ny Adams (small blind) folded before Flop





PokerStars Hand #152886351845:  Hold'em No Limit ($0.50/$1.00 USD) - 2016/05/05 16:43:22 CET [2016/05/05 10:43:22 ET]
Table 'Kraz II' 9-max Seat #9 is the button
Seat 1: HITYESCA ($100 in chips) 
Seat 2: sanpidk ($147.09 in chips) 
Seat 3: Khaine_CM ($106.98 in chips) 
Seat 5: Kukuryzka ($100 in chips) 
Seat 6: andy84lfc ($242.16 in chips) 
Seat 7: Dantist1122 ($118.60 in chips) 
Seat 8: 178013 ($100 in chips) 
Seat 9: matiko09 ($177.37 in chips) 
HITYESCA: posts small blind $0.50
sanpidk: posts big blind $1
CI58: sits out 
178013: posts big blind $1
*** HOLE CARDS ***
Dealt to matiko09 [5h 3c]
Khaine_CM: folds 
Kukuryzka: folds 
andy84lfc: raises $2 to $3
Dantist1122: folds 
178013: calls $2
matiko09: folds 
HITYESCA: folds 
sanpidk: folds 
*** FLOP *** [As 8h 6h]
andy84lfc: bets $3.56
178013: folds 
Uncalled bet ($3.56) returned to andy84lfc
andy84lfc collected $7.12 from pot
*** SUMMARY ***
Total pot $7.50 | Rake $0.38 
Board [As 8h 6h]
Seat 1: HITYESCA (small blind) folded before Flop
Seat 2: sanpidk (big blind) folded before Flop
Seat 3: Khaine_CM folded before Flop (didn't bet)
Seat 5: Kukuryzka folded before Flop (didn't bet)
Seat 6: andy84lfc collected ($7.12)
Seat 7: Dantist1122 folded before Flop (didn't bet)
Seat 8: 178013 folded on the Flop
Seat 9: matiko09 (button) folded before Flop (didn't bet)





PokerStars Hand #152886352033:  Hold'em No Limit (€1/€2 EUR) - 2016/05/05 16:43:22 CET [2016/05/05 10:43:22 ET]
Table 'Skat II' 9-max Seat #4 is the button
Seat 4: JoaquinMRuiz (€209.31 in chips) 
Seat 6: drissmouzou (€248.60 in chips) 
Seat 7: PacPacBum (€200 in chips) 
Seat 8: Painkiller72 (€207 in chips) 
Seat 9: matiko09 (€200 in chips) 
drissmouzou: posts small blind €1
PacPacBum: posts big blind €2
*** HOLE CARDS ***
Dealt to matiko09 [Jd Qd]
Painkiller72: folds 
matiko09: raises €3 to €5
JoaquinMRuiz: raises €11 to €16
drissmouzou: folds 
PacPacBum: folds 
matiko09: calls €11
*** FLOP *** [Kh Ts 8d]
matiko09: checks 
JoaquinMRuiz: bets €15.63
matiko09: calls €15.63
*** TURN *** [Kh Ts 8d] [3c]
matiko09: checks 
JoaquinMRuiz: bets €37.16
matiko09: folds 
Uncalled bet (€37.16) returned to JoaquinMRuiz
JoaquinMRuiz collected €63.76 from pot
*** SUMMARY ***
Total pot €66.26 | Rake €2.50 
Board [Kh Ts 8d 3c]
Seat 4: JoaquinMRuiz (button) collected (€63.76)
Seat 6: drissmouzou (small blind) folded before Flop
Seat 7: PacPacBum (big blind) folded before Flop
Seat 8: Painkiller72 folded before Flop (didn't bet)
Seat 9: matiko09 folded on the Turn





PokerStars Hand #152886352432:  Hold'em No Limit ($0.50/$1.00 USD) - 2016/05/05 16:43:23 CET [2016/05/05 10:43:23 ET]
Table 'Porzia' 9-max Seat #7 is the button
Seat 1: vrnMike ($134 in chips) 
Seat 2: matiko09 ($100 in chips) 
Seat 3: sanpidk ($100 in chips) 
Seat 4: Khaine_CM ($100 in chips) 
Seat 5: CZECHMYSAK ($40.72 in chips) 
Seat 6: janarr5 ($172.27 in chips) 
Seat 7: HITYESCA ($104.15 in chips) 
Seat 8: PRINCE JULIO ($79.19 in chips) 
Seat 9: kl4ssic ($45 in chips) 
PRINCE JULIO: posts small blind $0.50
kl4ssic: posts big blind $1
*** HOLE CARDS ***
Dealt to matiko09 [2c 4s]
vrnMike: folds 
matiko09: folds 
sanpidk: folds 
Khaine_CM: folds 
CZECHMYSAK: raises $1 to $2
janarr5: folds 
HITYESCA: calls $2
PRINCE JULIO: folds 
kl4ssic: calls $1
*** FLOP *** [9h 9s Ts]
kl4ssic: checks 
CZECHMYSAK: checks 
HITYESCA: checks 
*** TURN *** [9h 9s Ts] [Th]
kl4ssic: bets $4
CZECHMYSAK: calls $4
HITYESCA: folds 
*** RIVER *** [9h 9s Ts Th] [Qh]
kl4ssic: bets $13
CZECHMYSAK: calls $13
*** SHOW DOWN ***
kl4ssic: shows [3d 6s] (two pair, Tens and Nines)
CZECHMYSAK: shows [Ah Jc] (two pair, Tens and Nines - Ace kicker)
CZECHMYSAK collected $38.48 from pot
*** SUMMARY ***
Total pot $40.50 | Rake $2.02 
Board [9h 9s Ts Th Qh]
Seat 1: vrnMike folded before Flop (didn't bet)
Seat 2: matiko09 folded before Flop (didn't bet)
Seat 3: sanpidk folded before Flop (didn't bet)
Seat 4: Khaine_CM folded before Flop (didn't bet)
Seat 5: CZECHMYSAK showed [Ah Jc] and won ($38.48) with two pair, Tens and Nines
Seat 6: janarr5 folded before Flop (didn't bet)
Seat 7: HITYESCA (button) folded on the Turn
Seat 8: PRINCE JULIO (small blind) folded before Flop
Seat 9: kl4ssic (big blind) showed [3d 6s] and lost with two pair, Tens and Nines





PokerStars Hand #152886353717:  Hold'em No Limit (€1/€2 EUR) - 2016/05/05 16:43:25 CET [2016/05/05 10:43:25 ET]
Table 'Bessel II' 9-max Seat #1 is the button
Seat 1: Soloaces224 (€225.68 in chips) 
Seat 3: PacPacBum (€200 in chips) 
Seat 4: Zorken76 (€160.82 in chips) 
Seat 5: Kukuryzka (€200 in chips) 
Seat 6: glanza_mike (€203 in chips) 
Seat 7: matiko09 (€200 in chips) 
Seat 8: chaps1988 (€254.52 in chips) 
Seat 9: JoaquinMRuiz (€200 in chips) 
PacPacBum: posts small blind €1
Zorken76: posts big blind €2
*** HOLE CARDS ***
Dealt to matiko09 [7c Jc]
Kukuryzka: folds 
glanza_mike: folds 
matiko09: folds 
chaps1988: folds 
JoaquinMRuiz: folds 
Soloaces224: calls €2
PacPacBum: folds 
Zorken76: checks 
*** FLOP *** [9h 4h 3h]
Zorken76: checks 
Soloaces224: bets €2
Zorken76: folds 
Uncalled bet (€2) returned to Soloaces224
Soloaces224 collected €4.75 from pot
Soloaces224: doesn't show hand 
*** SUMMARY ***
Total pot €5 | Rake €0.25 
Board [9h 4h 3h]
Seat 1: Soloaces224 (button) collected (€4.75)
Seat 3: PacPacBum (small blind) folded before Flop
Seat 4: Zorken76 (big blind) folded on the Flop
Seat 5: Kukuryzka folded before Flop (didn't bet)
Seat 6: glanza_mike folded before Flop (didn't bet)
Seat 7: matiko09 folded before Flop (didn't bet)
Seat 8: chaps1988 folded before Flop (didn't bet)
Seat 9: JoaquinMRuiz folded before Flop (didn't bet)





PokerStars Hand #152886363153:  Hold'em No Limit ($1/$2 USD) - 2016/05/05 16:43:40 CET [2016/05/05 10:43:40 ET]
Table 'Tatry II' 9-max Seat #3 is the button
Seat 1: glanza_mike ($217.80 in chips) 
Seat 2: T0ny Adams ($64.74 in chips) 
Seat 3: matiko09 ($200 in chips) 
Seat 4: PacPacBum ($210.49 in chips) 
Seat 5: Painkiller72 ($327.05 in chips) 
Seat 6: Kukuryzka ($276.60 in chips) 
Seat 8: chaps1988 ($258.54 in chips) 
Seat 9: korol702 ($160.40 in chips) 
PacPacBum: posts small blind $1
Painkiller72: posts big blind $2
*** HOLE CARDS ***
Dealt to matiko09 [6s 2h]
Kukuryzka: folds 
chaps1988: folds 
korol702: folds 
glanza_mike: folds 
T0ny Adams: raises $2.68 to $4.68
matiko09: folds 
PacPacBum: raises $11.32 to $16
Painkiller72: folds 
T0ny Adams: folds 
Uncalled bet ($11.32) returned to PacPacBum
PacPacBum collected $11.36 from pot
PacPacBum: doesn't show hand 
*** SUMMARY ***
Total pot $11.36 | Rake $0 
Seat 1: glanza_mike folded before Flop (didn't bet)
Seat 2: T0ny Adams folded before Flop
Seat 3: matiko09 (button) folded before Flop (didn't bet)
Seat 4: PacPacBum (small blind) collected ($11.36)
Seat 5: Painkiller72 (big blind) folded before Flop
Seat 6: Kukuryzka folded before Flop (didn't bet)
Seat 8: chaps1988 folded before Flop (didn't bet)
Seat 9: korol702 folded before Flop (didn't bet)





PokerStars Hand #152886370475:  Hold'em No Limit ($1/$2 USD) - 2016/05/05 16:43:52 CET [2016/05/05 10:43:52 ET]
Table 'Tololo' 9-max Seat #7 is the button
Seat 1: Kukuryzka ($255.09 in chips) 
Seat 3: Khaine_CM ($200 in chips) 
Seat 4: mooose100 ($158.47 in chips) 
Seat 5: matiko09 ($231.10 in chips) 
Seat 6: Xagua ($150.70 in chips) 
Seat 7: chaps1988 ($281.42 in chips) 
Seat 8: myatiy 96 ($200 in chips) 
myatiy 96: posts small blind $1
Kukuryzka: posts big blind $2
tepi_guy: sits out 
*** HOLE CARDS ***
Dealt to matiko09 [8c Tc]
Khaine_CM: folds 
mooose100: folds 
matiko09: folds 
Xagua: folds 
chaps1988: folds 
myatiy 96: raises $4 to $6
Kukuryzka: raises $12 to $18
myatiy 96: calls $12
*** FLOP *** [9h 6s Td]
myatiy 96: checks 
Kukuryzka: bets $17.10
myatiy 96: folds 
Uncalled bet ($17.10) returned to Kukuryzka
Kukuryzka collected $34.20 from pot
Kukuryzka: doesn't show hand 
*** SUMMARY ***
Total pot $36 | Rake $1.80 
Board [9h 6s Td]
Seat 1: Kukuryzka (big blind) collected ($34.20)
Seat 3: Khaine_CM folded before Flop (didn't bet)
Seat 4: mooose100 folded before Flop (didn't bet)
Seat 5: matiko09 folded before Flop (didn't bet)
Seat 6: Xagua folded before Flop (didn't bet)
Seat 7: chaps1988 (button) folded before Flop (didn't bet)
Seat 8: myatiy 96 (small blind) folded on the Flop





PokerStars Hand #152886376752:  Hold'em No Limit ($1/$2 USD) - 2016/05/05 16:44:02 CET [2016/05/05 10:44:02 ET]
Table 'Lundia' 9-max Seat #6 is the button
Seat 2: patpaty ($265.73 in chips) 
Seat 3: Painkiller72 ($209.25 in chips) 
Seat 4: PacPacBum ($200 in chips) 
Seat 5: zmOe84 ($207.82 in chips) 
Seat 6: CI58 ($282.98 in chips) 
Seat 7: matiko09 ($220.95 in chips) 
Seat 8: chaps1988 ($226.59 in chips) 
matiko09: posts small blind $1
chaps1988: posts big blind $2
tepi_guy: sits out 
*** HOLE CARDS ***
Dealt to matiko09 [Qc Ts]
patpaty: calls $2
Painkiller72: folds 
PacPacBum: folds 
zmOe84: folds 
CI58: folds 
matiko09: calls $1
chaps1988: checks 
*** FLOP *** [Qs 2h 7d]
matiko09: bets $3.71
chaps1988: folds 
patpaty: calls $3.71
*** TURN *** [Qs 2h 7d] [5s]
matiko09: bets $8
patpaty: calls $8
*** RIVER *** [Qs 2h 7d 5s] [As]
matiko09: checks 
patpaty: checks 
*** SHOW DOWN ***
matiko09: shows [Qc Ts] (a pair of Queens)
patpaty: mucks hand 
matiko09 collected $27.95 from pot
*** SUMMARY ***
Total pot $29.42 | Rake $1.47 
Board [Qs 2h 7d 5s As]
Seat 2: patpaty mucked [8s 8c]
Seat 3: Painkiller72 folded before Flop (didn't bet)
Seat 4: PacPacBum folded before Flop (didn't bet)
Seat 5: zmOe84 folded before Flop (didn't bet)
Seat 6: CI58 (button) folded before Flop (didn't bet)
Seat 7: matiko09 (small blind) showed [Qc Ts] and won ($27.95) with a pair of Queens
Seat 8: chaps1988 (big blind) folded on the Flop





PokerStars Hand #152886378631:  Hold'em No Limit ($1/$2 USD) - 2016/05/05 16:44:05 CET [2016/05/05 10:44:05 ET]
Table 'Samitchell' 9-max Seat #8 is the button
Seat 1: Kukuryzka ($205 in chips) 
Seat 2: matiko09 ($284.71 in chips) 
Seat 3: han3bj ($203 in chips) 
Seat 5: chaps1988 ($274.12 in chips) 
Seat 6: PacPacBum ($205.57 in chips) 
Seat 7: patpaty ($161.11 in chips) 
Seat 8: tepi_guy ($200 in chips) 
Seat 9: kblkxls ($143.40 in chips) 
kblkxls: posts small blind $1
Kukuryzka: posts big blind $2
*** HOLE CARDS ***
Dealt to matiko09 [7s 7c]
matiko09: raises $3 to $5
han3bj: folds 
chaps1988: folds 
PacPacBum: folds 
patpaty: folds 
tepi_guy: folds 
kblkxls: calls $4
Kukuryzka: folds 
*** FLOP *** [7d Kd 3c]
kblkxls: checks 
matiko09: bets $7.41
kblkxls: folds 
Uncalled bet ($7.41) returned to matiko09
matiko09 collected $11.40 from pot
matiko09: doesn't show hand 
*** SUMMARY ***
Total pot $12 | Rake $0.60 
Board [7d Kd 3c]
Seat 1: Kukuryzka (big blind) folded before Flop
Seat 2: matiko09 collected ($11.40)
Seat 3: han3bj folded before Flop (didn't bet)
Seat 5: chaps1988 folded before Flop (didn't bet)
Seat 6: PacPacBum folded before Flop (didn't bet)
Seat 7: patpaty folded before Flop (didn't bet)
Seat 8: tepi_guy (button) folded before Flop (didn't bet)
Seat 9: kblkxls (small blind) folded on the Flop





PokerStars Hand #152886380005:  Hold'em No Limit ($0.50/$1.00 USD) - 2016/05/05 16:44:08 CET [2016/05/05 10:44:08 ET]
Table 'Kraz II' 9-max Seat #1 is the button
Seat 1: HITYESCA ($100 in chips) 
Seat 2: sanpidk ($146.09 in chips) 
Seat 3: Khaine_CM ($106.98 in chips) 
Seat 5: Kukuryzka ($100 in chips) 
Seat 6: andy84lfc ($246.28 in chips) 
Seat 7: Dantist1122 ($118.60 in chips) 
Seat 8: 178013 ($97 in chips) 
Seat 9: matiko09 ($177.37 in chips) 
sanpidk: posts small blind $0.50
Khaine_CM: posts big blind $1
CI58: sits out 
*** HOLE CARDS ***
Dealt to matiko09 [Kh Qh]
Kukuryzka: folds 
andy84lfc: folds 
Dantist1122: folds 
178013: raises $2 to $3
matiko09: raises $6 to $9
HITYESCA: folds 
sanpidk: folds 
Khaine_CM: folds 
178013: folds 
Uncalled bet ($6) returned to matiko09
matiko09 collected $7.50 from pot
matiko09: doesn't show hand 
*** SUMMARY ***
Total pot $7.50 | Rake $0 
Seat 1: HITYESCA (button) folded before Flop (didn't bet)
Seat 2: sanpidk (small blind) folded before Flop
Seat 3: Khaine_CM (big blind) folded before Flop
Seat 5: Kukuryzka folded before Flop (didn't bet)
Seat 6: andy84lfc folded before Flop (didn't bet)
Seat 7: Dantist1122 folded before Flop (didn't bet)
Seat 8: 178013 folded before Flop
Seat 9: matiko09 collected ($7.50)





PokerStars Hand #152886379940:  Hold'em No Limit ($1/$2 USD) - 2016/05/05 16:44:08 CET [2016/05/05 10:44:08 ET]
Table 'Euporie II' 9-max Seat #9 is the button
Seat 1: PacPacBum ($204.50 in chips) 
Seat 2: kblkxls ($88.82 in chips) 
Seat 3: chaps1988 ($236.25 in chips) 
Seat 5: Nuskatko1986 ($65.07 in chips) 
Seat 6: Kukuryzka ($200 in chips) 
Seat 7: matiko09 ($226.61 in chips) 
Seat 8: Painkiller72 ($289.25 in chips) 
Seat 9: T0ny Adams ($90.48 in chips) 
PacPacBum: posts small blind $1
kblkxls: posts big blind $2
*** HOLE CARDS ***
Dealt to matiko09 [6c 9h]
chaps1988: folds 
Nuskatko1986: folds 
Kukuryzka: folds 
matiko09: folds 
Painkiller72: raises $3 to $5
T0ny Adams: raises $8 to $13
PacPacBum: folds 
kblkxls: folds 
Painkiller72: folds 
Uncalled bet ($8) returned to T0ny Adams
T0ny Adams collected $13 from pot
T0ny Adams: doesn't show hand 
*** SUMMARY ***
Total pot $13 | Rake $0 
Seat 1: PacPacBum (small blind) folded before Flop
Seat 2: kblkxls (big blind) folded before Flop
Seat 3: chaps1988 folded before Flop (didn't bet)
Seat 5: Nuskatko1986 folded before Flop (didn't bet)
Seat 6: Kukuryzka folded before Flop (didn't bet)
Seat 7: matiko09 folded before Flop (didn't bet)
Seat 8: Painkiller72 folded before Flop
Seat 9: T0ny Adams (button) collected ($13)





PokerStars Hand #152886383355:  Hold'em No Limit (€1/€2 EUR) - 2016/05/05 16:44:13 CET [2016/05/05 10:44:13 ET]
Table 'Bessel II' 9-max Seat #3 is the button
Seat 1: Soloaces224 (€228.43 in chips) 
Seat 3: PacPacBum (€200 in chips) 
Seat 4: Zorken76 (€158.82 in chips) 
Seat 5: Kukuryzka (€200 in chips) 
Seat 6: glanza_mike (€203 in chips) 
Seat 7: matiko09 (€200 in chips) 
Seat 8: chaps1988 (€254.52 in chips) 
Seat 9: JoaquinMRuiz (€200 in chips) 
Zorken76: posts small blind €1
Kukuryzka: posts big blind €2
*** HOLE CARDS ***
Dealt to matiko09 [4c Ad]
glanza_mike: folds 
matiko09: folds 
chaps1988: raises €3 to €5
JoaquinMRuiz: folds 
Soloaces224: calls €5
PacPacBum: folds 
Zorken76: calls €4
Kukuryzka: folds 
*** FLOP *** [Kc 6d 6c]
Zorken76: checks 
chaps1988: checks 
Soloaces224: checks 
*** TURN *** [Kc 6d 6c] [Ks]
Zorken76: checks 
chaps1988: checks 
Soloaces224: checks 
*** RIVER *** [Kc 6d 6c Ks] [Jc]
Zorken76: checks 
chaps1988: checks 
Soloaces224: checks 
*** SHOW DOWN ***
Zorken76: shows [Tc Qs] (two pair, Kings and Sixes)
chaps1988: mucks hand 
Soloaces224: mucks hand 
Zorken76 collected €16.15 from pot
*** SUMMARY ***
Total pot €17 | Rake €0.85 
Board [Kc 6d 6c Ks Jc]
Seat 1: Soloaces224 mucked [3s 3c]
Seat 3: PacPacBum (button) folded before Flop (didn't bet)
Seat 4: Zorken76 (small blind) showed [Tc Qs] and won (€16.15) with two pair, Kings and Sixes
Seat 5: Kukuryzka (big blind) folded before Flop
Seat 6: glanza_mike folded before Flop (didn't bet)
Seat 7: matiko09 folded before Flop (didn't bet)
Seat 8: chaps1988 mucked [7h 8h]
Seat 9: JoaquinMRuiz folded before Flop (didn't bet)





PokerStars Hand #152886386448:  Hold'em No Limit ($1/$2 USD) - 2016/05/05 16:44:18 CET [2016/05/05 10:44:18 ET]
Table 'Tatry II' 9-max Seat #4 is the button
Seat 1: glanza_mike ($217.80 in chips) 
Seat 2: T0ny Adams ($60.06 in chips) 
Seat 3: matiko09 ($200 in chips) 
Seat 4: PacPacBum ($217.17 in chips) 
Seat 5: Painkiller72 ($325.05 in chips) 
Seat 6: Kukuryzka ($276.60 in chips) 
Seat 8: chaps1988 ($258.54 in chips) 
Seat 9: korol702 ($160.40 in chips) 
Painkiller72: posts small blind $1
Kukuryzka: posts big blind $2
*** HOLE CARDS ***
Dealt to matiko09 [4s Ts]
chaps1988: folds 
korol702: calls $2
glanza_mike: folds 
T0ny Adams: folds 
matiko09: folds 
PacPacBum: folds 
Painkiller72: calls $1
Kukuryzka: checks 
*** FLOP *** [8h 3d 6d]
Painkiller72: checks 
Kukuryzka: checks 
korol702: checks 
*** TURN *** [8h 3d 6d] [7c]
Painkiller72: checks 
Kukuryzka: checks 
korol702: checks 
*** RIVER *** [8h 3d 6d 7c] [Qc]
Painkiller72: checks 
Kukuryzka: checks 
korol702: checks 
*** SHOW DOWN ***
Painkiller72: shows [2h 3h] (a pair of Threes)
Kukuryzka: mucks hand 
korol702: mucks hand 
Painkiller72 collected $5.70 from pot
*** SUMMARY ***
Total pot $6 | Rake $0.30 
Board [8h 3d 6d 7c Qc]
Seat 1: glanza_mike folded before Flop (didn't bet)
Seat 2: T0ny Adams folded before Flop (didn't bet)
Seat 3: matiko09 folded before Flop (didn't bet)
Seat 4: PacPacBum (button) folded before Flop (didn't bet)
Seat 5: Painkiller72 (small blind) showed [2h 3h] and won ($5.70) with a pair of Threes
Seat 6: Kukuryzka (big blind) mucked [Jc 9c]
Seat 8: chaps1988 folded before Flop (didn't bet)
Seat 9: korol702 mucked [2d 2c]





PokerStars Hand #152886392746:  Hold'em No Limit ($1/$2 USD) - 2016/05/05 16:44:29 CET [2016/05/05 10:44:29 ET]
Table 'Tololo' 9-max Seat #8 is the button
Seat 1: Kukuryzka ($271.29 in chips) 
Seat 2: tepi_guy ($200 in chips) 
Seat 3: Khaine_CM ($200 in chips) 
Seat 4: mooose100 ($158.47 in chips) 
Seat 5: matiko09 ($231.10 in chips) 
Seat 6: Xagua ($150.70 in chips) 
Seat 7: chaps1988 ($281.42 in chips) 
Seat 8: myatiy 96 ($200 in chips) 
Kukuryzka: posts small blind $1
tepi_guy: posts big blind $2
*** HOLE CARDS ***
Dealt to matiko09 [4d 9h]
Khaine_CM: raises $4 to $6
mooose100: calls $6
matiko09: folds 
Xagua: folds 
chaps1988: folds 
myatiy 96: folds 
Kukuryzka: folds 
tepi_guy: folds 
*** FLOP *** [4h 9d 6s]
Khaine_CM: bets $10
mooose100: calls $10
*** TURN *** [4h 9d 6s] [5d]
Khaine_CM: bets $24
mooose100: calls $24
*** RIVER *** [4h 9d 6s 5d] [8h]
Khaine_CM: checks 
mooose100: bets $118.47 and is all-in
Khaine_CM: folds 
Uncalled bet ($118.47) returned to mooose100
mooose100 collected $80.25 from pot
mooose100: doesn't show hand 
*** SUMMARY ***
Total pot $83 | Rake $2.75 
Board [4h 9d 6s 5d 8h]
Seat 1: Kukuryzka (small blind) folded before Flop
Seat 2: tepi_guy (big blind) folded before Flop
Seat 3: Khaine_CM folded on the River
Seat 4: mooose100 collected ($80.25)
Seat 5: matiko09 folded before Flop (didn't bet)
Seat 6: Xagua folded before Flop (didn't bet)
Seat 7: chaps1988 folded before Flop (didn't bet)
Seat 8: myatiy 96 (button) folded before Flop (didn't bet)





PokerStars Hand #152886396880:  Hold'em No Limit ($0.50/$1.00 USD) - 2016/05/05 16:44:35 CET [2016/05/05 10:44:35 ET]
Table 'Porzia' 9-max Seat #8 is the button
Seat 1: vrnMike ($134 in chips) 
Seat 2: matiko09 ($100 in chips) 
Seat 3: sanpidk ($100 in chips) 
Seat 4: Khaine_CM ($100 in chips) 
Seat 5: CZECHMYSAK ($60.20 in chips) 
Seat 6: janarr5 ($172.27 in chips) 
Seat 7: HITYESCA ($102.15 in chips) 
Seat 8: PRINCE JULIO ($78.69 in chips) 
Seat 9: kl4ssic ($50 in chips) 
kl4ssic: posts small blind $0.50
vrnMike: posts big blind $1
*** HOLE CARDS ***
Dealt to matiko09 [3c Kd]
matiko09: folds 
CZECHMYSAK said, "<'))><"
sanpidk: folds 
Khaine_CM: raises $2 to $3
CZECHMYSAK: folds 
janarr5: calls $3
HITYESCA: folds 
PRINCE JULIO: folds 
kl4ssic: folds 
vrnMike: calls $2
*** FLOP *** [2s 8s 6c]
vrnMike: checks 
Khaine_CM: checks 
janarr5: bets $6
vrnMike: folds 
Khaine_CM: folds 
Uncalled bet ($6) returned to janarr5
janarr5 collected $9.02 from pot
janarr5: doesn't show hand 
*** SUMMARY ***
Total pot $9.50 | Rake $0.48 
Board [2s 8s 6c]
Seat 1: vrnMike (big blind) folded on the Flop
Seat 2: matiko09 folded before Flop (didn't bet)
Seat 3: sanpidk folded before Flop (didn't bet)
Seat 4: Khaine_CM folded on the Flop
Seat 5: CZECHMYSAK folded before Flop (didn't bet)
Seat 6: janarr5 collected ($9.02)
Seat 7: HITYESCA folded before Flop (didn't bet)
Seat 8: PRINCE JULIO (button) folded before Flop (didn't bet)
Seat 9: kl4ssic (small blind) folded before Flop





PokerStars Hand #152886399482:  Hold'em No Limit ($0.50/$1.00 USD) - 2016/05/05 16:44:40 CET [2016/05/05 10:44:40 ET]
Table 'Kraz II' 9-max Seat #2 is the button
Seat 1: HITYESCA ($100 in chips) 
Seat 2: sanpidk ($145.59 in chips) 
Seat 3: Khaine_CM ($105.98 in chips) 
Seat 4: CI58 ($100 in chips) 
Seat 5: Kukuryzka ($100 in chips) 
Seat 6: andy84lfc ($246.28 in chips) 
Seat 7: Dantist1122 ($118.60 in chips) 
Seat 8: 178013 ($94 in chips) 
Seat 9: matiko09 ($181.87 in chips) 
Khaine_CM: posts small blind $0.50
CI58: posts big blind $1
*** HOLE CARDS ***
Dealt to matiko09 [Kd 8s]
Kukuryzka: folds 
Kukuryzka leaves the table
andy84lfc: folds 
Dantist1122: raises $2 to $3
178013: folds 
matiko09: folds 
HITYESCA: folds 
sanpidk: folds 
Hayer ana joins the table at seat #5 
Khaine_CM: folds 
CI58: folds 
Uncalled bet ($2) returned to Dantist1122
Dantist1122 collected $2.50 from pot
Dantist1122: doesn't show hand 
*** SUMMARY ***
Total pot $2.50 | Rake $0 
Seat 1: HITYESCA folded before Flop (didn't bet)
Seat 2: sanpidk (button) folded before Flop (didn't bet)
Seat 3: Khaine_CM (small blind) folded before Flop
Seat 4: CI58 (big blind) folded before Flop
Seat 5: Kukuryzka folded before Flop (didn't bet)
Seat 6: andy84lfc folded before Flop (didn't bet)
Seat 7: Dantist1122 collected ($2.50)
Seat 8: 178013 folded before Flop (didn't bet)
Seat 9: matiko09 folded before Flop (didn't bet)





PokerStars Hand #152886400102:  Hold'em No Limit ($1/$2 USD) - 2016/05/05 16:44:41 CET [2016/05/05 10:44:41 ET]
Table 'Euporie II' 9-max Seat #1 is the button
Seat 1: PacPacBum ($203.50 in chips) 
Seat 2: kblkxls ($100.82 in chips) 
Seat 3: chaps1988 ($236.25 in chips) 
Seat 5: Nuskatko1986 ($65.07 in chips) 
Seat 6: Kukuryzka ($200 in chips) 
Seat 7: matiko09 ($226.61 in chips) 
Seat 8: Painkiller72 ($284.25 in chips) 
Seat 9: T0ny Adams ($98.48 in chips) 
kblkxls: posts small blind $1
chaps1988: posts big blind $2
*** HOLE CARDS ***
Dealt to matiko09 [Tc Th]
Nuskatko1986: calls $2
Kukuryzka: folds 
matiko09: raises $6 to $8
Painkiller72: folds 
T0ny Adams: folds 
PacPacBum: folds 
kblkxls: folds 
chaps1988: folds 
Nuskatko1986: calls $6
*** FLOP *** [5h 7s 7c]
Nuskatko1986: checks 
matiko09: bets $10
Nuskatko1986: calls $10
*** TURN *** [5h 7s 7c] [Kh]
Nuskatko1986: bets $47.07 and is all-in
matiko09: calls $47.07
*** RIVER *** [5h 7s 7c Kh] [6h]
*** SHOW DOWN ***
Nuskatko1986: shows [Ac Ah] (two pair, Aces and Sevens)
matiko09: mucks hand 
Nuskatko1986 collected $130.39 from pot
*** SUMMARY ***
Total pot $133.14 | Rake $2.75 
Board [5h 7s 7c Kh 6h]
Seat 1: PacPacBum (button) folded before Flop (didn't bet)
Seat 2: kblkxls (small blind) folded before Flop
Seat 3: chaps1988 (big blind) folded before Flop
Seat 5: Nuskatko1986 showed [Ac Ah] and won ($130.39) with two pair, Aces and Sevens
Seat 6: Kukuryzka folded before Flop (didn't bet)
Seat 7: matiko09 mucked [Tc Th]
Seat 8: Painkiller72 folded before Flop (didn't bet)
Seat 9: T0ny Adams folded before Flop (didn't bet)





PokerStars Hand #152886405200:  Hold'em No Limit ($1/$2 USD) - 2016/05/05 16:44:49 CET [2016/05/05 10:44:49 ET]
Table 'Samitchell' 9-max Seat #9 is the button
Seat 1: Kukuryzka ($203 in chips) 
Seat 2: matiko09 ($291.11 in chips) 
Seat 3: han3bj ($203 in chips) 
Seat 5: chaps1988 ($274.12 in chips) 
Seat 6: PacPacBum ($205.57 in chips) 
Seat 7: patpaty ($161.11 in chips) 
Seat 8: tepi_guy ($200 in chips) 
Seat 9: kblkxls ($138.40 in chips) 
Kukuryzka: posts small blind $1
matiko09: posts big blind $2
*** HOLE CARDS ***
Dealt to matiko09 [Js Th]
han3bj: folds 
chaps1988: folds 
PacPacBum: folds 
patpaty: folds 
tepi_guy: folds 
kblkxls: raises $2 to $4
Kukuryzka: folds 
matiko09: calls $2
*** FLOP *** [Td 3d 6d]
matiko09: checks 
kblkxls: bets $4
matiko09: calls $4
*** TURN *** [Td 3d 6d] [5d]
matiko09: checks 
kblkxls: checks 
*** RIVER *** [Td 3d 6d 5d] [2s]
matiko09: checks 
kblkxls: checks 
*** SHOW DOWN ***
matiko09: shows [Js Th] (a pair of Tens)
kblkxls: mucks hand 
matiko09 collected $16.15 from pot
*** SUMMARY ***
Total pot $17 | Rake $0.85 
Board [Td 3d 6d 5d 2s]
Seat 1: Kukuryzka (small blind) folded before Flop
Seat 2: matiko09 (big blind) showed [Js Th] and won ($16.15) with a pair of Tens
Seat 3: han3bj folded before Flop (didn't bet)
Seat 5: chaps1988 folded before Flop (didn't bet)
Seat 6: PacPacBum folded before Flop (didn't bet)
Seat 7: patpaty folded before Flop (didn't bet)
Seat 8: tepi_guy folded before Flop (didn't bet)
Seat 9: kblkxls (button) mucked [Ac 6c]





PokerStars Hand #152886410444:  Hold'em No Limit (€1/€2 EUR) - 2016/05/05 16:44:57 CET [2016/05/05 10:44:57 ET]
Table 'Bessel II' 9-max Seat #4 is the button
Seat 1: Soloaces224 (€223.43 in chips) 
Seat 3: PacPacBum (€200 in chips) 
Seat 4: Zorken76 (€169.97 in chips) 
Seat 5: Kukuryzka (€198 in chips) 
Seat 6: glanza_mike (€203 in chips) 
Seat 7: matiko09 (€200 in chips) 
Seat 8: chaps1988 (€249.52 in chips) 
Seat 9: JoaquinMRuiz (€200 in chips) 
Kukuryzka: posts small blind €1
glanza_mike: posts big blind €2
*** HOLE CARDS ***
Dealt to matiko09 [Ac Kh]
matiko09: raises €3 to €5
chaps1988: folds 
JoaquinMRuiz: folds 
Soloaces224: calls €5
PacPacBum: folds 
Zorken76: folds 
Kukuryzka: folds 
glanza_mike: calls €3
*** FLOP *** [Qd 7s 5h]
glanza_mike: checks 
matiko09: bets €9.88
Soloaces224: folds 
glanza_mike: folds 
Uncalled bet (€9.88) returned to matiko09
matiko09 collected €15.20 from pot
matiko09: doesn't show hand 
*** SUMMARY ***
Total pot €16 | Rake €0.80 
Board [Qd 7s 5h]
Seat 1: Soloaces224 folded on the Flop
Seat 3: PacPacBum folded before Flop (didn't bet)
Seat 4: Zorken76 (button) folded before Flop (didn't bet)
Seat 5: Kukuryzka (small blind) folded before Flop
Seat 6: glanza_mike (big blind) folded on the Flop
Seat 7: matiko09 collected (€15.20)
Seat 8: chaps1988 folded before Flop (didn't bet)
Seat 9: JoaquinMRuiz folded before Flop (didn't bet)





PokerStars Hand #152886425933:  Hold'em No Limit (€1/€2 EUR) - 2016/05/05 16:45:23 CET [2016/05/05 10:45:23 ET]
Table 'Skat II' 9-max Seat #6 is the button
Seat 4: JoaquinMRuiz (€241.44 in chips) 
Seat 6: drissmouzou (€247.60 in chips) 
Seat 7: PacPacBum (€200 in chips) 
Seat 8: Painkiller72 (€207 in chips) 
Seat 9: matiko09 (€200 in chips) 
PacPacBum: posts small blind €1
Painkiller72: posts big blind €2
*** HOLE CARDS ***
Dealt to matiko09 [4h 4d]
matiko09: raises €3 to €5
JoaquinMRuiz: folds 
drissmouzou has timed out
drissmouzou: folds 
PacPacBum: folds 
Painkiller72: folds 
Uncalled bet (€3) returned to matiko09
matiko09 collected €5 from pot
matiko09: doesn't show hand 
*** SUMMARY ***
Total pot €5 | Rake €0 
Seat 4: JoaquinMRuiz folded before Flop (didn't bet)
Seat 6: drissmouzou (button) folded before Flop (didn't bet)
Seat 7: PacPacBum (small blind) folded before Flop
Seat 8: Painkiller72 (big blind) folded before Flop
Seat 9: matiko09 collected (€5)





PokerStars Hand #152886427115:  Hold'em No Limit ($1/$2 USD) - 2016/05/05 16:45:25 CET [2016/05/05 10:45:25 ET]
Table 'Lundia' 9-max Seat #7 is the button
Seat 2: patpaty ($252.02 in chips) 
Seat 3: Painkiller72 ($209.25 in chips) 
Seat 4: PacPacBum ($200 in chips) 
Seat 5: zmOe84 ($207.82 in chips) 
Seat 6: CI58 ($282.98 in chips) 
Seat 7: matiko09 ($235.19 in chips) 
Seat 8: chaps1988 ($224.59 in chips) 
Seat 9: tepi_guy ($200 in chips) 
chaps1988: posts small blind $1
tepi_guy: posts big blind $2
*** HOLE CARDS ***
Dealt to matiko09 [Tc 2s]
patpaty: folds 
Painkiller72: folds 
PacPacBum: folds 
zmOe84: folds 
CI58: folds 
matiko09: folds 
chaps1988: raises $4 to $6
tepi_guy: folds 
Uncalled bet ($4) returned to chaps1988
chaps1988 collected $4 from pot
*** SUMMARY ***
Total pot $4 | Rake $0 
Seat 2: patpaty folded before Flop (didn't bet)
Seat 3: Painkiller72 folded before Flop (didn't bet)
Seat 4: PacPacBum folded before Flop (didn't bet)
Seat 5: zmOe84 folded before Flop (didn't bet)
Seat 6: CI58 folded before Flop (didn't bet)
Seat 7: matiko09 (button) folded before Flop (didn't bet)
Seat 8: chaps1988 (small blind) collected ($4)
Seat 9: tepi_guy (big blind) folded before Flop





PokerStars Hand #152886429015:  Hold'em No Limit ($0.50/$1.00 USD) - 2016/05/05 16:45:28 CET [2016/05/05 10:45:28 ET]
Table 'Kraz II' 9-max Seat #3 is the button
Seat 1: HITYESCA ($100 in chips) 
Seat 2: sanpidk ($145.59 in chips) 
Seat 3: Khaine_CM ($105.48 in chips) 
Seat 4: CI58 ($100 in chips) 
Seat 6: andy84lfc ($246.28 in chips) 
Seat 7: Dantist1122 ($120.10 in chips) 
Seat 8: 178013 ($94 in chips) 
Seat 9: matiko09 ($181.87 in chips) 
CI58: posts small blind $0.50
Hayer ana: is sitting out 
Hayer ana leaves the table
andy84lfc: posts big blind $1
*** HOLE CARDS ***
Dealt to matiko09 [Ts Jc]
Dantist1122: folds 
178013: folds 
matiko09: folds 
HITYESCA: folds 
sanpidk: raises $1.50 to $2.50
Alex Frider joins the table at seat #5 
Khaine_CM: folds 
CI58: raises $5.50 to $8
Dantist1122 leaves the table
andy84lfc: folds 
sanpidk: calls $5.50
*** FLOP *** [8c As 4d]
lucifer0730 joins the table at seat #7 
CI58: bets $8.07
lucifer0730 leaves the table
maxxmeister joins the table at seat #7 
sanpidk: calls $8.07
*** TURN *** [8c As 4d] [4h]
CI58: checks 
sanpidk: checks 
*** RIVER *** [8c As 4d 4h] [9d]
CI58: bets $12.59
sanpidk: calls $12.59
*** SHOW DOWN ***
CI58: shows [Qs Ad] (two pair, Aces and Fours)
sanpidk: shows [Ac Qc] (two pair, Aces and Fours)
CI58 collected $27.91 from pot
sanpidk collected $27.91 from pot
*** SUMMARY ***
Total pot $58.32 | Rake $2.50 
Board [8c As 4d 4h 9d]
Seat 1: HITYESCA folded before Flop (didn't bet)
Seat 2: sanpidk showed [Ac Qc] and won ($27.91) with two pair, Aces and Fours
Seat 3: Khaine_CM (button) folded before Flop (didn't bet)
Seat 4: CI58 (small blind) showed [Qs Ad] and won ($27.91) with two pair, Aces and Fours
Seat 6: andy84lfc (big blind) folded before Flop
Seat 7: Dantist1122 folded before Flop (didn't bet)
Seat 8: 178013 folded before Flop (didn't bet)
Seat 9: matiko09 folded before Flop (didn't bet)





PokerStars Hand #152886434855:  Hold'em No Limit ($1/$2 USD) - 2016/05/05 16:45:37 CET [2016/05/05 10:45:37 ET]
Table 'Euporie II' 9-max Seat #2 is the button
Seat 1: PacPacBum ($203.50 in chips) 
Seat 2: kblkxls ($99.82 in chips) 
Seat 3: chaps1988 ($234.25 in chips) 
Seat 5: Nuskatko1986 ($130.39 in chips) 
Seat 6: Kukuryzka ($200 in chips) 
Seat 7: matiko09 ($200 in chips) 
Seat 8: Painkiller72 ($284.25 in chips) 
Seat 9: T0ny Adams ($98.48 in chips) 
chaps1988: posts small blind $1
Nuskatko1986: posts big blind $2
*** HOLE CARDS ***
Dealt to matiko09 [9h Ad]
Kukuryzka: folds 
matiko09: folds 
Painkiller72: raises $3 to $5
T0ny Adams: raises $8 to $13
PacPacBum: folds 
kblkxls: folds 
chaps1988: raises $8.66 to $21.66
Nuskatko1986: folds 
Painkiller72: folds 
T0ny Adams: raises $76.82 to $98.48 and is all-in
chaps1988: calls $76.82
*** FLOP *** [Js 3s Th]
*** TURN *** [Js 3s Th] [8h]
*** RIVER *** [Js 3s Th 8h] [Qc]
*** SHOW DOWN ***
chaps1988: shows [As Ah] (a pair of Aces)
T0ny Adams: shows [Kc Ac] (a straight, Ten to Ace)
T0ny Adams collected $201.21 from pot
*** SUMMARY ***
Total pot $203.96 | Rake $2.75 
Board [Js 3s Th 8h Qc]
Seat 1: PacPacBum folded before Flop (didn't bet)
Seat 2: kblkxls (button) folded before Flop (didn't bet)
Seat 3: chaps1988 (small blind) showed [As Ah] and lost with a pair of Aces
Seat 5: Nuskatko1986 (big blind) folded before Flop
Seat 6: Kukuryzka folded before Flop (didn't bet)
Seat 7: matiko09 folded before Flop (didn't bet)
Seat 8: Painkiller72 folded before Flop
Seat 9: T0ny Adams showed [Kc Ac] and won ($201.21) with a straight, Ten to Ace





PokerStars Hand #152886443149:  Hold'em No Limit ($0.50/$1.00 USD) - 2016/05/05 16:45:51 CET [2016/05/05 10:45:51 ET]
Table 'Porzia' 9-max Seat #9 is the button
Seat 1: vrnMike ($131 in chips) 
Seat 2: matiko09 ($100 in chips) 
Seat 3: sanpidk ($100 in chips) 
Seat 4: Khaine_CM ($100 in chips) 
Seat 5: CZECHMYSAK ($60.20 in chips) 
Seat 6: janarr5 ($178.29 in chips) 
Seat 7: HITYESCA ($102.15 in chips) 
Seat 8: PRINCE JULIO ($78.69 in chips) 
Seat 9: kl4ssic ($49.50 in chips) 
vrnMike: posts small blind $0.50
matiko09: posts big blind $1
*** HOLE CARDS ***
Dealt to matiko09 [5h Js]
sanpidk: folds 
Khaine_CM: folds 
CZECHMYSAK: folds 
janarr5: folds 
HITYESCA: folds 
PRINCE JULIO: folds 
kl4ssic: folds 
vrnMike: folds 
Uncalled bet ($0.50) returned to matiko09
matiko09 collected $1 from pot
matiko09: doesn't show hand 
*** SUMMARY ***
Total pot $1 | Rake $0 
Seat 1: vrnMike (small blind) folded before Flop
Seat 2: matiko09 (big blind) collected ($1)
Seat 3: sanpidk folded before Flop (didn't bet)
Seat 4: Khaine_CM folded before Flop (didn't bet)
Seat 5: CZECHMYSAK folded before Flop (didn't bet)
Seat 6: janarr5 folded before Flop (didn't bet)
Seat 7: HITYESCA folded before Flop (didn't bet)
Seat 8: PRINCE JULIO folded before Flop (didn't bet)
Seat 9: kl4ssic (button) folded before Flop (didn't bet)





PokerStars Hand #152886453894:  Hold'em No Limit ($1/$2 USD) - 2016/05/05 16:46:08 CET [2016/05/05 10:46:08 ET]
Table 'Tatry II' 9-max Seat #5 is the button
Seat 1: glanza_mike ($217.80 in chips) 
Seat 2: T0ny Adams ($60.06 in chips) 
Seat 3: matiko09 ($200 in chips) 
Seat 4: PacPacBum ($217.17 in chips) 
Seat 5: Painkiller72 ($328.75 in chips) 
Seat 6: Kukuryzka ($274.60 in chips) 
Seat 8: chaps1988 ($258.54 in chips) 
Seat 9: korol702 ($158.40 in chips) 
Kukuryzka: posts small blind $1
chaps1988: posts big blind $2
*** HOLE CARDS ***
Dealt to matiko09 [6d 2s]
korol702: folds 
glanza_mike: raises $4 to $6
T0ny Adams: folds 
matiko09: folds 
PacPacBum: folds 
Painkiller72: folds 
Kukuryzka: folds 
chaps1988: folds 
Uncalled bet ($4) returned to glanza_mike
glanza_mike collected $5 from pot
glanza_mike: doesn't show hand 
*** SUMMARY ***
Total pot $5 | Rake $0 
Seat 1: glanza_mike collected ($5)
Seat 2: T0ny Adams folded before Flop (didn't bet)
Seat 3: matiko09 folded before Flop (didn't bet)
Seat 4: PacPacBum folded before Flop (didn't bet)
Seat 5: Painkiller72 (button) folded before Flop (didn't bet)
Seat 6: Kukuryzka (small blind) folded before Flop
Seat 8: chaps1988 (big blind) folded before Flop
Seat 9: korol702 folded before Flop (didn't bet)





PokerStars Hand #152886457002:  Hold'em No Limit ($1/$2 USD) - 2016/05/05 16:46:13 CET [2016/05/05 10:46:13 ET]
Table 'Samitchell' 9-max Seat #1 is the button
Seat 1: Kukuryzka ($202 in chips) 
Seat 2: matiko09 ($299.26 in chips) 
Seat 3: han3bj ($203 in chips) 
Seat 5: chaps1988 ($274.12 in chips) 
Seat 6: PacPacBum ($205.57 in chips) 
Seat 7: patpaty ($161.11 in chips) 
Seat 8: tepi_guy ($200 in chips) 
Seat 9: kblkxls ($130.40 in chips) 
matiko09: posts small blind $1
han3bj: posts big blind $2
*** HOLE CARDS ***
Dealt to matiko09 [As 9d]
chaps1988: folds 
PacPacBum: folds 
patpaty: raises $2 to $4
tepi_guy: folds 
kblkxls: folds 
Kukuryzka: folds 
matiko09: folds 
han3bj: folds 
Uncalled bet ($2) returned to patpaty
patpaty collected $5 from pot
patpaty: doesn't show hand 
*** SUMMARY ***
Total pot $5 | Rake $0 
Seat 1: Kukuryzka (button) folded before Flop (didn't bet)
Seat 2: matiko09 (small blind) folded before Flop
Seat 3: han3bj (big blind) folded before Flop
Seat 5: chaps1988 folded before Flop (didn't bet)
Seat 6: PacPacBum folded before Flop (didn't bet)
Seat 7: patpaty collected ($5)
Seat 8: tepi_guy folded before Flop (didn't bet)
Seat 9: kblkxls folded before Flop (didn't bet)





PokerStars Hand #152886457327:  Hold'em No Limit (€1/€2 EUR) - 2016/05/05 16:46:14 CET [2016/05/05 10:46:14 ET]
Table 'Bessel II' 9-max Seat #5 is the button
Seat 1: Soloaces224 (€218.43 in chips) 
Seat 3: PacPacBum (€200 in chips) 
Seat 4: Zorken76 (€169.97 in chips) 
Seat 5: Kukuryzka (€200 in chips) 
Seat 6: glanza_mike (€200 in chips) 
Seat 7: matiko09 (€210.20 in chips) 
Seat 8: chaps1988 (€249.52 in chips) 
Seat 9: JoaquinMRuiz (€200 in chips) 
glanza_mike: posts small blind €1
matiko09: posts big blind €2
*** HOLE CARDS ***
Dealt to matiko09 [Jc 7c]
chaps1988: folds 
JoaquinMRuiz: raises €2.35 to €4.35
Soloaces224: folds 
PacPacBum: folds 
Zorken76: folds 
Kukuryzka: folds 
glanza_mike: folds 
matiko09: folds 
Uncalled bet (€2.35) returned to JoaquinMRuiz
JoaquinMRuiz collected €5 from pot
*** SUMMARY ***
Total pot €5 | Rake €0 
Seat 1: Soloaces224 folded before Flop (didn't bet)
Seat 3: PacPacBum folded before Flop (didn't bet)
Seat 4: Zorken76 folded before Flop (didn't bet)
Seat 5: Kukuryzka (button) folded before Flop (didn't bet)
Seat 6: glanza_mike (small blind) folded before Flop
Seat 7: matiko09 (big blind) folded before Flop
Seat 8: chaps1988 folded before Flop (didn't bet)
Seat 9: JoaquinMRuiz collected (€5)





PokerStars Hand #152886458720:  Hold'em No Limit ($1/$2 USD) - 2016/05/05 16:46:16 CET [2016/05/05 10:46:16 ET]
Table 'Lundia' 9-max Seat #8 is the button
Seat 3: Painkiller72 ($209.25 in chips) 
Seat 4: PacPacBum ($200 in chips) 
Seat 5: zmOe84 ($207.82 in chips) 
Seat 6: CI58 ($282.98 in chips) 
Seat 7: matiko09 ($235.19 in chips) 
Seat 8: chaps1988 ($226.59 in chips) 
Seat 9: tepi_guy ($200 in chips) 
tepi_guy: posts small blind $1
patpaty: is sitting out 
Painkiller72: posts big blind $2
*** HOLE CARDS ***
Dealt to matiko09 [Ks Qs]
patpaty leaves the table
Kukuryzka joins the table at seat #2 
Kukuryzka leaves the table
Alex Frider joins the table at seat #2 
PacPacBum: folds 
zmOe84: folds 
CI58: folds 
matiko09: raises $3 to $5
chaps1988: folds 
tepi_guy: folds 
Painkiller72: calls $3
*** FLOP *** [6s Kh 9s]
Painkiller72: checks 
matiko09: bets $6.79
Painkiller72: folds 
Uncalled bet ($6.79) returned to matiko09
matiko09 collected $10.45 from pot
matiko09: doesn't show hand 
*** SUMMARY ***
Total pot $11 | Rake $0.55 
Board [6s Kh 9s]
Seat 3: Painkiller72 (big blind) folded on the Flop
Seat 4: PacPacBum folded before Flop (didn't bet)
Seat 5: zmOe84 folded before Flop (didn't bet)
Seat 6: CI58 folded before Flop (didn't bet)
Seat 7: matiko09 collected ($10.45)
Seat 8: chaps1988 (button) folded before Flop (didn't bet)
Seat 9: tepi_guy (small blind) folded before Flop





PokerStars Hand #152886460309:  Hold'em No Limit ($1/$2 USD) - 2016/05/05 16:46:19 CET [2016/05/05 10:46:19 ET]
Table 'Tololo' 9-max Seat #1 is the button
Seat 1: Kukuryzka ($270.29 in chips) 
Seat 2: tepi_guy ($200 in chips) 
Seat 3: Khaine_CM ($200 in chips) 
Seat 4: mooose100 ($198.72 in chips) 
Seat 5: matiko09 ($231.10 in chips) 
Seat 6: Xagua ($150.70 in chips) 
Seat 7: chaps1988 ($281.42 in chips) 
Seat 8: myatiy 96 ($200 in chips) 
tepi_guy: posts small blind $1
Khaine_CM: posts big blind $2
*** HOLE CARDS ***
Dealt to matiko09 [3d 4c]
mooose100: calls $2
matiko09: folds 
Xagua: raises $3 to $5
chaps1988: raises $13 to $18
myatiy 96: folds 
Kukuryzka: folds 
tepi_guy: folds 
Khaine_CM: folds 
mooose100: folds 
Xagua: calls $13
*** FLOP *** [As 5d Ah]
Xagua: checks 
chaps1988: checks 
*** TURN *** [As 5d Ah] [Th]
Xagua: checks 
chaps1988: bets $18
Xagua: folds 
Uncalled bet ($18) returned to chaps1988
chaps1988 collected $38.95 from pot
*** SUMMARY ***
Total pot $41 | Rake $2.05 
Board [As 5d Ah Th]
Seat 1: Kukuryzka (button) folded before Flop (didn't bet)
Seat 2: tepi_guy (small blind) folded before Flop
Seat 3: Khaine_CM (big blind) folded before Flop
Seat 4: mooose100 folded before Flop
Seat 5: matiko09 folded before Flop (didn't bet)
Seat 6: Xagua folded on the Turn
Seat 7: chaps1988 collected ($38.95)
Seat 8: myatiy 96 folded before Flop (didn't bet)





PokerStars Hand #152886462009:  Hold'em No Limit ($0.50/$1.00 USD) - 2016/05/05 16:46:21 CET [2016/05/05 10:46:21 ET]
Table 'Porzia' 9-max Seat #1 is the button
Seat 1: vrnMike ($130.50 in chips) 
Seat 2: matiko09 ($100.50 in chips) 
Seat 3: sanpidk ($100 in chips) 
Seat 4: Khaine_CM ($100 in chips) 
Seat 5: CZECHMYSAK ($60.20 in chips) 
Seat 6: janarr5 ($178.29 in chips) 
Seat 7: HITYESCA ($102.15 in chips) 
Seat 8: PRINCE JULIO ($78.69 in chips) 
Seat 9: kl4ssic ($49.50 in chips) 
matiko09: posts small blind $0.50
sanpidk: posts big blind $1
*** HOLE CARDS ***
Dealt to matiko09 [9d 9h]
Khaine_CM: folds 
CZECHMYSAK: folds 
janarr5: folds 
HITYESCA: folds 
PRINCE JULIO: folds 
kl4ssic: raises $1.75 to $2.75
vrnMike: folds 
matiko09: raises $6.25 to $9
sanpidk: folds 
kl4ssic: calls $6.25
*** FLOP *** [Qh 2c 4c]
matiko09: checks 
kl4ssic: bets $9.02
matiko09: calls $9.02
*** TURN *** [Qh 2c 4c] [6d]
matiko09: checks 
kl4ssic: bets $31.48 and is all-in
matiko09: folds 
Uncalled bet ($31.48) returned to kl4ssic
kl4ssic collected $35.19 from pot
kl4ssic: doesn't show hand 
*** SUMMARY ***
Total pot $37.04 | Rake $1.85 
Board [Qh 2c 4c 6d]
Seat 1: vrnMike (button) folded before Flop (didn't bet)
Seat 2: matiko09 (small blind) folded on the Turn
Seat 3: sanpidk (big blind) folded before Flop
Seat 4: Khaine_CM folded before Flop (didn't bet)
Seat 5: CZECHMYSAK folded before Flop (didn't bet)
Seat 6: janarr5 folded before Flop (didn't bet)
Seat 7: HITYESCA folded before Flop (didn't bet)
Seat 8: PRINCE JULIO folded before Flop (didn't bet)
Seat 9: kl4ssic collected ($35.19)





PokerStars Hand #152886463285:  Hold'em No Limit (€1/€2 EUR) - 2016/05/05 16:46:24 CET [2016/05/05 10:46:24 ET]
Table 'Skat II' 9-max Seat #7 is the button
Seat 4: JoaquinMRuiz (€241.44 in chips) 
Seat 7: PacPacBum (€200 in chips) 
Seat 8: Painkiller72 (€205 in chips) 
Seat 9: matiko09 (€203 in chips) 
Painkiller72: posts small blind €1
matiko09: posts big blind €2
*** HOLE CARDS ***
Dealt to matiko09 [3c 2c]
JoaquinMRuiz: folds 
PacPacBum: folds 
Alex Frider joins the table at seat #3 
Painkiller72: folds 
Uncalled bet (€1) returned to matiko09
matiko09 collected €2 from pot
matiko09: doesn't show hand 
*** SUMMARY ***
Total pot €2 | Rake €0 
Seat 4: JoaquinMRuiz folded before Flop (didn't bet)
Seat 7: PacPacBum (button) folded before Flop (didn't bet)
Seat 8: Painkiller72 (small blind) folded before Flop
Seat 9: matiko09 (big blind) collected (€2)





PokerStars Hand #152886472734:  Hold'em No Limit (€1/€2 EUR) - 2016/05/05 16:46:39 CET [2016/05/05 10:46:39 ET]
Table 'Skat II' 9-max Seat #8 is the button
Seat 3: Alex Frider (€200 in chips) 
Seat 4: JoaquinMRuiz (€241.44 in chips) 
Seat 7: PacPacBum (€200 in chips) 
Seat 8: Painkiller72 (€204 in chips) 
Seat 9: matiko09 (€204 in chips) 
matiko09: posts small blind €1
Alex Frider: posts big blind €2
*** HOLE CARDS ***
Dealt to matiko09 [7h Jd]
Bebeto342193 joins the table at seat #1 
JoaquinMRuiz: folds 
PacPacBum: folds 
Painkiller72: folds 
matiko09: folds 
Uncalled bet (€1) returned to Alex Frider
Alex Frider collected €2 from pot
Alex Frider: doesn't show hand 
*** SUMMARY ***
Total pot €2 | Rake €0 
Seat 3: Alex Frider (big blind) collected (€2)
Seat 4: JoaquinMRuiz folded before Flop (didn't bet)
Seat 7: PacPacBum folded before Flop (didn't bet)
Seat 8: Painkiller72 (button) folded before Flop (didn't bet)
Seat 9: matiko09 (small blind) folded before Flop





PokerStars Hand #152886481394:  Hold'em No Limit ($1/$2 USD) - 2016/05/05 16:46:54 CET [2016/05/05 10:46:54 ET]
Table 'Euporie II' 9-max Seat #3 is the button
Seat 1: PacPacBum ($203.50 in chips) 
Seat 2: kblkxls ($99.82 in chips) 
Seat 3: chaps1988 ($200 in chips) 
Seat 5: Nuskatko1986 ($128.39 in chips) 
Seat 6: Kukuryzka ($200 in chips) 
Seat 7: matiko09 ($200 in chips) 
Seat 8: Painkiller72 ($279.25 in chips) 
Seat 9: T0ny Adams ($201.21 in chips) 
Nuskatko1986: posts small blind $1
Kukuryzka: posts big blind $2
*** HOLE CARDS ***
Dealt to matiko09 [9s Qc]
matiko09: folds 
Painkiller72: folds 
T0ny Adams: folds 
PacPacBum: folds 
kblkxls: calls $2
chaps1988: folds 
Nuskatko1986: folds 
Kukuryzka: checks 
*** FLOP *** [Qd Kd Ac]
Kukuryzka: checks 
kblkxls: bets $2
Kukuryzka: calls $2
*** TURN *** [Qd Kd Ac] [Ks]
Kukuryzka: checks 
kblkxls: bets $6
Kukuryzka: folds 
Uncalled bet ($6) returned to kblkxls
kblkxls collected $8.55 from pot
*** SUMMARY ***
Total pot $9 | Rake $0.45 
Board [Qd Kd Ac Ks]
Seat 1: PacPacBum folded before Flop (didn't bet)
Seat 2: kblkxls collected ($8.55)
Seat 3: chaps1988 (button) folded before Flop (didn't bet)
Seat 5: Nuskatko1986 (small blind) folded before Flop
Seat 6: Kukuryzka (big blind) folded on the Turn
Seat 7: matiko09 folded before Flop (didn't bet)
Seat 8: Painkiller72 folded before Flop (didn't bet)
Seat 9: T0ny Adams folded before Flop (didn't bet)





PokerStars Hand #152886481553:  Hold'em No Limit (€1/€2 EUR) - 2016/05/05 16:46:54 CET [2016/05/05 10:46:54 ET]
Table 'Bessel II' 9-max Seat #6 is the button
Seat 1: Soloaces224 (€218.43 in chips) 
Seat 3: PacPacBum (€200 in chips) 
Seat 4: Zorken76 (€169.97 in chips) 
Seat 5: Kukuryzka (€200 in chips) 
Seat 6: glanza_mike (€200 in chips) 
Seat 7: matiko09 (€208.20 in chips) 
Seat 8: chaps1988 (€249.52 in chips) 
Seat 9: JoaquinMRuiz (€203 in chips) 
matiko09: posts small blind €1
chaps1988: posts big blind €2
*** HOLE CARDS ***
Dealt to matiko09 [8c 2h]
JoaquinMRuiz: folds 
Soloaces224: folds 
PacPacBum: raises €4 to €6
Zorken76: folds 
Kukuryzka: folds 
glanza_mike: folds 
matiko09: folds 
chaps1988: calls €4
*** FLOP *** [Ts 8h Jh]
chaps1988: checks 
PacPacBum: bets €8.52
chaps1988: calls €8.52
*** TURN *** [Ts 8h Jh] [Qc]
chaps1988: checks 
PacPacBum: checks 
*** RIVER *** [Ts 8h Jh Qc] [6c]
chaps1988: checks 
PacPacBum: checks 
*** SHOW DOWN ***
chaps1988: shows [Qs Ah] (a pair of Queens)
PacPacBum: shows [Kh Kc] (a pair of Kings)
PacPacBum collected €28.54 from pot
*** SUMMARY ***
Total pot €30.04 | Rake €1.50 
Board [Ts 8h Jh Qc 6c]
Seat 1: Soloaces224 folded before Flop (didn't bet)
Seat 3: PacPacBum showed [Kh Kc] and won (€28.54) with a pair of Kings
Seat 4: Zorken76 folded before Flop (didn't bet)
Seat 5: Kukuryzka folded before Flop (didn't bet)
Seat 6: glanza_mike (button) folded before Flop (didn't bet)
Seat 7: matiko09 (small blind) folded before Flop
Seat 8: chaps1988 (big blind) showed [Qs Ah] and lost with a pair of Queens
Seat 9: JoaquinMRuiz folded before Flop (didn't bet)





PokerStars Hand #152886483629:  Hold'em No Limit ($1/$2 USD) - 2016/05/05 16:46:57 CET [2016/05/05 10:46:57 ET]
Table 'Samitchell' 9-max Seat #2 is the button
Seat 1: Kukuryzka ($202 in chips) 
Seat 2: matiko09 ($298.26 in chips) 
Seat 3: han3bj ($201 in chips) 
Seat 5: chaps1988 ($274.12 in chips) 
Seat 6: PacPacBum ($205.57 in chips) 
Seat 7: patpaty ($164.11 in chips) 
Seat 8: tepi_guy ($200 in chips) 
Seat 9: kblkxls ($130.40 in chips) 
han3bj: posts small blind $1
chaps1988: posts big blind $2
*** HOLE CARDS ***
Dealt to matiko09 [Tc Qh]
PacPacBum: folds 
patpaty: folds 
tepi_guy: raises $3.40 to $5.40
kblkxls: folds 
Kukuryzka: folds 
matiko09: folds 
han3bj: folds 
chaps1988: folds 
Uncalled bet ($3.40) returned to tepi_guy
tepi_guy collected $5 from pot
tepi_guy: doesn't show hand 
*** SUMMARY ***
Total pot $5 | Rake $0 
Seat 1: Kukuryzka folded before Flop (didn't bet)
Seat 2: matiko09 (button) folded before Flop (didn't bet)
Seat 3: han3bj (small blind) folded before Flop
Seat 5: chaps1988 (big blind) folded before Flop
Seat 6: PacPacBum folded before Flop (didn't bet)
Seat 7: patpaty folded before Flop (didn't bet)
Seat 8: tepi_guy collected ($5)
Seat 9: kblkxls folded before Flop (didn't bet)





PokerStars Hand #152886483974:  Hold'em No Limit (€1/€2 EUR) - 2016/05/05 16:46:58 CET [2016/05/05 10:46:58 ET]
Table 'Skat II' 9-max Seat #9 is the button
Seat 3: Alex Frider (€201 in chips) 
Seat 7: PacPacBum (€200 in chips) 
Seat 8: Painkiller72 (€204 in chips) 
Seat 9: matiko09 (€203 in chips) 
Bebeto342193 will be allowed to play after the button
Alex Frider: posts small blind €1
JoaquinMRuiz: is sitting out 
PacPacBum: posts big blind €2
*** HOLE CARDS ***
Dealt to matiko09 [3h 2d]
Painkiller72: folds 
matiko09: folds 
Alex Frider: folds 
Uncalled bet (€1) returned to PacPacBum
PacPacBum collected €2 from pot
PacPacBum: doesn't show hand 
*** SUMMARY ***
Total pot €2 | Rake €0 
Seat 3: Alex Frider (small blind) folded before Flop
Seat 7: PacPacBum (big blind) collected (€2)
Seat 8: Painkiller72 folded before Flop (didn't bet)
Seat 9: matiko09 (button) folded before Flop (didn't bet)





PokerStars Hand #152886486463:  Hold'em No Limit ($1/$2 USD) - 2016/05/05 16:47:02 CET [2016/05/05 10:47:02 ET]
Table 'Tatry II' 9-max Seat #6 is the button
Seat 1: glanza_mike ($220.80 in chips) 
Seat 2: T0ny Adams ($60.06 in chips) 
Seat 3: matiko09 ($200 in chips) 
Seat 4: PacPacBum ($217.17 in chips) 
Seat 5: Painkiller72 ($328.75 in chips) 
Seat 6: Kukuryzka ($273.60 in chips) 
Seat 8: chaps1988 ($256.54 in chips) 
Seat 9: korol702 ($158.40 in chips) 
chaps1988: posts small blind $1
korol702: posts big blind $2
*** HOLE CARDS ***
Dealt to matiko09 [3s 5h]
glanza_mike: folds 
T0ny Adams: folds 
matiko09: folds 
PacPacBum: folds 
Painkiller72: raises $3 to $5
Kukuryzka: folds 
chaps1988: folds 
korol702: calls $3
*** FLOP *** [8d 2s 7d]
korol702: bets $6
Painkiller72: calls $6
*** TURN *** [8d 2s 7d] [4s]
korol702: checks 
Painkiller72: checks 
*** RIVER *** [8d 2s 7d 4s] [9d]
korol702: checks 
Painkiller72: checks 
*** SHOW DOWN ***
korol702: shows [2h Kc] (a pair of Deuces)
Painkiller72: mucks hand 
korol702 collected $21.85 from pot
*** SUMMARY ***
Total pot $23 | Rake $1.15 
Board [8d 2s 7d 4s 9d]
Seat 1: glanza_mike folded before Flop (didn't bet)
Seat 2: T0ny Adams folded before Flop (didn't bet)
Seat 3: matiko09 folded before Flop (didn't bet)
Seat 4: PacPacBum folded before Flop (didn't bet)
Seat 5: Painkiller72 mucked [Ac Ks]
Seat 6: Kukuryzka (button) folded before Flop (didn't bet)
Seat 8: chaps1988 (small blind) folded before Flop
Seat 9: korol702 (big blind) showed [2h Kc] and won ($21.85) with a pair of Deuces





PokerStars Hand #152886495399:  Hold'em No Limit (€1/€2 EUR) - 2016/05/05 16:47:16 CET [2016/05/05 10:47:16 ET]
Table 'Skat II' 9-max Seat #3 is the button
Seat 3: Alex Frider (€200 in chips) 
Seat 7: PacPacBum (€201 in chips) 
Seat 8: Painkiller72 (€204 in chips) 
Seat 9: matiko09 (€203 in chips) 
PacPacBum: posts small blind €1
Painkiller72: posts big blind €2
Bebeto342193: sits out 
*** HOLE CARDS ***
Dealt to matiko09 [5d 4d]
matiko09: folds 
Alex Frider: folds 
ceedonen joins the table at seat #5 
PacPacBum: raises €3 to €5
Painkiller72: raises €13 to €18
PacPacBum: folds 
Uncalled bet (€13) returned to Painkiller72
Painkiller72 collected €10 from pot
Painkiller72: doesn't show hand 
*** SUMMARY ***
Total pot €10 | Rake €0 
Seat 3: Alex Frider (button) folded before Flop (didn't bet)
Seat 7: PacPacBum (small blind) folded before Flop
Seat 8: Painkiller72 (big blind) collected (€10)
Seat 9: matiko09 folded before Flop (didn't bet)





PokerStars Hand #152886499525:  Hold'em No Limit ($1/$2 USD) - 2016/05/05 16:47:23 CET [2016/05/05 10:47:23 ET]
Table 'Lundia' 9-max Seat #9 is the button
Seat 3: Painkiller72 ($204.25 in chips) 
Seat 4: PacPacBum ($200 in chips) 
Seat 5: zmOe84 ($207.82 in chips) 
Seat 6: CI58 ($282.98 in chips) 
Seat 7: matiko09 ($240.64 in chips) 
Seat 8: chaps1988 ($226.59 in chips) 
Seat 9: tepi_guy ($200 in chips) 
Alex Frider will be allowed to play after the button
Painkiller72: posts small blind $1
PacPacBum: posts big blind $2
*** HOLE CARDS ***
Dealt to matiko09 [4s Js]
zmOe84: folds 
CI58: folds 
matiko09: folds 
chaps1988: raises $2.50 to $4.50
tepi_guy: folds 
Painkiller72: folds 
PacPacBum: calls $2.50
*** FLOP *** [5s 7h 3s]
PacPacBum: checks 
chaps1988: bets $6
PacPacBum: folds 
Uncalled bet ($6) returned to chaps1988
chaps1988 collected $9.50 from pot
*** SUMMARY ***
Total pot $10 | Rake $0.50 
Board [5s 7h 3s]
Seat 3: Painkiller72 (small blind) folded before Flop
Seat 4: PacPacBum (big blind) folded on the Flop
Seat 5: zmOe84 folded before Flop (didn't bet)
Seat 6: CI58 folded before Flop (didn't bet)
Seat 7: matiko09 folded before Flop (didn't bet)
Seat 8: chaps1988 collected ($9.50)
Seat 9: tepi_guy (button) folded before Flop (didn't bet)





PokerStars Hand #152886500160:  Hold'em No Limit ($1/$2 USD) - 2016/05/05 16:47:24 CET [2016/05/05 10:47:24 ET]
Table 'Samitchell' 9-max Seat #3 is the button
Seat 1: Kukuryzka ($202 in chips) 
Seat 2: matiko09 ($298.26 in chips) 
Seat 3: han3bj ($200 in chips) 
Seat 5: chaps1988 ($272.12 in chips) 
Seat 6: PacPacBum ($205.57 in chips) 
Seat 7: patpaty ($164.11 in chips) 
Seat 8: tepi_guy ($203 in chips) 
Seat 9: kblkxls ($130.40 in chips) 
chaps1988: posts small blind $1
PacPacBum: posts big blind $2
*** HOLE CARDS ***
Dealt to matiko09 [Jc 7c]
patpaty: folds 
tepi_guy: folds 
kblkxls: raises $4 to $6
Kukuryzka: folds 
matiko09: folds 
han3bj: calls $6
chaps1988: folds 
PacPacBum: folds 
*** FLOP *** [9h Qc 5d]
kblkxls: checks 
han3bj: bets $8
kblkxls: folds 
Uncalled bet ($8) returned to han3bj
han3bj collected $14.25 from pot
han3bj: doesn't show hand 
*** SUMMARY ***
Total pot $15 | Rake $0.75 
Board [9h Qc 5d]
Seat 1: Kukuryzka folded before Flop (didn't bet)
Seat 2: matiko09 folded before Flop (didn't bet)
Seat 3: han3bj (button) collected ($14.25)
Seat 5: chaps1988 (small blind) folded before Flop
Seat 6: PacPacBum (big blind) folded before Flop
Seat 7: patpaty folded before Flop (didn't bet)
Seat 8: tepi_guy folded before Flop (didn't bet)
Seat 9: kblkxls folded on the Flop





PokerStars Hand #152886513148:  Hold'em No Limit ($1/$2 USD) - 2016/05/05 16:47:45 CET [2016/05/05 10:47:45 ET]
Table 'Tololo' 9-max Seat #2 is the button
Seat 1: Kukuryzka ($270.29 in chips) 
Seat 2: tepi_guy ($200 in chips) 
Seat 3: Khaine_CM ($200 in chips) 
Seat 4: mooose100 ($196.72 in chips) 
Seat 5: matiko09 ($231.10 in chips) 
Seat 6: Xagua ($132.70 in chips) 
Seat 7: chaps1988 ($302.37 in chips) 
Seat 8: myatiy 96 ($200 in chips) 
Khaine_CM: posts small blind $1
mooose100: posts big blind $2
*** HOLE CARDS ***
Dealt to matiko09 [5d 6d]
matiko09: folds 
Xagua: folds 
chaps1988: folds 
myatiy 96: folds 
Kukuryzka: folds 
tepi_guy: raises $2.40 to $4.40
Khaine_CM: folds 
mooose100: folds 
Uncalled bet ($2.40) returned to tepi_guy
tepi_guy collected $5 from pot
tepi_guy: doesn't show hand 
*** SUMMARY ***
Total pot $5 | Rake $0 
Seat 1: Kukuryzka folded before Flop (didn't bet)
Seat 2: tepi_guy (button) collected ($5)
Seat 3: Khaine_CM (small blind) folded before Flop
Seat 4: mooose100 (big blind) folded before Flop
Seat 5: matiko09 folded before Flop (didn't bet)
Seat 6: Xagua folded before Flop (didn't bet)
Seat 7: chaps1988 folded before Flop (didn't bet)
Seat 8: myatiy 96 folded before Flop (didn't bet)





PokerStars Hand #152886513853:  Hold'em No Limit ($0.50/$1.00 USD) - 2016/05/05 16:47:46 CET [2016/05/05 10:47:46 ET]
Table 'Kraz II' 9-max Seat #4 is the button
Seat 1: HITYESCA ($100 in chips) 
Seat 2: sanpidk ($144.84 in chips) 
Seat 3: Khaine_CM ($105.48 in chips) 
Seat 4: CI58 ($100 in chips) 
Seat 6: andy84lfc ($245.28 in chips) 
Seat 7: maxxmeister ($100 in chips) 
Seat 8: 178013 ($94 in chips) 
Seat 9: matiko09 ($181.87 in chips) 
Alex Frider will be allowed to play after the button
andy84lfc: posts small blind $0.50
maxxmeister: posts big blind $1
*** HOLE CARDS ***
Dealt to matiko09 [8c Tc]
178013: folds 
matiko09: folds 
HITYESCA: raises $2 to $3
sanpidk: folds 
Khaine_CM: folds 
CI58: folds 
andy84lfc: calls $2.50
maxxmeister: folds 
*** FLOP *** [8s 5c 6d]
andy84lfc: bets $3.32
HITYESCA: calls $3.32
*** TURN *** [8s 5c 6d] [5h]
andy84lfc: bets $6.48
HITYESCA: calls $6.48
*** RIVER *** [8s 5c 6d 5h] [2h]
andy84lfc: bets $8
HITYESCA: raises $15 to $23
andy84lfc: calls $15
*** SHOW DOWN ***
HITYESCA: shows [Qd Qs] (two pair, Queens and Fives)
andy84lfc: mucks hand 
HITYESCA collected $70.10 from pot
*** SUMMARY ***
Total pot $72.60 | Rake $2.50 
Board [8s 5c 6d 5h 2h]
Seat 1: HITYESCA showed [Qd Qs] and won ($70.10) with two pair, Queens and Fives
Seat 2: sanpidk folded before Flop (didn't bet)
Seat 3: Khaine_CM folded before Flop (didn't bet)
Seat 4: CI58 (button) folded before Flop (didn't bet)
Seat 6: andy84lfc (small blind) mucked [7c Ac]
Seat 7: maxxmeister (big blind) folded before Flop
Seat 8: 178013 folded before Flop (didn't bet)
Seat 9: matiko09 folded before Flop (didn't bet)





PokerStars Hand #152886522804:  Hold'em No Limit ($1/$2 USD) - 2016/05/05 16:48:01 CET [2016/05/05 10:48:01 ET]
Table 'Euporie II' 9-max Seat #5 is the button
Seat 1: PacPacBum ($203.50 in chips) 
Seat 2: kblkxls ($104.37 in chips) 
Seat 3: chaps1988 ($200 in chips) 
Seat 5: Nuskatko1986 ($127.39 in chips) 
Seat 6: Kukuryzka ($200 in chips) 
Seat 7: matiko09 ($200 in chips) 
Seat 8: Painkiller72 ($279.25 in chips) 
Seat 9: T0ny Adams ($201.21 in chips) 
Kukuryzka: posts small blind $1
matiko09: posts big blind $2
*** HOLE CARDS ***
Dealt to matiko09 [Jh 6c]
Painkiller72: folds 
T0ny Adams: folds 
PacPacBum: folds 
kblkxls: raises $4 to $6
chaps1988: folds 
Nuskatko1986: folds 
Kukuryzka: folds 
matiko09: folds 
Uncalled bet ($4) returned to kblkxls
kblkxls collected $5 from pot
kblkxls: doesn't show hand 
*** SUMMARY ***
Total pot $5 | Rake $0 
Seat 1: PacPacBum folded before Flop (didn't bet)
Seat 2: kblkxls collected ($5)
Seat 3: chaps1988 folded before Flop (didn't bet)
Seat 5: Nuskatko1986 (button) folded before Flop (didn't bet)
Seat 6: Kukuryzka (small blind) folded before Flop
Seat 7: matiko09 (big blind) folded before Flop
Seat 8: Painkiller72 folded before Flop (didn't bet)
Seat 9: T0ny Adams folded before Flop (didn't bet)





PokerStars Hand #152886523810:  Hold'em No Limit (€1/€2 EUR) - 2016/05/05 16:48:02 CET [2016/05/05 10:48:02 ET]
Table 'Skat II' 9-max Seat #7 is the button
Seat 1: Bebeto342193 (€97.52 in chips) 
Seat 3: Alex Frider (€200 in chips) 
Seat 7: PacPacBum (€200 in chips) 
Seat 8: Painkiller72 (€209 in chips) 
Seat 9: matiko09 (€203 in chips) 
Painkiller72: posts small blind €1
matiko09: posts big blind €2
Bebeto342193: posts big blind €2
JoaquinMRuiz: sits out 
ceedonen: sits out 
*** HOLE CARDS ***
Dealt to matiko09 [As 3c]
Bebeto342193: checks 
Alex Frider: calls €2
PacPacBum: folds 
Painkiller72: calls €1
matiko09: checks 
*** FLOP *** [8d 9d Jd]
Painkiller72: checks 
matiko09: checks 
Bebeto342193: bets €3.80
Alex Frider: folds 
Painkiller72: folds 
matiko09: folds 
Uncalled bet (€3.80) returned to Bebeto342193
Bebeto342193 collected €7.60 from pot
Bebeto342193: doesn't show hand 
*** SUMMARY ***
Total pot €8 | Rake €0.40 
Board [8d 9d Jd]
Seat 1: Bebeto342193 collected (€7.60)
Seat 3: Alex Frider folded on the Flop
Seat 7: PacPacBum (button) folded before Flop (didn't bet)
Seat 8: Painkiller72 (small blind) folded on the Flop
Seat 9: matiko09 (big blind) folded on the Flop





PokerStars Hand #152886523745:  Hold'em No Limit ($1/$2 USD) - 2016/05/05 16:48:02 CET [2016/05/05 10:48:02 ET]
Table 'Samitchell' 9-max Seat #5 is the button
Seat 1: Kukuryzka ($202 in chips) 
Seat 2: matiko09 ($298.26 in chips) 
Seat 3: han3bj ($208.25 in chips) 
Seat 5: chaps1988 ($271.12 in chips) 
Seat 6: PacPacBum ($203.57 in chips) 
Seat 7: patpaty ($164.11 in chips) 
Seat 8: tepi_guy ($203 in chips) 
Seat 9: kblkxls ($124.40 in chips) 
PacPacBum: posts small blind $1
patpaty: posts big blind $2
*** HOLE CARDS ***
Dealt to matiko09 [4h Kh]
tepi_guy: raises $3.40 to $5.40
kblkxls: folds 
Kukuryzka: folds 
matiko09: folds 
han3bj: folds 
chaps1988: folds 
PacPacBum: folds 
patpaty: folds 
Uncalled bet ($3.40) returned to tepi_guy
tepi_guy collected $5 from pot
tepi_guy: doesn't show hand 
*** SUMMARY ***
Total pot $5 | Rake $0 
Seat 1: Kukuryzka folded before Flop (didn't bet)
Seat 2: matiko09 folded before Flop (didn't bet)
Seat 3: han3bj folded before Flop (didn't bet)
Seat 5: chaps1988 (button) folded before Flop (didn't bet)
Seat 6: PacPacBum (small blind) folded before Flop
Seat 7: patpaty (big blind) folded before Flop
Seat 8: tepi_guy collected ($5)
Seat 9: kblkxls folded before Flop (didn't bet)





PokerStars Hand #152886530102:  Hold'em No Limit (€1/€2 EUR) - 2016/05/05 16:48:13 CET [2016/05/05 10:48:13 ET]
Table 'Bessel II' 9-max Seat #7 is the button
Seat 1: Soloaces224 (€218.43 in chips) 
Seat 3: PacPacBum (€214.02 in chips) 
Seat 4: Zorken76 (€169.97 in chips) 
Seat 5: Kukuryzka (€200 in chips) 
Seat 6: glanza_mike (€200 in chips) 
Seat 7: matiko09 (€207.20 in chips) 
Seat 8: chaps1988 (€235 in chips) 
Seat 9: JoaquinMRuiz (€203 in chips) 
chaps1988: posts small blind €1
JoaquinMRuiz: posts big blind €2
*** HOLE CARDS ***
Dealt to matiko09 [5s 5c]
Soloaces224: folds 
PacPacBum: folds 
Zorken76: folds 
Kukuryzka: folds 
glanza_mike: folds 
matiko09: raises €2.54 to €4.54
chaps1988: folds 
JoaquinMRuiz: folds 
Uncalled bet (€2.54) returned to matiko09
matiko09 collected €5 from pot
matiko09: doesn't show hand 
*** SUMMARY ***
Total pot €5 | Rake €0 
Seat 1: Soloaces224 folded before Flop (didn't bet)
Seat 3: PacPacBum folded before Flop (didn't bet)
Seat 4: Zorken76 folded before Flop (didn't bet)
Seat 5: Kukuryzka folded before Flop (didn't bet)
Seat 6: glanza_mike folded before Flop (didn't bet)
Seat 7: matiko09 (button) collected (€5)
Seat 8: chaps1988 (small blind) folded before Flop
Seat 9: JoaquinMRuiz (big blind) folded before Flop





PokerStars Hand #152886533208:  Hold'em No Limit ($1/$2 USD) - 2016/05/05 16:48:18 CET [2016/05/05 10:48:18 ET]
Table 'Tololo' 9-max Seat #3 is the button
Seat 1: Kukuryzka ($270.29 in chips) 
Seat 2: tepi_guy ($203 in chips) 
Seat 3: Khaine_CM ($200 in chips) 
Seat 4: mooose100 ($194.72 in chips) 
Seat 5: matiko09 ($231.10 in chips) 
Seat 6: Xagua ($132.70 in chips) 
Seat 7: chaps1988 ($302.37 in chips) 
Seat 8: myatiy 96 ($200 in chips) 
mooose100: posts small blind $1
matiko09: posts big blind $2
*** HOLE CARDS ***
Dealt to matiko09 [Jd 4d]
Xagua: folds 
chaps1988: folds 
myatiy 96: raises $4 to $6
Kukuryzka: folds 
tepi_guy: folds 
Khaine_CM: raises $10 to $16
mooose100: calls $15
matiko09: folds 
myatiy 96: calls $10
*** FLOP *** [6h Ah 5c]
mooose100: bets $23.75
myatiy 96: folds 
Khaine_CM: folds 
Uncalled bet ($23.75) returned to mooose100
mooose100 collected $47.50 from pot
mooose100: doesn't show hand 
*** SUMMARY ***
Total pot $50 | Rake $2.50 
Board [6h Ah 5c]
Seat 1: Kukuryzka folded before Flop (didn't bet)
Seat 2: tepi_guy folded before Flop (didn't bet)
Seat 3: Khaine_CM (button) folded on the Flop
Seat 4: mooose100 (small blind) collected ($47.50)
Seat 5: matiko09 (big blind) folded before Flop
Seat 6: Xagua folded before Flop (didn't bet)
Seat 7: chaps1988 folded before Flop (didn't bet)
Seat 8: myatiy 96 folded on the Flop





PokerStars Hand #152886535793:  Hold'em No Limit ($0.50/$1.00 USD) - 2016/05/05 16:48:22 CET [2016/05/05 10:48:22 ET]
Table 'Porzia' 9-max Seat #2 is the button
Seat 1: vrnMike ($130.50 in chips) 
Seat 2: matiko09 ($100 in chips) 
Seat 3: sanpidk ($100 in chips) 
Seat 4: Khaine_CM ($100 in chips) 
Seat 5: CZECHMYSAK ($60.20 in chips) 
Seat 6: janarr5 ($178.29 in chips) 
Seat 7: HITYESCA ($102.15 in chips) 
Seat 8: PRINCE JULIO ($78.69 in chips) 
Seat 9: kl4ssic ($66.67 in chips) 
sanpidk: posts small blind $0.50
Khaine_CM: posts big blind $1
*** HOLE CARDS ***
Dealt to matiko09 [Qh 7d]
CZECHMYSAK: folds 
janarr5: raises $2 to $3
HITYESCA: folds 
PRINCE JULIO: folds 
kl4ssic: folds 
vrnMike: folds 
matiko09: folds 
sanpidk: folds 
Khaine_CM: folds 
Uncalled bet ($2) returned to janarr5
janarr5 collected $2.50 from pot
janarr5: doesn't show hand 
*** SUMMARY ***
Total pot $2.50 | Rake $0 
Seat 1: vrnMike folded before Flop (didn't bet)
Seat 2: matiko09 (button) folded before Flop (didn't bet)
Seat 3: sanpidk (small blind) folded before Flop
Seat 4: Khaine_CM (big blind) folded before Flop
Seat 5: CZECHMYSAK folded before Flop (didn't bet)
Seat 6: janarr5 collected ($2.50)
Seat 7: HITYESCA folded before Flop (didn't bet)
Seat 8: PRINCE JULIO folded before Flop (didn't bet)
Seat 9: kl4ssic folded before Flop (didn't bet)





PokerStars Hand #152886541021:  Hold'em No Limit ($1/$2 USD) - 2016/05/05 16:48:30 CET [2016/05/05 10:48:30 ET]
Table 'Lundia' 9-max Seat #3 is the button
Seat 3: Painkiller72 ($203.25 in chips) 
Seat 4: PacPacBum ($200 in chips) 
Seat 5: zmOe84 ($207.82 in chips) 
Seat 6: CI58 ($282.98 in chips) 
Seat 7: matiko09 ($240.64 in chips) 
Seat 8: chaps1988 ($231.59 in chips) 
Seat 9: tepi_guy ($200 in chips) 
PacPacBum: posts small blind $1
zmOe84: posts big blind $2
Alex Frider: sits out 
*** HOLE CARDS ***
Dealt to matiko09 [9s 8c]
CI58: folds 
matiko09: folds 
chaps1988: raises $3 to $5
tepi_guy: folds 
Painkiller72: folds 
PacPacBum: calls $4
zmOe84: folds 
*** FLOP *** [3h 7h 6c]
PacPacBum: checks 
chaps1988: checks 
*** TURN *** [3h 7h 6c] [2h]
PacPacBum: bets $6.15
chaps1988: folds 
Uncalled bet ($6.15) returned to PacPacBum
PacPacBum collected $11.40 from pot
PacPacBum: doesn't show hand 
*** SUMMARY ***
Total pot $12 | Rake $0.60 
Board [3h 7h 6c 2h]
Seat 3: Painkiller72 (button) folded before Flop (didn't bet)
Seat 4: PacPacBum (small blind) collected ($11.40)
Seat 5: zmOe84 (big blind) folded before Flop
Seat 6: CI58 folded before Flop (didn't bet)
Seat 7: matiko09 folded before Flop (didn't bet)
Seat 8: chaps1988 folded on the Turn
Seat 9: tepi_guy folded before Flop (didn't bet)





PokerStars Hand #152886542255:  Hold'em No Limit ($1/$2 USD) - 2016/05/05 16:48:32 CET [2016/05/05 10:48:32 ET]
Table 'Samitchell' 9-max Seat #6 is the button
Seat 1: Kukuryzka ($202 in chips) 
Seat 2: matiko09 ($298.26 in chips) 
Seat 3: han3bj ($208.25 in chips) 
Seat 5: chaps1988 ($271.12 in chips) 
Seat 6: PacPacBum ($202.57 in chips) 
Seat 7: patpaty ($162.11 in chips) 
Seat 8: tepi_guy ($206 in chips) 
Seat 9: kblkxls ($124.40 in chips) 
patpaty: posts small blind $1
tepi_guy: posts big blind $2
*** HOLE CARDS ***
Dealt to matiko09 [Js 5h]
kblkxls: folds 
Kukuryzka: folds 
matiko09: folds 
han3bj: raises $4 to $6
chaps1988: folds 
PacPacBum: folds 
patpaty: folds 
tepi_guy: calls $4
*** FLOP *** [Ah 8c Qd]
tepi_guy: checks 
han3bj: checks 
*** TURN *** [Ah 8c Qd] [As]
tepi_guy: bets $9.88
han3bj: calls $9.88
*** RIVER *** [Ah 8c Qd As] [2h]
tepi_guy: bets $20.92
han3bj: folds 
Uncalled bet ($20.92) returned to tepi_guy
tepi_guy collected $31.12 from pot
tepi_guy: doesn't show hand 
*** SUMMARY ***
Total pot $32.76 | Rake $1.64 
Board [Ah 8c Qd As 2h]
Seat 1: Kukuryzka folded before Flop (didn't bet)
Seat 2: matiko09 folded before Flop (didn't bet)
Seat 3: han3bj folded on the River
Seat 5: chaps1988 folded before Flop (didn't bet)
Seat 6: PacPacBum (button) folded before Flop (didn't bet)
Seat 7: patpaty (small blind) folded before Flop
Seat 8: tepi_guy (big blind) collected ($31.12)
Seat 9: kblkxls folded before Flop (didn't bet)





PokerStars Hand #152886542265:  Hold'em No Limit ($1/$2 USD) - 2016/05/05 16:48:33 CET [2016/05/05 10:48:33 ET]
Table 'Tatry II' 9-max Seat #8 is the button
Seat 1: glanza_mike ($220.80 in chips) 
Seat 2: T0ny Adams ($60.06 in chips) 
Seat 3: matiko09 ($200 in chips) 
Seat 4: PacPacBum ($217.17 in chips) 
Seat 5: Painkiller72 ($317.75 in chips) 
Seat 6: Kukuryzka ($273.60 in chips) 
Seat 8: chaps1988 ($255.54 in chips) 
Seat 9: korol702 ($169.25 in chips) 
korol702: posts small blind $1
glanza_mike: posts big blind $2
*** HOLE CARDS ***
Dealt to matiko09 [2h 2c]
T0ny Adams: folds 
matiko09: raises $3 to $5
PacPacBum: folds 
Painkiller72: folds 
Kukuryzka: folds 
chaps1988: folds 
korol702: folds 
glanza_mike: folds 
Uncalled bet ($3) returned to matiko09
matiko09 collected $5 from pot
matiko09: doesn't show hand 
*** SUMMARY ***
Total pot $5 | Rake $0 
Seat 1: glanza_mike (big blind) folded before Flop
Seat 2: T0ny Adams folded before Flop (didn't bet)
Seat 3: matiko09 collected ($5)
Seat 4: PacPacBum folded before Flop (didn't bet)
Seat 5: Painkiller72 folded before Flop (didn't bet)
Seat 6: Kukuryzka folded before Flop (didn't bet)
Seat 8: chaps1988 (button) folded before Flop (didn't bet)
Seat 9: korol702 (small blind) folded before Flop





PokerStars Hand #152886546655:  Hold'em No Limit (€1/€2 EUR) - 2016/05/05 16:48:40 CET [2016/05/05 10:48:40 ET]
Table 'Bessel II' 9-max Seat #8 is the button
Seat 1: Soloaces224 (€218.43 in chips) 
Seat 3: PacPacBum (€214.02 in chips) 
Seat 4: Zorken76 (€169.97 in chips) 
Seat 5: Kukuryzka (€200 in chips) 
Seat 6: glanza_mike (€200 in chips) 
Seat 7: matiko09 (€210.20 in chips) 
Seat 8: chaps1988 (€234 in chips) 
Seat 9: JoaquinMRuiz (€201 in chips) 
JoaquinMRuiz: posts small blind €1
Soloaces224: posts big blind €2
*** HOLE CARDS ***
Dealt to matiko09 [4d 6s]
PacPacBum: folds 
Zorken76: folds 
Kukuryzka: folds 
glanza_mike: raises €4 to €6
matiko09: folds 
chaps1988: folds 
JoaquinMRuiz: folds 
Soloaces224: calls €4
*** FLOP *** [Ts 4s Ad]
Soloaces224: checks 
glanza_mike: checks 
*** TURN *** [Ts 4s Ad] [Jh]
Soloaces224: checks 
glanza_mike: checks 
*** RIVER *** [Ts 4s Ad Jh] [8s]
Soloaces224: checks 
glanza_mike: bets €9.50
Soloaces224: folds 
Uncalled bet (€9.50) returned to glanza_mike
glanza_mike collected €12.35 from pot
glanza_mike: doesn't show hand 
*** SUMMARY ***
Total pot €13 | Rake €0.65 
Board [Ts 4s Ad Jh 8s]
Seat 1: Soloaces224 (big blind) folded on the River
Seat 3: PacPacBum folded before Flop (didn't bet)
Seat 4: Zorken76 folded before Flop (didn't bet)
Seat 5: Kukuryzka folded before Flop (didn't bet)
Seat 6: glanza_mike collected (€12.35)
Seat 7: matiko09 folded before Flop (didn't bet)
Seat 8: chaps1988 (button) folded before Flop (didn't bet)
Seat 9: JoaquinMRuiz (small blind) folded before Flop





PokerStars Hand #152886550350:  Hold'em No Limit (€1/€2 EUR) - 2016/05/05 16:48:46 CET [2016/05/05 10:48:46 ET]
Table 'Skat II' 9-max Seat #8 is the button
Seat 1: Bebeto342193 (€103.12 in chips) 
Seat 3: Alex Frider (€200 in chips) 
Seat 7: PacPacBum (€200 in chips) 
Seat 8: Painkiller72 (€207 in chips) 
Seat 9: matiko09 (€201 in chips) 
matiko09: posts small blind €1
Bebeto342193: posts big blind €2
JoaquinMRuiz: sits out 
ceedonen: sits out 
*** HOLE CARDS ***
Dealt to matiko09 [Kh 4c]
Alex Frider: folds 
PacPacBum: folds 
Painkiller72: raises €2 to €4
matiko09: folds 
Bebeto342193: folds 
Uncalled bet (€2) returned to Painkiller72
Painkiller72 collected €5 from pot
Painkiller72: doesn't show hand 
*** SUMMARY ***
Total pot €5 | Rake €0 
Seat 1: Bebeto342193 (big blind) folded before Flop
Seat 3: Alex Frider folded before Flop (didn't bet)
Seat 7: PacPacBum folded before Flop (didn't bet)
Seat 8: Painkiller72 (button) collected (€5)
Seat 9: matiko09 (small blind) folded before Flop





PokerStars Hand #152886552625:  Hold'em No Limit ($1/$2 USD) - 2016/05/05 16:48:49 CET [2016/05/05 10:48:49 ET]
Table 'Euporie II' 9-max Seat #6 is the button
Seat 1: PacPacBum ($203.50 in chips) 
Seat 2: kblkxls ($107.37 in chips) 
Seat 3: chaps1988 ($200 in chips) 
Seat 5: Nuskatko1986 ($127.39 in chips) 
Seat 6: Kukuryzka ($199 in chips) 
Seat 7: matiko09 ($200 in chips) 
Seat 8: Painkiller72 ($279.25 in chips) 
Seat 9: T0ny Adams ($201.21 in chips) 
matiko09: posts small blind $1
Painkiller72: posts big blind $2
*** HOLE CARDS ***
Dealt to matiko09 [Js Ts]
T0ny Adams: folds 
PacPacBum: folds 
kblkxls: folds 
chaps1988: folds 
Nuskatko1986: folds 
Kukuryzka: folds 
matiko09: raises $3 to $5
Painkiller72: folds 
Uncalled bet ($3) returned to matiko09
matiko09 collected $4 from pot
matiko09: doesn't show hand 
*** SUMMARY ***
Total pot $4 | Rake $0 
Seat 1: PacPacBum folded before Flop (didn't bet)
Seat 2: kblkxls folded before Flop (didn't bet)
Seat 3: chaps1988 folded before Flop (didn't bet)
Seat 5: Nuskatko1986 folded before Flop (didn't bet)
Seat 6: Kukuryzka (button) folded before Flop (didn't bet)
Seat 7: matiko09 (small blind) collected ($4)
Seat 8: Painkiller72 (big blind) folded before Flop
Seat 9: T0ny Adams folded before Flop (didn't bet)





PokerStars Hand #152886558887:  Hold'em No Limit ($1/$2 USD) - 2016/05/05 16:49:00 CET [2016/05/05 10:49:00 ET]
Table 'Tatry II' 9-max Seat #9 is the button
Seat 1: glanza_mike ($218.80 in chips) 
Seat 2: T0ny Adams ($60.06 in chips) 
Seat 3: matiko09 ($203 in chips) 
Seat 4: PacPacBum ($217.17 in chips) 
Seat 5: Painkiller72 ($317.75 in chips) 
Seat 6: Kukuryzka ($273.60 in chips) 
Seat 8: chaps1988 ($255.54 in chips) 
Seat 9: korol702 ($168.25 in chips) 
glanza_mike: posts small blind $1
T0ny Adams: posts big blind $2
*** HOLE CARDS ***
Dealt to matiko09 [4h Js]
matiko09: folds 
PacPacBum: folds 
Painkiller72: folds 
Kukuryzka: folds 
chaps1988: folds 
korol702: folds 
glanza_mike: folds 
Uncalled bet ($1) returned to T0ny Adams
T0ny Adams collected $2 from pot
T0ny Adams: doesn't show hand 
*** SUMMARY ***
Total pot $2 | Rake $0 
Seat 1: glanza_mike (small blind) folded before Flop
Seat 2: T0ny Adams (big blind) collected ($2)
Seat 3: matiko09 folded before Flop (didn't bet)
Seat 4: PacPacBum folded before Flop (didn't bet)
Seat 5: Painkiller72 folded before Flop (didn't bet)
Seat 6: Kukuryzka folded before Flop (didn't bet)
Seat 8: chaps1988 folded before Flop (didn't bet)
Seat 9: korol702 (button) folded before Flop (didn't bet)





PokerStars Hand #152886561220:  Hold'em No Limit (€1/€2 EUR) - 2016/05/05 16:49:03 CET [2016/05/05 10:49:03 ET]
Table 'Skat II' 9-max Seat #9 is the button
Seat 1: Bebeto342193 (€101.12 in chips) 
Seat 3: Alex Frider (€200 in chips) 
Seat 7: PacPacBum (€200 in chips) 
Seat 8: Painkiller72 (€210 in chips) 
Seat 9: matiko09 (€200 in chips) 
Bebeto342193: posts small blind €1
Fitzyferret was removed from the table for failing to post
Alex Frider: posts big blind €2
JoaquinMRuiz: sits out 
ceedonen: sits out 
*** HOLE CARDS ***
Dealt to matiko09 [2c 4d]
myatiy 96 joins the table at seat #2 
PacPacBum: folds 
Painkiller72: folds 
matiko09: folds 
Bebeto342193: raises €2 to €4
Alex Frider: calls €2
*** FLOP *** [9s 8h Kh]
Bebeto342193: checks 
Alex Frider: checks 
*** TURN *** [9s 8h Kh] [7c]
Bebeto342193: bets €3.80
Alex Frider: calls €3.80
*** RIVER *** [9s 8h Kh 7c] [8d]
Bebeto342193: bets €7.41
Alex Frider: calls €7.41
*** SHOW DOWN ***
Bebeto342193: shows [3h Jh] (a pair of Eights)
Alex Frider: shows [9h Ts] (two pair, Nines and Eights)
Alex Frider collected €28.90 from pot
*** SUMMARY ***
Total pot €30.42 | Rake €1.52 
Board [9s 8h Kh 7c 8d]
Seat 1: Bebeto342193 (small blind) showed [3h Jh] and lost with a pair of Eights
Seat 3: Alex Frider (big blind) showed [9h Ts] and won (€28.90) with two pair, Nines and Eights
Seat 7: PacPacBum folded before Flop (didn't bet)
Seat 8: Painkiller72 folded before Flop (didn't bet)
Seat 9: matiko09 (button) folded before Flop (didn't bet)





PokerStars Hand #152886565063:  Hold'em No Limit ($0.50/$1.00 USD) - 2016/05/05 16:49:10 CET [2016/05/05 10:49:10 ET]
Table 'Porzia' 9-max Seat #3 is the button
Seat 1: vrnMike ($130.50 in chips) 
Seat 2: matiko09 ($100 in chips) 
Seat 3: sanpidk ($100 in chips) 
Seat 4: Khaine_CM ($100 in chips) 
Seat 5: CZECHMYSAK ($60.20 in chips) 
Seat 6: janarr5 ($179.79 in chips) 
Seat 7: HITYESCA ($102.15 in chips) 
Seat 8: PRINCE JULIO ($78.69 in chips) 
Seat 9: kl4ssic ($66.67 in chips) 
Khaine_CM: posts small blind $0.50
CZECHMYSAK: posts big blind $1
*** HOLE CARDS ***
Dealt to matiko09 [7d 7s]
janarr5: folds 
HITYESCA: folds 
PRINCE JULIO: folds 
kl4ssic: folds 
vrnMike: raises $1 to $2
matiko09: calls $2
sanpidk: calls $2
Khaine_CM: folds 
CZECHMYSAK: calls $1
*** FLOP *** [6d 2s As]
CZECHMYSAK: checks 
vrnMike: checks 
matiko09: checks 
sanpidk: checks 
*** TURN *** [6d 2s As] [5c]
CZECHMYSAK: bets $4.04
vrnMike: calls $4.04
matiko09: folds 
sanpidk: folds 
*** RIVER *** [6d 2s As 5c] [3c]
CZECHMYSAK: checks 
vrnMike: bets $21
CZECHMYSAK: folds 
Uncalled bet ($21) returned to vrnMike
vrnMike collected $15.75 from pot
*** SUMMARY ***
Total pot $16.58 | Rake $0.83 
Board [6d 2s As 5c 3c]
Seat 1: vrnMike collected ($15.75)
Seat 2: matiko09 folded on the Turn
Seat 3: sanpidk (button) folded on the Turn
Seat 4: Khaine_CM (small blind) folded before Flop
Seat 5: CZECHMYSAK (big blind) folded on the River
Seat 6: janarr5 folded before Flop (didn't bet)
Seat 7: HITYESCA folded before Flop (didn't bet)
Seat 8: PRINCE JULIO folded before Flop (didn't bet)
Seat 9: kl4ssic folded before Flop (didn't bet)





PokerStars Hand #152886565911:  Hold'em No Limit ($1/$2 USD) - 2016/05/05 16:49:11 CET [2016/05/05 10:49:11 ET]
Table 'Euporie II' 9-max Seat #7 is the button
Seat 1: PacPacBum ($203.50 in chips) 
Seat 2: kblkxls ($107.37 in chips) 
Seat 3: chaps1988 ($200 in chips) 
Seat 5: Nuskatko1986 ($127.39 in chips) 
Seat 6: Kukuryzka ($199 in chips) 
Seat 7: matiko09 ($202 in chips) 
Seat 8: Painkiller72 ($277.25 in chips) 
Painkiller72: posts small blind $1
T0ny Adams: is sitting out 
PacPacBum: posts big blind $2
*** HOLE CARDS ***
Dealt to matiko09 [Js 2c]
kblkxls: folds 
chaps1988: folds 
T0ny Adams leaves the table
Nuskatko1986: calls $2
myatiy 96 joins the table at seat #9 
Kukuryzka: folds 
matiko09: folds 
Painkiller72: folds 
PacPacBum: checks 
*** FLOP *** [Qs 6c 4d]
PacPacBum: checks 
Nuskatko1986: checks 
*** TURN *** [Qs 6c 4d] [3s]
PacPacBum: bets $2.56
Nuskatko1986: calls $2.56
*** RIVER *** [Qs 6c 4d 3s] [Ac]
PacPacBum: checks 
Nuskatko1986: bets $42
PacPacBum: folds 
Uncalled bet ($42) returned to Nuskatko1986
Nuskatko1986 collected $9.61 from pot
Nuskatko1986: doesn't show hand 
*** SUMMARY ***
Total pot $10.12 | Rake $0.51 
Board [Qs 6c 4d 3s Ac]
Seat 1: PacPacBum (big blind) folded on the River
Seat 2: kblkxls folded before Flop (didn't bet)
Seat 3: chaps1988 folded before Flop (didn't bet)
Seat 5: Nuskatko1986 collected ($9.61)
Seat 6: Kukuryzka folded before Flop (didn't bet)
Seat 7: matiko09 (button) folded before Flop (didn't bet)
Seat 8: Painkiller72 (small blind) folded before Flop





PokerStars Hand #152886567548:  Hold'em No Limit ($0.50/$1.00 USD) - 2016/05/05 16:49:14 CET [2016/05/05 10:49:14 ET]
Table 'Kraz II' 9-max Seat #6 is the button
Seat 1: HITYESCA ($134.30 in chips) 
Seat 2: sanpidk ($144.84 in chips) 
Seat 3: Khaine_CM ($105.48 in chips) 
Seat 4: CI58 ($100 in chips) 
Seat 6: andy84lfc ($209.48 in chips) 
Seat 7: maxxmeister ($100 in chips) 
Seat 8: 178013 ($94 in chips) 
Seat 9: matiko09 ($181.87 in chips) 
maxxmeister: posts small blind $0.50
178013: posts big blind $1
Alex Frider: sits out 
*** HOLE CARDS ***
Dealt to matiko09 [Tc 4s]
matiko09: folds 
HITYESCA: folds 
sanpidk: folds 
Khaine_CM: folds 
CI58: folds 
andy84lfc: raises $2 to $3
maxxmeister: folds 
178013: raises $7.50 to $10.50
andy84lfc: calls $7.50
*** FLOP *** [8s 4h 2c]
178013: bets $13
andy84lfc: raises $59 to $72
178013: raises $11.50 to $83.50 and is all-in
andy84lfc: calls $11.50
*** TURN *** [8s 4h 2c] [Kc]
*** RIVER *** [8s 4h 2c Kc] [Qd]
*** SHOW DOWN ***
178013: shows [7d 8d] (a pair of Eights)
andy84lfc: shows [4d Ac] (a pair of Fours)
178013 collected $186 from pot
*** SUMMARY ***
Total pot $188.50 | Rake $2.50 
Board [8s 4h 2c Kc Qd]
Seat 1: HITYESCA folded before Flop (didn't bet)
Seat 2: sanpidk folded before Flop (didn't bet)
Seat 3: Khaine_CM folded before Flop (didn't bet)
Seat 4: CI58 folded before Flop (didn't bet)
Seat 6: andy84lfc (button) showed [4d Ac] and lost with a pair of Fours
Seat 7: maxxmeister (small blind) folded before Flop
Seat 8: 178013 (big blind) showed [7d 8d] and won ($186) with a pair of Eights
Seat 9: matiko09 folded before Flop (didn't bet)





PokerStars Hand #152886573634:  Hold'em No Limit ($1/$2 USD) - 2016/05/05 16:49:24 CET [2016/05/05 10:49:24 ET]
Table 'Samitchell' 9-max Seat #7 is the button
Seat 1: Kukuryzka ($202 in chips) 
Seat 2: matiko09 ($298.26 in chips) 
Seat 3: han3bj ($192.37 in chips) 
Seat 5: chaps1988 ($271.12 in chips) 
Seat 6: PacPacBum ($202.57 in chips) 
Seat 7: patpaty ($161.11 in chips) 
Seat 8: tepi_guy ($221.24 in chips) 
Seat 9: kblkxls ($124.40 in chips) 
tepi_guy: posts small blind $1
kblkxls: posts big blind $2
*** HOLE CARDS ***
Dealt to matiko09 [Ah 2d]
Kukuryzka: folds 
Kukuryzka leaves the table
CI58 joins the table at seat #1 
matiko09: folds 
han3bj: raises $4 to $6
chaps1988: folds 
PacPacBum: raises $12 to $18
patpaty: folds 
tepi_guy: folds 
kblkxls: folds 
han3bj: folds 
Uncalled bet ($12) returned to PacPacBum
PacPacBum collected $15 from pot
PacPacBum: doesn't show hand 
*** SUMMARY ***
Total pot $15 | Rake $0 
Seat 1: Kukuryzka folded before Flop (didn't bet)
Seat 2: matiko09 folded before Flop (didn't bet)
Seat 3: han3bj folded before Flop
Seat 5: chaps1988 folded before Flop (didn't bet)
Seat 6: PacPacBum collected ($15)
Seat 7: patpaty (button) folded before Flop (didn't bet)
Seat 8: tepi_guy (small blind) folded before Flop
Seat 9: kblkxls (big blind) folded before Flop





PokerStars Hand #152886577042:  Hold'em No Limit ($1/$2 USD) - 2016/05/05 16:49:29 CET [2016/05/05 10:49:29 ET]
Table 'Tatry II' 9-max Seat #1 is the button
Seat 1: glanza_mike ($217.80 in chips) 
Seat 2: T0ny Adams ($61.06 in chips) 
Seat 3: matiko09 ($203 in chips) 
Seat 4: PacPacBum ($217.17 in chips) 
Seat 5: Painkiller72 ($317.75 in chips) 
Seat 6: Kukuryzka ($273.60 in chips) 
Seat 8: chaps1988 ($255.54 in chips) 
Seat 9: korol702 ($168.25 in chips) 
T0ny Adams: posts small blind $1
matiko09: posts big blind $2
*** HOLE CARDS ***
Dealt to matiko09 [8h Jh]
PacPacBum: folds 
Painkiller72: folds 
Kukuryzka: folds 
chaps1988: folds 
korol702: raises $4 to $6
glanza_mike: folds 
T0ny Adams: folds 
matiko09: folds 
Uncalled bet ($4) returned to korol702
korol702 collected $5 from pot
*** SUMMARY ***
Total pot $5 | Rake $0 
Seat 1: glanza_mike (button) folded before Flop (didn't bet)
Seat 2: T0ny Adams (small blind) folded before Flop
Seat 3: matiko09 (big blind) folded before Flop
Seat 4: PacPacBum folded before Flop (didn't bet)
Seat 5: Painkiller72 folded before Flop (didn't bet)
Seat 6: Kukuryzka folded before Flop (didn't bet)
Seat 8: chaps1988 folded before Flop (didn't bet)
Seat 9: korol702 collected ($5)





PokerStars Hand #152886579101:  Hold'em No Limit ($1/$2 USD) - 2016/05/05 16:49:33 CET [2016/05/05 10:49:33 ET]
Table 'Tololo' 9-max Seat #4 is the button
Seat 1: Kukuryzka ($270.29 in chips) 
Seat 2: tepi_guy ($203 in chips) 
Seat 3: Khaine_CM ($200 in chips) 
Seat 4: mooose100 ($226.22 in chips) 
Seat 5: matiko09 ($229.10 in chips) 
Seat 6: Xagua ($132.70 in chips) 
Seat 7: chaps1988 ($302.37 in chips) 
Seat 8: myatiy 96 ($200 in chips) 
matiko09: posts small blind $1
Xagua: posts big blind $2
*** HOLE CARDS ***
Dealt to matiko09 [Qd Kh]
chaps1988: raises $4 to $6
myatiy 96: folds 
Kukuryzka: folds 
tepi_guy: folds 
Khaine_CM: folds 
mooose100: folds 
matiko09: folds 
Xagua: calls $4
*** FLOP *** [6d Th 2d]
Xagua: checks 
chaps1988: bets $7
Xagua: calls $7
*** TURN *** [6d Th 2d] [Qc]
Xagua: checks 
chaps1988: bets $22
Xagua: folds 
Uncalled bet ($22) returned to chaps1988
chaps1988 collected $25.65 from pot
*** SUMMARY ***
Total pot $27 | Rake $1.35 
Board [6d Th 2d Qc]
Seat 1: Kukuryzka folded before Flop (didn't bet)
Seat 2: tepi_guy folded before Flop (didn't bet)
Seat 3: Khaine_CM folded before Flop (didn't bet)
Seat 4: mooose100 (button) folded before Flop (didn't bet)
Seat 5: matiko09 (small blind) folded before Flop
Seat 6: Xagua (big blind) folded on the Turn
Seat 7: chaps1988 collected ($25.65)
Seat 8: myatiy 96 folded before Flop (didn't bet)





PokerStars Hand #152886584147:  Hold'em No Limit (€1/€2 EUR) - 2016/05/05 16:49:41 CET [2016/05/05 10:49:41 ET]
Table 'Bessel II' 9-max Seat #9 is the button
Seat 1: Soloaces224 (€212.43 in chips) 
Seat 3: PacPacBum (€214.02 in chips) 
Seat 4: Zorken76 (€169.97 in chips) 
Seat 5: Kukuryzka (€200 in chips) 
Seat 6: glanza_mike (€206.35 in chips) 
Seat 7: matiko09 (€210.20 in chips) 
Seat 8: chaps1988 (€234 in chips) 
Seat 9: JoaquinMRuiz (€200 in chips) 
Soloaces224: posts small blind €1
PacPacBum: posts big blind €2
*** HOLE CARDS ***
Dealt to matiko09 [Js 2s]
Zorken76: folds 
Kukuryzka: folds 
glanza_mike: folds 
matiko09: folds 
chaps1988: folds 
JoaquinMRuiz: folds 
Soloaces224: calls €1
PacPacBum: checks 
*** FLOP *** [7h Td 5d]
Soloaces224: bets €3.80
PacPacBum: folds 
Uncalled bet (€3.80) returned to Soloaces224
Soloaces224 collected €3.80 from pot
Soloaces224: doesn't show hand 
*** SUMMARY ***
Total pot €4 | Rake €0.20 
Board [7h Td 5d]
Seat 1: Soloaces224 (small blind) collected (€3.80)
Seat 3: PacPacBum (big blind) folded on the Flop
Seat 4: Zorken76 folded before Flop (didn't bet)
Seat 5: Kukuryzka folded before Flop (didn't bet)
Seat 6: glanza_mike folded before Flop (didn't bet)
Seat 7: matiko09 folded before Flop (didn't bet)
Seat 8: chaps1988 folded before Flop (didn't bet)
Seat 9: JoaquinMRuiz (button) folded before Flop (didn't bet)





PokerStars Hand #152886585046:  Hold'em No Limit (€1/€2 EUR) - 2016/05/05 16:49:42 CET [2016/05/05 10:49:42 ET]
Table 'Skat II' 9-max Seat #1 is the button
Seat 1: Bebeto342193 (€85.91 in chips) 
Seat 3: Alex Frider (€213.69 in chips) 
Seat 4: JoaquinMRuiz (€241.44 in chips) 
Seat 7: PacPacBum (€200 in chips) 
Seat 8: Painkiller72 (€210 in chips) 
Seat 9: matiko09 (€200 in chips) 
myatiy 96 will be allowed to play after the button
Alex Frider: posts small blind €1
JoaquinMRuiz: posts big blind €2
ceedonen: sits out 
*** HOLE CARDS ***
Dealt to matiko09 [2s 3s]
PacPacBum: folds 
Painkiller72: raises €3 to €5
matiko09: folds 
Bebeto342193: folds 
Alex Frider: folds 
JoaquinMRuiz: folds 
Uncalled bet (€3) returned to Painkiller72
Painkiller72 collected €5 from pot
Painkiller72: doesn't show hand 
*** SUMMARY ***
Total pot €5 | Rake €0 
Seat 1: Bebeto342193 (button) folded before Flop (didn't bet)
Seat 3: Alex Frider (small blind) folded before Flop
Seat 4: JoaquinMRuiz (big blind) folded before Flop
Seat 7: PacPacBum folded before Flop (didn't bet)
Seat 8: Painkiller72 collected (€5)
Seat 9: matiko09 folded before Flop (didn't bet)





PokerStars Hand #152886598545:  Hold'em No Limit (€1/€2 EUR) - 2016/05/05 16:50:04 CET [2016/05/05 10:50:04 ET]
Table 'Skat II' 9-max Seat #3 is the button
Seat 1: Bebeto342193 (€85.91 in chips) 
Seat 3: Alex Frider (€212.69 in chips) 
Seat 4: JoaquinMRuiz (€239.44 in chips) 
Seat 5: ceedonen (€200 in chips) 
Seat 7: PacPacBum (€200 in chips) 
Seat 8: Painkiller72 (€213 in chips) 
Seat 9: matiko09 (€200 in chips) 
JoaquinMRuiz: posts small blind €1
ceedonen: posts big blind €2
*** HOLE CARDS ***
Dealt to matiko09 [Th 4h]
PacPacBum: raises €2.08 to €4.08
myatiy 96 leaves the table
Kukuryzka joins the table at seat #2 
Painkiller72: folds 
Kukuryzka leaves the table
Fitzyferret joins the table at seat #2 
matiko09: folds 
Bebeto342193: raises €11.16 to €15.24
Alex Frider: folds 
JoaquinMRuiz: folds 
ceedonen: folds 
PacPacBum: folds 
Uncalled bet (€11.16) returned to Bebeto342193
Bebeto342193 collected €11.16 from pot
Bebeto342193: doesn't show hand 
*** SUMMARY ***
Total pot €11.16 | Rake €0 
Seat 1: Bebeto342193 collected (€11.16)
Seat 3: Alex Frider (button) folded before Flop (didn't bet)
Seat 4: JoaquinMRuiz (small blind) folded before Flop
Seat 5: ceedonen (big blind) folded before Flop
Seat 7: PacPacBum folded before Flop
Seat 8: Painkiller72 folded before Flop (didn't bet)
Seat 9: matiko09 folded before Flop (didn't bet)





PokerStars Hand #152886603460:  Hold'em No Limit ($1/$2 USD) - 2016/05/05 16:50:12 CET [2016/05/05 10:50:12 ET]
Table 'Euporie II' 9-max Seat #8 is the button
Seat 1: PacPacBum ($200 in chips) 
Seat 2: kblkxls ($107.37 in chips) 
Seat 3: chaps1988 ($200 in chips) 
Seat 5: Nuskatko1986 ($132.44 in chips) 
Seat 6: Kukuryzka ($199 in chips) 
Seat 7: matiko09 ($202 in chips) 
Seat 8: Painkiller72 ($276.25 in chips) 
myatiy 96 will be allowed to play after the button
PacPacBum: posts small blind $1
kblkxls: posts big blind $2
*** HOLE CARDS ***
Dealt to matiko09 [Ac 2c]
chaps1988: folds 
Nuskatko1986: calls $2
Kukuryzka: folds 
matiko09: raises $6 to $8
Painkiller72: folds 
PacPacBum: folds 
kblkxls: folds 
Fitzyferret leaves the table
Nuskatko1986: calls $6
*** FLOP *** [3c 5s 5c]
tepi_guy joins the table at seat #4 
Nuskatko1986: checks 
matiko09: bets $10
Nuskatko1986: calls $10
*** TURN *** [3c 5s 5c] [2d]
Nuskatko1986: checks 
matiko09: checks 
*** RIVER *** [3c 5s 5c 2d] [Ts]
Nuskatko1986: bets $66
matiko09: folds 
Uncalled bet ($66) returned to Nuskatko1986
Nuskatko1986 collected $37.05 from pot
Nuskatko1986: doesn't show hand 
*** SUMMARY ***
Total pot $39 | Rake $1.95 
Board [3c 5s 5c 2d Ts]
Seat 1: PacPacBum (small blind) folded before Flop
Seat 2: kblkxls (big blind) folded before Flop
Seat 3: chaps1988 folded before Flop (didn't bet)
Seat 5: Nuskatko1986 collected ($37.05)
Seat 6: Kukuryzka folded before Flop (didn't bet)
Seat 7: matiko09 folded on the River
Seat 8: Painkiller72 (button) folded before Flop (didn't bet)





PokerStars Hand #152886604477:  Hold'em No Limit (€1/€2 EUR) - 2016/05/05 16:50:14 CET [2016/05/05 10:50:14 ET]
Table 'Bessel II' 9-max Seat #1 is the button
Seat 1: Soloaces224 (€214.23 in chips) 
Seat 3: PacPacBum (€212.02 in chips) 
Seat 4: Zorken76 (€169.97 in chips) 
Seat 5: Kukuryzka (€200 in chips) 
Seat 6: glanza_mike (€206.35 in chips) 
Seat 7: matiko09 (€210.20 in chips) 
Seat 8: chaps1988 (€234 in chips) 
Seat 9: JoaquinMRuiz (€200 in chips) 
Fitzyferret will be allowed to play after the button
PacPacBum: posts small blind €1
Zorken76: posts big blind €2
*** HOLE CARDS ***
Dealt to matiko09 [2c 9d]
Kukuryzka: folds 
glanza_mike: raises €4 to €6
matiko09: folds 
chaps1988: folds 
JoaquinMRuiz: folds 
Soloaces224: folds 
PacPacBum: folds 
Zorken76: calls €4
*** FLOP *** [Qs 4h Ks]
Zorken76: checks 
glanza_mike: bets €6.17
Zorken76: folds 
Uncalled bet (€6.17) returned to glanza_mike
glanza_mike collected €12.35 from pot
glanza_mike: doesn't show hand 
*** SUMMARY ***
Total pot €13 | Rake €0.65 
Board [Qs 4h Ks]
Seat 1: Soloaces224 (button) folded before Flop (didn't bet)
Seat 3: PacPacBum (small blind) folded before Flop
Seat 4: Zorken76 (big blind) folded on the Flop
Seat 5: Kukuryzka folded before Flop (didn't bet)
Seat 6: glanza_mike collected (€12.35)
Seat 7: matiko09 folded before Flop (didn't bet)
Seat 8: chaps1988 folded before Flop (didn't bet)
Seat 9: JoaquinMRuiz folded before Flop (didn't bet)





PokerStars Hand #152886605419:  Hold'em No Limit ($1/$2 USD) - 2016/05/05 16:50:16 CET [2016/05/05 10:50:16 ET]
Table 'Tatry II' 9-max Seat #2 is the button
Seat 1: glanza_mike ($217.80 in chips) 
Seat 2: T0ny Adams ($60.06 in chips) 
Seat 3: matiko09 ($201 in chips) 
Seat 4: PacPacBum ($217.17 in chips) 
Seat 5: Painkiller72 ($317.75 in chips) 
Seat 6: Kukuryzka ($273.60 in chips) 
Seat 8: chaps1988 ($255.54 in chips) 
Seat 9: korol702 ($171.25 in chips) 
matiko09: posts small blind $1
PacPacBum: posts big blind $2
*** HOLE CARDS ***
Dealt to matiko09 [3d 6h]
Painkiller72: folds 
Kukuryzka: folds 
Fitzyferret leaves the table
myatiy 96 joins the table at seat #7 
chaps1988: folds 
korol702: folds 
glanza_mike: raises $4 to $6
T0ny Adams: folds 
matiko09: folds 
PacPacBum: folds 
Uncalled bet ($4) returned to glanza_mike
glanza_mike collected $5 from pot
glanza_mike: doesn't show hand 
*** SUMMARY ***
Total pot $5 | Rake $0 
Seat 1: glanza_mike collected ($5)
Seat 2: T0ny Adams (button) folded before Flop (didn't bet)
Seat 3: matiko09 (small blind) folded before Flop
Seat 4: PacPacBum (big blind) folded before Flop
Seat 5: Painkiller72 folded before Flop (didn't bet)
Seat 6: Kukuryzka folded before Flop (didn't bet)
Seat 8: chaps1988 folded before Flop (didn't bet)
Seat 9: korol702 folded before Flop (didn't bet)





PokerStars Hand #152886605721:  Hold'em No Limit ($1/$2 USD) - 2016/05/05 16:50:16 CET [2016/05/05 10:50:16 ET]
Table 'Samitchell' 9-max Seat #8 is the button
Seat 1: CI58 ($200 in chips) 
Seat 2: matiko09 ($298.26 in chips) 
Seat 3: han3bj ($186.37 in chips) 
Seat 5: chaps1988 ($271.12 in chips) 
Seat 6: PacPacBum ($211.57 in chips) 
Seat 7: patpaty ($161.11 in chips) 
Seat 8: tepi_guy ($220.24 in chips) 
Seat 9: kblkxls ($122.40 in chips) 
kblkxls: posts small blind $1
CI58: posts big blind $2
Fitzyferret: sits out 
*** HOLE CARDS ***
Dealt to matiko09 [4c 2h]
matiko09: folds 
han3bj: folds 
chaps1988: raises $3 to $5
PacPacBum: folds 
patpaty: folds 
tepi_guy: raises $12 to $17
kblkxls: folds 
CI58: folds 
chaps1988: folds 
Uncalled bet ($12) returned to tepi_guy
tepi_guy collected $13 from pot
tepi_guy: doesn't show hand 
*** SUMMARY ***
Total pot $13 | Rake $0 
Seat 1: CI58 (big blind) folded before Flop
Seat 2: matiko09 folded before Flop (didn't bet)
Seat 3: han3bj folded before Flop (didn't bet)
Seat 5: chaps1988 folded before Flop
Seat 6: PacPacBum folded before Flop (didn't bet)
Seat 7: patpaty folded before Flop (didn't bet)
Seat 8: tepi_guy (button) collected ($13)
Seat 9: kblkxls (small blind) folded before Flop





PokerStars Hand #152886618160:  Hold'em No Limit ($0.50/$1.00 USD) - 2016/05/05 16:50:36 CET [2016/05/05 10:50:36 ET]
Table 'Porzia' 9-max Seat #4 is the button
Seat 1: vrnMike ($140.21 in chips) 
Seat 2: matiko09 ($100 in chips) 
Seat 3: sanpidk ($100 in chips) 
Seat 4: Khaine_CM ($100 in chips) 
Seat 5: CZECHMYSAK ($54.16 in chips) 
Seat 6: janarr5 ($179.79 in chips) 
Seat 7: HITYESCA ($102.15 in chips) 
Seat 8: PRINCE JULIO ($78.69 in chips) 
Seat 9: kl4ssic ($66.67 in chips) 
CZECHMYSAK: posts small blind $0.50
janarr5: posts big blind $1
*** HOLE CARDS ***
Dealt to matiko09 [2s 5s]
HITYESCA: folds 
PRINCE JULIO: raises $2 to $3
kl4ssic: folds 
vrnMike: folds 
matiko09: folds 
sanpidk: folds 
Khaine_CM: calls $3
CZECHMYSAK: folds 
janarr5: folds 
*** FLOP *** [2d 8h Jh]
PRINCE JULIO: checks 
Khaine_CM: bets $5
PRINCE JULIO: folds 
Uncalled bet ($5) returned to Khaine_CM
Khaine_CM collected $7.12 from pot
Khaine_CM: doesn't show hand 
*** SUMMARY ***
Total pot $7.50 | Rake $0.38 
Board [2d 8h Jh]
Seat 1: vrnMike folded before Flop (didn't bet)
Seat 2: matiko09 folded before Flop (didn't bet)
Seat 3: sanpidk folded before Flop (didn't bet)
Seat 4: Khaine_CM (button) collected ($7.12)
Seat 5: CZECHMYSAK (small blind) folded before Flop
Seat 6: janarr5 (big blind) folded before Flop
Seat 7: HITYESCA folded before Flop (didn't bet)
Seat 8: PRINCE JULIO folded on the Flop
Seat 9: kl4ssic folded before Flop (didn't bet)





PokerStars Hand #152886624292:  Hold'em No Limit ($0.50/$1.00 USD) - 2016/05/05 16:50:46 CET [2016/05/05 10:50:46 ET]
Table 'Kraz II' 9-max Seat #7 is the button
Seat 1: HITYESCA ($134.30 in chips) 
Seat 2: sanpidk ($144.84 in chips) 
Seat 3: Khaine_CM ($105.48 in chips) 
Seat 4: CI58 ($100 in chips) 
Seat 6: andy84lfc ($115.48 in chips) 
Seat 7: maxxmeister ($100 in chips) 
Seat 8: 178013 ($186 in chips) 
Seat 9: matiko09 ($181.87 in chips) 
178013: posts small blind $0.50
matiko09: posts big blind $1
Alex Frider: sits out 
*** HOLE CARDS ***
Dealt to matiko09 [2h Tc]
HITYESCA: folds 
sanpidk: folds 
Khaine_CM: folds 
CI58: raises $2 to $3
andy84lfc: calls $3
maxxmeister: folds 
178013: calls $2.50
matiko09: folds 
*** FLOP *** [Jc 7c 3c]
178013: checks 
CI58: checks 
andy84lfc: bets $9.50
178013: folds 
CI58: folds 
Uncalled bet ($9.50) returned to andy84lfc
andy84lfc collected $9.50 from pot
*** SUMMARY ***
Total pot $10 | Rake $0.50 
Board [Jc 7c 3c]
Seat 1: HITYESCA folded before Flop (didn't bet)
Seat 2: sanpidk folded before Flop (didn't bet)
Seat 3: Khaine_CM folded before Flop (didn't bet)
Seat 4: CI58 folded on the Flop
Seat 6: andy84lfc collected ($9.50)
Seat 7: maxxmeister (button) folded before Flop (didn't bet)
Seat 8: 178013 (small blind) folded on the Flop
Seat 9: matiko09 (big blind) folded before Flop





PokerStars Hand #152886627221:  Hold'em No Limit (€1/€2 EUR) - 2016/05/05 16:50:51 CET [2016/05/05 10:50:51 ET]
Table 'Skat II' 9-max Seat #4 is the button
Seat 1: Bebeto342193 (€92.99 in chips) 
Seat 3: Alex Frider (€212.69 in chips) 
Seat 4: JoaquinMRuiz (€238.44 in chips) 
Seat 5: ceedonen (€200 in chips) 
Seat 7: PacPacBum (€200 in chips) 
Seat 8: Painkiller72 (€213 in chips) 
Seat 9: matiko09 (€200 in chips) 
ceedonen: posts small blind €1
PacPacBum: posts big blind €2
Fitzyferret: sits out 
*** HOLE CARDS ***
Dealt to matiko09 [4h 6c]
Painkiller72: folds 
matiko09: folds 
Bebeto342193: raises €2 to €4
Alex Frider: folds 
JoaquinMRuiz: folds 
ceedonen: raises €9 to €13
PacPacBum: folds 
Bebeto342193: calls €9
*** FLOP *** [8d Jh 8s]
ceedonen: checks 
Bebeto342193: checks 
*** TURN *** [8d Jh 8s] [9c]
ceedonen: bets €17.29
Bebeto342193: calls €17.29
*** RIVER *** [8d Jh 8s 9c] [Ad]
ceedonen: checks 
Bebeto342193: checks 
*** SHOW DOWN ***
ceedonen: shows [Kc Qs] (a pair of Eights)
Bebeto342193: shows [9d 2d] (two pair, Nines and Eights)
Bebeto342193 collected €60.08 from pot
*** SUMMARY ***
Total pot €62.58 | Rake €2.50 
Board [8d Jh 8s 9c Ad]
Seat 1: Bebeto342193 showed [9d 2d] and won (€60.08) with two pair, Nines and Eights
Seat 3: Alex Frider folded before Flop (didn't bet)
Seat 4: JoaquinMRuiz (button) folded before Flop (didn't bet)
Seat 5: ceedonen (small blind) showed [Kc Qs] and lost with a pair of Eights
Seat 7: PacPacBum (big blind) folded before Flop
Seat 8: Painkiller72 folded before Flop (didn't bet)
Seat 9: matiko09 folded before Flop (didn't bet)





PokerStars Hand #152886630368:  Hold'em No Limit ($1/$2 USD) - 2016/05/05 16:50:56 CET [2016/05/05 10:50:56 ET]
Table 'Tatry II' 9-max Seat #3 is the button
Seat 1: glanza_mike ($220.80 in chips) 
Seat 2: T0ny Adams ($60.06 in chips) 
Seat 3: matiko09 ($200 in chips) 
Seat 4: PacPacBum ($215.17 in chips) 
Seat 5: Painkiller72 ($317.75 in chips) 
Seat 6: Kukuryzka ($273.60 in chips) 
Seat 8: chaps1988 ($255.54 in chips) 
Seat 9: korol702 ($171.25 in chips) 
PacPacBum: posts small blind $1
Painkiller72: posts big blind $2
myatiy 96: sits out 
*** HOLE CARDS ***
Dealt to matiko09 [5h 5c]
Kukuryzka: folds 
chaps1988: folds 
korol702: folds 
glanza_mike: raises $4 to $6
T0ny Adams: folds 
matiko09: calls $6
PacPacBum: folds 
Painkiller72: folds 
*** FLOP *** [As Qd 3s]
glanza_mike: checks 
matiko09: checks 
*** TURN *** [As Qd 3s] [7h]
glanza_mike: bets $10.33
matiko09: folds 
Uncalled bet ($10.33) returned to glanza_mike
glanza_mike collected $14.25 from pot
glanza_mike: doesn't show hand 
*** SUMMARY ***
Total pot $15 | Rake $0.75 
Board [As Qd 3s 7h]
Seat 1: glanza_mike collected ($14.25)
Seat 2: T0ny Adams folded before Flop (didn't bet)
Seat 3: matiko09 (button) folded on the Turn
Seat 4: PacPacBum (small blind) folded before Flop
Seat 5: Painkiller72 (big blind) folded before Flop
Seat 6: Kukuryzka folded before Flop (didn't bet)
Seat 8: chaps1988 folded before Flop (didn't bet)
Seat 9: korol702 folded before Flop (didn't bet)





PokerStars Hand #152886634749:  Hold'em No Limit ($1/$2 USD) - 2016/05/05 16:51:03 CET [2016/05/05 10:51:03 ET]
Table 'Samitchell' 9-max Seat #9 is the button
Seat 1: CI58 ($200 in chips) 
Seat 2: matiko09 ($298.26 in chips) 
Seat 3: han3bj ($186.37 in chips) 
Seat 5: chaps1988 ($266.12 in chips) 
Seat 6: PacPacBum ($211.57 in chips) 
Seat 7: patpaty ($161.11 in chips) 
Seat 8: tepi_guy ($228.24 in chips) 
Seat 9: kblkxls ($121.40 in chips) 
CI58: posts small blind $1
matiko09: posts big blind $2
Fitzyferret: sits out 
*** HOLE CARDS ***
Dealt to matiko09 [Jh 2c]
han3bj: raises $4 to $6
chaps1988: folds 
PacPacBum: folds 
patpaty: folds 
tepi_guy: folds 
kblkxls: folds 
CI58: folds 
matiko09: folds 
Uncalled bet ($4) returned to han3bj
han3bj collected $5 from pot
han3bj: doesn't show hand 
*** SUMMARY ***
Total pot $5 | Rake $0 
Seat 1: CI58 (small blind) folded before Flop
Seat 2: matiko09 (big blind) folded before Flop
Seat 3: han3bj collected ($5)
Seat 5: chaps1988 folded before Flop (didn't bet)
Seat 6: PacPacBum folded before Flop (didn't bet)
Seat 7: patpaty folded before Flop (didn't bet)
Seat 8: tepi_guy folded before Flop (didn't bet)
Seat 9: kblkxls (button) folded before Flop (didn't bet)





PokerStars Hand #152886641632:  Hold'em No Limit (€1/€2 EUR) - 2016/05/05 16:51:14 CET [2016/05/05 10:51:14 ET]
Table 'Bessel II' 9-max Seat #3 is the button
Seat 1: Soloaces224 (€214.23 in chips) 
Seat 3: PacPacBum (€211.02 in chips) 
Seat 4: Zorken76 (€163.97 in chips) 
Seat 5: Kukuryzka (€200 in chips) 
Seat 6: glanza_mike (€212.70 in chips) 
Seat 7: matiko09 (€210.20 in chips) 
Seat 8: chaps1988 (€234 in chips) 
Seat 9: JoaquinMRuiz (€200 in chips) 
Zorken76: posts small blind €1
Kukuryzka: posts big blind €2
Fitzyferret: sits out 
*** HOLE CARDS ***
Dealt to matiko09 [Qd 8s]
glanza_mike: folds 
matiko09: folds 
chaps1988: folds 
JoaquinMRuiz: folds 
Soloaces224: folds 
PacPacBum: folds 
Zorken76: folds 
Uncalled bet (€1) returned to Kukuryzka
Kukuryzka collected €2 from pot
Kukuryzka: doesn't show hand 
*** SUMMARY ***
Total pot €2 | Rake €0 
Seat 1: Soloaces224 folded before Flop (didn't bet)
Seat 3: PacPacBum (button) folded before Flop (didn't bet)
Seat 4: Zorken76 (small blind) folded before Flop
Seat 5: Kukuryzka (big blind) collected (€2)
Seat 6: glanza_mike folded before Flop (didn't bet)
Seat 7: matiko09 folded before Flop (didn't bet)
Seat 8: chaps1988 folded before Flop (didn't bet)
Seat 9: JoaquinMRuiz folded before Flop (didn't bet)





PokerStars Hand #152886642387:  Hold'em No Limit ($0.50/$1.00 USD) - 2016/05/05 16:51:16 CET [2016/05/05 10:51:16 ET]
Table 'Porzia' 9-max Seat #5 is the button
Seat 1: vrnMike ($140.21 in chips) 
Seat 2: matiko09 ($100 in chips) 
Seat 3: sanpidk ($100 in chips) 
Seat 4: Khaine_CM ($104.12 in chips) 
Seat 5: CZECHMYSAK ($53.66 in chips) 
Seat 6: janarr5 ($178.79 in chips) 
Seat 7: HITYESCA ($102.15 in chips) 
Seat 8: PRINCE JULIO ($75.69 in chips) 
Seat 9: kl4ssic ($66.67 in chips) 
janarr5: posts small blind $0.50
HITYESCA: posts big blind $1
*** HOLE CARDS ***
Dealt to matiko09 [As 9d]
PRINCE JULIO: folds 
kl4ssic: folds 
vrnMike: folds 
matiko09: folds 
sanpidk: folds 
Khaine_CM: folds 
CZECHMYSAK: raises $1 to $2
janarr5: folds 
HITYESCA: calls $1
*** FLOP *** [9s 2h Ah]
HITYESCA: checks 
CZECHMYSAK: bets $4.28
HITYESCA: folds 
Uncalled bet ($4.28) returned to CZECHMYSAK
CZECHMYSAK collected $4.28 from pot
*** SUMMARY ***
Total pot $4.50 | Rake $0.22 
Board [9s 2h Ah]
Seat 1: vrnMike folded before Flop (didn't bet)
Seat 2: matiko09 folded before Flop (didn't bet)
Seat 3: sanpidk folded before Flop (didn't bet)
Seat 4: Khaine_CM folded before Flop (didn't bet)
Seat 5: CZECHMYSAK (button) collected ($4.28)
Seat 6: janarr5 (small blind) folded before Flop
Seat 7: HITYESCA (big blind) folded on the Flop
Seat 8: PRINCE JULIO folded before Flop (didn't bet)
Seat 9: kl4ssic folded before Flop (didn't bet)





PokerStars Hand #152886646656:  Hold'em No Limit ($1/$2 USD) - 2016/05/05 16:51:23 CET [2016/05/05 10:51:23 ET]
Table 'Tololo' 9-max Seat #5 is the button
Seat 1: Kukuryzka ($270.29 in chips) 
Seat 2: tepi_guy ($203 in chips) 
Seat 3: Khaine_CM ($200 in chips) 
Seat 4: mooose100 ($226.22 in chips) 
Seat 5: matiko09 ($228.10 in chips) 
Seat 6: Xagua ($119.70 in chips) 
Seat 7: chaps1988 ($315.02 in chips) 
Seat 8: myatiy 96 ($200 in chips) 
Xagua: posts small blind $1
chaps1988: posts big blind $2
Fitzyferret: sits out 
*** HOLE CARDS ***
Dealt to matiko09 [Js 5d]
myatiy 96: folds 
Kukuryzka: folds 
tepi_guy: folds 
Khaine_CM: folds 
mooose100: folds 
matiko09: folds 
Xagua: folds 
Uncalled bet ($1) returned to chaps1988
chaps1988 collected $2 from pot
*** SUMMARY ***
Total pot $2 | Rake $0 
Seat 1: Kukuryzka folded before Flop (didn't bet)
Seat 2: tepi_guy folded before Flop (didn't bet)
Seat 3: Khaine_CM folded before Flop (didn't bet)
Seat 4: mooose100 folded before Flop (didn't bet)
Seat 5: matiko09 (button) folded before Flop (didn't bet)
Seat 6: Xagua (small blind) folded before Flop
Seat 7: chaps1988 (big blind) collected ($2)
Seat 8: myatiy 96 folded before Flop (didn't bet)





PokerStars Hand #152886648939:  Hold'em No Limit ($1/$2 USD) - 2016/05/05 16:51:26 CET [2016/05/05 10:51:26 ET]
Table 'Euporie II' 9-max Seat #1 is the button
Seat 1: PacPacBum ($200 in chips) 
Seat 2: kblkxls ($105.37 in chips) 
Seat 3: chaps1988 ($200 in chips) 
Seat 5: Nuskatko1986 ($151.49 in chips) 
Seat 6: Kukuryzka ($199 in chips) 
Seat 7: matiko09 ($200 in chips) 
Seat 8: Painkiller72 ($276.25 in chips) 
kblkxls: posts small blind $1
chaps1988: posts big blind $2
tepi_guy: sits out 
myatiy 96: sits out 
*** HOLE CARDS ***
Dealt to matiko09 [8h 5c]
Nuskatko1986: calls $2
Kukuryzka: folds 
matiko09: folds 
Painkiller72: raises $7 to $9
PacPacBum: folds 
kblkxls: folds 
chaps1988: folds 
Nuskatko1986: folds 
Uncalled bet ($7) returned to Painkiller72
Painkiller72 collected $7 from pot
Painkiller72: doesn't show hand 
*** SUMMARY ***
Total pot $7 | Rake $0 
Seat 1: PacPacBum (button) folded before Flop (didn't bet)
Seat 2: kblkxls (small blind) folded before Flop
Seat 3: chaps1988 (big blind) folded before Flop
Seat 5: Nuskatko1986 folded before Flop
Seat 6: Kukuryzka folded before Flop (didn't bet)
Seat 7: matiko09 folded before Flop (didn't bet)
Seat 8: Painkiller72 collected ($7)





PokerStars Hand #152886653389:  Hold'em No Limit ($1/$2 USD) - 2016/05/05 16:51:34 CET [2016/05/05 10:51:34 ET]
Table 'Samitchell' 9-max Seat #1 is the button
Seat 1: CI58 ($200 in chips) 
Seat 2: matiko09 ($296.26 in chips) 
Seat 3: han3bj ($189.37 in chips) 
Seat 5: chaps1988 ($266.12 in chips) 
Seat 6: PacPacBum ($211.57 in chips) 
Seat 7: patpaty ($161.11 in chips) 
Seat 8: tepi_guy ($228.24 in chips) 
Seat 9: kblkxls ($121.40 in chips) 
matiko09: posts small blind $1
han3bj: posts big blind $2
Fitzyferret: sits out 
*** HOLE CARDS ***
Dealt to matiko09 [5s Jh]
chaps1988: folds 
PacPacBum: raises $2.08 to $4.08
patpaty: folds 
tepi_guy: calls $4.08
kblkxls: folds 
CI58: folds 
matiko09: folds 
han3bj: raises $10.08 to $14.16
PacPacBum: calls $10.08
tepi_guy: calls $10.08
*** FLOP *** [Kh 2d 4s]
han3bj: checks 
PacPacBum: checks 
tepi_guy: checks 
*** TURN *** [Kh 2d 4s] [Ac]
han3bj: checks 
PacPacBum: checks 
tepi_guy: checks 
*** RIVER *** [Kh 2d 4s Ac] [Qs]
han3bj: bets $24
PacPacBum: folds 
tepi_guy: folds 
Uncalled bet ($24) returned to han3bj
han3bj collected $41.31 from pot
han3bj: doesn't show hand 
*** SUMMARY ***
Total pot $43.48 | Rake $2.17 
Board [Kh 2d 4s Ac Qs]
Seat 1: CI58 (button) folded before Flop (didn't bet)
Seat 2: matiko09 (small blind) folded before Flop
Seat 3: han3bj (big blind) collected ($41.31)
Seat 5: chaps1988 folded before Flop (didn't bet)
Seat 6: PacPacBum folded on the River
Seat 7: patpaty folded before Flop (didn't bet)
Seat 8: tepi_guy folded on the River
Seat 9: kblkxls folded before Flop (didn't bet)





PokerStars Hand #152886658923:  Hold'em No Limit (€1/€2 EUR) - 2016/05/05 16:51:42 CET [2016/05/05 10:51:42 ET]
Table 'Bessel II' 9-max Seat #4 is the button
Seat 1: Soloaces224 (€214.23 in chips) 
Seat 3: PacPacBum (€211.02 in chips) 
Seat 4: Zorken76 (€162.97 in chips) 
Seat 5: Kukuryzka (€201 in chips) 
Seat 6: glanza_mike (€212.70 in chips) 
Seat 7: matiko09 (€210.20 in chips) 
Seat 8: chaps1988 (€234 in chips) 
Seat 9: JoaquinMRuiz (€200 in chips) 
Kukuryzka: posts small blind €1
glanza_mike: posts big blind €2
Fitzyferret: sits out 
*** HOLE CARDS ***
Dealt to matiko09 [Ah Js]
matiko09: folds 
chaps1988: folds 
JoaquinMRuiz: folds 
Soloaces224: folds 
PacPacBum: folds 
Zorken76: raises €5 to €7
Kukuryzka: calls €6
glanza_mike: raises €20 to €27
Zorken76: folds 
Kukuryzka: folds 
Uncalled bet (€20) returned to glanza_mike
glanza_mike collected €21 from pot
glanza_mike: doesn't show hand 
*** SUMMARY ***
Total pot €21 | Rake €0 
Seat 1: Soloaces224 folded before Flop (didn't bet)
Seat 3: PacPacBum folded before Flop (didn't bet)
Seat 4: Zorken76 (button) folded before Flop
Seat 5: Kukuryzka (small blind) folded before Flop
Seat 6: glanza_mike (big blind) collected (€21)
Seat 7: matiko09 folded before Flop (didn't bet)
Seat 8: chaps1988 folded before Flop (didn't bet)
Seat 9: JoaquinMRuiz folded before Flop (didn't bet)





PokerStars Hand #152886661896:  Hold'em No Limit ($0.50/$1.00 USD) - 2016/05/05 16:51:47 CET [2016/05/05 10:51:47 ET]
Table 'Kraz II' 9-max Seat #8 is the button
Seat 1: HITYESCA ($134.30 in chips) 
Seat 2: sanpidk ($144.84 in chips) 
Seat 3: Khaine_CM ($105.48 in chips) 
Seat 4: CI58 ($100 in chips) 
Seat 6: andy84lfc ($121.98 in chips) 
Seat 7: maxxmeister ($100 in chips) 
Seat 8: 178013 ($183 in chips) 
Seat 9: matiko09 ($180.87 in chips) 
matiko09: posts small blind $0.50
HITYESCA: posts big blind $1
Alex Frider: sits out 
*** HOLE CARDS ***
Dealt to matiko09 [Ac 7d]
sanpidk: raises $2 to $3
Khaine_CM: folds 
CI58: folds 
andy84lfc: folds 
maxxmeister: folds 
178013: folds 
matiko09: folds 
HITYESCA: folds 
Uncalled bet ($2) returned to sanpidk
sanpidk collected $2.50 from pot
sanpidk: doesn't show hand 
*** SUMMARY ***
Total pot $2.50 | Rake $0 
Seat 1: HITYESCA (big blind) folded before Flop
Seat 2: sanpidk collected ($2.50)
Seat 3: Khaine_CM folded before Flop (didn't bet)
Seat 4: CI58 folded before Flop (didn't bet)
Seat 6: andy84lfc folded before Flop (didn't bet)
Seat 7: maxxmeister folded before Flop (didn't bet)
Seat 8: 178013 (button) folded before Flop (didn't bet)
Seat 9: matiko09 (small blind) folded before Flop





PokerStars Hand #152886668874:  Hold'em No Limit ($1/$2 USD) - 2016/05/05 16:51:59 CET [2016/05/05 10:51:59 ET]
Table 'Euporie II' 9-max Seat #2 is the button
Seat 1: PacPacBum ($200 in chips) 
Seat 2: kblkxls ($104.37 in chips) 
Seat 3: chaps1988 ($200 in chips) 
Seat 4: tepi_guy ($200 in chips) 
Seat 5: Nuskatko1986 ($149.49 in chips) 
Seat 6: Kukuryzka ($199 in chips) 
Seat 7: matiko09 ($200 in chips) 
Seat 8: Painkiller72 ($281.25 in chips) 
chaps1988: posts small blind $1
tepi_guy: posts big blind $2
myatiy 96: sits out 
*** HOLE CARDS ***
Dealt to matiko09 [5s 4s]
Nuskatko1986: calls $2
Kukuryzka: raises $6 to $8
matiko09: folds 
Painkiller72: folds 
PacPacBum: folds 
kblkxls: folds 
chaps1988: folds 
tepi_guy: folds 
Nuskatko1986: calls $6
*** FLOP *** [Ad 7s Kh]
Nuskatko1986: checks 
Kukuryzka: checks 
*** TURN *** [Ad 7s Kh] [2d]
Nuskatko1986: checks 
Kukuryzka: bets $12.64
Nuskatko1986: calls $12.64
*** RIVER *** [Ad 7s Kh 2d] [6d]
Nuskatko1986: checks 
Kukuryzka: bets $26
Nuskatko1986: folds 
Uncalled bet ($26) returned to Kukuryzka
Kukuryzka collected $42.07 from pot
Kukuryzka: doesn't show hand 
*** SUMMARY ***
Total pot $44.28 | Rake $2.21 
Board [Ad 7s Kh 2d 6d]
Seat 1: PacPacBum folded before Flop (didn't bet)
Seat 2: kblkxls (button) folded before Flop (didn't bet)
Seat 3: chaps1988 (small blind) folded before Flop
Seat 4: tepi_guy (big blind) folded before Flop
Seat 5: Nuskatko1986 folded on the River
Seat 6: Kukuryzka collected ($42.07)
Seat 7: matiko09 folded before Flop (didn't bet)
Seat 8: Painkiller72 folded before Flop (didn't bet)





PokerStars Hand #152886670757:  Hold'em No Limit ($1/$2 USD) - 2016/05/05 16:52:02 CET [2016/05/05 10:52:02 ET]
Table 'Tatry II' 9-max Seat #4 is the button
Seat 1: glanza_mike ($229.05 in chips) 
Seat 2: T0ny Adams ($60.06 in chips) 
Seat 3: matiko09 ($200 in chips) 
Seat 4: PacPacBum ($214.17 in chips) 
Seat 5: Painkiller72 ($315.75 in chips) 
Seat 6: Kukuryzka ($273.60 in chips) 
Seat 8: chaps1988 ($255.54 in chips) 
Seat 9: korol702 ($171.25 in chips) 
Painkiller72: posts small blind $1
Kukuryzka: posts big blind $2
myatiy 96: sits out 
*** HOLE CARDS ***
Dealt to matiko09 [2c Ad]
chaps1988: folds 
korol702: calls $2
glanza_mike: raises $5 to $7
T0ny Adams: folds 
matiko09: folds 
PacPacBum: folds 
Painkiller72: folds 
Kukuryzka: raises $15 to $22
korol702: folds 
glanza_mike: folds 
Uncalled bet ($15) returned to Kukuryzka
Kukuryzka collected $17 from pot
Kukuryzka: doesn't show hand 
*** SUMMARY ***
Total pot $17 | Rake $0 
Seat 1: glanza_mike folded before Flop
Seat 2: T0ny Adams folded before Flop (didn't bet)
Seat 3: matiko09 folded before Flop (didn't bet)
Seat 4: PacPacBum (button) folded before Flop (didn't bet)
Seat 5: Painkiller72 (small blind) folded before Flop
Seat 6: Kukuryzka (big blind) collected ($17)
Seat 8: chaps1988 folded before Flop (didn't bet)
Seat 9: korol702 folded before Flop





PokerStars Hand #152886672292:  Hold'em No Limit ($0.50/$1.00 USD) - 2016/05/05 16:52:04 CET [2016/05/05 10:52:04 ET]
Table 'Porzia' 9-max Seat #6 is the button
Seat 1: vrnMike ($140.21 in chips) 
Seat 2: matiko09 ($100 in chips) 
Seat 3: sanpidk ($100 in chips) 
Seat 4: Khaine_CM ($104.12 in chips) 
Seat 5: CZECHMYSAK ($55.94 in chips) 
Seat 6: janarr5 ($178.29 in chips) 
Seat 7: HITYESCA ($100.15 in chips) 
Seat 8: PRINCE JULIO ($75.69 in chips) 
Seat 9: kl4ssic ($66.67 in chips) 
HITYESCA: posts small blind $0.50
PRINCE JULIO: posts big blind $1
*** HOLE CARDS ***
Dealt to matiko09 [Js Qh]
kl4ssic: calls $1
vrnMike: calls $1
matiko09: folds 
sanpidk: folds 
Khaine_CM: folds 
CZECHMYSAK: folds 
janarr5: folds 
HITYESCA: folds 
PRINCE JULIO: checks 
*** FLOP *** [9c 3d Qd]
PRINCE JULIO: checks 
kl4ssic: checks 
vrnMike: bets $3
PRINCE JULIO: folds 
kl4ssic: folds 
Uncalled bet ($3) returned to vrnMike
vrnMike collected $3.32 from pot
*** SUMMARY ***
Total pot $3.50 | Rake $0.18 
Board [9c 3d Qd]
Seat 1: vrnMike collected ($3.32)
Seat 2: matiko09 folded before Flop (didn't bet)
Seat 3: sanpidk folded before Flop (didn't bet)
Seat 4: Khaine_CM folded before Flop (didn't bet)
Seat 5: CZECHMYSAK folded before Flop (didn't bet)
Seat 6: janarr5 (button) folded before Flop (didn't bet)
Seat 7: HITYESCA (small blind) folded before Flop
Seat 8: PRINCE JULIO (big blind) folded on the Flop
Seat 9: kl4ssic folded on the Flop





PokerStars Hand #152886674262:  Hold'em No Limit (€1/€2 EUR) - 2016/05/05 16:52:07 CET [2016/05/05 10:52:07 ET]
Table 'Skat II' 9-max Seat #5 is the button
Seat 1: Bebeto342193 (€122.78 in chips) 
Seat 3: Alex Frider (€212.69 in chips) 
Seat 4: JoaquinMRuiz (€238.44 in chips) 
Seat 5: ceedonen (€200 in chips) 
Seat 7: PacPacBum (€200 in chips) 
Seat 8: Painkiller72 (€213 in chips) 
Seat 9: matiko09 (€200 in chips) 
drissmouzou will be allowed to play after the button
PacPacBum: posts small blind €1
Painkiller72: posts big blind €2
Fitzyferret: sits out 
*** HOLE CARDS ***
Dealt to matiko09 [8c 3d]
matiko09: folds 
Bebeto342193: folds 
Alex Frider: folds 
JoaquinMRuiz: folds 
ceedonen: folds 
PacPacBum: raises €3 to €5
Painkiller72: folds 
Uncalled bet (€3) returned to PacPacBum
PacPacBum collected €4 from pot
PacPacBum: doesn't show hand 
*** SUMMARY ***
Total pot €4 | Rake €0 
Seat 1: Bebeto342193 folded before Flop (didn't bet)
Seat 3: Alex Frider folded before Flop (didn't bet)
Seat 4: JoaquinMRuiz folded before Flop (didn't bet)
Seat 5: ceedonen (button) folded before Flop (didn't bet)
Seat 7: PacPacBum (small blind) collected (€4)
Seat 8: Painkiller72 (big blind) folded before Flop
Seat 9: matiko09 folded before Flop (didn't bet)





PokerStars Hand #152886677421:  Hold'em No Limit ($1/$2 USD) - 2016/05/05 16:52:13 CET [2016/05/05 10:52:13 ET]
Table 'Tololo' 9-max Seat #6 is the button
Seat 1: Kukuryzka ($270.29 in chips) 
Seat 2: tepi_guy ($203 in chips) 
Seat 3: Khaine_CM ($200 in chips) 
Seat 4: mooose100 ($226.22 in chips) 
Seat 5: matiko09 ($228.10 in chips) 
Seat 6: Xagua ($118.70 in chips) 
Seat 7: chaps1988 ($316.02 in chips) 
Seat 8: myatiy 96 ($200 in chips) 
chaps1988: posts small blind $1
myatiy 96: posts big blind $2
Fitzyferret: sits out 
*** HOLE CARDS ***
Dealt to matiko09 [Qs 2h]
Kukuryzka: raises $4 to $6
tepi_guy: folds 
Khaine_CM: folds 
mooose100: folds 
matiko09: folds 
Xagua: calls $6
chaps1988: folds 
myatiy 96: folds 
*** FLOP *** [Jd 2s Kc]
Kukuryzka: checks 
Xagua: bets $6
Kukuryzka: folds 
Uncalled bet ($6) returned to Xagua
Xagua collected $14.25 from pot
Xagua: doesn't show hand 
*** SUMMARY ***
Total pot $15 | Rake $0.75 
Board [Jd 2s Kc]
Seat 1: Kukuryzka folded on the Flop
Seat 2: tepi_guy folded before Flop (didn't bet)
Seat 3: Khaine_CM folded before Flop (didn't bet)
Seat 4: mooose100 folded before Flop (didn't bet)
Seat 5: matiko09 folded before Flop (didn't bet)
Seat 6: Xagua (button) collected ($14.25)
Seat 7: chaps1988 (small blind) folded before Flop
Seat 8: myatiy 96 (big blind) folded before Flop





PokerStars Hand #152886683571:  Hold'em No Limit ($0.50/$1.00 USD) - 2016/05/05 16:52:23 CET [2016/05/05 10:52:23 ET]
Table 'Kraz II' 9-max Seat #9 is the button
Seat 1: HITYESCA ($133.30 in chips) 
Seat 2: sanpidk ($146.34 in chips) 
Seat 3: Khaine_CM ($105.48 in chips) 
Seat 4: CI58 ($100 in chips) 
Seat 6: andy84lfc ($121.98 in chips) 
Seat 7: maxxmeister ($100 in chips) 
Seat 8: 178013 ($183 in chips) 
Seat 9: matiko09 ($180.37 in chips) 
HITYESCA: posts small blind $0.50
sanpidk: posts big blind $1
Alex Frider: sits out 
*** HOLE CARDS ***
Dealt to matiko09 [Td Qh]
Khaine_CM: raises $2 to $3
CI58: calls $3
andy84lfc: folds 
maxxmeister: folds 
178013: raises $11.50 to $14.50
matiko09: folds 
HITYESCA: folds 
sanpidk: folds 
Khaine_CM: folds 
CI58: calls $11.50
*** FLOP *** [Ad 3s Ac]
CI58: checks 
178013: bets $16
CI58: folds 
Uncalled bet ($16) returned to 178013
178013 collected $31.82 from pot
178013: doesn't show hand 
*** SUMMARY ***
Total pot $33.50 | Rake $1.68 
Board [Ad 3s Ac]
Seat 1: HITYESCA (small blind) folded before Flop
Seat 2: sanpidk (big blind) folded before Flop
Seat 3: Khaine_CM folded before Flop
Seat 4: CI58 folded on the Flop
Seat 6: andy84lfc folded before Flop (didn't bet)
Seat 7: maxxmeister folded before Flop (didn't bet)
Seat 8: 178013 collected ($31.82)
Seat 9: matiko09 (button) folded before Flop (didn't bet)





PokerStars Hand #152886689234:  Hold'em No Limit (€1/€2 EUR) - 2016/05/05 16:52:32 CET [2016/05/05 10:52:32 ET]
Table 'Bessel II' 9-max Seat #5 is the button
Seat 1: Soloaces224 (€214.23 in chips) 
Seat 3: PacPacBum (€211.02 in chips) 
Seat 4: Zorken76 (€155.97 in chips) 
Seat 5: Kukuryzka (€200 in chips) 
Seat 6: glanza_mike (€226.70 in chips) 
Seat 7: matiko09 (€210.20 in chips) 
Seat 8: chaps1988 (€234 in chips) 
Seat 9: JoaquinMRuiz (€200 in chips) 
glanza_mike: posts small blind €1
matiko09: posts big blind €2
Fitzyferret: sits out 
*** HOLE CARDS ***
Dealt to matiko09 [8s Kc]
chaps1988: folds 
JoaquinMRuiz: folds 
Soloaces224: folds 
PacPacBum: folds 
Zorken76: raises €4 to €6
Kukuryzka: folds 
glanza_mike: folds 
matiko09: folds 
Uncalled bet (€4) returned to Zorken76
Zorken76 collected €5 from pot
Zorken76: doesn't show hand 
*** SUMMARY ***
Total pot €5 | Rake €0 
Seat 1: Soloaces224 folded before Flop (didn't bet)
Seat 3: PacPacBum folded before Flop (didn't bet)
Seat 4: Zorken76 collected (€5)
Seat 5: Kukuryzka (button) folded before Flop (didn't bet)
Seat 6: glanza_mike (small blind) folded before Flop
Seat 7: matiko09 (big blind) folded before Flop
Seat 8: chaps1988 folded before Flop (didn't bet)
Seat 9: JoaquinMRuiz folded before Flop (didn't bet)





PokerStars Hand #152886696091:  Hold'em No Limit (€1/€2 EUR) - 2016/05/05 16:52:43 CET [2016/05/05 10:52:43 ET]
Table 'Skat II' 9-max Seat #7 is the button
Seat 1: Bebeto342193 (€122.78 in chips) 
Seat 3: Alex Frider (€212.69 in chips) 
Seat 4: JoaquinMRuiz (€238.44 in chips) 
Seat 5: ceedonen (€200 in chips) 
Seat 7: PacPacBum (€202 in chips) 
Seat 8: Painkiller72 (€211 in chips) 
Seat 9: matiko09 (€200 in chips) 
Painkiller72: posts small blind €1
matiko09: posts big blind €2
Fitzyferret: sits out 
drissmouzou: sits out 
*** HOLE CARDS ***
Dealt to matiko09 [4c Qh]
Bebeto342193: calls €2
Alex Frider: folds 
JoaquinMRuiz: folds 
ceedonen: folds 
PacPacBum: folds 
Painkiller72: calls €1
matiko09: checks 
*** FLOP *** [8d 6c Td]
Painkiller72: checks 
matiko09: checks 
Bebeto342193: bets €2
Painkiller72: folds 
matiko09: folds 
Uncalled bet (€2) returned to Bebeto342193
Bebeto342193 collected €5.70 from pot
Bebeto342193: doesn't show hand 
*** SUMMARY ***
Total pot €6 | Rake €0.30 
Board [8d 6c Td]
Seat 1: Bebeto342193 collected (€5.70)
Seat 3: Alex Frider folded before Flop (didn't bet)
Seat 4: JoaquinMRuiz folded before Flop (didn't bet)
Seat 5: ceedonen folded before Flop (didn't bet)
Seat 7: PacPacBum (button) folded before Flop (didn't bet)
Seat 8: Painkiller72 (small blind) folded on the Flop
Seat 9: matiko09 (big blind) folded on the Flop





PokerStars Hand #152886706336:  Hold'em No Limit (€1/€2 EUR) - 2016/05/05 16:53:00 CET [2016/05/05 10:53:00 ET]
Table 'Bessel II' 9-max Seat #6 is the button
Seat 1: Soloaces224 (€214.23 in chips) 
Seat 3: PacPacBum (€211.02 in chips) 
Seat 4: Zorken76 (€158.97 in chips) 
Seat 5: Kukuryzka (€200 in chips) 
Seat 6: glanza_mike (€225.70 in chips) 
Seat 7: matiko09 (€208.20 in chips) 
Seat 8: chaps1988 (€234 in chips) 
Seat 9: JoaquinMRuiz (€200 in chips) 
matiko09: posts small blind €1
chaps1988: posts big blind €2
Fitzyferret: sits out 
*** HOLE CARDS ***
Dealt to matiko09 [6s 2h]
JoaquinMRuiz: folds 
Soloaces224: folds 
PacPacBum: folds 
Zorken76: folds 
Kukuryzka: raises €3 to €5
glanza_mike: folds 
matiko09: folds 
chaps1988: folds 
Uncalled bet (€3) returned to Kukuryzka
Kukuryzka collected €5 from pot
Kukuryzka: doesn't show hand 
*** SUMMARY ***
Total pot €5 | Rake €0 
Seat 1: Soloaces224 folded before Flop (didn't bet)
Seat 3: PacPacBum folded before Flop (didn't bet)
Seat 4: Zorken76 folded before Flop (didn't bet)
Seat 5: Kukuryzka collected (€5)
Seat 6: glanza_mike (button) folded before Flop (didn't bet)
Seat 7: matiko09 (small blind) folded before Flop
Seat 8: chaps1988 (big blind) folded before Flop
Seat 9: JoaquinMRuiz folded before Flop (didn't bet)





PokerStars Hand #152886707691:  Hold'em No Limit ($1/$2 USD) - 2016/05/05 16:53:02 CET [2016/05/05 10:53:02 ET]
Table 'Tatry II' 9-max Seat #5 is the button
Seat 1: glanza_mike ($222.05 in chips) 
Seat 2: T0ny Adams ($60.06 in chips) 
Seat 3: matiko09 ($200 in chips) 
Seat 4: PacPacBum ($214.17 in chips) 
Seat 5: Painkiller72 ($314.75 in chips) 
Seat 6: Kukuryzka ($283.60 in chips) 
Seat 7: myatiy 96 ($200 in chips) 
Seat 8: chaps1988 ($255.54 in chips) 
Seat 9: korol702 ($169.25 in chips) 
Kukuryzka: posts small blind $1
myatiy 96: posts big blind $2
*** HOLE CARDS ***
Dealt to matiko09 [2d 2s]
chaps1988: folds 
korol702: raises $4 to $6
glanza_mike: folds 
T0ny Adams: folds 
matiko09: folds 
PacPacBum: folds 
Painkiller72: folds 
Kukuryzka: folds 
myatiy 96: folds 
Uncalled bet ($4) returned to korol702
korol702 collected $5 from pot
korol702: doesn't show hand 
*** SUMMARY ***
Total pot $5 | Rake $0 
Seat 1: glanza_mike folded before Flop (didn't bet)
Seat 2: T0ny Adams folded before Flop (didn't bet)
Seat 3: matiko09 folded before Flop (didn't bet)
Seat 4: PacPacBum folded before Flop (didn't bet)
Seat 5: Painkiller72 (button) folded before Flop (didn't bet)
Seat 6: Kukuryzka (small blind) folded before Flop
Seat 7: myatiy 96 (big blind) folded before Flop
Seat 8: chaps1988 folded before Flop (didn't bet)
Seat 9: korol702 collected ($5)





PokerStars Hand #152886709750:  Hold'em No Limit ($1/$2 USD) - 2016/05/05 16:53:05 CET [2016/05/05 10:53:05 ET]
Table 'Samitchell' 9-max Seat #2 is the button
Seat 1: CI58 ($200 in chips) 
Seat 2: matiko09 ($295.26 in chips) 
Seat 3: han3bj ($216.52 in chips) 
Seat 4: Fitzyferret ($365.13 in chips) 
Seat 5: chaps1988 ($266.12 in chips) 
Seat 6: PacPacBum ($200 in chips) 
Seat 7: patpaty ($161.11 in chips) 
Seat 8: tepi_guy ($214.08 in chips) 
Seat 9: kblkxls ($121.40 in chips) 
han3bj: posts small blind $1
Fitzyferret: posts big blind $2
*** HOLE CARDS ***
Dealt to matiko09 [4c Td]
chaps1988: folds 
PacPacBum: folds 
patpaty: raises $2 to $4
tepi_guy: folds 
kblkxls: folds 
CI58: folds 
matiko09: folds 
han3bj: folds 
Fitzyferret: folds 
Uncalled bet ($2) returned to patpaty
tepi_guy is disconnected 
patpaty collected $5 from pot
patpaty: doesn't show hand 
*** SUMMARY ***
Total pot $5 | Rake $0 
Seat 1: CI58 folded before Flop (didn't bet)
Seat 2: matiko09 (button) folded before Flop (didn't bet)
Seat 3: han3bj (small blind) folded before Flop
Seat 4: Fitzyferret (big blind) folded before Flop
Seat 5: chaps1988 folded before Flop (didn't bet)
Seat 6: PacPacBum folded before Flop (didn't bet)
Seat 7: patpaty collected ($5)
Seat 8: tepi_guy folded before Flop (didn't bet)
Seat 9: kblkxls folded before Flop (didn't bet)





PokerStars Hand #152886720035:  Hold'em No Limit (€1/€2 EUR) - 2016/05/05 16:53:22 CET [2016/05/05 10:53:22 ET]
Table 'Bessel II' 9-max Seat #7 is the button
Seat 1: Soloaces224 (€214.23 in chips) 
Seat 3: PacPacBum (€211.02 in chips) 
Seat 4: Zorken76 (€158.97 in chips) 
Seat 5: Kukuryzka (€203 in chips) 
Seat 6: glanza_mike (€225.70 in chips) 
Seat 7: matiko09 (€207.20 in chips) 
Seat 8: chaps1988 (€232 in chips) 
Seat 9: JoaquinMRuiz (€200 in chips) 
chaps1988: posts small blind €1
JoaquinMRuiz: posts big blind €2
Fitzyferret: sits out 
*** HOLE CARDS ***
Dealt to matiko09 [7h 4c]
Soloaces224: raises €4 to €6
PacPacBum: folds 
Zorken76: calls €6
Kukuryzka: folds 
glanza_mike: folds 
matiko09: folds 
chaps1988: folds 
JoaquinMRuiz: calls €4
*** FLOP *** [5h 2c Ts]
JoaquinMRuiz: checks 
Soloaces224: bets €9.02
Zorken76: folds 
JoaquinMRuiz: folds 
Uncalled bet (€9.02) returned to Soloaces224
Soloaces224 collected €18.05 from pot
Soloaces224: doesn't show hand 
*** SUMMARY ***
Total pot €19 | Rake €0.95 
Board [5h 2c Ts]
Seat 1: Soloaces224 collected (€18.05)
Seat 3: PacPacBum folded before Flop (didn't bet)
Seat 4: Zorken76 folded on the Flop
Seat 5: Kukuryzka folded before Flop (didn't bet)
Seat 6: glanza_mike folded before Flop (didn't bet)
Seat 7: matiko09 (button) folded before Flop (didn't bet)
Seat 8: chaps1988 (small blind) folded before Flop
Seat 9: JoaquinMRuiz (big blind) folded on the Flop





PokerStars Hand #152886726199:  Hold'em No Limit ($1/$2 USD) - 2016/05/05 16:53:32 CET [2016/05/05 10:53:32 ET]
Table 'Euporie II' 9-max Seat #3 is the button
Seat 1: PacPacBum ($200 in chips) 
Seat 2: kblkxls ($104.37 in chips) 
Seat 3: chaps1988 ($200 in chips) 
Seat 4: tepi_guy ($200 in chips) 
Seat 5: Nuskatko1986 ($128.85 in chips) 
Seat 6: Kukuryzka ($220.43 in chips) 
Seat 7: matiko09 ($200 in chips) 
Seat 8: Painkiller72 ($281.25 in chips) 
tepi_guy: posts small blind $1
Nuskatko1986: posts big blind $2
myatiy 96: sits out 
*** HOLE CARDS ***
Dealt to matiko09 [Ks 4s]
Kukuryzka: folds 
matiko09: folds 
Painkiller72: folds 
PacPacBum: folds 
kblkxls: folds 
chaps1988: raises $2 to $4
tepi_guy is disconnected 
tepi_guy is connected 
tepi_guy: calls $3
Nuskatko1986: calls $2
*** FLOP *** [3s As 2s]
tepi_guy: checks 
Nuskatko1986: bets $2
chaps1988: folds 
tepi_guy: folds 
Uncalled bet ($2) returned to Nuskatko1986
Nuskatko1986 collected $11.40 from pot
Nuskatko1986: doesn't show hand 
*** SUMMARY ***
Total pot $12 | Rake $0.60 
Board [3s As 2s]
Seat 1: PacPacBum folded before Flop (didn't bet)
Seat 2: kblkxls folded before Flop (didn't bet)
Seat 3: chaps1988 (button) folded on the Flop
Seat 4: tepi_guy (small blind) folded on the Flop
Seat 5: Nuskatko1986 (big blind) collected ($11.40)
Seat 6: Kukuryzka folded before Flop (didn't bet)
Seat 7: matiko09 folded before Flop (didn't bet)
Seat 8: Painkiller72 folded before Flop (didn't bet)





PokerStars Hand #152886727748:  Hold'em No Limit (€1/€2 EUR) - 2016/05/05 16:53:35 CET [2016/05/05 10:53:35 ET]
Table 'Skat II' 9-max Seat #8 is the button
Seat 1: Bebeto342193 (€126.48 in chips) 
Seat 3: Alex Frider (€212.69 in chips) 
Seat 4: JoaquinMRuiz (€238.44 in chips) 
Seat 5: ceedonen (€200 in chips) 
Seat 7: PacPacBum (€202 in chips) 
Seat 8: Painkiller72 (€209 in chips) 
Seat 9: matiko09 (€200 in chips) 
matiko09: posts small blind €1
Bebeto342193: posts big blind €2
Fitzyferret: sits out 
drissmouzou: sits out 
*** HOLE CARDS ***
Dealt to matiko09 [5s 4c]
Alex Frider: folds 
JoaquinMRuiz: folds 
ceedonen: raises €4 to €6
PacPacBum: folds 
Painkiller72: folds 
matiko09: folds 
Bebeto342193: calls €4
*** FLOP *** [Qc Qs 9s]
Bebeto342193: checks 
ceedonen: checks 
*** TURN *** [Qc Qs 9s] [5d]
Bebeto342193: bets €6.17
ceedonen: calls €6.17
*** RIVER *** [Qc Qs 9s 5d] [5h]
Bebeto342193: bets €12.03
ceedonen: calls €12.03
*** SHOW DOWN ***
Bebeto342193: shows [4h 6d] (two pair, Queens and Fives)
ceedonen: shows [Ad Jh] (two pair, Queens and Fives - Ace kicker)
ceedonen collected €46.93 from pot
*** SUMMARY ***
Total pot €49.40 | Rake €2.47 
Board [Qc Qs 9s 5d 5h]
Seat 1: Bebeto342193 (big blind) showed [4h 6d] and lost with two pair, Queens and Fives
Seat 3: Alex Frider folded before Flop (didn't bet)
Seat 4: JoaquinMRuiz folded before Flop (didn't bet)
Seat 5: ceedonen showed [Ad Jh] and won (€46.93) with two pair, Queens and Fives
Seat 7: PacPacBum folded before Flop (didn't bet)
Seat 8: Painkiller72 (button) folded before Flop (didn't bet)
Seat 9: matiko09 (small blind) folded before Flop





PokerStars Hand #152886729045:  Hold'em No Limit ($1/$2 USD) - 2016/05/05 16:53:37 CET [2016/05/05 10:53:37 ET]
Table 'Tatry II' 9-max Seat #6 is the button
Seat 1: glanza_mike ($222.05 in chips) 
Seat 2: T0ny Adams ($60.06 in chips) 
Seat 3: matiko09 ($200 in chips) 
Seat 4: PacPacBum ($214.17 in chips) 
Seat 5: Painkiller72 ($314.75 in chips) 
Seat 6: Kukuryzka ($282.60 in chips) 
Seat 7: myatiy 96 ($200 in chips) 
Seat 8: chaps1988 ($255.54 in chips) 
Seat 9: korol702 ($172.25 in chips) 
myatiy 96: posts small blind $1
chaps1988: posts big blind $2
*** HOLE CARDS ***
Dealt to matiko09 [Ac 2c]
korol702: folds 
glanza_mike: folds 
T0ny Adams: folds 
matiko09: folds 
PacPacBum: folds 
Painkiller72: folds 
Kukuryzka: raises $2 to $4
myatiy 96: folds 
chaps1988: folds 
Uncalled bet ($2) returned to Kukuryzka
Kukuryzka collected $5 from pot
Kukuryzka: doesn't show hand 
*** SUMMARY ***
Total pot $5 | Rake $0 
Seat 1: glanza_mike folded before Flop (didn't bet)
Seat 2: T0ny Adams folded before Flop (didn't bet)
Seat 3: matiko09 folded before Flop (didn't bet)
Seat 4: PacPacBum folded before Flop (didn't bet)
Seat 5: Painkiller72 folded before Flop (didn't bet)
Seat 6: Kukuryzka (button) collected ($5)
Seat 7: myatiy 96 (small blind) folded before Flop
Seat 8: chaps1988 (big blind) folded before Flop
Seat 9: korol702 folded before Flop (didn't bet)





PokerStars Hand #152886729778:  Hold'em No Limit ($1/$2 USD) - 2016/05/05 16:53:38 CET [2016/05/05 10:53:38 ET]
Table 'Tololo' 9-max Seat #7 is the button
Seat 1: Kukuryzka ($264.29 in chips) 
Seat 2: tepi_guy ($203 in chips) 
Seat 3: Khaine_CM ($200 in chips) 
Seat 4: mooose100 ($226.22 in chips) 
Seat 5: matiko09 ($228.10 in chips) 
Seat 6: Xagua ($126.95 in chips) 
Seat 7: chaps1988 ($315.02 in chips) 
Seat 8: myatiy 96 ($200 in chips) 
Seat 9: Fitzyferret ($380.77 in chips) 
myatiy 96: posts small blind $1
Fitzyferret: posts big blind $2
*** HOLE CARDS ***
Dealt to matiko09 [9s 7s]
Kukuryzka: folds 
tepi_guy: folds 
Khaine_CM: folds 
tepi_guy is disconnected 
mooose100 has timed out
mooose100: folds 
matiko09: folds 
Xagua: folds 
chaps1988: raises $3 to $5
myatiy 96: raises $13 to $18
Fitzyferret: folds 
chaps1988: calls $13
*** FLOP *** [6h Qs 4d]
myatiy 96: checks 
chaps1988: checks 
*** TURN *** [6h Qs 4d] [8c]
myatiy 96: checks 
chaps1988: bets $17.50
myatiy 96: folds 
Uncalled bet ($17.50) returned to chaps1988
chaps1988 collected $36.10 from pot
*** SUMMARY ***
Total pot $38 | Rake $1.90 
Board [6h Qs 4d 8c]
Seat 1: Kukuryzka folded before Flop (didn't bet)
Seat 2: tepi_guy folded before Flop (didn't bet)
Seat 3: Khaine_CM folded before Flop (didn't bet)
Seat 4: mooose100 folded before Flop (didn't bet)
Seat 5: matiko09 folded before Flop (didn't bet)
Seat 6: Xagua folded before Flop (didn't bet)
Seat 7: chaps1988 (button) collected ($36.10)
Seat 8: myatiy 96 (small blind) folded on the Turn
Seat 9: Fitzyferret (big blind) folded before Flop





PokerStars Hand #152886743374:  Hold'em No Limit ($0.50/$1.00 USD) - 2016/05/05 16:54:01 CET [2016/05/05 10:54:01 ET]
Table 'Kraz II' 9-max Seat #1 is the button
Seat 1: HITYESCA ($132.80 in chips) 
Seat 2: sanpidk ($145.34 in chips) 
Seat 3: Khaine_CM ($102.48 in chips) 
Seat 4: CI58 ($100 in chips) 
Seat 6: andy84lfc ($121.98 in chips) 
Seat 7: maxxmeister ($100 in chips) 
Seat 8: 178013 ($200.32 in chips) 
Seat 9: matiko09 ($180.37 in chips) 
sanpidk: posts small blind $0.50
Khaine_CM: posts big blind $1
Alex Frider: sits out 
*** HOLE CARDS ***
Dealt to matiko09 [Js 7s]
CI58: folds 
andy84lfc: raises $2 to $3
maxxmeister: folds 
178013: folds 
matiko09: folds 
HITYESCA: folds 
sanpidk: folds 
Khaine_CM: folds 
Uncalled bet ($2) returned to andy84lfc
andy84lfc collected $2.50 from pot
*** SUMMARY ***
Total pot $2.50 | Rake $0 
Seat 1: HITYESCA (button) folded before Flop (didn't bet)
Seat 2: sanpidk (small blind) folded before Flop
Seat 3: Khaine_CM (big blind) folded before Flop
Seat 4: CI58 folded before Flop (didn't bet)
Seat 6: andy84lfc collected ($2.50)
Seat 7: maxxmeister folded before Flop (didn't bet)
Seat 8: 178013 folded before Flop (didn't bet)
Seat 9: matiko09 folded before Flop (didn't bet)





PokerStars Hand #152886744520:  Hold'em No Limit ($1/$2 USD) - 2016/05/05 16:54:02 CET [2016/05/05 10:54:02 ET]
Table 'Tatry II' 9-max Seat #7 is the button
Seat 1: glanza_mike ($222.05 in chips) 
Seat 2: T0ny Adams ($60.06 in chips) 
Seat 3: matiko09 ($200 in chips) 
Seat 4: PacPacBum ($214.17 in chips) 
Seat 5: Painkiller72 ($314.75 in chips) 
Seat 6: Kukuryzka ($285.60 in chips) 
Seat 7: myatiy 96 ($200 in chips) 
Seat 8: chaps1988 ($253.54 in chips) 
Seat 9: korol702 ($172.25 in chips) 
chaps1988: posts small blind $1
korol702: posts big blind $2
*** HOLE CARDS ***
Dealt to matiko09 [Kh 8h]
glanza_mike: folds 
T0ny Adams: folds 
matiko09: raises $3 to $5
PacPacBum: folds 
Painkiller72 has timed out
Painkiller72: folds 
Kukuryzka: folds 
myatiy 96: folds 
chaps1988: folds 
korol702: calls $3
*** FLOP *** [3s Qs 6s]
korol702: checks 
matiko09: checks 
*** TURN *** [3s Qs 6s] [4h]
korol702: checks 
matiko09: checks 
*** RIVER *** [3s Qs 6s 4h] [Jc]
korol702: checks 
matiko09: checks 
*** SHOW DOWN ***
korol702: shows [Tc 9c] (high card Queen)
matiko09: shows [Kh 8h] (high card King)
matiko09 collected $10.45 from pot
*** SUMMARY ***
Total pot $11 | Rake $0.55 
Board [3s Qs 6s 4h Jc]
Seat 1: glanza_mike folded before Flop (didn't bet)
Seat 2: T0ny Adams folded before Flop (didn't bet)
Seat 3: matiko09 showed [Kh 8h] and won ($10.45) with high card King
Seat 4: PacPacBum folded before Flop (didn't bet)
Seat 5: Painkiller72 folded before Flop (didn't bet)
Seat 6: Kukuryzka folded before Flop (didn't bet)
Seat 7: myatiy 96 (button) folded before Flop (didn't bet)
Seat 8: chaps1988 (small blind) folded before Flop
Seat 9: korol702 (big blind) showed [Tc 9c] and lost with high card Queen





PokerStars Hand #152886748850:  Hold'em No Limit ($1/$2 USD) - 2016/05/05 16:54:10 CET [2016/05/05 10:54:10 ET]
Table 'Samitchell' 9-max Seat #3 is the button
Seat 1: CI58 ($200 in chips) 
Seat 2: matiko09 ($295.26 in chips) 
Seat 3: han3bj ($215.52 in chips) 
Seat 4: Fitzyferret ($363.13 in chips) 
Seat 5: chaps1988 ($266.12 in chips) 
Seat 6: PacPacBum ($200 in chips) 
Seat 7: patpaty ($164.11 in chips) 
Seat 8: tepi_guy ($214.08 in chips) 
Seat 9: kblkxls ($121.40 in chips) 
Fitzyferret: posts small blind $1
chaps1988: posts big blind $2
*** HOLE CARDS ***
Dealt to matiko09 [7s Ks]
PacPacBum: folds 
patpaty: calls $2
tepi_guy has timed out
tepi_guy: folds 
kblkxls: folds 
CI58: folds 
matiko09: raises $6 to $8
han3bj: calls $8
Fitzyferret: folds 
chaps1988: folds 
patpaty: calls $6
*** FLOP *** [9h 9c Tc]
patpaty: checks 
matiko09: checks 
han3bj: bets $16
patpaty: calls $16
matiko09: folds 
*** TURN *** [9h 9c Tc] [4c]
patpaty: checks 
han3bj: bets $36
patpaty: folds 
Uncalled bet ($36) returned to han3bj
han3bj collected $56.25 from pot
han3bj: doesn't show hand 
*** SUMMARY ***
Total pot $59 | Rake $2.75 
Board [9h 9c Tc 4c]
Seat 1: CI58 folded before Flop (didn't bet)
Seat 2: matiko09 folded on the Flop
Seat 3: han3bj (button) collected ($56.25)
Seat 4: Fitzyferret (small blind) folded before Flop
Seat 5: chaps1988 (big blind) folded before Flop
Seat 6: PacPacBum folded before Flop (didn't bet)
Seat 7: patpaty folded on the Turn
Seat 8: tepi_guy folded before Flop (didn't bet)
Seat 9: kblkxls folded before Flop (didn't bet)





PokerStars Hand #152886765053:  Hold'em No Limit (€1/€2 EUR) - 2016/05/05 16:54:36 CET [2016/05/05 10:54:36 ET]
Table 'Bessel II' 9-max Seat #8 is the button
Seat 1: Soloaces224 (€226.28 in chips) 
Seat 3: PacPacBum (€211.02 in chips) 
Seat 4: Zorken76 (€152.97 in chips) 
Seat 5: Kukuryzka (€203 in chips) 
Seat 6: glanza_mike (€225.70 in chips) 
Seat 7: matiko09 (€207.20 in chips) 
Seat 8: chaps1988 (€231 in chips) 
Seat 9: JoaquinMRuiz (€200 in chips) 
JoaquinMRuiz: posts small blind €1
Soloaces224: posts big blind €2
Fitzyferret: sits out 
*** HOLE CARDS ***
Dealt to matiko09 [Qh Kc]
PacPacBum: folds 
Zorken76: calls €2
Kukuryzka: folds 
glanza_mike: folds 
matiko09: raises €6 to €8
chaps1988: calls €8
JoaquinMRuiz: folds 
Soloaces224: folds 
Zorken76: calls €6
*** FLOP *** [Ad 8h Td]
Zorken76: checks 
matiko09: checks 
chaps1988: bets €16
Zorken76: folds 
matiko09: folds 
Uncalled bet (€16) returned to chaps1988
chaps1988 collected €25.65 from pot
*** SUMMARY ***
Total pot €27 | Rake €1.35 
Board [Ad 8h Td]
Seat 1: Soloaces224 (big blind) folded before Flop
Seat 3: PacPacBum folded before Flop (didn't bet)
Seat 4: Zorken76 folded on the Flop
Seat 5: Kukuryzka folded before Flop (didn't bet)
Seat 6: glanza_mike folded before Flop (didn't bet)
Seat 7: matiko09 folded on the Flop
Seat 8: chaps1988 (button) collected (€25.65)
Seat 9: JoaquinMRuiz (small blind) folded before Flop





PokerStars Hand #152886765010:  Hold'em No Limit ($1/$2 USD) - 2016/05/05 16:54:36 CET [2016/05/05 10:54:36 ET]
Table 'Euporie II' 9-max Seat #4 is the button
Seat 1: PacPacBum ($200 in chips) 
Seat 2: kblkxls ($104.37 in chips) 
Seat 3: chaps1988 ($200 in chips) 
Seat 4: tepi_guy ($200 in chips) 
Seat 5: Nuskatko1986 ($136.25 in chips) 
Seat 6: Kukuryzka ($220.43 in chips) 
Seat 7: matiko09 ($200 in chips) 
Seat 8: Painkiller72 ($281.25 in chips) 
Nuskatko1986: posts small blind $1
Kukuryzka: posts big blind $2
myatiy 96: sits out 
*** HOLE CARDS ***
Dealt to matiko09 [3s 8h]
matiko09: folds 
Painkiller72 has timed out
Painkiller72: folds 
PacPacBum: folds 
kblkxls: raises $4 to $6
chaps1988: folds 
tepi_guy: folds 
Nuskatko1986: calls $5
Kukuryzka: folds 
*** FLOP *** [6d 2s Th]
Nuskatko1986: checks 
kblkxls: bets $8
Nuskatko1986: folds 
Uncalled bet ($8) returned to kblkxls
kblkxls collected $13.30 from pot
kblkxls: doesn't show hand 
*** SUMMARY ***
Total pot $14 | Rake $0.70 
Board [6d 2s Th]
Seat 1: PacPacBum folded before Flop (didn't bet)
Seat 2: kblkxls collected ($13.30)
Seat 3: chaps1988 folded before Flop (didn't bet)
Seat 4: tepi_guy (button) folded before Flop (didn't bet)
Seat 5: Nuskatko1986 (small blind) folded on the Flop
Seat 6: Kukuryzka (big blind) folded before Flop
Seat 7: matiko09 folded before Flop (didn't bet)
Seat 8: Painkiller72 folded before Flop (didn't bet)





PokerStars Hand #152886767317:  Hold'em No Limit (€1/€2 EUR) - 2016/05/05 16:54:40 CET [2016/05/05 10:54:40 ET]
Table 'Skat II' 9-max Seat #9 is the button
Seat 1: Bebeto342193 (€102.28 in chips) 
Seat 2: Fitzyferret (€200 in chips) 
Seat 3: Alex Frider (€212.69 in chips) 
Seat 4: JoaquinMRuiz (€238.44 in chips) 
Seat 5: ceedonen (€222.73 in chips) 
Seat 7: PacPacBum (€202 in chips) 
Seat 8: Painkiller72 (€209 in chips) 
Seat 9: matiko09 (€200 in chips) 
Bebeto342193: posts small blind €1
Fitzyferret: posts big blind €2
drissmouzou: sits out 
*** HOLE CARDS ***
Dealt to matiko09 [Qd Ac]
Alex Frider: folds 
JoaquinMRuiz: folds 
ceedonen: raises €4 to €6
PacPacBum: folds 
Painkiller72: folds 
matiko09: calls €6
Bebeto342193: calls €5
Fitzyferret: folds 
*** FLOP *** [8h Tc 6c]
Bebeto342193: checks 
ceedonen: checks 
matiko09: bets €12
Bebeto342193: folds 
ceedonen: folds 
Uncalled bet (€12) returned to matiko09
matiko09 collected €19 from pot
matiko09: doesn't show hand 
*** SUMMARY ***
Total pot €20 | Rake €1 
Board [8h Tc 6c]
Seat 1: Bebeto342193 (small blind) folded on the Flop
Seat 2: Fitzyferret (big blind) folded before Flop
Seat 3: Alex Frider folded before Flop (didn't bet)
Seat 4: JoaquinMRuiz folded before Flop (didn't bet)
Seat 5: ceedonen folded on the Flop
Seat 7: PacPacBum folded before Flop (didn't bet)
Seat 8: Painkiller72 folded before Flop (didn't bet)
Seat 9: matiko09 (button) collected (€19)





PokerStars Hand #152886771210:  Hold'em No Limit ($0.50/$1.00 USD) - 2016/05/05 16:54:46 CET [2016/05/05 10:54:46 ET]
Table 'Kraz II' 9-max Seat #2 is the button
Seat 1: HITYESCA ($132.80 in chips) 
Seat 2: sanpidk ($144.84 in chips) 
Seat 3: Khaine_CM ($101.48 in chips) 
Seat 4: CI58 ($100 in chips) 
Seat 6: andy84lfc ($123.48 in chips) 
Seat 7: maxxmeister ($100 in chips) 
Seat 8: 178013 ($200.32 in chips) 
Seat 9: matiko09 ($180.37 in chips) 
Khaine_CM: posts small blind $0.50
CI58: posts big blind $1
Alex Frider: sits out 
*** HOLE CARDS ***
Dealt to matiko09 [7c 8h]
andy84lfc: folds 
maxxmeister: folds 
178013: folds 
matiko09: folds 
HITYESCA: raises $1.50 to $2.50
sanpidk: folds 
Khaine_CM: folds 
CI58: raises $5.50 to $8
HITYESCA: raises $10 to $18
CI58: folds 
Uncalled bet ($10) returned to HITYESCA
HITYESCA collected $16.50 from pot
HITYESCA: doesn't show hand 
*** SUMMARY ***
Total pot $16.50 | Rake $0 
Seat 1: HITYESCA collected ($16.50)
Seat 2: sanpidk (button) folded before Flop (didn't bet)
Seat 3: Khaine_CM (small blind) folded before Flop
Seat 4: CI58 (big blind) folded before Flop
Seat 6: andy84lfc folded before Flop (didn't bet)
Seat 7: maxxmeister folded before Flop (didn't bet)
Seat 8: 178013 folded before Flop (didn't bet)
Seat 9: matiko09 folded before Flop (didn't bet)





PokerStars Hand #152886795448:  Hold'em No Limit ($1/$2 USD) - 2016/05/05 16:55:29 CET [2016/05/05 10:55:29 ET]
Table 'Tololo' 9-max Seat #8 is the button
Seat 1: Kukuryzka ($264.29 in chips) 
Seat 2: tepi_guy ($203 in chips) 
Seat 3: Khaine_CM ($200 in chips) 
Seat 5: matiko09 ($228.10 in chips) 
Seat 6: Xagua ($126.95 in chips) 
Seat 7: chaps1988 ($333.12 in chips) 
Seat 8: myatiy 96 ($200 in chips) 
Seat 9: Fitzyferret ($378.77 in chips) 
Fitzyferret: posts small blind $1
Kukuryzka: posts big blind $2
*** HOLE CARDS ***
Dealt to matiko09 [9c 3s]
tepi_guy: folds 
Khaine_CM: folds 
matiko09: folds 
Xagua: raises $3 to $5
chaps1988: folds 
myatiy 96: folds 
Fitzyferret: folds 
Kukuryzka: folds 
Uncalled bet ($3) returned to Xagua
Xagua collected $5 from pot
Xagua: doesn't show hand 
*** SUMMARY ***
Total pot $5 | Rake $0 
Seat 1: Kukuryzka (big blind) folded before Flop
Seat 2: tepi_guy folded before Flop (didn't bet)
Seat 3: Khaine_CM folded before Flop (didn't bet)
Seat 5: matiko09 folded before Flop (didn't bet)
Seat 6: Xagua collected ($5)
Seat 7: chaps1988 folded before Flop (didn't bet)
Seat 8: myatiy 96 (button) folded before Flop (didn't bet)
Seat 9: Fitzyferret (small blind) folded before Flop





PokerStars Hand #152886798948:  Hold'em No Limit (€1/€2 EUR) - 2016/05/05 16:55:36 CET [2016/05/05 10:55:36 ET]
Table 'Bessel II' 9-max Seat #9 is the button
Seat 1: Soloaces224 (€224.28 in chips) 
Seat 2: Fitzyferret (€344.70 in chips) 
Seat 3: PacPacBum (€211.02 in chips) 
Seat 4: Zorken76 (€144.97 in chips) 
Seat 5: Kukuryzka (€203 in chips) 
Seat 6: glanza_mike (€225.70 in chips) 
Seat 7: matiko09 (€200 in chips) 
Seat 8: chaps1988 (€248.65 in chips) 
Seat 9: JoaquinMRuiz (€200 in chips) 
Soloaces224: posts small blind €1
Fitzyferret: posts big blind €2
*** HOLE CARDS ***
Dealt to matiko09 [Qd As]
PacPacBum: folds 
Zorken76: folds 
Kukuryzka: folds 
glanza_mike: folds 
matiko09: raises €3 to €5
chaps1988: folds 
JoaquinMRuiz: calls €5
Soloaces224: calls €4
Fitzyferret: folds 
*** FLOP *** [Kh 3c 5h]
Soloaces224: checks 
matiko09: checks 
JoaquinMRuiz: bets €10.17
Soloaces224: folds 
matiko09: folds 
Uncalled bet (€10.17) returned to JoaquinMRuiz
JoaquinMRuiz collected €16.15 from pot
*** SUMMARY ***
Total pot €17 | Rake €0.85 
Board [Kh 3c 5h]
Seat 1: Soloaces224 (small blind) folded on the Flop
Seat 2: Fitzyferret (big blind) folded before Flop
Seat 3: PacPacBum folded before Flop (didn't bet)
Seat 4: Zorken76 folded before Flop (didn't bet)
Seat 5: Kukuryzka folded before Flop (didn't bet)
Seat 6: glanza_mike folded before Flop (didn't bet)
Seat 7: matiko09 folded on the Flop
Seat 8: chaps1988 folded before Flop (didn't bet)
Seat 9: JoaquinMRuiz (button) collected (€16.15)





PokerStars Hand #152886799677:  Hold'em No Limit ($1/$2 USD) - 2016/05/05 16:55:37 CET [2016/05/05 10:55:37 ET]
Table 'Euporie II' 9-max Seat #5 is the button
Seat 1: PacPacBum ($200 in chips) 
Seat 2: kblkxls ($111.67 in chips) 
Seat 3: chaps1988 ($200 in chips) 
Seat 4: tepi_guy ($200 in chips) 
Seat 5: Nuskatko1986 ($130.25 in chips) 
Seat 6: Kukuryzka ($218.43 in chips) 
Seat 7: matiko09 ($200 in chips) 
Kukuryzka: posts small blind $1
matiko09: posts big blind $2
myatiy 96: sits out 
*** HOLE CARDS ***
Dealt to matiko09 [5h 7s]
PacPacBum: folds 
kblkxls: folds 
chaps1988: folds 
tepi_guy: folds 
Nuskatko1986: calls $2
Kukuryzka: folds 
matiko09: checks 
*** FLOP *** [Kh 2s 6h]
matiko09: checks 
Nuskatko1986: bets $2
matiko09: folds 
Uncalled bet ($2) returned to Nuskatko1986
Nuskatko1986 collected $4.75 from pot
Nuskatko1986: doesn't show hand 
*** SUMMARY ***
Total pot $5 | Rake $0.25 
Board [Kh 2s 6h]
Seat 1: PacPacBum folded before Flop (didn't bet)
Seat 2: kblkxls folded before Flop (didn't bet)
Seat 3: chaps1988 folded before Flop (didn't bet)
Seat 4: tepi_guy folded before Flop (didn't bet)
Seat 5: Nuskatko1986 (button) collected ($4.75)
Seat 6: Kukuryzka (small blind) folded before Flop
Seat 7: matiko09 (big blind) folded on the Flop





PokerStars Hand #152886802508:  Hold'em No Limit (€1/€2 EUR) - 2016/05/05 16:55:43 CET [2016/05/05 10:55:43 ET]
Table 'Skat II' 9-max Seat #1 is the button
Seat 1: Bebeto342193 (€96.28 in chips) 
Seat 2: Fitzyferret (€200 in chips) 
Seat 3: Alex Frider (€212.69 in chips) 
Seat 4: JoaquinMRuiz (€238.44 in chips) 
Seat 5: ceedonen (€216.73 in chips) 
Seat 7: PacPacBum (€202 in chips) 
Seat 9: matiko09 (€213 in chips) 
Fitzyferret: posts small blind €1
Alex Frider: posts big blind €2
drissmouzou: sits out 
*** HOLE CARDS ***
Dealt to matiko09 [7s 2d]
JoaquinMRuiz: folds 
ceedonen: folds 
PacPacBum: folds 
matiko09: folds 
Bebeto342193: folds 
Bebeto342193 leaves the table
Vikulja1993 joins the table at seat #1 
Fitzyferret: folds 
Uncalled bet (€1) returned to Alex Frider
Alex Frider collected €2 from pot
Alex Frider: doesn't show hand 
*** SUMMARY ***
Total pot €2 | Rake €0 
Seat 1: Bebeto342193 (button) folded before Flop (didn't bet)
Seat 2: Fitzyferret (small blind) folded before Flop
Seat 3: Alex Frider (big blind) collected (€2)
Seat 4: JoaquinMRuiz folded before Flop (didn't bet)
Seat 5: ceedonen folded before Flop (didn't bet)
Seat 7: PacPacBum folded before Flop (didn't bet)
Seat 9: matiko09 folded before Flop (didn't bet)





PokerStars Hand #152886802738:  Hold'em No Limit ($0.50/$1.00 USD) - 2016/05/05 16:55:43 CET [2016/05/05 10:55:43 ET]
Table 'Kraz II' 9-max Seat #3 is the button
Seat 1: HITYESCA ($141.30 in chips) 
Seat 2: sanpidk ($144.84 in chips) 
Seat 3: Khaine_CM ($100.98 in chips) 
Seat 4: CI58 ($100 in chips) 
Seat 5: Alex Frider ($100 in chips) 
Seat 6: andy84lfc ($123.48 in chips) 
Seat 7: maxxmeister ($100 in chips) 
Seat 8: 178013 ($200.32 in chips) 
Seat 9: matiko09 ($180.37 in chips) 
CI58: posts small blind $0.50
Alex Frider: posts big blind $1
*** HOLE CARDS ***
Dealt to matiko09 [2h 9s]
andy84lfc: raises $2 to $3
maxxmeister: folds 
178013: folds 
matiko09: folds 
HITYESCA: folds 
sanpidk: folds 
Khaine_CM: folds 
CI58: folds 
Alex Frider: calls $2
*** FLOP *** [8c 2d Kd]
Alex Frider: checks 
andy84lfc: bets $3.09
Alex Frider: folds 
Uncalled bet ($3.09) returned to andy84lfc
andy84lfc collected $6.18 from pot
*** SUMMARY ***
Total pot $6.50 | Rake $0.32 
Board [8c 2d Kd]
Seat 1: HITYESCA folded before Flop (didn't bet)
Seat 2: sanpidk folded before Flop (didn't bet)
Seat 3: Khaine_CM (button) folded before Flop (didn't bet)
Seat 4: CI58 (small blind) folded before Flop
Seat 5: Alex Frider (big blind) folded on the Flop
Seat 6: andy84lfc collected ($6.18)
Seat 7: maxxmeister folded before Flop (didn't bet)
Seat 8: 178013 folded before Flop (didn't bet)
Seat 9: matiko09 folded before Flop (didn't bet)





PokerStars Hand #152886802488:  Hold'em No Limit ($1/$2 USD) - 2016/05/05 16:55:43 CET [2016/05/05 10:55:43 ET]
Table 'Tatry II' 9-max Seat #8 is the button
Seat 1: glanza_mike ($222.05 in chips) 
Seat 2: T0ny Adams ($60.06 in chips) 
Seat 3: matiko09 ($205.45 in chips) 
Seat 4: PacPacBum ($214.17 in chips) 
Seat 6: Kukuryzka ($285.60 in chips) 
Seat 7: myatiy 96 ($200 in chips) 
Seat 8: chaps1988 ($252.54 in chips) 
Seat 9: korol702 ($167.25 in chips) 
korol702: posts small blind $1
glanza_mike: posts big blind $2
*** HOLE CARDS ***
Dealt to matiko09 [6s Qc]
T0ny Adams: folds 
matiko09: folds 
PacPacBum: folds 
Kukuryzka: folds 
myatiy 96: folds 
chaps1988: folds 
korol702: calls $1
glanza_mike: checks 
*** FLOP *** [Jc 5h Qs]
korol702: bets $6
glanza_mike: calls $6
*** TURN *** [Jc 5h Qs] [2s]
korol702: bets $6
glanza_mike: calls $6
*** RIVER *** [Jc 5h Qs 2s] [Th]
korol702: checks 
glanza_mike: checks 
*** SHOW DOWN ***
korol702: shows [Tc 4c] (a pair of Tens)
glanza_mike: shows [Qh 6c] (a pair of Queens)
glanza_mike collected $26.60 from pot
*** SUMMARY ***
Total pot $28 | Rake $1.40 
Board [Jc 5h Qs 2s Th]
Seat 1: glanza_mike (big blind) showed [Qh 6c] and won ($26.60) with a pair of Queens
Seat 2: T0ny Adams folded before Flop (didn't bet)
Seat 3: matiko09 folded before Flop (didn't bet)
Seat 4: PacPacBum folded before Flop (didn't bet)
Seat 6: Kukuryzka folded before Flop (didn't bet)
Seat 7: myatiy 96 folded before Flop (didn't bet)
Seat 8: chaps1988 (button) folded before Flop (didn't bet)
Seat 9: korol702 (small blind) showed [Tc 4c] and lost with a pair of Tens





PokerStars Hand #152886815210:  Hold'em No Limit ($1/$2 USD) - 2016/05/05 16:56:07 CET [2016/05/05 10:56:07 ET]
Table 'Tololo' 9-max Seat #9 is the button
Seat 1: Kukuryzka ($262.29 in chips) 
Seat 2: tepi_guy ($203 in chips) 
Seat 3: Khaine_CM ($200 in chips) 
Seat 5: matiko09 ($228.10 in chips) 
Seat 6: Xagua ($129.95 in chips) 
Seat 7: chaps1988 ($333.12 in chips) 
Seat 8: myatiy 96 ($200 in chips) 
Seat 9: Fitzyferret ($377.77 in chips) 
Kukuryzka: posts small blind $1
tepi_guy: posts big blind $2
*** HOLE CARDS ***
Dealt to matiko09 [Kd Kh]
Khaine_CM: folds 
matiko09: raises $3 to $5
Xagua: folds 
chaps1988: folds 
myatiy 96: folds 
Fitzyferret: folds 
Kukuryzka: folds 
tepi_guy has timed out
tepi_guy: folds 
Uncalled bet ($3) returned to matiko09
matiko09 collected $5 from pot
matiko09: doesn't show hand 
*** SUMMARY ***
Total pot $5 | Rake $0 
Seat 1: Kukuryzka (small blind) folded before Flop
Seat 2: tepi_guy (big blind) folded before Flop
Seat 3: Khaine_CM folded before Flop (didn't bet)
Seat 5: matiko09 collected ($5)
Seat 6: Xagua folded before Flop (didn't bet)
Seat 7: chaps1988 folded before Flop (didn't bet)
Seat 8: myatiy 96 folded before Flop (didn't bet)
Seat 9: Fitzyferret (button) folded before Flop (didn't bet)





PokerStars Hand #152886816049:  Hold'em No Limit (€1/€2 EUR) - 2016/05/05 16:56:09 CET [2016/05/05 10:56:09 ET]
Table 'Skat II' 9-max Seat #2 is the button
Seat 2: Fitzyferret (€200 in chips) 
Seat 3: Alex Frider (€213.69 in chips) 
Seat 4: JoaquinMRuiz (€238.44 in chips) 
Seat 5: ceedonen (€216.73 in chips) 
Seat 7: PacPacBum (€202 in chips) 
Seat 9: matiko09 (€213 in chips) 
Alex Frider: posts small blind €1
JoaquinMRuiz: posts big blind €2
drissmouzou: sits out 
Vikulja1993: sits out 
*** HOLE CARDS ***
Dealt to matiko09 [Td 7c]
ceedonen: folds 
PacPacBum: folds 
matiko09: folds 
Fitzyferret: folds 
Alex Frider: raises €2.10 to €4.10
JoaquinMRuiz: calls €2.10
*** FLOP *** [8d Qc 3d]
Alex Frider: checks 
JoaquinMRuiz: bets €4.90
Alex Frider: folds 
Uncalled bet (€4.90) returned to JoaquinMRuiz
JoaquinMRuiz collected €7.79 from pot
*** SUMMARY ***
Total pot €8.20 | Rake €0.41 
Board [8d Qc 3d]
Seat 2: Fitzyferret (button) folded before Flop (didn't bet)
Seat 3: Alex Frider (small blind) folded on the Flop
Seat 4: JoaquinMRuiz (big blind) collected (€7.79)
Seat 5: ceedonen folded before Flop (didn't bet)
Seat 7: PacPacBum folded before Flop (didn't bet)
Seat 9: matiko09 folded before Flop (didn't bet)





PokerStars Hand #152886830531:  Hold'em No Limit ($1/$2 USD) - 2016/05/05 16:56:36 CET [2016/05/05 10:56:36 ET]
Table 'Euporie II' 9-max Seat #6 is the button
Seat 1: PacPacBum ($200 in chips) 
Seat 2: kblkxls ($111.67 in chips) 
Seat 3: chaps1988 ($200 in chips) 
Seat 4: tepi_guy ($200 in chips) 
Seat 5: Nuskatko1986 ($133 in chips) 
Seat 6: Kukuryzka ($217.43 in chips) 
Seat 7: matiko09 ($200 in chips) 
Seat 9: myatiy 96 ($200 in chips) 
matiko09: posts small blind $1
myatiy 96: posts big blind $2
*** HOLE CARDS ***
Dealt to matiko09 [9h 9d]
PacPacBum: folds 
kblkxls: folds 
chaps1988: folds 
tepi_guy: folds 
Nuskatko1986: folds 
Kukuryzka: raises $2 to $4
matiko09: raises $12 to $16
myatiy 96: folds 
Kukuryzka: folds 
Uncalled bet ($12) returned to matiko09
matiko09 collected $10 from pot
matiko09: doesn't show hand 
*** SUMMARY ***
Total pot $10 | Rake $0 
Seat 1: PacPacBum folded before Flop (didn't bet)
Seat 2: kblkxls folded before Flop (didn't bet)
Seat 3: chaps1988 folded before Flop (didn't bet)
Seat 4: tepi_guy folded before Flop (didn't bet)
Seat 5: Nuskatko1986 folded before Flop (didn't bet)
Seat 6: Kukuryzka (button) folded before Flop
Seat 7: matiko09 (small blind) collected ($10)
Seat 9: myatiy 96 (big blind) folded before Flop





PokerStars Hand #152886830990:  Hold'em No Limit (€1/€2 EUR) - 2016/05/05 16:56:37 CET [2016/05/05 10:56:37 ET]
Table 'Skat II' 9-max Seat #3 is the button
Seat 2: Fitzyferret (€200 in chips) 
Seat 3: Alex Frider (€209.59 in chips) 
Seat 4: JoaquinMRuiz (€242.13 in chips) 
Seat 5: ceedonen (€216.73 in chips) 
Seat 7: PacPacBum (€202 in chips) 
Seat 9: matiko09 (€213 in chips) 
JoaquinMRuiz: posts small blind €1
ceedonen: posts big blind €2
drissmouzou: sits out 
Vikulja1993: sits out 
*** HOLE CARDS ***
Dealt to matiko09 [Jc Th]
PacPacBum: folds 
matiko09: folds 
Fitzyferret: raises €2.60 to €4.60
Alex Frider: folds 
JoaquinMRuiz: folds 
ceedonen: folds 
Uncalled bet (€2.60) returned to Fitzyferret
Fitzyferret collected €5 from pot
Fitzyferret: doesn't show hand 
*** SUMMARY ***
Total pot €5 | Rake €0 
Seat 2: Fitzyferret collected (€5)
Seat 3: Alex Frider (button) folded before Flop (didn't bet)
Seat 4: JoaquinMRuiz (small blind) folded before Flop
Seat 5: ceedonen (big blind) folded before Flop
Seat 7: PacPacBum folded before Flop (didn't bet)
Seat 9: matiko09 folded before Flop (didn't bet)





PokerStars Hand #152886836173:  Hold'em No Limit ($0.50/$1.00 USD) - 2016/05/05 16:56:47 CET [2016/05/05 10:56:47 ET]
Table 'Kraz II' 9-max Seat #4 is the button
Seat 1: HITYESCA ($141.30 in chips) 
Seat 2: sanpidk ($144.84 in chips) 
Seat 3: Khaine_CM ($100.98 in chips) 
Seat 4: CI58 ($100 in chips) 
Seat 5: Alex Frider ($100 in chips) 
Seat 6: andy84lfc ($126.66 in chips) 
Seat 7: maxxmeister ($100 in chips) 
Seat 8: 178013 ($200.32 in chips) 
Seat 9: matiko09 ($180.37 in chips) 
Alex Frider: posts small blind $0.50
andy84lfc: posts big blind $1
*** HOLE CARDS ***
Dealt to matiko09 [6c 4s]
maxxmeister: folds 
178013: folds 
matiko09: folds 
HITYESCA: folds 
sanpidk: folds 
Khaine_CM: folds 
CI58: folds 
Alex Frider: raises $1.05 to $2.05
andy84lfc: folds 
Uncalled bet ($1.05) returned to Alex Frider
Alex Frider collected $2 from pot
Alex Frider: doesn't show hand 
*** SUMMARY ***
Total pot $2 | Rake $0 
Seat 1: HITYESCA folded before Flop (didn't bet)
Seat 2: sanpidk folded before Flop (didn't bet)
Seat 3: Khaine_CM folded before Flop (didn't bet)
Seat 4: CI58 (button) folded before Flop (didn't bet)
Seat 5: Alex Frider (small blind) collected ($2)
Seat 6: andy84lfc (big blind) folded before Flop
Seat 7: maxxmeister folded before Flop (didn't bet)
Seat 8: 178013 folded before Flop (didn't bet)
Seat 9: matiko09 folded before Flop (didn't bet)





PokerStars Hand #152886840334:  Hold'em No Limit ($1/$2 USD) - 2016/05/05 16:56:55 CET [2016/05/05 10:56:55 ET]
Table 'Tatry II' 9-max Seat #9 is the button
Seat 1: glanza_mike ($234.65 in chips) 
Seat 2: T0ny Adams ($60.06 in chips) 
Seat 3: matiko09 ($205.45 in chips) 
Seat 4: PacPacBum ($214.17 in chips) 
Seat 6: Kukuryzka ($285.60 in chips) 
Seat 7: myatiy 96 ($200 in chips) 
Seat 8: chaps1988 ($252.54 in chips) 
Seat 9: korol702 ($153.25 in chips) 
glanza_mike: posts small blind $1
T0ny Adams: posts big blind $2
*** HOLE CARDS ***
Dealt to matiko09 [Ac Qh]
matiko09: raises $3 to $5
PacPacBum: folds 
Kukuryzka: calls $5
myatiy 96: folds 
chaps1988: folds 
korol702: folds 
glanza_mike: folds 
T0ny Adams: folds 
*** FLOP *** [6h 6s Qd]
matiko09: bets $8.03
Kukuryzka: calls $8.03
*** TURN *** [6h 6s Qd] [Jc]
matiko09: checks 
Kukuryzka: bets $19.33
matiko09: calls $19.33
*** RIVER *** [6h 6s Qd Jc] [3s]
matiko09: checks 
Kukuryzka: bets $64.97
matiko09: folds 
Uncalled bet ($64.97) returned to Kukuryzka
Kukuryzka collected $64.97 from pot
Kukuryzka: doesn't show hand 
*** SUMMARY ***
Total pot $67.72 | Rake $2.75 
Board [6h 6s Qd Jc 3s]
Seat 1: glanza_mike (small blind) folded before Flop
Seat 2: T0ny Adams (big blind) folded before Flop
Seat 3: matiko09 folded on the River
Seat 4: PacPacBum folded before Flop (didn't bet)
Seat 6: Kukuryzka collected ($64.97)
Seat 7: myatiy 96 folded before Flop (didn't bet)
Seat 8: chaps1988 folded before Flop (didn't bet)
Seat 9: korol702 (button) folded before Flop (didn't bet)





PokerStars Hand #152886840915:  Hold'em No Limit (€1/€2 EUR) - 2016/05/05 16:56:56 CET [2016/05/05 10:56:56 ET]
Table 'Bessel II' 9-max Seat #1 is the button
Seat 1: Soloaces224 (€219.28 in chips) 
Seat 2: Fitzyferret (€342.70 in chips) 
Seat 3: PacPacBum (€211.02 in chips) 
Seat 4: Zorken76 (€144.97 in chips) 
Seat 5: Kukuryzka (€203 in chips) 
Seat 6: glanza_mike (€225.70 in chips) 
Seat 7: matiko09 (€200 in chips) 
Seat 8: chaps1988 (€248.65 in chips) 
Seat 9: JoaquinMRuiz (€211.15 in chips) 
Fitzyferret: posts small blind €1
PacPacBum: posts big blind €2
*** HOLE CARDS ***
Dealt to matiko09 [8h 3c]
Zorken76: folds 
Kukuryzka: raises €4 to €6
glanza_mike: folds 
matiko09: folds 
chaps1988: folds 
JoaquinMRuiz: folds 
Soloaces224: folds 
Fitzyferret: folds 
PacPacBum: folds 
Uncalled bet (€4) returned to Kukuryzka
Kukuryzka collected €5 from pot
Kukuryzka: doesn't show hand 
*** SUMMARY ***
Total pot €5 | Rake €0 
Seat 1: Soloaces224 (button) folded before Flop (didn't bet)
Seat 2: Fitzyferret (small blind) folded before Flop
Seat 3: PacPacBum (big blind) folded before Flop
Seat 4: Zorken76 folded before Flop (didn't bet)
Seat 5: Kukuryzka collected (€5)
Seat 6: glanza_mike folded before Flop (didn't bet)
Seat 7: matiko09 folded before Flop (didn't bet)
Seat 8: chaps1988 folded before Flop (didn't bet)
Seat 9: JoaquinMRuiz folded before Flop (didn't bet)





PokerStars Hand #152886841451:  Hold'em No Limit (€1/€2 EUR) - 2016/05/05 16:56:57 CET [2016/05/05 10:56:57 ET]
Table 'Skat II' 9-max Seat #4 is the button
Seat 2: Fitzyferret (€203 in chips) 
Seat 3: Alex Frider (€209.59 in chips) 
Seat 4: JoaquinMRuiz (€241.13 in chips) 
Seat 5: ceedonen (€214.73 in chips) 
Seat 6: drissmouzou (€247.60 in chips) 
Seat 7: PacPacBum (€202 in chips) 
Seat 9: matiko09 (€213 in chips) 
ceedonen: posts small blind €1
drissmouzou: posts big blind €2
Vikulja1993: sits out 
*** HOLE CARDS ***
Dealt to matiko09 [2h Kd]
PacPacBum: folds 
matiko09: folds 
Fitzyferret: folds 
Alex Frider: folds 
JoaquinMRuiz: raises €2.35 to €4.35
ceedonen: folds 
drissmouzou: calls €2.35
*** FLOP *** [Qh 8h Tc]
drissmouzou: checks 
JoaquinMRuiz: checks 
*** TURN *** [Qh 8h Tc] [Js]
drissmouzou: bets €4
JoaquinMRuiz: folds 
Uncalled bet (€4) returned to drissmouzou
drissmouzou collected €9.22 from pot
drissmouzou: doesn't show hand 
*** SUMMARY ***
Total pot €9.70 | Rake €0.48 
Board [Qh 8h Tc Js]
Seat 2: Fitzyferret folded before Flop (didn't bet)
Seat 3: Alex Frider folded before Flop (didn't bet)
Seat 4: JoaquinMRuiz (button) folded on the Turn
Seat 5: ceedonen (small blind) folded before Flop
Seat 6: drissmouzou (big blind) collected (€9.22)
Seat 7: PacPacBum folded before Flop (didn't bet)
Seat 9: matiko09 folded before Flop (didn't bet)





PokerStars Hand #152886843931:  Hold'em No Limit ($1/$2 USD) - 2016/05/05 16:57:02 CET [2016/05/05 10:57:02 ET]
Table 'Samitchell' 9-max Seat #4 is the button
Seat 1: CI58 ($200 in chips) 
Seat 2: matiko09 ($287.26 in chips) 
Seat 3: han3bj ($247.77 in chips) 
Seat 4: Fitzyferret ($362.13 in chips) 
Seat 5: chaps1988 ($264.12 in chips) 
Seat 6: PacPacBum ($200 in chips) 
Seat 7: patpaty ($140.11 in chips) 
Seat 8: tepi_guy ($214.08 in chips) 
Seat 9: kblkxls ($121.40 in chips) 
chaps1988: posts small blind $1
PacPacBum: posts big blind $2
*** HOLE CARDS ***
Dealt to matiko09 [2s Tc]
patpaty: folds 
tepi_guy: folds 
kblkxls: folds 
CI58: folds 
matiko09: folds 
han3bj: folds 
Fitzyferret: raises $2.60 to $4.60
chaps1988: raises $14.90 to $19.50
PacPacBum: folds 
Fitzyferret: calls $14.90
*** FLOP *** [Ac 8c 3s]
chaps1988: bets $16.50
Fitzyferret: raises $36.50 to $53
chaps1988: calls $36.50
*** TURN *** [Ac 8c 3s] [7c]
chaps1988: checks 
Fitzyferret: checks 
*** RIVER *** [Ac 8c 3s 7c] [Qs]
chaps1988: checks 
Fitzyferret: bets $56
chaps1988: calls $56
*** SHOW DOWN ***
Fitzyferret: shows [4c 3c] (a flush, Ace high)
chaps1988: mucks hand 
Fitzyferret collected $256.25 from pot
*** SUMMARY ***
Total pot $259 | Rake $2.75 
Board [Ac 8c 3s 7c Qs]
Seat 1: CI58 folded before Flop (didn't bet)
Seat 2: matiko09 folded before Flop (didn't bet)
Seat 3: han3bj folded before Flop (didn't bet)
Seat 4: Fitzyferret (button) showed [4c 3c] and won ($256.25) with a flush, Ace high
Seat 5: chaps1988 (small blind) mucked [Ad Ks]
Seat 6: PacPacBum (big blind) folded before Flop
Seat 7: patpaty folded before Flop (didn't bet)
Seat 8: tepi_guy folded before Flop (didn't bet)
Seat 9: kblkxls folded before Flop (didn't bet)





PokerStars Hand #152886849129:  Hold'em No Limit ($1/$2 USD) - 2016/05/05 16:57:12 CET [2016/05/05 10:57:12 ET]
Table 'Tololo' 9-max Seat #1 is the button
Seat 1: Kukuryzka ($261.29 in chips) 
Seat 2: tepi_guy ($201 in chips) 
Seat 3: Khaine_CM ($200 in chips) 
Seat 5: matiko09 ($231.10 in chips) 
Seat 6: Xagua ($129.95 in chips) 
Seat 7: chaps1988 ($333.12 in chips) 
Seat 8: myatiy 96 ($200 in chips) 
Seat 9: Fitzyferret ($377.77 in chips) 
tepi_guy: posts small blind $1
Khaine_CM: posts big blind $2
*** HOLE CARDS ***
Dealt to matiko09 [Jh 3h]
matiko09: folds 
Xagua: folds 
chaps1988: folds 
myatiy 96: folds 
Fitzyferret: raises $2.60 to $4.60
Kukuryzka: folds 
tepi_guy: folds 
Khaine_CM: folds 
Uncalled bet ($2.60) returned to Fitzyferret
Fitzyferret collected $5 from pot
Fitzyferret: doesn't show hand 
*** SUMMARY ***
Total pot $5 | Rake $0 
Seat 1: Kukuryzka (button) folded before Flop (didn't bet)
Seat 2: tepi_guy (small blind) folded before Flop
Seat 3: Khaine_CM (big blind) folded before Flop
Seat 5: matiko09 folded before Flop (didn't bet)
Seat 6: Xagua folded before Flop (didn't bet)
Seat 7: chaps1988 folded before Flop (didn't bet)
Seat 8: myatiy 96 folded before Flop (didn't bet)
Seat 9: Fitzyferret collected ($5)





PokerStars Hand #152886850605:  Hold'em No Limit ($1/$2 USD) - 2016/05/05 16:57:15 CET [2016/05/05 10:57:15 ET]
Table 'Euporie II' 9-max Seat #7 is the button
Seat 1: PacPacBum ($200 in chips) 
Seat 2: kblkxls ($111.67 in chips) 
Seat 3: chaps1988 ($200 in chips) 
Seat 4: tepi_guy ($200 in chips) 
Seat 5: Nuskatko1986 ($133 in chips) 
Seat 6: Kukuryzka ($213.43 in chips) 
Seat 7: matiko09 ($206 in chips) 
Seat 9: myatiy 96 ($200 in chips) 
myatiy 96: posts small blind $1
PacPacBum: posts big blind $2
*** HOLE CARDS ***
Dealt to matiko09 [6s 6c]
kblkxls: calls $2
chaps1988: folds 
tepi_guy: folds 
Nuskatko1986: calls $2
Kukuryzka: folds 
matiko09: calls $2
myatiy 96: folds 
PacPacBum: checks 
*** FLOP *** [Qh Qs Th]
PacPacBum: checks 
kblkxls: checks 
Nuskatko1986: checks 
matiko09: checks 
*** TURN *** [Qh Qs Th] [9d]
PacPacBum: bets $4.61
kblkxls: calls $4.61
Nuskatko1986: folds 
matiko09: folds 
*** RIVER *** [Qh Qs Th 9d] [5s]
PacPacBum: bets $9.34
kblkxls: raises $20.66 to $30
PacPacBum: folds 
Uncalled bet ($20.66) returned to kblkxls
kblkxls collected $35.06 from pot
kblkxls: doesn't show hand 
*** SUMMARY ***
Total pot $36.90 | Rake $1.84 
Board [Qh Qs Th 9d 5s]
Seat 1: PacPacBum (big blind) folded on the River
Seat 2: kblkxls collected ($35.06)
Seat 3: chaps1988 folded before Flop (didn't bet)
Seat 4: tepi_guy folded before Flop (didn't bet)
Seat 5: Nuskatko1986 folded on the Turn
Seat 6: Kukuryzka folded before Flop (didn't bet)
Seat 7: matiko09 (button) folded on the Turn
Seat 9: myatiy 96 (small blind) folded before Flop





PokerStars Hand #152886857104:  Hold'em No Limit (€1/€2 EUR) - 2016/05/05 16:57:28 CET [2016/05/05 10:57:28 ET]
Table 'Bessel II' 9-max Seat #2 is the button
Seat 1: Soloaces224 (€219.28 in chips) 
Seat 2: Fitzyferret (€341.70 in chips) 
Seat 3: PacPacBum (€209.02 in chips) 
Seat 4: Zorken76 (€144.97 in chips) 
Seat 5: Kukuryzka (€206 in chips) 
Seat 6: glanza_mike (€225.70 in chips) 
Seat 7: matiko09 (€200 in chips) 
Seat 8: chaps1988 (€248.65 in chips) 
Seat 9: JoaquinMRuiz (€211.15 in chips) 
PacPacBum: posts small blind €1
Zorken76: posts big blind €2
*** HOLE CARDS ***
Dealt to matiko09 [4h 7d]
Kukuryzka: folds 
glanza_mike: folds 
matiko09: folds 
chaps1988: raises €4 to €6
JoaquinMRuiz: folds 
Soloaces224: calls €6
Fitzyferret: folds 
PacPacBum: folds 
Zorken76: folds 
*** FLOP *** [7s Kd Ks]
chaps1988: checks 
Soloaces224: bets €2
chaps1988: calls €2
*** TURN *** [7s Kd Ks] [Tc]
chaps1988: checks 
Soloaces224: checks 
*** RIVER *** [7s Kd Ks Tc] [3s]
chaps1988: bets €12
Soloaces224: folds 
Uncalled bet (€12) returned to chaps1988
chaps1988 collected €18.05 from pot
*** SUMMARY ***
Total pot €19 | Rake €0.95 
Board [7s Kd Ks Tc 3s]
Seat 1: Soloaces224 folded on the River
Seat 2: Fitzyferret (button) folded before Flop (didn't bet)
Seat 3: PacPacBum (small blind) folded before Flop
Seat 4: Zorken76 (big blind) folded before Flop
Seat 5: Kukuryzka folded before Flop (didn't bet)
Seat 6: glanza_mike folded before Flop (didn't bet)
Seat 7: matiko09 folded before Flop (didn't bet)
Seat 8: chaps1988 collected (€18.05)
Seat 9: JoaquinMRuiz folded before Flop (didn't bet)





PokerStars Hand #152886858728:  Hold'em No Limit ($0.50/$1.00 USD) - 2016/05/05 16:57:31 CET [2016/05/05 10:57:31 ET]
Table 'Kraz II' 9-max Seat #5 is the button
Seat 1: HITYESCA ($141.30 in chips) 
Seat 2: sanpidk ($144.84 in chips) 
Seat 3: Khaine_CM ($100.98 in chips) 
Seat 4: CI58 ($100 in chips) 
Seat 5: Alex Frider ($101 in chips) 
Seat 6: andy84lfc ($125.66 in chips) 
Seat 7: maxxmeister ($100 in chips) 
Seat 8: 178013 ($200.32 in chips) 
Seat 9: matiko09 ($180.37 in chips) 
andy84lfc: posts small blind $0.50
maxxmeister: posts big blind $1
*** HOLE CARDS ***
Dealt to matiko09 [6s Th]
178013: folds 
matiko09: folds 
HITYESCA: folds 
sanpidk: folds 
Khaine_CM: folds 
CI58: folds 
Alex Frider: raises $1.50 to $2.50
andy84lfc: folds 
maxxmeister: calls $1.50
*** FLOP *** [Jd 3c 7c]
maxxmeister: checks 
Alex Frider: checks 
*** TURN *** [Jd 3c 7c] [2s]
maxxmeister: bets $4.15
Alex Frider: calls $4.15
*** RIVER *** [Jd 3c 7c 2s] [7d]
maxxmeister: bets $7
Alex Frider: raises $20.50 to $27.50
maxxmeister: raises $65.85 to $93.35 and is all-in
Alex Frider: folds 
Uncalled bet ($65.85) returned to maxxmeister
maxxmeister collected $66.30 from pot
maxxmeister: doesn't show hand 
*** SUMMARY ***
Total pot $68.80 | Rake $2.50 
Board [Jd 3c 7c 2s 7d]
Seat 1: HITYESCA folded before Flop (didn't bet)
Seat 2: sanpidk folded before Flop (didn't bet)
Seat 3: Khaine_CM folded before Flop (didn't bet)
Seat 4: CI58 folded before Flop (didn't bet)
Seat 5: Alex Frider (button) folded on the River
Seat 6: andy84lfc (small blind) folded before Flop
Seat 7: maxxmeister (big blind) collected ($66.30)
Seat 8: 178013 folded before Flop (didn't bet)
Seat 9: matiko09 folded before Flop (didn't bet)





PokerStars Hand #152886871144:  Hold'em No Limit (€1/€2 EUR) - 2016/05/05 16:57:54 CET [2016/05/05 10:57:54 ET]
Table 'Skat II' 9-max Seat #5 is the button
Seat 2: Fitzyferret (€203 in chips) 
Seat 3: Alex Frider (€209.59 in chips) 
Seat 4: JoaquinMRuiz (€236.78 in chips) 
Seat 5: ceedonen (€213.73 in chips) 
Seat 6: drissmouzou (€252.47 in chips) 
Seat 7: PacPacBum (€202 in chips) 
Seat 9: matiko09 (€213 in chips) 
drissmouzou: posts small blind €1
PacPacBum: posts big blind €2
Vikulja1993: sits out 
*** HOLE CARDS ***
Dealt to matiko09 [5c As]
matiko09: folds 
Fitzyferret: folds 
Alex Frider: folds 
JoaquinMRuiz: folds 
ceedonen: folds 
drissmouzou: calls €1
PacPacBum: checks 
*** FLOP *** [Ah 5h 4s]
drissmouzou: bets €2
PacPacBum: raises €4.21 to €6.21
drissmouzou: folds 
Uncalled bet (€4.21) returned to PacPacBum
PacPacBum collected €7.60 from pot
PacPacBum: doesn't show hand 
*** SUMMARY ***
Total pot €8 | Rake €0.40 
Board [Ah 5h 4s]
Seat 2: Fitzyferret folded before Flop (didn't bet)
Seat 3: Alex Frider folded before Flop (didn't bet)
Seat 4: JoaquinMRuiz folded before Flop (didn't bet)
Seat 5: ceedonen (button) folded before Flop (didn't bet)
Seat 6: drissmouzou (small blind) folded on the Flop
Seat 7: PacPacBum (big blind) collected (€7.60)
Seat 9: matiko09 folded before Flop (didn't bet)





PokerStars Hand #152886872289:  Hold'em No Limit ($1/$2 USD) - 2016/05/05 16:57:57 CET [2016/05/05 10:57:57 ET]
Table 'Tololo' 9-max Seat #2 is the button
Seat 1: Kukuryzka ($261.29 in chips) 
Seat 2: tepi_guy ($200 in chips) 
Seat 3: Khaine_CM ($200 in chips) 
Seat 5: matiko09 ($231.10 in chips) 
Seat 6: Xagua ($129.95 in chips) 
Seat 7: chaps1988 ($333.12 in chips) 
Seat 8: myatiy 96 ($200 in chips) 
Seat 9: Fitzyferret ($380.77 in chips) 
Khaine_CM: posts small blind $1
matiko09: posts big blind $2
*** HOLE CARDS ***
Dealt to matiko09 [9c Kc]
Xagua: folds 
chaps1988: folds 
myatiy 96: folds 
Fitzyferret: folds 
Kukuryzka: folds 
Xagua leaves the table
Vikulja1993 joins the table at seat #6 
tepi_guy: raises $2.40 to $4.40
Khaine_CM: calls $3.40
matiko09: calls $2.40
*** FLOP *** [Jh 4c 2h]
Khaine_CM: checks 
matiko09: bets $8
tepi_guy: calls $8
Khaine_CM: folds 
*** TURN *** [Jh 4c 2h] [9h]
matiko09: checks 
tepi_guy: bets $20.75
matiko09: folds 
Uncalled bet ($20.75) returned to tepi_guy
tepi_guy collected $27.74 from pot
tepi_guy: doesn't show hand 
*** SUMMARY ***
Total pot $29.20 | Rake $1.46 
Board [Jh 4c 2h 9h]
Seat 1: Kukuryzka folded before Flop (didn't bet)
Seat 2: tepi_guy (button) collected ($27.74)
Seat 3: Khaine_CM (small blind) folded on the Flop
Seat 5: matiko09 (big blind) folded on the Turn
Seat 6: Xagua folded before Flop (didn't bet)
Seat 7: chaps1988 folded before Flop (didn't bet)
Seat 8: myatiy 96 folded before Flop (didn't bet)
Seat 9: Fitzyferret folded before Flop (didn't bet)





PokerStars Hand #152886877189:  Hold'em No Limit ($1/$2 USD) - 2016/05/05 16:58:06 CET [2016/05/05 10:58:06 ET]
Table 'Tatry II' 9-max Seat #1 is the button
Seat 1: glanza_mike ($233.65 in chips) 
Seat 2: T0ny Adams ($80 in chips) 
Seat 3: matiko09 ($200 in chips) 
Seat 4: PacPacBum ($214.17 in chips) 
Seat 6: Kukuryzka ($318.21 in chips) 
Seat 7: myatiy 96 ($200 in chips) 
Seat 8: chaps1988 ($252.54 in chips) 
Seat 9: korol702 ($153.25 in chips) 
T0ny Adams: posts small blind $1
matiko09: posts big blind $2
*** HOLE CARDS ***
Dealt to matiko09 [Qs 4c]
PacPacBum: folds 
Kukuryzka: folds 
myatiy 96: folds 
chaps1988: folds 
korol702: raises $2 to $4
glanza_mike: raises $9 to $13
T0ny Adams: folds 
matiko09: folds 
korol702: calls $9
*** FLOP *** [8c 5d 3d]
korol702: checks 
glanza_mike: bets $14.50
korol702: calls $14.50
*** TURN *** [8c 5d 3d] [7c]
korol702: checks 
glanza_mike: checks 
*** RIVER *** [8c 5d 3d 7c] [Kh]
korol702: checks 
glanza_mike: checks 
*** SHOW DOWN ***
korol702: shows [Kd Qd] (a pair of Kings)
glanza_mike: mucks hand 
korol702 collected $55.25 from pot
*** SUMMARY ***
Total pot $58 | Rake $2.75 
Board [8c 5d 3d 7c Kh]
Seat 1: glanza_mike (button) mucked [9d 7d]
Seat 2: T0ny Adams (small blind) folded before Flop
Seat 3: matiko09 (big blind) folded before Flop
Seat 4: PacPacBum folded before Flop (didn't bet)
Seat 6: Kukuryzka folded before Flop (didn't bet)
Seat 7: myatiy 96 folded before Flop (didn't bet)
Seat 8: chaps1988 folded before Flop (didn't bet)
Seat 9: korol702 showed [Kd Qd] and won ($55.25) with a pair of Kings





PokerStars Hand #152886885552:  Hold'em No Limit (€1/€2 EUR) - 2016/05/05 16:58:22 CET [2016/05/05 10:58:22 ET]
Table 'Bessel II' 9-max Seat #3 is the button
Seat 1: Soloaces224 (€211.28 in chips) 
Seat 2: Fitzyferret (€341.70 in chips) 
Seat 3: PacPacBum (€208.02 in chips) 
Seat 4: Zorken76 (€142.97 in chips) 
Seat 5: Kukuryzka (€206 in chips) 
Seat 6: glanza_mike (€225.70 in chips) 
Seat 7: matiko09 (€200 in chips) 
Seat 8: chaps1988 (€258.70 in chips) 
Seat 9: JoaquinMRuiz (€211.15 in chips) 
Zorken76: posts small blind €1
Kukuryzka: posts big blind €2
*** HOLE CARDS ***
Dealt to matiko09 [2h Qc]
glanza_mike: folds 
matiko09: folds 
chaps1988: folds 
JoaquinMRuiz: folds 
Soloaces224: raises €4 to €6
Fitzyferret: folds 
PacPacBum: folds 
Zorken76: folds 
Kukuryzka: folds 
Uncalled bet (€4) returned to Soloaces224
Soloaces224 collected €5 from pot
Soloaces224: doesn't show hand 
*** SUMMARY ***
Total pot €5 | Rake €0 
Seat 1: Soloaces224 collected (€5)
Seat 2: Fitzyferret folded before Flop (didn't bet)
Seat 3: PacPacBum (button) folded before Flop (didn't bet)
Seat 4: Zorken76 (small blind) folded before Flop
Seat 5: Kukuryzka (big blind) folded before Flop
Seat 6: glanza_mike folded before Flop (didn't bet)
Seat 7: matiko09 folded before Flop (didn't bet)
Seat 8: chaps1988 folded before Flop (didn't bet)
Seat 9: JoaquinMRuiz folded before Flop (didn't bet)





PokerStars Hand #152886892347:  Hold'em No Limit ($0.50/$1.00 USD) - 2016/05/05 16:58:35 CET [2016/05/05 10:58:35 ET]
Table 'Siberia' 9-max Seat #4 is the button
Seat 1: Kukuryzka ($100 in chips) 
Seat 2: Painkiller72 ($100 in chips) 
Seat 3: sanpidk ($100 in chips) 
Seat 4: opsv ($70 in chips) 
Seat 5: myatiy 96 ($100 in chips) 
Seat 6: bjonlyking ($100 in chips) 
Seat 7: matiko09 ($100 in chips) 
Seat 8: Vikulja1993 ($100 in chips) 
Seat 9: arctur17 ($80 in chips) 
myatiy 96: posts small blind $0.50
bjonlyking: posts big blind $1
*** HOLE CARDS ***
Dealt to matiko09 [7h Qs]
matiko09: folds 
Vikulja1993: folds 
arctur17: folds 
Kukuryzka: folds 
Painkiller72 has timed out
Painkiller72: folds 
sanpidk: raises $1.50 to $2.50
opsv: folds 
myatiy 96: folds 
bjonlyking: folds 
Uncalled bet ($1.50) returned to sanpidk
sanpidk collected $2.50 from pot
sanpidk: doesn't show hand 
*** SUMMARY ***
Total pot $2.50 | Rake $0 
Seat 1: Kukuryzka folded before Flop (didn't bet)
Seat 2: Painkiller72 folded before Flop (didn't bet)
Seat 3: sanpidk collected ($2.50)
Seat 4: opsv (button) folded before Flop (didn't bet)
Seat 5: myatiy 96 (small blind) folded before Flop
Seat 6: bjonlyking (big blind) folded before Flop
Seat 7: matiko09 folded before Flop (didn't bet)
Seat 8: Vikulja1993 folded before Flop (didn't bet)
Seat 9: arctur17 folded before Flop (didn't bet)





PokerStars Hand #152886893347:  Hold'em No Limit ($1/$2 USD) - 2016/05/05 16:58:37 CET [2016/05/05 10:58:37 ET]
Table 'Euporie II' 9-max Seat #9 is the button
Seat 1: PacPacBum ($200 in chips) 
Seat 2: kblkxls ($130.78 in chips) 
Seat 3: chaps1988 ($200 in chips) 
Seat 4: tepi_guy ($200 in chips) 
Seat 5: Nuskatko1986 ($131 in chips) 
Seat 6: Kukuryzka ($213.43 in chips) 
Seat 7: matiko09 ($204 in chips) 
Seat 9: myatiy 96 ($200 in chips) 
PacPacBum: posts small blind $1
kblkxls: posts big blind $2
*** HOLE CARDS ***
Dealt to matiko09 [5d Td]
chaps1988: folds 
tepi_guy: folds 
Nuskatko1986: calls $2
Kukuryzka: raises $6 to $8
matiko09: folds 
myatiy 96: folds 
PacPacBum: folds 
kblkxls: calls $6
Nuskatko1986: calls $6
*** FLOP *** [Jh 8d 5h]
kblkxls: checks 
Nuskatko1986: checks 
Kukuryzka: checks 
*** TURN *** [Jh 8d 5h] [6s]
kblkxls: bets $15
Nuskatko1986: folds 
Kukuryzka: folds 
Uncalled bet ($15) returned to kblkxls
kblkxls collected $23.75 from pot
kblkxls: doesn't show hand 
*** SUMMARY ***
Total pot $25 | Rake $1.25 
Board [Jh 8d 5h 6s]
Seat 1: PacPacBum (small blind) folded before Flop
Seat 2: kblkxls (big blind) collected ($23.75)
Seat 3: chaps1988 folded before Flop (didn't bet)
Seat 4: tepi_guy folded before Flop (didn't bet)
Seat 5: Nuskatko1986 folded on the Turn
Seat 6: Kukuryzka folded on the Turn
Seat 7: matiko09 folded before Flop (didn't bet)
Seat 9: myatiy 96 (button) folded before Flop (didn't bet)





PokerStars Hand #152886895198:  Hold'em No Limit (€1/€2 EUR) - 2016/05/05 16:58:40 CET [2016/05/05 10:58:40 ET]
Table 'Skat II' 9-max Seat #6 is the button
Seat 2: Fitzyferret (€203 in chips) 
Seat 3: Alex Frider (€209.59 in chips) 
Seat 4: JoaquinMRuiz (€236.78 in chips) 
Seat 5: ceedonen (€213.73 in chips) 
Seat 6: drissmouzou (€248.47 in chips) 
Seat 7: PacPacBum (€205.60 in chips) 
Seat 9: matiko09 (€213 in chips) 
PacPacBum: posts small blind €1
matiko09: posts big blind €2
Vikulja1993: sits out 
*** HOLE CARDS ***
Dealt to matiko09 [7h 6c]
Fitzyferret: folds 
Alex Frider: folds 
JoaquinMRuiz: folds 
ceedonen: folds 
drissmouzou: raises €2 to €4
PacPacBum: folds 
matiko09: folds 
Uncalled bet (€2) returned to drissmouzou
drissmouzou collected €5 from pot
drissmouzou: doesn't show hand 
*** SUMMARY ***
Total pot €5 | Rake €0 
Seat 2: Fitzyferret folded before Flop (didn't bet)
Seat 3: Alex Frider folded before Flop (didn't bet)
Seat 4: JoaquinMRuiz folded before Flop (didn't bet)
Seat 5: ceedonen folded before Flop (didn't bet)
Seat 6: drissmouzou (button) collected (€5)
Seat 7: PacPacBum (small blind) folded before Flop
Seat 9: matiko09 (big blind) folded before Flop





PokerStars Hand #152886897952:  Hold'em No Limit (€1/€2 EUR) - 2016/05/05 16:58:45 CET [2016/05/05 10:58:45 ET]
Table 'Bessel II' 9-max Seat #4 is the button
Seat 1: Soloaces224 (€214.28 in chips) 
Seat 2: Fitzyferret (€341.70 in chips) 
Seat 3: PacPacBum (€208.02 in chips) 
Seat 4: Zorken76 (€141.97 in chips) 
Seat 5: Kukuryzka (€204 in chips) 
Seat 7: matiko09 (€200 in chips) 
Seat 8: chaps1988 (€258.70 in chips) 
Seat 9: JoaquinMRuiz (€211.15 in chips) 
Kukuryzka: posts small blind €1
glanza_mike: is sitting out 
matiko09: posts big blind €2
*** HOLE CARDS ***
Dealt to matiko09 [9c Qc]
chaps1988: folds 
glanza_mike leaves the table
Vikulja1993 joins the table at seat #6 
JoaquinMRuiz: folds 
Soloaces224: folds 
Fitzyferret: folds 
PacPacBum: folds 
Zorken76: folds 
Kukuryzka: raises €4 to €6
matiko09: calls €4
*** FLOP *** [2h 6h 6s]
Kukuryzka: bets €8.55
matiko09: folds 
Uncalled bet (€8.55) returned to Kukuryzka
Kukuryzka collected €11.40 from pot
Kukuryzka: doesn't show hand 
*** SUMMARY ***
Total pot €12 | Rake €0.60 
Board [2h 6h 6s]
Seat 1: Soloaces224 folded before Flop (didn't bet)
Seat 2: Fitzyferret folded before Flop (didn't bet)
Seat 3: PacPacBum folded before Flop (didn't bet)
Seat 4: Zorken76 (button) folded before Flop (didn't bet)
Seat 5: Kukuryzka (small blind) collected (€11.40)
Seat 7: matiko09 (big blind) folded on the Flop
Seat 8: chaps1988 folded before Flop (didn't bet)
Seat 9: JoaquinMRuiz folded before Flop (didn't bet)





PokerStars Hand #152886905200:  Hold'em No Limit (€1/€2 EUR) - 2016/05/05 16:58:59 CET [2016/05/05 10:58:59 ET]
Table 'Skat II' 9-max Seat #7 is the button
Seat 1: Vikulja1993 (€200 in chips) 
Seat 2: Fitzyferret (€203 in chips) 
Seat 3: Alex Frider (€209.59 in chips) 
Seat 4: JoaquinMRuiz (€236.78 in chips) 
Seat 5: ceedonen (€213.73 in chips) 
Seat 6: drissmouzou (€251.47 in chips) 
Seat 7: PacPacBum (€204.60 in chips) 
Seat 9: matiko09 (€211 in chips) 
matiko09: posts small blind €1
Vikulja1993: posts big blind €2
*** HOLE CARDS ***
Dealt to matiko09 [8d 8c]
Fitzyferret: folds 
Alex Frider: folds 
JoaquinMRuiz: folds 
ceedonen: folds 
drissmouzou: folds 
PacPacBum: raises €4 to €6
matiko09: raises €14 to €20
Vikulja1993: folds 
PacPacBum: calls €14
*** FLOP *** [Jc 4s Ks]
matiko09: checks 
PacPacBum: checks 
*** TURN *** [Jc 4s Ks] [Ts]
matiko09: checks 
PacPacBum: bets €27.53
matiko09: folds 
Uncalled bet (€27.53) returned to PacPacBum
PacPacBum collected €39.90 from pot
PacPacBum: doesn't show hand 
*** SUMMARY ***
Total pot €42 | Rake €2.10 
Board [Jc 4s Ks Ts]
Seat 1: Vikulja1993 (big blind) folded before Flop
Seat 2: Fitzyferret folded before Flop (didn't bet)
Seat 3: Alex Frider folded before Flop (didn't bet)
Seat 4: JoaquinMRuiz folded before Flop (didn't bet)
Seat 5: ceedonen folded before Flop (didn't bet)
Seat 6: drissmouzou folded before Flop (didn't bet)
Seat 7: PacPacBum (button) collected (€39.90)
Seat 9: matiko09 (small blind) folded on the Turn





PokerStars Hand #152886910925:  Hold'em No Limit ($1/$2 USD) - 2016/05/05 16:59:10 CET [2016/05/05 10:59:10 ET]
Table 'Tatry II' 9-max Seat #2 is the button
Seat 1: glanza_mike ($206.15 in chips) 
Seat 2: T0ny Adams ($79 in chips) 
Seat 3: matiko09 ($200 in chips) 
Seat 4: PacPacBum ($214.17 in chips) 
Seat 6: Kukuryzka ($318.21 in chips) 
Seat 7: myatiy 96 ($200 in chips) 
Seat 8: chaps1988 ($252.54 in chips) 
Seat 9: korol702 ($181 in chips) 
matiko09: posts small blind $1
PacPacBum: posts big blind $2
*** HOLE CARDS ***
Dealt to matiko09 [Kc 8d]
Kukuryzka: folds 
myatiy 96: folds 
chaps1988: raises $4 to $6
korol702: folds 
glanza_mike: folds 
T0ny Adams: folds 
matiko09: folds 
PacPacBum: folds 
Uncalled bet ($4) returned to chaps1988
chaps1988 collected $5 from pot
*** SUMMARY ***
Total pot $5 | Rake $0 
Seat 1: glanza_mike folded before Flop (didn't bet)
Seat 2: T0ny Adams (button) folded before Flop (didn't bet)
Seat 3: matiko09 (small blind) folded before Flop
Seat 4: PacPacBum (big blind) folded before Flop
Seat 6: Kukuryzka folded before Flop (didn't bet)
Seat 7: myatiy 96 folded before Flop (didn't bet)
Seat 8: chaps1988 collected ($5)
Seat 9: korol702 folded before Flop (didn't bet)





PokerStars Hand #152886913513:  Hold'em No Limit ($0.50/$1.00 USD) - 2016/05/05 16:59:15 CET [2016/05/05 10:59:15 ET]
Table 'Kraz II' 9-max Seat #6 is the button
Seat 1: HITYESCA ($141.30 in chips) 
Seat 2: sanpidk ($144.84 in chips) 
Seat 3: Khaine_CM ($100.98 in chips) 
Seat 4: CI58 ($100 in chips) 
Seat 5: Alex Frider ($100 in chips) 
Seat 6: andy84lfc ($125.16 in chips) 
Seat 7: maxxmeister ($132.15 in chips) 
Seat 8: 178013 ($200.32 in chips) 
Seat 9: matiko09 ($180.37 in chips) 
maxxmeister: posts small blind $0.50
178013: posts big blind $1
*** HOLE CARDS ***
Dealt to matiko09 [Qh Kc]
matiko09: folds 
HITYESCA: folds 
sanpidk: folds 
Khaine_CM: folds 
CI58: folds 
Alex Frider: folds 
andy84lfc: folds 
maxxmeister: folds 
Uncalled bet ($0.50) returned to 178013
178013 collected $1 from pot
178013: doesn't show hand 
*** SUMMARY ***
Total pot $1 | Rake $0 
Seat 1: HITYESCA folded before Flop (didn't bet)
Seat 2: sanpidk folded before Flop (didn't bet)
Seat 3: Khaine_CM folded before Flop (didn't bet)
Seat 4: CI58 folded before Flop (didn't bet)
Seat 5: Alex Frider folded before Flop (didn't bet)
Seat 6: andy84lfc (button) folded before Flop (didn't bet)
Seat 7: maxxmeister (small blind) folded before Flop
Seat 8: 178013 (big blind) collected ($1)
Seat 9: matiko09 folded before Flop (didn't bet)





PokerStars Hand #152886914312:  Hold'em No Limit ($1/$2 USD) - 2016/05/05 16:59:17 CET [2016/05/05 10:59:17 ET]
Table 'Tololo' 9-max Seat #3 is the button
Seat 1: Kukuryzka ($261.29 in chips) 
Seat 2: tepi_guy ($215.34 in chips) 
Seat 3: Khaine_CM ($200 in chips) 
Seat 5: matiko09 ($218.70 in chips) 
Seat 6: Vikulja1993 ($200 in chips) 
Seat 7: chaps1988 ($333.12 in chips) 
Seat 8: myatiy 96 ($200 in chips) 
Seat 9: Fitzyferret ($380.77 in chips) 
mooose100 will be allowed to play after the button
matiko09: posts small blind $1
Vikulja1993: posts big blind $2
*** HOLE CARDS ***
Dealt to matiko09 [Jh 8d]
chaps1988: raises $4 to $6
myatiy 96: folds 
Fitzyferret: folds 
Kukuryzka: folds 
tepi_guy: folds 
Khaine_CM: folds 
matiko09: folds 
Vikulja1993: folds 
Uncalled bet ($4) returned to chaps1988
chaps1988 collected $5 from pot
*** SUMMARY ***
Total pot $5 | Rake $0 
Seat 1: Kukuryzka folded before Flop (didn't bet)
Seat 2: tepi_guy folded before Flop (didn't bet)
Seat 3: Khaine_CM (button) folded before Flop (didn't bet)
Seat 5: matiko09 (small blind) folded before Flop
Seat 6: Vikulja1993 (big blind) folded before Flop
Seat 7: chaps1988 collected ($5)
Seat 8: myatiy 96 folded before Flop (didn't bet)
Seat 9: Fitzyferret folded before Flop (didn't bet)





PokerStars Hand #152886917851:  Hold'em No Limit ($1/$2 USD) - 2016/05/05 16:59:23 CET [2016/05/05 10:59:23 ET]
Table 'Samitchell' 9-max Seat #5 is the button
Seat 1: CI58 ($200 in chips) 
Seat 2: matiko09 ($287.26 in chips) 
Seat 3: han3bj ($247.77 in chips) 
Seat 4: Fitzyferret ($489.88 in chips) 
Seat 5: chaps1988 ($200 in chips) 
Seat 6: PacPacBum ($200 in chips) 
Seat 7: patpaty ($140.11 in chips) 
Seat 8: tepi_guy ($214.08 in chips) 
Seat 9: kblkxls ($121.40 in chips) 
PacPacBum: posts small blind $1
patpaty: posts big blind $2
*** HOLE CARDS ***
Dealt to matiko09 [Qh Ac]
tepi_guy has timed out
tepi_guy: folds 
kblkxls: folds 
CI58: folds 
matiko09: raises $3 to $5
han3bj: folds 
Fitzyferret: raises $14 to $19
chaps1988: folds 
PacPacBum: folds 
patpaty: folds 
matiko09: folds 
Uncalled bet ($14) returned to Fitzyferret
Fitzyferret collected $13 from pot
Fitzyferret: doesn't show hand 
*** SUMMARY ***
Total pot $13 | Rake $0 
Seat 1: CI58 folded before Flop (didn't bet)
Seat 2: matiko09 folded before Flop
Seat 3: han3bj folded before Flop (didn't bet)
Seat 4: Fitzyferret collected ($13)
Seat 5: chaps1988 (button) folded before Flop (didn't bet)
Seat 6: PacPacBum (small blind) folded before Flop
Seat 7: patpaty (big blind) folded before Flop
Seat 8: tepi_guy folded before Flop (didn't bet)
Seat 9: kblkxls folded before Flop (didn't bet)





PokerStars Hand #152886923332:  Hold'em No Limit (€1/€2 EUR) - 2016/05/05 16:59:34 CET [2016/05/05 10:59:34 ET]
Table 'Bessel II' 9-max Seat #5 is the button
Seat 1: Soloaces224 (€214.28 in chips) 
Seat 2: Fitzyferret (€341.70 in chips) 
Seat 3: PacPacBum (€208.02 in chips) 
Seat 4: Zorken76 (€141.97 in chips) 
Seat 5: Kukuryzka (€209.40 in chips) 
Seat 7: matiko09 (€200 in chips) 
Seat 8: chaps1988 (€258.70 in chips) 
Seat 9: JoaquinMRuiz (€211.15 in chips) 
Vikulja1993 will be allowed to play after the button
matiko09: posts small blind €1
chaps1988: posts big blind €2
*** HOLE CARDS ***
Dealt to matiko09 [3d 9d]
JoaquinMRuiz: raises €2.35 to €4.35
Soloaces224: folds 
Fitzyferret: folds 
PacPacBum: folds 
Zorken76 is disconnected 
Zorken76 has timed out while disconnected
Zorken76: folds 
Kukuryzka: folds 
matiko09: folds 
Zorken76 leaves the table
chaps1988: folds 
Uncalled bet (€2.35) returned to JoaquinMRuiz
myatiy 96 joins the table at seat #4 
JoaquinMRuiz collected €5 from pot
myatiy 96 leaves the table
*** SUMMARY ***
Total pot €5 | Rake €0 
Seat 1: Soloaces224 folded before Flop (didn't bet)
Seat 2: Fitzyferret folded before Flop (didn't bet)
Seat 3: PacPacBum folded before Flop (didn't bet)
Seat 4: Zorken76 folded before Flop (didn't bet)
Seat 5: Kukuryzka (button) folded before Flop (didn't bet)
Seat 7: matiko09 (small blind) folded before Flop
Seat 8: chaps1988 (big blind) folded before Flop
Seat 9: JoaquinMRuiz collected (€5)





PokerStars Hand #152886925992:  Hold'em No Limit ($1/$2 USD) - 2016/05/05 16:59:39 CET [2016/05/05 10:59:39 ET]
Table 'Tatry II' 9-max Seat #3 is the button
Seat 1: glanza_mike ($206.15 in chips) 
Seat 2: T0ny Adams ($79 in chips) 
Seat 3: matiko09 ($200 in chips) 
Seat 4: PacPacBum ($212.17 in chips) 
Seat 5: Painkiller72 ($314.75 in chips) 
Seat 6: Kukuryzka ($318.21 in chips) 
Seat 7: myatiy 96 ($200 in chips) 
Seat 8: chaps1988 ($255.54 in chips) 
Seat 9: korol702 ($181 in chips) 
PacPacBum: posts small blind $1
Painkiller72: posts big blind $2
*** HOLE CARDS ***
Dealt to matiko09 [6c 7s]
Kukuryzka: folds 
myatiy 96: folds 
chaps1988: folds 
korol702: raises $4 to $6
glanza_mike: calls $6
T0ny Adams: folds 
matiko09: folds 
PacPacBum: folds 
Painkiller72: raises $19 to $25
korol702: raises $41 to $66
glanza_mike: folds 
Painkiller72: folds 
Uncalled bet ($41) returned to korol702
korol702 collected $57 from pot
korol702: doesn't show hand 
*** SUMMARY ***
Total pot $57 | Rake $0 
Seat 1: glanza_mike folded before Flop
Seat 2: T0ny Adams folded before Flop (didn't bet)
Seat 3: matiko09 (button) folded before Flop (didn't bet)
Seat 4: PacPacBum (small blind) folded before Flop
Seat 5: Painkiller72 (big blind) folded before Flop
Seat 6: Kukuryzka folded before Flop (didn't bet)
Seat 7: myatiy 96 folded before Flop (didn't bet)
Seat 8: chaps1988 folded before Flop (didn't bet)
Seat 9: korol702 collected ($57)





PokerStars Hand #152886931119:  Hold'em No Limit ($1/$2 USD) - 2016/05/05 16:59:49 CET [2016/05/05 10:59:49 ET]
Table 'Euporie II' 9-max Seat #1 is the button
Seat 1: PacPacBum ($200 in chips) 
Seat 2: kblkxls ($146.53 in chips) 
Seat 3: chaps1988 ($200 in chips) 
Seat 4: tepi_guy ($200 in chips) 
Seat 5: Nuskatko1986 ($123 in chips) 
Seat 6: Kukuryzka ($205.43 in chips) 
Seat 7: matiko09 ($204 in chips) 
Seat 9: myatiy 96 ($200 in chips) 
kblkxls: posts small blind $1
chaps1988: posts big blind $2
Painkiller72: sits out 
*** HOLE CARDS ***
Dealt to matiko09 [4h 7d]
tepi_guy: folds 
Nuskatko1986: calls $2
Kukuryzka: folds 
matiko09: folds 
myatiy 96: folds 
PacPacBum: folds 
kblkxls: calls $1
chaps1988: raises $8 to $10
Nuskatko1986: folds 
kblkxls: folds 
Uncalled bet ($8) returned to chaps1988
chaps1988 collected $6 from pot
*** SUMMARY ***
Total pot $6 | Rake $0 
Seat 1: PacPacBum (button) folded before Flop (didn't bet)
Seat 2: kblkxls (small blind) folded before Flop
Seat 3: chaps1988 (big blind) collected ($6)
Seat 4: tepi_guy folded before Flop (didn't bet)
Seat 5: Nuskatko1986 folded before Flop
Seat 6: Kukuryzka folded before Flop (didn't bet)
Seat 7: matiko09 folded before Flop (didn't bet)
Seat 9: myatiy 96 folded before Flop (didn't bet)





PokerStars Hand #152886933800:  Hold'em No Limit ($1/$2 USD) - 2016/05/05 16:59:54 CET [2016/05/05 10:59:54 ET]
Table 'Tololo' 9-max Seat #5 is the button
Seat 1: Kukuryzka ($261.29 in chips) 
Seat 2: tepi_guy ($215.34 in chips) 
Seat 3: Khaine_CM ($200 in chips) 
Seat 5: matiko09 ($217.70 in chips) 
Seat 6: Vikulja1993 ($200 in chips) 
Seat 7: chaps1988 ($336.12 in chips) 
Seat 8: myatiy 96 ($200 in chips) 
Seat 9: Fitzyferret ($380.77 in chips) 
Vikulja1993: posts small blind $1
chaps1988: posts big blind $2
mooose100: sits out 
*** HOLE CARDS ***
Dealt to matiko09 [2h 9c]
myatiy 96: folds 
Fitzyferret: folds 
Kukuryzka: folds 
tepi_guy: folds 
Khaine_CM: folds 
matiko09: folds 
Vikulja1993: folds 
Uncalled bet ($1) returned to chaps1988
chaps1988 collected $2 from pot
*** SUMMARY ***
Total pot $2 | Rake $0 
Seat 1: Kukuryzka folded before Flop (didn't bet)
Seat 2: tepi_guy folded before Flop (didn't bet)
Seat 3: Khaine_CM folded before Flop (didn't bet)
Seat 5: matiko09 (button) folded before Flop (didn't bet)
Seat 6: Vikulja1993 (small blind) folded before Flop
Seat 7: chaps1988 (big blind) collected ($2)
Seat 8: myatiy 96 folded before Flop (didn't bet)
Seat 9: Fitzyferret folded before Flop (didn't bet)





PokerStars Hand #152886937285:  Hold'em No Limit (€1/€2 EUR) - 2016/05/05 17:00:00 CET [2016/05/05 11:00:00 ET]
Table 'Skat II' 9-max Seat #9 is the button
Seat 1: Vikulja1993 (€200 in chips) 
Seat 2: Fitzyferret (€203 in chips) 
Seat 3: Alex Frider (€209.59 in chips) 
Seat 4: JoaquinMRuiz (€236.78 in chips) 
Seat 5: ceedonen (€213.73 in chips) 
Seat 6: drissmouzou (€251.47 in chips) 
Seat 7: PacPacBum (€224.50 in chips) 
Seat 9: matiko09 (€200 in chips) 
Vikulja1993: posts small blind €1
Fitzyferret: posts big blind €2
Painkiller72: sits out 
*** HOLE CARDS ***
Dealt to matiko09 [Ad 6s]
Alex Frider: folds 
JoaquinMRuiz: folds 
ceedonen: raises €4 to €6
drissmouzou: folds 
PacPacBum: folds 
matiko09: folds 
Vikulja1993: folds 
Fitzyferret: folds 
Uncalled bet (€4) returned to ceedonen
ceedonen collected €5 from pot
*** SUMMARY ***
Total pot €5 | Rake €0 
Seat 1: Vikulja1993 (small blind) folded before Flop
Seat 2: Fitzyferret (big blind) folded before Flop
Seat 3: Alex Frider folded before Flop (didn't bet)
Seat 4: JoaquinMRuiz folded before Flop (didn't bet)
Seat 5: ceedonen collected (€5)
Seat 6: drissmouzou folded before Flop (didn't bet)
Seat 7: PacPacBum folded before Flop (didn't bet)
Seat 9: matiko09 (button) folded before Flop (didn't bet)





PokerStars Hand #152886937701:  Hold'em No Limit ($0.50/$1.00 USD) - 2016/05/05 17:00:01 CET [2016/05/05 11:00:01 ET]
Table 'Siberia' 9-max Seat #5 is the button
Seat 1: Kukuryzka ($100 in chips) 
Seat 2: Painkiller72 ($100 in chips) 
Seat 3: sanpidk ($101.50 in chips) 
Seat 4: opsv ($70 in chips) 
Seat 5: myatiy 96 ($100 in chips) 
Seat 6: bjonlyking ($99 in chips) 
Seat 7: matiko09 ($100 in chips) 
Seat 8: Vikulja1993 ($100 in chips) 
Seat 9: arctur17 ($100 in chips) 
bjonlyking: posts small blind $0.50
matiko09: posts big blind $1
*** HOLE CARDS ***
Dealt to matiko09 [6h 3h]
Vikulja1993: folds 
arctur17: folds 
Kukuryzka: folds 
Painkiller72: folds 
sanpidk: folds 
opsv: raises $1 to $2
myatiy 96: folds 
bjonlyking: raises $4 to $6
matiko09: folds 
opsv: folds 
Uncalled bet ($4) returned to bjonlyking
bjonlyking collected $5 from pot
*** SUMMARY ***
Total pot $5 | Rake $0 
Seat 1: Kukuryzka folded before Flop (didn't bet)
Seat 2: Painkiller72 folded before Flop (didn't bet)
Seat 3: sanpidk folded before Flop (didn't bet)
Seat 4: opsv folded before Flop
Seat 5: myatiy 96 (button) folded before Flop (didn't bet)
Seat 6: bjonlyking (small blind) collected ($5)
Seat 7: matiko09 (big blind) folded before Flop
Seat 8: Vikulja1993 folded before Flop (didn't bet)
Seat 9: arctur17 folded before Flop (didn't bet)





PokerStars Hand #152886938550:  Hold'em No Limit ($0.50/$1.00 USD) - 2016/05/05 17:00:02 CET [2016/05/05 11:00:02 ET]
Table 'Kraz II' 9-max Seat #7 is the button
Seat 1: HITYESCA ($141.30 in chips) 
Seat 2: sanpidk ($144.84 in chips) 
Seat 3: Khaine_CM ($100.98 in chips) 
Seat 4: CI58 ($100 in chips) 
Seat 5: Alex Frider ($100 in chips) 
Seat 6: andy84lfc ($125.16 in chips) 
Seat 7: maxxmeister ($131.65 in chips) 
Seat 8: 178013 ($200.82 in chips) 
Seat 9: matiko09 ($180.37 in chips) 
178013: posts small blind $0.50
matiko09: posts big blind $1
*** HOLE CARDS ***
Dealt to matiko09 [8h Td]
HITYESCA: folds 
sanpidk: folds 
Khaine_CM: folds 
CI58: folds 
Alex Frider: folds 
andy84lfc: raises $2 to $3
maxxmeister: raises $8 to $11
178013: folds 
matiko09: folds 
andy84lfc: calls $8
*** FLOP *** [3d Jc 5s]
andy84lfc: bets $11.16
maxxmeister: calls $11.16
*** TURN *** [3d Jc 5s] [Ts]
andy84lfc: bets $21.76
maxxmeister: raises $87.73 to $109.49 and is all-in
andy84lfc: calls $81.24 and is all-in
Uncalled bet ($6.49) returned to maxxmeister
*** RIVER *** [3d Jc 5s Ts] [5c]
*** SHOW DOWN ***
andy84lfc: shows [6s As] (a pair of Fives)
maxxmeister: shows [Ac Js] (two pair, Jacks and Fives)
maxxmeister collected $249.32 from pot
*** SUMMARY ***
Total pot $251.82 | Rake $2.50 
Board [3d Jc 5s Ts 5c]
Seat 1: HITYESCA folded before Flop (didn't bet)
Seat 2: sanpidk folded before Flop (didn't bet)
Seat 3: Khaine_CM folded before Flop (didn't bet)
Seat 4: CI58 folded before Flop (didn't bet)
Seat 5: Alex Frider folded before Flop (didn't bet)
Seat 6: andy84lfc showed [6s As] and lost with a pair of Fives
Seat 7: maxxmeister (button) showed [Ac Js] and won ($249.32) with two pair, Jacks and Fives
Seat 8: 178013 (small blind) folded before Flop
Seat 9: matiko09 (big blind) folded before Flop





PokerStars Hand #152886942589:  Hold'em No Limit ($1/$2 USD) - 2016/05/05 17:00:10 CET [2016/05/05 11:00:10 ET]
Table 'Tololo' 9-max Seat #6 is the button
Seat 1: Kukuryzka ($261.29 in chips) 
Seat 2: tepi_guy ($215.34 in chips) 
Seat 3: Khaine_CM ($200 in chips) 
Seat 5: matiko09 ($217.70 in chips) 
Seat 6: Vikulja1993 ($200 in chips) 
Seat 7: chaps1988 ($337.12 in chips) 
Seat 8: myatiy 96 ($200 in chips) 
Seat 9: Fitzyferret ($380.77 in chips) 
chaps1988: posts small blind $1
myatiy 96: posts big blind $2
mooose100: sits out 
*** HOLE CARDS ***
Dealt to matiko09 [2h 3c]
Fitzyferret: raises $3.24 to $5.24
Kukuryzka: folds 
tepi_guy: folds 
Khaine_CM: folds 
matiko09: folds 
Vikulja1993: folds 
chaps1988: folds 
myatiy 96: folds 
Uncalled bet ($3.24) returned to Fitzyferret
Fitzyferret collected $5 from pot
Fitzyferret: doesn't show hand 
*** SUMMARY ***
Total pot $5 | Rake $0 
Seat 1: Kukuryzka folded before Flop (didn't bet)
Seat 2: tepi_guy folded before Flop (didn't bet)
Seat 3: Khaine_CM folded before Flop (didn't bet)
Seat 5: matiko09 folded before Flop (didn't bet)
Seat 6: Vikulja1993 (button) folded before Flop (didn't bet)
Seat 7: chaps1988 (small blind) folded before Flop
Seat 8: myatiy 96 (big blind) folded before Flop
Seat 9: Fitzyferret collected ($5)





PokerStars Hand #152886949276:  Hold'em No Limit (€1/€2 EUR) - 2016/05/05 17:00:22 CET [2016/05/05 11:00:22 ET]
Table 'Skat II' 9-max Seat #1 is the button
Seat 1: Vikulja1993 (€200 in chips) 
Seat 2: Fitzyferret (€201 in chips) 
Seat 3: Alex Frider (€209.59 in chips) 
Seat 4: JoaquinMRuiz (€236.78 in chips) 
Seat 5: ceedonen (€216.73 in chips) 
Seat 6: drissmouzou (€251.47 in chips) 
Seat 7: PacPacBum (€224.50 in chips) 
Seat 9: matiko09 (€200 in chips) 
Fitzyferret: posts small blind €1
Alex Frider: posts big blind €2
Painkiller72: sits out 
*** HOLE CARDS ***
Dealt to matiko09 [2d 6d]
JoaquinMRuiz: folds 
ceedonen: folds 
drissmouzou: folds 
PacPacBum: folds 
matiko09: folds 
Vikulja1993: raises €2 to €4
Fitzyferret: folds 
Alex Frider: calls €2
*** FLOP *** [Th Tc 4s]
Alex Frider: checks 
Vikulja1993: bets €4
Alex Frider: folds 
Uncalled bet (€4) returned to Vikulja1993
Vikulja1993 collected €8.55 from pot
Vikulja1993: doesn't show hand 
*** SUMMARY ***
Total pot €9 | Rake €0.45 
Board [Th Tc 4s]
Seat 1: Vikulja1993 (button) collected (€8.55)
Seat 2: Fitzyferret (small blind) folded before Flop
Seat 3: Alex Frider (big blind) folded on the Flop
Seat 4: JoaquinMRuiz folded before Flop (didn't bet)
Seat 5: ceedonen folded before Flop (didn't bet)
Seat 6: drissmouzou folded before Flop (didn't bet)
Seat 7: PacPacBum folded before Flop (didn't bet)
Seat 9: matiko09 folded before Flop (didn't bet)





PokerStars Hand #152886950311:  Hold'em No Limit (€1/€2 EUR) - 2016/05/05 17:00:24 CET [2016/05/05 11:00:24 ET]
Table 'Bessel II' 9-max Seat #7 is the button
Seat 1: Soloaces224 (€214.28 in chips) 
Seat 2: Fitzyferret (€341.70 in chips) 
Seat 3: PacPacBum (€208.02 in chips) 
Seat 5: Kukuryzka (€209.40 in chips) 
Seat 7: matiko09 (€200 in chips) 
Seat 8: chaps1988 (€256.70 in chips) 
Seat 9: JoaquinMRuiz (€214.15 in chips) 
chaps1988: posts small blind €1
JoaquinMRuiz: posts big blind €2
Vikulja1993: sits out 
*** HOLE CARDS ***
Dealt to matiko09 [3s Qc]
Soloaces224: folds 
Fitzyferret: folds 
Vikulja1993 leaves the table
Alex Frider joins the table at seat #4 
PacPacBum: folds 
Kukuryzka: folds 
matiko09: folds 
chaps1988: raises €4 to €6
coinflip_si joins the table at seat #6 
JoaquinMRuiz: folds 
Uncalled bet (€4) returned to chaps1988
chaps1988 collected €4 from pot
*** SUMMARY ***
Total pot €4 | Rake €0 
Seat 1: Soloaces224 folded before Flop (didn't bet)
Seat 2: Fitzyferret folded before Flop (didn't bet)
Seat 3: PacPacBum folded before Flop (didn't bet)
Seat 5: Kukuryzka folded before Flop (didn't bet)
Seat 7: matiko09 (button) folded before Flop (didn't bet)
Seat 8: chaps1988 (small blind) collected (€4)
Seat 9: JoaquinMRuiz (big blind) folded before Flop





PokerStars Hand #152886951255:  Hold'em No Limit ($1/$2 USD) - 2016/05/05 17:00:26 CET [2016/05/05 11:00:26 ET]
Table 'Euporie II' 9-max Seat #2 is the button
Seat 1: PacPacBum ($200 in chips) 
Seat 2: kblkxls ($144.53 in chips) 
Seat 3: chaps1988 ($204 in chips) 
Seat 4: tepi_guy ($200 in chips) 
Seat 5: Nuskatko1986 ($121 in chips) 
Seat 6: Kukuryzka ($205.43 in chips) 
Seat 7: matiko09 ($204 in chips) 
Seat 9: myatiy 96 ($200 in chips) 
chaps1988: posts small blind $1
tepi_guy: posts big blind $2
Painkiller72: sits out 
*** HOLE CARDS ***
Dealt to matiko09 [4c Ks]
Nuskatko1986: calls $2
Kukuryzka: folds 
matiko09: folds 
myatiy 96: raises $7 to $9
PacPacBum: folds 
kblkxls: folds 
chaps1988: folds 
tepi_guy: folds 
Nuskatko1986: folds 
Uncalled bet ($7) returned to myatiy 96
myatiy 96 collected $7 from pot
myatiy 96: doesn't show hand 
*** SUMMARY ***
Total pot $7 | Rake $0 
Seat 1: PacPacBum folded before Flop (didn't bet)
Seat 2: kblkxls (button) folded before Flop (didn't bet)
Seat 3: chaps1988 (small blind) folded before Flop
Seat 4: tepi_guy (big blind) folded before Flop
Seat 5: Nuskatko1986 folded before Flop
Seat 6: Kukuryzka folded before Flop (didn't bet)
Seat 7: matiko09 folded before Flop (didn't bet)
Seat 9: myatiy 96 collected ($7)





PokerStars Hand #152886955504:  Hold'em No Limit ($1/$2 USD) - 2016/05/05 17:00:34 CET [2016/05/05 11:00:34 ET]
Table 'Tatry II' 9-max Seat #4 is the button
Seat 1: glanza_mike ($200.15 in chips) 
Seat 2: T0ny Adams ($79 in chips) 
Seat 3: matiko09 ($200 in chips) 
Seat 4: PacPacBum ($211.17 in chips) 
Seat 5: Painkiller72 ($289.75 in chips) 
Seat 6: Kukuryzka ($318.21 in chips) 
Seat 7: myatiy 96 ($200 in chips) 
Seat 8: chaps1988 ($255.54 in chips) 
Seat 9: korol702 ($213 in chips) 
Painkiller72: posts small blind $1
Kukuryzka: posts big blind $2
*** HOLE CARDS ***
Dealt to matiko09 [Ac 7d]
myatiy 96: folds 
chaps1988: folds 
korol702: calls $2
glanza_mike: folds 
T0ny Adams: folds 
matiko09: raises $6 to $8
PacPacBum: folds 
Painkiller72: folds 
Kukuryzka: raises $17 to $25
korol702: folds 
matiko09: folds 
Uncalled bet ($17) returned to Kukuryzka
Kukuryzka collected $19 from pot
Kukuryzka: doesn't show hand 
*** SUMMARY ***
Total pot $19 | Rake $0 
Seat 1: glanza_mike folded before Flop (didn't bet)
Seat 2: T0ny Adams folded before Flop (didn't bet)
Seat 3: matiko09 folded before Flop
Seat 4: PacPacBum (button) folded before Flop (didn't bet)
Seat 5: Painkiller72 (small blind) folded before Flop
Seat 6: Kukuryzka (big blind) collected ($19)
Seat 7: myatiy 96 folded before Flop (didn't bet)
Seat 8: chaps1988 folded before Flop (didn't bet)
Seat 9: korol702 folded before Flop





PokerStars Hand #152886957179:  Hold'em No Limit ($1/$2 USD) - 2016/05/05 17:00:37 CET [2016/05/05 11:00:37 ET]
Table 'Samitchell' 9-max Seat #6 is the button
Seat 1: CI58 ($200 in chips) 
Seat 2: matiko09 ($282.26 in chips) 
Seat 3: han3bj ($247.77 in chips) 
Seat 4: Fitzyferret ($497.88 in chips) 
Seat 5: chaps1988 ($200 in chips) 
Seat 6: PacPacBum ($200 in chips) 
Seat 7: patpaty ($138.11 in chips) 
Seat 8: tepi_guy ($214.08 in chips) 
Seat 9: kblkxls ($121.40 in chips) 
patpaty: posts small blind $1
tepi_guy: posts big blind $2
*** HOLE CARDS ***
Dealt to matiko09 [3d Qd]
kblkxls: calls $2
CI58: folds 
matiko09: folds 
han3bj: folds 
Fitzyferret: folds 
chaps1988: folds 
kblkxls said, "han3bj go to sleep son!"
PacPacBum: folds 
han3bj said, "whats ur problem?"
patpaty: calls $1
kblkxls said, "I hate australians"
tepi_guy: raises $5.40 to $7.40
kblkxls: calls $5.40
patpaty: calls $5.40
*** FLOP *** [9c 2s 9h]
han3bj said, "lol im just in aus"
patpaty: checks 
tepi_guy: checks 
kblkxls said, "Stop the boats!"
kblkxls: bets $7
patpaty: calls $7
kblkxls said, "nah im having a go mate."
han3bj said, "dont know what ur talking about"
tepi_guy: folds 
*** TURN *** [9c 2s 9h] [2h]
patpaty: checks 
kblkxls said, "im just being a chap son"
kblkxls: bets $13
patpaty: calls $13
*** RIVER *** [9c 2s 9h 2h] [2d]
patpaty: bets $22
kblkxls said, "you have A9 ?"
han3bj said, "i think u r just being idiot"
kblkxls said, "du hast a9"
kblkxls: folds 
Uncalled bet ($22) returned to patpaty
patpaty collected $59.45 from pot
patpaty: doesn't show hand 
*** SUMMARY ***
Total pot $62.20 | Rake $2.75 
Board [9c 2s 9h 2h 2d]
Seat 1: CI58 folded before Flop (didn't bet)
Seat 2: matiko09 folded before Flop (didn't bet)
Seat 3: han3bj folded before Flop (didn't bet)
Seat 4: Fitzyferret folded before Flop (didn't bet)
Seat 5: chaps1988 folded before Flop (didn't bet)
Seat 6: PacPacBum (button) folded before Flop (didn't bet)
Seat 7: patpaty (small blind) collected ($59.45)
Seat 8: tepi_guy (big blind) folded on the Flop
Seat 9: kblkxls folded on the River





PokerStars Hand #152886961762:  Hold'em No Limit ($1/$2 USD) - 2016/05/05 17:00:45 CET [2016/05/05 11:00:45 ET]
Table 'Tololo' 9-max Seat #7 is the button
Seat 1: Kukuryzka ($261.29 in chips) 
Seat 2: tepi_guy ($215.34 in chips) 
Seat 3: Khaine_CM ($200 in chips) 
Seat 5: matiko09 ($217.70 in chips) 
Seat 6: Vikulja1993 ($200 in chips) 
Seat 7: chaps1988 ($336.12 in chips) 
Seat 8: myatiy 96 ($200 in chips) 
Seat 9: Fitzyferret ($383.77 in chips) 
myatiy 96: posts small blind $1
Fitzyferret: posts big blind $2
mooose100: sits out 
*** HOLE CARDS ***
Dealt to matiko09 [4h 2c]
Kukuryzka: folds 
tepi_guy: raises $3.40 to $5.40
Khaine_CM: folds 
matiko09: folds 
Vikulja1993: folds 
chaps1988: folds 
myatiy 96: folds 
Fitzyferret: folds 
Uncalled bet ($3.40) returned to tepi_guy
tepi_guy collected $5 from pot
tepi_guy: doesn't show hand 
*** SUMMARY ***
Total pot $5 | Rake $0 
Seat 1: Kukuryzka folded before Flop (didn't bet)
Seat 2: tepi_guy collected ($5)
Seat 3: Khaine_CM folded before Flop (didn't bet)
Seat 5: matiko09 folded before Flop (didn't bet)
Seat 6: Vikulja1993 folded before Flop (didn't bet)
Seat 7: chaps1988 (button) folded before Flop (didn't bet)
Seat 8: myatiy 96 (small blind) folded before Flop
Seat 9: Fitzyferret (big blind) folded before Flop





PokerStars Hand #152886967355:  Hold'em No Limit ($0.50/$1.00 USD) - 2016/05/05 17:00:55 CET [2016/05/05 11:00:55 ET]
Table 'Siberia' 9-max Seat #6 is the button
Seat 1: Kukuryzka ($100 in chips) 
Seat 2: Painkiller72 ($100 in chips) 
Seat 3: sanpidk ($101.50 in chips) 
Seat 4: opsv ($68 in chips) 
Seat 5: myatiy 96 ($100 in chips) 
Seat 6: bjonlyking ($102 in chips) 
Seat 7: matiko09 ($100 in chips) 
Seat 8: Vikulja1993 ($100 in chips) 
Seat 9: arctur17 ($100 in chips) 
matiko09: posts small blind $0.50
Vikulja1993: posts big blind $1
*** HOLE CARDS ***
Dealt to matiko09 [7d Jd]
arctur17: folds 
Kukuryzka: folds 
Painkiller72: folds 
sanpidk: folds 
opsv: folds 
myatiy 96: folds 
bjonlyking: calls $1
matiko09: calls $0.50
Vikulja1993: raises $4 to $5
bjonlyking: calls $4
matiko09: folds 
*** FLOP *** [Qs 2d 3s]
Vikulja1993: bets $5
bjonlyking: raises $8 to $13
Vikulja1993: folds 
Uncalled bet ($8) returned to bjonlyking
bjonlyking collected $19.95 from pot
bjonlyking: doesn't show hand 
*** SUMMARY ***
Total pot $21 | Rake $1.05 
Board [Qs 2d 3s]
Seat 1: Kukuryzka folded before Flop (didn't bet)
Seat 2: Painkiller72 folded before Flop (didn't bet)
Seat 3: sanpidk folded before Flop (didn't bet)
Seat 4: opsv folded before Flop (didn't bet)
Seat 5: myatiy 96 folded before Flop (didn't bet)
Seat 6: bjonlyking (button) collected ($19.95)
Seat 7: matiko09 (small blind) folded before Flop
Seat 8: Vikulja1993 (big blind) folded on the Flop
Seat 9: arctur17 folded before Flop (didn't bet)





PokerStars Hand #152886970654:  Hold'em No Limit (€1/€2 EUR) - 2016/05/05 17:01:01 CET [2016/05/05 11:01:01 ET]
Table 'Bessel II' 9-max Seat #8 is the button
Seat 1: Soloaces224 (€214.28 in chips) 
Seat 2: Fitzyferret (€341.70 in chips) 
Seat 3: PacPacBum (€208.02 in chips) 
Seat 5: Kukuryzka (€209.40 in chips) 
Seat 7: matiko09 (€200 in chips) 
Seat 8: chaps1988 (€258.70 in chips) 
Seat 9: JoaquinMRuiz (€212.15 in chips) 
JoaquinMRuiz: posts small blind €1
Soloaces224: posts big blind €2
Alex Frider: sits out 
*** HOLE CARDS ***
Dealt to matiko09 [7d Th]
Fitzyferret: folds 
PacPacBum: folds 
Kukuryzka: folds 
matiko09: folds 
chaps1988: raises €2.50 to €4.50
JoaquinMRuiz: folds 
Soloaces224: folds 
Uncalled bet (€2.50) returned to chaps1988
chaps1988 collected €5 from pot
*** SUMMARY ***
Total pot €5 | Rake €0 
Seat 1: Soloaces224 (big blind) folded before Flop
Seat 2: Fitzyferret folded before Flop (didn't bet)
Seat 3: PacPacBum folded before Flop (didn't bet)
Seat 5: Kukuryzka folded before Flop (didn't bet)
Seat 7: matiko09 folded before Flop (didn't bet)
Seat 8: chaps1988 (button) collected (€5)
Seat 9: JoaquinMRuiz (small blind) folded before Flop





PokerStars Hand #152886978779:  Hold'em No Limit ($1/$2 USD) - 2016/05/05 17:01:14 CET [2016/05/05 11:01:14 ET]
Table 'Euporie II' 9-max Seat #3 is the button
Seat 1: PacPacBum ($200 in chips) 
Seat 2: kblkxls ($144.53 in chips) 
Seat 3: chaps1988 ($203 in chips) 
Seat 4: tepi_guy ($200 in chips) 
Seat 5: Nuskatko1986 ($119 in chips) 
Seat 6: Kukuryzka ($205.43 in chips) 
Seat 7: matiko09 ($204 in chips) 
Seat 9: myatiy 96 ($205 in chips) 
tepi_guy: posts small blind $1
Nuskatko1986: posts big blind $2
Painkiller72: sits out 
*** HOLE CARDS ***
Dealt to matiko09 [9d 8c]
Kukuryzka: folds 
matiko09: folds 
myatiy 96: folds 
PacPacBum: folds 
kblkxls: folds 
chaps1988: folds 
tepi_guy: folds 
Uncalled bet ($1) returned to Nuskatko1986
Nuskatko1986 collected $2 from pot
Nuskatko1986: doesn't show hand 
*** SUMMARY ***
Total pot $2 | Rake $0 
Seat 1: PacPacBum folded before Flop (didn't bet)
Seat 2: kblkxls folded before Flop (didn't bet)
Seat 3: chaps1988 (button) folded before Flop (didn't bet)
Seat 4: tepi_guy (small blind) folded before Flop
Seat 5: Nuskatko1986 (big blind) collected ($2)
Seat 6: Kukuryzka folded before Flop (didn't bet)
Seat 7: matiko09 folded before Flop (didn't bet)
Seat 9: myatiy 96 folded before Flop (didn't bet)





PokerStars Hand #152886979026:  Hold'em No Limit ($0.50/$1.00 USD) - 2016/05/05 17:01:15 CET [2016/05/05 11:01:15 ET]
Table 'Kraz II' 9-max Seat #8 is the button
Seat 1: HITYESCA ($141.30 in chips) 
Seat 2: sanpidk ($144.84 in chips) 
Seat 3: Khaine_CM ($100.98 in chips) 
Seat 4: CI58 ($100 in chips) 
Seat 5: Alex Frider ($100 in chips) 
Seat 7: maxxmeister ($255.81 in chips) 
Seat 8: 178013 ($200.32 in chips) 
Seat 9: matiko09 ($179.37 in chips) 
matiko09: posts small blind $0.50
HITYESCA: posts big blind $1
*** HOLE CARDS ***
Dealt to matiko09 [7s 9d]
sanpidk: folds 
sanpidk leaves the table
Vikulja1993 joins the table at seat #2 
Khaine_CM: folds 
CI58: folds 
Alex Frider: folds 
maxxmeister: folds 
178013: folds 
Vikulja1993 leaves the table
Hayer ana joins the table at seat #2 
matiko09: folds 
Uncalled bet ($0.50) returned to HITYESCA
HITYESCA collected $1 from pot
HITYESCA: doesn't show hand 
*** SUMMARY ***
Total pot $1 | Rake $0 
Seat 1: HITYESCA (big blind) collected ($1)
Seat 2: sanpidk folded before Flop (didn't bet)
Seat 3: Khaine_CM folded before Flop (didn't bet)
Seat 4: CI58 folded before Flop (didn't bet)
Seat 5: Alex Frider folded before Flop (didn't bet)
Seat 7: maxxmeister folded before Flop (didn't bet)
Seat 8: 178013 (button) folded before Flop (didn't bet)
Seat 9: matiko09 (small blind) folded before Flop





PokerStars Hand #152886983077:  Hold'em No Limit ($1/$2 USD) - 2016/05/05 17:01:22 CET [2016/05/05 11:01:22 ET]
Table 'Tololo' 9-max Seat #8 is the button
Seat 1: Kukuryzka ($261.29 in chips) 
Seat 2: tepi_guy ($218.34 in chips) 
Seat 3: Khaine_CM ($200 in chips) 
Seat 5: matiko09 ($217.70 in chips) 
Seat 6: Vikulja1993 ($200 in chips) 
Seat 7: chaps1988 ($336.12 in chips) 
Seat 8: myatiy 96 ($200 in chips) 
Seat 9: Fitzyferret ($381.77 in chips) 
Fitzyferret: posts small blind $1
Kukuryzka: posts big blind $2
mooose100: sits out 
*** HOLE CARDS ***
Dealt to matiko09 [Jh Qd]
tepi_guy: folds 
Khaine_CM: folds 
matiko09: folds 
Vikulja1993: raises $4 to $6
chaps1988: folds 
myatiy 96: folds 
Fitzyferret: folds 
Kukuryzka: folds 
Uncalled bet ($4) returned to Vikulja1993
Vikulja1993 collected $5 from pot
Vikulja1993: doesn't show hand 
*** SUMMARY ***
Total pot $5 | Rake $0 
Seat 1: Kukuryzka (big blind) folded before Flop
Seat 2: tepi_guy folded before Flop (didn't bet)
Seat 3: Khaine_CM folded before Flop (didn't bet)
Seat 5: matiko09 folded before Flop (didn't bet)
Seat 6: Vikulja1993 collected ($5)
Seat 7: chaps1988 folded before Flop (didn't bet)
Seat 8: myatiy 96 (button) folded before Flop (didn't bet)
Seat 9: Fitzyferret (small blind) folded before Flop





PokerStars Hand #152886990546:  Hold'em No Limit ($1/$2 USD) - 2016/05/05 17:01:34 CET [2016/05/05 11:01:34 ET]
Table 'Euporie II' 9-max Seat #4 is the button
Seat 1: PacPacBum ($200 in chips) 
Seat 2: kblkxls ($144.53 in chips) 
Seat 3: chaps1988 ($203 in chips) 
Seat 4: tepi_guy ($200 in chips) 
Seat 5: Nuskatko1986 ($120 in chips) 
Seat 6: Kukuryzka ($205.43 in chips) 
Seat 7: matiko09 ($204 in chips) 
Seat 9: myatiy 96 ($205 in chips) 
Nuskatko1986: posts small blind $1
Kukuryzka: posts big blind $2
Painkiller72: sits out 
*** HOLE CARDS ***
Dealt to matiko09 [7h 8d]
matiko09: folds 
myatiy 96: folds 
PacPacBum: folds 
kblkxls: folds 
chaps1988: folds 
tepi_guy: folds 
Nuskatko1986: folds 
Uncalled bet ($1) returned to Kukuryzka
Kukuryzka collected $2 from pot
Kukuryzka: doesn't show hand 
*** SUMMARY ***
Total pot $2 | Rake $0 
Seat 1: PacPacBum folded before Flop (didn't bet)
Seat 2: kblkxls folded before Flop (didn't bet)
Seat 3: chaps1988 folded before Flop (didn't bet)
Seat 4: tepi_guy (button) folded before Flop (didn't bet)
Seat 5: Nuskatko1986 (small blind) folded before Flop
Seat 6: Kukuryzka (big blind) collected ($2)
Seat 7: matiko09 folded before Flop (didn't bet)
Seat 9: myatiy 96 folded before Flop (didn't bet)





PokerStars Hand #152886990987:  Hold'em No Limit ($1/$2 USD) - 2016/05/05 17:01:35 CET [2016/05/05 11:01:35 ET]
Table 'Tatry II' 9-max Seat #5 is the button
Seat 1: glanza_mike ($200.15 in chips) 
Seat 2: T0ny Adams ($79 in chips) 
Seat 3: matiko09 ($200 in chips) 
Seat 4: PacPacBum ($211.17 in chips) 
Seat 5: Painkiller72 ($288.75 in chips) 
Seat 6: Kukuryzka ($329.21 in chips) 
Seat 7: myatiy 96 ($200 in chips) 
Seat 8: chaps1988 ($255.54 in chips) 
Seat 9: korol702 ($211 in chips) 
Kukuryzka: posts small blind $1
myatiy 96: posts big blind $2
*** HOLE CARDS ***
Dealt to matiko09 [8d Qh]
chaps1988: folds 
korol702: folds 
glanza_mike: folds 
T0ny Adams: folds 
matiko09: folds 
PacPacBum: raises $2.08 to $4.08
Painkiller72: folds 
Kukuryzka: folds 
myatiy 96: calls $2.08
*** FLOP *** [7s Js 2s]
myatiy 96: checks 
PacPacBum: bets $4.69
myatiy 96: folds 
Uncalled bet ($4.69) returned to PacPacBum
PacPacBum collected $8.70 from pot
PacPacBum: doesn't show hand 
*** SUMMARY ***
Total pot $9.16 | Rake $0.46 
Board [7s Js 2s]
Seat 1: glanza_mike folded before Flop (didn't bet)
Seat 2: T0ny Adams folded before Flop (didn't bet)
Seat 3: matiko09 folded before Flop (didn't bet)
Seat 4: PacPacBum collected ($8.70)
Seat 5: Painkiller72 (button) folded before Flop (didn't bet)
Seat 6: Kukuryzka (small blind) folded before Flop
Seat 7: myatiy 96 (big blind) folded on the Flop
Seat 8: chaps1988 folded before Flop (didn't bet)
Seat 9: korol702 folded before Flop (didn't bet)





PokerStars Hand #152886991569:  Hold'em No Limit (€1/€2 EUR) - 2016/05/05 17:01:36 CET [2016/05/05 11:01:36 ET]
Table 'Skat II' 9-max Seat #2 is the button
Seat 1: Vikulja1993 (€204.55 in chips) 
Seat 2: Fitzyferret (€200 in chips) 
Seat 3: Alex Frider (€205.59 in chips) 
Seat 4: JoaquinMRuiz (€236.78 in chips) 
Seat 5: ceedonen (€216.73 in chips) 
Seat 6: drissmouzou (€251.47 in chips) 
Seat 7: PacPacBum (€224.50 in chips) 
Seat 9: matiko09 (€200 in chips) 
Alex Frider: posts small blind €1
JoaquinMRuiz: posts big blind €2
Painkiller72: sits out 
*** HOLE CARDS ***
Dealt to matiko09 [5d 8d]
ceedonen: raises €4 to €6
drissmouzou: folds 
PacPacBum: folds 
matiko09: folds 
Vikulja1993: folds 
Fitzyferret: folds 
Alex Frider: folds 
JoaquinMRuiz: folds 
Uncalled bet (€4) returned to ceedonen
ceedonen collected €5 from pot
*** SUMMARY ***
Total pot €5 | Rake €0 
Seat 1: Vikulja1993 folded before Flop (didn't bet)
Seat 2: Fitzyferret (button) folded before Flop (didn't bet)
Seat 3: Alex Frider (small blind) folded before Flop
Seat 4: JoaquinMRuiz (big blind) folded before Flop
Seat 5: ceedonen collected (€5)
Seat 6: drissmouzou folded before Flop (didn't bet)
Seat 7: PacPacBum folded before Flop (didn't bet)
Seat 9: matiko09 folded before Flop (didn't bet)





PokerStars Hand #152886998426:  Hold'em No Limit (€1/€2 EUR) - 2016/05/05 17:01:47 CET [2016/05/05 11:01:47 ET]
Table 'Bessel II' 9-max Seat #9 is the button
Seat 1: Soloaces224 (€212.28 in chips) 
Seat 2: Fitzyferret (€341.70 in chips) 
Seat 3: PacPacBum (€208.02 in chips) 
Seat 5: Kukuryzka (€209.40 in chips) 
Seat 7: matiko09 (€200 in chips) 
Seat 8: chaps1988 (€261.70 in chips) 
Seat 9: JoaquinMRuiz (€211.15 in chips) 
Soloaces224: posts small blind €1
Fitzyferret: posts big blind €2
Alex Frider: sits out 
*** HOLE CARDS ***
Dealt to matiko09 [8c Qd]
PacPacBum: folds 
Kukuryzka: folds 
matiko09: folds 
chaps1988: folds 
JoaquinMRuiz: folds 
Soloaces224: folds 
Uncalled bet (€1) returned to Fitzyferret
Fitzyferret collected €2 from pot
Fitzyferret: doesn't show hand 
*** SUMMARY ***
Total pot €2 | Rake €0 
Seat 1: Soloaces224 (small blind) folded before Flop
Seat 2: Fitzyferret (big blind) collected (€2)
Seat 3: PacPacBum folded before Flop (didn't bet)
Seat 5: Kukuryzka folded before Flop (didn't bet)
Seat 7: matiko09 folded before Flop (didn't bet)
Seat 8: chaps1988 folded before Flop (didn't bet)
Seat 9: JoaquinMRuiz (button) folded before Flop (didn't bet)





PokerStars Hand #152886999386:  Hold'em No Limit ($0.50/$1.00 USD) - 2016/05/05 17:01:49 CET [2016/05/05 11:01:49 ET]
Table 'Kraz II' 9-max Seat #9 is the button
Seat 1: HITYESCA ($141.80 in chips) 
Seat 2: Hayer ana ($100 in chips) 
Seat 3: Khaine_CM ($100.98 in chips) 
Seat 4: CI58 ($100 in chips) 
Seat 5: Alex Frider ($100 in chips) 
Seat 7: maxxmeister ($255.81 in chips) 
Seat 8: 178013 ($200.32 in chips) 
Seat 9: matiko09 ($178.87 in chips) 
HITYESCA: posts small blind $0.50
Hayer ana: posts big blind $1
*** HOLE CARDS ***
Dealt to matiko09 [9s 3c]
Khaine_CM: folds 
CI58: folds 
Alex Frider: raises $2 to $3
maxxmeister: folds 
178013: raises $7.50 to $10.50
matiko09: folds 
HITYESCA: folds 
Hayer ana: folds 
Alex Frider: calls $7.50
*** FLOP *** [6d Ks 7s]
Alex Frider: checks 
178013: bets $14
Alex Frider: raises $20 to $34
178013: folds 
Uncalled bet ($20) returned to Alex Frider
Alex Frider collected $48 from pot
Alex Frider: doesn't show hand 
*** SUMMARY ***
Total pot $50.50 | Rake $2.50 
Board [6d Ks 7s]
Seat 1: HITYESCA (small blind) folded before Flop
Seat 2: Hayer ana (big blind) folded before Flop
Seat 3: Khaine_CM folded before Flop (didn't bet)
Seat 4: CI58 folded before Flop (didn't bet)
Seat 5: Alex Frider collected ($48)
Seat 7: maxxmeister folded before Flop (didn't bet)
Seat 8: 178013 folded on the Flop
Seat 9: matiko09 (button) folded before Flop (didn't bet)





PokerStars Hand #152887001924:  Hold'em No Limit ($1/$2 USD) - 2016/05/05 17:01:53 CET [2016/05/05 11:01:53 ET]
Table 'Euporie II' 9-max Seat #5 is the button
Seat 1: PacPacBum ($200 in chips) 
Seat 2: kblkxls ($144.53 in chips) 
Seat 3: chaps1988 ($203 in chips) 
Seat 4: tepi_guy ($200 in chips) 
Seat 5: Nuskatko1986 ($119 in chips) 
Seat 6: Kukuryzka ($206.43 in chips) 
Seat 7: matiko09 ($204 in chips) 
Seat 9: myatiy 96 ($205 in chips) 
Kukuryzka: posts small blind $1
matiko09: posts big blind $2
Painkiller72: sits out 
*** HOLE CARDS ***
Dealt to matiko09 [4s Kc]
myatiy 96: folds 
PacPacBum: folds 
kblkxls: folds 
chaps1988: folds 
tepi_guy: folds 
Nuskatko1986: calls $2
Kukuryzka: folds 
matiko09: checks 
*** FLOP *** [3c Td Ts]
matiko09: checks 
Nuskatko1986: checks 
*** TURN *** [3c Td Ts] [6s]
matiko09: checks 
Nuskatko1986: bets $2
matiko09: folds 
Uncalled bet ($2) returned to Nuskatko1986
Nuskatko1986 collected $4.75 from pot
Nuskatko1986: doesn't show hand 
*** SUMMARY ***
Total pot $5 | Rake $0.25 
Board [3c Td Ts 6s]
Seat 1: PacPacBum folded before Flop (didn't bet)
Seat 2: kblkxls folded before Flop (didn't bet)
Seat 3: chaps1988 folded before Flop (didn't bet)
Seat 4: tepi_guy folded before Flop (didn't bet)
Seat 5: Nuskatko1986 (button) collected ($4.75)
Seat 6: Kukuryzka (small blind) folded before Flop
Seat 7: matiko09 (big blind) folded on the Turn
Seat 9: myatiy 96 folded before Flop (didn't bet)





PokerStars Hand #152887009472:  Hold'em No Limit ($0.50/$1.00 USD) - 2016/05/05 17:02:05 CET [2016/05/05 11:02:05 ET]
Table 'Siberia' 9-max Seat #7 is the button
Seat 1: Kukuryzka ($100 in chips) 
Seat 2: Painkiller72 ($100 in chips) 
Seat 3: sanpidk ($101.50 in chips) 
Seat 4: opsv ($68 in chips) 
Seat 5: myatiy 96 ($100 in chips) 
Seat 6: bjonlyking ($111.95 in chips) 
Seat 7: matiko09 ($100 in chips) 
Seat 8: Vikulja1993 ($100 in chips) 
Seat 9: arctur17 ($100 in chips) 
Vikulja1993: posts small blind $0.50
arctur17: posts big blind $1
*** HOLE CARDS ***
Dealt to matiko09 [9d 8s]
Kukuryzka: folds 
Painkiller72: folds 
sanpidk: folds 
opsv: folds 
myatiy 96: raises $2 to $3
bjonlyking: folds 
matiko09: folds 
Vikulja1993: folds 
arctur17: folds 
Uncalled bet ($2) returned to myatiy 96
myatiy 96 collected $2.50 from pot
myatiy 96: doesn't show hand 
*** SUMMARY ***
Total pot $2.50 | Rake $0 
Seat 1: Kukuryzka folded before Flop (didn't bet)
Seat 2: Painkiller72 folded before Flop (didn't bet)
Seat 3: sanpidk folded before Flop (didn't bet)
Seat 4: opsv folded before Flop (didn't bet)
Seat 5: myatiy 96 collected ($2.50)
Seat 6: bjonlyking folded before Flop (didn't bet)
Seat 7: matiko09 (button) folded before Flop (didn't bet)
Seat 8: Vikulja1993 (small blind) folded before Flop
Seat 9: arctur17 (big blind) folded before Flop





PokerStars Hand #152887011041:  Hold'em No Limit ($1/$2 USD) - 2016/05/05 17:02:08 CET [2016/05/05 11:02:08 ET]
Table 'Tololo' 9-max Seat #9 is the button
Seat 1: Kukuryzka ($259.29 in chips) 
Seat 2: tepi_guy ($218.34 in chips) 
Seat 3: Khaine_CM ($200 in chips) 
Seat 5: matiko09 ($217.70 in chips) 
Seat 6: Vikulja1993 ($203 in chips) 
Seat 7: chaps1988 ($336.12 in chips) 
Seat 8: myatiy 96 ($200 in chips) 
Seat 9: Fitzyferret ($380.77 in chips) 
Kukuryzka: posts small blind $1
tepi_guy: posts big blind $2
mooose100: sits out 
*** HOLE CARDS ***
Dealt to matiko09 [Ts 4d]
Khaine_CM: folds 
matiko09: folds 
Vikulja1993: folds 
chaps1988: folds 
myatiy 96: raises $3.70 to $5.70
Fitzyferret: folds 
Kukuryzka: folds 
tepi_guy: folds 
Uncalled bet ($3.70) returned to myatiy 96
myatiy 96 collected $5 from pot
myatiy 96: doesn't show hand 
*** SUMMARY ***
Total pot $5 | Rake $0 
Seat 1: Kukuryzka (small blind) folded before Flop
Seat 2: tepi_guy (big blind) folded before Flop
Seat 3: Khaine_CM folded before Flop (didn't bet)
Seat 5: matiko09 folded before Flop (didn't bet)
Seat 6: Vikulja1993 folded before Flop (didn't bet)
Seat 7: chaps1988 folded before Flop (didn't bet)
Seat 8: myatiy 96 collected ($5)
Seat 9: Fitzyferret (button) folded before Flop (didn't bet)





PokerStars Hand #152887014900:  Hold'em No Limit (€1/€2 EUR) - 2016/05/05 17:02:14 CET [2016/05/05 11:02:14 ET]
Table 'Bessel II' 9-max Seat #1 is the button
Seat 1: Soloaces224 (€211.28 in chips) 
Seat 2: Fitzyferret (€342.70 in chips) 
Seat 3: PacPacBum (€208.02 in chips) 
Seat 5: Kukuryzka (€209.40 in chips) 
Seat 7: matiko09 (€200 in chips) 
Seat 8: chaps1988 (€261.70 in chips) 
Seat 9: JoaquinMRuiz (€211.15 in chips) 
Fitzyferret: posts small blind €1
PacPacBum: posts big blind €2
Alex Frider: sits out 
*** HOLE CARDS ***
Dealt to matiko09 [7s 5h]
Kukuryzka: raises €4 to €6
matiko09: folds 
chaps1988: folds 
JoaquinMRuiz: folds 
Soloaces224: folds 
Fitzyferret: folds 
PacPacBum: folds 
Uncalled bet (€4) returned to Kukuryzka
Kukuryzka collected €5 from pot
Kukuryzka: doesn't show hand 
*** SUMMARY ***
Total pot €5 | Rake €0 
Seat 1: Soloaces224 (button) folded before Flop (didn't bet)
Seat 2: Fitzyferret (small blind) folded before Flop
Seat 3: PacPacBum (big blind) folded before Flop
Seat 5: Kukuryzka collected (€5)
Seat 7: matiko09 folded before Flop (didn't bet)
Seat 8: chaps1988 folded before Flop (didn't bet)
Seat 9: JoaquinMRuiz folded before Flop (didn't bet)





PokerStars Hand #152887021050:  Hold'em No Limit (€1/€2 EUR) - 2016/05/05 17:02:24 CET [2016/05/05 11:02:24 ET]
Table 'Skat II' 9-max Seat #3 is the button
Seat 1: Vikulja1993 (€204.55 in chips) 
Seat 2: Fitzyferret (€200 in chips) 
Seat 3: Alex Frider (€204.59 in chips) 
Seat 4: JoaquinMRuiz (€234.78 in chips) 
Seat 5: ceedonen (€219.73 in chips) 
Seat 6: drissmouzou (€251.47 in chips) 
Seat 7: PacPacBum (€224.50 in chips) 
Seat 9: matiko09 (€200 in chips) 
JoaquinMRuiz: posts small blind €1
ceedonen: posts big blind €2
Painkiller72: sits out 
*** HOLE CARDS ***
Dealt to matiko09 [6h Kc]
drissmouzou: folds 
PacPacBum: folds 
matiko09: folds 
Vikulja1993: folds 
Fitzyferret: raises €2.60 to €4.60
Alex Frider: folds 
JoaquinMRuiz: raises €11.61 to €16.21
ceedonen: folds 
Fitzyferret: calls €11.61
*** FLOP *** [8s 8c 9d]
JoaquinMRuiz: bets €11.44
Fitzyferret: raises €21.56 to €33
JoaquinMRuiz: calls €21.56
*** TURN *** [8s 8c 9d] [Ac]
JoaquinMRuiz: checks 
Fitzyferret: bets €40
JoaquinMRuiz: calls €40
*** RIVER *** [8s 8c 9d Ac] [9s]
JoaquinMRuiz: checks 
Fitzyferret: checks 
*** SHOW DOWN ***
JoaquinMRuiz: shows [Qh Qd] (two pair, Queens and Nines)
Fitzyferret: shows [8d 7d] (a full house, Eights full of Nines)
Fitzyferret collected €177.92 from pot
*** SUMMARY ***
Total pot €180.42 | Rake €2.50 
Board [8s 8c 9d Ac 9s]
Seat 1: Vikulja1993 folded before Flop (didn't bet)
Seat 2: Fitzyferret showed [8d 7d] and won (€177.92) with a full house, Eights full of Nines
Seat 3: Alex Frider (button) folded before Flop (didn't bet)
Seat 4: JoaquinMRuiz (small blind) showed [Qh Qd] and lost with two pair, Queens and Nines
Seat 5: ceedonen (big blind) folded before Flop
Seat 6: drissmouzou folded before Flop (didn't bet)
Seat 7: PacPacBum folded before Flop (didn't bet)
Seat 9: matiko09 folded before Flop (didn't bet)





PokerStars Hand #152887027035:  Hold'em No Limit ($1/$2 USD) - 2016/05/05 17:02:34 CET [2016/05/05 11:02:34 ET]
Table 'Tatry II' 9-max Seat #6 is the button
Seat 1: glanza_mike ($200.15 in chips) 
Seat 2: T0ny Adams ($79 in chips) 
Seat 3: matiko09 ($200 in chips) 
Seat 4: PacPacBum ($215.79 in chips) 
Seat 5: Painkiller72 ($288.75 in chips) 
Seat 6: Kukuryzka ($328.21 in chips) 
Seat 7: myatiy 96 ($200 in chips) 
Seat 8: chaps1988 ($255.54 in chips) 
Seat 9: korol702 ($211 in chips) 
myatiy 96: posts small blind $1
chaps1988: posts big blind $2
*** HOLE CARDS ***
Dealt to matiko09 [3c 6s]
korol702: folds 
glanza_mike: folds 
T0ny Adams: folds 
matiko09: folds 
PacPacBum: folds 
Painkiller72: folds 
Kukuryzka: folds 
myatiy 96: raises $4 to $6
chaps1988: folds 
Uncalled bet ($4) returned to myatiy 96
myatiy 96 collected $4 from pot
myatiy 96: doesn't show hand 
*** SUMMARY ***
Total pot $4 | Rake $0 
Seat 1: glanza_mike folded before Flop (didn't bet)
Seat 2: T0ny Adams folded before Flop (didn't bet)
Seat 3: matiko09 folded before Flop (didn't bet)
Seat 4: PacPacBum folded before Flop (didn't bet)
Seat 5: Painkiller72 folded before Flop (didn't bet)
Seat 6: Kukuryzka (button) folded before Flop (didn't bet)
Seat 7: myatiy 96 (small blind) collected ($4)
Seat 8: chaps1988 (big blind) folded before Flop
Seat 9: korol702 folded before Flop (didn't bet)





PokerStars Hand #152887028008:  Hold'em No Limit ($1/$2 USD) - 2016/05/05 17:02:36 CET [2016/05/05 11:02:36 ET]
Table 'Tololo' 9-max Seat #1 is the button
Seat 1: Kukuryzka ($258.29 in chips) 
Seat 2: tepi_guy ($216.34 in chips) 
Seat 3: Khaine_CM ($200 in chips) 
Seat 5: matiko09 ($217.70 in chips) 
Seat 6: Vikulja1993 ($203 in chips) 
Seat 7: chaps1988 ($336.12 in chips) 
Seat 8: myatiy 96 ($203 in chips) 
Seat 9: Fitzyferret ($380.77 in chips) 
tepi_guy: posts small blind $1
Khaine_CM: posts big blind $2
mooose100: sits out 
*** HOLE CARDS ***
Dealt to matiko09 [Jd 2h]
matiko09: folds 
Vikulja1993: folds 
chaps1988: folds 
myatiy 96: folds 
Fitzyferret: folds 
Kukuryzka: raises $2 to $4
tepi_guy: raises $10 to $14
Khaine_CM: folds 
Kukuryzka: folds 
Uncalled bet ($10) returned to tepi_guy
tepi_guy collected $10 from pot
tepi_guy: doesn't show hand 
*** SUMMARY ***
Total pot $10 | Rake $0 
Seat 1: Kukuryzka (button) folded before Flop
Seat 2: tepi_guy (small blind) collected ($10)
Seat 3: Khaine_CM (big blind) folded before Flop
Seat 5: matiko09 folded before Flop (didn't bet)
Seat 6: Vikulja1993 folded before Flop (didn't bet)
Seat 7: chaps1988 folded before Flop (didn't bet)
Seat 8: myatiy 96 folded before Flop (didn't bet)
Seat 9: Fitzyferret folded before Flop (didn't bet)





PokerStars Hand #152887030397:  Hold'em No Limit ($0.50/$1.00 USD) - 2016/05/05 17:02:40 CET [2016/05/05 11:02:40 ET]
Table 'Siberia' 9-max Seat #8 is the button
Seat 2: Painkiller72 ($100 in chips) 
Seat 3: sanpidk ($101.50 in chips) 
Seat 4: opsv ($68 in chips) 
Seat 5: myatiy 96 ($101.50 in chips) 
Seat 6: bjonlyking ($111.95 in chips) 
Seat 7: matiko09 ($100 in chips) 
Seat 8: Vikulja1993 ($100 in chips) 
Seat 9: arctur17 ($99 in chips) 
arctur17: posts small blind $0.50
Kukuryzka: is sitting out 
Painkiller72: posts big blind $1
*** HOLE CARDS ***
Dealt to matiko09 [9h 6s]
Kukuryzka leaves the table
sanpidk: folds 
opsv: raises $1 to $2
myatiy 96: folds 
Lycaon23 joins the table at seat #1 
bjonlyking: folds 
matiko09: folds 
Vikulja1993: calls $2
arctur17: calls $1.50
Painkiller72: folds 
*** FLOP *** [9c Ad Qc]
arctur17: checks 
opsv: bets $5
Vikulja1993: calls $5
arctur17: calls $5
*** TURN *** [9c Ad Qc] [6d]
arctur17: checks 
opsv: checks 
Vikulja1993: checks 
*** RIVER *** [9c Ad Qc 6d] [Ts]
arctur17: bets $12
opsv: folds 
Vikulja1993: folds 
Uncalled bet ($12) returned to arctur17
arctur17 collected $20.90 from pot
arctur17: doesn't show hand 
*** SUMMARY ***
Total pot $22 | Rake $1.10 
Board [9c Ad Qc 6d Ts]
Seat 2: Painkiller72 (big blind) folded before Flop
Seat 3: sanpidk folded before Flop (didn't bet)
Seat 4: opsv folded on the River
Seat 5: myatiy 96 folded before Flop (didn't bet)
Seat 6: bjonlyking folded before Flop (didn't bet)
Seat 7: matiko09 folded before Flop (didn't bet)
Seat 8: Vikulja1993 (button) folded on the River
Seat 9: arctur17 (small blind) collected ($20.90)





PokerStars Hand #152887035376:  Hold'em No Limit (€1/€2 EUR) - 2016/05/05 17:02:48 CET [2016/05/05 11:02:48 ET]
Table 'Bessel II' 9-max Seat #2 is the button
Seat 1: Soloaces224 (€211.28 in chips) 
Seat 2: Fitzyferret (€341.70 in chips) 
Seat 3: PacPacBum (€206.02 in chips) 
Seat 4: Alex Frider (€200 in chips) 
Seat 5: Kukuryzka (€212.40 in chips) 
Seat 7: matiko09 (€200 in chips) 
Seat 8: chaps1988 (€261.70 in chips) 
Seat 9: JoaquinMRuiz (€211.15 in chips) 
PacPacBum: posts small blind €1
Alex Frider: posts big blind €2
*** HOLE CARDS ***
Dealt to matiko09 [6d 2h]
Kukuryzka: folds 
matiko09: folds 
chaps1988: folds 
JoaquinMRuiz: folds 
Soloaces224: folds 
Fitzyferret: folds 
PacPacBum: raises €3 to €5
Alex Frider: folds 
Uncalled bet (€3) returned to PacPacBum
PacPacBum collected €4 from pot
PacPacBum: doesn't show hand 
*** SUMMARY ***
Total pot €4 | Rake €0 
Seat 1: Soloaces224 folded before Flop (didn't bet)
Seat 2: Fitzyferret (button) folded before Flop (didn't bet)
Seat 3: PacPacBum (small blind) collected (€4)
Seat 4: Alex Frider (big blind) folded before Flop
Seat 5: Kukuryzka folded before Flop (didn't bet)
Seat 7: matiko09 folded before Flop (didn't bet)
Seat 8: chaps1988 folded before Flop (didn't bet)
Seat 9: JoaquinMRuiz folded before Flop (didn't bet)





PokerStars Hand #152887037684:  Hold'em No Limit ($1/$2 USD) - 2016/05/05 17:02:51 CET [2016/05/05 11:02:51 ET]
Table 'Euporie II' 9-max Seat #6 is the button
Seat 1: PacPacBum ($200 in chips) 
Seat 2: kblkxls ($144.53 in chips) 
Seat 3: chaps1988 ($203 in chips) 
Seat 4: tepi_guy ($200 in chips) 
Seat 5: Nuskatko1986 ($121.75 in chips) 
Seat 6: Kukuryzka ($205.43 in chips) 
Seat 7: matiko09 ($202 in chips) 
Seat 8: Painkiller72 ($281.25 in chips) 
Seat 9: myatiy 96 ($205 in chips) 
matiko09: posts small blind $1
Painkiller72: posts big blind $2
*** HOLE CARDS ***
Dealt to matiko09 [9d Ks]
myatiy 96: folds 
PacPacBum: folds 
kblkxls: folds 
chaps1988: folds 
tepi_guy: folds 
Nuskatko1986: folds 
Kukuryzka: folds 
matiko09: raises $3 to $5
Painkiller72: calls $3
*** FLOP *** [4c 9h Td]
matiko09: checks 
Painkiller72: bets $6.65
matiko09: calls $6.65
*** TURN *** [4c 9h Td] [Qc]
matiko09: checks 
Painkiller72: checks 
*** RIVER *** [4c 9h Td Qc] [3h]
matiko09: checks 
Painkiller72: bets $15.49
matiko09: calls $15.49
*** SHOW DOWN ***
Painkiller72: shows [Kh Tc] (a pair of Tens)
matiko09: mucks hand 
Painkiller72 collected $51.57 from pot
*** SUMMARY ***
Total pot $54.28 | Rake $2.71 
Board [4c 9h Td Qc 3h]
Seat 1: PacPacBum folded before Flop (didn't bet)
Seat 2: kblkxls folded before Flop (didn't bet)
Seat 3: chaps1988 folded before Flop (didn't bet)
Seat 4: tepi_guy folded before Flop (didn't bet)
Seat 5: Nuskatko1986 folded before Flop (didn't bet)
Seat 6: Kukuryzka (button) folded before Flop (didn't bet)
Seat 7: matiko09 (small blind) mucked [9d Ks]
Seat 8: Painkiller72 (big blind) showed [Kh Tc] and won ($51.57) with a pair of Tens
Seat 9: myatiy 96 folded before Flop (didn't bet)





PokerStars Hand #152887047098:  Hold'em No Limit ($1/$2 USD) - 2016/05/05 17:03:06 CET [2016/05/05 11:03:06 ET]
Table 'Tololo' 9-max Seat #2 is the button
Seat 1: Kukuryzka ($254.29 in chips) 
Seat 2: tepi_guy ($222.34 in chips) 
Seat 3: Khaine_CM ($200 in chips) 
Seat 4: mooose100 ($226.22 in chips) 
Seat 5: matiko09 ($217.70 in chips) 
Seat 6: Vikulja1993 ($203 in chips) 
Seat 7: chaps1988 ($336.12 in chips) 
Seat 8: myatiy 96 ($203 in chips) 
Seat 9: Fitzyferret ($380.77 in chips) 
Khaine_CM: posts small blind $1
mooose100: posts big blind $2
*** HOLE CARDS ***
Dealt to matiko09 [Th 7d]
matiko09: folds 
Vikulja1993: folds 
chaps1988: folds 
myatiy 96: folds 
Fitzyferret: raises $2.60 to $4.60
Kukuryzka: folds 
tepi_guy: folds 
Khaine_CM: folds 
mooose100: folds 
Uncalled bet ($2.60) returned to Fitzyferret
Fitzyferret collected $5 from pot
Fitzyferret: doesn't show hand 
*** SUMMARY ***
Total pot $5 | Rake $0 
Seat 1: Kukuryzka folded before Flop (didn't bet)
Seat 2: tepi_guy (button) folded before Flop (didn't bet)
Seat 3: Khaine_CM (small blind) folded before Flop
Seat 4: mooose100 (big blind) folded before Flop
Seat 5: matiko09 folded before Flop (didn't bet)
Seat 6: Vikulja1993 folded before Flop (didn't bet)
Seat 7: chaps1988 folded before Flop (didn't bet)
Seat 8: myatiy 96 folded before Flop (didn't bet)
Seat 9: Fitzyferret collected ($5)





PokerStars Hand #152887053645:  Hold'em No Limit ($0.50/$1.00 USD) - 2016/05/05 17:03:17 CET [2016/05/05 11:03:17 ET]
Table 'Kraz II' 9-max Seat #1 is the button
Seat 1: HITYESCA ($141.30 in chips) 
Seat 2: Hayer ana ($99 in chips) 
Seat 3: Khaine_CM ($100.98 in chips) 
Seat 4: CI58 ($100 in chips) 
Seat 5: Alex Frider ($123.50 in chips) 
Seat 6: andy84lfc ($100 in chips) 
Seat 7: maxxmeister ($255.81 in chips) 
Seat 8: 178013 ($175.82 in chips) 
Seat 9: matiko09 ($178.87 in chips) 
Hayer ana: posts small blind $0.50
Khaine_CM: posts big blind $1
*** HOLE CARDS ***
Dealt to matiko09 [9h Ah]
CI58: calls $1
Alex Frider: folds 
andy84lfc: raises $2 to $3
maxxmeister: folds 
178013: raises $7.50 to $10.50
matiko09: folds 
HITYESCA: folds 
Hayer ana: folds 
Khaine_CM: folds 
CI58: folds 
andy84lfc: calls $7.50
*** FLOP *** [3c Qs 7s]
andy84lfc: bets $22.32
178013: raises $143 to $165.32 and is all-in
andy84lfc: calls $67.18 and is all-in
Uncalled bet ($75.82) returned to 178013
*** TURN *** [3c Qs 7s] [Th]
*** RIVER *** [3c Qs 7s Th] [Ks]
*** SHOW DOWN ***
andy84lfc: shows [8c Qc] (a pair of Queens)
178013: shows [Ad Qd] (a pair of Queens - Ace kicker)
178013 collected $200 from pot
*** SUMMARY ***
Total pot $202.50 | Rake $2.50 
Board [3c Qs 7s Th Ks]
Seat 1: HITYESCA (button) folded before Flop (didn't bet)
Seat 2: Hayer ana (small blind) folded before Flop
Seat 3: Khaine_CM (big blind) folded before Flop
Seat 4: CI58 folded before Flop
Seat 5: Alex Frider folded before Flop (didn't bet)
Seat 6: andy84lfc showed [8c Qc] and lost with a pair of Queens
Seat 7: maxxmeister folded before Flop (didn't bet)
Seat 8: 178013 showed [Ad Qd] and won ($200) with a pair of Queens
Seat 9: matiko09 folded before Flop (didn't bet)





PokerStars Hand #152887054026:  Hold'em No Limit ($1/$2 USD) - 2016/05/05 17:03:18 CET [2016/05/05 11:03:18 ET]
Table 'Tatry II' 9-max Seat #7 is the button
Seat 1: glanza_mike ($200.15 in chips) 
Seat 2: T0ny Adams ($79 in chips) 
Seat 3: matiko09 ($200 in chips) 
Seat 4: PacPacBum ($215.79 in chips) 
Seat 5: Painkiller72 ($288.75 in chips) 
Seat 6: Kukuryzka ($328.21 in chips) 
Seat 7: myatiy 96 ($202 in chips) 
Seat 8: chaps1988 ($253.54 in chips) 
Seat 9: korol702 ($211 in chips) 
chaps1988: posts small blind $1
korol702: posts big blind $2
*** HOLE CARDS ***
Dealt to matiko09 [Qs Kc]
glanza_mike: folds 
T0ny Adams: folds 
matiko09: raises $3 to $5
PacPacBum: folds 
Painkiller72: folds 
Kukuryzka: folds 
myatiy 96: folds 
chaps1988: folds 
korol702: calls $3
*** FLOP *** [7s 4h As]
korol702: checks 
matiko09: checks 
*** TURN *** [7s 4h As] [3c]
korol702: checks 
matiko09: checks 
*** RIVER *** [7s 4h As 3c] [6d]
korol702: checks 
matiko09: checks 
*** SHOW DOWN ***
korol702: shows [3d 9c] (a pair of Threes)
matiko09: mucks hand 
korol702 collected $10.45 from pot
*** SUMMARY ***
Total pot $11 | Rake $0.55 
Board [7s 4h As 3c 6d]
Seat 1: glanza_mike folded before Flop (didn't bet)
Seat 2: T0ny Adams folded before Flop (didn't bet)
Seat 3: matiko09 mucked [Qs Kc]
Seat 4: PacPacBum folded before Flop (didn't bet)
Seat 5: Painkiller72 folded before Flop (didn't bet)
Seat 6: Kukuryzka folded before Flop (didn't bet)
Seat 7: myatiy 96 (button) folded before Flop (didn't bet)
Seat 8: chaps1988 (small blind) folded before Flop
Seat 9: korol702 (big blind) showed [3d 9c] and won ($10.45) with a pair of Threes





PokerStars Hand #152887055460:  Hold'em No Limit (€1/€2 EUR) - 2016/05/05 17:03:20 CET [2016/05/05 11:03:20 ET]
Table 'Bessel II' 9-max Seat #3 is the button
Seat 1: Soloaces224 (€211.28 in chips) 
Seat 2: Fitzyferret (€341.70 in chips) 
Seat 3: PacPacBum (€208.02 in chips) 
Seat 4: Alex Frider (€200 in chips) 
Seat 5: Kukuryzka (€212.40 in chips) 
Seat 7: matiko09 (€200 in chips) 
Seat 8: chaps1988 (€261.70 in chips) 
Seat 9: JoaquinMRuiz (€211.15 in chips) 
Alex Frider: posts small blind €1
Kukuryzka: posts big blind €2
*** HOLE CARDS ***
Dealt to matiko09 [9s 3s]
matiko09: folds 
chaps1988: folds 
JoaquinMRuiz: folds 
Soloaces224: folds 
Fitzyferret: folds 
PacPacBum: folds 
Alex Frider: folds 
Uncalled bet (€1) returned to Kukuryzka
Kukuryzka collected €2 from pot
Kukuryzka: doesn't show hand 
*** SUMMARY ***
Total pot €2 | Rake €0 
Seat 1: Soloaces224 folded before Flop (didn't bet)
Seat 2: Fitzyferret folded before Flop (didn't bet)
Seat 3: PacPacBum (button) folded before Flop (didn't bet)
Seat 4: Alex Frider (small blind) folded before Flop
Seat 5: Kukuryzka (big blind) collected (€2)
Seat 7: matiko09 folded before Flop (didn't bet)
Seat 8: chaps1988 folded before Flop (didn't bet)
Seat 9: JoaquinMRuiz folded before Flop (didn't bet)





PokerStars Hand #152887061635:  Hold'em No Limit ($1/$2 USD) - 2016/05/05 17:03:30 CET [2016/05/05 11:03:30 ET]
Table 'Samitchell' 9-max Seat #7 is the button
Seat 1: CI58 ($200 in chips) 
Seat 2: matiko09 ($282.26 in chips) 
Seat 3: han3bj ($247.77 in chips) 
Seat 4: Fitzyferret ($497.88 in chips) 
Seat 5: chaps1988 ($200 in chips) 
Seat 6: PacPacBum ($200 in chips) 
Seat 7: patpaty ($170.16 in chips) 
Seat 8: tepi_guy ($206.68 in chips) 
Seat 9: kblkxls ($94 in chips) 
tepi_guy: posts small blind $1
kblkxls: posts big blind $2
*** HOLE CARDS ***
Dealt to matiko09 [Ks Ts]
CI58: folds 
matiko09: raises $3 to $5
han3bj: folds 
Fitzyferret: folds 
chaps1988: folds 
PacPacBum: folds 
kblkxls said, "You wot mate? I swear on me mum"
han3bj said, "nice donation"
patpaty: folds 
tepi_guy: folds 
kblkxls: calls $3
*** FLOP *** [5h Ac 3s]
kblkxls: checks 
matiko09: bets $6.79
kblkxls: folds 
Uncalled bet ($6.79) returned to matiko09
matiko09 collected $10.45 from pot
matiko09: doesn't show hand 
*** SUMMARY ***
Total pot $11 | Rake $0.55 
Board [5h Ac 3s]
Seat 1: CI58 folded before Flop (didn't bet)
Seat 2: matiko09 collected ($10.45)
Seat 3: han3bj folded before Flop (didn't bet)
Seat 4: Fitzyferret folded before Flop (didn't bet)
Seat 5: chaps1988 folded before Flop (didn't bet)
Seat 6: PacPacBum folded before Flop (didn't bet)
Seat 7: patpaty (button) folded before Flop (didn't bet)
Seat 8: tepi_guy (small blind) folded before Flop
Seat 9: kblkxls (big blind) folded on the Flop





PokerStars Hand #152887089537:  Hold'em No Limit ($0.50/$1.00 USD) - 2016/05/05 17:04:16 CET [2016/05/05 11:04:16 ET]
Table 'Siberia' 9-max Seat #9 is the button
Seat 2: Painkiller72 ($100 in chips) 
Seat 3: sanpidk ($101.50 in chips) 
Seat 4: opsv ($61 in chips) 
Seat 5: myatiy 96 ($101.50 in chips) 
Seat 6: bjonlyking ($111.95 in chips) 
Seat 7: matiko09 ($100 in chips) 
Seat 8: Vikulja1993 ($100 in chips) 
Seat 9: arctur17 ($112.90 in chips) 
Lycaon23 will be allowed to play after the button
Painkiller72: posts small blind $0.50
sanpidk: posts big blind $1
*** HOLE CARDS ***
Dealt to matiko09 [8h 9c]
opsv: folds 
myatiy 96: folds 
bjonlyking: folds 
matiko09: folds 
Vikulja1993: raises $1.50 to $2.50
arctur17: raises $5.50 to $8
Painkiller72: folds 
sanpidk: folds 
Vikulja1993: calls $5.50
*** FLOP *** [Jd Js As]
Vikulja1993: checks 
arctur17: bets $10
Vikulja1993: folds 
Uncalled bet ($10) returned to arctur17
arctur17 collected $16.62 from pot
arctur17: doesn't show hand 
*** SUMMARY ***
Total pot $17.50 | Rake $0.88 
Board [Jd Js As]
Seat 2: Painkiller72 (small blind) folded before Flop
Seat 3: sanpidk (big blind) folded before Flop
Seat 4: opsv folded before Flop (didn't bet)
Seat 5: myatiy 96 folded before Flop (didn't bet)
Seat 6: bjonlyking folded before Flop (didn't bet)
Seat 7: matiko09 folded before Flop (didn't bet)
Seat 8: Vikulja1993 folded on the Flop
Seat 9: arctur17 (button) collected ($16.62)





PokerStars Hand #152887090320:  Hold'em No Limit ($1/$2 USD) - 2016/05/05 17:04:17 CET [2016/05/05 11:04:17 ET]
Table 'Euporie II' 9-max Seat #7 is the button
Seat 1: PacPacBum ($200 in chips) 
Seat 2: kblkxls ($144.53 in chips) 
Seat 3: chaps1988 ($203 in chips) 
Seat 4: tepi_guy ($200 in chips) 
Seat 5: Nuskatko1986 ($121.75 in chips) 
Seat 6: Kukuryzka ($205.43 in chips) 
Seat 7: matiko09 ($200 in chips) 
Seat 8: Painkiller72 ($305.68 in chips) 
Seat 9: myatiy 96 ($205 in chips) 
Painkiller72: posts small blind $1
myatiy 96: posts big blind $2
*** HOLE CARDS ***
Dealt to matiko09 [Kh 8d]
PacPacBum: folds 
kblkxls: folds 
chaps1988: folds 
tepi_guy: folds 
Nuskatko1986: calls $2
Kukuryzka: folds 
matiko09: raises $6 to $8
Painkiller72: folds 
myatiy 96: folds 
Nuskatko1986: calls $6
*** FLOP *** [8h 6c 6h]
Nuskatko1986: bets $2
matiko09: raises $8 to $10
Nuskatko1986: calls $8
*** TURN *** [8h 6c 6h] [Kc]
Nuskatko1986: bets $103.75 and is all-in
matiko09: calls $103.75
*** RIVER *** [8h 6c 6h Kc] [2d]
*** SHOW DOWN ***
Nuskatko1986: shows [As Qd] (a pair of Sixes)
matiko09: shows [Kh 8d] (two pair, Kings and Eights)
matiko09 collected $243.75 from pot
*** SUMMARY ***
Total pot $246.50 | Rake $2.75 
Board [8h 6c 6h Kc 2d]
Seat 1: PacPacBum folded before Flop (didn't bet)
Seat 2: kblkxls folded before Flop (didn't bet)
Seat 3: chaps1988 folded before Flop (didn't bet)
Seat 4: tepi_guy folded before Flop (didn't bet)
Seat 5: Nuskatko1986 showed [As Qd] and lost with a pair of Sixes
Seat 6: Kukuryzka folded before Flop (didn't bet)
Seat 7: matiko09 (button) showed [Kh 8d] and won ($243.75) with two pair, Kings and Eights
Seat 8: Painkiller72 (small blind) folded before Flop
Seat 9: myatiy 96 (big blind) folded before Flop





PokerStars Hand #152887090471:  Hold'em No Limit ($1/$2 USD) - 2016/05/05 17:04:18 CET [2016/05/05 11:04:18 ET]
Table 'Tololo' 9-max Seat #3 is the button
Seat 1: Kukuryzka ($254.29 in chips) 
Seat 2: tepi_guy ($222.34 in chips) 
Seat 3: Khaine_CM ($200 in chips) 
Seat 4: mooose100 ($224.22 in chips) 
Seat 5: matiko09 ($217.70 in chips) 
Seat 6: Vikulja1993 ($203 in chips) 
Seat 7: chaps1988 ($336.12 in chips) 
Seat 8: myatiy 96 ($203 in chips) 
Seat 9: Fitzyferret ($383.77 in chips) 
mooose100: posts small blind $1
matiko09: posts big blind $2
*** HOLE CARDS ***
Dealt to matiko09 [4c 6d]
Vikulja1993: folds 
chaps1988: folds 
myatiy 96: folds 
Fitzyferret: raises $3.24 to $5.24
Kukuryzka: folds 
tepi_guy: folds 
Khaine_CM: calls $5.24
mooose100: raises $17.72 to $22.96
matiko09: folds 
Fitzyferret: folds 
Khaine_CM: calls $17.72
*** FLOP *** [Js 2c As]
mooose100: bets $25.25
Khaine_CM: calls $25.25
*** TURN *** [Js 2c As] [9s]
mooose100: checks 
Khaine_CM: checks 
*** RIVER *** [Js 2c As 9s] [5d]
mooose100: bets $50.45
Khaine_CM: folds 
Uncalled bet ($50.45) returned to mooose100
mooose100 collected $100.91 from pot
mooose100: doesn't show hand 
*** SUMMARY ***
Total pot $103.66 | Rake $2.75 
Board [Js 2c As 9s 5d]
Seat 1: Kukuryzka folded before Flop (didn't bet)
Seat 2: tepi_guy folded before Flop (didn't bet)
Seat 3: Khaine_CM (button) folded on the River
Seat 4: mooose100 (small blind) collected ($100.91)
Seat 5: matiko09 (big blind) folded before Flop
Seat 6: Vikulja1993 folded before Flop (didn't bet)
Seat 7: chaps1988 folded before Flop (didn't bet)
Seat 8: myatiy 96 folded before Flop (didn't bet)
Seat 9: Fitzyferret folded before Flop





PokerStars Hand #152887092209:  Hold'em No Limit ($1/$2 USD) - 2016/05/05 17:04:20 CET [2016/05/05 11:04:20 ET]
Table 'Tatry II' 9-max Seat #8 is the button
Seat 3: matiko09 ($200 in chips) 
Seat 4: PacPacBum ($215.79 in chips) 
Seat 5: Painkiller72 ($288.75 in chips) 
Seat 6: Kukuryzka ($328.21 in chips) 
Seat 7: myatiy 96 ($202 in chips) 
Seat 8: chaps1988 ($252.54 in chips) 
Seat 9: korol702 ($216.45 in chips) 
korol702: posts small blind $1
glanza_mike: is sitting out 
T0ny Adams: is sitting out 
matiko09: posts big blind $2
*** HOLE CARDS ***
Dealt to matiko09 [4c Qs]
T0ny Adams leaves the table
tepi_guy joins the table at seat #2 
glanza_mike leaves the table
Alex Frider joins the table at seat #1 
PacPacBum: raises $2.08 to $4.08
Painkiller72: folds 
Kukuryzka: folds 
myatiy 96: folds 
chaps1988: folds 
korol702: folds 
matiko09: folds 
Uncalled bet ($2.08) returned to PacPacBum
PacPacBum collected $5 from pot
PacPacBum: doesn't show hand 
*** SUMMARY ***
Total pot $5 | Rake $0 
Seat 3: matiko09 (big blind) folded before Flop
Seat 4: PacPacBum collected ($5)
Seat 5: Painkiller72 folded before Flop (didn't bet)
Seat 6: Kukuryzka folded before Flop (didn't bet)
Seat 7: myatiy 96 folded before Flop (didn't bet)
Seat 8: chaps1988 (button) folded before Flop (didn't bet)
Seat 9: korol702 (small blind) folded before Flop





PokerStars Hand #152887095556:  Hold'em No Limit ($0.50/$1.00 USD) - 2016/05/05 17:04:26 CET [2016/05/05 11:04:26 ET]
Table 'Kraz II' 9-max Seat #2 is the button
Seat 1: HITYESCA ($141.30 in chips) 
Seat 2: Hayer ana ($100 in chips) 
Seat 3: Khaine_CM ($100 in chips) 
Seat 4: CI58 ($100 in chips) 
Seat 5: Alex Frider ($123.50 in chips) 
Seat 7: maxxmeister ($255.81 in chips) 
Seat 8: 178013 ($275.82 in chips) 
Seat 9: matiko09 ($178.87 in chips) 
Khaine_CM: posts small blind $0.50
CI58: posts big blind $1
*** HOLE CARDS ***
Dealt to matiko09 [Ac 7s]
Alex Frider: folds 
maxxmeister: folds 
178013: folds 
matiko09: folds 
HITYESCA: folds 
Hayer ana: raises $1.50 to $2.50
Khaine_CM: raises $6.50 to $9
CI58: folds 
Hayer ana: folds 
Uncalled bet ($6.50) returned to Khaine_CM
Khaine_CM collected $6 from pot
Khaine_CM: doesn't show hand 
*** SUMMARY ***
Total pot $6 | Rake $0 
Seat 1: HITYESCA folded before Flop (didn't bet)
Seat 2: Hayer ana (button) folded before Flop
Seat 3: Khaine_CM (small blind) collected ($6)
Seat 4: CI58 (big blind) folded before Flop
Seat 5: Alex Frider folded before Flop (didn't bet)
Seat 7: maxxmeister folded before Flop (didn't bet)
Seat 8: 178013 folded before Flop (didn't bet)
Seat 9: matiko09 folded before Flop (didn't bet)





PokerStars Hand #152887103637:  Hold'em No Limit (€1/€2 EUR) - 2016/05/05 17:04:39 CET [2016/05/05 11:04:39 ET]
Table 'Skat II' 9-max Seat #4 is the button
Seat 1: Vikulja1993 (€204.55 in chips) 
Seat 2: Fitzyferret (€288.71 in chips) 
Seat 3: Alex Frider (€204.59 in chips) 
Seat 4: JoaquinMRuiz (€200 in chips) 
Seat 5: ceedonen (€217.73 in chips) 
Seat 6: drissmouzou (€251.47 in chips) 
Seat 7: PacPacBum (€224.50 in chips) 
Seat 9: matiko09 (€200 in chips) 
ceedonen: posts small blind €1
drissmouzou: posts big blind €2
Painkiller72: sits out 
*** HOLE CARDS ***
Dealt to matiko09 [Td 3h]
drissmouzou said, "<3<3<3<38)"
PacPacBum: folds 
drissmouzou said, "(y)"
matiko09: folds 
Vikulja1993: folds 
Fitzyferret: folds 
Alex Frider: folds 
JoaquinMRuiz: folds 
ceedonen: folds 
Uncalled bet (€1) returned to drissmouzou
drissmouzou collected €2 from pot
drissmouzou: doesn't show hand 
*** SUMMARY ***
Total pot €2 | Rake €0 
Seat 1: Vikulja1993 folded before Flop (didn't bet)
Seat 2: Fitzyferret folded before Flop (didn't bet)
Seat 3: Alex Frider folded before Flop (didn't bet)
Seat 4: JoaquinMRuiz (button) folded before Flop (didn't bet)
Seat 5: ceedonen (small blind) folded before Flop
Seat 6: drissmouzou (big blind) collected (€2)
Seat 7: PacPacBum folded before Flop (didn't bet)
Seat 9: matiko09 folded before Flop (didn't bet)





PokerStars Hand #152887110531:  Hold'em No Limit ($1/$2 USD) - 2016/05/05 17:04:50 CET [2016/05/05 11:04:50 ET]
Table 'Samitchell' 9-max Seat #8 is the button
Seat 1: CI58 ($200 in chips) 
Seat 2: matiko09 ($287.71 in chips) 
Seat 3: han3bj ($247.77 in chips) 
Seat 4: Fitzyferret ($497.88 in chips) 
Seat 5: chaps1988 ($200 in chips) 
Seat 6: PacPacBum ($200 in chips) 
Seat 7: patpaty ($170.16 in chips) 
Seat 8: tepi_guy ($205.68 in chips) 
Seat 9: kblkxls ($97 in chips) 
kblkxls: posts small blind $1
CI58: posts big blind $2
*** HOLE CARDS ***
Dealt to matiko09 [4c Ks]
kblkxls said, "you dont remember me hey?"
matiko09: folds 
han3bj: folds 
Fitzyferret: folds 
chaps1988: folds 
PacPacBum: folds 
patpaty: folds 
tepi_guy: folds 
kblkxls: calls $1
CI58: checks 
*** FLOP *** [Qc 6c Ah]
kblkxls: checks 
han3bj said, "never heard about u"
CI58: checks 
*** TURN *** [Qc 6c Ah] [3h]
kblkxls said, "I think you do, maybe you dont want to admit it"
kblkxls: bets $2
kblkxls said, "you have a short sister yes?"
CI58: folds 
Uncalled bet ($2) returned to kblkxls
kblkxls collected $3.80 from pot
kblkxls: doesn't show hand 
*** SUMMARY ***
Total pot $4 | Rake $0.20 
Board [Qc 6c Ah 3h]
Seat 1: CI58 (big blind) folded on the Turn
Seat 2: matiko09 folded before Flop (didn't bet)
Seat 3: han3bj folded before Flop (didn't bet)
Seat 4: Fitzyferret folded before Flop (didn't bet)
Seat 5: chaps1988 folded before Flop (didn't bet)
Seat 6: PacPacBum folded before Flop (didn't bet)
Seat 7: patpaty folded before Flop (didn't bet)
Seat 8: tepi_guy (button) folded before Flop (didn't bet)
Seat 9: kblkxls (small blind) collected ($3.80)





PokerStars Hand #152887114431:  Hold'em No Limit ($1/$2 USD) - 2016/05/05 17:04:57 CET [2016/05/05 11:04:57 ET]
Table 'Tatry II' 9-max Seat #9 is the button
Seat 3: matiko09 ($200 in chips) 
Seat 4: PacPacBum ($218.79 in chips) 
Seat 5: Painkiller72 ($288.75 in chips) 
Seat 6: Kukuryzka ($328.21 in chips) 
Seat 7: myatiy 96 ($202 in chips) 
Seat 8: chaps1988 ($252.54 in chips) 
Seat 9: korol702 ($215.45 in chips) 
Alex Frider will be allowed to play after the button
tepi_guy will be allowed to play after the button
matiko09: posts small blind $1
PacPacBum: posts big blind $2
*** HOLE CARDS ***
Dealt to matiko09 [6h Qh]
Painkiller72: folds 
Kukuryzka: folds 
myatiy 96: folds 
chaps1988: raises $2.50 to $4.50
korol702: folds 
matiko09: folds 
PacPacBum: folds 
Uncalled bet ($2.50) returned to chaps1988
chaps1988 collected $5 from pot
*** SUMMARY ***
Total pot $5 | Rake $0 
Seat 3: matiko09 (small blind) folded before Flop
Seat 4: PacPacBum (big blind) folded before Flop
Seat 5: Painkiller72 folded before Flop (didn't bet)
Seat 6: Kukuryzka folded before Flop (didn't bet)
Seat 7: myatiy 96 folded before Flop (didn't bet)
Seat 8: chaps1988 collected ($5)
Seat 9: korol702 (button) folded before Flop (didn't bet)





PokerStars Hand #152887124425:  Hold'em No Limit (€1/€2 EUR) - 2016/05/05 17:05:13 CET [2016/05/05 11:05:13 ET]
Table 'Skat II' 9-max Seat #5 is the button
Seat 1: Vikulja1993 (€204.55 in chips) 
Seat 2: Fitzyferret (€288.71 in chips) 
Seat 3: Alex Frider (€204.59 in chips) 
Seat 4: JoaquinMRuiz (€200 in chips) 
Seat 5: ceedonen (€216.73 in chips) 
Seat 6: drissmouzou (€252.47 in chips) 
Seat 7: PacPacBum (€224.50 in chips) 
Seat 9: matiko09 (€200 in chips) 
drissmouzou: posts small blind €1
PacPacBum: posts big blind €2
Painkiller72: sits out 
*** HOLE CARDS ***
Dealt to matiko09 [3d Tc]
matiko09: folds 
Vikulja1993: folds 
Fitzyferret: raises €3.24 to €5.24
Alex Frider: folds 
JoaquinMRuiz: folds 
ceedonen: calls €5.24
drissmouzou: folds 
PacPacBum: folds 
*** FLOP *** [Ts Ah 5s]
Fitzyferret: checks 
ceedonen: bets €6.40
Fitzyferret: calls €6.40
*** TURN *** [Ts Ah 5s] [8d]
Fitzyferret: checks 
ceedonen: bets €16.23
Fitzyferret: calls €16.23
*** RIVER *** [Ts Ah 5s 8d] [4s]
Fitzyferret: checks 
ceedonen: bets €36.55
Fitzyferret: folds 
Uncalled bet (€36.55) returned to ceedonen
ceedonen collected €56.24 from pot
*** SUMMARY ***
Total pot €58.74 | Rake €2.50 
Board [Ts Ah 5s 8d 4s]
Seat 1: Vikulja1993 folded before Flop (didn't bet)
Seat 2: Fitzyferret folded on the River
Seat 3: Alex Frider folded before Flop (didn't bet)
Seat 4: JoaquinMRuiz folded before Flop (didn't bet)
Seat 5: ceedonen (button) collected (€56.24)
Seat 6: drissmouzou (small blind) folded before Flop
Seat 7: PacPacBum (big blind) folded before Flop
Seat 9: matiko09 folded before Flop (didn't bet)





PokerStars Hand #152887125392:  Hold'em No Limit ($0.50/$1.00 USD) - 2016/05/05 17:05:14 CET [2016/05/05 11:05:14 ET]
Table 'Siberia' 9-max Seat #2 is the button
Seat 2: Painkiller72 ($100 in chips) 
Seat 3: sanpidk ($100.50 in chips) 
Seat 4: opsv ($61 in chips) 
Seat 5: myatiy 96 ($101.50 in chips) 
Seat 6: bjonlyking ($111.95 in chips) 
Seat 7: matiko09 ($100 in chips) 
Seat 8: Vikulja1993 ($100 in chips) 
Seat 9: arctur17 ($121.52 in chips) 
sanpidk: posts small blind $0.50
opsv: posts big blind $1
Lycaon23: sits out 
*** HOLE CARDS ***
Dealt to matiko09 [Th Kc]
myatiy 96: folds 
myatiy 96 leaves the table
Hayer ana joins the table at seat #5 
bjonlyking: folds 
matiko09: folds 
Vikulja1993: folds 
arctur17: folds 
Painkiller72: folds 
sanpidk: raises $1.24 to $2.24
opsv: folds 
Uncalled bet ($1.24) returned to sanpidk
sanpidk collected $2 from pot
sanpidk: doesn't show hand 
*** SUMMARY ***
Total pot $2 | Rake $0 
Seat 2: Painkiller72 (button) folded before Flop (didn't bet)
Seat 3: sanpidk (small blind) collected ($2)
Seat 4: opsv (big blind) folded before Flop
Seat 5: myatiy 96 folded before Flop (didn't bet)
Seat 6: bjonlyking folded before Flop (didn't bet)
Seat 7: matiko09 folded before Flop (didn't bet)
Seat 8: Vikulja1993 folded before Flop (didn't bet)
Seat 9: arctur17 folded before Flop (didn't bet)





PokerStars Hand #152887131248:  Hold'em No Limit ($0.50/$1.00 USD) - 2016/05/05 17:05:24 CET [2016/05/05 11:05:24 ET]
Table 'Kraz II' 9-max Seat #3 is the button
Seat 1: HITYESCA ($141.30 in chips) 
Seat 2: Hayer ana ($100 in chips) 
Seat 3: Khaine_CM ($103.50 in chips) 
Seat 4: CI58 ($100 in chips) 
Seat 5: Alex Frider ($123.50 in chips) 
Seat 6: andy84lfc ($41.12 in chips) 
Seat 7: maxxmeister ($255.81 in chips) 
Seat 8: 178013 ($275.82 in chips) 
Seat 9: matiko09 ($178.87 in chips) 
CI58: posts small blind $0.50
Alex Frider: posts big blind $1
*** HOLE CARDS ***
Dealt to matiko09 [5c Jh]
andy84lfc: folds 
maxxmeister: folds 
178013: folds 
matiko09: folds 
HITYESCA: folds 
Hayer ana: raises $1.50 to $2.50
Khaine_CM: folds 
CI58: folds 
Alex Frider: folds 
Uncalled bet ($1.50) returned to Hayer ana
Hayer ana collected $2.50 from pot
Hayer ana: doesn't show hand 
*** SUMMARY ***
Total pot $2.50 | Rake $0 
Seat 1: HITYESCA folded before Flop (didn't bet)
Seat 2: Hayer ana collected ($2.50)
Seat 3: Khaine_CM (button) folded before Flop (didn't bet)
Seat 4: CI58 (small blind) folded before Flop
Seat 5: Alex Frider (big blind) folded before Flop
Seat 6: andy84lfc folded before Flop (didn't bet)
Seat 7: maxxmeister folded before Flop (didn't bet)
Seat 8: 178013 folded before Flop (didn't bet)
Seat 9: matiko09 folded before Flop (didn't bet)





PokerStars Hand #152887137756:  Hold'em No Limit ($1/$2 USD) - 2016/05/05 17:05:34 CET [2016/05/05 11:05:34 ET]
Table 'Tatry II' 9-max Seat #3 is the button
Seat 3: matiko09 ($200 in chips) 
Seat 4: PacPacBum ($216.79 in chips) 
Seat 5: Painkiller72 ($288.75 in chips) 
Seat 6: Kukuryzka ($328.21 in chips) 
Seat 7: myatiy 96 ($202 in chips) 
Seat 8: chaps1988 ($255.54 in chips) 
Seat 9: korol702 ($215.45 in chips) 
PacPacBum: posts small blind $1
Painkiller72: posts big blind $2
Alex Frider: sits out 
tepi_guy: sits out 
*** HOLE CARDS ***
Dealt to matiko09 [8d 3c]
Kukuryzka: folds 
myatiy 96: folds 
chaps1988: folds 
korol702 has timed out
korol702: folds 
matiko09: folds 
PacPacBum: raises $2.08 to $4.08
Painkiller72: folds 
Uncalled bet ($2.08) returned to PacPacBum
PacPacBum collected $4 from pot
PacPacBum: doesn't show hand 
*** SUMMARY ***
Total pot $4 | Rake $0 
Seat 3: matiko09 (button) folded before Flop (didn't bet)
Seat 4: PacPacBum (small blind) collected ($4)
Seat 5: Painkiller72 (big blind) folded before Flop
Seat 6: Kukuryzka folded before Flop (didn't bet)
Seat 7: myatiy 96 folded before Flop (didn't bet)
Seat 8: chaps1988 folded before Flop (didn't bet)
Seat 9: korol702 folded before Flop (didn't bet)





PokerStars Hand #152887146344:  Hold'em No Limit ($1/$2 USD) - 2016/05/05 17:05:48 CET [2016/05/05 11:05:48 ET]
Table 'Samitchell' 9-max Seat #9 is the button
Seat 1: CI58 ($200 in chips) 
Seat 2: matiko09 ($287.71 in chips) 
Seat 3: han3bj ($247.77 in chips) 
Seat 4: Fitzyferret ($497.88 in chips) 
Seat 5: chaps1988 ($200 in chips) 
Seat 6: PacPacBum ($200 in chips) 
Seat 7: patpaty ($170.16 in chips) 
Seat 8: tepi_guy ($205.68 in chips) 
Seat 9: kblkxls ($98.80 in chips) 
CI58: posts small blind $1
matiko09: posts big blind $2
*** HOLE CARDS ***
Dealt to matiko09 [8s Ac]
kblkxls said, "with black hair and really long legs?"
han3bj: folds 
Fitzyferret: folds 
chaps1988: folds 
PacPacBum: folds 
patpaty: raises $2 to $4
tepi_guy: folds 
kblkxls: calls $4
CI58: folds 
matiko09: calls $2
*** FLOP *** [2s 6s 3s]
matiko09: checks 
han3bj said, "lol u must think me of the other guy"
patpaty: checks 
han3bj said, "i dont have sister"
kblkxls: bets $12
matiko09: folds 
patpaty: folds 
Uncalled bet ($12) returned to kblkxls
kblkxls collected $12.35 from pot
kblkxls: doesn't show hand 
*** SUMMARY ***
Total pot $13 | Rake $0.65 
Board [2s 6s 3s]
Seat 1: CI58 (small blind) folded before Flop
Seat 2: matiko09 (big blind) folded on the Flop
Seat 3: han3bj folded before Flop (didn't bet)
Seat 4: Fitzyferret folded before Flop (didn't bet)
Seat 5: chaps1988 folded before Flop (didn't bet)
Seat 6: PacPacBum folded before Flop (didn't bet)
Seat 7: patpaty folded on the Flop
Seat 8: tepi_guy folded before Flop (didn't bet)
Seat 9: kblkxls (button) collected ($12.35)





PokerStars Hand #152887147831:  Hold'em No Limit ($0.50/$1.00 USD) - 2016/05/05 17:05:50 CET [2016/05/05 11:05:50 ET]
Table 'Kraz II' 9-max Seat #4 is the button
Seat 1: HITYESCA ($141.30 in chips) 
Seat 2: Hayer ana ($101.50 in chips) 
Seat 3: Khaine_CM ($103.50 in chips) 
Seat 4: CI58 ($100 in chips) 
Seat 5: Alex Frider ($122.50 in chips) 
Seat 6: andy84lfc ($41.12 in chips) 
Seat 7: maxxmeister ($255.81 in chips) 
Seat 8: 178013 ($275.82 in chips) 
Seat 9: matiko09 ($178.87 in chips) 
Alex Frider: posts small blind $0.50
andy84lfc: posts big blind $1
*** HOLE CARDS ***
Dealt to matiko09 [2s Qd]
maxxmeister: folds 
178013: folds 
matiko09: folds 
HITYESCA: folds 
Hayer ana: raises $2 to $3
Khaine_CM: folds 
CI58: folds 
Alex Frider: raises $7 to $10
andy84lfc: calls $9
Hayer ana: calls $7
*** FLOP *** [2d Td 4c]
Alex Frider: bets $14.82
andy84lfc: folds 
Hayer ana: calls $14.82
*** TURN *** [2d Td 4c] [4d]
Alex Frider: checks 
Hayer ana: checks 
*** RIVER *** [2d Td 4c 4d] [As]
Alex Frider: bets $41.14
Hayer ana: raises $35.54 to $76.68 and is all-in
Alex Frider: calls $35.54
*** SHOW DOWN ***
Hayer ana: shows [Ts Th] (a full house, Tens full of Fours)
Alex Frider: mucks hand 
Hayer ana collected $210.50 from pot
*** SUMMARY ***
Total pot $213 | Rake $2.50 
Board [2d Td 4c 4d As]
Seat 1: HITYESCA folded before Flop (didn't bet)
Seat 2: Hayer ana showed [Ts Th] and won ($210.50) with a full house, Tens full of Fours
Seat 3: Khaine_CM folded before Flop (didn't bet)
Seat 4: CI58 (button) folded before Flop (didn't bet)
Seat 5: Alex Frider (small blind) mucked [Kd Ac]
Seat 6: andy84lfc (big blind) folded on the Flop
Seat 7: maxxmeister folded before Flop (didn't bet)
Seat 8: 178013 folded before Flop (didn't bet)
Seat 9: matiko09 folded before Flop (didn't bet)





PokerStars Hand #152887150012:  Hold'em No Limit ($0.50/$1.00 USD) - 2016/05/05 17:05:54 CET [2016/05/05 11:05:54 ET]
Table 'Siberia' 9-max Seat #3 is the button
Seat 2: Painkiller72 ($100 in chips) 
Seat 3: sanpidk ($101.50 in chips) 
Seat 4: opsv ($60 in chips) 
Seat 5: Hayer ana ($100 in chips) 
Seat 6: bjonlyking ($111.95 in chips) 
Seat 7: matiko09 ($100 in chips) 
Seat 8: Vikulja1993 ($100 in chips) 
Seat 9: arctur17 ($121.52 in chips) 
opsv: posts small blind $0.50
Hayer ana: posts big blind $1
Lycaon23: sits out 
*** HOLE CARDS ***
Dealt to matiko09 [9s Qh]
bjonlyking: folds 
matiko09: folds 
Vikulja1993: folds 
arctur17: raises $1 to $2
Painkiller72: folds 
sanpidk: folds 
opsv: folds 
Hayer ana: folds 
Uncalled bet ($1) returned to arctur17
arctur17 collected $2.50 from pot
arctur17: doesn't show hand 
*** SUMMARY ***
Total pot $2.50 | Rake $0 
Seat 2: Painkiller72 folded before Flop (didn't bet)
Seat 3: sanpidk (button) folded before Flop (didn't bet)
Seat 4: opsv (small blind) folded before Flop
Seat 5: Hayer ana (big blind) folded before Flop
Seat 6: bjonlyking folded before Flop (didn't bet)
Seat 7: matiko09 folded before Flop (didn't bet)
Seat 8: Vikulja1993 folded before Flop (didn't bet)
Seat 9: arctur17 collected ($2.50)





PokerStars Hand #152887161638:  Hold'em No Limit ($1/$2 USD) - 2016/05/05 17:06:13 CET [2016/05/05 11:06:13 ET]
Table 'Tatry II' 9-max Seat #4 is the button
Seat 3: matiko09 ($200 in chips) 
Seat 4: PacPacBum ($218.79 in chips) 
Seat 5: Painkiller72 ($286.75 in chips) 
Seat 6: Kukuryzka ($328.21 in chips) 
Seat 7: myatiy 96 ($202 in chips) 
Seat 8: chaps1988 ($255.54 in chips) 
Seat 9: korol702 ($215.45 in chips) 
Painkiller72: posts small blind $1
Kukuryzka: posts big blind $2
Alex Frider: sits out 
tepi_guy: sits out 
*** HOLE CARDS ***
Dealt to matiko09 [Kc 2s]
myatiy 96: folds 
chaps1988: folds 
korol702: calls $2
matiko09: folds 
PacPacBum: folds 
Painkiller72: folds 
Kukuryzka: raises $6 to $8
korol702: calls $6
*** FLOP *** [9h 9c 6h]
Kukuryzka: bets $12.11
korol702: folds 
Uncalled bet ($12.11) returned to Kukuryzka
Kukuryzka collected $16.15 from pot
Kukuryzka: doesn't show hand 
*** SUMMARY ***
Total pot $17 | Rake $0.85 
Board [9h 9c 6h]
Seat 3: matiko09 folded before Flop (didn't bet)
Seat 4: PacPacBum (button) folded before Flop (didn't bet)
Seat 5: Painkiller72 (small blind) folded before Flop
Seat 6: Kukuryzka (big blind) collected ($16.15)
Seat 7: myatiy 96 folded before Flop (didn't bet)
Seat 8: chaps1988 folded before Flop (didn't bet)
Seat 9: korol702 folded on the Flop





PokerStars Hand #152887163535:  Hold'em No Limit ($1/$2 USD) - 2016/05/05 17:06:16 CET [2016/05/05 11:06:16 ET]
Table 'Euporie II' 9-max Seat #8 is the button
Seat 1: PacPacBum ($200 in chips) 
Seat 2: kblkxls ($144.53 in chips) 
Seat 3: chaps1988 ($203 in chips) 
Seat 4: tepi_guy ($200 in chips) 
Seat 6: Kukuryzka ($205.43 in chips) 
Seat 7: matiko09 ($322 in chips) 
Seat 8: Painkiller72 ($304.68 in chips) 
Seat 9: myatiy 96 ($203 in chips) 
myatiy 96: posts small blind $1
PacPacBum: posts big blind $2
*** HOLE CARDS ***
Dealt to matiko09 [9s 6d]
kblkxls: folds 
chaps1988: folds 
Nuskatko1986 leaves the table
tepi_guy: folds 
Kukuryzka: folds 
Alex Frider joins the table at seat #5 
matiko09: folds 
Painkiller72: folds 
myatiy 96: folds 
Uncalled bet ($1) returned to PacPacBum
PacPacBum collected $2 from pot
PacPacBum: doesn't show hand 
*** SUMMARY ***
Total pot $2 | Rake $0 
Seat 1: PacPacBum (big blind) collected ($2)
Seat 2: kblkxls folded before Flop (didn't bet)
Seat 3: chaps1988 folded before Flop (didn't bet)
Seat 4: tepi_guy folded before Flop (didn't bet)
Seat 6: Kukuryzka folded before Flop (didn't bet)
Seat 7: matiko09 folded before Flop (didn't bet)
Seat 8: Painkiller72 (button) folded before Flop (didn't bet)
Seat 9: myatiy 96 (small blind) folded before Flop





PokerStars Hand #152887170903:  Hold'em No Limit ($0.50/$1.00 USD) - 2016/05/05 17:06:28 CET [2016/05/05 11:06:28 ET]
Table 'Siberia' 9-max Seat #4 is the button
Seat 2: Painkiller72 ($100 in chips) 
Seat 3: sanpidk ($101.50 in chips) 
Seat 4: opsv ($59.50 in chips) 
Seat 5: Hayer ana ($99 in chips) 
Seat 6: bjonlyking ($111.95 in chips) 
Seat 7: matiko09 ($100 in chips) 
Seat 8: Vikulja1993 ($100 in chips) 
Seat 9: arctur17 ($123.02 in chips) 
Hayer ana: posts small blind $0.50
bjonlyking: posts big blind $1
Lycaon23: sits out 
*** HOLE CARDS ***
Dealt to matiko09 [3s 8s]
matiko09: folds 
Vikulja1993: raises $2 to $3
arctur17: calls $3
Painkiller72: raises $10 to $13
sanpidk: folds 
opsv: folds 
Hayer ana: folds 
bjonlyking: folds 
Vikulja1993: folds 
arctur17: folds 
Uncalled bet ($10) returned to Painkiller72
Painkiller72 collected $10.50 from pot
Painkiller72: doesn't show hand 
*** SUMMARY ***
Total pot $10.50 | Rake $0 
Seat 2: Painkiller72 collected ($10.50)
Seat 3: sanpidk folded before Flop (didn't bet)
Seat 4: opsv (button) folded before Flop (didn't bet)
Seat 5: Hayer ana (small blind) folded before Flop
Seat 6: bjonlyking (big blind) folded before Flop
Seat 7: matiko09 folded before Flop (didn't bet)
Seat 8: Vikulja1993 folded before Flop
Seat 9: arctur17 folded before Flop





PokerStars Hand #152887174536:  Hold'em No Limit ($1/$2 USD) - 2016/05/05 17:06:34 CET [2016/05/05 11:06:34 ET]
Table 'Euporie II' 9-max Seat #9 is the button
Seat 1: PacPacBum ($201 in chips) 
Seat 2: kblkxls ($144.53 in chips) 
Seat 3: chaps1988 ($203 in chips) 
Seat 4: tepi_guy ($200 in chips) 
Seat 6: Kukuryzka ($205.43 in chips) 
Seat 7: matiko09 ($322 in chips) 
Seat 8: Painkiller72 ($304.68 in chips) 
Seat 9: myatiy 96 ($202 in chips) 
PacPacBum: posts small blind $1
kblkxls: posts big blind $2
Alex Frider: sits out 
*** HOLE CARDS ***
Dealt to matiko09 [2s 6h]
chaps1988: folds 
tepi_guy: folds 
Kukuryzka: folds 
matiko09: folds 
Painkiller72: folds 
myatiy 96: folds 
PacPacBum: raises $3 to $5
kblkxls: calls $3
*** FLOP *** [8c 2d 6s]
PacPacBum: checks 
kblkxls: bets $7
PacPacBum: calls $7
*** TURN *** [8c 2d 6s] [9h]
PacPacBum: checks 
kblkxls: checks 
*** RIVER *** [8c 2d 6s 9h] [9d]
PacPacBum: checks 
kblkxls: bets $4
PacPacBum: calls $4
*** SHOW DOWN ***
kblkxls: shows [Ah 6c] (two pair, Nines and Sixes)
PacPacBum: shows [6d Ac] (two pair, Nines and Sixes)
PacPacBum collected $15.20 from pot
kblkxls collected $15.20 from pot
*** SUMMARY ***
Total pot $32 | Rake $1.60 
Board [8c 2d 6s 9h 9d]
Seat 1: PacPacBum (small blind) showed [6d Ac] and won ($15.20) with two pair, Nines and Sixes
Seat 2: kblkxls (big blind) showed [Ah 6c] and won ($15.20) with two pair, Nines and Sixes
Seat 3: chaps1988 folded before Flop (didn't bet)
Seat 4: tepi_guy folded before Flop (didn't bet)
Seat 6: Kukuryzka folded before Flop (didn't bet)
Seat 7: matiko09 folded before Flop (didn't bet)
Seat 8: Painkiller72 folded before Flop (didn't bet)
Seat 9: myatiy 96 (button) folded before Flop (didn't bet)





PokerStars Hand #152887184082:  Hold'em No Limit ($1/$2 USD) - 2016/05/05 17:06:49 CET [2016/05/05 11:06:49 ET]
Table 'Samitchell' 9-max Seat #1 is the button
Seat 1: CI58 ($200 in chips) 
Seat 2: matiko09 ($283.71 in chips) 
Seat 3: han3bj ($247.77 in chips) 
Seat 4: Fitzyferret ($497.88 in chips) 
Seat 5: chaps1988 ($200 in chips) 
Seat 6: PacPacBum ($200 in chips) 
Seat 7: patpaty ($166.16 in chips) 
Seat 8: tepi_guy ($205.68 in chips) 
Seat 9: kblkxls ($107.15 in chips) 
matiko09: posts small blind $1
han3bj: posts big blind $2
*** HOLE CARDS ***
Dealt to matiko09 [2s 6c]
Fitzyferret: folds 
chaps1988: raises $4 to $6
kblkxls said, "yes you do. really short blonde that has broken legs"
PacPacBum: folds 
patpaty: folds 
tepi_guy: calls $6
kblkxls: folds 
CI58: folds 
han3bj said, "zzz r u insane?"
matiko09: folds 
han3bj: folds 
*** FLOP *** [7c 9h Tc]
chaps1988: checks 
kblkxls said, "no but I use to play tennis for a while, except i wasnt very good"
tepi_guy has timed out
tepi_guy: checks 
*** TURN *** [7c 9h Tc] [9d]
chaps1988: bets $9.50
han3bj said, "nice logic"
tepi_guy: folds 
Uncalled bet ($9.50) returned to chaps1988
chaps1988 collected $14.25 from pot
*** SUMMARY ***
Total pot $15 | Rake $0.75 
Board [7c 9h Tc 9d]
Seat 1: CI58 (button) folded before Flop (didn't bet)
Seat 2: matiko09 (small blind) folded before Flop
Seat 3: han3bj (big blind) folded before Flop
Seat 4: Fitzyferret folded before Flop (didn't bet)
Seat 5: chaps1988 collected ($14.25)
Seat 6: PacPacBum folded before Flop (didn't bet)
Seat 7: patpaty folded before Flop (didn't bet)
Seat 8: tepi_guy folded on the Turn
Seat 9: kblkxls folded before Flop (didn't bet)





PokerStars Hand #152887194861:  Hold'em No Limit ($0.50/$1.00 USD) - 2016/05/05 17:07:06 CET [2016/05/05 11:07:06 ET]
Table 'Siberia' 9-max Seat #5 is the button
Seat 2: Painkiller72 ($107.50 in chips) 
Seat 3: sanpidk ($101.50 in chips) 
Seat 4: opsv ($59.50 in chips) 
Seat 5: Hayer ana ($100 in chips) 
Seat 6: bjonlyking ($110.95 in chips) 
Seat 7: matiko09 ($100 in chips) 
Seat 8: Vikulja1993 ($100 in chips) 
Seat 9: arctur17 ($120.02 in chips) 
bjonlyking: posts small blind $0.50
matiko09: posts big blind $1
Lycaon23: sits out 
*** HOLE CARDS ***
Dealt to matiko09 [Js Ah]
Vikulja1993: folds 
arctur17: folds 
Painkiller72: folds 
sanpidk: folds 
opsv: folds 
Hayer ana: folds 
bjonlyking: folds 
Uncalled bet ($0.50) returned to matiko09
matiko09 collected $1 from pot
matiko09: doesn't show hand 
*** SUMMARY ***
Total pot $1 | Rake $0 
Seat 2: Painkiller72 folded before Flop (didn't bet)
Seat 3: sanpidk folded before Flop (didn't bet)
Seat 4: opsv folded before Flop (didn't bet)
Seat 5: Hayer ana (button) folded before Flop (didn't bet)
Seat 6: bjonlyking (small blind) folded before Flop
Seat 7: matiko09 (big blind) collected ($1)
Seat 8: Vikulja1993 folded before Flop (didn't bet)
Seat 9: arctur17 folded before Flop (didn't bet)





PokerStars Hand #152887202320:  Hold'em No Limit ($1/$2 USD) - 2016/05/05 17:07:18 CET [2016/05/05 11:07:18 ET]
Table 'Tololo' 9-max Seat #4 is the button
Seat 1: Kukuryzka ($254.29 in chips) 
Seat 2: tepi_guy ($222.34 in chips) 
Seat 3: Khaine_CM ($200 in chips) 
Seat 4: mooose100 ($276.92 in chips) 
Seat 5: matiko09 ($215.70 in chips) 
Seat 6: Vikulja1993 ($203 in chips) 
Seat 7: chaps1988 ($336.12 in chips) 
Seat 8: myatiy 96 ($203 in chips) 
Seat 9: Fitzyferret ($378.53 in chips) 
matiko09: posts small blind $1
Vikulja1993: posts big blind $2
*** HOLE CARDS ***
Dealt to matiko09 [5c 3s]
chaps1988: folds 
myatiy 96: folds 
Fitzyferret: raises $3.24 to $5.24
Kukuryzka: folds 
tepi_guy: calls $5.24
Khaine_CM: raises $3.24 to $8.48
mooose100: folds 
matiko09: folds 
Vikulja1993: folds 
Fitzyferret: calls $3.24
tepi_guy: calls $3.24
*** FLOP *** [9c 8h 4s]
Fitzyferret: bets $14
tepi_guy: folds 
Khaine_CM: folds 
Uncalled bet ($14) returned to Fitzyferret
Fitzyferret collected $27.02 from pot
Fitzyferret: doesn't show hand 
*** SUMMARY ***
Total pot $28.44 | Rake $1.42 
Board [9c 8h 4s]
Seat 1: Kukuryzka folded before Flop (didn't bet)
Seat 2: tepi_guy folded on the Flop
Seat 3: Khaine_CM folded on the Flop
Seat 4: mooose100 (button) folded before Flop (didn't bet)
Seat 5: matiko09 (small blind) folded before Flop
Seat 6: Vikulja1993 (big blind) folded before Flop
Seat 7: chaps1988 folded before Flop (didn't bet)
Seat 8: myatiy 96 folded before Flop (didn't bet)
Seat 9: Fitzyferret collected ($27.02)





PokerStars Hand #152887215523:  Hold'em No Limit ($0.50/$1.00 USD) - 2016/05/05 17:07:40 CET [2016/05/05 11:07:40 ET]
Table 'Siberia' 9-max Seat #6 is the button
Seat 2: Painkiller72 ($107.50 in chips) 
Seat 3: sanpidk ($101.50 in chips) 
Seat 4: opsv ($59.50 in chips) 
Seat 5: Hayer ana ($100 in chips) 
Seat 6: bjonlyking ($110.45 in chips) 
Seat 7: matiko09 ($100.50 in chips) 
Seat 9: arctur17 ($120.02 in chips) 
matiko09: posts small blind $0.50
Vikulja1993: is sitting out 
Vikulja1993 leaves the table
arctur17: posts big blind $1
Lycaon23: sits out 
*** HOLE CARDS ***
Dealt to matiko09 [4c 4s]
Painkiller72: raises $1.50 to $2.50
janarr5 joins the table at seat #8 
sanpidk: folds 
opsv: folds 
Hayer ana: folds 
bjonlyking: folds 
matiko09: folds 
arctur17: folds 
Uncalled bet ($1.50) returned to Painkiller72
Painkiller72 collected $2.50 from pot
Painkiller72: doesn't show hand 
*** SUMMARY ***
Total pot $2.50 | Rake $0 
Seat 2: Painkiller72 collected ($2.50)
Seat 3: sanpidk folded before Flop (didn't bet)
Seat 4: opsv folded before Flop (didn't bet)
Seat 5: Hayer ana folded before Flop (didn't bet)
Seat 6: bjonlyking (button) folded before Flop (didn't bet)
Seat 7: matiko09 (small blind) folded before Flop
Seat 9: arctur17 (big blind) folded before Flop





PokerStars Hand #152887217922:  Hold'em No Limit (€1/€2 EUR) - 2016/05/05 17:07:44 CET [2016/05/05 11:07:44 ET]
Table 'Skat II' 9-max Seat #6 is the button
Seat 1: Vikulja1993 (€204.55 in chips) 
Seat 2: Fitzyferret (€260.84 in chips) 
Seat 3: Alex Frider (€204.59 in chips) 
Seat 4: JoaquinMRuiz (€200 in chips) 
Seat 5: ceedonen (€245.10 in chips) 
Seat 6: drissmouzou (€251.47 in chips) 
Seat 7: PacPacBum (€222.50 in chips) 
Seat 8: Painkiller72 (€209 in chips) 
Seat 9: matiko09 (€200 in chips) 
PacPacBum: posts small blind €1
Painkiller72: posts big blind €2
*** HOLE CARDS ***
Dealt to matiko09 [8c 9s]
matiko09: folds 
Vikulja1993: folds 
Fitzyferret: folds 
Alex Frider: folds 
JoaquinMRuiz: folds 
ceedonen: folds 
drissmouzou: raises €2 to €4
PacPacBum: folds 
Painkiller72: folds 
Uncalled bet (€2) returned to drissmouzou
drissmouzou collected €5 from pot
drissmouzou: doesn't show hand 
*** SUMMARY ***
Total pot €5 | Rake €0 
Seat 1: Vikulja1993 folded before Flop (didn't bet)
Seat 2: Fitzyferret folded before Flop (didn't bet)
Seat 3: Alex Frider folded before Flop (didn't bet)
Seat 4: JoaquinMRuiz folded before Flop (didn't bet)
Seat 5: ceedonen folded before Flop (didn't bet)
Seat 6: drissmouzou (button) collected (€5)
Seat 7: PacPacBum (small blind) folded before Flop
Seat 8: Painkiller72 (big blind) folded before Flop
Seat 9: matiko09 folded before Flop (didn't bet)





PokerStars Hand #152887223988:  Hold'em No Limit ($1/$2 USD) - 2016/05/05 17:07:54 CET [2016/05/05 11:07:54 ET]
Table 'Tatry II' 9-max Seat #5 is the button
Seat 3: matiko09 ($200 in chips) 
Seat 4: PacPacBum ($218.79 in chips) 
Seat 5: Painkiller72 ($285.75 in chips) 
Seat 6: Kukuryzka ($336.36 in chips) 
Seat 7: myatiy 96 ($202 in chips) 
Seat 8: chaps1988 ($255.54 in chips) 
Seat 9: korol702 ($207.45 in chips) 
Kukuryzka: posts small blind $1
myatiy 96: posts big blind $2
Alex Frider: sits out 
tepi_guy: sits out 
*** HOLE CARDS ***
Dealt to matiko09 [3s Ad]
chaps1988: folds 
korol702: raises $4 to $6
matiko09: folds 
PacPacBum: folds 
Painkiller72: folds 
Kukuryzka: folds 
myatiy 96: folds 
Uncalled bet ($4) returned to korol702
korol702 collected $5 from pot
korol702: doesn't show hand 
*** SUMMARY ***
Total pot $5 | Rake $0 
Seat 3: matiko09 folded before Flop (didn't bet)
Seat 4: PacPacBum folded before Flop (didn't bet)
Seat 5: Painkiller72 (button) folded before Flop (didn't bet)
Seat 6: Kukuryzka (small blind) folded before Flop
Seat 7: myatiy 96 (big blind) folded before Flop
Seat 8: chaps1988 folded before Flop (didn't bet)
Seat 9: korol702 collected ($5)





PokerStars Hand #152887226995:  Hold'em No Limit ($0.50/$1.00 USD) - 2016/05/05 17:07:58 CET [2016/05/05 11:07:58 ET]
Table 'Siberia' 9-max Seat #7 is the button
Seat 1: Lycaon23 ($100 in chips) 
Seat 2: Painkiller72 ($109 in chips) 
Seat 3: sanpidk ($101.50 in chips) 
Seat 4: opsv ($59.50 in chips) 
Seat 5: Hayer ana ($100 in chips) 
Seat 6: bjonlyking ($110.45 in chips) 
Seat 7: matiko09 ($100 in chips) 
Seat 9: arctur17 ($119.02 in chips) 
janarr5 will be allowed to play after the button
arctur17: posts small blind $0.50
Lycaon23: posts big blind $1
*** HOLE CARDS ***
Dealt to matiko09 [2d Kc]
Painkiller72: folds 
sanpidk: folds 
opsv: raises $1 to $2
Hayer ana: folds 
bjonlyking: folds 
matiko09: folds 
arctur17: calls $1.50
Lycaon23: calls $1
*** FLOP *** [6c Ts 8d]
arctur17: checks 
Lycaon23: checks 
opsv: checks 
*** TURN *** [6c Ts 8d] [4d]
arctur17: checks 
Lycaon23: bets $3
opsv: folds 
arctur17: folds 
Uncalled bet ($3) returned to Lycaon23
Lycaon23 collected $5.70 from pot
Lycaon23: doesn't show hand 
*** SUMMARY ***
Total pot $6 | Rake $0.30 
Board [6c Ts 8d 4d]
Seat 1: Lycaon23 (big blind) collected ($5.70)
Seat 2: Painkiller72 folded before Flop (didn't bet)
Seat 3: sanpidk folded before Flop (didn't bet)
Seat 4: opsv folded on the Turn
Seat 5: Hayer ana folded before Flop (didn't bet)
Seat 6: bjonlyking folded before Flop (didn't bet)
Seat 7: matiko09 (button) folded before Flop (didn't bet)
Seat 9: arctur17 (small blind) folded on the Turn





PokerStars Hand #152887238869:  Hold'em No Limit ($1/$2 USD) - 2016/05/05 17:08:18 CET [2016/05/05 11:08:18 ET]
Table 'Euporie II' 9-max Seat #1 is the button
Seat 1: PacPacBum ($200.20 in chips) 
Seat 2: kblkxls ($143.73 in chips) 
Seat 3: chaps1988 ($203 in chips) 
Seat 4: tepi_guy ($200 in chips) 
Seat 6: Kukuryzka ($205.43 in chips) 
Seat 7: matiko09 ($322 in chips) 
Seat 8: Painkiller72 ($304.68 in chips) 
Seat 9: myatiy 96 ($202 in chips) 
kblkxls: posts small blind $1
chaps1988: posts big blind $2
Alex Frider: sits out 
*** HOLE CARDS ***
Dealt to matiko09 [Th 6h]
kblkxls said, "YES!!"
kblkxls said, ":)"
tepi_guy: raises $3.40 to $5.40
Kukuryzka: folds 
matiko09: folds 
Painkiller72: folds 
myatiy 96: folds 
PacPacBum: folds 
kblkxls: folds 
chaps1988: folds 
Uncalled bet ($3.40) returned to tepi_guy
tepi_guy collected $5 from pot
tepi_guy: doesn't show hand 
*** SUMMARY ***
Total pot $5 | Rake $0 
Seat 1: PacPacBum (button) folded before Flop (didn't bet)
Seat 2: kblkxls (small blind) folded before Flop
Seat 3: chaps1988 (big blind) folded before Flop
Seat 4: tepi_guy collected ($5)
Seat 6: Kukuryzka folded before Flop (didn't bet)
Seat 7: matiko09 folded before Flop (didn't bet)
Seat 8: Painkiller72 folded before Flop (didn't bet)
Seat 9: myatiy 96 folded before Flop (didn't bet)





PokerStars Hand #152887239330:  Hold'em No Limit ($0.50/$1.00 USD) - 2016/05/05 17:08:19 CET [2016/05/05 11:08:19 ET]
Table 'Kraz II' 9-max Seat #5 is the button
Seat 1: HITYESCA ($141.30 in chips) 
Seat 2: Hayer ana ($210.50 in chips) 
Seat 3: Khaine_CM ($103.50 in chips) 
Seat 4: CI58 ($100 in chips) 
Seat 5: Alex Frider ($27.95 in chips) 
Seat 6: andy84lfc ($31.12 in chips) 
Seat 7: maxxmeister ($255.81 in chips) 
Seat 8: 178013 ($275.82 in chips) 
Seat 9: matiko09 ($178.87 in chips) 
andy84lfc: posts small blind $0.50
maxxmeister: posts big blind $1
*** HOLE CARDS ***
Dealt to matiko09 [Qs Td]
178013: raises $2 to $3
matiko09: folds 
HITYESCA: folds 
Hayer ana: folds 
Khaine_CM: calls $3
CI58: folds 
Alex Frider: folds 
andy84lfc: folds 
maxxmeister: folds 
*** FLOP *** [6c 7c Jh]
178013: bets $5
Khaine_CM: calls $5
*** TURN *** [6c 7c Jh] [6d]
178013: bets $9
Khaine_CM: calls $9
*** RIVER *** [6c 7c Jh 6d] [2h]
178013: checks 
Khaine_CM: checks 
*** SHOW DOWN ***
178013: shows [3c Ac] (a pair of Sixes)
Khaine_CM: mucks hand 
178013 collected $33.72 from pot
*** SUMMARY ***
Total pot $35.50 | Rake $1.78 
Board [6c 7c Jh 6d 2h]
Seat 1: HITYESCA folded before Flop (didn't bet)
Seat 2: Hayer ana folded before Flop (didn't bet)
Seat 3: Khaine_CM mucked [Tc Qc]
Seat 4: CI58 folded before Flop (didn't bet)
Seat 5: Alex Frider (button) folded before Flop (didn't bet)
Seat 6: andy84lfc (small blind) folded before Flop
Seat 7: maxxmeister (big blind) folded before Flop
Seat 8: 178013 showed [3c Ac] and won ($33.72) with a pair of Sixes
Seat 9: matiko09 folded before Flop (didn't bet)





PokerStars Hand #152887241581:  Hold'em No Limit ($1/$2 USD) - 2016/05/05 17:08:22 CET [2016/05/05 11:08:22 ET]
Table 'Samitchell' 9-max Seat #2 is the button
Seat 1: CI58 ($200 in chips) 
Seat 2: matiko09 ($282.71 in chips) 
Seat 3: han3bj ($245.77 in chips) 
Seat 4: Fitzyferret ($497.88 in chips) 
Seat 5: chaps1988 ($208.25 in chips) 
Seat 6: PacPacBum ($200 in chips) 
Seat 7: patpaty ($166.16 in chips) 
Seat 8: tepi_guy ($200 in chips) 
Seat 9: kblkxls ($107.15 in chips) 
han3bj: posts small blind $1
Fitzyferret: posts big blind $2
*** HOLE CARDS ***
Dealt to matiko09 [Qs 8c]
chaps1988: folds 
PacPacBum: folds 
patpaty: calls $2
tepi_guy: folds 
kblkxls: folds 
kblkxls said, "are you mocking me?"
kblkxls said, "because I feel that I am being mocked."
CI58: folds 
matiko09: raises $6 to $8
han3bj: folds 
Fitzyferret: folds 
patpaty: calls $6
*** FLOP *** [9s 8h Ks]
han3bj said, "lol"
patpaty: checks 
kblkxls said, "mate seriously though Im just really trying to entertain myself."
matiko09: checks 
*** TURN *** [9s 8h Ks] [9c]
han3bj said, "u r a strange guy"
patpaty: bets $2
matiko09: raises $4 to $6
patpaty: calls $4
*** RIVER *** [9s 8h Ks 9c] [3c]
patpaty: checks 
matiko09: checks 
*** SHOW DOWN ***
patpaty: shows [Jc Js] (two pair, Jacks and Nines)
matiko09: mucks hand 
patpaty collected $29.45 from pot
*** SUMMARY ***
Total pot $31 | Rake $1.55 
Board [9s 8h Ks 9c 3c]
Seat 1: CI58 folded before Flop (didn't bet)
Seat 2: matiko09 (button) mucked [Qs 8c]
Seat 3: han3bj (small blind) folded before Flop
Seat 4: Fitzyferret (big blind) folded before Flop
Seat 5: chaps1988 folded before Flop (didn't bet)
Seat 6: PacPacBum folded before Flop (didn't bet)
Seat 7: patpaty showed [Jc Js] and won ($29.45) with two pair, Jacks and Nines
Seat 8: tepi_guy folded before Flop (didn't bet)
Seat 9: kblkxls folded before Flop (didn't bet)





PokerStars Hand #152887245753:  Hold'em No Limit ($1/$2 USD) - 2016/05/05 17:08:29 CET [2016/05/05 11:08:29 ET]
Table 'Tatry II' 9-max Seat #6 is the button
Seat 3: matiko09 ($200 in chips) 
Seat 4: PacPacBum ($218.79 in chips) 
Seat 5: Painkiller72 ($285.75 in chips) 
Seat 6: Kukuryzka ($335.36 in chips) 
Seat 7: myatiy 96 ($200 in chips) 
Seat 8: chaps1988 ($255.54 in chips) 
Seat 9: korol702 ($210.45 in chips) 
myatiy 96: posts small blind $1
chaps1988: posts big blind $2
Alex Frider: sits out 
tepi_guy: sits out 
*** HOLE CARDS ***
Dealt to matiko09 [Qh Kd]
korol702: folds 
matiko09: raises $3 to $5
PacPacBum: folds 
Painkiller72: folds 
Kukuryzka: raises $13 to $18
myatiy 96: folds 
chaps1988: folds 
matiko09: folds 
Uncalled bet ($13) returned to Kukuryzka
Kukuryzka collected $13 from pot
Kukuryzka: doesn't show hand 
*** SUMMARY ***
Total pot $13 | Rake $0 
Seat 3: matiko09 folded before Flop
Seat 4: PacPacBum folded before Flop (didn't bet)
Seat 5: Painkiller72 folded before Flop (didn't bet)
Seat 6: Kukuryzka (button) collected ($13)
Seat 7: myatiy 96 (small blind) folded before Flop
Seat 8: chaps1988 (big blind) folded before Flop
Seat 9: korol702 folded before Flop (didn't bet)





PokerStars Hand #152887252451:  Hold'em No Limit ($1/$2 USD) - 2016/05/05 17:08:40 CET [2016/05/05 11:08:40 ET]
Table 'Tololo' 9-max Seat #5 is the button
Seat 1: Kukuryzka ($254.29 in chips) 
Seat 2: tepi_guy ($213.86 in chips) 
Seat 3: Khaine_CM ($200 in chips) 
Seat 4: mooose100 ($276.92 in chips) 
Seat 5: matiko09 ($214.70 in chips) 
Seat 6: Vikulja1993 ($201 in chips) 
Seat 7: chaps1988 ($336.12 in chips) 
Seat 8: myatiy 96 ($203 in chips) 
Seat 9: Fitzyferret ($397.07 in chips) 
Vikulja1993: posts small blind $1
chaps1988: posts big blind $2
*** HOLE CARDS ***
Dealt to matiko09 [As 9c]
myatiy 96: folds 
Fitzyferret: folds 
Kukuryzka: folds 
tepi_guy: folds 
Khaine_CM: raises $4 to $6
mooose100: folds 
matiko09: folds 
Vikulja1993: folds 
chaps1988: folds 
Uncalled bet ($4) returned to Khaine_CM
Khaine_CM collected $5 from pot
Khaine_CM: doesn't show hand 
*** SUMMARY ***
Total pot $5 | Rake $0 
Seat 1: Kukuryzka folded before Flop (didn't bet)
Seat 2: tepi_guy folded before Flop (didn't bet)
Seat 3: Khaine_CM collected ($5)
Seat 4: mooose100 folded before Flop (didn't bet)
Seat 5: matiko09 (button) folded before Flop (didn't bet)
Seat 6: Vikulja1993 (small blind) folded before Flop
Seat 7: chaps1988 (big blind) folded before Flop
Seat 8: myatiy 96 folded before Flop (didn't bet)
Seat 9: Fitzyferret folded before Flop (didn't bet)





PokerStars Hand #152887254837:  Hold'em No Limit (€1/€2 EUR) - 2016/05/05 17:08:43 CET [2016/05/05 11:08:43 ET]
Table 'Skat II' 9-max Seat #7 is the button
Seat 1: Vikulja1993 (€204.55 in chips) 
Seat 2: Fitzyferret (€260.84 in chips) 
Seat 3: Alex Frider (€204.59 in chips) 
Seat 4: JoaquinMRuiz (€200 in chips) 
Seat 5: ceedonen (€245.10 in chips) 
Seat 6: drissmouzou (€254.47 in chips) 
Seat 7: PacPacBum (€221.50 in chips) 
Seat 8: Painkiller72 (€207 in chips) 
Seat 9: matiko09 (€200 in chips) 
Painkiller72: posts small blind €1
matiko09: posts big blind €2
*** HOLE CARDS ***
Dealt to matiko09 [3s Kc]
Vikulja1993: raises €4 to €6
Fitzyferret: folds 
Alex Frider: folds 
JoaquinMRuiz: folds 
ceedonen: folds 
drissmouzou: folds 
PacPacBum: folds 
Painkiller72: folds 
matiko09: folds 
Uncalled bet (€4) returned to Vikulja1993
Vikulja1993 collected €5 from pot
Vikulja1993: doesn't show hand 
*** SUMMARY ***
Total pot €5 | Rake €0 
Seat 1: Vikulja1993 collected (€5)
Seat 2: Fitzyferret folded before Flop (didn't bet)
Seat 3: Alex Frider folded before Flop (didn't bet)
Seat 4: JoaquinMRuiz folded before Flop (didn't bet)
Seat 5: ceedonen folded before Flop (didn't bet)
Seat 6: drissmouzou folded before Flop (didn't bet)
Seat 7: PacPacBum (button) folded before Flop (didn't bet)
Seat 8: Painkiller72 (small blind) folded before Flop
Seat 9: matiko09 (big blind) folded before Flop





PokerStars Hand #152887268459:  Hold'em No Limit ($0.50/$1.00 USD) - 2016/05/05 17:09:05 CET [2016/05/05 11:09:05 ET]
Table 'Siberia' 9-max Seat #9 is the button
Seat 1: Lycaon23 ($103.70 in chips) 
Seat 4: opsv ($57.50 in chips) 
Seat 5: Hayer ana ($100 in chips) 
Seat 6: bjonlyking ($110.45 in chips) 
Seat 7: matiko09 ($100 in chips) 
Seat 9: arctur17 ($117.02 in chips) 
Lycaon23: posts small blind $0.50
Painkiller72: is sitting out 
Painkiller72 leaves the table
sanpidk: is sitting out 
opsv: posts big blind $1
janarr5: sits out 
*** HOLE CARDS ***
Dealt to matiko09 [Ad 6s]
sanpidk leaves the table
Hayer ana: folds 
bjonlyking: folds 
matiko09: folds 
arctur17: raises $1 to $2
Lycaon23: folds 
opsv: calls $1
*** FLOP *** [Ac Kh 2h]
opsv: checks 
arctur17: checks 
*** TURN *** [Ac Kh 2h] [6d]
opsv: checks 
arctur17: checks 
*** RIVER *** [Ac Kh 2h 6d] [Kd]
opsv: bets $3
arctur17: folds 
Uncalled bet ($3) returned to opsv
opsv collected $4.28 from pot
*** SUMMARY ***
Total pot $4.50 | Rake $0.22 
Board [Ac Kh 2h 6d Kd]
Seat 1: Lycaon23 (small blind) folded before Flop
Seat 4: opsv (big blind) collected ($4.28)
Seat 5: Hayer ana folded before Flop (didn't bet)
Seat 6: bjonlyking folded before Flop (didn't bet)
Seat 7: matiko09 folded before Flop (didn't bet)
Seat 9: arctur17 (button) folded on the River





PokerStars Hand #152887271514:  Hold'em No Limit ($1/$2 USD) - 2016/05/05 17:09:10 CET [2016/05/05 11:09:10 ET]
Table 'Euporie II' 9-max Seat #2 is the button
Seat 1: PacPacBum ($200.20 in chips) 
Seat 2: kblkxls ($142.73 in chips) 
Seat 3: chaps1988 ($201 in chips) 
Seat 4: tepi_guy ($203 in chips) 
Seat 6: Kukuryzka ($205.43 in chips) 
Seat 7: matiko09 ($322 in chips) 
Seat 8: Painkiller72 ($304.68 in chips) 
Seat 9: myatiy 96 ($202 in chips) 
chaps1988: posts small blind $1
tepi_guy: posts big blind $2
Alex Frider: sits out 
*** HOLE CARDS ***
Dealt to matiko09 [5c 2c]
Kukuryzka: folds 
matiko09: folds 
Painkiller72: folds 
myatiy 96: folds 
PacPacBum: folds 
kblkxls: raises $2 to $4
chaps1988: folds 
tepi_guy: raises $10 to $14
kblkxls: folds [Ks]
Uncalled bet ($10) returned to tepi_guy
tepi_guy collected $9 from pot
tepi_guy: doesn't show hand 
*** SUMMARY ***
Total pot $9 | Rake $0 
Seat 1: PacPacBum folded before Flop (didn't bet)
Seat 2: kblkxls (button) folded before Flop
Seat 3: chaps1988 (small blind) folded before Flop
Seat 4: tepi_guy (big blind) collected ($9)
Seat 6: Kukuryzka folded before Flop (didn't bet)
Seat 7: matiko09 folded before Flop (didn't bet)
Seat 8: Painkiller72 folded before Flop (didn't bet)
Seat 9: myatiy 96 folded before Flop (didn't bet)





PokerStars Hand #152887273736:  Hold'em No Limit (€1/€2 EUR) - 2016/05/05 17:09:14 CET [2016/05/05 11:09:14 ET]
Table 'Skat II' 9-max Seat #8 is the button
Seat 1: Vikulja1993 (€207.55 in chips) 
Seat 2: Fitzyferret (€260.84 in chips) 
Seat 3: Alex Frider (€204.59 in chips) 
Seat 4: JoaquinMRuiz (€200 in chips) 
Seat 5: ceedonen (€245.10 in chips) 
Seat 6: drissmouzou (€254.47 in chips) 
Seat 7: PacPacBum (€221.50 in chips) 
Seat 8: Painkiller72 (€206 in chips) 
Seat 9: matiko09 (€200 in chips) 
matiko09: posts small blind €1
Vikulja1993: posts big blind €2
*** HOLE CARDS ***
Dealt to matiko09 [8s Tc]
Fitzyferret: folds 
Alex Frider: folds 
JoaquinMRuiz: folds 
ceedonen: folds 
drissmouzou: folds 
PacPacBum: raises €3 to €5
Painkiller72: folds 
matiko09: folds 
Vikulja1993: raises €13 to €18
PacPacBum: folds 
Uncalled bet (€13) returned to Vikulja1993
Vikulja1993 collected €11 from pot
Vikulja1993: doesn't show hand 
*** SUMMARY ***
Total pot €11 | Rake €0 
Seat 1: Vikulja1993 (big blind) collected (€11)
Seat 2: Fitzyferret folded before Flop (didn't bet)
Seat 3: Alex Frider folded before Flop (didn't bet)
Seat 4: JoaquinMRuiz folded before Flop (didn't bet)
Seat 5: ceedonen folded before Flop (didn't bet)
Seat 6: drissmouzou folded before Flop (didn't bet)
Seat 7: PacPacBum folded before Flop
Seat 8: Painkiller72 (button) folded before Flop (didn't bet)
Seat 9: matiko09 (small blind) folded before Flop





PokerStars Hand #152887279069:  Hold'em No Limit ($1/$2 USD) - 2016/05/05 17:09:23 CET [2016/05/05 11:09:23 ET]
Table 'Tatry II' 9-max Seat #7 is the button
Seat 3: matiko09 ($200 in chips) 
Seat 4: PacPacBum ($218.79 in chips) 
Seat 5: Painkiller72 ($285.75 in chips) 
Seat 6: Kukuryzka ($343.36 in chips) 
Seat 7: myatiy 96 ($200 in chips) 
Seat 8: chaps1988 ($253.54 in chips) 
Seat 9: korol702 ($210.45 in chips) 
chaps1988: posts small blind $1
korol702: posts big blind $2
Alex Frider: sits out 
tepi_guy: sits out 
*** HOLE CARDS ***
Dealt to matiko09 [5h 3d]
matiko09: folds 
PacPacBum: folds 
Painkiller72: folds 
Kukuryzka: raises $3 to $5
myatiy 96: folds 
chaps1988: folds 
korol702: raises $7 to $12
Kukuryzka: folds 
Uncalled bet ($7) returned to korol702
korol702 collected $11 from pot
korol702: doesn't show hand 
*** SUMMARY ***
Total pot $11 | Rake $0 
Seat 3: matiko09 folded before Flop (didn't bet)
Seat 4: PacPacBum folded before Flop (didn't bet)
Seat 5: Painkiller72 folded before Flop (didn't bet)
Seat 6: Kukuryzka folded before Flop
Seat 7: myatiy 96 (button) folded before Flop (didn't bet)
Seat 8: chaps1988 (small blind) folded before Flop
Seat 9: korol702 (big blind) collected ($11)





PokerStars Hand #152887290168:  Hold'em No Limit ($1/$2 USD) - 2016/05/05 17:09:41 CET [2016/05/05 11:09:41 ET]
Table 'Tololo' 9-max Seat #6 is the button
Seat 1: Kukuryzka ($254.29 in chips) 
Seat 2: tepi_guy ($213.86 in chips) 
Seat 3: Khaine_CM ($203 in chips) 
Seat 4: mooose100 ($276.92 in chips) 
Seat 5: matiko09 ($214.70 in chips) 
Seat 6: Vikulja1993 ($200 in chips) 
Seat 7: chaps1988 ($334.12 in chips) 
Seat 8: myatiy 96 ($203 in chips) 
Seat 9: Fitzyferret ($397.07 in chips) 
chaps1988: posts small blind $1
myatiy 96: posts big blind $2
*** HOLE CARDS ***
Dealt to matiko09 [Qs Td]
Fitzyferret: folds 
Kukuryzka: folds 
tepi_guy: folds 
Khaine_CM: folds 
mooose100: folds 
matiko09: raises $3 to $5
Vikulja1993: folds 
chaps1988: folds 
myatiy 96: folds 
Uncalled bet ($3) returned to matiko09
matiko09 collected $5 from pot
matiko09: doesn't show hand 
*** SUMMARY ***
Total pot $5 | Rake $0 
Seat 1: Kukuryzka folded before Flop (didn't bet)
Seat 2: tepi_guy folded before Flop (didn't bet)
Seat 3: Khaine_CM folded before Flop (didn't bet)
Seat 4: mooose100 folded before Flop (didn't bet)
Seat 5: matiko09 collected ($5)
Seat 6: Vikulja1993 (button) folded before Flop (didn't bet)
Seat 7: chaps1988 (small blind) folded before Flop
Seat 8: myatiy 96 (big blind) folded before Flop
Seat 9: Fitzyferret folded before Flop (didn't bet)





PokerStars Hand #152887292462:  Hold'em No Limit ($0.50/$1.00 USD) - 2016/05/05 17:09:44 CET [2016/05/05 11:09:44 ET]
Table 'Siberia' 9-max Seat #1 is the button
Seat 1: Lycaon23 ($103.20 in chips) 
Seat 4: opsv ($59.78 in chips) 
Seat 5: Hayer ana ($100 in chips) 
Seat 6: bjonlyking ($110.45 in chips) 
Seat 7: matiko09 ($100 in chips) 
Seat 9: arctur17 ($115.02 in chips) 
opsv: posts small blind $0.50
Hayer ana: posts big blind $1
janarr5: sits out 
*** HOLE CARDS ***
Dealt to matiko09 [8c 5d]
bjonlyking: calls $1
matiko09: folds 
arctur17: calls $1
Lycaon23: folds 
opsv: folds 
Hayer ana: checks 
*** FLOP *** [5h Kh Qd]
janarr5 leaves the table
Hayer ana: checks 
bjonlyking: bets $4
arctur17: calls $4
Hayer ana: folds 
*** TURN *** [5h Kh Qd] [9h]
bjonlyking: checks 
arctur17: checks 
*** RIVER *** [5h Kh Qd 9h] [Ah]
bjonlyking: bets $11
Mukhin1 joins the table at seat #2 
arctur17: folds 
Uncalled bet ($11) returned to bjonlyking
bjonlyking collected $10.92 from pot
bjonlyking: doesn't show hand 
*** SUMMARY ***
Total pot $11.50 | Rake $0.58 
Board [5h Kh Qd 9h Ah]
Seat 1: Lycaon23 (button) folded before Flop (didn't bet)
Seat 4: opsv (small blind) folded before Flop
Seat 5: Hayer ana (big blind) folded on the Flop
Seat 6: bjonlyking collected ($10.92)
Seat 7: matiko09 folded before Flop (didn't bet)
Seat 9: arctur17 folded on the River





PokerStars Hand #152887293851:  Hold'em No Limit (€1/€2 EUR) - 2016/05/05 17:09:47 CET [2016/05/05 11:09:47 ET]
Table 'Skat II' 9-max Seat #9 is the button
Seat 1: Vikulja1993 (€213.55 in chips) 
Seat 2: Fitzyferret (€260.84 in chips) 
Seat 3: Alex Frider (€204.59 in chips) 
Seat 4: JoaquinMRuiz (€200 in chips) 
Seat 5: ceedonen (€245.10 in chips) 
Seat 6: drissmouzou (€254.47 in chips) 
Seat 7: PacPacBum (€216.50 in chips) 
Seat 8: Painkiller72 (€206 in chips) 
Seat 9: matiko09 (€200 in chips) 
Vikulja1993: posts small blind €1
Fitzyferret: posts big blind €2
*** HOLE CARDS ***
Dealt to matiko09 [4d Kh]
Alex Frider: raises €2 to €4
JoaquinMRuiz: folds 
ceedonen: calls €4
drissmouzou: folds 
PacPacBum: folds 
Painkiller72: folds 
matiko09: folds 
Vikulja1993: folds 
Fitzyferret: folds 
*** FLOP *** [3c Ah Ts]
Alex Frider: bets €6
ceedonen: calls €6
*** TURN *** [3c Ah Ts] [Th]
Alex Frider: bets €12
ceedonen: folds 
Uncalled bet (€12) returned to Alex Frider
Alex Frider collected €21.85 from pot
Alex Frider: doesn't show hand 
*** SUMMARY ***
Total pot €23 | Rake €1.15 
Board [3c Ah Ts Th]
Seat 1: Vikulja1993 (small blind) folded before Flop
Seat 2: Fitzyferret (big blind) folded before Flop
Seat 3: Alex Frider collected (€21.85)
Seat 4: JoaquinMRuiz folded before Flop (didn't bet)
Seat 5: ceedonen folded on the Turn
Seat 6: drissmouzou folded before Flop (didn't bet)
Seat 7: PacPacBum folded before Flop (didn't bet)
Seat 8: Painkiller72 folded before Flop (didn't bet)
Seat 9: matiko09 (button) folded before Flop (didn't bet)





PokerStars Hand #152887294193:  Hold'em No Limit ($1/$2 USD) - 2016/05/05 17:09:47 CET [2016/05/05 11:09:47 ET]
Table 'Euporie II' 9-max Seat #3 is the button
Seat 1: PacPacBum ($200.20 in chips) 
Seat 2: kblkxls ($138.73 in chips) 
Seat 3: chaps1988 ($200 in chips) 
Seat 4: tepi_guy ($208 in chips) 
Seat 5: Alex Frider ($200 in chips) 
Seat 6: Kukuryzka ($205.43 in chips) 
Seat 7: matiko09 ($322 in chips) 
Seat 8: Painkiller72 ($304.68 in chips) 
Seat 9: myatiy 96 ($202 in chips) 
tepi_guy: posts small blind $1
Alex Frider: posts big blind $2
*** HOLE CARDS ***
Dealt to matiko09 [Ac 4d]
Kukuryzka: folds 
Kukuryzka leaves the table
matiko09: folds 
Vikulja1993 joins the table at seat #6 
Painkiller72: folds 
myatiy 96: folds 
PacPacBum: folds 
Vikulja1993 leaves the table
kblkxls: raises $4 to $6
chaps1988: folds 
Fitzyferret joins the table at seat #6 
tepi_guy: folds 
Alex Frider: raises $13 to $19
kblkxls: calls $13
*** FLOP *** [As Jd 3h]
Alex Frider: bets $18
kblkxls: folds [Kc Js]
Uncalled bet ($18) returned to Alex Frider
Alex Frider collected $37.05 from pot
Alex Frider: doesn't show hand 
*** SUMMARY ***
Total pot $39 | Rake $1.95 
Board [As Jd 3h]
Seat 1: PacPacBum folded before Flop (didn't bet)
Seat 2: kblkxls folded on the Flop
Seat 3: chaps1988 (button) folded before Flop (didn't bet)
Seat 4: tepi_guy (small blind) folded before Flop
Seat 5: Alex Frider (big blind) collected ($37.05)
Seat 6: Kukuryzka folded before Flop (didn't bet)
Seat 7: matiko09 folded before Flop (didn't bet)
Seat 8: Painkiller72 folded before Flop (didn't bet)
Seat 9: myatiy 96 folded before Flop (didn't bet)





PokerStars Hand #152887299829:  Hold'em No Limit ($0.50/$1.00 USD) - 2016/05/05 17:09:56 CET [2016/05/05 11:09:56 ET]
Table 'Kraz II' 9-max Seat #6 is the button
Seat 1: HITYESCA ($141.30 in chips) 
Seat 2: Hayer ana ($210.50 in chips) 
Seat 3: Khaine_CM ($100 in chips) 
Seat 4: CI58 ($100 in chips) 
Seat 5: Alex Frider ($27.95 in chips) 
Seat 6: andy84lfc ($30.62 in chips) 
Seat 7: maxxmeister ($254.81 in chips) 
Seat 8: 178013 ($292.54 in chips) 
Seat 9: matiko09 ($178.87 in chips) 
maxxmeister: posts small blind $0.50
178013: posts big blind $1
*** HOLE CARDS ***
Dealt to matiko09 [6c 4h]
matiko09: folds 
HITYESCA: folds 
Hayer ana: raises $2 to $3
Khaine_CM: folds 
CI58: folds 
Alex Frider: folds 
andy84lfc: calls $3
maxxmeister: folds 
178013: folds 
*** FLOP *** [8c Jd 3c]
Hayer ana: bets $4
andy84lfc: calls $4
*** TURN *** [8c Jd 3c] [8h]
Hayer ana: checks 
andy84lfc: checks 
*** RIVER *** [8c Jd 3c 8h] [As]
Hayer ana: bets $7.80
andy84lfc: folds 
Uncalled bet ($7.80) returned to Hayer ana
Hayer ana collected $14.72 from pot
Hayer ana: doesn't show hand 
*** SUMMARY ***
Total pot $15.50 | Rake $0.78 
Board [8c Jd 3c 8h As]
Seat 1: HITYESCA folded before Flop (didn't bet)
Seat 2: Hayer ana collected ($14.72)
Seat 3: Khaine_CM folded before Flop (didn't bet)
Seat 4: CI58 folded before Flop (didn't bet)
Seat 5: Alex Frider folded before Flop (didn't bet)
Seat 6: andy84lfc (button) folded on the River
Seat 7: maxxmeister (small blind) folded before Flop
Seat 8: 178013 (big blind) folded before Flop
Seat 9: matiko09 folded before Flop (didn't bet)





PokerStars Hand #152887300902:  Hold'em No Limit ($1/$2 USD) - 2016/05/05 17:09:58 CET [2016/05/05 11:09:58 ET]
Table 'Samitchell' 9-max Seat #3 is the button
Seat 1: CI58 ($200 in chips) 
Seat 2: matiko09 ($268.71 in chips) 
Seat 3: han3bj ($244.77 in chips) 
Seat 4: Fitzyferret ($495.88 in chips) 
Seat 5: chaps1988 ($208.25 in chips) 
Seat 6: PacPacBum ($200 in chips) 
Seat 7: patpaty ($181.61 in chips) 
Seat 8: tepi_guy ($200 in chips) 
Seat 9: kblkxls ($107.15 in chips) 
Fitzyferret: posts small blind $1
chaps1988: posts big blind $2
*** HOLE CARDS ***
Dealt to matiko09 [9s Td]
PacPacBum: folds 
kblkxls said, "do you want to play tennis some time?"
kblkxls said, "how big is your serve?"
patpaty: folds 
tepi_guy: folds 
kblkxls: raises $4 to $6
CI58: folds 
matiko09: folds 
han3bj: folds 
Fitzyferret: folds 
han3bj said, "go find someone else to talk"
chaps1988: folds 
Uncalled bet ($4) returned to kblkxls
kblkxls collected $5 from pot
kblkxls: doesn't show hand 
*** SUMMARY ***
Total pot $5 | Rake $0 
Seat 1: CI58 folded before Flop (didn't bet)
Seat 2: matiko09 folded before Flop (didn't bet)
Seat 3: han3bj (button) folded before Flop (didn't bet)
Seat 4: Fitzyferret (small blind) folded before Flop
Seat 5: chaps1988 (big blind) folded before Flop
Seat 6: PacPacBum folded before Flop (didn't bet)
Seat 7: patpaty folded before Flop (didn't bet)
Seat 8: tepi_guy folded before Flop (didn't bet)
Seat 9: kblkxls collected ($5)





PokerStars Hand #152887308095:  Hold'em No Limit ($1/$2 USD) - 2016/05/05 17:10:09 CET [2016/05/05 11:10:09 ET]
Table 'Tatry II' 9-max Seat #8 is the button
Seat 1: Alex Frider ($200 in chips) 
Seat 3: matiko09 ($200 in chips) 
Seat 4: PacPacBum ($218.79 in chips) 
Seat 5: Painkiller72 ($285.75 in chips) 
Seat 6: Kukuryzka ($338.36 in chips) 
Seat 7: myatiy 96 ($200 in chips) 
Seat 8: chaps1988 ($252.54 in chips) 
Seat 9: korol702 ($216.45 in chips) 
korol702: posts small blind $1
Alex Frider: posts big blind $2
tepi_guy: sits out 
*** HOLE CARDS ***
Dealt to matiko09 [Ah 6s]
matiko09: folds 
PacPacBum: folds 
Painkiller72: folds 
Kukuryzka: folds 
myatiy 96: raises $3.70 to $5.70
chaps1988: folds 
korol702: folds 
Alex Frider: folds 
Uncalled bet ($3.70) returned to myatiy 96
myatiy 96 collected $5 from pot
myatiy 96: doesn't show hand 
*** SUMMARY ***
Total pot $5 | Rake $0 
Seat 1: Alex Frider (big blind) folded before Flop
Seat 3: matiko09 folded before Flop (didn't bet)
Seat 4: PacPacBum folded before Flop (didn't bet)
Seat 5: Painkiller72 folded before Flop (didn't bet)
Seat 6: Kukuryzka folded before Flop (didn't bet)
Seat 7: myatiy 96 collected ($5)
Seat 8: chaps1988 (button) folded before Flop (didn't bet)
Seat 9: korol702 (small blind) folded before Flop





PokerStars Hand #152887320887:  Hold'em No Limit ($1/$2 USD) - 2016/05/05 17:10:30 CET [2016/05/05 11:10:30 ET]
Table 'Tololo' 9-max Seat #7 is the button
Seat 1: Kukuryzka ($254.29 in chips) 
Seat 2: tepi_guy ($213.86 in chips) 
Seat 3: Khaine_CM ($203 in chips) 
Seat 4: mooose100 ($276.92 in chips) 
Seat 5: matiko09 ($217.70 in chips) 
Seat 6: Vikulja1993 ($200 in chips) 
Seat 7: chaps1988 ($333.12 in chips) 
Seat 8: myatiy 96 ($201 in chips) 
Seat 9: Fitzyferret ($397.07 in chips) 
myatiy 96: posts small blind $1
Fitzyferret: posts big blind $2
*** HOLE CARDS ***
Dealt to matiko09 [Ad 2d]
Kukuryzka: folds 
tepi_guy has timed out
tepi_guy: folds 
Khaine_CM: folds 
mooose100: calls $2
matiko09: raises $6 to $8
Vikulja1993: folds 
chaps1988: folds 
myatiy 96: folds 
Fitzyferret: folds 
mooose100: calls $6
*** FLOP *** [4s Kh 4d]
mooose100: bets $9.02
matiko09: folds 
Uncalled bet ($9.02) returned to mooose100
mooose100 collected $18.05 from pot
mooose100: doesn't show hand 
*** SUMMARY ***
Total pot $19 | Rake $0.95 
Board [4s Kh 4d]
Seat 1: Kukuryzka folded before Flop (didn't bet)
Seat 2: tepi_guy folded before Flop (didn't bet)
Seat 3: Khaine_CM folded before Flop (didn't bet)
Seat 4: mooose100 collected ($18.05)
Seat 5: matiko09 folded on the Flop
Seat 6: Vikulja1993 folded before Flop (didn't bet)
Seat 7: chaps1988 (button) folded before Flop (didn't bet)
Seat 8: myatiy 96 (small blind) folded before Flop
Seat 9: Fitzyferret (big blind) folded before Flop





PokerStars Hand #152887326840:  Hold'em No Limit ($1/$2 USD) - 2016/05/05 17:10:39 CET [2016/05/05 11:10:39 ET]
Table 'Tatry II' 9-max Seat #9 is the button
Seat 1: Alex Frider ($198 in chips) 
Seat 2: tepi_guy ($200 in chips) 
Seat 3: matiko09 ($200 in chips) 
Seat 4: PacPacBum ($218.79 in chips) 
Seat 5: Painkiller72 ($285.75 in chips) 
Seat 6: Kukuryzka ($338.36 in chips) 
Seat 7: myatiy 96 ($203 in chips) 
Seat 8: chaps1988 ($252.54 in chips) 
Seat 9: korol702 ($215.45 in chips) 
Alex Frider: posts small blind $1
tepi_guy: posts big blind $2
*** HOLE CARDS ***
Dealt to matiko09 [As 2c]
matiko09: folds 
PacPacBum: folds 
Painkiller72: folds 
Kukuryzka: folds 
myatiy 96: raises $4 to $6
chaps1988: folds 
korol702: calls $6
Alex Frider: folds 
tepi_guy: calls $4
*** FLOP *** [Qs Ac Kh]
tepi_guy: checks 
myatiy 96: bets $13.53
korol702: folds 
tepi_guy: folds 
Uncalled bet ($13.53) returned to myatiy 96
myatiy 96 collected $18.05 from pot
myatiy 96: doesn't show hand 
*** SUMMARY ***
Total pot $19 | Rake $0.95 
Board [Qs Ac Kh]
Seat 1: Alex Frider (small blind) folded before Flop
Seat 2: tepi_guy (big blind) folded on the Flop
Seat 3: matiko09 folded before Flop (didn't bet)
Seat 4: PacPacBum folded before Flop (didn't bet)
Seat 5: Painkiller72 folded before Flop (didn't bet)
Seat 6: Kukuryzka folded before Flop (didn't bet)
Seat 7: myatiy 96 collected ($18.05)
Seat 8: chaps1988 folded before Flop (didn't bet)
Seat 9: korol702 (button) folded on the Flop





PokerStars Hand #152887332944:  Hold'em No Limit ($1/$2 USD) - 2016/05/05 17:10:49 CET [2016/05/05 11:10:49 ET]
Table 'Samitchell' 9-max Seat #4 is the button
Seat 1: CI58 ($200 in chips) 
Seat 2: matiko09 ($268.71 in chips) 
Seat 3: han3bj ($244.77 in chips) 
Seat 4: Fitzyferret ($494.88 in chips) 
Seat 5: chaps1988 ($206.25 in chips) 
Seat 6: PacPacBum ($200 in chips) 
Seat 7: patpaty ($181.61 in chips) 
Seat 8: tepi_guy ($200 in chips) 
Seat 9: kblkxls ($110.15 in chips) 
chaps1988: posts small blind $1
PacPacBum: posts big blind $2
*** HOLE CARDS ***
Dealt to matiko09 [Kd 8h]
patpaty: folds 
tepi_guy: folds 
kblkxls: folds 
CI58: folds 
matiko09: folds 
han3bj: folds 
Fitzyferret: raises $2.60 to $4.60
chaps1988: folds 
PacPacBum: folds 
Uncalled bet ($2.60) returned to Fitzyferret
Fitzyferret collected $5 from pot
Fitzyferret: doesn't show hand 
*** SUMMARY ***
Total pot $5 | Rake $0 
Seat 1: CI58 folded before Flop (didn't bet)
Seat 2: matiko09 folded before Flop (didn't bet)
Seat 3: han3bj folded before Flop (didn't bet)
Seat 4: Fitzyferret (button) collected ($5)
Seat 5: chaps1988 (small blind) folded before Flop
Seat 6: PacPacBum (big blind) folded before Flop
Seat 7: patpaty folded before Flop (didn't bet)
Seat 8: tepi_guy folded before Flop (didn't bet)
Seat 9: kblkxls folded before Flop (didn't bet)





PokerStars Hand #152887348721:  Hold'em No Limit ($0.50/$1.00 USD) - 2016/05/05 17:11:14 CET [2016/05/05 11:11:14 ET]
Table 'Kraz II' 9-max Seat #7 is the button
Seat 1: HITYESCA ($141.30 in chips) 
Seat 2: Hayer ana ($218.22 in chips) 
Seat 3: Khaine_CM ($100 in chips) 
Seat 4: CI58 ($100 in chips) 
Seat 5: Alex Frider ($27.95 in chips) 
Seat 6: andy84lfc ($23.62 in chips) 
Seat 7: maxxmeister ($254.31 in chips) 
Seat 8: 178013 ($291.54 in chips) 
Seat 9: matiko09 ($178.87 in chips) 
178013: posts small blind $0.50
matiko09: posts big blind $1
*** HOLE CARDS ***
Dealt to matiko09 [Ah 5d]
HITYESCA: folds 
Hayer ana: folds 
Khaine_CM: folds 
CI58: folds 
Alex Frider: folds 
andy84lfc: raises $2 to $3
maxxmeister: folds 
178013: folds 
matiko09: folds 
Uncalled bet ($2) returned to andy84lfc
andy84lfc collected $2.50 from pot
*** SUMMARY ***
Total pot $2.50 | Rake $0 
Seat 1: HITYESCA folded before Flop (didn't bet)
Seat 2: Hayer ana folded before Flop (didn't bet)
Seat 3: Khaine_CM folded before Flop (didn't bet)
Seat 4: CI58 folded before Flop (didn't bet)
Seat 5: Alex Frider folded before Flop (didn't bet)
Seat 6: andy84lfc collected ($2.50)
Seat 7: maxxmeister (button) folded before Flop (didn't bet)
Seat 8: 178013 (small blind) folded before Flop
Seat 9: matiko09 (big blind) folded before Flop





PokerStars Hand #152887359520:  Hold'em No Limit (€1/€2 EUR) - 2016/05/05 17:11:32 CET [2016/05/05 11:11:32 ET]
Table 'Skat II' 9-max Seat #1 is the button
Seat 1: Vikulja1993 (€212.55 in chips) 
Seat 2: Fitzyferret (€258.84 in chips) 
Seat 3: Alex Frider (€216.44 in chips) 
Seat 4: JoaquinMRuiz (€200 in chips) 
Seat 5: ceedonen (€235.10 in chips) 
Seat 6: drissmouzou (€254.47 in chips) 
Seat 7: PacPacBum (€216.50 in chips) 
Seat 8: Painkiller72 (€206 in chips) 
Seat 9: matiko09 (€200 in chips) 
Fitzyferret: posts small blind €1
Alex Frider: posts big blind €2
*** HOLE CARDS ***
Dealt to matiko09 [2d 3d]
JoaquinMRuiz: raises €2.35 to €4.35
ceedonen: folds 
drissmouzou: folds 
PacPacBum: folds 
Painkiller72: folds 
matiko09: folds 
Vikulja1993: folds 
Fitzyferret: folds 
Alex Frider: folds 
Uncalled bet (€2.35) returned to JoaquinMRuiz
JoaquinMRuiz collected €5 from pot
*** SUMMARY ***
Total pot €5 | Rake €0 
Seat 1: Vikulja1993 (button) folded before Flop (didn't bet)
Seat 2: Fitzyferret (small blind) folded before Flop
Seat 3: Alex Frider (big blind) folded before Flop
Seat 4: JoaquinMRuiz collected (€5)
Seat 5: ceedonen folded before Flop (didn't bet)
Seat 6: drissmouzou folded before Flop (didn't bet)
Seat 7: PacPacBum folded before Flop (didn't bet)
Seat 8: Painkiller72 folded before Flop (didn't bet)
Seat 9: matiko09 folded before Flop (didn't bet)





PokerStars Hand #152887362137:  Hold'em No Limit ($0.50/$1.00 USD) - 2016/05/05 17:11:36 CET [2016/05/05 11:11:36 ET]
Table 'Siberia' 9-max Seat #4 is the button
Seat 1: Lycaon23 ($103.20 in chips) 
Seat 4: opsv ($59.28 in chips) 
Seat 5: Hayer ana ($99 in chips) 
Seat 6: bjonlyking ($116.37 in chips) 
Seat 7: matiko09 ($100 in chips) 
Seat 9: arctur17 ($110.02 in chips) 
Hayer ana: posts small blind $0.50
bjonlyking: posts big blind $1
Mukhin1: sits out 
*** HOLE CARDS ***
Dealt to matiko09 [8c Tc]
matiko09: folds 
arctur17: folds 
Lycaon23: folds 
opsv has timed out
opsv: folds 
Hayer ana: folds 
Uncalled bet ($0.50) returned to bjonlyking
bjonlyking collected $1 from pot
bjonlyking: doesn't show hand 
*** SUMMARY ***
Total pot $1 | Rake $0 
Seat 1: Lycaon23 folded before Flop (didn't bet)
Seat 4: opsv (button) folded before Flop (didn't bet)
Seat 5: Hayer ana (small blind) folded before Flop
Seat 6: bjonlyking (big blind) collected ($1)
Seat 7: matiko09 folded before Flop (didn't bet)
Seat 9: arctur17 folded before Flop (didn't bet)





PokerStars Hand #152887362407:  Hold'em No Limit ($1/$2 USD) - 2016/05/05 17:11:36 CET [2016/05/05 11:11:36 ET]
Table 'Samitchell' 9-max Seat #5 is the button
Seat 1: CI58 ($200 in chips) 
Seat 2: matiko09 ($268.71 in chips) 
Seat 3: han3bj ($244.77 in chips) 
Seat 4: Fitzyferret ($497.88 in chips) 
Seat 5: chaps1988 ($205.25 in chips) 
Seat 6: PacPacBum ($200 in chips) 
Seat 7: patpaty ($181.61 in chips) 
Seat 8: tepi_guy ($200 in chips) 
Seat 9: kblkxls ($110.15 in chips) 
PacPacBum: posts small blind $1
patpaty: posts big blind $2
*** HOLE CARDS ***
Dealt to matiko09 [Qd 2c]
kblkxls said, ":("
tepi_guy: folds 
kblkxls: calls $2
CI58: folds 
matiko09: folds 
han3bj: folds 
Fitzyferret: raises $6.50 to $8.50
chaps1988: folds 
PacPacBum: folds 
patpaty: calls $6.50
kblkxls said, "have you ever given your sister a  rub?"
kblkxls: folds 
*** FLOP *** [4d 4s 9h]
patpaty: checks 
Fitzyferret: checks 
*** TURN *** [4d 4s 9h] [Jd]
kblkxls said, "like in the bath"
patpaty: checks 
kblkxls said, "I use to have a sister. I stabber her in the throat with a kitchen knife. *****"
Fitzyferret: checks 
*** RIVER *** [4d 4s 9h Jd] [Qh]
han3bj said, "give me a sister first"
patpaty: bets $6
Fitzyferret: folds 
Uncalled bet ($6) returned to patpaty
patpaty collected $19 from pot
patpaty: doesn't show hand 
*** SUMMARY ***
Total pot $20 | Rake $1 
Board [4d 4s 9h Jd Qh]
Seat 1: CI58 folded before Flop (didn't bet)
Seat 2: matiko09 folded before Flop (didn't bet)
Seat 3: han3bj folded before Flop (didn't bet)
Seat 4: Fitzyferret folded on the River
Seat 5: chaps1988 (button) folded before Flop (didn't bet)
Seat 6: PacPacBum (small blind) folded before Flop
Seat 7: patpaty (big blind) collected ($19)
Seat 8: tepi_guy folded before Flop (didn't bet)
Seat 9: kblkxls folded before Flop





PokerStars Hand #152887364396:  Hold'em No Limit ($1/$2 USD) - 2016/05/05 17:11:40 CET [2016/05/05 11:11:40 ET]
Table 'Tatry II' 9-max Seat #1 is the button
Seat 1: Alex Frider ($197 in chips) 
Seat 2: tepi_guy ($200 in chips) 
Seat 3: matiko09 ($200 in chips) 
Seat 4: PacPacBum ($218.79 in chips) 
Seat 5: Painkiller72 ($285.75 in chips) 
Seat 6: Kukuryzka ($338.36 in chips) 
Seat 7: myatiy 96 ($215.05 in chips) 
Seat 8: chaps1988 ($252.54 in chips) 
Seat 9: korol702 ($209.45 in chips) 
tepi_guy: posts small blind $1
matiko09: posts big blind $2
*** HOLE CARDS ***
Dealt to matiko09 [3h Jh]
PacPacBum: raises $2.08 to $4.08
Painkiller72: folds 
Kukuryzka: folds 
myatiy 96: folds 
chaps1988: folds 
korol702: raises $8.08 to $12.16
Alex Frider: folds 
tepi_guy: folds 
matiko09: folds 
PacPacBum: folds 
Uncalled bet ($8.08) returned to korol702
korol702 collected $11.16 from pot
korol702: doesn't show hand 
*** SUMMARY ***
Total pot $11.16 | Rake $0 
Seat 1: Alex Frider (button) folded before Flop (didn't bet)
Seat 2: tepi_guy (small blind) folded before Flop
Seat 3: matiko09 (big blind) folded before Flop
Seat 4: PacPacBum folded before Flop
Seat 5: Painkiller72 folded before Flop (didn't bet)
Seat 6: Kukuryzka folded before Flop (didn't bet)
Seat 7: myatiy 96 folded before Flop (didn't bet)
Seat 8: chaps1988 folded before Flop (didn't bet)
Seat 9: korol702 collected ($11.16)





PokerStars Hand #152887370793:  Hold'em No Limit ($0.50/$1.00 USD) - 2016/05/05 17:11:50 CET [2016/05/05 11:11:50 ET]
Table 'Kraz II' 9-max Seat #8 is the button
Seat 1: HITYESCA ($141.30 in chips) 
Seat 2: Hayer ana ($218.22 in chips) 
Seat 3: Khaine_CM ($100 in chips) 
Seat 4: CI58 ($100 in chips) 
Seat 5: Alex Frider ($27.95 in chips) 
Seat 6: andy84lfc ($25.12 in chips) 
Seat 7: maxxmeister ($254.31 in chips) 
Seat 8: 178013 ($291.04 in chips) 
Seat 9: matiko09 ($177.87 in chips) 
matiko09: posts small blind $0.50
HITYESCA: posts big blind $1
*** HOLE CARDS ***
Dealt to matiko09 [9c 6c]
Hayer ana: folds 
Khaine_CM: folds 
CI58: folds 
Alex Frider: raises $2 to $3
andy84lfc: folds 
maxxmeister: folds 
178013: calls $3
matiko09: folds 
HITYESCA: folds 
*** FLOP *** [6d 2c 5h]
Alex Frider: checks 
178013: bets $4
Alex Frider: calls $4
*** TURN *** [6d 2c 5h] [9h]
Alex Frider: checks 
178013: checks 
*** RIVER *** [6d 2c 5h 9h] [Qd]
Alex Frider: checks 
178013: checks 
*** SHOW DOWN ***
Alex Frider: shows [Ac 5c] (a pair of Fives)
178013: mucks hand 
Alex Frider collected $14.72 from pot
*** SUMMARY ***
Total pot $15.50 | Rake $0.78 
Board [6d 2c 5h 9h Qd]
Seat 1: HITYESCA (big blind) folded before Flop
Seat 2: Hayer ana folded before Flop (didn't bet)
Seat 3: Khaine_CM folded before Flop (didn't bet)
Seat 4: CI58 folded before Flop (didn't bet)
Seat 5: Alex Frider showed [Ac 5c] and won ($14.72) with a pair of Fives
Seat 6: andy84lfc folded before Flop (didn't bet)
Seat 7: maxxmeister folded before Flop (didn't bet)
Seat 8: 178013 (button) mucked [Ks Js]
Seat 9: matiko09 (small blind) folded before Flop





PokerStars Hand #152887380044:  Hold'em No Limit ($0.50/$1.00 USD) - 2016/05/05 17:12:05 CET [2016/05/05 11:12:05 ET]
Table 'Siberia' 9-max Seat #5 is the button
Seat 1: Lycaon23 ($103.20 in chips) 
Seat 4: opsv ($59.28 in chips) 
Seat 5: Hayer ana ($100 in chips) 
Seat 6: bjonlyking ($116.87 in chips) 
Seat 7: matiko09 ($100 in chips) 
Seat 9: arctur17 ($110.02 in chips) 
bjonlyking: posts small blind $0.50
matiko09: posts big blind $1
Mukhin1: sits out 
*** HOLE CARDS ***
Dealt to matiko09 [6c Tc]
arctur17: folds 
Lycaon23: folds 
opsv has timed out
opsv: folds 
Hayer ana: folds 
bjonlyking: folds 
Uncalled bet ($0.50) returned to matiko09
matiko09 collected $1 from pot
matiko09: doesn't show hand 
*** SUMMARY ***
Total pot $1 | Rake $0 
Seat 1: Lycaon23 folded before Flop (didn't bet)
Seat 4: opsv folded before Flop (didn't bet)
Seat 5: Hayer ana (button) folded before Flop (didn't bet)
Seat 6: bjonlyking (small blind) folded before Flop
Seat 7: matiko09 (big blind) collected ($1)
Seat 9: arctur17 folded before Flop (didn't bet)





PokerStars Hand #152887382203:  Hold'em No Limit ($1/$2 USD) - 2016/05/05 17:12:08 CET [2016/05/05 11:12:08 ET]
Table 'Tololo' 9-max Seat #8 is the button
Seat 1: Kukuryzka ($254.29 in chips) 
Seat 2: tepi_guy ($213.86 in chips) 
Seat 3: Khaine_CM ($203 in chips) 
Seat 4: mooose100 ($286.97 in chips) 
Seat 5: matiko09 ($209.70 in chips) 
Seat 6: Vikulja1993 ($200 in chips) 
Seat 7: chaps1988 ($333.12 in chips) 
Seat 8: myatiy 96 ($200 in chips) 
Seat 9: Fitzyferret ($395.07 in chips) 
Fitzyferret: posts small blind $1
Kukuryzka: posts big blind $2
*** HOLE CARDS ***
Dealt to matiko09 [9h 2c]
tepi_guy: folds 
Khaine_CM: raises $4 to $6
mooose100 has timed out
mooose100: folds 
matiko09: folds 
Vikulja1993: folds 
chaps1988: folds 
myatiy 96: folds 
Fitzyferret: folds 
Kukuryzka: folds 
Uncalled bet ($4) returned to Khaine_CM
Khaine_CM collected $5 from pot
Khaine_CM: doesn't show hand 
*** SUMMARY ***
Total pot $5 | Rake $0 
Seat 1: Kukuryzka (big blind) folded before Flop
Seat 2: tepi_guy folded before Flop (didn't bet)
Seat 3: Khaine_CM collected ($5)
Seat 4: mooose100 folded before Flop (didn't bet)
Seat 5: matiko09 folded before Flop (didn't bet)
Seat 6: Vikulja1993 folded before Flop (didn't bet)
Seat 7: chaps1988 folded before Flop (didn't bet)
Seat 8: myatiy 96 (button) folded before Flop (didn't bet)
Seat 9: Fitzyferret (small blind) folded before Flop





PokerStars Hand #152887388393:  Hold'em No Limit ($0.50/$1.00 USD) - 2016/05/05 17:12:18 CET [2016/05/05 11:12:18 ET]
Table 'Porzia' 9-max Seat #4 is the button
Seat 1: Alex Frider ($106.78 in chips) 
Seat 2: ceedonen ($100 in chips) 
Seat 3: VanDobeln ($98.50 in chips) 
Seat 4: Khaine_CM ($115.38 in chips) 
Seat 5: CZECHMYSAK ($73.87 in chips) 
Seat 6: matiko09 ($100 in chips) 
Seat 7: HITYESCA ($136.29 in chips) 
Seat 8: PRINCE JULIO ($61.69 in chips) 
Seat 9: Hayer ana ($108.82 in chips) 
CZECHMYSAK: posts small blind $0.50
matiko09: posts big blind $1
*** HOLE CARDS ***
Dealt to matiko09 [4d Tc]
HITYESCA: folds 
PRINCE JULIO: folds 
Hayer ana: folds 
Alex Frider: folds 
ceedonen: folds 
VanDobeln: folds 
Khaine_CM: raises $1 to $2
CZECHMYSAK: folds 
matiko09: folds 
Uncalled bet ($1) returned to Khaine_CM
Khaine_CM collected $2.50 from pot
Khaine_CM: doesn't show hand 
*** SUMMARY ***
Total pot $2.50 | Rake $0 
Seat 1: Alex Frider folded before Flop (didn't bet)
Seat 2: ceedonen folded before Flop (didn't bet)
Seat 3: VanDobeln folded before Flop (didn't bet)
Seat 4: Khaine_CM (button) collected ($2.50)
Seat 5: CZECHMYSAK (small blind) folded before Flop
Seat 6: matiko09 (big blind) folded before Flop
Seat 7: HITYESCA folded before Flop (didn't bet)
Seat 8: PRINCE JULIO folded before Flop (didn't bet)
Seat 9: Hayer ana folded before Flop (didn't bet)





PokerStars Hand #152887392671:  Hold'em No Limit (€1/€2 EUR) - 2016/05/05 17:12:25 CET [2016/05/05 11:12:25 ET]
Table 'Skat II' 9-max Seat #2 is the button
Seat 1: Vikulja1993 (€212.55 in chips) 
Seat 2: Fitzyferret (€257.84 in chips) 
Seat 3: Alex Frider (€214.44 in chips) 
Seat 4: JoaquinMRuiz (€203 in chips) 
Seat 5: ceedonen (€235.10 in chips) 
Seat 6: drissmouzou (€254.47 in chips) 
Seat 7: PacPacBum (€216.50 in chips) 
Seat 8: Painkiller72 (€206 in chips) 
Seat 9: matiko09 (€200 in chips) 
Alex Frider: posts small blind €1
JoaquinMRuiz: posts big blind €2
*** HOLE CARDS ***
Dealt to matiko09 [6h 5s]
ceedonen: folds 
drissmouzou: folds 
PacPacBum: folds 
Painkiller72: folds 
matiko09: folds 
Vikulja1993: folds 
Fitzyferret: raises €2.60 to €4.60
Alex Frider: folds 
JoaquinMRuiz: calls €2.60
*** FLOP *** [3c 5c Qh]
JoaquinMRuiz: checks 
Fitzyferret: bets €6
JoaquinMRuiz: calls €6
*** TURN *** [3c 5c Qh] [Kc]
JoaquinMRuiz: checks 
Fitzyferret: checks 
*** RIVER *** [3c 5c Qh Kc] [Kh]
JoaquinMRuiz: bets €13.28
Fitzyferret: folds 
Uncalled bet (€13.28) returned to JoaquinMRuiz
JoaquinMRuiz collected €21.09 from pot
*** SUMMARY ***
Total pot €22.20 | Rake €1.11 
Board [3c 5c Qh Kc Kh]
Seat 1: Vikulja1993 folded before Flop (didn't bet)
Seat 2: Fitzyferret (button) folded on the River
Seat 3: Alex Frider (small blind) folded before Flop
Seat 4: JoaquinMRuiz (big blind) collected (€21.09)
Seat 5: ceedonen folded before Flop (didn't bet)
Seat 6: drissmouzou folded before Flop (didn't bet)
Seat 7: PacPacBum folded before Flop (didn't bet)
Seat 8: Painkiller72 folded before Flop (didn't bet)
Seat 9: matiko09 folded before Flop (didn't bet)





PokerStars Hand #152887396020:  Hold'em No Limit ($1/$2 USD) - 2016/05/05 17:12:30 CET [2016/05/05 11:12:30 ET]
Table 'Tatry II' 9-max Seat #2 is the button
Seat 1: Alex Frider ($197 in chips) 
Seat 2: tepi_guy ($200 in chips) 
Seat 3: matiko09 ($200 in chips) 
Seat 4: PacPacBum ($214.71 in chips) 
Seat 5: Painkiller72 ($285.75 in chips) 
Seat 6: Kukuryzka ($338.36 in chips) 
Seat 7: myatiy 96 ($215.05 in chips) 
Seat 8: chaps1988 ($252.54 in chips) 
Seat 9: korol702 ($216.53 in chips) 
matiko09: posts small blind $1
PacPacBum: posts big blind $2
*** HOLE CARDS ***
Dealt to matiko09 [Qs 6d]
Painkiller72: folds 
Kukuryzka: folds 
myatiy 96: folds 
chaps1988: folds 
korol702: folds 
Alex Frider: raises $3 to $5
tepi_guy: folds 
matiko09: folds 
PacPacBum: folds 
Uncalled bet ($3) returned to Alex Frider
Alex Frider collected $5 from pot
Alex Frider: doesn't show hand 
*** SUMMARY ***
Total pot $5 | Rake $0 
Seat 1: Alex Frider collected ($5)
Seat 2: tepi_guy (button) folded before Flop (didn't bet)
Seat 3: matiko09 (small blind) folded before Flop
Seat 4: PacPacBum (big blind) folded before Flop
Seat 5: Painkiller72 folded before Flop (didn't bet)
Seat 6: Kukuryzka folded before Flop (didn't bet)
Seat 7: myatiy 96 folded before Flop (didn't bet)
Seat 8: chaps1988 folded before Flop (didn't bet)
Seat 9: korol702 folded before Flop (didn't bet)





PokerStars Hand #152887404335:  Hold'em No Limit ($0.50/$1.00 USD) - 2016/05/05 17:12:44 CET [2016/05/05 11:12:44 ET]
Table 'Siberia' 9-max Seat #6 is the button
Seat 1: Lycaon23 ($103.20 in chips) 
Seat 4: opsv ($59.28 in chips) 
Seat 5: Hayer ana ($100 in chips) 
Seat 6: bjonlyking ($116.37 in chips) 
Seat 7: matiko09 ($100.50 in chips) 
Seat 9: arctur17 ($110.02 in chips) 
matiko09: posts small blind $0.50
arctur17: posts big blind $1
Mukhin1: sits out 
*** HOLE CARDS ***
Dealt to matiko09 [Js Qc]
Lycaon23: folds 
$-Twackle-$ joins the table at seat #8 
opsv: folds 
Hayer ana: folds 
bjonlyking: calls $1
matiko09: calls $0.50
arctur17: checks 
*** FLOP *** [7d As Jh]
matiko09: checks 
arctur17: bets $2
bjonlyking: calls $2
matiko09: folds 
*** TURN *** [7d As Jh] [7s]
arctur17: bets $4
bjonlyking: calls $4
*** RIVER *** [7d As Jh 7s] [4h]
arctur17: bets $10
bjonlyking: folds 
Uncalled bet ($10) returned to arctur17
arctur17 collected $14.25 from pot
arctur17: doesn't show hand 
*** SUMMARY ***
Total pot $15 | Rake $0.75 
Board [7d As Jh 7s 4h]
Seat 1: Lycaon23 folded before Flop (didn't bet)
Seat 4: opsv folded before Flop (didn't bet)
Seat 5: Hayer ana folded before Flop (didn't bet)
Seat 6: bjonlyking (button) folded on the River
Seat 7: matiko09 (small blind) folded on the Flop
Seat 9: arctur17 (big blind) collected ($14.25)





PokerStars Hand #152887411474:  Hold'em No Limit ($0.50/$1.00 USD) - 2016/05/05 17:12:55 CET [2016/05/05 11:12:55 ET]
Table 'Porzia' 9-max Seat #5 is the button
Seat 1: Alex Frider ($106.78 in chips) 
Seat 2: ceedonen ($100 in chips) 
Seat 3: VanDobeln ($98.50 in chips) 
Seat 4: Khaine_CM ($116.88 in chips) 
Seat 5: CZECHMYSAK ($73.37 in chips) 
Seat 6: matiko09 ($100 in chips) 
Seat 7: HITYESCA ($136.29 in chips) 
Seat 8: PRINCE JULIO ($61.69 in chips) 
Seat 9: Hayer ana ($108.82 in chips) 
matiko09: posts small blind $0.50
HITYESCA: posts big blind $1
*** HOLE CARDS ***
Dealt to matiko09 [2c Kc]
PRINCE JULIO: folds 
Hayer ana: folds 
Alex Frider: folds 
ceedonen: folds 
VanDobeln: folds 
Khaine_CM: folds 
CZECHMYSAK: folds 
matiko09: raises $1.50 to $2.50
HITYESCA: folds 
Uncalled bet ($1.50) returned to matiko09
matiko09 collected $2 from pot
matiko09: doesn't show hand 
*** SUMMARY ***
Total pot $2 | Rake $0 
Seat 1: Alex Frider folded before Flop (didn't bet)
Seat 2: ceedonen folded before Flop (didn't bet)
Seat 3: VanDobeln folded before Flop (didn't bet)
Seat 4: Khaine_CM folded before Flop (didn't bet)
Seat 5: CZECHMYSAK (button) folded before Flop (didn't bet)
Seat 6: matiko09 (small blind) collected ($2)
Seat 7: HITYESCA (big blind) folded before Flop
Seat 8: PRINCE JULIO folded before Flop (didn't bet)
Seat 9: Hayer ana folded before Flop (didn't bet)





PokerStars Hand #152887415266:  Hold'em No Limit ($1/$2 USD) - 2016/05/05 17:13:01 CET [2016/05/05 11:13:01 ET]
Table 'Tatry II' 9-max Seat #3 is the button
Seat 1: Alex Frider ($200 in chips) 
Seat 2: tepi_guy ($200 in chips) 
Seat 3: matiko09 ($200 in chips) 
Seat 4: PacPacBum ($212.71 in chips) 
Seat 5: Painkiller72 ($285.75 in chips) 
Seat 6: Kukuryzka ($338.36 in chips) 
Seat 7: myatiy 96 ($215.05 in chips) 
Seat 8: chaps1988 ($252.54 in chips) 
Seat 9: korol702 ($216.53 in chips) 
PacPacBum: posts small blind $1
Painkiller72: posts big blind $2
*** HOLE CARDS ***
Dealt to matiko09 [5d Ks]
Kukuryzka: raises $4 to $6
myatiy 96: folds 
chaps1988: folds 
korol702: folds 
Alex Frider: folds 
tepi_guy: folds 
matiko09: folds 
PacPacBum: folds 
Painkiller72: folds 
Uncalled bet ($4) returned to Kukuryzka
Kukuryzka collected $5 from pot
Kukuryzka: doesn't show hand 
*** SUMMARY ***
Total pot $5 | Rake $0 
Seat 1: Alex Frider folded before Flop (didn't bet)
Seat 2: tepi_guy folded before Flop (didn't bet)
Seat 3: matiko09 (button) folded before Flop (didn't bet)
Seat 4: PacPacBum (small blind) folded before Flop
Seat 5: Painkiller72 (big blind) folded before Flop
Seat 6: Kukuryzka collected ($5)
Seat 7: myatiy 96 folded before Flop (didn't bet)
Seat 8: chaps1988 folded before Flop (didn't bet)
Seat 9: korol702 folded before Flop (didn't bet)





PokerStars Hand #152887418356:  Hold'em No Limit ($0.50/$1.00 USD) - 2016/05/05 17:13:06 CET [2016/05/05 11:13:06 ET]
Table 'Kraz II' 9-max Seat #9 is the button
Seat 1: HITYESCA ($140.30 in chips) 
Seat 2: Hayer ana ($218.22 in chips) 
Seat 3: Khaine_CM ($100 in chips) 
Seat 4: CI58 ($100 in chips) 
Seat 5: Alex Frider ($35.67 in chips) 
Seat 6: andy84lfc ($25.12 in chips) 
Seat 7: maxxmeister ($254.31 in chips) 
Seat 8: 178013 ($284.04 in chips) 
Seat 9: matiko09 ($177.37 in chips) 
HITYESCA: posts small blind $0.50
Hayer ana: posts big blind $1
*** HOLE CARDS ***
Dealt to matiko09 [Ah Tc]
Khaine_CM: folds 
CI58: folds 
Alex Frider: raises $2 to $3
andy84lfc: folds 
maxxmeister: calls $3
178013: calls $3
matiko09: folds 
HITYESCA: folds 
Hayer ana: folds 
*** FLOP *** [6d 4h 5c]
Alex Frider: checks 
maxxmeister: checks 
178013: bets $6
Alex Frider: folds 
maxxmeister: folds 
Uncalled bet ($6) returned to 178013
178013 collected $9.98 from pot
178013: doesn't show hand 
*** SUMMARY ***
Total pot $10.50 | Rake $0.52 
Board [6d 4h 5c]
Seat 1: HITYESCA (small blind) folded before Flop
Seat 2: Hayer ana (big blind) folded before Flop
Seat 3: Khaine_CM folded before Flop (didn't bet)
Seat 4: CI58 folded before Flop (didn't bet)
Seat 5: Alex Frider folded on the Flop
Seat 6: andy84lfc folded before Flop (didn't bet)
Seat 7: maxxmeister folded on the Flop
Seat 8: 178013 collected ($9.98)
Seat 9: matiko09 (button) folded before Flop (didn't bet)





PokerStars Hand #152887419974:  Hold'em No Limit ($1/$2 USD) - 2016/05/05 17:13:09 CET [2016/05/05 11:13:09 ET]
Table 'Samitchell' 9-max Seat #6 is the button
Seat 1: CI58 ($200 in chips) 
Seat 2: matiko09 ($268.71 in chips) 
Seat 3: han3bj ($244.77 in chips) 
Seat 4: Fitzyferret ($489.38 in chips) 
Seat 5: chaps1988 ($205.25 in chips) 
Seat 6: PacPacBum ($200 in chips) 
Seat 7: patpaty ($192.11 in chips) 
Seat 8: tepi_guy ($200 in chips) 
Seat 9: kblkxls ($108.15 in chips) 
patpaty: posts small blind $1
tepi_guy: posts big blind $2
*** HOLE CARDS ***
Dealt to matiko09 [Th Ks]
kblkxls said, "you can borror mine if you dont mind the corps"
kblkxls: folds 
CI58: folds 
matiko09: folds 
han3bj: folds 
Fitzyferret: folds 
chaps1988: folds 
PacPacBum: raises $2.08 to $4.08
kblkxls said, "you in nsw?"
kblkxls said, "why up so late?"
patpaty: folds 
han3bj said, "go talk to ur sister"
kblkxls said, "no i will tlak to you untill you give me all of your chips"
tepi_guy: calls $2.08
*** FLOP *** [4d 6c 3d]
kblkxls said, "or play tennis with my sister"
han3bj said, "lol keep dreaming"
kblkxls said, "you dont want to play with her?"
tepi_guy has timed out
tepi_guy: checks 
PacPacBum: bets $4.69
PacPacBum said, "australians..."
kblkxls said, "why not. she wears a very short skirt. She also likes to play with the balls"
tepi_guy has timed out
tepi_guy: folds 
Uncalled bet ($4.69) returned to PacPacBum
PacPacBum collected $8.70 from pot
PacPacBum: doesn't show hand 
*** SUMMARY ***
Total pot $9.16 | Rake $0.46 
Board [4d 6c 3d]
Seat 1: CI58 folded before Flop (didn't bet)
Seat 2: matiko09 folded before Flop (didn't bet)
Seat 3: han3bj folded before Flop (didn't bet)
Seat 4: Fitzyferret folded before Flop (didn't bet)
Seat 5: chaps1988 folded before Flop (didn't bet)
Seat 6: PacPacBum (button) collected ($8.70)
Seat 7: patpaty (small blind) folded before Flop
Seat 8: tepi_guy (big blind) folded on the Flop
Seat 9: kblkxls folded before Flop (didn't bet)





PokerStars Hand #152887424335:  Hold'em No Limit ($1/$2 USD) - 2016/05/05 17:13:16 CET [2016/05/05 11:13:16 ET]
Table 'Tololo' 9-max Seat #9 is the button
Seat 1: Kukuryzka ($252.29 in chips) 
Seat 2: tepi_guy ($213.86 in chips) 
Seat 3: Khaine_CM ($206 in chips) 
Seat 4: mooose100 ($286.97 in chips) 
Seat 5: matiko09 ($209.70 in chips) 
Seat 6: Vikulja1993 ($200 in chips) 
Seat 7: chaps1988 ($333.12 in chips) 
Seat 8: myatiy 96 ($200 in chips) 
Seat 9: Fitzyferret ($394.07 in chips) 
Kukuryzka: posts small blind $1
tepi_guy: posts big blind $2
*** HOLE CARDS ***
Dealt to matiko09 [Ad As]
Khaine_CM: folds 
mooose100: calls $2
matiko09: raises $6 to $8
Vikulja1993: folds 
chaps1988: folds 
myatiy 96: folds 
Fitzyferret: folds 
Kukuryzka: folds 
tepi_guy has timed out
tepi_guy: folds 
mooose100: calls $6
*** FLOP *** [4h 7d 7h]
mooose100: checks 
matiko09: checks 
*** TURN *** [4h 7d 7h] [8h]
mooose100: checks 
matiko09: bets $12
mooose100: raises $12 to $24
matiko09: calls $12
*** RIVER *** [4h 7d 7h 8h] [9d]
mooose100: bets $32.12
matiko09: calls $32.12
*** SHOW DOWN ***
mooose100: shows [Jh Ah] (a flush, Ace high)
matiko09: mucks hand 
mooose100 collected $128.49 from pot
*** SUMMARY ***
Total pot $131.24 | Rake $2.75 
Board [4h 7d 7h 8h 9d]
Seat 1: Kukuryzka (small blind) folded before Flop
Seat 2: tepi_guy (big blind) folded before Flop
Seat 3: Khaine_CM folded before Flop (didn't bet)
Seat 4: mooose100 showed [Jh Ah] and won ($128.49) with a flush, Ace high
Seat 5: matiko09 mucked [Ad As]
Seat 6: Vikulja1993 folded before Flop (didn't bet)
Seat 7: chaps1988 folded before Flop (didn't bet)
Seat 8: myatiy 96 folded before Flop (didn't bet)
Seat 9: Fitzyferret (button) folded before Flop (didn't bet)





PokerStars Hand #152887436038:  Hold'em No Limit ($0.50/$1.00 USD) - 2016/05/05 17:13:34 CET [2016/05/05 11:13:34 ET]
Table 'Porzia' 9-max Seat #6 is the button
Seat 1: Alex Frider ($106.78 in chips) 
Seat 2: ceedonen ($100 in chips) 
Seat 3: VanDobeln ($98.50 in chips) 
Seat 4: Khaine_CM ($116.88 in chips) 
Seat 5: CZECHMYSAK ($73.37 in chips) 
Seat 6: matiko09 ($101 in chips) 
Seat 7: HITYESCA ($135.29 in chips) 
Seat 8: PRINCE JULIO ($61.69 in chips) 
Seat 9: Hayer ana ($108.82 in chips) 
HITYESCA: posts small blind $0.50
PRINCE JULIO: posts big blind $1
*** HOLE CARDS ***
Dealt to matiko09 [9h 4c]
Hayer ana: folds 
Alex Frider: folds 
ceedonen: folds 
VanDobeln: folds 
Khaine_CM: folds 
CZECHMYSAK: folds 
matiko09: folds 
HITYESCA: folds 
Uncalled bet ($0.50) returned to PRINCE JULIO
PRINCE JULIO collected $1 from pot
PRINCE JULIO: doesn't show hand 
*** SUMMARY ***
Total pot $1 | Rake $0 
Seat 1: Alex Frider folded before Flop (didn't bet)
Seat 2: ceedonen folded before Flop (didn't bet)
Seat 3: VanDobeln folded before Flop (didn't bet)
Seat 4: Khaine_CM folded before Flop (didn't bet)
Seat 5: CZECHMYSAK folded before Flop (didn't bet)
Seat 6: matiko09 (button) folded before Flop (didn't bet)
Seat 7: HITYESCA (small blind) folded before Flop
Seat 8: PRINCE JULIO (big blind) collected ($1)
Seat 9: Hayer ana folded before Flop (didn't bet)





PokerStars Hand #152887441153:  Hold'em No Limit ($0.50/$1.00 USD) - 2016/05/05 17:13:43 CET [2016/05/05 11:13:43 ET]
Table 'Natascha' 9-max Seat #6 is the button
Seat 1: Alex Frider ($104.47 in chips) 
Seat 2: HITYESCA ($128.32 in chips) 
Seat 4: Chqraiser007 ($50 in chips) 
Seat 5: Sundown100 ($63.76 in chips) 
Seat 6: CI58 ($118.07 in chips) 
Seat 8: $-Twackle-$ ($109.02 in chips) 
Seat 9: matiko09 ($135.21 in chips) 
$-Twackle-$: posts small blind $0.50
matiko09: posts big blind $1
*** HOLE CARDS ***
Dealt to matiko09 [8h Jc]
Alex Frider: folds 
HITYESCA: folds 
Chqraiser007: folds 
Sundown100: calls $1
CI58: folds 
$-Twackle-$: raises $3 to $4
matiko09: folds 
Sundown100: calls $3
*** FLOP *** [6s 2c 8d]
$-Twackle-$: bets $5.13
Sundown100: folds 
Uncalled bet ($5.13) returned to $-Twackle-$
$-Twackle-$ collected $8.55 from pot
$-Twackle-$: doesn't show hand 
*** SUMMARY ***
Total pot $9 | Rake $0.45 
Board [6s 2c 8d]
Seat 1: Alex Frider folded before Flop (didn't bet)
Seat 2: HITYESCA folded before Flop (didn't bet)
Seat 4: Chqraiser007 folded before Flop (didn't bet)
Seat 5: Sundown100 folded on the Flop
Seat 6: CI58 (button) folded before Flop (didn't bet)
Seat 8: $-Twackle-$ (small blind) collected ($8.55)
Seat 9: matiko09 (big blind) folded before Flop





PokerStars Hand #152887442098:  Hold'em No Limit ($1/$2 USD) - 2016/05/05 17:13:44 CET [2016/05/05 11:13:44 ET]
Table 'Tatry II' 9-max Seat #4 is the button
Seat 1: Alex Frider ($200 in chips) 
Seat 2: tepi_guy ($200 in chips) 
Seat 3: matiko09 ($200 in chips) 
Seat 4: PacPacBum ($211.71 in chips) 
Seat 5: Painkiller72 ($283.75 in chips) 
Seat 6: Kukuryzka ($341.36 in chips) 
Seat 7: myatiy 96 ($215.05 in chips) 
Seat 8: chaps1988 ($252.54 in chips) 
Seat 9: korol702 ($216.53 in chips) 
Painkiller72: posts small blind $1
Kukuryzka: posts big blind $2
*** HOLE CARDS ***
Dealt to matiko09 [Jh Kh]
myatiy 96: folds 
chaps1988: folds 
korol702: folds 
Alex Frider: folds 
tepi_guy: folds 
matiko09: raises $3 to $5
PacPacBum: calls $5
Painkiller72: folds 
Kukuryzka: folds 
*** FLOP *** [Ad 8s Kc]
matiko09: checks 
PacPacBum: bets $6.66
matiko09: calls $6.66
*** TURN *** [Ad 8s Kc] [4c]
matiko09: checks 
PacPacBum: checks 
*** RIVER *** [Ad 8s Kc 4c] [Ah]
matiko09: checks 
PacPacBum: checks 
*** SHOW DOWN ***
matiko09: shows [Jh Kh] (two pair, Aces and Kings)
PacPacBum: mucks hand 
matiko09 collected $25 from pot
*** SUMMARY ***
Total pot $26.32 | Rake $1.32 
Board [Ad 8s Kc 4c Ah]
Seat 1: Alex Frider folded before Flop (didn't bet)
Seat 2: tepi_guy folded before Flop (didn't bet)
Seat 3: matiko09 showed [Jh Kh] and won ($25) with two pair, Aces and Kings
Seat 4: PacPacBum (button) mucked [Qd Td]
Seat 5: Painkiller72 (small blind) folded before Flop
Seat 6: Kukuryzka (big blind) folded before Flop
Seat 7: myatiy 96 folded before Flop (didn't bet)
Seat 8: chaps1988 folded before Flop (didn't bet)
Seat 9: korol702 folded before Flop (didn't bet)





PokerStars Hand #152887445501:  Hold'em No Limit ($0.50/$1.00 USD) - 2016/05/05 17:13:49 CET [2016/05/05 11:13:49 ET]
Table 'Siberia' 9-max Seat #7 is the button
Seat 1: Lycaon23 ($103.20 in chips) 
Seat 4: opsv ($59.28 in chips) 
Seat 5: Hayer ana ($100 in chips) 
Seat 6: bjonlyking ($109.37 in chips) 
Seat 7: matiko09 ($100 in chips) 
Seat 9: arctur17 ($117.27 in chips) 
$-Twackle-$ will be allowed to play after the button
arctur17: posts small blind $0.50
Lycaon23: posts big blind $1
Mukhin1: sits out 
*** HOLE CARDS ***
Dealt to matiko09 [3h Kd]
opsv: folds 
Hayer ana: folds 
bjonlyking: folds 
matiko09: folds 
arctur17: folds 
Uncalled bet ($0.50) returned to Lycaon23
Lycaon23 collected $1 from pot
Lycaon23: doesn't show hand 
*** SUMMARY ***
Total pot $1 | Rake $0 
Seat 1: Lycaon23 (big blind) collected ($1)
Seat 4: opsv folded before Flop (didn't bet)
Seat 5: Hayer ana folded before Flop (didn't bet)
Seat 6: bjonlyking folded before Flop (didn't bet)
Seat 7: matiko09 (button) folded before Flop (didn't bet)
Seat 9: arctur17 (small blind) folded before Flop





PokerStars Hand #152887451067:  Hold'em No Limit ($0.50/$1.00 USD) - 2016/05/05 17:13:58 CET [2016/05/05 11:13:58 ET]
Table 'Porzia' 9-max Seat #7 is the button
Seat 1: Alex Frider ($106.78 in chips) 
Seat 2: ceedonen ($100 in chips) 
Seat 3: VanDobeln ($98.50 in chips) 
Seat 4: Khaine_CM ($116.88 in chips) 
Seat 5: CZECHMYSAK ($73.37 in chips) 
Seat 6: matiko09 ($101 in chips) 
Seat 7: HITYESCA ($134.79 in chips) 
Seat 8: PRINCE JULIO ($62.19 in chips) 
PRINCE JULIO: posts small blind $0.50
Hayer ana: is sitting out 
Hayer ana leaves the table
Alex Frider: posts big blind $1
*** HOLE CARDS ***
Dealt to matiko09 [Jh Ac]
ceedonen: folds 
VanDobeln: folds 
myatiy 96 joins the table at seat #9 
myatiy 96 leaves the table
Khaine_CM: folds 
CZECHMYSAK: folds 
matiko09: raises $1.50 to $2.50
myatiy 96 joins the table at seat #9 
HITYESCA: folds 
myatiy 96 leaves the table
PRINCE JULIO: raises $5.50 to $8
Alex Frider: folds 
matiko09: folds 
Uncalled bet ($5.50) returned to PRINCE JULIO
PRINCE JULIO collected $6 from pot
PRINCE JULIO: doesn't show hand 
*** SUMMARY ***
Total pot $6 | Rake $0 
Seat 1: Alex Frider (big blind) folded before Flop
Seat 2: ceedonen folded before Flop (didn't bet)
Seat 3: VanDobeln folded before Flop (didn't bet)
Seat 4: Khaine_CM folded before Flop (didn't bet)
Seat 5: CZECHMYSAK folded before Flop (didn't bet)
Seat 6: matiko09 folded before Flop
Seat 7: HITYESCA (button) folded before Flop (didn't bet)
Seat 8: PRINCE JULIO (small blind) collected ($6)





PokerStars Hand #152887459345:  Hold'em No Limit ($0.50/$1.00 USD) - 2016/05/05 17:14:12 CET [2016/05/05 11:14:12 ET]
Table 'Siberia' 9-max Seat #9 is the button
Seat 1: Lycaon23 ($103.70 in chips) 
Seat 2: Mukhin1 ($100 in chips) 
Seat 4: opsv ($59.28 in chips) 
Seat 5: Hayer ana ($100 in chips) 
Seat 6: bjonlyking ($109.37 in chips) 
Seat 7: matiko09 ($100 in chips) 
Seat 9: arctur17 ($116.77 in chips) 
Lycaon23: posts small blind $0.50
Mukhin1: posts big blind $1
$-Twackle-$: sits out 
*** HOLE CARDS ***
Dealt to matiko09 [9c 5s]
opsv: raises $1 to $2
Hayer ana: folds 
bjonlyking: folds 
matiko09: folds 
arctur17: folds 
Lycaon23: folds 
Mukhin1: folds 
Uncalled bet ($1) returned to opsv
opsv collected $2.50 from pot
*** SUMMARY ***
Total pot $2.50 | Rake $0 
Seat 1: Lycaon23 (small blind) folded before Flop
Seat 2: Mukhin1 (big blind) folded before Flop
Seat 4: opsv collected ($2.50)
Seat 5: Hayer ana folded before Flop (didn't bet)
Seat 6: bjonlyking folded before Flop (didn't bet)
Seat 7: matiko09 folded before Flop (didn't bet)
Seat 9: arctur17 (button) folded before Flop (didn't bet)





PokerStars Hand #152887466780:  Hold'em No Limit (€1/€2 EUR) - 2016/05/05 17:14:24 CET [2016/05/05 11:14:24 ET]
Table 'Skat II' 9-max Seat #3 is the button
Seat 1: Vikulja1993 (€212.55 in chips) 
Seat 2: Fitzyferret (€247.24 in chips) 
Seat 3: Alex Frider (€213.44 in chips) 
Seat 4: JoaquinMRuiz (€213.49 in chips) 
Seat 5: ceedonen (€235.10 in chips) 
Seat 6: drissmouzou (€254.47 in chips) 
Seat 7: PacPacBum (€216.50 in chips) 
Seat 8: Painkiller72 (€206 in chips) 
Seat 9: matiko09 (€200 in chips) 
JoaquinMRuiz: posts small blind €1
ceedonen: posts big blind €2
*** HOLE CARDS ***
Dealt to matiko09 [9c Ac]
drissmouzou: folds 
PacPacBum: folds 
Painkiller72: folds 
matiko09: folds 
Vikulja1993: folds 
Fitzyferret: folds 
Alex Frider: raises €2.10 to €4.10
JoaquinMRuiz: raises €10.20 to €14.30
ceedonen: folds 
Alex Frider: calls €10.20
*** FLOP *** [6h Tc 6s]
JoaquinMRuiz: bets €18.31
Alex Frider: calls €18.31
*** TURN *** [6h Tc 6s] [Jh]
JoaquinMRuiz: checks 
Alex Frider: checks 
*** RIVER *** [6h Tc 6s Jh] [2h]
JoaquinMRuiz: checks 
Alex Frider: checks 
*** SHOW DOWN ***
JoaquinMRuiz: shows [7s 7c] (two pair, Sevens and Sixes)
Alex Frider: shows [Td 8d] (two pair, Tens and Sixes)
Alex Frider collected €64.72 from pot
*** SUMMARY ***
Total pot €67.22 | Rake €2.50 
Board [6h Tc 6s Jh 2h]
Seat 1: Vikulja1993 folded before Flop (didn't bet)
Seat 2: Fitzyferret folded before Flop (didn't bet)
Seat 3: Alex Frider (button) showed [Td 8d] and won (€64.72) with two pair, Tens and Sixes
Seat 4: JoaquinMRuiz (small blind) showed [7s 7c] and lost with two pair, Sevens and Sixes
Seat 5: ceedonen (big blind) folded before Flop
Seat 6: drissmouzou folded before Flop (didn't bet)
Seat 7: PacPacBum folded before Flop (didn't bet)
Seat 8: Painkiller72 folded before Flop (didn't bet)
Seat 9: matiko09 folded before Flop (didn't bet)





PokerStars Hand #152887471384:  Hold'em No Limit ($0.50/$1.00 USD) - 2016/05/05 17:14:31 CET [2016/05/05 11:14:31 ET]
Table 'Porzia' 9-max Seat #8 is the button
Seat 1: Alex Frider ($105.78 in chips) 
Seat 2: ceedonen ($100 in chips) 
Seat 3: VanDobeln ($98.50 in chips) 
Seat 4: Khaine_CM ($116.88 in chips) 
Seat 5: CZECHMYSAK ($73.37 in chips) 
Seat 6: matiko09 ($100 in chips) 
Seat 7: HITYESCA ($134.79 in chips) 
Seat 8: PRINCE JULIO ($65.69 in chips) 
Alex Frider: posts small blind $0.50
ceedonen: posts big blind $1
*** HOLE CARDS ***
Dealt to matiko09 [2s Kc]
VanDobeln: folds 
Khaine_CM: raises $2 to $3
CZECHMYSAK: folds 
matiko09: folds 
HITYESCA: folds 
PRINCE JULIO: calls $3
Alex Frider: folds 
ceedonen: folds 
*** FLOP *** [Js 4h 6h]
Khaine_CM: bets $5
PRINCE JULIO: folds 
Uncalled bet ($5) returned to Khaine_CM
paullle joins the table at seat #9 
Khaine_CM collected $7.12 from pot
Khaine_CM: doesn't show hand 
*** SUMMARY ***
Total pot $7.50 | Rake $0.38 
Board [Js 4h 6h]
Seat 1: Alex Frider (small blind) folded before Flop
Seat 2: ceedonen (big blind) folded before Flop
Seat 3: VanDobeln folded before Flop (didn't bet)
Seat 4: Khaine_CM collected ($7.12)
Seat 5: CZECHMYSAK folded before Flop (didn't bet)
Seat 6: matiko09 folded before Flop (didn't bet)
Seat 7: HITYESCA folded before Flop (didn't bet)
Seat 8: PRINCE JULIO (button) folded on the Flop





PokerStars Hand #152887476254:  Hold'em No Limit ($0.50/$1.00 USD) - 2016/05/05 17:14:39 CET [2016/05/05 11:14:39 ET]
Table 'Kraz II' 9-max Seat #1 is the button
Seat 1: HITYESCA ($139.80 in chips) 
Seat 2: Hayer ana ($217.22 in chips) 
Seat 3: Khaine_CM ($100 in chips) 
Seat 4: CI58 ($100 in chips) 
Seat 5: Alex Frider ($32.67 in chips) 
Seat 6: andy84lfc ($25.12 in chips) 
Seat 7: maxxmeister ($251.31 in chips) 
Seat 8: 178013 ($291.02 in chips) 
Seat 9: matiko09 ($177.37 in chips) 
Hayer ana: posts small blind $0.50
Khaine_CM: posts big blind $1
*** HOLE CARDS ***
Dealt to matiko09 [4d Qc]
CI58: raises $2 to $3
Alex Frider: folds 
andy84lfc: folds 
maxxmeister: folds 
178013: folds 
matiko09: folds 
HITYESCA: folds 
Hayer ana: folds 
Khaine_CM: folds 
Uncalled bet ($2) returned to CI58
CI58 collected $2.50 from pot
CI58: doesn't show hand 
*** SUMMARY ***
Total pot $2.50 | Rake $0 
Seat 1: HITYESCA (button) folded before Flop (didn't bet)
Seat 2: Hayer ana (small blind) folded before Flop
Seat 3: Khaine_CM (big blind) folded before Flop
Seat 4: CI58 collected ($2.50)
Seat 5: Alex Frider folded before Flop (didn't bet)
Seat 6: andy84lfc folded before Flop (didn't bet)
Seat 7: maxxmeister folded before Flop (didn't bet)
Seat 8: 178013 folded before Flop (didn't bet)
Seat 9: matiko09 folded before Flop (didn't bet)





PokerStars Hand #152887477635:  Hold'em No Limit ($0.50/$1.00 USD) - 2016/05/05 17:14:41 CET [2016/05/05 11:14:41 ET]
Table 'Siberia' 9-max Seat #1 is the button
Seat 1: Lycaon23 ($103.20 in chips) 
Seat 2: Mukhin1 ($100 in chips) 
Seat 4: opsv ($60.78 in chips) 
Seat 5: Hayer ana ($100 in chips) 
Seat 6: bjonlyking ($109.37 in chips) 
Seat 7: matiko09 ($100 in chips) 
Seat 9: arctur17 ($116.77 in chips) 
Mukhin1: posts small blind $0.50
opsv: posts big blind $1
$-Twackle-$: sits out 
*** HOLE CARDS ***
Dealt to matiko09 [Kd Ac]
Hayer ana: folds 
bjonlyking: folds 
matiko09: raises $2 to $3
arctur17: folds 
Lycaon23: folds 
Mukhin1: folds 
opsv: folds 
Uncalled bet ($2) returned to matiko09
matiko09 collected $2.50 from pot
matiko09: doesn't show hand 
*** SUMMARY ***
Total pot $2.50 | Rake $0 
Seat 1: Lycaon23 (button) folded before Flop (didn't bet)
Seat 2: Mukhin1 (small blind) folded before Flop
Seat 4: opsv (big blind) folded before Flop
Seat 5: Hayer ana folded before Flop (didn't bet)
Seat 6: bjonlyking folded before Flop (didn't bet)
Seat 7: matiko09 collected ($2.50)
Seat 9: arctur17 folded before Flop (didn't bet)





PokerStars Hand #152887478332:  Hold'em No Limit ($0.50/$1.00 USD) - 2016/05/05 17:14:42 CET [2016/05/05 11:14:42 ET]
Table 'Natascha' 9-max Seat #8 is the button
Seat 1: Alex Frider ($104.47 in chips) 
Seat 2: HITYESCA ($128.32 in chips) 
Seat 4: Chqraiser007 ($50 in chips) 
Seat 5: Sundown100 ($59.76 in chips) 
Seat 6: CI58 ($118.07 in chips) 
Seat 8: $-Twackle-$ ($113.57 in chips) 
Seat 9: matiko09 ($134.21 in chips) 
matiko09: posts small blind $0.50
Alex Frider: posts big blind $1
*** HOLE CARDS ***
Dealt to matiko09 [7d 8d]
HITYESCA: folds 
Chqraiser007: folds 
Sundown100: folds 
CI58: folds 
$-Twackle-$: folds 
matiko09: raises $1.50 to $2.50
Alex Frider: calls $1.50
*** FLOP *** [8c 4d Js]
matiko09: checks 
Alex Frider: checks 
*** TURN *** [8c 4d Js] [Ts]
matiko09: checks 
Alex Frider: checks 
*** RIVER *** [8c 4d Js Ts] [9s]
matiko09: checks 
Alex Frider: bets $3.42
matiko09: calls $3.42
*** SHOW DOWN ***
Alex Frider: shows [Ah 3c] (high card Ace)
matiko09: shows [7d 8d] (a straight, Seven to Jack)
matiko09 collected $11.25 from pot
*** SUMMARY ***
Total pot $11.84 | Rake $0.59 
Board [8c 4d Js Ts 9s]
Seat 1: Alex Frider (big blind) showed [Ah 3c] and lost with high card Ace
Seat 2: HITYESCA folded before Flop (didn't bet)
Seat 4: Chqraiser007 folded before Flop (didn't bet)
Seat 5: Sundown100 folded before Flop (didn't bet)
Seat 6: CI58 folded before Flop (didn't bet)
Seat 8: $-Twackle-$ (button) folded before Flop (didn't bet)
Seat 9: matiko09 (small blind) showed [7d 8d] and won ($11.25) with a straight, Seven to Jack





