PokerStars Hand #155299804208:  Hold'em No Limit ($0.50/$1.00 USD) - 2016/06/28 15:31:44 CET [2016/06/28 9:31:44 ET]
Table 'Charybdis II' 9-max Seat #5 is the button
Seat 1: r4mz3s ($100 in chips) 
Seat 2: suited_doc ($58.88 in chips) 
Seat 4: Greha999 ($73.88 in chips) 
Seat 5: WDW3 ($100 in chips) 
Seat 6: matiko09 ($121.29 in chips) 
Seat 7: ozone2003 ($121.23 in chips) 
Seat 8: Kukuryzka ($102 in chips) 
Seat 9: SkUhNi ($181.66 in chips) 
matiko09: posts small blind $0.50
ozone2003: posts big blind $1
Rafaello18: sits out 
r4mz3s: posts the ante $0.20
suited_doc: posts the ante $0.20
Greha999: posts the ante $0.20
WDW3: posts the ante $0.20
matiko09: posts the ante $0.20
ozone2003: posts the ante $0.20
Kukuryzka: posts the ante $0.20
SkUhNi: posts the ante $0.20
*** HOLE CARDS ***
Dealt to matiko09 [5d Jd]
Kukuryzka: folds 
SkUhNi: folds 
r4mz3s: folds 
suited_doc: raises $1 to $2
Greha999: folds 
WDW3: calls $2
matiko09: folds 
ozone2003: folds 
*** FLOP *** [Ts Jh 4c]
suited_doc: checks 
WDW3: checks 
*** TURN *** [Ts Jh 4c] [7h]
suited_doc: checks 
WDW3: checks 
*** RIVER *** [Ts Jh 4c 7h] [4d]
suited_doc: bets $3.37
WDW3: calls $3.37
*** SHOW DOWN ***
suited_doc: shows [9c 7c] (two pair, Sevens and Fours)
WDW3: mucks hand 
suited_doc collected $13.15 from pot
*** SUMMARY ***
Total pot $13.84 | Rake $0.69 
Board [Ts Jh 4c 7h 4d]
Seat 1: r4mz3s folded before Flop (didn't bet)
Seat 2: suited_doc showed [9c 7c] and won ($13.15) with two pair, Sevens and Fours
Seat 4: Greha999 folded before Flop (didn't bet)
Seat 5: WDW3 (button) mucked [2h 2d]
Seat 6: matiko09 (small blind) folded before Flop
Seat 7: ozone2003 (big blind) folded before Flop
Seat 8: Kukuryzka folded before Flop (didn't bet)
Seat 9: SkUhNi folded before Flop (didn't bet)





PokerStars Hand #155299805426:  Hold'em No Limit ($0.25/$0.50 USD) - 2016/06/28 15:31:46 CET [2016/06/28 9:31:46 ET]
Table 'Utra' 9-max Seat #2 is the button
Seat 1: ardo888 ($50.10 in chips) 
Seat 2: matiko09 ($50 in chips) 
Seat 3: psychmantis ($47.20 in chips) 
Seat 6: Franky77200 ($46.86 in chips) 
Seat 7: el.suertero ($80.13 in chips) 
Seat 8: funXmun ($52.88 in chips) 
Seat 9: Kukuryzka ($50 in chips) 
psychmantis: posts small blind $0.25
Franky77200: posts big blind $0.50
ardo888: posts the ante $0.10
matiko09: posts the ante $0.10
psychmantis: posts the ante $0.10
Franky77200: posts the ante $0.10
el.suertero: posts the ante $0.10
funXmun: posts the ante $0.10
Kukuryzka: posts the ante $0.10
*** HOLE CARDS ***
Dealt to matiko09 [6h As]
el.suertero: folds 
baoyu4749892 joins the table at seat #5 
funXmun: folds 
Kukuryzka: folds 
ManChild9 joins the table at seat #4 
ardo888: raises $0.75 to $1.25
matiko09: folds 
psychmantis: folds 
Franky77200: calls $0.75
*** FLOP *** [2s Ks Jc]
Franky77200: checks 
ardo888: checks 
*** TURN *** [2s Ks Jc] [Ts]
Franky77200: bets $2.50
ardo888: folds 
Uncalled bet ($2.50) returned to Franky77200
Franky77200 collected $3.28 from pot
Franky77200: doesn't show hand 
*** SUMMARY ***
Total pot $3.45 | Rake $0.17 
Board [2s Ks Jc Ts]
Seat 1: ardo888 folded on the Turn
Seat 2: matiko09 (button) folded before Flop (didn't bet)
Seat 3: psychmantis (small blind) folded before Flop
Seat 6: Franky77200 (big blind) collected ($3.28)
Seat 7: el.suertero folded before Flop (didn't bet)
Seat 8: funXmun folded before Flop (didn't bet)
Seat 9: Kukuryzka folded before Flop (didn't bet)





PokerStars Hand #155299805083:  Hold'em No Limit ($0.50/$1.00 USD) - 2016/06/28 15:31:46 CET [2016/06/28 9:31:46 ET]
Table 'Lobelia' 9-max Seat #7 is the button
Seat 2: SkUhNi ($171.80 in chips) 
Seat 3: matiko09 ($200.44 in chips) 
Seat 4: ardo888 ($100 in chips) 
Seat 5: ramzes160468 ($98.10 in chips) 
Seat 6: WDW3 ($100 in chips) 
Seat 7: tipner ($106.28 in chips) 
Seat 8: TORIO09 ($96 in chips) 
Seat 9: Rafaello18 ($100 in chips) 
TORIO09: posts small blind $0.50
Rafaello18: posts big blind $1
r4mz3s: sits out 
*** HOLE CARDS ***
Dealt to matiko09 [Kd Qh]
SkUhNi: folds 
matiko09: folds 
ardo888: folds 
ramzes160468 has timed out
ramzes160468: folds 
WDW3: raises $1.80 to $2.80
tipner: calls $2.80
TORIO09: folds 
Rafaello18: folds 
*** FLOP *** [5c 3c Tc]
WDW3: bets $4.45
tipner: raises $7.55 to $12
WDW3: folds 
Uncalled bet ($7.55) returned to tipner
tipner collected $15.20 from pot
tipner: doesn't show hand 
*** SUMMARY ***
Total pot $16 | Rake $0.80 
Board [5c 3c Tc]
Seat 2: SkUhNi folded before Flop (didn't bet)
Seat 3: matiko09 folded before Flop (didn't bet)
Seat 4: ardo888 folded before Flop (didn't bet)
Seat 5: ramzes160468 folded before Flop (didn't bet)
Seat 6: WDW3 folded on the Flop
Seat 7: tipner (button) collected ($15.20)
Seat 8: TORIO09 (small blind) folded before Flop
Seat 9: Rafaello18 (big blind) folded before Flop





PokerStars Hand #155299810102:  Hold'em No Limit ($0.50/$1.00 USD) - 2016/06/28 15:31:55 CET [2016/06/28 9:31:55 ET]
Table 'Herodias II' 9-max Seat #6 is the button
Seat 1: matiko09 ($100 in chips) 
Seat 2: myatiy 96 ($117.59 in chips) 
Seat 3: ardo888 ($103.60 in chips) 
Seat 6: vanilica ($101 in chips) 
Seat 7: ilaviiitech ($100 in chips) 
Seat 8: thecurv ($114.27 in chips) 
Seat 9: vanapeer ($100 in chips) 
ilaviiitech: posts small blind $0.50
thecurv: posts big blind $1
f1reworks: sits out 
*** HOLE CARDS ***
Dealt to matiko09 [Kc 2c]
vanapeer: folds 
matiko09: folds 
Buko1988 is disconnected 
myatiy 96: raises $1.50 to $2.50
ardo888: folds 
vanilica: folds 
ilaviiitech: folds 
thecurv: folds 
Uncalled bet ($1.50) returned to myatiy 96
myatiy 96 collected $2.50 from pot
*** SUMMARY ***
Total pot $2.50 | Rake $0 
Seat 1: matiko09 folded before Flop (didn't bet)
Seat 2: myatiy 96 collected ($2.50)
Seat 3: ardo888 folded before Flop (didn't bet)
Seat 6: vanilica (button) folded before Flop (didn't bet)
Seat 7: ilaviiitech (small blind) folded before Flop
Seat 8: thecurv (big blind) folded before Flop
Seat 9: vanapeer folded before Flop (didn't bet)





PokerStars Hand #155299813530:  Hold'em No Limit ($0.50/$1.00 USD) - 2016/06/28 15:32:02 CET [2016/06/28 9:32:02 ET]
Table 'Lyyli II' 9-max Seat #2 is the button
Seat 1: tipner ($131.10 in chips) 
Seat 2: Rafaello18 ($163.36 in chips) 
Seat 3: ozone2003 ($103.12 in chips) 
Seat 4: Greha999 ($98.12 in chips) 
Seat 5: WDW3 ($113.64 in chips) 
Seat 6: matiko09 ($101.50 in chips) 
Seat 7: Kukuryzka ($200.50 in chips) 
Seat 8: SkUhNi ($100 in chips) 
Seat 9: f1reworks ($104.30 in chips) 
ozone2003: posts small blind $0.50
Greha999: posts big blind $1
*** HOLE CARDS ***
Dealt to matiko09 [4s 7d]
WDW3: folds 
matiko09: folds 
Kukuryzka: folds 
SkUhNi: folds 
f1reworks: folds 
tipner: raises $1 to $2
Rafaello18: folds 
ozone2003: folds 
Greha999: calls $1
*** FLOP *** [7h As Kd]
Greha999: checks 
tipner: bets $3
Greha999: calls $3
*** TURN *** [7h As Kd] [Ah]
Greha999: checks 
tipner: checks 
*** RIVER *** [7h As Kd Ah] [Ac]
Greha999: bets $5
tipner: folds 
Uncalled bet ($5) returned to Greha999
Greha999 collected $9.98 from pot
*** SUMMARY ***
Total pot $10.50 | Rake $0.52 
Board [7h As Kd Ah Ac]
Seat 1: tipner folded on the River
Seat 2: Rafaello18 (button) folded before Flop (didn't bet)
Seat 3: ozone2003 (small blind) folded before Flop
Seat 4: Greha999 (big blind) collected ($9.98)
Seat 5: WDW3 folded before Flop (didn't bet)
Seat 6: matiko09 folded before Flop (didn't bet)
Seat 7: Kukuryzka folded before Flop (didn't bet)
Seat 8: SkUhNi folded before Flop (didn't bet)
Seat 9: f1reworks folded before Flop (didn't bet)





PokerStars Hand #155299824878:  Hold'em No Limit ($0.50/$1.00 USD) - 2016/06/28 15:32:24 CET [2016/06/28 9:32:24 ET]
Table 'Herodias II' 9-max Seat #7 is the button
Seat 1: matiko09 ($100 in chips) 
Seat 2: myatiy 96 ($119.09 in chips) 
Seat 3: ardo888 ($103.60 in chips) 
Seat 6: vanilica ($101 in chips) 
Seat 7: ilaviiitech ($100 in chips) 
Seat 8: thecurv ($113.27 in chips) 
Seat 9: vanapeer ($100 in chips) 
thecurv: posts small blind $0.50
vanapeer: posts big blind $1
f1reworks: sits out 
*** HOLE CARDS ***
Dealt to matiko09 [8d 7c]
matiko09: folds 
myatiy 96: raises $1.50 to $2.50
ardo888: folds 
vanilica: folds 
ilaviiitech: calls $2.50
thecurv: folds 
vanapeer: folds 
*** FLOP *** [Kh 9s 5h]
myatiy 96: bets $4.63
ilaviiitech: folds 
Uncalled bet ($4.63) returned to myatiy 96
myatiy 96 collected $6.18 from pot
*** SUMMARY ***
Total pot $6.50 | Rake $0.32 
Board [Kh 9s 5h]
Seat 1: matiko09 folded before Flop (didn't bet)
Seat 2: myatiy 96 collected ($6.18)
Seat 3: ardo888 folded before Flop (didn't bet)
Seat 6: vanilica folded before Flop (didn't bet)
Seat 7: ilaviiitech (button) folded on the Flop
Seat 8: thecurv (small blind) folded before Flop
Seat 9: vanapeer (big blind) folded before Flop





PokerStars Hand #155299826577:  Hold'em No Limit ($0.50/$1.00 USD) - 2016/06/28 15:32:27 CET [2016/06/28 9:32:27 ET]
Table 'Kamenyar' 9-max Seat #5 is the button
Seat 1: Rafaello18 ($100 in chips) 
Seat 2: ozone2003 ($103.32 in chips) 
Seat 3: r4mz3s ($104 in chips) 
Seat 4: f1reworks ($221.41 in chips) 
Seat 5: bwly520 ($234.67 in chips) 
Seat 6: matiko09 ($110.05 in chips) 
Seat 9: pyromid ($93 in chips) 
matiko09: posts small blind $0.50
SkUhNi: is sitting out 
SkUhNi leaves the table
pyromid: posts big blind $1
*** HOLE CARDS ***
Dealt to matiko09 [5h 7h]
myatiy 96 joins the table at seat #8 
myatiy 96 leaves the table
sanpidk joins the table at seat #8 
Rafaello18: folds 
ozone2003: folds 
r4mz3s: folds 
f1reworks: raises $2 to $3
bwly520: folds 
matiko09: folds 
pyromid: folds 
Uncalled bet ($2) returned to f1reworks
f1reworks collected $2.50 from pot
f1reworks: doesn't show hand 
*** SUMMARY ***
Total pot $2.50 | Rake $0 
Seat 1: Rafaello18 folded before Flop (didn't bet)
Seat 2: ozone2003 folded before Flop (didn't bet)
Seat 3: r4mz3s folded before Flop (didn't bet)
Seat 4: f1reworks collected ($2.50)
Seat 5: bwly520 (button) folded before Flop (didn't bet)
Seat 6: matiko09 (small blind) folded before Flop
Seat 9: pyromid (big blind) folded before Flop





PokerStars Hand #155299833119:  Hold'em No Limit ($0.25/$0.50 USD) - 2016/06/28 15:32:40 CET [2016/06/28 9:32:40 ET]
Table 'Utra' 9-max Seat #3 is the button
Seat 1: ardo888 ($50 in chips) 
Seat 2: matiko09 ($50 in chips) 
Seat 3: psychmantis ($46.85 in chips) 
Seat 6: Franky77200 ($48.79 in chips) 
Seat 7: el.suertero ($80.03 in chips) 
Seat 8: funXmun ($52.78 in chips) 
Seat 9: Kukuryzka ($49.90 in chips) 
ManChild9 will be allowed to play after the button
baoyu4749892 will be allowed to play after the button
Franky77200: posts small blind $0.25
el.suertero: posts big blind $0.50
ardo888: posts the ante $0.10
matiko09: posts the ante $0.10
psychmantis: posts the ante $0.10
Franky77200: posts the ante $0.10
el.suertero: posts the ante $0.10
funXmun: posts the ante $0.10
Kukuryzka: posts the ante $0.10
*** HOLE CARDS ***
Dealt to matiko09 [3s Ah]
funXmun: folds 
Kukuryzka: folds 
ardo888: folds 
matiko09: raises $1 to $1.50
psychmantis: calls $1.50
Franky77200: calls $1.25
el.suertero: folds 
*** FLOP *** [8d 7s 6c]
Franky77200: checks 
matiko09: checks 
psychmantis: checks 
*** TURN *** [8d 7s 6c] [8c]
Franky77200: bets $5
matiko09: folds 
psychmantis: folds 
Uncalled bet ($5) returned to Franky77200
Franky77200 collected $5.42 from pot
Franky77200: doesn't show hand 
*** SUMMARY ***
Total pot $5.70 | Rake $0.28 
Board [8d 7s 6c 8c]
Seat 1: ardo888 folded before Flop (didn't bet)
Seat 2: matiko09 folded on the Turn
Seat 3: psychmantis (button) folded on the Turn
Seat 6: Franky77200 (small blind) collected ($5.42)
Seat 7: el.suertero (big blind) folded before Flop
Seat 8: funXmun folded before Flop (didn't bet)
Seat 9: Kukuryzka folded before Flop (didn't bet)





PokerStars Hand #155299836281:  Hold'em No Limit ($0.50/$1.00 USD) - 2016/06/28 15:32:46 CET [2016/06/28 9:32:46 ET]
Table 'Tynka' 9-max Seat #7 is the button
Seat 1: Pokah4Living ($120.07 in chips) 
Seat 2: matiko09 ($100 in chips) 
Seat 3: vanapeer ($122.06 in chips) 
Seat 4: sanpidk ($116.68 in chips) 
Seat 6: SkUhNi ($253.12 in chips) 
Seat 7: Mukhin1 ($139.81 in chips) 
Seat 8: r4mz3s ($103.98 in chips) 
r4mz3s: posts small blind $0.50
Pokah4Living: posts big blind $1
*** HOLE CARDS ***
Dealt to matiko09 [3c 6d]
matiko09: folds 
vanapeer: folds 
sanpidk: folds 
SkUhNi: folds 
Mukhin1: raises $1.30 to $2.30
r4mz3s: calls $1.80
Pokah4Living: folds 
*** FLOP *** [Td 2s 3h]
r4mz3s: checks 
Mukhin1: bets $2.76
r4mz3s: calls $2.76
*** TURN *** [Td 2s 3h] [7c]
r4mz3s: checks 
Mukhin1: bets $7.81
Dickyxxx leaves the table
r4mz3s: calls $7.81
*** RIVER *** [Td 2s 3h 7c] [8d]
r4mz3s: checks 
Mukhin1: checks 
*** SHOW DOWN ***
r4mz3s: shows [7s 7h] (three of a kind, Sevens)
Mukhin1: mucks hand 
r4mz3s collected $25.40 from pot
*** SUMMARY ***
Total pot $26.74 | Rake $1.34 
Board [Td 2s 3h 7c 8d]
Seat 1: Pokah4Living (big blind) folded before Flop
Seat 2: matiko09 folded before Flop (didn't bet)
Seat 3: vanapeer folded before Flop (didn't bet)
Seat 4: sanpidk folded before Flop (didn't bet)
Seat 6: SkUhNi folded before Flop (didn't bet)
Seat 7: Mukhin1 (button) mucked [Jh Ks]
Seat 8: r4mz3s (small blind) showed [7s 7h] and won ($25.40) with three of a kind, Sevens





PokerStars Hand #155299838370:  Hold'em No Limit ($0.50/$1.00 USD) - 2016/06/28 15:32:50 CET [2016/06/28 9:32:50 ET]
Table 'Charybdis II' 9-max Seat #6 is the button
Seat 1: r4mz3s ($100 in chips) 
Seat 2: suited_doc ($66.46 in chips) 
Seat 4: Greha999 ($73.68 in chips) 
Seat 5: WDW3 ($100 in chips) 
Seat 6: matiko09 ($120.59 in chips) 
Seat 7: ozone2003 ($120.03 in chips) 
Seat 8: Kukuryzka ($101.80 in chips) 
Seat 9: SkUhNi ($181.46 in chips) 
ozone2003: posts small blind $0.50
Kukuryzka: posts big blind $1
Rafaello18: sits out 
r4mz3s: posts the ante $0.20
suited_doc: posts the ante $0.20
Greha999: posts the ante $0.20
WDW3: posts the ante $0.20
matiko09: posts the ante $0.20
ozone2003: posts the ante $0.20
Kukuryzka: posts the ante $0.20
SkUhNi: posts the ante $0.20
*** HOLE CARDS ***
Dealt to matiko09 [3c 7h]
SkUhNi: folds 
r4mz3s: folds 
suited_doc: raises $3 to $4
Greha999: folds 
WDW3: folds 
matiko09: folds 
ozone2003: folds 
Kukuryzka: folds 
Uncalled bet ($3) returned to suited_doc
suited_doc collected $4.10 from pot
suited_doc: doesn't show hand 
*** SUMMARY ***
Total pot $4.10 | Rake $0 
Seat 1: r4mz3s folded before Flop (didn't bet)
Seat 2: suited_doc collected ($4.10)
Seat 4: Greha999 folded before Flop (didn't bet)
Seat 5: WDW3 folded before Flop (didn't bet)
Seat 6: matiko09 (button) folded before Flop (didn't bet)
Seat 7: ozone2003 (small blind) folded before Flop
Seat 8: Kukuryzka (big blind) folded before Flop
Seat 9: SkUhNi folded before Flop (didn't bet)





PokerStars Hand #155299840739:  Hold'em No Limit ($0.50/$1.00 USD) - 2016/06/28 15:32:55 CET [2016/06/28 9:32:55 ET]
Table 'Herodias II' 9-max Seat #8 is the button
Seat 1: matiko09 ($100 in chips) 
Seat 2: myatiy 96 ($122.77 in chips) 
Seat 3: ardo888 ($103.60 in chips) 
Seat 6: vanilica ($101 in chips) 
Seat 7: ilaviiitech ($100 in chips) 
Seat 8: thecurv ($112.77 in chips) 
Seat 9: vanapeer ($100 in chips) 
vanapeer: posts small blind $0.50
matiko09: posts big blind $1
f1reworks: sits out 
*** HOLE CARDS ***
Dealt to matiko09 [9h Ts]
myatiy 96: folds 
ardo888: folds 
vanilica: folds 
ilaviiitech: folds 
thecurv: raises $1.05 to $2.05
vanapeer: folds 
matiko09: calls $1.05
*** FLOP *** [Js 6d Qh]
matiko09: checks 
thecurv: checks 
*** TURN *** [Js 6d Qh] [5h]
matiko09: bets $2.27
thecurv: raises $5.23 to $7.50
matiko09: folds 
Uncalled bet ($5.23) returned to thecurv
thecurv collected $8.68 from pot
thecurv: doesn't show hand 
*** SUMMARY ***
Total pot $9.14 | Rake $0.46 
Board [Js 6d Qh 5h]
Seat 1: matiko09 (big blind) folded on the Turn
Seat 2: myatiy 96 folded before Flop (didn't bet)
Seat 3: ardo888 folded before Flop (didn't bet)
Seat 6: vanilica folded before Flop (didn't bet)
Seat 7: ilaviiitech folded before Flop (didn't bet)
Seat 8: thecurv (button) collected ($8.68)
Seat 9: vanapeer (small blind) folded before Flop





PokerStars Hand #155299845872:  Hold'em No Limit ($0.25/$0.50 USD) - 2016/06/28 15:33:05 CET [2016/06/28 9:33:05 ET]
Table 'Arago' 9-max Seat #7 is the button
Seat 1: Vedpapa ($50.75 in chips) 
Seat 2: Xx7-Zeus-7xX ($48.50 in chips) 
Seat 3: Kodiak8787 ($89.19 in chips) 
Seat 4: funXmun ($53.81 in chips) 
Seat 5: omorfadramou ($50 in chips) 
Seat 6: Slushpup69 ($77.04 in chips) 
Seat 7: Rafaello18 ($50 in chips) 
Seat 8: matiko09 ($50 in chips) 
Seat 9: bratbugor ($77.46 in chips) 
matiko09: posts small blind $0.25
bratbugor: posts big blind $0.50
*** HOLE CARDS ***
Dealt to matiko09 [Qc Ac]
Vedpapa: folds 
Xx7-Zeus-7xX: folds 
Kodiak8787: folds 
funXmun: folds 
omorfadramou: folds 
Slushpup69: folds 
Slushpup69 leaves the table
Rafaello18: folds 
SumPosad joins the table at seat #6 
matiko09: raises $1 to $1.50
bratbugor: folds 
Uncalled bet ($1) returned to matiko09
matiko09 collected $1 from pot
matiko09: doesn't show hand 
*** SUMMARY ***
Total pot $1 | Rake $0 
Seat 1: Vedpapa folded before Flop (didn't bet)
Seat 2: Xx7-Zeus-7xX folded before Flop (didn't bet)
Seat 3: Kodiak8787 folded before Flop (didn't bet)
Seat 4: funXmun folded before Flop (didn't bet)
Seat 5: omorfadramou folded before Flop (didn't bet)
Seat 6: Slushpup69 folded before Flop (didn't bet)
Seat 7: Rafaello18 (button) folded before Flop (didn't bet)
Seat 8: matiko09 (small blind) collected ($1)
Seat 9: bratbugor (big blind) folded before Flop





PokerStars Hand #155299846323:  Hold'em No Limit ($0.50/$1.00 USD) - 2016/06/28 15:33:06 CET [2016/06/28 9:33:06 ET]
Table 'Lobelia' 9-max Seat #8 is the button
Seat 1: r4mz3s ($100 in chips) 
Seat 2: SkUhNi ($171.80 in chips) 
Seat 3: matiko09 ($200.44 in chips) 
Seat 4: ardo888 ($100 in chips) 
Seat 6: WDW3 ($100 in chips) 
Seat 7: tipner ($114.23 in chips) 
Seat 8: TORIO09 ($95.50 in chips) 
Seat 9: Rafaello18 ($100 in chips) 
Rafaello18: posts small blind $0.50
r4mz3s: posts big blind $1
*** HOLE CARDS ***
Dealt to matiko09 [Tc Td]
SkUhNi: folds 
matiko09: raises $2 to $3
ardo888: folds 
WDW3: folds 
tipner: folds 
TORIO09: folds 
Rafaello18: folds 
r4mz3s: calls $2
*** FLOP *** [9d Jh Ad]
r4mz3s: checks 
matiko09: checks 
*** TURN *** [9d Jh Ad] [Qh]
r4mz3s: bets $6.18
matiko09: folds 
Uncalled bet ($6.18) returned to r4mz3s
r4mz3s collected $6.18 from pot
r4mz3s: doesn't show hand 
*** SUMMARY ***
Total pot $6.50 | Rake $0.32 
Board [9d Jh Ad Qh]
Seat 1: r4mz3s (big blind) collected ($6.18)
Seat 2: SkUhNi folded before Flop (didn't bet)
Seat 3: matiko09 folded on the Turn
Seat 4: ardo888 folded before Flop (didn't bet)
Seat 6: WDW3 folded before Flop (didn't bet)
Seat 7: tipner folded before Flop (didn't bet)
Seat 8: TORIO09 (button) folded before Flop (didn't bet)
Seat 9: Rafaello18 (small blind) folded before Flop





PokerStars Hand #155299851405:  Hold'em No Limit ($0.50/$1.00 USD) - 2016/06/28 15:33:15 CET [2016/06/28 9:33:15 ET]
Table 'Lyyli II' 9-max Seat #3 is the button
Seat 1: tipner ($126.10 in chips) 
Seat 2: Rafaello18 ($163.36 in chips) 
Seat 3: ozone2003 ($102.62 in chips) 
Seat 4: Greha999 ($103.10 in chips) 
Seat 5: WDW3 ($113.64 in chips) 
Seat 6: matiko09 ($101.50 in chips) 
Seat 7: Kukuryzka ($200.50 in chips) 
Seat 8: SkUhNi ($100 in chips) 
Seat 9: f1reworks ($104.30 in chips) 
Greha999: posts small blind $0.50
WDW3: posts big blind $1
*** HOLE CARDS ***
Dealt to matiko09 [Qc 3s]
matiko09: folds 
Kukuryzka: folds 
SkUhNi: folds 
f1reworks: folds 
tipner: folds 
Rafaello18: folds 
ozone2003: folds 
Greha999: raises $1 to $2
WDW3: calls $1
*** FLOP *** [8h 8d 5h]
Greha999: checks 
WDW3: bets $2.51
Greha999: folds 
Uncalled bet ($2.51) returned to WDW3
WDW3 collected $3.80 from pot
WDW3: doesn't show hand 
*** SUMMARY ***
Total pot $4 | Rake $0.20 
Board [8h 8d 5h]
Seat 1: tipner folded before Flop (didn't bet)
Seat 2: Rafaello18 folded before Flop (didn't bet)
Seat 3: ozone2003 (button) folded before Flop (didn't bet)
Seat 4: Greha999 (small blind) folded on the Flop
Seat 5: WDW3 (big blind) collected ($3.80)
Seat 6: matiko09 folded before Flop (didn't bet)
Seat 7: Kukuryzka folded before Flop (didn't bet)
Seat 8: SkUhNi folded before Flop (didn't bet)
Seat 9: f1reworks folded before Flop (didn't bet)





PokerStars Hand #155299851940:  Hold'em No Limit ($0.50/$1.00 USD) - 2016/06/28 15:33:16 CET [2016/06/28 9:33:16 ET]
Table 'Charybdis II' 9-max Seat #7 is the button
Seat 1: r4mz3s ($100 in chips) 
Seat 2: suited_doc ($69.36 in chips) 
Seat 4: Greha999 ($73.48 in chips) 
Seat 5: WDW3 ($100 in chips) 
Seat 6: matiko09 ($120.39 in chips) 
Seat 7: ozone2003 ($119.33 in chips) 
Seat 8: Kukuryzka ($100.60 in chips) 
Kukuryzka: posts small blind $0.50
SkUhNi: is sitting out 
SkUhNi leaves the table
r4mz3s: posts big blind $1
Rafaello18: sits out 
r4mz3s: posts the ante $0.20
suited_doc: posts the ante $0.20
Greha999: posts the ante $0.20
WDW3: posts the ante $0.20
matiko09: posts the ante $0.20
ozone2003: posts the ante $0.20
Kukuryzka: posts the ante $0.20
*** HOLE CARDS ***
Dealt to matiko09 [9c 5c]
myatiy 96 joins the table at seat #9 
suited_doc: raises $1 to $2
Greha999: calls $2
WDW3: folds 
matiko09: folds 
ozone2003: folds 
Kukuryzka: calls $1.50
r4mz3s: calls $1
*** FLOP *** [2c As 9h]
Kukuryzka: checks 
r4mz3s: checks 
suited_doc: bets $2
Greha999: calls $2
Kukuryzka: folds 
r4mz3s: folds 
*** TURN *** [2c As 9h] [8d]
suited_doc: bets $3
Greha999: calls $3
*** RIVER *** [2c As 9h 8d] [Qh]
suited_doc: checks 
Greha999: checks 
*** SHOW DOWN ***
suited_doc: shows [Ts Ah] (a pair of Aces)
Greha999: mucks hand 
suited_doc collected $18.43 from pot
*** SUMMARY ***
Total pot $19.40 | Rake $0.97 
Board [2c As 9h 8d Qh]
Seat 1: r4mz3s (big blind) folded on the Flop
Seat 2: suited_doc showed [Ts Ah] and won ($18.43) with a pair of Aces
Seat 4: Greha999 mucked [Kh 2h]
Seat 5: WDW3 folded before Flop (didn't bet)
Seat 6: matiko09 folded before Flop (didn't bet)
Seat 7: ozone2003 (button) folded before Flop (didn't bet)
Seat 8: Kukuryzka (small blind) folded on the Flop





PokerStars Hand #155299854001:  Hold'em No Limit ($0.50/$1.00 USD) - 2016/06/28 15:33:20 CET [2016/06/28 9:33:20 ET]
Table 'Kamenyar' 9-max Seat #6 is the button
Seat 1: Rafaello18 ($100 in chips) 
Seat 2: ozone2003 ($103.32 in chips) 
Seat 3: r4mz3s ($104 in chips) 
Seat 4: f1reworks ($222.91 in chips) 
Seat 5: bwly520 ($234.67 in chips) 
Seat 6: matiko09 ($109.55 in chips) 
Seat 9: pyromid ($92 in chips) 
sanpidk will be allowed to play after the button
pyromid: posts small blind $0.50
Rafaello18: posts big blind $1
*** HOLE CARDS ***
Dealt to matiko09 [Th 9s]
ozone2003: folds 
r4mz3s: raises $1.55 to $2.55
f1reworks: folds 
bwly520: folds 
matiko09: folds 
pyromid: folds 
Rafaello18: calls $1.55
*** FLOP *** [Kh Ks 6s]
Rafaello18: checks 
r4mz3s: checks 
*** TURN *** [Kh Ks 6s] [Ts]
Rafaello18: bets $4
r4mz3s: folds 
Uncalled bet ($4) returned to Rafaello18
Rafaello18 collected $5.32 from pot
Rafaello18: doesn't show hand 
*** SUMMARY ***
Total pot $5.60 | Rake $0.28 
Board [Kh Ks 6s Ts]
Seat 1: Rafaello18 (big blind) collected ($5.32)
Seat 2: ozone2003 folded before Flop (didn't bet)
Seat 3: r4mz3s folded on the Turn
Seat 4: f1reworks folded before Flop (didn't bet)
Seat 5: bwly520 folded before Flop (didn't bet)
Seat 6: matiko09 (button) folded before Flop (didn't bet)
Seat 9: pyromid (small blind) folded before Flop





PokerStars Hand #155299862552:  Hold'em No Limit ($0.25/$0.50 USD) - 2016/06/28 15:33:37 CET [2016/06/28 9:33:37 ET]
Table 'Arago' 9-max Seat #8 is the button
Seat 1: Vedpapa ($50.75 in chips) 
Seat 2: Xx7-Zeus-7xX ($48.50 in chips) 
Seat 3: Kodiak8787 ($89.19 in chips) 
Seat 4: funXmun ($53.81 in chips) 
Seat 5: omorfadramou ($50 in chips) 
Seat 7: Rafaello18 ($50 in chips) 
Seat 8: matiko09 ($50.50 in chips) 
Seat 9: bratbugor ($76.96 in chips) 
bratbugor: posts small blind $0.25
Vedpapa: posts big blind $0.50
SumPosad: sits out 
*** HOLE CARDS ***
Dealt to matiko09 [Ac Jd]
Xx7-Zeus-7xX: folds 
Kodiak8787: raises $0.97 to $1.47
funXmun: raises $2.94 to $4.41
omorfadramou: folds 
Rafaello18: folds 
matiko09: folds 
bratbugor: folds 
Vedpapa: folds 
Kodiak8787: folds 
Uncalled bet ($2.94) returned to funXmun
funXmun collected $3.69 from pot
funXmun: doesn't show hand 
*** SUMMARY ***
Total pot $3.69 | Rake $0 
Seat 1: Vedpapa (big blind) folded before Flop
Seat 2: Xx7-Zeus-7xX folded before Flop (didn't bet)
Seat 3: Kodiak8787 folded before Flop
Seat 4: funXmun collected ($3.69)
Seat 5: omorfadramou folded before Flop (didn't bet)
Seat 7: Rafaello18 folded before Flop (didn't bet)
Seat 8: matiko09 (button) folded before Flop (didn't bet)
Seat 9: bratbugor (small blind) folded before Flop





PokerStars Hand #155299880319:  Hold'em No Limit ($0.50/$1.00 USD) - 2016/06/28 15:34:11 CET [2016/06/28 9:34:11 ET]
Table 'Kamenyar' 9-max Seat #9 is the button
Seat 1: Rafaello18 ($102.77 in chips) 
Seat 2: ozone2003 ($103.32 in chips) 
Seat 3: r4mz3s ($101.45 in chips) 
Seat 4: f1reworks ($222.91 in chips) 
Seat 5: bwly520 ($234.67 in chips) 
Seat 6: matiko09 ($109.55 in chips) 
Seat 9: pyromid ($91.50 in chips) 
Rafaello18: posts small blind $0.50
ozone2003: posts big blind $1
sanpidk: sits out 
*** HOLE CARDS ***
Dealt to matiko09 [9s 5s]
r4mz3s: folds 
f1reworks: raises $2 to $3
bwly520: folds 
matiko09: folds 
pyromid: folds 
Rafaello18: folds 
ozone2003: folds 
Uncalled bet ($2) returned to f1reworks
f1reworks collected $2.50 from pot
*** SUMMARY ***
Total pot $2.50 | Rake $0 
Seat 1: Rafaello18 (small blind) folded before Flop
Seat 2: ozone2003 (big blind) folded before Flop
Seat 3: r4mz3s folded before Flop (didn't bet)
Seat 4: f1reworks collected ($2.50)
Seat 5: bwly520 folded before Flop (didn't bet)
Seat 6: matiko09 folded before Flop (didn't bet)
Seat 9: pyromid (button) folded before Flop (didn't bet)





PokerStars Hand #155299881776:  Hold'em No Limit ($0.50/$1.00 USD) - 2016/06/28 15:34:14 CET [2016/06/28 9:34:14 ET]
Table 'Lyyli II' 9-max Seat #4 is the button
Seat 1: tipner ($126.10 in chips) 
Seat 2: Rafaello18 ($163.36 in chips) 
Seat 3: ozone2003 ($102.62 in chips) 
Seat 4: Greha999 ($101.10 in chips) 
Seat 5: WDW3 ($115.44 in chips) 
Seat 6: matiko09 ($101.50 in chips) 
Seat 7: Kukuryzka ($200.50 in chips) 
Seat 8: SkUhNi ($100 in chips) 
Seat 9: f1reworks ($104.30 in chips) 
WDW3: posts small blind $0.50
matiko09: posts big blind $1
*** HOLE CARDS ***
Dealt to matiko09 [Th 4c]
Kukuryzka: folds 
SkUhNi: folds 
f1reworks: raises $2 to $3
tipner: folds 
Rafaello18: raises $6 to $9
ozone2003: folds 
Greha999: folds 
WDW3: raises $13 to $22
matiko09: folds 
f1reworks: folds 
Rafaello18: folds 
Uncalled bet ($13) returned to WDW3
WDW3 collected $22 from pot
WDW3: doesn't show hand 
*** SUMMARY ***
Total pot $22 | Rake $0 
Seat 1: tipner folded before Flop (didn't bet)
Seat 2: Rafaello18 folded before Flop
Seat 3: ozone2003 folded before Flop (didn't bet)
Seat 4: Greha999 (button) folded before Flop (didn't bet)
Seat 5: WDW3 (small blind) collected ($22)
Seat 6: matiko09 (big blind) folded before Flop
Seat 7: Kukuryzka folded before Flop (didn't bet)
Seat 8: SkUhNi folded before Flop (didn't bet)
Seat 9: f1reworks folded before Flop





PokerStars Hand #155299882449:  Hold'em No Limit ($0.25/$0.50 USD) - 2016/06/28 15:34:16 CET [2016/06/28 9:34:16 ET]
Table 'Utra' 9-max Seat #6 is the button
Seat 1: ardo888 ($50 in chips) 
Seat 2: matiko09 ($50 in chips) 
Seat 3: psychmantis ($45.25 in chips) 
Seat 4: ManChild9 ($50 in chips) 
Seat 5: baoyu4749892 ($50 in chips) 
Seat 6: Franky77200 ($52.61 in chips) 
Seat 7: el.suertero ($79.43 in chips) 
Seat 8: funXmun ($52.68 in chips) 
Seat 9: Kukuryzka ($49.80 in chips) 
el.suertero: posts small blind $0.25
funXmun: posts big blind $0.50
ManChild9: posts big blind $0.50
baoyu4749892: posts big blind $0.50
ardo888: posts the ante $0.10
matiko09: posts the ante $0.10
psychmantis: posts the ante $0.10
ManChild9: posts the ante $0.10
baoyu4749892: posts the ante $0.10
Franky77200: posts the ante $0.10
el.suertero: posts the ante $0.10
funXmun: posts the ante $0.10
Kukuryzka: posts the ante $0.10
*** HOLE CARDS ***
Dealt to matiko09 [Qd 7h]
Kukuryzka: folds 
ardo888: folds 
matiko09: folds 
psychmantis: folds 
ManChild9: checks 
baoyu4749892: raises $0.50 to $1
Franky77200: calls $1
el.suertero: calls $0.75
funXmun: folds 
ManChild9: calls $0.50
*** FLOP *** [Ac 4c Qs]
el.suertero: checks 
ManChild9: checks 
baoyu4749892: bets $2.50
Franky77200: folds 
el.suertero: calls $2.50
ManChild9: folds 
*** TURN *** [Ac 4c Qs] [4d]
el.suertero: checks 
baoyu4749892: bets $5
el.suertero: folds 
Uncalled bet ($5) returned to baoyu4749892
baoyu4749892 collected $9.88 from pot
baoyu4749892: doesn't show hand 
*** SUMMARY ***
Total pot $10.40 | Rake $0.52 
Board [Ac 4c Qs 4d]
Seat 1: ardo888 folded before Flop (didn't bet)
Seat 2: matiko09 folded before Flop (didn't bet)
Seat 3: psychmantis folded before Flop (didn't bet)
Seat 4: ManChild9 folded on the Flop
Seat 5: baoyu4749892 collected ($9.88)
Seat 6: Franky77200 (button) folded on the Flop
Seat 7: el.suertero (small blind) folded on the Turn
Seat 8: funXmun (big blind) folded before Flop
Seat 9: Kukuryzka folded before Flop (didn't bet)





PokerStars Hand #155299883155:  Hold'em No Limit ($0.50/$1.00 USD) - 2016/06/28 15:34:17 CET [2016/06/28 9:34:17 ET]
Table 'Tynka' 9-max Seat #8 is the button
Seat 1: Pokah4Living ($119.07 in chips) 
Seat 2: matiko09 ($100 in chips) 
Seat 3: vanapeer ($122.06 in chips) 
Seat 4: sanpidk ($116.68 in chips) 
Seat 6: SkUhNi ($253.12 in chips) 
Seat 7: Mukhin1 ($126.94 in chips) 
Seat 8: r4mz3s ($116.51 in chips) 
Pokah4Living: posts small blind $0.50
matiko09: posts big blind $1
*** HOLE CARDS ***
Dealt to matiko09 [Ks 9c]
vanapeer: folds 
sanpidk: folds 
SkUhNi: folds 
Mukhin1: folds 
r4mz3s: folds 
Pokah4Living: folds 
Uncalled bet ($0.50) returned to matiko09
matiko09 collected $1 from pot
matiko09: doesn't show hand 
*** SUMMARY ***
Total pot $1 | Rake $0 
Seat 1: Pokah4Living (small blind) folded before Flop
Seat 2: matiko09 (big blind) collected ($1)
Seat 3: vanapeer folded before Flop (didn't bet)
Seat 4: sanpidk folded before Flop (didn't bet)
Seat 6: SkUhNi folded before Flop (didn't bet)
Seat 7: Mukhin1 folded before Flop (didn't bet)
Seat 8: r4mz3s (button) folded before Flop (didn't bet)





PokerStars Hand #155299889397:  Hold'em No Limit ($0.50/$1.00 USD) - 2016/06/28 15:34:29 CET [2016/06/28 9:34:29 ET]
Table 'Tynka' 9-max Seat #1 is the button
Seat 1: Pokah4Living ($118.57 in chips) 
Seat 2: matiko09 ($100.50 in chips) 
Seat 4: sanpidk ($116.68 in chips) 
Seat 6: SkUhNi ($253.12 in chips) 
Seat 7: Mukhin1 ($126.94 in chips) 
Seat 8: r4mz3s ($116.51 in chips) 
matiko09: posts small blind $0.50
vanapeer: is sitting out 
sanpidk: posts big blind $1
*** HOLE CARDS ***
Dealt to matiko09 [6c 7c]
SkUhNi: folds 
Mukhin1: folds 
r4mz3s: folds 
Pokah4Living: calls $1
matiko09: raises $3.50 to $4.50
vanapeer leaves the table
sanpidk: raises $9 to $13.50
Pokah4Living: folds 
matiko09: folds 
Uncalled bet ($9) returned to sanpidk
sanpidk collected $10 from pot
sanpidk: doesn't show hand 
*** SUMMARY ***
Total pot $10 | Rake $0 
Seat 1: Pokah4Living (button) folded before Flop
Seat 2: matiko09 (small blind) folded before Flop
Seat 4: sanpidk (big blind) collected ($10)
Seat 6: SkUhNi folded before Flop (didn't bet)
Seat 7: Mukhin1 folded before Flop (didn't bet)
Seat 8: r4mz3s folded before Flop (didn't bet)





PokerStars Hand #155299889145:  Hold'em No Limit ($0.50/$1.00 USD) - 2016/06/28 15:34:29 CET [2016/06/28 9:34:29 ET]
Table 'Herodias II' 9-max Seat #9 is the button
Seat 1: matiko09 ($100 in chips) 
Seat 2: myatiy 96 ($122.77 in chips) 
Seat 3: ardo888 ($103.60 in chips) 
Seat 6: vanilica ($101 in chips) 
Seat 7: ilaviiitech ($100 in chips) 
Seat 8: thecurv ($117.13 in chips) 
Seat 9: vanapeer ($100 in chips) 
matiko09: posts small blind $0.50
myatiy 96: posts big blind $1
f1reworks: sits out 
*** HOLE CARDS ***
Dealt to matiko09 [7c 2h]
ardo888: folds 
vanilica: raises $2 to $3
ilaviiitech: folds 
thecurv: folds 
vanapeer: folds 
matiko09: folds 
myatiy 96: folds 
Uncalled bet ($2) returned to vanilica
vanilica collected $2.50 from pot
vanilica: doesn't show hand 
*** SUMMARY ***
Total pot $2.50 | Rake $0 
Seat 1: matiko09 (small blind) folded before Flop
Seat 2: myatiy 96 (big blind) folded before Flop
Seat 3: ardo888 folded before Flop (didn't bet)
Seat 6: vanilica collected ($2.50)
Seat 7: ilaviiitech folded before Flop (didn't bet)
Seat 8: thecurv folded before Flop (didn't bet)
Seat 9: vanapeer (button) folded before Flop (didn't bet)





PokerStars Hand #155299892873:  Hold'em No Limit ($0.50/$1.00 USD) - 2016/06/28 15:34:36 CET [2016/06/28 9:34:36 ET]
Table 'Charybdis II' 9-max Seat #8 is the button
Seat 1: r4mz3s ($100 in chips) 
Seat 3: Rafaello18 ($100 in chips) 
Seat 4: Greha999 ($66.28 in chips) 
Seat 5: WDW3 ($100 in chips) 
Seat 6: matiko09 ($120.19 in chips) 
Seat 7: ozone2003 ($119.13 in chips) 
Seat 8: Kukuryzka ($100 in chips) 
myatiy 96 will be allowed to play after the button
r4mz3s: posts small blind $0.50
suited_doc: is sitting out 
Rafaello18: posts big blind $1
r4mz3s: posts the ante $0.20
Rafaello18: posts the ante $0.20
Greha999: posts the ante $0.20
WDW3: posts the ante $0.20
matiko09: posts the ante $0.20
ozone2003: posts the ante $0.20
Kukuryzka: posts the ante $0.20
*** HOLE CARDS ***
Dealt to matiko09 [8h 9h]
Greha999: raises $1 to $2
WDW3: folds 
matiko09: raises $1 to $3
ozone2003: folds 
Kukuryzka: folds 
r4mz3s: folds 
Rafaello18: folds 
Greha999: calls $1
*** FLOP *** [Jd 2c 8s]
Greha999: checks 
matiko09: bets $4.39
Greha999: calls $4.39
*** TURN *** [Jd 2c 8s] [9s]
Greha999: checks 
matiko09: bets $10
Greha999: folds 
Uncalled bet ($10) returned to matiko09
matiko09 collected $16.80 from pot
matiko09: doesn't show hand 
*** SUMMARY ***
Total pot $17.68 | Rake $0.88 
Board [Jd 2c 8s 9s]
Seat 1: r4mz3s (small blind) folded before Flop
Seat 3: Rafaello18 (big blind) folded before Flop
Seat 4: Greha999 folded on the Turn
Seat 5: WDW3 folded before Flop (didn't bet)
Seat 6: matiko09 collected ($16.80)
Seat 7: ozone2003 folded before Flop (didn't bet)
Seat 8: Kukuryzka (button) folded before Flop (didn't bet)





PokerStars Hand #155299896415:  Hold'em No Limit ($0.25/$0.50 USD) - 2016/06/28 15:34:43 CET [2016/06/28 9:34:43 ET]
Table 'Arago' 9-max Seat #9 is the button
Seat 1: Vedpapa ($50.25 in chips) 
Seat 2: Xx7-Zeus-7xX ($48.50 in chips) 
Seat 3: Kodiak8787 ($87.72 in chips) 
Seat 4: funXmun ($56.03 in chips) 
Seat 5: omorfadramou ($50 in chips) 
Seat 7: Rafaello18 ($50 in chips) 
Seat 8: matiko09 ($50.50 in chips) 
Seat 9: bratbugor ($76.71 in chips) 
Vedpapa: posts small blind $0.25
Xx7-Zeus-7xX: posts big blind $0.50
SumPosad: sits out 
*** HOLE CARDS ***
Dealt to matiko09 [As 4d]
Kodiak8787: folds 
funXmun: folds 
omorfadramou: raises $1 to $1.50
Rafaello18: folds 
matiko09: folds 
bratbugor: folds 
Vedpapa: folds 
Xx7-Zeus-7xX: folds 
Uncalled bet ($1) returned to omorfadramou
omorfadramou collected $1.25 from pot
omorfadramou: doesn't show hand 
*** SUMMARY ***
Total pot $1.25 | Rake $0 
Seat 1: Vedpapa (small blind) folded before Flop
Seat 2: Xx7-Zeus-7xX (big blind) folded before Flop
Seat 3: Kodiak8787 folded before Flop (didn't bet)
Seat 4: funXmun folded before Flop (didn't bet)
Seat 5: omorfadramou collected ($1.25)
Seat 7: Rafaello18 folded before Flop (didn't bet)
Seat 8: matiko09 folded before Flop (didn't bet)
Seat 9: bratbugor (button) folded before Flop (didn't bet)





PokerStars Hand #155299901700:  Hold'em No Limit ($0.50/$1.00 USD) - 2016/06/28 15:34:53 CET [2016/06/28 9:34:53 ET]
Table 'Herodias II' 9-max Seat #1 is the button
Seat 1: matiko09 ($100 in chips) 
Seat 2: myatiy 96 ($121.77 in chips) 
Seat 3: ardo888 ($103.60 in chips) 
Seat 6: vanilica ($102.50 in chips) 
Seat 7: ilaviiitech ($100 in chips) 
Seat 8: thecurv ($117.13 in chips) 
Seat 9: vanapeer ($100 in chips) 
myatiy 96: posts small blind $0.50
ardo888: posts big blind $1
f1reworks: sits out 
*** HOLE CARDS ***
Dealt to matiko09 [4h 9c]
vanilica: folds 
ilaviiitech: folds 
thecurv: raises $1.50 to $2.50
vanapeer: folds 
matiko09: folds 
myatiy 96: folds 
ardo888: folds 
Uncalled bet ($1.50) returned to thecurv
thecurv collected $2.50 from pot
thecurv: doesn't show hand 
*** SUMMARY ***
Total pot $2.50 | Rake $0 
Seat 1: matiko09 (button) folded before Flop (didn't bet)
Seat 2: myatiy 96 (small blind) folded before Flop
Seat 3: ardo888 (big blind) folded before Flop
Seat 6: vanilica folded before Flop (didn't bet)
Seat 7: ilaviiitech folded before Flop (didn't bet)
Seat 8: thecurv collected ($2.50)
Seat 9: vanapeer folded before Flop (didn't bet)





PokerStars Hand #155299904958:  Hold'em No Limit ($0.50/$1.00 USD) - 2016/06/28 15:35:00 CET [2016/06/28 9:35:00 ET]
Table 'Kamenyar' 9-max Seat #1 is the button
Seat 1: Rafaello18 ($102.27 in chips) 
Seat 2: ozone2003 ($102.32 in chips) 
Seat 3: r4mz3s ($101.45 in chips) 
Seat 4: f1reworks ($224.41 in chips) 
Seat 5: bwly520 ($234.67 in chips) 
Seat 6: matiko09 ($109.55 in chips) 
Seat 9: pyromid ($91.50 in chips) 
ozone2003: posts small blind $0.50
r4mz3s: posts big blind $1
sanpidk: sits out 
*** HOLE CARDS ***
Dealt to matiko09 [3d 3s]
f1reworks: folds 
bwly520: folds 
vanapeer leaves the table
myatiy 96 joins the table at seat #7 
myatiy 96 leaves the table
matiko09: raises $2 to $3
pyromid: folds 
Rafaello18: folds 
ozone2003: folds 
r4mz3s: folds 
Uncalled bet ($2) returned to matiko09
matiko09 collected $2.50 from pot
matiko09: doesn't show hand 
*** SUMMARY ***
Total pot $2.50 | Rake $0 
Seat 1: Rafaello18 (button) folded before Flop (didn't bet)
Seat 2: ozone2003 (small blind) folded before Flop
Seat 3: r4mz3s (big blind) folded before Flop
Seat 4: f1reworks folded before Flop (didn't bet)
Seat 5: bwly520 folded before Flop (didn't bet)
Seat 6: matiko09 collected ($2.50)
Seat 9: pyromid folded before Flop (didn't bet)





PokerStars Hand #155299916126:  Hold'em No Limit ($0.50/$1.00 USD) - 2016/06/28 15:35:22 CET [2016/06/28 9:35:22 ET]
Table 'Herodias II' 9-max Seat #2 is the button
Seat 1: matiko09 ($100 in chips) 
Seat 2: myatiy 96 ($121.27 in chips) 
Seat 3: ardo888 ($102.60 in chips) 
Seat 4: f1reworks ($100 in chips) 
Seat 6: vanilica ($102.50 in chips) 
Seat 7: ilaviiitech ($100 in chips) 
Seat 8: thecurv ($118.63 in chips) 
Seat 9: vanapeer ($100 in chips) 
ardo888: posts small blind $0.50
f1reworks: posts big blind $1
*** HOLE CARDS ***
Dealt to matiko09 [7s 4h]
vanilica: folds 
ilaviiitech: folds 
thecurv: folds 
vanapeer: folds 
matiko09: folds 
myatiy 96: folds 
ardo888: raises $2 to $3
f1reworks: calls $2
*** FLOP *** [Qh 7h Th]
ardo888: checks 
f1reworks: checks 
*** TURN *** [Qh 7h Th] [Tc]
ardo888: checks 
f1reworks: checks 
*** RIVER *** [Qh 7h Th Tc] [9d]
ardo888: bets $3.70
f1reworks: folds 
Uncalled bet ($3.70) returned to ardo888
ardo888 collected $5.70 from pot
ardo888: doesn't show hand 
*** SUMMARY ***
Total pot $6 | Rake $0.30 
Board [Qh 7h Th Tc 9d]
Seat 1: matiko09 folded before Flop (didn't bet)
Seat 2: myatiy 96 (button) folded before Flop (didn't bet)
Seat 3: ardo888 (small blind) collected ($5.70)
Seat 4: f1reworks (big blind) folded on the River
Seat 6: vanilica folded before Flop (didn't bet)
Seat 7: ilaviiitech folded before Flop (didn't bet)
Seat 8: thecurv folded before Flop (didn't bet)
Seat 9: vanapeer folded before Flop (didn't bet)





PokerStars Hand #155299917926:  Hold'em No Limit ($0.25/$0.50 USD) - 2016/06/28 15:35:25 CET [2016/06/28 9:35:25 ET]
Table 'Utra' 9-max Seat #7 is the button
Seat 1: ardo888 ($50 in chips) 
Seat 2: matiko09 ($50 in chips) 
Seat 3: psychmantis ($45.15 in chips) 
Seat 4: ManChild9 ($48.90 in chips) 
Seat 5: baoyu4749892 ($56.28 in chips) 
Seat 6: Franky77200 ($51.51 in chips) 
Seat 7: el.suertero ($75.83 in chips) 
Seat 8: funXmun ($52.08 in chips) 
Seat 9: Kukuryzka ($49.70 in chips) 
funXmun: posts small blind $0.25
Kukuryzka: posts big blind $0.50
ardo888: posts the ante $0.10
matiko09: posts the ante $0.10
psychmantis: posts the ante $0.10
ManChild9: posts the ante $0.10
baoyu4749892: posts the ante $0.10
Franky77200: posts the ante $0.10
el.suertero: posts the ante $0.10
funXmun: posts the ante $0.10
Kukuryzka: posts the ante $0.10
*** HOLE CARDS ***
Dealt to matiko09 [3s 2h]
ardo888: folds 
matiko09: folds 
psychmantis: raises $1 to $1.50
ManChild9: folds 
baoyu4749892: folds 
Franky77200: calls $1.50
el.suertero: calls $1.50
funXmun: folds 
Kukuryzka: calls $1
*** FLOP *** [Ad 6s Kh]
Kukuryzka: checks 
psychmantis: checks 
Franky77200: bets $3.50
el.suertero: folds 
Kukuryzka: calls $3.50
psychmantis: folds 
*** TURN *** [Ad 6s Kh] [8d]
Kukuryzka: checks 
Franky77200: bets $7.50
Kukuryzka: calls $7.50
*** RIVER *** [Ad 6s Kh 8d] [6h]
Kukuryzka: checks 
Franky77200: checks 
*** SHOW DOWN ***
Kukuryzka: shows [Jc As] (two pair, Aces and Sixes)
Franky77200: mucks hand 
Kukuryzka collected $27.69 from pot
*** SUMMARY ***
Total pot $29.15 | Rake $1.46 
Board [Ad 6s Kh 8d 6h]
Seat 1: ardo888 folded before Flop (didn't bet)
Seat 2: matiko09 folded before Flop (didn't bet)
Seat 3: psychmantis folded on the Flop
Seat 4: ManChild9 folded before Flop (didn't bet)
Seat 5: baoyu4749892 folded before Flop (didn't bet)
Seat 6: Franky77200 mucked [2d 4d]
Seat 7: el.suertero (button) folded on the Flop
Seat 8: funXmun (small blind) folded before Flop
Seat 9: Kukuryzka (big blind) showed [Jc As] and won ($27.69) with two pair, Aces and Sixes





PokerStars Hand #155299917753:  Hold'em No Limit ($0.50/$1.00 USD) - 2016/06/28 15:35:25 CET [2016/06/28 9:35:25 ET]
Table 'Tynka' 9-max Seat #2 is the button
Seat 1: Pokah4Living ($117.57 in chips) 
Seat 2: matiko09 ($100 in chips) 
Seat 4: sanpidk ($122.18 in chips) 
Seat 7: Mukhin1 ($126.94 in chips) 
Seat 8: r4mz3s ($116.51 in chips) 
sanpidk: posts small blind $0.50
SkUhNi: is sitting out 
Mukhin1: posts big blind $1
*** HOLE CARDS ***
Dealt to matiko09 [Td Qs]
SkUhNi leaves the table
r4mz3s: raises $1.55 to $2.55
Pokah4Living: calls $2.55
matiko09: folds 
sanpidk: folds 
Mukhin1: folds 
*** FLOP *** [Ah 8s 4h]
r4mz3s: bets $4.50
Pokah4Living: folds 
Uncalled bet ($4.50) returned to r4mz3s
r4mz3s collected $6.27 from pot
r4mz3s: doesn't show hand 
*** SUMMARY ***
Total pot $6.60 | Rake $0.33 
Board [Ah 8s 4h]
Seat 1: Pokah4Living folded on the Flop
Seat 2: matiko09 (button) folded before Flop (didn't bet)
Seat 4: sanpidk (small blind) folded before Flop
Seat 7: Mukhin1 (big blind) folded before Flop
Seat 8: r4mz3s collected ($6.27)





PokerStars Hand #155299918362:  Hold'em No Limit ($0.25/$0.50 USD) - 2016/06/28 15:35:26 CET [2016/06/28 9:35:26 ET]
Table 'Arago' 9-max Seat #1 is the button
Seat 1: Vedpapa ($50 in chips) 
Seat 2: Xx7-Zeus-7xX ($48 in chips) 
Seat 3: Kodiak8787 ($87.72 in chips) 
Seat 4: funXmun ($56.03 in chips) 
Seat 5: omorfadramou ($50.75 in chips) 
Seat 7: Rafaello18 ($50 in chips) 
Seat 8: matiko09 ($50.50 in chips) 
Seat 9: bratbugor ($76.71 in chips) 
Xx7-Zeus-7xX: posts small blind $0.25
Kodiak8787: posts big blind $0.50
SumPosad: sits out 
*** HOLE CARDS ***
Dealt to matiko09 [5c Qc]
funXmun: folds 
omorfadramou: folds 
Rafaello18: folds 
matiko09: folds 
bratbugor: raises $0.57 to $1.07
Vedpapa: folds 
Xx7-Zeus-7xX: calls $0.82
Kodiak8787: folds 
*** FLOP *** [5h Th Tc]
Xx7-Zeus-7xX: checks 
bratbugor: checks 
*** TURN *** [5h Th Tc] [7c]
Xx7-Zeus-7xX: checks 
bratbugor: bets $1.68
Xx7-Zeus-7xX: raises $3.32 to $5
bratbugor: folds 
Uncalled bet ($3.32) returned to Xx7-Zeus-7xX
Xx7-Zeus-7xX collected $5.70 from pot
Xx7-Zeus-7xX: doesn't show hand 
*** SUMMARY ***
Total pot $6 | Rake $0.30 
Board [5h Th Tc 7c]
Seat 1: Vedpapa (button) folded before Flop (didn't bet)
Seat 2: Xx7-Zeus-7xX (small blind) collected ($5.70)
Seat 3: Kodiak8787 (big blind) folded before Flop
Seat 4: funXmun folded before Flop (didn't bet)
Seat 5: omorfadramou folded before Flop (didn't bet)
Seat 7: Rafaello18 folded before Flop (didn't bet)
Seat 8: matiko09 folded before Flop (didn't bet)
Seat 9: bratbugor folded on the Turn





PokerStars Hand #155299921765:  Hold'em No Limit ($0.50/$1.00 USD) - 2016/06/28 15:35:33 CET [2016/06/28 9:35:33 ET]
Table 'Charybdis II' 9-max Seat #1 is the button
Seat 1: r4mz3s ($100 in chips) 
Seat 3: Rafaello18 ($100 in chips) 
Seat 4: Greha999 ($58.69 in chips) 
Seat 5: WDW3 ($100 in chips) 
Seat 6: matiko09 ($129.40 in chips) 
Seat 7: ozone2003 ($118.93 in chips) 
Seat 8: Kukuryzka ($99.80 in chips) 
suited_doc will be allowed to play after the button
Rafaello18: posts small blind $0.50
Greha999: posts big blind $1
myatiy 96: sits out 
r4mz3s: posts the ante $0.20
Rafaello18: posts the ante $0.20
Greha999: posts the ante $0.20
WDW3: posts the ante $0.20
matiko09: posts the ante $0.20
ozone2003: posts the ante $0.20
Kukuryzka: posts the ante $0.20
*** HOLE CARDS ***
Dealt to matiko09 [Qs Td]
WDW3: folds 
matiko09: folds 
ozone2003: raises $2 to $3
Kukuryzka: folds 
r4mz3s: folds 
Rafaello18: folds 
Greha999: folds 
Uncalled bet ($2) returned to ozone2003
ozone2003 collected $3.90 from pot
ozone2003: doesn't show hand 
*** SUMMARY ***
Total pot $3.90 | Rake $0 
Seat 1: r4mz3s (button) folded before Flop (didn't bet)
Seat 3: Rafaello18 (small blind) folded before Flop
Seat 4: Greha999 (big blind) folded before Flop
Seat 5: WDW3 folded before Flop (didn't bet)
Seat 6: matiko09 folded before Flop (didn't bet)
Seat 7: ozone2003 collected ($3.90)
Seat 8: Kukuryzka folded before Flop (didn't bet)





PokerStars Hand #155299927069:  Hold'em No Limit ($0.50/$1.00 USD) - 2016/06/28 15:35:43 CET [2016/06/28 9:35:43 ET]
Table 'Tynka' 9-max Seat #4 is the button
Seat 1: Pokah4Living ($115.02 in chips) 
Seat 2: matiko09 ($100 in chips) 
Seat 4: sanpidk ($121.68 in chips) 
Seat 7: Mukhin1 ($125.94 in chips) 
Mukhin1: posts small blind $0.50
r4mz3s: is sitting out 
Pokah4Living: posts big blind $1
*** HOLE CARDS ***
Dealt to matiko09 [5s Tc]
matiko09: folds 
sanpidk: raises $1.50 to $2.50
Mukhin1: folds 
Pokah4Living: folds 
Uncalled bet ($1.50) returned to sanpidk
sanpidk collected $2.50 from pot
sanpidk: doesn't show hand 
*** SUMMARY ***
Total pot $2.50 | Rake $0 
Seat 1: Pokah4Living (big blind) folded before Flop
Seat 2: matiko09 folded before Flop (didn't bet)
Seat 4: sanpidk (button) collected ($2.50)
Seat 7: Mukhin1 (small blind) folded before Flop





PokerStars Hand #155299935727:  Hold'em No Limit ($0.50/$1.00 USD) - 2016/06/28 15:36:00 CET [2016/06/28 9:36:00 ET]
Table 'Tynka' 9-max Seat #7 is the button
Seat 1: Pokah4Living ($114.02 in chips) 
Seat 2: matiko09 ($100 in chips) 
Seat 4: sanpidk ($123.18 in chips) 
Seat 7: Mukhin1 ($125.44 in chips) 
r4mz3s will be allowed to play after the button
Pokah4Living: posts small blind $0.50
matiko09: posts big blind $1
*** HOLE CARDS ***
Dealt to matiko09 [Ks As]
sanpidk: folds 
Mukhin1: folds 
Pokah4Living: folds 
Uncalled bet ($0.50) returned to matiko09
matiko09 collected $1 from pot
matiko09: doesn't show hand 
*** SUMMARY ***
Total pot $1 | Rake $0 
Seat 1: Pokah4Living (small blind) folded before Flop
Seat 2: matiko09 (big blind) collected ($1)
Seat 4: sanpidk folded before Flop (didn't bet)
Seat 7: Mukhin1 (button) folded before Flop (didn't bet)





PokerStars Hand #155299937629:  Hold'em No Limit ($0.50/$1.00 USD) - 2016/06/28 15:36:04 CET [2016/06/28 9:36:04 ET]
Table 'Lyyli II' 9-max Seat #5 is the button
Seat 1: tipner ($126.10 in chips) 
Seat 2: Rafaello18 ($154.36 in chips) 
Seat 3: ozone2003 ($102.62 in chips) 
Seat 4: Greha999 ($101.10 in chips) 
Seat 5: WDW3 ($128.44 in chips) 
Seat 6: matiko09 ($100.50 in chips) 
Seat 7: Kukuryzka ($200.50 in chips) 
Seat 8: SkUhNi ($100 in chips) 
Seat 9: f1reworks ($101.30 in chips) 
matiko09: posts small blind $0.50
Kukuryzka: posts big blind $1
*** HOLE CARDS ***
Dealt to matiko09 [Qs Ac]
SkUhNi: folds 
f1reworks: folds 
tipner: folds 
Rafaello18: folds 
ozone2003: folds 
Greha999: folds 
WDW3: raises $1.40 to $2.40
matiko09: raises $6.60 to $9
Kukuryzka: folds 
WDW3: calls $6.60
*** FLOP *** [3s Tc Jc]
matiko09: bets $5.59
WDW3: calls $5.59
*** TURN *** [3s Tc Jc] [9h]
matiko09: checks 
WDW3: bets $21.50
matiko09: folds 
Uncalled bet ($21.50) returned to WDW3
WDW3 collected $28.67 from pot
WDW3: doesn't show hand 
*** SUMMARY ***
Total pot $30.18 | Rake $1.51 
Board [3s Tc Jc 9h]
Seat 1: tipner folded before Flop (didn't bet)
Seat 2: Rafaello18 folded before Flop (didn't bet)
Seat 3: ozone2003 folded before Flop (didn't bet)
Seat 4: Greha999 folded before Flop (didn't bet)
Seat 5: WDW3 (button) collected ($28.67)
Seat 6: matiko09 (small blind) folded on the Turn
Seat 7: Kukuryzka (big blind) folded before Flop
Seat 8: SkUhNi folded before Flop (didn't bet)
Seat 9: f1reworks folded before Flop (didn't bet)





PokerStars Hand #155299939815:  Hold'em No Limit ($0.50/$1.00 USD) - 2016/06/28 15:36:08 CET [2016/06/28 9:36:08 ET]
Table 'Charybdis II' 9-max Seat #3 is the button
Seat 1: r4mz3s ($100 in chips) 
Seat 2: suited_doc ($80.59 in chips) 
Seat 3: Rafaello18 ($100 in chips) 
Seat 4: Greha999 ($57.49 in chips) 
Seat 5: WDW3 ($100 in chips) 
Seat 6: matiko09 ($129.20 in chips) 
Seat 7: ozone2003 ($121.63 in chips) 
Seat 8: Kukuryzka ($99.60 in chips) 
Greha999: posts small blind $0.50
WDW3: posts big blind $1
myatiy 96: sits out 
suited_doc: posts small & big blinds $1.50
r4mz3s: posts the ante $0.20
suited_doc: posts the ante $0.20
Rafaello18: posts the ante $0.20
Greha999: posts the ante $0.20
WDW3: posts the ante $0.20
matiko09: posts the ante $0.20
ozone2003: posts the ante $0.20
Kukuryzka: posts the ante $0.20
*** HOLE CARDS ***
Dealt to matiko09 [2c Ks]
matiko09: folds 
ozone2003: folds 
Kukuryzka: folds 
r4mz3s: folds 
suited_doc: checks 
Rafaello18: raises $3 to $4
Greha999: folds 
WDW3: folds 
suited_doc: calls $3
*** FLOP *** [Kh 2h 6c]
suited_doc: bets $2
Rafaello18: raises $4 to $6
suited_doc: calls $4
*** TURN *** [Kh 2h 6c] [5s]
suited_doc: checks 
Rafaello18: checks 
*** RIVER *** [Kh 2h 6c 5s] [3s]
suited_doc: checks 
Rafaello18: checks 
*** SHOW DOWN ***
suited_doc: shows [5h 3h] (two pair, Fives and Threes)
Rafaello18: mucks hand 
suited_doc collected $22.42 from pot
*** SUMMARY ***
Total pot $23.60 | Rake $1.18 
Board [Kh 2h 6c 5s 3s]
Seat 1: r4mz3s folded before Flop (didn't bet)
Seat 2: suited_doc showed [5h 3h] and won ($22.42) with two pair, Fives and Threes
Seat 3: Rafaello18 (button) mucked [Jh Qs]
Seat 4: Greha999 (small blind) folded before Flop
Seat 5: WDW3 (big blind) folded before Flop
Seat 6: matiko09 folded before Flop (didn't bet)
Seat 7: ozone2003 folded before Flop (didn't bet)
Seat 8: Kukuryzka folded before Flop (didn't bet)





PokerStars Hand #155299940178:  Hold'em No Limit ($0.50/$1.00 USD) - 2016/06/28 15:36:09 CET [2016/06/28 9:36:09 ET]
Table 'Tynka' 9-max Seat #1 is the button
Seat 1: Pokah4Living ($113.52 in chips) 
Seat 2: matiko09 ($100.50 in chips) 
Seat 4: sanpidk ($123.18 in chips) 
Seat 7: Mukhin1 ($125.44 in chips) 
matiko09: posts small blind $0.50
sanpidk: posts big blind $1
r4mz3s: sits out 
*** HOLE CARDS ***
Dealt to matiko09 [6d Tc]
Mukhin1: folds 
Pokah4Living: folds 
Pokah4Living leaves the table
matiko09: folds 
Uncalled bet ($0.50) returned to sanpidk
sanpidk collected $1 from pot
sanpidk: doesn't show hand 
*** SUMMARY ***
Total pot $1 | Rake $0 
Seat 1: Pokah4Living (button) folded before Flop (didn't bet)
Seat 2: matiko09 (small blind) folded before Flop
Seat 4: sanpidk (big blind) collected ($1)
Seat 7: Mukhin1 folded before Flop (didn't bet)





PokerStars Hand #155299942611:  Hold'em No Limit ($0.50/$1.00 USD) - 2016/06/28 15:36:13 CET [2016/06/28 9:36:13 ET]
Table 'Kamenyar' 9-max Seat #2 is the button
Seat 1: Rafaello18 ($102.27 in chips) 
Seat 2: ozone2003 ($101.82 in chips) 
Seat 3: r4mz3s ($100.45 in chips) 
Seat 4: f1reworks ($224.41 in chips) 
Seat 5: bwly520 ($234.67 in chips) 
Seat 6: matiko09 ($111.05 in chips) 
Seat 9: pyromid ($91.50 in chips) 
r4mz3s: posts small blind $0.50
f1reworks: posts big blind $1
sanpidk: sits out 
*** HOLE CARDS ***
Dealt to matiko09 [Js 8h]
bwly520 has timed out
bwly520: folds 
Pokah4Living joins the table at seat #7 
matiko09: folds 
pyromid: raises $1.50 to $2.50
Rafaello18: folds 
ozone2003: raises $6.50 to $9
r4mz3s: folds 
f1reworks: folds 
pyromid: folds 
Uncalled bet ($6.50) returned to ozone2003
ozone2003 collected $6.50 from pot
ozone2003: doesn't show hand 
*** SUMMARY ***
Total pot $6.50 | Rake $0 
Seat 1: Rafaello18 folded before Flop (didn't bet)
Seat 2: ozone2003 (button) collected ($6.50)
Seat 3: r4mz3s (small blind) folded before Flop
Seat 4: f1reworks (big blind) folded before Flop
Seat 5: bwly520 folded before Flop (didn't bet)
Seat 6: matiko09 folded before Flop (didn't bet)
Seat 9: pyromid folded before Flop





PokerStars Hand #155299945403:  Hold'em No Limit ($0.50/$1.00 USD) - 2016/06/28 15:36:19 CET [2016/06/28 9:36:19 ET]
Table 'Tynka' 9-max Seat #2 is the button
Seat 2: matiko09 ($100 in chips) 
Seat 4: sanpidk ($123.68 in chips) 
Seat 7: Mukhin1 ($125.44 in chips) 
sanpidk: posts small blind $0.50
Mukhin1: posts big blind $1
r4mz3s: sits out 
*** HOLE CARDS ***
Dealt to matiko09 [7d Kd]
matiko09: raises $1.27 to $2.27
sanpidk: calls $1.77
r4mz3s leaves the table
Mukhin1: raises $8.23 to $10.50
matiko09: folds 
sanpidk: folds 
Uncalled bet ($8.23) returned to Mukhin1
matiko09 leaves the table
Mukhin1 collected $6.81 from pot
Mukhin1: doesn't show hand 
*** SUMMARY ***
Total pot $6.81 | Rake $0 
Seat 2: matiko09 (button) folded before Flop
Seat 4: sanpidk (small blind) folded before Flop
Seat 7: Mukhin1 (big blind) collected ($6.81)





PokerStars Hand #155299952490:  Hold'em No Limit ($0.50/$1.00 USD) - 2016/06/28 15:36:33 CET [2016/06/28 9:36:33 ET]
Table 'Herodias II' 9-max Seat #3 is the button
Seat 1: matiko09 ($100 in chips) 
Seat 2: myatiy 96 ($121.27 in chips) 
Seat 3: ardo888 ($105.30 in chips) 
Seat 4: f1reworks ($100 in chips) 
Seat 6: vanilica ($102.50 in chips) 
Seat 7: ilaviiitech ($100 in chips) 
Seat 8: thecurv ($118.63 in chips) 
Seat 9: vanapeer ($100 in chips) 
f1reworks: posts small blind $0.50
vanilica: posts big blind $1
*** HOLE CARDS ***
Dealt to matiko09 [4s 9d]
ilaviiitech: folds 
thecurv: raises $1.50 to $2.50
vanapeer: folds 
matiko09: folds 
myatiy 96: raises $5.50 to $8
ardo888: folds 
f1reworks: folds 
vanilica: folds 
thecurv: folds 
Uncalled bet ($5.50) returned to myatiy 96
myatiy 96 collected $6.50 from pot
*** SUMMARY ***
Total pot $6.50 | Rake $0 
Seat 1: matiko09 folded before Flop (didn't bet)
Seat 2: myatiy 96 collected ($6.50)
Seat 3: ardo888 (button) folded before Flop (didn't bet)
Seat 4: f1reworks (small blind) folded before Flop
Seat 6: vanilica (big blind) folded before Flop
Seat 7: ilaviiitech folded before Flop (didn't bet)
Seat 8: thecurv folded before Flop
Seat 9: vanapeer folded before Flop (didn't bet)





PokerStars Hand #155299966580:  Hold'em No Limit ($0.25/$0.50 USD) - 2016/06/28 15:37:01 CET [2016/06/28 9:37:01 ET]
Table 'Utra' 9-max Seat #8 is the button
Seat 1: ardo888 ($50 in chips) 
Seat 2: matiko09 ($50 in chips) 
Seat 3: psychmantis ($43.55 in chips) 
Seat 4: ManChild9 ($48.80 in chips) 
Seat 5: baoyu4749892 ($56.18 in chips) 
Seat 6: Franky77200 ($38.91 in chips) 
Seat 7: el.suertero ($74.23 in chips) 
Seat 8: funXmun ($51.73 in chips) 
Seat 9: Kukuryzka ($64.79 in chips) 
Kukuryzka: posts small blind $0.25
ardo888: posts big blind $0.50
ardo888: posts the ante $0.10
matiko09: posts the ante $0.10
psychmantis: posts the ante $0.10
ManChild9: posts the ante $0.10
baoyu4749892: posts the ante $0.10
Franky77200: posts the ante $0.10
el.suertero: posts the ante $0.10
funXmun: posts the ante $0.10
Kukuryzka: posts the ante $0.10
*** HOLE CARDS ***
Dealt to matiko09 [Jh Kh]
matiko09: raises $1 to $1.50
psychmantis: folds 
ManChild9: folds 
baoyu4749892: folds 
Franky77200: calls $1.50
el.suertero: folds 
funXmun: folds 
Kukuryzka: folds 
ardo888: folds 
*** FLOP *** [6h 8h As]
matiko09: bets $2.50
Franky77200: calls $2.50
*** TURN *** [6h 8h As] [5s]
matiko09: checks 
Franky77200: bets $7
matiko09: folds 
Uncalled bet ($7) returned to Franky77200
Franky77200 collected $9.17 from pot
Franky77200: doesn't show hand 
*** SUMMARY ***
Total pot $9.65 | Rake $0.48 
Board [6h 8h As 5s]
Seat 1: ardo888 (big blind) folded before Flop
Seat 2: matiko09 folded on the Turn
Seat 3: psychmantis folded before Flop (didn't bet)
Seat 4: ManChild9 folded before Flop (didn't bet)
Seat 5: baoyu4749892 folded before Flop (didn't bet)
Seat 6: Franky77200 collected ($9.17)
Seat 7: el.suertero folded before Flop (didn't bet)
Seat 8: funXmun (button) folded before Flop (didn't bet)
Seat 9: Kukuryzka (small blind) folded before Flop





PokerStars Hand #155299968207:  Hold'em No Limit ($0.50/$1.00 USD) - 2016/06/28 15:37:04 CET [2016/06/28 9:37:04 ET]
Table 'Herodias II' 9-max Seat #4 is the button
Seat 1: matiko09 ($100 in chips) 
Seat 2: myatiy 96 ($125.27 in chips) 
Seat 3: ardo888 ($105.30 in chips) 
Seat 4: f1reworks ($100 in chips) 
Seat 6: vanilica ($101.50 in chips) 
Seat 7: ilaviiitech ($100 in chips) 
Seat 8: thecurv ($116.13 in chips) 
Seat 9: vanapeer ($100 in chips) 
vanilica: posts small blind $0.50
ilaviiitech: posts big blind $1
*** HOLE CARDS ***
Dealt to matiko09 [4d 3s]
thecurv: folds 
vanapeer: raises $1.50 to $2.50
matiko09: folds 
myatiy 96: calls $2.50
ardo888: folds 
f1reworks: folds 
vanilica: folds 
ilaviiitech: folds 
*** FLOP *** [7d Tc 7s]
vanapeer: checks 
myatiy 96: bets $3.09
vanapeer: folds 
Uncalled bet ($3.09) returned to myatiy 96
myatiy 96 collected $6.18 from pot
*** SUMMARY ***
Total pot $6.50 | Rake $0.32 
Board [7d Tc 7s]
Seat 1: matiko09 folded before Flop (didn't bet)
Seat 2: myatiy 96 collected ($6.18)
Seat 3: ardo888 folded before Flop (didn't bet)
Seat 4: f1reworks (button) folded before Flop (didn't bet)
Seat 6: vanilica (small blind) folded before Flop
Seat 7: ilaviiitech (big blind) folded before Flop
Seat 8: thecurv folded before Flop (didn't bet)
Seat 9: vanapeer folded on the Flop





PokerStars Hand #155299973088:  Hold'em No Limit ($0.50/$1.00 USD) - 2016/06/28 15:37:14 CET [2016/06/28 9:37:14 ET]
Table 'Kamenyar' 9-max Seat #3 is the button
Seat 1: Rafaello18 ($102.27 in chips) 
Seat 2: ozone2003 ($105.82 in chips) 
Seat 3: r4mz3s ($100 in chips) 
Seat 4: f1reworks ($223.41 in chips) 
Seat 6: matiko09 ($111.05 in chips) 
Seat 7: Pokah4Living ($63.52 in chips) 
Seat 9: pyromid ($100 in chips) 
f1reworks: posts small blind $0.50
matiko09: posts big blind $1
Pokah4Living: posts big blind $1
sanpidk: sits out 
*** HOLE CARDS ***
Dealt to matiko09 [Qh Ks]
Pokah4Living: checks 
pyromid: folds 
Rafaello18: folds 
ozone2003: folds 
r4mz3s: raises $3 to $4
f1reworks: folds 
matiko09: calls $3
Pokah4Living: folds 
*** FLOP *** [7h 9c Kd]
matiko09: checks 
r4mz3s: checks 
*** TURN *** [7h 9c Kd] [8d]
matiko09: bets $6
r4mz3s: calls $6
*** RIVER *** [7h 9c Kd 8d] [5c]
matiko09: checks 
r4mz3s: bets $10.50
matiko09: folds 
Uncalled bet ($10.50) returned to r4mz3s
r4mz3s collected $20.42 from pot
r4mz3s: doesn't show hand 
*** SUMMARY ***
Total pot $21.50 | Rake $1.08 
Board [7h 9c Kd 8d 5c]
Seat 1: Rafaello18 folded before Flop (didn't bet)
Seat 2: ozone2003 folded before Flop (didn't bet)
Seat 3: r4mz3s (button) collected ($20.42)
Seat 4: f1reworks (small blind) folded before Flop
Seat 6: matiko09 (big blind) folded on the River
Seat 7: Pokah4Living folded before Flop
Seat 9: pyromid folded before Flop (didn't bet)





PokerStars Hand #155299975189:  Hold'em No Limit ($0.25/$0.50 USD) - 2016/06/28 15:37:18 CET [2016/06/28 9:37:18 ET]
Table 'Arago' 9-max Seat #2 is the button
Seat 1: Vedpapa ($50 in chips) 
Seat 2: Xx7-Zeus-7xX ($50.95 in chips) 
Seat 3: Kodiak8787 ($87.22 in chips) 
Seat 4: funXmun ($56.03 in chips) 
Seat 5: omorfadramou ($50.75 in chips) 
Seat 7: Rafaello18 ($50 in chips) 
Seat 8: matiko09 ($50.50 in chips) 
Seat 9: bratbugor ($73.96 in chips) 
Kodiak8787: posts small blind $0.25
funXmun: posts big blind $0.50
SumPosad: sits out 
*** HOLE CARDS ***
Dealt to matiko09 [4h 9d]
omorfadramou: folds 
Rafaello18: folds 
matiko09: folds 
bratbugor: folds 
Vedpapa: folds 
Xx7-Zeus-7xX: folds 
Kodiak8787: raises $0.97 to $1.47
funXmun: calls $0.97
*** FLOP *** [Ks 3d 5h]
Kodiak8787: bets $1.61
funXmun: calls $1.61
*** TURN *** [Ks 3d 5h] [Ad]
Kodiak8787: bets $4.21
funXmun: calls $4.21
*** RIVER *** [Ks 3d 5h Ad] [Ah]
Kodiak8787: checks 
funXmun: checks 
*** SHOW DOWN ***
Kodiak8787: shows [Kh Tc] (two pair, Aces and Kings)
funXmun: mucks hand 
Kodiak8787 collected $13.85 from pot
*** SUMMARY ***
Total pot $14.58 | Rake $0.73 
Board [Ks 3d 5h Ad Ah]
Seat 1: Vedpapa folded before Flop (didn't bet)
Seat 2: Xx7-Zeus-7xX (button) folded before Flop (didn't bet)
Seat 3: Kodiak8787 (small blind) showed [Kh Tc] and won ($13.85) with two pair, Aces and Kings
Seat 4: funXmun (big blind) mucked [Kd 6d]
Seat 5: omorfadramou folded before Flop (didn't bet)
Seat 7: Rafaello18 folded before Flop (didn't bet)
Seat 8: matiko09 folded before Flop (didn't bet)
Seat 9: bratbugor folded before Flop (didn't bet)





PokerStars Hand #155299987952:  Hold'em No Limit ($0.50/$1.00 USD) - 2016/06/28 15:37:43 CET [2016/06/28 9:37:43 ET]
Table 'Charybdis II' 9-max Seat #4 is the button
Seat 1: r4mz3s ($100 in chips) 
Seat 2: suited_doc ($92.31 in chips) 
Seat 3: Rafaello18 ($100 in chips) 
Seat 4: Greha999 ($56.79 in chips) 
Seat 5: WDW3 ($100 in chips) 
Seat 6: matiko09 ($129 in chips) 
Seat 7: ozone2003 ($121.43 in chips) 
Seat 8: Kukuryzka ($99.40 in chips) 
WDW3: posts small blind $0.50
matiko09: posts big blind $1
myatiy 96: sits out 
r4mz3s: posts the ante $0.20
suited_doc: posts the ante $0.20
Rafaello18: posts the ante $0.20
Greha999: posts the ante $0.20
WDW3: posts the ante $0.20
matiko09: posts the ante $0.20
ozone2003: posts the ante $0.20
Kukuryzka: posts the ante $0.20
*** HOLE CARDS ***
Dealt to matiko09 [9c Ks]
ozone2003: folds 
Kukuryzka: folds 
r4mz3s: folds 
suited_doc: folds 
Rafaello18: folds 
Greha999: raises $2 to $3
WDW3: folds 
matiko09: folds 
Uncalled bet ($2) returned to Greha999
Greha999 collected $4.10 from pot
*** SUMMARY ***
Total pot $4.10 | Rake $0 
Seat 1: r4mz3s folded before Flop (didn't bet)
Seat 2: suited_doc folded before Flop (didn't bet)
Seat 3: Rafaello18 folded before Flop (didn't bet)
Seat 4: Greha999 (button) collected ($4.10)
Seat 5: WDW3 (small blind) folded before Flop
Seat 6: matiko09 (big blind) folded before Flop
Seat 7: ozone2003 folded before Flop (didn't bet)
Seat 8: Kukuryzka folded before Flop (didn't bet)





PokerStars Hand #155299997154:  Hold'em No Limit ($0.50/$1.00 USD) - 2016/06/28 15:38:01 CET [2016/06/28 9:38:01 ET]
Table 'Herodias II' 9-max Seat #6 is the button
Seat 1: matiko09 ($100 in chips) 
Seat 2: myatiy 96 ($128.95 in chips) 
Seat 3: ardo888 ($105.30 in chips) 
Seat 4: f1reworks ($100 in chips) 
Seat 6: vanilica ($101 in chips) 
Seat 7: ilaviiitech ($100 in chips) 
Seat 8: thecurv ($116.13 in chips) 
Seat 9: vanapeer ($100 in chips) 
ilaviiitech: posts small blind $0.50
thecurv: posts big blind $1
*** HOLE CARDS ***
Dealt to matiko09 [2d 4d]
vanapeer: folds 
matiko09: folds 
myatiy 96: folds 
ardo888: folds 
f1reworks: folds 
vanilica: folds 
ilaviiitech: folds 
Uncalled bet ($0.50) returned to thecurv
thecurv collected $1 from pot
thecurv: doesn't show hand 
*** SUMMARY ***
Total pot $1 | Rake $0 
Seat 1: matiko09 folded before Flop (didn't bet)
Seat 2: myatiy 96 folded before Flop (didn't bet)
Seat 3: ardo888 folded before Flop (didn't bet)
Seat 4: f1reworks folded before Flop (didn't bet)
Seat 6: vanilica (button) folded before Flop (didn't bet)
Seat 7: ilaviiitech (small blind) folded before Flop
Seat 8: thecurv (big blind) collected ($1)
Seat 9: vanapeer folded before Flop (didn't bet)





PokerStars Hand #155300000760:  Hold'em No Limit ($0.50/$1.00 USD) - 2016/06/28 15:38:08 CET [2016/06/28 9:38:08 ET]
Table 'Charybdis II' 9-max Seat #5 is the button
Seat 1: r4mz3s ($100 in chips) 
Seat 2: suited_doc ($92.11 in chips) 
Seat 3: Rafaello18 ($100 in chips) 
Seat 4: Greha999 ($59.69 in chips) 
Seat 5: WDW3 ($100 in chips) 
Seat 6: matiko09 ($127.80 in chips) 
Seat 7: ozone2003 ($121.23 in chips) 
Seat 8: Kukuryzka ($99.20 in chips) 
matiko09: posts small blind $0.50
ozone2003: posts big blind $1
myatiy 96: sits out 
r4mz3s: posts the ante $0.20
suited_doc: posts the ante $0.20
Rafaello18: posts the ante $0.20
Greha999: posts the ante $0.20
WDW3: posts the ante $0.20
matiko09: posts the ante $0.20
ozone2003: posts the ante $0.20
Kukuryzka: posts the ante $0.20
*** HOLE CARDS ***
Dealt to matiko09 [Td 3d]
Kukuryzka: raises $2 to $3
r4mz3s: folds 
suited_doc: folds 
Rafaello18: folds 
Greha999: folds 
WDW3: folds 
matiko09: folds 
ozone2003: folds 
Uncalled bet ($2) returned to Kukuryzka
Kukuryzka collected $4.10 from pot
Kukuryzka: doesn't show hand 
*** SUMMARY ***
Total pot $4.10 | Rake $0 
Seat 1: r4mz3s folded before Flop (didn't bet)
Seat 2: suited_doc folded before Flop (didn't bet)
Seat 3: Rafaello18 folded before Flop (didn't bet)
Seat 4: Greha999 folded before Flop (didn't bet)
Seat 5: WDW3 (button) folded before Flop (didn't bet)
Seat 6: matiko09 (small blind) folded before Flop
Seat 7: ozone2003 (big blind) folded before Flop
Seat 8: Kukuryzka collected ($4.10)





PokerStars Hand #155300004887:  Hold'em No Limit ($0.25/$0.50 USD) - 2016/06/28 15:38:16 CET [2016/06/28 9:38:16 ET]
Table 'Utra' 9-max Seat #9 is the button
Seat 1: ardo888 ($50 in chips) 
Seat 2: matiko09 ($50 in chips) 
Seat 3: psychmantis ($43.45 in chips) 
Seat 4: ManChild9 ($48.70 in chips) 
Seat 5: baoyu4749892 ($56.08 in chips) 
Seat 6: Franky77200 ($43.98 in chips) 
Seat 7: el.suertero ($74.13 in chips) 
Seat 8: funXmun ($51.63 in chips) 
Seat 9: Kukuryzka ($64.44 in chips) 
ardo888: posts small blind $0.25
matiko09: posts big blind $0.50
ardo888: posts the ante $0.10
matiko09: posts the ante $0.10
psychmantis: posts the ante $0.10
ManChild9: posts the ante $0.10
baoyu4749892: posts the ante $0.10
Franky77200: posts the ante $0.10
el.suertero: posts the ante $0.10
funXmun: posts the ante $0.10
Kukuryzka: posts the ante $0.10
*** HOLE CARDS ***
Dealt to matiko09 [7h 7s]
psychmantis: calls $0.50
ManChild9: calls $0.50
baoyu4749892: calls $0.50
Franky77200: folds 
el.suertero: raises $3.50 to $4
funXmun: folds 
Kukuryzka: folds 
ardo888: folds 
matiko09: calls $3.50
psychmantis: calls $3.50
ManChild9: calls $3.50
baoyu4749892: calls $3.50
*** FLOP *** [Jd 4s Js]
matiko09: checks 
psychmantis: checks 
ManChild9: checks 
baoyu4749892: checks 
el.suertero: checks 
*** TURN *** [Jd 4s Js] [5c]
matiko09: bets $5.50
psychmantis: folds 
ManChild9: folds 
baoyu4749892: calls $5.50
el.suertero: folds 
*** RIVER *** [Jd 4s Js 5c] [Jc]
matiko09: bets $9.50
baoyu4749892: calls $9.50
*** SHOW DOWN ***
matiko09: shows [7h 7s] (a full house, Jacks full of Sevens)
baoyu4749892: mucks hand 
matiko09 collected $49.15 from pot
*** SUMMARY ***
Total pot $51.15 | Rake $2 
Board [Jd 4s Js 5c Jc]
Seat 1: ardo888 (small blind) folded before Flop
Seat 2: matiko09 (big blind) showed [7h 7s] and won ($49.15) with a full house, Jacks full of Sevens
Seat 3: psychmantis folded on the Turn
Seat 4: ManChild9 folded on the Turn
Seat 5: baoyu4749892 mucked [6c 6s]
Seat 6: Franky77200 folded before Flop (didn't bet)
Seat 7: el.suertero folded on the Turn
Seat 8: funXmun folded before Flop (didn't bet)
Seat 9: Kukuryzka (button) folded before Flop (didn't bet)





PokerStars Hand #155300011523:  Hold'em No Limit ($0.50/$1.00 USD) - 2016/06/28 15:38:29 CET [2016/06/28 9:38:29 ET]
Table 'Lyyli II' 9-max Seat #6 is the button
Seat 1: tipner ($126.10 in chips) 
Seat 2: Rafaello18 ($154.36 in chips) 
Seat 3: ozone2003 ($102.62 in chips) 
Seat 4: Greha999 ($101.10 in chips) 
Seat 5: WDW3 ($142.52 in chips) 
Seat 6: matiko09 ($100 in chips) 
Seat 7: Kukuryzka ($199.50 in chips) 
Seat 9: f1reworks ($101.30 in chips) 
Kukuryzka: posts small blind $0.50
SkUhNi: is sitting out 
SkUhNi leaves the table
f1reworks: posts big blind $1
*** HOLE CARDS ***
Dealt to matiko09 [2s 7c]
r4mz3s joins the table at seat #8 
tipner is disconnected 
tipner has timed out while disconnected
tipner: folds 
Rafaello18: folds 
ozone2003: folds 
Greha999: folds 
WDW3: folds 
matiko09: folds 
Kukuryzka: folds 
Uncalled bet ($0.50) returned to f1reworks
f1reworks collected $1 from pot
f1reworks: doesn't show hand 
*** SUMMARY ***
Total pot $1 | Rake $0 
Seat 1: tipner folded before Flop (didn't bet)
Seat 2: Rafaello18 folded before Flop (didn't bet)
Seat 3: ozone2003 folded before Flop (didn't bet)
Seat 4: Greha999 folded before Flop (didn't bet)
Seat 5: WDW3 folded before Flop (didn't bet)
Seat 6: matiko09 (button) folded before Flop (didn't bet)
Seat 7: Kukuryzka (small blind) folded before Flop
Seat 9: f1reworks (big blind) collected ($1)





PokerStars Hand #155300014837:  Hold'em No Limit ($0.50/$1.00 USD) - 2016/06/28 15:38:35 CET [2016/06/28 9:38:35 ET]
Table 'Herodias II' 9-max Seat #7 is the button
Seat 1: matiko09 ($100 in chips) 
Seat 2: myatiy 96 ($128.95 in chips) 
Seat 3: ardo888 ($105.30 in chips) 
Seat 4: f1reworks ($100 in chips) 
Seat 6: vanilica ($101 in chips) 
Seat 7: ilaviiitech ($100 in chips) 
Seat 8: thecurv ($116.63 in chips) 
Seat 9: vanapeer ($100 in chips) 
thecurv: posts small blind $0.50
vanapeer: posts big blind $1
*** HOLE CARDS ***
Dealt to matiko09 [Qs 5c]
matiko09: folds 
myatiy 96: folds 
ardo888: folds 
f1reworks: folds 
vanilica: folds 
ilaviiitech: folds 
thecurv: raises $1.05 to $2.05
vanapeer: calls $1.05
*** FLOP *** [5h 2s Js]
thecurv: bets $2.92
vanapeer: folds 
Uncalled bet ($2.92) returned to thecurv
thecurv collected $3.90 from pot
thecurv: doesn't show hand 
*** SUMMARY ***
Total pot $4.10 | Rake $0.20 
Board [5h 2s Js]
Seat 1: matiko09 folded before Flop (didn't bet)
Seat 2: myatiy 96 folded before Flop (didn't bet)
Seat 3: ardo888 folded before Flop (didn't bet)
Seat 4: f1reworks folded before Flop (didn't bet)
Seat 6: vanilica folded before Flop (didn't bet)
Seat 7: ilaviiitech (button) folded before Flop (didn't bet)
Seat 8: thecurv (small blind) collected ($3.90)
Seat 9: vanapeer (big blind) folded on the Flop





PokerStars Hand #155300016509:  Hold'em No Limit ($0.50/$1.00 USD) - 2016/06/28 15:38:38 CET [2016/06/28 9:38:38 ET]
Table 'Charybdis II' 9-max Seat #6 is the button
Seat 1: r4mz3s ($100 in chips) 
Seat 2: suited_doc ($91.91 in chips) 
Seat 3: Rafaello18 ($100 in chips) 
Seat 4: Greha999 ($59.49 in chips) 
Seat 5: WDW3 ($100 in chips) 
Seat 6: matiko09 ($127.10 in chips) 
Seat 7: ozone2003 ($120.03 in chips) 
Seat 8: Kukuryzka ($102.10 in chips) 
ozone2003: posts small blind $0.50
Kukuryzka: posts big blind $1
myatiy 96: sits out 
r4mz3s: posts the ante $0.20
suited_doc: posts the ante $0.20
Rafaello18: posts the ante $0.20
Greha999: posts the ante $0.20
WDW3: posts the ante $0.20
matiko09: posts the ante $0.20
ozone2003: posts the ante $0.20
Kukuryzka: posts the ante $0.20
*** HOLE CARDS ***
Dealt to matiko09 [5s 6s]
r4mz3s: raises $2 to $3
suited_doc: folds 
Rafaello18: folds 
Greha999: calls $3
WDW3: folds 
matiko09: calls $3
ozone2003: calls $2.50
Kukuryzka: folds 
*** FLOP *** [2s Ac 6c]
ozone2003: checks 
r4mz3s: checks 
Greha999: bets $9
matiko09: folds 
ozone2003: folds 
r4mz3s: calls $9
*** TURN *** [2s Ac 6c] [5h]
r4mz3s: checks 
Greha999: bets $15
r4mz3s: raises $33 to $48
Greha999: calls $32.29 and is all-in
Uncalled bet ($0.71) returned to r4mz3s
*** RIVER *** [2s Ac 6c 5h] [Th]
*** SHOW DOWN ***
r4mz3s: shows [Jd Ad] (a pair of Aces)
Greha999: shows [3c 5c] (a pair of Fives)
r4mz3s collected $124.68 from pot
*** SUMMARY ***
Total pot $127.18 | Rake $2.50 
Board [2s Ac 6c 5h Th]
Seat 1: r4mz3s showed [Jd Ad] and won ($124.68) with a pair of Aces
Seat 2: suited_doc folded before Flop (didn't bet)
Seat 3: Rafaello18 folded before Flop (didn't bet)
Seat 4: Greha999 showed [3c 5c] and lost with a pair of Fives
Seat 5: WDW3 folded before Flop (didn't bet)
Seat 6: matiko09 (button) folded on the Flop
Seat 7: ozone2003 (small blind) folded on the Flop
Seat 8: Kukuryzka (big blind) folded before Flop





PokerStars Hand #155300021492:  Hold'em No Limit ($0.25/$0.50 USD) - 2016/06/28 15:38:48 CET [2016/06/28 9:38:48 ET]
Table 'Arago' 9-max Seat #3 is the button
Seat 1: Vedpapa ($50 in chips) 
Seat 2: Xx7-Zeus-7xX ($50.95 in chips) 
Seat 3: Kodiak8787 ($93.78 in chips) 
Seat 4: funXmun ($50 in chips) 
Seat 5: omorfadramou ($50.75 in chips) 
Seat 7: Rafaello18 ($50 in chips) 
Seat 8: matiko09 ($50.50 in chips) 
Seat 9: bratbugor ($73.96 in chips) 
funXmun: posts small blind $0.25
omorfadramou: posts big blind $0.50
SumPosad: sits out 
*** HOLE CARDS ***
Dealt to matiko09 [6s Th]
Rafaello18: folds 
matiko09: folds 
bratbugor: folds 
Vedpapa: raises $1 to $1.50
Xx7-Zeus-7xX: folds 
Kodiak8787: calls $1.50
funXmun: folds 
omorfadramou: folds 
*** FLOP *** [5h 4h Js]
Vedpapa: bets $2
Kodiak8787: calls $2
*** TURN *** [5h 4h Js] [Ac]
Vedpapa: checks 
Kodiak8787: bets $4.26
Vedpapa: calls $4.26
*** RIVER *** [5h 4h Js Ac] [2s]
Vedpapa: checks 
Kodiak8787: bets $11.13
Vedpapa: calls $11.13
*** SHOW DOWN ***
Kodiak8787: shows [7c 8s] (high card Ace)
Vedpapa: shows [Ah 4s] (two pair, Aces and Fours)
Vedpapa collected $36.60 from pot
*** SUMMARY ***
Total pot $38.53 | Rake $1.93 
Board [5h 4h Js Ac 2s]
Seat 1: Vedpapa showed [Ah 4s] and won ($36.60) with two pair, Aces and Fours
Seat 2: Xx7-Zeus-7xX folded before Flop (didn't bet)
Seat 3: Kodiak8787 (button) showed [7c 8s] and lost with high card Ace
Seat 4: funXmun (small blind) folded before Flop
Seat 5: omorfadramou (big blind) folded before Flop
Seat 7: Rafaello18 folded before Flop (didn't bet)
Seat 8: matiko09 folded before Flop (didn't bet)
Seat 9: bratbugor folded before Flop (didn't bet)





PokerStars Hand #155300037227:  Hold'em No Limit ($0.50/$1.00 USD) - 2016/06/28 15:39:18 CET [2016/06/28 9:39:18 ET]
Table 'Kamenyar' 9-max Seat #4 is the button
Seat 1: Rafaello18 ($102.27 in chips) 
Seat 2: ozone2003 ($105.82 in chips) 
Seat 3: r4mz3s ($110.42 in chips) 
Seat 4: f1reworks ($222.91 in chips) 
Seat 6: matiko09 ($101.05 in chips) 
Seat 7: Pokah4Living ($62.52 in chips) 
Seat 9: pyromid ($100 in chips) 
matiko09: posts small blind $0.50
Pokah4Living: posts big blind $1
sanpidk: sits out 
*** HOLE CARDS ***
Dealt to matiko09 [5d 8s]
pyromid: folds 
Rafaello18: folds 
ozone2003: folds 
r4mz3s: raises $1.55 to $2.55
f1reworks: folds 
matiko09: folds 
Pokah4Living: folds 
Uncalled bet ($1.55) returned to r4mz3s
r4mz3s collected $2.50 from pot
r4mz3s: doesn't show hand 
*** SUMMARY ***
Total pot $2.50 | Rake $0 
Seat 1: Rafaello18 folded before Flop (didn't bet)
Seat 2: ozone2003 folded before Flop (didn't bet)
Seat 3: r4mz3s collected ($2.50)
Seat 4: f1reworks (button) folded before Flop (didn't bet)
Seat 6: matiko09 (small blind) folded before Flop
Seat 7: Pokah4Living (big blind) folded before Flop
Seat 9: pyromid folded before Flop (didn't bet)





PokerStars Hand #155300040229:  Hold'em No Limit ($0.50/$1.00 USD) - 2016/06/28 15:39:24 CET [2016/06/28 9:39:24 ET]
Table 'Lyyli II' 9-max Seat #7 is the button
Seat 2: Rafaello18 ($154.36 in chips) 
Seat 3: ozone2003 ($102.62 in chips) 
Seat 4: Greha999 ($101.10 in chips) 
Seat 5: WDW3 ($142.52 in chips) 
Seat 6: matiko09 ($100 in chips) 
Seat 7: Kukuryzka ($199 in chips) 
Seat 9: f1reworks ($101.80 in chips) 
r4mz3s will be allowed to play after the button
f1reworks: posts small blind $0.50
Rafaello18: posts big blind $1
*** HOLE CARDS ***
Dealt to matiko09 [Kh 2s]
ozone2003: folds 
Greha999: folds 
WDW3: raises $1.80 to $2.80
matiko09: folds 
Kukuryzka: calls $2.80
f1reworks: folds 
Rafaello18: folds 
*** FLOP *** [Th 3d Jh]
WDW3: checks 
Kukuryzka: bets $4.44
WDW3: folds 
Uncalled bet ($4.44) returned to Kukuryzka
Kukuryzka collected $6.74 from pot
Kukuryzka: doesn't show hand 
*** SUMMARY ***
Total pot $7.10 | Rake $0.36 
Board [Th 3d Jh]
Seat 2: Rafaello18 (big blind) folded before Flop
Seat 3: ozone2003 folded before Flop (didn't bet)
Seat 4: Greha999 folded before Flop (didn't bet)
Seat 5: WDW3 folded on the Flop
Seat 6: matiko09 folded before Flop (didn't bet)
Seat 7: Kukuryzka (button) collected ($6.74)
Seat 9: f1reworks (small blind) folded before Flop





PokerStars Hand #155300051231:  Hold'em No Limit ($0.50/$1.00 USD) - 2016/06/28 15:39:45 CET [2016/06/28 9:39:45 ET]
Table 'Kamenyar' 9-max Seat #6 is the button
Seat 1: Rafaello18 ($102.27 in chips) 
Seat 2: ozone2003 ($105.82 in chips) 
Seat 3: r4mz3s ($111.92 in chips) 
Seat 4: f1reworks ($222.91 in chips) 
Seat 6: matiko09 ($100.55 in chips) 
Seat 7: Pokah4Living ($61.52 in chips) 
Seat 8: sanpidk ($100 in chips) 
Seat 9: pyromid ($100 in chips) 
Pokah4Living: posts small blind $0.50
sanpidk: posts big blind $1
*** HOLE CARDS ***
Dealt to matiko09 [Kc 2s]
pyromid: folds 
Rafaello18: folds 
ozone2003: folds 
r4mz3s: folds 
f1reworks: folds 
matiko09: folds 
Pokah4Living: folds 
Uncalled bet ($0.50) returned to sanpidk
sanpidk collected $1 from pot
sanpidk: doesn't show hand 
*** SUMMARY ***
Total pot $1 | Rake $0 
Seat 1: Rafaello18 folded before Flop (didn't bet)
Seat 2: ozone2003 folded before Flop (didn't bet)
Seat 3: r4mz3s folded before Flop (didn't bet)
Seat 4: f1reworks folded before Flop (didn't bet)
Seat 6: matiko09 (button) folded before Flop (didn't bet)
Seat 7: Pokah4Living (small blind) folded before Flop
Seat 8: sanpidk (big blind) collected ($1)
Seat 9: pyromid folded before Flop (didn't bet)





PokerStars Hand #155300061587:  Hold'em No Limit ($0.50/$1.00 USD) - 2016/06/28 15:40:05 CET [2016/06/28 9:40:05 ET]
Table 'Lyyli II' 9-max Seat #9 is the button
Seat 2: Rafaello18 ($153.36 in chips) 
Seat 4: Greha999 ($101.10 in chips) 
Seat 5: WDW3 ($139.72 in chips) 
Seat 6: matiko09 ($100 in chips) 
Seat 7: Kukuryzka ($202.94 in chips) 
Seat 9: f1reworks ($101.30 in chips) 
Rafaello18: posts small blind $0.50
ozone2003: is sitting out 
Greha999: posts big blind $1
r4mz3s: sits out 
*** HOLE CARDS ***
Dealt to matiko09 [3c Kc]
WDW3: folds 
matiko09: folds 
ozone2003 leaves the table
Kukuryzka: folds 
f1reworks: folds 
Rafaello18: raises $1.50 to $2.50
sanpidk joins the table at seat #3 
sanpidk leaves the table
CI58 joins the table at seat #3 
Greha999: calls $1.50
*** FLOP *** [Ah 4s 6d]
Rafaello18: checks 
Greha999: bets $2
Rafaello18: folds 
Uncalled bet ($2) returned to Greha999
Greha999 collected $4.75 from pot
CI58 leaves the table
*** SUMMARY ***
Total pot $5 | Rake $0.25 
Board [Ah 4s 6d]
Seat 2: Rafaello18 (small blind) folded on the Flop
Seat 4: Greha999 (big blind) collected ($4.75)
Seat 5: WDW3 folded before Flop (didn't bet)
Seat 6: matiko09 folded before Flop (didn't bet)
Seat 7: Kukuryzka folded before Flop (didn't bet)
Seat 9: f1reworks (button) folded before Flop (didn't bet)





PokerStars Hand #155300062637:  Hold'em No Limit ($0.50/$1.00 USD) - 2016/06/28 15:40:07 CET [2016/06/28 9:40:07 ET]
Table 'Kamenyar' 9-max Seat #7 is the button
Seat 1: Rafaello18 ($102.27 in chips) 
Seat 2: ozone2003 ($105.82 in chips) 
Seat 3: r4mz3s ($111.92 in chips) 
Seat 4: f1reworks ($222.91 in chips) 
Seat 6: matiko09 ($100.55 in chips) 
Seat 7: Pokah4Living ($61.02 in chips) 
Seat 8: sanpidk ($100.50 in chips) 
Seat 9: pyromid ($100 in chips) 
sanpidk: posts small blind $0.50
pyromid: posts big blind $1
*** HOLE CARDS ***
Dealt to matiko09 [Jc 7c]
Rafaello18: folds 
ozone2003: folds 
r4mz3s: folds 
f1reworks: raises $2 to $3
matiko09: folds 
Pokah4Living: folds 
sanpidk: folds 
pyromid: folds 
Uncalled bet ($2) returned to f1reworks
f1reworks collected $2.50 from pot
f1reworks: doesn't show hand 
*** SUMMARY ***
Total pot $2.50 | Rake $0 
Seat 1: Rafaello18 folded before Flop (didn't bet)
Seat 2: ozone2003 folded before Flop (didn't bet)
Seat 3: r4mz3s folded before Flop (didn't bet)
Seat 4: f1reworks collected ($2.50)
Seat 6: matiko09 folded before Flop (didn't bet)
Seat 7: Pokah4Living (button) folded before Flop (didn't bet)
Seat 8: sanpidk (small blind) folded before Flop
Seat 9: pyromid (big blind) folded before Flop





PokerStars Hand #155300063300:  Hold'em No Limit ($0.25/$0.50 USD) - 2016/06/28 15:40:09 CET [2016/06/28 9:40:09 ET]
Table 'Arago' 9-max Seat #4 is the button
Seat 1: Vedpapa ($67.71 in chips) 
Seat 2: Xx7-Zeus-7xX ($50.95 in chips) 
Seat 3: Kodiak8787 ($74.89 in chips) 
Seat 4: funXmun ($50 in chips) 
Seat 5: omorfadramou ($50.25 in chips) 
Seat 6: SumPosad ($20 in chips) 
Seat 7: Rafaello18 ($50 in chips) 
Seat 8: matiko09 ($50.50 in chips) 
Seat 9: bratbugor ($73.96 in chips) 
omorfadramou: posts small blind $0.25
SumPosad: posts big blind $0.50
*** HOLE CARDS ***
Dealt to matiko09 [Ah Kh]
Rafaello18: raises $0.75 to $1.25
matiko09: calls $1.25
bratbugor: folds 
Vedpapa: folds 
Xx7-Zeus-7xX: calls $1.25
Kodiak8787: calls $1.25
funXmun: folds 
omorfadramou: folds 
SumPosad: folds 
*** FLOP *** [6h 8d 6d]
Rafaello18: checks 
matiko09: checks 
Xx7-Zeus-7xX: checks 
Kodiak8787: checks 
*** TURN *** [6h 8d 6d] [7s]
Rafaello18: checks 
matiko09: checks 
Xx7-Zeus-7xX: bets $3.50
Kodiak8787: folds 
Rafaello18: folds 
matiko09: folds 
Uncalled bet ($3.50) returned to Xx7-Zeus-7xX
Xx7-Zeus-7xX collected $5.46 from pot
Xx7-Zeus-7xX: doesn't show hand 
*** SUMMARY ***
Total pot $5.75 | Rake $0.29 
Board [6h 8d 6d 7s]
Seat 1: Vedpapa folded before Flop (didn't bet)
Seat 2: Xx7-Zeus-7xX collected ($5.46)
Seat 3: Kodiak8787 folded on the Turn
Seat 4: funXmun (button) folded before Flop (didn't bet)
Seat 5: omorfadramou (small blind) folded before Flop
Seat 6: SumPosad (big blind) folded before Flop
Seat 7: Rafaello18 folded on the Turn
Seat 8: matiko09 folded on the Turn
Seat 9: bratbugor folded before Flop (didn't bet)





PokerStars Hand #155300076382:  Hold'em No Limit ($0.25/$0.50 USD) - 2016/06/28 15:40:34 CET [2016/06/28 9:40:34 ET]
Table 'Utra' 9-max Seat #1 is the button
Seat 1: ardo888 ($50 in chips) 
Seat 2: matiko09 ($80.05 in chips) 
Seat 3: psychmantis ($39.35 in chips) 
Seat 4: ManChild9 ($44.60 in chips) 
Seat 5: baoyu4749892 ($36.98 in chips) 
Seat 6: Franky77200 ($43.88 in chips) 
Seat 7: el.suertero ($70.03 in chips) 
Seat 8: funXmun ($51.53 in chips) 
Seat 9: Kukuryzka ($64.34 in chips) 
matiko09: posts small blind $0.25
psychmantis: posts big blind $0.50
ardo888: posts the ante $0.10
matiko09: posts the ante $0.10
psychmantis: posts the ante $0.10
ManChild9: posts the ante $0.10
baoyu4749892: posts the ante $0.10
Franky77200: posts the ante $0.10
el.suertero: posts the ante $0.10
funXmun: posts the ante $0.10
Kukuryzka: posts the ante $0.10
*** HOLE CARDS ***
Dealt to matiko09 [Tc Th]
ManChild9: folds 
baoyu4749892: folds 
Franky77200: raises $1 to $1.50
el.suertero: folds 
funXmun: raises $2.25 to $3.75
Kukuryzka: folds 
ardo888: folds 
matiko09: calls $3.50
psychmantis: folds 
Franky77200: calls $2.25
*** FLOP *** [7c 7d 4s]
matiko09: checks 
Franky77200: bets $9
funXmun: folds 
matiko09: raises $67.20 to $76.20 and is all-in
Franky77200: folds 
Uncalled bet ($67.20) returned to matiko09
matiko09 collected $29.12 from pot
matiko09: doesn't show hand 
*** SUMMARY ***
Total pot $30.65 | Rake $1.53 
Board [7c 7d 4s]
Seat 1: ardo888 (button) folded before Flop (didn't bet)
Seat 2: matiko09 (small blind) collected ($29.12)
Seat 3: psychmantis (big blind) folded before Flop
Seat 4: ManChild9 folded before Flop (didn't bet)
Seat 5: baoyu4749892 folded before Flop (didn't bet)
Seat 6: Franky77200 folded on the Flop
Seat 7: el.suertero folded before Flop (didn't bet)
Seat 8: funXmun folded on the Flop
Seat 9: Kukuryzka folded before Flop (didn't bet)





PokerStars Hand #155300077559:  Hold'em No Limit ($0.50/$1.00 USD) - 2016/06/28 15:40:36 CET [2016/06/28 9:40:36 ET]
Table 'Kamenyar' 9-max Seat #8 is the button
Seat 1: Rafaello18 ($102.27 in chips) 
Seat 2: ozone2003 ($105.82 in chips) 
Seat 3: r4mz3s ($111.92 in chips) 
Seat 4: f1reworks ($224.41 in chips) 
Seat 6: matiko09 ($100.55 in chips) 
Seat 7: Pokah4Living ($61.02 in chips) 
Seat 8: sanpidk ($100 in chips) 
Seat 9: pyromid ($99 in chips) 
pyromid: posts small blind $0.50
Rafaello18: posts big blind $1
*** HOLE CARDS ***
Dealt to matiko09 [Td Ad]
ozone2003: folds 
r4mz3s: folds 
f1reworks: folds 
matiko09: raises $2 to $3
Pokah4Living: raises $5 to $8
sanpidk: folds 
pyromid: folds 
Rafaello18: folds 
matiko09: folds 
Uncalled bet ($5) returned to Pokah4Living
Pokah4Living collected $7.50 from pot
Pokah4Living: doesn't show hand 
*** SUMMARY ***
Total pot $7.50 | Rake $0 
Seat 1: Rafaello18 (big blind) folded before Flop
Seat 2: ozone2003 folded before Flop (didn't bet)
Seat 3: r4mz3s folded before Flop (didn't bet)
Seat 4: f1reworks folded before Flop (didn't bet)
Seat 6: matiko09 folded before Flop
Seat 7: Pokah4Living collected ($7.50)
Seat 8: sanpidk (button) folded before Flop (didn't bet)
Seat 9: pyromid (small blind) folded before Flop





PokerStars Hand #155300085608:  Hold'em No Limit ($0.50/$1.00 USD) - 2016/06/28 15:40:52 CET [2016/06/28 9:40:52 ET]
Table 'Charybdis II' 9-max Seat #7 is the button
Seat 1: r4mz3s ($165.19 in chips) 
Seat 2: suited_doc ($91.71 in chips) 
Seat 3: Rafaello18 ($100 in chips) 
Seat 5: WDW3 ($100 in chips) 
Seat 6: matiko09 ($123.90 in chips) 
Seat 7: ozone2003 ($116.83 in chips) 
Seat 8: Kukuryzka ($100.90 in chips) 
Seat 9: myatiy 96 ($100 in chips) 
Kukuryzka: posts small blind $0.50
myatiy 96: posts big blind $1
r4mz3s: posts the ante $0.20
suited_doc: posts the ante $0.20
Rafaello18: posts the ante $0.20
WDW3: posts the ante $0.20
matiko09: posts the ante $0.20
ozone2003: posts the ante $0.20
Kukuryzka: posts the ante $0.20
myatiy 96: posts the ante $0.20
*** HOLE CARDS ***
Dealt to matiko09 [Th 5d]
r4mz3s: folds 
suited_doc: folds 
Greha999 leaves the table
Rafaello18: raises $1.50 to $2.50
WDW3: folds 
matiko09: folds 
ozone2003: folds 
Kukuryzka: folds 
myatiy 96: folds 
Uncalled bet ($1.50) returned to Rafaello18
Rafaello18 collected $4.10 from pot
Rafaello18: doesn't show hand 
*** SUMMARY ***
Total pot $4.10 | Rake $0 
Seat 1: r4mz3s folded before Flop (didn't bet)
Seat 2: suited_doc folded before Flop (didn't bet)
Seat 3: Rafaello18 collected ($4.10)
Seat 5: WDW3 folded before Flop (didn't bet)
Seat 6: matiko09 folded before Flop (didn't bet)
Seat 7: ozone2003 (button) folded before Flop (didn't bet)
Seat 8: Kukuryzka (small blind) folded before Flop
Seat 9: myatiy 96 (big blind) folded before Flop





PokerStars Hand #155300102241:  Hold'em No Limit ($0.50/$1.00 USD) - 2016/06/28 15:41:24 CET [2016/06/28 9:41:24 ET]
Table 'Lyyli II' 9-max Seat #2 is the button
Seat 2: Rafaello18 ($150.86 in chips) 
Seat 4: Greha999 ($103.35 in chips) 
Seat 6: matiko09 ($100 in chips) 
Seat 7: Kukuryzka ($202.94 in chips) 
Seat 9: f1reworks ($101.30 in chips) 
Greha999: posts small blind $0.50
WDW3: is sitting out 
matiko09: posts big blind $1
WDW3 leaves the table
r4mz3s: sits out 
*** HOLE CARDS ***
Dealt to matiko09 [4d 3s]
flk.Dasas joins the table at seat #5 
Racushniak joins the table at seat #3 
Kukuryzka: folds 
f1reworks: folds 
Rafaello18: raises $1.50 to $2.50
Greha999: calls $2
matiko09: folds 
*** FLOP *** [4h 3h 3c]
Greha999: checks 
Rafaello18: bets $4
Greha999: folds 
Uncalled bet ($4) returned to Rafaello18
Rafaello18 collected $5.70 from pot
Rafaello18: doesn't show hand 
*** SUMMARY ***
Total pot $6 | Rake $0.30 
Board [4h 3h 3c]
Seat 2: Rafaello18 (button) collected ($5.70)
Seat 4: Greha999 (small blind) folded on the Flop
Seat 6: matiko09 (big blind) folded before Flop
Seat 7: Kukuryzka folded before Flop (didn't bet)
Seat 9: f1reworks folded before Flop (didn't bet)





PokerStars Hand #155300103783:  Hold'em No Limit ($0.50/$1.00 USD) - 2016/06/28 15:41:27 CET [2016/06/28 9:41:27 ET]
Table 'Charybdis II' 9-max Seat #8 is the button
Seat 1: r4mz3s ($164.99 in chips) 
Seat 2: suited_doc ($91.51 in chips) 
Seat 3: Rafaello18 ($102.90 in chips) 
Seat 5: WDW3 ($100 in chips) 
Seat 6: matiko09 ($123.70 in chips) 
Seat 7: ozone2003 ($116.63 in chips) 
Seat 8: Kukuryzka ($100.20 in chips) 
Seat 9: myatiy 96 ($100 in chips) 
myatiy 96: posts small blind $0.50
r4mz3s: posts big blind $1
r4mz3s: posts the ante $0.20
suited_doc: posts the ante $0.20
Rafaello18: posts the ante $0.20
WDW3: posts the ante $0.20
matiko09: posts the ante $0.20
ozone2003: posts the ante $0.20
Kukuryzka: posts the ante $0.20
myatiy 96: posts the ante $0.20
*** HOLE CARDS ***
Dealt to matiko09 [8c Qd]
suited_doc: folds 
Rafaello18: folds 
WDW3: folds 
matiko09: folds 
ozone2003: raises $1.50 to $2.50
CI58 joins the table at seat #4 
Kukuryzka: folds 
myatiy 96: folds 
r4mz3s: folds 
Uncalled bet ($1.50) returned to ozone2003
ozone2003 collected $4.10 from pot
ozone2003: doesn't show hand 
*** SUMMARY ***
Total pot $4.10 | Rake $0 
Seat 1: r4mz3s (big blind) folded before Flop
Seat 2: suited_doc folded before Flop (didn't bet)
Seat 3: Rafaello18 folded before Flop (didn't bet)
Seat 5: WDW3 folded before Flop (didn't bet)
Seat 6: matiko09 folded before Flop (didn't bet)
Seat 7: ozone2003 collected ($4.10)
Seat 8: Kukuryzka (button) folded before Flop (didn't bet)
Seat 9: myatiy 96 (small blind) folded before Flop





PokerStars Hand #155300104928:  Hold'em No Limit ($0.50/$1.00 USD) - 2016/06/28 15:41:29 CET [2016/06/28 9:41:29 ET]
Table 'Kamenyar' 9-max Seat #9 is the button
Seat 1: Rafaello18 ($101.27 in chips) 
Seat 2: ozone2003 ($105.82 in chips) 
Seat 3: r4mz3s ($111.92 in chips) 
Seat 4: f1reworks ($224.41 in chips) 
Seat 6: matiko09 ($100 in chips) 
Seat 7: Pokah4Living ($65.52 in chips) 
Seat 8: sanpidk ($100 in chips) 
Seat 9: pyromid ($98.50 in chips) 
Rafaello18: posts small blind $0.50
ozone2003: posts big blind $1
bwly520: sits out 
*** HOLE CARDS ***
Dealt to matiko09 [3h Ks]
r4mz3s: raises $2 to $3
f1reworks: folds 
matiko09: folds 
Pokah4Living: calls $3
sanpidk: folds 
pyromid: folds 
Rafaello18: calls $2.50
ozone2003: folds 
*** FLOP *** [5h Kh Js]
Rafaello18: checks 
r4mz3s: checks 
Pokah4Living: checks 
*** TURN *** [5h Kh Js] [3d]
Rafaello18: bets $6.50
r4mz3s: folds 
Pokah4Living: folds 
Uncalled bet ($6.50) returned to Rafaello18
Rafaello18 collected $9.50 from pot
Rafaello18: doesn't show hand 
*** SUMMARY ***
Total pot $10 | Rake $0.50 
Board [5h Kh Js 3d]
Seat 1: Rafaello18 (small blind) collected ($9.50)
Seat 2: ozone2003 (big blind) folded before Flop
Seat 3: r4mz3s folded on the Turn
Seat 4: f1reworks folded before Flop (didn't bet)
Seat 6: matiko09 folded before Flop (didn't bet)
Seat 7: Pokah4Living folded on the Turn
Seat 8: sanpidk folded before Flop (didn't bet)
Seat 9: pyromid (button) folded before Flop (didn't bet)





PokerStars Hand #155300106838:  Hold'em No Limit ($0.25/$0.50 USD) - 2016/06/28 15:41:33 CET [2016/06/28 9:41:33 ET]
Table 'Arago' 9-max Seat #5 is the button
Seat 1: Vedpapa ($67.71 in chips) 
Seat 2: Xx7-Zeus-7xX ($55.16 in chips) 
Seat 3: Kodiak8787 ($73.64 in chips) 
Seat 4: funXmun ($50 in chips) 
Seat 5: omorfadramou ($50 in chips) 
Seat 6: SumPosad ($19.50 in chips) 
Seat 7: Rafaello18 ($50 in chips) 
Seat 8: matiko09 ($50 in chips) 
Seat 9: bratbugor ($73.96 in chips) 
SumPosad: posts small blind $0.25
Rafaello18: posts big blind $0.50
*** HOLE CARDS ***
Dealt to matiko09 [9c 9s]
matiko09: raises $1 to $1.50
bratbugor: folds 
Vedpapa: folds 
Xx7-Zeus-7xX: folds 
Kodiak8787: folds 
funXmun: folds 
omorfadramou: folds 
SumPosad: folds 
Rafaello18: folds 
Uncalled bet ($1) returned to matiko09
matiko09 collected $1.25 from pot
matiko09: doesn't show hand 
*** SUMMARY ***
Total pot $1.25 | Rake $0 
Seat 1: Vedpapa folded before Flop (didn't bet)
Seat 2: Xx7-Zeus-7xX folded before Flop (didn't bet)
Seat 3: Kodiak8787 folded before Flop (didn't bet)
Seat 4: funXmun folded before Flop (didn't bet)
Seat 5: omorfadramou (button) folded before Flop (didn't bet)
Seat 6: SumPosad (small blind) folded before Flop
Seat 7: Rafaello18 (big blind) folded before Flop
Seat 8: matiko09 collected ($1.25)
Seat 9: bratbugor folded before Flop (didn't bet)





PokerStars Hand #155300116471:  Hold'em No Limit ($0.50/$1.00 USD) - 2016/06/28 15:41:51 CET [2016/06/28 9:41:51 ET]
Table 'Charybdis II' 9-max Seat #9 is the button
Seat 1: r4mz3s ($163.79 in chips) 
Seat 2: suited_doc ($91.31 in chips) 
Seat 3: Rafaello18 ($102.70 in chips) 
Seat 5: WDW3 ($100 in chips) 
Seat 6: matiko09 ($123.50 in chips) 
Seat 7: ozone2003 ($119.53 in chips) 
Seat 8: Kukuryzka ($100 in chips) 
Seat 9: myatiy 96 ($100 in chips) 
r4mz3s: posts small blind $0.50
suited_doc: posts big blind $1
CI58: sits out 
r4mz3s: posts the ante $0.20
suited_doc: posts the ante $0.20
Rafaello18: posts the ante $0.20
WDW3: posts the ante $0.20
matiko09: posts the ante $0.20
ozone2003: posts the ante $0.20
Kukuryzka: posts the ante $0.20
myatiy 96: posts the ante $0.20
*** HOLE CARDS ***
Dealt to matiko09 [2d Ts]
Rafaello18: folds 
WDW3: folds 
matiko09: folds 
ozone2003: raises $2 to $3
Kukuryzka: folds 
myatiy 96: folds 
r4mz3s: folds 
suited_doc: folds 
Uncalled bet ($2) returned to ozone2003
ozone2003 collected $4.10 from pot
ozone2003: doesn't show hand 
*** SUMMARY ***
Total pot $4.10 | Rake $0 
Seat 1: r4mz3s (small blind) folded before Flop
Seat 2: suited_doc (big blind) folded before Flop
Seat 3: Rafaello18 folded before Flop (didn't bet)
Seat 5: WDW3 folded before Flop (didn't bet)
Seat 6: matiko09 folded before Flop (didn't bet)
Seat 7: ozone2003 collected ($4.10)
Seat 8: Kukuryzka folded before Flop (didn't bet)
Seat 9: myatiy 96 (button) folded before Flop (didn't bet)





PokerStars Hand #155300126896:  Hold'em No Limit ($0.25/$0.50 USD) - 2016/06/28 15:42:11 CET [2016/06/28 9:42:11 ET]
Table 'Utra' 9-max Seat #2 is the button
Seat 1: ardo888 ($50 in chips) 
Seat 2: matiko09 ($96.32 in chips) 
Seat 3: psychmantis ($38.75 in chips) 
Seat 4: ManChild9 ($44.50 in chips) 
Seat 5: baoyu4749892 ($36.88 in chips) 
Seat 6: Franky77200 ($31.03 in chips) 
Seat 7: el.suertero ($69.93 in chips) 
Seat 8: funXmun ($50 in chips) 
Seat 9: Kukuryzka ($64.24 in chips) 
psychmantis: posts small blind $0.25
ManChild9: posts big blind $0.50
ardo888: posts the ante $0.10
matiko09: posts the ante $0.10
psychmantis: posts the ante $0.10
ManChild9: posts the ante $0.10
baoyu4749892: posts the ante $0.10
Franky77200: posts the ante $0.10
el.suertero: posts the ante $0.10
funXmun: posts the ante $0.10
Kukuryzka: posts the ante $0.10
*** HOLE CARDS ***
Dealt to matiko09 [9d 3h]
baoyu4749892: folds 
Franky77200: raises $1 to $1.50
el.suertero: folds 
funXmun: folds 
Kukuryzka: folds 
ardo888: folds 
matiko09: folds 
psychmantis: calls $1.25
ManChild9: calls $1
*** FLOP *** [5h 7h 9c]
psychmantis: checks 
ManChild9: bets $3
Franky77200: calls $3
psychmantis: calls $3
*** TURN *** [5h 7h 9c] [6d]
psychmantis: bets $6.84
ManChild9: folds 
Franky77200: calls $6.84
*** RIVER *** [5h 7h 9c 6d] [Qc]
psychmantis: checks 
Franky77200: checks 
*** SHOW DOWN ***
psychmantis: shows [Td Jd] (high card Queen)
Franky77200: shows [5d 4c] (a pair of Fives)
Franky77200 collected $26.68 from pot
*** SUMMARY ***
Total pot $28.08 | Rake $1.40 
Board [5h 7h 9c 6d Qc]
Seat 1: ardo888 folded before Flop (didn't bet)
Seat 2: matiko09 (button) folded before Flop (didn't bet)
Seat 3: psychmantis (small blind) showed [Td Jd] and lost with high card Queen
Seat 4: ManChild9 (big blind) folded on the Turn
Seat 5: baoyu4749892 folded before Flop (didn't bet)
Seat 6: Franky77200 showed [5d 4c] and won ($26.68) with a pair of Fives
Seat 7: el.suertero folded before Flop (didn't bet)
Seat 8: funXmun folded before Flop (didn't bet)
Seat 9: Kukuryzka folded before Flop (didn't bet)





PokerStars Hand #155300134522:  Hold'em No Limit ($0.50/$1.00 USD) - 2016/06/28 15:42:25 CET [2016/06/28 9:42:25 ET]
Table 'Charybdis II' 9-max Seat #1 is the button
Seat 1: r4mz3s ($163.09 in chips) 
Seat 2: suited_doc ($90.11 in chips) 
Seat 3: Rafaello18 ($102.50 in chips) 
Seat 5: WDW3 ($100 in chips) 
Seat 6: matiko09 ($123.30 in chips) 
Seat 7: ozone2003 ($122.43 in chips) 
Seat 8: Kukuryzka ($99.80 in chips) 
Seat 9: myatiy 96 ($100 in chips) 
suited_doc: posts small blind $0.50
Rafaello18: posts big blind $1
CI58: sits out 
r4mz3s: posts the ante $0.20
suited_doc: posts the ante $0.20
Rafaello18: posts the ante $0.20
WDW3: posts the ante $0.20
matiko09: posts the ante $0.20
ozone2003: posts the ante $0.20
Kukuryzka: posts the ante $0.20
myatiy 96: posts the ante $0.20
*** HOLE CARDS ***
Dealt to matiko09 [8c 5c]
WDW3: folds 
matiko09: folds 
ozone2003: raises $2 to $3
Kukuryzka: folds 
myatiy 96: folds 
r4mz3s: folds 
suited_doc: folds 
Rafaello18: folds 
Uncalled bet ($2) returned to ozone2003
ozone2003 collected $4.10 from pot
ozone2003: doesn't show hand 
*** SUMMARY ***
Total pot $4.10 | Rake $0 
Seat 1: r4mz3s (button) folded before Flop (didn't bet)
Seat 2: suited_doc (small blind) folded before Flop
Seat 3: Rafaello18 (big blind) folded before Flop
Seat 5: WDW3 folded before Flop (didn't bet)
Seat 6: matiko09 folded before Flop (didn't bet)
Seat 7: ozone2003 collected ($4.10)
Seat 8: Kukuryzka folded before Flop (didn't bet)
Seat 9: myatiy 96 folded before Flop (didn't bet)





PokerStars Hand #155300143409:  Hold'em No Limit ($0.50/$1.00 USD) - 2016/06/28 15:42:42 CET [2016/06/28 9:42:42 ET]
Table 'Lyyli II' 9-max Seat #4 is the button
Seat 2: Rafaello18 ($154.06 in chips) 
Seat 4: Greha999 ($100.85 in chips) 
Seat 6: matiko09 ($100 in chips) 
Seat 7: Kukuryzka ($202.94 in chips) 
Seat 9: f1reworks ($101.30 in chips) 
flk.Dasas will be allowed to play after the button
matiko09: posts small blind $0.50
Kukuryzka: posts big blind $1
r4mz3s: sits out 
tipner: sits out 
Racushniak: sits out 
*** HOLE CARDS ***
Dealt to matiko09 [Kc 9h]
f1reworks: folds 
Rafaello18: folds 
Greha999: raises $2 to $3
matiko09: folds 
Kukuryzka: folds 
Uncalled bet ($2) returned to Greha999
Greha999 collected $2.50 from pot
*** SUMMARY ***
Total pot $2.50 | Rake $0 
Seat 2: Rafaello18 folded before Flop (didn't bet)
Seat 4: Greha999 (button) collected ($2.50)
Seat 6: matiko09 (small blind) folded before Flop
Seat 7: Kukuryzka (big blind) folded before Flop
Seat 9: f1reworks folded before Flop (didn't bet)





PokerStars Hand #155300145936:  Hold'em No Limit ($0.50/$1.00 USD) - 2016/06/28 15:42:47 CET [2016/06/28 9:42:47 ET]
Table 'Kamenyar' 9-max Seat #1 is the button
Seat 1: Rafaello18 ($107.77 in chips) 
Seat 2: ozone2003 ($104.82 in chips) 
Seat 3: r4mz3s ($108.92 in chips) 
Seat 4: f1reworks ($224.41 in chips) 
Seat 6: matiko09 ($100 in chips) 
Seat 7: Pokah4Living ($62.52 in chips) 
Seat 8: sanpidk ($100 in chips) 
Seat 9: pyromid ($98.50 in chips) 
ozone2003: posts small blind $0.50
r4mz3s: posts big blind $1
bwly520: sits out 
*** HOLE CARDS ***
Dealt to matiko09 [Jh Tc]
f1reworks: raises $2 to $3
matiko09: folds 
Pokah4Living: folds 
sanpidk: folds 
pyromid: folds 
Rafaello18: folds 
ozone2003: folds 
r4mz3s: folds 
Uncalled bet ($2) returned to f1reworks
f1reworks collected $2.50 from pot
f1reworks: doesn't show hand 
*** SUMMARY ***
Total pot $2.50 | Rake $0 
Seat 1: Rafaello18 (button) folded before Flop (didn't bet)
Seat 2: ozone2003 (small blind) folded before Flop
Seat 3: r4mz3s (big blind) folded before Flop
Seat 4: f1reworks collected ($2.50)
Seat 6: matiko09 folded before Flop (didn't bet)
Seat 7: Pokah4Living folded before Flop (didn't bet)
Seat 8: sanpidk folded before Flop (didn't bet)
Seat 9: pyromid folded before Flop (didn't bet)





PokerStars Hand #155300150543:  Hold'em No Limit ($0.50/$1.00 USD) - 2016/06/28 15:42:56 CET [2016/06/28 9:42:56 ET]
Table 'Charybdis II' 9-max Seat #2 is the button
Seat 1: r4mz3s ($162.89 in chips) 
Seat 2: suited_doc ($89.41 in chips) 
Seat 3: Rafaello18 ($101.30 in chips) 
Seat 4: CI58 ($100 in chips) 
Seat 5: WDW3 ($100 in chips) 
Seat 6: matiko09 ($123.10 in chips) 
Seat 7: ozone2003 ($125.33 in chips) 
Seat 8: Kukuryzka ($99.60 in chips) 
Seat 9: myatiy 96 ($100 in chips) 
Rafaello18: posts small blind $0.50
CI58: posts big blind $1
r4mz3s: posts the ante $0.20
suited_doc: posts the ante $0.20
Rafaello18: posts the ante $0.20
CI58: posts the ante $0.20
WDW3: posts the ante $0.20
matiko09: posts the ante $0.20
ozone2003: posts the ante $0.20
Kukuryzka: posts the ante $0.20
myatiy 96: posts the ante $0.20
*** HOLE CARDS ***
Dealt to matiko09 [5h As]
WDW3: folds 
matiko09: folds 
ozone2003: folds 
Kukuryzka: folds 
myatiy 96: folds 
r4mz3s: folds 
suited_doc: raises $1 to $2
Rafaello18: calls $1.50
CI58: folds 
*** FLOP *** [Ad Js Th]
Rafaello18: checks 
suited_doc: checks 
*** TURN *** [Ad Js Th] [Tc]
Rafaello18: bets $4
suited_doc: folds 
Uncalled bet ($4) returned to Rafaello18
Rafaello18 collected $6.46 from pot
Rafaello18: doesn't show hand 
*** SUMMARY ***
Total pot $6.80 | Rake $0.34 
Board [Ad Js Th Tc]
Seat 1: r4mz3s folded before Flop (didn't bet)
Seat 2: suited_doc (button) folded on the Turn
Seat 3: Rafaello18 (small blind) collected ($6.46)
Seat 4: CI58 (big blind) folded before Flop
Seat 5: WDW3 folded before Flop (didn't bet)
Seat 6: matiko09 folded before Flop (didn't bet)
Seat 7: ozone2003 folded before Flop (didn't bet)
Seat 8: Kukuryzka folded before Flop (didn't bet)
Seat 9: myatiy 96 folded before Flop (didn't bet)





PokerStars Hand #155300156578:  Hold'em No Limit ($0.50/$1.00 USD) - 2016/06/28 15:43:07 CET [2016/06/28 9:43:07 ET]
Table 'Lyyli II' 9-max Seat #6 is the button
Seat 2: Rafaello18 ($154.06 in chips) 
Seat 4: Greha999 ($102.35 in chips) 
Seat 6: matiko09 ($100 in chips) 
Seat 7: Kukuryzka ($201.94 in chips) 
Seat 8: r4mz3s ($100 in chips) 
Seat 9: f1reworks ($101.30 in chips) 
Kukuryzka: posts small blind $0.50
r4mz3s: posts big blind $1
tipner: sits out 
Racushniak: sits out 
flk.Dasas: sits out 
*** HOLE CARDS ***
Dealt to matiko09 [7c 3d]
f1reworks: folds 
Rafaello18: folds 
Greha999: raises $2 to $3
matiko09: folds 
Kukuryzka: folds 
r4mz3s: folds 
Uncalled bet ($2) returned to Greha999
Greha999 collected $2.50 from pot
*** SUMMARY ***
Total pot $2.50 | Rake $0 
Seat 2: Rafaello18 folded before Flop (didn't bet)
Seat 4: Greha999 collected ($2.50)
Seat 6: matiko09 (button) folded before Flop (didn't bet)
Seat 7: Kukuryzka (small blind) folded before Flop
Seat 8: r4mz3s (big blind) folded before Flop
Seat 9: f1reworks folded before Flop (didn't bet)





PokerStars Hand #155300160416:  Hold'em No Limit ($0.50/$1.00 USD) - 2016/06/28 15:43:15 CET [2016/06/28 9:43:15 ET]
Table 'Kamenyar' 9-max Seat #2 is the button
Seat 1: Rafaello18 ($107.77 in chips) 
Seat 2: ozone2003 ($104.32 in chips) 
Seat 3: r4mz3s ($107.92 in chips) 
Seat 4: f1reworks ($225.91 in chips) 
Seat 6: matiko09 ($100 in chips) 
Seat 7: Pokah4Living ($62.52 in chips) 
Seat 8: sanpidk ($100 in chips) 
Seat 9: pyromid ($98.50 in chips) 
r4mz3s: posts small blind $0.50
f1reworks: posts big blind $1
bwly520: sits out 
*** HOLE CARDS ***
Dealt to matiko09 [7s 8s]
matiko09: raises $2 to $3
Pokah4Living: folds 
sanpidk: folds 
pyromid: folds 
Rafaello18: folds 
ozone2003: folds 
r4mz3s: folds 
f1reworks: folds 
Uncalled bet ($2) returned to matiko09
matiko09 collected $2.50 from pot
matiko09: doesn't show hand 
*** SUMMARY ***
Total pot $2.50 | Rake $0 
Seat 1: Rafaello18 folded before Flop (didn't bet)
Seat 2: ozone2003 (button) folded before Flop (didn't bet)
Seat 3: r4mz3s (small blind) folded before Flop
Seat 4: f1reworks (big blind) folded before Flop
Seat 6: matiko09 collected ($2.50)
Seat 7: Pokah4Living folded before Flop (didn't bet)
Seat 8: sanpidk folded before Flop (didn't bet)
Seat 9: pyromid folded before Flop (didn't bet)





PokerStars Hand #155300161823:  Hold'em No Limit ($0.25/$0.50 USD) - 2016/06/28 15:43:17 CET [2016/06/28 9:43:17 ET]
Table 'Utra' 9-max Seat #3 is the button
Seat 1: ardo888 ($50 in chips) 
Seat 2: matiko09 ($96.22 in chips) 
Seat 3: psychmantis ($27.31 in chips) 
Seat 4: ManChild9 ($39.90 in chips) 
Seat 5: baoyu4749892 ($36.78 in chips) 
Seat 6: Franky77200 ($46.27 in chips) 
Seat 7: el.suertero ($69.83 in chips) 
Seat 8: funXmun ($50 in chips) 
Seat 9: Kukuryzka ($64.14 in chips) 
ManChild9: posts small blind $0.25
baoyu4749892: posts big blind $0.50
ardo888: posts the ante $0.10
matiko09: posts the ante $0.10
psychmantis: posts the ante $0.10
ManChild9: posts the ante $0.10
baoyu4749892: posts the ante $0.10
Franky77200: posts the ante $0.10
el.suertero: posts the ante $0.10
funXmun: posts the ante $0.10
Kukuryzka: posts the ante $0.10
*** HOLE CARDS ***
Dealt to matiko09 [5s Kc]
Franky77200: folds 
el.suertero: folds 
funXmun: folds 
Kukuryzka: folds 
ardo888: folds 
matiko09: folds 
psychmantis: folds 
ManChild9: calls $0.25
baoyu4749892: checks 
*** FLOP *** [6d 2c As]
ManChild9: bets $0.90
baoyu4749892: calls $0.90
*** TURN *** [6d 2c As] [Ad]
ManChild9: bets $1.76
baoyu4749892: folds 
Uncalled bet ($1.76) returned to ManChild9
ManChild9 collected $3.52 from pot
ManChild9: doesn't show hand 
*** SUMMARY ***
Total pot $3.70 | Rake $0.18 
Board [6d 2c As Ad]
Seat 1: ardo888 folded before Flop (didn't bet)
Seat 2: matiko09 folded before Flop (didn't bet)
Seat 3: psychmantis (button) folded before Flop (didn't bet)
Seat 4: ManChild9 (small blind) collected ($3.52)
Seat 5: baoyu4749892 (big blind) folded on the Turn
Seat 6: Franky77200 folded before Flop (didn't bet)
Seat 7: el.suertero folded before Flop (didn't bet)
Seat 8: funXmun folded before Flop (didn't bet)
Seat 9: Kukuryzka folded before Flop (didn't bet)





PokerStars Hand #155300175216:  Hold'em No Limit ($0.50/$1.00 USD) - 2016/06/28 15:43:43 CET [2016/06/28 9:43:43 ET]
Table 'Kamenyar' 9-max Seat #3 is the button
Seat 1: Rafaello18 ($107.77 in chips) 
Seat 2: ozone2003 ($104.32 in chips) 
Seat 3: r4mz3s ($107.42 in chips) 
Seat 4: f1reworks ($224.91 in chips) 
Seat 5: bwly520 ($234.67 in chips) 
Seat 6: matiko09 ($101.50 in chips) 
Seat 7: Pokah4Living ($62.52 in chips) 
Seat 8: sanpidk ($100 in chips) 
Seat 9: pyromid ($98.50 in chips) 
f1reworks: posts small blind $0.50
bwly520: posts big blind $1
*** HOLE CARDS ***
Dealt to matiko09 [Th 4c]
matiko09: folds 
Pokah4Living: folds 
sanpidk: raises $2 to $3
pyromid: folds 
Rafaello18: calls $3
ozone2003: calls $3
r4mz3s: folds 
f1reworks: folds 
bwly520: calls $2
*** FLOP *** [2c 2s 4d]
bwly520: checks 
sanpidk: bets $7
Rafaello18: folds 
ozone2003: folds 
bwly520: folds 
Uncalled bet ($7) returned to sanpidk
sanpidk collected $11.88 from pot
sanpidk: doesn't show hand 
*** SUMMARY ***
Total pot $12.50 | Rake $0.62 
Board [2c 2s 4d]
Seat 1: Rafaello18 folded on the Flop
Seat 2: ozone2003 folded on the Flop
Seat 3: r4mz3s (button) folded before Flop (didn't bet)
Seat 4: f1reworks (small blind) folded before Flop
Seat 5: bwly520 (big blind) folded on the Flop
Seat 6: matiko09 folded before Flop (didn't bet)
Seat 7: Pokah4Living folded before Flop (didn't bet)
Seat 8: sanpidk collected ($11.88)
Seat 9: pyromid folded before Flop (didn't bet)





PokerStars Hand #155300182396:  Hold'em No Limit ($0.50/$1.00 USD) - 2016/06/28 15:43:57 CET [2016/06/28 9:43:57 ET]
Table 'Lyyli II' 9-max Seat #7 is the button
Seat 2: Rafaello18 ($154.06 in chips) 
Seat 4: Greha999 ($103.85 in chips) 
Seat 6: matiko09 ($100 in chips) 
Seat 7: Kukuryzka ($201.44 in chips) 
Seat 8: r4mz3s ($100 in chips) 
Seat 9: f1reworks ($101.30 in chips) 
r4mz3s: posts small blind $0.50
f1reworks: posts big blind $1
tipner: sits out 
Racushniak: sits out 
flk.Dasas: sits out 
*** HOLE CARDS ***
Dealt to matiko09 [5d Kc]
Rafaello18: folds 
Greha999: folds 
matiko09: folds 
Kukuryzka: raises $1 to $2
r4mz3s: folds 
f1reworks: folds 
Uncalled bet ($1) returned to Kukuryzka
Kukuryzka collected $2.50 from pot
Kukuryzka: doesn't show hand 
*** SUMMARY ***
Total pot $2.50 | Rake $0 
Seat 2: Rafaello18 folded before Flop (didn't bet)
Seat 4: Greha999 folded before Flop (didn't bet)
Seat 6: matiko09 folded before Flop (didn't bet)
Seat 7: Kukuryzka (button) collected ($2.50)
Seat 8: r4mz3s (small blind) folded before Flop
Seat 9: f1reworks (big blind) folded before Flop





PokerStars Hand #155300190748:  Hold'em No Limit ($0.50/$1.00 USD) - 2016/06/28 15:44:13 CET [2016/06/28 9:44:13 ET]
Table 'Lyyli II' 9-max Seat #8 is the button
Seat 1: tipner ($126.10 in chips) 
Seat 2: Rafaello18 ($154.06 in chips) 
Seat 4: Greha999 ($103.85 in chips) 
Seat 6: matiko09 ($100 in chips) 
Seat 7: Kukuryzka ($202.94 in chips) 
Seat 8: r4mz3s ($100 in chips) 
Seat 9: f1reworks ($100.30 in chips) 
f1reworks: posts small blind $0.50
tipner: posts big blind $1
Racushniak: sits out 
flk.Dasas: sits out 
*** HOLE CARDS ***
Dealt to matiko09 [Jc Js]
Rafaello18: folds 
Greha999: folds 
matiko09: raises $2 to $3
Kukuryzka: folds 
r4mz3s: folds 
f1reworks: raises $6 to $9
tipner: folds 
matiko09: calls $6
*** FLOP *** [4c Qd 8s]
f1reworks: bets $10
matiko09: calls $10
*** TURN *** [4c Qd 8s] [Ac]
f1reworks: bets $22
matiko09: folds 
Uncalled bet ($22) returned to f1reworks
f1reworks collected $37.05 from pot
f1reworks: doesn't show hand 
*** SUMMARY ***
Total pot $39 | Rake $1.95 
Board [4c Qd 8s Ac]
Seat 1: tipner (big blind) folded before Flop
Seat 2: Rafaello18 folded before Flop (didn't bet)
Seat 4: Greha999 folded before Flop (didn't bet)
Seat 6: matiko09 folded on the Turn
Seat 7: Kukuryzka folded before Flop (didn't bet)
Seat 8: r4mz3s (button) folded before Flop (didn't bet)
Seat 9: f1reworks (small blind) collected ($37.05)





PokerStars Hand #155300191612:  Hold'em No Limit ($0.50/$1.00 USD) - 2016/06/28 15:44:15 CET [2016/06/28 9:44:15 ET]
Table 'Charybdis II' 9-max Seat #3 is the button
Seat 1: r4mz3s ($162.69 in chips) 
Seat 2: suited_doc ($87.21 in chips) 
Seat 3: Rafaello18 ($105.56 in chips) 
Seat 4: CI58 ($100 in chips) 
Seat 6: matiko09 ($122.90 in chips) 
Seat 7: ozone2003 ($125.13 in chips) 
Seat 8: Kukuryzka ($99.40 in chips) 
Seat 9: myatiy 96 ($100 in chips) 
CI58: posts small blind $0.50
WDW3: is sitting out 
matiko09: posts big blind $1
r4mz3s: posts the ante $0.20
suited_doc: posts the ante $0.20
Rafaello18: posts the ante $0.20
CI58: posts the ante $0.20
matiko09: posts the ante $0.20
ozone2003: posts the ante $0.20
Kukuryzka: posts the ante $0.20
myatiy 96: posts the ante $0.20
*** HOLE CARDS ***
Dealt to matiko09 [Qh Td]
WDW3 leaves the table
ozone2003: folds 
flk.Dasas joins the table at seat #5 
Kukuryzka: folds 
myatiy 96: raises $1.50 to $2.50
r4mz3s: folds 
suited_doc: calls $2.50
Rafaello18: calls $2.50
CI58: folds 
matiko09: calls $1.50
*** FLOP *** [9c 3c As]
matiko09: checks 
myatiy 96: bets $7.66
suited_doc: folds 
Rafaello18: folds 
matiko09: folds 
Uncalled bet ($7.66) returned to myatiy 96
myatiy 96 collected $11.50 from pot
*** SUMMARY ***
Total pot $12.10 | Rake $0.60 
Board [9c 3c As]
Seat 1: r4mz3s folded before Flop (didn't bet)
Seat 2: suited_doc folded on the Flop
Seat 3: Rafaello18 (button) folded on the Flop
Seat 4: CI58 (small blind) folded before Flop
Seat 6: matiko09 (big blind) folded on the Flop
Seat 7: ozone2003 folded before Flop (didn't bet)
Seat 8: Kukuryzka folded before Flop (didn't bet)
Seat 9: myatiy 96 collected ($11.50)





PokerStars Hand #155300196592:  Hold'em No Limit ($0.25/$0.50 USD) - 2016/06/28 15:44:24 CET [2016/06/28 9:44:24 ET]
Table 'Utra' 9-max Seat #4 is the button
Seat 1: ardo888 ($50 in chips) 
Seat 2: matiko09 ($96.12 in chips) 
Seat 3: psychmantis ($27.21 in chips) 
Seat 4: ManChild9 ($41.92 in chips) 
Seat 5: baoyu4749892 ($35.28 in chips) 
Seat 6: Franky77200 ($46.17 in chips) 
Seat 8: funXmun ($50 in chips) 
Seat 9: Kukuryzka ($64.04 in chips) 
baoyu4749892: posts small blind $0.25
Franky77200: posts big blind $0.50
ardo888: posts the ante $0.10
matiko09: posts the ante $0.10
psychmantis: posts the ante $0.10
ManChild9: posts the ante $0.10
baoyu4749892: posts the ante $0.10
Franky77200: posts the ante $0.10
funXmun: posts the ante $0.10
Kukuryzka: posts the ante $0.10
*** HOLE CARDS ***
Dealt to matiko09 [2c 8s]
funXmun: folds 
Kukuryzka: raises $1 to $1.50
ardo888: folds 
matiko09: folds 
psychmantis: folds 
ManChild9: folds 
baoyu4749892: raises $3 to $4.50
Franky77200: folds 
Kukuryzka: calls $3
*** FLOP *** [Td Js Kh]
baoyu4749892: checks 
Kukuryzka: bets $4.89
baoyu4749892: raises $4.89 to $9.78
Kukuryzka: raises $17.47 to $27.25
baoyu4749892: raises $3.43 to $30.68 and is all-in
Kukuryzka: calls $3.43
*** TURN *** [Td Js Kh] [3h]
*** RIVER *** [Td Js Kh 3h] [Ad]
*** SHOW DOWN ***
baoyu4749892: shows [Kc Ks] (three of a kind, Kings)
Kukuryzka: shows [Kd Jd] (two pair, Kings and Jacks)
baoyu4749892 collected $69.66 from pot
*** SUMMARY ***
Total pot $71.66 | Rake $2 
Board [Td Js Kh 3h Ad]
Seat 1: ardo888 folded before Flop (didn't bet)
Seat 2: matiko09 folded before Flop (didn't bet)
Seat 3: psychmantis folded before Flop (didn't bet)
Seat 4: ManChild9 (button) folded before Flop (didn't bet)
Seat 5: baoyu4749892 (small blind) showed [Kc Ks] and won ($69.66) with three of a kind, Kings
Seat 6: Franky77200 (big blind) folded before Flop
Seat 8: funXmun folded before Flop (didn't bet)
Seat 9: Kukuryzka showed [Kd Jd] and lost with two pair, Kings and Jacks





PokerStars Hand #155300220207:  Hold'em No Limit ($0.50/$1.00 USD) - 2016/06/28 15:45:10 CET [2016/06/28 9:45:10 ET]
Table 'Lyyli II' 9-max Seat #9 is the button
Seat 1: tipner ($125.10 in chips) 
Seat 2: Rafaello18 ($154.06 in chips) 
Seat 4: Greha999 ($103.85 in chips) 
Seat 6: matiko09 ($100 in chips) 
Seat 7: Kukuryzka ($202.94 in chips) 
Seat 8: r4mz3s ($100 in chips) 
Seat 9: f1reworks ($118.35 in chips) 
tipner: posts small blind $0.50
Rafaello18: posts big blind $1
Racushniak: sits out 
flk.Dasas: sits out 
*** HOLE CARDS ***
Dealt to matiko09 [8c Ts]
Greha999: folds 
matiko09: folds 
Kukuryzka: folds 
r4mz3s: raises $1.55 to $2.55
f1reworks: calls $2.55
tipner: folds 
Rafaello18: folds 
*** FLOP *** [Jc 4c Kh]
r4mz3s: checks 
f1reworks: checks 
*** TURN *** [Jc 4c Kh] [5s]
r4mz3s: bets $4.50
f1reworks: calls $4.50
*** RIVER *** [Jc 4c Kh 5s] [3d]
r4mz3s: bets $10.50
f1reworks: folds 
Uncalled bet ($10.50) returned to r4mz3s
r4mz3s collected $14.82 from pot
r4mz3s: doesn't show hand 
*** SUMMARY ***
Total pot $15.60 | Rake $0.78 
Board [Jc 4c Kh 5s 3d]
Seat 1: tipner (small blind) folded before Flop
Seat 2: Rafaello18 (big blind) folded before Flop
Seat 4: Greha999 folded before Flop (didn't bet)
Seat 6: matiko09 folded before Flop (didn't bet)
Seat 7: Kukuryzka folded before Flop (didn't bet)
Seat 8: r4mz3s collected ($14.82)
Seat 9: f1reworks (button) folded on the River





PokerStars Hand #155300234647:  Hold'em No Limit ($0.50/$1.00 USD) - 2016/06/28 15:45:37 CET [2016/06/28 9:45:37 ET]
Table 'Charybdis II' 9-max Seat #4 is the button
Seat 1: r4mz3s ($162.49 in chips) 
Seat 2: suited_doc ($84.51 in chips) 
Seat 3: Rafaello18 ($102.86 in chips) 
Seat 4: CI58 ($100 in chips) 
Seat 6: matiko09 ($120.20 in chips) 
Seat 7: ozone2003 ($124.93 in chips) 
Seat 8: Kukuryzka ($99.20 in chips) 
Seat 9: myatiy 96 ($108.80 in chips) 
flk.Dasas will be allowed to play after the button
matiko09: posts small blind $0.50
ozone2003: posts big blind $1
r4mz3s: posts the ante $0.20
suited_doc: posts the ante $0.20
Rafaello18: posts the ante $0.20
CI58: posts the ante $0.20
matiko09: posts the ante $0.20
ozone2003: posts the ante $0.20
Kukuryzka: posts the ante $0.20
myatiy 96: posts the ante $0.20
*** HOLE CARDS ***
Dealt to matiko09 [As 8s]
Kukuryzka: folds 
myatiy 96: folds 
r4mz3s: raises $1.55 to $2.55
suited_doc: calls $2.55
Rafaello18: folds 
CI58: calls $2.55
matiko09: folds 
ozone2003: folds 
*** FLOP *** [8d 5s 3h]
r4mz3s: checks 
suited_doc: bets $5.10
CI58: calls $5.10
r4mz3s: folds 
*** TURN *** [8d 5s 3h] [4c]
suited_doc: bets $9.95
CI58: folds 
Uncalled bet ($9.95) returned to suited_doc
suited_doc collected $19.90 from pot
suited_doc: doesn't show hand 
*** SUMMARY ***
Total pot $20.95 | Rake $1.05 
Board [8d 5s 3h 4c]
Seat 1: r4mz3s folded on the Flop
Seat 2: suited_doc collected ($19.90)
Seat 3: Rafaello18 folded before Flop (didn't bet)
Seat 4: CI58 (button) folded on the Turn
Seat 6: matiko09 (small blind) folded before Flop
Seat 7: ozone2003 (big blind) folded before Flop
Seat 8: Kukuryzka folded before Flop (didn't bet)
Seat 9: myatiy 96 folded before Flop (didn't bet)





PokerStars Hand #155300243781:  Hold'em No Limit ($0.50/$1.00 USD) - 2016/06/28 15:45:55 CET [2016/06/28 9:45:55 ET]
Table 'Kamenyar' 9-max Seat #4 is the button
Seat 1: Rafaello18 ($104.77 in chips) 
Seat 2: ozone2003 ($101.32 in chips) 
Seat 3: r4mz3s ($107.42 in chips) 
Seat 4: f1reworks ($224.41 in chips) 
Seat 5: bwly520 ($231.67 in chips) 
Seat 6: matiko09 ($101.50 in chips) 
Seat 7: Pokah4Living ($62.52 in chips) 
Seat 8: sanpidk ($108.88 in chips) 
Seat 9: pyromid ($98.50 in chips) 
bwly520: posts small blind $0.50
matiko09: posts big blind $1
*** HOLE CARDS ***
Dealt to matiko09 [2s 5h]
Pokah4Living: folds 
sanpidk: folds 
pyromid: folds 
Rafaello18: raises $1.50 to $2.50
ozone2003: folds 
r4mz3s: folds 
f1reworks: folds 
bwly520: calls $2
matiko09: folds 
*** FLOP *** [2c Jh Qc]
bwly520: checks 
Rafaello18: bets $4
bwly520: calls $4
*** TURN *** [2c Jh Qc] [7d]
bwly520: checks 
Rafaello18: bets $10
bwly520: calls $10
*** RIVER *** [2c Jh Qc 7d] [6h]
bwly520: checks 
Rafaello18: bets $22
bwly520: folds 
Uncalled bet ($22) returned to Rafaello18
Rafaello18 collected $32.30 from pot
Rafaello18: doesn't show hand 
*** SUMMARY ***
Total pot $34 | Rake $1.70 
Board [2c Jh Qc 7d 6h]
Seat 1: Rafaello18 collected ($32.30)
Seat 2: ozone2003 folded before Flop (didn't bet)
Seat 3: r4mz3s folded before Flop (didn't bet)
Seat 4: f1reworks (button) folded before Flop (didn't bet)
Seat 5: bwly520 (small blind) folded on the River
Seat 6: matiko09 (big blind) folded before Flop
Seat 7: Pokah4Living folded before Flop (didn't bet)
Seat 8: sanpidk folded before Flop (didn't bet)
Seat 9: pyromid folded before Flop (didn't bet)





PokerStars Hand #155300263434:  Hold'em No Limit ($0.50/$1.00 USD) - 2016/06/28 15:46:33 CET [2016/06/28 9:46:33 ET]
Table 'Lyyli II' 9-max Seat #1 is the button
Seat 1: tipner ($124.60 in chips) 
Seat 2: Rafaello18 ($153.06 in chips) 
Seat 3: Racushniak ($100 in chips) 
Seat 4: Greha999 ($103.85 in chips) 
Seat 6: matiko09 ($100 in chips) 
Seat 7: Kukuryzka ($202.94 in chips) 
Seat 8: r4mz3s ($107.77 in chips) 
Seat 9: f1reworks ($111.30 in chips) 
Rafaello18: posts small blind $0.50
Racushniak: posts big blind $1
flk.Dasas: sits out 
*** HOLE CARDS ***
Dealt to matiko09 [Tc Th]
Greha999: raises $2 to $3
matiko09: raises $6 to $9
Kukuryzka: folds 
r4mz3s: folds 
f1reworks: folds 
tipner: folds 
Rafaello18: folds 
Racushniak: folds 
Greha999: calls $6
*** FLOP *** [5h Js 2h]
Greha999: checks 
matiko09: bets $10
Greha999: folds 
Uncalled bet ($10) returned to matiko09
matiko09 collected $18.52 from pot
matiko09: doesn't show hand 
*** SUMMARY ***
Total pot $19.50 | Rake $0.98 
Board [5h Js 2h]
Seat 1: tipner (button) folded before Flop (didn't bet)
Seat 2: Rafaello18 (small blind) folded before Flop
Seat 3: Racushniak (big blind) folded before Flop
Seat 4: Greha999 folded on the Flop
Seat 6: matiko09 collected ($18.52)
Seat 7: Kukuryzka folded before Flop (didn't bet)
Seat 8: r4mz3s folded before Flop (didn't bet)
Seat 9: f1reworks folded before Flop (didn't bet)





PokerStars Hand #155300269683:  Hold'em No Limit ($0.25/$0.50 USD) - 2016/06/28 15:46:45 CET [2016/06/28 9:46:45 ET]
Table 'Utra' 9-max Seat #5 is the button
Seat 1: ardo888 ($50 in chips) 
Seat 2: matiko09 ($96.02 in chips) 
Seat 3: psychmantis ($27.11 in chips) 
Seat 4: ManChild9 ($41.82 in chips) 
Seat 5: baoyu4749892 ($69.66 in chips) 
Seat 6: Franky77200 ($45.57 in chips) 
Seat 8: funXmun ($50 in chips) 
Seat 9: Kukuryzka ($50 in chips) 
Franky77200: posts small blind $0.25
funXmun: posts big blind $0.50
ardo888: posts the ante $0.10
matiko09: posts the ante $0.10
psychmantis: posts the ante $0.10
ManChild9: posts the ante $0.10
baoyu4749892: posts the ante $0.10
Franky77200: posts the ante $0.10
funXmun: posts the ante $0.10
Kukuryzka: posts the ante $0.10
*** HOLE CARDS ***
Dealt to matiko09 [3d Td]
Kukuryzka: folds 
ardo888: raises $1 to $1.50
matiko09: folds 
psychmantis: folds 
ManChild9: folds 
baoyu4749892: folds 
Franky77200: calls $1.25
funXmun: folds 
*** FLOP *** [6d 6h Tc]
Franky77200: checks 
ardo888: bets $2
Franky77200: raises $4.50 to $6.50
ardo888: folds 
Uncalled bet ($4.50) returned to Franky77200
Franky77200 collected $7.88 from pot
Franky77200: doesn't show hand 
*** SUMMARY ***
Total pot $8.30 | Rake $0.42 
Board [6d 6h Tc]
Seat 1: ardo888 folded on the Flop
Seat 2: matiko09 folded before Flop (didn't bet)
Seat 3: psychmantis folded before Flop (didn't bet)
Seat 4: ManChild9 folded before Flop (didn't bet)
Seat 5: baoyu4749892 (button) folded before Flop (didn't bet)
Seat 6: Franky77200 (small blind) collected ($7.88)
Seat 8: funXmun (big blind) folded before Flop
Seat 9: Kukuryzka folded before Flop (didn't bet)





PokerStars Hand #155300284755:  Hold'em No Limit ($0.50/$1.00 USD) - 2016/06/28 15:47:06 CET [2016/06/28 9:47:06 ET]
Table 'Kamenyar' 9-max Seat #5 is the button
Seat 1: Rafaello18 ($120.57 in chips) 
Seat 2: ozone2003 ($101.32 in chips) 
Seat 3: r4mz3s ($107.42 in chips) 
Seat 4: f1reworks ($224.41 in chips) 
Seat 5: bwly520 ($215.17 in chips) 
Seat 6: matiko09 ($100.50 in chips) 
Seat 7: Pokah4Living ($62.52 in chips) 
Seat 8: sanpidk ($108.88 in chips) 
Seat 9: pyromid ($98.50 in chips) 
matiko09: posts small blind $0.50
Pokah4Living: posts big blind $1
*** HOLE CARDS ***
Dealt to matiko09 [Ts 2c]
sanpidk: folds 
pyromid: folds 
Rafaello18: folds 
ozone2003: folds 
r4mz3s: folds 
f1reworks: raises $2 to $3
bwly520: folds 
matiko09: folds 
Pokah4Living: folds 
Uncalled bet ($2) returned to f1reworks
f1reworks collected $2.50 from pot
f1reworks: doesn't show hand 
*** SUMMARY ***
Total pot $2.50 | Rake $0 
Seat 1: Rafaello18 folded before Flop (didn't bet)
Seat 2: ozone2003 folded before Flop (didn't bet)
Seat 3: r4mz3s folded before Flop (didn't bet)
Seat 4: f1reworks collected ($2.50)
Seat 5: bwly520 (button) folded before Flop (didn't bet)
Seat 6: matiko09 (small blind) folded before Flop
Seat 7: Pokah4Living (big blind) folded before Flop
Seat 8: sanpidk folded before Flop (didn't bet)
Seat 9: pyromid folded before Flop (didn't bet)





PokerStars Hand #155300296673:  Hold'em No Limit ($0.50/$1.00 USD) - 2016/06/28 15:47:21 CET [2016/06/28 9:47:21 ET]
Table 'Charybdis II' 9-max Seat #6 is the button
Seat 1: r4mz3s ($159.74 in chips) 
Seat 2: suited_doc ($96.56 in chips) 
Seat 3: Rafaello18 ($102.66 in chips) 
Seat 4: CI58 ($100 in chips) 
Seat 6: matiko09 ($119.50 in chips) 
Seat 7: ozone2003 ($123.73 in chips) 
ozone2003: posts small blind $0.50
Kukuryzka: is sitting out 
myatiy 96: is sitting out 
r4mz3s: posts big blind $1
flk.Dasas: sits out 
r4mz3s: posts the ante $0.20
suited_doc: posts the ante $0.20
Rafaello18: posts the ante $0.20
CI58: posts the ante $0.20
matiko09: posts the ante $0.20
ozone2003: posts the ante $0.20
*** HOLE CARDS ***
Dealt to matiko09 [7h Ac]
myatiy 96 leaves the table
suited_doc: folds 
Kukuryzka leaves the table
Rafaello18: folds 
CI58: folds 
matiko09: raises $1.27 to $2.27
myatiy 96 joins the table at seat #8 
ozone2003: folds 
myatiy 96 leaves the table
r4mz3s: folds 
Uncalled bet ($1.27) returned to matiko09
matiko09 collected $3.70 from pot
matiko09: doesn't show hand 
*** SUMMARY ***
Total pot $3.70 | Rake $0 
Seat 1: r4mz3s (big blind) folded before Flop
Seat 2: suited_doc folded before Flop (didn't bet)
Seat 3: Rafaello18 folded before Flop (didn't bet)
Seat 4: CI58 folded before Flop (didn't bet)
Seat 6: matiko09 (button) collected ($3.70)
Seat 7: ozone2003 (small blind) folded before Flop





PokerStars Hand #155300308693:  Hold'em No Limit ($0.25/$0.50 USD) - 2016/06/28 15:47:37 CET [2016/06/28 9:47:37 ET]
Table 'Kordula' 9-max Seat #4 is the button
Seat 1: Peremogec8 ($51.75 in chips) 
Seat 2: app1e_j@ck ($51.24 in chips) 
Seat 3: Kukuryzka ($49.75 in chips) 
Seat 4: badmadrabbit ($50 in chips) 
Seat 5: longway386 ($23.75 in chips) 
Seat 6: matiko09 ($50 in chips) 
Seat 9: balthie ($70.56 in chips) 
longway386: posts small blind $0.25
matiko09: posts big blind $0.50
advser: sits out 
ardo888: sits out 
*** HOLE CARDS ***
Dealt to matiko09 [8h 4d]
balthie: calls $0.50
Peremogec8: folds 
app1e_j@ck: folds 
Kukuryzka: folds 
badmadrabbit: folds 
longway386: raises $1 to $1.50
matiko09: folds 
balthie: raises $4 to $5.50
longway386: calls $4
*** FLOP *** [6c 7s Js]
longway386: checks 
balthie: bets $13.50
longway386: folds 
Uncalled bet ($13.50) returned to balthie
balthie collected $10.92 from pot
*** SUMMARY ***
Total pot $11.50 | Rake $0.58 
Board [6c 7s Js]
Seat 1: Peremogec8 folded before Flop (didn't bet)
Seat 2: app1e_j@ck folded before Flop (didn't bet)
Seat 3: Kukuryzka folded before Flop (didn't bet)
Seat 4: badmadrabbit (button) folded before Flop (didn't bet)
Seat 5: longway386 (small blind) folded on the Flop
Seat 6: matiko09 (big blind) folded before Flop
Seat 9: balthie collected ($10.92)





PokerStars Hand #155300317009:  Hold'em No Limit ($0.25/$0.50 USD) - 2016/06/28 15:47:50 CET [2016/06/28 9:47:50 ET]
Table 'Utra' 9-max Seat #6 is the button
Seat 1: ardo888 ($50 in chips) 
Seat 2: matiko09 ($95.92 in chips) 
Seat 3: psychmantis ($27.01 in chips) 
Seat 4: ManChild9 ($41.72 in chips) 
Seat 5: baoyu4749892 ($69.56 in chips) 
Seat 6: Franky77200 ($49.85 in chips) 
Seat 8: funXmun ($50 in chips) 
Seat 9: Kukuryzka ($49.90 in chips) 
funXmun: posts small blind $0.25
Kukuryzka: posts big blind $0.50
ardo888: posts the ante $0.10
matiko09: posts the ante $0.10
psychmantis: posts the ante $0.10
ManChild9: posts the ante $0.10
baoyu4749892: posts the ante $0.10
Franky77200: posts the ante $0.10
funXmun: posts the ante $0.10
Kukuryzka: posts the ante $0.10
*** HOLE CARDS ***
Dealt to matiko09 [9s Tc]
ardo888: folds 
matiko09: folds 
psychmantis: folds 
ManChild9: calls $0.50
baoyu4749892: folds 
Franky77200: raises $1 to $1.50
funXmun: folds 
Kukuryzka: calls $1
ManChild9: calls $1
*** FLOP *** [7h Qc Qd]
Kukuryzka: checks 
ManChild9: bets $2.63
Franky77200: calls $2.63
Kukuryzka: folds 
*** TURN *** [7h Qc Qd] [6c]
ManChild9: checks 
Franky77200: checks 
*** RIVER *** [7h Qc Qd 6c] [7d]
ManChild9: bets $6.50
Franky77200: raises $39.12 to $45.62 and is all-in
ManChild9: folds 
Uncalled bet ($39.12) returned to Franky77200
Franky77200 collected $22.62 from pot
Franky77200: doesn't show hand 
*** SUMMARY ***
Total pot $23.81 | Rake $1.19 
Board [7h Qc Qd 6c 7d]
Seat 1: ardo888 folded before Flop (didn't bet)
Seat 2: matiko09 folded before Flop (didn't bet)
Seat 3: psychmantis folded before Flop (didn't bet)
Seat 4: ManChild9 folded on the River
Seat 5: baoyu4749892 folded before Flop (didn't bet)
Seat 6: Franky77200 (button) collected ($22.62)
Seat 8: funXmun (small blind) folded before Flop
Seat 9: Kukuryzka (big blind) folded on the Flop





PokerStars Hand #155300317102:  Hold'em No Limit ($0.50/$1.00 USD) - 2016/06/28 15:47:50 CET [2016/06/28 9:47:50 ET]
Table 'Kamenyar' 9-max Seat #6 is the button
Seat 1: Rafaello18 ($120.57 in chips) 
Seat 2: ozone2003 ($101.32 in chips) 
Seat 3: r4mz3s ($107.42 in chips) 
Seat 4: f1reworks ($225.91 in chips) 
Seat 5: bwly520 ($215.17 in chips) 
Seat 6: matiko09 ($100 in chips) 
Seat 7: Pokah4Living ($61.52 in chips) 
Seat 8: sanpidk ($108.88 in chips) 
Seat 9: pyromid ($98.50 in chips) 
Pokah4Living: posts small blind $0.50
sanpidk: posts big blind $1
*** HOLE CARDS ***
Dealt to matiko09 [Ks 2h]
pyromid: folds 
Rafaello18: folds 
ozone2003: folds 
r4mz3s: folds 
f1reworks: folds 
bwly520: raises $2 to $3
matiko09: folds 
Pokah4Living: folds 
sanpidk: folds 
Uncalled bet ($2) returned to bwly520
bwly520 collected $2.50 from pot
*** SUMMARY ***
Total pot $2.50 | Rake $0 
Seat 1: Rafaello18 folded before Flop (didn't bet)
Seat 2: ozone2003 folded before Flop (didn't bet)
Seat 3: r4mz3s folded before Flop (didn't bet)
Seat 4: f1reworks folded before Flop (didn't bet)
Seat 5: bwly520 collected ($2.50)
Seat 6: matiko09 (button) folded before Flop (didn't bet)
Seat 7: Pokah4Living (small blind) folded before Flop
Seat 8: sanpidk (big blind) folded before Flop
Seat 9: pyromid folded before Flop (didn't bet)





PokerStars Hand #155300318242:  Hold'em No Limit ($0.50/$1.00 USD) - 2016/06/28 15:47:52 CET [2016/06/28 9:47:52 ET]
Table 'Lyyli II' 9-max Seat #2 is the button
Seat 1: tipner ($124.60 in chips) 
Seat 2: Rafaello18 ($152.56 in chips) 
Seat 3: Racushniak ($100 in chips) 
Seat 4: Greha999 ($94.85 in chips) 
Seat 6: matiko09 ($109.52 in chips) 
Seat 7: Kukuryzka ($202.94 in chips) 
Seat 8: r4mz3s ($107.77 in chips) 
Seat 9: f1reworks ($111.30 in chips) 
Racushniak: posts small blind $0.50
Greha999: posts big blind $1
flk.Dasas: sits out 
*** HOLE CARDS ***
Dealt to matiko09 [Jd 8h]
matiko09: folds 
Kukuryzka: folds 
r4mz3s: folds 
f1reworks: raises $2 to $3
tipner: folds 
Rafaello18: folds 
Racushniak: folds 
Greha999: folds 
Uncalled bet ($2) returned to f1reworks
f1reworks collected $2.50 from pot
f1reworks: doesn't show hand 
*** SUMMARY ***
Total pot $2.50 | Rake $0 
Seat 1: tipner folded before Flop (didn't bet)
Seat 2: Rafaello18 (button) folded before Flop (didn't bet)
Seat 3: Racushniak (small blind) folded before Flop
Seat 4: Greha999 (big blind) folded before Flop
Seat 6: matiko09 folded before Flop (didn't bet)
Seat 7: Kukuryzka folded before Flop (didn't bet)
Seat 8: r4mz3s folded before Flop (didn't bet)
Seat 9: f1reworks collected ($2.50)





PokerStars Hand #155300327198:  Hold'em No Limit ($0.50/$1.00 USD) - 2016/06/28 15:48:09 CET [2016/06/28 9:48:09 ET]
Table 'Charybdis II' 9-max Seat #7 is the button
Seat 1: r4mz3s ($158.54 in chips) 
Seat 2: suited_doc ($96.36 in chips) 
Seat 3: Rafaello18 ($102.46 in chips) 
Seat 4: CI58 ($100 in chips) 
Seat 6: matiko09 ($122 in chips) 
Seat 7: ozone2003 ($123.03 in chips) 
r4mz3s: posts small blind $0.50
suited_doc: posts big blind $1
flk.Dasas: sits out 
r4mz3s: posts the ante $0.20
suited_doc: posts the ante $0.20
Rafaello18: posts the ante $0.20
CI58: posts the ante $0.20
matiko09: posts the ante $0.20
ozone2003: posts the ante $0.20
*** HOLE CARDS ***
Dealt to matiko09 [4c Jd]
Rafaello18: raises $1.50 to $2.50
CI58: folds 
matiko09: folds 
ozone2003: calls $2.50
r4mz3s: folds 
suited_doc: folds 
*** FLOP *** [8c 4s Qd]
Rafaello18: bets $5
ozone2003: folds 
Uncalled bet ($5) returned to Rafaello18
Rafaello18 collected $7.32 from pot
Rafaello18: doesn't show hand 
*** SUMMARY ***
Total pot $7.70 | Rake $0.38 
Board [8c 4s Qd]
Seat 1: r4mz3s (small blind) folded before Flop
Seat 2: suited_doc (big blind) folded before Flop
Seat 3: Rafaello18 collected ($7.32)
Seat 4: CI58 folded before Flop (didn't bet)
Seat 6: matiko09 folded before Flop (didn't bet)
Seat 7: ozone2003 (button) folded on the Flop





PokerStars Hand #155300332175:  Hold'em No Limit ($0.50/$1.00 USD) - 2016/06/28 15:48:18 CET [2016/06/28 9:48:18 ET]
Table 'Lyyli II' 9-max Seat #3 is the button
Seat 1: tipner ($124.60 in chips) 
Seat 2: Rafaello18 ($152.56 in chips) 
Seat 3: Racushniak ($100 in chips) 
Seat 4: Greha999 ($93.85 in chips) 
Seat 5: flk.Dasas ($100 in chips) 
Seat 6: matiko09 ($109.52 in chips) 
Seat 7: Kukuryzka ($202.94 in chips) 
Seat 8: r4mz3s ($107.77 in chips) 
Seat 9: f1reworks ($112.80 in chips) 
Greha999: posts small blind $0.50
flk.Dasas: posts big blind $1
*** HOLE CARDS ***
Dealt to matiko09 [4h Kc]
matiko09: folds 
Kukuryzka: folds 
r4mz3s: folds 
f1reworks: folds 
tipner: folds 
Rafaello18: folds 
Racushniak: folds 
Greha999: raises $2 to $3
flk.Dasas: raises $7 to $10
Greha999: calls $7
*** FLOP *** [5s 8s 7c]
Greha999: checks 
flk.Dasas: bets $9.74
Greha999: raises $9.74 to $19.48
flk.Dasas: folds 
Uncalled bet ($9.74) returned to Greha999
Greha999 collected $37.51 from pot
*** SUMMARY ***
Total pot $39.48 | Rake $1.97 
Board [5s 8s 7c]
Seat 1: tipner folded before Flop (didn't bet)
Seat 2: Rafaello18 folded before Flop (didn't bet)
Seat 3: Racushniak (button) folded before Flop (didn't bet)
Seat 4: Greha999 (small blind) collected ($37.51)
Seat 5: flk.Dasas (big blind) folded on the Flop
Seat 6: matiko09 folded before Flop (didn't bet)
Seat 7: Kukuryzka folded before Flop (didn't bet)
Seat 8: r4mz3s folded before Flop (didn't bet)
Seat 9: f1reworks folded before Flop (didn't bet)





PokerStars Hand #155300332553:  Hold'em No Limit ($0.50/$1.00 USD) - 2016/06/28 15:48:19 CET [2016/06/28 9:48:19 ET]
Table 'Kamenyar' 9-max Seat #7 is the button
Seat 1: Rafaello18 ($120.57 in chips) 
Seat 2: ozone2003 ($101.32 in chips) 
Seat 3: r4mz3s ($107.42 in chips) 
Seat 4: f1reworks ($225.91 in chips) 
Seat 5: bwly520 ($216.67 in chips) 
Seat 6: matiko09 ($100 in chips) 
Seat 7: Pokah4Living ($61.02 in chips) 
Seat 8: sanpidk ($107.88 in chips) 
Seat 9: pyromid ($98.50 in chips) 
sanpidk: posts small blind $0.50
pyromid: posts big blind $1
*** HOLE CARDS ***
Dealt to matiko09 [3c Kh]
Rafaello18: folds 
ozone2003: folds 
r4mz3s: folds 
f1reworks: folds 
bwly520: raises $2 to $3
matiko09: folds 
Pokah4Living: folds 
sanpidk: folds 
pyromid: folds 
Uncalled bet ($2) returned to bwly520
bwly520 collected $2.50 from pot
*** SUMMARY ***
Total pot $2.50 | Rake $0 
Seat 1: Rafaello18 folded before Flop (didn't bet)
Seat 2: ozone2003 folded before Flop (didn't bet)
Seat 3: r4mz3s folded before Flop (didn't bet)
Seat 4: f1reworks folded before Flop (didn't bet)
Seat 5: bwly520 collected ($2.50)
Seat 6: matiko09 folded before Flop (didn't bet)
Seat 7: Pokah4Living (button) folded before Flop (didn't bet)
Seat 8: sanpidk (small blind) folded before Flop
Seat 9: pyromid (big blind) folded before Flop





PokerStars Hand #155300340796:  Hold'em No Limit ($0.25/$0.50 USD) - 2016/06/28 15:48:34 CET [2016/06/28 9:48:34 ET]
Table 'Kordula' 9-max Seat #5 is the button
Seat 1: Peremogec8 ($51.75 in chips) 
Seat 2: app1e_j@ck ($51.24 in chips) 
Seat 3: Kukuryzka ($49.75 in chips) 
Seat 4: badmadrabbit ($50 in chips) 
Seat 5: longway386 ($18.25 in chips) 
Seat 6: matiko09 ($50 in chips) 
Seat 7: advser ($40 in chips) 
Seat 9: balthie ($75.98 in chips) 
matiko09: posts small blind $0.25
advser: posts big blind $0.50
ardo888: sits out 
*** HOLE CARDS ***
Dealt to matiko09 [2c 4s]
balthie: folds 
Peremogec8: calls $0.50
app1e_j@ck: raises $1.50 to $2
Kukuryzka: folds 
badmadrabbit: folds 
longway386: folds 
matiko09: folds 
advser: folds 
Peremogec8: folds 
Uncalled bet ($1.50) returned to app1e_j@ck
app1e_j@ck collected $1.75 from pot
app1e_j@ck: doesn't show hand 
*** SUMMARY ***
Total pot $1.75 | Rake $0 
Seat 1: Peremogec8 folded before Flop
Seat 2: app1e_j@ck collected ($1.75)
Seat 3: Kukuryzka folded before Flop (didn't bet)
Seat 4: badmadrabbit folded before Flop (didn't bet)
Seat 5: longway386 (button) folded before Flop (didn't bet)
Seat 6: matiko09 (small blind) folded before Flop
Seat 7: advser (big blind) folded before Flop
Seat 9: balthie folded before Flop (didn't bet)





PokerStars Hand #155300348168:  Hold'em No Limit ($0.50/$1.00 USD) - 2016/06/28 15:48:48 CET [2016/06/28 9:48:48 ET]
Table 'Kamenyar' 9-max Seat #8 is the button
Seat 1: Rafaello18 ($120.57 in chips) 
Seat 2: ozone2003 ($101.32 in chips) 
Seat 3: r4mz3s ($107.42 in chips) 
Seat 4: f1reworks ($225.91 in chips) 
Seat 5: bwly520 ($218.17 in chips) 
Seat 6: matiko09 ($100 in chips) 
Seat 7: Pokah4Living ($61.02 in chips) 
Seat 8: sanpidk ($107.38 in chips) 
Seat 9: pyromid ($97.50 in chips) 
pyromid: posts small blind $0.50
Rafaello18: posts big blind $1
*** HOLE CARDS ***
Dealt to matiko09 [3d 3c]
ozone2003: folds 
r4mz3s: folds 
f1reworks: folds 
bwly520: raises $1 to $2
matiko09: calls $2
Pokah4Living: folds 
sanpidk: calls $2
pyromid: calls $1.50
Rafaello18: raises $14 to $16
bwly520: folds 
matiko09: folds 
sanpidk: folds 
pyromid: folds 
Uncalled bet ($14) returned to Rafaello18
Rafaello18 collected $10 from pot
Rafaello18: doesn't show hand 
*** SUMMARY ***
Total pot $10 | Rake $0 
Seat 1: Rafaello18 (big blind) collected ($10)
Seat 2: ozone2003 folded before Flop (didn't bet)
Seat 3: r4mz3s folded before Flop (didn't bet)
Seat 4: f1reworks folded before Flop (didn't bet)
Seat 5: bwly520 folded before Flop
Seat 6: matiko09 folded before Flop
Seat 7: Pokah4Living folded before Flop (didn't bet)
Seat 8: sanpidk (button) folded before Flop
Seat 9: pyromid (small blind) folded before Flop





PokerStars Hand #155300355279:  Hold'em No Limit ($0.50/$1.00 USD) - 2016/06/28 15:49:02 CET [2016/06/28 9:49:02 ET]
Table 'Charybdis II' 9-max Seat #1 is the button
Seat 1: r4mz3s ($157.84 in chips) 
Seat 2: suited_doc ($95.16 in chips) 
Seat 3: Rafaello18 ($107.08 in chips) 
Seat 4: CI58 ($100 in chips) 
Seat 6: matiko09 ($121.80 in chips) 
Seat 7: ozone2003 ($120.33 in chips) 
suited_doc: posts small blind $0.50
Rafaello18: posts big blind $1
flk.Dasas: sits out 
r4mz3s: posts the ante $0.20
suited_doc: posts the ante $0.20
Rafaello18: posts the ante $0.20
CI58: posts the ante $0.20
matiko09: posts the ante $0.20
ozone2003: posts the ante $0.20
*** HOLE CARDS ***
Dealt to matiko09 [2h Qc]
CI58: folds 
matiko09: folds 
ozone2003: folds 
r4mz3s: folds 
suited_doc: calls $0.50
Rafaello18: checks 
*** FLOP *** [2c Js Kh]
suited_doc: checks 
Rafaello18: checks 
*** TURN *** [2c Js Kh] [As]
suited_doc: checks 
Rafaello18: bets $1
suited_doc: calls $1
*** RIVER *** [2c Js Kh As] [6s]
suited_doc: checks 
Rafaello18: checks 
*** SHOW DOWN ***
suited_doc: shows [Kd 8s] (a pair of Kings)
Rafaello18: mucks hand 
suited_doc collected $4.94 from pot
*** SUMMARY ***
Total pot $5.20 | Rake $0.26 
Board [2c Js Kh As 6s]
Seat 1: r4mz3s (button) folded before Flop (didn't bet)
Seat 2: suited_doc (small blind) showed [Kd 8s] and won ($4.94) with a pair of Kings
Seat 3: Rafaello18 (big blind) mucked [7d 9h]
Seat 4: CI58 folded before Flop (didn't bet)
Seat 6: matiko09 folded before Flop (didn't bet)
Seat 7: ozone2003 folded before Flop (didn't bet)





PokerStars Hand #155300360627:  Hold'em No Limit ($0.25/$0.50 USD) - 2016/06/28 15:49:12 CET [2016/06/28 9:49:12 ET]
Table 'Utra' 9-max Seat #8 is the button
Seat 1: ardo888 ($50 in chips) 
Seat 2: matiko09 ($95.82 in chips) 
Seat 3: psychmantis ($26.91 in chips) 
Seat 4: ManChild9 ($30.99 in chips) 
Seat 5: baoyu4749892 ($69.46 in chips) 
Seat 6: Franky77200 ($61.74 in chips) 
Seat 8: funXmun ($50 in chips) 
Seat 9: Kukuryzka ($50 in chips) 
Kukuryzka: posts small blind $0.25
ardo888: posts big blind $0.50
el.suertero: sits out 
ardo888: posts the ante $0.10
matiko09: posts the ante $0.10
psychmantis: posts the ante $0.10
ManChild9: posts the ante $0.10
baoyu4749892: posts the ante $0.10
Franky77200: posts the ante $0.10
funXmun: posts the ante $0.10
Kukuryzka: posts the ante $0.10
*** HOLE CARDS ***
Dealt to matiko09 [6c Jh]
matiko09: folds 
psychmantis: folds 
ManChild9: folds 
baoyu4749892: raises $1 to $1.50
Franky77200: calls $1.50
funXmun: folds 
Kukuryzka: folds 
ardo888: folds 
*** FLOP *** [Qd Td 7h]
baoyu4749892: checks 
Franky77200: bets $2.50
baoyu4749892: calls $2.50
*** TURN *** [Qd Td 7h] [Ad]
baoyu4749892: bets $4.50
Franky77200: folds 
Uncalled bet ($4.50) returned to baoyu4749892
baoyu4749892 collected $9.07 from pot
baoyu4749892: doesn't show hand 
*** SUMMARY ***
Total pot $9.55 | Rake $0.48 
Board [Qd Td 7h Ad]
Seat 1: ardo888 (big blind) folded before Flop
Seat 2: matiko09 folded before Flop (didn't bet)
Seat 3: psychmantis folded before Flop (didn't bet)
Seat 4: ManChild9 folded before Flop (didn't bet)
Seat 5: baoyu4749892 collected ($9.07)
Seat 6: Franky77200 folded on the Turn
Seat 8: funXmun (button) folded before Flop (didn't bet)
Seat 9: Kukuryzka (small blind) folded before Flop





PokerStars Hand #155300362405:  Hold'em No Limit ($0.25/$0.50 USD) - 2016/06/28 15:49:15 CET [2016/06/28 9:49:15 ET]
Table 'Konkolya II' 9-max Seat #6 is the button
Seat 1: RvPersie ($82.58 in chips) 
Seat 2: app1e_j@ck ($50.50 in chips) 
Seat 3: Vedpapa ($50 in chips) 
Seat 5: zoofu97 ($48.50 in chips) 
Seat 6: fudzi ($99.55 in chips) 
Seat 7: CAnthonyGo ($78.97 in chips) 
Seat 8: matiko09 ($50 in chips) 
Seat 9: Xx7-Zeus-7xX ($45.78 in chips) 
CAnthonyGo: posts small blind $0.25
matiko09: posts big blind $0.50
seblafstian: sits out 
zoofu97: posts big blind $0.50
*** HOLE CARDS ***
Dealt to matiko09 [9h 7s]
Xx7-Zeus-7xX: folds 
RvPersie: folds 
app1e_j@ck: folds 
Vedpapa: folds 
zoofu97 said, "8|"
zoofu97: raises $1 to $1.50
fudzi: folds 
CAnthonyGo: folds 
matiko09: folds 
Uncalled bet ($1) returned to zoofu97
zoofu97 collected $1.25 from pot
zoofu97: doesn't show hand 
*** SUMMARY ***
Total pot $1.25 | Rake $0 
Seat 1: RvPersie folded before Flop (didn't bet)
Seat 2: app1e_j@ck folded before Flop (didn't bet)
Seat 3: Vedpapa folded before Flop (didn't bet)
Seat 5: zoofu97 collected ($1.25)
Seat 6: fudzi (button) folded before Flop (didn't bet)
Seat 7: CAnthonyGo (small blind) folded before Flop
Seat 8: matiko09 (big blind) folded before Flop
Seat 9: Xx7-Zeus-7xX folded before Flop (didn't bet)





PokerStars Hand #155300370579:  Hold'em No Limit ($0.25/$0.50 USD) - 2016/06/28 15:49:31 CET [2016/06/28 9:49:31 ET]
Table 'Kordula' 9-max Seat #6 is the button
Seat 1: Peremogec8 ($51.25 in chips) 
Seat 2: app1e_j@ck ($52.49 in chips) 
Seat 3: Kukuryzka ($49.75 in chips) 
Seat 4: badmadrabbit ($50 in chips) 
Seat 5: longway386 ($38.25 in chips) 
Seat 6: matiko09 ($50 in chips) 
Seat 7: advser ($40 in chips) 
Seat 8: ardo888 ($50 in chips) 
Seat 9: balthie ($75.98 in chips) 
advser: posts small blind $0.25
ardo888: posts big blind $0.50
*** HOLE CARDS ***
Dealt to matiko09 [Ad 6s]
balthie: raises $0.50 to $1
Peremogec8: folds 
app1e_j@ck: folds 
Kukuryzka: folds 
badmadrabbit: folds 
longway386: calls $1
matiko09: folds 
advser: folds 
ardo888: raises $4.50 to $5.50
balthie: raises $19.50 to $25
longway386: folds 
ardo888: raises $25 to $50 and is all-in
balthie: calls $25
*** FLOP *** [9c 8c 8d]
*** TURN *** [9c 8c 8d] [9s]
*** RIVER *** [9c 8c 8d 9s] [3d]
*** SHOW DOWN ***
ardo888: shows [Kh Kd] (two pair, Kings and Nines)
balthie: shows [Qs Qd] (two pair, Queens and Nines)
ardo888 collected $99.25 from pot
*** SUMMARY ***
Total pot $101.25 | Rake $2 
Board [9c 8c 8d 9s 3d]
Seat 1: Peremogec8 folded before Flop (didn't bet)
Seat 2: app1e_j@ck folded before Flop (didn't bet)
Seat 3: Kukuryzka folded before Flop (didn't bet)
Seat 4: badmadrabbit folded before Flop (didn't bet)
Seat 5: longway386 folded before Flop
Seat 6: matiko09 (button) folded before Flop (didn't bet)
Seat 7: advser (small blind) folded before Flop
Seat 8: ardo888 (big blind) showed [Kh Kd] and won ($99.25) with two pair, Kings and Nines
Seat 9: balthie showed [Qs Qd] and lost with two pair, Queens and Nines





PokerStars Hand #155300378528:  Hold'em No Limit ($0.50/$1.00 USD) - 2016/06/28 15:49:46 CET [2016/06/28 9:49:46 ET]
Table 'Lyyli II' 9-max Seat #4 is the button
Seat 1: tipner ($124.60 in chips) 
Seat 2: Rafaello18 ($152.56 in chips) 
Seat 3: Racushniak ($100 in chips) 
Seat 4: Greha999 ($111.62 in chips) 
Seat 5: flk.Dasas ($100 in chips) 
Seat 6: matiko09 ($109.52 in chips) 
Seat 7: Kukuryzka ($202.94 in chips) 
Seat 8: r4mz3s ($107.77 in chips) 
Seat 9: f1reworks ($112.80 in chips) 
flk.Dasas: posts small blind $0.50
matiko09: posts big blind $1
*** HOLE CARDS ***
Dealt to matiko09 [Qs Kc]
Kukuryzka: raises $2 to $3
r4mz3s: folds 
f1reworks: calls $3
tipner: folds 
Rafaello18: folds 
Racushniak: folds 
Greha999: calls $3
flk.Dasas: folds 
matiko09: calls $2
*** FLOP *** [Ks 9s 5c]
matiko09: bets $7
Kukuryzka: folds 
f1reworks: folds 
Greha999: folds 
Uncalled bet ($7) returned to matiko09
matiko09 collected $11.88 from pot
matiko09: doesn't show hand 
*** SUMMARY ***
Total pot $12.50 | Rake $0.62 
Board [Ks 9s 5c]
Seat 1: tipner folded before Flop (didn't bet)
Seat 2: Rafaello18 folded before Flop (didn't bet)
Seat 3: Racushniak folded before Flop (didn't bet)
Seat 4: Greha999 (button) folded on the Flop
Seat 5: flk.Dasas (small blind) folded before Flop
Seat 6: matiko09 (big blind) collected ($11.88)
Seat 7: Kukuryzka folded on the Flop
Seat 8: r4mz3s folded before Flop (didn't bet)
Seat 9: f1reworks folded on the Flop





PokerStars Hand #155300381261:  Hold'em No Limit ($0.50/$1.00 USD) - 2016/06/28 15:49:51 CET [2016/06/28 9:49:51 ET]
Table 'Kamenyar' 9-max Seat #9 is the button
Seat 1: Rafaello18 ($128.57 in chips) 
Seat 2: ozone2003 ($101.32 in chips) 
Seat 3: r4mz3s ($107.42 in chips) 
Seat 4: f1reworks ($225.91 in chips) 
Seat 5: bwly520 ($216.17 in chips) 
Seat 6: matiko09 ($100 in chips) 
Seat 7: Pokah4Living ($61.02 in chips) 
Seat 8: sanpidk ($105.38 in chips) 
Seat 9: pyromid ($95.50 in chips) 
Rafaello18: posts small blind $0.50
ozone2003: posts big blind $1
*** HOLE CARDS ***
Dealt to matiko09 [Js 4d]
r4mz3s: folds 
f1reworks: folds 
bwly520: folds 
matiko09: folds 
Pokah4Living: folds 
sanpidk: folds 
pyromid: folds 
Rafaello18: raises $1.50 to $2.50
ozone2003: raises $6.50 to $9
Rafaello18: folds 
Uncalled bet ($6.50) returned to ozone2003
ozone2003 collected $5 from pot
ozone2003: doesn't show hand 
*** SUMMARY ***
Total pot $5 | Rake $0 
Seat 1: Rafaello18 (small blind) folded before Flop
Seat 2: ozone2003 (big blind) collected ($5)
Seat 3: r4mz3s folded before Flop (didn't bet)
Seat 4: f1reworks folded before Flop (didn't bet)
Seat 5: bwly520 folded before Flop (didn't bet)
Seat 6: matiko09 folded before Flop (didn't bet)
Seat 7: Pokah4Living folded before Flop (didn't bet)
Seat 8: sanpidk folded before Flop (didn't bet)
Seat 9: pyromid (button) folded before Flop (didn't bet)





PokerStars Hand #155300389246:  Hold'em No Limit ($0.25/$0.50 USD) - 2016/06/28 15:50:06 CET [2016/06/28 9:50:06 ET]
Table 'Konkolya II' 9-max Seat #7 is the button
Seat 1: RvPersie ($82.58 in chips) 
Seat 2: app1e_j@ck ($50.50 in chips) 
Seat 3: Vedpapa ($50 in chips) 
Seat 5: zoofu97 ($49.25 in chips) 
Seat 6: fudzi ($99.55 in chips) 
Seat 7: CAnthonyGo ($78.72 in chips) 
Seat 8: matiko09 ($50 in chips) 
Seat 9: Xx7-Zeus-7xX ($45.78 in chips) 
matiko09: posts small blind $0.25
Xx7-Zeus-7xX: posts big blind $0.50
seblafstian: sits out 
*** HOLE CARDS ***
Dealt to matiko09 [4s 9d]
zoofu97 said, ":D"
RvPersie: folds 
app1e_j@ck: folds 
Vedpapa: folds 
zoofu97: raises $1 to $1.50
fudzi: folds 
CAnthonyGo: folds 
matiko09: folds 
Xx7-Zeus-7xX: folds 
Uncalled bet ($1) returned to zoofu97
zoofu97 collected $1.25 from pot
zoofu97: doesn't show hand 
*** SUMMARY ***
Total pot $1.25 | Rake $0 
Seat 1: RvPersie folded before Flop (didn't bet)
Seat 2: app1e_j@ck folded before Flop (didn't bet)
Seat 3: Vedpapa folded before Flop (didn't bet)
Seat 5: zoofu97 collected ($1.25)
Seat 6: fudzi folded before Flop (didn't bet)
Seat 7: CAnthonyGo (button) folded before Flop (didn't bet)
Seat 8: matiko09 (small blind) folded before Flop
Seat 9: Xx7-Zeus-7xX (big blind) folded before Flop





PokerStars Hand #155300391356:  Hold'em No Limit ($0.50/$1.00 USD) - 2016/06/28 15:50:11 CET [2016/06/28 9:50:11 ET]
Table 'Charybdis II' 9-max Seat #2 is the button
Seat 1: r4mz3s ($157.64 in chips) 
Seat 2: suited_doc ($97.90 in chips) 
Seat 3: Rafaello18 ($104.88 in chips) 
Seat 4: CI58 ($100 in chips) 
Seat 6: matiko09 ($121.60 in chips) 
Seat 7: ozone2003 ($120.13 in chips) 
Rafaello18: posts small blind $0.50
CI58: posts big blind $1
flk.Dasas: sits out 
r4mz3s: posts the ante $0.20
suited_doc: posts the ante $0.20
Rafaello18: posts the ante $0.20
CI58: posts the ante $0.20
matiko09: posts the ante $0.20
ozone2003: posts the ante $0.20
*** HOLE CARDS ***
Dealt to matiko09 [Jd Kd]
matiko09: raises $2 to $3
ozone2003: folds 
r4mz3s: folds 
suited_doc: folds 
Rafaello18: folds 
CI58: folds 
Uncalled bet ($2) returned to matiko09
matiko09 collected $3.70 from pot
matiko09: doesn't show hand 
*** SUMMARY ***
Total pot $3.70 | Rake $0 
Seat 1: r4mz3s folded before Flop (didn't bet)
Seat 2: suited_doc (button) folded before Flop (didn't bet)
Seat 3: Rafaello18 (small blind) folded before Flop
Seat 4: CI58 (big blind) folded before Flop
Seat 6: matiko09 collected ($3.70)
Seat 7: ozone2003 folded before Flop (didn't bet)





PokerStars Hand #155300400051:  Hold'em No Limit ($0.25/$0.50 USD) - 2016/06/28 15:50:27 CET [2016/06/28 9:50:27 ET]
Table 'Utra' 9-max Seat #9 is the button
Seat 1: ardo888 ($50 in chips) 
Seat 2: matiko09 ($95.72 in chips) 
Seat 3: psychmantis ($26.81 in chips) 
Seat 4: ManChild9 ($30.89 in chips) 
Seat 5: baoyu4749892 ($74.43 in chips) 
Seat 6: Franky77200 ($57.64 in chips) 
Seat 8: funXmun ($50 in chips) 
Seat 9: Kukuryzka ($49.65 in chips) 
ardo888: posts small blind $0.25
matiko09: posts big blind $0.50
el.suertero: sits out 
ardo888: posts the ante $0.10
matiko09: posts the ante $0.10
psychmantis: posts the ante $0.10
ManChild9: posts the ante $0.10
baoyu4749892: posts the ante $0.10
Franky77200: posts the ante $0.10
funXmun: posts the ante $0.10
Kukuryzka: posts the ante $0.10
*** HOLE CARDS ***
Dealt to matiko09 [5d Th]
psychmantis: folds 
ManChild9: folds 
baoyu4749892: folds 
Franky77200: folds 
funXmun: folds 
Kukuryzka: folds 
ardo888: raises $1 to $1.50
matiko09: folds 
Uncalled bet ($1) returned to ardo888
ardo888 collected $1.80 from pot
ardo888: doesn't show hand 
*** SUMMARY ***
Total pot $1.80 | Rake $0 
Seat 1: ardo888 (small blind) collected ($1.80)
Seat 2: matiko09 (big blind) folded before Flop
Seat 3: psychmantis folded before Flop (didn't bet)
Seat 4: ManChild9 folded before Flop (didn't bet)
Seat 5: baoyu4749892 folded before Flop (didn't bet)
Seat 6: Franky77200 folded before Flop (didn't bet)
Seat 8: funXmun folded before Flop (didn't bet)
Seat 9: Kukuryzka (button) folded before Flop (didn't bet)





PokerStars Hand #155300401140:  Hold'em No Limit ($0.50/$1.00 USD) - 2016/06/28 15:50:29 CET [2016/06/28 9:50:29 ET]
Table 'Kamenyar' 9-max Seat #1 is the button
Seat 1: Rafaello18 ($126.07 in chips) 
Seat 2: ozone2003 ($103.82 in chips) 
Seat 3: r4mz3s ($107.42 in chips) 
Seat 4: f1reworks ($225.91 in chips) 
Seat 5: bwly520 ($216.17 in chips) 
Seat 6: matiko09 ($100 in chips) 
Seat 7: Pokah4Living ($61.02 in chips) 
Seat 8: sanpidk ($105.38 in chips) 
Seat 9: pyromid ($95.50 in chips) 
ozone2003: posts small blind $0.50
r4mz3s: posts big blind $1
*** HOLE CARDS ***
Dealt to matiko09 [7s 9d]
f1reworks: folds 
bwly520: folds 
matiko09: folds 
Pokah4Living: raises $2 to $3
sanpidk: folds 
pyromid: folds 
Rafaello18: folds 
ozone2003: folds 
r4mz3s: folds 
Uncalled bet ($2) returned to Pokah4Living
Pokah4Living collected $2.50 from pot
Pokah4Living: doesn't show hand 
*** SUMMARY ***
Total pot $2.50 | Rake $0 
Seat 1: Rafaello18 (button) folded before Flop (didn't bet)
Seat 2: ozone2003 (small blind) folded before Flop
Seat 3: r4mz3s (big blind) folded before Flop
Seat 4: f1reworks folded before Flop (didn't bet)
Seat 5: bwly520 folded before Flop (didn't bet)
Seat 6: matiko09 folded before Flop (didn't bet)
Seat 7: Pokah4Living collected ($2.50)
Seat 8: sanpidk folded before Flop (didn't bet)
Seat 9: pyromid folded before Flop (didn't bet)





PokerStars Hand #155300402806:  Hold'em No Limit ($0.50/$1.00 USD) - 2016/06/28 15:50:32 CET [2016/06/28 9:50:32 ET]
Table 'Charybdis II' 9-max Seat #3 is the button
Seat 1: r4mz3s ($157.44 in chips) 
Seat 2: suited_doc ($97.70 in chips) 
Seat 3: Rafaello18 ($104.18 in chips) 
Seat 4: CI58 ($100 in chips) 
Seat 5: flk.Dasas ($100 in chips) 
Seat 6: matiko09 ($124.10 in chips) 
Seat 7: ozone2003 ($119.93 in chips) 
CI58: posts small blind $0.50
flk.Dasas: posts big blind $1
r4mz3s: posts the ante $0.20
suited_doc: posts the ante $0.20
Rafaello18: posts the ante $0.20
CI58: posts the ante $0.20
flk.Dasas: posts the ante $0.20
matiko09: posts the ante $0.20
ozone2003: posts the ante $0.20
*** HOLE CARDS ***
Dealt to matiko09 [7d Ks]
matiko09: folds 
ozone2003: folds 
r4mz3s: folds 
suited_doc: folds 
Rafaello18: folds 
CI58: calls $0.50
flk.Dasas: checks 
*** FLOP *** [5c 9d 9s]
CI58: checks 
flk.Dasas: checks 
*** TURN *** [5c 9d 9s] [6c]
CI58: bets $1.61
flk.Dasas: folds 
Uncalled bet ($1.61) returned to CI58
CI58 collected $3.23 from pot
CI58: doesn't show hand 
*** SUMMARY ***
Total pot $3.40 | Rake $0.17 
Board [5c 9d 9s 6c]
Seat 1: r4mz3s folded before Flop (didn't bet)
Seat 2: suited_doc folded before Flop (didn't bet)
Seat 3: Rafaello18 (button) folded before Flop (didn't bet)
Seat 4: CI58 (small blind) collected ($3.23)
Seat 5: flk.Dasas (big blind) folded on the Turn
Seat 6: matiko09 folded before Flop (didn't bet)
Seat 7: ozone2003 folded before Flop (didn't bet)





PokerStars Hand #155300404319:  Hold'em No Limit ($0.25/$0.50 USD) - 2016/06/28 15:50:35 CET [2016/06/28 9:50:35 ET]
Table 'Kordula' 9-max Seat #7 is the button
Seat 1: Peremogec8 ($51.25 in chips) 
Seat 2: app1e_j@ck ($52.49 in chips) 
Seat 3: Kukuryzka ($49.75 in chips) 
Seat 4: badmadrabbit ($50 in chips) 
Seat 5: longway386 ($37.25 in chips) 
Seat 6: matiko09 ($50 in chips) 
Seat 7: advser ($40 in chips) 
Seat 8: ardo888 ($99.25 in chips) 
Seat 9: balthie ($25.98 in chips) 
ardo888: posts small blind $0.25
balthie: posts big blind $0.50
*** HOLE CARDS ***
Dealt to matiko09 [Ks 4s]
Peremogec8: folds 
app1e_j@ck: folds 
Kukuryzka: folds 
badmadrabbit: folds 
longway386: folds 
matiko09: folds 
advser: folds 
ardo888: raises $1 to $1.50
balthie: raises $5.50 to $7
ardo888: folds 
Uncalled bet ($5.50) returned to balthie
balthie collected $3 from pot
*** SUMMARY ***
Total pot $3 | Rake $0 
Seat 1: Peremogec8 folded before Flop (didn't bet)
Seat 2: app1e_j@ck folded before Flop (didn't bet)
Seat 3: Kukuryzka folded before Flop (didn't bet)
Seat 4: badmadrabbit folded before Flop (didn't bet)
Seat 5: longway386 folded before Flop (didn't bet)
Seat 6: matiko09 folded before Flop (didn't bet)
Seat 7: advser (button) folded before Flop (didn't bet)
Seat 8: ardo888 (small blind) folded before Flop
Seat 9: balthie (big blind) collected ($3)





PokerStars Hand #155300404145:  Hold'em No Limit ($0.25/$0.50 USD) - 2016/06/28 15:50:35 CET [2016/06/28 9:50:35 ET]
Table 'Konkolya II' 9-max Seat #8 is the button
Seat 1: RvPersie ($82.58 in chips) 
Seat 2: app1e_j@ck ($50.50 in chips) 
Seat 3: Vedpapa ($50 in chips) 
Seat 5: zoofu97 ($50 in chips) 
Seat 6: fudzi ($99.55 in chips) 
Seat 7: CAnthonyGo ($78.72 in chips) 
Seat 8: matiko09 ($50 in chips) 
Seat 9: Xx7-Zeus-7xX ($45.28 in chips) 
Xx7-Zeus-7xX: posts small blind $0.25
RvPersie: posts big blind $0.50
seblafstian: sits out 
*** HOLE CARDS ***
Dealt to matiko09 [8s 5c]
app1e_j@ck: raises $1 to $1.50
Vedpapa: folds 
zoofu97: calls $1.50
fudzi: folds 
CAnthonyGo: folds 
matiko09: folds 
Xx7-Zeus-7xX: folds 
RvPersie: folds 
*** FLOP *** [7d 7s Tc]
app1e_j@ck: checks 
zoofu97: bets $1.50
app1e_j@ck: calls $1.50
*** TURN *** [7d 7s Tc] [Jh]
app1e_j@ck: checks 
zoofu97: bets $5
app1e_j@ck: folds 
Uncalled bet ($5) returned to zoofu97
zoofu97 collected $6.41 from pot
zoofu97: doesn't show hand 
*** SUMMARY ***
Total pot $6.75 | Rake $0.34 
Board [7d 7s Tc Jh]
Seat 1: RvPersie (big blind) folded before Flop
Seat 2: app1e_j@ck folded on the Turn
Seat 3: Vedpapa folded before Flop (didn't bet)
Seat 5: zoofu97 collected ($6.41)
Seat 6: fudzi folded before Flop (didn't bet)
Seat 7: CAnthonyGo folded before Flop (didn't bet)
Seat 8: matiko09 (button) folded before Flop (didn't bet)
Seat 9: Xx7-Zeus-7xX (small blind) folded before Flop





PokerStars Hand #155300414070:  Hold'em No Limit ($0.25/$0.50 USD) - 2016/06/28 15:50:54 CET [2016/06/28 9:50:54 ET]
Table 'Utra' 9-max Seat #1 is the button
Seat 1: ardo888 ($51.20 in chips) 
Seat 2: matiko09 ($95.12 in chips) 
Seat 3: psychmantis ($26.71 in chips) 
Seat 4: ManChild9 ($30.79 in chips) 
Seat 5: baoyu4749892 ($74.33 in chips) 
Seat 6: Franky77200 ($57.54 in chips) 
Seat 8: funXmun ($50 in chips) 
Seat 9: Kukuryzka ($49.55 in chips) 
matiko09: posts small blind $0.25
psychmantis: posts big blind $0.50
el.suertero: sits out 
ardo888: posts the ante $0.10
matiko09: posts the ante $0.10
psychmantis: posts the ante $0.10
ManChild9: posts the ante $0.10
baoyu4749892: posts the ante $0.10
Franky77200: posts the ante $0.10
funXmun: posts the ante $0.10
Kukuryzka: posts the ante $0.10
*** HOLE CARDS ***
Dealt to matiko09 [8d 2h]
ManChild9: calls $0.50
baoyu4749892: raises $0.50 to $1
Franky77200: folds 
funXmun: folds 
Kukuryzka: folds 
ardo888: folds 
matiko09: folds 
psychmantis: calls $0.50
ManChild9: calls $0.50
*** FLOP *** [8c Qc Kd]
psychmantis: checks 
ManChild9: checks 
baoyu4749892: bets $2
psychmantis: folds 
ManChild9: folds 
Uncalled bet ($2) returned to baoyu4749892
baoyu4749892 collected $3.85 from pot
baoyu4749892: doesn't show hand 
*** SUMMARY ***
Total pot $4.05 | Rake $0.20 
Board [8c Qc Kd]
Seat 1: ardo888 (button) folded before Flop (didn't bet)
Seat 2: matiko09 (small blind) folded before Flop
Seat 3: psychmantis (big blind) folded on the Flop
Seat 4: ManChild9 folded on the Flop
Seat 5: baoyu4749892 collected ($3.85)
Seat 6: Franky77200 folded before Flop (didn't bet)
Seat 8: funXmun folded before Flop (didn't bet)
Seat 9: Kukuryzka folded before Flop (didn't bet)





PokerStars Hand #155300415074:  Hold'em No Limit ($0.50/$1.00 USD) - 2016/06/28 15:50:56 CET [2016/06/28 9:50:56 ET]
Table 'Lyyli II' 9-max Seat #5 is the button
Seat 1: tipner ($124.60 in chips) 
Seat 2: Rafaello18 ($152.56 in chips) 
Seat 3: Racushniak ($100 in chips) 
Seat 4: Greha999 ($108.62 in chips) 
Seat 5: flk.Dasas ($100 in chips) 
Seat 6: matiko09 ($118.40 in chips) 
Seat 7: Kukuryzka ($199.94 in chips) 
Seat 8: r4mz3s ($107.77 in chips) 
Seat 9: f1reworks ($109.80 in chips) 
matiko09: posts small blind $0.50
Kukuryzka: posts big blind $1
*** HOLE CARDS ***
Dealt to matiko09 [9c Qc]
r4mz3s: folds 
f1reworks: folds 
tipner: raises $2 to $3
Rafaello18: raises $6 to $9
Racushniak: folds 
Greha999: folds 
flk.Dasas: folds 
matiko09: folds 
Kukuryzka: folds 
tipner: folds 
Uncalled bet ($6) returned to Rafaello18
Rafaello18 collected $7.50 from pot
Rafaello18: doesn't show hand 
*** SUMMARY ***
Total pot $7.50 | Rake $0 
Seat 1: tipner folded before Flop
Seat 2: Rafaello18 collected ($7.50)
Seat 3: Racushniak folded before Flop (didn't bet)
Seat 4: Greha999 folded before Flop (didn't bet)
Seat 5: flk.Dasas (button) folded before Flop (didn't bet)
Seat 6: matiko09 (small blind) folded before Flop
Seat 7: Kukuryzka (big blind) folded before Flop
Seat 8: r4mz3s folded before Flop (didn't bet)
Seat 9: f1reworks folded before Flop (didn't bet)





PokerStars Hand #155300419444:  Hold'em No Limit ($0.50/$1.00 USD) - 2016/06/28 15:51:04 CET [2016/06/28 9:51:04 ET]
Table 'Kamenyar' 9-max Seat #2 is the button
Seat 1: Rafaello18 ($126.07 in chips) 
Seat 2: ozone2003 ($103.32 in chips) 
Seat 3: r4mz3s ($106.42 in chips) 
Seat 4: f1reworks ($225.91 in chips) 
Seat 5: bwly520 ($216.17 in chips) 
Seat 6: matiko09 ($100 in chips) 
Seat 7: Pokah4Living ($62.52 in chips) 
Seat 8: sanpidk ($105.38 in chips) 
Seat 9: pyromid ($95.50 in chips) 
r4mz3s: posts small blind $0.50
f1reworks: posts big blind $1
*** HOLE CARDS ***
Dealt to matiko09 [6h Qc]
bwly520: raises $2 to $3
matiko09: folds 
Pokah4Living: folds 
sanpidk: folds 
pyromid: folds 
Rafaello18: folds 
ozone2003: folds 
r4mz3s: folds 
f1reworks: folds 
Uncalled bet ($2) returned to bwly520
bwly520 collected $2.50 from pot
*** SUMMARY ***
Total pot $2.50 | Rake $0 
Seat 1: Rafaello18 folded before Flop (didn't bet)
Seat 2: ozone2003 (button) folded before Flop (didn't bet)
Seat 3: r4mz3s (small blind) folded before Flop
Seat 4: f1reworks (big blind) folded before Flop
Seat 5: bwly520 collected ($2.50)
Seat 6: matiko09 folded before Flop (didn't bet)
Seat 7: Pokah4Living folded before Flop (didn't bet)
Seat 8: sanpidk folded before Flop (didn't bet)
Seat 9: pyromid folded before Flop (didn't bet)





PokerStars Hand #155300425268:  Hold'em No Limit ($0.25/$0.50 USD) - 2016/06/28 15:51:16 CET [2016/06/28 9:51:16 ET]
Table 'Kordula' 9-max Seat #8 is the button
Seat 1: Peremogec8 ($51.25 in chips) 
Seat 2: app1e_j@ck ($52.49 in chips) 
Seat 3: Kukuryzka ($49.75 in chips) 
Seat 4: badmadrabbit ($50 in chips) 
Seat 5: longway386 ($37.25 in chips) 
Seat 6: matiko09 ($50 in chips) 
Seat 7: advser ($40 in chips) 
Seat 8: ardo888 ($97.75 in chips) 
Seat 9: balthie ($27.48 in chips) 
balthie: posts small blind $0.25
Peremogec8: posts big blind $0.50
*** HOLE CARDS ***
Dealt to matiko09 [As 4d]
app1e_j@ck: folds 
Kukuryzka: folds 
badmadrabbit: folds 
longway386: folds 
matiko09: folds 
advser: folds 
ardo888: raises $0.75 to $1.25
balthie: raises $0.75 to $2
Peremogec8: folds 
ardo888: calls $0.75
*** FLOP *** [Qd 9s 7d]
balthie: checks 
ardo888: checks 
*** TURN *** [Qd 9s 7d] [8c]
balthie: bets $6
ardo888: folds 
Uncalled bet ($6) returned to balthie
balthie collected $4.28 from pot
*** SUMMARY ***
Total pot $4.50 | Rake $0.22 
Board [Qd 9s 7d 8c]
Seat 1: Peremogec8 (big blind) folded before Flop
Seat 2: app1e_j@ck folded before Flop (didn't bet)
Seat 3: Kukuryzka folded before Flop (didn't bet)
Seat 4: badmadrabbit folded before Flop (didn't bet)
Seat 5: longway386 folded before Flop (didn't bet)
Seat 6: matiko09 folded before Flop (didn't bet)
Seat 7: advser folded before Flop (didn't bet)
Seat 8: ardo888 (button) folded on the Turn
Seat 9: balthie (small blind) collected ($4.28)





PokerStars Hand #155300429283:  Hold'em No Limit ($0.50/$1.00 USD) - 2016/06/28 15:51:24 CET [2016/06/28 9:51:24 ET]
Table 'Kamenyar' 9-max Seat #3 is the button
Seat 1: Rafaello18 ($126.07 in chips) 
Seat 2: ozone2003 ($103.32 in chips) 
Seat 3: r4mz3s ($105.92 in chips) 
Seat 4: f1reworks ($224.91 in chips) 
Seat 5: bwly520 ($217.67 in chips) 
Seat 6: matiko09 ($100 in chips) 
Seat 7: Pokah4Living ($62.52 in chips) 
Seat 8: sanpidk ($105.38 in chips) 
Seat 9: pyromid ($95.50 in chips) 
f1reworks: posts small blind $0.50
bwly520: posts big blind $1
*** HOLE CARDS ***
Dealt to matiko09 [3d Kc]
matiko09: folds 
Pokah4Living: folds 
sanpidk: folds 
pyromid: raises $1.50 to $2.50
Rafaello18: calls $2.50
ozone2003: calls $2.50
r4mz3s: folds 
f1reworks: folds 
bwly520: calls $1.50
*** FLOP *** [8s 2s Td]
bwly520: checks 
pyromid is disconnected 
pyromid has timed out while disconnected
pyromid: checks 
Rafaello18: checks 
ozone2003: bets $6.49
bwly520: calls $6.49
pyromid has timed out while disconnected
pyromid: folds 
Rafaello18: folds 
*** TURN *** [8s 2s Td] [5s]
bwly520: checks 
ozone2003: bets $12.38
bwly520: raises $17.38 to $29.76
ozone2003: folds 
Uncalled bet ($17.38) returned to bwly520
bwly520 collected $45.83 from pot
*** SUMMARY ***
Total pot $48.24 | Rake $2.41 
Board [8s 2s Td 5s]
Seat 1: Rafaello18 folded on the Flop
Seat 2: ozone2003 folded on the Turn
Seat 3: r4mz3s (button) folded before Flop (didn't bet)
Seat 4: f1reworks (small blind) folded before Flop
Seat 5: bwly520 (big blind) collected ($45.83)
Seat 6: matiko09 folded before Flop (didn't bet)
Seat 7: Pokah4Living folded before Flop (didn't bet)
Seat 8: sanpidk folded before Flop (didn't bet)
Seat 9: pyromid folded on the Flop





PokerStars Hand #155300431950:  Hold'em No Limit ($0.50/$1.00 USD) - 2016/06/28 15:51:29 CET [2016/06/28 9:51:29 ET]
Table 'Charybdis II' 9-max Seat #4 is the button
Seat 1: r4mz3s ($157.24 in chips) 
Seat 2: suited_doc ($97.50 in chips) 
Seat 3: Rafaello18 ($103.98 in chips) 
Seat 4: CI58 ($102.03 in chips) 
Seat 5: flk.Dasas ($100 in chips) 
Seat 6: matiko09 ($123.90 in chips) 
Seat 7: ozone2003 ($119.73 in chips) 
flk.Dasas: posts small blind $0.50
matiko09: posts big blind $1
r4mz3s: posts the ante $0.20
suited_doc: posts the ante $0.20
Rafaello18: posts the ante $0.20
CI58: posts the ante $0.20
flk.Dasas: posts the ante $0.20
matiko09: posts the ante $0.20
ozone2003: posts the ante $0.20
*** HOLE CARDS ***
Dealt to matiko09 [2s Ks]
ozone2003: folds 
r4mz3s: folds 
suited_doc: folds 
Rafaello18: folds 
ozone2003 leaves the table
CI58: raises $1 to $2
flk.Dasas: raises $7 to $9
matiko09: folds 
CI58: folds 
Uncalled bet ($7) returned to flk.Dasas
flk.Dasas collected $6.40 from pot
flk.Dasas: doesn't show hand 
*** SUMMARY ***
Total pot $6.40 | Rake $0 
Seat 1: r4mz3s folded before Flop (didn't bet)
Seat 2: suited_doc folded before Flop (didn't bet)
Seat 3: Rafaello18 folded before Flop (didn't bet)
Seat 4: CI58 (button) folded before Flop
Seat 5: flk.Dasas (small blind) collected ($6.40)
Seat 6: matiko09 (big blind) folded before Flop
Seat 7: ozone2003 folded before Flop (didn't bet)





PokerStars Hand #155300438351:  Hold'em No Limit ($0.25/$0.50 USD) - 2016/06/28 15:51:41 CET [2016/06/28 9:51:41 ET]
Table 'Konkolya II' 9-max Seat #9 is the button
Seat 1: RvPersie ($82.08 in chips) 
Seat 2: app1e_j@ck ($50 in chips) 
Seat 3: Vedpapa ($50 in chips) 
Seat 5: zoofu97 ($53.41 in chips) 
Seat 6: fudzi ($99.55 in chips) 
Seat 7: CAnthonyGo ($78.72 in chips) 
Seat 8: matiko09 ($50 in chips) 
Seat 9: Xx7-Zeus-7xX ($45.03 in chips) 
RvPersie: posts small blind $0.25
app1e_j@ck: posts big blind $0.50
seblafstian: sits out 
*** HOLE CARDS ***
Dealt to matiko09 [As Ac]
Vedpapa: folds 
zoofu97: folds 
fudzi: folds 
CAnthonyGo: folds 
matiko09: raises $0.75 to $1.25
Xx7-Zeus-7xX: folds 
RvPersie: folds 
app1e_j@ck: folds 
Uncalled bet ($0.75) returned to matiko09
matiko09 collected $1.25 from pot
matiko09: doesn't show hand 
*** SUMMARY ***
Total pot $1.25 | Rake $0 
Seat 1: RvPersie (small blind) folded before Flop
Seat 2: app1e_j@ck (big blind) folded before Flop
Seat 3: Vedpapa folded before Flop (didn't bet)
Seat 5: zoofu97 folded before Flop (didn't bet)
Seat 6: fudzi folded before Flop (didn't bet)
Seat 7: CAnthonyGo folded before Flop (didn't bet)
Seat 8: matiko09 collected ($1.25)
Seat 9: Xx7-Zeus-7xX (button) folded before Flop (didn't bet)





PokerStars Hand #155300444364:  Hold'em No Limit ($0.25/$0.50 USD) - 2016/06/28 15:51:53 CET [2016/06/28 9:51:53 ET]
Table 'Utra' 9-max Seat #2 is the button
Seat 1: ardo888 ($51.10 in chips) 
Seat 2: matiko09 ($94.77 in chips) 
Seat 3: psychmantis ($25.61 in chips) 
Seat 4: ManChild9 ($29.69 in chips) 
Seat 5: baoyu4749892 ($77.08 in chips) 
Seat 6: Franky77200 ($57.44 in chips) 
Seat 8: funXmun ($50 in chips) 
Seat 9: Kukuryzka ($50 in chips) 
psychmantis: posts small blind $0.25
ManChild9: posts big blind $0.50
el.suertero: sits out 
ardo888: posts the ante $0.10
matiko09: posts the ante $0.10
psychmantis: posts the ante $0.10
ManChild9: posts the ante $0.10
baoyu4749892: posts the ante $0.10
Franky77200: posts the ante $0.10
funXmun: posts the ante $0.10
Kukuryzka: posts the ante $0.10
*** HOLE CARDS ***
Dealt to matiko09 [2d 9h]
baoyu4749892: raises $0.50 to $1
Franky77200: folds 
funXmun: folds 
Kukuryzka: folds 
ardo888: folds 
matiko09: folds 
psychmantis: calls $0.75
ManChild9: calls $0.50
*** FLOP *** [Kh 4h 9d]
psychmantis: checks 
ManChild9: checks 
baoyu4749892: bets $2
psychmantis: folds 
ManChild9: folds 
Uncalled bet ($2) returned to baoyu4749892
baoyu4749892 collected $3.61 from pot
baoyu4749892: doesn't show hand 
*** SUMMARY ***
Total pot $3.80 | Rake $0.19 
Board [Kh 4h 9d]
Seat 1: ardo888 folded before Flop (didn't bet)
Seat 2: matiko09 (button) folded before Flop (didn't bet)
Seat 3: psychmantis (small blind) folded on the Flop
Seat 4: ManChild9 (big blind) folded on the Flop
Seat 5: baoyu4749892 collected ($3.61)
Seat 6: Franky77200 folded before Flop (didn't bet)
Seat 8: funXmun folded before Flop (didn't bet)
Seat 9: Kukuryzka folded before Flop (didn't bet)





PokerStars Hand #155300444578:  Hold'em No Limit ($0.50/$1.00 USD) - 2016/06/28 15:51:53 CET [2016/06/28 9:51:53 ET]
Table 'Dorado II' 9-max Seat #5 is the button
Seat 2: Kukuryzka ($100 in chips) 
Seat 4: pyromid ($112 in chips) 
Seat 5: KovIFish89 ($100 in chips) 
Seat 6: ozone2003 ($173.92 in chips) 
Seat 7: matiko09 ($100 in chips) 
Seat 8: Rafaello18 ($161.83 in chips) 
Seat 9: tipner ($100 in chips) 
ozone2003: posts small blind $0.50
matiko09: posts big blind $1
f1reworks: sits out 
*** HOLE CARDS ***
Dealt to matiko09 [Jh 8c]
Rafaello18: raises $1.50 to $2.50
tipner: folds 
Kukuryzka: folds 
pyromid is disconnected 
pyromid has timed out while disconnected
pyromid: folds 
KovIFish89: folds 
ozone2003: raises $6.50 to $9
matiko09: folds 
Rafaello18: calls $6.50
*** FLOP *** [4h Js 7s]
ozone2003: checks 
Rafaello18: checks 
*** TURN *** [4h Js 7s] [4s]
ozone2003: bets $11.37
Rafaello18: calls $11.37
*** RIVER *** [4h Js 7s 4s] [5s]
ozone2003: bets $28.90
Rafaello18: folds 
Uncalled bet ($28.90) returned to ozone2003
ozone2003 collected $39.65 from pot
ozone2003: doesn't show hand 
*** SUMMARY ***
Total pot $41.74 | Rake $2.09 
Board [4h Js 7s 4s 5s]
Seat 2: Kukuryzka folded before Flop (didn't bet)
Seat 4: pyromid folded before Flop (didn't bet)
Seat 5: KovIFish89 (button) folded before Flop (didn't bet)
Seat 6: ozone2003 (small blind) collected ($39.65)
Seat 7: matiko09 (big blind) folded before Flop
Seat 8: Rafaello18 folded on the River
Seat 9: tipner folded before Flop (didn't bet)





PokerStars Hand #155300449723:  Hold'em No Limit ($0.50/$1.00 USD) - 2016/06/28 15:52:03 CET [2016/06/28 9:52:03 ET]
Table 'Lyyli II' 9-max Seat #6 is the button
Seat 1: tipner ($121.60 in chips) 
Seat 2: Rafaello18 ($157.06 in chips) 
Seat 3: Racushniak ($100 in chips) 
Seat 4: Greha999 ($108.62 in chips) 
Seat 5: flk.Dasas ($100 in chips) 
Seat 6: matiko09 ($117.90 in chips) 
Seat 7: Kukuryzka ($198.94 in chips) 
Seat 8: r4mz3s ($107.77 in chips) 
Seat 9: f1reworks ($109.80 in chips) 
Kukuryzka: posts small blind $0.50
r4mz3s: posts big blind $1
*** HOLE CARDS ***
Dealt to matiko09 [5d 6c]
f1reworks: folds 
tipner: folds 
Rafaello18: folds 
Racushniak: folds 
Greha999: raises $2 to $3
flk.Dasas: folds 
matiko09: folds 
Kukuryzka: folds 
r4mz3s: folds 
Uncalled bet ($2) returned to Greha999
Greha999 collected $2.50 from pot
*** SUMMARY ***
Total pot $2.50 | Rake $0 
Seat 1: tipner folded before Flop (didn't bet)
Seat 2: Rafaello18 folded before Flop (didn't bet)
Seat 3: Racushniak folded before Flop (didn't bet)
Seat 4: Greha999 collected ($2.50)
Seat 5: flk.Dasas folded before Flop (didn't bet)
Seat 6: matiko09 (button) folded before Flop (didn't bet)
Seat 7: Kukuryzka (small blind) folded before Flop
Seat 8: r4mz3s (big blind) folded before Flop
Seat 9: f1reworks folded before Flop (didn't bet)





PokerStars Hand #155300457089:  Hold'em No Limit ($0.50/$1.00 USD) - 2016/06/28 15:52:17 CET [2016/06/28 9:52:17 ET]
Table 'Charybdis II' 9-max Seat #5 is the button
Seat 1: r4mz3s ($157.04 in chips) 
Seat 2: suited_doc ($97.30 in chips) 
Seat 3: Rafaello18 ($103.78 in chips) 
Seat 4: CI58 ($100 in chips) 
Seat 5: flk.Dasas ($104.20 in chips) 
Seat 6: matiko09 ($122.70 in chips) 
matiko09: posts small blind $0.50
r4mz3s: posts big blind $1
r4mz3s: posts the ante $0.20
suited_doc: posts the ante $0.20
Rafaello18: posts the ante $0.20
CI58: posts the ante $0.20
flk.Dasas: posts the ante $0.20
matiko09: posts the ante $0.20
*** HOLE CARDS ***
Dealt to matiko09 [9c Ks]
suited_doc: folds 
Rafaello18: folds 
CI58: folds 
flk.Dasas: raises $2 to $3
matiko09: folds 
r4mz3s: folds 
Uncalled bet ($2) returned to flk.Dasas
flk.Dasas collected $3.70 from pot
flk.Dasas: doesn't show hand 
*** SUMMARY ***
Total pot $3.70 | Rake $0 
Seat 1: r4mz3s (big blind) folded before Flop
Seat 2: suited_doc folded before Flop (didn't bet)
Seat 3: Rafaello18 folded before Flop (didn't bet)
Seat 4: CI58 folded before Flop (didn't bet)
Seat 5: flk.Dasas (button) collected ($3.70)
Seat 6: matiko09 (small blind) folded before Flop





PokerStars Hand #155300461145:  Hold'em No Limit ($0.25/$0.50 USD) - 2016/06/28 15:52:25 CET [2016/06/28 9:52:25 ET]
Table 'Konkolya II' 9-max Seat #1 is the button
Seat 1: RvPersie ($81.83 in chips) 
Seat 2: app1e_j@ck ($50 in chips) 
Seat 3: Vedpapa ($50 in chips) 
Seat 5: zoofu97 ($53.41 in chips) 
Seat 6: fudzi ($99.55 in chips) 
Seat 7: CAnthonyGo ($78.72 in chips) 
Seat 8: matiko09 ($50.75 in chips) 
Seat 9: Xx7-Zeus-7xX ($45.03 in chips) 
app1e_j@ck: posts small blind $0.25
Vedpapa: posts big blind $0.50
seblafstian: sits out 
*** HOLE CARDS ***
Dealt to matiko09 [7s 5h]
zoofu97: folds 
fudzi: folds 
CAnthonyGo: folds 
matiko09: folds 
Xx7-Zeus-7xX: folds 
RvPersie: raises $0.75 to $1.25
app1e_j@ck: folds 
Vedpapa: folds 
Uncalled bet ($0.75) returned to RvPersie
RvPersie collected $1.25 from pot
RvPersie: doesn't show hand 
*** SUMMARY ***
Total pot $1.25 | Rake $0 
Seat 1: RvPersie (button) collected ($1.25)
Seat 2: app1e_j@ck (small blind) folded before Flop
Seat 3: Vedpapa (big blind) folded before Flop
Seat 5: zoofu97 folded before Flop (didn't bet)
Seat 6: fudzi folded before Flop (didn't bet)
Seat 7: CAnthonyGo folded before Flop (didn't bet)
Seat 8: matiko09 folded before Flop (didn't bet)
Seat 9: Xx7-Zeus-7xX folded before Flop (didn't bet)





PokerStars Hand #155300461933:  Hold'em No Limit ($0.25/$0.50 USD) - 2016/06/28 15:52:26 CET [2016/06/28 9:52:26 ET]
Table 'Utra' 9-max Seat #3 is the button
Seat 1: ardo888 ($51 in chips) 
Seat 2: matiko09 ($94.67 in chips) 
Seat 3: psychmantis ($24.51 in chips) 
Seat 4: ManChild9 ($28.59 in chips) 
Seat 5: baoyu4749892 ($79.59 in chips) 
Seat 6: Franky77200 ($57.34 in chips) 
Seat 8: funXmun ($50 in chips) 
Seat 9: Kukuryzka ($49.90 in chips) 
ManChild9: posts small blind $0.25
baoyu4749892: posts big blind $0.50
el.suertero: sits out 
ardo888: posts the ante $0.10
matiko09: posts the ante $0.10
psychmantis: posts the ante $0.10
ManChild9: posts the ante $0.10
baoyu4749892: posts the ante $0.10
Franky77200: posts the ante $0.10
funXmun: posts the ante $0.10
Kukuryzka: posts the ante $0.10
*** HOLE CARDS ***
Dealt to matiko09 [Ah 5d]
Franky77200: raises $1 to $1.50
funXmun: folds 
Kukuryzka: folds 
ardo888: folds 
matiko09: folds 
psychmantis: folds 
ManChild9: calls $1.25
baoyu4749892: folds 
*** FLOP *** [2h Qs 4d]
ManChild9: bets $2.04
Franky77200: calls $2.04
*** TURN *** [2h Qs 4d] [7c]
ManChild9: bets $3.98
Franky77200: calls $3.98
*** RIVER *** [2h Qs 4d 7c] [Ks]
ManChild9: checks 
Franky77200: bets $22.50
ManChild9: calls $20.97 and is all-in
Uncalled bet ($1.53) returned to Franky77200
*** SHOW DOWN ***
Franky77200: shows [9c Ad] (high card Ace)
ManChild9: shows [Qd Ts] (a pair of Queens)
ManChild9 collected $56.28 from pot
*** SUMMARY ***
Total pot $58.28 | Rake $2 
Board [2h Qs 4d 7c Ks]
Seat 1: ardo888 folded before Flop (didn't bet)
Seat 2: matiko09 folded before Flop (didn't bet)
Seat 3: psychmantis (button) folded before Flop (didn't bet)
Seat 4: ManChild9 (small blind) showed [Qd Ts] and won ($56.28) with a pair of Queens
Seat 5: baoyu4749892 (big blind) folded before Flop
Seat 6: Franky77200 showed [9c Ad] and lost with high card Ace
Seat 8: funXmun folded before Flop (didn't bet)
Seat 9: Kukuryzka folded before Flop (didn't bet)





PokerStars Hand #155300465772:  Hold'em No Limit ($0.25/$0.50 USD) - 2016/06/28 15:52:34 CET [2016/06/28 9:52:34 ET]
Table 'Kordula' 9-max Seat #9 is the button
Seat 1: Peremogec8 ($50.75 in chips) 
Seat 2: app1e_j@ck ($52.49 in chips) 
Seat 3: Kukuryzka ($49.75 in chips) 
Seat 4: badmadrabbit ($50 in chips) 
Seat 5: longway386 ($37.25 in chips) 
Seat 6: matiko09 ($50 in chips) 
Seat 7: advser ($40 in chips) 
Seat 8: ardo888 ($95.75 in chips) 
Seat 9: balthie ($29.76 in chips) 
Peremogec8: posts small blind $0.25
app1e_j@ck: posts big blind $0.50
*** HOLE CARDS ***
Dealt to matiko09 [7s Jh]
Kukuryzka: folds 
badmadrabbit: folds 
longway386: folds 
matiko09: folds 
advser: raises $0.75 to $1.25
ardo888: folds 
balthie: folds 
Peremogec8: folds 
app1e_j@ck: folds 
Uncalled bet ($0.75) returned to advser
advser collected $1.25 from pot
*** SUMMARY ***
Total pot $1.25 | Rake $0 
Seat 1: Peremogec8 (small blind) folded before Flop
Seat 2: app1e_j@ck (big blind) folded before Flop
Seat 3: Kukuryzka folded before Flop (didn't bet)
Seat 4: badmadrabbit folded before Flop (didn't bet)
Seat 5: longway386 folded before Flop (didn't bet)
Seat 6: matiko09 folded before Flop (didn't bet)
Seat 7: advser collected ($1.25)
Seat 8: ardo888 folded before Flop (didn't bet)
Seat 9: balthie (button) folded before Flop (didn't bet)





PokerStars Hand #155300476805:  Hold'em No Limit ($0.25/$0.50 USD) - 2016/06/28 15:52:55 CET [2016/06/28 9:52:55 ET]
Table 'Konkolya II' 9-max Seat #2 is the button
Seat 1: RvPersie ($82.58 in chips) 
Seat 2: app1e_j@ck ($50 in chips) 
Seat 3: Vedpapa ($50 in chips) 
Seat 4: seblafstian ($50 in chips) 
Seat 5: zoofu97 ($53.41 in chips) 
Seat 6: fudzi ($99.55 in chips) 
Seat 7: CAnthonyGo ($78.72 in chips) 
Seat 8: matiko09 ($50.75 in chips) 
Seat 9: Xx7-Zeus-7xX ($45.03 in chips) 
Vedpapa: posts small blind $0.25
seblafstian: posts big blind $0.50
*** HOLE CARDS ***
Dealt to matiko09 [6h 3d]
zoofu97: folds 
fudzi: raises $1 to $1.50
CAnthonyGo: calls $1.50
matiko09: folds 
Xx7-Zeus-7xX: folds 
RvPersie: calls $1.50
app1e_j@ck: folds 
Vedpapa: folds 
seblafstian: folds 
*** FLOP *** [7c 4h 2c]
fudzi: checks 
CAnthonyGo: bets $3
RvPersie: calls $3
fudzi: raises $6.99 to $9.99
CAnthonyGo: folds 
RvPersie: folds 
Uncalled bet ($6.99) returned to fudzi
CAnthonyGo leaves the table
fudzi collected $13.54 from pot
fudzi: doesn't show hand 
mixer29 joins the table at seat #7 
*** SUMMARY ***
Total pot $14.25 | Rake $0.71 
Board [7c 4h 2c]
Seat 1: RvPersie folded on the Flop
Seat 2: app1e_j@ck (button) folded before Flop (didn't bet)
Seat 3: Vedpapa (small blind) folded before Flop
Seat 4: seblafstian (big blind) folded before Flop
Seat 5: zoofu97 folded before Flop (didn't bet)
Seat 6: fudzi collected ($13.54)
Seat 7: CAnthonyGo folded on the Flop
Seat 8: matiko09 folded before Flop (didn't bet)
Seat 9: Xx7-Zeus-7xX folded before Flop (didn't bet)





PokerStars Hand #155300477313:  Hold'em No Limit ($0.50/$1.00 USD) - 2016/06/28 15:52:56 CET [2016/06/28 9:52:56 ET]
Table 'Lyyli II' 9-max Seat #7 is the button
Seat 1: tipner ($121.60 in chips) 
Seat 2: Rafaello18 ($157.06 in chips) 
Seat 3: Racushniak ($100 in chips) 
Seat 4: Greha999 ($110.12 in chips) 
Seat 5: flk.Dasas ($100 in chips) 
Seat 6: matiko09 ($117.90 in chips) 
Seat 7: Kukuryzka ($198.44 in chips) 
Seat 8: r4mz3s ($106.77 in chips) 
Seat 9: f1reworks ($109.80 in chips) 
r4mz3s: posts small blind $0.50
f1reworks: posts big blind $1
*** HOLE CARDS ***
Dealt to matiko09 [Qs 7c]
tipner: folds 
Rafaello18: folds 
Racushniak: folds 
Greha999: raises $2 to $3
flk.Dasas: raises $6 to $9
matiko09: folds 
Kukuryzka: folds 
r4mz3s: folds 
f1reworks: folds 
Greha999: folds 
Uncalled bet ($6) returned to flk.Dasas
flk.Dasas collected $7.50 from pot
flk.Dasas: doesn't show hand 
*** SUMMARY ***
Total pot $7.50 | Rake $0 
Seat 1: tipner folded before Flop (didn't bet)
Seat 2: Rafaello18 folded before Flop (didn't bet)
Seat 3: Racushniak folded before Flop (didn't bet)
Seat 4: Greha999 folded before Flop
Seat 5: flk.Dasas collected ($7.50)
Seat 6: matiko09 folded before Flop (didn't bet)
Seat 7: Kukuryzka (button) folded before Flop (didn't bet)
Seat 8: r4mz3s (small blind) folded before Flop
Seat 9: f1reworks (big blind) folded before Flop





PokerStars Hand #155300483419:  Hold'em No Limit ($0.50/$1.00 USD) - 2016/06/28 15:53:08 CET [2016/06/28 9:53:08 ET]
Table 'Charybdis II' 9-max Seat #6 is the button
Seat 1: r4mz3s ($155.84 in chips) 
Seat 2: suited_doc ($97.10 in chips) 
Seat 3: Rafaello18 ($103.58 in chips) 
Seat 4: CI58 ($100 in chips) 
Seat 5: flk.Dasas ($106.70 in chips) 
Seat 6: matiko09 ($122 in chips) 
r4mz3s: posts small blind $0.50
suited_doc: posts big blind $1
r4mz3s: posts the ante $0.20
suited_doc: posts the ante $0.20
Rafaello18: posts the ante $0.20
CI58: posts the ante $0.20
flk.Dasas: posts the ante $0.20
matiko09: posts the ante $0.20
*** HOLE CARDS ***
Dealt to matiko09 [Kc 2s]
mycka86 joins the table at seat #7 
Rafaello18: folds 
CI58: folds 
flk.Dasas: folds 
matiko09: folds 
r4mz3s: folds 
Uncalled bet ($0.50) returned to suited_doc
suited_doc collected $2.20 from pot
suited_doc: doesn't show hand 
*** SUMMARY ***
Total pot $2.20 | Rake $0 
Seat 1: r4mz3s (small blind) folded before Flop
Seat 2: suited_doc (big blind) collected ($2.20)
Seat 3: Rafaello18 folded before Flop (didn't bet)
Seat 4: CI58 folded before Flop (didn't bet)
Seat 5: flk.Dasas folded before Flop (didn't bet)
Seat 6: matiko09 (button) folded before Flop (didn't bet)





PokerStars Hand #155300484625:  Hold'em No Limit ($0.25/$0.50 USD) - 2016/06/28 15:53:10 CET [2016/06/28 9:53:10 ET]
Table 'Utra' 9-max Seat #4 is the button
Seat 1: ardo888 ($50.90 in chips) 
Seat 2: matiko09 ($94.57 in chips) 
Seat 3: psychmantis ($24.41 in chips) 
Seat 4: ManChild9 ($56.28 in chips) 
Seat 5: baoyu4749892 ($78.99 in chips) 
Seat 6: Franky77200 ($28.75 in chips) 
Seat 8: funXmun ($50 in chips) 
Seat 9: Kukuryzka ($49.80 in chips) 
baoyu4749892: posts small blind $0.25
Franky77200: posts big blind $0.50
el.suertero: sits out 
ardo888: posts the ante $0.10
matiko09: posts the ante $0.10
psychmantis: posts the ante $0.10
ManChild9: posts the ante $0.10
baoyu4749892: posts the ante $0.10
Franky77200: posts the ante $0.10
funXmun: posts the ante $0.10
Kukuryzka: posts the ante $0.10
*** HOLE CARDS ***
Dealt to matiko09 [2s Th]
funXmun: folds 
Kukuryzka: folds 
ardo888: raises $1 to $1.50
matiko09: folds 
psychmantis: folds 
ManChild9: folds 
baoyu4749892: folds 
Franky77200: calls $1
*** FLOP *** [Ah 8c 6h]
Franky77200: checks 
ardo888: checks 
*** TURN *** [Ah 8c 6h] [5d]
Franky77200: checks 
ardo888: checks 
*** RIVER *** [Ah 8c 6h 5d] [Tc]
Franky77200: checks 
ardo888: checks 
*** SHOW DOWN ***
Franky77200: shows [4c 5c] (a pair of Fives)
ardo888: shows [7d 7h] (a pair of Sevens)
ardo888 collected $3.85 from pot
*** SUMMARY ***
Total pot $4.05 | Rake $0.20 
Board [Ah 8c 6h 5d Tc]
Seat 1: ardo888 showed [7d 7h] and won ($3.85) with a pair of Sevens
Seat 2: matiko09 folded before Flop (didn't bet)
Seat 3: psychmantis folded before Flop (didn't bet)
Seat 4: ManChild9 (button) folded before Flop (didn't bet)
Seat 5: baoyu4749892 (small blind) folded before Flop
Seat 6: Franky77200 (big blind) showed [4c 5c] and lost with a pair of Fives
Seat 8: funXmun folded before Flop (didn't bet)
Seat 9: Kukuryzka folded before Flop (didn't bet)





PokerStars Hand #155300485869:  Hold'em No Limit ($0.25/$0.50 USD) - 2016/06/28 15:53:12 CET [2016/06/28 9:53:12 ET]
Table 'Kordula' 9-max Seat #1 is the button
Seat 1: Peremogec8 ($50.50 in chips) 
Seat 2: app1e_j@ck ($51.99 in chips) 
Seat 3: Kukuryzka ($49.75 in chips) 
Seat 4: badmadrabbit ($50 in chips) 
Seat 5: longway386 ($37.25 in chips) 
Seat 6: matiko09 ($50 in chips) 
Seat 7: advser ($40.75 in chips) 
Seat 8: ardo888 ($95.75 in chips) 
Seat 9: balthie ($29.76 in chips) 
app1e_j@ck: posts small blind $0.25
Kukuryzka: posts big blind $0.50
*** HOLE CARDS ***
Dealt to matiko09 [9h 4c]
badmadrabbit: folds 
longway386: folds 
matiko09: folds 
advser: folds 
ardo888: folds 
balthie: calls $0.50
Peremogec8: folds 
app1e_j@ck: calls $0.25
Kukuryzka: checks 
*** FLOP *** [Ac 9d 3d]
app1e_j@ck: bets $1.13
Kukuryzka: folds 
balthie: calls $1.13
*** TURN *** [Ac 9d 3d] [5s]
app1e_j@ck: bets $2
balthie: calls $2
*** RIVER *** [Ac 9d 3d 5s] [7c]
app1e_j@ck: checks 
balthie: bets $26.13 and is all-in
app1e_j@ck: folds 
Uncalled bet ($26.13) returned to balthie
balthie collected $7.37 from pot
*** SUMMARY ***
Total pot $7.76 | Rake $0.39 
Board [Ac 9d 3d 5s 7c]
Seat 1: Peremogec8 (button) folded before Flop (didn't bet)
Seat 2: app1e_j@ck (small blind) folded on the River
Seat 3: Kukuryzka (big blind) folded on the Flop
Seat 4: badmadrabbit folded before Flop (didn't bet)
Seat 5: longway386 folded before Flop (didn't bet)
Seat 6: matiko09 folded before Flop (didn't bet)
Seat 7: advser folded before Flop (didn't bet)
Seat 8: ardo888 folded before Flop (didn't bet)
Seat 9: balthie collected ($7.37)





PokerStars Hand #155300494719:  Hold'em No Limit ($0.50/$1.00 USD) - 2016/06/28 15:53:29 CET [2016/06/28 9:53:29 ET]
Table 'Charybdis II' 9-max Seat #1 is the button
Seat 1: r4mz3s ($155.14 in chips) 
Seat 2: suited_doc ($98.60 in chips) 
Seat 3: Rafaello18 ($103.38 in chips) 
Seat 4: CI58 ($100 in chips) 
Seat 5: flk.Dasas ($106.50 in chips) 
Seat 6: matiko09 ($121.80 in chips) 
suited_doc: posts small blind $0.50
Rafaello18: posts big blind $1
mycka86: sits out 
r4mz3s: posts the ante $0.20
suited_doc: posts the ante $0.20
Rafaello18: posts the ante $0.20
CI58: posts the ante $0.20
flk.Dasas: posts the ante $0.20
matiko09: posts the ante $0.20
*** HOLE CARDS ***
Dealt to matiko09 [Js 2d]
CI58: folds 
flk.Dasas: folds 
matiko09: folds 
r4mz3s: folds 
suited_doc: raises $2 to $3
Rafaello18: calls $2
*** FLOP *** [Ac 7c Jd]
suited_doc: bets $3
Rafaello18: calls $3
*** TURN *** [Ac 7c Jd] [5s]
suited_doc: bets $6.27
Rafaello18: folds 
Uncalled bet ($6.27) returned to suited_doc
suited_doc collected $12.54 from pot
suited_doc: doesn't show hand 
*** SUMMARY ***
Total pot $13.20 | Rake $0.66 
Board [Ac 7c Jd 5s]
Seat 1: r4mz3s (button) folded before Flop (didn't bet)
Seat 2: suited_doc (small blind) collected ($12.54)
Seat 3: Rafaello18 (big blind) folded on the Turn
Seat 4: CI58 folded before Flop (didn't bet)
Seat 5: flk.Dasas folded before Flop (didn't bet)
Seat 6: matiko09 folded before Flop (didn't bet)





PokerStars Hand #155300498237:  Hold'em No Limit ($0.50/$1.00 USD) - 2016/06/28 15:53:36 CET [2016/06/28 9:53:36 ET]
Table 'Lyyli II' 9-max Seat #8 is the button
Seat 1: tipner ($121.60 in chips) 
Seat 2: Rafaello18 ($157.06 in chips) 
Seat 3: Racushniak ($100 in chips) 
Seat 4: Greha999 ($107.12 in chips) 
Seat 5: flk.Dasas ($104.50 in chips) 
Seat 6: matiko09 ($117.90 in chips) 
Seat 7: Kukuryzka ($198.44 in chips) 
Seat 8: r4mz3s ($106.27 in chips) 
Seat 9: f1reworks ($108.80 in chips) 
f1reworks: posts small blind $0.50
tipner: posts big blind $1
*** HOLE CARDS ***
Dealt to matiko09 [3c 4c]
Rafaello18: folds 
Racushniak has timed out
Racushniak: folds 
Greha999: folds 
flk.Dasas: folds 
matiko09: folds 
Kukuryzka: folds 
r4mz3s: folds 
f1reworks: raises $2 to $3
tipner: folds 
Uncalled bet ($2) returned to f1reworks
f1reworks collected $2 from pot
f1reworks: doesn't show hand 
*** SUMMARY ***
Total pot $2 | Rake $0 
Seat 1: tipner (big blind) folded before Flop
Seat 2: Rafaello18 folded before Flop (didn't bet)
Seat 3: Racushniak folded before Flop (didn't bet)
Seat 4: Greha999 folded before Flop (didn't bet)
Seat 5: flk.Dasas folded before Flop (didn't bet)
Seat 6: matiko09 folded before Flop (didn't bet)
Seat 7: Kukuryzka folded before Flop (didn't bet)
Seat 8: r4mz3s (button) folded before Flop (didn't bet)
Seat 9: f1reworks (small blind) collected ($2)





PokerStars Hand #155300504765:  Hold'em No Limit ($0.50/$1.00 USD) - 2016/06/28 15:53:48 CET [2016/06/28 9:53:48 ET]
Table 'Dorado II' 9-max Seat #6 is the button
Seat 2: Kukuryzka ($100 in chips) 
Seat 5: KovIFish89 ($100 in chips) 
Seat 6: ozone2003 ($193.20 in chips) 
Seat 7: matiko09 ($100 in chips) 
Seat 8: Rafaello18 ($141.46 in chips) 
Seat 9: tipner ($100 in chips) 
matiko09: posts small blind $0.50
Rafaello18: posts big blind $1
f1reworks: sits out 
*** HOLE CARDS ***
Dealt to matiko09 [Th Td]
tipner: folds 
Kukuryzka: folds 
KovIFish89 has timed out
KovIFish89: folds 
ozone2003: raises $1.20 to $2.20
matiko09: raises $6.80 to $9
Rafaello18: folds 
ozone2003: raises $11 to $20
matiko09: calls $11
*** FLOP *** [5s Ks 6c]
matiko09: checks 
ozone2003: bets $19
matiko09: folds 
Uncalled bet ($19) returned to ozone2003
ozone2003 collected $38.95 from pot
ozone2003: doesn't show hand 
*** SUMMARY ***
Total pot $41 | Rake $2.05 
Board [5s Ks 6c]
Seat 2: Kukuryzka folded before Flop (didn't bet)
Seat 5: KovIFish89 folded before Flop (didn't bet)
Seat 6: ozone2003 (button) collected ($38.95)
Seat 7: matiko09 (small blind) folded on the Flop
Seat 8: Rafaello18 (big blind) folded before Flop
Seat 9: tipner folded before Flop (didn't bet)





PokerStars Hand #155300505518:  Hold'em No Limit ($0.25/$0.50 USD) - 2016/06/28 15:53:50 CET [2016/06/28 9:53:50 ET]
Table 'Utra' 9-max Seat #5 is the button
Seat 1: ardo888 ($53.15 in chips) 
Seat 2: matiko09 ($94.47 in chips) 
Seat 3: psychmantis ($24.31 in chips) 
Seat 4: ManChild9 ($56.18 in chips) 
Seat 5: baoyu4749892 ($78.64 in chips) 
Seat 6: Franky77200 ($27.15 in chips) 
Seat 7: el.suertero ($69.73 in chips) 
Seat 8: funXmun ($50 in chips) 
Seat 9: Kukuryzka ($49.70 in chips) 
Franky77200: posts small blind $0.25
el.suertero: posts big blind $0.50
ardo888: posts the ante $0.10
matiko09: posts the ante $0.10
psychmantis: posts the ante $0.10
ManChild9: posts the ante $0.10
baoyu4749892: posts the ante $0.10
Franky77200: posts the ante $0.10
el.suertero: posts the ante $0.10
funXmun: posts the ante $0.10
Kukuryzka: posts the ante $0.10
*** HOLE CARDS ***
Dealt to matiko09 [4d 2d]
funXmun: folds 
Kukuryzka: folds 
ardo888: folds 
matiko09: folds 
psychmantis: folds 
ManChild9: calls $0.50
baoyu4749892: raises $1 to $1.50
Franky77200: calls $1.25
el.suertero: calls $1
ManChild9: calls $1
*** FLOP *** [8s Ks 8c]
Franky77200: checks 
el.suertero: checks 
ManChild9: checks 
baoyu4749892: bets $3.50
Franky77200: folds 
el.suertero: folds 
ManChild9: folds 
Uncalled bet ($3.50) returned to baoyu4749892
baoyu4749892 collected $6.56 from pot
baoyu4749892: doesn't show hand 
*** SUMMARY ***
Total pot $6.90 | Rake $0.34 
Board [8s Ks 8c]
Seat 1: ardo888 folded before Flop (didn't bet)
Seat 2: matiko09 folded before Flop (didn't bet)
Seat 3: psychmantis folded before Flop (didn't bet)
Seat 4: ManChild9 folded on the Flop
Seat 5: baoyu4749892 (button) collected ($6.56)
Seat 6: Franky77200 (small blind) folded on the Flop
Seat 7: el.suertero (big blind) folded on the Flop
Seat 8: funXmun folded before Flop (didn't bet)
Seat 9: Kukuryzka folded before Flop (didn't bet)





PokerStars Hand #155300514994:  Hold'em No Limit ($0.50/$1.00 USD) - 2016/06/28 15:54:08 CET [2016/06/28 9:54:08 ET]
Table 'Charybdis II' 9-max Seat #2 is the button
Seat 1: r4mz3s ($154.94 in chips) 
Seat 2: suited_doc ($104.94 in chips) 
Seat 3: Rafaello18 ($100 in chips) 
Seat 4: CI58 ($100 in chips) 
Seat 5: flk.Dasas ($106.30 in chips) 
Seat 6: matiko09 ($121.60 in chips) 
Rafaello18: posts small blind $0.50
CI58: posts big blind $1
mycka86: sits out 
r4mz3s: posts the ante $0.20
suited_doc: posts the ante $0.20
Rafaello18: posts the ante $0.20
CI58: posts the ante $0.20
flk.Dasas: posts the ante $0.20
matiko09: posts the ante $0.20
*** HOLE CARDS ***
Dealt to matiko09 [6d 4c]
flk.Dasas: folds 
matiko09: folds 
r4mz3s: raises $1.55 to $2.55
suited_doc: calls $2.55
Rafaello18: folds 
CI58: folds 
*** FLOP *** [Th 2s Td]
r4mz3s: bets $4.50
suited_doc: folds 
Uncalled bet ($4.50) returned to r4mz3s
r4mz3s collected $7.41 from pot
r4mz3s: doesn't show hand 
*** SUMMARY ***
Total pot $7.80 | Rake $0.39 
Board [Th 2s Td]
Seat 1: r4mz3s collected ($7.41)
Seat 2: suited_doc (button) folded on the Flop
Seat 3: Rafaello18 (small blind) folded before Flop
Seat 4: CI58 (big blind) folded before Flop
Seat 5: flk.Dasas folded before Flop (didn't bet)
Seat 6: matiko09 folded before Flop (didn't bet)





PokerStars Hand #155300518243:  Hold'em No Limit ($0.25/$0.50 USD) - 2016/06/28 15:54:14 CET [2016/06/28 9:54:14 ET]
Table 'Konkolya II' 9-max Seat #3 is the button
Seat 1: RvPersie ($78.08 in chips) 
Seat 2: app1e_j@ck ($50 in chips) 
Seat 3: Vedpapa ($50 in chips) 
Seat 4: seblafstian ($50 in chips) 
Seat 5: zoofu97 ($53.41 in chips) 
Seat 6: fudzi ($108.59 in chips) 
Seat 8: matiko09 ($50.75 in chips) 
Seat 9: Xx7-Zeus-7xX ($45.03 in chips) 
seblafstian: posts small blind $0.25
zoofu97: posts big blind $0.50
mixer29: sits out 
*** HOLE CARDS ***
Dealt to matiko09 [Ks 5s]
fudzi: folds 
matiko09: folds 
Xx7-Zeus-7xX: raises $1 to $1.50
RvPersie: folds 
app1e_j@ck: folds 
Vedpapa: folds 
seblafstian: folds 
zoofu97: folds 
Uncalled bet ($1) returned to Xx7-Zeus-7xX
Xx7-Zeus-7xX collected $1.25 from pot
Xx7-Zeus-7xX: doesn't show hand 
*** SUMMARY ***
Total pot $1.25 | Rake $0 
Seat 1: RvPersie folded before Flop (didn't bet)
Seat 2: app1e_j@ck folded before Flop (didn't bet)
Seat 3: Vedpapa (button) folded before Flop (didn't bet)
Seat 4: seblafstian (small blind) folded before Flop
Seat 5: zoofu97 (big blind) folded before Flop
Seat 6: fudzi folded before Flop (didn't bet)
Seat 8: matiko09 folded before Flop (didn't bet)
Seat 9: Xx7-Zeus-7xX collected ($1.25)





PokerStars Hand #155300521879:  Hold'em No Limit ($0.50/$1.00 USD) - 2016/06/28 15:54:21 CET [2016/06/28 9:54:21 ET]
Table 'Lyyli II' 9-max Seat #9 is the button
Seat 1: tipner ($120.60 in chips) 
Seat 2: Rafaello18 ($157.06 in chips) 
Seat 4: Greha999 ($107.12 in chips) 
Seat 5: flk.Dasas ($104.50 in chips) 
Seat 6: matiko09 ($117.90 in chips) 
Seat 7: Kukuryzka ($198.44 in chips) 
Seat 8: r4mz3s ($106.27 in chips) 
Seat 9: f1reworks ($109.80 in chips) 
tipner: posts small blind $0.50
Rafaello18: posts big blind $1
*** HOLE CARDS ***
Dealt to matiko09 [Ah 8h]
Greha999: folds 
flk.Dasas: folds 
matiko09: folds 
Kukuryzka: folds 
r4mz3s: folds 
f1reworks: folds 
tipner: folds 
Uncalled bet ($0.50) returned to Rafaello18
Rafaello18 collected $1 from pot
Rafaello18: doesn't show hand 
*** SUMMARY ***
Total pot $1 | Rake $0 
Seat 1: tipner (small blind) folded before Flop
Seat 2: Rafaello18 (big blind) collected ($1)
Seat 4: Greha999 folded before Flop (didn't bet)
Seat 5: flk.Dasas folded before Flop (didn't bet)
Seat 6: matiko09 folded before Flop (didn't bet)
Seat 7: Kukuryzka folded before Flop (didn't bet)
Seat 8: r4mz3s folded before Flop (didn't bet)
Seat 9: f1reworks (button) folded before Flop (didn't bet)





PokerStars Hand #155300525022:  Hold'em No Limit ($0.25/$0.50 USD) - 2016/06/28 15:54:27 CET [2016/06/28 9:54:27 ET]
Table 'Kordula' 9-max Seat #2 is the button
Seat 1: Peremogec8 ($50.50 in chips) 
Seat 2: app1e_j@ck ($50 in chips) 
Seat 3: Kukuryzka ($50 in chips) 
Seat 4: badmadrabbit ($50 in chips) 
Seat 5: longway386 ($37.25 in chips) 
Seat 6: matiko09 ($50 in chips) 
Seat 7: advser ($40.75 in chips) 
Seat 8: ardo888 ($95.75 in chips) 
Seat 9: balthie ($33.50 in chips) 
Kukuryzka: posts small blind $0.25
badmadrabbit: posts big blind $0.50
*** HOLE CARDS ***
Dealt to matiko09 [8d 6c]
longway386: folds 
matiko09: folds 
advser: folds 
ardo888: folds 
balthie: calls $0.50
Peremogec8: folds 
app1e_j@ck: raises $1.50 to $2
Kukuryzka: folds 
badmadrabbit: folds 
balthie: raises $1.50 to $3.50
app1e_j@ck: folds 
Uncalled bet ($1.50) returned to balthie
balthie collected $4.75 from pot
*** SUMMARY ***
Total pot $4.75 | Rake $0 
Seat 1: Peremogec8 folded before Flop (didn't bet)
Seat 2: app1e_j@ck (button) folded before Flop
Seat 3: Kukuryzka (small blind) folded before Flop
Seat 4: badmadrabbit (big blind) folded before Flop
Seat 5: longway386 folded before Flop (didn't bet)
Seat 6: matiko09 folded before Flop (didn't bet)
Seat 7: advser folded before Flop (didn't bet)
Seat 8: ardo888 folded before Flop (didn't bet)
Seat 9: balthie collected ($4.75)





PokerStars Hand #155300531355:  Hold'em No Limit ($0.50/$1.00 USD) - 2016/06/28 15:54:39 CET [2016/06/28 9:54:39 ET]
Table 'Lyyli II' 9-max Seat #1 is the button
Seat 1: tipner ($120.10 in chips) 
Seat 2: Rafaello18 ($157.56 in chips) 
Seat 4: Greha999 ($107.12 in chips) 
Seat 5: flk.Dasas ($104.50 in chips) 
Seat 6: matiko09 ($117.90 in chips) 
Seat 7: Kukuryzka ($198.44 in chips) 
Seat 8: r4mz3s ($106.27 in chips) 
Seat 9: f1reworks ($109.80 in chips) 
Rafaello18: posts small blind $0.50
Greha999: posts big blind $1
*** HOLE CARDS ***
Dealt to matiko09 [6c 8d]
flk.Dasas: folds 
matiko09: folds 
Kukuryzka: folds 
r4mz3s: raises $1.55 to $2.55
f1reworks: folds 
tipner: folds 
Rafaello18: folds 
Greha999: folds 
Uncalled bet ($1.55) returned to r4mz3s
r4mz3s collected $2.50 from pot
r4mz3s: doesn't show hand 
*** SUMMARY ***
Total pot $2.50 | Rake $0 
Seat 1: tipner (button) folded before Flop (didn't bet)
Seat 2: Rafaello18 (small blind) folded before Flop
Seat 4: Greha999 (big blind) folded before Flop
Seat 5: flk.Dasas folded before Flop (didn't bet)
Seat 6: matiko09 folded before Flop (didn't bet)
Seat 7: Kukuryzka folded before Flop (didn't bet)
Seat 8: r4mz3s collected ($2.50)
Seat 9: f1reworks folded before Flop (didn't bet)





PokerStars Hand #155300536300:  Hold'em No Limit ($0.25/$0.50 USD) - 2016/06/28 15:54:48 CET [2016/06/28 9:54:48 ET]
Table 'Utra' 9-max Seat #6 is the button
Seat 1: ardo888 ($53.05 in chips) 
Seat 2: matiko09 ($94.37 in chips) 
Seat 3: psychmantis ($24.21 in chips) 
Seat 4: ManChild9 ($54.58 in chips) 
Seat 5: baoyu4749892 ($83.60 in chips) 
Seat 6: Franky77200 ($25.55 in chips) 
Seat 7: el.suertero ($68.13 in chips) 
Seat 8: funXmun ($50 in chips) 
Seat 9: Kukuryzka ($49.60 in chips) 
el.suertero: posts small blind $0.25
funXmun: posts big blind $0.50
ardo888: posts the ante $0.10
matiko09: posts the ante $0.10
psychmantis: posts the ante $0.10
ManChild9: posts the ante $0.10
baoyu4749892: posts the ante $0.10
Franky77200: posts the ante $0.10
el.suertero: posts the ante $0.10
funXmun: posts the ante $0.10
Kukuryzka: posts the ante $0.10
*** HOLE CARDS ***
Dealt to matiko09 [Ts 3d]
Kukuryzka: folds 
ardo888: folds 
matiko09: folds 
psychmantis: folds 
ManChild9: folds 
baoyu4749892: folds 
Franky77200: folds 
el.suertero: folds 
Uncalled bet ($0.25) returned to funXmun
funXmun collected $1.40 from pot
funXmun: doesn't show hand 
*** SUMMARY ***
Total pot $1.40 | Rake $0 
Seat 1: ardo888 folded before Flop (didn't bet)
Seat 2: matiko09 folded before Flop (didn't bet)
Seat 3: psychmantis folded before Flop (didn't bet)
Seat 4: ManChild9 folded before Flop (didn't bet)
Seat 5: baoyu4749892 folded before Flop (didn't bet)
Seat 6: Franky77200 (button) folded before Flop (didn't bet)
Seat 7: el.suertero (small blind) folded before Flop
Seat 8: funXmun (big blind) collected ($1.40)
Seat 9: Kukuryzka folded before Flop (didn't bet)





PokerStars Hand #155300539756:  Hold'em No Limit ($0.50/$1.00 USD) - 2016/06/28 15:54:55 CET [2016/06/28 9:54:55 ET]
Table 'Charybdis II' 9-max Seat #3 is the button
Seat 1: r4mz3s ($159.60 in chips) 
Seat 2: suited_doc ($102.19 in chips) 
Seat 3: Rafaello18 ($100 in chips) 
Seat 4: CI58 ($100 in chips) 
Seat 5: flk.Dasas ($106.10 in chips) 
Seat 6: matiko09 ($121.40 in chips) 
CI58: posts small blind $0.50
flk.Dasas: posts big blind $1
mycka86: sits out 
r4mz3s: posts the ante $0.20
suited_doc: posts the ante $0.20
Rafaello18: posts the ante $0.20
CI58: posts the ante $0.20
flk.Dasas: posts the ante $0.20
matiko09: posts the ante $0.20
*** HOLE CARDS ***
Dealt to matiko09 [Kh 3s]
matiko09: folds 
r4mz3s: folds 
suited_doc: calls $1
Rafaello18: raises $3 to $4
CI58: folds 
flk.Dasas: folds 
suited_doc: calls $3
*** FLOP *** [4c As Jh]
suited_doc: checks 
Rafaello18: bets $3.35
ardo888 joins the table at seat #8 
suited_doc: calls $3.35
*** TURN *** [4c As Jh] [3h]
suited_doc: bets $8.26
Rafaello18: folds 
Uncalled bet ($8.26) returned to suited_doc
suited_doc collected $16.53 from pot
suited_doc: doesn't show hand 
*** SUMMARY ***
Total pot $17.40 | Rake $0.87 
Board [4c As Jh 3h]
Seat 1: r4mz3s folded before Flop (didn't bet)
Seat 2: suited_doc collected ($16.53)
Seat 3: Rafaello18 (button) folded on the Turn
Seat 4: CI58 (small blind) folded before Flop
Seat 5: flk.Dasas (big blind) folded before Flop
Seat 6: matiko09 folded before Flop (didn't bet)





PokerStars Hand #155300550139:  Hold'em No Limit ($0.50/$1.00 USD) - 2016/06/28 15:54:56 CET [2016/06/28 9:54:56 ET]
Table 'Dorado II' 9-max Seat #7 is the button
Seat 2: Kukuryzka ($100 in chips) 
Seat 5: KovIFish89 ($100 in chips) 
Seat 6: ozone2003 ($212.15 in chips) 
Seat 7: matiko09 ($100 in chips) 
Seat 8: Rafaello18 ($140.46 in chips) 
Seat 9: tipner ($100 in chips) 
Rafaello18: posts small blind $0.50
tipner: posts big blind $1
f1reworks: sits out 
*** HOLE CARDS ***
Dealt to matiko09 [3h 2h]
Kukuryzka: folds 
KovIFish89: raises $2 to $3
ozone2003: folds 
matiko09: folds 
Rafaello18: folds 
tipner: folds 
Uncalled bet ($2) returned to KovIFish89
KovIFish89 collected $2.50 from pot
KovIFish89: doesn't show hand 
*** SUMMARY ***
Total pot $2.50 | Rake $0 
Seat 2: Kukuryzka folded before Flop (didn't bet)
Seat 5: KovIFish89 collected ($2.50)
Seat 6: ozone2003 folded before Flop (didn't bet)
Seat 7: matiko09 (button) folded before Flop (didn't bet)
Seat 8: Rafaello18 (small blind) folded before Flop
Seat 9: tipner (big blind) folded before Flop





PokerStars Hand #155300556513:  Hold'em No Limit ($0.50/$1.00 USD) - 2016/06/28 15:55:08 CET [2016/06/28 9:55:08 ET]
Table 'Lyyli II' 9-max Seat #2 is the button
Seat 1: tipner ($120.10 in chips) 
Seat 2: Rafaello18 ($157.06 in chips) 
Seat 4: Greha999 ($106.12 in chips) 
Seat 5: flk.Dasas ($104.50 in chips) 
Seat 6: matiko09 ($117.90 in chips) 
Seat 7: Kukuryzka ($198.44 in chips) 
Seat 8: r4mz3s ($107.77 in chips) 
Seat 9: f1reworks ($109.80 in chips) 
Greha999: posts small blind $0.50
flk.Dasas: posts big blind $1
*** HOLE CARDS ***
Dealt to matiko09 [3d 8h]
matiko09: folds 
Kukuryzka: raises $2 to $3
r4mz3s: folds 
f1reworks: folds 
tipner: calls $3
Rafaello18: folds 
Greha999: folds 
flk.Dasas: folds 
*** FLOP *** [5s 9c As]
Kukuryzka: bets $3.56
tipner: raises $8.44 to $12
Kukuryzka: calls $8.44
*** TURN *** [5s 9c As] [Ah]
Kukuryzka: checks 
tipner: checks 
*** RIVER *** [5s 9c As Ah] [7d]
Kukuryzka: bets $14.96
tipner: folds 
Uncalled bet ($14.96) returned to Kukuryzka
Kukuryzka collected $29.92 from pot
Kukuryzka: doesn't show hand 
*** SUMMARY ***
Total pot $31.50 | Rake $1.58 
Board [5s 9c As Ah 7d]
Seat 1: tipner folded on the River
Seat 2: Rafaello18 (button) folded before Flop (didn't bet)
Seat 4: Greha999 (small blind) folded before Flop
Seat 5: flk.Dasas (big blind) folded before Flop
Seat 6: matiko09 folded before Flop (didn't bet)
Seat 7: Kukuryzka collected ($29.92)
Seat 8: r4mz3s folded before Flop (didn't bet)
Seat 9: f1reworks folded before Flop (didn't bet)





PokerStars Hand #155300561162:  Hold'em No Limit ($0.25/$0.50 USD) - 2016/06/28 15:55:18 CET [2016/06/28 9:55:18 ET]
Table 'Utra' 9-max Seat #7 is the button
Seat 1: ardo888 ($52.95 in chips) 
Seat 2: matiko09 ($94.27 in chips) 
Seat 3: psychmantis ($24.11 in chips) 
Seat 4: ManChild9 ($54.48 in chips) 
Seat 5: baoyu4749892 ($83.50 in chips) 
Seat 6: Franky77200 ($25.45 in chips) 
Seat 7: el.suertero ($67.78 in chips) 
Seat 8: funXmun ($51.05 in chips) 
Seat 9: Kukuryzka ($49.50 in chips) 
funXmun: posts small blind $0.25
Kukuryzka: posts big blind $0.50
ardo888: posts the ante $0.10
matiko09: posts the ante $0.10
psychmantis: posts the ante $0.10
ManChild9: posts the ante $0.10
baoyu4749892: posts the ante $0.10
Franky77200: posts the ante $0.10
el.suertero: posts the ante $0.10
funXmun: posts the ante $0.10
Kukuryzka: posts the ante $0.10
*** HOLE CARDS ***
Dealt to matiko09 [3s 6c]
ardo888: folds 
matiko09: folds 
psychmantis: raises $1 to $1.50
ManChild9: folds 
baoyu4749892: calls $1.50
Franky77200: folds 
el.suertero: folds 
funXmun: folds 
Kukuryzka: folds 
*** FLOP *** [3d Jc Ts]
psychmantis: bets $2.21
baoyu4749892: calls $2.21
*** TURN *** [3d Jc Ts] [Kc]
psychmantis: checks 
baoyu4749892: bets $4.50
psychmantis: calls $4.50
*** RIVER *** [3d Jc Ts Kc] [Ah]
psychmantis: bets $8.58
baoyu4749892: calls $8.58
*** SHOW DOWN ***
psychmantis: shows [Jh Qs] (a straight, Ten to Ace)
baoyu4749892: mucks hand 
psychmantis collected $33.47 from pot
*** SUMMARY ***
Total pot $35.23 | Rake $1.76 
Board [3d Jc Ts Kc Ah]
Seat 1: ardo888 folded before Flop (didn't bet)
Seat 2: matiko09 folded before Flop (didn't bet)
Seat 3: psychmantis showed [Jh Qs] and won ($33.47) with a straight, Ten to Ace
Seat 4: ManChild9 folded before Flop (didn't bet)
Seat 5: baoyu4749892 mucked [As Kd]
Seat 6: Franky77200 folded before Flop (didn't bet)
Seat 7: el.suertero (button) folded before Flop (didn't bet)
Seat 8: funXmun (small blind) folded before Flop
Seat 9: Kukuryzka (big blind) folded before Flop





PokerStars Hand #155300562167:  Hold'em No Limit ($0.25/$0.50 USD) - 2016/06/28 15:55:20 CET [2016/06/28 9:55:20 ET]
Table 'Kordula' 9-max Seat #3 is the button
Seat 1: Peremogec8 ($50.50 in chips) 
Seat 2: app1e_j@ck ($50 in chips) 
Seat 3: Kukuryzka ($49.75 in chips) 
Seat 4: badmadrabbit ($50 in chips) 
Seat 5: longway386 ($37.25 in chips) 
Seat 6: matiko09 ($50 in chips) 
Seat 7: advser ($40.75 in chips) 
Seat 8: ardo888 ($95.75 in chips) 
Seat 9: balthie ($36.25 in chips) 
badmadrabbit: posts small blind $0.25
longway386: posts big blind $0.50
*** HOLE CARDS ***
Dealt to matiko09 [Qd 3h]
matiko09: folds 
advser: folds 
ardo888: folds 
balthie: calls $0.50
Peremogec8: folds 
app1e_j@ck: raises $1.50 to $2
Kukuryzka: folds 
badmadrabbit: folds 
longway386: folds 
balthie: calls $1.50
*** FLOP *** [8s 7c 7s]
balthie: checks 
app1e_j@ck: checks 
*** TURN *** [8s 7c 7s] [Jc]
balthie: bets $5.50
app1e_j@ck: folds 
Uncalled bet ($5.50) returned to balthie
balthie collected $4.51 from pot
*** SUMMARY ***
Total pot $4.75 | Rake $0.24 
Board [8s 7c 7s Jc]
Seat 1: Peremogec8 folded before Flop (didn't bet)
Seat 2: app1e_j@ck folded on the Turn
Seat 3: Kukuryzka (button) folded before Flop (didn't bet)
Seat 4: badmadrabbit (small blind) folded before Flop
Seat 5: longway386 (big blind) folded before Flop
Seat 6: matiko09 folded before Flop (didn't bet)
Seat 7: advser folded before Flop (didn't bet)
Seat 8: ardo888 folded before Flop (didn't bet)
Seat 9: balthie collected ($4.51)





PokerStars Hand #155300562563:  Hold'em No Limit ($0.25/$0.50 USD) - 2016/06/28 15:55:21 CET [2016/06/28 9:55:21 ET]
Table 'Konkolya II' 9-max Seat #4 is the button
Seat 1: RvPersie ($78.08 in chips) 
Seat 2: app1e_j@ck ($50 in chips) 
Seat 3: Vedpapa ($50 in chips) 
Seat 4: seblafstian ($50 in chips) 
Seat 5: zoofu97 ($52.91 in chips) 
Seat 6: fudzi ($108.59 in chips) 
Seat 8: matiko09 ($50.75 in chips) 
Seat 9: Xx7-Zeus-7xX ($45.78 in chips) 
zoofu97: posts small blind $0.25
fudzi: posts big blind $0.50
mixer29: sits out 
*** HOLE CARDS ***
Dealt to matiko09 [Kc Qc]
matiko09: raises $1 to $1.50
Xx7-Zeus-7xX: folds 
RvPersie: folds 
app1e_j@ck: folds 
Vedpapa: folds 
seblafstian: folds 
zoofu97: folds 
fudzi: folds 
Uncalled bet ($1) returned to matiko09
matiko09 collected $1.25 from pot
matiko09: doesn't show hand 
*** SUMMARY ***
Total pot $1.25 | Rake $0 
Seat 1: RvPersie folded before Flop (didn't bet)
Seat 2: app1e_j@ck folded before Flop (didn't bet)
Seat 3: Vedpapa folded before Flop (didn't bet)
Seat 4: seblafstian (button) folded before Flop (didn't bet)
Seat 5: zoofu97 (small blind) folded before Flop
Seat 6: fudzi (big blind) folded before Flop
Seat 8: matiko09 collected ($1.25)
Seat 9: Xx7-Zeus-7xX folded before Flop (didn't bet)





PokerStars Hand #155300563657:  Hold'em No Limit ($0.50/$1.00 USD) - 2016/06/28 15:55:23 CET [2016/06/28 9:55:23 ET]
Table 'Kamenyar' 9-max Seat #4 is the button
Seat 1: Rafaello18 ($123.57 in chips) 
Seat 2: ozone2003 ($100 in chips) 
Seat 3: r4mz3s ($105.92 in chips) 
Seat 4: f1reworks ($224.41 in chips) 
Seat 5: bwly520 ($242.13 in chips) 
Seat 6: matiko09 ($100 in chips) 
Seat 7: Pokah4Living ($62.52 in chips) 
Seat 8: sanpidk ($105.38 in chips) 
bwly520: posts small blind $0.50
matiko09: posts big blind $1
*** HOLE CARDS ***
Dealt to matiko09 [Qd 9h]
Pokah4Living: folds 
sanpidk: folds 
Rafaello18: folds 
ozone2003: folds 
r4mz3s: folds 
f1reworks: folds 
bwly520: raises $2 to $3
matiko09: calls $2
*** FLOP *** [Qs 8c 9d]
bwly520: bets $4
matiko09: calls $4
*** TURN *** [Qs 8c 9d] [Jc]
bwly520: bets $7.50
matiko09: calls $7.50
*** RIVER *** [Qs 8c 9d Jc] [4h]
bwly520: bets $16
matiko09: folds 
Uncalled bet ($16) returned to bwly520
bwly520 collected $27.55 from pot
*** SUMMARY ***
Total pot $29 | Rake $1.45 
Board [Qs 8c 9d Jc 4h]
Seat 1: Rafaello18 folded before Flop (didn't bet)
Seat 2: ozone2003 folded before Flop (didn't bet)
Seat 3: r4mz3s folded before Flop (didn't bet)
Seat 4: f1reworks (button) folded before Flop (didn't bet)
Seat 5: bwly520 (small blind) collected ($27.55)
Seat 6: matiko09 (big blind) folded on the River
Seat 7: Pokah4Living folded before Flop (didn't bet)
Seat 8: sanpidk folded before Flop (didn't bet)





PokerStars Hand #155300566508:  Hold'em No Limit ($0.50/$1.00 USD) - 2016/06/28 15:55:30 CET [2016/06/28 9:55:30 ET]
Table 'Dorado II' 9-max Seat #8 is the button
Seat 1: f1reworks ($118.52 in chips) 
Seat 2: Kukuryzka ($100 in chips) 
Seat 5: KovIFish89 ($101.50 in chips) 
Seat 6: ozone2003 ($212.15 in chips) 
Seat 7: matiko09 ($100 in chips) 
Seat 8: Rafaello18 ($139.96 in chips) 
Seat 9: tipner ($100 in chips) 
tipner: posts small blind $0.50
f1reworks: posts big blind $1
*** HOLE CARDS ***
Dealt to matiko09 [Kd Ah]
Kukuryzka: folds 
KovIFish89: raises $2 to $3
ozone2003: folds 
matiko09: raises $7 to $10
Rafaello18: folds 
tipner: folds 
f1reworks: folds 
KovIFish89: folds 
Uncalled bet ($7) returned to matiko09
matiko09 collected $7.50 from pot
matiko09: doesn't show hand 
*** SUMMARY ***
Total pot $7.50 | Rake $0 
Seat 1: f1reworks (big blind) folded before Flop
Seat 2: Kukuryzka folded before Flop (didn't bet)
Seat 5: KovIFish89 folded before Flop
Seat 6: ozone2003 folded before Flop (didn't bet)
Seat 7: matiko09 collected ($7.50)
Seat 8: Rafaello18 (button) folded before Flop (didn't bet)
Seat 9: tipner (small blind) folded before Flop





PokerStars Hand #155300573317:  Hold'em No Limit ($0.50/$1.00 USD) - 2016/06/28 15:55:45 CET [2016/06/28 9:55:45 ET]
Table 'Charybdis II' 9-max Seat #4 is the button
Seat 1: r4mz3s ($159.40 in chips) 
Seat 2: suited_doc ($111.17 in chips) 
Seat 3: Rafaello18 ($100 in chips) 
Seat 4: CI58 ($100 in chips) 
Seat 5: flk.Dasas ($104.90 in chips) 
Seat 6: matiko09 ($121.20 in chips) 
flk.Dasas: posts small blind $0.50
matiko09: posts big blind $1
mycka86: sits out 
ardo888: sits out 
r4mz3s: posts the ante $0.20
suited_doc: posts the ante $0.20
Rafaello18: posts the ante $0.20
CI58: posts the ante $0.20
flk.Dasas: posts the ante $0.20
matiko09: posts the ante $0.20
*** HOLE CARDS ***
Dealt to matiko09 [3h 7c]
r4mz3s: folds 
suited_doc: folds 
Rafaello18: folds 
CI58: raises $1 to $2
JKVSAK85 joins the table at seat #9 
flk.Dasas: raises $7 to $9
matiko09: folds 
CI58: folds 
Uncalled bet ($7) returned to flk.Dasas
flk.Dasas collected $6.20 from pot
flk.Dasas: doesn't show hand 
*** SUMMARY ***
Total pot $6.20 | Rake $0 
Seat 1: r4mz3s folded before Flop (didn't bet)
Seat 2: suited_doc folded before Flop (didn't bet)
Seat 3: Rafaello18 folded before Flop (didn't bet)
Seat 4: CI58 (button) folded before Flop
Seat 5: flk.Dasas (small blind) collected ($6.20)
Seat 6: matiko09 (big blind) folded before Flop





PokerStars Hand #155300582303:  Hold'em No Limit ($0.25/$0.50 USD) - 2016/06/28 15:56:05 CET [2016/06/28 9:56:05 ET]
Table 'Kordula' 9-max Seat #4 is the button
Seat 1: Peremogec8 ($50.50 in chips) 
Seat 2: app1e_j@ck ($50 in chips) 
Seat 3: Kukuryzka ($49.75 in chips) 
Seat 4: badmadrabbit ($50 in chips) 
Seat 5: longway386 ($36.75 in chips) 
Seat 6: matiko09 ($50 in chips) 
Seat 7: advser ($40.75 in chips) 
Seat 8: ardo888 ($95.75 in chips) 
Seat 9: balthie ($38.76 in chips) 
longway386: posts small blind $0.25
matiko09: posts big blind $0.50
*** HOLE CARDS ***
Dealt to matiko09 [2d 3d]
advser: folds 
ardo888: folds 
balthie: raises $0.50 to $1
Peremogec8: raises $2.50 to $3.50
app1e_j@ck: folds 
Kukuryzka: folds 
badmadrabbit: folds 
longway386: folds 
matiko09: folds 
balthie: calls $2.50
*** FLOP *** [Qs 9d 3h]
balthie: bets $35.26 and is all-in
Peremogec8: calls $35.26
*** TURN *** [Qs 9d 3h] [9h]
*** RIVER *** [Qs 9d 3h 9h] [Th]
*** SHOW DOWN ***
balthie: shows [4s Qc] (two pair, Queens and Nines)
Peremogec8: shows [Ts Tc] (a full house, Tens full of Nines)
Peremogec8 collected $76.27 from pot
*** SUMMARY ***
Total pot $78.27 | Rake $2 
Board [Qs 9d 3h 9h Th]
Seat 1: Peremogec8 showed [Ts Tc] and won ($76.27) with a full house, Tens full of Nines
Seat 2: app1e_j@ck folded before Flop (didn't bet)
Seat 3: Kukuryzka folded before Flop (didn't bet)
Seat 4: badmadrabbit (button) folded before Flop (didn't bet)
Seat 5: longway386 (small blind) folded before Flop
Seat 6: matiko09 (big blind) folded before Flop
Seat 7: advser folded before Flop (didn't bet)
Seat 8: ardo888 folded before Flop (didn't bet)
Seat 9: balthie showed [4s Qc] and lost with two pair, Queens and Nines





PokerStars Hand #155300584162:  Hold'em No Limit ($0.25/$0.50 USD) - 2016/06/28 15:56:09 CET [2016/06/28 9:56:09 ET]
Table 'Konkolya II' 9-max Seat #5 is the button
Seat 1: RvPersie ($78.08 in chips) 
Seat 2: app1e_j@ck ($50 in chips) 
Seat 3: Vedpapa ($50 in chips) 
Seat 4: seblafstian ($50 in chips) 
Seat 5: zoofu97 ($52.66 in chips) 
Seat 6: fudzi ($108.09 in chips) 
Seat 7: mixer29 ($50 in chips) 
Seat 8: matiko09 ($51.50 in chips) 
Seat 9: Xx7-Zeus-7xX ($45.78 in chips) 
fudzi: posts small blind $0.25
mixer29: posts big blind $0.50
*** HOLE CARDS ***
Dealt to matiko09 [Tc Jh]
matiko09: folds 
Xx7-Zeus-7xX: folds 
RvPersie: folds 
app1e_j@ck: folds 
Vedpapa: folds 
seblafstian: folds 
zoofu97: raises $1 to $1.50
fudzi: folds 
mixer29: folds 
Uncalled bet ($1) returned to zoofu97
zoofu97 collected $1.25 from pot
zoofu97: doesn't show hand 
*** SUMMARY ***
Total pot $1.25 | Rake $0 
Seat 1: RvPersie folded before Flop (didn't bet)
Seat 2: app1e_j@ck folded before Flop (didn't bet)
Seat 3: Vedpapa folded before Flop (didn't bet)
Seat 4: seblafstian folded before Flop (didn't bet)
Seat 5: zoofu97 (button) collected ($1.25)
Seat 6: fudzi (small blind) folded before Flop
Seat 7: mixer29 (big blind) folded before Flop
Seat 8: matiko09 folded before Flop (didn't bet)
Seat 9: Xx7-Zeus-7xX folded before Flop (didn't bet)





PokerStars Hand #155300588508:  Hold'em No Limit ($0.25/$0.50 USD) - 2016/06/28 15:56:19 CET [2016/06/28 9:56:19 ET]
Table 'Antonia II' 9-max Seat #1 is the button
Seat 1: Domotirko228 ($50 in chips) 
Seat 2: St.LaCoste ($57.84 in chips) 
Seat 3: matiko09 ($50 in chips) 
Seat 7: Rafaello18 ($54.21 in chips) 
Seat 8: mabbiche_007 ($50 in chips) 
Seat 9: Mott the Hoo ($0.91 in chips) 
St.LaCoste: posts small blind $0.25
matiko09: posts big blind $0.50
app1e_j@ck: sits out 
myatiy 96: sits out 
ardo888: sits out 
*** HOLE CARDS ***
Dealt to matiko09 [Jd Js]
Rafaello18: folds 
mabbiche_007: calls $0.50
Mott the Hoo: raises $0.41 to $0.91 and is all-in
Domotirko228: folds 
St.LaCoste: folds 
matiko09: raises $1.59 to $2.50
mabbiche_007: calls $2
*** FLOP *** [6h 5h Kh]
matiko09: checks 
mabbiche_007: checks 
*** TURN *** [6h 5h Kh] [Tc]
matiko09: bets $3.50
mabbiche_007: calls $3.50
*** RIVER *** [6h 5h Kh Tc] [Ks]
matiko09: bets $3.50
mabbiche_007: folds 
Uncalled bet ($3.50) returned to matiko09
*** SHOW DOWN ***
matiko09: shows [Jd Js] (two pair, Kings and Jacks)
matiko09 collected $9.67 from side pot
Mott the Hoo: shows [3d 3c] (two pair, Kings and Threes)
matiko09 collected $2.83 from main pot
*** SUMMARY ***
Total pot $13.16 Main pot $2.83. Side pot $9.67. | Rake $0.66 
Board [6h 5h Kh Tc Ks]
Seat 1: Domotirko228 (button) folded before Flop (didn't bet)
Seat 2: St.LaCoste (small blind) folded before Flop
Seat 3: matiko09 (big blind) showed [Jd Js] and won ($12.50) with two pair, Kings and Jacks
Seat 7: Rafaello18 folded before Flop (didn't bet)
Seat 8: mabbiche_007 folded on the River
Seat 9: Mott the Hoo showed [3d 3c] and lost with two pair, Kings and Threes





PokerStars Hand #155300590543:  Hold'em No Limit ($0.50/$1.00 USD) - 2016/06/28 15:56:23 CET [2016/06/28 9:56:23 ET]
Table 'Charybdis II' 9-max Seat #5 is the button
Seat 1: r4mz3s ($159.20 in chips) 
Seat 2: suited_doc ($110.97 in chips) 
Seat 3: Rafaello18 ($100 in chips) 
Seat 4: CI58 ($100 in chips) 
Seat 5: flk.Dasas ($108.90 in chips) 
Seat 6: matiko09 ($120 in chips) 
Seat 7: mycka86 ($100 in chips) 
matiko09: posts small blind $0.50
mycka86: posts big blind $1
ardo888: sits out 
JKVSAK85: sits out 
r4mz3s: posts the ante $0.20
suited_doc: posts the ante $0.20
Rafaello18: posts the ante $0.20
CI58: posts the ante $0.20
flk.Dasas: posts the ante $0.20
matiko09: posts the ante $0.20
mycka86: posts the ante $0.20
*** HOLE CARDS ***
Dealt to matiko09 [6c Ks]
r4mz3s: raises $1.55 to $2.55
suited_doc: folds 
Rafaello18: folds 
CI58: folds 
flk.Dasas: folds 
matiko09: folds 
mycka86: folds 
Uncalled bet ($1.55) returned to r4mz3s
r4mz3s collected $3.90 from pot
r4mz3s: doesn't show hand 
*** SUMMARY ***
Total pot $3.90 | Rake $0 
Seat 1: r4mz3s collected ($3.90)
Seat 2: suited_doc folded before Flop (didn't bet)
Seat 3: Rafaello18 folded before Flop (didn't bet)
Seat 4: CI58 folded before Flop (didn't bet)
Seat 5: flk.Dasas (button) folded before Flop (didn't bet)
Seat 6: matiko09 (small blind) folded before Flop
Seat 7: mycka86 (big blind) folded before Flop





PokerStars Hand #155300591151:  Hold'em No Limit ($0.25/$0.50 USD) - 2016/06/28 15:56:24 CET [2016/06/28 9:56:24 ET]
Table 'Utra' 9-max Seat #8 is the button
Seat 1: ardo888 ($52.85 in chips) 
Seat 2: matiko09 ($94.17 in chips) 
Seat 3: psychmantis ($40.69 in chips) 
Seat 4: ManChild9 ($54.38 in chips) 
Seat 5: baoyu4749892 ($66.61 in chips) 
Seat 6: Franky77200 ($25.35 in chips) 
Seat 7: el.suertero ($67.68 in chips) 
Seat 8: funXmun ($50.70 in chips) 
Seat 9: Kukuryzka ($50 in chips) 
Kukuryzka: posts small blind $0.25
ardo888: posts big blind $0.50
ardo888: posts the ante $0.10
matiko09: posts the ante $0.10
psychmantis: posts the ante $0.10
ManChild9: posts the ante $0.10
baoyu4749892: posts the ante $0.10
Franky77200: posts the ante $0.10
el.suertero: posts the ante $0.10
funXmun: posts the ante $0.10
Kukuryzka: posts the ante $0.10
*** HOLE CARDS ***
Dealt to matiko09 [3d Td]
matiko09: folds 
psychmantis: folds 
ManChild9: raises $2.50 to $3
baoyu4749892: folds 
Franky77200: folds 
el.suertero: calls $3
funXmun: folds 
Kukuryzka: folds 
ardo888: folds 
*** FLOP *** [Qd 6s 9s]
ManChild9: bets $3.63
el.suertero: calls $3.63
*** TURN *** [Qd 6s 9s] [6h]
ManChild9: bets $7.08
el.suertero: calls $7.08
*** RIVER *** [Qd 6s 9s 6h] [5d]
ManChild9: bets $7
el.suertero: folds 
Uncalled bet ($7) returned to ManChild9
ManChild9 collected $27.62 from pot
ManChild9: doesn't show hand 
*** SUMMARY ***
Total pot $29.07 | Rake $1.45 
Board [Qd 6s 9s 6h 5d]
Seat 1: ardo888 (big blind) folded before Flop
Seat 2: matiko09 folded before Flop (didn't bet)
Seat 3: psychmantis folded before Flop (didn't bet)
Seat 4: ManChild9 collected ($27.62)
Seat 5: baoyu4749892 folded before Flop (didn't bet)
Seat 6: Franky77200 folded before Flop (didn't bet)
Seat 7: el.suertero folded on the River
Seat 8: funXmun (button) folded before Flop (didn't bet)
Seat 9: Kukuryzka (small blind) folded before Flop





PokerStars Hand #155300593496:  Hold'em No Limit ($0.25/$0.50 USD) - 2016/06/28 15:56:29 CET [2016/06/28 9:56:29 ET]
Table 'Konkolya II' 9-max Seat #6 is the button
Seat 1: RvPersie ($78.08 in chips) 
Seat 2: app1e_j@ck ($50 in chips) 
Seat 3: Vedpapa ($50 in chips) 
Seat 4: seblafstian ($50 in chips) 
Seat 5: zoofu97 ($53.41 in chips) 
Seat 6: fudzi ($107.84 in chips) 
Seat 7: mixer29 ($50 in chips) 
Seat 8: matiko09 ($51.50 in chips) 
Seat 9: Xx7-Zeus-7xX ($45.78 in chips) 
mixer29: posts small blind $0.25
matiko09: posts big blind $0.50
*** HOLE CARDS ***
Dealt to matiko09 [Tc Td]
Xx7-Zeus-7xX: folds 
RvPersie: folds 
app1e_j@ck: folds 
Vedpapa: folds 
seblafstian: folds 
zoofu97: raises $1 to $1.50
fudzi: folds 
mixer29: raises $3 to $4.50
matiko09: calls $4
zoofu97: folds 
*** FLOP *** [Qh 2c Ks]
mixer29: bets $5.25
matiko09: folds 
Uncalled bet ($5.25) returned to mixer29
mixer29 collected $9.98 from pot
mixer29: doesn't show hand 
*** SUMMARY ***
Total pot $10.50 | Rake $0.52 
Board [Qh 2c Ks]
Seat 1: RvPersie folded before Flop (didn't bet)
Seat 2: app1e_j@ck folded before Flop (didn't bet)
Seat 3: Vedpapa folded before Flop (didn't bet)
Seat 4: seblafstian folded before Flop (didn't bet)
Seat 5: zoofu97 folded before Flop
Seat 6: fudzi (button) folded before Flop (didn't bet)
Seat 7: mixer29 (small blind) collected ($9.98)
Seat 8: matiko09 (big blind) folded on the Flop
Seat 9: Xx7-Zeus-7xX folded before Flop (didn't bet)





PokerStars Hand #155300594290:  Hold'em No Limit ($0.50/$1.00 USD) - 2016/06/28 15:56:31 CET [2016/06/28 9:56:31 ET]
Table 'Dorado II' 9-max Seat #9 is the button
Seat 1: f1reworks ($117.52 in chips) 
Seat 5: KovIFish89 ($100 in chips) 
Seat 6: ozone2003 ($212.15 in chips) 
Seat 7: matiko09 ($104.50 in chips) 
Seat 8: Rafaello18 ($139.96 in chips) 
Seat 9: tipner ($100 in chips) 
f1reworks: posts small blind $0.50
Kukuryzka: is sitting out 
KovIFish89: posts big blind $1
*** HOLE CARDS ***
Dealt to matiko09 [7s 5s]
ozone2003: folds 
Kukuryzka leaves the table
ozone2003 leaves the table
myatiy 96 joins the table at seat #6 
myatiy 96 leaves the table
matiko09: folds 
Rafaello18: folds 
tipner: folds 
f1reworks: folds 
Uncalled bet ($0.50) returned to KovIFish89
KovIFish89 collected $1 from pot
KovIFish89: doesn't show hand 
*** SUMMARY ***
Total pot $1 | Rake $0 
Seat 1: f1reworks (small blind) folded before Flop
Seat 5: KovIFish89 (big blind) collected ($1)
Seat 6: ozone2003 folded before Flop (didn't bet)
Seat 7: matiko09 folded before Flop (didn't bet)
Seat 8: Rafaello18 folded before Flop (didn't bet)
Seat 9: tipner (button) folded before Flop (didn't bet)





PokerStars Hand #155300599537:  Hold'em No Limit ($0.50/$1.00 USD) - 2016/06/28 15:56:42 CET [2016/06/28 9:56:42 ET]
Table 'Lyyli II' 9-max Seat #4 is the button
Seat 1: tipner ($105.10 in chips) 
Seat 2: Rafaello18 ($157.06 in chips) 
Seat 4: Greha999 ($105.62 in chips) 
Seat 5: flk.Dasas ($103.50 in chips) 
Seat 6: matiko09 ($117.90 in chips) 
Seat 7: Kukuryzka ($213.36 in chips) 
Seat 8: r4mz3s ($107.77 in chips) 
Seat 9: f1reworks ($109.80 in chips) 
flk.Dasas: posts small blind $0.50
matiko09: posts big blind $1
*** HOLE CARDS ***
Dealt to matiko09 [6s Ks]
Kukuryzka: raises $2 to $3
r4mz3s: folds 
f1reworks: folds 
tipner: folds 
Rafaello18: folds 
Greha999: calls $3
flk.Dasas: raises $10 to $13
matiko09: folds 
Kukuryzka: folds 
Greha999: folds 
Uncalled bet ($10) returned to flk.Dasas
flk.Dasas collected $10 from pot
flk.Dasas: doesn't show hand 
*** SUMMARY ***
Total pot $10 | Rake $0 
Seat 1: tipner folded before Flop (didn't bet)
Seat 2: Rafaello18 folded before Flop (didn't bet)
Seat 4: Greha999 (button) folded before Flop
Seat 5: flk.Dasas (small blind) collected ($10)
Seat 6: matiko09 (big blind) folded before Flop
Seat 7: Kukuryzka folded before Flop
Seat 8: r4mz3s folded before Flop (didn't bet)
Seat 9: f1reworks folded before Flop (didn't bet)





PokerStars Hand #155300600000:  Hold'em No Limit ($0.50/$1.00 USD) - 2016/06/28 15:56:43 CET [2016/06/28 9:56:43 ET]
Table 'Charybdis II' 9-max Seat #6 is the button
Seat 1: r4mz3s ($161.90 in chips) 
Seat 2: suited_doc ($110.77 in chips) 
Seat 3: Rafaello18 ($100 in chips) 
Seat 4: CI58 ($100 in chips) 
Seat 5: flk.Dasas ($108.70 in chips) 
Seat 6: matiko09 ($119.30 in chips) 
Seat 7: mycka86 ($100 in chips) 
Seat 8: ardo888 ($100 in chips) 
mycka86: posts small blind $0.50
ardo888: posts big blind $1
JKVSAK85: sits out 
r4mz3s: posts the ante $0.20
suited_doc: posts the ante $0.20
Rafaello18: posts the ante $0.20
CI58: posts the ante $0.20
flk.Dasas: posts the ante $0.20
matiko09: posts the ante $0.20
mycka86: posts the ante $0.20
ardo888: posts the ante $0.20
*** HOLE CARDS ***
Dealt to matiko09 [7h Qc]
r4mz3s: folds 
suited_doc: folds 
Rafaello18: folds 
CI58: raises $2 to $3
flk.Dasas: folds 
matiko09: folds 
mycka86: folds 
ardo888: folds 
Uncalled bet ($2) returned to CI58
CI58 collected $4.10 from pot
CI58: doesn't show hand 
*** SUMMARY ***
Total pot $4.10 | Rake $0 
Seat 1: r4mz3s folded before Flop (didn't bet)
Seat 2: suited_doc folded before Flop (didn't bet)
Seat 3: Rafaello18 folded before Flop (didn't bet)
Seat 4: CI58 collected ($4.10)
Seat 5: flk.Dasas folded before Flop (didn't bet)
Seat 6: matiko09 (button) folded before Flop (didn't bet)
Seat 7: mycka86 (small blind) folded before Flop
Seat 8: ardo888 (big blind) folded before Flop





PokerStars Hand #155300606057:  Hold'em No Limit ($0.50/$1.00 USD) - 2016/06/28 15:56:57 CET [2016/06/28 9:56:57 ET]
Table 'Kamenyar' 9-max Seat #5 is the button
Seat 1: Rafaello18 ($123.57 in chips) 
Seat 2: ozone2003 ($100 in chips) 
Seat 3: r4mz3s ($105.92 in chips) 
Seat 4: f1reworks ($224.41 in chips) 
Seat 5: bwly520 ($255.18 in chips) 
Seat 6: matiko09 ($100 in chips) 
Seat 7: Pokah4Living ($62.52 in chips) 
Seat 8: sanpidk ($105.38 in chips) 
matiko09: posts small blind $0.50
Pokah4Living: posts big blind $1
*** HOLE CARDS ***
Dealt to matiko09 [Qc 5d]
sanpidk: folds 
Rafaello18: raises $1.50 to $2.50
ozone2003: folds 
r4mz3s: folds 
f1reworks: folds 
bwly520: folds 
matiko09: folds 
Pokah4Living: raises $2.50 to $5
Rafaello18: raises $7 to $12
Pokah4Living: calls $7
*** FLOP *** [9h 8s Kh]
Pokah4Living: checks 
Rafaello18: bets $14
Pokah4Living: calls $14
*** TURN *** [9h 8s Kh] [Jd]
Pokah4Living: bets $36.52 and is all-in
Rafaello18: calls $36.52
*** RIVER *** [9h 8s Kh Jd] [3h]
*** SHOW DOWN ***
Pokah4Living: shows [Kc As] (a pair of Kings)
Rafaello18: shows [Ac Ad] (a pair of Aces)
Rafaello18 collected $123.04 from pot
*** SUMMARY ***
Total pot $125.54 | Rake $2.50 
Board [9h 8s Kh Jd 3h]
Seat 1: Rafaello18 showed [Ac Ad] and won ($123.04) with a pair of Aces
Seat 2: ozone2003 folded before Flop (didn't bet)
Seat 3: r4mz3s folded before Flop (didn't bet)
Seat 4: f1reworks folded before Flop (didn't bet)
Seat 5: bwly520 (button) folded before Flop (didn't bet)
Seat 6: matiko09 (small blind) folded before Flop
Seat 7: Pokah4Living (big blind) showed [Kc As] and lost with a pair of Kings
Seat 8: sanpidk folded before Flop (didn't bet)





PokerStars Hand #155300606788:  Hold'em No Limit ($0.50/$1.00 USD) - 2016/06/28 15:56:58 CET [2016/06/28 9:56:58 ET]
Table 'Dorado II' 9-max Seat #1 is the button
Seat 1: f1reworks ($117.02 in chips) 
Seat 5: KovIFish89 ($100.50 in chips) 
Seat 7: matiko09 ($104.50 in chips) 
Seat 8: Rafaello18 ($139.96 in chips) 
Seat 9: tipner ($100 in chips) 
KovIFish89: posts small blind $0.50
matiko09: posts big blind $1
*** HOLE CARDS ***
Dealt to matiko09 [5h 6d]
Rafaello18: folds 
tipner: folds 
Rafaello18 leaves the table
f1reworks: folds 
mycka86 joins the table at seat #6 
flk.Dasas joins the table at seat #8 
KovIFish89: folds 
Uncalled bet ($0.50) returned to matiko09
matiko09 collected $1 from pot
matiko09: doesn't show hand 
*** SUMMARY ***
Total pot $1 | Rake $0 
Seat 1: f1reworks (button) folded before Flop (didn't bet)
Seat 5: KovIFish89 (small blind) folded before Flop
Seat 7: matiko09 (big blind) collected ($1)
Seat 8: Rafaello18 folded before Flop (didn't bet)
Seat 9: tipner folded before Flop (didn't bet)





PokerStars Hand #155300615770:  Hold'em No Limit ($0.50/$1.00 USD) - 2016/06/28 15:57:18 CET [2016/06/28 9:57:18 ET]
Table 'Charybdis II' 9-max Seat #7 is the button
Seat 1: r4mz3s ($161.70 in chips) 
Seat 2: suited_doc ($110.57 in chips) 
Seat 3: Rafaello18 ($100 in chips) 
Seat 4: CI58 ($102.90 in chips) 
Seat 5: flk.Dasas ($108.50 in chips) 
Seat 6: matiko09 ($119.10 in chips) 
Seat 7: mycka86 ($100 in chips) 
Seat 8: ardo888 ($100 in chips) 
Seat 9: JKVSAK85 ($100 in chips) 
ardo888: posts small blind $0.50
JKVSAK85: posts big blind $1
r4mz3s: posts the ante $0.20
suited_doc: posts the ante $0.20
Rafaello18: posts the ante $0.20
CI58: posts the ante $0.20
flk.Dasas: posts the ante $0.20
matiko09: posts the ante $0.20
mycka86: posts the ante $0.20
ardo888: posts the ante $0.20
JKVSAK85: posts the ante $0.20
*** HOLE CARDS ***
Dealt to matiko09 [5h 7s]
r4mz3s: raises $2 to $3
suited_doc: calls $3
Rafaello18: folds 
CI58: calls $3
flk.Dasas: folds 
matiko09: folds 
mycka86: raises $12 to $15
ardo888: folds 
JKVSAK85: folds 
r4mz3s: folds 
suited_doc: folds 
CI58: calls $12
*** FLOP *** [7d 2c 6d]
CI58: checks 
mycka86: bets $20.53
CI58: calls $20.53
*** TURN *** [7d 2c 6d] [Td]
CI58: bets $67.17 and is all-in
mycka86: folds 
Uncalled bet ($67.17) returned to CI58
CI58 collected $77.86 from pot
CI58: doesn't show hand 
*** SUMMARY ***
Total pot $80.36 | Rake $2.50 
Board [7d 2c 6d Td]
Seat 1: r4mz3s folded before Flop
Seat 2: suited_doc folded before Flop
Seat 3: Rafaello18 folded before Flop (didn't bet)
Seat 4: CI58 collected ($77.86)
Seat 5: flk.Dasas folded before Flop (didn't bet)
Seat 6: matiko09 folded before Flop (didn't bet)
Seat 7: mycka86 (button) folded on the Turn
Seat 8: ardo888 (small blind) folded before Flop
Seat 9: JKVSAK85 (big blind) folded before Flop





PokerStars Hand #155300617429:  Hold'em No Limit ($0.25/$0.50 USD) - 2016/06/28 15:57:22 CET [2016/06/28 9:57:22 ET]
Table 'Antonia II' 9-max Seat #2 is the button
Seat 1: Domotirko228 ($50 in chips) 
Seat 2: St.LaCoste ($57.59 in chips) 
Seat 3: matiko09 ($56.50 in chips) 
Seat 4: app1e_j@ck ($50 in chips) 
Seat 7: Rafaello18 ($54.21 in chips) 
Seat 8: mabbiche_007 ($44 in chips) 
matiko09: posts small blind $0.25
app1e_j@ck: posts big blind $0.50
myatiy 96: sits out 
ardo888: sits out 
*** HOLE CARDS ***
Dealt to matiko09 [Ad 9h]
Rafaello18: folds 
mabbiche_007: raises $1.50 to $2
Domotirko228: folds 
St.LaCoste: folds 
matiko09: folds 
app1e_j@ck: folds 
Uncalled bet ($1.50) returned to mabbiche_007
mabbiche_007 collected $1.25 from pot
*** SUMMARY ***
Total pot $1.25 | Rake $0 
Seat 1: Domotirko228 folded before Flop (didn't bet)
Seat 2: St.LaCoste (button) folded before Flop (didn't bet)
Seat 3: matiko09 (small blind) folded before Flop
Seat 4: app1e_j@ck (big blind) folded before Flop
Seat 7: Rafaello18 folded before Flop (didn't bet)
Seat 8: mabbiche_007 collected ($1.25)





PokerStars Hand #155300618227:  Hold'em No Limit ($0.50/$1.00 USD) - 2016/06/28 15:57:24 CET [2016/06/28 9:57:24 ET]
Table 'Dorado II' 9-max Seat #5 is the button
Seat 1: f1reworks ($117.02 in chips) 
Seat 5: KovIFish89 ($100 in chips) 
Seat 7: matiko09 ($105 in chips) 
Seat 9: tipner ($100 in chips) 
mycka86 will be allowed to play after the button
matiko09: posts small blind $0.50
tipner: posts big blind $1
*** HOLE CARDS ***
Dealt to matiko09 [9s 4c]
f1reworks: folds 
KovIFish89: raises $1 to $2
matiko09: folds 
vanilica joins the table at seat #2 
tipner: folds 
Uncalled bet ($1) returned to KovIFish89
KovIFish89 collected $2.50 from pot
KovIFish89: doesn't show hand 
*** SUMMARY ***
Total pot $2.50 | Rake $0 
Seat 1: f1reworks folded before Flop (didn't bet)
Seat 5: KovIFish89 (button) collected ($2.50)
Seat 7: matiko09 (small blind) folded before Flop
Seat 9: tipner (big blind) folded before Flop





PokerStars Hand #155300622284:  Hold'em No Limit ($0.25/$0.50 USD) - 2016/06/28 15:57:33 CET [2016/06/28 9:57:33 ET]
Table 'Kordula' 9-max Seat #5 is the button
Seat 1: Peremogec8 ($88.01 in chips) 
Seat 2: app1e_j@ck ($50 in chips) 
Seat 3: Kukuryzka ($49.75 in chips) 
Seat 4: badmadrabbit ($50 in chips) 
Seat 5: longway386 ($36.50 in chips) 
Seat 6: matiko09 ($50 in chips) 
Seat 7: advser ($40.75 in chips) 
Seat 8: ardo888 ($95.75 in chips) 
matiko09: posts small blind $0.25
advser: posts big blind $0.50
*** HOLE CARDS ***
Dealt to matiko09 [7s 2s]
ardo888: folds 
balthie leaves the table
Peremogec8: folds 
app1e_j@ck: folds 
Kukuryzka: folds 
badmadrabbit: raises $0.75 to $1.25
longway386: folds 
mixer29 joins the table at seat #9 
matiko09: folds 
mixer29 leaves the table
advser: folds 
Uncalled bet ($0.75) returned to badmadrabbit
badmadrabbit collected $1.25 from pot
badmadrabbit: doesn't show hand 
*** SUMMARY ***
Total pot $1.25 | Rake $0 
Seat 1: Peremogec8 folded before Flop (didn't bet)
Seat 2: app1e_j@ck folded before Flop (didn't bet)
Seat 3: Kukuryzka folded before Flop (didn't bet)
Seat 4: badmadrabbit collected ($1.25)
Seat 5: longway386 (button) folded before Flop (didn't bet)
Seat 6: matiko09 (small blind) folded before Flop
Seat 7: advser (big blind) folded before Flop
Seat 8: ardo888 folded before Flop (didn't bet)





PokerStars Hand #155300622900:  Hold'em No Limit ($0.25/$0.50 USD) - 2016/06/28 15:57:34 CET [2016/06/28 9:57:34 ET]
Table 'Utra' 9-max Seat #9 is the button
Seat 1: ardo888 ($52.25 in chips) 
Seat 2: matiko09 ($94.07 in chips) 
Seat 3: psychmantis ($40.59 in chips) 
Seat 4: ManChild9 ($68.19 in chips) 
Seat 5: baoyu4749892 ($66.51 in chips) 
Seat 6: Franky77200 ($25.25 in chips) 
Seat 7: el.suertero ($53.87 in chips) 
Seat 8: funXmun ($50.60 in chips) 
Seat 9: Kukuryzka ($49.65 in chips) 
ardo888: posts small blind $0.25
matiko09: posts big blind $0.50
ardo888: posts the ante $0.10
matiko09: posts the ante $0.10
psychmantis: posts the ante $0.10
ManChild9: posts the ante $0.10
baoyu4749892: posts the ante $0.10
Franky77200: posts the ante $0.10
el.suertero: posts the ante $0.10
funXmun: posts the ante $0.10
Kukuryzka: posts the ante $0.10
*** HOLE CARDS ***
Dealt to matiko09 [Jc 4d]
psychmantis: folds 
ManChild9: folds 
baoyu4749892: folds 
Franky77200: raises $1 to $1.50
el.suertero: folds 
funXmun: folds 
Kukuryzka: folds 
ardo888: folds 
matiko09: folds 
Uncalled bet ($1) returned to Franky77200
Franky77200 collected $2.15 from pot
Franky77200: doesn't show hand 
*** SUMMARY ***
Total pot $2.15 | Rake $0 
Seat 1: ardo888 (small blind) folded before Flop
Seat 2: matiko09 (big blind) folded before Flop
Seat 3: psychmantis folded before Flop (didn't bet)
Seat 4: ManChild9 folded before Flop (didn't bet)
Seat 5: baoyu4749892 folded before Flop (didn't bet)
Seat 6: Franky77200 collected ($2.15)
Seat 7: el.suertero folded before Flop (didn't bet)
Seat 8: funXmun folded before Flop (didn't bet)
Seat 9: Kukuryzka (button) folded before Flop (didn't bet)





PokerStars Hand #155300625165:  Hold'em No Limit ($0.50/$1.00 USD) - 2016/06/28 15:57:39 CET [2016/06/28 9:57:39 ET]
Table 'Lyyli II' 9-max Seat #5 is the button
Seat 1: tipner ($105.10 in chips) 
Seat 2: Rafaello18 ($157.06 in chips) 
Seat 4: Greha999 ($102.62 in chips) 
Seat 5: flk.Dasas ($110.50 in chips) 
Seat 6: matiko09 ($116.90 in chips) 
Seat 7: Kukuryzka ($210.36 in chips) 
Seat 8: r4mz3s ($107.77 in chips) 
Seat 9: f1reworks ($109.80 in chips) 
matiko09: posts small blind $0.50
Kukuryzka: posts big blind $1
*** HOLE CARDS ***
Dealt to matiko09 [Kh 9d]
r4mz3s: folds 
f1reworks: folds 
tipner has timed out
tipner: folds 
Rafaello18: folds 
Greha999: folds 
flk.Dasas: folds 
matiko09: raises $2 to $3
Kukuryzka: folds 
Uncalled bet ($2) returned to matiko09
matiko09 collected $2 from pot
matiko09: doesn't show hand 
*** SUMMARY ***
Total pot $2 | Rake $0 
Seat 1: tipner folded before Flop (didn't bet)
Seat 2: Rafaello18 folded before Flop (didn't bet)
Seat 4: Greha999 folded before Flop (didn't bet)
Seat 5: flk.Dasas (button) folded before Flop (didn't bet)
Seat 6: matiko09 (small blind) collected ($2)
Seat 7: Kukuryzka (big blind) folded before Flop
Seat 8: r4mz3s folded before Flop (didn't bet)
Seat 9: f1reworks folded before Flop (didn't bet)





PokerStars Hand #155300628175:  Hold'em No Limit ($0.25/$0.50 USD) - 2016/06/28 15:57:45 CET [2016/06/28 9:57:45 ET]
Table 'Antonia II' 9-max Seat #3 is the button
Seat 1: Domotirko228 ($50 in chips) 
Seat 2: St.LaCoste ($57.59 in chips) 
Seat 3: matiko09 ($56.25 in chips) 
Seat 4: app1e_j@ck ($50 in chips) 
Seat 5: myatiy 96 ($57.43 in chips) 
Seat 7: Rafaello18 ($54.21 in chips) 
Seat 8: mabbiche_007 ($44.75 in chips) 
app1e_j@ck: posts small blind $0.25
myatiy 96: posts big blind $0.50
ardo888: sits out 
*** HOLE CARDS ***
Dealt to matiko09 [4s Jd]
Rafaello18: folds 
mabbiche_007: folds 
Domotirko228: folds 
St.LaCoste: folds 
matiko09: folds 
app1e_j@ck: raises $0.55 to $1.05
myatiy 96: calls $0.55
*** FLOP *** [6s 8h 3d]
app1e_j@ck: checks 
myatiy 96: bets $1.33
app1e_j@ck: folds 
Uncalled bet ($1.33) returned to myatiy 96
myatiy 96 collected $2 from pot
*** SUMMARY ***
Total pot $2.10 | Rake $0.10 
Board [6s 8h 3d]
Seat 1: Domotirko228 folded before Flop (didn't bet)
Seat 2: St.LaCoste folded before Flop (didn't bet)
Seat 3: matiko09 (button) folded before Flop (didn't bet)
Seat 4: app1e_j@ck (small blind) folded on the Flop
Seat 5: myatiy 96 (big blind) collected ($2)
Seat 7: Rafaello18 folded before Flop (didn't bet)
Seat 8: mabbiche_007 folded before Flop (didn't bet)





PokerStars Hand #155300630098:  Hold'em No Limit ($0.25/$0.50 USD) - 2016/06/28 15:57:50 CET [2016/06/28 9:57:50 ET]
Table 'Konkolya II' 9-max Seat #7 is the button
Seat 1: RvPersie ($78.08 in chips) 
Seat 2: app1e_j@ck ($50 in chips) 
Seat 3: Vedpapa ($50 in chips) 
Seat 4: seblafstian ($50 in chips) 
Seat 5: zoofu97 ($51.91 in chips) 
Seat 6: fudzi ($107.84 in chips) 
Seat 7: mixer29 ($55.48 in chips) 
Seat 8: matiko09 ($50 in chips) 
Seat 9: Xx7-Zeus-7xX ($45.78 in chips) 
matiko09: posts small blind $0.25
Xx7-Zeus-7xX: posts big blind $0.50
*** HOLE CARDS ***
Dealt to matiko09 [9c Jh]
RvPersie: folds 
app1e_j@ck: folds 
Vedpapa: folds 
seblafstian: folds 
zoofu97: calls $0.50
fudzi: raises $1.50 to $2
mixer29: folds 
matiko09: folds 
Xx7-Zeus-7xX: folds 
zoofu97: calls $1.50
*** FLOP *** [2d 5c 4c]
zoofu97: checks 
fudzi: checks 
*** TURN *** [2d 5c 4c] [4h]
zoofu97: bets $2
fudzi: folds 
Uncalled bet ($2) returned to zoofu97
zoofu97 collected $4.51 from pot
zoofu97: doesn't show hand 
*** SUMMARY ***
Total pot $4.75 | Rake $0.24 
Board [2d 5c 4c 4h]
Seat 1: RvPersie folded before Flop (didn't bet)
Seat 2: app1e_j@ck folded before Flop (didn't bet)
Seat 3: Vedpapa folded before Flop (didn't bet)
Seat 4: seblafstian folded before Flop (didn't bet)
Seat 5: zoofu97 collected ($4.51)
Seat 6: fudzi folded on the Turn
Seat 7: mixer29 (button) folded before Flop (didn't bet)
Seat 8: matiko09 (small blind) folded before Flop
Seat 9: Xx7-Zeus-7xX (big blind) folded before Flop





PokerStars Hand #155300630883:  Hold'em No Limit ($0.25/$0.50 USD) - 2016/06/28 15:57:51 CET [2016/06/28 9:57:51 ET]
Table 'Utra' 9-max Seat #1 is the button
Seat 1: ardo888 ($51.90 in chips) 
Seat 2: matiko09 ($93.47 in chips) 
Seat 3: psychmantis ($40.49 in chips) 
Seat 4: ManChild9 ($68.09 in chips) 
Seat 5: baoyu4749892 ($66.41 in chips) 
Seat 6: Franky77200 ($26.80 in chips) 
Seat 7: el.suertero ($53.77 in chips) 
Seat 8: funXmun ($50.50 in chips) 
Seat 9: Kukuryzka ($49.55 in chips) 
matiko09: posts small blind $0.25
psychmantis: posts big blind $0.50
ardo888: posts the ante $0.10
matiko09: posts the ante $0.10
psychmantis: posts the ante $0.10
ManChild9: posts the ante $0.10
baoyu4749892: posts the ante $0.10
Franky77200: posts the ante $0.10
el.suertero: posts the ante $0.10
funXmun: posts the ante $0.10
Kukuryzka: posts the ante $0.10
*** HOLE CARDS ***
Dealt to matiko09 [4c 4s]
ManChild9: folds 
ManChild9 leaves the table
baoyu4749892: folds 
Franky77200: folds 
myatiy 96 joins the table at seat #4 
el.suertero: raises $1 to $1.50
funXmun: folds 
Kukuryzka: folds 
ardo888: folds 
matiko09: folds 
psychmantis: folds 
Uncalled bet ($1) returned to el.suertero
el.suertero collected $2.15 from pot
el.suertero: doesn't show hand 
*** SUMMARY ***
Total pot $2.15 | Rake $0 
Seat 1: ardo888 (button) folded before Flop (didn't bet)
Seat 2: matiko09 (small blind) folded before Flop
Seat 3: psychmantis (big blind) folded before Flop
Seat 4: ManChild9 folded before Flop (didn't bet)
Seat 5: baoyu4749892 folded before Flop (didn't bet)
Seat 6: Franky77200 folded before Flop (didn't bet)
Seat 7: el.suertero collected ($2.15)
Seat 8: funXmun folded before Flop (didn't bet)
Seat 9: Kukuryzka folded before Flop (didn't bet)





PokerStars Hand #155300636044:  Hold'em No Limit ($0.50/$1.00 USD) - 2016/06/28 15:58:03 CET [2016/06/28 9:58:03 ET]
Table 'Dorado II' 9-max Seat #7 is the button
Seat 1: f1reworks ($117.02 in chips) 
Seat 5: KovIFish89 ($101.50 in chips) 
Seat 7: matiko09 ($104.50 in chips) 
Seat 9: tipner ($100 in chips) 
tipner: posts small blind $0.50
f1reworks: posts big blind $1
vanilica: sits out 
mycka86: sits out 
*** HOLE CARDS ***
Dealt to matiko09 [3d 8d]
KovIFish89: raises $2 to $3
matiko09: folds 
tipner: calls $2.50
f1reworks: folds 
*** FLOP *** [Ah Tc Ks]
tipner: checks 
KovIFish89: bets $3.50
tipner: calls $3.50
*** TURN *** [Ah Tc Ks] [7d]
tipner: checks 
KovIFish89: bets $8
tipner: calls $8
*** RIVER *** [Ah Tc Ks 7d] [3h]
tipner: checks 
KovIFish89: checks 
*** SHOW DOWN ***
tipner: shows [Jd As] (a pair of Aces)
KovIFish89: shows [Kc Th] (two pair, Kings and Tens)
KovIFish89 collected $29 from pot
*** SUMMARY ***
Total pot $30 | Rake $1 
Board [Ah Tc Ks 7d 3h]
Seat 1: f1reworks (big blind) folded before Flop
Seat 5: KovIFish89 showed [Kc Th] and won ($29) with two pair, Kings and Tens
Seat 7: matiko09 (button) folded before Flop (didn't bet)
Seat 9: tipner (small blind) showed [Jd As] and lost with a pair of Aces





PokerStars Hand #155300637930:  Hold'em No Limit ($0.25/$0.50 USD) - 2016/06/28 15:58:07 CET [2016/06/28 9:58:07 ET]
Table 'Kordula' 9-max Seat #6 is the button
Seat 2: app1e_j@ck ($50 in chips) 
Seat 3: Kukuryzka ($49.75 in chips) 
Seat 4: badmadrabbit ($50.75 in chips) 
Seat 5: longway386 ($36.50 in chips) 
Seat 6: matiko09 ($50 in chips) 
Seat 7: advser ($40.25 in chips) 
advser: posts small blind $0.25
ardo888: is sitting out 
Peremogec8: is sitting out 
app1e_j@ck: posts big blind $0.50
*** HOLE CARDS ***
Dealt to matiko09 [6h 6c]
Peremogec8 leaves the table
ardo888 leaves the table
drosser321 joins the table at seat #8 
denitz21 joins the table at seat #9 
drosser321 leaves the table
el.suertero joins the table at seat #1 
Kukuryzka: folds 
badmadrabbit: folds 
Kukuryzka leaves the table
longway386: raises $1 to $1.50
matiko09: calls $1.50
beetge joins the table at seat #3 
advser: calls $1.25
app1e_j@ck: folds 
*** FLOP *** [5d 7c Td]
advser: checks 
longway386: bets $3
matiko09: folds 
advser: calls $3
*** TURN *** [5d 7c Td] [9h]
advser: bets $6.50
myatiy 96 joins the table at seat #8 
myatiy 96 leaves the table
longway386: calls $6.50
*** RIVER *** [5d 7c Td 9h] [5c]
Alexey_Kim2 joins the table at seat #8 
advser: bets $18.50
longway386: folds 
Uncalled bet ($18.50) returned to advser
advser collected $22.80 from pot
*** SUMMARY ***
Total pot $24 | Rake $1.20 
Board [5d 7c Td 9h 5c]
Seat 2: app1e_j@ck (big blind) folded before Flop
Seat 3: Kukuryzka folded before Flop (didn't bet)
Seat 4: badmadrabbit folded before Flop (didn't bet)
Seat 5: longway386 folded on the River
Seat 6: matiko09 (button) folded on the Flop
Seat 7: advser (small blind) collected ($22.80)





PokerStars Hand #155300644547:  Hold'em No Limit ($0.50/$1.00 USD) - 2016/06/28 15:58:21 CET [2016/06/28 9:58:21 ET]
Table 'Lyyli II' 9-max Seat #6 is the button
Seat 1: tipner ($105.10 in chips) 
Seat 2: Rafaello18 ($157.06 in chips) 
Seat 4: Greha999 ($102.62 in chips) 
Seat 5: flk.Dasas ($110.50 in chips) 
Seat 6: matiko09 ($117.90 in chips) 
Seat 7: Kukuryzka ($209.36 in chips) 
Seat 8: r4mz3s ($107.77 in chips) 
Seat 9: f1reworks ($109.80 in chips) 
Kukuryzka: posts small blind $0.50
r4mz3s: posts big blind $1
*** HOLE CARDS ***
Dealt to matiko09 [Ts 6h]
f1reworks: raises $2 to $3
tipner: folds 
Rafaello18: folds 
Greha999: raises $7 to $10
flk.Dasas: folds 
matiko09: folds 
Kukuryzka: folds 
r4mz3s: folds 
f1reworks: calls $7
*** FLOP *** [9c 6c 7c]
f1reworks: checks 
Greha999: checks 
*** TURN *** [9c 6c 7c] [8s]
f1reworks: checks 
Greha999: bets $20
f1reworks: calls $20
*** RIVER *** [9c 6c 7c 8s] [2d]
f1reworks: checks 
Greha999: bets $29
f1reworks: calls $29
*** SHOW DOWN ***
Greha999: shows [Kc Ac] (a flush, Ace high)
f1reworks: mucks hand 
Greha999 collected $117 from pot
*** SUMMARY ***
Total pot $119.50 | Rake $2.50 
Board [9c 6c 7c 8s 2d]
Seat 1: tipner folded before Flop (didn't bet)
Seat 2: Rafaello18 folded before Flop (didn't bet)
Seat 4: Greha999 showed [Kc Ac] and won ($117) with a flush, Ace high
Seat 5: flk.Dasas folded before Flop (didn't bet)
Seat 6: matiko09 (button) folded before Flop (didn't bet)
Seat 7: Kukuryzka (small blind) folded before Flop
Seat 8: r4mz3s (big blind) folded before Flop
Seat 9: f1reworks mucked [Jc Jh]





PokerStars Hand #155300647672:  Hold'em No Limit ($0.50/$1.00 USD) - 2016/06/28 15:58:28 CET [2016/06/28 9:58:28 ET]
Table 'Kamenyar' 9-max Seat #6 is the button
Seat 1: Rafaello18 ($184.09 in chips) 
Seat 2: ozone2003 ($100 in chips) 
Seat 3: r4mz3s ($105.92 in chips) 
Seat 4: f1reworks ($224.41 in chips) 
Seat 5: bwly520 ($255.18 in chips) 
Seat 6: matiko09 ($100 in chips) 
Seat 8: sanpidk ($105.38 in chips) 
sanpidk: posts small blind $0.50
Rafaello18: posts big blind $1
*** HOLE CARDS ***
Dealt to matiko09 [6s 5c]
ozone2003: folds 
r4mz3s: folds 
f1reworks: folds 
bwly520 is connected 
bwly520 is disconnected 
Pokah4Living leaves the table
myatiy 96 joins the table at seat #7 
bwly520 has timed out while disconnected
bwly520: folds 
matiko09: folds 
myatiy 96 leaves the table
sanpidk: raises $1.50 to $2.50
Rafaello18: calls $1.50
*** FLOP *** [2s 6c Td]
sanpidk: bets $3
Racushniak joins the table at seat #7 
Rafaello18: folds 
Uncalled bet ($3) returned to sanpidk
sanpidk collected $4.75 from pot
sanpidk: doesn't show hand 
*** SUMMARY ***
Total pot $5 | Rake $0.25 
Board [2s 6c Td]
Seat 1: Rafaello18 (big blind) folded on the Flop
Seat 2: ozone2003 folded before Flop (didn't bet)
Seat 3: r4mz3s folded before Flop (didn't bet)
Seat 4: f1reworks folded before Flop (didn't bet)
Seat 5: bwly520 folded before Flop (didn't bet)
Seat 6: matiko09 (button) folded before Flop (didn't bet)
Seat 8: sanpidk (small blind) collected ($4.75)





PokerStars Hand #155300651975:  Hold'em No Limit ($0.25/$0.50 USD) - 2016/06/28 15:58:38 CET [2016/06/28 9:58:38 ET]
Table 'Antonia II' 9-max Seat #4 is the button
Seat 1: Domotirko228 ($50 in chips) 
Seat 2: St.LaCoste ($57.59 in chips) 
Seat 3: matiko09 ($56.25 in chips) 
Seat 4: app1e_j@ck ($50 in chips) 
Seat 5: myatiy 96 ($58.38 in chips) 
Seat 6: ardo888 ($72.42 in chips) 
Seat 7: Rafaello18 ($54.21 in chips) 
Seat 8: mabbiche_007 ($44.75 in chips) 
myatiy 96: posts small blind $0.25
ardo888: posts big blind $0.50
*** HOLE CARDS ***
Dealt to matiko09 [5h 9c]
Rafaello18: folds 
mabbiche_007: folds 
Domotirko228: raises $1 to $1.50
St.LaCoste: folds 
matiko09: folds 
app1e_j@ck: folds 
myatiy 96: folds 
ardo888: folds 
Uncalled bet ($1) returned to Domotirko228
Domotirko228 collected $1.25 from pot
Domotirko228: doesn't show hand 
*** SUMMARY ***
Total pot $1.25 | Rake $0 
Seat 1: Domotirko228 collected ($1.25)
Seat 2: St.LaCoste folded before Flop (didn't bet)
Seat 3: matiko09 folded before Flop (didn't bet)
Seat 4: app1e_j@ck (button) folded before Flop (didn't bet)
Seat 5: myatiy 96 (small blind) folded before Flop
Seat 6: ardo888 (big blind) folded before Flop
Seat 7: Rafaello18 folded before Flop (didn't bet)
Seat 8: mabbiche_007 folded before Flop (didn't bet)





PokerStars Hand #155300653764:  Hold'em No Limit ($0.25/$0.50 USD) - 2016/06/28 15:58:42 CET [2016/06/28 9:58:42 ET]
Table 'Utra' 9-max Seat #2 is the button
Seat 1: ardo888 ($51.80 in chips) 
Seat 2: matiko09 ($93.12 in chips) 
Seat 3: psychmantis ($39.89 in chips) 
Seat 4: myatiy 96 ($50 in chips) 
Seat 5: baoyu4749892 ($66.31 in chips) 
Seat 6: Franky77200 ($26.70 in chips) 
Seat 7: el.suertero ($55.32 in chips) 
Seat 8: funXmun ($50.40 in chips) 
Seat 9: Kukuryzka ($50 in chips) 
psychmantis: posts small blind $0.25
myatiy 96: posts big blind $0.50
ardo888: posts the ante $0.10
matiko09: posts the ante $0.10
psychmantis: posts the ante $0.10
myatiy 96: posts the ante $0.10
baoyu4749892: posts the ante $0.10
Franky77200: posts the ante $0.10
el.suertero: posts the ante $0.10
funXmun: posts the ante $0.10
Kukuryzka: posts the ante $0.10
*** HOLE CARDS ***
Dealt to matiko09 [7h 6s]
baoyu4749892: raises $0.50 to $1
Franky77200: calls $1
el.suertero: folds 
funXmun: folds 
Kukuryzka: folds 
ardo888: folds 
matiko09: folds 
psychmantis: folds 
myatiy 96: calls $0.50
*** FLOP *** [Ks 5c 9c]
myatiy 96: checks 
baoyu4749892: bets $2
Franky77200: calls $2
myatiy 96: calls $2
*** TURN *** [Ks 5c 9c] [2s]
myatiy 96: checks 
baoyu4749892: bets $5
Franky77200: calls $5
myatiy 96: folds 
*** RIVER *** [Ks 5c 9c 2s] [9d]
baoyu4749892: bets $14.50
Franky77200: calls $14.50
*** SHOW DOWN ***
baoyu4749892: shows [Qs 8c] (a pair of Nines)
Franky77200: shows [5s 4h] (two pair, Nines and Fives)
Franky77200 collected $47.15 from pot
*** SUMMARY ***
Total pot $49.15 | Rake $2 
Board [Ks 5c 9c 2s 9d]
Seat 1: ardo888 folded before Flop (didn't bet)
Seat 2: matiko09 (button) folded before Flop (didn't bet)
Seat 3: psychmantis (small blind) folded before Flop
Seat 4: myatiy 96 (big blind) folded on the Turn
Seat 5: baoyu4749892 showed [Qs 8c] and lost with a pair of Nines
Seat 6: Franky77200 showed [5s 4h] and won ($47.15) with two pair, Nines and Fives
Seat 7: el.suertero folded before Flop (didn't bet)
Seat 8: funXmun folded before Flop (didn't bet)
Seat 9: Kukuryzka folded before Flop (didn't bet)





PokerStars Hand #155300656754:  Hold'em No Limit ($0.50/$1.00 USD) - 2016/06/28 15:58:48 CET [2016/06/28 9:58:48 ET]
Table 'Dorado II' 9-max Seat #9 is the button
Seat 1: f1reworks ($116.02 in chips) 
Seat 2: vanilica ($100 in chips) 
Seat 5: KovIFish89 ($116 in chips) 
Seat 7: matiko09 ($104.50 in chips) 
Seat 9: tipner ($100 in chips) 
f1reworks: posts small blind $0.50
vanilica: posts big blind $1
mycka86: sits out 
*** HOLE CARDS ***
Dealt to matiko09 [9c 2c]
KovIFish89: folds 
matiko09: folds 
tipner: folds 
f1reworks: folds 
Uncalled bet ($0.50) returned to vanilica
vanilica collected $1 from pot
vanilica: doesn't show hand 
*** SUMMARY ***
Total pot $1 | Rake $0 
Seat 1: f1reworks (small blind) folded before Flop
Seat 2: vanilica (big blind) collected ($1)
Seat 5: KovIFish89 folded before Flop (didn't bet)
Seat 7: matiko09 folded before Flop (didn't bet)
Seat 9: tipner (button) folded before Flop (didn't bet)





PokerStars Hand #155300659390:  Hold'em No Limit ($0.25/$0.50 USD) - 2016/06/28 15:58:54 CET [2016/06/28 9:58:54 ET]
Table 'Konkolya II' 9-max Seat #8 is the button
Seat 1: RvPersie ($78.08 in chips) 
Seat 2: app1e_j@ck ($50 in chips) 
Seat 3: Vedpapa ($50 in chips) 
Seat 4: seblafstian ($50 in chips) 
Seat 5: zoofu97 ($54.42 in chips) 
Seat 6: fudzi ($105.84 in chips) 
Seat 7: mixer29 ($55.48 in chips) 
Seat 8: matiko09 ($50 in chips) 
Seat 9: Xx7-Zeus-7xX ($45.28 in chips) 
Xx7-Zeus-7xX: posts small blind $0.25
RvPersie: posts big blind $0.50
*** HOLE CARDS ***
Dealt to matiko09 [Qs 9h]
app1e_j@ck: folds 
Vedpapa has timed out
Vedpapa: folds 
seblafstian: folds 
zoofu97: folds 
fudzi: folds 
mixer29: folds 
matiko09: raises $0.63 to $1.13
Xx7-Zeus-7xX: folds 
RvPersie: folds 
Uncalled bet ($0.63) returned to matiko09
matiko09 collected $1.25 from pot
matiko09: doesn't show hand 
*** SUMMARY ***
Total pot $1.25 | Rake $0 
Seat 1: RvPersie (big blind) folded before Flop
Seat 2: app1e_j@ck folded before Flop (didn't bet)
Seat 3: Vedpapa folded before Flop (didn't bet)
Seat 4: seblafstian folded before Flop (didn't bet)
Seat 5: zoofu97 folded before Flop (didn't bet)
Seat 6: fudzi folded before Flop (didn't bet)
Seat 7: mixer29 folded before Flop (didn't bet)
Seat 8: matiko09 (button) collected ($1.25)
Seat 9: Xx7-Zeus-7xX (small blind) folded before Flop





PokerStars Hand #155300662592:  Hold'em No Limit ($0.50/$1.00 USD) - 2016/06/28 15:59:01 CET [2016/06/28 9:59:01 ET]
Table 'Dorado II' 9-max Seat #1 is the button
Seat 1: f1reworks ($115.52 in chips) 
Seat 2: vanilica ($100.50 in chips) 
Seat 5: KovIFish89 ($116 in chips) 
Seat 7: matiko09 ($104.50 in chips) 
Seat 9: tipner ($100 in chips) 
vanilica: posts small blind $0.50
KovIFish89: posts big blind $1
mycka86: sits out 
*** HOLE CARDS ***
Dealt to matiko09 [9s 7c]
matiko09: folds 
tipner: raises $1 to $2
f1reworks: folds 
vanilica: folds 
KovIFish89: folds 
Uncalled bet ($1) returned to tipner
tipner collected $2.50 from pot
tipner: doesn't show hand 
*** SUMMARY ***
Total pot $2.50 | Rake $0 
Seat 1: f1reworks (button) folded before Flop (didn't bet)
Seat 2: vanilica (small blind) folded before Flop
Seat 5: KovIFish89 (big blind) folded before Flop
Seat 7: matiko09 folded before Flop (didn't bet)
Seat 9: tipner collected ($2.50)





PokerStars Hand #155300665527:  Hold'em No Limit ($0.50/$1.00 USD) - 2016/06/28 15:59:07 CET [2016/06/28 9:59:07 ET]
Table 'Charybdis II' 9-max Seat #8 is the button
Seat 1: r4mz3s ($158.50 in chips) 
Seat 2: suited_doc ($107.37 in chips) 
Seat 3: Rafaello18 ($100 in chips) 
Seat 4: CI58 ($145.03 in chips) 
Seat 5: flk.Dasas ($108.30 in chips) 
Seat 6: matiko09 ($118.90 in chips) 
Seat 7: mycka86 ($100 in chips) 
Seat 8: ardo888 ($100 in chips) 
Seat 9: JKVSAK85 ($100 in chips) 
JKVSAK85: posts small blind $0.50
r4mz3s: posts big blind $1
r4mz3s: posts the ante $0.20
suited_doc: posts the ante $0.20
Rafaello18: posts the ante $0.20
CI58: posts the ante $0.20
flk.Dasas: posts the ante $0.20
matiko09: posts the ante $0.20
mycka86: posts the ante $0.20
ardo888: posts the ante $0.20
JKVSAK85: posts the ante $0.20
*** HOLE CARDS ***
Dealt to matiko09 [Ts Kd]
suited_doc: folds 
Rafaello18: folds 
CI58: folds 
flk.Dasas: folds 
matiko09: folds 
mycka86: folds 
ardo888: folds 
JKVSAK85: raises $1 to $2
r4mz3s: folds 
Uncalled bet ($1) returned to JKVSAK85
JKVSAK85 collected $3.80 from pot
*** SUMMARY ***
Total pot $3.80 | Rake $0 
Seat 1: r4mz3s (big blind) folded before Flop
Seat 2: suited_doc folded before Flop (didn't bet)
Seat 3: Rafaello18 folded before Flop (didn't bet)
Seat 4: CI58 folded before Flop (didn't bet)
Seat 5: flk.Dasas folded before Flop (didn't bet)
Seat 6: matiko09 folded before Flop (didn't bet)
Seat 7: mycka86 folded before Flop (didn't bet)
Seat 8: ardo888 (button) folded before Flop (didn't bet)
Seat 9: JKVSAK85 (small blind) collected ($3.80)





PokerStars Hand #155300665925:  Hold'em No Limit ($0.25/$0.50 USD) - 2016/06/28 15:59:08 CET [2016/06/28 9:59:08 ET]
Table 'Antonia II' 9-max Seat #5 is the button
Seat 1: Domotirko228 ($50.75 in chips) 
Seat 2: St.LaCoste ($57.59 in chips) 
Seat 3: matiko09 ($56.25 in chips) 
Seat 4: app1e_j@ck ($50 in chips) 
Seat 5: myatiy 96 ($58.13 in chips) 
Seat 6: ardo888 ($71.92 in chips) 
Seat 8: mabbiche_007 ($44.75 in chips) 
ardo888: posts small blind $0.25
Rafaello18: is sitting out 
Rafaello18 leaves the table
mabbiche_007: posts big blind $0.50
*** HOLE CARDS ***
Dealt to matiko09 [Ac 2h]
Domotirko228: folds 
Kukuryzka joins the table at seat #7 
St.LaCoste: folds 
matiko09: folds 
app1e_j@ck: folds 
myatiy 96: folds 
ardo888: folds 
Uncalled bet ($0.25) returned to mabbiche_007
mabbiche_007 collected $0.50 from pot
*** SUMMARY ***
Total pot $0.50 | Rake $0 
Seat 1: Domotirko228 folded before Flop (didn't bet)
Seat 2: St.LaCoste folded before Flop (didn't bet)
Seat 3: matiko09 folded before Flop (didn't bet)
Seat 4: app1e_j@ck folded before Flop (didn't bet)
Seat 5: myatiy 96 (button) folded before Flop (didn't bet)
Seat 6: ardo888 (small blind) folded before Flop
Seat 8: mabbiche_007 (big blind) collected ($0.50)





PokerStars Hand #155300673761:  Hold'em No Limit ($0.50/$1.00 USD) - 2016/06/28 15:59:25 CET [2016/06/28 9:59:25 ET]
Table 'Kamenyar' 9-max Seat #8 is the button
Seat 1: Rafaello18 ($181.59 in chips) 
Seat 2: ozone2003 ($100 in chips) 
Seat 3: r4mz3s ($105.92 in chips) 
Seat 4: f1reworks ($224.41 in chips) 
Seat 5: bwly520 ($255.18 in chips) 
Seat 6: matiko09 ($100 in chips) 
Seat 8: sanpidk ($107.63 in chips) 
Rafaello18: posts small blind $0.50
ozone2003: posts big blind $1
Racushniak: sits out 
*** HOLE CARDS ***
Dealt to matiko09 [6d 8s]
r4mz3s: raises $1.55 to $2.55
f1reworks: folds 
bwly520: calls $2.55
matiko09: folds 
sanpidk: folds 
Rafaello18: folds 
ozone2003: raises $7.45 to $10
r4mz3s: calls $7.45
bwly520: calls $7.45
*** FLOP *** [5h 9d 2c]
ozone2003: checks 
r4mz3s: bets $10.50
bwly520: calls $10.50
ozone2003: calls $10.50
*** TURN *** [5h 9d 2c] [7s]
ozone2003: checks 
r4mz3s: checks 
bwly520: bets $17.55
ozone2003: folds 
r4mz3s: calls $17.55
*** RIVER *** [5h 9d 2c 7s] [Kd]
r4mz3s: checks 
bwly520: bets $39.75
r4mz3s: calls $39.75
*** SHOW DOWN ***
bwly520: shows [5c 7c] (two pair, Sevens and Fives)
r4mz3s: mucks hand 
bwly520 collected $174.10 from pot
*** SUMMARY ***
Total pot $176.60 | Rake $2.50 
Board [5h 9d 2c 7s Kd]
Seat 1: Rafaello18 (small blind) folded before Flop
Seat 2: ozone2003 (big blind) folded on the Turn
Seat 3: r4mz3s mucked [8c 8h]
Seat 4: f1reworks folded before Flop (didn't bet)
Seat 5: bwly520 showed [5c 7c] and won ($174.10) with two pair, Sevens and Fives
Seat 6: matiko09 folded before Flop (didn't bet)
Seat 8: sanpidk (button) folded before Flop (didn't bet)





PokerStars Hand #155300679304:  Hold'em No Limit ($0.25/$0.50 USD) - 2016/06/28 15:59:38 CET [2016/06/28 9:59:38 ET]
Table 'Konkolya II' 9-max Seat #9 is the button
Seat 1: RvPersie ($77.58 in chips) 
Seat 2: app1e_j@ck ($50 in chips) 
Seat 4: seblafstian ($50 in chips) 
Seat 5: zoofu97 ($54.42 in chips) 
Seat 6: fudzi ($105.84 in chips) 
Seat 7: mixer29 ($55.48 in chips) 
Seat 8: matiko09 ($50.75 in chips) 
Seat 9: Xx7-Zeus-7xX ($45.03 in chips) 
RvPersie: posts small blind $0.25
app1e_j@ck: posts big blind $0.50
*** HOLE CARDS ***
Dealt to matiko09 [Tc Ks]
seblafstian: raises $1 to $1.50
zoofu97: folds 
fudzi: folds 
mixer29: calls $1.50
matiko09: folds 
Xx7-Zeus-7xX: folds 
RvPersie: folds 
app1e_j@ck: folds 
*** FLOP *** [4h 6c Qs]
seblafstian: bets $2.13
mixer29: folds 
Uncalled bet ($2.13) returned to seblafstian
seblafstian collected $3.56 from pot
seblafstian: doesn't show hand 
*** SUMMARY ***
Total pot $3.75 | Rake $0.19 
Board [4h 6c Qs]
Seat 1: RvPersie (small blind) folded before Flop
Seat 2: app1e_j@ck (big blind) folded before Flop
Seat 4: seblafstian collected ($3.56)
Seat 5: zoofu97 folded before Flop (didn't bet)
Seat 6: fudzi folded before Flop (didn't bet)
Seat 7: mixer29 folded on the Flop
Seat 8: matiko09 folded before Flop (didn't bet)
Seat 9: Xx7-Zeus-7xX (button) folded before Flop (didn't bet)





PokerStars Hand #155300681711:  Hold'em No Limit ($0.25/$0.50 USD) - 2016/06/28 15:59:43 CET [2016/06/28 9:59:43 ET]
Table 'Antonia II' 9-max Seat #6 is the button
Seat 1: Domotirko228 ($50.75 in chips) 
Seat 2: St.LaCoste ($57.59 in chips) 
Seat 3: matiko09 ($56.25 in chips) 
Seat 4: app1e_j@ck ($50 in chips) 
Seat 5: myatiy 96 ($58.13 in chips) 
Seat 6: ardo888 ($71.67 in chips) 
Seat 8: mabbiche_007 ($45 in chips) 
Kukuryzka will be allowed to play after the button
mabbiche_007: posts small blind $0.25
Domotirko228: posts big blind $0.50
*** HOLE CARDS ***
Dealt to matiko09 [Js 7c]
St.LaCoste: raises $1 to $1.50
matiko09: folds 
app1e_j@ck: folds 
myatiy 96: calls $1.50
ardo888: folds 
mabbiche_007: folds 
Domotirko228: folds 
*** FLOP *** [9h Th 9s]
St.LaCoste: bets $1.17
myatiy 96: calls $1.17
*** TURN *** [9h Th 9s] [2c]
St.LaCoste: bets $3.57
myatiy 96: folds 
Uncalled bet ($3.57) returned to St.LaCoste
St.LaCoste collected $5.79 from pot
St.LaCoste: doesn't show hand 
*** SUMMARY ***
Total pot $6.09 | Rake $0.30 
Board [9h Th 9s 2c]
Seat 1: Domotirko228 (big blind) folded before Flop
Seat 2: St.LaCoste collected ($5.79)
Seat 3: matiko09 folded before Flop (didn't bet)
Seat 4: app1e_j@ck folded before Flop (didn't bet)
Seat 5: myatiy 96 folded on the Turn
Seat 6: ardo888 (button) folded before Flop (didn't bet)
Seat 8: mabbiche_007 (small blind) folded before Flop





PokerStars Hand #155300682763:  Hold'em No Limit ($0.50/$1.00 USD) - 2016/06/28 15:59:45 CET [2016/06/28 9:59:45 ET]
Table 'Dorado II' 9-max Seat #2 is the button
Seat 1: f1reworks ($115.52 in chips) 
Seat 2: vanilica ($100 in chips) 
Seat 5: KovIFish89 ($115 in chips) 
Seat 6: mycka86 ($100 in chips) 
Seat 7: matiko09 ($104.50 in chips) 
Seat 9: tipner ($101.50 in chips) 
KovIFish89: posts small blind $0.50
mycka86: posts big blind $1
*** HOLE CARDS ***
Dealt to matiko09 [Tc 9c]
matiko09: raises $2 to $3
tipner: folds 
f1reworks: folds 
tipner leaves the table
r4mz3s joins the table at seat #9 
vanilica: folds 
KovIFish89: folds 
mycka86: folds 
Uncalled bet ($2) returned to matiko09
matiko09 collected $2.50 from pot
matiko09: doesn't show hand 
*** SUMMARY ***
Total pot $2.50 | Rake $0 
Seat 1: f1reworks folded before Flop (didn't bet)
Seat 2: vanilica (button) folded before Flop (didn't bet)
Seat 5: KovIFish89 (small blind) folded before Flop
Seat 6: mycka86 (big blind) folded before Flop
Seat 7: matiko09 collected ($2.50)
Seat 9: tipner folded before Flop (didn't bet)





PokerStars Hand #155300682751:  Hold'em No Limit ($0.25/$0.50 USD) - 2016/06/28 15:59:45 CET [2016/06/28 9:59:45 ET]
Table 'Kordula' 9-max Seat #7 is the button
Seat 2: app1e_j@ck ($50 in chips) 
Seat 3: beetge ($47.96 in chips) 
Seat 4: badmadrabbit ($50.75 in chips) 
Seat 5: longway386 ($25.50 in chips) 
Seat 6: matiko09 ($50 in chips) 
Seat 7: advser ($52.05 in chips) 
denitz21 will be allowed to play after the button
el.suertero will be allowed to play after the button
app1e_j@ck: posts small blind $0.25
beetge: posts big blind $0.50
*** HOLE CARDS ***
Dealt to matiko09 [Qd 5d]
badmadrabbit: raises $1 to $1.50
longway386: folds 
matiko09: folds 
advser: folds 
app1e_j@ck: folds 
beetge: folds 
Uncalled bet ($1) returned to badmadrabbit
badmadrabbit collected $1.25 from pot
badmadrabbit: doesn't show hand 
*** SUMMARY ***
Total pot $1.25 | Rake $0 
Seat 2: app1e_j@ck (small blind) folded before Flop
Seat 3: beetge (big blind) folded before Flop
Seat 4: badmadrabbit collected ($1.25)
Seat 5: longway386 folded before Flop (didn't bet)
Seat 6: matiko09 folded before Flop (didn't bet)
Seat 7: advser (button) folded before Flop (didn't bet)





PokerStars Hand #155300684122:  Hold'em No Limit ($0.50/$1.00 USD) - 2016/06/28 15:59:48 CET [2016/06/28 9:59:48 ET]
Table 'Charybdis II' 9-max Seat #9 is the button
Seat 1: r4mz3s ($157.30 in chips) 
Seat 4: CI58 ($144.83 in chips) 
Seat 5: flk.Dasas ($108.10 in chips) 
Seat 6: matiko09 ($118.70 in chips) 
Seat 7: mycka86 ($100 in chips) 
Seat 8: ardo888 ($100 in chips) 
Seat 9: JKVSAK85 ($102.60 in chips) 
r4mz3s: posts small blind $0.50
suited_doc: is sitting out 
Rafaello18: is sitting out 
CI58: posts big blind $1
r4mz3s: posts the ante $0.20
CI58: posts the ante $0.20
flk.Dasas: posts the ante $0.20
matiko09: posts the ante $0.20
mycka86: posts the ante $0.20
ardo888: posts the ante $0.20
JKVSAK85: posts the ante $0.20
*** HOLE CARDS ***
Dealt to matiko09 [3h 9d]
flk.Dasas: raises $3 to $4
matiko09: folds 
mycka86: folds 
ardo888: folds 
JKVSAK85: folds 
r4mz3s: folds 
CI58: folds 
Uncalled bet ($3) returned to flk.Dasas
flk.Dasas collected $3.90 from pot
flk.Dasas: doesn't show hand 
*** SUMMARY ***
Total pot $3.90 | Rake $0 
Seat 1: r4mz3s (small blind) folded before Flop
Seat 4: CI58 (big blind) folded before Flop
Seat 5: flk.Dasas collected ($3.90)
Seat 6: matiko09 folded before Flop (didn't bet)
Seat 7: mycka86 folded before Flop (didn't bet)
Seat 8: ardo888 folded before Flop (didn't bet)
Seat 9: JKVSAK85 (button) folded before Flop (didn't bet)





PokerStars Hand #155300686131:  Hold'em No Limit ($0.50/$1.00 USD) - 2016/06/28 15:59:52 CET [2016/06/28 9:59:52 ET]
Table 'Lyyli II' 9-max Seat #7 is the button
Seat 1: tipner ($105.10 in chips) 
Seat 2: Rafaello18 ($157.06 in chips) 
Seat 4: Greha999 ($160.62 in chips) 
Seat 5: flk.Dasas ($110.50 in chips) 
Seat 6: matiko09 ($117.90 in chips) 
Seat 7: Kukuryzka ($208.86 in chips) 
Seat 8: r4mz3s ($106.77 in chips) 
Seat 9: f1reworks ($100 in chips) 
r4mz3s: posts small blind $0.50
f1reworks: posts big blind $1
Racushniak: sits out 
*** HOLE CARDS ***
Dealt to matiko09 [4s 6c]
tipner: raises $2 to $3
Rafaello18: folds 
Greha999: calls $3
flk.Dasas: folds 
matiko09: folds 
Kukuryzka: folds 
r4mz3s: folds 
f1reworks: folds 
*** FLOP *** [7s Qh 5c]
tipner: checks 
Greha999: checks 
*** TURN *** [7s Qh 5c] [3s]
tipner: bets $4
Greha999: folds 
Uncalled bet ($4) returned to tipner
tipner collected $7.12 from pot
tipner: doesn't show hand 
*** SUMMARY ***
Total pot $7.50 | Rake $0.38 
Board [7s Qh 5c 3s]
Seat 1: tipner collected ($7.12)
Seat 2: Rafaello18 folded before Flop (didn't bet)
Seat 4: Greha999 folded on the Turn
Seat 5: flk.Dasas folded before Flop (didn't bet)
Seat 6: matiko09 folded before Flop (didn't bet)
Seat 7: Kukuryzka (button) folded before Flop (didn't bet)
Seat 8: r4mz3s (small blind) folded before Flop
Seat 9: f1reworks (big blind) folded before Flop





PokerStars Hand #155300693502:  Hold'em No Limit ($0.25/$0.50 USD) - 2016/06/28 16:00:07 CET [2016/06/28 10:00:07 ET]
Table 'Kordula' 9-max Seat #2 is the button
Seat 2: app1e_j@ck ($50 in chips) 
Seat 3: beetge ($47.46 in chips) 
Seat 5: longway386 ($25.50 in chips) 
Seat 6: matiko09 ($50 in chips) 
Seat 7: advser ($52.05 in chips) 
beetge: posts small blind $0.25
badmadrabbit: is sitting out 
longway386: posts big blind $0.50
denitz21: sits out 
el.suertero: sits out 
*** HOLE CARDS ***
Dealt to matiko09 [Qh 7s]
badmadrabbit leaves the table
matiko09: folds 
advser: folds 
bratbugor joins the table at seat #4 
Alexey_Kim2 leaves the table
app1e_j@ck: folds 
beetge: raises $1 to $1.50
I_Freemen joins the table at seat #8 
longway386: calls $1
*** FLOP *** [8h 5h 3h]
beetge: bets $2
longway386: calls $2
*** TURN *** [8h 5h 3h] [2c]
beetge: bets $3
longway386: folds 
Uncalled bet ($3) returned to beetge
beetge collected $6.65 from pot
beetge: doesn't show hand 
*** SUMMARY ***
Total pot $7 | Rake $0.35 
Board [8h 5h 3h 2c]
Seat 2: app1e_j@ck (button) folded before Flop (didn't bet)
Seat 3: beetge (small blind) collected ($6.65)
Seat 5: longway386 (big blind) folded on the Turn
Seat 6: matiko09 folded before Flop (didn't bet)
Seat 7: advser folded before Flop (didn't bet)





PokerStars Hand #155300697486:  Hold'em No Limit ($0.50/$1.00 USD) - 2016/06/28 16:00:16 CET [2016/06/28 10:00:16 ET]
Table 'Dorado II' 9-max Seat #5 is the button
Seat 1: f1reworks ($115.52 in chips) 
Seat 2: vanilica ($100 in chips) 
Seat 5: KovIFish89 ($114.50 in chips) 
Seat 6: mycka86 ($100 in chips) 
Seat 7: matiko09 ($106 in chips) 
mycka86: posts small blind $0.50
matiko09: posts big blind $1
r4mz3s: sits out 
pyromid: sits out 
*** HOLE CARDS ***
Dealt to matiko09 [Kd 4d]
f1reworks: folds 
vanilica: folds 
KovIFish89: raises $1 to $2
mycka86: folds 
matiko09: calls $1
*** FLOP *** [Ts 7s 6c]
matiko09: checks 
KovIFish89: checks 
*** TURN *** [Ts 7s 6c] [9c]
matiko09: checks 
KovIFish89: checks 
*** RIVER *** [Ts 7s 6c 9c] [5d]
matiko09: bets $2.22
KovIFish89: folds 
Uncalled bet ($2.22) returned to matiko09
matiko09 collected $4.28 from pot
matiko09: doesn't show hand 
*** SUMMARY ***
Total pot $4.50 | Rake $0.22 
Board [Ts 7s 6c 9c 5d]
Seat 1: f1reworks folded before Flop (didn't bet)
Seat 2: vanilica folded before Flop (didn't bet)
Seat 5: KovIFish89 (button) folded on the River
Seat 6: mycka86 (small blind) folded before Flop
Seat 7: matiko09 (big blind) collected ($4.28)





PokerStars Hand #155300698045:  Hold'em No Limit ($0.25/$0.50 USD) - 2016/06/28 16:00:17 CET [2016/06/28 10:00:17 ET]
Table 'Utra' 9-max Seat #3 is the button
Seat 1: ardo888 ($51.70 in chips) 
Seat 2: matiko09 ($93.02 in chips) 
Seat 3: psychmantis ($39.54 in chips) 
Seat 4: myatiy 96 ($50 in chips) 
Seat 5: baoyu4749892 ($43.71 in chips) 
Seat 6: Franky77200 ($51.25 in chips) 
Seat 7: el.suertero ($55.22 in chips) 
Seat 8: funXmun ($50.30 in chips) 
Seat 9: Kukuryzka ($49.90 in chips) 
myatiy 96: posts small blind $0.25
baoyu4749892: posts big blind $0.50
ardo888: posts the ante $0.10
matiko09: posts the ante $0.10
psychmantis: posts the ante $0.10
myatiy 96: posts the ante $0.10
baoyu4749892: posts the ante $0.10
Franky77200: posts the ante $0.10
el.suertero: posts the ante $0.10
funXmun: posts the ante $0.10
Kukuryzka: posts the ante $0.10
*** HOLE CARDS ***
Dealt to matiko09 [3d 6d]
Franky77200: folds 
el.suertero: folds 
funXmun: folds 
Kukuryzka: folds 
ardo888: folds 
matiko09: folds 
psychmantis: calls $0.50
myatiy 96: folds 
baoyu4749892: checks 
*** FLOP *** [Jh 6s 4s]
baoyu4749892: checks 
psychmantis: bets $1.02
baoyu4749892: raises $1.02 to $2.04
psychmantis: raises $1.02 to $3.06
baoyu4749892: calls $1.02
*** TURN *** [Jh 6s 4s] [7c]
funXmun leaves the table
baoyu4749892: checks 
psychmantis: checks 
*** RIVER *** [Jh 6s 4s 7c] [2h]
baoyu4749892: checks 
psychmantis: checks 
*** SHOW DOWN ***
baoyu4749892: shows [3s 7s] (a pair of Sevens)
psychmantis: shows [Js Th] (a pair of Jacks)
psychmantis collected $7.86 from pot
*** SUMMARY ***
Total pot $8.27 | Rake $0.41 
Board [Jh 6s 4s 7c 2h]
Seat 1: ardo888 folded before Flop (didn't bet)
Seat 2: matiko09 folded before Flop (didn't bet)
Seat 3: psychmantis (button) showed [Js Th] and won ($7.86) with a pair of Jacks
Seat 4: myatiy 96 (small blind) folded before Flop
Seat 5: baoyu4749892 (big blind) showed [3s 7s] and lost with a pair of Sevens
Seat 6: Franky77200 folded before Flop (didn't bet)
Seat 7: el.suertero folded before Flop (didn't bet)
Seat 8: funXmun folded before Flop (didn't bet)
Seat 9: Kukuryzka folded before Flop (didn't bet)





PokerStars Hand #155300709284:  Hold'em No Limit ($0.50/$1.00 USD) - 2016/06/28 16:00:40 CET [2016/06/28 10:00:40 ET]
Table 'Charybdis II' 9-max Seat #1 is the button
Seat 1: r4mz3s ($156.60 in chips) 
Seat 4: CI58 ($143.63 in chips) 
Seat 5: flk.Dasas ($110.80 in chips) 
Seat 6: matiko09 ($118.50 in chips) 
Seat 7: mycka86 ($100 in chips) 
Seat 8: ardo888 ($100 in chips) 
Seat 9: JKVSAK85 ($102.40 in chips) 
CI58: posts small blind $0.50
flk.Dasas: posts big blind $1
r4mz3s: posts the ante $0.20
CI58: posts the ante $0.20
flk.Dasas: posts the ante $0.20
matiko09: posts the ante $0.20
mycka86: posts the ante $0.20
ardo888: posts the ante $0.20
JKVSAK85: posts the ante $0.20
*** HOLE CARDS ***
Dealt to matiko09 [Ts As]
matiko09: raises $2 to $3
mycka86: folds 
suited_doc leaves the table
ardo888: folds 
JKVSAK85: folds 
myatiy 96 joins the table at seat #2 
r4mz3s: calls $3
CI58: folds 
flk.Dasas: folds 
*** FLOP *** [2h Tc Qs]
matiko09: checks 
myatiy 96 leaves the table
phil_cheng joins the table at seat #2 
r4mz3s: bets $4.50
matiko09: calls $4.50
*** TURN *** [2h Tc Qs] [9h]
matiko09: checks 
r4mz3s: bets $12.50
matiko09: folds 
Uncalled bet ($12.50) returned to r4mz3s
r4mz3s collected $17 from pot
r4mz3s: doesn't show hand 
*** SUMMARY ***
Total pot $17.90 | Rake $0.90 
Board [2h Tc Qs 9h]
Seat 1: r4mz3s (button) collected ($17)
Seat 4: CI58 (small blind) folded before Flop
Seat 5: flk.Dasas (big blind) folded before Flop
Seat 6: matiko09 folded on the Turn
Seat 7: mycka86 folded before Flop (didn't bet)
Seat 8: ardo888 folded before Flop (didn't bet)
Seat 9: JKVSAK85 folded before Flop (didn't bet)





PokerStars Hand #155300710753:  Hold'em No Limit ($0.25/$0.50 USD) - 2016/06/28 16:00:43 CET [2016/06/28 10:00:43 ET]
Table 'Konkolya II' 9-max Seat #1 is the button
Seat 1: RvPersie ($77.33 in chips) 
Seat 2: app1e_j@ck ($50 in chips) 
Seat 3: Vedpapa ($50 in chips) 
Seat 4: seblafstian ($52.06 in chips) 
Seat 5: zoofu97 ($54.42 in chips) 
Seat 6: fudzi ($105.84 in chips) 
Seat 7: mixer29 ($53.98 in chips) 
Seat 8: matiko09 ($50.75 in chips) 
Seat 9: Xx7-Zeus-7xX ($45.03 in chips) 
app1e_j@ck: posts small blind $0.25
Vedpapa: posts big blind $0.50
*** HOLE CARDS ***
Dealt to matiko09 [3c 4d]
seblafstian: folds 
zoofu97: folds 
fudzi: folds 
mixer29: folds 
matiko09: folds 
Xx7-Zeus-7xX: folds 
RvPersie: folds 
app1e_j@ck: folds 
Uncalled bet ($0.25) returned to Vedpapa
Vedpapa collected $0.50 from pot
Vedpapa: doesn't show hand 
*** SUMMARY ***
Total pot $0.50 | Rake $0 
Seat 1: RvPersie (button) folded before Flop (didn't bet)
Seat 2: app1e_j@ck (small blind) folded before Flop
Seat 3: Vedpapa (big blind) collected ($0.50)
Seat 4: seblafstian folded before Flop (didn't bet)
Seat 5: zoofu97 folded before Flop (didn't bet)
Seat 6: fudzi folded before Flop (didn't bet)
Seat 7: mixer29 folded before Flop (didn't bet)
Seat 8: matiko09 folded before Flop (didn't bet)
Seat 9: Xx7-Zeus-7xX folded before Flop (didn't bet)





PokerStars Hand #155300716415:  Hold'em No Limit ($0.50/$1.00 USD) - 2016/06/28 16:00:55 CET [2016/06/28 10:00:55 ET]
Table 'Lyyli II' 9-max Seat #8 is the button
Seat 1: tipner ($109.22 in chips) 
Seat 2: Rafaello18 ($157.06 in chips) 
Seat 4: Greha999 ($157.62 in chips) 
Seat 5: flk.Dasas ($110.50 in chips) 
Seat 6: matiko09 ($117.90 in chips) 
Seat 7: Kukuryzka ($208.86 in chips) 
Seat 8: r4mz3s ($106.27 in chips) 
Seat 9: f1reworks ($100 in chips) 
f1reworks: posts small blind $0.50
tipner: posts big blind $1
Racushniak: sits out 
*** HOLE CARDS ***
Dealt to matiko09 [9h Jd]
Rafaello18: folds 
Rafaello18 leaves the table
Greha999: folds 
sanpidk joins the table at seat #2 
flk.Dasas: folds 
sanpidk leaves the table
matiko09: folds 
Kukuryzka: folds 
r4mz3s: raises $1.14 to $2.14
CI58 joins the table at seat #2 
f1reworks: folds 
tipner: calls $1.14
*** FLOP *** [2c Ah 5h]
tipner: checks 
r4mz3s: checks 
*** TURN *** [2c Ah 5h] [Kh]
tipner: checks 
r4mz3s: checks 
*** RIVER *** [2c Ah 5h Kh] [Kc]
tipner: checks 
r4mz3s: checks 
*** SHOW DOWN ***
tipner: shows [3c 3h] (two pair, Kings and Threes)
r4mz3s: shows [Tc Td] (two pair, Kings and Tens)
r4mz3s collected $4.54 from pot
*** SUMMARY ***
Total pot $4.78 | Rake $0.24 
Board [2c Ah 5h Kh Kc]
Seat 1: tipner (big blind) showed [3c 3h] and lost with two pair, Kings and Threes
Seat 2: Rafaello18 folded before Flop (didn't bet)
Seat 4: Greha999 folded before Flop (didn't bet)
Seat 5: flk.Dasas folded before Flop (didn't bet)
Seat 6: matiko09 folded before Flop (didn't bet)
Seat 7: Kukuryzka folded before Flop (didn't bet)
Seat 8: r4mz3s (button) showed [Tc Td] and won ($4.54) with two pair, Kings and Tens
Seat 9: f1reworks (small blind) folded before Flop





PokerStars Hand #155300721853:  Hold'em No Limit ($0.50/$1.00 USD) - 2016/06/28 16:01:05 CET [2016/06/28 10:01:05 ET]
Table 'Dorado II' 9-max Seat #6 is the button
Seat 1: f1reworks ($115.52 in chips) 
Seat 2: vanilica ($100 in chips) 
Seat 5: KovIFish89 ($112.50 in chips) 
Seat 6: mycka86 ($100 in chips) 
Seat 7: matiko09 ($108.28 in chips) 
Seat 9: r4mz3s ($100 in chips) 
matiko09: posts small blind $0.50
r4mz3s: posts big blind $1
pyromid: sits out 
*** HOLE CARDS ***
Dealt to matiko09 [7s 3c]
f1reworks: folds 
vanilica: folds 
KovIFish89: raises $1.50 to $2.50
mycka86: folds 
matiko09: folds 
r4mz3s: folds 
Uncalled bet ($1.50) returned to KovIFish89
KovIFish89 collected $2.50 from pot
KovIFish89: doesn't show hand 
*** SUMMARY ***
Total pot $2.50 | Rake $0 
Seat 1: f1reworks folded before Flop (didn't bet)
Seat 2: vanilica folded before Flop (didn't bet)
Seat 5: KovIFish89 collected ($2.50)
Seat 6: mycka86 (button) folded before Flop (didn't bet)
Seat 7: matiko09 (small blind) folded before Flop
Seat 9: r4mz3s (big blind) folded before Flop





PokerStars Hand #155300731131:  Hold'em No Limit ($0.25/$0.50 USD) - 2016/06/28 16:01:24 CET [2016/06/28 10:01:24 ET]
Table 'Konkolya II' 9-max Seat #2 is the button
Seat 1: RvPersie ($77.33 in chips) 
Seat 2: app1e_j@ck ($50 in chips) 
Seat 3: Vedpapa ($50.25 in chips) 
Seat 4: seblafstian ($52.06 in chips) 
Seat 5: zoofu97 ($54.42 in chips) 
Seat 6: fudzi ($105.84 in chips) 
Seat 7: mixer29 ($53.98 in chips) 
Seat 8: matiko09 ($50.75 in chips) 
Seat 9: Xx7-Zeus-7xX ($45.03 in chips) 
Vedpapa: posts small blind $0.25
seblafstian: posts big blind $0.50
*** HOLE CARDS ***
Dealt to matiko09 [9h 5d]
zoofu97: calls $0.50
fudzi: raises $1.50 to $2
mixer29: folds 
matiko09: folds 
Xx7-Zeus-7xX: folds 
RvPersie: folds 
app1e_j@ck: folds 
Vedpapa: folds 
seblafstian: folds 
zoofu97: calls $1.50
*** FLOP *** [3h 8s Ac]
zoofu97: checks 
fudzi: bets $3
zoofu97: calls $3
*** TURN *** [3h 8s Ac] [Js]
zoofu97: checks 
fudzi: bets $6.50
zoofu97: folds 
Uncalled bet ($6.50) returned to fudzi
fudzi collected $10.21 from pot
fudzi: doesn't show hand 
*** SUMMARY ***
Total pot $10.75 | Rake $0.54 
Board [3h 8s Ac Js]
Seat 1: RvPersie folded before Flop (didn't bet)
Seat 2: app1e_j@ck (button) folded before Flop (didn't bet)
Seat 3: Vedpapa (small blind) folded before Flop
Seat 4: seblafstian (big blind) folded before Flop
Seat 5: zoofu97 folded on the Turn
Seat 6: fudzi collected ($10.21)
Seat 7: mixer29 folded before Flop (didn't bet)
Seat 8: matiko09 folded before Flop (didn't bet)
Seat 9: Xx7-Zeus-7xX folded before Flop (didn't bet)





PokerStars Hand #155300737966:  Hold'em No Limit ($0.25/$0.50 USD) - 2016/06/28 16:01:37 CET [2016/06/28 10:01:37 ET]
Table 'Utra' 9-max Seat #4 is the button
Seat 1: ardo888 ($51.60 in chips) 
Seat 2: matiko09 ($92.92 in chips) 
Seat 4: myatiy 96 ($50 in chips) 
Seat 5: baoyu4749892 ($40.05 in chips) 
Seat 6: Franky77200 ($51.15 in chips) 
Seat 7: el.suertero ($55.12 in chips) 
Seat 9: Kukuryzka ($49.80 in chips) 
baoyu4749892: posts small blind $0.25
Franky77200: posts big blind $0.50
ardo888: posts the ante $0.10
matiko09: posts the ante $0.10
myatiy 96: posts the ante $0.10
baoyu4749892: posts the ante $0.10
Franky77200: posts the ante $0.10
el.suertero: posts the ante $0.10
Kukuryzka: posts the ante $0.10
*** HOLE CARDS ***
Dealt to matiko09 [9c 2h]
el.suertero: folds 
Kukuryzka: folds 
ardo888: raises $1 to $1.50
psychmantis leaves the table
matiko09: folds 
myatiy 96: folds 
baoyu4749892: calls $1.25
fudzi joins the table at seat #8 
Franky77200: calls $1
*** FLOP *** [4c Ac 2s]
baoyu4749892: checks 
Franky77200: checks 
ardo888: checks 
*** TURN *** [4c Ac 2s] [Ks]
baoyu4749892: checks 
Franky77200: bets $3.50
ardo888: calls $3.50
baoyu4749892: folds 
*** RIVER *** [4c Ac 2s Ks] [7c]
Franky77200: checks 
mycka86 joins the table at seat #3 
ardo888: checks 
*** SHOW DOWN ***
Franky77200: shows [6s 3c] (high card Ace)
ardo888: shows [Js Qs] (high card Ace - King+Queen kicker)
ardo888 collected $11.59 from pot
*** SUMMARY ***
Total pot $12.20 | Rake $0.61 
Board [4c Ac 2s Ks 7c]
Seat 1: ardo888 showed [Js Qs] and won ($11.59) with high card Ace
Seat 2: matiko09 folded before Flop (didn't bet)
Seat 4: myatiy 96 (button) folded before Flop (didn't bet)
Seat 5: baoyu4749892 (small blind) folded on the Turn
Seat 6: Franky77200 (big blind) showed [6s 3c] and lost with high card Ace
Seat 7: el.suertero folded before Flop (didn't bet)
Seat 9: Kukuryzka folded before Flop (didn't bet)





PokerStars Hand #155300740380:  Hold'em No Limit ($0.50/$1.00 USD) - 2016/06/28 16:01:42 CET [2016/06/28 10:01:42 ET]
Table 'Dorado II' 9-max Seat #7 is the button
Seat 1: f1reworks ($115.52 in chips) 
Seat 2: vanilica ($100 in chips) 
Seat 5: KovIFish89 ($114 in chips) 
Seat 6: mycka86 ($100 in chips) 
Seat 7: matiko09 ($107.78 in chips) 
Seat 9: r4mz3s ($100 in chips) 
r4mz3s: posts small blind $0.50
f1reworks: posts big blind $1
pyromid: sits out 
*** HOLE CARDS ***
Dealt to matiko09 [6d 7h]
vanilica: folds 
KovIFish89: folds 
mycka86: folds 
matiko09: folds 
r4mz3s: raises $2 to $3
f1reworks: folds 
Uncalled bet ($2) returned to r4mz3s
r4mz3s collected $2 from pot
r4mz3s: doesn't show hand 
*** SUMMARY ***
Total pot $2 | Rake $0 
Seat 1: f1reworks (big blind) folded before Flop
Seat 2: vanilica folded before Flop (didn't bet)
Seat 5: KovIFish89 folded before Flop (didn't bet)
Seat 6: mycka86 folded before Flop (didn't bet)
Seat 7: matiko09 (button) folded before Flop (didn't bet)
Seat 9: r4mz3s (small blind) collected ($2)





PokerStars Hand #155300741266:  Hold'em No Limit ($0.25/$0.50 USD) - 2016/06/28 16:01:44 CET [2016/06/28 10:01:44 ET]
Table 'Antonia II' 9-max Seat #8 is the button
Seat 1: Domotirko228 ($50.25 in chips) 
Seat 2: St.LaCoste ($60.71 in chips) 
Seat 3: matiko09 ($56.25 in chips) 
Seat 4: app1e_j@ck ($50 in chips) 
Seat 5: myatiy 96 ($55.46 in chips) 
Seat 6: ardo888 ($71.67 in chips) 
Seat 8: mabbiche_007 ($44.75 in chips) 
Domotirko228: posts small blind $0.25
St.LaCoste: posts big blind $0.50
Kukuryzka: sits out 
*** HOLE CARDS ***
Dealt to matiko09 [Kh Tc]
matiko09: folds 
app1e_j@ck: folds 
myatiy 96: folds 
ardo888: raises $1 to $1.50
mabbiche_007: folds 
Domotirko228: folds 
St.LaCoste: folds 
Uncalled bet ($1) returned to ardo888
ardo888 collected $1.25 from pot
ardo888: doesn't show hand 
*** SUMMARY ***
Total pot $1.25 | Rake $0 
Seat 1: Domotirko228 (small blind) folded before Flop
Seat 2: St.LaCoste (big blind) folded before Flop
Seat 3: matiko09 folded before Flop (didn't bet)
Seat 4: app1e_j@ck folded before Flop (didn't bet)
Seat 5: myatiy 96 folded before Flop (didn't bet)
Seat 6: ardo888 collected ($1.25)
Seat 8: mabbiche_007 (button) folded before Flop (didn't bet)





PokerStars Hand #155300748851:  Hold'em No Limit ($0.25/$0.50 USD) - 2016/06/28 16:01:58 CET [2016/06/28 10:01:58 ET]
Table 'Antonia II' 9-max Seat #1 is the button
Seat 1: Domotirko228 ($50 in chips) 
Seat 2: St.LaCoste ($60.21 in chips) 
Seat 3: matiko09 ($56.25 in chips) 
Seat 4: app1e_j@ck ($50 in chips) 
Seat 5: myatiy 96 ($55.46 in chips) 
Seat 6: ardo888 ($72.42 in chips) 
Seat 8: mabbiche_007 ($44.75 in chips) 
St.LaCoste: posts small blind $0.25
matiko09: posts big blind $0.50
Kukuryzka: sits out 
*** HOLE CARDS ***
Dealt to matiko09 [9h 5s]
app1e_j@ck: folds 
myatiy 96: folds 
ardo888: folds 
mabbiche_007: folds 
Domotirko228: raises $0.75 to $1.25
Mott the Hoo leaves the table
bratbugor joins the table at seat #9 
St.LaCoste: raises $3.75 to $5
matiko09: folds 
Domotirko228: raises $6 to $11
St.LaCoste: folds 
Uncalled bet ($6) returned to Domotirko228
Domotirko228 collected $10.50 from pot
Domotirko228: doesn't show hand 
*** SUMMARY ***
Total pot $10.50 | Rake $0 
Seat 1: Domotirko228 (button) collected ($10.50)
Seat 2: St.LaCoste (small blind) folded before Flop
Seat 3: matiko09 (big blind) folded before Flop
Seat 4: app1e_j@ck folded before Flop (didn't bet)
Seat 5: myatiy 96 folded before Flop (didn't bet)
Seat 6: ardo888 folded before Flop (didn't bet)
Seat 8: mabbiche_007 folded before Flop (didn't bet)





PokerStars Hand #155300751447:  Hold'em No Limit ($0.50/$1.00 USD) - 2016/06/28 16:02:03 CET [2016/06/28 10:02:03 ET]
Table 'Charybdis II' 9-max Seat #4 is the button
Seat 1: r4mz3s ($165.90 in chips) 
Seat 4: CI58 ($142.93 in chips) 
Seat 5: flk.Dasas ($109.60 in chips) 
Seat 6: matiko09 ($110.80 in chips) 
Seat 7: mycka86 ($100 in chips) 
Seat 8: ardo888 ($100 in chips) 
Seat 9: JKVSAK85 ($102.20 in chips) 
flk.Dasas: posts small blind $0.50
matiko09: posts big blind $1
phil_cheng: sits out 
r4mz3s: posts the ante $0.20
CI58: posts the ante $0.20
flk.Dasas: posts the ante $0.20
matiko09: posts the ante $0.20
mycka86: posts the ante $0.20
ardo888: posts the ante $0.20
JKVSAK85: posts the ante $0.20
*** HOLE CARDS ***
Dealt to matiko09 [9c 6d]
mycka86: folds 
ardo888: folds 
JKVSAK85: raises $1.50 to $2.50
r4mz3s: folds 
CI58: folds 
Rafaello18 leaves the table
ozone2003 joins the table at seat #3 
flk.Dasas: calls $2
matiko09: folds 
*** FLOP *** [Th Jd 2h]
flk.Dasas: checks 
JKVSAK85: checks 
*** TURN *** [Th Jd 2h] [Kh]
flk.Dasas: checks 
JKVSAK85: bets $4.69
flk.Dasas: folds 
Uncalled bet ($4.69) returned to JKVSAK85
JKVSAK85 collected $7.03 from pot
*** SUMMARY ***
Total pot $7.40 | Rake $0.37 
Board [Th Jd 2h Kh]
Seat 1: r4mz3s folded before Flop (didn't bet)
Seat 4: CI58 (button) folded before Flop (didn't bet)
Seat 5: flk.Dasas (small blind) folded on the Turn
Seat 6: matiko09 (big blind) folded before Flop
Seat 7: mycka86 folded before Flop (didn't bet)
Seat 8: ardo888 folded before Flop (didn't bet)
Seat 9: JKVSAK85 collected ($7.03)





PokerStars Hand #155300753596:  Hold'em No Limit ($0.50/$1.00 USD) - 2016/06/28 16:02:08 CET [2016/06/28 10:02:08 ET]
Table 'Dorado II' 9-max Seat #9 is the button
Seat 1: f1reworks ($114.52 in chips) 
Seat 2: vanilica ($100 in chips) 
Seat 5: KovIFish89 ($114 in chips) 
Seat 6: mycka86 ($100 in chips) 
Seat 7: matiko09 ($107.78 in chips) 
Seat 9: r4mz3s ($101 in chips) 
f1reworks: posts small blind $0.50
vanilica: posts big blind $1
pyromid: sits out 
*** HOLE CARDS ***
Dealt to matiko09 [7s 5s]
KovIFish89: folds 
mycka86: folds 
matiko09: folds 
r4mz3s: folds 
f1reworks: folds 
Uncalled bet ($0.50) returned to vanilica
vanilica collected $1 from pot
vanilica: doesn't show hand 
*** SUMMARY ***
Total pot $1 | Rake $0 
Seat 1: f1reworks (small blind) folded before Flop
Seat 2: vanilica (big blind) collected ($1)
Seat 5: KovIFish89 folded before Flop (didn't bet)
Seat 6: mycka86 folded before Flop (didn't bet)
Seat 7: matiko09 folded before Flop (didn't bet)
Seat 9: r4mz3s (button) folded before Flop (didn't bet)





PokerStars Hand #155300755292:  Hold'em No Limit ($0.50/$1.00 USD) - 2016/06/28 16:02:10 CET [2016/06/28 10:02:10 ET]
Table 'Lyyli II' 9-max Seat #9 is the button
Seat 1: tipner ($107.08 in chips) 
Seat 2: CI58 ($100 in chips) 
Seat 4: Greha999 ($157.62 in chips) 
Seat 5: flk.Dasas ($110.50 in chips) 
Seat 6: matiko09 ($117.90 in chips) 
Seat 7: Kukuryzka ($208.86 in chips) 
Seat 8: r4mz3s ($108.67 in chips) 
Seat 9: f1reworks ($100 in chips) 
tipner: posts small blind $0.50
CI58: posts big blind $1
Racushniak: sits out 
*** HOLE CARDS ***
Dealt to matiko09 [2c Qc]
Greha999: folds 
flk.Dasas: folds 
matiko09: folds 
Kukuryzka: folds 
r4mz3s: folds 
f1reworks: folds 
tipner: raises $2 to $3
CI58: folds 
Uncalled bet ($2) returned to tipner
tipner collected $2 from pot
tipner: doesn't show hand 
*** SUMMARY ***
Total pot $2 | Rake $0 
Seat 1: tipner (small blind) collected ($2)
Seat 2: CI58 (big blind) folded before Flop
Seat 4: Greha999 folded before Flop (didn't bet)
Seat 5: flk.Dasas folded before Flop (didn't bet)
Seat 6: matiko09 folded before Flop (didn't bet)
Seat 7: Kukuryzka folded before Flop (didn't bet)
Seat 8: r4mz3s folded before Flop (didn't bet)
Seat 9: f1reworks (button) folded before Flop (didn't bet)





PokerStars Hand #155300770260:  Hold'em No Limit ($0.50/$1.00 USD) - 2016/06/28 16:02:39 CET [2016/06/28 10:02:39 ET]
Table 'Dorado II' 9-max Seat #1 is the button
Seat 1: f1reworks ($114.02 in chips) 
Seat 2: vanilica ($100.50 in chips) 
Seat 4: pyromid ($112 in chips) 
Seat 5: KovIFish89 ($114 in chips) 
Seat 6: mycka86 ($100 in chips) 
Seat 7: matiko09 ($107.78 in chips) 
Seat 9: r4mz3s ($101 in chips) 
vanilica: posts small blind $0.50
pyromid: posts big blind $1
*** HOLE CARDS ***
Dealt to matiko09 [Qd Th]
KovIFish89: folds 
mycka86: folds 
matiko09: folds 
r4mz3s: raises $1.55 to $2.55
f1reworks: folds 
vanilica: folds 
pyromid: calls $1.55
*** FLOP *** [As 5s 6c]
pyromid: checks 
r4mz3s: bets $4
pyromid: calls $4
*** TURN *** [As 5s 6c] [3s]
pyromid: checks 
r4mz3s: checks 
*** RIVER *** [As 5s 6c 3s] [2h]
pyromid: bets $6.46
r4mz3s: folds 
Uncalled bet ($6.46) returned to pyromid
pyromid collected $12.92 from pot
pyromid: doesn't show hand 
*** SUMMARY ***
Total pot $13.60 | Rake $0.68 
Board [As 5s 6c 3s 2h]
Seat 1: f1reworks (button) folded before Flop (didn't bet)
Seat 2: vanilica (small blind) folded before Flop
Seat 4: pyromid (big blind) collected ($12.92)
Seat 5: KovIFish89 folded before Flop (didn't bet)
Seat 6: mycka86 folded before Flop (didn't bet)
Seat 7: matiko09 folded before Flop (didn't bet)
Seat 9: r4mz3s folded on the River





PokerStars Hand #155300771415:  Hold'em No Limit ($0.25/$0.50 USD) - 2016/06/28 16:02:41 CET [2016/06/28 10:02:41 ET]
Table 'Utra' 9-max Seat #5 is the button
Seat 1: ardo888 ($58.09 in chips) 
Seat 2: matiko09 ($92.82 in chips) 
Seat 4: myatiy 96 ($50 in chips) 
Seat 5: baoyu4749892 ($38.45 in chips) 
Seat 6: Franky77200 ($46.05 in chips) 
Seat 7: el.suertero ($55.02 in chips) 
Seat 9: Kukuryzka ($49.70 in chips) 
Franky77200: posts small blind $0.25
el.suertero: posts big blind $0.50
fudzi: sits out 
mycka86: sits out 
ardo888: posts the ante $0.10
matiko09: posts the ante $0.10
myatiy 96: posts the ante $0.10
baoyu4749892: posts the ante $0.10
Franky77200: posts the ante $0.10
el.suertero: posts the ante $0.10
Kukuryzka: posts the ante $0.10
*** HOLE CARDS ***
Dealt to matiko09 [6c 8s]
Kukuryzka: folds 
ardo888: folds 
matiko09: folds 
myatiy 96: folds 
baoyu4749892: raises $1 to $1.50
Franky77200: calls $1.25
el.suertero: calls $1
*** FLOP *** [Ks Qh 7s]
Franky77200: checks 
el.suertero: bets $3
baoyu4749892: calls $3
Franky77200: folds 
*** TURN *** [Ks Qh 7s] [As]
el.suertero: checks 
baoyu4749892: checks 
*** RIVER *** [Ks Qh 7s As] [3c]
el.suertero: checks 
baoyu4749892: checks 
*** SHOW DOWN ***
el.suertero: shows [Kc 8c] (a pair of Kings)
baoyu4749892: mucks hand 
el.suertero collected $10.64 from pot
*** SUMMARY ***
Total pot $11.20 | Rake $0.56 
Board [Ks Qh 7s As 3c]
Seat 1: ardo888 folded before Flop (didn't bet)
Seat 2: matiko09 folded before Flop (didn't bet)
Seat 4: myatiy 96 folded before Flop (didn't bet)
Seat 5: baoyu4749892 (button) mucked [4h 4s]
Seat 6: Franky77200 (small blind) folded on the Flop
Seat 7: el.suertero (big blind) showed [Kc 8c] and won ($10.64) with a pair of Kings
Seat 9: Kukuryzka folded before Flop (didn't bet)





PokerStars Hand #155300780989:  Hold'em No Limit ($0.25/$0.50 USD) - 2016/06/28 16:02:59 CET [2016/06/28 10:02:59 ET]
Table 'Konkolya II' 9-max Seat #3 is the button
Seat 1: RvPersie ($77.33 in chips) 
Seat 2: app1e_j@ck ($50 in chips) 
Seat 3: Vedpapa ($50 in chips) 
Seat 4: seblafstian ($51.56 in chips) 
Seat 5: zoofu97 ($49.42 in chips) 
Seat 6: fudzi ($111.05 in chips) 
Seat 7: mixer29 ($53.98 in chips) 
Seat 8: matiko09 ($50.75 in chips) 
Seat 9: Xx7-Zeus-7xX ($45.03 in chips) 
seblafstian: posts small blind $0.25
zoofu97: posts big blind $0.50
*** HOLE CARDS ***
Dealt to matiko09 [Kh 8d]
fudzi: folds 
mixer29: folds 
zoofu97 said, "3:)"
matiko09: folds 
Xx7-Zeus-7xX: raises $1 to $1.50
RvPersie: folds 
app1e_j@ck: folds 
Vedpapa: folds 
seblafstian: folds 
zoofu97: calls $1
*** FLOP *** [7h 6c Kd]
zoofu97: checks 
Xx7-Zeus-7xX: bets $2.50
zoofu97: calls $2.50
*** TURN *** [7h 6c Kd] [2s]
zoofu97: checks 
Xx7-Zeus-7xX: checks 
*** RIVER *** [7h 6c Kd 2s] [9d]
zoofu97: checks 
Xx7-Zeus-7xX: checks 
*** SHOW DOWN ***
zoofu97: shows [Jc 6h] (a pair of Sixes)
Xx7-Zeus-7xX: mucks hand 
zoofu97 collected $7.84 from pot
*** SUMMARY ***
Total pot $8.25 | Rake $0.41 
Board [7h 6c Kd 2s 9d]
Seat 1: RvPersie folded before Flop (didn't bet)
Seat 2: app1e_j@ck folded before Flop (didn't bet)
Seat 3: Vedpapa (button) folded before Flop (didn't bet)
Seat 4: seblafstian (small blind) folded before Flop
Seat 5: zoofu97 (big blind) showed [Jc 6h] and won ($7.84) with a pair of Sixes
Seat 6: fudzi folded before Flop (didn't bet)
Seat 7: mixer29 folded before Flop (didn't bet)
Seat 8: matiko09 folded before Flop (didn't bet)
Seat 9: Xx7-Zeus-7xX mucked [As Ts]





PokerStars Hand #155300781088:  Hold'em No Limit ($0.25/$0.50 USD) - 2016/06/28 16:02:59 CET [2016/06/28 10:02:59 ET]
Table 'Antonia II' 9-max Seat #2 is the button
Seat 1: Domotirko228 ($55.50 in chips) 
Seat 2: St.LaCoste ($55.21 in chips) 
Seat 3: matiko09 ($55.75 in chips) 
Seat 4: app1e_j@ck ($50 in chips) 
Seat 5: myatiy 96 ($55.46 in chips) 
Seat 6: ardo888 ($72.42 in chips) 
matiko09: posts small blind $0.25
app1e_j@ck: posts big blind $0.50
Kukuryzka: sits out 
bratbugor: sits out 
*** HOLE CARDS ***
Dealt to matiko09 [Qd 2d]
myatiy 96: folds 
ardo888: folds 
myatiy 96 leaves the table
Domotirko228: folds 
St.LaCoste: folds 
matiko09: folds 
Uncalled bet ($0.25) returned to app1e_j@ck
app1e_j@ck collected $0.50 from pot
app1e_j@ck: doesn't show hand 
*** SUMMARY ***
Total pot $0.50 | Rake $0 
Seat 1: Domotirko228 folded before Flop (didn't bet)
Seat 2: St.LaCoste (button) folded before Flop (didn't bet)
Seat 3: matiko09 (small blind) folded before Flop
Seat 4: app1e_j@ck (big blind) collected ($0.50)
Seat 5: myatiy 96 folded before Flop (didn't bet)
Seat 6: ardo888 folded before Flop (didn't bet)





PokerStars Hand #155300781640:  Hold'em No Limit ($0.50/$1.00 USD) - 2016/06/28 16:03:00 CET [2016/06/28 10:03:00 ET]
Table 'Lyyli II' 9-max Seat #1 is the button
Seat 1: tipner ($108.08 in chips) 
Seat 2: CI58 ($100 in chips) 
Seat 3: Racushniak ($100 in chips) 
Seat 4: Greha999 ($157.62 in chips) 
Seat 5: flk.Dasas ($110.50 in chips) 
Seat 6: matiko09 ($117.90 in chips) 
Seat 7: Kukuryzka ($208.86 in chips) 
Seat 8: r4mz3s ($108.67 in chips) 
Seat 9: f1reworks ($100 in chips) 
CI58: posts small blind $0.50
Racushniak: posts big blind $1
*** HOLE CARDS ***
Dealt to matiko09 [Js 2h]
Greha999: folds 
flk.Dasas: folds 
matiko09: folds 
Kukuryzka: raises $2 to $3
r4mz3s: folds 
f1reworks: raises $6 to $9
tipner: folds 
CI58: folds 
Racushniak: folds 
Kukuryzka: folds 
Uncalled bet ($6) returned to f1reworks
f1reworks collected $7.50 from pot
f1reworks: doesn't show hand 
*** SUMMARY ***
Total pot $7.50 | Rake $0 
Seat 1: tipner (button) folded before Flop (didn't bet)
Seat 2: CI58 (small blind) folded before Flop
Seat 3: Racushniak (big blind) folded before Flop
Seat 4: Greha999 folded before Flop (didn't bet)
Seat 5: flk.Dasas folded before Flop (didn't bet)
Seat 6: matiko09 folded before Flop (didn't bet)
Seat 7: Kukuryzka folded before Flop
Seat 8: r4mz3s folded before Flop (didn't bet)
Seat 9: f1reworks collected ($7.50)





PokerStars Hand #155300792772:  Hold'em No Limit ($0.25/$0.50 USD) - 2016/06/28 16:03:21 CET [2016/06/28 10:03:21 ET]
Table 'Antonia II' 9-max Seat #3 is the button
Seat 1: Domotirko228 ($55.50 in chips) 
Seat 2: St.LaCoste ($55.21 in chips) 
Seat 3: matiko09 ($55.50 in chips) 
Seat 4: app1e_j@ck ($50.25 in chips) 
Seat 6: ardo888 ($72.42 in chips) 
app1e_j@ck: posts small blind $0.25
ardo888: posts big blind $0.50
Kukuryzka: sits out 
bratbugor: sits out 
*** HOLE CARDS ***
Dealt to matiko09 [5d Kc]
Domotirko228: folds 
St.LaCoste: folds 
matiko09: folds 
app1e_j@ck: raises $0.55 to $1.05
ardo888: calls $0.55
*** FLOP *** [Tc As 4s]
app1e_j@ck: bets $1.50
ardo888: calls $1.50
*** TURN *** [Tc As 4s] [Ts]
app1e_j@ck: bets $3.63
ardo888: folds 
Uncalled bet ($3.63) returned to app1e_j@ck
app1e_j@ck collected $4.84 from pot
app1e_j@ck: doesn't show hand 
*** SUMMARY ***
Total pot $5.10 | Rake $0.26 
Board [Tc As 4s Ts]
Seat 1: Domotirko228 folded before Flop (didn't bet)
Seat 2: St.LaCoste folded before Flop (didn't bet)
Seat 3: matiko09 (button) folded before Flop (didn't bet)
Seat 4: app1e_j@ck (small blind) collected ($4.84)
Seat 6: ardo888 (big blind) folded on the Turn





PokerStars Hand #155300796400:  Hold'em No Limit ($0.25/$0.50 USD) - 2016/06/28 16:03:27 CET [2016/06/28 10:03:27 ET]
Table 'Utra' 9-max Seat #6 is the button
Seat 1: ardo888 ($57.99 in chips) 
Seat 2: matiko09 ($92.72 in chips) 
Seat 4: myatiy 96 ($50 in chips) 
Seat 5: baoyu4749892 ($33.85 in chips) 
Seat 6: Franky77200 ($44.45 in chips) 
Seat 7: el.suertero ($61.06 in chips) 
Seat 8: fudzi ($50 in chips) 
Seat 9: Kukuryzka ($49.60 in chips) 
el.suertero: posts small blind $0.25
fudzi: posts big blind $0.50
mycka86: sits out 
ardo888: posts the ante $0.10
matiko09: posts the ante $0.10
myatiy 96: posts the ante $0.10
baoyu4749892: posts the ante $0.10
Franky77200: posts the ante $0.10
el.suertero: posts the ante $0.10
fudzi: posts the ante $0.10
Kukuryzka: posts the ante $0.10
*** HOLE CARDS ***
Dealt to matiko09 [6h Jd]
Kukuryzka: folds 
ardo888: folds 
matiko09: folds 
myatiy 96: folds 
baoyu4749892: raises $0.50 to $1
Franky77200: calls $1
el.suertero: folds 
fudzi: folds 
*** FLOP *** [Ts 4h Qh]
baoyu4749892: checks 
Franky77200: checks 
*** TURN *** [Ts 4h Qh] [3c]
baoyu4749892: bets $1.50
Franky77200: folds 
Uncalled bet ($1.50) returned to baoyu4749892
baoyu4749892 collected $3.37 from pot
baoyu4749892: doesn't show hand 
*** SUMMARY ***
Total pot $3.55 | Rake $0.18 
Board [Ts 4h Qh 3c]
Seat 1: ardo888 folded before Flop (didn't bet)
Seat 2: matiko09 folded before Flop (didn't bet)
Seat 4: myatiy 96 folded before Flop (didn't bet)
Seat 5: baoyu4749892 collected ($3.37)
Seat 6: Franky77200 (button) folded on the Turn
Seat 7: el.suertero (small blind) folded before Flop
Seat 8: fudzi (big blind) folded before Flop
Seat 9: Kukuryzka folded before Flop (didn't bet)





PokerStars Hand #155300799796:  Hold'em No Limit ($0.50/$1.00 USD) - 2016/06/28 16:03:34 CET [2016/06/28 10:03:34 ET]
Table 'Charybdis II' 9-max Seat #5 is the button
Seat 1: r4mz3s ($165.70 in chips) 
Seat 4: CI58 ($142.73 in chips) 
Seat 5: flk.Dasas ($106.90 in chips) 
Seat 6: matiko09 ($109.60 in chips) 
Seat 7: mycka86 ($100 in chips) 
Seat 8: ardo888 ($100 in chips) 
Seat 9: JKVSAK85 ($106.53 in chips) 
matiko09: posts small blind $0.50
mycka86: posts big blind $1
phil_cheng: sits out 
ozone2003: sits out 
r4mz3s: posts the ante $0.20
CI58: posts the ante $0.20
flk.Dasas: posts the ante $0.20
matiko09: posts the ante $0.20
mycka86: posts the ante $0.20
ardo888: posts the ante $0.20
JKVSAK85: posts the ante $0.20
*** HOLE CARDS ***
Dealt to matiko09 [As Ks]
ardo888: folds 
JKVSAK85: folds 
r4mz3s: folds 
CI58: raises $1.50 to $2.50
flk.Dasas: folds 
matiko09: raises $7.50 to $10
mycka86: folds 
CI58: calls $7.50
*** FLOP *** [Qs 4h Jd]
matiko09: bets $6.59
CI58: folds 
Uncalled bet ($6.59) returned to matiko09
matiko09 collected $21.28 from pot
matiko09: doesn't show hand 
*** SUMMARY ***
Total pot $22.40 | Rake $1.12 
Board [Qs 4h Jd]
Seat 1: r4mz3s folded before Flop (didn't bet)
Seat 4: CI58 folded on the Flop
Seat 5: flk.Dasas (button) folded before Flop (didn't bet)
Seat 6: matiko09 (small blind) collected ($21.28)
Seat 7: mycka86 (big blind) folded before Flop
Seat 8: ardo888 folded before Flop (didn't bet)
Seat 9: JKVSAK85 folded before Flop (didn't bet)





PokerStars Hand #155300803612:  Hold'em No Limit ($0.50/$1.00 USD) - 2016/06/28 16:03:41 CET [2016/06/28 10:03:41 ET]
Table 'Kamenyar' 9-max Seat #1 is the button
Seat 1: Rafaello18 ($181.09 in chips) 
Seat 2: ozone2003 ($100 in chips) 
Seat 3: r4mz3s ($100 in chips) 
Seat 4: f1reworks ($224.41 in chips) 
Seat 5: bwly520 ($351.48 in chips) 
Seat 6: matiko09 ($100 in chips) 
Seat 8: sanpidk ($107.63 in chips) 
ozone2003: posts small blind $0.50
r4mz3s: posts big blind $1
Racushniak: sits out 
pyromid: sits out 
*** HOLE CARDS ***
Dealt to matiko09 [Kc 4d]
f1reworks: folds 
bwly520: folds 
matiko09: folds 
sanpidk: folds 
Rafaello18: raises $1.50 to $2.50
ozone2003: folds 
r4mz3s: calls $1.50
*** FLOP *** [4h Tc Qc]
r4mz3s: checks 
Rafaello18: checks 
*** TURN *** [4h Tc Qc] [5s]
r4mz3s: checks 
Rafaello18: checks 
*** RIVER *** [4h Tc Qc 5s] [Qh]
r4mz3s: checks 
Rafaello18: checks 
*** SHOW DOWN ***
r4mz3s: shows [7c 7h] (two pair, Queens and Sevens)
Rafaello18: shows [8h 8s] (two pair, Queens and Eights)
Rafaello18 collected $5.22 from pot
*** SUMMARY ***
Total pot $5.50 | Rake $0.28 
Board [4h Tc Qc 5s Qh]
Seat 1: Rafaello18 (button) showed [8h 8s] and won ($5.22) with two pair, Queens and Eights
Seat 2: ozone2003 (small blind) folded before Flop
Seat 3: r4mz3s (big blind) showed [7c 7h] and lost with two pair, Queens and Sevens
Seat 4: f1reworks folded before Flop (didn't bet)
Seat 5: bwly520 folded before Flop (didn't bet)
Seat 6: matiko09 folded before Flop (didn't bet)
Seat 8: sanpidk folded before Flop (didn't bet)





PokerStars Hand #155300805248:  Hold'em No Limit ($0.50/$1.00 USD) - 2016/06/28 16:03:44 CET [2016/06/28 10:03:44 ET]
Table 'Lyyli II' 9-max Seat #2 is the button
Seat 1: tipner ($108.08 in chips) 
Seat 2: CI58 ($100 in chips) 
Seat 3: Racushniak ($100 in chips) 
Seat 4: Greha999 ($157.62 in chips) 
Seat 5: flk.Dasas ($110.50 in chips) 
Seat 6: matiko09 ($117.90 in chips) 
Seat 7: Kukuryzka ($205.86 in chips) 
Seat 8: r4mz3s ($108.67 in chips) 
Seat 9: f1reworks ($104.50 in chips) 
Racushniak: posts small blind $0.50
Greha999: posts big blind $1
*** HOLE CARDS ***
Dealt to matiko09 [5d 7d]
flk.Dasas: raises $2 to $3
matiko09: folds 
Kukuryzka: folds 
r4mz3s: folds 
f1reworks: folds 
tipner: folds 
CI58: folds 
Racushniak: folds 
Greha999: calls $2
*** FLOP *** [Qc Ks 9d]
Greha999: checks 
flk.Dasas: checks 
*** TURN *** [Qc Ks 9d] [5c]
Greha999: bets $3
flk.Dasas: calls $3
*** RIVER *** [Qc Ks 9d 5c] [Qh]
Greha999: checks 
flk.Dasas: checks 
*** SHOW DOWN ***
Greha999: shows [Td Kh] (two pair, Kings and Queens)
flk.Dasas: mucks hand 
Greha999 collected $11.88 from pot
*** SUMMARY ***
Total pot $12.50 | Rake $0.62 
Board [Qc Ks 9d 5c Qh]
Seat 1: tipner folded before Flop (didn't bet)
Seat 2: CI58 (button) folded before Flop (didn't bet)
Seat 3: Racushniak (small blind) folded before Flop
Seat 4: Greha999 (big blind) showed [Td Kh] and won ($11.88) with two pair, Kings and Queens
Seat 5: flk.Dasas mucked [8h 8d]
Seat 6: matiko09 folded before Flop (didn't bet)
Seat 7: Kukuryzka folded before Flop (didn't bet)
Seat 8: r4mz3s folded before Flop (didn't bet)
Seat 9: f1reworks folded before Flop (didn't bet)





PokerStars Hand #155300806961:  Hold'em No Limit ($0.50/$1.00 USD) - 2016/06/28 16:03:47 CET [2016/06/28 10:03:47 ET]
Table 'Dorado II' 9-max Seat #2 is the button
Seat 1: f1reworks ($114.02 in chips) 
Seat 2: vanilica ($100 in chips) 
Seat 4: pyromid ($118.37 in chips) 
Seat 5: KovIFish89 ($114 in chips) 
Seat 6: mycka86 ($100 in chips) 
Seat 7: matiko09 ($107.78 in chips) 
Seat 9: r4mz3s ($100 in chips) 
ghostriderxu will be allowed to play after the button
pyromid: posts small blind $0.50
KovIFish89: posts big blind $1
*** HOLE CARDS ***
Dealt to matiko09 [9s 6h]
mycka86: folds 
matiko09: folds 
r4mz3s: folds 
f1reworks: folds 
vanilica: folds 
pyromid: folds 
Uncalled bet ($0.50) returned to KovIFish89
KovIFish89 collected $1 from pot
KovIFish89: doesn't show hand 
*** SUMMARY ***
Total pot $1 | Rake $0 
Seat 1: f1reworks folded before Flop (didn't bet)
Seat 2: vanilica (button) folded before Flop (didn't bet)
Seat 4: pyromid (small blind) folded before Flop
Seat 5: KovIFish89 (big blind) collected ($1)
Seat 6: mycka86 folded before Flop (didn't bet)
Seat 7: matiko09 folded before Flop (didn't bet)
Seat 9: r4mz3s folded before Flop (didn't bet)





PokerStars Hand #155300812921:  Hold'em No Limit ($0.25/$0.50 USD) - 2016/06/28 16:03:58 CET [2016/06/28 10:03:58 ET]
Table 'Antonia II' 9-max Seat #4 is the button
Seat 1: Domotirko228 ($55.50 in chips) 
Seat 2: St.LaCoste ($55.21 in chips) 
Seat 3: matiko09 ($55.50 in chips) 
Seat 4: app1e_j@ck ($52.54 in chips) 
Seat 6: ardo888 ($69.87 in chips) 
Seat 7: Kukuryzka ($50 in chips) 
ardo888: posts small blind $0.25
Kukuryzka: posts big blind $0.50
bratbugor: sits out 
*** HOLE CARDS ***
Dealt to matiko09 [7c 3h]
Domotirko228: folds 
St.LaCoste: raises $1 to $1.50
SumPosad joins the table at seat #5 
matiko09: folds 
app1e_j@ck: folds 
ardo888: folds 
Kukuryzka: folds 
Uncalled bet ($1) returned to St.LaCoste
St.LaCoste collected $1.25 from pot
St.LaCoste: doesn't show hand 
*** SUMMARY ***
Total pot $1.25 | Rake $0 
Seat 1: Domotirko228 folded before Flop (didn't bet)
Seat 2: St.LaCoste collected ($1.25)
Seat 3: matiko09 folded before Flop (didn't bet)
Seat 4: app1e_j@ck (button) folded before Flop (didn't bet)
Seat 6: ardo888 (small blind) folded before Flop
Seat 7: Kukuryzka (big blind) folded before Flop





PokerStars Hand #155300814892:  Hold'em No Limit ($0.50/$1.00 USD) - 2016/06/28 16:04:02 CET [2016/06/28 10:04:02 ET]
Table 'Dorado II' 9-max Seat #4 is the button
Seat 1: f1reworks ($114.02 in chips) 
Seat 2: vanilica ($100 in chips) 
Seat 3: ghostriderxu ($100 in chips) 
Seat 4: pyromid ($117.87 in chips) 
Seat 5: KovIFish89 ($114.50 in chips) 
Seat 6: mycka86 ($100 in chips) 
Seat 7: matiko09 ($107.78 in chips) 
Seat 9: r4mz3s ($100 in chips) 
KovIFish89: posts small blind $0.50
mycka86: posts big blind $1
ghostriderxu: posts small & big blinds $1.50
*** HOLE CARDS ***
Dealt to matiko09 [9s 6s]
matiko09: folds 
r4mz3s: folds 
f1reworks: folds 
vanilica: folds 
ghostriderxu: raises $2 to $3
pyromid: folds 
KovIFish89: folds 
mycka86: folds 
Uncalled bet ($2) returned to ghostriderxu
ghostriderxu collected $3 from pot
ghostriderxu: doesn't show hand 
*** SUMMARY ***
Total pot $3 | Rake $0 
Seat 1: f1reworks folded before Flop (didn't bet)
Seat 2: vanilica folded before Flop (didn't bet)
Seat 3: ghostriderxu collected ($3)
Seat 4: pyromid (button) folded before Flop (didn't bet)
Seat 5: KovIFish89 (small blind) folded before Flop
Seat 6: mycka86 (big blind) folded before Flop
Seat 7: matiko09 folded before Flop (didn't bet)
Seat 9: r4mz3s folded before Flop (didn't bet)





PokerStars Hand #155300821644:  Hold'em No Limit ($0.25/$0.50 USD) - 2016/06/28 16:04:15 CET [2016/06/28 10:04:15 ET]
Table 'Konkolya II' 9-max Seat #4 is the button
Seat 1: RvPersie ($77.33 in chips) 
Seat 2: app1e_j@ck ($50 in chips) 
Seat 3: Vedpapa ($50 in chips) 
Seat 4: seblafstian ($51.31 in chips) 
Seat 5: zoofu97 ($53.26 in chips) 
Seat 6: fudzi ($111.05 in chips) 
Seat 7: mixer29 ($53.98 in chips) 
Seat 8: matiko09 ($50.75 in chips) 
Seat 9: Xx7-Zeus-7xX ($41.03 in chips) 
zoofu97: posts small blind $0.25
fudzi: posts big blind $0.50
*** HOLE CARDS ***
Dealt to matiko09 [Td Js]
mixer29: folds 
matiko09: folds 
Xx7-Zeus-7xX: folds 
RvPersie: folds 
app1e_j@ck: folds 
Vedpapa: folds 
seblafstian: raises $1 to $1.50
zoofu97: folds 
fudzi: folds 
Uncalled bet ($1) returned to seblafstian
seblafstian collected $1.25 from pot
seblafstian: doesn't show hand 
*** SUMMARY ***
Total pot $1.25 | Rake $0 
Seat 1: RvPersie folded before Flop (didn't bet)
Seat 2: app1e_j@ck folded before Flop (didn't bet)
Seat 3: Vedpapa folded before Flop (didn't bet)
Seat 4: seblafstian (button) collected ($1.25)
Seat 5: zoofu97 (small blind) folded before Flop
Seat 6: fudzi (big blind) folded before Flop
Seat 7: mixer29 folded before Flop (didn't bet)
Seat 8: matiko09 folded before Flop (didn't bet)
Seat 9: Xx7-Zeus-7xX folded before Flop (didn't bet)





PokerStars Hand #155300824316:  Hold'em No Limit ($0.25/$0.50 USD) - 2016/06/28 16:04:20 CET [2016/06/28 10:04:20 ET]
Table 'Utra' 9-max Seat #7 is the button
Seat 1: ardo888 ($57.89 in chips) 
Seat 2: matiko09 ($92.62 in chips) 
Seat 4: myatiy 96 ($50 in chips) 
Seat 5: baoyu4749892 ($36.12 in chips) 
Seat 6: Franky77200 ($43.35 in chips) 
Seat 7: el.suertero ($60.71 in chips) 
Seat 8: fudzi ($50 in chips) 
Seat 9: Kukuryzka ($49.50 in chips) 
fudzi: posts small blind $0.25
Kukuryzka: posts big blind $0.50
mycka86: sits out 
ardo888: posts the ante $0.10
matiko09: posts the ante $0.10
myatiy 96: posts the ante $0.10
baoyu4749892: posts the ante $0.10
Franky77200: posts the ante $0.10
el.suertero: posts the ante $0.10
fudzi: posts the ante $0.10
Kukuryzka: posts the ante $0.10
*** HOLE CARDS ***
Dealt to matiko09 [Td 9s]
ardo888: folds 
matiko09: folds 
myatiy 96: folds 
baoyu4749892: raises $0.50 to $1
Franky77200: folds 
el.suertero: raises $3.50 to $4.50
fudzi: folds 
Kukuryzka: folds 
baoyu4749892: folds 
Uncalled bet ($3.50) returned to el.suertero
el.suertero collected $3.55 from pot
el.suertero: doesn't show hand 
*** SUMMARY ***
Total pot $3.55 | Rake $0 
Seat 1: ardo888 folded before Flop (didn't bet)
Seat 2: matiko09 folded before Flop (didn't bet)
Seat 4: myatiy 96 folded before Flop (didn't bet)
Seat 5: baoyu4749892 folded before Flop
Seat 6: Franky77200 folded before Flop (didn't bet)
Seat 7: el.suertero (button) collected ($3.55)
Seat 8: fudzi (small blind) folded before Flop
Seat 9: Kukuryzka (big blind) folded before Flop





PokerStars Hand #155300829969:  Hold'em No Limit ($0.50/$1.00 USD) - 2016/06/28 16:04:30 CET [2016/06/28 10:04:30 ET]
Table 'Dorado II' 9-max Seat #5 is the button
Seat 1: f1reworks ($114.02 in chips) 
Seat 2: vanilica ($100 in chips) 
Seat 3: ghostriderxu ($101.50 in chips) 
Seat 4: pyromid ($117.87 in chips) 
Seat 5: KovIFish89 ($114 in chips) 
Seat 6: mycka86 ($100 in chips) 
Seat 7: matiko09 ($107.78 in chips) 
Seat 9: r4mz3s ($100 in chips) 
mycka86: posts small blind $0.50
matiko09: posts big blind $1
flk.Dasas: sits out 
*** HOLE CARDS ***
Dealt to matiko09 [9h 7s]
r4mz3s: folds 
f1reworks: folds 
vanilica: folds 
ghostriderxu: folds 
pyromid: folds 
KovIFish89: raises $1 to $2
mycka86: folds 
matiko09: folds 
Uncalled bet ($1) returned to KovIFish89
KovIFish89 collected $2.50 from pot
KovIFish89: doesn't show hand 
*** SUMMARY ***
Total pot $2.50 | Rake $0 
Seat 1: f1reworks folded before Flop (didn't bet)
Seat 2: vanilica folded before Flop (didn't bet)
Seat 3: ghostriderxu folded before Flop (didn't bet)
Seat 4: pyromid folded before Flop (didn't bet)
Seat 5: KovIFish89 (button) collected ($2.50)
Seat 6: mycka86 (small blind) folded before Flop
Seat 7: matiko09 (big blind) folded before Flop
Seat 9: r4mz3s folded before Flop (didn't bet)





PokerStars Hand #155300830826:  Hold'em No Limit ($0.50/$1.00 USD) - 2016/06/28 16:04:32 CET [2016/06/28 10:04:32 ET]
Table 'Kamenyar' 9-max Seat #2 is the button
Seat 1: Rafaello18 ($183.81 in chips) 
Seat 2: ozone2003 ($100 in chips) 
Seat 3: r4mz3s ($100 in chips) 
Seat 4: f1reworks ($224.41 in chips) 
Seat 5: bwly520 ($351.48 in chips) 
Seat 6: matiko09 ($100 in chips) 
Seat 8: sanpidk ($107.63 in chips) 
r4mz3s: posts small blind $0.50
f1reworks: posts big blind $1
Racushniak: sits out 
pyromid: sits out 
*** HOLE CARDS ***
Dealt to matiko09 [2s 9h]
bwly520: raises $1.25 to $2.25
matiko09: folds 
sanpidk: raises $4.75 to $7
Rafaello18: folds 
ozone2003: calls $7
r4mz3s: folds 
f1reworks: folds 
bwly520: calls $4.75
*** FLOP *** [5s 3d 6s]
bwly520: checks 
sanpidk: checks 
ozone2003: checks 
*** TURN *** [5s 3d 6s] [Js]
bwly520: checks 
sanpidk: bets $14.50
ozone2003: calls $14.50
bwly520: folds 
*** RIVER *** [5s 3d 6s Js] [Jh]
sanpidk: checks 
ozone2003: checks 
*** SHOW DOWN ***
sanpidk: shows [Jc Kc] (three of a kind, Jacks)
ozone2003: mucks hand 
sanpidk collected $49 from pot
*** SUMMARY ***
Total pot $51.50 | Rake $2.50 
Board [5s 3d 6s Js Jh]
Seat 1: Rafaello18 folded before Flop (didn't bet)
Seat 2: ozone2003 (button) mucked [4h 4d]
Seat 3: r4mz3s (small blind) folded before Flop
Seat 4: f1reworks (big blind) folded before Flop
Seat 5: bwly520 folded on the Turn
Seat 6: matiko09 folded before Flop (didn't bet)
Seat 8: sanpidk showed [Jc Kc] and won ($49) with three of a kind, Jacks





PokerStars Hand #155300831970:  Hold'em No Limit ($0.50/$1.00 USD) - 2016/06/28 16:04:34 CET [2016/06/28 10:04:34 ET]
Table 'Charybdis II' 9-max Seat #6 is the button
Seat 1: r4mz3s ($165.50 in chips) 
Seat 4: CI58 ($132.53 in chips) 
Seat 5: flk.Dasas ($106.70 in chips) 
Seat 6: matiko09 ($120.68 in chips) 
Seat 7: mycka86 ($100 in chips) 
Seat 9: JKVSAK85 ($106.33 in chips) 
mycka86: posts small blind $0.50
ardo888: is sitting out 
JKVSAK85: posts big blind $1
phil_cheng: sits out 
ozone2003: sits out 
r4mz3s: posts the ante $0.20
CI58: posts the ante $0.20
flk.Dasas: posts the ante $0.20
matiko09: posts the ante $0.20
mycka86: posts the ante $0.20
JKVSAK85: posts the ante $0.20
*** HOLE CARDS ***
Dealt to matiko09 [Qs 7d]
r4mz3s: folds 
ardo888 leaves the table
CI58: folds 
chenconhaste joins the table at seat #8 
flk.Dasas: folds 
matiko09: folds 
mycka86: folds 
Uncalled bet ($0.50) returned to JKVSAK85
JKVSAK85 collected $2.20 from pot
*** SUMMARY ***
Total pot $2.20 | Rake $0 
Seat 1: r4mz3s folded before Flop (didn't bet)
Seat 4: CI58 folded before Flop (didn't bet)
Seat 5: flk.Dasas folded before Flop (didn't bet)
Seat 6: matiko09 (button) folded before Flop (didn't bet)
Seat 7: mycka86 (small blind) folded before Flop
Seat 9: JKVSAK85 (big blind) collected ($2.20)





PokerStars Hand #155300836971:  Hold'em No Limit ($0.25/$0.50 USD) - 2016/06/28 16:04:43 CET [2016/06/28 10:04:43 ET]
Table 'Antonia II' 9-max Seat #6 is the button
Seat 1: Domotirko228 ($55.50 in chips) 
Seat 2: St.LaCoste ($55.96 in chips) 
Seat 3: matiko09 ($55.50 in chips) 
Seat 4: app1e_j@ck ($52.54 in chips) 
Seat 6: ardo888 ($69.62 in chips) 
Seat 7: Kukuryzka ($49.50 in chips) 
Seat 9: bratbugor ($50.75 in chips) 
Kukuryzka: posts small blind $0.25
bratbugor: posts big blind $0.50
*** HOLE CARDS ***
Dealt to matiko09 [Qd 3d]
Domotirko228: folds 
St.LaCoste: folds 
matiko09: folds 
app1e_j@ck: folds 
ardo888: folds 
Kukuryzka: folds 
Uncalled bet ($0.25) returned to bratbugor
bratbugor collected $0.50 from pot
bratbugor: doesn't show hand 
*** SUMMARY ***
Total pot $0.50 | Rake $0 
Seat 1: Domotirko228 folded before Flop (didn't bet)
Seat 2: St.LaCoste folded before Flop (didn't bet)
Seat 3: matiko09 folded before Flop (didn't bet)
Seat 4: app1e_j@ck folded before Flop (didn't bet)
Seat 6: ardo888 (button) folded before Flop (didn't bet)
Seat 7: Kukuryzka (small blind) folded before Flop
Seat 9: bratbugor (big blind) collected ($0.50)





PokerStars Hand #155300838515:  Hold'em No Limit ($0.50/$1.00 USD) - 2016/06/28 16:04:46 CET [2016/06/28 10:04:46 ET]
Table 'Dorado II' 9-max Seat #6 is the button
Seat 1: f1reworks ($114.02 in chips) 
Seat 2: vanilica ($100 in chips) 
Seat 3: ghostriderxu ($101.50 in chips) 
Seat 4: pyromid ($117.87 in chips) 
Seat 5: KovIFish89 ($115.50 in chips) 
Seat 6: mycka86 ($100 in chips) 
Seat 7: matiko09 ($106.78 in chips) 
Seat 8: flk.Dasas ($100 in chips) 
Seat 9: r4mz3s ($100 in chips) 
matiko09: posts small blind $0.50
flk.Dasas: posts big blind $1
*** HOLE CARDS ***
Dealt to matiko09 [5d 7c]
r4mz3s: folds 
f1reworks: raises $2 to $3
vanilica: folds 
ghostriderxu: calls $3
pyromid: folds 
KovIFish89: folds 
mycka86: folds 
matiko09: folds 
flk.Dasas: calls $2
*** FLOP *** [3h 8s 6d]
flk.Dasas: checks 
f1reworks: bets $7
ghostriderxu: calls $7
flk.Dasas: folds 
*** TURN *** [3h 8s 6d] [Td]
f1reworks: checks 
ghostriderxu: checks 
*** RIVER *** [3h 8s 6d Td] [7s]
f1reworks: bets $17
ghostriderxu: folds 
Uncalled bet ($17) returned to f1reworks
f1reworks collected $22.32 from pot
f1reworks: doesn't show hand 
*** SUMMARY ***
Total pot $23.50 | Rake $1.18 
Board [3h 8s 6d Td 7s]
Seat 1: f1reworks collected ($22.32)
Seat 2: vanilica folded before Flop (didn't bet)
Seat 3: ghostriderxu folded on the River
Seat 4: pyromid folded before Flop (didn't bet)
Seat 5: KovIFish89 folded before Flop (didn't bet)
Seat 6: mycka86 (button) folded before Flop (didn't bet)
Seat 7: matiko09 (small blind) folded before Flop
Seat 8: flk.Dasas (big blind) folded on the Flop
Seat 9: r4mz3s folded before Flop (didn't bet)





PokerStars Hand #155300846465:  Hold'em No Limit ($0.25/$0.50 USD) - 2016/06/28 16:05:01 CET [2016/06/28 10:05:01 ET]
Table 'Utra' 9-max Seat #8 is the button
Seat 1: ardo888 ($57.79 in chips) 
Seat 2: matiko09 ($92.52 in chips) 
Seat 4: myatiy 96 ($50 in chips) 
Seat 5: baoyu4749892 ($35.02 in chips) 
Seat 6: Franky77200 ($43.25 in chips) 
Seat 7: el.suertero ($63.16 in chips) 
Seat 8: fudzi ($50 in chips) 
Seat 9: Kukuryzka ($50 in chips) 
Kukuryzka: posts small blind $0.25
ardo888: posts big blind $0.50
mycka86: sits out 
ardo888: posts the ante $0.10
matiko09: posts the ante $0.10
myatiy 96: posts the ante $0.10
baoyu4749892: posts the ante $0.10
Franky77200: posts the ante $0.10
el.suertero: posts the ante $0.10
fudzi: posts the ante $0.10
Kukuryzka: posts the ante $0.10
*** HOLE CARDS ***
Dealt to matiko09 [8d 5s]
matiko09: folds 
myatiy 96: folds 
baoyu4749892: folds 
Franky77200: folds 
el.suertero: folds 
fudzi: folds 
Kukuryzka: folds 
Uncalled bet ($0.25) returned to ardo888
ardo888 collected $1.30 from pot
ardo888: doesn't show hand 
*** SUMMARY ***
Total pot $1.30 | Rake $0 
Seat 1: ardo888 (big blind) collected ($1.30)
Seat 2: matiko09 folded before Flop (didn't bet)
Seat 4: myatiy 96 folded before Flop (didn't bet)
Seat 5: baoyu4749892 folded before Flop (didn't bet)
Seat 6: Franky77200 folded before Flop (didn't bet)
Seat 7: el.suertero folded before Flop (didn't bet)
Seat 8: fudzi (button) folded before Flop (didn't bet)
Seat 9: Kukuryzka (small blind) folded before Flop





PokerStars Hand #155300848997:  Hold'em No Limit ($0.50/$1.00 USD) - 2016/06/28 16:05:05 CET [2016/06/28 10:05:05 ET]
Table 'Lyyli II' 9-max Seat #3 is the button
Seat 1: tipner ($108.08 in chips) 
Seat 2: CI58 ($100 in chips) 
Seat 3: Racushniak ($100 in chips) 
Seat 4: Greha999 ($163.50 in chips) 
Seat 5: flk.Dasas ($104.50 in chips) 
Seat 6: matiko09 ($117.90 in chips) 
Seat 7: Kukuryzka ($205.86 in chips) 
Seat 8: r4mz3s ($108.67 in chips) 
Seat 9: f1reworks ($104.50 in chips) 
Greha999: posts small blind $0.50
flk.Dasas: posts big blind $1
*** HOLE CARDS ***
Dealt to matiko09 [As 9s]
matiko09: folds 
Kukuryzka: raises $2 to $3
r4mz3s: folds 
f1reworks: folds 
tipner: folds 
CI58: folds 
Racushniak: folds 
Greha999: calls $2.50
flk.Dasas: folds 
*** FLOP *** [Ks 8h Jc]
Greha999: checks 
Kukuryzka: bets $3.32
Greha999: calls $3.32
*** TURN *** [Ks 8h Jc] [9h]
Greha999: checks 
Kukuryzka: bets $8.81
Greha999: calls $8.81
*** RIVER *** [Ks 8h Jc 9h] [8s]
Greha999: checks 
Kukuryzka: checks 
*** SHOW DOWN ***
Greha999: shows [Kd Tc] (two pair, Kings and Eights)
Kukuryzka: shows [Th Kh] (two pair, Kings and Eights)
Greha999 collected $14.85 from pot
Kukuryzka collected $14.85 from pot
*** SUMMARY ***
Total pot $31.26 | Rake $1.56 
Board [Ks 8h Jc 9h 8s]
Seat 1: tipner folded before Flop (didn't bet)
Seat 2: CI58 folded before Flop (didn't bet)
Seat 3: Racushniak (button) folded before Flop (didn't bet)
Seat 4: Greha999 (small blind) showed [Kd Tc] and won ($14.85) with two pair, Kings and Eights
Seat 5: flk.Dasas (big blind) folded before Flop
Seat 6: matiko09 folded before Flop (didn't bet)
Seat 7: Kukuryzka showed [Th Kh] and won ($14.85) with two pair, Kings and Eights
Seat 8: r4mz3s folded before Flop (didn't bet)
Seat 9: f1reworks folded before Flop (didn't bet)





PokerStars Hand #155300849134:  Hold'em No Limit ($0.50/$1.00 USD) - 2016/06/28 16:05:05 CET [2016/06/28 10:05:05 ET]
Table 'Charybdis II' 9-max Seat #7 is the button
Seat 1: r4mz3s ($165.30 in chips) 
Seat 4: CI58 ($132.33 in chips) 
Seat 5: flk.Dasas ($106.50 in chips) 
Seat 6: matiko09 ($120.48 in chips) 
Seat 7: mycka86 ($100 in chips) 
Seat 9: JKVSAK85 ($107.83 in chips) 
chenconhaste will be allowed to play after the button
JKVSAK85: posts small blind $0.50
r4mz3s: posts big blind $1
phil_cheng: sits out 
ozone2003: sits out 
r4mz3s: posts the ante $0.20
CI58: posts the ante $0.20
flk.Dasas: posts the ante $0.20
matiko09: posts the ante $0.20
mycka86: posts the ante $0.20
JKVSAK85: posts the ante $0.20
*** HOLE CARDS ***
Dealt to matiko09 [Jd Ts]
CI58: folds 
flk.Dasas: raises $3 to $4
matiko09: folds 
mycka86: folds 
JKVSAK85: folds 
r4mz3s: folds 
Uncalled bet ($3) returned to flk.Dasas
flk.Dasas collected $3.70 from pot
flk.Dasas: doesn't show hand 
*** SUMMARY ***
Total pot $3.70 | Rake $0 
Seat 1: r4mz3s (big blind) folded before Flop
Seat 4: CI58 folded before Flop (didn't bet)
Seat 5: flk.Dasas collected ($3.70)
Seat 6: matiko09 folded before Flop (didn't bet)
Seat 7: mycka86 (button) folded before Flop (didn't bet)
Seat 9: JKVSAK85 (small blind) folded before Flop





PokerStars Hand #155300861735:  Hold'em No Limit ($0.25/$0.50 USD) - 2016/06/28 16:05:29 CET [2016/06/28 10:05:29 ET]
Table 'Thyestes II' 9-max Seat #8 is the button
Seat 1: ardo888 ($60.17 in chips) 
Seat 2: matiko09 ($50 in chips) 
Seat 3: seblafstian ($50.75 in chips) 
Seat 4: bratbugor ($55.55 in chips) 
Seat 5: St.LaCoste ($49.25 in chips) 
Seat 6: superior_pl ($43.18 in chips) 
Seat 7: Vedpapa ($68.63 in chips) 
Seat 8: Azzaj91 ($50.41 in chips) 
ardo888: posts small blind $0.25
matiko09: posts big blind $0.50
*** HOLE CARDS ***
Dealt to matiko09 [5s 3c]
seblafstian: raises $1 to $1.50
bratbugor: calls $1.50
St.LaCoste: folds 
superior_pl: folds 
Vedpapa: folds 
Azzaj91: folds 
ardo888: folds 
matiko09: folds 
*** FLOP *** [7s Ad 7c]
seblafstian: bets $2.13
bratbugor: calls $2.13
*** TURN *** [7s Ad 7c] [6d]
seblafstian: checks 
bratbugor: bets $5.41
seblafstian: folds 
Uncalled bet ($5.41) returned to bratbugor
bratbugor collected $7.61 from pot
bratbugor: doesn't show hand 
*** SUMMARY ***
Total pot $8.01 | Rake $0.40 
Board [7s Ad 7c 6d]
Seat 1: ardo888 (small blind) folded before Flop
Seat 2: matiko09 (big blind) folded before Flop
Seat 3: seblafstian folded on the Turn
Seat 4: bratbugor collected ($7.61)
Seat 5: St.LaCoste folded before Flop (didn't bet)
Seat 6: superior_pl folded before Flop (didn't bet)
Seat 7: Vedpapa folded before Flop (didn't bet)
Seat 8: Azzaj91 (button) folded before Flop (didn't bet)





PokerStars Hand #155300865020:  Hold'em No Limit ($0.50/$1.00 USD) - 2016/06/28 16:05:35 CET [2016/06/28 10:05:35 ET]
Table 'Charybdis II' 9-max Seat #9 is the button
Seat 1: r4mz3s ($164.10 in chips) 
Seat 2: phil_cheng ($100 in chips) 
Seat 4: CI58 ($132.13 in chips) 
Seat 5: flk.Dasas ($109 in chips) 
Seat 6: matiko09 ($120.28 in chips) 
Seat 7: mycka86 ($100 in chips) 
Seat 9: JKVSAK85 ($107.13 in chips) 
r4mz3s: posts small blind $0.50
phil_cheng: posts big blind $1
ozone2003: sits out 
chenconhaste: sits out 
r4mz3s: posts the ante $0.20
phil_cheng: posts the ante $0.20
CI58: posts the ante $0.20
flk.Dasas: posts the ante $0.20
matiko09: posts the ante $0.20
mycka86: posts the ante $0.20
JKVSAK85: posts the ante $0.20
*** HOLE CARDS ***
Dealt to matiko09 [Qd As]
CI58: folds 
flk.Dasas: folds 
matiko09: raises $2 to $3
mycka86: folds 
JKVSAK85: folds 
r4mz3s: folds 
phil_cheng: folds 
Uncalled bet ($2) returned to matiko09
matiko09 collected $3.90 from pot
matiko09: doesn't show hand 
*** SUMMARY ***
Total pot $3.90 | Rake $0 
Seat 1: r4mz3s (small blind) folded before Flop
Seat 2: phil_cheng (big blind) folded before Flop
Seat 4: CI58 folded before Flop (didn't bet)
Seat 5: flk.Dasas folded before Flop (didn't bet)
Seat 6: matiko09 collected ($3.90)
Seat 7: mycka86 folded before Flop (didn't bet)
Seat 9: JKVSAK85 (button) folded before Flop (didn't bet)





PokerStars Hand #155300872026:  Hold'em No Limit ($0.25/$0.50 USD) - 2016/06/28 16:05:48 CET [2016/06/28 10:05:48 ET]
Table 'Utra' 9-max Seat #9 is the button
Seat 1: ardo888 ($58.74 in chips) 
Seat 2: matiko09 ($92.42 in chips) 
Seat 4: myatiy 96 ($50 in chips) 
Seat 5: baoyu4749892 ($34.92 in chips) 
Seat 6: Franky77200 ($43.15 in chips) 
Seat 7: el.suertero ($63.06 in chips) 
Seat 8: fudzi ($50 in chips) 
Seat 9: Kukuryzka ($49.65 in chips) 
ardo888: posts small blind $0.25
matiko09: posts big blind $0.50
mycka86: sits out 
ardo888: posts the ante $0.10
matiko09: posts the ante $0.10
myatiy 96: posts the ante $0.10
baoyu4749892: posts the ante $0.10
Franky77200: posts the ante $0.10
el.suertero: posts the ante $0.10
fudzi: posts the ante $0.10
Kukuryzka: posts the ante $0.10
*** HOLE CARDS ***
Dealt to matiko09 [8s 2h]
myatiy 96: folds 
baoyu4749892: folds 
Franky77200: folds 
el.suertero: raises $1 to $1.50
fudzi: folds 
Kukuryzka: raises $3 to $4.50
ardo888: folds 
matiko09: folds 
el.suertero: folds 
Uncalled bet ($3) returned to Kukuryzka
Kukuryzka collected $4.55 from pot
Kukuryzka: doesn't show hand 
*** SUMMARY ***
Total pot $4.55 | Rake $0 
Seat 1: ardo888 (small blind) folded before Flop
Seat 2: matiko09 (big blind) folded before Flop
Seat 4: myatiy 96 folded before Flop (didn't bet)
Seat 5: baoyu4749892 folded before Flop (didn't bet)
Seat 6: Franky77200 folded before Flop (didn't bet)
Seat 7: el.suertero folded before Flop
Seat 8: fudzi folded before Flop (didn't bet)
Seat 9: Kukuryzka (button) collected ($4.55)





PokerStars Hand #155300878997:  Hold'em No Limit ($0.50/$1.00 USD) - 2016/06/28 16:06:01 CET [2016/06/28 10:06:01 ET]
Table 'Charybdis II' 9-max Seat #1 is the button
Seat 1: r4mz3s ($163.40 in chips) 
Seat 2: phil_cheng ($100 in chips) 
Seat 3: ozone2003 ($119.53 in chips) 
Seat 4: CI58 ($131.93 in chips) 
Seat 5: flk.Dasas ($108.80 in chips) 
Seat 6: matiko09 ($122.98 in chips) 
Seat 7: mycka86 ($100 in chips) 
Seat 9: JKVSAK85 ($106.93 in chips) 
phil_cheng: posts small blind $0.50
ozone2003: posts big blind $1
chenconhaste: sits out 
r4mz3s: posts the ante $0.20
phil_cheng: posts the ante $0.20
ozone2003: posts the ante $0.20
CI58: posts the ante $0.20
flk.Dasas: posts the ante $0.20
matiko09: posts the ante $0.20
mycka86: posts the ante $0.20
JKVSAK85: posts the ante $0.20
*** HOLE CARDS ***
Dealt to matiko09 [Jc 9d]
CI58: folds 
flk.Dasas: folds 
matiko09: folds 
mycka86: raises $2 to $3
JKVSAK85: folds 
r4mz3s: folds 
phil_cheng: folds 
ozone2003: folds 
Uncalled bet ($2) returned to mycka86
mycka86 collected $4.10 from pot
*** SUMMARY ***
Total pot $4.10 | Rake $0 
Seat 1: r4mz3s (button) folded before Flop (didn't bet)
Seat 2: phil_cheng (small blind) folded before Flop
Seat 3: ozone2003 (big blind) folded before Flop
Seat 4: CI58 folded before Flop (didn't bet)
Seat 5: flk.Dasas folded before Flop (didn't bet)
Seat 6: matiko09 folded before Flop (didn't bet)
Seat 7: mycka86 collected ($4.10)
Seat 9: JKVSAK85 folded before Flop (didn't bet)





PokerStars Hand #155300881735:  Hold'em No Limit ($0.25/$0.50 USD) - 2016/06/28 16:06:06 CET [2016/06/28 10:06:06 ET]
Table 'Ajax II' 9-max Seat #6 is the button
Seat 1: omorfadramou ($53.32 in chips) 
Seat 2: SumPosad ($20.12 in chips) 
Seat 4: ardo888 ($50.50 in chips) 
Seat 5: sopir ($50.60 in chips) 
Seat 6: PokerGirl558 ($54.14 in chips) 
Seat 7: myatiy 96 ($53.16 in chips) 
Seat 9: matiko09 ($50 in chips) 
myatiy 96: posts small blind $0.25
bratbugor: is sitting out 
matiko09: posts big blind $0.50
*** HOLE CARDS ***
Dealt to matiko09 [Js Ad]
omorfadramou: folds 
bratbugor leaves the table
SumPosad: folds 
chenconhaste joins the table at seat #8 
ardo888: folds 
sopir: folds 
PokerGirl558: folds 
myatiy 96: raises $1 to $1.50
matiko09: calls $1
*** FLOP *** [2s 6c Ts]
myatiy 96: bets $1.89
matiko09: calls $1.89
*** TURN *** [2s 6c Ts] [4s]
myatiy 96: bets $4.83
matiko09: folds 
Uncalled bet ($4.83) returned to myatiy 96
myatiy 96 collected $6.44 from pot
*** SUMMARY ***
Total pot $6.78 | Rake $0.34 
Board [2s 6c Ts 4s]
Seat 1: omorfadramou folded before Flop (didn't bet)
Seat 2: SumPosad folded before Flop (didn't bet)
Seat 4: ardo888 folded before Flop (didn't bet)
Seat 5: sopir folded before Flop (didn't bet)
Seat 6: PokerGirl558 (button) folded before Flop (didn't bet)
Seat 7: myatiy 96 (small blind) collected ($6.44)
Seat 9: matiko09 (big blind) folded on the Turn





PokerStars Hand #155300885443:  Hold'em No Limit ($0.50/$1.00 USD) - 2016/06/28 16:06:13 CET [2016/06/28 10:06:13 ET]
Table 'Dorado II' 9-max Seat #7 is the button
Seat 1: f1reworks ($126.34 in chips) 
Seat 2: vanilica ($100 in chips) 
Seat 3: ghostriderxu ($91.50 in chips) 
Seat 4: pyromid ($117.87 in chips) 
Seat 5: KovIFish89 ($115.50 in chips) 
Seat 6: mycka86 ($100 in chips) 
Seat 7: matiko09 ($106.28 in chips) 
Seat 8: flk.Dasas ($100 in chips) 
Seat 9: r4mz3s ($100 in chips) 
flk.Dasas: posts small blind $0.50
r4mz3s: posts big blind $1
*** HOLE CARDS ***
Dealt to matiko09 [6h 6c]
f1reworks: folds 
vanilica: folds 
ghostriderxu: folds 
pyromid: folds 
KovIFish89: raises $2 to $3
mycka86: folds 
matiko09: calls $3
flk.Dasas: folds 
r4mz3s: calls $2
*** FLOP *** [Ac 9c 9h]
r4mz3s: checks 
KovIFish89: checks 
matiko09: checks 
*** TURN *** [Ac 9c 9h] [3d]
r4mz3s: checks 
KovIFish89: checks 
matiko09: checks 
*** RIVER *** [Ac 9c 9h 3d] [5c]
r4mz3s: checks 
KovIFish89: checks 
matiko09: checks 
*** SHOW DOWN ***
r4mz3s: shows [Th Ks] (a pair of Nines)
KovIFish89: shows [7d 7c] (two pair, Nines and Sevens)
matiko09: mucks hand 
KovIFish89 collected $9.02 from pot
*** SUMMARY ***
Total pot $9.50 | Rake $0.48 
Board [Ac 9c 9h 3d 5c]
Seat 1: f1reworks folded before Flop (didn't bet)
Seat 2: vanilica folded before Flop (didn't bet)
Seat 3: ghostriderxu folded before Flop (didn't bet)
Seat 4: pyromid folded before Flop (didn't bet)
Seat 5: KovIFish89 showed [7d 7c] and won ($9.02) with two pair, Nines and Sevens
Seat 6: mycka86 folded before Flop (didn't bet)
Seat 7: matiko09 (button) mucked [6h 6c]
Seat 8: flk.Dasas (small blind) folded before Flop
Seat 9: r4mz3s (big blind) showed [Th Ks] and lost with a pair of Nines





PokerStars Hand #155300890314:  Hold'em No Limit ($0.50/$1.00 USD) - 2016/06/28 16:06:22 CET [2016/06/28 10:06:22 ET]
Table 'Kamenyar' 9-max Seat #3 is the button
Seat 1: Rafaello18 ($183.81 in chips) 
Seat 2: ozone2003 ($100 in chips) 
Seat 3: r4mz3s ($100 in chips) 
Seat 4: f1reworks ($223.41 in chips) 
Seat 5: bwly520 ($344.48 in chips) 
Seat 6: matiko09 ($100 in chips) 
Seat 8: sanpidk ($135.13 in chips) 
f1reworks: posts small blind $0.50
bwly520: posts big blind $1
Racushniak: sits out 
pyromid: sits out 
*** HOLE CARDS ***
Dealt to matiko09 [9d 9h]
matiko09: raises $2 to $3
sanpidk: folds 
Rafaello18: folds 
ozone2003: raises $6 to $9
r4mz3s: folds 
f1reworks: folds 
bwly520: folds 
matiko09: folds 
Uncalled bet ($6) returned to ozone2003
ozone2003 collected $7.50 from pot
ozone2003: doesn't show hand 
*** SUMMARY ***
Total pot $7.50 | Rake $0 
Seat 1: Rafaello18 folded before Flop (didn't bet)
Seat 2: ozone2003 collected ($7.50)
Seat 3: r4mz3s (button) folded before Flop (didn't bet)
Seat 4: f1reworks (small blind) folded before Flop
Seat 5: bwly520 (big blind) folded before Flop
Seat 6: matiko09 folded before Flop
Seat 8: sanpidk folded before Flop (didn't bet)





PokerStars Hand #155300889924:  Hold'em No Limit ($0.50/$1.00 USD) - 2016/06/28 16:06:22 CET [2016/06/28 10:06:22 ET]
Table 'Tynka' 9-max Seat #9 is the button
Seat 1: ilaviiitech ($100.50 in chips) 
Seat 2: matiko09 ($100 in chips) 
Seat 5: Tirpo ($100 in chips) 
Seat 6: WDW3 ($100 in chips) 
Seat 8: Bigtomboi ($56.72 in chips) 
Seat 9: duanyucheng ($62.23 in chips) 
ilaviiitech: posts small blind $0.50
matiko09: posts big blind $1
tipner: sits out 
chenconhaste: sits out 
flk.Dasas: sits out 
*** HOLE CARDS ***
Dealt to matiko09 [3h Ks]
Tirpo: folds 
WDW3: folds 
Bigtomboi: folds 
duanyucheng: folds 
ilaviiitech: folds 
Uncalled bet ($0.50) returned to matiko09
matiko09 collected $1 from pot
matiko09: doesn't show hand 
*** SUMMARY ***
Total pot $1 | Rake $0 
Seat 1: ilaviiitech (small blind) folded before Flop
Seat 2: matiko09 (big blind) collected ($1)
Seat 5: Tirpo folded before Flop (didn't bet)
Seat 6: WDW3 folded before Flop (didn't bet)
Seat 8: Bigtomboi folded before Flop (didn't bet)
Seat 9: duanyucheng (button) folded before Flop (didn't bet)





PokerStars Hand #155300891313:  Hold'em No Limit ($0.50/$1.00 USD) - 2016/06/28 16:06:24 CET [2016/06/28 10:06:24 ET]
Table 'Lyyli II' 9-max Seat #4 is the button
Seat 1: tipner ($108.08 in chips) 
Seat 2: CI58 ($100 in chips) 
Seat 3: Racushniak ($100 in chips) 
Seat 4: Greha999 ($163.22 in chips) 
Seat 5: flk.Dasas ($103.50 in chips) 
Seat 6: matiko09 ($117.90 in chips) 
Seat 7: Kukuryzka ($205.58 in chips) 
Seat 8: r4mz3s ($108.67 in chips) 
Seat 9: f1reworks ($104.50 in chips) 
flk.Dasas: posts small blind $0.50
matiko09: posts big blind $1
*** HOLE CARDS ***
Dealt to matiko09 [Ac Qd]
Kukuryzka: folds 
r4mz3s: folds 
f1reworks: folds 
tipner: folds 
CI58: folds 
Racushniak: folds 
Greha999: raises $2 to $3
flk.Dasas: calls $2.50
matiko09: raises $10 to $13
Greha999: folds 
flk.Dasas: folds 
Uncalled bet ($10) returned to matiko09
matiko09 collected $9 from pot
matiko09: doesn't show hand 
*** SUMMARY ***
Total pot $9 | Rake $0 
Seat 1: tipner folded before Flop (didn't bet)
Seat 2: CI58 folded before Flop (didn't bet)
Seat 3: Racushniak folded before Flop (didn't bet)
Seat 4: Greha999 (button) folded before Flop
Seat 5: flk.Dasas (small blind) folded before Flop
Seat 6: matiko09 (big blind) collected ($9)
Seat 7: Kukuryzka folded before Flop (didn't bet)
Seat 8: r4mz3s folded before Flop (didn't bet)
Seat 9: f1reworks folded before Flop (didn't bet)





PokerStars Hand #155300892042:  Hold'em No Limit ($0.25/$0.50 USD) - 2016/06/28 16:06:26 CET [2016/06/28 10:06:26 ET]
Table 'Utra' 9-max Seat #1 is the button
Seat 1: ardo888 ($58.39 in chips) 
Seat 2: matiko09 ($91.82 in chips) 
Seat 3: mycka86 ($50 in chips) 
Seat 4: myatiy 96 ($50 in chips) 
Seat 5: baoyu4749892 ($34.82 in chips) 
Seat 6: Franky77200 ($43.05 in chips) 
Seat 7: el.suertero ($61.46 in chips) 
Seat 8: fudzi ($50 in chips) 
Seat 9: Kukuryzka ($52.60 in chips) 
matiko09: posts small blind $0.25
mycka86: posts big blind $0.50
ardo888: posts the ante $0.10
matiko09: posts the ante $0.10
mycka86: posts the ante $0.10
myatiy 96: posts the ante $0.10
baoyu4749892: posts the ante $0.10
Franky77200: posts the ante $0.10
el.suertero: posts the ante $0.10
fudzi: posts the ante $0.10
Kukuryzka: posts the ante $0.10
*** HOLE CARDS ***
Dealt to matiko09 [Ac 6c]
myatiy 96: folds 
baoyu4749892: folds 
Franky77200: folds 
el.suertero: folds 
fudzi: folds 
Kukuryzka: folds 
ardo888: raises $0.75 to $1.25
matiko09: folds 
mycka86: folds 
Uncalled bet ($0.75) returned to ardo888
ardo888 collected $2.15 from pot
ardo888: doesn't show hand 
*** SUMMARY ***
Total pot $2.15 | Rake $0 
Seat 1: ardo888 (button) collected ($2.15)
Seat 2: matiko09 (small blind) folded before Flop
Seat 3: mycka86 (big blind) folded before Flop
Seat 4: myatiy 96 folded before Flop (didn't bet)
Seat 5: baoyu4749892 folded before Flop (didn't bet)
Seat 6: Franky77200 folded before Flop (didn't bet)
Seat 7: el.suertero folded before Flop (didn't bet)
Seat 8: fudzi folded before Flop (didn't bet)
Seat 9: Kukuryzka folded before Flop (didn't bet)





PokerStars Hand #155300896908:  Hold'em No Limit ($0.50/$1.00 USD) - 2016/06/28 16:06:35 CET [2016/06/28 10:06:35 ET]
Table 'Tynka' 9-max Seat #1 is the button
Seat 1: ilaviiitech ($100 in chips) 
Seat 2: matiko09 ($100.50 in chips) 
Seat 3: tipner ($100 in chips) 
Seat 5: Tirpo ($100 in chips) 
Seat 6: WDW3 ($100 in chips) 
Seat 8: Bigtomboi ($56.72 in chips) 
Seat 9: duanyucheng ($62.23 in chips) 
matiko09: posts small blind $0.50
tipner: posts big blind $1
chenconhaste: sits out 
flk.Dasas: sits out 
*** HOLE CARDS ***
Dealt to matiko09 [Kc 3d]
Tirpo: folds 
WDW3: folds 
Bigtomboi: raises $2.50 to $3.50
duanyucheng: folds 
ilaviiitech: folds 
matiko09: folds 
tipner: folds 
Uncalled bet ($2.50) returned to Bigtomboi
Bigtomboi collected $2.50 from pot
Bigtomboi: doesn't show hand 
*** SUMMARY ***
Total pot $2.50 | Rake $0 
Seat 1: ilaviiitech (button) folded before Flop (didn't bet)
Seat 2: matiko09 (small blind) folded before Flop
Seat 3: tipner (big blind) folded before Flop
Seat 5: Tirpo folded before Flop (didn't bet)
Seat 6: WDW3 folded before Flop (didn't bet)
Seat 8: Bigtomboi collected ($2.50)
Seat 9: duanyucheng folded before Flop (didn't bet)





PokerStars Hand #155300903921:  Hold'em No Limit ($0.50/$1.00 USD) - 2016/06/28 16:06:48 CET [2016/06/28 10:06:48 ET]
Table 'Tynka' 9-max Seat #2 is the button
Seat 1: ilaviiitech ($100 in chips) 
Seat 2: matiko09 ($100 in chips) 
Seat 3: tipner ($100 in chips) 
Seat 4: chenconhaste ($100 in chips) 
Seat 5: Tirpo ($100 in chips) 
Seat 6: WDW3 ($100 in chips) 
Seat 8: Bigtomboi ($58.22 in chips) 
Seat 9: duanyucheng ($62.23 in chips) 
tipner: posts small blind $0.50
chenconhaste: posts big blind $1
flk.Dasas: sits out 
*** HOLE CARDS ***
Dealt to matiko09 [6s 7s]
Tirpo: folds 
WDW3: folds 
Bigtomboi: folds 
duanyucheng: folds 
ilaviiitech: folds 
matiko09: raises $1.27 to $2.27
tipner: folds 
chenconhaste: calls $1.27
*** FLOP *** [Tc 5s Qd]
chenconhaste: checks 
matiko09: bets $3.11
chenconhaste: folds 
Uncalled bet ($3.11) returned to matiko09
matiko09 collected $4.79 from pot
matiko09: doesn't show hand 
*** SUMMARY ***
Total pot $5.04 | Rake $0.25 
Board [Tc 5s Qd]
Seat 1: ilaviiitech folded before Flop (didn't bet)
Seat 2: matiko09 (button) collected ($4.79)
Seat 3: tipner (small blind) folded before Flop
Seat 4: chenconhaste (big blind) folded on the Flop
Seat 5: Tirpo folded before Flop (didn't bet)
Seat 6: WDW3 folded before Flop (didn't bet)
Seat 8: Bigtomboi folded before Flop (didn't bet)
Seat 9: duanyucheng folded before Flop (didn't bet)





PokerStars Hand #155300904948:  Hold'em No Limit ($0.25/$0.50 USD) - 2016/06/28 16:06:50 CET [2016/06/28 10:06:50 ET]
Table 'Utra' 9-max Seat #2 is the button
Seat 1: ardo888 ($59.94 in chips) 
Seat 2: matiko09 ($91.47 in chips) 
Seat 3: mycka86 ($50 in chips) 
Seat 4: myatiy 96 ($50 in chips) 
Seat 5: baoyu4749892 ($34.72 in chips) 
Seat 6: Franky77200 ($42.95 in chips) 
Seat 7: el.suertero ($61.36 in chips) 
Seat 8: fudzi ($50 in chips) 
Seat 9: Kukuryzka ($52.50 in chips) 
mycka86: posts small blind $0.25
myatiy 96: posts big blind $0.50
ardo888: posts the ante $0.10
matiko09: posts the ante $0.10
mycka86: posts the ante $0.10
myatiy 96: posts the ante $0.10
baoyu4749892: posts the ante $0.10
Franky77200: posts the ante $0.10
el.suertero: posts the ante $0.10
fudzi: posts the ante $0.10
Kukuryzka: posts the ante $0.10
*** HOLE CARDS ***
Dealt to matiko09 [3h 3d]
baoyu4749892: folds 
Franky77200: raises $1 to $1.50
el.suertero: folds 
fudzi: folds 
Kukuryzka: folds 
ardo888: folds 
matiko09: calls $1.50
mycka86: raises $4.75 to $6.25
myatiy 96: folds 
Franky77200: calls $4.75
matiko09: calls $4.75
*** FLOP *** [5c 4s 8s]
mycka86: bets $10.52
Franky77200: folds 
matiko09: folds 
Uncalled bet ($10.52) returned to mycka86
mycka86 collected $19.14 from pot
*** SUMMARY ***
Total pot $20.15 | Rake $1.01 
Board [5c 4s 8s]
Seat 1: ardo888 folded before Flop (didn't bet)
Seat 2: matiko09 (button) folded on the Flop
Seat 3: mycka86 (small blind) collected ($19.14)
Seat 4: myatiy 96 (big blind) folded before Flop
Seat 5: baoyu4749892 folded before Flop (didn't bet)
Seat 6: Franky77200 folded on the Flop
Seat 7: el.suertero folded before Flop (didn't bet)
Seat 8: fudzi folded before Flop (didn't bet)
Seat 9: Kukuryzka folded before Flop (didn't bet)





PokerStars Hand #155300906153:  Hold'em No Limit ($0.50/$1.00 USD) - 2016/06/28 16:06:52 CET [2016/06/28 10:06:52 ET]
Table 'Kamenyar' 9-max Seat #4 is the button
Seat 1: Rafaello18 ($183.81 in chips) 
Seat 2: ozone2003 ($104.50 in chips) 
Seat 3: r4mz3s ($100 in chips) 
Seat 4: f1reworks ($222.91 in chips) 
Seat 5: bwly520 ($343.48 in chips) 
Seat 6: matiko09 ($100 in chips) 
Seat 8: sanpidk ($135.13 in chips) 
bwly520: posts small blind $0.50
matiko09: posts big blind $1
Racushniak: sits out 
pyromid: sits out 
*** HOLE CARDS ***
Dealt to matiko09 [Jc Ac]
sanpidk: folds 
Rafaello18: folds 
ozone2003: raises $2 to $3
r4mz3s: folds 
f1reworks: folds 
bwly520: folds 
matiko09: calls $2
*** FLOP *** [Qh 3d 5s]
matiko09: checks 
ozone2003: bets $5.25
matiko09: folds 
Uncalled bet ($5.25) returned to ozone2003
ozone2003 collected $6.18 from pot
ozone2003: doesn't show hand 
*** SUMMARY ***
Total pot $6.50 | Rake $0.32 
Board [Qh 3d 5s]
Seat 1: Rafaello18 folded before Flop (didn't bet)
Seat 2: ozone2003 collected ($6.18)
Seat 3: r4mz3s folded before Flop (didn't bet)
Seat 4: f1reworks (button) folded before Flop (didn't bet)
Seat 5: bwly520 (small blind) folded before Flop
Seat 6: matiko09 (big blind) folded on the Flop
Seat 8: sanpidk folded before Flop (didn't bet)





PokerStars Hand #155300908595:  Hold'em No Limit ($0.50/$1.00 USD) - 2016/06/28 16:06:56 CET [2016/06/28 10:06:56 ET]
Table 'Charybdis II' 9-max Seat #2 is the button
Seat 1: r4mz3s ($163.20 in chips) 
Seat 2: phil_cheng ($100 in chips) 
Seat 3: ozone2003 ($118.33 in chips) 
Seat 4: CI58 ($131.73 in chips) 
Seat 5: flk.Dasas ($108.60 in chips) 
Seat 6: matiko09 ($122.78 in chips) 
Seat 7: mycka86 ($102.90 in chips) 
Seat 9: JKVSAK85 ($106.73 in chips) 
ozone2003: posts small blind $0.50
CI58: posts big blind $1
chenconhaste: sits out 
r4mz3s: posts the ante $0.20
phil_cheng: posts the ante $0.20
ozone2003: posts the ante $0.20
CI58: posts the ante $0.20
flk.Dasas: posts the ante $0.20
matiko09: posts the ante $0.20
mycka86: posts the ante $0.20
JKVSAK85: posts the ante $0.20
*** HOLE CARDS ***
Dealt to matiko09 [Ac 7c]
flk.Dasas: folds 
matiko09: folds 
mycka86: folds 
JKVSAK85: folds 
r4mz3s: folds 
phil_cheng: folds 
ozone2003: raises $1.95 to $2.95
CI58: folds 
Uncalled bet ($1.95) returned to ozone2003
ozone2003 collected $3.60 from pot
ozone2003: doesn't show hand 
*** SUMMARY ***
Total pot $3.60 | Rake $0 
Seat 1: r4mz3s folded before Flop (didn't bet)
Seat 2: phil_cheng (button) folded before Flop (didn't bet)
Seat 3: ozone2003 (small blind) collected ($3.60)
Seat 4: CI58 (big blind) folded before Flop
Seat 5: flk.Dasas folded before Flop (didn't bet)
Seat 6: matiko09 folded before Flop (didn't bet)
Seat 7: mycka86 folded before Flop (didn't bet)
Seat 9: JKVSAK85 folded before Flop (didn't bet)





PokerStars Hand #155300909135:  Hold'em No Limit ($0.25/$0.50 USD) - 2016/06/28 16:06:57 CET [2016/06/28 10:06:57 ET]
Table 'Thyestes II' 9-max Seat #1 is the button
Seat 1: ardo888 ($59.92 in chips) 
Seat 2: matiko09 ($50 in chips) 
Seat 3: seblafstian ($50 in chips) 
Seat 4: bratbugor ($59.53 in chips) 
Seat 5: St.LaCoste ($49.25 in chips) 
Seat 6: superior_pl ($43.18 in chips) 
Seat 7: Vedpapa ($68.63 in chips) 
Seat 8: Azzaj91 ($50.41 in chips) 
matiko09: posts small blind $0.25
seblafstian: posts big blind $0.50
*** HOLE CARDS ***
Dealt to matiko09 [5c 9d]
bratbugor: folds 
St.LaCoste: folds 
superior_pl: folds 
Vedpapa: folds 
Azzaj91: folds 
ardo888: raises $0.75 to $1.25
matiko09: folds 
seblafstian: raises $3.25 to $4.50
ardo888: calls $3.25
*** FLOP *** [8s Ac 4c]
seblafstian: bets $5.27
ardo888: calls $5.27
*** TURN *** [8s Ac 4c] [Jd]
seblafstian: checks 
ardo888: checks 
*** RIVER *** [8s Ac 4c Jd] [Jc]
seblafstian: bets $15.04
ardo888: folds 
Uncalled bet ($15.04) returned to seblafstian
seblafstian collected $18.80 from pot
seblafstian: doesn't show hand 
*** SUMMARY ***
Total pot $19.79 | Rake $0.99 
Board [8s Ac 4c Jd Jc]
Seat 1: ardo888 (button) folded on the River
Seat 2: matiko09 (small blind) folded before Flop
Seat 3: seblafstian (big blind) collected ($18.80)
Seat 4: bratbugor folded before Flop (didn't bet)
Seat 5: St.LaCoste folded before Flop (didn't bet)
Seat 6: superior_pl folded before Flop (didn't bet)
Seat 7: Vedpapa folded before Flop (didn't bet)
Seat 8: Azzaj91 folded before Flop (didn't bet)





PokerStars Hand #155300913264:  Hold'em No Limit ($0.25/$0.50 USD) - 2016/06/28 16:07:05 CET [2016/06/28 10:07:05 ET]
Table 'Ajax II' 9-max Seat #7 is the button
Seat 1: omorfadramou ($53.32 in chips) 
Seat 2: SumPosad ($20.12 in chips) 
Seat 4: ardo888 ($50.50 in chips) 
Seat 5: sopir ($50.60 in chips) 
Seat 6: PokerGirl558 ($54.14 in chips) 
Seat 7: myatiy 96 ($56.21 in chips) 
Seat 9: matiko09 ($50 in chips) 
chenconhaste will be allowed to play after the button
matiko09: posts small blind $0.25
omorfadramou: posts big blind $0.50
*** HOLE CARDS ***
Dealt to matiko09 [4h 5d]
SumPosad: folds 
ardo888: folds 
sopir: folds 
PokerGirl558: folds 
myatiy 96: raises $0.75 to $1.25
matiko09: folds 
omorfadramou: folds 
Uncalled bet ($0.75) returned to myatiy 96
myatiy 96 collected $1.25 from pot
*** SUMMARY ***
Total pot $1.25 | Rake $0 
Seat 1: omorfadramou (big blind) folded before Flop
Seat 2: SumPosad folded before Flop (didn't bet)
Seat 4: ardo888 folded before Flop (didn't bet)
Seat 5: sopir folded before Flop (didn't bet)
Seat 6: PokerGirl558 folded before Flop (didn't bet)
Seat 7: myatiy 96 (button) collected ($1.25)
Seat 9: matiko09 (small blind) folded before Flop





PokerStars Hand #155300918406:  Hold'em No Limit ($0.50/$1.00 USD) - 2016/06/28 16:07:15 CET [2016/06/28 10:07:15 ET]
Table 'Tynka' 9-max Seat #3 is the button
Seat 1: ilaviiitech ($100 in chips) 
Seat 2: matiko09 ($102.52 in chips) 
Seat 3: tipner ($100 in chips) 
Seat 4: chenconhaste ($100 in chips) 
Seat 5: Tirpo ($100 in chips) 
Seat 6: WDW3 ($100 in chips) 
Seat 8: Bigtomboi ($58.22 in chips) 
Seat 9: duanyucheng ($62.23 in chips) 
chenconhaste: posts small blind $0.50
Tirpo: posts big blind $1
flk.Dasas: sits out 
*** HOLE CARDS ***
Dealt to matiko09 [Ks 5c]
WDW3: folds 
Bigtomboi: folds 
duanyucheng: folds 
ilaviiitech: folds 
matiko09: folds 
tipner: raises $1.50 to $2.50
chenconhaste: raises $7.50 to $10
Tirpo: folds 
tipner: folds 
Uncalled bet ($7.50) returned to chenconhaste
chenconhaste collected $6 from pot
*** SUMMARY ***
Total pot $6 | Rake $0 
Seat 1: ilaviiitech folded before Flop (didn't bet)
Seat 2: matiko09 folded before Flop (didn't bet)
Seat 3: tipner (button) folded before Flop
Seat 4: chenconhaste (small blind) collected ($6)
Seat 5: Tirpo (big blind) folded before Flop
Seat 6: WDW3 folded before Flop (didn't bet)
Seat 8: Bigtomboi folded before Flop (didn't bet)
Seat 9: duanyucheng folded before Flop (didn't bet)





PokerStars Hand #155300921841:  Hold'em No Limit ($0.50/$1.00 USD) - 2016/06/28 16:07:21 CET [2016/06/28 10:07:21 ET]
Table 'Lyyli II' 9-max Seat #5 is the button
Seat 1: tipner ($108.08 in chips) 
Seat 2: CI58 ($100 in chips) 
Seat 3: Racushniak ($100 in chips) 
Seat 4: Greha999 ($160.22 in chips) 
Seat 5: flk.Dasas ($100.50 in chips) 
Seat 6: matiko09 ($123.90 in chips) 
Seat 7: Kukuryzka ($205.58 in chips) 
Seat 8: r4mz3s ($108.67 in chips) 
Seat 9: f1reworks ($104.50 in chips) 
matiko09: posts small blind $0.50
Kukuryzka: posts big blind $1
*** HOLE CARDS ***
Dealt to matiko09 [Ks 9h]
r4mz3s: folds 
f1reworks: folds 
tipner: folds 
CI58: folds 
Racushniak: folds 
Greha999: folds 
flk.Dasas: folds 
matiko09: raises $2 to $3
Kukuryzka: calls $2
*** FLOP *** [8h 2s 3s]
matiko09: bets $3.71
Kukuryzka: calls $3.71
*** TURN *** [8h 2s 3s] [As]
matiko09: bets $9
Kukuryzka: folds 
Uncalled bet ($9) returned to matiko09
matiko09 collected $12.75 from pot
matiko09: doesn't show hand 
*** SUMMARY ***
Total pot $13.42 | Rake $0.67 
Board [8h 2s 3s As]
Seat 1: tipner folded before Flop (didn't bet)
Seat 2: CI58 folded before Flop (didn't bet)
Seat 3: Racushniak folded before Flop (didn't bet)
Seat 4: Greha999 folded before Flop (didn't bet)
Seat 5: flk.Dasas (button) folded before Flop (didn't bet)
Seat 6: matiko09 (small blind) collected ($12.75)
Seat 7: Kukuryzka (big blind) folded on the Turn
Seat 8: r4mz3s folded before Flop (didn't bet)
Seat 9: f1reworks folded before Flop (didn't bet)





PokerStars Hand #155300923603:  Hold'em No Limit ($0.50/$1.00 USD) - 2016/06/28 16:07:24 CET [2016/06/28 10:07:24 ET]
Table 'Dorado II' 9-max Seat #8 is the button
Seat 1: f1reworks ($126.34 in chips) 
Seat 2: vanilica ($100 in chips) 
Seat 3: ghostriderxu ($91.50 in chips) 
Seat 4: pyromid ($117.87 in chips) 
Seat 5: KovIFish89 ($121.52 in chips) 
Seat 6: mycka86 ($100 in chips) 
Seat 7: matiko09 ($103.28 in chips) 
Seat 8: flk.Dasas ($100 in chips) 
Seat 9: r4mz3s ($100 in chips) 
r4mz3s: posts small blind $0.50
f1reworks: posts big blind $1
*** HOLE CARDS ***
Dealt to matiko09 [6d 7d]
vanilica: folds 
ghostriderxu: raises $2 to $3
pyromid: calls $3
KovIFish89: folds 
mycka86: folds 
matiko09: calls $3
flk.Dasas: folds 
r4mz3s: folds 
f1reworks: folds 
*** FLOP *** [6s Qc 2c]
ghostriderxu: bets $3.30
pyromid: folds 
matiko09: calls $3.30
*** TURN *** [6s Qc 2c] [Jd]
ghostriderxu: bets $5.50
matiko09: folds 
Uncalled bet ($5.50) returned to ghostriderxu
ghostriderxu collected $16.24 from pot
ghostriderxu: doesn't show hand 
*** SUMMARY ***
Total pot $17.10 | Rake $0.86 
Board [6s Qc 2c Jd]
Seat 1: f1reworks (big blind) folded before Flop
Seat 2: vanilica folded before Flop (didn't bet)
Seat 3: ghostriderxu collected ($16.24)
Seat 4: pyromid folded on the Flop
Seat 5: KovIFish89 folded before Flop (didn't bet)
Seat 6: mycka86 folded before Flop (didn't bet)
Seat 7: matiko09 folded on the Turn
Seat 8: flk.Dasas (button) folded before Flop (didn't bet)
Seat 9: r4mz3s (small blind) folded before Flop





PokerStars Hand #155300926138:  Hold'em No Limit ($0.25/$0.50 USD) - 2016/06/28 16:07:29 CET [2016/06/28 10:07:29 ET]
Table 'Ajax II' 9-max Seat #9 is the button
Seat 1: omorfadramou ($52.82 in chips) 
Seat 2: SumPosad ($20.12 in chips) 
Seat 4: ardo888 ($50.50 in chips) 
Seat 5: sopir ($50.60 in chips) 
Seat 6: PokerGirl558 ($54.14 in chips) 
Seat 7: myatiy 96 ($56.96 in chips) 
Seat 9: matiko09 ($50 in chips) 
omorfadramou: posts small blind $0.25
SumPosad: posts big blind $0.50
chenconhaste: sits out 
*** HOLE CARDS ***
Dealt to matiko09 [8s As]
ardo888: folds 
sopir: raises $1.60 to $2.10
PokerGirl558: folds 
myatiy 96: folds 
matiko09: folds 
omorfadramou: folds 
SumPosad: folds 
Uncalled bet ($1.60) returned to sopir
sopir collected $1.25 from pot
sopir: doesn't show hand 
*** SUMMARY ***
Total pot $1.25 | Rake $0 
Seat 1: omorfadramou (small blind) folded before Flop
Seat 2: SumPosad (big blind) folded before Flop
Seat 4: ardo888 folded before Flop (didn't bet)
Seat 5: sopir collected ($1.25)
Seat 6: PokerGirl558 folded before Flop (didn't bet)
Seat 7: myatiy 96 folded before Flop (didn't bet)
Seat 9: matiko09 (button) folded before Flop (didn't bet)





PokerStars Hand #155300937588:  Hold'em No Limit ($0.50/$1.00 USD) - 2016/06/28 16:07:51 CET [2016/06/28 10:07:51 ET]
Table 'Kamenyar' 9-max Seat #5 is the button
Seat 1: Rafaello18 ($183.81 in chips) 
Seat 2: ozone2003 ($107.68 in chips) 
Seat 3: r4mz3s ($100 in chips) 
Seat 4: f1reworks ($222.91 in chips) 
Seat 5: bwly520 ($342.98 in chips) 
Seat 6: matiko09 ($100 in chips) 
Seat 7: Racushniak ($100 in chips) 
Seat 8: sanpidk ($135.13 in chips) 
matiko09: posts small blind $0.50
Racushniak: posts big blind $1
pyromid: sits out 
*** HOLE CARDS ***
Dealt to matiko09 [3d Kc]
sanpidk: folds 
Rafaello18: raises $1.50 to $2.50
ozone2003: folds 
r4mz3s: folds 
f1reworks: folds 
bwly520: folds 
matiko09: folds 
Racushniak: folds 
Uncalled bet ($1.50) returned to Rafaello18
Rafaello18 collected $2.50 from pot
Rafaello18: doesn't show hand 
*** SUMMARY ***
Total pot $2.50 | Rake $0 
Seat 1: Rafaello18 collected ($2.50)
Seat 2: ozone2003 folded before Flop (didn't bet)
Seat 3: r4mz3s folded before Flop (didn't bet)
Seat 4: f1reworks folded before Flop (didn't bet)
Seat 5: bwly520 (button) folded before Flop (didn't bet)
Seat 6: matiko09 (small blind) folded before Flop
Seat 7: Racushniak (big blind) folded before Flop
Seat 8: sanpidk folded before Flop (didn't bet)





PokerStars Hand #155300942671:  Hold'em No Limit ($0.25/$0.50 USD) - 2016/06/28 16:08:00 CET [2016/06/28 10:08:00 ET]
Table 'Ajax II' 9-max Seat #1 is the button
Seat 1: omorfadramou ($52.57 in chips) 
Seat 2: SumPosad ($19.62 in chips) 
Seat 4: ardo888 ($50.50 in chips) 
Seat 5: sopir ($51.35 in chips) 
Seat 6: PokerGirl558 ($54.14 in chips) 
Seat 7: myatiy 96 ($56.96 in chips) 
Seat 9: matiko09 ($50 in chips) 
SumPosad: posts small blind $0.25
ardo888: posts big blind $0.50
chenconhaste: sits out 
*** HOLE CARDS ***
Dealt to matiko09 [2c Kc]
sopir: folds 
PokerGirl558: folds 
myatiy 96: folds 
matiko09: folds 
omorfadramou: raises $0.58 to $1.08
SumPosad: folds 
ardo888: calls $0.58
*** FLOP *** [3s Ah 3h]
ardo888: checks 
omorfadramou: bets $1.21
ardo888: calls $1.21
*** TURN *** [3s Ah 3h] [6c]
ardo888: checks 
omorfadramou: bets $2.89
ardo888: folds 
Uncalled bet ($2.89) returned to omorfadramou
omorfadramou collected $4.59 from pot
omorfadramou: doesn't show hand 
*** SUMMARY ***
Total pot $4.83 | Rake $0.24 
Board [3s Ah 3h 6c]
Seat 1: omorfadramou (button) collected ($4.59)
Seat 2: SumPosad (small blind) folded before Flop
Seat 4: ardo888 (big blind) folded on the Turn
Seat 5: sopir folded before Flop (didn't bet)
Seat 6: PokerGirl558 folded before Flop (didn't bet)
Seat 7: myatiy 96 folded before Flop (didn't bet)
Seat 9: matiko09 folded before Flop (didn't bet)





PokerStars Hand #155300942817:  Hold'em No Limit ($0.50/$1.00 USD) - 2016/06/28 16:08:00 CET [2016/06/28 10:08:00 ET]
Table 'Tynka' 9-max Seat #4 is the button
Seat 1: ilaviiitech ($100 in chips) 
Seat 2: matiko09 ($102.52 in chips) 
Seat 3: tipner ($100 in chips) 
Seat 4: chenconhaste ($103.50 in chips) 
Seat 5: Tirpo ($100 in chips) 
Seat 6: WDW3 ($100 in chips) 
Seat 8: Bigtomboi ($58.22 in chips) 
Seat 9: duanyucheng ($62.23 in chips) 
Tirpo: posts small blind $0.50
WDW3: posts big blind $1
flk.Dasas: sits out 
*** HOLE CARDS ***
Dealt to matiko09 [5d Jd]
Bigtomboi: folds 
duanyucheng: folds 
ilaviiitech: folds 
matiko09: folds 
tipner: folds 
chenconhaste: raises $1.25 to $2.25
Tirpo: folds 
WDW3: folds 
Uncalled bet ($1.25) returned to chenconhaste
chenconhaste collected $2.50 from pot
*** SUMMARY ***
Total pot $2.50 | Rake $0 
Seat 1: ilaviiitech folded before Flop (didn't bet)
Seat 2: matiko09 folded before Flop (didn't bet)
Seat 3: tipner folded before Flop (didn't bet)
Seat 4: chenconhaste (button) collected ($2.50)
Seat 5: Tirpo (small blind) folded before Flop
Seat 6: WDW3 (big blind) folded before Flop
Seat 8: Bigtomboi folded before Flop (didn't bet)
Seat 9: duanyucheng folded before Flop (didn't bet)





PokerStars Hand #155300953176:  Hold'em No Limit ($0.25/$0.50 USD) - 2016/06/28 16:08:20 CET [2016/06/28 10:08:20 ET]
Table 'Utra' 9-max Seat #3 is the button
Seat 1: ardo888 ($59.84 in chips) 
Seat 2: matiko09 ($85.12 in chips) 
Seat 3: mycka86 ($62.79 in chips) 
Seat 4: myatiy 96 ($50 in chips) 
Seat 5: baoyu4749892 ($34.62 in chips) 
Seat 6: Franky77200 ($36.60 in chips) 
Seat 7: el.suertero ($61.26 in chips) 
Seat 8: fudzi ($50 in chips) 
Seat 9: Kukuryzka ($52.40 in chips) 
myatiy 96: posts small blind $0.25
baoyu4749892: posts big blind $0.50
ardo888: posts the ante $0.10
matiko09: posts the ante $0.10
mycka86: posts the ante $0.10
myatiy 96: posts the ante $0.10
baoyu4749892: posts the ante $0.10
Franky77200: posts the ante $0.10
el.suertero: posts the ante $0.10
fudzi: posts the ante $0.10
Kukuryzka: posts the ante $0.10
*** HOLE CARDS ***
Dealt to matiko09 [Ts Th]
Franky77200: raises $1 to $1.50
el.suertero: folds 
fudzi: folds 
Kukuryzka: folds 
ardo888: raises $2.75 to $4.25
matiko09: calls $4.25
mycka86: folds 
myatiy 96: folds 
baoyu4749892: calls $3.75
Franky77200: raises $7.25 to $11.50
ardo888: folds 
matiko09: folds 
baoyu4749892: calls $7.25
*** FLOP *** [4s 2h 6d]
baoyu4749892: checks 
Franky77200: bets $8
baoyu4749892: calls $8
*** TURN *** [4s 2h 6d] [7d]
baoyu4749892: checks 
Franky77200: bets $17 and is all-in
baoyu4749892: calls $15.02 and is all-in
Uncalled bet ($1.98) returned to Franky77200
*** RIVER *** [4s 2h 6d 7d] [3d]
*** SHOW DOWN ***
baoyu4749892: shows [Qc As] (high card Ace)
Franky77200: shows [Qs Qh] (a pair of Queens)
Franky77200 collected $76.69 from pot
*** SUMMARY ***
Total pot $78.69 | Rake $2 
Board [4s 2h 6d 7d 3d]
Seat 1: ardo888 folded before Flop
Seat 2: matiko09 folded before Flop
Seat 3: mycka86 (button) folded before Flop (didn't bet)
Seat 4: myatiy 96 (small blind) folded before Flop
Seat 5: baoyu4749892 (big blind) showed [Qc As] and lost with high card Ace
Seat 6: Franky77200 showed [Qs Qh] and won ($76.69) with a pair of Queens
Seat 7: el.suertero folded before Flop (didn't bet)
Seat 8: fudzi folded before Flop (didn't bet)
Seat 9: Kukuryzka folded before Flop (didn't bet)





PokerStars Hand #155300956750:  Hold'em No Limit ($0.50/$1.00 USD) - 2016/06/28 16:08:27 CET [2016/06/28 10:08:27 ET]
Table 'Dorado II' 9-max Seat #9 is the button
Seat 1: f1reworks ($125.34 in chips) 
Seat 2: vanilica ($100 in chips) 
Seat 3: ghostriderxu ($101.44 in chips) 
Seat 4: pyromid ($114.87 in chips) 
Seat 5: KovIFish89 ($121.52 in chips) 
Seat 6: mycka86 ($100 in chips) 
Seat 7: matiko09 ($100 in chips) 
Seat 8: flk.Dasas ($100 in chips) 
Seat 9: r4mz3s ($100 in chips) 
f1reworks: posts small blind $0.50
vanilica: posts big blind $1
*** HOLE CARDS ***
Dealt to matiko09 [7h Jh]
ghostriderxu: folds 
pyromid: folds 
KovIFish89: raises $2 to $3
mycka86: folds 
matiko09: folds 
flk.Dasas: folds 
r4mz3s: folds 
f1reworks: folds 
vanilica: folds 
Uncalled bet ($2) returned to KovIFish89
KovIFish89 collected $2.50 from pot
KovIFish89: doesn't show hand 
*** SUMMARY ***
Total pot $2.50 | Rake $0 
Seat 1: f1reworks (small blind) folded before Flop
Seat 2: vanilica (big blind) folded before Flop
Seat 3: ghostriderxu folded before Flop (didn't bet)
Seat 4: pyromid folded before Flop (didn't bet)
Seat 5: KovIFish89 collected ($2.50)
Seat 6: mycka86 folded before Flop (didn't bet)
Seat 7: matiko09 folded before Flop (didn't bet)
Seat 8: flk.Dasas folded before Flop (didn't bet)
Seat 9: r4mz3s (button) folded before Flop (didn't bet)





PokerStars Hand #155300957854:  Hold'em No Limit ($0.50/$1.00 USD) - 2016/06/28 16:08:29 CET [2016/06/28 10:08:29 ET]
Table 'Kamenyar' 9-max Seat #6 is the button
Seat 1: Rafaello18 ($185.31 in chips) 
Seat 2: ozone2003 ($107.68 in chips) 
Seat 3: r4mz3s ($100 in chips) 
Seat 4: f1reworks ($222.91 in chips) 
Seat 5: bwly520 ($342.98 in chips) 
Seat 6: matiko09 ($100 in chips) 
Seat 7: Racushniak ($100 in chips) 
Seat 8: sanpidk ($135.13 in chips) 
Racushniak: posts small blind $0.50
sanpidk: posts big blind $1
pyromid: sits out 
*** HOLE CARDS ***
Dealt to matiko09 [As Ad]
Rafaello18: folds 
ozone2003: folds 
r4mz3s: folds 
f1reworks: folds 
bwly520: raises $2 to $3
matiko09: raises $7 to $10
Racushniak: folds 
sanpidk: folds 
bwly520: folds 
Uncalled bet ($7) returned to matiko09
matiko09 collected $7.50 from pot
matiko09: doesn't show hand 
*** SUMMARY ***
Total pot $7.50 | Rake $0 
Seat 1: Rafaello18 folded before Flop (didn't bet)
Seat 2: ozone2003 folded before Flop (didn't bet)
Seat 3: r4mz3s folded before Flop (didn't bet)
Seat 4: f1reworks folded before Flop (didn't bet)
Seat 5: bwly520 folded before Flop
Seat 6: matiko09 (button) collected ($7.50)
Seat 7: Racushniak (small blind) folded before Flop
Seat 8: sanpidk (big blind) folded before Flop





PokerStars Hand #155300960424:  Hold'em No Limit ($0.50/$1.00 USD) - 2016/06/28 16:08:34 CET [2016/06/28 10:08:34 ET]
Table 'Tynka' 9-max Seat #5 is the button
Seat 1: ilaviiitech ($100 in chips) 
Seat 2: matiko09 ($102.52 in chips) 
Seat 3: tipner ($100 in chips) 
Seat 4: chenconhaste ($105 in chips) 
Seat 5: Tirpo ($100 in chips) 
Seat 6: WDW3 ($100 in chips) 
Seat 7: flk.Dasas ($100 in chips) 
Seat 8: Bigtomboi ($58.22 in chips) 
Seat 9: duanyucheng ($62.23 in chips) 
WDW3: posts small blind $0.50
flk.Dasas: posts big blind $1
*** HOLE CARDS ***
Dealt to matiko09 [9c 8c]
Bigtomboi: raises $3.50 to $4.50
duanyucheng: folds 
ilaviiitech: folds 
matiko09: folds 
tipner: calls $4.50
chenconhaste: folds 
Tirpo: folds 
WDW3: folds 
flk.Dasas: folds 
*** FLOP *** [6d Kc 4s]
Bigtomboi: bets $5
tipner: calls $5
*** TURN *** [6d Kc 4s] [2d]
Bigtomboi: bets $10
tipner: calls $10
*** RIVER *** [6d Kc 4s 2d] [2s]
Bigtomboi: bets $19
tipner: calls $19
*** SHOW DOWN ***
Bigtomboi: shows [3h 2h] (three of a kind, Deuces)
tipner: mucks hand 
Bigtomboi collected $76 from pot
*** SUMMARY ***
Total pot $78.50 | Rake $2.50 
Board [6d Kc 4s 2d 2s]
Seat 1: ilaviiitech folded before Flop (didn't bet)
Seat 2: matiko09 folded before Flop (didn't bet)
Seat 3: tipner mucked [Qh Kh]
Seat 4: chenconhaste folded before Flop (didn't bet)
Seat 5: Tirpo (button) folded before Flop (didn't bet)
Seat 6: WDW3 (small blind) folded before Flop
Seat 7: flk.Dasas (big blind) folded before Flop
Seat 8: Bigtomboi showed [3h 2h] and won ($76) with three of a kind, Deuces
Seat 9: duanyucheng folded before Flop (didn't bet)





PokerStars Hand #155300965502:  Hold'em No Limit ($0.25/$0.50 USD) - 2016/06/28 16:08:43 CET [2016/06/28 10:08:43 ET]
Table 'Thyestes II' 9-max Seat #2 is the button
Seat 1: ardo888 ($50.15 in chips) 
Seat 2: matiko09 ($50 in chips) 
Seat 3: seblafstian ($59.03 in chips) 
Seat 5: St.LaCoste ($49.25 in chips) 
Seat 6: superior_pl ($43.18 in chips) 
Seat 7: Vedpapa ($68.63 in chips) 
Seat 8: Azzaj91 ($50.41 in chips) 
seblafstian: posts small blind $0.25
bratbugor: is sitting out 
St.LaCoste: posts big blind $0.50
*** HOLE CARDS ***
Dealt to matiko09 [4h 7d]
superior_pl: folds 
bratbugor leaves the table
Vedpapa: folds 
Domotirko228 joins the table at seat #4 
Azzaj91: calls $0.50
ardo888: folds 
matiko09: folds 
seblafstian: calls $0.25
St.LaCoste: checks 
*** FLOP *** [4d 7h Ac]
seblafstian: checks 
St.LaCoste: checks 
Azzaj91: checks 
*** TURN *** [4d 7h Ac] [Jc]
seblafstian: checks 
St.LaCoste: checks 
Azzaj91: checks 
*** RIVER *** [4d 7h Ac Jc] [Ad]
seblafstian: bets $1.13
St.LaCoste: folds 
Azzaj91: folds 
Uncalled bet ($1.13) returned to seblafstian
seblafstian collected $1.42 from pot
seblafstian: doesn't show hand 
*** SUMMARY ***
Total pot $1.50 | Rake $0.08 
Board [4d 7h Ac Jc Ad]
Seat 1: ardo888 folded before Flop (didn't bet)
Seat 2: matiko09 (button) folded before Flop (didn't bet)
Seat 3: seblafstian (small blind) collected ($1.42)
Seat 5: St.LaCoste (big blind) folded on the River
Seat 6: superior_pl folded before Flop (didn't bet)
Seat 7: Vedpapa folded before Flop (didn't bet)
Seat 8: Azzaj91 folded on the River





PokerStars Hand #155300967329:  Hold'em No Limit ($0.25/$0.50 USD) - 2016/06/28 16:08:47 CET [2016/06/28 10:08:47 ET]
Table 'Ajax II' 9-max Seat #2 is the button
Seat 1: omorfadramou ($54.87 in chips) 
Seat 2: SumPosad ($19.37 in chips) 
Seat 4: ardo888 ($50 in chips) 
Seat 5: sopir ($51.35 in chips) 
Seat 6: PokerGirl558 ($54.14 in chips) 
Seat 7: myatiy 96 ($56.96 in chips) 
Seat 9: matiko09 ($50 in chips) 
ardo888: posts small blind $0.25
sopir: posts big blind $0.50
chenconhaste: sits out 
*** HOLE CARDS ***
Dealt to matiko09 [6c 7h]
PokerGirl558: calls $0.50
myatiy 96: folds 
matiko09: folds 
omorfadramou: folds 
SumPosad: folds 
ardo888: raises $1.75 to $2.25
sopir: folds 
PokerGirl558: calls $1.75
*** FLOP *** [Ks 4s 2d]
ardo888: checks 
PokerGirl558: checks 
*** TURN *** [Ks 4s 2d] [3d]
ardo888: checks 
PokerGirl558: bets $3
ardo888: calls $3
*** RIVER *** [Ks 4s 2d 3d] [9d]
ardo888: checks 
PokerGirl558: bets $3
ardo888: calls $3
*** SHOW DOWN ***
PokerGirl558: shows [Qh Qc] (a pair of Queens)
ardo888: mucks hand 
PokerGirl558 collected $16.15 from pot
*** SUMMARY ***
Total pot $17 | Rake $0.85 
Board [Ks 4s 2d 3d 9d]
Seat 1: omorfadramou folded before Flop (didn't bet)
Seat 2: SumPosad (button) folded before Flop (didn't bet)
Seat 4: ardo888 (small blind) mucked [Td Th]
Seat 5: sopir (big blind) folded before Flop
Seat 6: PokerGirl558 showed [Qh Qc] and won ($16.15) with a pair of Queens
Seat 7: myatiy 96 folded before Flop (didn't bet)
Seat 9: matiko09 folded before Flop (didn't bet)





PokerStars Hand #155300971979:  Hold'em No Limit ($0.50/$1.00 USD) - 2016/06/28 16:08:55 CET [2016/06/28 10:08:55 ET]
Table 'Lyyli II' 9-max Seat #6 is the button
Seat 1: tipner ($108.08 in chips) 
Seat 2: CI58 ($100 in chips) 
Seat 3: Racushniak ($100 in chips) 
Seat 4: Greha999 ($160.22 in chips) 
Seat 5: flk.Dasas ($100.50 in chips) 
Seat 6: matiko09 ($129.94 in chips) 
Seat 7: Kukuryzka ($198.87 in chips) 
Seat 8: r4mz3s ($108.67 in chips) 
Seat 9: f1reworks ($104.50 in chips) 
Kukuryzka: posts small blind $0.50
r4mz3s: posts big blind $1
*** HOLE CARDS ***
Dealt to matiko09 [4s 5h]
f1reworks: folds 
tipner: folds 
CI58: folds 
Racushniak: folds 
Greha999: folds 
flk.Dasas: folds 
matiko09: folds 
Kukuryzka: raises $1.50 to $2.50
r4mz3s: calls $1.50
*** FLOP *** [3c 8h Qd]
Kukuryzka: bets $2.38
r4mz3s: calls $2.38
*** TURN *** [3c 8h Qd] [Td]
Kukuryzka: bets $6.30
r4mz3s: calls $6.30
*** RIVER *** [3c 8h Qd Td] [5s]
Kukuryzka: checks 
r4mz3s: checks 
*** SHOW DOWN ***
Kukuryzka: shows [4d 4c] (a pair of Fours)
r4mz3s: shows [Ac Ts] (a pair of Tens)
r4mz3s collected $21.24 from pot
*** SUMMARY ***
Total pot $22.36 | Rake $1.12 
Board [3c 8h Qd Td 5s]
Seat 1: tipner folded before Flop (didn't bet)
Seat 2: CI58 folded before Flop (didn't bet)
Seat 3: Racushniak folded before Flop (didn't bet)
Seat 4: Greha999 folded before Flop (didn't bet)
Seat 5: flk.Dasas folded before Flop (didn't bet)
Seat 6: matiko09 (button) folded before Flop (didn't bet)
Seat 7: Kukuryzka (small blind) showed [4d 4c] and lost with a pair of Fours
Seat 8: r4mz3s (big blind) showed [Ac Ts] and won ($21.24) with a pair of Tens
Seat 9: f1reworks folded before Flop (didn't bet)





PokerStars Hand #155300972459:  Hold'em No Limit ($0.50/$1.00 USD) - 2016/06/28 16:08:56 CET [2016/06/28 10:08:56 ET]
Table 'Dorado II' 9-max Seat #1 is the button
Seat 1: f1reworks ($124.84 in chips) 
Seat 2: vanilica ($100 in chips) 
Seat 3: ghostriderxu ($101.44 in chips) 
Seat 4: pyromid ($114.87 in chips) 
Seat 5: KovIFish89 ($123.02 in chips) 
Seat 6: mycka86 ($100 in chips) 
Seat 7: matiko09 ($100 in chips) 
Seat 8: flk.Dasas ($100 in chips) 
Seat 9: r4mz3s ($100 in chips) 
vanilica: posts small blind $0.50
ghostriderxu: posts big blind $1
*** HOLE CARDS ***
Dealt to matiko09 [8h 9d]
pyromid: raises $1.50 to $2.50
KovIFish89: folds 
mycka86: folds 
matiko09: folds 
flk.Dasas: folds 
r4mz3s: folds 
f1reworks: folds 
vanilica: folds 
ghostriderxu: folds 
Uncalled bet ($1.50) returned to pyromid
pyromid collected $2.50 from pot
pyromid: doesn't show hand 
*** SUMMARY ***
Total pot $2.50 | Rake $0 
Seat 1: f1reworks (button) folded before Flop (didn't bet)
Seat 2: vanilica (small blind) folded before Flop
Seat 3: ghostriderxu (big blind) folded before Flop
Seat 4: pyromid collected ($2.50)
Seat 5: KovIFish89 folded before Flop (didn't bet)
Seat 6: mycka86 folded before Flop (didn't bet)
Seat 7: matiko09 folded before Flop (didn't bet)
Seat 8: flk.Dasas folded before Flop (didn't bet)
Seat 9: r4mz3s folded before Flop (didn't bet)





PokerStars Hand #155300974114:  Hold'em No Limit ($0.50/$1.00 USD) - 2016/06/28 16:08:59 CET [2016/06/28 10:08:59 ET]
Table 'Kamenyar' 9-max Seat #7 is the button
Seat 1: Rafaello18 ($185.31 in chips) 
Seat 2: ozone2003 ($107.68 in chips) 
Seat 3: r4mz3s ($100 in chips) 
Seat 4: f1reworks ($222.91 in chips) 
Seat 5: bwly520 ($339.98 in chips) 
Seat 6: matiko09 ($104.50 in chips) 
Seat 7: Racushniak ($100 in chips) 
Seat 8: sanpidk ($134.13 in chips) 
Seat 9: pyromid ($100 in chips) 
sanpidk: posts small blind $0.50
pyromid: posts big blind $1
*** HOLE CARDS ***
Dealt to matiko09 [Tc 7h]
Rafaello18: folds 
ozone2003: folds 
r4mz3s: folds 
f1reworks: raises $2 to $3
bwly520: folds 
Rafaello18 leaves the table
matiko09: folds 
Racushniak: folds 
sanpidk: raises $7.50 to $10.50
pyromid: folds 
f1reworks: calls $7.50
*** FLOP *** [Ah Ts 3d]
sanpidk: checks 
f1reworks: checks 
*** TURN *** [Ah Ts 3d] [8d]
sanpidk: checks 
f1reworks: checks 
*** RIVER *** [Ah Ts 3d 8d] [2h]
flk.Dasas joins the table at seat #1 
sanpidk: bets $16
f1reworks: folds 
Uncalled bet ($16) returned to sanpidk
sanpidk collected $20.90 from pot
sanpidk: doesn't show hand 
*** SUMMARY ***
Total pot $22 | Rake $1.10 
Board [Ah Ts 3d 8d 2h]
Seat 1: Rafaello18 folded before Flop (didn't bet)
Seat 2: ozone2003 folded before Flop (didn't bet)
Seat 3: r4mz3s folded before Flop (didn't bet)
Seat 4: f1reworks folded on the River
Seat 5: bwly520 folded before Flop (didn't bet)
Seat 6: matiko09 folded before Flop (didn't bet)
Seat 7: Racushniak (button) folded before Flop (didn't bet)
Seat 8: sanpidk (small blind) collected ($20.90)
Seat 9: pyromid (big blind) folded before Flop





PokerStars Hand #155300988735:  Hold'em No Limit ($0.50/$1.00 USD) - 2016/06/28 16:09:27 CET [2016/06/28 10:09:27 ET]
Table 'Tynka' 9-max Seat #6 is the button
Seat 1: ilaviiitech ($100 in chips) 
Seat 2: matiko09 ($102.52 in chips) 
Seat 3: tipner ($100 in chips) 
Seat 4: chenconhaste ($105 in chips) 
Seat 5: Tirpo ($100 in chips) 
Seat 6: WDW3 ($100 in chips) 
Seat 7: flk.Dasas ($100 in chips) 
Seat 8: Bigtomboi ($95.72 in chips) 
Seat 9: duanyucheng ($62.23 in chips) 
flk.Dasas: posts small blind $0.50
Bigtomboi: posts big blind $1
*** HOLE CARDS ***
Dealt to matiko09 [8d 4c]
duanyucheng: folds 
ilaviiitech: folds 
Bigtomboi said, "hahah"
matiko09: folds 
tipner: folds 
chenconhaste: folds 
Tirpo: raises $2.50 to $3.50
WDW3: folds 
flk.Dasas: folds 
Bigtomboi: raises $7.50 to $11
Tirpo: calls $7.50
*** FLOP *** [9d 3d Ah]
Bigtomboi: bets $1
Tirpo: calls $1
*** TURN *** [9d 3d Ah] [6d]
Bigtomboi: checks 
Tirpo: checks 
*** RIVER *** [9d 3d Ah 6d] [2h]
Bigtomboi: bets $12
Tirpo: calls $12
*** SHOW DOWN ***
Bigtomboi: shows [Td Ad] (a flush, Ace high)
Tirpo: mucks hand 
Bigtomboi collected $46.08 from pot
*** SUMMARY ***
Total pot $48.50 | Rake $2.42 
Board [9d 3d Ah 6d 2h]
Seat 1: ilaviiitech folded before Flop (didn't bet)
Seat 2: matiko09 folded before Flop (didn't bet)
Seat 3: tipner folded before Flop (didn't bet)
Seat 4: chenconhaste folded before Flop (didn't bet)
Seat 5: Tirpo mucked [As Qs]
Seat 6: WDW3 (button) folded before Flop (didn't bet)
Seat 7: flk.Dasas (small blind) folded before Flop
Seat 8: Bigtomboi (big blind) showed [Td Ad] and won ($46.08) with a flush, Ace high
Seat 9: duanyucheng folded before Flop (didn't bet)





PokerStars Hand #155300989807:  Hold'em No Limit ($0.50/$1.00 USD) - 2016/06/28 16:09:29 CET [2016/06/28 10:09:29 ET]
Table 'Dorado II' 9-max Seat #2 is the button
Seat 1: f1reworks ($124.84 in chips) 
Seat 2: vanilica ($100 in chips) 
Seat 3: ghostriderxu ($100.44 in chips) 
Seat 4: pyromid ($116.37 in chips) 
Seat 5: KovIFish89 ($123.02 in chips) 
Seat 6: mycka86 ($100 in chips) 
Seat 7: matiko09 ($100 in chips) 
Seat 8: flk.Dasas ($100 in chips) 
Seat 9: r4mz3s ($100 in chips) 
ghostriderxu: posts small blind $0.50
pyromid: posts big blind $1
*** HOLE CARDS ***
Dealt to matiko09 [6c 8h]
KovIFish89: folds 
mycka86: folds 
matiko09: folds 
flk.Dasas: folds 
r4mz3s: folds 
f1reworks: raises $2 to $3
vanilica: folds 
ghostriderxu: folds 
pyromid: calls $2
*** FLOP *** [9c Ts 3d]
pyromid: checks 
f1reworks: checks 
*** TURN *** [9c Ts 3d] [7s]
pyromid: bets $6.18
f1reworks: folds 
Uncalled bet ($6.18) returned to pyromid
pyromid collected $6.18 from pot
pyromid: doesn't show hand 
*** SUMMARY ***
Total pot $6.50 | Rake $0.32 
Board [9c Ts 3d 7s]
Seat 1: f1reworks folded on the Turn
Seat 2: vanilica (button) folded before Flop (didn't bet)
Seat 3: ghostriderxu (small blind) folded before Flop
Seat 4: pyromid (big blind) collected ($6.18)
Seat 5: KovIFish89 folded before Flop (didn't bet)
Seat 6: mycka86 folded before Flop (didn't bet)
Seat 7: matiko09 folded before Flop (didn't bet)
Seat 8: flk.Dasas folded before Flop (didn't bet)
Seat 9: r4mz3s folded before Flop (didn't bet)





PokerStars Hand #155300996806:  Hold'em No Limit ($0.25/$0.50 USD) - 2016/06/28 16:09:42 CET [2016/06/28 10:09:42 ET]
Table 'Ajax II' 9-max Seat #4 is the button
Seat 1: omorfadramou ($54.87 in chips) 
Seat 2: SumPosad ($19.37 in chips) 
Seat 4: ardo888 ($50 in chips) 
Seat 5: sopir ($50.85 in chips) 
Seat 6: PokerGirl558 ($62.04 in chips) 
Seat 7: myatiy 96 ($56.96 in chips) 
Seat 9: matiko09 ($50 in chips) 
sopir: posts small blind $0.25
PokerGirl558: posts big blind $0.50
chenconhaste: sits out 
*** HOLE CARDS ***
Dealt to matiko09 [5h Ac]
myatiy 96: folds 
matiko09: folds 
omorfadramou: folds 
SumPosad: folds 
ardo888: raises $0.75 to $1.25
sopir: folds 
PokerGirl558: folds 
Uncalled bet ($0.75) returned to ardo888
ardo888 collected $1.25 from pot
ardo888: doesn't show hand 
*** SUMMARY ***
Total pot $1.25 | Rake $0 
Seat 1: omorfadramou folded before Flop (didn't bet)
Seat 2: SumPosad folded before Flop (didn't bet)
Seat 4: ardo888 (button) collected ($1.25)
Seat 5: sopir (small blind) folded before Flop
Seat 6: PokerGirl558 (big blind) folded before Flop
Seat 7: myatiy 96 folded before Flop (didn't bet)
Seat 9: matiko09 folded before Flop (didn't bet)





PokerStars Hand #155301008462:  Hold'em No Limit ($0.50/$1.00 USD) - 2016/06/28 16:10:04 CET [2016/06/28 10:10:04 ET]
Table 'Dorado II' 9-max Seat #3 is the button
Seat 1: f1reworks ($121.84 in chips) 
Seat 2: vanilica ($100 in chips) 
Seat 3: ghostriderxu ($99.94 in chips) 
Seat 4: pyromid ($119.55 in chips) 
Seat 5: KovIFish89 ($123.02 in chips) 
Seat 6: mycka86 ($100 in chips) 
Seat 7: matiko09 ($100 in chips) 
Seat 8: flk.Dasas ($100 in chips) 
Seat 9: r4mz3s ($100 in chips) 
pyromid: posts small blind $0.50
KovIFish89: posts big blind $1
*** HOLE CARDS ***
Dealt to matiko09 [As 2d]
mycka86: raises $2 to $3
matiko09: folds 
flk.Dasas: folds 
r4mz3s: folds 
f1reworks: folds 
vanilica: folds 
ghostriderxu: folds 
pyromid: folds 
KovIFish89: folds 
Uncalled bet ($2) returned to mycka86
mycka86 collected $2.50 from pot
*** SUMMARY ***
Total pot $2.50 | Rake $0 
Seat 1: f1reworks folded before Flop (didn't bet)
Seat 2: vanilica folded before Flop (didn't bet)
Seat 3: ghostriderxu (button) folded before Flop (didn't bet)
Seat 4: pyromid (small blind) folded before Flop
Seat 5: KovIFish89 (big blind) folded before Flop
Seat 6: mycka86 collected ($2.50)
Seat 7: matiko09 folded before Flop (didn't bet)
Seat 8: flk.Dasas folded before Flop (didn't bet)
Seat 9: r4mz3s folded before Flop (didn't bet)





PokerStars Hand #155301010100:  Hold'em No Limit ($0.50/$1.00 USD) - 2016/06/28 16:10:07 CET [2016/06/28 10:10:07 ET]
Table 'Lyyli II' 9-max Seat #7 is the button
Seat 1: tipner ($108.08 in chips) 
Seat 2: CI58 ($100 in chips) 
Seat 3: Racushniak ($100 in chips) 
Seat 4: Greha999 ($160.22 in chips) 
Seat 5: flk.Dasas ($100.50 in chips) 
Seat 6: matiko09 ($129.94 in chips) 
Seat 7: Kukuryzka ($187.69 in chips) 
Seat 8: r4mz3s ($118.73 in chips) 
Seat 9: f1reworks ($104.50 in chips) 
r4mz3s: posts small blind $0.50
f1reworks: posts big blind $1
*** HOLE CARDS ***
Dealt to matiko09 [4d Kc]
tipner: folds 
CI58: raises $2 to $3
Racushniak: folds 
Greha999: folds 
flk.Dasas: folds 
matiko09: folds 
Kukuryzka: folds 
r4mz3s: folds 
f1reworks: folds 
Uncalled bet ($2) returned to CI58
CI58 collected $2.50 from pot
CI58: doesn't show hand 
*** SUMMARY ***
Total pot $2.50 | Rake $0 
Seat 1: tipner folded before Flop (didn't bet)
Seat 2: CI58 collected ($2.50)
Seat 3: Racushniak folded before Flop (didn't bet)
Seat 4: Greha999 folded before Flop (didn't bet)
Seat 5: flk.Dasas folded before Flop (didn't bet)
Seat 6: matiko09 folded before Flop (didn't bet)
Seat 7: Kukuryzka (button) folded before Flop (didn't bet)
Seat 8: r4mz3s (small blind) folded before Flop
Seat 9: f1reworks (big blind) folded before Flop





PokerStars Hand #155301011573:  Hold'em No Limit ($0.50/$1.00 USD) - 2016/06/28 16:10:10 CET [2016/06/28 10:10:10 ET]
Table 'Kamenyar' 9-max Seat #8 is the button
Seat 1: flk.Dasas ($100 in chips) 
Seat 2: ozone2003 ($107.68 in chips) 
Seat 3: r4mz3s ($100 in chips) 
Seat 4: f1reworks ($212.41 in chips) 
Seat 5: bwly520 ($339.98 in chips) 
Seat 6: matiko09 ($104.50 in chips) 
Seat 7: Racushniak ($100 in chips) 
Seat 8: sanpidk ($144.53 in chips) 
Seat 9: pyromid ($99 in chips) 
pyromid: posts small blind $0.50
flk.Dasas: posts big blind $1
*** HOLE CARDS ***
Dealt to matiko09 [4d 9d]
ozone2003: folds 
r4mz3s: folds 
f1reworks: folds 
bwly520: folds 
matiko09: folds 
Racushniak: folds 
sanpidk: raises $1.50 to $2.50
pyromid: calls $2
flk.Dasas: folds 
*** FLOP *** [4s Jd 4h]
pyromid: checks 
sanpidk: bets $3.50
pyromid: calls $3.50
*** TURN *** [4s Jd 4h] [Kd]
pyromid: checks 
sanpidk: checks 
*** RIVER *** [4s Jd 4h Kd] [3h]
pyromid: bets $6.17
sanpidk: calls $6.17
*** SHOW DOWN ***
pyromid: shows [Ks Qs] (two pair, Kings and Fours)
sanpidk: mucks hand 
pyromid collected $24.07 from pot
*** SUMMARY ***
Total pot $25.34 | Rake $1.27 
Board [4s Jd 4h Kd 3h]
Seat 1: flk.Dasas (big blind) folded before Flop
Seat 2: ozone2003 folded before Flop (didn't bet)
Seat 3: r4mz3s folded before Flop (didn't bet)
Seat 4: f1reworks folded before Flop (didn't bet)
Seat 5: bwly520 folded before Flop (didn't bet)
Seat 6: matiko09 folded before Flop (didn't bet)
Seat 7: Racushniak folded before Flop (didn't bet)
Seat 8: sanpidk (button) mucked [2h 2d]
Seat 9: pyromid (small blind) showed [Ks Qs] and won ($24.07) with two pair, Kings and Fours





PokerStars Hand #155301012671:  Hold'em No Limit ($0.50/$1.00 USD) - 2016/06/28 16:10:12 CET [2016/06/28 10:10:12 ET]
Table 'Tynka' 9-max Seat #7 is the button
Seat 1: ilaviiitech ($100 in chips) 
Seat 2: matiko09 ($102.52 in chips) 
Seat 3: tipner ($100 in chips) 
Seat 4: chenconhaste ($105 in chips) 
Seat 5: Tirpo ($100 in chips) 
Seat 6: WDW3 ($100 in chips) 
Seat 7: flk.Dasas ($100 in chips) 
Seat 8: Bigtomboi ($117.80 in chips) 
Seat 9: duanyucheng ($62.23 in chips) 
Bigtomboi: posts small blind $0.50
duanyucheng: posts big blind $1
*** HOLE CARDS ***
Dealt to matiko09 [5d 7c]
ilaviiitech: folds 
matiko09: folds 
tipner: raises $2 to $3
chenconhaste: folds 
Tirpo: folds 
WDW3: folds 
flk.Dasas: folds 
Bigtomboi: calls $2.50
duanyucheng: folds 
*** FLOP *** [Jh Kc 8s]
Bigtomboi: checks 
tipner: checks 
*** TURN *** [Jh Kc 8s] [5c]
Bigtomboi: bets $5
tipner: folds 
Uncalled bet ($5) returned to Bigtomboi
Bigtomboi collected $6.65 from pot
Bigtomboi: doesn't show hand 
*** SUMMARY ***
Total pot $7 | Rake $0.35 
Board [Jh Kc 8s 5c]
Seat 1: ilaviiitech folded before Flop (didn't bet)
Seat 2: matiko09 folded before Flop (didn't bet)
Seat 3: tipner folded on the Turn
Seat 4: chenconhaste folded before Flop (didn't bet)
Seat 5: Tirpo folded before Flop (didn't bet)
Seat 6: WDW3 folded before Flop (didn't bet)
Seat 7: flk.Dasas (button) folded before Flop (didn't bet)
Seat 8: Bigtomboi (small blind) collected ($6.65)
Seat 9: duanyucheng (big blind) folded before Flop





PokerStars Hand #155301013210:  Hold'em No Limit ($0.25/$0.50 USD) - 2016/06/28 16:10:13 CET [2016/06/28 10:10:13 ET]
Table 'Thyestes II' 9-max Seat #3 is the button
Seat 1: ardo888 ($50.15 in chips) 
Seat 2: matiko09 ($50 in chips) 
Seat 3: seblafstian ($59.95 in chips) 
Seat 5: St.LaCoste ($48.75 in chips) 
Seat 6: superior_pl ($43.18 in chips) 
Seat 7: Vedpapa ($68.63 in chips) 
Seat 8: Azzaj91 ($49.91 in chips) 
Domotirko228 will be allowed to play after the button
St.LaCoste: posts small blind $0.25
superior_pl: posts big blind $0.50
*** HOLE CARDS ***
Dealt to matiko09 [7d 5h]
Vedpapa: folds 
Azzaj91: folds 
ardo888: folds 
matiko09: folds 
seblafstian: folds 
St.LaCoste: raises $1 to $1.50
superior_pl: folds 
Uncalled bet ($1) returned to St.LaCoste
St.LaCoste collected $1 from pot
St.LaCoste: doesn't show hand 
*** SUMMARY ***
Total pot $1 | Rake $0 
Seat 1: ardo888 folded before Flop (didn't bet)
Seat 2: matiko09 folded before Flop (didn't bet)
Seat 3: seblafstian (button) folded before Flop (didn't bet)
Seat 5: St.LaCoste (small blind) collected ($1)
Seat 6: superior_pl (big blind) folded before Flop
Seat 7: Vedpapa folded before Flop (didn't bet)
Seat 8: Azzaj91 folded before Flop (didn't bet)





PokerStars Hand #155301024418:  Hold'em No Limit ($0.50/$1.00 USD) - 2016/06/28 16:10:34 CET [2016/06/28 10:10:34 ET]
Table 'Dorado II' 9-max Seat #4 is the button
Seat 1: f1reworks ($121.84 in chips) 
Seat 2: vanilica ($100 in chips) 
Seat 3: ghostriderxu ($99.94 in chips) 
Seat 4: pyromid ($119.05 in chips) 
Seat 5: KovIFish89 ($122.02 in chips) 
Seat 6: mycka86 ($101.50 in chips) 
Seat 7: matiko09 ($100 in chips) 
Seat 8: flk.Dasas ($100 in chips) 
Seat 9: r4mz3s ($100 in chips) 
KovIFish89: posts small blind $0.50
mycka86: posts big blind $1
*** HOLE CARDS ***
Dealt to matiko09 [Qh Kd]
matiko09: folds 
flk.Dasas: folds 
r4mz3s: raises $1.55 to $2.55
f1reworks: folds 
vanilica: folds 
ghostriderxu: raises $4.95 to $7.50
pyromid: folds 
KovIFish89: folds 
mycka86: folds 
r4mz3s: folds 
Uncalled bet ($4.95) returned to ghostriderxu
ghostriderxu collected $6.60 from pot
ghostriderxu: doesn't show hand 
*** SUMMARY ***
Total pot $6.60 | Rake $0 
Seat 1: f1reworks folded before Flop (didn't bet)
Seat 2: vanilica folded before Flop (didn't bet)
Seat 3: ghostriderxu collected ($6.60)
Seat 4: pyromid (button) folded before Flop (didn't bet)
Seat 5: KovIFish89 (small blind) folded before Flop
Seat 6: mycka86 (big blind) folded before Flop
Seat 7: matiko09 folded before Flop (didn't bet)
Seat 8: flk.Dasas folded before Flop (didn't bet)
Seat 9: r4mz3s folded before Flop





PokerStars Hand #155301027543:  Hold'em No Limit ($0.25/$0.50 USD) - 2016/06/28 16:10:40 CET [2016/06/28 10:10:40 ET]
Table 'Thyestes II' 9-max Seat #5 is the button
Seat 1: ardo888 ($50.15 in chips) 
Seat 2: matiko09 ($50 in chips) 
Seat 3: seblafstian ($59.95 in chips) 
Seat 5: St.LaCoste ($49.25 in chips) 
Seat 6: superior_pl ($42.68 in chips) 
Seat 7: Vedpapa ($68.63 in chips) 
Seat 8: Azzaj91 ($49.91 in chips) 
superior_pl: posts small blind $0.25
Vedpapa: posts big blind $0.50
Domotirko228: sits out 
*** HOLE CARDS ***
Dealt to matiko09 [5c 9s]
Azzaj91: folds 
ardo888: folds 
matiko09: folds 
seblafstian: folds 
St.LaCoste: folds 
superior_pl: calls $0.25
Vedpapa: checks 
*** FLOP *** [Jd 2c 7h]
superior_pl: checks 
Vedpapa: checks 
*** TURN *** [Jd 2c 7h] [6h]
superior_pl: checks 
Vedpapa: checks 
*** RIVER *** [Jd 2c 7h 6h] [Kh]
superior_pl: checks 
Vedpapa: checks 
*** SHOW DOWN ***
superior_pl: shows [As 4s] (high card Ace)
Vedpapa: shows [6d Ts] (a pair of Sixes)
Vedpapa collected $0.95 from pot
*** SUMMARY ***
Total pot $1 | Rake $0.05 
Board [Jd 2c 7h 6h Kh]
Seat 1: ardo888 folded before Flop (didn't bet)
Seat 2: matiko09 folded before Flop (didn't bet)
Seat 3: seblafstian folded before Flop (didn't bet)
Seat 5: St.LaCoste (button) folded before Flop (didn't bet)
Seat 6: superior_pl (small blind) showed [As 4s] and lost with high card Ace
Seat 7: Vedpapa (big blind) showed [6d Ts] and won ($0.95) with a pair of Sixes
Seat 8: Azzaj91 folded before Flop (didn't bet)





PokerStars Hand #155301027972:  Hold'em No Limit ($0.50/$1.00 USD) - 2016/06/28 16:10:41 CET [2016/06/28 10:10:41 ET]
Table 'Lyyli II' 9-max Seat #8 is the button
Seat 1: tipner ($108.08 in chips) 
Seat 2: CI58 ($101.50 in chips) 
Seat 3: Racushniak ($100 in chips) 
Seat 4: Greha999 ($160.22 in chips) 
Seat 5: flk.Dasas ($100.50 in chips) 
Seat 6: matiko09 ($129.94 in chips) 
Seat 7: Kukuryzka ($187.69 in chips) 
Seat 8: r4mz3s ($118.23 in chips) 
Seat 9: f1reworks ($103.50 in chips) 
f1reworks: posts small blind $0.50
tipner: posts big blind $1
*** HOLE CARDS ***
Dealt to matiko09 [6d Js]
CI58: folds 
Racushniak: folds 
Greha999: folds 
flk.Dasas: folds 
matiko09: folds 
Kukuryzka: folds 
r4mz3s: raises $1.14 to $2.14
f1reworks: folds 
tipner: calls $1.14
*** FLOP *** [As 3c Ks]
tipner: checks 
r4mz3s: checks 
*** TURN *** [As 3c Ks] [2d]
tipner: checks 
r4mz3s: checks 
*** RIVER *** [As 3c Ks 2d] [9c]
tipner: checks 
r4mz3s: checks 
*** SHOW DOWN ***
tipner: shows [Jc 9h] (a pair of Nines)
r4mz3s: mucks hand 
tipner collected $4.54 from pot
*** SUMMARY ***
Total pot $4.78 | Rake $0.24 
Board [As 3c Ks 2d 9c]
Seat 1: tipner (big blind) showed [Jc 9h] and won ($4.54) with a pair of Nines
Seat 2: CI58 folded before Flop (didn't bet)
Seat 3: Racushniak folded before Flop (didn't bet)
Seat 4: Greha999 folded before Flop (didn't bet)
Seat 5: flk.Dasas folded before Flop (didn't bet)
Seat 6: matiko09 folded before Flop (didn't bet)
Seat 7: Kukuryzka folded before Flop (didn't bet)
Seat 8: r4mz3s (button) mucked [8c Qc]
Seat 9: f1reworks (small blind) folded before Flop





PokerStars Hand #155301032219:  Hold'em No Limit ($0.25/$0.50 USD) - 2016/06/28 16:10:49 CET [2016/06/28 10:10:49 ET]
Table 'Utra' 9-max Seat #4 is the button
Seat 1: ardo888 ($55.49 in chips) 
Seat 2: matiko09 ($80.77 in chips) 
Seat 3: mycka86 ($62.69 in chips) 
Seat 4: myatiy 96 ($50 in chips) 
Seat 6: Franky77200 ($78.67 in chips) 
Seat 7: el.suertero ($61.16 in chips) 
Seat 8: fudzi ($50 in chips) 
Seat 9: Kukuryzka ($52.30 in chips) 
Franky77200: posts small blind $0.25
el.suertero: posts big blind $0.50
ardo888: posts the ante $0.10
matiko09: posts the ante $0.10
mycka86: posts the ante $0.10
myatiy 96: posts the ante $0.10
Franky77200: posts the ante $0.10
el.suertero: posts the ante $0.10
fudzi: posts the ante $0.10
Kukuryzka: posts the ante $0.10
*** HOLE CARDS ***
Dealt to matiko09 [4s 2c]
fudzi: folds 
Kukuryzka: folds 
baoyu4749892 leaves the table
ardo888: raises $1 to $1.50
matiko09: folds 
mycka86: folds 
myatiy 96: folds 
Franky77200: folds 
Domotirko228 joins the table at seat #5 
el.suertero: folds 
Uncalled bet ($1) returned to ardo888
Domotirko228 leaves the table
ardo888 collected $2.05 from pot
ardo888: doesn't show hand 
*** SUMMARY ***
Total pot $2.05 | Rake $0 
Seat 1: ardo888 collected ($2.05)
Seat 2: matiko09 folded before Flop (didn't bet)
Seat 3: mycka86 folded before Flop (didn't bet)
Seat 4: myatiy 96 (button) folded before Flop (didn't bet)
Seat 6: Franky77200 (small blind) folded before Flop
Seat 7: el.suertero (big blind) folded before Flop
Seat 8: fudzi folded before Flop (didn't bet)
Seat 9: Kukuryzka folded before Flop (didn't bet)





PokerStars Hand #155301038568:  Hold'em No Limit ($0.50/$1.00 USD) - 2016/06/28 16:11:01 CET [2016/06/28 10:11:01 ET]
Table 'Tynka' 9-max Seat #8 is the button
Seat 1: ilaviiitech ($100 in chips) 
Seat 2: matiko09 ($102.52 in chips) 
Seat 3: tipner ($100 in chips) 
Seat 4: chenconhaste ($105 in chips) 
Seat 5: Tirpo ($100 in chips) 
Seat 6: WDW3 ($100 in chips) 
Seat 7: flk.Dasas ($100 in chips) 
Seat 8: Bigtomboi ($121.45 in chips) 
Seat 9: duanyucheng ($61.23 in chips) 
duanyucheng: posts small blind $0.50
ilaviiitech: posts big blind $1
*** HOLE CARDS ***
Dealt to matiko09 [5d 7d]
matiko09: folds 
tipner: raises $2 to $3
chenconhaste: folds 
Tirpo: folds 
WDW3: folds 
flk.Dasas: folds 
Bigtomboi: folds 
duanyucheng: folds 
Bigtomboi leaves the table
ilaviiitech: folds 
Uncalled bet ($2) returned to tipner
tipner collected $2.50 from pot
tipner: doesn't show hand 
*** SUMMARY ***
Total pot $2.50 | Rake $0 
Seat 1: ilaviiitech (big blind) folded before Flop
Seat 2: matiko09 folded before Flop (didn't bet)
Seat 3: tipner collected ($2.50)
Seat 4: chenconhaste folded before Flop (didn't bet)
Seat 5: Tirpo folded before Flop (didn't bet)
Seat 6: WDW3 folded before Flop (didn't bet)
Seat 7: flk.Dasas folded before Flop (didn't bet)
Seat 8: Bigtomboi (button) folded before Flop (didn't bet)
Seat 9: duanyucheng (small blind) folded before Flop





PokerStars Hand #155301042943:  Hold'em No Limit ($0.50/$1.00 USD) - 2016/06/28 16:11:09 CET [2016/06/28 10:11:09 ET]
Table 'Dorado II' 9-max Seat #5 is the button
Seat 1: f1reworks ($121.84 in chips) 
Seat 2: vanilica ($100 in chips) 
Seat 3: ghostriderxu ($103.99 in chips) 
Seat 4: pyromid ($119.05 in chips) 
Seat 5: KovIFish89 ($121.52 in chips) 
Seat 6: mycka86 ($100.50 in chips) 
Seat 7: matiko09 ($100 in chips) 
Seat 8: flk.Dasas ($100 in chips) 
Seat 9: r4mz3s ($100 in chips) 
mycka86: posts small blind $0.50
matiko09: posts big blind $1
*** HOLE CARDS ***
Dealt to matiko09 [3h Ah]
flk.Dasas: folds 
r4mz3s: folds 
f1reworks: folds 
vanilica: folds 
ghostriderxu: raises $2 to $3
pyromid: folds 
KovIFish89: folds 
mycka86: folds 
matiko09: folds 
Uncalled bet ($2) returned to ghostriderxu
ghostriderxu collected $2.50 from pot
ghostriderxu: doesn't show hand 
*** SUMMARY ***
Total pot $2.50 | Rake $0 
Seat 1: f1reworks folded before Flop (didn't bet)
Seat 2: vanilica folded before Flop (didn't bet)
Seat 3: ghostriderxu collected ($2.50)
Seat 4: pyromid folded before Flop (didn't bet)
Seat 5: KovIFish89 (button) folded before Flop (didn't bet)
Seat 6: mycka86 (small blind) folded before Flop
Seat 7: matiko09 (big blind) folded before Flop
Seat 8: flk.Dasas folded before Flop (didn't bet)
Seat 9: r4mz3s folded before Flop (didn't bet)





PokerStars Hand #155301044705:  Hold'em No Limit ($0.50/$1.00 USD) - 2016/06/28 16:11:12 CET [2016/06/28 10:11:12 ET]
Table 'Kamenyar' 9-max Seat #9 is the button
Seat 1: flk.Dasas ($100 in chips) 
Seat 2: ozone2003 ($107.68 in chips) 
Seat 3: r4mz3s ($100 in chips) 
Seat 4: f1reworks ($212.41 in chips) 
Seat 5: bwly520 ($339.98 in chips) 
Seat 6: matiko09 ($104.50 in chips) 
Seat 7: Racushniak ($100 in chips) 
Seat 8: sanpidk ($132.36 in chips) 
Seat 9: pyromid ($110.90 in chips) 
flk.Dasas: posts small blind $0.50
ozone2003: posts big blind $1
*** HOLE CARDS ***
Dealt to matiko09 [4s 6d]
r4mz3s: folds 
f1reworks: folds 
bwly520: raises $2 to $3
matiko09: folds 
Racushniak: folds 
sanpidk: folds 
pyromid: calls $3
flk.Dasas: folds 
ozone2003: folds 
*** FLOP *** [Ah Kc 6h]
bwly520: bets $4
pyromid: calls $4
*** TURN *** [Ah Kc 6h] [Ks]
bwly520: checks 
pyromid: checks 
*** RIVER *** [Ah Kc 6h Ks] [Kh]
bwly520: bets $5.75
pyromid: calls $5.75
*** SHOW DOWN ***
bwly520: shows [Jc Qc] (three of a kind, Kings)
pyromid: shows [Ad Qd] (a full house, Kings full of Aces)
pyromid collected $25.65 from pot
*** SUMMARY ***
Total pot $27 | Rake $1.35 
Board [Ah Kc 6h Ks Kh]
Seat 1: flk.Dasas (small blind) folded before Flop
Seat 2: ozone2003 (big blind) folded before Flop
Seat 3: r4mz3s folded before Flop (didn't bet)
Seat 4: f1reworks folded before Flop (didn't bet)
Seat 5: bwly520 showed [Jc Qc] and lost with three of a kind, Kings
Seat 6: matiko09 folded before Flop (didn't bet)
Seat 7: Racushniak folded before Flop (didn't bet)
Seat 8: sanpidk folded before Flop (didn't bet)
Seat 9: pyromid (button) showed [Ad Qd] and won ($25.65) with a full house, Kings full of Aces





PokerStars Hand #155301044593:  Hold'em No Limit ($0.25/$0.50 USD) - 2016/06/28 16:11:12 CET [2016/06/28 10:11:12 ET]
Table 'Utra' 9-max Seat #6 is the button
Seat 1: ardo888 ($56.94 in chips) 
Seat 2: matiko09 ($80.67 in chips) 
Seat 3: mycka86 ($62.59 in chips) 
Seat 4: myatiy 96 ($50 in chips) 
Seat 6: Franky77200 ($78.32 in chips) 
Seat 7: el.suertero ($60.56 in chips) 
Seat 8: fudzi ($50 in chips) 
Seat 9: Kukuryzka ($52.20 in chips) 
el.suertero: posts small blind $0.25
fudzi: posts big blind $0.50
ardo888: posts the ante $0.10
matiko09: posts the ante $0.10
mycka86: posts the ante $0.10
myatiy 96: posts the ante $0.10
Franky77200: posts the ante $0.10
el.suertero: posts the ante $0.10
fudzi: posts the ante $0.10
Kukuryzka: posts the ante $0.10
*** HOLE CARDS ***
Dealt to matiko09 [9c 7s]
Kukuryzka: folds 
ardo888: folds 
matiko09: folds 
mycka86: folds 
myatiy 96: folds 
Franky77200: raises $1 to $1.50
el.suertero: calls $1.25
fudzi: folds 
*** FLOP *** [8c 6s 5c]
el.suertero: checks 
Franky77200: checks 
*** TURN *** [8c 6s 5c] [2h]
el.suertero: checks 
Franky77200: checks 
*** RIVER *** [8c 6s 5c 2h] [Ad]
el.suertero: checks 
Franky77200: checks 
*** SHOW DOWN ***
el.suertero: shows [9s Qs] (high card Ace)
Franky77200: shows [Th 6h] (a pair of Sixes)
Franky77200 collected $4.08 from pot
*** SUMMARY ***
Total pot $4.30 | Rake $0.22 
Board [8c 6s 5c 2h Ad]
Seat 1: ardo888 folded before Flop (didn't bet)
Seat 2: matiko09 folded before Flop (didn't bet)
Seat 3: mycka86 folded before Flop (didn't bet)
Seat 4: myatiy 96 folded before Flop (didn't bet)
Seat 6: Franky77200 (button) showed [Th 6h] and won ($4.08) with a pair of Sixes
Seat 7: el.suertero (small blind) showed [9s Qs] and lost with high card Ace
Seat 8: fudzi (big blind) folded before Flop
Seat 9: Kukuryzka folded before Flop (didn't bet)





PokerStars Hand #155301058618:  Hold'em No Limit ($0.50/$1.00 USD) - 2016/06/28 16:11:38 CET [2016/06/28 10:11:38 ET]
Table 'Tynka' 9-max Seat #9 is the button
Seat 1: ilaviiitech ($100 in chips) 
Seat 2: matiko09 ($102.52 in chips) 
Seat 3: tipner ($101.50 in chips) 
Seat 4: chenconhaste ($105 in chips) 
Seat 5: Tirpo ($100 in chips) 
Seat 6: WDW3 ($100 in chips) 
Seat 7: flk.Dasas ($100 in chips) 
Seat 9: duanyucheng ($60.73 in chips) 
ilaviiitech: posts small blind $0.50
matiko09: posts big blind $1
*** HOLE CARDS ***
Dealt to matiko09 [4d 9s]
tipner: folds 
chenconhaste: folds 
Tirpo: folds 
WDW3: folds 
flk.Dasas: folds 
duanyucheng: folds 
ilaviiitech: folds 
Uncalled bet ($0.50) returned to matiko09
matiko09 collected $1 from pot
matiko09: doesn't show hand 
*** SUMMARY ***
Total pot $1 | Rake $0 
Seat 1: ilaviiitech (small blind) folded before Flop
Seat 2: matiko09 (big blind) collected ($1)
Seat 3: tipner folded before Flop (didn't bet)
Seat 4: chenconhaste folded before Flop (didn't bet)
Seat 5: Tirpo folded before Flop (didn't bet)
Seat 6: WDW3 folded before Flop (didn't bet)
Seat 7: flk.Dasas folded before Flop (didn't bet)
Seat 9: duanyucheng (button) folded before Flop (didn't bet)





PokerStars Hand #155301062549:  Hold'em No Limit ($0.50/$1.00 USD) - 2016/06/28 16:11:46 CET [2016/06/28 10:11:46 ET]
Table 'Lyyli II' 9-max Seat #9 is the button
Seat 1: tipner ($110.48 in chips) 
Seat 2: CI58 ($101.50 in chips) 
Seat 3: Racushniak ($100 in chips) 
Seat 4: Greha999 ($160.22 in chips) 
Seat 5: flk.Dasas ($100.50 in chips) 
Seat 6: matiko09 ($129.94 in chips) 
Seat 7: Kukuryzka ($187.69 in chips) 
Seat 8: r4mz3s ($116.09 in chips) 
Seat 9: f1reworks ($103 in chips) 
tipner: posts small blind $0.50
CI58: posts big blind $1
*** HOLE CARDS ***
Dealt to matiko09 [2d 6d]
Racushniak: raises $1.80 to $2.80
Greha999: calls $2.80
flk.Dasas: folds 
matiko09: folds 
Kukuryzka: folds 
r4mz3s: folds 
f1reworks: calls $2.80
tipner: folds 
CI58: calls $1.80
*** FLOP *** [9d Jc 4c]
CI58: checks 
Racushniak: bets $8
Greha999: folds 
f1reworks: folds 
CI58: raises $16 to $24
Racushniak: folds 
Uncalled bet ($16) returned to CI58
CI58 collected $26.32 from pot
CI58: doesn't show hand 
*** SUMMARY ***
Total pot $27.70 | Rake $1.38 
Board [9d Jc 4c]
Seat 1: tipner (small blind) folded before Flop
Seat 2: CI58 (big blind) collected ($26.32)
Seat 3: Racushniak folded on the Flop
Seat 4: Greha999 folded on the Flop
Seat 5: flk.Dasas folded before Flop (didn't bet)
Seat 6: matiko09 folded before Flop (didn't bet)
Seat 7: Kukuryzka folded before Flop (didn't bet)
Seat 8: r4mz3s folded before Flop (didn't bet)
Seat 9: f1reworks (button) folded on the Flop





PokerStars Hand #155301063157:  Hold'em No Limit ($0.50/$1.00 USD) - 2016/06/28 16:11:47 CET [2016/06/28 10:11:47 ET]
Table 'Dorado II' 9-max Seat #6 is the button
Seat 1: f1reworks ($121.84 in chips) 
Seat 2: vanilica ($100 in chips) 
Seat 3: ghostriderxu ($105.49 in chips) 
Seat 4: pyromid ($119.05 in chips) 
Seat 5: KovIFish89 ($121.52 in chips) 
Seat 6: mycka86 ($100 in chips) 
Seat 7: matiko09 ($100 in chips) 
Seat 8: flk.Dasas ($100 in chips) 
Seat 9: r4mz3s ($100 in chips) 
matiko09: posts small blind $0.50
flk.Dasas: posts big blind $1
*** HOLE CARDS ***
Dealt to matiko09 [4s 4h]
r4mz3s: folds 
f1reworks: folds 
vanilica: folds 
ghostriderxu: folds 
pyromid: folds 
KovIFish89: folds 
mycka86: raises $1.10 to $2.10
matiko09: folds 
flk.Dasas: calls $1.10
*** FLOP *** [9h Td 2h]
flk.Dasas: checks 
mycka86: bets $3
flk.Dasas: folds 
Uncalled bet ($3) returned to mycka86
mycka86 collected $4.46 from pot
*** SUMMARY ***
Total pot $4.70 | Rake $0.24 
Board [9h Td 2h]
Seat 1: f1reworks folded before Flop (didn't bet)
Seat 2: vanilica folded before Flop (didn't bet)
Seat 3: ghostriderxu folded before Flop (didn't bet)
Seat 4: pyromid folded before Flop (didn't bet)
Seat 5: KovIFish89 folded before Flop (didn't bet)
Seat 6: mycka86 (button) collected ($4.46)
Seat 7: matiko09 (small blind) folded before Flop
Seat 8: flk.Dasas (big blind) folded on the Flop
Seat 9: r4mz3s folded before Flop (didn't bet)





PokerStars Hand #155301065903:  Hold'em No Limit ($0.25/$0.50 USD) - 2016/06/28 16:11:52 CET [2016/06/28 10:11:52 ET]
Table 'Thyestes II' 9-max Seat #6 is the button
Seat 1: ardo888 ($50.15 in chips) 
Seat 2: matiko09 ($50 in chips) 
Seat 3: seblafstian ($59.95 in chips) 
Seat 5: St.LaCoste ($49.25 in chips) 
Seat 6: superior_pl ($42.18 in chips) 
Seat 7: Vedpapa ($69.08 in chips) 
Seat 8: Azzaj91 ($49.91 in chips) 
Vedpapa: posts small blind $0.25
Azzaj91: posts big blind $0.50
Domotirko228: sits out 
*** HOLE CARDS ***
Dealt to matiko09 [2d 3d]
ardo888: folds 
matiko09: folds 
seblafstian: folds 
St.LaCoste: folds 
superior_pl: folds 
Vedpapa: raises $1 to $1.50
Azzaj91: raises $1 to $2.50
Vedpapa: calls $1
*** FLOP *** [Ac 8s 7h]
Vedpapa: checks 
Azzaj91: bets $2.37
Vedpapa: folds 
Uncalled bet ($2.37) returned to Azzaj91
Azzaj91 collected $4.75 from pot
Azzaj91: doesn't show hand 
*** SUMMARY ***
Total pot $5 | Rake $0.25 
Board [Ac 8s 7h]
Seat 1: ardo888 folded before Flop (didn't bet)
Seat 2: matiko09 folded before Flop (didn't bet)
Seat 3: seblafstian folded before Flop (didn't bet)
Seat 5: St.LaCoste folded before Flop (didn't bet)
Seat 6: superior_pl (button) folded before Flop (didn't bet)
Seat 7: Vedpapa (small blind) folded on the Flop
Seat 8: Azzaj91 (big blind) collected ($4.75)





PokerStars Hand #155301068255:  Hold'em No Limit ($0.50/$1.00 USD) - 2016/06/28 16:11:56 CET [2016/06/28 10:11:56 ET]
Table 'Tynka' 9-max Seat #1 is the button
Seat 1: ilaviiitech ($100 in chips) 
Seat 2: matiko09 ($103.02 in chips) 
Seat 3: tipner ($101.50 in chips) 
Seat 4: chenconhaste ($105 in chips) 
Seat 5: Tirpo ($100 in chips) 
Seat 6: WDW3 ($100 in chips) 
Seat 7: flk.Dasas ($100 in chips) 
Seat 9: duanyucheng ($60.73 in chips) 
matiko09: posts small blind $0.50
tipner: posts big blind $1
*** HOLE CARDS ***
Dealt to matiko09 [3c 5c]
chenconhaste: folds 
Tirpo: folds 
WDW3: folds 
flk.Dasas: folds 
duanyucheng: folds 
ilaviiitech: folds 
r4mz3s joins the table at seat #8 
matiko09: folds 
Uncalled bet ($0.50) returned to tipner
tipner collected $1 from pot
tipner: doesn't show hand 
*** SUMMARY ***
Total pot $1 | Rake $0 
Seat 1: ilaviiitech (button) folded before Flop (didn't bet)
Seat 2: matiko09 (small blind) folded before Flop
Seat 3: tipner (big blind) collected ($1)
Seat 4: chenconhaste folded before Flop (didn't bet)
Seat 5: Tirpo folded before Flop (didn't bet)
Seat 6: WDW3 folded before Flop (didn't bet)
Seat 7: flk.Dasas folded before Flop (didn't bet)
Seat 9: duanyucheng folded before Flop (didn't bet)





PokerStars Hand #155301068238:  Hold'em No Limit ($0.50/$1.00 USD) - 2016/06/28 16:11:56 CET [2016/06/28 10:11:56 ET]
Table 'Vicia II' 9-max Seat #5 is the button
Seat 1: sanpidk ($121.86 in chips) 
Seat 2: Kukuryzka ($101.50 in chips) 
Seat 3: vanilica ($100 in chips) 
Seat 4: vanapeer ($100 in chips) 
Seat 5: wallium ($249.11 in chips) 
Seat 6: ozone2003 ($100 in chips) 
Seat 7: matiko09 ($100 in chips) 
Seat 8: f1reworks ($207.36 in chips) 
Seat 9: r4mz3s ($100 in chips) 
ozone2003: posts small blind $0.50
matiko09: posts big blind $1
*** HOLE CARDS ***
Dealt to matiko09 [Qs As]
f1reworks: raises $2 to $3
r4mz3s: folds 
sanpidk: folds 
Kukuryzka: folds 
vanilica: folds 
vanapeer: folds 
wallium: folds 
ozone2003: folds 
matiko09: calls $2
*** FLOP *** [6s 2d 2h]
matiko09: checks 
f1reworks: bets $3.39
matiko09: folds 
Uncalled bet ($3.39) returned to f1reworks
f1reworks collected $6.18 from pot
f1reworks: doesn't show hand 
*** SUMMARY ***
Total pot $6.50 | Rake $0.32 
Board [6s 2d 2h]
Seat 1: sanpidk folded before Flop (didn't bet)
Seat 2: Kukuryzka folded before Flop (didn't bet)
Seat 3: vanilica folded before Flop (didn't bet)
Seat 4: vanapeer folded before Flop (didn't bet)
Seat 5: wallium (button) folded before Flop (didn't bet)
Seat 6: ozone2003 (small blind) folded before Flop
Seat 7: matiko09 (big blind) folded on the Flop
Seat 8: f1reworks collected ($6.18)
Seat 9: r4mz3s folded before Flop (didn't bet)





PokerStars Hand #155301076372:  Hold'em No Limit ($0.25/$0.50 USD) - 2016/06/28 16:12:11 CET [2016/06/28 10:12:11 ET]
Table 'Utra' 9-max Seat #7 is the button
Seat 1: ardo888 ($56.84 in chips) 
Seat 2: matiko09 ($80.57 in chips) 
Seat 3: mycka86 ($62.49 in chips) 
Seat 4: myatiy 96 ($50 in chips) 
Seat 6: Franky77200 ($80.80 in chips) 
Seat 7: el.suertero ($58.96 in chips) 
Seat 8: fudzi ($50 in chips) 
Seat 9: Kukuryzka ($52.10 in chips) 
fudzi: posts small blind $0.25
Kukuryzka: posts big blind $0.50
ardo888: posts the ante $0.10
matiko09: posts the ante $0.10
mycka86: posts the ante $0.10
myatiy 96: posts the ante $0.10
Franky77200: posts the ante $0.10
el.suertero: posts the ante $0.10
fudzi: posts the ante $0.10
Kukuryzka: posts the ante $0.10
*** HOLE CARDS ***
Dealt to matiko09 [3d 8d]
ardo888: folds 
er13to joins the table at seat #5 
matiko09: folds 
mycka86: folds 
myatiy 96: folds 
Franky77200: folds 
el.suertero: folds 
fudzi: raises $1 to $1.50
Kukuryzka: calls $1
*** FLOP *** [Qd 7c Ad]
fudzi: checks 
Kukuryzka: checks 
*** TURN *** [Qd 7c Ad] [Tc]
fudzi: bets $2.50
Kukuryzka: raises $5 to $7.50
fudzi: folds 
Uncalled bet ($5) returned to Kukuryzka
Kukuryzka collected $8.36 from pot
Kukuryzka: doesn't show hand 
*** SUMMARY ***
Total pot $8.80 | Rake $0.44 
Board [Qd 7c Ad Tc]
Seat 1: ardo888 folded before Flop (didn't bet)
Seat 2: matiko09 folded before Flop (didn't bet)
Seat 3: mycka86 folded before Flop (didn't bet)
Seat 4: myatiy 96 folded before Flop (didn't bet)
Seat 6: Franky77200 folded before Flop (didn't bet)
Seat 7: el.suertero (button) folded before Flop (didn't bet)
Seat 8: fudzi (small blind) folded on the Turn
Seat 9: Kukuryzka (big blind) collected ($8.36)





PokerStars Hand #155301079443:  Hold'em No Limit ($0.50/$1.00 USD) - 2016/06/28 16:12:17 CET [2016/06/28 10:12:17 ET]
Table 'Tynka' 9-max Seat #2 is the button
Seat 1: ilaviiitech ($100 in chips) 
Seat 2: matiko09 ($102.52 in chips) 
Seat 3: tipner ($102 in chips) 
Seat 4: chenconhaste ($105 in chips) 
Seat 5: Tirpo ($100 in chips) 
Seat 6: WDW3 ($100 in chips) 
Seat 7: flk.Dasas ($100 in chips) 
Seat 9: duanyucheng ($60.73 in chips) 
tipner: posts small blind $0.50
chenconhaste: posts big blind $1
r4mz3s: sits out 
*** HOLE CARDS ***
Dealt to matiko09 [5s 6c]
Tirpo: folds 
WDW3: folds 
flk.Dasas: folds 
duanyucheng: folds 
ilaviiitech: folds 
matiko09: folds 
tipner: folds 
Uncalled bet ($0.50) returned to chenconhaste
chenconhaste collected $1 from pot
*** SUMMARY ***
Total pot $1 | Rake $0 
Seat 1: ilaviiitech folded before Flop (didn't bet)
Seat 2: matiko09 (button) folded before Flop (didn't bet)
Seat 3: tipner (small blind) folded before Flop
Seat 4: chenconhaste (big blind) collected ($1)
Seat 5: Tirpo folded before Flop (didn't bet)
Seat 6: WDW3 folded before Flop (didn't bet)
Seat 7: flk.Dasas folded before Flop (didn't bet)
Seat 9: duanyucheng folded before Flop (didn't bet)





PokerStars Hand #155301087177:  Hold'em No Limit ($0.50/$1.00 USD) - 2016/06/28 16:12:32 CET [2016/06/28 10:12:32 ET]
Table 'Kamenyar' 9-max Seat #1 is the button
Seat 1: flk.Dasas ($100 in chips) 
Seat 2: ozone2003 ($106.68 in chips) 
Seat 3: r4mz3s ($100 in chips) 
Seat 4: f1reworks ($212.41 in chips) 
Seat 5: bwly520 ($327.23 in chips) 
Seat 6: matiko09 ($104.50 in chips) 
Seat 7: Racushniak ($100 in chips) 
Seat 8: sanpidk ($132.36 in chips) 
Seat 9: pyromid ($123.80 in chips) 
ozone2003: posts small blind $0.50
r4mz3s: posts big blind $1
*** HOLE CARDS ***
Dealt to matiko09 [Ah Qh]
f1reworks: folds 
bwly520: folds 
matiko09: raises $2 to $3
Racushniak: folds 
sanpidk: calls $3
pyromid: folds 
flk.Dasas: folds 
ozone2003: raises $9 to $12
r4mz3s: folds 
matiko09: calls $9
sanpidk: calls $9
*** FLOP *** [8c 7s 2h]
ozone2003: checks 
matiko09: bets $11
sanpidk: folds 
ozone2003: folds 
Uncalled bet ($11) returned to matiko09
matiko09 collected $35.15 from pot
matiko09: doesn't show hand 
*** SUMMARY ***
Total pot $37 | Rake $1.85 
Board [8c 7s 2h]
Seat 1: flk.Dasas (button) folded before Flop (didn't bet)
Seat 2: ozone2003 (small blind) folded on the Flop
Seat 3: r4mz3s (big blind) folded before Flop
Seat 4: f1reworks folded before Flop (didn't bet)
Seat 5: bwly520 folded before Flop (didn't bet)
Seat 6: matiko09 collected ($35.15)
Seat 7: Racushniak folded before Flop (didn't bet)
Seat 8: sanpidk folded on the Flop
Seat 9: pyromid folded before Flop (didn't bet)





PokerStars Hand #155301089117:  Hold'em No Limit ($0.50/$1.00 USD) - 2016/06/28 16:12:35 CET [2016/06/28 10:12:35 ET]
Table 'Tynka' 9-max Seat #3 is the button
Seat 1: ilaviiitech ($100 in chips) 
Seat 2: matiko09 ($102.52 in chips) 
Seat 3: tipner ($101.50 in chips) 
Seat 4: chenconhaste ($105.50 in chips) 
Seat 5: Tirpo ($100 in chips) 
Seat 6: WDW3 ($100 in chips) 
Seat 7: flk.Dasas ($100 in chips) 
Seat 9: duanyucheng ($60.73 in chips) 
chenconhaste: posts small blind $0.50
Tirpo: posts big blind $1
r4mz3s: sits out 
*** HOLE CARDS ***
Dealt to matiko09 [Ac 7c]
WDW3: folds 
flk.Dasas: folds 
duanyucheng: folds 
ilaviiitech: folds 
WDW3 leaves the table
matiko09: raises $1.50 to $2.50
tipner: folds 
chenconhaste: folds 
Tirpo: folds 
Uncalled bet ($1.50) returned to matiko09
matiko09 collected $2.50 from pot
matiko09: doesn't show hand 
*** SUMMARY ***
Total pot $2.50 | Rake $0 
Seat 1: ilaviiitech folded before Flop (didn't bet)
Seat 2: matiko09 collected ($2.50)
Seat 3: tipner (button) folded before Flop (didn't bet)
Seat 4: chenconhaste (small blind) folded before Flop
Seat 5: Tirpo (big blind) folded before Flop
Seat 6: WDW3 folded before Flop (didn't bet)
Seat 7: flk.Dasas folded before Flop (didn't bet)
Seat 9: duanyucheng folded before Flop (didn't bet)





PokerStars Hand #155301091296:  Hold'em No Limit ($0.50/$1.00 USD) - 2016/06/28 16:12:39 CET [2016/06/28 10:12:39 ET]
Table 'Dorado II' 9-max Seat #7 is the button
Seat 1: f1reworks ($121.84 in chips) 
Seat 2: vanilica ($100 in chips) 
Seat 3: ghostriderxu ($105.49 in chips) 
Seat 4: pyromid ($119.05 in chips) 
Seat 5: KovIFish89 ($121.52 in chips) 
Seat 6: mycka86 ($102.36 in chips) 
Seat 7: matiko09 ($100 in chips) 
Seat 8: flk.Dasas ($100 in chips) 
Seat 9: r4mz3s ($100 in chips) 
flk.Dasas: posts small blind $0.50
r4mz3s: posts big blind $1
*** HOLE CARDS ***
Dealt to matiko09 [4h 7h]
f1reworks: folds 
vanilica: folds 
ghostriderxu: folds 
pyromid: folds 
KovIFish89: folds 
mycka86: raises $1.10 to $2.10
matiko09: folds 
flk.Dasas: raises $5.90 to $8
r4mz3s: folds 
mycka86: calls $5.90
*** FLOP *** [9c Ad Th]
flk.Dasas: checks 
mycka86: bets $8.88
flk.Dasas: calls $8.88
*** TURN *** [9c Ad Th] [Jh]
flk.Dasas: checks 
mycka86: bets $20.16
flk.Dasas: calls $20.16
*** RIVER *** [9c Ad Th Jh] [6s]
flk.Dasas: checks 
mycka86: bets $65.32 and is all-in
flk.Dasas: calls $62.96 and is all-in
Uncalled bet ($2.36) returned to mycka86
*** SHOW DOWN ***
mycka86: shows [Jc Kc] (a pair of Jacks)
flk.Dasas: shows [Ah As] (three of a kind, Aces)
flk.Dasas collected $198.50 from pot
*** SUMMARY ***
Total pot $201 | Rake $2.50 
Board [9c Ad Th Jh 6s]
Seat 1: f1reworks folded before Flop (didn't bet)
Seat 2: vanilica folded before Flop (didn't bet)
Seat 3: ghostriderxu folded before Flop (didn't bet)
Seat 4: pyromid folded before Flop (didn't bet)
Seat 5: KovIFish89 folded before Flop (didn't bet)
Seat 6: mycka86 showed [Jc Kc] and lost with a pair of Jacks
Seat 7: matiko09 (button) folded before Flop (didn't bet)
Seat 8: flk.Dasas (small blind) showed [Ah As] and won ($198.50) with three of a kind, Aces
Seat 9: r4mz3s (big blind) folded before Flop





PokerStars Hand #155301096703:  Hold'em No Limit ($0.50/$1.00 USD) - 2016/06/28 16:12:49 CET [2016/06/28 10:12:49 ET]
Table 'Vicia II' 9-max Seat #6 is the button
Seat 1: sanpidk ($121.86 in chips) 
Seat 2: Kukuryzka ($101.50 in chips) 
Seat 3: vanilica ($100 in chips) 
Seat 4: vanapeer ($100 in chips) 
Seat 5: wallium ($249.11 in chips) 
Seat 6: ozone2003 ($100 in chips) 
Seat 7: matiko09 ($100 in chips) 
Seat 8: f1reworks ($210.54 in chips) 
Seat 9: r4mz3s ($100 in chips) 
matiko09: posts small blind $0.50
f1reworks: posts big blind $1
*** HOLE CARDS ***
Dealt to matiko09 [Ts 8h]
r4mz3s: folds 
sanpidk: folds 
Kukuryzka: folds 
vanilica: folds 
vanapeer: folds 
wallium: raises $1 to $2
ozone2003: folds 
matiko09: folds 
f1reworks: folds 
Uncalled bet ($1) returned to wallium
wallium collected $2.50 from pot
wallium: doesn't show hand 
*** SUMMARY ***
Total pot $2.50 | Rake $0 
Seat 1: sanpidk folded before Flop (didn't bet)
Seat 2: Kukuryzka folded before Flop (didn't bet)
Seat 3: vanilica folded before Flop (didn't bet)
Seat 4: vanapeer folded before Flop (didn't bet)
Seat 5: wallium collected ($2.50)
Seat 6: ozone2003 (button) folded before Flop (didn't bet)
Seat 7: matiko09 (small blind) folded before Flop
Seat 8: f1reworks (big blind) folded before Flop
Seat 9: r4mz3s folded before Flop (didn't bet)





PokerStars Hand #155301098033:  Hold'em No Limit ($0.25/$0.50 USD) - 2016/06/28 16:12:52 CET [2016/06/28 10:12:52 ET]
Table 'Thyestes II' 9-max Seat #7 is the button
Seat 1: ardo888 ($50.15 in chips) 
Seat 2: matiko09 ($50 in chips) 
Seat 3: seblafstian ($59.95 in chips) 
Seat 5: St.LaCoste ($49.25 in chips) 
Seat 6: superior_pl ($42.18 in chips) 
Seat 7: Vedpapa ($66.58 in chips) 
Seat 8: Azzaj91 ($52.16 in chips) 
Azzaj91: posts small blind $0.25
ardo888: posts big blind $0.50
Domotirko228: sits out 
*** HOLE CARDS ***
Dealt to matiko09 [6d 4s]
matiko09: folds 
seblafstian: folds 
St.LaCoste: raises $1 to $1.50
superior_pl: folds 
Vedpapa: folds 
Azzaj91: raises $1 to $2.50
ardo888: folds 
St.LaCoste: raises $5 to $7.50
Azzaj91: calls $5
*** FLOP *** [2d Kc 7h]
Azzaj91: bets $7.36
St.LaCoste: calls $7.36
*** TURN *** [2d Kc 7h] [Js]
Azzaj91: bets $14.35
St.LaCoste: calls $14.35
*** RIVER *** [2d Kc 7h Js] [Ah]
Azzaj91: checks 
St.LaCoste: bets $20.04 and is all-in
Azzaj91: calls $20.04
*** SHOW DOWN ***
St.LaCoste: shows [Ks Ad] (two pair, Aces and Kings)
Azzaj91: shows [Qs Qh] (a pair of Queens)
St.LaCoste collected $97 from pot
*** SUMMARY ***
Total pot $99 | Rake $2 
Board [2d Kc 7h Js Ah]
Seat 1: ardo888 (big blind) folded before Flop
Seat 2: matiko09 folded before Flop (didn't bet)
Seat 3: seblafstian folded before Flop (didn't bet)
Seat 5: St.LaCoste showed [Ks Ad] and won ($97) with two pair, Aces and Kings
Seat 6: superior_pl folded before Flop (didn't bet)
Seat 7: Vedpapa (button) folded before Flop (didn't bet)
Seat 8: Azzaj91 (small blind) showed [Qs Qh] and lost with a pair of Queens





PokerStars Hand #155301099599:  Hold'em No Limit ($0.50/$1.00 USD) - 2016/06/28 16:12:55 CET [2016/06/28 10:12:55 ET]
Table 'Tynka' 9-max Seat #4 is the button
Seat 1: ilaviiitech ($100 in chips) 
Seat 2: matiko09 ($104.02 in chips) 
Seat 3: tipner ($101.50 in chips) 
Seat 4: chenconhaste ($105 in chips) 
Seat 5: Tirpo ($100 in chips) 
Seat 7: flk.Dasas ($100 in chips) 
Seat 9: duanyucheng ($60.73 in chips) 
Tirpo: posts small blind $0.50
flk.Dasas: posts big blind $1
r4mz3s: sits out 
*** HOLE CARDS ***
Dealt to matiko09 [As Qc]
duanyucheng: folds 
ilaviiitech: folds 
matiko09: raises $2 to $3
tipner: folds 
chenconhaste: folds 
Tirpo: folds 
flk.Dasas: folds 
Uncalled bet ($2) returned to matiko09
matiko09 collected $2.50 from pot
matiko09: doesn't show hand 
*** SUMMARY ***
Total pot $2.50 | Rake $0 
Seat 1: ilaviiitech folded before Flop (didn't bet)
Seat 2: matiko09 collected ($2.50)
Seat 3: tipner folded before Flop (didn't bet)
Seat 4: chenconhaste (button) folded before Flop (didn't bet)
Seat 5: Tirpo (small blind) folded before Flop
Seat 7: flk.Dasas (big blind) folded before Flop
Seat 9: duanyucheng folded before Flop (didn't bet)





PokerStars Hand #155301105732:  Hold'em No Limit ($0.50/$1.00 USD) - 2016/06/28 16:13:06 CET [2016/06/28 10:13:06 ET]
Table 'Anitra' 9-max Seat #4 is the button
Seat 4: Rohitbarve ($41 in chips) 
Seat 5: er13to ($100 in chips) 
Seat 6: matiko09 ($100 in chips) 
er13to: posts small blind $0.50
matiko09: posts big blind $1
sanpidk: sits out 
*** HOLE CARDS ***
Dealt to matiko09 [9c 2c]
Rohitbarve: folds 
er13to: folds 
Uncalled bet ($0.50) returned to matiko09
matiko09 collected $1 from pot
matiko09: doesn't show hand 
*** SUMMARY ***
Total pot $1 | Rake $0 
Seat 4: Rohitbarve (button) folded before Flop (didn't bet)
Seat 5: er13to (small blind) folded before Flop
Seat 6: matiko09 (big blind) collected ($1)





PokerStars Hand #155301106813:  Hold'em No Limit ($0.50/$1.00 USD) - 2016/06/28 16:13:08 CET [2016/06/28 10:13:08 ET]
Table 'Tynka' 9-max Seat #5 is the button
Seat 1: ilaviiitech ($100 in chips) 
Seat 2: matiko09 ($105.52 in chips) 
Seat 3: tipner ($101.50 in chips) 
Seat 4: chenconhaste ($105 in chips) 
Seat 5: Tirpo ($100 in chips) 
Seat 7: flk.Dasas ($100 in chips) 
Seat 8: r4mz3s ($100 in chips) 
Seat 9: duanyucheng ($60.73 in chips) 
flk.Dasas: posts small blind $0.50
r4mz3s: posts big blind $1
*** HOLE CARDS ***
Dealt to matiko09 [Qs Tc]
myatiy 96 joins the table at seat #6 
myatiy 96 leaves the table
duanyucheng: folds 
ilaviiitech: folds 
matiko09: folds 
f1reworks joins the table at seat #6 
tipner: folds 
chenconhaste: folds 
Tirpo: folds 
tipner leaves the table
flk.Dasas: raises $2 to $3
r4mz3s: folds 
Uncalled bet ($2) returned to flk.Dasas
flk.Dasas collected $2 from pot
flk.Dasas: doesn't show hand 
*** SUMMARY ***
Total pot $2 | Rake $0 
Seat 1: ilaviiitech folded before Flop (didn't bet)
Seat 2: matiko09 folded before Flop (didn't bet)
Seat 3: tipner folded before Flop (didn't bet)
Seat 4: chenconhaste folded before Flop (didn't bet)
Seat 5: Tirpo (button) folded before Flop (didn't bet)
Seat 7: flk.Dasas (small blind) collected ($2)
Seat 8: r4mz3s (big blind) folded before Flop
Seat 9: duanyucheng folded before Flop (didn't bet)





PokerStars Hand #155301110296:  Hold'em No Limit ($0.25/$0.50 USD) - 2016/06/28 16:13:15 CET [2016/06/28 10:13:15 ET]
Table 'Utra' 9-max Seat #8 is the button
Seat 1: ardo888 ($56.74 in chips) 
Seat 2: matiko09 ($80.47 in chips) 
Seat 3: mycka86 ($62.39 in chips) 
Seat 4: myatiy 96 ($50 in chips) 
Seat 6: Franky77200 ($80.70 in chips) 
Seat 7: el.suertero ($58.86 in chips) 
Seat 8: fudzi ($50 in chips) 
Seat 9: Kukuryzka ($56.36 in chips) 
Kukuryzka: posts small blind $0.25
ardo888: posts big blind $0.50
er13to: sits out 
ardo888: posts the ante $0.10
matiko09: posts the ante $0.10
mycka86: posts the ante $0.10
myatiy 96: posts the ante $0.10
Franky77200: posts the ante $0.10
el.suertero: posts the ante $0.10
fudzi: posts the ante $0.10
Kukuryzka: posts the ante $0.10
*** HOLE CARDS ***
Dealt to matiko09 [Ks Jc]
matiko09: folds 
mycka86: raises $1.25 to $1.75
myatiy 96: folds 
Franky77200: folds 
el.suertero: folds 
fudzi: folds 
Kukuryzka: folds 
ardo888: folds 
Uncalled bet ($1.25) returned to mycka86
mycka86 collected $2.05 from pot
*** SUMMARY ***
Total pot $2.05 | Rake $0 
Seat 1: ardo888 (big blind) folded before Flop
Seat 2: matiko09 folded before Flop (didn't bet)
Seat 3: mycka86 collected ($2.05)
Seat 4: myatiy 96 folded before Flop (didn't bet)
Seat 6: Franky77200 folded before Flop (didn't bet)
Seat 7: el.suertero folded before Flop (didn't bet)
Seat 8: fudzi (button) folded before Flop (didn't bet)
Seat 9: Kukuryzka (small blind) folded before Flop





PokerStars Hand #155301110814:  Hold'em No Limit ($0.50/$1.00 USD) - 2016/06/28 16:13:16 CET [2016/06/28 10:13:16 ET]
Table 'Anitra' 9-max Seat #5 is the button
Seat 4: Rohitbarve ($41 in chips) 
Seat 5: er13to ($100 in chips) 
Seat 6: matiko09 ($100.50 in chips) 
Seat 7: sanpidk ($100 in chips) 
matiko09: posts small blind $0.50
sanpidk: posts big blind $1
*** HOLE CARDS ***
Dealt to matiko09 [Tc Qs]
chenconhaste joins the table at seat #9 
Rohitbarve: raises $1 to $2
vanilica joins the table at seat #8 
er13to: raises $7 to $9
matiko09: folds 
sanpidk: folds 
Rohitbarve: calls $7
*** FLOP *** [9d Qh Ts]
Rohitbarve: checks 
er13to: checks 
*** TURN *** [9d Qh Ts] [7s]
Rohitbarve: bets $10
er13to: folds 
Uncalled bet ($10) returned to Rohitbarve
Rohitbarve collected $18.52 from pot
Rohitbarve: doesn't show hand 
*** SUMMARY ***
Total pot $19.50 | Rake $0.98 
Board [9d Qh Ts 7s]
Seat 4: Rohitbarve collected ($18.52)
Seat 5: er13to (button) folded on the Turn
Seat 6: matiko09 (small blind) folded before Flop
Seat 7: sanpidk (big blind) folded before Flop





PokerStars Hand #155301115202:  Hold'em No Limit ($0.50/$1.00 USD) - 2016/06/28 16:13:24 CET [2016/06/28 10:13:24 ET]
Table 'Vicia II' 9-max Seat #7 is the button
Seat 1: sanpidk ($121.86 in chips) 
Seat 2: Kukuryzka ($101.50 in chips) 
Seat 3: vanilica ($100 in chips) 
Seat 4: vanapeer ($100 in chips) 
Seat 5: wallium ($250.61 in chips) 
Seat 6: ozone2003 ($100 in chips) 
Seat 7: matiko09 ($100 in chips) 
Seat 8: f1reworks ($209.54 in chips) 
Seat 9: r4mz3s ($100 in chips) 
f1reworks: posts small blind $0.50
r4mz3s: posts big blind $1
*** HOLE CARDS ***
Dealt to matiko09 [Qh 9c]
sanpidk: folds 
Kukuryzka: folds 
vanilica: folds 
vanapeer: raises $1.50 to $2.50
wallium: calls $2.50
ozone2003: folds 
matiko09: folds 
f1reworks: folds 
r4mz3s: folds 
*** FLOP *** [6h Jc 9d]
vanapeer: bets $3.50
wallium: folds 
Uncalled bet ($3.50) returned to vanapeer
vanapeer collected $6.18 from pot
vanapeer: doesn't show hand 
*** SUMMARY ***
Total pot $6.50 | Rake $0.32 
Board [6h Jc 9d]
Seat 1: sanpidk folded before Flop (didn't bet)
Seat 2: Kukuryzka folded before Flop (didn't bet)
Seat 3: vanilica folded before Flop (didn't bet)
Seat 4: vanapeer collected ($6.18)
Seat 5: wallium folded on the Flop
Seat 6: ozone2003 folded before Flop (didn't bet)
Seat 7: matiko09 (button) folded before Flop (didn't bet)
Seat 8: f1reworks (small blind) folded before Flop
Seat 9: r4mz3s (big blind) folded before Flop





PokerStars Hand #155301124350:  Hold'em No Limit ($0.25/$0.50 USD) - 2016/06/28 16:13:41 CET [2016/06/28 10:13:41 ET]
Table 'Vaino II' 9-max Seat #8 is the button
Seat 1: Vedpapa ($50.25 in chips) 
Seat 2: matiko09 ($50 in chips) 
Seat 3: chenconhaste ($56.30 in chips) 
Seat 4: fudzi ($95.65 in chips) 
Seat 5: Sak N0eL ($53.13 in chips) 
Seat 6: denitz21 ($51.14 in chips) 
Seat 7: er13to ($50 in chips) 
Seat 8: Domotirko228 ($50 in chips) 
Vedpapa: posts small blind $0.25
matiko09: posts big blind $0.50
*** HOLE CARDS ***
Dealt to matiko09 [Jh 7d]
chenconhaste: folds 
fudzi: folds 
Sak N0eL: folds 
denitz21: folds 
er13to: raises $0.86 to $1.36
Domotirko228: folds 
Vedpapa: folds 
matiko09: folds 
Uncalled bet ($0.86) returned to er13to
er13to collected $1.25 from pot
*** SUMMARY ***
Total pot $1.25 | Rake $0 
Seat 1: Vedpapa (small blind) folded before Flop
Seat 2: matiko09 (big blind) folded before Flop
Seat 3: chenconhaste folded before Flop (didn't bet)
Seat 4: fudzi folded before Flop (didn't bet)
Seat 5: Sak N0eL folded before Flop (didn't bet)
Seat 6: denitz21 folded before Flop (didn't bet)
Seat 7: er13to collected ($1.25)
Seat 8: Domotirko228 (button) folded before Flop (didn't bet)





PokerStars Hand #155301126973:  Hold'em No Limit ($0.50/$1.00 USD) - 2016/06/28 16:13:46 CET [2016/06/28 10:13:46 ET]
Table 'Lyyli II' 9-max Seat #1 is the button
Seat 1: tipner ($109.98 in chips) 
Seat 2: CI58 ($117.02 in chips) 
Seat 3: Racushniak ($100 in chips) 
Seat 4: Greha999 ($157.42 in chips) 
Seat 5: flk.Dasas ($100.50 in chips) 
Seat 6: matiko09 ($129.94 in chips) 
Seat 7: Kukuryzka ($187.69 in chips) 
Seat 8: r4mz3s ($116.09 in chips) 
Seat 9: f1reworks ($100.20 in chips) 
CI58: posts small blind $0.50
Racushniak: posts big blind $1
*** HOLE CARDS ***
Dealt to matiko09 [8h 7s]
Greha999: folds 
flk.Dasas: folds 
matiko09: folds 
Kukuryzka: folds 
r4mz3s: folds 
f1reworks: folds 
tipner: raises $1.50 to $2.50
CI58: folds 
Racushniak: calls $1.50
*** FLOP *** [Qc 5s Th]
Racushniak: checks 
tipner: checks 
*** TURN *** [Qc 5s Th] [8c]
Racushniak: bets $7.72
tipner: folds 
Uncalled bet ($7.72) returned to Racushniak
Racushniak collected $5.22 from pot
Racushniak: doesn't show hand 
*** SUMMARY ***
Total pot $5.50 | Rake $0.28 
Board [Qc 5s Th 8c]
Seat 1: tipner (button) folded on the Turn
Seat 2: CI58 (small blind) folded before Flop
Seat 3: Racushniak (big blind) collected ($5.22)
Seat 4: Greha999 folded before Flop (didn't bet)
Seat 5: flk.Dasas folded before Flop (didn't bet)
Seat 6: matiko09 folded before Flop (didn't bet)
Seat 7: Kukuryzka folded before Flop (didn't bet)
Seat 8: r4mz3s folded before Flop (didn't bet)
Seat 9: f1reworks folded before Flop (didn't bet)





PokerStars Hand #155301129143:  Hold'em No Limit ($0.25/$0.50 USD) - 2016/06/28 16:13:50 CET [2016/06/28 10:13:50 ET]
Table 'Utra' 9-max Seat #9 is the button
Seat 1: ardo888 ($56.14 in chips) 
Seat 2: matiko09 ($80.37 in chips) 
Seat 3: mycka86 ($63.84 in chips) 
Seat 4: myatiy 96 ($50 in chips) 
Seat 6: Franky77200 ($80.60 in chips) 
Seat 7: el.suertero ($58.76 in chips) 
Seat 8: fudzi ($50 in chips) 
Seat 9: Kukuryzka ($56.01 in chips) 
ardo888: posts small blind $0.25
matiko09: posts big blind $0.50
er13to: sits out 
ardo888: posts the ante $0.10
matiko09: posts the ante $0.10
mycka86: posts the ante $0.10
myatiy 96: posts the ante $0.10
Franky77200: posts the ante $0.10
el.suertero: posts the ante $0.10
fudzi: posts the ante $0.10
Kukuryzka: posts the ante $0.10
*** HOLE CARDS ***
Dealt to matiko09 [8c 5h]
mycka86: folds 
myatiy 96: folds 
Franky77200: raises $1 to $1.50
el.suertero: folds 
fudzi: folds 
Kukuryzka: folds 
ardo888: folds 
matiko09: folds 
Uncalled bet ($1) returned to Franky77200
Franky77200 collected $2.05 from pot
Franky77200: doesn't show hand 
*** SUMMARY ***
Total pot $2.05 | Rake $0 
Seat 1: ardo888 (small blind) folded before Flop
Seat 2: matiko09 (big blind) folded before Flop
Seat 3: mycka86 folded before Flop (didn't bet)
Seat 4: myatiy 96 folded before Flop (didn't bet)
Seat 6: Franky77200 collected ($2.05)
Seat 7: el.suertero folded before Flop (didn't bet)
Seat 8: fudzi folded before Flop (didn't bet)
Seat 9: Kukuryzka (button) folded before Flop (didn't bet)





PokerStars Hand #155301131837:  Hold'em No Limit ($0.50/$1.00 USD) - 2016/06/28 16:13:55 CET [2016/06/28 10:13:55 ET]
Table 'Anitra' 9-max Seat #6 is the button
Seat 4: Rohitbarve ($50.52 in chips) 
Seat 5: er13to ($100 in chips) 
Seat 6: matiko09 ($100 in chips) 
Seat 7: sanpidk ($100 in chips) 
Seat 8: vanilica ($100 in chips) 
sanpidk: posts small blind $0.50
vanilica: posts big blind $1
chenconhaste: sits out 
*** HOLE CARDS ***
Dealt to matiko09 [Jc 4d]
Rohitbarve: calls $1
er13to: folds 
matiko09: folds 
sanpidk: raises $3.50 to $4.50
vanilica: folds 
Rohitbarve: calls $3.50
*** FLOP *** [Qd 8c Ah]
sanpidk: checks 
Rohitbarve: checks 
*** TURN *** [Qd 8c Ah] [3h]
sanpidk: checks 
Rohitbarve: checks 
*** RIVER *** [Qd 8c Ah 3h] [5c]
sanpidk: bets $5
Klappspaten0 joins the table at seat #1 
Rohitbarve: folds 
Uncalled bet ($5) returned to sanpidk
sanpidk collected $9.50 from pot
sanpidk: doesn't show hand 
*** SUMMARY ***
Total pot $10 | Rake $0.50 
Board [Qd 8c Ah 3h 5c]
Seat 4: Rohitbarve folded on the River
Seat 5: er13to folded before Flop (didn't bet)
Seat 6: matiko09 (button) folded before Flop (didn't bet)
Seat 7: sanpidk (small blind) collected ($9.50)
Seat 8: vanilica (big blind) folded before Flop





PokerStars Hand #155301138568:  Hold'em No Limit ($0.25/$0.50 USD) - 2016/06/28 16:14:08 CET [2016/06/28 10:14:08 ET]
Table 'Vaino II' 9-max Seat #1 is the button
Seat 1: Vedpapa ($50 in chips) 
Seat 2: matiko09 ($50 in chips) 
Seat 3: chenconhaste ($56.30 in chips) 
Seat 4: fudzi ($95.65 in chips) 
Seat 5: Sak N0eL ($53.13 in chips) 
Seat 6: denitz21 ($51.14 in chips) 
Seat 7: er13to ($50.75 in chips) 
Seat 8: Domotirko228 ($50 in chips) 
matiko09: posts small blind $0.25
chenconhaste: posts big blind $0.50
*** HOLE CARDS ***
Dealt to matiko09 [3d Js]
fudzi: folds 
Sak N0eL: folds 
denitz21: folds 
er13to: raises $0.86 to $1.36
pandalapa joins the table at seat #9 
Domotirko228: folds 
Vedpapa: calls $1.36
matiko09: folds 
chenconhaste: folds 
*** FLOP *** [5d 6s 9s]
er13to: bets $2.17
Vedpapa: calls $2.17
*** TURN *** [5d 6s 9s] [Ac]
er13to: bets $5.71
Vedpapa: folds 
Uncalled bet ($5.71) returned to er13to
er13to collected $7.42 from pot
*** SUMMARY ***
Total pot $7.81 | Rake $0.39 
Board [5d 6s 9s Ac]
Seat 1: Vedpapa (button) folded on the Turn
Seat 2: matiko09 (small blind) folded before Flop
Seat 3: chenconhaste (big blind) folded before Flop
Seat 4: fudzi folded before Flop (didn't bet)
Seat 5: Sak N0eL folded before Flop (didn't bet)
Seat 6: denitz21 folded before Flop (didn't bet)
Seat 7: er13to collected ($7.42)
Seat 8: Domotirko228 folded before Flop (didn't bet)





PokerStars Hand #155301139137:  Hold'em No Limit ($0.50/$1.00 USD) - 2016/06/28 16:14:10 CET [2016/06/28 10:14:10 ET]
Table 'Vicia II' 9-max Seat #8 is the button
Seat 1: sanpidk ($121.86 in chips) 
Seat 2: Kukuryzka ($101.50 in chips) 
Seat 3: vanilica ($100 in chips) 
Seat 4: vanapeer ($103.68 in chips) 
Seat 5: wallium ($248.11 in chips) 
Seat 6: ozone2003 ($100 in chips) 
Seat 7: matiko09 ($100 in chips) 
Seat 8: f1reworks ($209.04 in chips) 
Seat 9: r4mz3s ($100 in chips) 
r4mz3s: posts small blind $0.50
sanpidk: posts big blind $1
*** HOLE CARDS ***
Dealt to matiko09 [7c 5c]
Kukuryzka: raises $2 to $3
vanilica: folds 
vanapeer: folds 
wallium: folds 
ozone2003: folds 
matiko09: folds 
f1reworks: folds 
r4mz3s: raises $7.50 to $10.50
sanpidk: folds 
Kukuryzka: calls $7.50
*** FLOP *** [4s 6c 5s]
r4mz3s: checks 
Kukuryzka: bets $10.45
r4mz3s: folds 
Uncalled bet ($10.45) returned to Kukuryzka
Kukuryzka collected $20.90 from pot
Kukuryzka: doesn't show hand 
*** SUMMARY ***
Total pot $22 | Rake $1.10 
Board [4s 6c 5s]
Seat 1: sanpidk (big blind) folded before Flop
Seat 2: Kukuryzka collected ($20.90)
Seat 3: vanilica folded before Flop (didn't bet)
Seat 4: vanapeer folded before Flop (didn't bet)
Seat 5: wallium folded before Flop (didn't bet)
Seat 6: ozone2003 folded before Flop (didn't bet)
Seat 7: matiko09 folded before Flop (didn't bet)
Seat 8: f1reworks (button) folded before Flop (didn't bet)
Seat 9: r4mz3s (small blind) folded on the Flop





PokerStars Hand #155301142247:  Hold'em No Limit ($0.25/$0.50 USD) - 2016/06/28 16:14:16 CET [2016/06/28 10:14:16 ET]
Table 'Utra' 9-max Seat #1 is the button
Seat 1: ardo888 ($55.79 in chips) 
Seat 2: matiko09 ($79.77 in chips) 
Seat 3: mycka86 ($63.74 in chips) 
Seat 4: myatiy 96 ($50 in chips) 
Seat 6: Franky77200 ($82.05 in chips) 
Seat 7: el.suertero ($58.66 in chips) 
Seat 8: fudzi ($50 in chips) 
Seat 9: Kukuryzka ($55.91 in chips) 
matiko09: posts small blind $0.25
mycka86: posts big blind $0.50
er13to: sits out 
ardo888: posts the ante $0.10
matiko09: posts the ante $0.10
mycka86: posts the ante $0.10
myatiy 96: posts the ante $0.10
Franky77200: posts the ante $0.10
el.suertero: posts the ante $0.10
fudzi: posts the ante $0.10
Kukuryzka: posts the ante $0.10
*** HOLE CARDS ***
Dealt to matiko09 [Td 5d]
myatiy 96: folds 
Franky77200: raises $1 to $1.50
el.suertero: raises $3 to $4.50
fudzi: folds 
Kukuryzka: folds 
ardo888: folds 
matiko09: folds 
mycka86: folds 
Franky77200: calls $3
*** FLOP *** [Kc 4s 2c]
Franky77200: checks 
el.suertero: bets $7.51
Franky77200: calls $7.51
*** TURN *** [Kc 4s 2c] [3d]
Franky77200: checks 
el.suertero: bets $14
Franky77200: folds 
Uncalled bet ($14) returned to el.suertero
el.suertero collected $24.29 from pot
el.suertero: doesn't show hand 
*** SUMMARY ***
Total pot $25.57 | Rake $1.28 
Board [Kc 4s 2c 3d]
Seat 1: ardo888 (button) folded before Flop (didn't bet)
Seat 2: matiko09 (small blind) folded before Flop
Seat 3: mycka86 (big blind) folded before Flop
Seat 4: myatiy 96 folded before Flop (didn't bet)
Seat 6: Franky77200 folded on the Turn
Seat 7: el.suertero collected ($24.29)
Seat 8: fudzi folded before Flop (didn't bet)
Seat 9: Kukuryzka folded before Flop (didn't bet)





PokerStars Hand #155301153066:  Hold'em No Limit ($0.50/$1.00 USD) - 2016/06/28 16:14:36 CET [2016/06/28 10:14:36 ET]
Table 'Kamenyar' 9-max Seat #2 is the button
Seat 1: flk.Dasas ($100 in chips) 
Seat 2: ozone2003 ($100 in chips) 
Seat 3: r4mz3s ($100 in chips) 
Seat 4: f1reworks ($212.41 in chips) 
Seat 5: bwly520 ($327.23 in chips) 
Seat 6: matiko09 ($127.65 in chips) 
Seat 7: Racushniak ($100 in chips) 
Seat 8: sanpidk ($120.36 in chips) 
Seat 9: pyromid ($123.80 in chips) 
r4mz3s: posts small blind $0.50
f1reworks: posts big blind $1
*** HOLE CARDS ***
Dealt to matiko09 [5d 4c]
bwly520: raises $2 to $3
matiko09: folds 
Racushniak: folds 
sanpidk: folds 
pyromid: calls $3
flk.Dasas: folds 
ozone2003: folds 
r4mz3s: folds 
f1reworks: calls $2
*** FLOP *** [Ks 3s As]
f1reworks: checks 
bwly520: bets $5
pyromid: calls $5
f1reworks: folds 
*** TURN *** [Ks 3s As] [5c]
bwly520: checks 
pyromid: bets $9.26
bwly520: calls $9.26
*** RIVER *** [Ks 3s As 5c] [4d]
bwly520: checks 
pyromid: bets $18.06
bwly520: calls $18.06
*** SHOW DOWN ***
pyromid: shows [3d Ad] (two pair, Aces and Threes)
bwly520: mucks hand 
pyromid collected $71.64 from pot
*** SUMMARY ***
Total pot $74.14 | Rake $2.50 
Board [Ks 3s As 5c 4d]
Seat 1: flk.Dasas folded before Flop (didn't bet)
Seat 2: ozone2003 (button) folded before Flop (didn't bet)
Seat 3: r4mz3s (small blind) folded before Flop
Seat 4: f1reworks (big blind) folded on the Flop
Seat 5: bwly520 mucked [6s Ah]
Seat 6: matiko09 folded before Flop (didn't bet)
Seat 7: Racushniak folded before Flop (didn't bet)
Seat 8: sanpidk folded before Flop (didn't bet)
Seat 9: pyromid showed [3d Ad] and won ($71.64) with two pair, Aces and Threes





PokerStars Hand #155301153999:  Hold'em No Limit ($0.25/$0.50 USD) - 2016/06/28 16:14:38 CET [2016/06/28 10:14:38 ET]
Table 'Thyestes II' 9-max Seat #8 is the button
Seat 1: ardo888 ($50 in chips) 
Seat 2: matiko09 ($50 in chips) 
Seat 3: seblafstian ($59.95 in chips) 
Seat 5: St.LaCoste ($97 in chips) 
Seat 6: superior_pl ($42.18 in chips) 
Seat 7: Vedpapa ($66.58 in chips) 
Seat 8: Azzaj91 ($2.91 in chips) 
pandalapa will be allowed to play after the button
ardo888: posts small blind $0.25
matiko09: posts big blind $0.50
Domotirko228: sits out 
*** HOLE CARDS ***
Dealt to matiko09 [4h 5c]
seblafstian: folds 
St.LaCoste: folds 
superior_pl: folds 
Vedpapa: folds 
Azzaj91: folds 
ardo888: folds 
Uncalled bet ($0.25) returned to matiko09
matiko09 collected $0.50 from pot
matiko09: doesn't show hand 
*** SUMMARY ***
Total pot $0.50 | Rake $0 
Seat 1: ardo888 (small blind) folded before Flop
Seat 2: matiko09 (big blind) collected ($0.50)
Seat 3: seblafstian folded before Flop (didn't bet)
Seat 5: St.LaCoste folded before Flop (didn't bet)
Seat 6: superior_pl folded before Flop (didn't bet)
Seat 7: Vedpapa folded before Flop (didn't bet)
Seat 8: Azzaj91 (button) folded before Flop (didn't bet)





PokerStars Hand #155301156321:  Hold'em No Limit ($0.50/$1.00 USD) - 2016/06/28 16:14:42 CET [2016/06/28 10:14:42 ET]
Table 'Anitra' 9-max Seat #7 is the button
Seat 4: Rohitbarve ($46.02 in chips) 
Seat 5: er13to ($100 in chips) 
Seat 6: matiko09 ($100 in chips) 
Seat 7: sanpidk ($105 in chips) 
Seat 8: vanilica ($100 in chips) 
Seat 9: chenconhaste ($100 in chips) 
vanilica: posts small blind $0.50
chenconhaste: posts big blind $1
Klappspaten0: sits out 
*** HOLE CARDS ***
Dealt to matiko09 [7d Kc]
Rohitbarve: folds 
Rohitbarve leaves the table
er13to: folds 
matiko09: folds 
sanpidk: raises $1.24 to $2.24
vanilica: folds 
chenconhaste: raises $7.76 to $10
sanpidk: raises $14 to $24
chenconhaste: folds 
Uncalled bet ($14) returned to sanpidk
sanpidk collected $20.50 from pot
sanpidk: doesn't show hand 
*** SUMMARY ***
Total pot $20.50 | Rake $0 
Seat 4: Rohitbarve folded before Flop (didn't bet)
Seat 5: er13to folded before Flop (didn't bet)
Seat 6: matiko09 folded before Flop (didn't bet)
Seat 7: sanpidk (button) collected ($20.50)
Seat 8: vanilica (small blind) folded before Flop
Seat 9: chenconhaste (big blind) folded before Flop





PokerStars Hand #155301165664:  Hold'em No Limit ($0.50/$1.00 USD) - 2016/06/28 16:14:59 CET [2016/06/28 10:14:59 ET]
Table 'Lyyli II' 9-max Seat #2 is the button
Seat 1: tipner ($107.48 in chips) 
Seat 2: CI58 ($116.52 in chips) 
Seat 3: Racushniak ($102.72 in chips) 
Seat 4: Greha999 ($157.42 in chips) 
Seat 5: flk.Dasas ($100.50 in chips) 
Seat 6: matiko09 ($129.94 in chips) 
Seat 7: Kukuryzka ($187.69 in chips) 
Seat 8: r4mz3s ($116.09 in chips) 
Seat 9: f1reworks ($100.20 in chips) 
Racushniak: posts small blind $0.50
Greha999: posts big blind $1
*** HOLE CARDS ***
Dealt to matiko09 [8c Qc]
flk.Dasas: folds 
matiko09: folds 
Kukuryzka: folds 
r4mz3s: folds 
f1reworks: folds 
tipner: folds 
CI58: raises $1 to $2
Racushniak: folds 
Greha999: calls $1
*** FLOP *** [8s Js 4h]
Greha999: checks 
CI58: checks 
*** TURN *** [8s Js 4h] [4d]
Greha999: bets $3
CI58: folds 
Uncalled bet ($3) returned to Greha999
Greha999 collected $4.28 from pot
*** SUMMARY ***
Total pot $4.50 | Rake $0.22 
Board [8s Js 4h 4d]
Seat 1: tipner folded before Flop (didn't bet)
Seat 2: CI58 (button) folded on the Turn
Seat 3: Racushniak (small blind) folded before Flop
Seat 4: Greha999 (big blind) collected ($4.28)
Seat 5: flk.Dasas folded before Flop (didn't bet)
Seat 6: matiko09 folded before Flop (didn't bet)
Seat 7: Kukuryzka folded before Flop (didn't bet)
Seat 8: r4mz3s folded before Flop (didn't bet)
Seat 9: f1reworks folded before Flop (didn't bet)





PokerStars Hand #155301169776:  Hold'em No Limit ($0.25/$0.50 USD) - 2016/06/28 16:15:07 CET [2016/06/28 10:15:07 ET]
Table 'Vaino II' 9-max Seat #2 is the button
Seat 1: Vedpapa ($50 in chips) 
Seat 2: matiko09 ($50 in chips) 
Seat 3: chenconhaste ($55.80 in chips) 
Seat 4: fudzi ($95.65 in chips) 
Seat 5: Sak N0eL ($53.13 in chips) 
Seat 6: denitz21 ($51.14 in chips) 
Seat 7: er13to ($54.64 in chips) 
Seat 8: Domotirko228 ($50 in chips) 
chenconhaste: posts small blind $0.25
fudzi: posts big blind $0.50
pandalapa: sits out 
*** HOLE CARDS ***
Dealt to matiko09 [9c Qd]
Sak N0eL: calls $0.50
denitz21: folds 
er13to: folds 
Domotirko228: raises $1.75 to $2.25
Vedpapa: folds 
matiko09: folds 
chenconhaste: folds 
fudzi: folds 
Sak N0eL: calls $1.75
*** FLOP *** [Tc 2s 5h]
Sak N0eL: checks 
Domotirko228: bets $2.49
Sak N0eL: folds 
Uncalled bet ($2.49) returned to Domotirko228
Domotirko228 collected $4.99 from pot
Domotirko228: doesn't show hand 
*** SUMMARY ***
Total pot $5.25 | Rake $0.26 
Board [Tc 2s 5h]
Seat 1: Vedpapa folded before Flop (didn't bet)
Seat 2: matiko09 (button) folded before Flop (didn't bet)
Seat 3: chenconhaste (small blind) folded before Flop
Seat 4: fudzi (big blind) folded before Flop
Seat 5: Sak N0eL folded on the Flop
Seat 6: denitz21 folded before Flop (didn't bet)
Seat 7: er13to folded before Flop (didn't bet)
Seat 8: Domotirko228 collected ($4.99)





PokerStars Hand #155301171133:  Hold'em No Limit ($0.50/$1.00 USD) - 2016/06/28 16:15:09 CET [2016/06/28 10:15:09 ET]
Table 'Josephina II' 9-max Seat #8 is the button
Seat 1: matiko09 ($100 in chips) 
Seat 2: vanapeer ($105.28 in chips) 
Seat 3: r4mz3s ($100 in chips) 
Seat 4: sanpidk ($145.61 in chips) 
Seat 5: vanilica ($118.59 in chips) 
Seat 6: ozone2003 ($173.36 in chips) 
Seat 7: KovIFish89 ($107.79 in chips) 
Seat 8: Rabinho588 ($133.56 in chips) 
Seat 9: tipner ($105.10 in chips) 
tipner: posts small blind $0.50
matiko09: posts big blind $1
*** HOLE CARDS ***
Dealt to matiko09 [5d Ad]
vanapeer: folds 
r4mz3s: folds 
sanpidk: raises $2 to $3
vanilica: folds 
ozone2003: calls $3
KovIFish89: folds 
Rabinho588: folds 
tipner: folds 
matiko09: folds 
*** FLOP *** [6c 5h 4d]
sanpidk: checks 
ozone2003: bets $4.63
sanpidk: folds 
Uncalled bet ($4.63) returned to ozone2003
ozone2003 collected $7.12 from pot
ozone2003: doesn't show hand 
*** SUMMARY ***
Total pot $7.50 | Rake $0.38 
Board [6c 5h 4d]
Seat 1: matiko09 (big blind) folded before Flop
Seat 2: vanapeer folded before Flop (didn't bet)
Seat 3: r4mz3s folded before Flop (didn't bet)
Seat 4: sanpidk folded on the Flop
Seat 5: vanilica folded before Flop (didn't bet)
Seat 6: ozone2003 collected ($7.12)
Seat 7: KovIFish89 folded before Flop (didn't bet)
Seat 8: Rabinho588 (button) folded before Flop (didn't bet)
Seat 9: tipner (small blind) folded before Flop





PokerStars Hand #155301171927:  Hold'em No Limit ($0.25/$0.50 USD) - 2016/06/28 16:15:11 CET [2016/06/28 10:15:11 ET]
Table 'Utra' 9-max Seat #2 is the button
Seat 1: ardo888 ($55.69 in chips) 
Seat 2: matiko09 ($79.42 in chips) 
Seat 3: mycka86 ($63.14 in chips) 
Seat 4: myatiy 96 ($50 in chips) 
Seat 6: Franky77200 ($69.94 in chips) 
Seat 7: el.suertero ($70.84 in chips) 
Seat 8: fudzi ($50 in chips) 
Seat 9: Kukuryzka ($55.81 in chips) 
mycka86: posts small blind $0.25
myatiy 96: posts big blind $0.50
er13to: sits out 
ardo888: posts the ante $0.10
matiko09: posts the ante $0.10
mycka86: posts the ante $0.10
myatiy 96: posts the ante $0.10
Franky77200: posts the ante $0.10
el.suertero: posts the ante $0.10
fudzi: posts the ante $0.10
Kukuryzka: posts the ante $0.10
*** HOLE CARDS ***
Dealt to matiko09 [6s 7s]
Franky77200: folds 
el.suertero: folds 
fudzi: folds 
Kukuryzka: raises $1 to $1.50
ardo888: raises $3.50 to $5
matiko09: folds 
mycka86: folds 
myatiy 96: folds 
Kukuryzka: raises $6 to $11
ardo888: calls $6
*** FLOP *** [Js 9s 5h]
Kukuryzka: bets $7.38
ardo888: calls $7.38
*** TURN *** [Js 9s 5h] [9d]
Kukuryzka: bets $37.33 and is all-in
ardo888: folds 
Uncalled bet ($37.33) returned to Kukuryzka
Kukuryzka collected $36.39 from pot
Kukuryzka: doesn't show hand 
*** SUMMARY ***
Total pot $38.31 | Rake $1.92 
Board [Js 9s 5h 9d]
Seat 1: ardo888 folded on the Turn
Seat 2: matiko09 (button) folded before Flop (didn't bet)
Seat 3: mycka86 (small blind) folded before Flop
Seat 4: myatiy 96 (big blind) folded before Flop
Seat 6: Franky77200 folded before Flop (didn't bet)
Seat 7: el.suertero folded before Flop (didn't bet)
Seat 8: fudzi folded before Flop (didn't bet)
Seat 9: Kukuryzka collected ($36.39)





PokerStars Hand #155301173150:  Hold'em No Limit ($0.25/$0.50 USD) - 2016/06/28 16:15:13 CET [2016/06/28 10:15:13 ET]
Table 'Thyestes II' 9-max Seat #1 is the button
Seat 1: ardo888 ($50 in chips) 
Seat 2: matiko09 ($50.25 in chips) 
Seat 3: seblafstian ($59.95 in chips) 
Seat 5: St.LaCoste ($97 in chips) 
Seat 6: superior_pl ($42.18 in chips) 
Seat 7: Vedpapa ($66.58 in chips) 
Seat 8: Azzaj91 ($2.91 in chips) 
matiko09: posts small blind $0.25
seblafstian: posts big blind $0.50
Domotirko228: sits out 
pandalapa: sits out 
*** HOLE CARDS ***
Dealt to matiko09 [9c Qd]
St.LaCoste: folds 
superior_pl: folds 
Vedpapa: folds 
Azzaj91: raises $2.41 to $2.91 and is all-in
ardo888: folds 
matiko09: folds 
seblafstian: folds 
Uncalled bet ($2.41) returned to Azzaj91
Azzaj91 collected $1.25 from pot
Azzaj91: doesn't show hand 
*** SUMMARY ***
Total pot $1.25 | Rake $0 
Seat 1: ardo888 (button) folded before Flop (didn't bet)
Seat 2: matiko09 (small blind) folded before Flop
Seat 3: seblafstian (big blind) folded before Flop
Seat 5: St.LaCoste folded before Flop (didn't bet)
Seat 6: superior_pl folded before Flop (didn't bet)
Seat 7: Vedpapa folded before Flop (didn't bet)
Seat 8: Azzaj91 collected ($1.25)





PokerStars Hand #155301175194:  Hold'em No Limit ($0.50/$1.00 USD) - 2016/06/28 16:15:17 CET [2016/06/28 10:15:17 ET]
Table 'Dorado II' 9-max Seat #8 is the button
Seat 1: f1reworks ($121.84 in chips) 
Seat 2: vanilica ($100 in chips) 
Seat 3: ghostriderxu ($105.49 in chips) 
Seat 4: pyromid ($119.05 in chips) 
Seat 5: KovIFish89 ($121.52 in chips) 
Seat 6: mycka86 ($100 in chips) 
Seat 7: matiko09 ($100 in chips) 
Seat 8: flk.Dasas ($198.50 in chips) 
Seat 9: r4mz3s ($100 in chips) 
r4mz3s: posts small blind $0.50
f1reworks: posts big blind $1
*** HOLE CARDS ***
Dealt to matiko09 [Kd 8c]
vanilica: folds 
ghostriderxu: folds 
pyromid: folds 
KovIFish89: folds 
mycka86: folds 
matiko09: folds 
flk.Dasas: folds 
r4mz3s: raises $2 to $3
f1reworks: folds 
Uncalled bet ($2) returned to r4mz3s
r4mz3s collected $2 from pot
r4mz3s: doesn't show hand 
*** SUMMARY ***
Total pot $2 | Rake $0 
Seat 1: f1reworks (big blind) folded before Flop
Seat 2: vanilica folded before Flop (didn't bet)
Seat 3: ghostriderxu folded before Flop (didn't bet)
Seat 4: pyromid folded before Flop (didn't bet)
Seat 5: KovIFish89 folded before Flop (didn't bet)
Seat 6: mycka86 folded before Flop (didn't bet)
Seat 7: matiko09 folded before Flop (didn't bet)
Seat 8: flk.Dasas (button) folded before Flop (didn't bet)
Seat 9: r4mz3s (small blind) collected ($2)





PokerStars Hand #155301183301:  Hold'em No Limit ($0.50/$1.00 USD) - 2016/06/28 16:15:32 CET [2016/06/28 10:15:32 ET]
Table 'Vicia II' 9-max Seat #9 is the button
Seat 1: sanpidk ($120.86 in chips) 
Seat 2: Kukuryzka ($111.90 in chips) 
Seat 3: vanilica ($100 in chips) 
Seat 4: vanapeer ($103.68 in chips) 
Seat 5: wallium ($248.11 in chips) 
Seat 6: ozone2003 ($100 in chips) 
Seat 7: matiko09 ($100 in chips) 
Seat 8: f1reworks ($209.04 in chips) 
Seat 9: r4mz3s ($100 in chips) 
sanpidk: posts small blind $0.50
Kukuryzka: posts big blind $1
*** HOLE CARDS ***
Dealt to matiko09 [4h Ks]
vanilica: raises $2 to $3
vanapeer: folds 
wallium: folds 
ozone2003: folds 
matiko09: folds 
f1reworks: folds 
r4mz3s: folds 
sanpidk: folds 
Kukuryzka: folds 
Uncalled bet ($2) returned to vanilica
vanilica collected $2.50 from pot
vanilica: doesn't show hand 
*** SUMMARY ***
Total pot $2.50 | Rake $0 
Seat 1: sanpidk (small blind) folded before Flop
Seat 2: Kukuryzka (big blind) folded before Flop
Seat 3: vanilica collected ($2.50)
Seat 4: vanapeer folded before Flop (didn't bet)
Seat 5: wallium folded before Flop (didn't bet)
Seat 6: ozone2003 folded before Flop (didn't bet)
Seat 7: matiko09 folded before Flop (didn't bet)
Seat 8: f1reworks folded before Flop (didn't bet)
Seat 9: r4mz3s (button) folded before Flop (didn't bet)





PokerStars Hand #155301184442:  Hold'em No Limit ($0.25/$0.50 USD) - 2016/06/28 16:15:34 CET [2016/06/28 10:15:34 ET]
Table 'Thyestes II' 9-max Seat #2 is the button
Seat 1: ardo888 ($50 in chips) 
Seat 2: matiko09 ($50 in chips) 
Seat 3: seblafstian ($59.45 in chips) 
Seat 4: Domotirko228 ($50 in chips) 
Seat 5: St.LaCoste ($97 in chips) 
Seat 6: superior_pl ($42.18 in chips) 
Seat 7: Vedpapa ($66.58 in chips) 
Seat 8: Azzaj91 ($3.66 in chips) 
seblafstian: posts small blind $0.25
Domotirko228: posts big blind $0.50
pandalapa: sits out 
*** HOLE CARDS ***
Dealt to matiko09 [Jd Ts]
St.LaCoste: folds 
superior_pl: folds 
Vedpapa: folds 
Azzaj91: folds 
ardo888: raises $0.75 to $1.25
matiko09: folds 
seblafstian: folds 
Domotirko228: calls $0.75
*** FLOP *** [As 5d Qc]
Domotirko228: checks 
ardo888: bets $1.69
Domotirko228: folds 
Uncalled bet ($1.69) returned to ardo888
ardo888 collected $2.61 from pot
ardo888: doesn't show hand 
*** SUMMARY ***
Total pot $2.75 | Rake $0.14 
Board [As 5d Qc]
Seat 1: ardo888 collected ($2.61)
Seat 2: matiko09 (button) folded before Flop (didn't bet)
Seat 3: seblafstian (small blind) folded before Flop
Seat 4: Domotirko228 (big blind) folded on the Flop
Seat 5: St.LaCoste folded before Flop (didn't bet)
Seat 6: superior_pl folded before Flop (didn't bet)
Seat 7: Vedpapa folded before Flop (didn't bet)
Seat 8: Azzaj91 folded before Flop (didn't bet)





PokerStars Hand #155301185280:  Hold'em No Limit ($0.50/$1.00 USD) - 2016/06/28 16:15:36 CET [2016/06/28 10:15:36 ET]
Table 'Dorado II' 9-max Seat #9 is the button
Seat 1: f1reworks ($120.84 in chips) 
Seat 2: vanilica ($100 in chips) 
Seat 3: ghostriderxu ($105.49 in chips) 
Seat 4: pyromid ($119.05 in chips) 
Seat 5: KovIFish89 ($121.52 in chips) 
Seat 6: mycka86 ($100 in chips) 
Seat 7: matiko09 ($100 in chips) 
Seat 8: flk.Dasas ($198.50 in chips) 
Seat 9: r4mz3s ($101 in chips) 
f1reworks: posts small blind $0.50
vanilica: posts big blind $1
*** HOLE CARDS ***
Dealt to matiko09 [4h Jc]
ghostriderxu: folds 
pyromid: folds 
KovIFish89: folds 
mycka86: folds 
matiko09: folds 
flk.Dasas: folds 
r4mz3s: folds 
f1reworks: raises $2 to $3
vanilica: folds 
Uncalled bet ($2) returned to f1reworks
f1reworks collected $2 from pot
f1reworks: doesn't show hand 
*** SUMMARY ***
Total pot $2 | Rake $0 
Seat 1: f1reworks (small blind) collected ($2)
Seat 2: vanilica (big blind) folded before Flop
Seat 3: ghostriderxu folded before Flop (didn't bet)
Seat 4: pyromid folded before Flop (didn't bet)
Seat 5: KovIFish89 folded before Flop (didn't bet)
Seat 6: mycka86 folded before Flop (didn't bet)
Seat 7: matiko09 folded before Flop (didn't bet)
Seat 8: flk.Dasas folded before Flop (didn't bet)
Seat 9: r4mz3s (button) folded before Flop (didn't bet)





PokerStars Hand #155301191684:  Hold'em No Limit ($0.50/$1.00 USD) - 2016/06/28 16:15:48 CET [2016/06/28 10:15:48 ET]
Table 'Kamenyar' 9-max Seat #3 is the button
Seat 1: flk.Dasas ($100 in chips) 
Seat 2: ozone2003 ($100 in chips) 
Seat 3: r4mz3s ($100 in chips) 
Seat 4: f1reworks ($209.41 in chips) 
Seat 5: bwly520 ($291.91 in chips) 
Seat 6: matiko09 ($127.65 in chips) 
Seat 7: Racushniak ($100 in chips) 
Seat 8: sanpidk ($120.36 in chips) 
Seat 9: pyromid ($160.12 in chips) 
f1reworks: posts small blind $0.50
bwly520: posts big blind $1
*** HOLE CARDS ***
Dealt to matiko09 [Kd 2h]
matiko09: folds 
Racushniak: folds 
sanpidk: folds 
pyromid: folds 
flk.Dasas: folds 
ozone2003: folds 
r4mz3s: raises $1.14 to $2.14
f1reworks: folds 
bwly520: folds 
Uncalled bet ($1.14) returned to r4mz3s
r4mz3s collected $2.50 from pot
r4mz3s: doesn't show hand 
*** SUMMARY ***
Total pot $2.50 | Rake $0 
Seat 1: flk.Dasas folded before Flop (didn't bet)
Seat 2: ozone2003 folded before Flop (didn't bet)
Seat 3: r4mz3s (button) collected ($2.50)
Seat 4: f1reworks (small blind) folded before Flop
Seat 5: bwly520 (big blind) folded before Flop
Seat 6: matiko09 folded before Flop (didn't bet)
Seat 7: Racushniak folded before Flop (didn't bet)
Seat 8: sanpidk folded before Flop (didn't bet)
Seat 9: pyromid folded before Flop (didn't bet)





PokerStars Hand #155301192530:  Hold'em No Limit ($0.50/$1.00 USD) - 2016/06/28 16:15:49 CET [2016/06/28 10:15:49 ET]
Table 'Lyyli II' 9-max Seat #3 is the button
Seat 1: tipner ($107.48 in chips) 
Seat 2: CI58 ($114.52 in chips) 
Seat 3: Racushniak ($102.22 in chips) 
Seat 4: Greha999 ($159.70 in chips) 
Seat 5: flk.Dasas ($100.50 in chips) 
Seat 6: matiko09 ($129.94 in chips) 
Seat 7: Kukuryzka ($187.69 in chips) 
Seat 8: r4mz3s ($116.09 in chips) 
Seat 9: f1reworks ($100.20 in chips) 
Greha999: posts small blind $0.50
flk.Dasas: posts big blind $1
*** HOLE CARDS ***
Dealt to matiko09 [Js 9d]
matiko09: folds 
Kukuryzka: folds 
r4mz3s: folds 
f1reworks: folds 
tipner: folds 
CI58: folds 
Racushniak: folds 
Greha999: folds 
Uncalled bet ($0.50) returned to flk.Dasas
flk.Dasas collected $1 from pot
flk.Dasas: doesn't show hand 
*** SUMMARY ***
Total pot $1 | Rake $0 
Seat 1: tipner folded before Flop (didn't bet)
Seat 2: CI58 folded before Flop (didn't bet)
Seat 3: Racushniak (button) folded before Flop (didn't bet)
Seat 4: Greha999 (small blind) folded before Flop
Seat 5: flk.Dasas (big blind) collected ($1)
Seat 6: matiko09 folded before Flop (didn't bet)
Seat 7: Kukuryzka folded before Flop (didn't bet)
Seat 8: r4mz3s folded before Flop (didn't bet)
Seat 9: f1reworks folded before Flop (didn't bet)





PokerStars Hand #155301194862:  Hold'em No Limit ($0.50/$1.00 USD) - 2016/06/28 16:15:53 CET [2016/06/28 10:15:53 ET]
Table 'Anitra' 9-max Seat #8 is the button
Seat 1: Klappspaten0 ($100 in chips) 
Seat 5: er13to ($100 in chips) 
Seat 6: matiko09 ($100 in chips) 
Seat 7: sanpidk ($115.50 in chips) 
Seat 8: vanilica ($100 in chips) 
Seat 9: chenconhaste ($100 in chips) 
chenconhaste: posts small blind $0.50
Klappspaten0: posts big blind $1
*** HOLE CARDS ***
Dealt to matiko09 [Jd Qd]
Shakeelg joins the table at seat #4 
er13to: folds 
matiko09: raises $2 to $3
sanpidk: folds 
facelessPPP joins the table at seat #3 
vanilica: calls $3
tipner joins the table at seat #2 
chenconhaste: folds 
Klappspaten0: calls $2
*** FLOP *** [Qh 3d As]
Klappspaten0: checks 
matiko09: checks 
vanilica: checks 
*** TURN *** [Qh 3d As] [9d]
Klappspaten0: checks 
matiko09: checks 
tipner leaves the table
vanilica: checks 
*** RIVER *** [Qh 3d As 9d] [Ad]
Klappspaten0: checks 
ardo888 joins the table at seat #2 
matiko09: bets $4.69
vanilica: folds 
Klappspaten0: folds 
Uncalled bet ($4.69) returned to matiko09
matiko09 collected $9.02 from pot
matiko09: doesn't show hand 
*** SUMMARY ***
Total pot $9.50 | Rake $0.48 
Board [Qh 3d As 9d Ad]
Seat 1: Klappspaten0 (big blind) folded on the River
Seat 5: er13to folded before Flop (didn't bet)
Seat 6: matiko09 collected ($9.02)
Seat 7: sanpidk folded before Flop (didn't bet)
Seat 8: vanilica (button) folded on the River
Seat 9: chenconhaste (small blind) folded before Flop





PokerStars Hand #155301195340:  Hold'em No Limit ($0.50/$1.00 USD) - 2016/06/28 16:15:54 CET [2016/06/28 10:15:54 ET]
Table 'Dorado II' 9-max Seat #1 is the button
Seat 1: f1reworks ($121.84 in chips) 
Seat 2: vanilica ($100 in chips) 
Seat 3: ghostriderxu ($105.49 in chips) 
Seat 4: pyromid ($119.05 in chips) 
Seat 5: KovIFish89 ($121.52 in chips) 
Seat 6: mycka86 ($100 in chips) 
Seat 7: matiko09 ($100 in chips) 
Seat 8: flk.Dasas ($198.50 in chips) 
Seat 9: r4mz3s ($101 in chips) 
vanilica: posts small blind $0.50
ghostriderxu: posts big blind $1
*** HOLE CARDS ***
Dealt to matiko09 [Th Qh]
pyromid: folds 
KovIFish89: folds 
mycka86: folds 
matiko09: raises $2 to $3
flk.Dasas: calls $3
r4mz3s: folds 
f1reworks: raises $11 to $14
vanilica: folds 
ghostriderxu: folds 
matiko09: folds 
flk.Dasas: folds 
Uncalled bet ($11) returned to f1reworks
f1reworks collected $10.50 from pot
f1reworks: doesn't show hand 
*** SUMMARY ***
Total pot $10.50 | Rake $0 
Seat 1: f1reworks (button) collected ($10.50)
Seat 2: vanilica (small blind) folded before Flop
Seat 3: ghostriderxu (big blind) folded before Flop
Seat 4: pyromid folded before Flop (didn't bet)
Seat 5: KovIFish89 folded before Flop (didn't bet)
Seat 6: mycka86 folded before Flop (didn't bet)
Seat 7: matiko09 folded before Flop
Seat 8: flk.Dasas folded before Flop
Seat 9: r4mz3s folded before Flop (didn't bet)





PokerStars Hand #155301205606:  Hold'em No Limit ($0.50/$1.00 USD) - 2016/06/28 16:16:14 CET [2016/06/28 10:16:14 ET]
Table 'Vicia II' 9-max Seat #1 is the button
Seat 1: sanpidk ($120.36 in chips) 
Seat 2: Kukuryzka ($110.90 in chips) 
Seat 3: vanilica ($101.50 in chips) 
Seat 4: vanapeer ($103.68 in chips) 
Seat 5: wallium ($248.11 in chips) 
Seat 6: ozone2003 ($100 in chips) 
Seat 7: matiko09 ($100 in chips) 
Seat 8: f1reworks ($209.04 in chips) 
Seat 9: r4mz3s ($100 in chips) 
Kukuryzka: posts small blind $0.50
vanilica: posts big blind $1
*** HOLE CARDS ***
Dealt to matiko09 [Td 7d]
vanapeer: folds 
wallium: raises $1 to $2
ozone2003: folds 
matiko09: folds 
f1reworks: folds 
r4mz3s: folds 
sanpidk: folds 
Kukuryzka: folds 
vanilica: raises $7 to $9
wallium: calls $7
*** FLOP *** [7h Jd 4s]
vanilica: bets $10.54
wallium: calls $10.54
*** TURN *** [7h Jd 4s] [9d]
vanilica: checks 
wallium: checks 
*** RIVER *** [7h Jd 4s 9d] [5h]
vanilica: checks 
wallium: bets $37.60
vanilica: folds 
Uncalled bet ($37.60) returned to wallium
wallium collected $37.60 from pot
wallium: doesn't show hand 
*** SUMMARY ***
Total pot $39.58 | Rake $1.98 
Board [7h Jd 4s 9d 5h]
Seat 1: sanpidk (button) folded before Flop (didn't bet)
Seat 2: Kukuryzka (small blind) folded before Flop
Seat 3: vanilica (big blind) folded on the River
Seat 4: vanapeer folded before Flop (didn't bet)
Seat 5: wallium collected ($37.60)
Seat 6: ozone2003 folded before Flop (didn't bet)
Seat 7: matiko09 folded before Flop (didn't bet)
Seat 8: f1reworks folded before Flop (didn't bet)
Seat 9: r4mz3s folded before Flop (didn't bet)





PokerStars Hand #155301209803:  Hold'em No Limit ($0.25/$0.50 USD) - 2016/06/28 16:16:21 CET [2016/06/28 10:16:21 ET]
Table 'Vaino II' 9-max Seat #3 is the button
Seat 1: Vedpapa ($50 in chips) 
Seat 2: matiko09 ($50 in chips) 
Seat 3: chenconhaste ($55.55 in chips) 
Seat 4: fudzi ($95.15 in chips) 
Seat 5: Sak N0eL ($50.88 in chips) 
Seat 6: denitz21 ($51.14 in chips) 
Seat 7: er13to ($54.64 in chips) 
Seat 8: Domotirko228 ($52.74 in chips) 
fudzi: posts small blind $0.25
Sak N0eL: posts big blind $0.50
pandalapa: sits out 
*** HOLE CARDS ***
Dealt to matiko09 [Qc As]
denitz21: folds 
er13to: folds 
Domotirko228: folds 
Vedpapa: folds 
matiko09: raises $1 to $1.50
chenconhaste: folds 
fudzi: raises $3.50 to $5
Sak N0eL: folds 
matiko09: calls $3.50
*** FLOP *** [7c Kd 8d]
fudzi: bets $6
matiko09: folds 
Uncalled bet ($6) returned to fudzi
fudzi collected $9.98 from pot
fudzi: doesn't show hand 
*** SUMMARY ***
Total pot $10.50 | Rake $0.52 
Board [7c Kd 8d]
Seat 1: Vedpapa folded before Flop (didn't bet)
Seat 2: matiko09 folded on the Flop
Seat 3: chenconhaste (button) folded before Flop (didn't bet)
Seat 4: fudzi (small blind) collected ($9.98)
Seat 5: Sak N0eL (big blind) folded before Flop
Seat 6: denitz21 folded before Flop (didn't bet)
Seat 7: er13to folded before Flop (didn't bet)
Seat 8: Domotirko228 folded before Flop (didn't bet)





PokerStars Hand #155301210345:  Hold'em No Limit ($0.50/$1.00 USD) - 2016/06/28 16:16:22 CET [2016/06/28 10:16:22 ET]
Table 'Josephina II' 9-max Seat #9 is the button
Seat 1: matiko09 ($100 in chips) 
Seat 2: vanapeer ($105.28 in chips) 
Seat 3: r4mz3s ($100 in chips) 
Seat 4: sanpidk ($142.61 in chips) 
Seat 5: vanilica ($118.59 in chips) 
Seat 6: ozone2003 ($177.48 in chips) 
Seat 7: KovIFish89 ($107.79 in chips) 
Seat 8: Rabinho588 ($133.56 in chips) 
Seat 9: tipner ($104.60 in chips) 
matiko09: posts small blind $0.50
vanapeer: posts big blind $1
*** HOLE CARDS ***
Dealt to matiko09 [9s 4c]
r4mz3s: folds 
sanpidk: folds 
vanilica: folds 
ozone2003: folds 
KovIFish89: folds 
Rabinho588 has timed out
Rabinho588: folds 
tipner: raises $1.50 to $2.50
matiko09: folds 
vanapeer: folds 
Uncalled bet ($1.50) returned to tipner
tipner collected $2.50 from pot
tipner: doesn't show hand 
*** SUMMARY ***
Total pot $2.50 | Rake $0 
Seat 1: matiko09 (small blind) folded before Flop
Seat 2: vanapeer (big blind) folded before Flop
Seat 3: r4mz3s folded before Flop (didn't bet)
Seat 4: sanpidk folded before Flop (didn't bet)
Seat 5: vanilica folded before Flop (didn't bet)
Seat 6: ozone2003 folded before Flop (didn't bet)
Seat 7: KovIFish89 folded before Flop (didn't bet)
Seat 8: Rabinho588 folded before Flop (didn't bet)
Seat 9: tipner (button) collected ($2.50)





PokerStars Hand #155301211050:  Hold'em No Limit ($0.50/$1.00 USD) - 2016/06/28 16:16:24 CET [2016/06/28 10:16:24 ET]
Table 'Lyyli II' 9-max Seat #4 is the button
Seat 1: tipner ($107.48 in chips) 
Seat 2: CI58 ($114.52 in chips) 
Seat 3: Racushniak ($102.22 in chips) 
Seat 4: Greha999 ($159.20 in chips) 
Seat 5: flk.Dasas ($101 in chips) 
Seat 6: matiko09 ($129.94 in chips) 
Seat 7: Kukuryzka ($187.69 in chips) 
Seat 8: r4mz3s ($116.09 in chips) 
Seat 9: f1reworks ($100.20 in chips) 
flk.Dasas: posts small blind $0.50
matiko09: posts big blind $1
*** HOLE CARDS ***
Dealt to matiko09 [9d Ah]
Kukuryzka: folds 
r4mz3s: folds 
f1reworks: folds 
tipner: folds 
CI58: folds 
Racushniak: folds 
Greha999: raises $1 to $2
flk.Dasas: folds 
matiko09: calls $1
*** FLOP *** [2d 6c Kh]
matiko09: checks 
Greha999: bets $2
matiko09: folds 
Uncalled bet ($2) returned to Greha999
Greha999 collected $4.28 from pot
*** SUMMARY ***
Total pot $4.50 | Rake $0.22 
Board [2d 6c Kh]
Seat 1: tipner folded before Flop (didn't bet)
Seat 2: CI58 folded before Flop (didn't bet)
Seat 3: Racushniak folded before Flop (didn't bet)
Seat 4: Greha999 (button) collected ($4.28)
Seat 5: flk.Dasas (small blind) folded before Flop
Seat 6: matiko09 (big blind) folded on the Flop
Seat 7: Kukuryzka folded before Flop (didn't bet)
Seat 8: r4mz3s folded before Flop (didn't bet)
Seat 9: f1reworks folded before Flop (didn't bet)





PokerStars Hand #155301211502:  Hold'em No Limit ($0.25/$0.50 USD) - 2016/06/28 16:16:24 CET [2016/06/28 10:16:24 ET]
Table 'Thyestes II' 9-max Seat #3 is the button
Seat 1: ardo888 ($51.36 in chips) 
Seat 2: matiko09 ($50 in chips) 
Seat 3: seblafstian ($59.20 in chips) 
Seat 4: Domotirko228 ($50 in chips) 
Seat 6: superior_pl ($42.18 in chips) 
Seat 7: Vedpapa ($66.58 in chips) 
Seat 8: Azzaj91 ($3.66 in chips) 
Domotirko228: posts small blind $0.25
St.LaCoste: is sitting out 
superior_pl: posts big blind $0.50
pandalapa: sits out 
*** HOLE CARDS ***
Dealt to matiko09 [8s 8h]
St.LaCoste leaves the table
Vedpapa: folds 
Azzaj91: folds 
ardo888: folds 
matiko09: raises $1 to $1.50
seblafstian: folds 
Domotirko228: folds 
superior_pl: calls $1
*** FLOP *** [5h Qs 3c]
superior_pl: checks 
matiko09: checks 
*** TURN *** [5h Qs 3c] [3d]
superior_pl: bets $1.50
matiko09: calls $1.50
*** RIVER *** [5h Qs 3c 3d] [4h]
superior_pl: bets $3
matiko09: folds 
Uncalled bet ($3) returned to superior_pl
superior_pl collected $5.94 from pot
superior_pl: doesn't show hand 
*** SUMMARY ***
Total pot $6.25 | Rake $0.31 
Board [5h Qs 3c 3d 4h]
Seat 1: ardo888 folded before Flop (didn't bet)
Seat 2: matiko09 folded on the River
Seat 3: seblafstian (button) folded before Flop (didn't bet)
Seat 4: Domotirko228 (small blind) folded before Flop
Seat 6: superior_pl (big blind) collected ($5.94)
Seat 7: Vedpapa folded before Flop (didn't bet)
Seat 8: Azzaj91 folded before Flop (didn't bet)





PokerStars Hand #155301223592:  Hold'em No Limit ($0.50/$1.00 USD) - 2016/06/28 16:16:47 CET [2016/06/28 10:16:47 ET]
Table 'Anitra' 9-max Seat #9 is the button
Seat 1: Klappspaten0 ($100 in chips) 
Seat 2: ardo888 ($100 in chips) 
Seat 5: er13to ($100 in chips) 
Seat 6: matiko09 ($106.02 in chips) 
Seat 7: sanpidk ($115.50 in chips) 
Seat 8: vanilica ($100 in chips) 
Seat 9: chenconhaste ($100 in chips) 
Klappspaten0: posts small blind $0.50
ardo888: posts big blind $1
facelessPPP: sits out 
Shakeelg: sits out 
*** HOLE CARDS ***
Dealt to matiko09 [Qs Ah]
er13to: folds 
matiko09: raises $2 to $3
sanpidk: folds 
vanilica: folds 
chenconhaste: folds 
Klappspaten0: folds 
ardo888: folds 
Uncalled bet ($2) returned to matiko09
matiko09 collected $2.50 from pot
matiko09: doesn't show hand 
*** SUMMARY ***
Total pot $2.50 | Rake $0 
Seat 1: Klappspaten0 (small blind) folded before Flop
Seat 2: ardo888 (big blind) folded before Flop
Seat 5: er13to folded before Flop (didn't bet)
Seat 6: matiko09 collected ($2.50)
Seat 7: sanpidk folded before Flop (didn't bet)
Seat 8: vanilica folded before Flop (didn't bet)
Seat 9: chenconhaste (button) folded before Flop (didn't bet)





PokerStars Hand #155301230240:  Hold'em No Limit ($0.50/$1.00 USD) - 2016/06/28 16:17:00 CET [2016/06/28 10:17:00 ET]
Table 'Dorado II' 9-max Seat #2 is the button
Seat 1: f1reworks ($129.34 in chips) 
Seat 2: vanilica ($100 in chips) 
Seat 3: ghostriderxu ($104.49 in chips) 
Seat 4: pyromid ($119.05 in chips) 
Seat 5: KovIFish89 ($121.52 in chips) 
Seat 6: mycka86 ($100 in chips) 
Seat 7: matiko09 ($100 in chips) 
Seat 8: flk.Dasas ($195.50 in chips) 
Seat 9: r4mz3s ($101 in chips) 
ghostriderxu: posts small blind $0.50
pyromid: posts big blind $1
*** HOLE CARDS ***
Dealt to matiko09 [6c Th]
KovIFish89: folds 
mycka86: folds 
matiko09: folds 
flk.Dasas: folds 
r4mz3s: folds 
f1reworks: folds 
vanilica: raises $1.50 to $2.50
ghostriderxu: folds 
pyromid: folds 
Uncalled bet ($1.50) returned to vanilica
vanilica collected $2.50 from pot
vanilica: doesn't show hand 
*** SUMMARY ***
Total pot $2.50 | Rake $0 
Seat 1: f1reworks folded before Flop (didn't bet)
Seat 2: vanilica (button) collected ($2.50)
Seat 3: ghostriderxu (small blind) folded before Flop
Seat 4: pyromid (big blind) folded before Flop
Seat 5: KovIFish89 folded before Flop (didn't bet)
Seat 6: mycka86 folded before Flop (didn't bet)
Seat 7: matiko09 folded before Flop (didn't bet)
Seat 8: flk.Dasas folded before Flop (didn't bet)
Seat 9: r4mz3s folded before Flop (didn't bet)





PokerStars Hand #155301232599:  Hold'em No Limit ($0.25/$0.50 USD) - 2016/06/28 16:17:04 CET [2016/06/28 10:17:04 ET]
Table 'Utra' 9-max Seat #3 is the button
Seat 1: ardo888 ($50 in chips) 
Seat 2: matiko09 ($79.32 in chips) 
Seat 3: mycka86 ($62.79 in chips) 
Seat 4: myatiy 96 ($50 in chips) 
Seat 5: er13to ($50 in chips) 
Seat 6: Franky77200 ($69.84 in chips) 
Seat 7: el.suertero ($70.74 in chips) 
Seat 8: fudzi ($50 in chips) 
Seat 9: Kukuryzka ($73.72 in chips) 
myatiy 96: posts small blind $0.25
er13to: posts big blind $0.50
ardo888: posts the ante $0.10
matiko09: posts the ante $0.10
mycka86: posts the ante $0.10
myatiy 96: posts the ante $0.10
er13to: posts the ante $0.10
Franky77200: posts the ante $0.10
el.suertero: posts the ante $0.10
fudzi: posts the ante $0.10
Kukuryzka: posts the ante $0.10
*** HOLE CARDS ***
Dealt to matiko09 [8h Jh]
Franky77200: folds 
el.suertero: folds 
fudzi: folds 
Kukuryzka: raises $1 to $1.50
ardo888: folds 
matiko09: folds 
mycka86: folds 
myatiy 96: folds 
er13to: folds 
Uncalled bet ($1) returned to Kukuryzka
Kukuryzka collected $2.15 from pot
Kukuryzka: doesn't show hand 
*** SUMMARY ***
Total pot $2.15 | Rake $0 
Seat 1: ardo888 folded before Flop (didn't bet)
Seat 2: matiko09 folded before Flop (didn't bet)
Seat 3: mycka86 (button) folded before Flop (didn't bet)
Seat 4: myatiy 96 (small blind) folded before Flop
Seat 5: er13to (big blind) folded before Flop
Seat 6: Franky77200 folded before Flop (didn't bet)
Seat 7: el.suertero folded before Flop (didn't bet)
Seat 8: fudzi folded before Flop (didn't bet)
Seat 9: Kukuryzka collected ($2.15)





PokerStars Hand #155301236131:  Hold'em No Limit ($0.50/$1.00 USD) - 2016/06/28 16:17:11 CET [2016/06/28 10:17:11 ET]
Table 'Lyyli II' 9-max Seat #5 is the button
Seat 1: tipner ($107.48 in chips) 
Seat 2: CI58 ($114.52 in chips) 
Seat 3: Racushniak ($102.22 in chips) 
Seat 4: Greha999 ($161.48 in chips) 
Seat 5: flk.Dasas ($100.50 in chips) 
Seat 6: matiko09 ($127.94 in chips) 
Seat 7: Kukuryzka ($187.69 in chips) 
Seat 8: r4mz3s ($116.09 in chips) 
Seat 9: f1reworks ($100.20 in chips) 
matiko09: posts small blind $0.50
Kukuryzka: posts big blind $1
*** HOLE CARDS ***
Dealt to matiko09 [8h Jd]
r4mz3s: folds 
f1reworks: folds 
tipner: folds 
CI58: folds 
Racushniak: folds 
Greha999: raises $1 to $2
flk.Dasas: folds 
matiko09: folds 
Kukuryzka: folds 
Uncalled bet ($1) returned to Greha999
Greha999 collected $2.50 from pot
*** SUMMARY ***
Total pot $2.50 | Rake $0 
Seat 1: tipner folded before Flop (didn't bet)
Seat 2: CI58 folded before Flop (didn't bet)
Seat 3: Racushniak folded before Flop (didn't bet)
Seat 4: Greha999 collected ($2.50)
Seat 5: flk.Dasas (button) folded before Flop (didn't bet)
Seat 6: matiko09 (small blind) folded before Flop
Seat 7: Kukuryzka (big blind) folded before Flop
Seat 8: r4mz3s folded before Flop (didn't bet)
Seat 9: f1reworks folded before Flop (didn't bet)





PokerStars Hand #155301238397:  Hold'em No Limit ($0.50/$1.00 USD) - 2016/06/28 16:17:15 CET [2016/06/28 10:17:15 ET]
Table 'Anitra' 9-max Seat #1 is the button
Seat 1: Klappspaten0 ($100 in chips) 
Seat 2: ardo888 ($100 in chips) 
Seat 3: facelessPPP ($100 in chips) 
Seat 4: Shakeelg ($80 in chips) 
Seat 5: er13to ($100 in chips) 
Seat 6: matiko09 ($107.52 in chips) 
Seat 7: sanpidk ($115.50 in chips) 
Seat 8: vanilica ($100 in chips) 
Seat 9: chenconhaste ($100 in chips) 
ardo888: posts small blind $0.50
facelessPPP: posts big blind $1
Shakeelg: posts big blind $1
*** HOLE CARDS ***
Dealt to matiko09 [Ah Qd]
Shakeelg: checks 
er13to: folds 
matiko09: raises $3 to $4
sanpidk: folds 
vanilica: folds 
chenconhaste: folds 
Klappspaten0: folds 
ardo888: folds 
facelessPPP: folds 
Shakeelg: calls $3
*** FLOP *** [8d 7d 4d]
Shakeelg: checks 
matiko09: bets $5
Shakeelg: calls $5
*** TURN *** [8d 7d 4d] [4h]
Shakeelg: checks 
matiko09: checks 
*** RIVER *** [8d 7d 4d 4h] [Td]
Shakeelg: bets $19
matiko09: folds 
Uncalled bet ($19) returned to Shakeelg
Shakeelg collected $18.52 from pot
Shakeelg: doesn't show hand 
*** SUMMARY ***
Total pot $19.50 | Rake $0.98 
Board [8d 7d 4d 4h Td]
Seat 1: Klappspaten0 (button) folded before Flop (didn't bet)
Seat 2: ardo888 (small blind) folded before Flop
Seat 3: facelessPPP (big blind) folded before Flop
Seat 4: Shakeelg collected ($18.52)
Seat 5: er13to folded before Flop (didn't bet)
Seat 6: matiko09 folded on the River
Seat 7: sanpidk folded before Flop (didn't bet)
Seat 8: vanilica folded before Flop (didn't bet)
Seat 9: chenconhaste folded before Flop (didn't bet)





PokerStars Hand #155301239059:  Hold'em No Limit ($0.25/$0.50 USD) - 2016/06/28 16:17:17 CET [2016/06/28 10:17:17 ET]
Table 'Vaino II' 9-max Seat #4 is the button
Seat 1: Vedpapa ($50 in chips) 
Seat 2: matiko09 ($50 in chips) 
Seat 3: chenconhaste ($55.55 in chips) 
Seat 4: fudzi ($100.13 in chips) 
Seat 5: Sak N0eL ($50.38 in chips) 
Seat 6: denitz21 ($51.14 in chips) 
Seat 7: er13to ($54.64 in chips) 
Seat 8: Domotirko228 ($52.74 in chips) 
Sak N0eL: posts small blind $0.25
denitz21: posts big blind $0.50
pandalapa: sits out 
*** HOLE CARDS ***
Dealt to matiko09 [Qh Ad]
er13to: folds 
Domotirko228: folds 
Vedpapa: folds 
matiko09: raises $1 to $1.50
chenconhaste: calls $1.50
fudzi: folds 
Sak N0eL: calls $1.25
denitz21: folds 
*** FLOP *** [3s 5d 2c]
Sak N0eL: checks 
matiko09: checks 
chenconhaste: bets $3.75
Sak N0eL: folds 
matiko09: calls $3.75
*** TURN *** [3s 5d 2c] [Kh]
matiko09: checks 
chenconhaste: checks 
*** RIVER *** [3s 5d 2c Kh] [7s]
matiko09: checks 
chenconhaste: bets $6
matiko09: folds 
Uncalled bet ($6) returned to chenconhaste
chenconhaste collected $11.88 from pot
*** SUMMARY ***
Total pot $12.50 | Rake $0.62 
Board [3s 5d 2c Kh 7s]
Seat 1: Vedpapa folded before Flop (didn't bet)
Seat 2: matiko09 folded on the River
Seat 3: chenconhaste collected ($11.88)
Seat 4: fudzi (button) folded before Flop (didn't bet)
Seat 5: Sak N0eL (small blind) folded on the Flop
Seat 6: denitz21 (big blind) folded before Flop
Seat 7: er13to folded before Flop (didn't bet)
Seat 8: Domotirko228 folded before Flop (didn't bet)





PokerStars Hand #155301238989:  Hold'em No Limit ($0.50/$1.00 USD) - 2016/06/28 16:17:17 CET [2016/06/28 10:17:17 ET]
Table 'Dorado II' 9-max Seat #3 is the button
Seat 1: f1reworks ($129.34 in chips) 
Seat 2: vanilica ($101.50 in chips) 
Seat 3: ghostriderxu ($103.99 in chips) 
Seat 4: pyromid ($118.05 in chips) 
Seat 5: KovIFish89 ($121.52 in chips) 
Seat 6: mycka86 ($100 in chips) 
Seat 7: matiko09 ($100 in chips) 
Seat 8: flk.Dasas ($195.50 in chips) 
Seat 9: r4mz3s ($101 in chips) 
pyromid: posts small blind $0.50
KovIFish89: posts big blind $1
*** HOLE CARDS ***
Dealt to matiko09 [7c 6c]
mycka86: folds 
matiko09: folds 
flk.Dasas: folds 
r4mz3s: folds 
f1reworks: folds 
vanilica: folds 
ghostriderxu: raises $2 to $3
pyromid: folds 
KovIFish89: folds 
Uncalled bet ($2) returned to ghostriderxu
ghostriderxu collected $2.50 from pot
ghostriderxu: doesn't show hand 
*** SUMMARY ***
Total pot $2.50 | Rake $0 
Seat 1: f1reworks folded before Flop (didn't bet)
Seat 2: vanilica folded before Flop (didn't bet)
Seat 3: ghostriderxu (button) collected ($2.50)
Seat 4: pyromid (small blind) folded before Flop
Seat 5: KovIFish89 (big blind) folded before Flop
Seat 6: mycka86 folded before Flop (didn't bet)
Seat 7: matiko09 folded before Flop (didn't bet)
Seat 8: flk.Dasas folded before Flop (didn't bet)
Seat 9: r4mz3s folded before Flop (didn't bet)





PokerStars Hand #155301242575:  Hold'em No Limit ($0.50/$1.00 USD) - 2016/06/28 16:17:23 CET [2016/06/28 10:17:23 ET]
Table 'Josephina II' 9-max Seat #1 is the button
Seat 1: matiko09 ($100 in chips) 
Seat 2: vanapeer ($104.28 in chips) 
Seat 3: r4mz3s ($100 in chips) 
Seat 4: sanpidk ($142.61 in chips) 
Seat 5: vanilica ($118.59 in chips) 
Seat 6: ozone2003 ($177.48 in chips) 
Seat 7: KovIFish89 ($107.79 in chips) 
Seat 9: tipner ($106.10 in chips) 
vanapeer: posts small blind $0.50
r4mz3s: posts big blind $1
*** HOLE CARDS ***
Dealt to matiko09 [Kc Qs]
sanpidk: folds 
vanilica: folds 
ozone2003: folds 
KovIFish89: raises $2 to $3
tipner: folds 
matiko09: raises $7 to $10
vanapeer: folds 
r4mz3s: folds 
KovIFish89: calls $7
*** FLOP *** [8h Ad 8d]
KovIFish89: checks 
matiko09: checks 
*** TURN *** [8h Ad 8d] [3d]
KovIFish89: checks 
matiko09: checks 
*** RIVER *** [8h Ad 8d 3d] [2s]
KovIFish89: checks 
matiko09: checks 
*** SHOW DOWN ***
KovIFish89: shows [Tc Jc] (a pair of Eights)
matiko09: shows [Kc Qs] (a pair of Eights - Ace+King kicker)
matiko09 collected $20.42 from pot
*** SUMMARY ***
Total pot $21.50 | Rake $1.08 
Board [8h Ad 8d 3d 2s]
Seat 1: matiko09 (button) showed [Kc Qs] and won ($20.42) with a pair of Eights
Seat 2: vanapeer (small blind) folded before Flop
Seat 3: r4mz3s (big blind) folded before Flop
Seat 4: sanpidk folded before Flop (didn't bet)
Seat 5: vanilica folded before Flop (didn't bet)
Seat 6: ozone2003 folded before Flop (didn't bet)
Seat 7: KovIFish89 showed [Tc Jc] and lost with a pair of Eights
Seat 9: tipner folded before Flop (didn't bet)





PokerStars Hand #155301244020:  Hold'em No Limit ($0.25/$0.50 USD) - 2016/06/28 16:17:26 CET [2016/06/28 10:17:26 ET]
Table 'Thyestes II' 9-max Seat #4 is the button
Seat 1: ardo888 ($51.36 in chips) 
Seat 2: matiko09 ($50 in chips) 
Seat 3: seblafstian ($59.20 in chips) 
Seat 4: Domotirko228 ($50 in chips) 
Seat 6: superior_pl ($45.12 in chips) 
Seat 7: Vedpapa ($66.58 in chips) 
Seat 8: Azzaj91 ($3.66 in chips) 
superior_pl: posts small blind $0.25
Vedpapa: posts big blind $0.50
pandalapa: sits out 
*** HOLE CARDS ***
Dealt to matiko09 [Td Kh]
Azzaj91: folds 
ardo888: folds 
matiko09: folds 
seblafstian: folds 
Domotirko228: raises $0.75 to $1.25
superior_pl: folds 
Vedpapa: folds 
Uncalled bet ($0.75) returned to Domotirko228
Domotirko228 collected $1.25 from pot
Domotirko228: doesn't show hand 
*** SUMMARY ***
Total pot $1.25 | Rake $0 
Seat 1: ardo888 folded before Flop (didn't bet)
Seat 2: matiko09 folded before Flop (didn't bet)
Seat 3: seblafstian folded before Flop (didn't bet)
Seat 4: Domotirko228 (button) collected ($1.25)
Seat 6: superior_pl (small blind) folded before Flop
Seat 7: Vedpapa (big blind) folded before Flop
Seat 8: Azzaj91 folded before Flop (didn't bet)





PokerStars Hand #155301245306:  Hold'em No Limit ($0.25/$0.50 USD) - 2016/06/28 16:17:29 CET [2016/06/28 10:17:29 ET]
Table 'Utra' 9-max Seat #4 is the button
Seat 1: ardo888 ($50 in chips) 
Seat 2: matiko09 ($79.22 in chips) 
Seat 3: mycka86 ($62.69 in chips) 
Seat 4: myatiy 96 ($50 in chips) 
Seat 5: er13to ($50 in chips) 
Seat 6: Franky77200 ($69.74 in chips) 
Seat 7: el.suertero ($70.64 in chips) 
Seat 8: fudzi ($50 in chips) 
Seat 9: Kukuryzka ($75.27 in chips) 
er13to: posts small blind $0.25
Franky77200: posts big blind $0.50
ardo888: posts the ante $0.10
matiko09: posts the ante $0.10
mycka86: posts the ante $0.10
myatiy 96: posts the ante $0.10
er13to: posts the ante $0.10
Franky77200: posts the ante $0.10
el.suertero: posts the ante $0.10
fudzi: posts the ante $0.10
Kukuryzka: posts the ante $0.10
*** HOLE CARDS ***
Dealt to matiko09 [6h 9h]
el.suertero: folds 
fudzi: folds 
Kukuryzka: folds 
ardo888: folds 
matiko09: folds 
mycka86: folds 
myatiy 96: folds 
er13to: folds 
Uncalled bet ($0.25) returned to Franky77200
Franky77200 collected $1.40 from pot
Franky77200: doesn't show hand 
*** SUMMARY ***
Total pot $1.40 | Rake $0 
Seat 1: ardo888 folded before Flop (didn't bet)
Seat 2: matiko09 folded before Flop (didn't bet)
Seat 3: mycka86 folded before Flop (didn't bet)
Seat 4: myatiy 96 (button) folded before Flop (didn't bet)
Seat 5: er13to (small blind) folded before Flop
Seat 6: Franky77200 (big blind) collected ($1.40)
Seat 7: el.suertero folded before Flop (didn't bet)
Seat 8: fudzi folded before Flop (didn't bet)
Seat 9: Kukuryzka folded before Flop (didn't bet)





PokerStars Hand #155301249094:  Hold'em No Limit ($0.50/$1.00 USD) - 2016/06/28 16:17:36 CET [2016/06/28 10:17:36 ET]
Table 'Dorado II' 9-max Seat #4 is the button
Seat 1: f1reworks ($129.34 in chips) 
Seat 2: vanilica ($101.50 in chips) 
Seat 3: ghostriderxu ($105.49 in chips) 
Seat 4: pyromid ($117.55 in chips) 
Seat 5: KovIFish89 ($120.52 in chips) 
Seat 6: mycka86 ($100 in chips) 
Seat 7: matiko09 ($100 in chips) 
Seat 8: flk.Dasas ($195.50 in chips) 
Seat 9: r4mz3s ($101 in chips) 
KovIFish89: posts small blind $0.50
mycka86: posts big blind $1
*** HOLE CARDS ***
Dealt to matiko09 [Qc Ah]
matiko09: raises $2 to $3
flk.Dasas: folds 
r4mz3s: folds 
f1reworks: folds 
vanilica: folds 
ghostriderxu: calls $3
pyromid: folds 
KovIFish89: folds 
mycka86: folds 
*** FLOP *** [5c Qs 9d]
matiko09: checks 
ghostriderxu: checks 
*** TURN *** [5c Qs 9d] [9h]
matiko09: bets $4.63
ghostriderxu: calls $4.63
*** RIVER *** [5c Qs 9d 9h] [3d]
matiko09: checks 
ghostriderxu: bets $8.80
matiko09: calls $8.80
*** SHOW DOWN ***
ghostriderxu: shows [7d 6d] (a pair of Nines)
matiko09: shows [Qc Ah] (two pair, Queens and Nines)
matiko09 collected $32.64 from pot
*** SUMMARY ***
Total pot $34.36 | Rake $1.72 
Board [5c Qs 9d 9h 3d]
Seat 1: f1reworks folded before Flop (didn't bet)
Seat 2: vanilica folded before Flop (didn't bet)
Seat 3: ghostriderxu showed [7d 6d] and lost with a pair of Nines
Seat 4: pyromid (button) folded before Flop (didn't bet)
Seat 5: KovIFish89 (small blind) folded before Flop
Seat 6: mycka86 (big blind) folded before Flop
Seat 7: matiko09 showed [Qc Ah] and won ($32.64) with two pair, Queens and Nines
Seat 8: flk.Dasas folded before Flop (didn't bet)
Seat 9: r4mz3s folded before Flop (didn't bet)





PokerStars Hand #155301251968:  Hold'em No Limit ($0.50/$1.00 USD) - 2016/06/28 16:17:41 CET [2016/06/28 10:17:41 ET]
Table 'Lyyli II' 9-max Seat #6 is the button
Seat 1: tipner ($107.48 in chips) 
Seat 2: CI58 ($114.52 in chips) 
Seat 3: Racushniak ($102.22 in chips) 
Seat 4: Greha999 ($162.98 in chips) 
Seat 5: flk.Dasas ($100.50 in chips) 
Seat 6: matiko09 ($127.44 in chips) 
Seat 7: Kukuryzka ($186.69 in chips) 
Seat 8: r4mz3s ($116.09 in chips) 
Seat 9: f1reworks ($100.20 in chips) 
Kukuryzka: posts small blind $0.50
r4mz3s: posts big blind $1
*** HOLE CARDS ***
Dealt to matiko09 [Qd Qh]
f1reworks: folds 
tipner: folds 
CI58: folds 
Racushniak: folds 
Greha999: folds 
flk.Dasas: folds 
matiko09: raises $1.27 to $2.27
Kukuryzka: folds 
r4mz3s: folds 
Uncalled bet ($1.27) returned to matiko09
matiko09 collected $2.50 from pot
matiko09: doesn't show hand 
*** SUMMARY ***
Total pot $2.50 | Rake $0 
Seat 1: tipner folded before Flop (didn't bet)
Seat 2: CI58 folded before Flop (didn't bet)
Seat 3: Racushniak folded before Flop (didn't bet)
Seat 4: Greha999 folded before Flop (didn't bet)
Seat 5: flk.Dasas folded before Flop (didn't bet)
Seat 6: matiko09 (button) collected ($2.50)
Seat 7: Kukuryzka (small blind) folded before Flop
Seat 8: r4mz3s (big blind) folded before Flop
Seat 9: f1reworks folded before Flop (didn't bet)





PokerStars Hand #155301253173:  Hold'em No Limit ($0.50/$1.00 USD) - 2016/06/28 16:17:43 CET [2016/06/28 10:17:43 ET]
Table 'Vicia II' 9-max Seat #2 is the button
Seat 1: sanpidk ($120.36 in chips) 
Seat 2: Kukuryzka ($110.40 in chips) 
Seat 3: vanilica ($100 in chips) 
Seat 4: vanapeer ($103.68 in chips) 
Seat 5: wallium ($266.17 in chips) 
Seat 6: ozone2003 ($100 in chips) 
Seat 7: matiko09 ($100 in chips) 
Seat 8: f1reworks ($209.04 in chips) 
Seat 9: r4mz3s ($100 in chips) 
vanilica: posts small blind $0.50
vanapeer: posts big blind $1
*** HOLE CARDS ***
Dealt to matiko09 [3h 6c]
wallium: raises $1 to $2
ozone2003: folds 
matiko09: folds 
f1reworks: folds 
r4mz3s: folds 
sanpidk: folds 
Kukuryzka: folds 
vanilica: raises $7 to $9
vanapeer: folds 
wallium: calls $7
*** FLOP *** [9c 2h 6s]
vanilica: checks 
wallium: checks 
*** TURN *** [9c 2h 6s] [5s]
vanilica: checks 
wallium: bets $18.05
vanilica: folds 
Uncalled bet ($18.05) returned to wallium
wallium collected $18.05 from pot
wallium: doesn't show hand 
*** SUMMARY ***
Total pot $19 | Rake $0.95 
Board [9c 2h 6s 5s]
Seat 1: sanpidk folded before Flop (didn't bet)
Seat 2: Kukuryzka (button) folded before Flop (didn't bet)
Seat 3: vanilica (small blind) folded on the Turn
Seat 4: vanapeer (big blind) folded before Flop
Seat 5: wallium collected ($18.05)
Seat 6: ozone2003 folded before Flop (didn't bet)
Seat 7: matiko09 folded before Flop (didn't bet)
Seat 8: f1reworks folded before Flop (didn't bet)
Seat 9: r4mz3s folded before Flop (didn't bet)





PokerStars Hand #155301261283:  Hold'em No Limit ($0.25/$0.50 USD) - 2016/06/28 16:17:59 CET [2016/06/28 10:17:59 ET]
Table 'Utra' 9-max Seat #5 is the button
Seat 1: ardo888 ($50 in chips) 
Seat 2: matiko09 ($79.12 in chips) 
Seat 3: mycka86 ($62.59 in chips) 
Seat 4: myatiy 96 ($50 in chips) 
Seat 5: er13to ($50 in chips) 
Seat 6: Franky77200 ($70.79 in chips) 
Seat 7: el.suertero ($70.54 in chips) 
Seat 8: fudzi ($50 in chips) 
Seat 9: Kukuryzka ($75.17 in chips) 
Franky77200: posts small blind $0.25
el.suertero: posts big blind $0.50
ardo888: posts the ante $0.10
matiko09: posts the ante $0.10
mycka86: posts the ante $0.10
myatiy 96: posts the ante $0.10
er13to: posts the ante $0.10
Franky77200: posts the ante $0.10
el.suertero: posts the ante $0.10
fudzi: posts the ante $0.10
Kukuryzka: posts the ante $0.10
*** HOLE CARDS ***
Dealt to matiko09 [6d 7c]
fudzi: folds 
Kukuryzka: folds 
ardo888: folds 
matiko09: folds 
mycka86: folds 
myatiy 96: folds 
er13to: raises $0.67 to $1.17
Franky77200: calls $0.92
el.suertero: folds 
*** FLOP *** [Th Kh Kd]
Franky77200: checks 
er13to: checks 
*** TURN *** [Th Kh Kd] [5h]
Franky77200: bets $2.50
er13to: folds 
Uncalled bet ($2.50) returned to Franky77200
Franky77200 collected $3.55 from pot
Franky77200: doesn't show hand 
*** SUMMARY ***
Total pot $3.74 | Rake $0.19 
Board [Th Kh Kd 5h]
Seat 1: ardo888 folded before Flop (didn't bet)
Seat 2: matiko09 folded before Flop (didn't bet)
Seat 3: mycka86 folded before Flop (didn't bet)
Seat 4: myatiy 96 folded before Flop (didn't bet)
Seat 5: er13to (button) folded on the Turn
Seat 6: Franky77200 (small blind) collected ($3.55)
Seat 7: el.suertero (big blind) folded before Flop
Seat 8: fudzi folded before Flop (didn't bet)
Seat 9: Kukuryzka folded before Flop (didn't bet)





PokerStars Hand #155301263928:  Hold'em No Limit ($0.25/$0.50 USD) - 2016/06/28 16:18:03 CET [2016/06/28 10:18:03 ET]
Table 'Thyestes II' 9-max Seat #6 is the button
Seat 1: ardo888 ($51.36 in chips) 
Seat 2: matiko09 ($50 in chips) 
Seat 3: seblafstian ($59.20 in chips) 
Seat 4: Domotirko228 ($50.75 in chips) 
Seat 6: superior_pl ($44.87 in chips) 
Seat 7: Vedpapa ($66.08 in chips) 
Seat 8: Azzaj91 ($3.66 in chips) 
Vedpapa: posts small blind $0.25
Azzaj91: posts big blind $0.50
pandalapa: sits out 
*** HOLE CARDS ***
Dealt to matiko09 [Jc 4d]
ardo888: folds 
matiko09: folds 
seblafstian: folds 
Domotirko228: folds 
superior_pl: folds 
Vedpapa: raises $1 to $1.50
Azzaj91: raises $2.16 to $3.66 and is all-in
Vedpapa: calls $2.16
*** FLOP *** [3c 8c Qh]
*** TURN *** [3c 8c Qh] [Td]
*** RIVER *** [3c 8c Qh Td] [Qd]
*** SHOW DOWN ***
Vedpapa: shows [Qc Tc] (a full house, Queens full of Tens)
Azzaj91: shows [9h 5s] (a pair of Queens)
Vedpapa collected $6.95 from pot
*** SUMMARY ***
Total pot $7.32 | Rake $0.37 
Board [3c 8c Qh Td Qd]
Seat 1: ardo888 folded before Flop (didn't bet)
Seat 2: matiko09 folded before Flop (didn't bet)
Seat 3: seblafstian folded before Flop (didn't bet)
Seat 4: Domotirko228 folded before Flop (didn't bet)
Seat 6: superior_pl (button) folded before Flop (didn't bet)
Seat 7: Vedpapa (small blind) showed [Qc Tc] and won ($6.95) with a full house, Queens full of Tens
Seat 8: Azzaj91 (big blind) showed [9h 5s] and lost with a pair of Queens





PokerStars Hand #155301268373:  Hold'em No Limit ($0.50/$1.00 USD) - 2016/06/28 16:18:11 CET [2016/06/28 10:18:11 ET]
Table 'Lyyli II' 9-max Seat #7 is the button
Seat 1: tipner ($107.48 in chips) 
Seat 2: CI58 ($114.52 in chips) 
Seat 4: Greha999 ($162.98 in chips) 
Seat 5: flk.Dasas ($100.50 in chips) 
Seat 6: matiko09 ($128.94 in chips) 
Seat 7: Kukuryzka ($186.19 in chips) 
Seat 8: r4mz3s ($115.09 in chips) 
Seat 9: f1reworks ($100.20 in chips) 
r4mz3s: posts small blind $0.50
f1reworks: posts big blind $1
*** HOLE CARDS ***
Dealt to matiko09 [8d 5s]
tipner: folds 
CI58: folds 
Greha999: folds 
flk.Dasas: folds 
matiko09: folds 
Kukuryzka: raises $1 to $2
r4mz3s: folds 
f1reworks: calls $1
*** FLOP *** [Kd Js 7c]
f1reworks: checks 
Kukuryzka: bets $2.14
f1reworks: folds 
Uncalled bet ($2.14) returned to Kukuryzka
Kukuryzka collected $4.28 from pot
Kukuryzka: doesn't show hand 
*** SUMMARY ***
Total pot $4.50 | Rake $0.22 
Board [Kd Js 7c]
Seat 1: tipner folded before Flop (didn't bet)
Seat 2: CI58 folded before Flop (didn't bet)
Seat 4: Greha999 folded before Flop (didn't bet)
Seat 5: flk.Dasas folded before Flop (didn't bet)
Seat 6: matiko09 folded before Flop (didn't bet)
Seat 7: Kukuryzka (button) collected ($4.28)
Seat 8: r4mz3s (small blind) folded before Flop
Seat 9: f1reworks (big blind) folded on the Flop





PokerStars Hand #155301268872:  Hold'em No Limit ($0.50/$1.00 USD) - 2016/06/28 16:18:12 CET [2016/06/28 10:18:12 ET]
Table 'Josephina II' 9-max Seat #2 is the button
Seat 1: matiko09 ($110.42 in chips) 
Seat 2: vanapeer ($103.78 in chips) 
Seat 3: r4mz3s ($100 in chips) 
Seat 4: sanpidk ($142.61 in chips) 
Seat 5: vanilica ($118.59 in chips) 
Seat 6: ozone2003 ($177.48 in chips) 
Seat 7: KovIFish89 ($100 in chips) 
Seat 8: Rabinho588 ($133.56 in chips) 
Seat 9: tipner ($106.10 in chips) 
r4mz3s: posts small blind $0.50
sanpidk: posts big blind $1
*** HOLE CARDS ***
Dealt to matiko09 [9h 4h]
vanilica: folds 
ozone2003: raises $2 to $3
KovIFish89: folds 
Rabinho588: calls $3
tipner: folds 
matiko09: folds 
vanapeer: folds 
r4mz3s: calls $2.50
sanpidk: folds 
*** FLOP *** [5h Qd 4d]
r4mz3s: checks 
ozone2003: checks 
Rabinho588: bets $11
r4mz3s: folds 
ozone2003: folds 
Uncalled bet ($11) returned to Rabinho588
Rabinho588 collected $9.50 from pot
Rabinho588: doesn't show hand 
*** SUMMARY ***
Total pot $10 | Rake $0.50 
Board [5h Qd 4d]
Seat 1: matiko09 folded before Flop (didn't bet)
Seat 2: vanapeer (button) folded before Flop (didn't bet)
Seat 3: r4mz3s (small blind) folded on the Flop
Seat 4: sanpidk (big blind) folded before Flop
Seat 5: vanilica folded before Flop (didn't bet)
Seat 6: ozone2003 folded on the Flop
Seat 7: KovIFish89 folded before Flop (didn't bet)
Seat 8: Rabinho588 collected ($9.50)
Seat 9: tipner folded before Flop (didn't bet)





PokerStars Hand #155301285348:  Hold'em No Limit ($0.50/$1.00 USD) - 2016/06/28 16:18:43 CET [2016/06/28 10:18:43 ET]
Table 'Anitra' 9-max Seat #2 is the button
Seat 1: Klappspaten0 ($100 in chips) 
Seat 2: ardo888 ($100 in chips) 
Seat 3: facelessPPP ($99 in chips) 
Seat 4: Shakeelg ($89.52 in chips) 
Seat 5: er13to ($100 in chips) 
Seat 6: matiko09 ($100 in chips) 
Seat 7: sanpidk ($115.50 in chips) 
Seat 8: vanilica ($100 in chips) 
Seat 9: chenconhaste ($100 in chips) 
facelessPPP: posts small blind $0.50
Shakeelg: posts big blind $1
*** HOLE CARDS ***
Dealt to matiko09 [Ac Th]
er13to: folds 
matiko09: folds 
sanpidk: raises $2 to $3
vanilica: folds 
chenconhaste: folds 
Klappspaten0: folds 
ardo888: folds 
facelessPPP: folds 
Shakeelg: calls $2
*** FLOP *** [7c 3d 2d]
Shakeelg: bets $4
sanpidk: calls $4
*** TURN *** [7c 3d 2d] [7d]
Shakeelg: bets $4
sanpidk: raises $12 to $16
Shakeelg: calls $12
*** RIVER *** [7c 3d 2d 7d] [3s]
Shakeelg: bets $66.52 and is all-in
sanpidk: folds 
Uncalled bet ($66.52) returned to Shakeelg
Shakeelg collected $44.18 from pot
*** SUMMARY ***
Total pot $46.50 | Rake $2.32 
Board [7c 3d 2d 7d 3s]
Seat 1: Klappspaten0 folded before Flop (didn't bet)
Seat 2: ardo888 (button) folded before Flop (didn't bet)
Seat 3: facelessPPP (small blind) folded before Flop
Seat 4: Shakeelg (big blind) collected ($44.18)
Seat 5: er13to folded before Flop (didn't bet)
Seat 6: matiko09 folded before Flop (didn't bet)
Seat 7: sanpidk folded on the River
Seat 8: vanilica folded before Flop (didn't bet)
Seat 9: chenconhaste folded before Flop (didn't bet)





PokerStars Hand #155301285303:  Hold'em No Limit ($0.25/$0.50 USD) - 2016/06/28 16:18:43 CET [2016/06/28 10:18:43 ET]
Table 'Utra' 9-max Seat #6 is the button
Seat 1: ardo888 ($50 in chips) 
Seat 2: matiko09 ($79.02 in chips) 
Seat 3: mycka86 ($62.49 in chips) 
Seat 4: myatiy 96 ($50 in chips) 
Seat 5: er13to ($50 in chips) 
Seat 6: Franky77200 ($73.07 in chips) 
Seat 7: el.suertero ($69.94 in chips) 
Seat 8: fudzi ($50 in chips) 
Seat 9: Kukuryzka ($75.07 in chips) 
el.suertero: posts small blind $0.25
fudzi: posts big blind $0.50
ardo888: posts the ante $0.10
matiko09: posts the ante $0.10
mycka86: posts the ante $0.10
myatiy 96: posts the ante $0.10
er13to: posts the ante $0.10
Franky77200: posts the ante $0.10
el.suertero: posts the ante $0.10
fudzi: posts the ante $0.10
Kukuryzka: posts the ante $0.10
*** HOLE CARDS ***
Dealt to matiko09 [6s 9h]
Kukuryzka: folds 
ardo888: folds 
matiko09: folds 
mycka86: raises $1 to $1.50
myatiy 96: folds 
er13to: folds 
Franky77200: raises $3 to $4.50
el.suertero: folds 
fudzi: folds 
mycka86: calls $3
*** FLOP *** [Jh 4d Ad]
mycka86: checks 
Franky77200: bets $6
mycka86: calls $6
*** TURN *** [Jh 4d Ad] [Tc]
mycka86: checks 
Franky77200: checks 
*** RIVER *** [Jh 4d Ad Tc] [8c]
mycka86: bets $17.86
Franky77200: folds 
Uncalled bet ($17.86) returned to mycka86
mycka86 collected $21.52 from pot
*** SUMMARY ***
Total pot $22.65 | Rake $1.13 
Board [Jh 4d Ad Tc 8c]
Seat 1: ardo888 folded before Flop (didn't bet)
Seat 2: matiko09 folded before Flop (didn't bet)
Seat 3: mycka86 collected ($21.52)
Seat 4: myatiy 96 folded before Flop (didn't bet)
Seat 5: er13to folded before Flop (didn't bet)
Seat 6: Franky77200 (button) folded on the River
Seat 7: el.suertero (small blind) folded before Flop
Seat 8: fudzi (big blind) folded before Flop
Seat 9: Kukuryzka folded before Flop (didn't bet)





PokerStars Hand #155301288576:  Hold'em No Limit ($0.50/$1.00 USD) - 2016/06/28 16:18:49 CET [2016/06/28 10:18:49 ET]
Table 'Dorado II' 9-max Seat #5 is the button
Seat 1: f1reworks ($129.34 in chips) 
Seat 2: vanilica ($101.50 in chips) 
Seat 3: ghostriderxu ($89.06 in chips) 
Seat 4: pyromid ($117.55 in chips) 
Seat 5: KovIFish89 ($120.02 in chips) 
Seat 6: mycka86 ($100 in chips) 
Seat 7: matiko09 ($116.21 in chips) 
Seat 8: flk.Dasas ($195.50 in chips) 
Seat 9: r4mz3s ($101 in chips) 
mycka86: posts small blind $0.50
matiko09: posts big blind $1
*** HOLE CARDS ***
Dealt to matiko09 [9s Jd]
flk.Dasas: raises $2 to $3
r4mz3s: folds 
f1reworks: calls $3
vanilica: folds 
ghostriderxu: raises $6.80 to $9.80
pyromid: folds 
KovIFish89: folds 
mycka86: folds 
matiko09: folds 
flk.Dasas: folds 
f1reworks: raises $11.20 to $21
ghostriderxu: calls $11.20
*** FLOP *** [5c Qs 3h]
f1reworks: bets $19
ghostriderxu: calls $19
*** TURN *** [5c Qs 3h] [7d]
f1reworks: bets $82
ghostriderxu: folds 
Uncalled bet ($82) returned to f1reworks
f1reworks collected $82 from pot
f1reworks: doesn't show hand 
*** SUMMARY ***
Total pot $84.50 | Rake $2.50 
Board [5c Qs 3h 7d]
Seat 1: f1reworks collected ($82)
Seat 2: vanilica folded before Flop (didn't bet)
Seat 3: ghostriderxu folded on the Turn
Seat 4: pyromid folded before Flop (didn't bet)
Seat 5: KovIFish89 (button) folded before Flop (didn't bet)
Seat 6: mycka86 (small blind) folded before Flop
Seat 7: matiko09 (big blind) folded before Flop
Seat 8: flk.Dasas folded before Flop
Seat 9: r4mz3s folded before Flop (didn't bet)





PokerStars Hand #155301288824:  Hold'em No Limit ($0.50/$1.00 USD) - 2016/06/28 16:18:50 CET [2016/06/28 10:18:50 ET]
Table 'Vicia II' 9-max Seat #3 is the button
Seat 1: sanpidk ($120.36 in chips) 
Seat 2: Kukuryzka ($110.40 in chips) 
Seat 3: vanilica ($100 in chips) 
Seat 4: vanapeer ($102.68 in chips) 
Seat 5: wallium ($275.22 in chips) 
Seat 6: ozone2003 ($100 in chips) 
Seat 7: matiko09 ($100 in chips) 
Seat 8: f1reworks ($209.04 in chips) 
Seat 9: r4mz3s ($100 in chips) 
vanapeer: posts small blind $0.50
wallium: posts big blind $1
*** HOLE CARDS ***
Dealt to matiko09 [8c 7d]
ozone2003: folds 
matiko09: folds 
f1reworks: folds 
r4mz3s: folds 
sanpidk: folds 
Kukuryzka: folds 
vanilica: raises $1.85 to $2.85
vanapeer: folds 
wallium: raises $8.15 to $11
vanilica: calls $8.15
*** FLOP *** [2s Kh 3d]
wallium: checks 
vanilica: checks 
*** TURN *** [2s Kh 3d] [7c]
wallium: bets $10.69
vanilica: folds 
Uncalled bet ($10.69) returned to wallium
wallium collected $21.38 from pot
wallium: doesn't show hand 
*** SUMMARY ***
Total pot $22.50 | Rake $1.12 
Board [2s Kh 3d 7c]
Seat 1: sanpidk folded before Flop (didn't bet)
Seat 2: Kukuryzka folded before Flop (didn't bet)
Seat 3: vanilica (button) folded on the Turn
Seat 4: vanapeer (small blind) folded before Flop
Seat 5: wallium (big blind) collected ($21.38)
Seat 6: ozone2003 folded before Flop (didn't bet)
Seat 7: matiko09 folded before Flop (didn't bet)
Seat 8: f1reworks folded before Flop (didn't bet)
Seat 9: r4mz3s folded before Flop (didn't bet)





PokerStars Hand #155301291698:  Hold'em No Limit ($0.50/$1.00 USD) - 2016/06/28 16:18:55 CET [2016/06/28 10:18:55 ET]
Table 'Lyyli II' 9-max Seat #8 is the button
Seat 1: tipner ($107.48 in chips) 
Seat 2: CI58 ($114.52 in chips) 
Seat 3: Racushniak ($102.22 in chips) 
Seat 4: Greha999 ($162.98 in chips) 
Seat 5: flk.Dasas ($100.50 in chips) 
Seat 6: matiko09 ($128.94 in chips) 
Seat 7: Kukuryzka ($188.47 in chips) 
Seat 8: r4mz3s ($114.59 in chips) 
Seat 9: f1reworks ($100 in chips) 
f1reworks: posts small blind $0.50
tipner: posts big blind $1
*** HOLE CARDS ***
Dealt to matiko09 [3s 4s]
CI58: folds 
Racushniak: folds 
Greha999: folds 
flk.Dasas: folds 
matiko09: folds 
Kukuryzka: folds 
r4mz3s: folds 
f1reworks: raises $2 to $3
tipner: folds 
Uncalled bet ($2) returned to f1reworks
f1reworks collected $2 from pot
f1reworks: doesn't show hand 
*** SUMMARY ***
Total pot $2 | Rake $0 
Seat 1: tipner (big blind) folded before Flop
Seat 2: CI58 folded before Flop (didn't bet)
Seat 3: Racushniak folded before Flop (didn't bet)
Seat 4: Greha999 folded before Flop (didn't bet)
Seat 5: flk.Dasas folded before Flop (didn't bet)
Seat 6: matiko09 folded before Flop (didn't bet)
Seat 7: Kukuryzka folded before Flop (didn't bet)
Seat 8: r4mz3s (button) folded before Flop (didn't bet)
Seat 9: f1reworks (small blind) collected ($2)





PokerStars Hand #155301301205:  Hold'em No Limit ($0.25/$0.50 USD) - 2016/06/28 16:19:13 CET [2016/06/28 10:19:13 ET]
Table 'Vaino II' 9-max Seat #5 is the button
Seat 1: Vedpapa ($50 in chips) 
Seat 2: matiko09 ($50 in chips) 
Seat 3: chenconhaste ($62.18 in chips) 
Seat 4: fudzi ($100.13 in chips) 
Seat 5: Sak N0eL ($48.88 in chips) 
Seat 6: denitz21 ($50.64 in chips) 
Seat 7: er13to ($54.64 in chips) 
Seat 8: Domotirko228 ($52.74 in chips) 
denitz21: posts small blind $0.25
er13to: posts big blind $0.50
pandalapa: sits out 
*** HOLE CARDS ***
Dealt to matiko09 [7h 4d]
Domotirko228: folds 
Vedpapa: raises $1 to $1.50
matiko09: folds 
chenconhaste: folds 
fudzi: folds 
Sak N0eL: folds 
denitz21: folds 
er13to: folds 
Uncalled bet ($1) returned to Vedpapa
Vedpapa collected $1.25 from pot
Vedpapa: doesn't show hand 
*** SUMMARY ***
Total pot $1.25 | Rake $0 
Seat 1: Vedpapa collected ($1.25)
Seat 2: matiko09 folded before Flop (didn't bet)
Seat 3: chenconhaste folded before Flop (didn't bet)
Seat 4: fudzi folded before Flop (didn't bet)
Seat 5: Sak N0eL (button) folded before Flop (didn't bet)
Seat 6: denitz21 (small blind) folded before Flop
Seat 7: er13to (big blind) folded before Flop
Seat 8: Domotirko228 folded before Flop (didn't bet)





PokerStars Hand #155301305440:  Hold'em No Limit ($0.50/$1.00 USD) - 2016/06/28 16:19:21 CET [2016/06/28 10:19:21 ET]
Table 'Lyyli II' 9-max Seat #9 is the button
Seat 1: tipner ($106.48 in chips) 
Seat 2: CI58 ($114.52 in chips) 
Seat 3: Racushniak ($102.22 in chips) 
Seat 4: Greha999 ($162.98 in chips) 
Seat 5: flk.Dasas ($100.50 in chips) 
Seat 6: matiko09 ($128.94 in chips) 
Seat 7: Kukuryzka ($188.47 in chips) 
Seat 8: r4mz3s ($114.59 in chips) 
Seat 9: f1reworks ($101 in chips) 
tipner: posts small blind $0.50
CI58: posts big blind $1
*** HOLE CARDS ***
Dealt to matiko09 [7c 6c]
Racushniak: folds 
Greha999: folds 
flk.Dasas: folds 
matiko09: folds 
Kukuryzka: folds 
r4mz3s: raises $1.55 to $2.55
f1reworks: folds 
tipner: raises $7.45 to $10
CI58: folds 
r4mz3s: folds 
Uncalled bet ($7.45) returned to tipner
tipner collected $6.10 from pot
tipner: doesn't show hand 
*** SUMMARY ***
Total pot $6.10 | Rake $0 
Seat 1: tipner (small blind) collected ($6.10)
Seat 2: CI58 (big blind) folded before Flop
Seat 3: Racushniak folded before Flop (didn't bet)
Seat 4: Greha999 folded before Flop (didn't bet)
Seat 5: flk.Dasas folded before Flop (didn't bet)
Seat 6: matiko09 folded before Flop (didn't bet)
Seat 7: Kukuryzka folded before Flop (didn't bet)
Seat 8: r4mz3s folded before Flop
Seat 9: f1reworks (button) folded before Flop (didn't bet)





PokerStars Hand #155301315402:  Hold'em No Limit ($0.25/$0.50 USD) - 2016/06/28 16:19:39 CET [2016/06/28 10:19:39 ET]
Table 'Vaino II' 9-max Seat #6 is the button
Seat 1: Vedpapa ($50.75 in chips) 
Seat 2: matiko09 ($50 in chips) 
Seat 3: chenconhaste ($62.18 in chips) 
Seat 4: fudzi ($100.13 in chips) 
Seat 5: Sak N0eL ($48.88 in chips) 
Seat 6: denitz21 ($50.39 in chips) 
Seat 7: er13to ($54.14 in chips) 
Seat 8: Domotirko228 ($52.74 in chips) 
er13to: posts small blind $0.25
Domotirko228: posts big blind $0.50
pandalapa: sits out 
*** HOLE CARDS ***
Dealt to matiko09 [Kh 7c]
Vedpapa: folds 
matiko09: folds 
chenconhaste: folds 
fudzi: folds 
Sak N0eL: raises $0.50 to $1
denitz21: folds 
er13to: folds 
Domotirko228: folds 
Uncalled bet ($0.50) returned to Sak N0eL
Sak N0eL collected $1.25 from pot
*** SUMMARY ***
Total pot $1.25 | Rake $0 
Seat 1: Vedpapa folded before Flop (didn't bet)
Seat 2: matiko09 folded before Flop (didn't bet)
Seat 3: chenconhaste folded before Flop (didn't bet)
Seat 4: fudzi folded before Flop (didn't bet)
Seat 5: Sak N0eL collected ($1.25)
Seat 6: denitz21 (button) folded before Flop (didn't bet)
Seat 7: er13to (small blind) folded before Flop
Seat 8: Domotirko228 (big blind) folded before Flop





PokerStars Hand #155301317479:  Hold'em No Limit ($0.50/$1.00 USD) - 2016/06/28 16:19:43 CET [2016/06/28 10:19:43 ET]
Table 'Josephina II' 9-max Seat #3 is the button
Seat 1: matiko09 ($110.42 in chips) 
Seat 2: vanapeer ($103.78 in chips) 
Seat 3: r4mz3s ($100 in chips) 
Seat 4: sanpidk ($141.61 in chips) 
Seat 5: vanilica ($118.59 in chips) 
Seat 6: ozone2003 ($174.48 in chips) 
Seat 7: KovIFish89 ($100 in chips) 
Seat 8: Rabinho588 ($140.06 in chips) 
Seat 9: tipner ($106.10 in chips) 
sanpidk: posts small blind $0.50
vanilica: posts big blind $1
*** HOLE CARDS ***
Dealt to matiko09 [8h Tc]
ozone2003: raises $2 to $3
KovIFish89: folds 
Rabinho588: folds 
tipner: folds 
matiko09: folds 
vanapeer: folds 
r4mz3s: folds 
sanpidk: folds 
vanilica: folds 
Uncalled bet ($2) returned to ozone2003
ozone2003 collected $2.50 from pot
ozone2003: doesn't show hand 
*** SUMMARY ***
Total pot $2.50 | Rake $0 
Seat 1: matiko09 folded before Flop (didn't bet)
Seat 2: vanapeer folded before Flop (didn't bet)
Seat 3: r4mz3s (button) folded before Flop (didn't bet)
Seat 4: sanpidk (small blind) folded before Flop
Seat 5: vanilica (big blind) folded before Flop
Seat 6: ozone2003 collected ($2.50)
Seat 7: KovIFish89 folded before Flop (didn't bet)
Seat 8: Rabinho588 folded before Flop (didn't bet)
Seat 9: tipner folded before Flop (didn't bet)





PokerStars Hand #155301320689:  Hold'em No Limit ($0.50/$1.00 USD) - 2016/06/28 16:19:49 CET [2016/06/28 10:19:49 ET]
Table 'Vicia II' 9-max Seat #4 is the button
Seat 1: sanpidk ($120.36 in chips) 
Seat 2: Kukuryzka ($110.40 in chips) 
Seat 3: vanilica ($100 in chips) 
Seat 4: vanapeer ($102.18 in chips) 
Seat 5: wallium ($285.60 in chips) 
Seat 7: matiko09 ($100 in chips) 
Seat 8: f1reworks ($209.04 in chips) 
Seat 9: r4mz3s ($100 in chips) 
wallium: posts small blind $0.50
ozone2003: is sitting out 
matiko09: posts big blind $1
*** HOLE CARDS ***
Dealt to matiko09 [8c Jc]
ozone2003 leaves the table
tipner joins the table at seat #6 
f1reworks: folds 
r4mz3s: folds 
sanpidk: folds 
Kukuryzka: folds 
vanilica: folds 
vanapeer: raises $1.50 to $2.50
wallium: calls $2
matiko09: calls $1.50
*** FLOP *** [2s 2d 3h]
wallium: checks 
matiko09: checks 
vanapeer: bets $4
wallium: calls $4
matiko09: folds 
*** TURN *** [2s 2d 3h] [7s]
wallium: checks 
vanapeer: checks 
*** RIVER *** [2s 2d 3h 7s] [Tc]
wallium: bets $14.72
vanapeer: calls $14.72
*** SHOW DOWN ***
wallium: shows [2h Qh] (three of a kind, Deuces)
vanapeer: mucks hand 
wallium collected $42.69 from pot
*** SUMMARY ***
Total pot $44.94 | Rake $2.25 
Board [2s 2d 3h 7s Tc]
Seat 1: sanpidk folded before Flop (didn't bet)
Seat 2: Kukuryzka folded before Flop (didn't bet)
Seat 3: vanilica folded before Flop (didn't bet)
Seat 4: vanapeer (button) mucked [Td 9d]
Seat 5: wallium (small blind) showed [2h Qh] and won ($42.69) with three of a kind, Deuces
Seat 7: matiko09 (big blind) folded on the Flop
Seat 8: f1reworks folded before Flop (didn't bet)
Seat 9: r4mz3s folded before Flop (didn't bet)





PokerStars Hand #155301327500:  Hold'em No Limit ($0.50/$1.00 USD) - 2016/06/28 16:20:02 CET [2016/06/28 10:20:02 ET]
Table 'Lyyli II' 9-max Seat #1 is the button
Seat 1: tipner ($110.03 in chips) 
Seat 2: CI58 ($113.52 in chips) 
Seat 3: Racushniak ($102.22 in chips) 
Seat 4: Greha999 ($162.98 in chips) 
Seat 5: flk.Dasas ($100.50 in chips) 
Seat 6: matiko09 ($128.94 in chips) 
Seat 7: Kukuryzka ($188.47 in chips) 
Seat 8: r4mz3s ($112.04 in chips) 
Seat 9: f1reworks ($101 in chips) 
CI58: posts small blind $0.50
Racushniak: posts big blind $1
*** HOLE CARDS ***
Dealt to matiko09 [Kh 3c]
Greha999: raises $2 to $3
flk.Dasas: folds 
matiko09: folds 
Kukuryzka: folds 
r4mz3s: folds 
f1reworks: folds 
tipner: calls $3
CI58: folds 
Racushniak: folds 
*** FLOP *** [7c 5s 6h]
Greha999: bets $4
tipner: raises $8 to $12
Greha999: calls $8
*** TURN *** [7c 5s 6h] [Qh]
Greha999: checks 
tipner: bets $24
Greha999: calls $24
*** RIVER *** [7c 5s 6h Qh] [7s]
Greha999: checks 
tipner: bets $71.03 and is all-in
Greha999: folds 
Uncalled bet ($71.03) returned to tipner
tipner collected $77 from pot
tipner: doesn't show hand 
*** SUMMARY ***
Total pot $79.50 | Rake $2.50 
Board [7c 5s 6h Qh 7s]
Seat 1: tipner (button) collected ($77)
Seat 2: CI58 (small blind) folded before Flop
Seat 3: Racushniak (big blind) folded before Flop
Seat 4: Greha999 folded on the River
Seat 5: flk.Dasas folded before Flop (didn't bet)
Seat 6: matiko09 folded before Flop (didn't bet)
Seat 7: Kukuryzka folded before Flop (didn't bet)
Seat 8: r4mz3s folded before Flop (didn't bet)
Seat 9: f1reworks folded before Flop (didn't bet)





PokerStars Hand #155301329752:  Hold'em No Limit ($0.50/$1.00 USD) - 2016/06/28 16:20:06 CET [2016/06/28 10:20:06 ET]
Table 'Josephina II' 9-max Seat #4 is the button
Seat 1: matiko09 ($110.42 in chips) 
Seat 2: vanapeer ($103.78 in chips) 
Seat 3: r4mz3s ($100 in chips) 
Seat 4: sanpidk ($141.11 in chips) 
Seat 5: vanilica ($117.59 in chips) 
Seat 7: KovIFish89 ($100 in chips) 
Seat 8: Rabinho588 ($140.06 in chips) 
Seat 9: tipner ($106.10 in chips) 
vanilica: posts small blind $0.50
ozone2003: is sitting out 
ozone2003 leaves the table
KovIFish89: posts big blind $1
*** HOLE CARDS ***
Dealt to matiko09 [Kc 9h]
Rabinho588: folds 
tipner: folds 
matiko09: folds 
vanapeer: folds 
r4mz3s: raises $1.55 to $2.55
sanpidk: folds 
vanilica: folds 
KovIFish89: folds 
Uncalled bet ($1.55) returned to r4mz3s
r4mz3s collected $2.50 from pot
r4mz3s: doesn't show hand 
*** SUMMARY ***
Total pot $2.50 | Rake $0 
Seat 1: matiko09 folded before Flop (didn't bet)
Seat 2: vanapeer folded before Flop (didn't bet)
Seat 3: r4mz3s collected ($2.50)
Seat 4: sanpidk (button) folded before Flop (didn't bet)
Seat 5: vanilica (small blind) folded before Flop
Seat 7: KovIFish89 (big blind) folded before Flop
Seat 8: Rabinho588 folded before Flop (didn't bet)
Seat 9: tipner folded before Flop (didn't bet)





PokerStars Hand #155301331265:  Hold'em No Limit ($0.50/$1.00 USD) - 2016/06/28 16:20:09 CET [2016/06/28 10:20:09 ET]
Table 'Anitra' 9-max Seat #3 is the button
Seat 1: Klappspaten0 ($100 in chips) 
Seat 2: ardo888 ($100 in chips) 
Seat 3: facelessPPP ($98.50 in chips) 
Seat 4: Shakeelg ($110.70 in chips) 
Seat 5: er13to ($100 in chips) 
Seat 6: matiko09 ($100 in chips) 
Seat 7: sanpidk ($100 in chips) 
Seat 8: vanilica ($100 in chips) 
Seat 9: chenconhaste ($100 in chips) 
Shakeelg: posts small blind $0.50
er13to: posts big blind $1
*** HOLE CARDS ***
Dealt to matiko09 [3d 7d]
matiko09: folds 
sanpidk: folds 
vanilica: folds 
chenconhaste: folds 
Klappspaten0: folds 
ardo888: folds 
facelessPPP: raises $1.50 to $2.50
Shakeelg: calls $2
er13to: folds 
*** FLOP *** [3s 5s 8c]
Shakeelg: checks 
facelessPPP: checks 
*** TURN *** [3s 5s 8c] [Td]
Shakeelg: checks 
facelessPPP: checks 
*** RIVER *** [3s 5s 8c Td] [9d]
Shakeelg: checks 
facelessPPP: checks 
*** SHOW DOWN ***
Shakeelg: shows [Ad 6c] (high card Ace)
facelessPPP: shows [5d 4d] (a pair of Fives)
facelessPPP collected $5.70 from pot
*** SUMMARY ***
Total pot $6 | Rake $0.30 
Board [3s 5s 8c Td 9d]
Seat 1: Klappspaten0 folded before Flop (didn't bet)
Seat 2: ardo888 folded before Flop (didn't bet)
Seat 3: facelessPPP (button) showed [5d 4d] and won ($5.70) with a pair of Fives
Seat 4: Shakeelg (small blind) showed [Ad 6c] and lost with high card Ace
Seat 5: er13to (big blind) folded before Flop
Seat 6: matiko09 folded before Flop (didn't bet)
Seat 7: sanpidk folded before Flop (didn't bet)
Seat 8: vanilica folded before Flop (didn't bet)
Seat 9: chenconhaste folded before Flop (didn't bet)





PokerStars Hand #155301335278:  Hold'em No Limit ($0.25/$0.50 USD) - 2016/06/28 16:20:17 CET [2016/06/28 10:20:17 ET]
Table 'Vaino II' 9-max Seat #7 is the button
Seat 1: Vedpapa ($50.75 in chips) 
Seat 2: matiko09 ($50 in chips) 
Seat 3: chenconhaste ($62.18 in chips) 
Seat 4: fudzi ($100.13 in chips) 
Seat 5: Sak N0eL ($49.63 in chips) 
Seat 6: denitz21 ($50.39 in chips) 
Seat 7: er13to ($53.89 in chips) 
Seat 8: Domotirko228 ($52.24 in chips) 
Seat 9: pandalapa ($50 in chips) 
Domotirko228: posts small blind $0.25
pandalapa: posts big blind $0.50
*** HOLE CARDS ***
Dealt to matiko09 [8c 8s]
Vedpapa: folds 
matiko09: raises $1 to $1.50
chenconhaste: folds 
fudzi: folds 
Sak N0eL: folds 
denitz21: folds 
er13to: folds 
Domotirko228: folds 
pandalapa: folds 
Uncalled bet ($1) returned to matiko09
matiko09 collected $1.25 from pot
matiko09: doesn't show hand 
*** SUMMARY ***
Total pot $1.25 | Rake $0 
Seat 1: Vedpapa folded before Flop (didn't bet)
Seat 2: matiko09 collected ($1.25)
Seat 3: chenconhaste folded before Flop (didn't bet)
Seat 4: fudzi folded before Flop (didn't bet)
Seat 5: Sak N0eL folded before Flop (didn't bet)
Seat 6: denitz21 folded before Flop (didn't bet)
Seat 7: er13to (button) folded before Flop (didn't bet)
Seat 8: Domotirko228 (small blind) folded before Flop
Seat 9: pandalapa (big blind) folded before Flop





PokerStars Hand #155301341078:  Hold'em No Limit ($0.50/$1.00 USD) - 2016/06/28 16:20:28 CET [2016/06/28 10:20:28 ET]
Table 'Josephina II' 9-max Seat #5 is the button
Seat 1: matiko09 ($110.42 in chips) 
Seat 2: vanapeer ($103.78 in chips) 
Seat 3: r4mz3s ($101.50 in chips) 
Seat 4: sanpidk ($141.11 in chips) 
Seat 5: vanilica ($117.09 in chips) 
Seat 7: KovIFish89 ($100 in chips) 
Seat 8: Rabinho588 ($140.06 in chips) 
Seat 9: tipner ($106.10 in chips) 
KovIFish89: posts small blind $0.50
Rabinho588: posts big blind $1
*** HOLE CARDS ***
Dealt to matiko09 [Ks 2h]
flk.Dasas joins the table at seat #6 
tipner: raises $2 to $3
matiko09: folds 
vanapeer: folds 
r4mz3s: folds 
sanpidk: folds 
vanilica: folds 
KovIFish89: folds 
Rabinho588: folds 
Uncalled bet ($2) returned to tipner
tipner collected $2.50 from pot
tipner: doesn't show hand 
*** SUMMARY ***
Total pot $2.50 | Rake $0 
Seat 1: matiko09 folded before Flop (didn't bet)
Seat 2: vanapeer folded before Flop (didn't bet)
Seat 3: r4mz3s folded before Flop (didn't bet)
Seat 4: sanpidk folded before Flop (didn't bet)
Seat 5: vanilica (button) folded before Flop (didn't bet)
Seat 7: KovIFish89 (small blind) folded before Flop
Seat 8: Rabinho588 (big blind) folded before Flop
Seat 9: tipner collected ($2.50)





PokerStars Hand #155301341039:  Hold'em No Limit ($0.25/$0.50 USD) - 2016/06/28 16:20:28 CET [2016/06/28 10:20:28 ET]
Table 'Utra' 9-max Seat #7 is the button
Seat 1: ardo888 ($50 in chips) 
Seat 2: matiko09 ($78.92 in chips) 
Seat 3: mycka86 ($73.41 in chips) 
Seat 4: myatiy 96 ($50 in chips) 
Seat 5: er13to ($50 in chips) 
Seat 6: Franky77200 ($62.47 in chips) 
Seat 7: el.suertero ($69.59 in chips) 
Seat 8: fudzi ($50 in chips) 
Seat 9: Kukuryzka ($74.97 in chips) 
fudzi: posts small blind $0.25
Kukuryzka: posts big blind $0.50
ardo888: posts the ante $0.10
matiko09: posts the ante $0.10
mycka86: posts the ante $0.10
myatiy 96: posts the ante $0.10
er13to: posts the ante $0.10
Franky77200: posts the ante $0.10
el.suertero: posts the ante $0.10
fudzi: posts the ante $0.10
Kukuryzka: posts the ante $0.10
*** HOLE CARDS ***
Dealt to matiko09 [Tc Qc]
ardo888: folds 
matiko09: raises $1 to $1.50
mycka86: folds 
myatiy 96: folds 
er13to: folds 
Franky77200: calls $1.50
el.suertero: calls $1.50
fudzi: folds 
Kukuryzka: folds 
*** FLOP *** [Ad 4d Qd]
matiko09: checks 
Franky77200: checks 
el.suertero: checks 
*** TURN *** [Ad 4d Qd] [7s]
matiko09: bets $1.81
Franky77200: raises $3.69 to $5.50
el.suertero: folds 
matiko09: folds 
Uncalled bet ($3.69) returned to Franky77200
Franky77200 collected $9.28 from pot
Franky77200: doesn't show hand 
*** SUMMARY ***
Total pot $9.77 | Rake $0.49 
Board [Ad 4d Qd 7s]
Seat 1: ardo888 folded before Flop (didn't bet)
Seat 2: matiko09 folded on the Turn
Seat 3: mycka86 folded before Flop (didn't bet)
Seat 4: myatiy 96 folded before Flop (didn't bet)
Seat 5: er13to folded before Flop (didn't bet)
Seat 6: Franky77200 collected ($9.28)
Seat 7: el.suertero (button) folded on the Turn
Seat 8: fudzi (small blind) folded before Flop
Seat 9: Kukuryzka (big blind) folded before Flop





PokerStars Hand #155301350601:  Hold'em No Limit ($0.25/$0.50 USD) - 2016/06/28 16:20:46 CET [2016/06/28 10:20:46 ET]
Table 'Vaino II' 9-max Seat #8 is the button
Seat 1: Vedpapa ($50.75 in chips) 
Seat 2: matiko09 ($50.75 in chips) 
Seat 3: chenconhaste ($62.18 in chips) 
Seat 4: fudzi ($100.13 in chips) 
Seat 5: Sak N0eL ($49.63 in chips) 
Seat 6: denitz21 ($50.39 in chips) 
Seat 7: er13to ($53.89 in chips) 
Seat 8: Domotirko228 ($51.99 in chips) 
Seat 9: pandalapa ($50 in chips) 
pandalapa: posts small blind $0.25
Vedpapa: posts big blind $0.50
*** HOLE CARDS ***
Dealt to matiko09 [5h Jh]
matiko09: folds 
chenconhaste: folds 
fudzi: folds 
Sak N0eL: calls $0.50
denitz21: folds 
er13to: folds 
Domotirko228: raises $1.75 to $2.25
pandalapa: folds 
Vedpapa: folds 
Sak N0eL: calls $1.75
*** FLOP *** [4s Ts 9s]
Sak N0eL: checks 
Domotirko228: bets $4
Sak N0eL: folds 
Uncalled bet ($4) returned to Domotirko228
Domotirko228 collected $4.99 from pot
Domotirko228: doesn't show hand 
*** SUMMARY ***
Total pot $5.25 | Rake $0.26 
Board [4s Ts 9s]
Seat 1: Vedpapa (big blind) folded before Flop
Seat 2: matiko09 folded before Flop (didn't bet)
Seat 3: chenconhaste folded before Flop (didn't bet)
Seat 4: fudzi folded before Flop (didn't bet)
Seat 5: Sak N0eL folded on the Flop
Seat 6: denitz21 folded before Flop (didn't bet)
Seat 7: er13to folded before Flop (didn't bet)
Seat 8: Domotirko228 (button) collected ($4.99)
Seat 9: pandalapa (small blind) folded before Flop





PokerStars Hand #155301351444:  Hold'em No Limit ($0.50/$1.00 USD) - 2016/06/28 16:20:47 CET [2016/06/28 10:20:47 ET]
Table 'Dorado II' 9-max Seat #6 is the button
Seat 1: f1reworks ($171.34 in chips) 
Seat 2: vanilica ($101.50 in chips) 
Seat 3: ghostriderxu ($49.06 in chips) 
Seat 4: pyromid ($117.55 in chips) 
Seat 5: KovIFish89 ($120.02 in chips) 
Seat 6: mycka86 ($100 in chips) 
Seat 7: matiko09 ($115.21 in chips) 
Seat 8: flk.Dasas ($192.50 in chips) 
Seat 9: r4mz3s ($101 in chips) 
matiko09: posts small blind $0.50
flk.Dasas: posts big blind $1
*** HOLE CARDS ***
Dealt to matiko09 [Qd 3d]
r4mz3s: folds 
f1reworks: folds 
vanilica: folds 
ghostriderxu: folds 
pyromid: folds 
KovIFish89: folds 
mycka86: raises $1.10 to $2.10
matiko09: folds 
flk.Dasas: folds 
Uncalled bet ($1.10) returned to mycka86
mycka86 collected $2.50 from pot
*** SUMMARY ***
Total pot $2.50 | Rake $0 
Seat 1: f1reworks folded before Flop (didn't bet)
Seat 2: vanilica folded before Flop (didn't bet)
Seat 3: ghostriderxu folded before Flop (didn't bet)
Seat 4: pyromid folded before Flop (didn't bet)
Seat 5: KovIFish89 folded before Flop (didn't bet)
Seat 6: mycka86 (button) collected ($2.50)
Seat 7: matiko09 (small blind) folded before Flop
Seat 8: flk.Dasas (big blind) folded before Flop
Seat 9: r4mz3s folded before Flop (didn't bet)





PokerStars Hand #155301356024:  Hold'em No Limit ($0.50/$1.00 USD) - 2016/06/28 16:20:56 CET [2016/06/28 10:20:56 ET]
Table 'Vicia II' 9-max Seat #5 is the button
Seat 1: sanpidk ($120.36 in chips) 
Seat 2: Kukuryzka ($110.40 in chips) 
Seat 3: vanilica ($100 in chips) 
Seat 4: vanapeer ($100 in chips) 
Seat 5: wallium ($307.07 in chips) 
Seat 7: matiko09 ($100 in chips) 
Seat 8: f1reworks ($209.04 in chips) 
Seat 9: r4mz3s ($100 in chips) 
tipner will be allowed to play after the button
matiko09: posts small blind $0.50
f1reworks: posts big blind $1
*** HOLE CARDS ***
Dealt to matiko09 [Jd Qs]
r4mz3s: raises $2 to $3
sanpidk: folds 
Kukuryzka: folds 
vanilica: folds 
vanapeer: folds 
wallium: calls $3
matiko09: folds 
f1reworks: calls $2
*** FLOP *** [Kd 3s 2d]
f1reworks: checks 
r4mz3s: bets $6.50
wallium: folds 
f1reworks: folds 
Uncalled bet ($6.50) returned to r4mz3s
r4mz3s collected $9.02 from pot
r4mz3s: doesn't show hand 
*** SUMMARY ***
Total pot $9.50 | Rake $0.48 
Board [Kd 3s 2d]
Seat 1: sanpidk folded before Flop (didn't bet)
Seat 2: Kukuryzka folded before Flop (didn't bet)
Seat 3: vanilica folded before Flop (didn't bet)
Seat 4: vanapeer folded before Flop (didn't bet)
Seat 5: wallium (button) folded on the Flop
Seat 7: matiko09 (small blind) folded before Flop
Seat 8: f1reworks (big blind) folded on the Flop
Seat 9: r4mz3s collected ($9.02)





PokerStars Hand #155301363614:  Hold'em No Limit ($0.50/$1.00 USD) - 2016/06/28 16:21:10 CET [2016/06/28 10:21:10 ET]
Table 'Josephina II' 9-max Seat #7 is the button
Seat 1: matiko09 ($110.42 in chips) 
Seat 2: vanapeer ($103.78 in chips) 
Seat 3: r4mz3s ($101.50 in chips) 
Seat 4: sanpidk ($141.11 in chips) 
Seat 5: vanilica ($117.09 in chips) 
Seat 7: KovIFish89 ($100 in chips) 
Seat 8: Rabinho588 ($139.06 in chips) 
Seat 9: tipner ($107.60 in chips) 
Rabinho588: posts small blind $0.50
tipner: posts big blind $1
*** HOLE CARDS ***
Dealt to matiko09 [Qh 8s]
matiko09: folds 
vanapeer: folds 
r4mz3s: folds 
sanpidk: folds 
vanilica: folds 
KovIFish89: raises $1 to $2
Rabinho588: calls $1.50
tipner: folds 
*** FLOP *** [Kh 5s Qd]
Rabinho588: checks 
KovIFish89: bets $2.50
Rabinho588: calls $2.50
*** TURN *** [Kh 5s Qd] [2h]
Rabinho588: checks 
KovIFish89: bets $6
Rabinho588: folds 
Uncalled bet ($6) returned to KovIFish89
KovIFish89 collected $9.50 from pot
KovIFish89: doesn't show hand 
*** SUMMARY ***
Total pot $10 | Rake $0.50 
Board [Kh 5s Qd 2h]
Seat 1: matiko09 folded before Flop (didn't bet)
Seat 2: vanapeer folded before Flop (didn't bet)
Seat 3: r4mz3s folded before Flop (didn't bet)
Seat 4: sanpidk folded before Flop (didn't bet)
Seat 5: vanilica folded before Flop (didn't bet)
Seat 7: KovIFish89 (button) collected ($9.50)
Seat 8: Rabinho588 (small blind) folded on the Turn
Seat 9: tipner (big blind) folded before Flop





PokerStars Hand #155301363909:  Hold'em No Limit ($0.50/$1.00 USD) - 2016/06/28 16:21:10 CET [2016/06/28 10:21:10 ET]
Table 'Dorado II' 9-max Seat #7 is the button
Seat 1: f1reworks ($171.34 in chips) 
Seat 2: vanilica ($101.50 in chips) 
Seat 3: ghostriderxu ($49.06 in chips) 
Seat 4: pyromid ($117.55 in chips) 
Seat 5: KovIFish89 ($120.02 in chips) 
Seat 6: mycka86 ($101.50 in chips) 
Seat 7: matiko09 ($114.71 in chips) 
Seat 8: flk.Dasas ($191.50 in chips) 
Seat 9: r4mz3s ($101 in chips) 
flk.Dasas: posts small blind $0.50
r4mz3s: posts big blind $1
*** HOLE CARDS ***
Dealt to matiko09 [6s 4d]
f1reworks: raises $2 to $3
vanilica: folds 
ghostriderxu: folds 
pyromid: folds 
KovIFish89: calls $3
mycka86: folds 
matiko09: folds 
flk.Dasas: folds 
r4mz3s: folds 
*** FLOP *** [Js 4h Qc]
f1reworks: bets $3.91
KovIFish89: folds 
Uncalled bet ($3.91) returned to f1reworks
f1reworks collected $7.12 from pot
f1reworks: doesn't show hand 
*** SUMMARY ***
Total pot $7.50 | Rake $0.38 
Board [Js 4h Qc]
Seat 1: f1reworks collected ($7.12)
Seat 2: vanilica folded before Flop (didn't bet)
Seat 3: ghostriderxu folded before Flop (didn't bet)
Seat 4: pyromid folded before Flop (didn't bet)
Seat 5: KovIFish89 folded on the Flop
Seat 6: mycka86 folded before Flop (didn't bet)
Seat 7: matiko09 (button) folded before Flop (didn't bet)
Seat 8: flk.Dasas (small blind) folded before Flop
Seat 9: r4mz3s (big blind) folded before Flop





PokerStars Hand #155301376263:  Hold'em No Limit ($0.25/$0.50 USD) - 2016/06/28 16:21:33 CET [2016/06/28 10:21:33 ET]
Table 'Utra' 9-max Seat #8 is the button
Seat 1: ardo888 ($50 in chips) 
Seat 2: matiko09 ($75.51 in chips) 
Seat 3: mycka86 ($73.31 in chips) 
Seat 4: myatiy 96 ($50 in chips) 
Seat 5: er13to ($50 in chips) 
Seat 6: Franky77200 ($68.34 in chips) 
Seat 7: el.suertero ($67.99 in chips) 
Seat 8: fudzi ($50 in chips) 
Seat 9: Kukuryzka ($74.37 in chips) 
Kukuryzka: posts small blind $0.25
ardo888: posts big blind $0.50
ardo888: posts the ante $0.10
matiko09: posts the ante $0.10
mycka86: posts the ante $0.10
myatiy 96: posts the ante $0.10
er13to: posts the ante $0.10
Franky77200: posts the ante $0.10
el.suertero: posts the ante $0.10
fudzi: posts the ante $0.10
Kukuryzka: posts the ante $0.10
*** HOLE CARDS ***
Dealt to matiko09 [Ks 3h]
matiko09: folds 
mycka86: folds 
myatiy 96: folds 
er13to: folds 
Franky77200: raises $1 to $1.50
el.suertero: raises $3 to $4.50
fudzi: folds 
Kukuryzka: folds 
ardo888: folds 
Franky77200: calls $3
*** FLOP *** [Jh 5s Qh]
Franky77200: checks 
el.suertero: bets $7.50
Franky77200: calls $7.50
*** TURN *** [Jh 5s Qh] [4d]
Franky77200: checks 
el.suertero: bets $14
Franky77200: calls $14
*** RIVER *** [Jh 5s Qh 4d] [9h]
Franky77200: bets $42.24 and is all-in
el.suertero: folds 
Uncalled bet ($42.24) returned to Franky77200
Franky77200 collected $51.65 from pot
Franky77200: doesn't show hand 
*** SUMMARY ***
Total pot $53.65 | Rake $2 
Board [Jh 5s Qh 4d 9h]
Seat 1: ardo888 (big blind) folded before Flop
Seat 2: matiko09 folded before Flop (didn't bet)
Seat 3: mycka86 folded before Flop (didn't bet)
Seat 4: myatiy 96 folded before Flop (didn't bet)
Seat 5: er13to folded before Flop (didn't bet)
Seat 6: Franky77200 collected ($51.65)
Seat 7: el.suertero folded on the River
Seat 8: fudzi (button) folded before Flop (didn't bet)
Seat 9: Kukuryzka (small blind) folded before Flop





PokerStars Hand #155301389361:  Hold'em No Limit ($0.50/$1.00 USD) - 2016/06/28 16:21:57 CET [2016/06/28 10:21:57 ET]
Table 'Lyyli II' 9-max Seat #2 is the button
Seat 1: tipner ($148.03 in chips) 
Seat 2: CI58 ($113.02 in chips) 
Seat 3: Racushniak ($101.22 in chips) 
Seat 4: Greha999 ($123.98 in chips) 
Seat 5: flk.Dasas ($100.50 in chips) 
Seat 6: matiko09 ($128.94 in chips) 
Seat 7: Kukuryzka ($188.47 in chips) 
Seat 8: r4mz3s ($112.04 in chips) 
Seat 9: f1reworks ($101 in chips) 
Racushniak: posts small blind $0.50
Greha999: posts big blind $1
*** HOLE CARDS ***
Dealt to matiko09 [Qs Qh]
flk.Dasas: folds 
matiko09: raises $2 to $3
Kukuryzka: folds 
r4mz3s: raises $6 to $9
f1reworks: folds 
tipner: folds 
CI58: folds 
Racushniak: folds 
Greha999: folds 
matiko09: calls $6
*** FLOP *** [5h 7h Jh]
matiko09: checks 
r4mz3s: checks 
*** TURN *** [5h 7h Jh] [2h]
matiko09: checks 
r4mz3s: bets $6.50
matiko09: calls $6.50
*** RIVER *** [5h 7h Jh 2h] [8h]
matiko09: checks 
r4mz3s: bets $30.88
matiko09: folds 
Uncalled bet ($30.88) returned to r4mz3s
r4mz3s collected $30.88 from pot
r4mz3s: doesn't show hand 
*** SUMMARY ***
Total pot $32.50 | Rake $1.62 
Board [5h 7h Jh 2h 8h]
Seat 1: tipner folded before Flop (didn't bet)
Seat 2: CI58 (button) folded before Flop (didn't bet)
Seat 3: Racushniak (small blind) folded before Flop
Seat 4: Greha999 (big blind) folded before Flop
Seat 5: flk.Dasas folded before Flop (didn't bet)
Seat 6: matiko09 folded on the River
Seat 7: Kukuryzka folded before Flop (didn't bet)
Seat 8: r4mz3s collected ($30.88)
Seat 9: f1reworks folded before Flop (didn't bet)





PokerStars Hand #155301388943:  Hold'em No Limit ($0.50/$1.00 USD) - 2016/06/28 16:21:57 CET [2016/06/28 10:21:57 ET]
Table 'Dorado II' 9-max Seat #8 is the button
Seat 1: f1reworks ($175.46 in chips) 
Seat 2: vanilica ($101.50 in chips) 
Seat 3: ghostriderxu ($49.06 in chips) 
Seat 4: pyromid ($117.55 in chips) 
Seat 5: KovIFish89 ($117.02 in chips) 
Seat 6: mycka86 ($101.50 in chips) 
Seat 7: matiko09 ($114.71 in chips) 
Seat 8: flk.Dasas ($191 in chips) 
Seat 9: r4mz3s ($100 in chips) 
r4mz3s: posts small blind $0.50
f1reworks: posts big blind $1
*** HOLE CARDS ***
Dealt to matiko09 [3s 3h]
vanilica: folds 
ghostriderxu: folds 
pyromid: folds 
KovIFish89: folds 
mycka86: folds 
matiko09: raises $1.50 to $2.50
flk.Dasas: folds 
r4mz3s: folds 
f1reworks: folds 
Uncalled bet ($1.50) returned to matiko09
matiko09 collected $2.50 from pot
matiko09: doesn't show hand 
*** SUMMARY ***
Total pot $2.50 | Rake $0 
Seat 1: f1reworks (big blind) folded before Flop
Seat 2: vanilica folded before Flop (didn't bet)
Seat 3: ghostriderxu folded before Flop (didn't bet)
Seat 4: pyromid folded before Flop (didn't bet)
Seat 5: KovIFish89 folded before Flop (didn't bet)
Seat 6: mycka86 folded before Flop (didn't bet)
Seat 7: matiko09 collected ($2.50)
Seat 8: flk.Dasas (button) folded before Flop (didn't bet)
Seat 9: r4mz3s (small blind) folded before Flop





PokerStars Hand #155301394826:  Hold'em No Limit ($0.50/$1.00 USD) - 2016/06/28 16:22:08 CET [2016/06/28 10:22:08 ET]
Table 'Vicia II' 9-max Seat #7 is the button
Seat 1: sanpidk ($120.36 in chips) 
Seat 2: Kukuryzka ($110.40 in chips) 
Seat 3: vanilica ($100 in chips) 
Seat 4: vanapeer ($100 in chips) 
Seat 5: wallium ($304.07 in chips) 
Seat 7: matiko09 ($100 in chips) 
Seat 8: f1reworks ($206.04 in chips) 
Seat 9: r4mz3s ($106.02 in chips) 
f1reworks: posts small blind $0.50
r4mz3s: posts big blind $1
tipner: sits out 
*** HOLE CARDS ***
Dealt to matiko09 [7s Ad]
sanpidk: folds 
Kukuryzka: folds 
vanilica: folds 
vanapeer: folds 
wallium: raises $2 to $3
matiko09: folds 
f1reworks: folds 
r4mz3s: folds 
Uncalled bet ($2) returned to wallium
wallium collected $2.50 from pot
wallium: doesn't show hand 
*** SUMMARY ***
Total pot $2.50 | Rake $0 
Seat 1: sanpidk folded before Flop (didn't bet)
Seat 2: Kukuryzka folded before Flop (didn't bet)
Seat 3: vanilica folded before Flop (didn't bet)
Seat 4: vanapeer folded before Flop (didn't bet)
Seat 5: wallium collected ($2.50)
Seat 7: matiko09 (button) folded before Flop (didn't bet)
Seat 8: f1reworks (small blind) folded before Flop
Seat 9: r4mz3s (big blind) folded before Flop





PokerStars Hand #155301406341:  Hold'em No Limit ($0.50/$1.00 USD) - 2016/06/28 16:22:29 CET [2016/06/28 10:22:29 ET]
Table 'Dorado II' 9-max Seat #9 is the button
Seat 1: f1reworks ($174.46 in chips) 
Seat 2: vanilica ($101.50 in chips) 
Seat 3: ghostriderxu ($49.06 in chips) 
Seat 4: pyromid ($117.55 in chips) 
Seat 5: KovIFish89 ($117.02 in chips) 
Seat 6: mycka86 ($101.50 in chips) 
Seat 7: matiko09 ($116.21 in chips) 
Seat 8: flk.Dasas ($191 in chips) 
Seat 9: r4mz3s ($100 in chips) 
f1reworks: posts small blind $0.50
vanilica: posts big blind $1
*** HOLE CARDS ***
Dealt to matiko09 [7s Kc]
ghostriderxu: raises $2 to $3
pyromid: folds 
KovIFish89: folds 
mycka86: folds 
matiko09: folds 
flk.Dasas: folds 
r4mz3s: folds 
f1reworks: folds 
vanilica: folds 
Uncalled bet ($2) returned to ghostriderxu
ghostriderxu collected $2.50 from pot
ghostriderxu: doesn't show hand 
*** SUMMARY ***
Total pot $2.50 | Rake $0 
Seat 1: f1reworks (small blind) folded before Flop
Seat 2: vanilica (big blind) folded before Flop
Seat 3: ghostriderxu collected ($2.50)
Seat 4: pyromid folded before Flop (didn't bet)
Seat 5: KovIFish89 folded before Flop (didn't bet)
Seat 6: mycka86 folded before Flop (didn't bet)
Seat 7: matiko09 folded before Flop (didn't bet)
Seat 8: flk.Dasas folded before Flop (didn't bet)
Seat 9: r4mz3s (button) folded before Flop (didn't bet)





PokerStars Hand #155301406371:  Hold'em No Limit ($0.50/$1.00 USD) - 2016/06/28 16:22:30 CET [2016/06/28 10:22:30 ET]
Table 'Vicia II' 9-max Seat #8 is the button
Seat 1: sanpidk ($120.36 in chips) 
Seat 2: Kukuryzka ($110.40 in chips) 
Seat 3: vanilica ($100 in chips) 
Seat 4: vanapeer ($100 in chips) 
Seat 5: wallium ($305.57 in chips) 
Seat 7: matiko09 ($100 in chips) 
Seat 8: f1reworks ($205.54 in chips) 
Seat 9: r4mz3s ($105.02 in chips) 
r4mz3s: posts small blind $0.50
sanpidk: posts big blind $1
tipner: sits out 
*** HOLE CARDS ***
Dealt to matiko09 [3s Ts]
Kukuryzka: folds 
vanilica: folds 
vanapeer: folds 
wallium: calls $1
matiko09: folds 
f1reworks: folds 
r4mz3s: raises $4 to $5
sanpidk: folds 
wallium: calls $4
*** FLOP *** [2c Ah As]
r4mz3s: bets $5.50
wallium: folds 
Uncalled bet ($5.50) returned to r4mz3s
r4mz3s collected $10.45 from pot
r4mz3s: doesn't show hand 
*** SUMMARY ***
Total pot $11 | Rake $0.55 
Board [2c Ah As]
Seat 1: sanpidk (big blind) folded before Flop
Seat 2: Kukuryzka folded before Flop (didn't bet)
Seat 3: vanilica folded before Flop (didn't bet)
Seat 4: vanapeer folded before Flop (didn't bet)
Seat 5: wallium folded on the Flop
Seat 7: matiko09 folded before Flop (didn't bet)
Seat 8: f1reworks (button) folded before Flop (didn't bet)
Seat 9: r4mz3s (small blind) collected ($10.45)





PokerStars Hand #155301411352:  Hold'em No Limit ($0.50/$1.00 USD) - 2016/06/28 16:22:39 CET [2016/06/28 10:22:39 ET]
Table 'Tomita' 9-max Seat #5 is the button
Seat 1: CI58 ($100 in chips) 
Seat 2: vanilica ($105.22 in chips) 
Seat 3: r4mz3s ($100 in chips) 
Seat 4: f1reworks ($116.95 in chips) 
Seat 5: ANDY19911608 ($168.26 in chips) 
Seat 6: tipner ($103.95 in chips) 
Seat 7: matiko09 ($110.30 in chips) 
Seat 8: myatiy 96 ($101.50 in chips) 
Seat 9: sanpidk ($143.89 in chips) 
tipner: posts small blind $0.50
matiko09: posts big blind $1
*** HOLE CARDS ***
Dealt to matiko09 [5h 8h]
myatiy 96: folds 
sanpidk: folds 
CI58: folds 
vanilica: folds 
r4mz3s: folds 
f1reworks: folds 
ANDY19911608: folds 
tipner: raises $2 to $3
matiko09: folds 
Uncalled bet ($2) returned to tipner
tipner collected $2 from pot
tipner: doesn't show hand 
*** SUMMARY ***
Total pot $2 | Rake $0 
Seat 1: CI58 folded before Flop (didn't bet)
Seat 2: vanilica folded before Flop (didn't bet)
Seat 3: r4mz3s folded before Flop (didn't bet)
Seat 4: f1reworks folded before Flop (didn't bet)
Seat 5: ANDY19911608 (button) folded before Flop (didn't bet)
Seat 6: tipner (small blind) collected ($2)
Seat 7: matiko09 (big blind) folded before Flop
Seat 8: myatiy 96 folded before Flop (didn't bet)
Seat 9: sanpidk folded before Flop (didn't bet)





PokerStars Hand #155301413300:  Hold'em No Limit ($0.50/$1.00 USD) - 2016/06/28 16:22:43 CET [2016/06/28 10:22:43 ET]
Table 'Dorado II' 9-max Seat #1 is the button
Seat 1: f1reworks ($173.96 in chips) 
Seat 2: vanilica ($100.50 in chips) 
Seat 3: ghostriderxu ($50.56 in chips) 
Seat 4: pyromid ($117.55 in chips) 
Seat 5: KovIFish89 ($117.02 in chips) 
Seat 6: mycka86 ($101.50 in chips) 
Seat 7: matiko09 ($116.21 in chips) 
Seat 8: flk.Dasas ($191 in chips) 
Seat 9: r4mz3s ($100 in chips) 
vanilica: posts small blind $0.50
ghostriderxu: posts big blind $1
*** HOLE CARDS ***
Dealt to matiko09 [Ad 8d]
pyromid: folds 
KovIFish89: raises $2 to $3
mycka86: folds 
matiko09: folds 
flk.Dasas: folds 
r4mz3s: folds 
f1reworks: calls $3
vanilica: folds 
ghostriderxu: calls $2
*** FLOP *** [8s Qs 7c]
ghostriderxu: checks 
KovIFish89: bets $7
f1reworks: calls $7
ghostriderxu: folds 
*** TURN *** [8s Qs 7c] [Td]
KovIFish89: bets $15
f1reworks: calls $15
*** RIVER *** [8s Qs 7c Td] [2s]
KovIFish89: checks 
f1reworks: bets $43
KovIFish89: folds 
Uncalled bet ($43) returned to f1reworks
f1reworks collected $51 from pot
f1reworks: doesn't show hand 
*** SUMMARY ***
Total pot $53.50 | Rake $2.50 
Board [8s Qs 7c Td 2s]
Seat 1: f1reworks (button) collected ($51)
Seat 2: vanilica (small blind) folded before Flop
Seat 3: ghostriderxu (big blind) folded on the Flop
Seat 4: pyromid folded before Flop (didn't bet)
Seat 5: KovIFish89 folded on the River
Seat 6: mycka86 folded before Flop (didn't bet)
Seat 7: matiko09 folded before Flop (didn't bet)
Seat 8: flk.Dasas folded before Flop (didn't bet)
Seat 9: r4mz3s folded before Flop (didn't bet)





PokerStars Hand #155301426660:  Hold'em No Limit ($0.25/$0.50 USD) - 2016/06/28 16:23:08 CET [2016/06/28 10:23:08 ET]
Table 'Utra' 9-max Seat #9 is the button
Seat 1: ardo888 ($50 in chips) 
Seat 2: matiko09 ($75.41 in chips) 
Seat 3: mycka86 ($73.21 in chips) 
Seat 4: myatiy 96 ($50 in chips) 
Seat 5: er13to ($50 in chips) 
Seat 6: Franky77200 ($93.89 in chips) 
Seat 7: el.suertero ($50 in chips) 
Seat 8: fudzi ($50 in chips) 
Seat 9: Kukuryzka ($74.02 in chips) 
ardo888: posts small blind $0.25
matiko09: posts big blind $0.50
ardo888: posts the ante $0.10
matiko09: posts the ante $0.10
mycka86: posts the ante $0.10
myatiy 96: posts the ante $0.10
er13to: posts the ante $0.10
Franky77200: posts the ante $0.10
el.suertero: posts the ante $0.10
fudzi: posts the ante $0.10
Kukuryzka: posts the ante $0.10
*** HOLE CARDS ***
Dealt to matiko09 [4d Kc]
mycka86: folds 
myatiy 96: folds 
er13to: folds 
Franky77200: folds 
el.suertero: folds 
fudzi: raises $1 to $1.50
Kukuryzka: folds 
ardo888: folds 
matiko09: folds 
Uncalled bet ($1) returned to fudzi
fudzi collected $2.15 from pot
fudzi: doesn't show hand 
*** SUMMARY ***
Total pot $2.15 | Rake $0 
Seat 1: ardo888 (small blind) folded before Flop
Seat 2: matiko09 (big blind) folded before Flop
Seat 3: mycka86 folded before Flop (didn't bet)
Seat 4: myatiy 96 folded before Flop (didn't bet)
Seat 5: er13to folded before Flop (didn't bet)
Seat 6: Franky77200 folded before Flop (didn't bet)
Seat 7: el.suertero folded before Flop (didn't bet)
Seat 8: fudzi collected ($2.15)
Seat 9: Kukuryzka (button) folded before Flop (didn't bet)





PokerStars Hand #155301428368:  Hold'em No Limit ($0.50/$1.00 USD) - 2016/06/28 16:23:11 CET [2016/06/28 10:23:11 ET]
Table 'Tomita' 9-max Seat #6 is the button
Seat 1: CI58 ($100 in chips) 
Seat 2: vanilica ($105.22 in chips) 
Seat 3: r4mz3s ($100 in chips) 
Seat 4: f1reworks ($116.95 in chips) 
Seat 5: ANDY19911608 ($168.26 in chips) 
Seat 6: tipner ($104.95 in chips) 
Seat 7: matiko09 ($109.30 in chips) 
Seat 8: myatiy 96 ($101.50 in chips) 
Seat 9: sanpidk ($143.89 in chips) 
matiko09: posts small blind $0.50
myatiy 96: posts big blind $1
*** HOLE CARDS ***
Dealt to matiko09 [7d 3h]
sanpidk: folds 
CI58: folds 
vanilica: folds 
r4mz3s: folds 
f1reworks: folds 
ANDY19911608: folds 
tipner: folds 
matiko09: folds 
Uncalled bet ($0.50) returned to myatiy 96
myatiy 96 collected $1 from pot
*** SUMMARY ***
Total pot $1 | Rake $0 
Seat 1: CI58 folded before Flop (didn't bet)
Seat 2: vanilica folded before Flop (didn't bet)
Seat 3: r4mz3s folded before Flop (didn't bet)
Seat 4: f1reworks folded before Flop (didn't bet)
Seat 5: ANDY19911608 folded before Flop (didn't bet)
Seat 6: tipner (button) folded before Flop (didn't bet)
Seat 7: matiko09 (small blind) folded before Flop
Seat 8: myatiy 96 (big blind) collected ($1)
Seat 9: sanpidk folded before Flop (didn't bet)





PokerStars Hand #155301446124:  Hold'em No Limit ($0.25/$0.50 USD) - 2016/06/28 16:23:44 CET [2016/06/28 10:23:44 ET]
Table 'Utra' 9-max Seat #1 is the button
Seat 1: ardo888 ($50 in chips) 
Seat 2: matiko09 ($74.81 in chips) 
Seat 3: mycka86 ($73.11 in chips) 
Seat 4: myatiy 96 ($50 in chips) 
Seat 5: er13to ($50 in chips) 
Seat 6: Franky77200 ($93.79 in chips) 
Seat 7: el.suertero ($50 in chips) 
Seat 8: fudzi ($51.55 in chips) 
Seat 9: Kukuryzka ($73.92 in chips) 
matiko09: posts small blind $0.25
mycka86: posts big blind $0.50
ardo888: posts the ante $0.10
matiko09: posts the ante $0.10
mycka86: posts the ante $0.10
myatiy 96: posts the ante $0.10
er13to: posts the ante $0.10
Franky77200: posts the ante $0.10
el.suertero: posts the ante $0.10
fudzi: posts the ante $0.10
Kukuryzka: posts the ante $0.10
*** HOLE CARDS ***
Dealt to matiko09 [9h 4d]
myatiy 96: folds 
er13to: folds 
Franky77200: raises $1 to $1.50
el.suertero: folds 
fudzi: folds 
Kukuryzka: folds 
ardo888: folds 
matiko09: folds 
mycka86: folds 
Uncalled bet ($1) returned to Franky77200
Franky77200 collected $2.15 from pot
Franky77200: doesn't show hand 
*** SUMMARY ***
Total pot $2.15 | Rake $0 
Seat 1: ardo888 (button) folded before Flop (didn't bet)
Seat 2: matiko09 (small blind) folded before Flop
Seat 3: mycka86 (big blind) folded before Flop
Seat 4: myatiy 96 folded before Flop (didn't bet)
Seat 5: er13to folded before Flop (didn't bet)
Seat 6: Franky77200 collected ($2.15)
Seat 7: el.suertero folded before Flop (didn't bet)
Seat 8: fudzi folded before Flop (didn't bet)
Seat 9: Kukuryzka folded before Flop (didn't bet)





PokerStars Hand #155301446865:  Hold'em No Limit ($0.50/$1.00 USD) - 2016/06/28 16:23:46 CET [2016/06/28 10:23:46 ET]
Table 'Tomita' 9-max Seat #7 is the button
Seat 1: CI58 ($100 in chips) 
Seat 2: vanilica ($105.22 in chips) 
Seat 3: r4mz3s ($100 in chips) 
Seat 4: f1reworks ($116.95 in chips) 
Seat 5: ANDY19911608 ($168.26 in chips) 
Seat 6: tipner ($104.95 in chips) 
Seat 7: matiko09 ($108.80 in chips) 
Seat 8: myatiy 96 ($102 in chips) 
Seat 9: sanpidk ($143.89 in chips) 
myatiy 96: posts small blind $0.50
sanpidk: posts big blind $1
*** HOLE CARDS ***
Dealt to matiko09 [3d 2c]
CI58: folds 
vanilica: folds 
r4mz3s: folds 
f1reworks: raises $2 to $3
ANDY19911608: folds 
tipner: folds 
matiko09: folds 
myatiy 96: folds 
sanpidk: folds 
Uncalled bet ($2) returned to f1reworks
f1reworks collected $2.50 from pot
f1reworks: doesn't show hand 
*** SUMMARY ***
Total pot $2.50 | Rake $0 
Seat 1: CI58 folded before Flop (didn't bet)
Seat 2: vanilica folded before Flop (didn't bet)
Seat 3: r4mz3s folded before Flop (didn't bet)
Seat 4: f1reworks collected ($2.50)
Seat 5: ANDY19911608 folded before Flop (didn't bet)
Seat 6: tipner folded before Flop (didn't bet)
Seat 7: matiko09 (button) folded before Flop (didn't bet)
Seat 8: myatiy 96 (small blind) folded before Flop
Seat 9: sanpidk (big blind) folded before Flop





PokerStars Hand #155301450882:  Hold'em No Limit ($0.50/$1.00 USD) - 2016/06/28 16:23:53 CET [2016/06/28 10:23:53 ET]
Table 'Anitra' 9-max Seat #4 is the button
Seat 1: Klappspaten0 ($100 in chips) 
Seat 2: ardo888 ($100 in chips) 
Seat 3: facelessPPP ($100.20 in chips) 
Seat 4: Shakeelg ($114.62 in chips) 
Seat 5: er13to ($100 in chips) 
Seat 6: matiko09 ($100 in chips) 
Seat 9: chenconhaste ($104.95 in chips) 
er13to: posts small blind $0.50
matiko09: posts big blind $1
myatiy 96: sits out 
yoshinoino: sits out 
*** HOLE CARDS ***
Dealt to matiko09 [Qc Qs]
chenconhaste: folds 
Klappspaten0: folds 
ardo888: raises $2 to $3
facelessPPP: folds 
Shakeelg: folds 
er13to: folds 
matiko09: raises $7 to $10
ardo888: folds 
Uncalled bet ($7) returned to matiko09
matiko09 collected $6.50 from pot
matiko09: doesn't show hand 
*** SUMMARY ***
Total pot $6.50 | Rake $0 
Seat 1: Klappspaten0 folded before Flop (didn't bet)
Seat 2: ardo888 folded before Flop
Seat 3: facelessPPP folded before Flop (didn't bet)
Seat 4: Shakeelg (button) folded before Flop (didn't bet)
Seat 5: er13to (small blind) folded before Flop
Seat 6: matiko09 (big blind) collected ($6.50)
Seat 9: chenconhaste folded before Flop (didn't bet)





PokerStars Hand #155301455193:  Hold'em No Limit ($0.50/$1.00 USD) - 2016/06/28 16:24:01 CET [2016/06/28 10:24:01 ET]
Table 'Vicia II' 9-max Seat #9 is the button
Seat 1: sanpidk ($119.36 in chips) 
Seat 2: Kukuryzka ($110.40 in chips) 
Seat 3: vanilica ($100 in chips) 
Seat 4: vanapeer ($100 in chips) 
Seat 5: wallium ($300.57 in chips) 
Seat 7: matiko09 ($100 in chips) 
Seat 8: f1reworks ($205.54 in chips) 
Seat 9: r4mz3s ($110.47 in chips) 
sanpidk: posts small blind $0.50
Kukuryzka: posts big blind $1
tipner: sits out 
*** HOLE CARDS ***
Dealt to matiko09 [Qh 8s]
vanilica: folds 
vanapeer: folds 
wallium: calls $1
matiko09: folds 
f1reworks: folds 
r4mz3s: folds 
sanpidk: raises $4 to $5
Kukuryzka: calls $4
wallium: calls $4
*** FLOP *** [9d 8h 3c]
sanpidk: bets $8.50
Kukuryzka: calls $8.50
wallium: raises $39.75 to $48.25
sanpidk: folds 
Kukuryzka: raises $44.25 to $92.50
wallium: raises $44.25 to $136.75
Kukuryzka: calls $12.90 and is all-in
Uncalled bet ($31.35) returned to wallium
*** TURN *** [9d 8h 3c] [2h]
*** RIVER *** [9d 8h 3c 2h] [6s]
*** SHOW DOWN ***
Kukuryzka: shows [Kh Ks] (a pair of Kings)
wallium: shows [Js Jd] (a pair of Jacks)
Kukuryzka collected $231.80 from pot
*** SUMMARY ***
Total pot $234.30 | Rake $2.50 
Board [9d 8h 3c 2h 6s]
Seat 1: sanpidk (small blind) folded on the Flop
Seat 2: Kukuryzka (big blind) showed [Kh Ks] and won ($231.80) with a pair of Kings
Seat 3: vanilica folded before Flop (didn't bet)
Seat 4: vanapeer folded before Flop (didn't bet)
Seat 5: wallium showed [Js Jd] and lost with a pair of Jacks
Seat 7: matiko09 folded before Flop (didn't bet)
Seat 8: f1reworks folded before Flop (didn't bet)
Seat 9: r4mz3s (button) folded before Flop (didn't bet)





PokerStars Hand #155301458489:  Hold'em No Limit ($0.50/$1.00 USD) - 2016/06/28 16:24:07 CET [2016/06/28 10:24:07 ET]
Table 'Dorado II' 9-max Seat #2 is the button
Seat 1: f1reworks ($199.96 in chips) 
Seat 2: vanilica ($100 in chips) 
Seat 3: ghostriderxu ($47.56 in chips) 
Seat 4: pyromid ($117.55 in chips) 
Seat 5: KovIFish89 ($100 in chips) 
Seat 6: mycka86 ($101.50 in chips) 
Seat 7: matiko09 ($116.21 in chips) 
Seat 8: flk.Dasas ($191 in chips) 
Seat 9: r4mz3s ($100 in chips) 
ghostriderxu: posts small blind $0.50
pyromid: posts big blind $1
*** HOLE CARDS ***
Dealt to matiko09 [4c Jc]
KovIFish89: folds 
mycka86: raises $2 to $3
matiko09: folds 
flk.Dasas: folds 
r4mz3s: folds 
f1reworks: folds 
vanilica: folds 
ghostriderxu: calls $2.50
pyromid: folds 
*** FLOP *** [2h Qs 9c]
ghostriderxu: checks 
mycka86: bets $5.10
ghostriderxu: calls $5.10
*** TURN *** [2h Qs 9c] [Kd]
ghostriderxu: checks 
mycka86: checks 
*** RIVER *** [2h Qs 9c Kd] [3c]
ghostriderxu: checks 
mycka86: bets $8.50
ghostriderxu: folds 
Uncalled bet ($8.50) returned to mycka86
mycka86 collected $16.34 from pot
*** SUMMARY ***
Total pot $17.20 | Rake $0.86 
Board [2h Qs 9c Kd 3c]
Seat 1: f1reworks folded before Flop (didn't bet)
Seat 2: vanilica (button) folded before Flop (didn't bet)
Seat 3: ghostriderxu (small blind) folded on the River
Seat 4: pyromid (big blind) folded before Flop
Seat 5: KovIFish89 folded before Flop (didn't bet)
Seat 6: mycka86 collected ($16.34)
Seat 7: matiko09 folded before Flop (didn't bet)
Seat 8: flk.Dasas folded before Flop (didn't bet)
Seat 9: r4mz3s folded before Flop (didn't bet)





PokerStars Hand #155301461473:  Hold'em No Limit ($0.50/$1.00 USD) - 2016/06/28 16:24:13 CET [2016/06/28 10:24:13 ET]
Table 'Tomita' 9-max Seat #8 is the button
Seat 1: CI58 ($100 in chips) 
Seat 2: vanilica ($105.22 in chips) 
Seat 3: r4mz3s ($100 in chips) 
Seat 4: f1reworks ($118.45 in chips) 
Seat 5: ANDY19911608 ($168.26 in chips) 
Seat 6: tipner ($104.95 in chips) 
Seat 7: matiko09 ($108.80 in chips) 
Seat 8: myatiy 96 ($101.50 in chips) 
Seat 9: sanpidk ($142.89 in chips) 
sanpidk: posts small blind $0.50
CI58: posts big blind $1
*** HOLE CARDS ***
Dealt to matiko09 [2s Qs]
vanilica: folds 
r4mz3s: folds 
f1reworks: folds 
ANDY19911608: calls $1
tipner: raises $3 to $4
matiko09: folds 
myatiy 96: folds 
sanpidk: folds 
CI58: folds 
ANDY19911608: calls $3
*** FLOP *** [Kh Kd Qd]
ANDY19911608: bets $1
tipner: raises $5 to $6
ANDY19911608: calls $5
*** TURN *** [Kh Kd Qd] [4d]
ANDY19911608: checks 
tipner: checks 
*** RIVER *** [Kh Kd Qd 4d] [3c]
ANDY19911608: checks 
tipner: checks 
*** SHOW DOWN ***
ANDY19911608: shows [Ah Tc] (a pair of Kings)
tipner: mucks hand 
ANDY19911608 collected $20.42 from pot
*** SUMMARY ***
Total pot $21.50 | Rake $1.08 
Board [Kh Kd Qd 4d 3c]
Seat 1: CI58 (big blind) folded before Flop
Seat 2: vanilica folded before Flop (didn't bet)
Seat 3: r4mz3s folded before Flop (didn't bet)
Seat 4: f1reworks folded before Flop (didn't bet)
Seat 5: ANDY19911608 showed [Ah Tc] and won ($20.42) with a pair of Kings
Seat 6: tipner mucked [8h 9h]
Seat 7: matiko09 folded before Flop (didn't bet)
Seat 8: myatiy 96 (button) folded before Flop (didn't bet)
Seat 9: sanpidk (small blind) folded before Flop





PokerStars Hand #155301462580:  Hold'em No Limit ($0.50/$1.00 USD) - 2016/06/28 16:24:15 CET [2016/06/28 10:24:15 ET]
Table 'Anitra' 9-max Seat #5 is the button
Seat 1: Klappspaten0 ($100 in chips) 
Seat 2: ardo888 ($100 in chips) 
Seat 3: facelessPPP ($100.20 in chips) 
Seat 4: Shakeelg ($114.62 in chips) 
Seat 5: er13to ($100 in chips) 
Seat 6: matiko09 ($103.50 in chips) 
Seat 7: myatiy 96 ($100 in chips) 
Seat 9: chenconhaste ($104.95 in chips) 
matiko09: posts small blind $0.50
myatiy 96: posts big blind $1
yoshinoino: sits out 
*** HOLE CARDS ***
Dealt to matiko09 [5s Ad]
chenconhaste: folds 
Klappspaten0: folds 
ardo888: folds 
facelessPPP: folds 
Shakeelg: folds 
er13to: raises $1.72 to $2.72
matiko09: folds 
myatiy 96: folds 
Uncalled bet ($1.72) returned to er13to
er13to collected $2.50 from pot
*** SUMMARY ***
Total pot $2.50 | Rake $0 
Seat 1: Klappspaten0 folded before Flop (didn't bet)
Seat 2: ardo888 folded before Flop (didn't bet)
Seat 3: facelessPPP folded before Flop (didn't bet)
Seat 4: Shakeelg folded before Flop (didn't bet)
Seat 5: er13to (button) collected ($2.50)
Seat 6: matiko09 (small blind) folded before Flop
Seat 7: myatiy 96 (big blind) folded before Flop
Seat 9: chenconhaste folded before Flop (didn't bet)





PokerStars Hand #155301465564:  Hold'em No Limit ($0.50/$1.00 USD) - 2016/06/28 16:24:21 CET [2016/06/28 10:24:21 ET]
Table 'Lyyli II' 9-max Seat #3 is the button
Seat 1: tipner ($148.03 in chips) 
Seat 2: CI58 ($113.02 in chips) 
Seat 3: Racushniak ($100.72 in chips) 
Seat 4: Greha999 ($122.98 in chips) 
Seat 5: flk.Dasas ($100.50 in chips) 
Seat 6: matiko09 ($113.44 in chips) 
Seat 7: Kukuryzka ($188.47 in chips) 
Seat 8: r4mz3s ($127.42 in chips) 
Seat 9: f1reworks ($101 in chips) 
Greha999: posts small blind $0.50
flk.Dasas: posts big blind $1
*** HOLE CARDS ***
Dealt to matiko09 [9h Qs]
matiko09: folds 
Kukuryzka: raises $2 to $3
r4mz3s: folds 
f1reworks: folds 
tipner: folds 
CI58: raises $6 to $9
Racushniak: folds 
Greha999: folds 
flk.Dasas: folds 
Kukuryzka: folds 
Uncalled bet ($6) returned to CI58
CI58 collected $7.50 from pot
CI58: doesn't show hand 
*** SUMMARY ***
Total pot $7.50 | Rake $0 
Seat 1: tipner folded before Flop (didn't bet)
Seat 2: CI58 collected ($7.50)
Seat 3: Racushniak (button) folded before Flop (didn't bet)
Seat 4: Greha999 (small blind) folded before Flop
Seat 5: flk.Dasas (big blind) folded before Flop
Seat 6: matiko09 folded before Flop (didn't bet)
Seat 7: Kukuryzka folded before Flop
Seat 8: r4mz3s folded before Flop (didn't bet)
Seat 9: f1reworks folded before Flop (didn't bet)





PokerStars Hand #155301470065:  Hold'em No Limit ($0.25/$0.50 USD) - 2016/06/28 16:24:29 CET [2016/06/28 10:24:29 ET]
Table 'Utra' 9-max Seat #2 is the button
Seat 1: ardo888 ($50 in chips) 
Seat 2: matiko09 ($74.46 in chips) 
Seat 3: mycka86 ($72.51 in chips) 
Seat 4: myatiy 96 ($50 in chips) 
Seat 5: er13to ($50 in chips) 
Seat 6: Franky77200 ($95.34 in chips) 
Seat 7: el.suertero ($50 in chips) 
Seat 8: fudzi ($51.45 in chips) 
Seat 9: Kukuryzka ($73.82 in chips) 
mycka86: posts small blind $0.25
myatiy 96: posts big blind $0.50
ardo888: posts the ante $0.10
matiko09: posts the ante $0.10
mycka86: posts the ante $0.10
myatiy 96: posts the ante $0.10
er13to: posts the ante $0.10
Franky77200: posts the ante $0.10
el.suertero: posts the ante $0.10
fudzi: posts the ante $0.10
Kukuryzka: posts the ante $0.10
*** HOLE CARDS ***
Dealt to matiko09 [4h 8h]
er13to: raises $0.86 to $1.36
Franky77200: folds 
el.suertero: folds 
fudzi: raises $4.37 to $5.73
Kukuryzka: folds 
ardo888: folds 
matiko09: folds 
mycka86: folds 
myatiy 96: folds 
er13to: folds 
Uncalled bet ($4.37) returned to fudzi
fudzi collected $4.37 from pot
fudzi: doesn't show hand 
*** SUMMARY ***
Total pot $4.37 | Rake $0 
Seat 1: ardo888 folded before Flop (didn't bet)
Seat 2: matiko09 (button) folded before Flop (didn't bet)
Seat 3: mycka86 (small blind) folded before Flop
Seat 4: myatiy 96 (big blind) folded before Flop
Seat 5: er13to folded before Flop
Seat 6: Franky77200 folded before Flop (didn't bet)
Seat 7: el.suertero folded before Flop (didn't bet)
Seat 8: fudzi collected ($4.37)
Seat 9: Kukuryzka folded before Flop (didn't bet)





PokerStars Hand #155301482148:  Hold'em No Limit ($0.50/$1.00 USD) - 2016/06/28 16:24:52 CET [2016/06/28 10:24:52 ET]
Table 'Anitra' 9-max Seat #6 is the button
Seat 1: Klappspaten0 ($100 in chips) 
Seat 2: ardo888 ($100 in chips) 
Seat 3: facelessPPP ($100.20 in chips) 
Seat 4: Shakeelg ($114.62 in chips) 
Seat 5: er13to ($101.50 in chips) 
Seat 6: matiko09 ($103 in chips) 
Seat 7: myatiy 96 ($100 in chips) 
Seat 8: yoshinoino ($41.50 in chips) 
Seat 9: chenconhaste ($104.95 in chips) 
myatiy 96: posts small blind $0.50
yoshinoino: posts big blind $1
*** HOLE CARDS ***
Dealt to matiko09 [Kh 4d]
chenconhaste: folds 
Klappspaten0: calls $1
ardo888: folds 
facelessPPP: folds 
Shakeelg: folds 
er13to: folds 
matiko09: folds 
myatiy 96: folds 
yoshinoino: checks 
*** FLOP *** [Ad 5h 9h]
yoshinoino: checks 
Klappspaten0: bets $1.78
yoshinoino: calls $1.78
*** TURN *** [Ad 5h 9h] [Kc]
yoshinoino: checks 
Klappspaten0: bets $4
yoshinoino: calls $4
*** RIVER *** [Ad 5h 9h Kc] [Qd]
yoshinoino: checks 
Klappspaten0: checks 
*** SHOW DOWN ***
yoshinoino: shows [6h Jh] (high card Ace)
Klappspaten0: shows [As Jd] (a pair of Aces)
Klappspaten0 collected $13.36 from pot
*** SUMMARY ***
Total pot $14.06 | Rake $0.70 
Board [Ad 5h 9h Kc Qd]
Seat 1: Klappspaten0 showed [As Jd] and won ($13.36) with a pair of Aces
Seat 2: ardo888 folded before Flop (didn't bet)
Seat 3: facelessPPP folded before Flop (didn't bet)
Seat 4: Shakeelg folded before Flop (didn't bet)
Seat 5: er13to folded before Flop (didn't bet)
Seat 6: matiko09 (button) folded before Flop (didn't bet)
Seat 7: myatiy 96 (small blind) folded before Flop
Seat 8: yoshinoino (big blind) showed [6h Jh] and lost with high card Ace
Seat 9: chenconhaste folded before Flop (didn't bet)





PokerStars Hand #155301487286:  Hold'em No Limit ($0.50/$1.00 USD) - 2016/06/28 16:25:01 CET [2016/06/28 10:25:01 ET]
Table 'Dorado II' 9-max Seat #3 is the button
Seat 1: f1reworks ($199.96 in chips) 
Seat 2: vanilica ($100 in chips) 
Seat 3: ghostriderxu ($39.46 in chips) 
Seat 4: pyromid ($116.55 in chips) 
Seat 5: KovIFish89 ($100 in chips) 
Seat 6: mycka86 ($109.74 in chips) 
Seat 7: matiko09 ($116.21 in chips) 
Seat 8: flk.Dasas ($191 in chips) 
Seat 9: r4mz3s ($100 in chips) 
pyromid: posts small blind $0.50
KovIFish89: posts big blind $1
*** HOLE CARDS ***
Dealt to matiko09 [6s Js]
mycka86: folds 
matiko09: folds 
flk.Dasas: folds 
r4mz3s: raises $1.55 to $2.55
f1reworks: folds 
vanilica: folds 
ghostriderxu: calls $2.55
pyromid: calls $2.05
KovIFish89: folds 
*** FLOP *** [Jh Jd Kc]
pyromid: checks 
r4mz3s: bets $5.50
ghostriderxu: folds 
pyromid: folds 
Uncalled bet ($5.50) returned to r4mz3s
r4mz3s collected $8.22 from pot
r4mz3s: doesn't show hand 
*** SUMMARY ***
Total pot $8.65 | Rake $0.43 
Board [Jh Jd Kc]
Seat 1: f1reworks folded before Flop (didn't bet)
Seat 2: vanilica folded before Flop (didn't bet)
Seat 3: ghostriderxu (button) folded on the Flop
Seat 4: pyromid (small blind) folded on the Flop
Seat 5: KovIFish89 (big blind) folded before Flop
Seat 6: mycka86 folded before Flop (didn't bet)
Seat 7: matiko09 folded before Flop (didn't bet)
Seat 8: flk.Dasas folded before Flop (didn't bet)
Seat 9: r4mz3s collected ($8.22)





PokerStars Hand #155301494760:  Hold'em No Limit ($0.50/$1.00 USD) - 2016/06/28 16:25:15 CET [2016/06/28 10:25:15 ET]
Table 'Lyyli II' 9-max Seat #4 is the button
Seat 1: tipner ($148.03 in chips) 
Seat 2: CI58 ($117.52 in chips) 
Seat 3: Racushniak ($100.72 in chips) 
Seat 4: Greha999 ($122.48 in chips) 
Seat 5: flk.Dasas ($100 in chips) 
Seat 6: matiko09 ($113.44 in chips) 
Seat 7: Kukuryzka ($185.47 in chips) 
Seat 8: r4mz3s ($127.42 in chips) 
Seat 9: f1reworks ($101 in chips) 
flk.Dasas: posts small blind $0.50
matiko09: posts big blind $1
*** HOLE CARDS ***
Dealt to matiko09 [Qd Js]
Kukuryzka: folds 
r4mz3s: folds 
f1reworks: folds 
tipner: folds 
CI58: folds 
Racushniak: folds 
Greha999: folds 
flk.Dasas: raises $2 to $3
matiko09: calls $2
*** FLOP *** [Th 3d Ts]
flk.Dasas: checks 
matiko09: checks 
*** TURN *** [Th 3d Ts] [8d]
flk.Dasas: bets $3.88
matiko09: folds 
Uncalled bet ($3.88) returned to flk.Dasas
flk.Dasas collected $5.70 from pot
flk.Dasas: doesn't show hand 
*** SUMMARY ***
Total pot $6 | Rake $0.30 
Board [Th 3d Ts 8d]
Seat 1: tipner folded before Flop (didn't bet)
Seat 2: CI58 folded before Flop (didn't bet)
Seat 3: Racushniak folded before Flop (didn't bet)
Seat 4: Greha999 (button) folded before Flop (didn't bet)
Seat 5: flk.Dasas (small blind) collected ($5.70)
Seat 6: matiko09 (big blind) folded on the Turn
Seat 7: Kukuryzka folded before Flop (didn't bet)
Seat 8: r4mz3s folded before Flop (didn't bet)
Seat 9: f1reworks folded before Flop (didn't bet)





PokerStars Hand #155301501134:  Hold'em No Limit ($0.50/$1.00 USD) - 2016/06/28 16:25:27 CET [2016/06/28 10:25:27 ET]
Table 'Tomita' 9-max Seat #9 is the button
Seat 1: CI58 ($100 in chips) 
Seat 2: vanilica ($105.22 in chips) 
Seat 3: r4mz3s ($100 in chips) 
Seat 4: f1reworks ($118.45 in chips) 
Seat 5: ANDY19911608 ($178.68 in chips) 
Seat 6: tipner ($100 in chips) 
Seat 7: matiko09 ($108.80 in chips) 
Seat 8: myatiy 96 ($101.50 in chips) 
Seat 9: sanpidk ($142.39 in chips) 
CI58: posts small blind $0.50
vanilica: posts big blind $1
*** HOLE CARDS ***
Dealt to matiko09 [Qc Kc]
r4mz3s: folds 
f1reworks: folds 
ANDY19911608: folds 
tipner: folds 
matiko09: raises $2 to $3
myatiy 96: folds 
sanpidk: folds 
CI58: folds 
vanilica: folds 
Uncalled bet ($2) returned to matiko09
matiko09 collected $2.50 from pot
matiko09: doesn't show hand 
*** SUMMARY ***
Total pot $2.50 | Rake $0 
Seat 1: CI58 (small blind) folded before Flop
Seat 2: vanilica (big blind) folded before Flop
Seat 3: r4mz3s folded before Flop (didn't bet)
Seat 4: f1reworks folded before Flop (didn't bet)
Seat 5: ANDY19911608 folded before Flop (didn't bet)
Seat 6: tipner folded before Flop (didn't bet)
Seat 7: matiko09 collected ($2.50)
Seat 8: myatiy 96 folded before Flop (didn't bet)
Seat 9: sanpidk (button) folded before Flop (didn't bet)





PokerStars Hand #155301503362:  Hold'em No Limit ($0.25/$0.50 USD) - 2016/06/28 16:25:31 CET [2016/06/28 10:25:31 ET]
Table 'Utra' 9-max Seat #3 is the button
Seat 2: matiko09 ($74.36 in chips) 
Seat 3: mycka86 ($72.16 in chips) 
Seat 4: myatiy 96 ($50 in chips) 
Seat 5: er13to ($50 in chips) 
Seat 6: Franky77200 ($95.24 in chips) 
Seat 7: el.suertero ($50 in chips) 
Seat 8: fudzi ($54.36 in chips) 
Seat 9: Kukuryzka ($73.72 in chips) 
myatiy 96: posts small blind $0.25
er13to: posts big blind $0.50
matiko09: posts the ante $0.10
mycka86: posts the ante $0.10
myatiy 96: posts the ante $0.10
er13to: posts the ante $0.10
Franky77200: posts the ante $0.10
el.suertero: posts the ante $0.10
fudzi: posts the ante $0.10
Kukuryzka: posts the ante $0.10
*** HOLE CARDS ***
Dealt to matiko09 [6c Ah]
Franky77200: folds 
el.suertero: folds 
fudzi: folds 
Kukuryzka: folds 
matiko09: folds 
mycka86: folds 
myatiy 96: raises $1.25 to $1.75
er13to: folds 
Uncalled bet ($1.25) returned to myatiy 96
myatiy 96 collected $1.80 from pot
*** SUMMARY ***
Total pot $1.80 | Rake $0 
Seat 2: matiko09 folded before Flop (didn't bet)
Seat 3: mycka86 (button) folded before Flop (didn't bet)
Seat 4: myatiy 96 (small blind) collected ($1.80)
Seat 5: er13to (big blind) folded before Flop
Seat 6: Franky77200 folded before Flop (didn't bet)
Seat 7: el.suertero folded before Flop (didn't bet)
Seat 8: fudzi folded before Flop (didn't bet)
Seat 9: Kukuryzka folded before Flop (didn't bet)





PokerStars Hand #155301508514:  Hold'em No Limit ($0.50/$1.00 USD) - 2016/06/28 16:25:41 CET [2016/06/28 10:25:41 ET]
Table 'Anitra' 9-max Seat #7 is the button
Seat 1: Klappspaten0 ($106.58 in chips) 
Seat 3: facelessPPP ($100.20 in chips) 
Seat 4: Shakeelg ($114.62 in chips) 
Seat 5: er13to ($101.50 in chips) 
Seat 6: matiko09 ($103 in chips) 
Seat 7: myatiy 96 ($100 in chips) 
Seat 8: yoshinoino ($34.72 in chips) 
Seat 9: chenconhaste ($104.95 in chips) 
yoshinoino: posts small blind $0.50
chenconhaste: posts big blind $1
*** HOLE CARDS ***
Dealt to matiko09 [7h Ah]
Klappspaten0: folds 
facelessPPP: folds 
Shakeelg: folds 
er13to: folds 
matiko09: raises $1.50 to $2.50
myatiy 96: folds 
yoshinoino: folds 
chenconhaste: folds 
Uncalled bet ($1.50) returned to matiko09
matiko09 collected $2.50 from pot
matiko09: doesn't show hand 
*** SUMMARY ***
Total pot $2.50 | Rake $0 
Seat 1: Klappspaten0 folded before Flop (didn't bet)
Seat 3: facelessPPP folded before Flop (didn't bet)
Seat 4: Shakeelg folded before Flop (didn't bet)
Seat 5: er13to folded before Flop (didn't bet)
Seat 6: matiko09 collected ($2.50)
Seat 7: myatiy 96 (button) folded before Flop (didn't bet)
Seat 8: yoshinoino (small blind) folded before Flop
Seat 9: chenconhaste (big blind) folded before Flop





PokerStars Hand #155301514544:  Hold'em No Limit ($0.50/$1.00 USD) - 2016/06/28 16:25:52 CET [2016/06/28 10:25:52 ET]
Table 'Vicia II' 9-max Seat #1 is the button
Seat 1: sanpidk ($105.86 in chips) 
Seat 2: Kukuryzka ($231.80 in chips) 
Seat 3: vanilica ($100 in chips) 
Seat 4: vanapeer ($100 in chips) 
Seat 5: wallium ($190.17 in chips) 
Seat 7: matiko09 ($100 in chips) 
Seat 8: f1reworks ($205.54 in chips) 
Seat 9: r4mz3s ($110.47 in chips) 
Kukuryzka: posts small blind $0.50
vanilica: posts big blind $1
tipner: sits out 
*** HOLE CARDS ***
Dealt to matiko09 [6d Kc]
vanapeer: folds 
wallium: folds 
wallium leaves the table
matiko09: folds 
f1reworks: folds 
r4mz3s: folds 
sanpidk: raises $1.50 to $2.50
Kukuryzka: folds 
vanilica: folds 
Uncalled bet ($1.50) returned to sanpidk
sanpidk collected $2.50 from pot
sanpidk: doesn't show hand 
*** SUMMARY ***
Total pot $2.50 | Rake $0 
Seat 1: sanpidk (button) collected ($2.50)
Seat 2: Kukuryzka (small blind) folded before Flop
Seat 3: vanilica (big blind) folded before Flop
Seat 4: vanapeer folded before Flop (didn't bet)
Seat 5: wallium folded before Flop (didn't bet)
Seat 7: matiko09 folded before Flop (didn't bet)
Seat 8: f1reworks folded before Flop (didn't bet)
Seat 9: r4mz3s folded before Flop (didn't bet)





PokerStars Hand #155301516509:  Hold'em No Limit ($0.50/$1.00 USD) - 2016/06/28 16:25:55 CET [2016/06/28 10:25:55 ET]
Table 'Dorado II' 9-max Seat #4 is the button
Seat 1: f1reworks ($199.96 in chips) 
Seat 2: vanilica ($100 in chips) 
Seat 3: ghostriderxu ($36.91 in chips) 
Seat 4: pyromid ($114 in chips) 
Seat 5: KovIFish89 ($100 in chips) 
Seat 6: mycka86 ($109.74 in chips) 
Seat 7: matiko09 ($116.21 in chips) 
Seat 8: flk.Dasas ($191 in chips) 
Seat 9: r4mz3s ($105.67 in chips) 
KovIFish89: posts small blind $0.50
mycka86: posts big blind $1
*** HOLE CARDS ***
Dealt to matiko09 [3d 9h]
matiko09: folds 
flk.Dasas: folds 
r4mz3s: folds 
f1reworks: folds 
vanilica: raises $1.50 to $2.50
ghostriderxu: folds 
pyromid: folds 
KovIFish89: folds 
mycka86: folds 
Uncalled bet ($1.50) returned to vanilica
vanilica collected $2.50 from pot
vanilica: doesn't show hand 
*** SUMMARY ***
Total pot $2.50 | Rake $0 
Seat 1: f1reworks folded before Flop (didn't bet)
Seat 2: vanilica collected ($2.50)
Seat 3: ghostriderxu folded before Flop (didn't bet)
Seat 4: pyromid (button) folded before Flop (didn't bet)
Seat 5: KovIFish89 (small blind) folded before Flop
Seat 6: mycka86 (big blind) folded before Flop
Seat 7: matiko09 folded before Flop (didn't bet)
Seat 8: flk.Dasas folded before Flop (didn't bet)
Seat 9: r4mz3s folded before Flop (didn't bet)





PokerStars Hand #155301522727:  Hold'em No Limit ($0.50/$1.00 USD) - 2016/06/28 16:26:07 CET [2016/06/28 10:26:07 ET]
Table 'Lyyli II' 9-max Seat #5 is the button
Seat 1: tipner ($148.03 in chips) 
Seat 2: CI58 ($117.52 in chips) 
Seat 3: Racushniak ($100.72 in chips) 
Seat 4: Greha999 ($122.48 in chips) 
Seat 5: flk.Dasas ($102.70 in chips) 
Seat 6: matiko09 ($110.44 in chips) 
Seat 7: Kukuryzka ($185.47 in chips) 
Seat 8: r4mz3s ($127.42 in chips) 
Seat 9: f1reworks ($101 in chips) 
matiko09: posts small blind $0.50
Kukuryzka: posts big blind $1
*** HOLE CARDS ***
Dealt to matiko09 [4h 7d]
r4mz3s: folds 
f1reworks: folds 
tipner: folds 
CI58: folds 
Racushniak: folds 
Greha999: raises $2 to $3
flk.Dasas: folds 
matiko09: folds 
Kukuryzka: folds 
Uncalled bet ($2) returned to Greha999
Greha999 collected $2.50 from pot
*** SUMMARY ***
Total pot $2.50 | Rake $0 
Seat 1: tipner folded before Flop (didn't bet)
Seat 2: CI58 folded before Flop (didn't bet)
Seat 3: Racushniak folded before Flop (didn't bet)
Seat 4: Greha999 collected ($2.50)
Seat 5: flk.Dasas (button) folded before Flop (didn't bet)
Seat 6: matiko09 (small blind) folded before Flop
Seat 7: Kukuryzka (big blind) folded before Flop
Seat 8: r4mz3s folded before Flop (didn't bet)
Seat 9: f1reworks folded before Flop (didn't bet)





PokerStars Hand #155301523103:  Hold'em No Limit ($0.25/$0.50 USD) - 2016/06/28 16:26:08 CET [2016/06/28 10:26:08 ET]
Table 'Utra' 9-max Seat #4 is the button
Seat 2: matiko09 ($74.26 in chips) 
Seat 3: mycka86 ($72.06 in chips) 
Seat 4: myatiy 96 ($51.20 in chips) 
Seat 5: er13to ($50 in chips) 
Seat 6: Franky77200 ($95.14 in chips) 
Seat 7: el.suertero ($50 in chips) 
Seat 8: fudzi ($54.26 in chips) 
Seat 9: Kukuryzka ($73.62 in chips) 
er13to: posts small blind $0.25
Franky77200: posts big blind $0.50
matiko09: posts the ante $0.10
mycka86: posts the ante $0.10
myatiy 96: posts the ante $0.10
er13to: posts the ante $0.10
Franky77200: posts the ante $0.10
el.suertero: posts the ante $0.10
fudzi: posts the ante $0.10
Kukuryzka: posts the ante $0.10
*** HOLE CARDS ***
Dealt to matiko09 [Kh 8s]
el.suertero: folds 
fudzi: folds 
Kukuryzka: folds 
matiko09: folds 
mycka86: folds 
myatiy 96: raises $0.75 to $1.25
er13to: folds 
Franky77200: calls $0.75
*** FLOP *** [Js Jc Th]
Franky77200: checks 
myatiy 96: bets $1.68
Franky77200: raises $3.82 to $5.50
myatiy 96: folds 
Uncalled bet ($3.82) returned to Franky77200
Franky77200 collected $6.56 from pot
Franky77200: doesn't show hand 
*** SUMMARY ***
Total pot $6.91 | Rake $0.35 
Board [Js Jc Th]
Seat 2: matiko09 folded before Flop (didn't bet)
Seat 3: mycka86 folded before Flop (didn't bet)
Seat 4: myatiy 96 (button) folded on the Flop
Seat 5: er13to (small blind) folded before Flop
Seat 6: Franky77200 (big blind) collected ($6.56)
Seat 7: el.suertero folded before Flop (didn't bet)
Seat 8: fudzi folded before Flop (didn't bet)
Seat 9: Kukuryzka folded before Flop (didn't bet)





PokerStars Hand #155301525463:  Hold'em No Limit ($0.50/$1.00 USD) - 2016/06/28 16:26:12 CET [2016/06/28 10:26:12 ET]
Table 'Anitra' 9-max Seat #8 is the button
Seat 1: Klappspaten0 ($106.58 in chips) 
Seat 3: facelessPPP ($100.20 in chips) 
Seat 4: Shakeelg ($114.62 in chips) 
Seat 5: er13to ($101.50 in chips) 
Seat 6: matiko09 ($104.50 in chips) 
Seat 7: myatiy 96 ($100 in chips) 
Seat 8: yoshinoino ($34.22 in chips) 
Seat 9: chenconhaste ($103.95 in chips) 
chenconhaste: posts small blind $0.50
Klappspaten0: posts big blind $1
*** HOLE CARDS ***
Dealt to matiko09 [9h 6d]
facelessPPP: folds 
Shakeelg: calls $1
er13to: folds 
matiko09: folds 
myatiy 96: folds 
yoshinoino: folds 
chenconhaste: folds 
Klappspaten0: checks 
*** FLOP *** [Qh As Th]
Klappspaten0: checks 
Shakeelg: checks 
*** TURN *** [Qh As Th] [7s]
Klappspaten0: checks 
Shakeelg: checks 
*** RIVER *** [Qh As Th 7s] [2c]
Klappspaten0: checks 
Shakeelg: bets $2
Klappspaten0: folds 
Uncalled bet ($2) returned to Shakeelg
Shakeelg collected $2.38 from pot
*** SUMMARY ***
Total pot $2.50 | Rake $0.12 
Board [Qh As Th 7s 2c]
Seat 1: Klappspaten0 (big blind) folded on the River
Seat 3: facelessPPP folded before Flop (didn't bet)
Seat 4: Shakeelg collected ($2.38)
Seat 5: er13to folded before Flop (didn't bet)
Seat 6: matiko09 folded before Flop (didn't bet)
Seat 7: myatiy 96 folded before Flop (didn't bet)
Seat 8: yoshinoino (button) folded before Flop (didn't bet)
Seat 9: chenconhaste (small blind) folded before Flop





PokerStars Hand #155301534212:  Hold'em No Limit ($0.50/$1.00 USD) - 2016/06/28 16:26:28 CET [2016/06/28 10:26:28 ET]
Table 'Dorado II' 9-max Seat #5 is the button
Seat 1: f1reworks ($199.96 in chips) 
Seat 2: vanilica ($101.50 in chips) 
Seat 3: ghostriderxu ($36.91 in chips) 
Seat 4: pyromid ($114 in chips) 
Seat 5: KovIFish89 ($100 in chips) 
Seat 6: mycka86 ($108.74 in chips) 
Seat 7: matiko09 ($116.21 in chips) 
Seat 8: flk.Dasas ($191 in chips) 
Seat 9: r4mz3s ($105.67 in chips) 
mycka86: posts small blind $0.50
matiko09: posts big blind $1
*** HOLE CARDS ***
Dealt to matiko09 [7h 8s]
flk.Dasas: folds 
r4mz3s: folds 
f1reworks: folds 
vanilica: raises $2 to $3
ghostriderxu: folds 
pyromid: folds 
KovIFish89: folds 
mycka86: folds 
matiko09: folds 
Uncalled bet ($2) returned to vanilica
vanilica collected $2.50 from pot
vanilica: doesn't show hand 
*** SUMMARY ***
Total pot $2.50 | Rake $0 
Seat 1: f1reworks folded before Flop (didn't bet)
Seat 2: vanilica collected ($2.50)
Seat 3: ghostriderxu folded before Flop (didn't bet)
Seat 4: pyromid folded before Flop (didn't bet)
Seat 5: KovIFish89 (button) folded before Flop (didn't bet)
Seat 6: mycka86 (small blind) folded before Flop
Seat 7: matiko09 (big blind) folded before Flop
Seat 8: flk.Dasas folded before Flop (didn't bet)
Seat 9: r4mz3s folded before Flop (didn't bet)





PokerStars Hand #155301534552:  Hold'em No Limit ($0.50/$1.00 USD) - 2016/06/28 16:26:29 CET [2016/06/28 10:26:29 ET]
Table 'Tomita' 9-max Seat #1 is the button
Seat 1: CI58 ($100 in chips) 
Seat 2: vanilica ($104.22 in chips) 
Seat 3: r4mz3s ($100 in chips) 
Seat 4: f1reworks ($118.45 in chips) 
Seat 5: ANDY19911608 ($178.68 in chips) 
Seat 6: tipner ($100 in chips) 
Seat 7: matiko09 ($110.30 in chips) 
Seat 8: myatiy 96 ($101.50 in chips) 
Seat 9: sanpidk ($142.39 in chips) 
vanilica: posts small blind $0.50
r4mz3s: posts big blind $1
*** HOLE CARDS ***
Dealt to matiko09 [Ad Jd]
f1reworks: folds 
ANDY19911608: folds 
tipner: raises $2 to $3
matiko09: raises $7 to $10
myatiy 96: folds 
sanpidk: folds 
CI58: folds 
vanilica: folds 
r4mz3s: folds 
tipner: folds 
Uncalled bet ($7) returned to matiko09
matiko09 collected $7.50 from pot
matiko09: doesn't show hand 
*** SUMMARY ***
Total pot $7.50 | Rake $0 
Seat 1: CI58 (button) folded before Flop (didn't bet)
Seat 2: vanilica (small blind) folded before Flop
Seat 3: r4mz3s (big blind) folded before Flop
Seat 4: f1reworks folded before Flop (didn't bet)
Seat 5: ANDY19911608 folded before Flop (didn't bet)
Seat 6: tipner folded before Flop
Seat 7: matiko09 collected ($7.50)
Seat 8: myatiy 96 folded before Flop (didn't bet)
Seat 9: sanpidk folded before Flop (didn't bet)





PokerStars Hand #155301535122:  Hold'em No Limit ($0.50/$1.00 USD) - 2016/06/28 16:26:30 CET [2016/06/28 10:26:30 ET]
Table 'Vicia II' 9-max Seat #2 is the button
Seat 1: sanpidk ($107.36 in chips) 
Seat 2: Kukuryzka ($231.30 in chips) 
Seat 3: vanilica ($100 in chips) 
Seat 4: vanapeer ($100 in chips) 
Seat 7: matiko09 ($100 in chips) 
Seat 8: f1reworks ($205.54 in chips) 
Seat 9: r4mz3s ($110.47 in chips) 
vanilica: posts small blind $0.50
vanapeer: posts big blind $1
tipner: sits out 
*** HOLE CARDS ***
Dealt to matiko09 [5h 6d]
matiko09: folds 
f1reworks: raises $2 to $3
r4mz3s: folds 
sanpidk: folds 
Kukuryzka: folds 
vanilica: folds 
vanapeer: folds 
Uncalled bet ($2) returned to f1reworks
f1reworks collected $2.50 from pot
f1reworks: doesn't show hand 
*** SUMMARY ***
Total pot $2.50 | Rake $0 
Seat 1: sanpidk folded before Flop (didn't bet)
Seat 2: Kukuryzka (button) folded before Flop (didn't bet)
Seat 3: vanilica (small blind) folded before Flop
Seat 4: vanapeer (big blind) folded before Flop
Seat 7: matiko09 folded before Flop (didn't bet)
Seat 8: f1reworks collected ($2.50)
Seat 9: r4mz3s folded before Flop (didn't bet)





PokerStars Hand #155301545088:  Hold'em No Limit ($0.50/$1.00 USD) - 2016/06/28 16:26:48 CET [2016/06/28 10:26:48 ET]
Table 'Lyyli II' 9-max Seat #6 is the button
Seat 1: tipner ($148.03 in chips) 
Seat 2: CI58 ($117.52 in chips) 
Seat 3: Racushniak ($100.72 in chips) 
Seat 4: Greha999 ($123.98 in chips) 
Seat 5: flk.Dasas ($102.70 in chips) 
Seat 6: matiko09 ($109.94 in chips) 
Seat 7: Kukuryzka ($184.47 in chips) 
Seat 8: r4mz3s ($127.42 in chips) 
Seat 9: f1reworks ($101 in chips) 
Kukuryzka: posts small blind $0.50
r4mz3s: posts big blind $1
*** HOLE CARDS ***
Dealt to matiko09 [7d 7c]
f1reworks: folds 
tipner: raises $2 to $3
CI58: folds 
Racushniak: folds 
Greha999: raises $5 to $8
flk.Dasas: folds 
matiko09: folds 
Kukuryzka: folds 
r4mz3s: folds 
tipner: calls $5
*** FLOP *** [3d Ks Kc]
tipner: checks 
Greha999: bets $8
tipner: calls $8
*** TURN *** [3d Ks Kc] [9s]
tipner: checks 
Greha999: checks 
*** RIVER *** [3d Ks Kc 9s] [2d]
tipner: checks 
Greha999: bets $23
tipner: folds 
Uncalled bet ($23) returned to Greha999
Greha999 collected $31.82 from pot
*** SUMMARY ***
Total pot $33.50 | Rake $1.68 
Board [3d Ks Kc 9s 2d]
Seat 1: tipner folded on the River
Seat 2: CI58 folded before Flop (didn't bet)
Seat 3: Racushniak folded before Flop (didn't bet)
Seat 4: Greha999 collected ($31.82)
Seat 5: flk.Dasas folded before Flop (didn't bet)
Seat 6: matiko09 (button) folded before Flop (didn't bet)
Seat 7: Kukuryzka (small blind) folded before Flop
Seat 8: r4mz3s (big blind) folded before Flop
Seat 9: f1reworks folded before Flop (didn't bet)





PokerStars Hand #155301548488:  Hold'em No Limit ($0.50/$1.00 USD) - 2016/06/28 16:26:54 CET [2016/06/28 10:26:54 ET]
Table 'Anitra' 9-max Seat #9 is the button
Seat 1: Klappspaten0 ($105.58 in chips) 
Seat 3: facelessPPP ($100.20 in chips) 
Seat 4: Shakeelg ($116 in chips) 
Seat 5: er13to ($101.50 in chips) 
Seat 6: matiko09 ($104.50 in chips) 
Seat 7: myatiy 96 ($100 in chips) 
Seat 8: yoshinoino ($34.22 in chips) 
Seat 9: chenconhaste ($103.45 in chips) 
Klappspaten0: posts small blind $0.50
facelessPPP: posts big blind $1
*** HOLE CARDS ***
Dealt to matiko09 [Jc Js]
Shakeelg: folds 
er13to: folds 
matiko09: raises $2 to $3
myatiy 96: folds 
yoshinoino: folds 
chenconhaste: folds 
Klappspaten0: folds 
facelessPPP: folds 
Uncalled bet ($2) returned to matiko09
matiko09 collected $2.50 from pot
matiko09: doesn't show hand 
*** SUMMARY ***
Total pot $2.50 | Rake $0 
Seat 1: Klappspaten0 (small blind) folded before Flop
Seat 3: facelessPPP (big blind) folded before Flop
Seat 4: Shakeelg folded before Flop (didn't bet)
Seat 5: er13to folded before Flop (didn't bet)
Seat 6: matiko09 collected ($2.50)
Seat 7: myatiy 96 folded before Flop (didn't bet)
Seat 8: yoshinoino folded before Flop (didn't bet)
Seat 9: chenconhaste (button) folded before Flop (didn't bet)





PokerStars Hand #155301551509:  Hold'em No Limit ($0.25/$0.50 USD) - 2016/06/28 16:27:00 CET [2016/06/28 10:27:00 ET]
Table 'Utra' 9-max Seat #5 is the button
Seat 2: matiko09 ($74.16 in chips) 
Seat 3: mycka86 ($71.96 in chips) 
Seat 4: myatiy 96 ($50 in chips) 
Seat 5: er13to ($50 in chips) 
Seat 6: Franky77200 ($98.67 in chips) 
Seat 7: el.suertero ($50 in chips) 
Seat 8: fudzi ($54.16 in chips) 
Seat 9: Kukuryzka ($73.52 in chips) 
Franky77200: posts small blind $0.25
el.suertero: posts big blind $0.50
matiko09: posts the ante $0.10
mycka86: posts the ante $0.10
myatiy 96: posts the ante $0.10
er13to: posts the ante $0.10
Franky77200: posts the ante $0.10
el.suertero: posts the ante $0.10
fudzi: posts the ante $0.10
Kukuryzka: posts the ante $0.10
*** HOLE CARDS ***
Dealt to matiko09 [7c 9d]
fudzi: folds 
Kukuryzka: folds 
matiko09: folds 
mycka86: folds 
myatiy 96: folds 
er13to: folds 
Franky77200: raises $1 to $1.50
el.suertero: raises $3 to $4.50
Franky77200: calls $3
*** FLOP *** [Kd Ad Qc]
Franky77200: checks 
el.suertero: bets $7.50
Franky77200: folds 
Uncalled bet ($7.50) returned to el.suertero
el.suertero collected $9.31 from pot
el.suertero: doesn't show hand 
*** SUMMARY ***
Total pot $9.80 | Rake $0.49 
Board [Kd Ad Qc]
Seat 2: matiko09 folded before Flop (didn't bet)
Seat 3: mycka86 folded before Flop (didn't bet)
Seat 4: myatiy 96 folded before Flop (didn't bet)
Seat 5: er13to (button) folded before Flop (didn't bet)
Seat 6: Franky77200 (small blind) folded on the Flop
Seat 7: el.suertero (big blind) collected ($9.31)
Seat 8: fudzi folded before Flop (didn't bet)
Seat 9: Kukuryzka folded before Flop (didn't bet)





PokerStars Hand #155301553373:  Hold'em No Limit ($0.50/$1.00 USD) - 2016/06/28 16:27:03 CET [2016/06/28 10:27:03 ET]
Table 'Dorado II' 9-max Seat #6 is the button
Seat 1: f1reworks ($199.96 in chips) 
Seat 2: vanilica ($103 in chips) 
Seat 3: ghostriderxu ($36.91 in chips) 
Seat 4: pyromid ($114 in chips) 
Seat 5: KovIFish89 ($100 in chips) 
Seat 6: mycka86 ($108.24 in chips) 
Seat 7: matiko09 ($115.21 in chips) 
Seat 8: flk.Dasas ($191 in chips) 
Seat 9: r4mz3s ($105.67 in chips) 
matiko09: posts small blind $0.50
flk.Dasas: posts big blind $1
*** HOLE CARDS ***
Dealt to matiko09 [Jd Qs]
r4mz3s: folds 
f1reworks: folds 
vanilica: folds 
ghostriderxu: folds 
pyromid: folds 
KovIFish89: raises $1.50 to $2.50
mycka86: folds 
matiko09: folds 
flk.Dasas: folds 
Uncalled bet ($1.50) returned to KovIFish89
KovIFish89 collected $2.50 from pot
KovIFish89: doesn't show hand 
*** SUMMARY ***
Total pot $2.50 | Rake $0 
Seat 1: f1reworks folded before Flop (didn't bet)
Seat 2: vanilica folded before Flop (didn't bet)
Seat 3: ghostriderxu folded before Flop (didn't bet)
Seat 4: pyromid folded before Flop (didn't bet)
Seat 5: KovIFish89 collected ($2.50)
Seat 6: mycka86 (button) folded before Flop (didn't bet)
Seat 7: matiko09 (small blind) folded before Flop
Seat 8: flk.Dasas (big blind) folded before Flop
Seat 9: r4mz3s folded before Flop (didn't bet)





PokerStars Hand #155301553614:  Hold'em No Limit ($0.50/$1.00 USD) - 2016/06/28 16:27:04 CET [2016/06/28 10:27:04 ET]
Table 'Tomita' 9-max Seat #2 is the button
Seat 1: CI58 ($100 in chips) 
Seat 2: vanilica ($103.72 in chips) 
Seat 3: r4mz3s ($100 in chips) 
Seat 4: f1reworks ($118.45 in chips) 
Seat 5: ANDY19911608 ($178.68 in chips) 
Seat 6: tipner ($100 in chips) 
Seat 7: matiko09 ($114.80 in chips) 
Seat 8: myatiy 96 ($101.50 in chips) 
Seat 9: sanpidk ($142.39 in chips) 
r4mz3s: posts small blind $0.50
f1reworks: posts big blind $1
*** HOLE CARDS ***
Dealt to matiko09 [Kd Qd]
ANDY19911608: calls $1
tipner: folds 
matiko09: raises $3 to $4
myatiy 96: calls $4
sanpidk: folds 
CI58: folds 
vanilica: folds 
r4mz3s: calls $3.50
f1reworks: folds 
ANDY19911608: calls $3
*** FLOP *** [6d 4d 9s]
r4mz3s: checks 
ANDY19911608: checks 
matiko09: bets $9
myatiy 96: calls $9
r4mz3s: calls $9
ANDY19911608: folds 
*** TURN *** [6d 4d 9s] [Td]
r4mz3s: checks 
matiko09: checks 
myatiy 96: bets $27.86
r4mz3s: folds 
matiko09: calls $27.86
*** RIVER *** [6d 4d 9s Td] [Qh]
matiko09: checks 
myatiy 96: bets $60.64 and is all-in
matiko09: calls $60.64
*** SHOW DOWN ***
myatiy 96: shows [2d Ad] (a flush, Ace high)
matiko09: shows [Kd Qd] (a flush, King high)
myatiy 96 collected $218.50 from pot
*** SUMMARY ***
Total pot $221 | Rake $2.50 
Board [6d 4d 9s Td Qh]
Seat 1: CI58 folded before Flop (didn't bet)
Seat 2: vanilica (button) folded before Flop (didn't bet)
Seat 3: r4mz3s (small blind) folded on the Turn
Seat 4: f1reworks (big blind) folded before Flop
Seat 5: ANDY19911608 folded on the Flop
Seat 6: tipner folded before Flop (didn't bet)
Seat 7: matiko09 showed [Kd Qd] and lost with a flush, King high
Seat 8: myatiy 96 showed [2d Ad] and won ($218.50) with a flush, Ace high
Seat 9: sanpidk folded before Flop (didn't bet)





PokerStars Hand #155301559713:  Hold'em No Limit ($0.50/$1.00 USD) - 2016/06/28 16:27:15 CET [2016/06/28 10:27:15 ET]
Table 'Anitra' 9-max Seat #1 is the button
Seat 1: Klappspaten0 ($105.08 in chips) 
Seat 3: facelessPPP ($99.20 in chips) 
Seat 4: Shakeelg ($116 in chips) 
Seat 5: er13to ($101.50 in chips) 
Seat 6: matiko09 ($106 in chips) 
Seat 7: myatiy 96 ($100 in chips) 
Seat 8: yoshinoino ($34.22 in chips) 
Seat 9: chenconhaste ($103.45 in chips) 
facelessPPP: posts small blind $0.50
Shakeelg: posts big blind $1
*** HOLE CARDS ***
Dealt to matiko09 [6s Ts]
er13to: raises $1.72 to $2.72
matiko09: folds 
myatiy 96: folds 
yoshinoino: folds 
chenconhaste: folds 
Klappspaten0: folds 
facelessPPP: folds 
Shakeelg: folds 
Uncalled bet ($1.72) returned to er13to
er13to collected $2.50 from pot
er13to: doesn't show hand 
*** SUMMARY ***
Total pot $2.50 | Rake $0 
Seat 1: Klappspaten0 (button) folded before Flop (didn't bet)
Seat 3: facelessPPP (small blind) folded before Flop
Seat 4: Shakeelg (big blind) folded before Flop
Seat 5: er13to collected ($2.50)
Seat 6: matiko09 folded before Flop (didn't bet)
Seat 7: myatiy 96 folded before Flop (didn't bet)
Seat 8: yoshinoino folded before Flop (didn't bet)
Seat 9: chenconhaste folded before Flop (didn't bet)





PokerStars Hand #155301566138:  Hold'em No Limit ($0.50/$1.00 USD) - 2016/06/28 16:27:27 CET [2016/06/28 10:27:27 ET]
Table 'Dorado II' 9-max Seat #7 is the button
Seat 1: f1reworks ($199.96 in chips) 
Seat 2: vanilica ($103 in chips) 
Seat 3: ghostriderxu ($36.91 in chips) 
Seat 4: pyromid ($114 in chips) 
Seat 5: KovIFish89 ($101.50 in chips) 
Seat 6: mycka86 ($108.24 in chips) 
Seat 7: matiko09 ($114.71 in chips) 
Seat 8: flk.Dasas ($190 in chips) 
Seat 9: r4mz3s ($105.67 in chips) 
flk.Dasas: posts small blind $0.50
r4mz3s: posts big blind $1
*** HOLE CARDS ***
Dealt to matiko09 [9h 4d]
f1reworks: folds 
vanilica: folds 
ghostriderxu: raises $2 to $3
pyromid: folds 
KovIFish89: folds 
mycka86: folds 
matiko09: folds 
flk.Dasas: folds 
r4mz3s: folds 
Uncalled bet ($2) returned to ghostriderxu
ghostriderxu collected $2.50 from pot
ghostriderxu: doesn't show hand 
*** SUMMARY ***
Total pot $2.50 | Rake $0 
Seat 1: f1reworks folded before Flop (didn't bet)
Seat 2: vanilica folded before Flop (didn't bet)
Seat 3: ghostriderxu collected ($2.50)
Seat 4: pyromid folded before Flop (didn't bet)
Seat 5: KovIFish89 folded before Flop (didn't bet)
Seat 6: mycka86 folded before Flop (didn't bet)
Seat 7: matiko09 (button) folded before Flop (didn't bet)
Seat 8: flk.Dasas (small blind) folded before Flop
Seat 9: r4mz3s (big blind) folded before Flop





PokerStars Hand #155301570864:  Hold'em No Limit ($0.50/$1.00 USD) - 2016/06/28 16:27:36 CET [2016/06/28 10:27:36 ET]
Table 'Anitra' 9-max Seat #3 is the button
Seat 1: Klappspaten0 ($105.08 in chips) 
Seat 3: facelessPPP ($98.70 in chips) 
Seat 4: Shakeelg ($115 in chips) 
Seat 5: er13to ($103 in chips) 
Seat 6: matiko09 ($106 in chips) 
Seat 7: myatiy 96 ($100 in chips) 
Seat 8: yoshinoino ($34.22 in chips) 
Seat 9: chenconhaste ($103.45 in chips) 
Shakeelg: posts small blind $0.50
er13to: posts big blind $1
*** HOLE CARDS ***
Dealt to matiko09 [Tc 5d]
matiko09: folds 
myatiy 96: folds 
yoshinoino: folds 
chenconhaste: folds 
Klappspaten0: folds 
facelessPPP: folds 
Shakeelg: raises $2 to $3
er13to: calls $2
*** FLOP *** [Qc Qd 6s]
Shakeelg: bets $5
er13to: folds 
Uncalled bet ($5) returned to Shakeelg
Shakeelg collected $5.70 from pot
Shakeelg: doesn't show hand 
*** SUMMARY ***
Total pot $6 | Rake $0.30 
Board [Qc Qd 6s]
Seat 1: Klappspaten0 folded before Flop (didn't bet)
Seat 3: facelessPPP (button) folded before Flop (didn't bet)
Seat 4: Shakeelg (small blind) collected ($5.70)
Seat 5: er13to (big blind) folded on the Flop
Seat 6: matiko09 folded before Flop (didn't bet)
Seat 7: myatiy 96 folded before Flop (didn't bet)
Seat 8: yoshinoino folded before Flop (didn't bet)
Seat 9: chenconhaste folded before Flop (didn't bet)





PokerStars Hand #155301578731:  Hold'em No Limit ($0.25/$0.50 USD) - 2016/06/28 16:27:50 CET [2016/06/28 10:27:50 ET]
Table 'Utra' 9-max Seat #6 is the button
Seat 2: matiko09 ($74.06 in chips) 
Seat 3: mycka86 ($71.86 in chips) 
Seat 4: myatiy 96 ($50 in chips) 
Seat 5: er13to ($50 in chips) 
Seat 6: Franky77200 ($94.07 in chips) 
Seat 7: el.suertero ($54.71 in chips) 
Seat 8: fudzi ($54.06 in chips) 
Seat 9: Kukuryzka ($73.42 in chips) 
el.suertero: posts small blind $0.25
fudzi: posts big blind $0.50
matiko09: posts the ante $0.10
mycka86: posts the ante $0.10
myatiy 96: posts the ante $0.10
er13to: posts the ante $0.10
Franky77200: posts the ante $0.10
el.suertero: posts the ante $0.10
fudzi: posts the ante $0.10
Kukuryzka: posts the ante $0.10
*** HOLE CARDS ***
Dealt to matiko09 [3h 8s]
Kukuryzka: folds 
matiko09: folds 
mycka86: raises $1 to $1.50
myatiy 96: folds 
er13to: folds 
Franky77200: folds 
el.suertero: folds 
fudzi: folds 
Uncalled bet ($1) returned to mycka86
mycka86 collected $2.05 from pot
*** SUMMARY ***
Total pot $2.05 | Rake $0 
Seat 2: matiko09 folded before Flop (didn't bet)
Seat 3: mycka86 collected ($2.05)
Seat 4: myatiy 96 folded before Flop (didn't bet)
Seat 5: er13to folded before Flop (didn't bet)
Seat 6: Franky77200 (button) folded before Flop (didn't bet)
Seat 7: el.suertero (small blind) folded before Flop
Seat 8: fudzi (big blind) folded before Flop
Seat 9: Kukuryzka folded before Flop (didn't bet)





PokerStars Hand #155301580726:  Hold'em No Limit ($0.50/$1.00 USD) - 2016/06/28 16:27:54 CET [2016/06/28 10:27:54 ET]
Table 'Dorado II' 9-max Seat #8 is the button
Seat 1: f1reworks ($199.96 in chips) 
Seat 2: vanilica ($103 in chips) 
Seat 3: ghostriderxu ($38.41 in chips) 
Seat 4: pyromid ($114 in chips) 
Seat 5: KovIFish89 ($101.50 in chips) 
Seat 6: mycka86 ($108.24 in chips) 
Seat 7: matiko09 ($114.71 in chips) 
Seat 8: flk.Dasas ($189.50 in chips) 
Seat 9: r4mz3s ($104.67 in chips) 
r4mz3s: posts small blind $0.50
f1reworks: posts big blind $1
*** HOLE CARDS ***
Dealt to matiko09 [6c Ac]
vanilica: folds 
ghostriderxu: raises $2 to $3
pyromid: folds 
KovIFish89: folds 
mycka86: folds 
matiko09: folds 
flk.Dasas: folds 
r4mz3s: folds 
f1reworks: raises $7 to $10
ghostriderxu: calls $7
*** FLOP *** [Kd Tc 7s]
f1reworks: bets $10.71
ghostriderxu: raises $17.70 to $28.41 and is all-in
f1reworks: calls $17.70
*** FIRST TURN *** [Kd Tc 7s] [2d]
*** FIRST RIVER *** [Kd Tc 7s 2d] [Ad]
*** SECOND TURN *** [Kd Tc 7s] [As]
*** SECOND RIVER *** [Kd Tc 7s As] [5s]
*** FIRST SHOW DOWN ***
f1reworks: shows [Jc Jd] (a pair of Jacks)
ghostriderxu: shows [Qh Qd] (a pair of Queens)
ghostriderxu collected $37.41 from pot
*** SECOND SHOW DOWN ***
f1reworks: shows [Jc Jd] (a pair of Jacks)
ghostriderxu: shows [Qh Qd] (a pair of Queens)
ghostriderxu collected $37.41 from pot
*** SUMMARY ***
Total pot $77.32 | Rake $2.50 
Hand was run twice
FIRST Board [Kd Tc 7s 2d Ad]
SECOND Board [Kd Tc 7s As 5s]
Seat 1: f1reworks (big blind) showed [Jc Jd] and lost with a pair of Jacks, and lost with a pair of Jacks
Seat 2: vanilica folded before Flop (didn't bet)
Seat 3: ghostriderxu showed [Qh Qd] and won ($37.41) with a pair of Queens, and won ($37.41) with a pair of Queens
Seat 4: pyromid folded before Flop (didn't bet)
Seat 5: KovIFish89 folded before Flop (didn't bet)
Seat 6: mycka86 folded before Flop (didn't bet)
Seat 7: matiko09 folded before Flop (didn't bet)
Seat 8: flk.Dasas (button) folded before Flop (didn't bet)
Seat 9: r4mz3s (small blind) folded before Flop





PokerStars Hand #155301595283:  Hold'em No Limit ($0.25/$0.50 USD) - 2016/06/28 16:28:21 CET [2016/06/28 10:28:21 ET]
Table 'Utra' 9-max Seat #7 is the button
Seat 2: matiko09 ($73.96 in chips) 
Seat 3: mycka86 ($73.31 in chips) 
Seat 4: myatiy 96 ($50 in chips) 
Seat 5: er13to ($50 in chips) 
Seat 6: Franky77200 ($93.97 in chips) 
Seat 7: el.suertero ($54.36 in chips) 
Seat 8: fudzi ($53.46 in chips) 
Seat 9: Kukuryzka ($73.32 in chips) 
fudzi: posts small blind $0.25
Kukuryzka: posts big blind $0.50
matiko09: posts the ante $0.10
mycka86: posts the ante $0.10
myatiy 96: posts the ante $0.10
er13to: posts the ante $0.10
Franky77200: posts the ante $0.10
el.suertero: posts the ante $0.10
fudzi: posts the ante $0.10
Kukuryzka: posts the ante $0.10
*** HOLE CARDS ***
Dealt to matiko09 [7d Qs]
matiko09: folds 
mycka86: folds 
myatiy 96: folds 
er13to: raises $0.86 to $1.36
Franky77200: calls $1.36
el.suertero: folds 
fudzi: folds 
Kukuryzka: folds 
*** FLOP *** [4c 6c Qc]
er13to: checks 
Franky77200: bets $3.50
er13to: calls $3.50
*** TURN *** [4c 6c Qc] [Qd]
er13to: checks 
Franky77200: bets $7
er13to: calls $7
*** RIVER *** [4c 6c Qc Qd] [6h]
er13to: checks 
Franky77200: bets $20
er13to: folds 
Uncalled bet ($20) returned to Franky77200
Franky77200 collected $24.01 from pot
Franky77200: doesn't show hand 
*** SUMMARY ***
Total pot $25.27 | Rake $1.26 
Board [4c 6c Qc Qd 6h]
Seat 2: matiko09 folded before Flop (didn't bet)
Seat 3: mycka86 folded before Flop (didn't bet)
Seat 4: myatiy 96 folded before Flop (didn't bet)
Seat 5: er13to folded on the River
Seat 6: Franky77200 collected ($24.01)
Seat 7: el.suertero (button) folded before Flop (didn't bet)
Seat 8: fudzi (small blind) folded before Flop
Seat 9: Kukuryzka (big blind) folded before Flop





PokerStars Hand #155301595084:  Hold'em No Limit ($0.50/$1.00 USD) - 2016/06/28 16:28:21 CET [2016/06/28 10:28:21 ET]
Table 'Anitra' 9-max Seat #4 is the button
Seat 1: Klappspaten0 ($105.08 in chips) 
Seat 3: facelessPPP ($98.70 in chips) 
Seat 4: Shakeelg ($117.70 in chips) 
Seat 5: er13to ($100 in chips) 
Seat 6: matiko09 ($106 in chips) 
Seat 7: myatiy 96 ($100 in chips) 
Seat 8: yoshinoino ($34.22 in chips) 
Seat 9: chenconhaste ($103.45 in chips) 
er13to: posts small blind $0.50
matiko09: posts big blind $1
*** HOLE CARDS ***
Dealt to matiko09 [Ts 7c]
myatiy 96: folds 
yoshinoino: folds 
chenconhaste: folds 
Klappspaten0: folds 
facelessPPP: folds 
Shakeelg: folds 
er13to: folds 
Uncalled bet ($0.50) returned to matiko09
matiko09 collected $1 from pot
matiko09: doesn't show hand 
*** SUMMARY ***
Total pot $1 | Rake $0 
Seat 1: Klappspaten0 folded before Flop (didn't bet)
Seat 3: facelessPPP folded before Flop (didn't bet)
Seat 4: Shakeelg (button) folded before Flop (didn't bet)
Seat 5: er13to (small blind) folded before Flop
Seat 6: matiko09 (big blind) collected ($1)
Seat 7: myatiy 96 folded before Flop (didn't bet)
Seat 8: yoshinoino folded before Flop (didn't bet)
Seat 9: chenconhaste folded before Flop (didn't bet)





PokerStars Hand #155301600032:  Hold'em No Limit ($0.50/$1.00 USD) - 2016/06/28 16:28:30 CET [2016/06/28 10:28:30 ET]
Table 'Lyyli II' 9-max Seat #7 is the button
Seat 1: tipner ($132.03 in chips) 
Seat 2: CI58 ($117.52 in chips) 
Seat 3: Racushniak ($100.72 in chips) 
Seat 4: Greha999 ($139.80 in chips) 
Seat 5: flk.Dasas ($102.70 in chips) 
Seat 6: matiko09 ($109.94 in chips) 
Seat 7: Kukuryzka ($183.97 in chips) 
Seat 8: r4mz3s ($126.42 in chips) 
Seat 9: f1reworks ($101 in chips) 
r4mz3s: posts small blind $0.50
f1reworks: posts big blind $1
*** HOLE CARDS ***
Dealt to matiko09 [Ah 7s]
tipner: folds 
CI58: raises $2 to $3
Racushniak: folds 
Greha999: folds 
flk.Dasas: folds 
matiko09: folds 
Kukuryzka: folds 
r4mz3s: folds 
f1reworks: folds 
Uncalled bet ($2) returned to CI58
CI58 collected $2.50 from pot
CI58: doesn't show hand 
*** SUMMARY ***
Total pot $2.50 | Rake $0 
Seat 1: tipner folded before Flop (didn't bet)
Seat 2: CI58 collected ($2.50)
Seat 3: Racushniak folded before Flop (didn't bet)
Seat 4: Greha999 folded before Flop (didn't bet)
Seat 5: flk.Dasas folded before Flop (didn't bet)
Seat 6: matiko09 folded before Flop (didn't bet)
Seat 7: Kukuryzka (button) folded before Flop (didn't bet)
Seat 8: r4mz3s (small blind) folded before Flop
Seat 9: f1reworks (big blind) folded before Flop





PokerStars Hand #155301601916:  Hold'em No Limit ($0.50/$1.00 USD) - 2016/06/28 16:28:34 CET [2016/06/28 10:28:34 ET]
Table 'Anitra' 9-max Seat #5 is the button
Seat 1: Klappspaten0 ($105.08 in chips) 
Seat 3: facelessPPP ($98.70 in chips) 
Seat 4: Shakeelg ($117.70 in chips) 
Seat 5: er13to ($100 in chips) 
Seat 6: matiko09 ($106.50 in chips) 
Seat 8: yoshinoino ($34.22 in chips) 
Seat 9: chenconhaste ($103.45 in chips) 
matiko09: posts small blind $0.50
myatiy 96: is sitting out 
yoshinoino: posts big blind $1
*** HOLE CARDS ***
Dealt to matiko09 [3h 6s]
chenconhaste: folds 
Klappspaten0: calls $1
facelessPPP: folds 
myatiy 96 leaves the table
phil_cheng joins the table at seat #7 
Shakeelg: raises $2 to $3
er13to: folds 
matiko09: folds 
yoshinoino: calls $2
Klappspaten0: calls $2
*** FLOP *** [9c Kh 7d]
yoshinoino: checks 
Klappspaten0: checks 
Shakeelg: bets $3
yoshinoino: folds 
Klappspaten0: calls $3
*** TURN *** [9c Kh 7d] [Jh]
Klappspaten0: checks 
Shakeelg: bets $5
Klappspaten0: raises $5 to $10
Shakeelg: calls $5
*** RIVER *** [9c Kh 7d Jh] [6h]
Klappspaten0: checks 
Shakeelg: bets $19
Klappspaten0: calls $19
*** SHOW DOWN ***
Shakeelg: shows [9s 9d] (three of a kind, Nines)
Klappspaten0: mucks hand 
Shakeelg collected $71 from pot
*** SUMMARY ***
Total pot $73.50 | Rake $2.50 
Board [9c Kh 7d Jh 6h]
Seat 1: Klappspaten0 mucked [Jd Kd]
Seat 3: facelessPPP folded before Flop (didn't bet)
Seat 4: Shakeelg showed [9s 9d] and won ($71) with three of a kind, Nines
Seat 5: er13to (button) folded before Flop (didn't bet)
Seat 6: matiko09 (small blind) folded before Flop
Seat 8: yoshinoino (big blind) folded on the Flop
Seat 9: chenconhaste folded before Flop (didn't bet)





PokerStars Hand #155301602170:  Hold'em No Limit ($0.50/$1.00 USD) - 2016/06/28 16:28:34 CET [2016/06/28 10:28:34 ET]
Table 'Dorado II' 9-max Seat #9 is the button
Seat 1: f1reworks ($161.55 in chips) 
Seat 2: vanilica ($103 in chips) 
Seat 3: ghostriderxu ($74.82 in chips) 
Seat 4: pyromid ($114 in chips) 
Seat 5: KovIFish89 ($101.50 in chips) 
Seat 6: mycka86 ($108.24 in chips) 
Seat 7: matiko09 ($114.71 in chips) 
Seat 8: flk.Dasas ($189.50 in chips) 
Seat 9: r4mz3s ($104.17 in chips) 
f1reworks: posts small blind $0.50
vanilica: posts big blind $1
*** HOLE CARDS ***
Dealt to matiko09 [Qs 3h]
ghostriderxu: folds 
pyromid: folds 
KovIFish89: raises $1.50 to $2.50
mycka86: folds 
matiko09: folds 
flk.Dasas: calls $2.50
r4mz3s: folds 
f1reworks: folds 
vanilica: folds 
*** FLOP *** [Qc 9c 7h]
KovIFish89: bets $4.11
flk.Dasas: calls $4.11
*** TURN *** [Qc 9c 7h] [7c]
KovIFish89: checks 
flk.Dasas: checks 
*** RIVER *** [Qc 9c 7h 7c] [Ks]
KovIFish89: bets $10.48
flk.Dasas: folds 
Uncalled bet ($10.48) returned to KovIFish89
KovIFish89 collected $13.98 from pot
KovIFish89: doesn't show hand 
*** SUMMARY ***
Total pot $14.72 | Rake $0.74 
Board [Qc 9c 7h 7c Ks]
Seat 1: f1reworks (small blind) folded before Flop
Seat 2: vanilica (big blind) folded before Flop
Seat 3: ghostriderxu folded before Flop (didn't bet)
Seat 4: pyromid folded before Flop (didn't bet)
Seat 5: KovIFish89 collected ($13.98)
Seat 6: mycka86 folded before Flop (didn't bet)
Seat 7: matiko09 folded before Flop (didn't bet)
Seat 8: flk.Dasas folded on the River
Seat 9: r4mz3s (button) folded before Flop (didn't bet)





PokerStars Hand #155301618297:  Hold'em No Limit ($0.50/$1.00 USD) - 2016/06/28 16:29:04 CET [2016/06/28 10:29:04 ET]
Table 'Lyyli II' 9-max Seat #8 is the button
Seat 1: tipner ($132.03 in chips) 
Seat 2: CI58 ($119.02 in chips) 
Seat 3: Racushniak ($100.72 in chips) 
Seat 4: Greha999 ($139.80 in chips) 
Seat 5: flk.Dasas ($102.70 in chips) 
Seat 6: matiko09 ($109.94 in chips) 
Seat 7: Kukuryzka ($183.97 in chips) 
Seat 8: r4mz3s ($125.92 in chips) 
Seat 9: f1reworks ($100 in chips) 
f1reworks: posts small blind $0.50
tipner: posts big blind $1
*** HOLE CARDS ***
Dealt to matiko09 [8s Kh]
CI58: folds 
Racushniak: folds 
Greha999: folds 
flk.Dasas: folds 
matiko09: folds 
Kukuryzka: raises $1.50 to $2.50
r4mz3s: folds 
f1reworks: folds 
tipner: folds 
Uncalled bet ($1.50) returned to Kukuryzka
Kukuryzka collected $2.50 from pot
Kukuryzka: doesn't show hand 
*** SUMMARY ***
Total pot $2.50 | Rake $0 
Seat 1: tipner (big blind) folded before Flop
Seat 2: CI58 folded before Flop (didn't bet)
Seat 3: Racushniak folded before Flop (didn't bet)
Seat 4: Greha999 folded before Flop (didn't bet)
Seat 5: flk.Dasas folded before Flop (didn't bet)
Seat 6: matiko09 folded before Flop (didn't bet)
Seat 7: Kukuryzka collected ($2.50)
Seat 8: r4mz3s (button) folded before Flop (didn't bet)
Seat 9: f1reworks (small blind) folded before Flop





PokerStars Hand #155301629674:  Hold'em No Limit ($0.50/$1.00 USD) - 2016/06/28 16:29:25 CET [2016/06/28 10:29:25 ET]
Table 'Lyyli II' 9-max Seat #9 is the button
Seat 1: tipner ($131.03 in chips) 
Seat 2: CI58 ($119.02 in chips) 
Seat 3: Racushniak ($100.72 in chips) 
Seat 4: Greha999 ($139.80 in chips) 
Seat 5: flk.Dasas ($102.70 in chips) 
Seat 6: matiko09 ($109.94 in chips) 
Seat 7: Kukuryzka ($185.47 in chips) 
Seat 8: r4mz3s ($125.92 in chips) 
Seat 9: f1reworks ($100 in chips) 
tipner: posts small blind $0.50
CI58: posts big blind $1
*** HOLE CARDS ***
Dealt to matiko09 [8c 3h]
Racushniak: raises $1.80 to $2.80
Greha999: calls $2.80
flk.Dasas: folds 
matiko09: folds 
Kukuryzka: folds 
r4mz3s: folds 
f1reworks: folds 
tipner: folds 
CI58: folds 
*** FLOP *** [2s Kc Ad]
Racushniak: bets $2.22
Greha999: calls $2.22
*** TURN *** [2s Kc Ad] [3d]
Racushniak: checks 
Greha999: checks 
*** RIVER *** [2s Kc Ad 3d] [4c]
Racushniak: checks 
Greha999: bets $7
Racushniak: folds 
Uncalled bet ($7) returned to Greha999
Greha999 collected $10.96 from pot
*** SUMMARY ***
Total pot $11.54 | Rake $0.58 
Board [2s Kc Ad 3d 4c]
Seat 1: tipner (small blind) folded before Flop
Seat 2: CI58 (big blind) folded before Flop
Seat 3: Racushniak folded on the River
Seat 4: Greha999 collected ($10.96)
Seat 5: flk.Dasas folded before Flop (didn't bet)
Seat 6: matiko09 folded before Flop (didn't bet)
Seat 7: Kukuryzka folded before Flop (didn't bet)
Seat 8: r4mz3s folded before Flop (didn't bet)
Seat 9: f1reworks (button) folded before Flop (didn't bet)





PokerStars Hand #155301634791:  Hold'em No Limit ($0.25/$0.50 USD) - 2016/06/28 16:29:34 CET [2016/06/28 10:29:34 ET]
Table 'Utra' 9-max Seat #8 is the button
Seat 2: matiko09 ($73.86 in chips) 
Seat 3: mycka86 ($73.21 in chips) 
Seat 4: myatiy 96 ($50 in chips) 
Seat 5: er13to ($50 in chips) 
Seat 6: Franky77200 ($106.02 in chips) 
Seat 7: el.suertero ($54.26 in chips) 
Seat 8: fudzi ($53.11 in chips) 
Seat 9: Kukuryzka ($72.72 in chips) 
Kukuryzka: posts small blind $0.25
matiko09: posts big blind $0.50
matiko09: posts the ante $0.10
mycka86: posts the ante $0.10
myatiy 96: posts the ante $0.10
er13to: posts the ante $0.10
Franky77200: posts the ante $0.10
el.suertero: posts the ante $0.10
fudzi: posts the ante $0.10
Kukuryzka: posts the ante $0.10
*** HOLE CARDS ***
Dealt to matiko09 [8d 3h]
mycka86: folds 
myatiy 96: raises $0.75 to $1.25
er13to: folds 
Franky77200: calls $1.25
el.suertero: folds 
fudzi: folds 
Kukuryzka: folds 
matiko09: folds 
*** FLOP *** [9c 3c 2c]
myatiy 96: checks 
Franky77200: bets $3
myatiy 96: folds 
Uncalled bet ($3) returned to Franky77200
Franky77200 collected $3.85 from pot
Franky77200: doesn't show hand 
*** SUMMARY ***
Total pot $4.05 | Rake $0.20 
Board [9c 3c 2c]
Seat 2: matiko09 (big blind) folded before Flop
Seat 3: mycka86 folded before Flop (didn't bet)
Seat 4: myatiy 96 folded on the Flop
Seat 5: er13to folded before Flop (didn't bet)
Seat 6: Franky77200 collected ($3.85)
Seat 7: el.suertero folded before Flop (didn't bet)
Seat 8: fudzi (button) folded before Flop (didn't bet)
Seat 9: Kukuryzka (small blind) folded before Flop





PokerStars Hand #155301635179:  Hold'em No Limit ($0.50/$1.00 USD) - 2016/06/28 16:29:35 CET [2016/06/28 10:29:35 ET]
Table 'Tomita' 9-max Seat #3 is the button
Seat 1: CI58 ($100 in chips) 
Seat 2: vanilica ($103.72 in chips) 
Seat 3: r4mz3s ($100 in chips) 
Seat 4: f1reworks ($117.45 in chips) 
Seat 5: ANDY19911608 ($174.68 in chips) 
Seat 6: tipner ($100 in chips) 
Seat 7: matiko09 ($100 in chips) 
Seat 8: myatiy 96 ($218.50 in chips) 
Seat 9: sanpidk ($142.39 in chips) 
f1reworks: posts small blind $0.50
ANDY19911608: posts big blind $1
*** HOLE CARDS ***
Dealt to matiko09 [Qh Qd]
tipner: folds 
matiko09: raises $2 to $3
myatiy 96: folds 
sanpidk: folds 
CI58: calls $3
vanilica: folds 
r4mz3s: raises $9 to $12
f1reworks: folds 
ANDY19911608: folds 
matiko09: calls $9
CI58: calls $9
*** FLOP *** [Td 8h 8d]
matiko09: checks 
CI58: checks 
r4mz3s: checks 
*** TURN *** [Td 8h 8d] [6c]
matiko09: bets $18
CI58: folds 
r4mz3s: folds 
Uncalled bet ($18) returned to matiko09
matiko09 collected $35.62 from pot
matiko09: doesn't show hand 
*** SUMMARY ***
Total pot $37.50 | Rake $1.88 
Board [Td 8h 8d 6c]
Seat 1: CI58 folded on the Turn
Seat 2: vanilica folded before Flop (didn't bet)
Seat 3: r4mz3s (button) folded on the Turn
Seat 4: f1reworks (small blind) folded before Flop
Seat 5: ANDY19911608 (big blind) folded before Flop
Seat 6: tipner folded before Flop (didn't bet)
Seat 7: matiko09 collected ($35.62)
Seat 8: myatiy 96 folded before Flop (didn't bet)
Seat 9: sanpidk folded before Flop (didn't bet)





PokerStars Hand #155301644326:  Hold'em No Limit ($0.50/$1.00 USD) - 2016/06/28 16:29:52 CET [2016/06/28 10:29:52 ET]
Table 'Anitra' 9-max Seat #6 is the button
Seat 1: Klappspaten0 ($100 in chips) 
Seat 3: facelessPPP ($98.70 in chips) 
Seat 4: Shakeelg ($153.70 in chips) 
Seat 5: er13to ($100 in chips) 
Seat 6: matiko09 ($106 in chips) 
Seat 8: yoshinoino ($31.22 in chips) 
Seat 9: chenconhaste ($103.45 in chips) 
phil_cheng will be allowed to play after the button
yoshinoino: posts small blind $0.50
chenconhaste: posts big blind $1
*** HOLE CARDS ***
Dealt to matiko09 [3d Ts]
Klappspaten0: folds 
facelessPPP: folds 
Shakeelg: folds 
er13to: raises $1.72 to $2.72
matiko09: folds 
yoshinoino: folds 
chenconhaste: calls $1.72
*** FLOP *** [Qc Js Jh]
chenconhaste: checks 
er13to: bets $2.93
chenconhaste: raises $8.07 to $11
er13to: calls $8.07
*** TURN *** [Qc Js Jh] [Tc]
chenconhaste: checks 
er13to: checks 
*** RIVER *** [Qc Js Jh Tc] [4d]
chenconhaste: checks 
er13to: bets $4.50
chenconhaste: folds 
Uncalled bet ($4.50) returned to er13to
er13to collected $26.54 from pot
*** SUMMARY ***
Total pot $27.94 | Rake $1.40 
Board [Qc Js Jh Tc 4d]
Seat 1: Klappspaten0 folded before Flop (didn't bet)
Seat 3: facelessPPP folded before Flop (didn't bet)
Seat 4: Shakeelg folded before Flop (didn't bet)
Seat 5: er13to collected ($26.54)
Seat 6: matiko09 (button) folded before Flop (didn't bet)
Seat 8: yoshinoino (small blind) folded before Flop
Seat 9: chenconhaste (big blind) folded on the River





PokerStars Hand #155301655280:  Hold'em No Limit ($0.25/$0.50 USD) - 2016/06/28 16:30:09 CET [2016/06/28 10:30:09 ET]
Table 'Utra' 9-max Seat #9 is the button
Seat 2: matiko09 ($73.26 in chips) 
Seat 3: mycka86 ($73.11 in chips) 
Seat 4: myatiy 96 ($50 in chips) 
Seat 5: er13to ($50 in chips) 
Seat 6: Franky77200 ($108.52 in chips) 
Seat 7: el.suertero ($54.16 in chips) 
Seat 8: fudzi ($53.01 in chips) 
Seat 9: Kukuryzka ($72.37 in chips) 
matiko09: posts small blind $0.25
mycka86: posts big blind $0.50
matiko09: posts the ante $0.10
mycka86: posts the ante $0.10
myatiy 96: posts the ante $0.10
er13to: posts the ante $0.10
Franky77200: posts the ante $0.10
el.suertero: posts the ante $0.10
fudzi: posts the ante $0.10
Kukuryzka: posts the ante $0.10
*** HOLE CARDS ***
Dealt to matiko09 [Kc As]
myatiy 96: raises $0.75 to $1.25
er13to: folds 
Franky77200: calls $1.25
el.suertero: folds 
fudzi: folds 
Kukuryzka: folds 
matiko09: raises $5.25 to $6.50
mycka86: folds 
myatiy 96: calls $5.25
Franky77200: calls $5.25
*** FLOP *** [3h Qd 7s]
matiko09: checks 
myatiy 96: checks 
Franky77200: checks 
*** TURN *** [3h Qd 7s] [7d]
matiko09: checks 
myatiy 96: bets $9.88
Franky77200: folds 
matiko09: folds 
Uncalled bet ($9.88) returned to myatiy 96
myatiy 96 collected $19.76 from pot
*** SUMMARY ***
Total pot $20.80 | Rake $1.04 
Board [3h Qd 7s 7d]
Seat 2: matiko09 (small blind) folded on the Turn
Seat 3: mycka86 (big blind) folded before Flop
Seat 4: myatiy 96 collected ($19.76)
Seat 5: er13to folded before Flop (didn't bet)
Seat 6: Franky77200 folded on the Turn
Seat 7: el.suertero folded before Flop (didn't bet)
Seat 8: fudzi folded before Flop (didn't bet)
Seat 9: Kukuryzka (button) folded before Flop (didn't bet)





PokerStars Hand #155301657134:  Hold'em No Limit ($0.50/$1.00 USD) - 2016/06/28 16:30:12 CET [2016/06/28 10:30:12 ET]
Table 'Lyyli II' 9-max Seat #1 is the button
Seat 1: tipner ($130.53 in chips) 
Seat 2: CI58 ($118.02 in chips) 
Seat 3: Racushniak ($100 in chips) 
Seat 4: Greha999 ($145.74 in chips) 
Seat 5: flk.Dasas ($102.70 in chips) 
Seat 6: matiko09 ($109.94 in chips) 
Seat 7: Kukuryzka ($185.47 in chips) 
Seat 8: r4mz3s ($125.92 in chips) 
Seat 9: f1reworks ($100 in chips) 
CI58: posts small blind $0.50
Racushniak: posts big blind $1
*** HOLE CARDS ***
Dealt to matiko09 [Qh 5s]
Greha999: folds 
flk.Dasas: folds 
matiko09: folds 
Kukuryzka: folds 
r4mz3s: folds 
f1reworks: folds 
tipner has timed out
tipner: folds 
CI58: folds 
Uncalled bet ($0.50) returned to Racushniak
Racushniak collected $1 from pot
Racushniak: doesn't show hand 
*** SUMMARY ***
Total pot $1 | Rake $0 
Seat 1: tipner (button) folded before Flop (didn't bet)
Seat 2: CI58 (small blind) folded before Flop
Seat 3: Racushniak (big blind) collected ($1)
Seat 4: Greha999 folded before Flop (didn't bet)
Seat 5: flk.Dasas folded before Flop (didn't bet)
Seat 6: matiko09 folded before Flop (didn't bet)
Seat 7: Kukuryzka folded before Flop (didn't bet)
Seat 8: r4mz3s folded before Flop (didn't bet)
Seat 9: f1reworks folded before Flop (didn't bet)





PokerStars Hand #155301672003:  Hold'em No Limit ($0.50/$1.00 USD) - 2016/06/28 16:30:40 CET [2016/06/28 10:30:40 ET]
Table 'Zerlina' 9-max Seat #9 is the button
Seat 1: arctur17 ($18.35 in chips) 
Seat 2: matiko09 ($100 in chips) 
Seat 3: Racushniak ($176.57 in chips) 
Seat 4: phil_cheng ($100.38 in chips) 
Seat 5: mycka86 ($101.50 in chips) 
Seat 6: sanpidk ($109.30 in chips) 
Seat 7: f1reworks ($274.92 in chips) 
Seat 8: Orga_060670 ($100 in chips) 
Seat 9: r4mz3s ($112.69 in chips) 
arctur17: posts small blind $0.50
matiko09: posts big blind $1
*** HOLE CARDS ***
Dealt to matiko09 [2h 4d]
Racushniak: folds 
phil_cheng: folds 
mycka86: folds 
sanpidk: folds 
f1reworks: folds 
Orga_060670: folds 
r4mz3s: folds 
arctur17: raises $2 to $3
matiko09: folds 
Uncalled bet ($2) returned to arctur17
arctur17 collected $2 from pot
arctur17: doesn't show hand 
*** SUMMARY ***
Total pot $2 | Rake $0 
Seat 1: arctur17 (small blind) collected ($2)
Seat 2: matiko09 (big blind) folded before Flop
Seat 3: Racushniak folded before Flop (didn't bet)
Seat 4: phil_cheng folded before Flop (didn't bet)
Seat 5: mycka86 folded before Flop (didn't bet)
Seat 6: sanpidk folded before Flop (didn't bet)
Seat 7: f1reworks folded before Flop (didn't bet)
Seat 8: Orga_060670 folded before Flop (didn't bet)
Seat 9: r4mz3s (button) folded before Flop (didn't bet)





PokerStars Hand #155301676123:  Hold'em No Limit ($0.50/$1.00 USD) - 2016/06/28 16:30:47 CET [2016/06/28 10:30:47 ET]
Table 'Dorado II' 9-max Seat #1 is the button
Seat 1: f1reworks ($161.05 in chips) 
Seat 2: vanilica ($102 in chips) 
Seat 3: ghostriderxu ($74.82 in chips) 
Seat 4: pyromid ($114 in chips) 
Seat 5: KovIFish89 ($108.87 in chips) 
Seat 6: mycka86 ($108.24 in chips) 
Seat 7: matiko09 ($114.71 in chips) 
Seat 8: flk.Dasas ($182.89 in chips) 
Seat 9: r4mz3s ($104.17 in chips) 
vanilica: posts small blind $0.50
ghostriderxu: posts big blind $1
*** HOLE CARDS ***
Dealt to matiko09 [7s 3d]
pyromid: folds 
KovIFish89: folds 
mycka86: folds 
matiko09: folds 
flk.Dasas: folds 
r4mz3s: folds 
f1reworks: raises $1.10 to $2.10
vanilica: folds 
ghostriderxu: calls $1.10
*** FLOP *** [5s 6h Kh]
ghostriderxu: checks 
f1reworks: bets $3
ghostriderxu: raises $4.80 to $7.80
f1reworks: raises $14.20 to $22
ghostriderxu: folds 
Uncalled bet ($14.20) returned to f1reworks
f1reworks collected $19.28 from pot
f1reworks: doesn't show hand 
*** SUMMARY ***
Total pot $20.30 | Rake $1.02 
Board [5s 6h Kh]
Seat 1: f1reworks (button) collected ($19.28)
Seat 2: vanilica (small blind) folded before Flop
Seat 3: ghostriderxu (big blind) folded on the Flop
Seat 4: pyromid folded before Flop (didn't bet)
Seat 5: KovIFish89 folded before Flop (didn't bet)
Seat 6: mycka86 folded before Flop (didn't bet)
Seat 7: matiko09 folded before Flop (didn't bet)
Seat 8: flk.Dasas folded before Flop (didn't bet)
Seat 9: r4mz3s folded before Flop (didn't bet)





PokerStars Hand #155301680036:  Hold'em No Limit ($0.50/$1.00 USD) - 2016/06/28 16:30:54 CET [2016/06/28 10:30:54 ET]
Table 'Lyyli II' 9-max Seat #2 is the button
Seat 2: CI58 ($117.52 in chips) 
Seat 3: Racushniak ($100.50 in chips) 
Seat 4: Greha999 ($145.74 in chips) 
Seat 5: flk.Dasas ($102.70 in chips) 
Seat 6: matiko09 ($109.94 in chips) 
Seat 7: Kukuryzka ($185.47 in chips) 
Seat 8: r4mz3s ($125.92 in chips) 
Seat 9: f1reworks ($100 in chips) 
Racushniak: posts small blind $0.50
Greha999: posts big blind $1
*** HOLE CARDS ***
Dealt to matiko09 [6h 9d]
flk.Dasas: raises $2 to $3
matiko09: folds 
Kukuryzka: raises $6 to $9
r4mz3s: folds 
f1reworks: folds 
CI58: raises $12 to $21
Racushniak: folds 
Greha999: folds 
flk.Dasas: folds 
Kukuryzka: folds 
Uncalled bet ($12) returned to CI58
CI58 collected $22.50 from pot
CI58: doesn't show hand 
*** SUMMARY ***
Total pot $22.50 | Rake $0 
Seat 2: CI58 (button) collected ($22.50)
Seat 3: Racushniak (small blind) folded before Flop
Seat 4: Greha999 (big blind) folded before Flop
Seat 5: flk.Dasas folded before Flop
Seat 6: matiko09 folded before Flop (didn't bet)
Seat 7: Kukuryzka folded before Flop
Seat 8: r4mz3s folded before Flop (didn't bet)
Seat 9: f1reworks folded before Flop (didn't bet)





PokerStars Hand #155301689845:  Hold'em No Limit ($0.50/$1.00 USD) - 2016/06/28 16:31:12 CET [2016/06/28 10:31:12 ET]
Table 'Zerlina' 9-max Seat #1 is the button
Seat 1: arctur17 ($19.35 in chips) 
Seat 2: matiko09 ($100 in chips) 
Seat 3: Racushniak ($176.57 in chips) 
Seat 4: phil_cheng ($100.38 in chips) 
Seat 5: mycka86 ($101.50 in chips) 
Seat 6: sanpidk ($109.30 in chips) 
Seat 7: f1reworks ($274.92 in chips) 
Seat 8: Orga_060670 ($100 in chips) 
Seat 9: r4mz3s ($112.69 in chips) 
matiko09: posts small blind $0.50
Racushniak: posts big blind $1
*** HOLE CARDS ***
Dealt to matiko09 [Jd Ks]
phil_cheng: folds 
mycka86: folds 
sanpidk: folds 
f1reworks: raises $2 to $3
Orga_060670: folds 
r4mz3s: raises $6 to $9
arctur17: folds 
matiko09: folds 
Racushniak: folds 
f1reworks: folds 
Uncalled bet ($6) returned to r4mz3s
r4mz3s collected $7.50 from pot
r4mz3s: doesn't show hand 
*** SUMMARY ***
Total pot $7.50 | Rake $0 
Seat 1: arctur17 (button) folded before Flop (didn't bet)
Seat 2: matiko09 (small blind) folded before Flop
Seat 3: Racushniak (big blind) folded before Flop
Seat 4: phil_cheng folded before Flop (didn't bet)
Seat 5: mycka86 folded before Flop (didn't bet)
Seat 6: sanpidk folded before Flop (didn't bet)
Seat 7: f1reworks folded before Flop
Seat 8: Orga_060670 folded before Flop (didn't bet)
Seat 9: r4mz3s collected ($7.50)





PokerStars Hand #155301702682:  Hold'em No Limit ($0.50/$1.00 USD) - 2016/06/28 16:31:35 CET [2016/06/28 10:31:35 ET]
Table 'Anitra' 9-max Seat #8 is the button
Seat 1: Klappspaten0 ($100 in chips) 
Seat 3: facelessPPP ($98.70 in chips) 
Seat 4: Shakeelg ($153.70 in chips) 
Seat 5: er13to ($112.82 in chips) 
Seat 6: matiko09 ($106 in chips) 
Seat 8: yoshinoino ($30.72 in chips) 
Seat 9: chenconhaste ($100 in chips) 
chenconhaste: posts small blind $0.50
Klappspaten0: posts big blind $1
phil_cheng: sits out 
*** HOLE CARDS ***
Dealt to matiko09 [Js 2h]
facelessPPP: folds 
Shakeelg: folds 
er13to: folds 
matiko09: folds 
yoshinoino: raises $1 to $2
chenconhaste: folds 
Klappspaten0: calls $1
*** FLOP *** [4h Qc 4s]
Klappspaten0: checks 
yoshinoino: bets $2.14
Klappspaten0: folds 
Uncalled bet ($2.14) returned to yoshinoino
yoshinoino collected $4.28 from pot
yoshinoino: doesn't show hand 
*** SUMMARY ***
Total pot $4.50 | Rake $0.22 
Board [4h Qc 4s]
Seat 1: Klappspaten0 (big blind) folded on the Flop
Seat 3: facelessPPP folded before Flop (didn't bet)
Seat 4: Shakeelg folded before Flop (didn't bet)
Seat 5: er13to folded before Flop (didn't bet)
Seat 6: matiko09 folded before Flop (didn't bet)
Seat 8: yoshinoino (button) collected ($4.28)
Seat 9: chenconhaste (small blind) folded before Flop





PokerStars Hand #155301713041:  Hold'em No Limit ($0.50/$1.00 USD) - 2016/06/28 16:31:54 CET [2016/06/28 10:31:54 ET]
Table 'Lyyli II' 9-max Seat #3 is the button
Seat 1: tipner ($130.53 in chips) 
Seat 2: CI58 ($131.02 in chips) 
Seat 3: Racushniak ($100 in chips) 
Seat 4: Greha999 ($144.74 in chips) 
Seat 5: flk.Dasas ($100 in chips) 
Seat 6: matiko09 ($109.94 in chips) 
Seat 7: Kukuryzka ($176.47 in chips) 
Seat 8: r4mz3s ($125.92 in chips) 
Seat 9: f1reworks ($100 in chips) 
Greha999: posts small blind $0.50
flk.Dasas: posts big blind $1
*** HOLE CARDS ***
Dealt to matiko09 [Tc 8d]
matiko09: folds 
Kukuryzka: folds 
r4mz3s: folds 
f1reworks: folds 
tipner: folds 
CI58: raises $1.50 to $2.50
Racushniak: folds 
Greha999: folds 
flk.Dasas: folds 
Uncalled bet ($1.50) returned to CI58
CI58 collected $2.50 from pot
CI58: doesn't show hand 
*** SUMMARY ***
Total pot $2.50 | Rake $0 
Seat 1: tipner folded before Flop (didn't bet)
Seat 2: CI58 collected ($2.50)
Seat 3: Racushniak (button) folded before Flop (didn't bet)
Seat 4: Greha999 (small blind) folded before Flop
Seat 5: flk.Dasas (big blind) folded before Flop
Seat 6: matiko09 folded before Flop (didn't bet)
Seat 7: Kukuryzka folded before Flop (didn't bet)
Seat 8: r4mz3s folded before Flop (didn't bet)
Seat 9: f1reworks folded before Flop (didn't bet)





PokerStars Hand #155301716908:  Hold'em No Limit ($0.50/$1.00 USD) - 2016/06/28 16:32:01 CET [2016/06/28 10:32:01 ET]
Table 'Tomita' 9-max Seat #4 is the button
Seat 1: CI58 ($100 in chips) 
Seat 2: vanilica ($103.72 in chips) 
Seat 3: r4mz3s ($100 in chips) 
Seat 4: f1reworks ($116.95 in chips) 
Seat 5: ANDY19911608 ($173.68 in chips) 
Seat 6: tipner ($100 in chips) 
Seat 7: matiko09 ($123.62 in chips) 
Seat 8: myatiy 96 ($218.50 in chips) 
Seat 9: sanpidk ($142.39 in chips) 
ANDY19911608: posts small blind $0.50
tipner: posts big blind $1
*** HOLE CARDS ***
Dealt to matiko09 [6d As]
matiko09: folds 
myatiy 96: folds 
sanpidk: folds 
CI58: raises $2 to $3
vanilica: folds 
r4mz3s: folds 
f1reworks: calls $3
ANDY19911608: folds 
tipner: folds 
*** FLOP *** [Ks Kc 4c]
CI58: checks 
f1reworks: checks 
*** TURN *** [Ks Kc 4c] [9c]
CI58: checks 
f1reworks: bets $4
CI58: folds 
Uncalled bet ($4) returned to f1reworks
f1reworks collected $7.12 from pot
f1reworks: doesn't show hand 
*** SUMMARY ***
Total pot $7.50 | Rake $0.38 
Board [Ks Kc 4c 9c]
Seat 1: CI58 folded on the Turn
Seat 2: vanilica folded before Flop (didn't bet)
Seat 3: r4mz3s folded before Flop (didn't bet)
Seat 4: f1reworks (button) collected ($7.12)
Seat 5: ANDY19911608 (small blind) folded before Flop
Seat 6: tipner (big blind) folded before Flop
Seat 7: matiko09 folded before Flop (didn't bet)
Seat 8: myatiy 96 folded before Flop (didn't bet)
Seat 9: sanpidk folded before Flop (didn't bet)





PokerStars Hand #155301718832:  Hold'em No Limit ($0.50/$1.00 USD) - 2016/06/28 16:32:05 CET [2016/06/28 10:32:05 ET]
Table 'Dorado II' 9-max Seat #2 is the button
Seat 1: f1reworks ($170.43 in chips) 
Seat 2: vanilica ($101.50 in chips) 
Seat 3: ghostriderxu ($64.92 in chips) 
Seat 4: pyromid ($114 in chips) 
Seat 5: KovIFish89 ($108.87 in chips) 
Seat 6: mycka86 ($108.24 in chips) 
Seat 7: matiko09 ($114.71 in chips) 
Seat 8: flk.Dasas ($182.89 in chips) 
Seat 9: r4mz3s ($104.17 in chips) 
ghostriderxu: posts small blind $0.50
pyromid: posts big blind $1
*** HOLE CARDS ***
Dealt to matiko09 [Qd 5c]
KovIFish89: folds 
mycka86: folds 
matiko09: folds 
flk.Dasas: folds 
r4mz3s: folds 
f1reworks: raises $2 to $3
vanilica: folds 
ghostriderxu: folds 
pyromid: folds 
Uncalled bet ($2) returned to f1reworks
f1reworks collected $2.50 from pot
f1reworks: doesn't show hand 
*** SUMMARY ***
Total pot $2.50 | Rake $0 
Seat 1: f1reworks collected ($2.50)
Seat 2: vanilica (button) folded before Flop (didn't bet)
Seat 3: ghostriderxu (small blind) folded before Flop
Seat 4: pyromid (big blind) folded before Flop
Seat 5: KovIFish89 folded before Flop (didn't bet)
Seat 6: mycka86 folded before Flop (didn't bet)
Seat 7: matiko09 folded before Flop (didn't bet)
Seat 8: flk.Dasas folded before Flop (didn't bet)
Seat 9: r4mz3s folded before Flop (didn't bet)





PokerStars Hand #155301719408:  Hold'em No Limit ($0.50/$1.00 USD) - 2016/06/28 16:32:06 CET [2016/06/28 10:32:06 ET]
Table 'Anitra' 9-max Seat #9 is the button
Seat 1: Klappspaten0 ($100 in chips) 
Seat 3: facelessPPP ($98.70 in chips) 
Seat 4: Shakeelg ($153.70 in chips) 
Seat 5: er13to ($112.82 in chips) 
Seat 6: matiko09 ($106 in chips) 
Seat 8: yoshinoino ($33 in chips) 
Seat 9: chenconhaste ($100 in chips) 
Klappspaten0: posts small blind $0.50
facelessPPP: posts big blind $1
phil_cheng: sits out 
*** HOLE CARDS ***
Dealt to matiko09 [Th 9h]
Shakeelg: folds 
er13to: folds 
matiko09: raises $2 to $3
yoshinoino: folds 
chenconhaste: folds 
Klappspaten0: folds 
facelessPPP: folds 
Uncalled bet ($2) returned to matiko09
matiko09 collected $2.50 from pot
matiko09: doesn't show hand 
*** SUMMARY ***
Total pot $2.50 | Rake $0 
Seat 1: Klappspaten0 (small blind) folded before Flop
Seat 3: facelessPPP (big blind) folded before Flop
Seat 4: Shakeelg folded before Flop (didn't bet)
Seat 5: er13to folded before Flop (didn't bet)
Seat 6: matiko09 collected ($2.50)
Seat 8: yoshinoino folded before Flop (didn't bet)
Seat 9: chenconhaste (button) folded before Flop (didn't bet)





PokerStars Hand #155301727455:  Hold'em No Limit ($0.50/$1.00 USD) - 2016/06/28 16:32:20 CET [2016/06/28 10:32:20 ET]
Table 'Zerlina' 9-max Seat #2 is the button
Seat 1: arctur17 ($19.35 in chips) 
Seat 2: matiko09 ($100 in chips) 
Seat 3: Racushniak ($175.57 in chips) 
Seat 4: phil_cheng ($100.38 in chips) 
Seat 5: mycka86 ($101.50 in chips) 
Seat 6: sanpidk ($109.30 in chips) 
Seat 7: f1reworks ($271.92 in chips) 
Seat 8: Orga_060670 ($100 in chips) 
Seat 9: r4mz3s ($117.19 in chips) 
Racushniak: posts small blind $0.50
phil_cheng: posts big blind $1
*** HOLE CARDS ***
Dealt to matiko09 [7h 4d]
mycka86: folds 
sanpidk: folds 
f1reworks: folds 
Orga_060670: folds 
r4mz3s: folds 
arctur17: raises $2 to $3
matiko09: folds 
Racushniak: folds 
phil_cheng: folds 
Uncalled bet ($2) returned to arctur17
arctur17 collected $2.50 from pot
arctur17: doesn't show hand 
*** SUMMARY ***
Total pot $2.50 | Rake $0 
Seat 1: arctur17 collected ($2.50)
Seat 2: matiko09 (button) folded before Flop (didn't bet)
Seat 3: Racushniak (small blind) folded before Flop
Seat 4: phil_cheng (big blind) folded before Flop
Seat 5: mycka86 folded before Flop (didn't bet)
Seat 6: sanpidk folded before Flop (didn't bet)
Seat 7: f1reworks folded before Flop (didn't bet)
Seat 8: Orga_060670 folded before Flop (didn't bet)
Seat 9: r4mz3s folded before Flop (didn't bet)





PokerStars Hand #155301730544:  Hold'em No Limit ($0.50/$1.00 USD) - 2016/06/28 16:32:26 CET [2016/06/28 10:32:26 ET]
Table 'Lyyli II' 9-max Seat #4 is the button
Seat 1: tipner ($130.53 in chips) 
Seat 2: CI58 ($132.52 in chips) 
Seat 3: Racushniak ($100 in chips) 
Seat 4: Greha999 ($144.24 in chips) 
Seat 5: flk.Dasas ($100 in chips) 
Seat 6: matiko09 ($109.94 in chips) 
Seat 7: Kukuryzka ($176.47 in chips) 
Seat 8: r4mz3s ($125.92 in chips) 
Seat 9: f1reworks ($100 in chips) 
flk.Dasas: posts small blind $0.50
matiko09: posts big blind $1
*** HOLE CARDS ***
Dealt to matiko09 [4d Jd]
Kukuryzka: folds 
r4mz3s: folds 
f1reworks: folds 
tipner: folds 
CI58: folds 
Racushniak: folds 
Greha999: folds 
flk.Dasas: raises $2 to $3
matiko09: folds 
Uncalled bet ($2) returned to flk.Dasas
flk.Dasas collected $2 from pot
flk.Dasas: doesn't show hand 
*** SUMMARY ***
Total pot $2 | Rake $0 
Seat 1: tipner folded before Flop (didn't bet)
Seat 2: CI58 folded before Flop (didn't bet)
Seat 3: Racushniak folded before Flop (didn't bet)
Seat 4: Greha999 (button) folded before Flop (didn't bet)
Seat 5: flk.Dasas (small blind) collected ($2)
Seat 6: matiko09 (big blind) folded before Flop
Seat 7: Kukuryzka folded before Flop (didn't bet)
Seat 8: r4mz3s folded before Flop (didn't bet)
Seat 9: f1reworks folded before Flop (didn't bet)





PokerStars Hand #155301734733:  Hold'em No Limit ($0.50/$1.00 USD) - 2016/06/28 16:32:33 CET [2016/06/28 10:32:33 ET]
Table 'Anitra' 9-max Seat #1 is the button
Seat 1: Klappspaten0 ($100 in chips) 
Seat 3: facelessPPP ($97.70 in chips) 
Seat 4: Shakeelg ($153.70 in chips) 
Seat 5: er13to ($112.82 in chips) 
Seat 6: matiko09 ($107.50 in chips) 
Seat 8: yoshinoino ($33 in chips) 
Seat 9: chenconhaste ($100 in chips) 
facelessPPP: posts small blind $0.50
Shakeelg: posts big blind $1
phil_cheng: sits out 
*** HOLE CARDS ***
Dealt to matiko09 [6c 2s]
er13to: folds 
matiko09: folds 
yoshinoino: folds 
chenconhaste: folds 
Klappspaten0: folds 
facelessPPP: raises $1 to $2
Shakeelg: calls $1
*** FLOP *** [8d As 8s]
facelessPPP: checks 
Shakeelg: bets $2
facelessPPP: calls $2
*** TURN *** [8d As 8s] [4h]
facelessPPP: checks 
Shakeelg: bets $3
facelessPPP: calls $3
*** RIVER *** [8d As 8s 4h] [Ah]
facelessPPP: checks 
Shakeelg: bets $14
facelessPPP: calls $14
*** SHOW DOWN ***
Shakeelg: shows [Ac 6s] (a full house, Aces full of Eights)
facelessPPP: shows [9d Ad] (a full house, Aces full of Eights)
facelessPPP collected $19.95 from pot
Shakeelg collected $19.95 from pot
*** SUMMARY ***
Total pot $42 | Rake $2.10 
Board [8d As 8s 4h Ah]
Seat 1: Klappspaten0 (button) folded before Flop (didn't bet)
Seat 3: facelessPPP (small blind) showed [9d Ad] and won ($19.95) with a full house, Aces full of Eights
Seat 4: Shakeelg (big blind) showed [Ac 6s] and won ($19.95) with a full house, Aces full of Eights
Seat 5: er13to folded before Flop (didn't bet)
Seat 6: matiko09 folded before Flop (didn't bet)
Seat 8: yoshinoino folded before Flop (didn't bet)
Seat 9: chenconhaste folded before Flop (didn't bet)





PokerStars Hand #155301735900:  Hold'em No Limit ($0.25/$0.50 USD) - 2016/06/28 16:32:35 CET [2016/06/28 10:32:35 ET]
Table 'Utra' 9-max Seat #2 is the button
Seat 2: matiko09 ($66.66 in chips) 
Seat 3: mycka86 ($72.51 in chips) 
Seat 5: er13to ($50 in chips) 
Seat 6: Franky77200 ($101.92 in chips) 
Seat 7: el.suertero ($54.06 in chips) 
Seat 8: fudzi ($52.91 in chips) 
Seat 9: Kukuryzka ($72.27 in chips) 
mycka86: posts small blind $0.25
myatiy 96: is sitting out 
er13to: posts big blind $0.50
matiko09: posts the ante $0.10
mycka86: posts the ante $0.10
er13to: posts the ante $0.10
Franky77200: posts the ante $0.10
el.suertero: posts the ante $0.10
fudzi: posts the ante $0.10
Kukuryzka: posts the ante $0.10
*** HOLE CARDS ***
Dealt to matiko09 [Kd 5d]
myatiy 96 leaves the table
Domotirko228 joins the table at seat #4 
Franky77200: folds 
Domotirko228 leaves the table
el.suertero: folds 
fudzi: folds 
Franky77200 leaves the table
Kukuryzka: folds 
matiko09: raises $0.63 to $1.13
el.suertero leaves the table
mycka86: raises $3.12 to $4.25
er13to: folds 
matiko09: folds 
Uncalled bet ($3.12) returned to mycka86
mycka86 collected $3.46 from pot
*** SUMMARY ***
Total pot $3.46 | Rake $0 
Seat 2: matiko09 (button) folded before Flop
Seat 3: mycka86 (small blind) collected ($3.46)
Seat 5: er13to (big blind) folded before Flop
Seat 6: Franky77200 folded before Flop (didn't bet)
Seat 7: el.suertero folded before Flop (didn't bet)
Seat 8: fudzi folded before Flop (didn't bet)
Seat 9: Kukuryzka folded before Flop (didn't bet)





PokerStars Hand #155301742352:  Hold'em No Limit ($0.50/$1.00 USD) - 2016/06/28 16:32:47 CET [2016/06/28 10:32:47 ET]
Table 'Dorado II' 9-max Seat #3 is the button
Seat 1: f1reworks ($171.93 in chips) 
Seat 2: vanilica ($101.50 in chips) 
Seat 3: ghostriderxu ($64.42 in chips) 
Seat 4: pyromid ($113 in chips) 
Seat 5: KovIFish89 ($108.87 in chips) 
Seat 6: mycka86 ($108.24 in chips) 
Seat 7: matiko09 ($114.71 in chips) 
Seat 8: flk.Dasas ($182.89 in chips) 
Seat 9: r4mz3s ($104.17 in chips) 
pyromid: posts small blind $0.50
KovIFish89: posts big blind $1
*** HOLE CARDS ***
Dealt to matiko09 [Td 9c]
mycka86: folds 
matiko09: folds 
flk.Dasas: folds 
r4mz3s: folds 
f1reworks: folds 
vanilica: folds 
ghostriderxu: raises $2 to $3
pyromid: folds 
KovIFish89: folds 
Uncalled bet ($2) returned to ghostriderxu
ghostriderxu collected $2.50 from pot
ghostriderxu: doesn't show hand 
*** SUMMARY ***
Total pot $2.50 | Rake $0 
Seat 1: f1reworks folded before Flop (didn't bet)
Seat 2: vanilica folded before Flop (didn't bet)
Seat 3: ghostriderxu (button) collected ($2.50)
Seat 4: pyromid (small blind) folded before Flop
Seat 5: KovIFish89 (big blind) folded before Flop
Seat 6: mycka86 folded before Flop (didn't bet)
Seat 7: matiko09 folded before Flop (didn't bet)
Seat 8: flk.Dasas folded before Flop (didn't bet)
Seat 9: r4mz3s folded before Flop (didn't bet)





PokerStars Hand #155301743454:  Hold'em No Limit ($0.25/$0.50 USD) - 2016/06/28 16:32:49 CET [2016/06/28 10:32:49 ET]
Table 'Antonia II' 9-max Seat #5 is the button
Seat 5: 35LOBO35 ($26.07 in chips) 
Seat 6: matiko09 ($55.50 in chips) 
Seat 7: Kukuryzka ($54.66 in chips) 
app1e_j@ck joins the table at seat #8 
matiko09: posts small blind $0.25
Kukuryzka: posts big blind $0.50
*** HOLE CARDS ***
Dealt to matiko09 [Qc 9c]
35LOBO35: folds 
matiko09: raises $1 to $1.50
Kukuryzka: folds 
Uncalled bet ($1) returned to matiko09
matiko09 collected $1 from pot
matiko09: doesn't show hand 
*** SUMMARY ***
Total pot $1 | Rake $0 
Seat 5: 35LOBO35 (button) folded before Flop (didn't bet)
Seat 6: matiko09 (small blind) collected ($1)
Seat 7: Kukuryzka (big blind) folded before Flop





PokerStars Hand #155301743393:  Hold'em No Limit ($0.50/$1.00 USD) - 2016/06/28 16:32:49 CET [2016/06/28 10:32:49 ET]
Table 'Lyyli II' 9-max Seat #5 is the button
Seat 1: tipner ($130.53 in chips) 
Seat 2: CI58 ($132.52 in chips) 
Seat 3: Racushniak ($100 in chips) 
Seat 4: Greha999 ($144.24 in chips) 
Seat 5: flk.Dasas ($101 in chips) 
Seat 6: matiko09 ($108.94 in chips) 
Seat 8: r4mz3s ($125.92 in chips) 
Seat 9: f1reworks ($100 in chips) 
matiko09: posts small blind $0.50
Kukuryzka: is sitting out 
r4mz3s: posts big blind $1
*** HOLE CARDS ***
Dealt to matiko09 [As 7d]
Kukuryzka leaves the table
f1reworks: folds 
tipner: raises $2 to $3
CI58: folds 
Racushniak: folds 
Greha999: calls $3
flk.Dasas: calls $3
mycka86 joins the table at seat #7 
matiko09: folds 
r4mz3s: folds 
*** FLOP *** [5c 2h 7s]
tipner: checks 
Greha999: checks 
flk.Dasas: bets $4.79
tipner: folds 
Greha999: raises $6.79 to $11.58
flk.Dasas: folds 
Uncalled bet ($6.79) returned to Greha999
Greha999 collected $19.08 from pot
*** SUMMARY ***
Total pot $20.08 | Rake $1 
Board [5c 2h 7s]
Seat 1: tipner folded on the Flop
Seat 2: CI58 folded before Flop (didn't bet)
Seat 3: Racushniak folded before Flop (didn't bet)
Seat 4: Greha999 collected ($19.08)
Seat 5: flk.Dasas (button) folded on the Flop
Seat 6: matiko09 (small blind) folded before Flop
Seat 8: r4mz3s (big blind) folded before Flop
Seat 9: f1reworks folded before Flop (didn't bet)





PokerStars Hand #155301748370:  Hold'em No Limit ($0.50/$1.00 USD) - 2016/06/28 16:32:58 CET [2016/06/28 10:32:58 ET]
Table 'Zerlina' 9-max Seat #3 is the button
Seat 1: arctur17 ($20.85 in chips) 
Seat 2: matiko09 ($100 in chips) 
Seat 3: Racushniak ($175.07 in chips) 
Seat 4: phil_cheng ($100 in chips) 
Seat 5: mycka86 ($101.50 in chips) 
Seat 6: sanpidk ($109.30 in chips) 
Seat 7: f1reworks ($271.92 in chips) 
Seat 8: Orga_060670 ($100 in chips) 
Seat 9: r4mz3s ($117.19 in chips) 
phil_cheng: posts small blind $0.50
mycka86: posts big blind $1
*** HOLE CARDS ***
Dealt to matiko09 [4s Jd]
sanpidk: folds 
f1reworks: folds 
Orga_060670: folds 
r4mz3s: folds 
arctur17: folds 
matiko09: folds 
Racushniak: raises $1.80 to $2.80
phil_cheng: folds 
mycka86: calls $1.80
*** FLOP *** [7h Ts Ks]
mycka86: checks 
Racushniak: checks 
*** TURN *** [7h Ts Ks] [9h]
mycka86: checks 
Racushniak: checks 
*** RIVER *** [7h Ts Ks 9h] [3h]
mycka86: bets $8
Racushniak: folds 
Uncalled bet ($8) returned to mycka86
mycka86 collected $5.80 from pot
*** SUMMARY ***
Total pot $6.10 | Rake $0.30 
Board [7h Ts Ks 9h 3h]
Seat 1: arctur17 folded before Flop (didn't bet)
Seat 2: matiko09 folded before Flop (didn't bet)
Seat 3: Racushniak (button) folded on the River
Seat 4: phil_cheng (small blind) folded before Flop
Seat 5: mycka86 (big blind) collected ($5.80)
Seat 6: sanpidk folded before Flop (didn't bet)
Seat 7: f1reworks folded before Flop (didn't bet)
Seat 8: Orga_060670 folded before Flop (didn't bet)
Seat 9: r4mz3s folded before Flop (didn't bet)





PokerStars Hand #155301751145:  Hold'em No Limit ($0.50/$1.00 USD) - 2016/06/28 16:33:03 CET [2016/06/28 10:33:03 ET]
Table 'Tomita' 9-max Seat #5 is the button
Seat 1: CI58 ($100 in chips) 
Seat 2: vanilica ($103.72 in chips) 
Seat 3: r4mz3s ($100 in chips) 
Seat 4: f1reworks ($121.07 in chips) 
Seat 5: ANDY19911608 ($173.18 in chips) 
Seat 6: tipner ($100 in chips) 
Seat 7: matiko09 ($123.62 in chips) 
Seat 8: myatiy 96 ($218.50 in chips) 
Seat 9: sanpidk ($142.39 in chips) 
tipner: posts small blind $0.50
matiko09: posts big blind $1
*** HOLE CARDS ***
Dealt to matiko09 [Kh Qc]
myatiy 96: folds 
sanpidk: folds 
CI58: raises $2 to $3
vanilica: folds 
r4mz3s: folds 
f1reworks: folds 
ANDY19911608: folds 
tipner: folds 
matiko09: folds 
Uncalled bet ($2) returned to CI58
CI58 collected $2.50 from pot
*** SUMMARY ***
Total pot $2.50 | Rake $0 
Seat 1: CI58 collected ($2.50)
Seat 2: vanilica folded before Flop (didn't bet)
Seat 3: r4mz3s folded before Flop (didn't bet)
Seat 4: f1reworks folded before Flop (didn't bet)
Seat 5: ANDY19911608 (button) folded before Flop (didn't bet)
Seat 6: tipner (small blind) folded before Flop
Seat 7: matiko09 (big blind) folded before Flop
Seat 8: myatiy 96 folded before Flop (didn't bet)
Seat 9: sanpidk folded before Flop (didn't bet)





PokerStars Hand #155301750602:  Hold'em No Limit ($0.25/$0.50 USD) - 2016/06/28 16:33:03 CET [2016/06/28 10:33:03 ET]
Table 'Antonia II' 9-max Seat #6 is the button
Seat 5: 35LOBO35 ($26.07 in chips) 
Seat 6: matiko09 ($56 in chips) 
Seat 7: Kukuryzka ($54.16 in chips) 
Seat 8: app1e_j@ck ($52.54 in chips) 
Kukuryzka: posts small blind $0.25
Domotirko228 joins the table at seat #9 
app1e_j@ck: posts big blind $0.50
*** HOLE CARDS ***
Dealt to matiko09 [8d 6h]
el.suertero joins the table at seat #4 
35LOBO35: raises $1 to $1.50
matiko09: folds 
Kukuryzka: folds 
app1e_j@ck: folds 
Uncalled bet ($1) returned to 35LOBO35
35LOBO35 collected $1.25 from pot
35LOBO35: doesn't show hand 
*** SUMMARY ***
Total pot $1.25 | Rake $0 
Seat 5: 35LOBO35 collected ($1.25)
Seat 6: matiko09 (button) folded before Flop (didn't bet)
Seat 7: Kukuryzka (small blind) folded before Flop
Seat 8: app1e_j@ck (big blind) folded before Flop





PokerStars Hand #155301758007:  Hold'em No Limit ($0.25/$0.50 USD) - 2016/06/28 16:33:16 CET [2016/06/28 10:33:16 ET]
Table 'Antonia II' 9-max Seat #7 is the button
Seat 5: 35LOBO35 ($26.82 in chips) 
Seat 6: matiko09 ($56 in chips) 
Seat 7: Kukuryzka ($53.91 in chips) 
Seat 8: app1e_j@ck ($52.04 in chips) 
Seat 9: Domotirko228 ($50 in chips) 
app1e_j@ck: posts small blind $0.25
Domotirko228: posts big blind $0.50
el.suertero: sits out 
*** HOLE CARDS ***
Dealt to matiko09 [7d Th]
35LOBO35: calls $0.50
matiko09: folds 
Kukuryzka: folds 
mabbiche_007 joins the table at seat #2 
app1e_j@ck: folds 
er13to joins the table at seat #1 
Domotirko228: checks 
*** FLOP *** [6d 3h 9s]
Domotirko228: checks 
35LOBO35: checks 
*** TURN *** [6d 3h 9s] [6h]
mabbiche_007 leaves the table
Domotirko228: checks 
myatiy 96 joins the table at seat #2 
35LOBO35: checks 
*** RIVER *** [6d 3h 9s 6h] [5s]
Domotirko228: checks 
35LOBO35: checks 
*** SHOW DOWN ***
Domotirko228: shows [Kh 7s] (a pair of Sixes)
35LOBO35: mucks hand 
Domotirko228 collected $1.19 from pot
*** SUMMARY ***
Total pot $1.25 | Rake $0.06 
Board [6d 3h 9s 6h 5s]
Seat 5: 35LOBO35 mucked [7h Jd]
Seat 6: matiko09 folded before Flop (didn't bet)
Seat 7: Kukuryzka (button) folded before Flop (didn't bet)
Seat 8: app1e_j@ck (small blind) folded before Flop
Seat 9: Domotirko228 (big blind) showed [Kh 7s] and won ($1.19) with a pair of Sixes





PokerStars Hand #155301760592:  Hold'em No Limit ($0.50/$1.00 USD) - 2016/06/28 16:33:20 CET [2016/06/28 10:33:20 ET]
Table 'Dorado II' 9-max Seat #4 is the button
Seat 1: f1reworks ($171.93 in chips) 
Seat 2: vanilica ($101.50 in chips) 
Seat 3: ghostriderxu ($65.92 in chips) 
Seat 4: pyromid ($112.50 in chips) 
Seat 5: KovIFish89 ($107.87 in chips) 
Seat 6: mycka86 ($108.24 in chips) 
Seat 7: matiko09 ($114.71 in chips) 
Seat 8: flk.Dasas ($182.89 in chips) 
Seat 9: r4mz3s ($104.17 in chips) 
KovIFish89: posts small blind $0.50
mycka86: posts big blind $1
*** HOLE CARDS ***
Dealt to matiko09 [6c Qs]
matiko09: folds 
flk.Dasas: folds 
r4mz3s: folds 
f1reworks: folds 
vanilica: folds 
ghostriderxu: folds 
pyromid: folds 
KovIFish89: raises $2 to $3
mycka86: calls $2
*** FLOP *** [9d 4h 2s]
KovIFish89: bets $3
mycka86: folds 
Uncalled bet ($3) returned to KovIFish89
KovIFish89 collected $5.70 from pot
KovIFish89: doesn't show hand 
*** SUMMARY ***
Total pot $6 | Rake $0.30 
Board [9d 4h 2s]
Seat 1: f1reworks folded before Flop (didn't bet)
Seat 2: vanilica folded before Flop (didn't bet)
Seat 3: ghostriderxu folded before Flop (didn't bet)
Seat 4: pyromid (button) folded before Flop (didn't bet)
Seat 5: KovIFish89 (small blind) collected ($5.70)
Seat 6: mycka86 (big blind) folded on the Flop
Seat 7: matiko09 folded before Flop (didn't bet)
Seat 8: flk.Dasas folded before Flop (didn't bet)
Seat 9: r4mz3s folded before Flop (didn't bet)





PokerStars Hand #155301766161:  Hold'em No Limit ($0.50/$1.00 USD) - 2016/06/28 16:33:31 CET [2016/06/28 10:33:31 ET]
Table 'Tomita' 9-max Seat #6 is the button
Seat 1: CI58 ($101.50 in chips) 
Seat 2: vanilica ($103.72 in chips) 
Seat 3: r4mz3s ($100 in chips) 
Seat 4: f1reworks ($121.07 in chips) 
Seat 5: ANDY19911608 ($173.18 in chips) 
Seat 6: tipner ($100 in chips) 
Seat 7: matiko09 ($122.62 in chips) 
Seat 9: sanpidk ($142.39 in chips) 
matiko09: posts small blind $0.50
myatiy 96: is sitting out 
sanpidk: posts big blind $1
*** HOLE CARDS ***
Dealt to matiko09 [8d 8s]
CI58: folds 
vanilica: folds 
r4mz3s: folds 
f1reworks: folds 
ANDY19911608: folds 
tipner: raises $1.50 to $2.50
myatiy 96 leaves the table
matiko09: raises $6.50 to $9
sanpidk: folds 
tipner: folds 
Uncalled bet ($6.50) returned to matiko09
matiko09 collected $6 from pot
matiko09: doesn't show hand 
*** SUMMARY ***
Total pot $6 | Rake $0 
Seat 1: CI58 folded before Flop (didn't bet)
Seat 2: vanilica folded before Flop (didn't bet)
Seat 3: r4mz3s folded before Flop (didn't bet)
Seat 4: f1reworks folded before Flop (didn't bet)
Seat 5: ANDY19911608 folded before Flop (didn't bet)
Seat 6: tipner (button) folded before Flop
Seat 7: matiko09 (small blind) collected ($6)
Seat 9: sanpidk (big blind) folded before Flop





PokerStars Hand #155301771292:  Hold'em No Limit ($0.50/$1.00 USD) - 2016/06/28 16:33:40 CET [2016/06/28 10:33:40 ET]
Table 'Anitra' 9-max Seat #3 is the button
Seat 1: Klappspaten0 ($100 in chips) 
Seat 3: facelessPPP ($96.65 in chips) 
Seat 4: Shakeelg ($152.65 in chips) 
Seat 5: er13to ($112.82 in chips) 
Seat 6: matiko09 ($107.50 in chips) 
Seat 8: yoshinoino ($33 in chips) 
Seat 9: chenconhaste ($100 in chips) 
Shakeelg: posts small blind $0.50
er13to: posts big blind $1
phil_cheng: sits out 
*** HOLE CARDS ***
Dealt to matiko09 [Ac 2d]
matiko09: folds 
yoshinoino: folds 
chenconhaste: folds 
Klappspaten0: folds 
facelessPPP: folds 
Shakeelg: calls $0.50
er13to: checks 
*** FLOP *** [2s Kh Ts]
Shakeelg: checks 
er13to: checks 
*** TURN *** [2s Kh Ts] [3c]
Shakeelg: checks 
er13to: checks 
*** RIVER *** [2s Kh Ts 3c] [Qh]
Shakeelg: checks 
er13to: checks 
*** SHOW DOWN ***
Shakeelg: shows [8h 9s] (high card King)
er13to: mucks hand 
Shakeelg collected $1.90 from pot
*** SUMMARY ***
Total pot $2 | Rake $0.10 
Board [2s Kh Ts 3c Qh]
Seat 1: Klappspaten0 folded before Flop (didn't bet)
Seat 3: facelessPPP (button) folded before Flop (didn't bet)
Seat 4: Shakeelg (small blind) showed [8h 9s] and won ($1.90) with high card King
Seat 5: er13to (big blind) mucked [6s 9h]
Seat 6: matiko09 folded before Flop (didn't bet)
Seat 8: yoshinoino folded before Flop (didn't bet)
Seat 9: chenconhaste folded before Flop (didn't bet)





PokerStars Hand #155301781932:  Hold'em No Limit ($0.50/$1.00 USD) - 2016/06/28 16:34:00 CET [2016/06/28 10:34:00 ET]
Table 'Zerlina' 9-max Seat #4 is the button
Seat 1: arctur17 ($20.85 in chips) 
Seat 2: matiko09 ($100 in chips) 
Seat 3: Racushniak ($172.27 in chips) 
Seat 4: phil_cheng ($100 in chips) 
Seat 5: mycka86 ($104.50 in chips) 
Seat 6: sanpidk ($109.30 in chips) 
Seat 7: f1reworks ($271.92 in chips) 
Seat 8: Orga_060670 ($100 in chips) 
Seat 9: r4mz3s ($117.19 in chips) 
mycka86: posts small blind $0.50
sanpidk: posts big blind $1
*** HOLE CARDS ***
Dealt to matiko09 [9c 7h]
f1reworks: folds 
Orga_060670: folds 
r4mz3s: folds 
arctur17: folds 
matiko09: folds 
Racushniak: folds 
phil_cheng: folds 
mycka86: raises $1.75 to $2.75
sanpidk: calls $1.75
*** FLOP *** [Qd Th Tc]
mycka86: checks 
sanpidk: checks 
*** TURN *** [Qd Th Tc] [2c]
mycka86: bets $3.50
sanpidk: folds 
Uncalled bet ($3.50) returned to mycka86
mycka86 collected $5.22 from pot
*** SUMMARY ***
Total pot $5.50 | Rake $0.28 
Board [Qd Th Tc 2c]
Seat 1: arctur17 folded before Flop (didn't bet)
Seat 2: matiko09 folded before Flop (didn't bet)
Seat 3: Racushniak folded before Flop (didn't bet)
Seat 4: phil_cheng (button) folded before Flop (didn't bet)
Seat 5: mycka86 (small blind) collected ($5.22)
Seat 6: sanpidk (big blind) folded on the Turn
Seat 7: f1reworks folded before Flop (didn't bet)
Seat 8: Orga_060670 folded before Flop (didn't bet)
Seat 9: r4mz3s folded before Flop (didn't bet)





PokerStars Hand #155301782338:  Hold'em No Limit ($0.50/$1.00 USD) - 2016/06/28 16:34:00 CET [2016/06/28 10:34:00 ET]
Table 'Tomita' 9-max Seat #7 is the button
Seat 1: CI58 ($101.50 in chips) 
Seat 2: vanilica ($103.72 in chips) 
Seat 3: r4mz3s ($100 in chips) 
Seat 4: f1reworks ($121.07 in chips) 
Seat 5: ANDY19911608 ($173.18 in chips) 
Seat 6: tipner ($100 in chips) 
Seat 7: matiko09 ($126.12 in chips) 
Seat 9: sanpidk ($141.39 in chips) 
sanpidk: posts small blind $0.50
CI58: posts big blind $1
*** HOLE CARDS ***
Dealt to matiko09 [7h 3h]
vanilica: folds 
r4mz3s: folds 
f1reworks: folds 
ANDY19911608: calls $1
tipner: folds 
matiko09: folds 
sanpidk: raises $4 to $5
CI58: folds 
ANDY19911608: folds 
Uncalled bet ($4) returned to sanpidk
sanpidk collected $3 from pot
sanpidk: doesn't show hand 
*** SUMMARY ***
Total pot $3 | Rake $0 
Seat 1: CI58 (big blind) folded before Flop
Seat 2: vanilica folded before Flop (didn't bet)
Seat 3: r4mz3s folded before Flop (didn't bet)
Seat 4: f1reworks folded before Flop (didn't bet)
Seat 5: ANDY19911608 folded before Flop
Seat 6: tipner folded before Flop (didn't bet)
Seat 7: matiko09 (button) folded before Flop (didn't bet)
Seat 9: sanpidk (small blind) collected ($3)





PokerStars Hand #155301784381:  Hold'em No Limit ($0.50/$1.00 USD) - 2016/06/28 16:34:04 CET [2016/06/28 10:34:04 ET]
Table 'Dorado II' 9-max Seat #5 is the button
Seat 1: f1reworks ($171.93 in chips) 
Seat 2: vanilica ($101.50 in chips) 
Seat 3: ghostriderxu ($65.92 in chips) 
Seat 4: pyromid ($112.50 in chips) 
Seat 5: KovIFish89 ($110.57 in chips) 
Seat 6: mycka86 ($105.24 in chips) 
Seat 7: matiko09 ($114.71 in chips) 
Seat 8: flk.Dasas ($182.89 in chips) 
Seat 9: r4mz3s ($104.17 in chips) 
mycka86: posts small blind $0.50
matiko09: posts big blind $1
*** HOLE CARDS ***
Dealt to matiko09 [Ts 2d]
flk.Dasas: folds 
r4mz3s: raises $2 to $3
f1reworks: folds 
vanilica: folds 
ghostriderxu: folds 
pyromid: folds 
KovIFish89: folds 
mycka86: folds 
matiko09: folds 
Uncalled bet ($2) returned to r4mz3s
r4mz3s collected $2.50 from pot
r4mz3s: doesn't show hand 
*** SUMMARY ***
Total pot $2.50 | Rake $0 
Seat 1: f1reworks folded before Flop (didn't bet)
Seat 2: vanilica folded before Flop (didn't bet)
Seat 3: ghostriderxu folded before Flop (didn't bet)
Seat 4: pyromid folded before Flop (didn't bet)
Seat 5: KovIFish89 (button) folded before Flop (didn't bet)
Seat 6: mycka86 (small blind) folded before Flop
Seat 7: matiko09 (big blind) folded before Flop
Seat 8: flk.Dasas folded before Flop (didn't bet)
Seat 9: r4mz3s collected ($2.50)





PokerStars Hand #155301785555:  Hold'em No Limit ($0.50/$1.00 USD) - 2016/06/28 16:34:06 CET [2016/06/28 10:34:06 ET]
Table 'Lyyli II' 9-max Seat #6 is the button
Seat 1: tipner ($127.53 in chips) 
Seat 2: CI58 ($132.52 in chips) 
Seat 3: Racushniak ($100 in chips) 
Seat 4: Greha999 ($155.53 in chips) 
Seat 5: flk.Dasas ($100 in chips) 
Seat 6: matiko09 ($108.44 in chips) 
Seat 8: r4mz3s ($124.92 in chips) 
Seat 9: f1reworks ($100 in chips) 
mycka86 will be allowed to play after the button
r4mz3s: posts small blind $0.50
f1reworks: posts big blind $1
*** HOLE CARDS ***
Dealt to matiko09 [7d 2h]
tipner: raises $2 to $3
CI58: folds 
Racushniak: folds 
Greha999: calls $3
flk.Dasas: folds 
matiko09: folds 
r4mz3s: folds 
f1reworks: calls $2
*** FLOP *** [7h 6c 6s]
f1reworks: checks 
tipner: checks 
Greha999: bets $7
f1reworks: calls $7
tipner: folds 
*** TURN *** [7h 6c 6s] [5s]
f1reworks: checks 
Greha999: bets $11
f1reworks: calls $11
*** RIVER *** [7h 6c 6s 5s] [As]
f1reworks: checks 
Greha999: bets $22
f1reworks: folds 
Uncalled bet ($22) returned to Greha999
Greha999 collected $43.22 from pot
*** SUMMARY ***
Total pot $45.50 | Rake $2.28 
Board [7h 6c 6s 5s As]
Seat 1: tipner folded on the Flop
Seat 2: CI58 folded before Flop (didn't bet)
Seat 3: Racushniak folded before Flop (didn't bet)
Seat 4: Greha999 collected ($43.22)
Seat 5: flk.Dasas folded before Flop (didn't bet)
Seat 6: matiko09 (button) folded before Flop (didn't bet)
Seat 8: r4mz3s (small blind) folded before Flop
Seat 9: f1reworks (big blind) folded on the River





PokerStars Hand #155301792934:  Hold'em No Limit ($0.50/$1.00 USD) - 2016/06/28 16:34:19 CET [2016/06/28 10:34:19 ET]
Table 'Anitra' 9-max Seat #4 is the button
Seat 1: Klappspaten0 ($100 in chips) 
Seat 3: facelessPPP ($96.65 in chips) 
Seat 4: Shakeelg ($153.55 in chips) 
Seat 5: er13to ($111.82 in chips) 
Seat 6: matiko09 ($107.50 in chips) 
Seat 8: yoshinoino ($33 in chips) 
Seat 9: chenconhaste ($100 in chips) 
er13to: posts small blind $0.50
matiko09: posts big blind $1
phil_cheng: sits out 
*** HOLE CARDS ***
Dealt to matiko09 [4d 3h]
yoshinoino: folds 
chenconhaste: raises $1.25 to $2.25
Klappspaten0: calls $2.25
facelessPPP: folds 
Shakeelg: folds 
er13to: folds 
matiko09: folds 
*** FLOP *** [3s 5s 6d]
chenconhaste: checks 
Klappspaten0: bets $4
chenconhaste: folds 
Uncalled bet ($4) returned to Klappspaten0
Klappspaten0 collected $5.70 from pot
Klappspaten0: doesn't show hand 
*** SUMMARY ***
Total pot $6 | Rake $0.30 
Board [3s 5s 6d]
Seat 1: Klappspaten0 collected ($5.70)
Seat 3: facelessPPP folded before Flop (didn't bet)
Seat 4: Shakeelg (button) folded before Flop (didn't bet)
Seat 5: er13to (small blind) folded before Flop
Seat 6: matiko09 (big blind) folded before Flop
Seat 8: yoshinoino folded before Flop (didn't bet)
Seat 9: chenconhaste folded on the Flop





PokerStars Hand #155301794102:  Hold'em No Limit ($0.25/$0.50 USD) - 2016/06/28 16:34:21 CET [2016/06/28 10:34:21 ET]
Table 'Antonia II' 9-max Seat #8 is the button
Seat 1: er13to ($50 in chips) 
Seat 5: 35LOBO35 ($26.32 in chips) 
Seat 6: matiko09 ($56 in chips) 
Seat 7: Kukuryzka ($53.91 in chips) 
Seat 8: app1e_j@ck ($51.79 in chips) 
Seat 9: Domotirko228 ($50.69 in chips) 
Domotirko228: posts small blind $0.25
er13to: posts big blind $0.50
myatiy 96: sits out 
el.suertero: sits out 
*** HOLE CARDS ***
Dealt to matiko09 [Kh 3h]
35LOBO35: folds 
matiko09: folds 
Kukuryzka: raises $0.75 to $1.25
app1e_j@ck: folds 
Domotirko228: folds 
er13to: folds 
Uncalled bet ($0.75) returned to Kukuryzka
Kukuryzka collected $1.25 from pot
Kukuryzka: doesn't show hand 
*** SUMMARY ***
Total pot $1.25 | Rake $0 
Seat 1: er13to (big blind) folded before Flop
Seat 5: 35LOBO35 folded before Flop (didn't bet)
Seat 6: matiko09 folded before Flop (didn't bet)
Seat 7: Kukuryzka collected ($1.25)
Seat 8: app1e_j@ck (button) folded before Flop (didn't bet)
Seat 9: Domotirko228 (small blind) folded before Flop





PokerStars Hand #155301798513:  Hold'em No Limit ($0.50/$1.00 USD) - 2016/06/28 16:34:29 CET [2016/06/28 10:34:29 ET]
Table 'Dorado II' 9-max Seat #6 is the button
Seat 1: f1reworks ($171.93 in chips) 
Seat 2: vanilica ($101.50 in chips) 
Seat 3: ghostriderxu ($65.92 in chips) 
Seat 4: pyromid ($112.50 in chips) 
Seat 5: KovIFish89 ($110.57 in chips) 
Seat 6: mycka86 ($104.74 in chips) 
Seat 7: matiko09 ($113.71 in chips) 
Seat 8: flk.Dasas ($182.89 in chips) 
Seat 9: r4mz3s ($105.67 in chips) 
matiko09: posts small blind $0.50
flk.Dasas: posts big blind $1
*** HOLE CARDS ***
Dealt to matiko09 [Qs 8d]
r4mz3s: raises $2 to $3
f1reworks: calls $3
vanilica: folds 
ghostriderxu: folds 
pyromid: folds 
KovIFish89: folds 
mycka86: folds 
matiko09: folds 
flk.Dasas: folds 
*** FLOP *** [Qh Th 8h]
r4mz3s: bets $5
f1reworks: folds 
Uncalled bet ($5) returned to r4mz3s
r4mz3s collected $7.12 from pot
r4mz3s: doesn't show hand 
*** SUMMARY ***
Total pot $7.50 | Rake $0.38 
Board [Qh Th 8h]
Seat 1: f1reworks folded on the Flop
Seat 2: vanilica folded before Flop (didn't bet)
Seat 3: ghostriderxu folded before Flop (didn't bet)
Seat 4: pyromid folded before Flop (didn't bet)
Seat 5: KovIFish89 folded before Flop (didn't bet)
Seat 6: mycka86 (button) folded before Flop (didn't bet)
Seat 7: matiko09 (small blind) folded before Flop
Seat 8: flk.Dasas (big blind) folded before Flop
Seat 9: r4mz3s collected ($7.12)





PokerStars Hand #155301799483:  Hold'em No Limit ($0.50/$1.00 USD) - 2016/06/28 16:34:31 CET [2016/06/28 10:34:31 ET]
Table 'Tomita' 9-max Seat #9 is the button
Seat 1: CI58 ($100.50 in chips) 
Seat 2: vanilica ($103.72 in chips) 
Seat 3: r4mz3s ($100 in chips) 
Seat 4: f1reworks ($121.07 in chips) 
Seat 5: ANDY19911608 ($172.18 in chips) 
Seat 6: tipner ($100 in chips) 
Seat 7: matiko09 ($126.12 in chips) 
Seat 9: sanpidk ($143.39 in chips) 
CI58: posts small blind $0.50
vanilica: posts big blind $1
*** HOLE CARDS ***
Dealt to matiko09 [9h Ah]
r4mz3s: folds 
f1reworks: folds 
ANDY19911608: calls $1
Noob0Saibot joins the table at seat #8 
tipner has timed out
tipner: folds 
matiko09: raises $3 to $4
sanpidk: folds 
CI58: folds 
vanilica: folds 
ANDY19911608: calls $3
*** FLOP *** [Ad Qc 4s]
ANDY19911608: bets $1
matiko09: calls $1
*** TURN *** [Ad Qc 4s] [2h]
ANDY19911608: bets $4
matiko09: calls $4
*** RIVER *** [Ad Qc 4s 2h] [9c]
ANDY19911608: bets $12
matiko09: raises $15 to $27
ANDY19911608: folds 
Uncalled bet ($15) returned to matiko09
matiko09 collected $41.32 from pot
matiko09: doesn't show hand 
*** SUMMARY ***
Total pot $43.50 | Rake $2.18 
Board [Ad Qc 4s 2h 9c]
Seat 1: CI58 (small blind) folded before Flop
Seat 2: vanilica (big blind) folded before Flop
Seat 3: r4mz3s folded before Flop (didn't bet)
Seat 4: f1reworks folded before Flop (didn't bet)
Seat 5: ANDY19911608 folded on the River
Seat 6: tipner folded before Flop (didn't bet)
Seat 7: matiko09 collected ($41.32)
Seat 9: sanpidk (button) folded before Flop (didn't bet)





PokerStars Hand #155301806656:  Hold'em No Limit ($0.25/$0.50 USD) - 2016/06/28 16:34:44 CET [2016/06/28 10:34:44 ET]
Table 'Antonia II' 9-max Seat #9 is the button
Seat 1: er13to ($50 in chips) 
Seat 2: myatiy 96 ($55.46 in chips) 
Seat 5: 35LOBO35 ($26.32 in chips) 
Seat 6: matiko09 ($56 in chips) 
Seat 7: Kukuryzka ($54.66 in chips) 
Seat 8: app1e_j@ck ($51.79 in chips) 
Seat 9: Domotirko228 ($50.44 in chips) 
er13to: posts small blind $0.25
myatiy 96: posts big blind $0.50
el.suertero: sits out 
*** HOLE CARDS ***
Dealt to matiko09 [7d 3c]
35LOBO35: calls $0.50
matiko09: folds 
Kukuryzka: folds 
app1e_j@ck: folds 
Domotirko228: folds 
er13to: folds 
myatiy 96: checks 
*** FLOP *** [As 6d 3d]
myatiy 96: checks 
35LOBO35: checks 
*** TURN *** [As 6d 3d] [2d]
myatiy 96: checks 
35LOBO35: bets $1.19
myatiy 96: calls $1.19
*** RIVER *** [As 6d 3d 2d] [9h]
myatiy 96: checks 
35LOBO35: bets $3.45
myatiy 96: folds 
Uncalled bet ($3.45) returned to 35LOBO35
35LOBO35 collected $3.45 from pot
35LOBO35: doesn't show hand 
*** SUMMARY ***
Total pot $3.63 | Rake $0.18 
Board [As 6d 3d 2d 9h]
Seat 1: er13to (small blind) folded before Flop
Seat 2: myatiy 96 (big blind) folded on the River
Seat 5: 35LOBO35 collected ($3.45)
Seat 6: matiko09 folded before Flop (didn't bet)
Seat 7: Kukuryzka folded before Flop (didn't bet)
Seat 8: app1e_j@ck folded before Flop (didn't bet)
Seat 9: Domotirko228 (button) folded before Flop (didn't bet)





PokerStars Hand #155301811872:  Hold'em No Limit ($0.50/$1.00 USD) - 2016/06/28 16:34:54 CET [2016/06/28 10:34:54 ET]
Table 'Anitra' 9-max Seat #5 is the button
Seat 1: Klappspaten0 ($103.45 in chips) 
Seat 3: facelessPPP ($96.65 in chips) 
Seat 4: Shakeelg ($153.55 in chips) 
Seat 5: er13to ($111.32 in chips) 
Seat 6: matiko09 ($106.50 in chips) 
Seat 7: phil_cheng ($100 in chips) 
Seat 8: yoshinoino ($33 in chips) 
Seat 9: chenconhaste ($100 in chips) 
matiko09: posts small blind $0.50
phil_cheng: posts big blind $1
*** HOLE CARDS ***
Dealt to matiko09 [8d 6c]
yoshinoino: folds 
chenconhaste: folds 
Klappspaten0: raises $2 to $3
facelessPPP: folds 
Shakeelg: folds 
er13to: folds 
matiko09: folds 
phil_cheng: folds 
Uncalled bet ($2) returned to Klappspaten0
Klappspaten0 collected $2.50 from pot
Klappspaten0: doesn't show hand 
*** SUMMARY ***
Total pot $2.50 | Rake $0 
Seat 1: Klappspaten0 collected ($2.50)
Seat 3: facelessPPP folded before Flop (didn't bet)
Seat 4: Shakeelg folded before Flop (didn't bet)
Seat 5: er13to (button) folded before Flop (didn't bet)
Seat 6: matiko09 (small blind) folded before Flop
Seat 7: phil_cheng (big blind) folded before Flop
Seat 8: yoshinoino folded before Flop (didn't bet)
Seat 9: chenconhaste folded before Flop (didn't bet)





PokerStars Hand #155301816946:  Hold'em No Limit ($0.50/$1.00 USD) - 2016/06/28 16:35:03 CET [2016/06/28 10:35:03 ET]
Table 'Zerlina' 9-max Seat #5 is the button
Seat 1: arctur17 ($20.85 in chips) 
Seat 2: matiko09 ($100 in chips) 
Seat 3: Racushniak ($172.27 in chips) 
Seat 4: phil_cheng ($100 in chips) 
Seat 5: mycka86 ($106.97 in chips) 
Seat 6: sanpidk ($106.55 in chips) 
Seat 7: f1reworks ($271.92 in chips) 
Seat 8: Orga_060670 ($100 in chips) 
Seat 9: r4mz3s ($117.19 in chips) 
sanpidk: posts small blind $0.50
f1reworks: posts big blind $1
*** HOLE CARDS ***
Dealt to matiko09 [8d Ts]
Orga_060670: folds 
r4mz3s: folds 
arctur17: folds 
matiko09: folds 
Racushniak: folds 
phil_cheng: raises $2 to $3
mycka86: folds 
sanpidk: calls $2.50
f1reworks: folds 
*** FLOP *** [6c Qc Kd]
sanpidk: checks 
phil_cheng: checks 
*** TURN *** [6c Qc Kd] [9s]
sanpidk: bets $4.50
phil_cheng: folds 
Uncalled bet ($4.50) returned to sanpidk
sanpidk collected $6.65 from pot
sanpidk: doesn't show hand 
*** SUMMARY ***
Total pot $7 | Rake $0.35 
Board [6c Qc Kd 9s]
Seat 1: arctur17 folded before Flop (didn't bet)
Seat 2: matiko09 folded before Flop (didn't bet)
Seat 3: Racushniak folded before Flop (didn't bet)
Seat 4: phil_cheng folded on the Turn
Seat 5: mycka86 (button) folded before Flop (didn't bet)
Seat 6: sanpidk (small blind) collected ($6.65)
Seat 7: f1reworks (big blind) folded before Flop
Seat 8: Orga_060670 folded before Flop (didn't bet)
Seat 9: r4mz3s folded before Flop (didn't bet)





PokerStars Hand #155301816647:  Hold'em No Limit ($0.50/$1.00 USD) - 2016/06/28 16:35:03 CET [2016/06/28 10:35:03 ET]
Table 'Dorado II' 9-max Seat #7 is the button
Seat 1: f1reworks ($168.93 in chips) 
Seat 2: vanilica ($101.50 in chips) 
Seat 3: ghostriderxu ($65.92 in chips) 
Seat 4: pyromid ($112.50 in chips) 
Seat 5: KovIFish89 ($110.57 in chips) 
Seat 6: mycka86 ($104.74 in chips) 
Seat 7: matiko09 ($113.21 in chips) 
Seat 8: flk.Dasas ($181.89 in chips) 
Seat 9: r4mz3s ($109.79 in chips) 
flk.Dasas: posts small blind $0.50
r4mz3s: posts big blind $1
*** HOLE CARDS ***
Dealt to matiko09 [6c 8h]
f1reworks: folds 
vanilica: folds 
ghostriderxu: folds 
pyromid: folds 
KovIFish89: folds 
mycka86: raises $1.10 to $2.10
matiko09: folds 
flk.Dasas: folds 
r4mz3s: folds 
Uncalled bet ($1.10) returned to mycka86
mycka86 collected $2.50 from pot
*** SUMMARY ***
Total pot $2.50 | Rake $0 
Seat 1: f1reworks folded before Flop (didn't bet)
Seat 2: vanilica folded before Flop (didn't bet)
Seat 3: ghostriderxu folded before Flop (didn't bet)
Seat 4: pyromid folded before Flop (didn't bet)
Seat 5: KovIFish89 folded before Flop (didn't bet)
Seat 6: mycka86 collected ($2.50)
Seat 7: matiko09 (button) folded before Flop (didn't bet)
Seat 8: flk.Dasas (small blind) folded before Flop
Seat 9: r4mz3s (big blind) folded before Flop





PokerStars Hand #155301832061:  Hold'em No Limit ($0.50/$1.00 USD) - 2016/06/28 16:35:28 CET [2016/06/28 10:35:28 ET]
Table 'Anitra' 9-max Seat #6 is the button
Seat 1: Klappspaten0 ($104.95 in chips) 
Seat 3: facelessPPP ($96.65 in chips) 
Seat 4: Shakeelg ($153.55 in chips) 
Seat 5: er13to ($111.32 in chips) 
Seat 6: matiko09 ($106 in chips) 
Seat 7: phil_cheng ($100 in chips) 
Seat 8: yoshinoino ($33 in chips) 
Seat 9: chenconhaste ($100 in chips) 
phil_cheng: posts small blind $0.50
yoshinoino: posts big blind $1
*** HOLE CARDS ***
Dealt to matiko09 [6h Kc]
chenconhaste: folds 
Klappspaten0: raises $2 to $3
facelessPPP: folds 
Shakeelg: calls $3
er13to: folds 
matiko09: folds 
phil_cheng: folds 
yoshinoino: folds 
*** FLOP *** [Ts 8s Ad]
Klappspaten0: bets $5
Shakeelg: calls $5
*** TURN *** [Ts 8s Ad] [Ah]
Klappspaten0: bets $12
Shakeelg: calls $12
*** RIVER *** [Ts 8s Ad Ah] [8c]
Klappspaten0: checks 
Shakeelg: bets $23
Klappspaten0: folds 
Uncalled bet ($23) returned to Shakeelg
Shakeelg collected $39.42 from pot
Shakeelg: doesn't show hand 
*** SUMMARY ***
Total pot $41.50 | Rake $2.08 
Board [Ts 8s Ad Ah 8c]
Seat 1: Klappspaten0 folded on the River
Seat 3: facelessPPP folded before Flop (didn't bet)
Seat 4: Shakeelg collected ($39.42)
Seat 5: er13to folded before Flop (didn't bet)
Seat 6: matiko09 (button) folded before Flop (didn't bet)
Seat 7: phil_cheng (small blind) folded before Flop
Seat 8: yoshinoino (big blind) folded before Flop
Seat 9: chenconhaste folded before Flop (didn't bet)





PokerStars Hand #155301833859:  Hold'em No Limit ($0.25/$0.50 USD) - 2016/06/28 16:35:31 CET [2016/06/28 10:35:31 ET]
Table 'Antonia II' 9-max Seat #1 is the button
Seat 1: er13to ($50 in chips) 
Seat 2: myatiy 96 ($53.77 in chips) 
Seat 4: el.suertero ($67.06 in chips) 
Seat 5: 35LOBO35 ($28.08 in chips) 
Seat 6: matiko09 ($56 in chips) 
Seat 7: Kukuryzka ($54.66 in chips) 
Seat 8: app1e_j@ck ($51.79 in chips) 
Seat 9: Domotirko228 ($50.44 in chips) 
myatiy 96: posts small blind $0.25
el.suertero: posts big blind $0.50
*** HOLE CARDS ***
Dealt to matiko09 [7d 6s]
35LOBO35: folds 
matiko09: folds 
Kukuryzka: folds 
app1e_j@ck: folds 
Domotirko228: folds 
er13to: raises $0.67 to $1.17
myatiy 96: raises $3.08 to $4.25
el.suertero: folds 
er13to: raises $6.50 to $10.75
myatiy 96: folds 
Uncalled bet ($6.50) returned to er13to
er13to collected $9 from pot
*** SUMMARY ***
Total pot $9 | Rake $0 
Seat 1: er13to (button) collected ($9)
Seat 2: myatiy 96 (small blind) folded before Flop
Seat 4: el.suertero (big blind) folded before Flop
Seat 5: 35LOBO35 folded before Flop (didn't bet)
Seat 6: matiko09 folded before Flop (didn't bet)
Seat 7: Kukuryzka folded before Flop (didn't bet)
Seat 8: app1e_j@ck folded before Flop (didn't bet)
Seat 9: Domotirko228 folded before Flop (didn't bet)





PokerStars Hand #155301843836:  Hold'em No Limit ($0.50/$1.00 USD) - 2016/06/28 16:35:49 CET [2016/06/28 10:35:49 ET]
Table 'Zerlina' 9-max Seat #6 is the button
Seat 1: arctur17 ($20.85 in chips) 
Seat 2: matiko09 ($100 in chips) 
Seat 3: Racushniak ($172.27 in chips) 
Seat 4: phil_cheng ($100 in chips) 
Seat 5: mycka86 ($106.97 in chips) 
Seat 6: sanpidk ($110.20 in chips) 
Seat 7: f1reworks ($270.92 in chips) 
Seat 8: Orga_060670 ($100 in chips) 
Seat 9: r4mz3s ($117.19 in chips) 
f1reworks: posts small blind $0.50
Orga_060670: posts big blind $1
*** HOLE CARDS ***
Dealt to matiko09 [5c Td]
r4mz3s: folds 
arctur17: folds 
matiko09: folds 
Racushniak: folds 
phil_cheng: raises $2 to $3
mycka86: folds 
sanpidk: folds 
f1reworks: folds 
Orga_060670: calls $2
*** FLOP *** [Kh Tc 9h]
Orga_060670: checks 
phil_cheng: bets $3.09
Orga_060670: folds 
Uncalled bet ($3.09) returned to phil_cheng
phil_cheng collected $6.18 from pot
phil_cheng: doesn't show hand 
*** SUMMARY ***
Total pot $6.50 | Rake $0.32 
Board [Kh Tc 9h]
Seat 1: arctur17 folded before Flop (didn't bet)
Seat 2: matiko09 folded before Flop (didn't bet)
Seat 3: Racushniak folded before Flop (didn't bet)
Seat 4: phil_cheng collected ($6.18)
Seat 5: mycka86 folded before Flop (didn't bet)
Seat 6: sanpidk (button) folded before Flop (didn't bet)
Seat 7: f1reworks (small blind) folded before Flop
Seat 8: Orga_060670 (big blind) folded on the Flop
Seat 9: r4mz3s folded before Flop (didn't bet)





PokerStars Hand #155301844370:  Hold'em No Limit ($0.50/$1.00 USD) - 2016/06/28 16:35:50 CET [2016/06/28 10:35:50 ET]
Table 'Dorado II' 9-max Seat #8 is the button
Seat 1: f1reworks ($168.93 in chips) 
Seat 2: vanilica ($101.50 in chips) 
Seat 3: ghostriderxu ($65.92 in chips) 
Seat 4: pyromid ($112.50 in chips) 
Seat 5: KovIFish89 ($110.57 in chips) 
Seat 6: mycka86 ($106.24 in chips) 
Seat 7: matiko09 ($113.21 in chips) 
Seat 8: flk.Dasas ($181.39 in chips) 
Seat 9: r4mz3s ($108.79 in chips) 
r4mz3s: posts small blind $0.50
f1reworks: posts big blind $1
*** HOLE CARDS ***
Dealt to matiko09 [7s Ac]
vanilica: folds 
ghostriderxu: folds 
pyromid: folds 
KovIFish89 has timed out
KovIFish89: folds 
mycka86: folds 
matiko09: folds 
flk.Dasas: folds 
r4mz3s: raises $2 to $3
f1reworks: folds 
Uncalled bet ($2) returned to r4mz3s
r4mz3s collected $2 from pot
r4mz3s: doesn't show hand 
*** SUMMARY ***
Total pot $2 | Rake $0 
Seat 1: f1reworks (big blind) folded before Flop
Seat 2: vanilica folded before Flop (didn't bet)
Seat 3: ghostriderxu folded before Flop (didn't bet)
Seat 4: pyromid folded before Flop (didn't bet)
Seat 5: KovIFish89 folded before Flop (didn't bet)
Seat 6: mycka86 folded before Flop (didn't bet)
Seat 7: matiko09 folded before Flop (didn't bet)
Seat 8: flk.Dasas (button) folded before Flop (didn't bet)
Seat 9: r4mz3s (small blind) collected ($2)





PokerStars Hand #155301849486:  Hold'em No Limit ($0.50/$1.00 USD) - 2016/06/28 16:36:00 CET [2016/06/28 10:36:00 ET]
Table 'Tomita' 9-max Seat #1 is the button
Seat 1: CI58 ($100 in chips) 
Seat 2: vanilica ($102.72 in chips) 
Seat 3: r4mz3s ($100 in chips) 
Seat 4: f1reworks ($121.07 in chips) 
Seat 5: ANDY19911608 ($151.18 in chips) 
Seat 6: tipner ($100 in chips) 
Seat 7: matiko09 ($146.44 in chips) 
Seat 8: Noob0Saibot ($100 in chips) 
Seat 9: sanpidk ($143.39 in chips) 
vanilica: posts small blind $0.50
r4mz3s: posts big blind $1
Noob0Saibot: posts big blind $1
*** HOLE CARDS ***
Dealt to matiko09 [4h Tc]
f1reworks: folds 
ANDY19911608: folds 
tipner: folds 
matiko09: folds 
Noob0Saibot: raises $2 to $3
sanpidk: folds 
CI58: folds 
vanilica: folds 
r4mz3s: folds 
Uncalled bet ($2) returned to Noob0Saibot
Noob0Saibot collected $2.50 from pot
Noob0Saibot: doesn't show hand 
*** SUMMARY ***
Total pot $2.50 | Rake $0 
Seat 1: CI58 (button) folded before Flop (didn't bet)
Seat 2: vanilica (small blind) folded before Flop
Seat 3: r4mz3s (big blind) folded before Flop
Seat 4: f1reworks folded before Flop (didn't bet)
Seat 5: ANDY19911608 folded before Flop (didn't bet)
Seat 6: tipner folded before Flop (didn't bet)
Seat 7: matiko09 folded before Flop (didn't bet)
Seat 8: Noob0Saibot collected ($2.50)
Seat 9: sanpidk folded before Flop (didn't bet)





PokerStars Hand #155301856207:  Hold'em No Limit ($0.50/$1.00 USD) - 2016/06/28 16:36:12 CET [2016/06/28 10:36:12 ET]
Table 'Lyyli II' 9-max Seat #8 is the button
Seat 1: tipner ($124.53 in chips) 
Seat 2: CI58 ($132.52 in chips) 
Seat 3: Racushniak ($100 in chips) 
Seat 4: Greha999 ($177.75 in chips) 
Seat 5: flk.Dasas ($100 in chips) 
Seat 6: matiko09 ($108.44 in chips) 
Seat 8: r4mz3s ($124.42 in chips) 
Seat 9: f1reworks ($100 in chips) 
f1reworks: posts small blind $0.50
tipner: posts big blind $1
mycka86: sits out 
*** HOLE CARDS ***
Dealt to matiko09 [Ts Kh]
CI58: folds 
Racushniak: folds 
Greha999: folds 
flk.Dasas: folds 
matiko09: raises $1.50 to $2.50
r4mz3s: folds 
f1reworks: calls $2
tipner: folds 
*** FLOP *** [Ac Jh Th]
f1reworks: checks 
matiko09: checks 
*** TURN *** [Ac Jh Th] [5d]
f1reworks: bets $4
matiko09: calls $4
*** RIVER *** [Ac Jh Th 5d] [Js]
f1reworks: bets $8
matiko09: folds 
Uncalled bet ($8) returned to f1reworks
f1reworks collected $13.30 from pot
f1reworks: doesn't show hand 
*** SUMMARY ***
Total pot $14 | Rake $0.70 
Board [Ac Jh Th 5d Js]
Seat 1: tipner (big blind) folded before Flop
Seat 2: CI58 folded before Flop (didn't bet)
Seat 3: Racushniak folded before Flop (didn't bet)
Seat 4: Greha999 folded before Flop (didn't bet)
Seat 5: flk.Dasas folded before Flop (didn't bet)
Seat 6: matiko09 folded on the River
Seat 8: r4mz3s (button) folded before Flop (didn't bet)
Seat 9: f1reworks (small blind) collected ($13.30)





PokerStars Hand #155301866686:  Hold'em No Limit ($0.50/$1.00 USD) - 2016/06/28 16:36:31 CET [2016/06/28 10:36:31 ET]
Table 'Anitra' 9-max Seat #7 is the button
Seat 1: Klappspaten0 ($100 in chips) 
Seat 3: facelessPPP ($96.65 in chips) 
Seat 4: Shakeelg ($172.97 in chips) 
Seat 5: er13to ($111.32 in chips) 
Seat 6: matiko09 ($106 in chips) 
Seat 7: phil_cheng ($100 in chips) 
Seat 8: yoshinoino ($32 in chips) 
Seat 9: chenconhaste ($100 in chips) 
yoshinoino: posts small blind $0.50
chenconhaste: posts big blind $1
ardo888: sits out 
*** HOLE CARDS ***
Dealt to matiko09 [5d 4s]
Klappspaten0: folds 
facelessPPP: folds 
Shakeelg: raises $2 to $3
er13to: folds 
matiko09: folds 
phil_cheng: folds 
yoshinoino: folds 
chenconhaste: folds 
Uncalled bet ($2) returned to Shakeelg
Shakeelg collected $2.50 from pot
Shakeelg: doesn't show hand 
*** SUMMARY ***
Total pot $2.50 | Rake $0 
Seat 1: Klappspaten0 folded before Flop (didn't bet)
Seat 3: facelessPPP folded before Flop (didn't bet)
Seat 4: Shakeelg collected ($2.50)
Seat 5: er13to folded before Flop (didn't bet)
Seat 6: matiko09 folded before Flop (didn't bet)
Seat 7: phil_cheng (button) folded before Flop (didn't bet)
Seat 8: yoshinoino (small blind) folded before Flop
Seat 9: chenconhaste (big blind) folded before Flop





PokerStars Hand #155301868924:  Hold'em No Limit ($0.25/$0.50 USD) - 2016/06/28 16:36:35 CET [2016/06/28 10:36:35 ET]
Table 'Antonia II' 9-max Seat #2 is the button
Seat 1: er13to ($54.75 in chips) 
Seat 2: myatiy 96 ($50 in chips) 
Seat 4: el.suertero ($66.56 in chips) 
Seat 5: 35LOBO35 ($28.08 in chips) 
Seat 6: matiko09 ($56 in chips) 
Seat 7: Kukuryzka ($54.66 in chips) 
Seat 8: app1e_j@ck ($51.79 in chips) 
Seat 9: Domotirko228 ($50.44 in chips) 
el.suertero: posts small blind $0.25
35LOBO35: posts big blind $0.50
*** HOLE CARDS ***
Dealt to matiko09 [2c Qc]
matiko09: folds 
Kukuryzka: folds 
app1e_j@ck: folds 
Domotirko228: folds 
er13to: folds 
myatiy 96: raises $0.50 to $1
el.suertero: raises $3 to $4
35LOBO35: folds 
myatiy 96: folds 
Uncalled bet ($3) returned to el.suertero
el.suertero collected $2.50 from pot
el.suertero: doesn't show hand 
*** SUMMARY ***
Total pot $2.50 | Rake $0 
Seat 1: er13to folded before Flop (didn't bet)
Seat 2: myatiy 96 (button) folded before Flop
Seat 4: el.suertero (small blind) collected ($2.50)
Seat 5: 35LOBO35 (big blind) folded before Flop
Seat 6: matiko09 folded before Flop (didn't bet)
Seat 7: Kukuryzka folded before Flop (didn't bet)
Seat 8: app1e_j@ck folded before Flop (didn't bet)
Seat 9: Domotirko228 folded before Flop (didn't bet)





PokerStars Hand #155301870451:  Hold'em No Limit ($0.50/$1.00 USD) - 2016/06/28 16:36:38 CET [2016/06/28 10:36:38 ET]
Table 'Tomita' 9-max Seat #2 is the button
Seat 1: CI58 ($100 in chips) 
Seat 2: vanilica ($102.22 in chips) 
Seat 3: r4mz3s ($100 in chips) 
Seat 4: f1reworks ($121.07 in chips) 
Seat 5: ANDY19911608 ($151.18 in chips) 
Seat 6: tipner ($100 in chips) 
Seat 7: matiko09 ($146.44 in chips) 
Seat 8: Noob0Saibot ($101.50 in chips) 
Seat 9: sanpidk ($143.39 in chips) 
r4mz3s: posts small blind $0.50
f1reworks: posts big blind $1
*** HOLE CARDS ***
Dealt to matiko09 [Ad 9s]
ANDY19911608: calls $1
tipner: folds 
matiko09: folds 
Noob0Saibot: raises $3 to $4
sanpidk: folds 
CI58: calls $4
vanilica: folds 
r4mz3s: folds 
f1reworks: folds 
ANDY19911608: calls $3
*** FLOP *** [3s 9h Jc]
ANDY19911608: checks 
Noob0Saibot: bets $9.61
CI58: folds 
ANDY19911608: folds 
Uncalled bet ($9.61) returned to Noob0Saibot
Noob0Saibot collected $12.82 from pot
Noob0Saibot: doesn't show hand 
*** SUMMARY ***
Total pot $13.50 | Rake $0.68 
Board [3s 9h Jc]
Seat 1: CI58 folded on the Flop
Seat 2: vanilica (button) folded before Flop (didn't bet)
Seat 3: r4mz3s (small blind) folded before Flop
Seat 4: f1reworks (big blind) folded before Flop
Seat 5: ANDY19911608 folded on the Flop
Seat 6: tipner folded before Flop (didn't bet)
Seat 7: matiko09 folded before Flop (didn't bet)
Seat 8: Noob0Saibot collected ($12.82)
Seat 9: sanpidk folded before Flop (didn't bet)





PokerStars Hand #155301873815:  Hold'em No Limit ($0.50/$1.00 USD) - 2016/06/28 16:36:44 CET [2016/06/28 10:36:44 ET]
Table 'Dorado II' 9-max Seat #9 is the button
Seat 1: f1reworks ($167.93 in chips) 
Seat 2: vanilica ($101.50 in chips) 
Seat 3: ghostriderxu ($65.92 in chips) 
Seat 4: pyromid ($112.50 in chips) 
Seat 5: KovIFish89 ($110.57 in chips) 
Seat 6: mycka86 ($106.24 in chips) 
Seat 7: matiko09 ($113.21 in chips) 
Seat 8: flk.Dasas ($181.39 in chips) 
Seat 9: r4mz3s ($109.79 in chips) 
f1reworks: posts small blind $0.50
vanilica: posts big blind $1
*** HOLE CARDS ***
Dealt to matiko09 [6c Jh]
ghostriderxu: raises $1 to $2
pyromid: folds 
KovIFish89: folds 
mycka86: calls $2
matiko09: folds 
flk.Dasas: folds 
r4mz3s: raises $8 to $10
f1reworks: folds 
vanilica: folds 
ghostriderxu: calls $8
mycka86: folds 
*** FLOP *** [3s As Jc]
ghostriderxu: checks 
r4mz3s: bets $8.50
ghostriderxu: calls $8.50
*** TURN *** [3s As Jc] [9c]
ghostriderxu: checks 
r4mz3s: checks 
*** RIVER *** [3s As Jc 9c] [Ks]
ghostriderxu: checks 
r4mz3s: checks 
*** SHOW DOWN ***
ghostriderxu: shows [9d Jd] (two pair, Jacks and Nines)
r4mz3s: mucks hand 
ghostriderxu collected $38.48 from pot
*** SUMMARY ***
Total pot $40.50 | Rake $2.02 
Board [3s As Jc 9c Ks]
Seat 1: f1reworks (small blind) folded before Flop
Seat 2: vanilica (big blind) folded before Flop
Seat 3: ghostriderxu showed [9d Jd] and won ($38.48) with two pair, Jacks and Nines
Seat 4: pyromid folded before Flop (didn't bet)
Seat 5: KovIFish89 folded before Flop (didn't bet)
Seat 6: mycka86 folded before Flop
Seat 7: matiko09 folded before Flop (didn't bet)
Seat 8: flk.Dasas folded before Flop (didn't bet)
Seat 9: r4mz3s (button) mucked [Kd Qs]





PokerStars Hand #155301877186:  Hold'em No Limit ($0.50/$1.00 USD) - 2016/06/28 16:36:50 CET [2016/06/28 10:36:50 ET]
Table 'Anitra' 9-max Seat #8 is the button
Seat 1: Klappspaten0 ($100 in chips) 
Seat 3: facelessPPP ($96.65 in chips) 
Seat 4: Shakeelg ($174.47 in chips) 
Seat 5: er13to ($111.32 in chips) 
Seat 6: matiko09 ($106 in chips) 
Seat 7: phil_cheng ($100 in chips) 
Seat 8: yoshinoino ($31.50 in chips) 
Seat 9: chenconhaste ($100 in chips) 
chenconhaste: posts small blind $0.50
Klappspaten0: posts big blind $1
ardo888: sits out 
*** HOLE CARDS ***
Dealt to matiko09 [3s 7d]
facelessPPP: folds 
Shakeelg: raises $2 to $3
er13to: folds 
matiko09: folds 
phil_cheng: folds 
yoshinoino: folds 
chenconhaste: folds 
Klappspaten0: calls $2
*** FLOP *** [Ts Qs 8s]
Klappspaten0: checks 
Shakeelg: bets $3
Klappspaten0: raises $7 to $10
Shakeelg: folds 
Uncalled bet ($7) returned to Klappspaten0
Klappspaten0 collected $11.88 from pot
Klappspaten0: doesn't show hand 
*** SUMMARY ***
Total pot $12.50 | Rake $0.62 
Board [Ts Qs 8s]
Seat 1: Klappspaten0 (big blind) collected ($11.88)
Seat 3: facelessPPP folded before Flop (didn't bet)
Seat 4: Shakeelg folded on the Flop
Seat 5: er13to folded before Flop (didn't bet)
Seat 6: matiko09 folded before Flop (didn't bet)
Seat 7: phil_cheng folded before Flop (didn't bet)
Seat 8: yoshinoino (button) folded before Flop (didn't bet)
Seat 9: chenconhaste (small blind) folded before Flop





PokerStars Hand #155301882455:  Hold'em No Limit ($0.50/$1.00 USD) - 2016/06/28 16:37:00 CET [2016/06/28 10:37:00 ET]
Table 'Zerlina' 9-max Seat #7 is the button
Seat 1: arctur17 ($20.85 in chips) 
Seat 2: matiko09 ($100 in chips) 
Seat 3: Racushniak ($172.27 in chips) 
Seat 4: phil_cheng ($103.18 in chips) 
Seat 5: mycka86 ($106.97 in chips) 
Seat 6: sanpidk ($110.20 in chips) 
Seat 7: f1reworks ($270.42 in chips) 
Seat 8: Orga_060670 ($100 in chips) 
Seat 9: r4mz3s ($117.19 in chips) 
Orga_060670: posts small blind $0.50
r4mz3s: posts big blind $1
*** HOLE CARDS ***
Dealt to matiko09 [Ad 5d]
arctur17: folds 
matiko09: folds 
Racushniak: folds 
phil_cheng: folds 
mycka86: folds 
sanpidk: folds 
f1reworks: raises $1.10 to $2.10
Orga_060670: folds 
r4mz3s: raises $5.90 to $8
f1reworks: folds 
Uncalled bet ($5.90) returned to r4mz3s
r4mz3s collected $4.70 from pot
r4mz3s: doesn't show hand 
*** SUMMARY ***
Total pot $4.70 | Rake $0 
Seat 1: arctur17 folded before Flop (didn't bet)
Seat 2: matiko09 folded before Flop (didn't bet)
Seat 3: Racushniak folded before Flop (didn't bet)
Seat 4: phil_cheng folded before Flop (didn't bet)
Seat 5: mycka86 folded before Flop (didn't bet)
Seat 6: sanpidk folded before Flop (didn't bet)
Seat 7: f1reworks (button) folded before Flop
Seat 8: Orga_060670 (small blind) folded before Flop
Seat 9: r4mz3s (big blind) collected ($4.70)





PokerStars Hand #155301889641:  Hold'em No Limit ($0.50/$1.00 USD) - 2016/06/28 16:37:13 CET [2016/06/28 10:37:13 ET]
Table 'Lyyli II' 9-max Seat #9 is the button
Seat 1: tipner ($123.53 in chips) 
Seat 2: CI58 ($132.52 in chips) 
Seat 3: Racushniak ($100 in chips) 
Seat 4: Greha999 ($177.75 in chips) 
Seat 5: flk.Dasas ($100 in chips) 
Seat 6: matiko09 ($101.94 in chips) 
Seat 8: r4mz3s ($124.42 in chips) 
Seat 9: f1reworks ($106.80 in chips) 
tipner: posts small blind $0.50
CI58: posts big blind $1
mycka86: sits out 
*** HOLE CARDS ***
Dealt to matiko09 [Ks Jh]
Racushniak: folds 
Greha999: raises $1 to $2
flk.Dasas: folds 
matiko09: folds 
r4mz3s: folds 
f1reworks: folds 
tipner: folds 
CI58: folds 
Uncalled bet ($1) returned to Greha999
Greha999 collected $2.50 from pot
*** SUMMARY ***
Total pot $2.50 | Rake $0 
Seat 1: tipner (small blind) folded before Flop
Seat 2: CI58 (big blind) folded before Flop
Seat 3: Racushniak folded before Flop (didn't bet)
Seat 4: Greha999 collected ($2.50)
Seat 5: flk.Dasas folded before Flop (didn't bet)
Seat 6: matiko09 folded before Flop (didn't bet)
Seat 8: r4mz3s folded before Flop (didn't bet)
Seat 9: f1reworks (button) folded before Flop (didn't bet)





PokerStars Hand #155301891613:  Hold'em No Limit ($0.25/$0.50 USD) - 2016/06/28 16:37:16 CET [2016/06/28 10:37:16 ET]
Table 'Antonia II' 9-max Seat #4 is the button
Seat 1: er13to ($54.75 in chips) 
Seat 2: myatiy 96 ($50 in chips) 
Seat 4: el.suertero ($68.06 in chips) 
Seat 5: 35LOBO35 ($27.58 in chips) 
Seat 6: matiko09 ($56 in chips) 
Seat 7: Kukuryzka ($54.66 in chips) 
Seat 8: app1e_j@ck ($51.79 in chips) 
Seat 9: Domotirko228 ($50.44 in chips) 
35LOBO35: posts small blind $0.25
matiko09: posts big blind $0.50
*** HOLE CARDS ***
Dealt to matiko09 [Kh 3d]
Kukuryzka: raises $1 to $1.50
app1e_j@ck: folds 
Domotirko228: folds 
er13to: folds 
myatiy 96: folds 
el.suertero: folds 
35LOBO35: raises $1.50 to $3
matiko09: folds 
Kukuryzka: calls $1.50
*** FLOP *** [Ac Qd 2h]
35LOBO35: checks 
Kukuryzka: bets $3.09
35LOBO35: folds 
Uncalled bet ($3.09) returned to Kukuryzka
Kukuryzka collected $6.18 from pot
Kukuryzka: doesn't show hand 
*** SUMMARY ***
Total pot $6.50 | Rake $0.32 
Board [Ac Qd 2h]
Seat 1: er13to folded before Flop (didn't bet)
Seat 2: myatiy 96 folded before Flop (didn't bet)
Seat 4: el.suertero (button) folded before Flop (didn't bet)
Seat 5: 35LOBO35 (small blind) folded on the Flop
Seat 6: matiko09 (big blind) folded before Flop
Seat 7: Kukuryzka collected ($6.18)
Seat 8: app1e_j@ck folded before Flop (didn't bet)
Seat 9: Domotirko228 folded before Flop (didn't bet)





PokerStars Hand #155301897381:  Hold'em No Limit ($0.50/$1.00 USD) - 2016/06/28 16:37:27 CET [2016/06/28 10:37:27 ET]
Table 'Tomita' 9-max Seat #3 is the button
Seat 1: CI58 ($100 in chips) 
Seat 2: vanilica ($102.22 in chips) 
Seat 3: r4mz3s ($100 in chips) 
Seat 4: f1reworks ($120.07 in chips) 
Seat 5: ANDY19911608 ($147.18 in chips) 
Seat 6: tipner ($100 in chips) 
Seat 7: matiko09 ($146.44 in chips) 
Seat 8: Noob0Saibot ($110.32 in chips) 
Seat 9: sanpidk ($143.39 in chips) 
f1reworks: posts small blind $0.50
ANDY19911608: posts big blind $1
*** HOLE CARDS ***
Dealt to matiko09 [Qs 6h]
tipner: raises $2 to $3
matiko09: folds 
Noob0Saibot: folds 
sanpidk: folds 
CI58: folds 
vanilica: folds 
r4mz3s: folds 
f1reworks: folds 
ANDY19911608: folds 
Uncalled bet ($2) returned to tipner
tipner collected $2.50 from pot
tipner: doesn't show hand 
*** SUMMARY ***
Total pot $2.50 | Rake $0 
Seat 1: CI58 folded before Flop (didn't bet)
Seat 2: vanilica folded before Flop (didn't bet)
Seat 3: r4mz3s (button) folded before Flop (didn't bet)
Seat 4: f1reworks (small blind) folded before Flop
Seat 5: ANDY19911608 (big blind) folded before Flop
Seat 6: tipner collected ($2.50)
Seat 7: matiko09 folded before Flop (didn't bet)
Seat 8: Noob0Saibot folded before Flop (didn't bet)
Seat 9: sanpidk folded before Flop (didn't bet)





PokerStars Hand #155301900658:  Hold'em No Limit ($0.50/$1.00 USD) - 2016/06/28 16:37:33 CET [2016/06/28 10:37:33 ET]
Table 'Anitra' 9-max Seat #9 is the button
Seat 1: Klappspaten0 ($105.88 in chips) 
Seat 2: ardo888 ($100 in chips) 
Seat 3: facelessPPP ($96.65 in chips) 
Seat 4: Shakeelg ($168.47 in chips) 
Seat 5: er13to ($111.32 in chips) 
Seat 6: matiko09 ($106 in chips) 
Seat 7: phil_cheng ($100 in chips) 
Seat 8: yoshinoino ($31.50 in chips) 
Seat 9: chenconhaste ($100 in chips) 
Klappspaten0: posts small blind $0.50
ardo888: posts big blind $1
*** HOLE CARDS ***
Dealt to matiko09 [Kc 4c]
facelessPPP: raises $2 to $3
Shakeelg: folds 
er13to: calls $3
matiko09: folds 
phil_cheng: folds 
yoshinoino: folds 
chenconhaste: folds 
Klappspaten0: folds 
ardo888: folds 
*** FLOP *** [Ah 2c 3h]
facelessPPP: bets $4.12
er13to: calls $4.12
*** TURN *** [Ah 2c 3h] [6c]
facelessPPP: bets $8.95
er13to: folds 
Uncalled bet ($8.95) returned to facelessPPP
facelessPPP collected $14.95 from pot
facelessPPP: doesn't show hand 
*** SUMMARY ***
Total pot $15.74 | Rake $0.79 
Board [Ah 2c 3h 6c]
Seat 1: Klappspaten0 (small blind) folded before Flop
Seat 2: ardo888 (big blind) folded before Flop
Seat 3: facelessPPP collected ($14.95)
Seat 4: Shakeelg folded before Flop (didn't bet)
Seat 5: er13to folded on the Turn
Seat 6: matiko09 folded before Flop (didn't bet)
Seat 7: phil_cheng folded before Flop (didn't bet)
Seat 8: yoshinoino folded before Flop (didn't bet)
Seat 9: chenconhaste (button) folded before Flop (didn't bet)





PokerStars Hand #155301902694:  Hold'em No Limit ($0.50/$1.00 USD) - 2016/06/28 16:37:36 CET [2016/06/28 10:37:36 ET]
Table 'Lyyli II' 9-max Seat #1 is the button
Seat 1: tipner ($123.03 in chips) 
Seat 2: CI58 ($131.52 in chips) 
Seat 3: Racushniak ($100 in chips) 
Seat 4: Greha999 ($179.25 in chips) 
Seat 5: flk.Dasas ($100 in chips) 
Seat 6: matiko09 ($101.94 in chips) 
Seat 8: r4mz3s ($124.42 in chips) 
Seat 9: f1reworks ($106.80 in chips) 
CI58: posts small blind $0.50
Racushniak: posts big blind $1
mycka86: sits out 
*** HOLE CARDS ***
Dealt to matiko09 [Td 6d]
Greha999: folds 
flk.Dasas: folds 
matiko09: folds 
r4mz3s: folds 
f1reworks: raises $2 to $3
tipner: folds 
CI58: folds 
Racushniak: folds 
Uncalled bet ($2) returned to f1reworks
f1reworks collected $2.50 from pot
f1reworks: doesn't show hand 
*** SUMMARY ***
Total pot $2.50 | Rake $0 
Seat 1: tipner (button) folded before Flop (didn't bet)
Seat 2: CI58 (small blind) folded before Flop
Seat 3: Racushniak (big blind) folded before Flop
Seat 4: Greha999 folded before Flop (didn't bet)
Seat 5: flk.Dasas folded before Flop (didn't bet)
Seat 6: matiko09 folded before Flop (didn't bet)
Seat 8: r4mz3s folded before Flop (didn't bet)
Seat 9: f1reworks collected ($2.50)





PokerStars Hand #155301913298:  Hold'em No Limit ($0.50/$1.00 USD) - 2016/06/28 16:37:56 CET [2016/06/28 10:37:56 ET]
Table 'Zerlina' 9-max Seat #8 is the button
Seat 1: arctur17 ($20.85 in chips) 
Seat 2: matiko09 ($100 in chips) 
Seat 3: Racushniak ($172.27 in chips) 
Seat 4: phil_cheng ($103.18 in chips) 
Seat 5: mycka86 ($106.97 in chips) 
Seat 6: sanpidk ($110.20 in chips) 
Seat 7: f1reworks ($268.32 in chips) 
Seat 8: Orga_060670 ($99.50 in chips) 
Seat 9: r4mz3s ($119.79 in chips) 
r4mz3s: posts small blind $0.50
arctur17: posts big blind $1
*** HOLE CARDS ***
Dealt to matiko09 [2s Ah]
matiko09: folds 
Racushniak: folds 
phil_cheng: folds 
mycka86: folds 
sanpidk: folds 
f1reworks: folds 
Orga_060670: folds 
r4mz3s: folds 
Uncalled bet ($0.50) returned to arctur17
arctur17 collected $1 from pot
arctur17: doesn't show hand 
*** SUMMARY ***
Total pot $1 | Rake $0 
Seat 1: arctur17 (big blind) collected ($1)
Seat 2: matiko09 folded before Flop (didn't bet)
Seat 3: Racushniak folded before Flop (didn't bet)
Seat 4: phil_cheng folded before Flop (didn't bet)
Seat 5: mycka86 folded before Flop (didn't bet)
Seat 6: sanpidk folded before Flop (didn't bet)
Seat 7: f1reworks folded before Flop (didn't bet)
Seat 8: Orga_060670 (button) folded before Flop (didn't bet)
Seat 9: r4mz3s (small blind) folded before Flop





PokerStars Hand #155301917080:  Hold'em No Limit ($0.25/$0.50 USD) - 2016/06/28 16:38:02 CET [2016/06/28 10:38:02 ET]
Table 'Bruchsalia II' 9-max Seat #5 is the button
Seat 5: Edkar686 ($40 in chips) 
Seat 6: matiko09 ($50 in chips) 
Edkar686: posts small blind $0.25
matiko09: posts big blind $0.50
*** HOLE CARDS ***
Dealt to matiko09 [5d 9s]
Edkar686: calls $0.25
matiko09: checks 
*** FLOP *** [8d Kc Kh]
Lipton20088 joins the table at seat #7 
matiko09: checks 
I_Freemen joins the table at seat #4 
Edkar686: bets $0.95
matiko09: folds 
Uncalled bet ($0.95) returned to Edkar686
Edkar686 collected $0.95 from pot
*** SUMMARY ***
Total pot $1 | Rake $0.05 
Board [8d Kc Kh]
Seat 5: Edkar686 (button) (small blind) collected ($0.95)
Seat 6: matiko09 (big blind) folded on the Flop





PokerStars Hand #155301919079:  Hold'em No Limit ($0.50/$1.00 USD) - 2016/06/28 16:38:06 CET [2016/06/28 10:38:06 ET]
Table 'Tomita' 9-max Seat #4 is the button
Seat 1: CI58 ($100 in chips) 
Seat 2: vanilica ($102.22 in chips) 
Seat 3: r4mz3s ($100 in chips) 
Seat 4: f1reworks ($119.57 in chips) 
Seat 5: ANDY19911608 ($146.18 in chips) 
Seat 6: tipner ($101.50 in chips) 
Seat 7: matiko09 ($146.44 in chips) 
Seat 8: Noob0Saibot ($110.32 in chips) 
Seat 9: sanpidk ($143.39 in chips) 
ANDY19911608: posts small blind $0.50
tipner: posts big blind $1
*** HOLE CARDS ***
Dealt to matiko09 [5s 3d]
matiko09: folds 
Noob0Saibot: folds 
sanpidk: raises $2 to $3
CI58: calls $3
vanilica: calls $3
r4mz3s: folds 
f1reworks: folds 
ANDY19911608: folds 
tipner: folds 
*** FLOP *** [8s Jc 3s]
sanpidk: checks 
CI58: bets $5
vanilica: folds 
sanpidk: folds 
Uncalled bet ($5) returned to CI58
CI58 collected $9.98 from pot
CI58: doesn't show hand 
*** SUMMARY ***
Total pot $10.50 | Rake $0.52 
Board [8s Jc 3s]
Seat 1: CI58 collected ($9.98)
Seat 2: vanilica folded on the Flop
Seat 3: r4mz3s folded before Flop (didn't bet)
Seat 4: f1reworks (button) folded before Flop (didn't bet)
Seat 5: ANDY19911608 (small blind) folded before Flop
Seat 6: tipner (big blind) folded before Flop
Seat 7: matiko09 folded before Flop (didn't bet)
Seat 8: Noob0Saibot folded before Flop (didn't bet)
Seat 9: sanpidk folded on the Flop





PokerStars Hand #155301920100:  Hold'em No Limit ($0.50/$1.00 USD) - 2016/06/28 16:38:08 CET [2016/06/28 10:38:08 ET]
Table 'Lyyli II' 9-max Seat #2 is the button
Seat 1: tipner ($123.03 in chips) 
Seat 2: CI58 ($131.02 in chips) 
Seat 3: Racushniak ($100 in chips) 
Seat 4: Greha999 ($179.25 in chips) 
Seat 5: flk.Dasas ($100 in chips) 
Seat 6: matiko09 ($101.94 in chips) 
Seat 8: r4mz3s ($124.42 in chips) 
Seat 9: f1reworks ($108.30 in chips) 
Racushniak: posts small blind $0.50
Greha999: posts big blind $1
mycka86: sits out 
*** HOLE CARDS ***
Dealt to matiko09 [Qh 7c]
flk.Dasas: folds 
matiko09: folds 
r4mz3s: folds 
f1reworks: folds 
tipner: raises $1 to $2
CI58: folds 
Racushniak: folds 
Greha999: calls $1
*** FLOP *** [8s Th 5h]
Greha999: checks 
tipner: checks 
*** TURN *** [8s Th 5h] [7s]
Greha999: bets $2
tipner: folds 
Uncalled bet ($2) returned to Greha999
Greha999 collected $4.28 from pot
*** SUMMARY ***
Total pot $4.50 | Rake $0.22 
Board [8s Th 5h 7s]
Seat 1: tipner folded on the Turn
Seat 2: CI58 (button) folded before Flop (didn't bet)
Seat 3: Racushniak (small blind) folded before Flop
Seat 4: Greha999 (big blind) collected ($4.28)
Seat 5: flk.Dasas folded before Flop (didn't bet)
Seat 6: matiko09 folded before Flop (didn't bet)
Seat 8: r4mz3s folded before Flop (didn't bet)
Seat 9: f1reworks folded before Flop (didn't bet)





PokerStars Hand #155301925120:  Hold'em No Limit ($0.50/$1.00 USD) - 2016/06/28 16:38:17 CET [2016/06/28 10:38:17 ET]
Table 'Zerlina' 9-max Seat #9 is the button
Seat 1: arctur17 ($21.35 in chips) 
Seat 2: matiko09 ($100 in chips) 
Seat 3: Racushniak ($172.27 in chips) 
Seat 4: phil_cheng ($103.18 in chips) 
Seat 5: mycka86 ($106.97 in chips) 
Seat 6: sanpidk ($110.20 in chips) 
Seat 7: f1reworks ($268.32 in chips) 
Seat 8: Orga_060670 ($100 in chips) 
Seat 9: r4mz3s ($119.29 in chips) 
arctur17: posts small blind $0.50
matiko09: posts big blind $1
*** HOLE CARDS ***
Dealt to matiko09 [5s Ah]
Racushniak: folds 
phil_cheng: folds 
mycka86: raises $2 to $3
sanpidk: folds 
f1reworks: folds 
Orga_060670: folds 
r4mz3s: folds 
arctur17: folds 
matiko09: folds 
Uncalled bet ($2) returned to mycka86
mycka86 collected $2.50 from pot
*** SUMMARY ***
Total pot $2.50 | Rake $0 
Seat 1: arctur17 (small blind) folded before Flop
Seat 2: matiko09 (big blind) folded before Flop
Seat 3: Racushniak folded before Flop (didn't bet)
Seat 4: phil_cheng folded before Flop (didn't bet)
Seat 5: mycka86 collected ($2.50)
Seat 6: sanpidk folded before Flop (didn't bet)
Seat 7: f1reworks folded before Flop (didn't bet)
Seat 8: Orga_060670 folded before Flop (didn't bet)
Seat 9: r4mz3s (button) folded before Flop (didn't bet)





PokerStars Hand #155301926800:  Hold'em No Limit ($0.50/$1.00 USD) - 2016/06/28 16:38:20 CET [2016/06/28 10:38:20 ET]
Table 'Dorado II' 9-max Seat #1 is the button
Seat 1: f1reworks ($167.43 in chips) 
Seat 2: vanilica ($100.50 in chips) 
Seat 3: ghostriderxu ($85.90 in chips) 
Seat 4: pyromid ($112.50 in chips) 
Seat 5: KovIFish89 ($110.57 in chips) 
Seat 6: mycka86 ($104.24 in chips) 
Seat 7: matiko09 ($113.21 in chips) 
Seat 8: flk.Dasas ($181.39 in chips) 
Seat 9: r4mz3s ($100 in chips) 
vanilica: posts small blind $0.50
ghostriderxu: posts big blind $1
*** HOLE CARDS ***
Dealt to matiko09 [Jc Ac]
pyromid: folds 
KovIFish89: folds 
mycka86: folds 
matiko09: raises $2 to $3
flk.Dasas: folds 
r4mz3s: folds 
f1reworks: folds 
vanilica: folds 
ghostriderxu: folds 
Uncalled bet ($2) returned to matiko09
matiko09 collected $2.50 from pot
matiko09: doesn't show hand 
*** SUMMARY ***
Total pot $2.50 | Rake $0 
Seat 1: f1reworks (button) folded before Flop (didn't bet)
Seat 2: vanilica (small blind) folded before Flop
Seat 3: ghostriderxu (big blind) folded before Flop
Seat 4: pyromid folded before Flop (didn't bet)
Seat 5: KovIFish89 folded before Flop (didn't bet)
Seat 6: mycka86 folded before Flop (didn't bet)
Seat 7: matiko09 collected ($2.50)
Seat 8: flk.Dasas folded before Flop (didn't bet)
Seat 9: r4mz3s folded before Flop (didn't bet)





PokerStars Hand #155301932744:  Hold'em No Limit ($0.25/$0.50 USD) - 2016/06/28 16:38:31 CET [2016/06/28 10:38:31 ET]
Table 'Bruchsalia II' 9-max Seat #5 is the button
Seat 5: Edkar686 ($40.45 in chips) 
Seat 6: matiko09 ($50 in chips) 
Seat 7: Lipton20088 ($20.75 in chips) 
matiko09: posts small blind $0.25
Lipton20088: posts big blind $0.50
*** HOLE CARDS ***
Dealt to matiko09 [4s Th]
Edkar686: calls $0.50
Kukuryzka joins the table at seat #8 
matiko09: folds 
Lipton20088: checks 
*** FLOP *** [5s Ah 5c]
Lipton20088: checks 
app1e_j@ck joins the table at seat #9 
Edkar686: bets $1.19
Lipton20088: folds 
Uncalled bet ($1.19) returned to Edkar686
el.suertero joins the table at seat #3 
Edkar686 collected $1.19 from pot
*** SUMMARY ***
Total pot $1.25 | Rake $0.06 
Board [5s Ah 5c]
Seat 5: Edkar686 (button) collected ($1.19)
Seat 6: matiko09 (small blind) folded before Flop
Seat 7: Lipton20088 (big blind) folded on the Flop





PokerStars Hand #155301936361:  Hold'em No Limit ($0.25/$0.50 USD) - 2016/06/28 16:38:38 CET [2016/06/28 10:38:38 ET]
Table 'Antonia II' 9-max Seat #5 is the button
Seat 1: er13to ($54.75 in chips) 
Seat 2: myatiy 96 ($50 in chips) 
Seat 4: el.suertero ($68.06 in chips) 
Seat 5: 35LOBO35 ($24.58 in chips) 
Seat 6: matiko09 ($55.50 in chips) 
Seat 7: Kukuryzka ($57.84 in chips) 
Seat 8: app1e_j@ck ($51.79 in chips) 
Seat 9: Domotirko228 ($50.44 in chips) 
matiko09: posts small blind $0.25
Kukuryzka: posts big blind $0.50
*** HOLE CARDS ***
Dealt to matiko09 [8h 7c]
app1e_j@ck: folds 
Domotirko228: folds 
er13to: folds 
myatiy 96: folds 
el.suertero: raises $1 to $1.50
35LOBO35: calls $1.50
matiko09: folds 
Kukuryzka: folds 
*** FLOP *** [3d Qs Ac]
el.suertero: bets $1.95
35LOBO35: folds 
Uncalled bet ($1.95) returned to el.suertero
el.suertero collected $3.56 from pot
el.suertero: doesn't show hand 
*** SUMMARY ***
Total pot $3.75 | Rake $0.19 
Board [3d Qs Ac]
Seat 1: er13to folded before Flop (didn't bet)
Seat 2: myatiy 96 folded before Flop (didn't bet)
Seat 4: el.suertero collected ($3.56)
Seat 5: 35LOBO35 (button) folded on the Flop
Seat 6: matiko09 (small blind) folded before Flop
Seat 7: Kukuryzka (big blind) folded before Flop
Seat 8: app1e_j@ck folded before Flop (didn't bet)
Seat 9: Domotirko228 folded before Flop (didn't bet)





PokerStars Hand #155301939105:  Hold'em No Limit ($0.50/$1.00 USD) - 2016/06/28 16:38:43 CET [2016/06/28 10:38:43 ET]
Table 'Anitra' 9-max Seat #1 is the button
Seat 1: Klappspaten0 ($105.38 in chips) 
Seat 2: ardo888 ($100 in chips) 
Seat 3: facelessPPP ($104.48 in chips) 
Seat 4: Shakeelg ($168.47 in chips) 
Seat 5: er13to ($104.20 in chips) 
Seat 6: matiko09 ($106 in chips) 
Seat 7: phil_cheng ($100 in chips) 
Seat 8: yoshinoino ($31.50 in chips) 
Seat 9: chenconhaste ($100 in chips) 
ardo888: posts small blind $0.50
facelessPPP: posts big blind $1
*** HOLE CARDS ***
Dealt to matiko09 [As Jc]
Shakeelg: folds 
er13to: folds 
matiko09: folds 
phil_cheng: folds 
yoshinoino: folds 
chenconhaste: folds 
Klappspaten0: raises $2 to $3
ardo888: folds 
facelessPPP: folds 
Uncalled bet ($2) returned to Klappspaten0
Klappspaten0 collected $2.50 from pot
Klappspaten0: doesn't show hand 
*** SUMMARY ***
Total pot $2.50 | Rake $0 
Seat 1: Klappspaten0 (button) collected ($2.50)
Seat 2: ardo888 (small blind) folded before Flop
Seat 3: facelessPPP (big blind) folded before Flop
Seat 4: Shakeelg folded before Flop (didn't bet)
Seat 5: er13to folded before Flop (didn't bet)
Seat 6: matiko09 folded before Flop (didn't bet)
Seat 7: phil_cheng folded before Flop (didn't bet)
Seat 8: yoshinoino folded before Flop (didn't bet)
Seat 9: chenconhaste folded before Flop (didn't bet)





PokerStars Hand #155301940472:  Hold'em No Limit ($0.50/$1.00 USD) - 2016/06/28 16:38:45 CET [2016/06/28 10:38:45 ET]
Table 'Zerlina' 9-max Seat #1 is the button
Seat 1: arctur17 ($20.85 in chips) 
Seat 2: matiko09 ($100 in chips) 
Seat 3: Racushniak ($172.27 in chips) 
Seat 4: phil_cheng ($103.18 in chips) 
Seat 5: mycka86 ($108.47 in chips) 
Seat 6: sanpidk ($110.20 in chips) 
Seat 7: f1reworks ($268.32 in chips) 
Seat 8: Orga_060670 ($100 in chips) 
Seat 9: r4mz3s ($119.29 in chips) 
matiko09: posts small blind $0.50
Racushniak: posts big blind $1
*** HOLE CARDS ***
Dealt to matiko09 [8s 4c]
phil_cheng: folds 
mycka86: raises $2 to $3
sanpidk: folds 
f1reworks: folds 
Orga_060670: folds 
r4mz3s: folds 
arctur17: folds 
matiko09: folds 
Racushniak: raises $6 to $9
mycka86: calls $6
*** FLOP *** [Th 8h 3h]
Racushniak: checks 
mycka86: checks 
*** TURN *** [Th 8h 3h] [3c]
Racushniak: bets $9
mycka86: calls $9
*** RIVER *** [Th 8h 3h 3c] [Qd]
Racushniak: bets $40
mycka86: folds 
Uncalled bet ($40) returned to Racushniak
Racushniak collected $34.68 from pot
Racushniak: doesn't show hand 
*** SUMMARY ***
Total pot $36.50 | Rake $1.82 
Board [Th 8h 3h 3c Qd]
Seat 1: arctur17 (button) folded before Flop (didn't bet)
Seat 2: matiko09 (small blind) folded before Flop
Seat 3: Racushniak (big blind) collected ($34.68)
Seat 4: phil_cheng folded before Flop (didn't bet)
Seat 5: mycka86 folded on the River
Seat 6: sanpidk folded before Flop (didn't bet)
Seat 7: f1reworks folded before Flop (didn't bet)
Seat 8: Orga_060670 folded before Flop (didn't bet)
Seat 9: r4mz3s folded before Flop (didn't bet)





PokerStars Hand #155301942954:  Hold'em No Limit ($0.50/$1.00 USD) - 2016/06/28 16:38:49 CET [2016/06/28 10:38:49 ET]
Table 'Dorado II' 9-max Seat #2 is the button
Seat 1: f1reworks ($167.43 in chips) 
Seat 2: vanilica ($100 in chips) 
Seat 3: ghostriderxu ($84.90 in chips) 
Seat 4: pyromid ($112.50 in chips) 
Seat 5: KovIFish89 ($110.57 in chips) 
Seat 6: mycka86 ($104.24 in chips) 
Seat 7: matiko09 ($114.71 in chips) 
Seat 8: flk.Dasas ($181.39 in chips) 
Seat 9: r4mz3s ($100 in chips) 
ghostriderxu: posts small blind $0.50
pyromid: posts big blind $1
*** HOLE CARDS ***
Dealt to matiko09 [Kc 3d]
KovIFish89: folds 
mycka86: folds 
matiko09: folds 
flk.Dasas: folds 
r4mz3s: folds 
f1reworks has timed out
f1reworks: folds 
vanilica: raises $1.50 to $2.50
ghostriderxu: folds 
pyromid: folds 
Uncalled bet ($1.50) returned to vanilica
vanilica collected $2.50 from pot
vanilica: doesn't show hand 
*** SUMMARY ***
Total pot $2.50 | Rake $0 
Seat 1: f1reworks folded before Flop (didn't bet)
Seat 2: vanilica (button) collected ($2.50)
Seat 3: ghostriderxu (small blind) folded before Flop
Seat 4: pyromid (big blind) folded before Flop
Seat 5: KovIFish89 folded before Flop (didn't bet)
Seat 6: mycka86 folded before Flop (didn't bet)
Seat 7: matiko09 folded before Flop (didn't bet)
Seat 8: flk.Dasas folded before Flop (didn't bet)
Seat 9: r4mz3s folded before Flop (didn't bet)





PokerStars Hand #155301945807:  Hold'em No Limit ($0.25/$0.50 USD) - 2016/06/28 16:38:55 CET [2016/06/28 10:38:55 ET]
Table 'Bruchsalia II' 9-max Seat #6 is the button
Seat 5: Edkar686 ($41.14 in chips) 
Seat 6: matiko09 ($50 in chips) 
Seat 7: Lipton20088 ($20.25 in chips) 
Seat 8: Kukuryzka ($50 in chips) 
ardo888 joins the table at seat #1 
Lipton20088: posts small blind $0.25
Kukuryzka: posts big blind $0.50
app1e_j@ck: sits out 
el.suertero: sits out 
*** HOLE CARDS ***
Dealt to matiko09 [Qs 6c]
Edkar686: calls $0.50
matiko09: folds 
Lipton20088: calls $0.25
Kukuryzka: raises $1 to $1.50
Edkar686: calls $1
Lipton20088: raises $18.75 to $20.25 and is all-in
Kukuryzka: folds 
Edkar686: folds 
Uncalled bet ($18.75) returned to Lipton20088
Lipton20088 collected $4.50 from pot
Lipton20088: doesn't show hand 
*** SUMMARY ***
Total pot $4.50 | Rake $0 
Seat 5: Edkar686 folded before Flop
Seat 6: matiko09 (button) folded before Flop (didn't bet)
Seat 7: Lipton20088 (small blind) collected ($4.50)
Seat 8: Kukuryzka (big blind) folded before Flop





PokerStars Hand #155301947287:  Hold'em No Limit ($0.50/$1.00 USD) - 2016/06/28 16:38:57 CET [2016/06/28 10:38:57 ET]
Table 'Tomita' 9-max Seat #5 is the button
Seat 1: CI58 ($106.98 in chips) 
Seat 2: vanilica ($100 in chips) 
Seat 3: r4mz3s ($100 in chips) 
Seat 4: f1reworks ($119.57 in chips) 
Seat 5: ANDY19911608 ($145.68 in chips) 
Seat 6: tipner ($100.50 in chips) 
Seat 7: matiko09 ($146.44 in chips) 
Seat 8: Noob0Saibot ($110.32 in chips) 
Seat 9: sanpidk ($140.39 in chips) 
tipner: posts small blind $0.50
matiko09: posts big blind $1
*** HOLE CARDS ***
Dealt to matiko09 [7s 3c]
Noob0Saibot: folds 
sanpidk: folds 
CI58: folds 
vanilica: raises $1.85 to $2.85
r4mz3s: folds 
f1reworks: folds 
ANDY19911608: folds 
tipner: folds 
matiko09: folds 
Uncalled bet ($1.85) returned to vanilica
vanilica collected $2.50 from pot
vanilica: doesn't show hand 
*** SUMMARY ***
Total pot $2.50 | Rake $0 
Seat 1: CI58 folded before Flop (didn't bet)
Seat 2: vanilica collected ($2.50)
Seat 3: r4mz3s folded before Flop (didn't bet)
Seat 4: f1reworks folded before Flop (didn't bet)
Seat 5: ANDY19911608 (button) folded before Flop (didn't bet)
Seat 6: tipner (small blind) folded before Flop
Seat 7: matiko09 (big blind) folded before Flop
Seat 8: Noob0Saibot folded before Flop (didn't bet)
Seat 9: sanpidk folded before Flop (didn't bet)





PokerStars Hand #155301952842:  Hold'em No Limit ($0.25/$0.50 USD) - 2016/06/28 16:39:07 CET [2016/06/28 10:39:07 ET]
Table 'Antonia II' 9-max Seat #6 is the button
Seat 1: er13to ($54.75 in chips) 
Seat 2: myatiy 96 ($50 in chips) 
Seat 4: el.suertero ($70.12 in chips) 
Seat 5: 35LOBO35 ($23.08 in chips) 
Seat 6: matiko09 ($55.25 in chips) 
Seat 7: Kukuryzka ($57.34 in chips) 
Seat 8: app1e_j@ck ($51.79 in chips) 
Seat 9: Domotirko228 ($50.44 in chips) 
Kukuryzka: posts small blind $0.25
app1e_j@ck: posts big blind $0.50
*** HOLE CARDS ***
Dealt to matiko09 [6c 5h]
Domotirko228: folds 
er13to: raises $0.86 to $1.36
myatiy 96: folds 
el.suertero: folds 
35LOBO35: folds 
matiko09: folds 
Kukuryzka: folds 
app1e_j@ck: folds 
Uncalled bet ($0.86) returned to er13to
er13to collected $1.25 from pot
*** SUMMARY ***
Total pot $1.25 | Rake $0 
Seat 1: er13to collected ($1.25)
Seat 2: myatiy 96 folded before Flop (didn't bet)
Seat 4: el.suertero folded before Flop (didn't bet)
Seat 5: 35LOBO35 folded before Flop (didn't bet)
Seat 6: matiko09 (button) folded before Flop (didn't bet)
Seat 7: Kukuryzka (small blind) folded before Flop
Seat 8: app1e_j@ck (big blind) folded before Flop
Seat 9: Domotirko228 folded before Flop (didn't bet)





PokerStars Hand #155301954545:  Hold'em No Limit ($0.50/$1.00 USD) - 2016/06/28 16:39:11 CET [2016/06/28 10:39:11 ET]
Table 'Lyyli II' 9-max Seat #3 is the button
Seat 1: tipner ($121.03 in chips) 
Seat 2: CI58 ($131.02 in chips) 
Seat 3: Racushniak ($100 in chips) 
Seat 4: Greha999 ($181.53 in chips) 
Seat 5: flk.Dasas ($100 in chips) 
Seat 6: matiko09 ($101.94 in chips) 
Seat 8: r4mz3s ($124.42 in chips) 
Seat 9: f1reworks ($108.30 in chips) 
Greha999: posts small blind $0.50
flk.Dasas: posts big blind $1
mycka86: sits out 
*** HOLE CARDS ***
Dealt to matiko09 [8c 9c]
matiko09: raises $2 to $3
r4mz3s: folds 
f1reworks: folds 
tipner: calls $3
CI58: folds 
Racushniak: folds 
Greha999: calls $2.50
flk.Dasas: folds 
*** FLOP *** [6d 3s Qh]
Greha999: checks 
matiko09: checks 
tipner: bets $6
Greha999: folds 
matiko09: folds 
Uncalled bet ($6) returned to tipner
tipner collected $9.50 from pot
tipner: doesn't show hand 
*** SUMMARY ***
Total pot $10 | Rake $0.50 
Board [6d 3s Qh]
Seat 1: tipner collected ($9.50)
Seat 2: CI58 folded before Flop (didn't bet)
Seat 3: Racushniak (button) folded before Flop (didn't bet)
Seat 4: Greha999 (small blind) folded on the Flop
Seat 5: flk.Dasas (big blind) folded before Flop
Seat 6: matiko09 folded on the Flop
Seat 8: r4mz3s folded before Flop (didn't bet)
Seat 9: f1reworks folded before Flop (didn't bet)





PokerStars Hand #155301957597:  Hold'em No Limit ($0.50/$1.00 USD) - 2016/06/28 16:39:16 CET [2016/06/28 10:39:16 ET]
Table 'Anitra' 9-max Seat #2 is the button
Seat 1: Klappspaten0 ($106.88 in chips) 
Seat 2: ardo888 ($100 in chips) 
Seat 3: facelessPPP ($103.48 in chips) 
Seat 4: Shakeelg ($168.47 in chips) 
Seat 5: er13to ($104.20 in chips) 
Seat 6: matiko09 ($106 in chips) 
Seat 7: phil_cheng ($100 in chips) 
Seat 8: yoshinoino ($31.50 in chips) 
Seat 9: chenconhaste ($100 in chips) 
facelessPPP: posts small blind $0.50
Shakeelg: posts big blind $1
*** HOLE CARDS ***
Dealt to matiko09 [Qh 6d]
er13to: folds 
matiko09: folds 
phil_cheng: folds 
yoshinoino: folds 
chenconhaste: folds 
Klappspaten0: raises $2 to $3
ardo888: folds 
facelessPPP: folds 
Shakeelg: calls $2
*** FLOP *** [3d Jd 8s]
Shakeelg: bets $3
Klappspaten0: raises $3 to $6
Shakeelg: calls $3
*** TURN *** [3d Jd 8s] [2c]
Shakeelg: checks 
Klappspaten0: checks 
*** RIVER *** [3d Jd 8s 2c] [4c]
Shakeelg: bets $3
Klappspaten0: raises $12 to $15
Shakeelg: calls $12
*** SHOW DOWN ***
Klappspaten0: shows [3c 6c] (a pair of Threes)
Shakeelg: shows [9d 9c] (a pair of Nines)
Shakeelg collected $46.08 from pot
*** SUMMARY ***
Total pot $48.50 | Rake $2.42 
Board [3d Jd 8s 2c 4c]
Seat 1: Klappspaten0 showed [3c 6c] and lost with a pair of Threes
Seat 2: ardo888 (button) folded before Flop (didn't bet)
Seat 3: facelessPPP (small blind) folded before Flop
Seat 4: Shakeelg (big blind) showed [9d 9c] and won ($46.08) with a pair of Nines
Seat 5: er13to folded before Flop (didn't bet)
Seat 6: matiko09 folded before Flop (didn't bet)
Seat 7: phil_cheng folded before Flop (didn't bet)
Seat 8: yoshinoino folded before Flop (didn't bet)
Seat 9: chenconhaste folded before Flop (didn't bet)





PokerStars Hand #155301962314:  Hold'em No Limit ($0.50/$1.00 USD) - 2016/06/28 16:39:25 CET [2016/06/28 10:39:25 ET]
Table 'Dorado II' 9-max Seat #3 is the button
Seat 1: f1reworks ($167.43 in chips) 
Seat 2: vanilica ($101.50 in chips) 
Seat 3: ghostriderxu ($84.40 in chips) 
Seat 4: pyromid ($111.50 in chips) 
Seat 5: KovIFish89 ($110.57 in chips) 
Seat 6: mycka86 ($104.24 in chips) 
Seat 7: matiko09 ($114.71 in chips) 
Seat 8: flk.Dasas ($181.39 in chips) 
Seat 9: r4mz3s ($100 in chips) 
pyromid: posts small blind $0.50
KovIFish89: posts big blind $1
*** HOLE CARDS ***
Dealt to matiko09 [6h Tc]
mycka86: folds 
matiko09: folds 
flk.Dasas: folds 
r4mz3s: folds 
f1reworks: folds 
vanilica: raises $1.50 to $2.50
ghostriderxu: calls $2.50
pyromid: folds 
KovIFish89: folds 
*** FLOP *** [Js Kc 3s]
vanilica: checks 
ghostriderxu: bets $3.09
vanilica: folds 
Uncalled bet ($3.09) returned to ghostriderxu
ghostriderxu collected $6.18 from pot
ghostriderxu: doesn't show hand 
*** SUMMARY ***
Total pot $6.50 | Rake $0.32 
Board [Js Kc 3s]
Seat 1: f1reworks folded before Flop (didn't bet)
Seat 2: vanilica folded on the Flop
Seat 3: ghostriderxu (button) collected ($6.18)
Seat 4: pyromid (small blind) folded before Flop
Seat 5: KovIFish89 (big blind) folded before Flop
Seat 6: mycka86 folded before Flop (didn't bet)
Seat 7: matiko09 folded before Flop (didn't bet)
Seat 8: flk.Dasas folded before Flop (didn't bet)
Seat 9: r4mz3s folded before Flop (didn't bet)





PokerStars Hand #155301965362:  Hold'em No Limit ($0.50/$1.00 USD) - 2016/06/28 16:39:30 CET [2016/06/28 10:39:30 ET]
Table 'Tomita' 9-max Seat #6 is the button
Seat 1: CI58 ($106.98 in chips) 
Seat 2: vanilica ($101.50 in chips) 
Seat 3: r4mz3s ($100 in chips) 
Seat 4: f1reworks ($119.57 in chips) 
Seat 5: ANDY19911608 ($145.68 in chips) 
Seat 6: tipner ($100 in chips) 
Seat 7: matiko09 ($145.44 in chips) 
Seat 8: Noob0Saibot ($110.32 in chips) 
Seat 9: sanpidk ($140.39 in chips) 
matiko09: posts small blind $0.50
Noob0Saibot: posts big blind $1
*** HOLE CARDS ***
Dealt to matiko09 [9h Qh]
sanpidk: folds 
CI58: raises $2 to $3
vanilica: folds 
r4mz3s: folds 
f1reworks: folds 
ANDY19911608: folds 
tipner: raises $6 to $9
matiko09: folds 
Noob0Saibot: folds 
CI58: calls $6
*** FLOP *** [4c As 4h]
CI58: checks 
tipner: checks 
*** TURN *** [4c As 4h] [Ad]
CI58: checks 
tipner: bets $9
CI58: folds 
Uncalled bet ($9) returned to tipner
tipner collected $18.52 from pot
tipner: doesn't show hand 
*** SUMMARY ***
Total pot $19.50 | Rake $0.98 
Board [4c As 4h Ad]
Seat 1: CI58 folded on the Turn
Seat 2: vanilica folded before Flop (didn't bet)
Seat 3: r4mz3s folded before Flop (didn't bet)
Seat 4: f1reworks folded before Flop (didn't bet)
Seat 5: ANDY19911608 folded before Flop (didn't bet)
Seat 6: tipner (button) collected ($18.52)
Seat 7: matiko09 (small blind) folded before Flop
Seat 8: Noob0Saibot (big blind) folded before Flop
Seat 9: sanpidk folded before Flop (didn't bet)





PokerStars Hand #155301966654:  Hold'em No Limit ($0.25/$0.50 USD) - 2016/06/28 16:39:33 CET [2016/06/28 10:39:33 ET]
Table 'Bruchsalia II' 9-max Seat #7 is the button
Seat 5: Edkar686 ($39.64 in chips) 
Seat 6: matiko09 ($50 in chips) 
Seat 7: Lipton20088 ($23.25 in chips) 
Seat 8: Kukuryzka ($50 in chips) 
Seat 9: app1e_j@ck ($50 in chips) 
Kukuryzka: posts small blind $0.25
app1e_j@ck: posts big blind $0.50
ardo888: sits out 
el.suertero: sits out 
*** HOLE CARDS ***
Dealt to matiko09 [4h 9d]
Edkar686: calls $0.50
matiko09: folds 
Lipton20088: raises $1 to $1.50
POTAPENKO700 joins the table at seat #2 
POTAPENKO700 leaves the table
Kukuryzka: folds 
app1e_j@ck: folds 
Edkar686: calls $1
*** FLOP *** [Ah 2h Qd]
Edkar686: checks 
Lipton20088 is disconnected 
Lipton20088 is connected 
Lipton20088: checks 
*** TURN *** [Ah 2h Qd] [Jc]
Edkar686: checks 
Lipton20088: bets $2.71
william87872 joins the table at seat #2 
Edkar686: calls $2.71
*** RIVER *** [Ah 2h Qd Jc] [6h]
Edkar686 is disconnected 
Edkar686 is connected 
Edkar686: bets $8.71
Lipton20088: folds 
Uncalled bet ($8.71) returned to Edkar686
Edkar686 collected $8.71 from pot
*** SUMMARY ***
Total pot $9.17 | Rake $0.46 
Board [Ah 2h Qd Jc 6h]
Seat 5: Edkar686 collected ($8.71)
Seat 6: matiko09 folded before Flop (didn't bet)
Seat 7: Lipton20088 (button) folded on the River
Seat 8: Kukuryzka (small blind) folded before Flop
Seat 9: app1e_j@ck (big blind) folded before Flop





PokerStars Hand #155301969369:  Hold'em No Limit ($0.25/$0.50 USD) - 2016/06/28 16:39:38 CET [2016/06/28 10:39:38 ET]
Table 'Antonia II' 9-max Seat #7 is the button
Seat 1: er13to ($55.50 in chips) 
Seat 2: myatiy 96 ($50 in chips) 
Seat 4: el.suertero ($70.12 in chips) 
Seat 5: 35LOBO35 ($23.08 in chips) 
Seat 6: matiko09 ($55.25 in chips) 
Seat 7: Kukuryzka ($57.09 in chips) 
Seat 8: app1e_j@ck ($51.29 in chips) 
Seat 9: Domotirko228 ($50.44 in chips) 
app1e_j@ck: posts small blind $0.25
Domotirko228: posts big blind $0.50
*** HOLE CARDS ***
Dealt to matiko09 [5s Qc]
er13to: folds 
myatiy 96: raises $0.75 to $1.25
el.suertero: folds 
35LOBO35: calls $1.25
matiko09: folds 
Kukuryzka: folds 
app1e_j@ck: folds 
Domotirko228: folds 
*** FLOP *** [2d Qd 5c]
myatiy 96: checks 
35LOBO35: checks 
*** TURN *** [2d Qd 5c] [Th]
myatiy 96: bets $1.54
35LOBO35: folds 
Uncalled bet ($1.54) returned to myatiy 96
myatiy 96 collected $3.09 from pot
*** SUMMARY ***
Total pot $3.25 | Rake $0.16 
Board [2d Qd 5c Th]
Seat 1: er13to folded before Flop (didn't bet)
Seat 2: myatiy 96 collected ($3.09)
Seat 4: el.suertero folded before Flop (didn't bet)
Seat 5: 35LOBO35 folded on the Turn
Seat 6: matiko09 folded before Flop (didn't bet)
Seat 7: Kukuryzka (button) folded before Flop (didn't bet)
Seat 8: app1e_j@ck (small blind) folded before Flop
Seat 9: Domotirko228 (big blind) folded before Flop





PokerStars Hand #155301982895:  Hold'em No Limit ($0.50/$1.00 USD) - 2016/06/28 16:40:02 CET [2016/06/28 10:40:02 ET]
Table 'Lyyli II' 9-max Seat #4 is the button
Seat 1: tipner ($127.53 in chips) 
Seat 2: CI58 ($131.02 in chips) 
Seat 3: Racushniak ($100 in chips) 
Seat 4: Greha999 ($178.53 in chips) 
Seat 5: flk.Dasas ($100 in chips) 
Seat 6: matiko09 ($100 in chips) 
Seat 8: r4mz3s ($124.42 in chips) 
Seat 9: f1reworks ($108.30 in chips) 
flk.Dasas: posts small blind $0.50
matiko09: posts big blind $1
mycka86: sits out 
*** HOLE CARDS ***
Dealt to matiko09 [Ks 6c]
r4mz3s: folds 
f1reworks: folds 
tipner: folds 
CI58: raises $2 to $3
Racushniak: folds 
Greha999: folds 
flk.Dasas: folds 
matiko09: folds 
Uncalled bet ($2) returned to CI58
CI58 collected $2.50 from pot
CI58: doesn't show hand 
*** SUMMARY ***
Total pot $2.50 | Rake $0 
Seat 1: tipner folded before Flop (didn't bet)
Seat 2: CI58 collected ($2.50)
Seat 3: Racushniak folded before Flop (didn't bet)
Seat 4: Greha999 (button) folded before Flop (didn't bet)
Seat 5: flk.Dasas (small blind) folded before Flop
Seat 6: matiko09 (big blind) folded before Flop
Seat 8: r4mz3s folded before Flop (didn't bet)
Seat 9: f1reworks folded before Flop (didn't bet)





PokerStars Hand #155301983887:  Hold'em No Limit ($0.50/$1.00 USD) - 2016/06/28 16:40:04 CET [2016/06/28 10:40:04 ET]
Table 'Dorado II' 9-max Seat #4 is the button
Seat 1: f1reworks ($167.43 in chips) 
Seat 2: vanilica ($100 in chips) 
Seat 3: ghostriderxu ($88.08 in chips) 
Seat 4: pyromid ($111 in chips) 
Seat 5: KovIFish89 ($109.57 in chips) 
Seat 6: mycka86 ($104.24 in chips) 
Seat 7: matiko09 ($114.71 in chips) 
Seat 8: flk.Dasas ($181.39 in chips) 
Seat 9: r4mz3s ($100 in chips) 
KovIFish89: posts small blind $0.50
mycka86: posts big blind $1
*** HOLE CARDS ***
Dealt to matiko09 [Ac Qc]
matiko09: raises $2 to $3
flk.Dasas: folds 
r4mz3s: raises $6 to $9
f1reworks: folds 
vanilica: folds 
ghostriderxu: folds 
pyromid: folds 
KovIFish89: folds 
mycka86: folds 
matiko09: calls $6
*** FLOP *** [5d 2h 3s]
matiko09: checks 
r4mz3s: checks 
*** TURN *** [5d 2h 3s] [6c]
matiko09: checks 
r4mz3s: checks 
*** RIVER *** [5d 2h 3s 6c] [Ah]
matiko09: bets $6.50
r4mz3s: calls $6.50
*** SHOW DOWN ***
matiko09: shows [Ac Qc] (a pair of Aces)
r4mz3s: shows [As Kc] (a pair of Aces - King kicker)
r4mz3s collected $30.88 from pot
*** SUMMARY ***
Total pot $32.50 | Rake $1.62 
Board [5d 2h 3s 6c Ah]
Seat 1: f1reworks folded before Flop (didn't bet)
Seat 2: vanilica folded before Flop (didn't bet)
Seat 3: ghostriderxu folded before Flop (didn't bet)
Seat 4: pyromid (button) folded before Flop (didn't bet)
Seat 5: KovIFish89 (small blind) folded before Flop
Seat 6: mycka86 (big blind) folded before Flop
Seat 7: matiko09 showed [Ac Qc] and lost with a pair of Aces
Seat 8: flk.Dasas folded before Flop (didn't bet)
Seat 9: r4mz3s showed [As Kc] and won ($30.88) with a pair of Aces





PokerStars Hand #155301990062:  Hold'em No Limit ($0.50/$1.00 USD) - 2016/06/28 16:40:15 CET [2016/06/28 10:40:15 ET]
Table 'Anitra' 9-max Seat #3 is the button
Seat 1: Klappspaten0 ($100 in chips) 
Seat 2: ardo888 ($100 in chips) 
Seat 3: facelessPPP ($102.98 in chips) 
Seat 4: Shakeelg ($190.55 in chips) 
Seat 5: er13to ($104.20 in chips) 
Seat 6: matiko09 ($106 in chips) 
Seat 7: phil_cheng ($100 in chips) 
Seat 8: yoshinoino ($31.50 in chips) 
Seat 9: chenconhaste ($100 in chips) 
Shakeelg: posts small blind $0.50
er13to: posts big blind $1
*** HOLE CARDS ***
Dealt to matiko09 [7d 5d]
matiko09: folds 
phil_cheng: folds 
yoshinoino: raises $1.50 to $2.50
chenconhaste: folds 
Klappspaten0: calls $2.50
ardo888: folds 
facelessPPP: folds 
Shakeelg: calls $2
er13to: calls $1.50
*** FLOP *** [8d Kc Jh]
Shakeelg: checks 
er13to: checks 
yoshinoino: checks 
Klappspaten0: bets $6
Shakeelg: folds 
er13to: folds 
yoshinoino: folds 
Uncalled bet ($6) returned to Klappspaten0
Klappspaten0 collected $9.50 from pot
Klappspaten0: doesn't show hand 
*** SUMMARY ***
Total pot $10 | Rake $0.50 
Board [8d Kc Jh]
Seat 1: Klappspaten0 collected ($9.50)
Seat 2: ardo888 folded before Flop (didn't bet)
Seat 3: facelessPPP (button) folded before Flop (didn't bet)
Seat 4: Shakeelg (small blind) folded on the Flop
Seat 5: er13to (big blind) folded on the Flop
Seat 6: matiko09 folded before Flop (didn't bet)
Seat 7: phil_cheng folded before Flop (didn't bet)
Seat 8: yoshinoino folded on the Flop
Seat 9: chenconhaste folded before Flop (didn't bet)





PokerStars Hand #155301992802:  Hold'em No Limit ($0.25/$0.50 USD) - 2016/06/28 16:40:20 CET [2016/06/28 10:40:20 ET]
Table 'Antonia II' 9-max Seat #8 is the button
Seat 1: er13to ($55.50 in chips) 
Seat 2: myatiy 96 ($51.84 in chips) 
Seat 4: el.suertero ($70.12 in chips) 
Seat 5: 35LOBO35 ($21.83 in chips) 
Seat 6: matiko09 ($55.25 in chips) 
Seat 7: Kukuryzka ($57.09 in chips) 
Seat 8: app1e_j@ck ($51.04 in chips) 
Seat 9: Domotirko228 ($50 in chips) 
Domotirko228: posts small blind $0.25
er13to: posts big blind $0.50
*** HOLE CARDS ***
Dealt to matiko09 [6h 6s]
myatiy 96: folds 
el.suertero: folds 
35LOBO35: raises $0.50 to $1
matiko09: calls $1
Kukuryzka: folds 
app1e_j@ck: folds 
Domotirko228: folds 
er13to: folds 
*** FLOP *** [9c 9s Jd]
35LOBO35: checks 
matiko09: checks 
*** TURN *** [9c 9s Jd] [Qh]
35LOBO35: checks 
matiko09: checks 
*** RIVER *** [9c 9s Jd Qh] [4c]
35LOBO35: bets $3
matiko09: folds 
Uncalled bet ($3) returned to 35LOBO35
35LOBO35 collected $2.61 from pot
35LOBO35: doesn't show hand 
*** SUMMARY ***
Total pot $2.75 | Rake $0.14 
Board [9c 9s Jd Qh 4c]
Seat 1: er13to (big blind) folded before Flop
Seat 2: myatiy 96 folded before Flop (didn't bet)
Seat 4: el.suertero folded before Flop (didn't bet)
Seat 5: 35LOBO35 collected ($2.61)
Seat 6: matiko09 folded on the River
Seat 7: Kukuryzka folded before Flop (didn't bet)
Seat 8: app1e_j@ck (button) folded before Flop (didn't bet)
Seat 9: Domotirko228 (small blind) folded before Flop





PokerStars Hand #155302000707:  Hold'em No Limit ($0.50/$1.00 USD) - 2016/06/28 16:40:35 CET [2016/06/28 10:40:35 ET]
Table 'Zerlina' 9-max Seat #2 is the button
Seat 1: arctur17 ($20.85 in chips) 
Seat 2: matiko09 ($100 in chips) 
Seat 3: Racushniak ($188.95 in chips) 
Seat 4: phil_cheng ($103.18 in chips) 
Seat 5: mycka86 ($100 in chips) 
Seat 6: sanpidk ($110.20 in chips) 
Seat 7: f1reworks ($268.32 in chips) 
Seat 8: Orga_060670 ($100 in chips) 
Seat 9: r4mz3s ($119.29 in chips) 
Racushniak: posts small blind $0.50
phil_cheng: posts big blind $1
*** HOLE CARDS ***
Dealt to matiko09 [4c Kc]
mycka86: raises $2 to $3
sanpidk: folds 
f1reworks: folds 
Orga_060670: folds 
r4mz3s: folds 
arctur17: folds 
matiko09: folds 
Racushniak: folds 
phil_cheng: folds 
Uncalled bet ($2) returned to mycka86
mycka86 collected $2.50 from pot
*** SUMMARY ***
Total pot $2.50 | Rake $0 
Seat 1: arctur17 folded before Flop (didn't bet)
Seat 2: matiko09 (button) folded before Flop (didn't bet)
Seat 3: Racushniak (small blind) folded before Flop
Seat 4: phil_cheng (big blind) folded before Flop
Seat 5: mycka86 collected ($2.50)
Seat 6: sanpidk folded before Flop (didn't bet)
Seat 7: f1reworks folded before Flop (didn't bet)
Seat 8: Orga_060670 folded before Flop (didn't bet)
Seat 9: r4mz3s folded before Flop (didn't bet)





PokerStars Hand #155302004119:  Hold'em No Limit ($0.50/$1.00 USD) - 2016/06/28 16:40:41 CET [2016/06/28 10:40:41 ET]
Table 'Tomita' 9-max Seat #7 is the button
Seat 1: CI58 ($100 in chips) 
Seat 2: vanilica ($101.50 in chips) 
Seat 3: r4mz3s ($100 in chips) 
Seat 4: f1reworks ($119.57 in chips) 
Seat 5: ANDY19911608 ($145.68 in chips) 
Seat 6: tipner ($109.52 in chips) 
Seat 7: matiko09 ($144.94 in chips) 
Seat 8: Noob0Saibot ($109.32 in chips) 
Seat 9: sanpidk ($140.39 in chips) 
Noob0Saibot: posts small blind $0.50
sanpidk: posts big blind $1
*** HOLE CARDS ***
Dealt to matiko09 [7h Kh]
CI58: folds 
vanilica: folds 
r4mz3s: folds 
f1reworks: folds 
ANDY19911608: calls $1
tipner: folds 
matiko09: raises $3 to $4
Noob0Saibot: raises $7.50 to $11.50
sanpidk: folds 
ANDY19911608: folds 
matiko09: folds 
Uncalled bet ($7.50) returned to Noob0Saibot
Noob0Saibot collected $10 from pot
Noob0Saibot: doesn't show hand 
*** SUMMARY ***
Total pot $10 | Rake $0 
Seat 1: CI58 folded before Flop (didn't bet)
Seat 2: vanilica folded before Flop (didn't bet)
Seat 3: r4mz3s folded before Flop (didn't bet)
Seat 4: f1reworks folded before Flop (didn't bet)
Seat 5: ANDY19911608 folded before Flop
Seat 6: tipner folded before Flop (didn't bet)
Seat 7: matiko09 (button) folded before Flop
Seat 8: Noob0Saibot (small blind) collected ($10)
Seat 9: sanpidk (big blind) folded before Flop





PokerStars Hand #155302003809:  Hold'em No Limit ($0.50/$1.00 USD) - 2016/06/28 16:40:41 CET [2016/06/28 10:40:41 ET]
Table 'Lyyli II' 9-max Seat #5 is the button
Seat 1: tipner ($127.53 in chips) 
Seat 2: CI58 ($132.52 in chips) 
Seat 3: Racushniak ($100 in chips) 
Seat 4: Greha999 ($178.53 in chips) 
Seat 5: flk.Dasas ($100 in chips) 
Seat 6: matiko09 ($100 in chips) 
Seat 7: mycka86 ($100 in chips) 
Seat 8: r4mz3s ($124.42 in chips) 
Seat 9: f1reworks ($108.30 in chips) 
matiko09: posts small blind $0.50
mycka86: posts big blind $1
*** HOLE CARDS ***
Dealt to matiko09 [2h Qh]
r4mz3s: folds 
f1reworks: folds 
tipner: raises $2 to $3
CI58: folds 
Racushniak: folds 
Greha999: folds 
flk.Dasas: folds 
matiko09: folds 
mycka86: calls $2
*** FLOP *** [Qd Ah 6c]
mycka86: checks 
tipner: checks 
*** TURN *** [Qd Ah 6c] [8d]
mycka86: checks 
tipner: checks 
*** RIVER *** [Qd Ah 6c 8d] [9s]
mycka86: bets $4.30
tipner: folds 
Uncalled bet ($4.30) returned to mycka86
mycka86 collected $6.18 from pot
*** SUMMARY ***
Total pot $6.50 | Rake $0.32 
Board [Qd Ah 6c 8d 9s]
Seat 1: tipner folded on the River
Seat 2: CI58 folded before Flop (didn't bet)
Seat 3: Racushniak folded before Flop (didn't bet)
Seat 4: Greha999 folded before Flop (didn't bet)
Seat 5: flk.Dasas (button) folded before Flop (didn't bet)
Seat 6: matiko09 (small blind) folded before Flop
Seat 7: mycka86 (big blind) collected ($6.18)
Seat 8: r4mz3s folded before Flop (didn't bet)
Seat 9: f1reworks folded before Flop (didn't bet)





PokerStars Hand #155302018269:  Hold'em No Limit ($0.50/$1.00 USD) - 2016/06/28 16:41:03 CET [2016/06/28 10:41:03 ET]
Table 'Zerlina' 9-max Seat #4 is the button
Seat 1: arctur17 ($20.85 in chips) 
Seat 2: matiko09 ($100 in chips) 
Seat 4: phil_cheng ($102.18 in chips) 
Seat 5: mycka86 ($101.50 in chips) 
Seat 6: sanpidk ($110.20 in chips) 
Seat 7: f1reworks ($268.32 in chips) 
Seat 8: Orga_060670 ($100 in chips) 
Seat 9: r4mz3s ($119.29 in chips) 
mycka86: posts small blind $0.50
sanpidk: posts big blind $1
*** HOLE CARDS ***
Dealt to matiko09 [2h 2c]
f1reworks: folds 
Orga_060670: folds 
r4mz3s: raises $1.55 to $2.55
arctur17: folds 
matiko09: folds 
phil_cheng: folds 
mycka86: folds 
sanpidk: calls $1.55
*** FLOP *** [3h 9s 7c]
sanpidk: checks 
r4mz3s: checks 
*** TURN *** [3h 9s 7c] [8d]
sanpidk: checks 
r4mz3s: checks 
*** RIVER *** [3h 9s 7c 8d] [Ah]
sanpidk: bets $3
r4mz3s: calls $3
*** SHOW DOWN ***
sanpidk: shows [As Ks] (a pair of Aces)
r4mz3s: mucks hand 
sanpidk collected $11.02 from pot
*** SUMMARY ***
Total pot $11.60 | Rake $0.58 
Board [3h 9s 7c 8d Ah]
Seat 1: arctur17 folded before Flop (didn't bet)
Seat 2: matiko09 folded before Flop (didn't bet)
Seat 4: phil_cheng (button) folded before Flop (didn't bet)
Seat 5: mycka86 (small blind) folded before Flop
Seat 6: sanpidk (big blind) showed [As Ks] and won ($11.02) with a pair of Aces
Seat 7: f1reworks folded before Flop (didn't bet)
Seat 8: Orga_060670 folded before Flop (didn't bet)
Seat 9: r4mz3s mucked [4d Ad]





PokerStars Hand #155302022405:  Hold'em No Limit ($0.50/$1.00 USD) - 2016/06/28 16:41:10 CET [2016/06/28 10:41:10 ET]
Table 'Anitra' 9-max Seat #4 is the button
Seat 1: Klappspaten0 ($107 in chips) 
Seat 2: ardo888 ($100 in chips) 
Seat 3: facelessPPP ($102.98 in chips) 
Seat 4: Shakeelg ($188.05 in chips) 
Seat 5: er13to ($101.70 in chips) 
Seat 6: matiko09 ($106 in chips) 
Seat 7: phil_cheng ($100 in chips) 
Seat 8: yoshinoino ($29 in chips) 
Seat 9: chenconhaste ($100 in chips) 
er13to: posts small blind $0.50
matiko09: posts big blind $1
*** HOLE CARDS ***
Dealt to matiko09 [2s 9c]
phil_cheng: raises $2 to $3
yoshinoino: folds 
chenconhaste: folds 
Klappspaten0: folds 
ardo888: folds 
facelessPPP: folds 
Shakeelg: folds 
er13to: folds 
matiko09: folds 
Uncalled bet ($2) returned to phil_cheng
phil_cheng collected $2.50 from pot
phil_cheng: doesn't show hand 
*** SUMMARY ***
Total pot $2.50 | Rake $0 
Seat 1: Klappspaten0 folded before Flop (didn't bet)
Seat 2: ardo888 folded before Flop (didn't bet)
Seat 3: facelessPPP folded before Flop (didn't bet)
Seat 4: Shakeelg (button) folded before Flop (didn't bet)
Seat 5: er13to (small blind) folded before Flop
Seat 6: matiko09 (big blind) folded before Flop
Seat 7: phil_cheng collected ($2.50)
Seat 8: yoshinoino folded before Flop (didn't bet)
Seat 9: chenconhaste folded before Flop (didn't bet)





PokerStars Hand #155302029520:  Hold'em No Limit ($0.50/$1.00 USD) - 2016/06/28 16:41:23 CET [2016/06/28 10:41:23 ET]
Table 'Dorado II' 9-max Seat #5 is the button
Seat 1: f1reworks ($167.43 in chips) 
Seat 2: vanilica ($100 in chips) 
Seat 3: ghostriderxu ($88.08 in chips) 
Seat 4: pyromid ($111 in chips) 
Seat 5: KovIFish89 ($109.07 in chips) 
Seat 6: mycka86 ($103.24 in chips) 
Seat 7: matiko09 ($100 in chips) 
Seat 8: flk.Dasas ($181.39 in chips) 
Seat 9: r4mz3s ($115.38 in chips) 
mycka86: posts small blind $0.50
matiko09: posts big blind $1
*** HOLE CARDS ***
Dealt to matiko09 [5s 6d]
flk.Dasas: folds 
r4mz3s: folds 
f1reworks: raises $2 to $3
vanilica: folds 
ghostriderxu: folds 
pyromid: folds 
KovIFish89: folds 
mycka86: calls $2.50
matiko09: folds 
*** FLOP *** [5d 2h 2d]
mycka86: checks 
f1reworks: checks 
*** TURN *** [5d 2h 2d] [7d]
mycka86: bets $4.50
f1reworks: folds 
Uncalled bet ($4.50) returned to mycka86
mycka86 collected $6.65 from pot
*** SUMMARY ***
Total pot $7 | Rake $0.35 
Board [5d 2h 2d 7d]
Seat 1: f1reworks folded on the Turn
Seat 2: vanilica folded before Flop (didn't bet)
Seat 3: ghostriderxu folded before Flop (didn't bet)
Seat 4: pyromid folded before Flop (didn't bet)
Seat 5: KovIFish89 (button) folded before Flop (didn't bet)
Seat 6: mycka86 (small blind) collected ($6.65)
Seat 7: matiko09 (big blind) folded before Flop
Seat 8: flk.Dasas folded before Flop (didn't bet)
Seat 9: r4mz3s folded before Flop (didn't bet)





PokerStars Hand #155302034043:  Hold'em No Limit ($0.25/$0.50 USD) - 2016/06/28 16:41:31 CET [2016/06/28 10:41:31 ET]
Table 'Bruchsalia II' 9-max Seat #8 is the button
Seat 1: ardo888 ($50 in chips) 
Seat 5: Edkar686 ($44.14 in chips) 
Seat 6: matiko09 ($50 in chips) 
Seat 7: Lipton20088 ($20 in chips) 
Seat 8: Kukuryzka ($49.75 in chips) 
Seat 9: app1e_j@ck ($50 in chips) 
app1e_j@ck: posts small blind $0.25
ardo888: posts big blind $0.50
william87872: sits out 
el.suertero: sits out 
*** HOLE CARDS ***
Dealt to matiko09 [8d 4d]
I_Freemen leaves the table
Edkar686: calls $0.50
matiko09: folds 
St.LaCoste joins the table at seat #4 
Lipton20088: raises $1 to $1.50
Kukuryzka: folds 
app1e_j@ck: folds 
ardo888: folds 
Edkar686: calls $1
*** FLOP *** [7s Kc 3h]
Edkar686: checks 
Lipton20088: bets $1.24
Edkar686: folds 
Uncalled bet ($1.24) returned to Lipton20088
Lipton20088 collected $3.56 from pot
Lipton20088: doesn't show hand 
*** SUMMARY ***
Total pot $3.75 | Rake $0.19 
Board [7s Kc 3h]
Seat 1: ardo888 (big blind) folded before Flop
Seat 5: Edkar686 folded on the Flop
Seat 6: matiko09 folded before Flop (didn't bet)
Seat 7: Lipton20088 collected ($3.56)
Seat 8: Kukuryzka (button) folded before Flop (didn't bet)
Seat 9: app1e_j@ck (small blind) folded before Flop





PokerStars Hand #155302035836:  Hold'em No Limit ($0.25/$0.50 USD) - 2016/06/28 16:41:35 CET [2016/06/28 10:41:35 ET]
Table 'Antonia II' 9-max Seat #9 is the button
Seat 1: er13to ($55 in chips) 
Seat 2: myatiy 96 ($51.84 in chips) 
Seat 4: el.suertero ($70.12 in chips) 
Seat 5: 35LOBO35 ($23.44 in chips) 
Seat 6: matiko09 ($54.25 in chips) 
Seat 7: Kukuryzka ($57.09 in chips) 
Seat 8: app1e_j@ck ($51.04 in chips) 
Seat 9: Domotirko228 ($50 in chips) 
er13to: posts small blind $0.25
myatiy 96: posts big blind $0.50
*** HOLE CARDS ***
Dealt to matiko09 [6h 4h]
el.suertero: raises $1 to $1.50
35LOBO35: folds 
matiko09: folds 
Kukuryzka: folds 
app1e_j@ck: folds 
Domotirko228: folds 
er13to: folds 
myatiy 96: folds 
Uncalled bet ($1) returned to el.suertero
el.suertero collected $1.25 from pot
el.suertero: doesn't show hand 
*** SUMMARY ***
Total pot $1.25 | Rake $0 
Seat 1: er13to (small blind) folded before Flop
Seat 2: myatiy 96 (big blind) folded before Flop
Seat 4: el.suertero collected ($1.25)
Seat 5: 35LOBO35 folded before Flop (didn't bet)
Seat 6: matiko09 folded before Flop (didn't bet)
Seat 7: Kukuryzka folded before Flop (didn't bet)
Seat 8: app1e_j@ck folded before Flop (didn't bet)
Seat 9: Domotirko228 (button) folded before Flop (didn't bet)





PokerStars Hand #155302036699:  Hold'em No Limit ($0.50/$1.00 USD) - 2016/06/28 16:41:36 CET [2016/06/28 10:41:36 ET]
Table 'Tomita' 9-max Seat #8 is the button
Seat 1: CI58 ($100 in chips) 
Seat 2: vanilica ($101.50 in chips) 
Seat 3: r4mz3s ($100 in chips) 
Seat 4: f1reworks ($119.57 in chips) 
Seat 5: ANDY19911608 ($144.68 in chips) 
Seat 6: tipner ($109.52 in chips) 
Seat 7: matiko09 ($140.94 in chips) 
Seat 8: Noob0Saibot ($115.32 in chips) 
Seat 9: sanpidk ($139.39 in chips) 
sanpidk: posts small blind $0.50
CI58: posts big blind $1
*** HOLE CARDS ***
Dealt to matiko09 [Ks Ts]
vanilica: folds 
r4mz3s: folds 
f1reworks: raises $2 to $3
ANDY19911608: calls $3
tipner: folds 
matiko09: calls $3
Noob0Saibot: folds 
sanpidk: calls $2.50
CI58: folds 
*** FLOP *** [2h Kd 3h]
sanpidk: checks 
f1reworks: bets $6.79
ANDY19911608: folds 
matiko09: calls $6.79
sanpidk: raises $20.21 to $27
f1reworks: folds 
matiko09: folds 
Uncalled bet ($20.21) returned to sanpidk
sanpidk collected $31.70 from pot
sanpidk: doesn't show hand 
*** SUMMARY ***
Total pot $33.37 | Rake $1.67 
Board [2h Kd 3h]
Seat 1: CI58 (big blind) folded before Flop
Seat 2: vanilica folded before Flop (didn't bet)
Seat 3: r4mz3s folded before Flop (didn't bet)
Seat 4: f1reworks folded on the Flop
Seat 5: ANDY19911608 folded on the Flop
Seat 6: tipner folded before Flop (didn't bet)
Seat 7: matiko09 folded on the Flop
Seat 8: Noob0Saibot (button) folded before Flop (didn't bet)
Seat 9: sanpidk (small blind) collected ($31.70)





PokerStars Hand #155302037501:  Hold'em No Limit ($0.50/$1.00 USD) - 2016/06/28 16:41:38 CET [2016/06/28 10:41:38 ET]
Table 'Anitra' 9-max Seat #5 is the button
Seat 1: Klappspaten0 ($107 in chips) 
Seat 2: ardo888 ($100 in chips) 
Seat 3: facelessPPP ($102.98 in chips) 
Seat 4: Shakeelg ($188.05 in chips) 
Seat 5: er13to ($101.20 in chips) 
Seat 6: matiko09 ($105 in chips) 
Seat 7: phil_cheng ($101.50 in chips) 
Seat 8: yoshinoino ($29 in chips) 
Seat 9: chenconhaste ($100 in chips) 
matiko09: posts small blind $0.50
phil_cheng: posts big blind $1
*** HOLE CARDS ***
Dealt to matiko09 [8h Jc]
yoshinoino: folds 
chenconhaste: folds 
Klappspaten0: folds 
ardo888: folds 
facelessPPP: folds 
Shakeelg: raises $2 to $3
er13to: folds 
matiko09: folds 
phil_cheng: folds 
Uncalled bet ($2) returned to Shakeelg
Shakeelg collected $2.50 from pot
Shakeelg: doesn't show hand 
*** SUMMARY ***
Total pot $2.50 | Rake $0 
Seat 1: Klappspaten0 folded before Flop (didn't bet)
Seat 2: ardo888 folded before Flop (didn't bet)
Seat 3: facelessPPP folded before Flop (didn't bet)
Seat 4: Shakeelg collected ($2.50)
Seat 5: er13to (button) folded before Flop (didn't bet)
Seat 6: matiko09 (small blind) folded before Flop
Seat 7: phil_cheng (big blind) folded before Flop
Seat 8: yoshinoino folded before Flop (didn't bet)
Seat 9: chenconhaste folded before Flop (didn't bet)





PokerStars Hand #155302057651:  Hold'em No Limit ($0.50/$1.00 USD) - 2016/06/28 16:42:14 CET [2016/06/28 10:42:14 ET]
Table 'Anitra' 9-max Seat #6 is the button
Seat 1: Klappspaten0 ($107 in chips) 
Seat 2: ardo888 ($100 in chips) 
Seat 3: facelessPPP ($102.98 in chips) 
Seat 4: Shakeelg ($189.55 in chips) 
Seat 5: er13to ($101.20 in chips) 
Seat 6: matiko09 ($104.50 in chips) 
Seat 7: phil_cheng ($100.50 in chips) 
Seat 8: yoshinoino ($29 in chips) 
Seat 9: chenconhaste ($100 in chips) 
phil_cheng: posts small blind $0.50
yoshinoino: posts big blind $1
*** HOLE CARDS ***
Dealt to matiko09 [7c 7s]
chenconhaste: raises $1.25 to $2.25
Klappspaten0: calls $2.25
ardo888: folds 
facelessPPP: folds 
Shakeelg: calls $2.25
er13to: folds 
matiko09: calls $2.25
phil_cheng: folds 
yoshinoino: calls $1.25
*** FLOP *** [Kh Jh 6d]
yoshinoino: checks 
chenconhaste: checks 
Klappspaten0: checks 
Shakeelg: checks 
matiko09: checks 
*** TURN *** [Kh Jh 6d] [Qs]
yoshinoino: checks 
chenconhaste: checks 
Klappspaten0: bets $8
Shakeelg: calls $8
matiko09: folds 
yoshinoino: folds 
chenconhaste: folds 
*** RIVER *** [Kh Jh 6d Qs] [9c]
Klappspaten0: checks 
Shakeelg: checks 
*** SHOW DOWN ***
Klappspaten0: shows [8s 8c] (a pair of Eights)
Shakeelg: mucks hand 
Klappspaten0 collected $26.36 from pot
*** SUMMARY ***
Total pot $27.75 | Rake $1.39 
Board [Kh Jh 6d Qs 9c]
Seat 1: Klappspaten0 showed [8s 8c] and won ($26.36) with a pair of Eights
Seat 2: ardo888 folded before Flop (didn't bet)
Seat 3: facelessPPP folded before Flop (didn't bet)
Seat 4: Shakeelg mucked [8h Ah]
Seat 5: er13to folded before Flop (didn't bet)
Seat 6: matiko09 (button) folded on the Turn
Seat 7: phil_cheng (small blind) folded before Flop
Seat 8: yoshinoino (big blind) folded on the Turn
Seat 9: chenconhaste folded on the Turn





PokerStars Hand #155302058738:  Hold'em No Limit ($0.50/$1.00 USD) - 2016/06/28 16:42:16 CET [2016/06/28 10:42:16 ET]
Table 'Zerlina' 9-max Seat #5 is the button
Seat 1: arctur17 ($20.85 in chips) 
Seat 2: matiko09 ($100 in chips) 
Seat 4: phil_cheng ($102.18 in chips) 
Seat 5: mycka86 ($101 in chips) 
Seat 6: sanpidk ($115.67 in chips) 
Seat 7: f1reworks ($268.32 in chips) 
Seat 8: Orga_060670 ($100 in chips) 
Seat 9: r4mz3s ($113.74 in chips) 
sanpidk: posts small blind $0.50
f1reworks: posts big blind $1
*** HOLE CARDS ***
Dealt to matiko09 [Jd 2d]
Orga_060670: folds 
r4mz3s: folds 
arctur17: folds 
matiko09: folds 
phil_cheng: raises $2 to $3
mycka86: folds 
sanpidk: raises $7.50 to $10.50
f1reworks: folds 
phil_cheng: folds 
Uncalled bet ($7.50) returned to sanpidk
sanpidk collected $7 from pot
sanpidk: doesn't show hand 
*** SUMMARY ***
Total pot $7 | Rake $0 
Seat 1: arctur17 folded before Flop (didn't bet)
Seat 2: matiko09 folded before Flop (didn't bet)
Seat 4: phil_cheng folded before Flop
Seat 5: mycka86 (button) folded before Flop (didn't bet)
Seat 6: sanpidk (small blind) collected ($7)
Seat 7: f1reworks (big blind) folded before Flop
Seat 8: Orga_060670 folded before Flop (didn't bet)
Seat 9: r4mz3s folded before Flop (didn't bet)





PokerStars Hand #155302060098:  Hold'em No Limit ($0.25/$0.50 USD) - 2016/06/28 16:42:18 CET [2016/06/28 10:42:18 ET]
Table 'Antonia II' 9-max Seat #1 is the button
Seat 1: er13to ($54.75 in chips) 
Seat 2: myatiy 96 ($51.34 in chips) 
Seat 4: el.suertero ($70.87 in chips) 
Seat 5: 35LOBO35 ($23.44 in chips) 
Seat 6: matiko09 ($54.25 in chips) 
Seat 7: Kukuryzka ($57.09 in chips) 
Seat 8: app1e_j@ck ($51.04 in chips) 
Seat 9: Domotirko228 ($50 in chips) 
myatiy 96: posts small blind $0.25
el.suertero: posts big blind $0.50
*** HOLE CARDS ***
Dealt to matiko09 [3d 9c]
35LOBO35: folds 
matiko09: folds 
Kukuryzka: raises $1 to $1.50
app1e_j@ck: folds 
Domotirko228: folds 
er13to: calls $1.50
myatiy 96: folds 
el.suertero: folds 
*** FLOP *** [7h 5c Kh]
Kukuryzka: bets $1.78
35LOBO35 is disconnected 
er13to: calls $1.78
*** TURN *** [7h 5c Kh] [3s]
Kukuryzka: checks 
er13to: bets $4.51
Kukuryzka: folds 
Uncalled bet ($4.51) returned to er13to
er13to collected $6.94 from pot
*** SUMMARY ***
Total pot $7.31 | Rake $0.37 
Board [7h 5c Kh 3s]
Seat 1: er13to (button) collected ($6.94)
Seat 2: myatiy 96 (small blind) folded before Flop
Seat 4: el.suertero (big blind) folded before Flop
Seat 5: 35LOBO35 folded before Flop (didn't bet)
Seat 6: matiko09 folded before Flop (didn't bet)
Seat 7: Kukuryzka folded on the Turn
Seat 8: app1e_j@ck folded before Flop (didn't bet)
Seat 9: Domotirko228 folded before Flop (didn't bet)





PokerStars Hand #155302059975:  Hold'em No Limit ($0.25/$0.50 USD) - 2016/06/28 16:42:18 CET [2016/06/28 10:42:18 ET]
Table 'Bruchsalia II' 9-max Seat #9 is the button
Seat 1: ardo888 ($50 in chips) 
Seat 2: william87872 ($50 in chips) 
Seat 5: Edkar686 ($42.64 in chips) 
Seat 6: matiko09 ($50 in chips) 
Seat 7: Lipton20088 ($22.06 in chips) 
Seat 8: Kukuryzka ($49.75 in chips) 
Seat 9: app1e_j@ck ($50 in chips) 
ardo888: posts small blind $0.25
william87872: posts big blind $0.50
el.suertero: sits out 
St.LaCoste: sits out 
*** HOLE CARDS ***
Dealt to matiko09 [5c Td]
Edkar686: folds 
matiko09: folds 
Lipton20088: folds 
Kukuryzka: folds 
app1e_j@ck: folds 
ardo888: folds 
Uncalled bet ($0.25) returned to william87872
william87872 collected $0.50 from pot
william87872: doesn't show hand 
*** SUMMARY ***
Total pot $0.50 | Rake $0 
Seat 1: ardo888 (small blind) folded before Flop
Seat 2: william87872 (big blind) collected ($0.50)
Seat 5: Edkar686 folded before Flop (didn't bet)
Seat 6: matiko09 folded before Flop (didn't bet)
Seat 7: Lipton20088 folded before Flop (didn't bet)
Seat 8: Kukuryzka folded before Flop (didn't bet)
Seat 9: app1e_j@ck (button) folded before Flop (didn't bet)





PokerStars Hand #155302061028:  Hold'em No Limit ($0.50/$1.00 USD) - 2016/06/28 16:42:20 CET [2016/06/28 10:42:20 ET]
Table 'Lyyli II' 9-max Seat #6 is the button
Seat 1: tipner ($124.53 in chips) 
Seat 2: CI58 ($132.52 in chips) 
Seat 4: Greha999 ($178.53 in chips) 
Seat 5: flk.Dasas ($100 in chips) 
Seat 6: matiko09 ($100 in chips) 
Seat 7: mycka86 ($103.18 in chips) 
Seat 8: r4mz3s ($124.42 in chips) 
Seat 9: f1reworks ($108.30 in chips) 
mycka86: posts small blind $0.50
r4mz3s: posts big blind $1
*** HOLE CARDS ***
Dealt to matiko09 [8h 3c]
f1reworks: folds 
tipner: folds 
CI58: folds 
Greha999: folds 
flk.Dasas: folds 
matiko09: folds 
mycka86: raises $1.75 to $2.75
r4mz3s: calls $1.75
*** FLOP *** [6c Ts Ks]
mycka86: bets $4
r4mz3s: folds 
Uncalled bet ($4) returned to mycka86
mycka86 collected $5.22 from pot
*** SUMMARY ***
Total pot $5.50 | Rake $0.28 
Board [6c Ts Ks]
Seat 1: tipner folded before Flop (didn't bet)
Seat 2: CI58 folded before Flop (didn't bet)
Seat 4: Greha999 folded before Flop (didn't bet)
Seat 5: flk.Dasas folded before Flop (didn't bet)
Seat 6: matiko09 (button) folded before Flop (didn't bet)
Seat 7: mycka86 (small blind) collected ($5.22)
Seat 8: r4mz3s (big blind) folded on the Flop
Seat 9: f1reworks folded before Flop (didn't bet)





PokerStars Hand #155302062519:  Hold'em No Limit ($0.50/$1.00 USD) - 2016/06/28 16:42:23 CET [2016/06/28 10:42:23 ET]
Table 'Dorado II' 9-max Seat #6 is the button
Seat 1: f1reworks ($164.43 in chips) 
Seat 2: vanilica ($100 in chips) 
Seat 3: ghostriderxu ($88.08 in chips) 
Seat 4: pyromid ($111 in chips) 
Seat 5: KovIFish89 ($109.07 in chips) 
Seat 6: mycka86 ($106.89 in chips) 
Seat 7: matiko09 ($100 in chips) 
Seat 8: flk.Dasas ($181.39 in chips) 
Seat 9: r4mz3s ($115.38 in chips) 
matiko09: posts small blind $0.50
flk.Dasas: posts big blind $1
*** HOLE CARDS ***
Dealt to matiko09 [6c 8c]
r4mz3s: folds 
f1reworks: folds 
vanilica: raises $2 to $3
ghostriderxu: folds 
pyromid: folds 
KovIFish89: calls $3
mycka86: raises $9 to $12
matiko09: folds 
flk.Dasas: folds 
vanilica: folds 
KovIFish89: folds 
Uncalled bet ($9) returned to mycka86
mycka86 collected $10.50 from pot
*** SUMMARY ***
Total pot $10.50 | Rake $0 
Seat 1: f1reworks folded before Flop (didn't bet)
Seat 2: vanilica folded before Flop
Seat 3: ghostriderxu folded before Flop (didn't bet)
Seat 4: pyromid folded before Flop (didn't bet)
Seat 5: KovIFish89 folded before Flop
Seat 6: mycka86 (button) collected ($10.50)
Seat 7: matiko09 (small blind) folded before Flop
Seat 8: flk.Dasas (big blind) folded before Flop
Seat 9: r4mz3s folded before Flop (didn't bet)





PokerStars Hand #155302068903:  Hold'em No Limit ($0.25/$0.50 USD) - 2016/06/28 16:42:34 CET [2016/06/28 10:42:34 ET]
Table 'Bruchsalia II' 9-max Seat #1 is the button
Seat 1: ardo888 ($50 in chips) 
Seat 2: william87872 ($50.25 in chips) 
Seat 3: el.suertero ($50 in chips) 
Seat 5: Edkar686 ($42.64 in chips) 
Seat 6: matiko09 ($50 in chips) 
Seat 7: Lipton20088 ($22.06 in chips) 
Seat 8: Kukuryzka ($49.75 in chips) 
Seat 9: app1e_j@ck ($50 in chips) 
william87872: posts small blind $0.25
el.suertero: posts big blind $0.50
St.LaCoste: sits out 
*** HOLE CARDS ***
Dealt to matiko09 [9h 7d]
Edkar686: calls $0.50
matiko09: folds 
Lipton20088: folds 
Kukuryzka: folds 
app1e_j@ck: raises $1.50 to $2
ardo888: folds 
william87872: folds 
el.suertero: calls $1.50
Edkar686: calls $1.50
*** FLOP *** [Kh Js Qd]
el.suertero: checks 
Edkar686: checks 
app1e_j@ck: checks 
*** TURN *** [Kh Js Qd] [3s]
el.suertero: checks 
Edkar686: checks 
app1e_j@ck: checks 
*** RIVER *** [Kh Js Qd 3s] [4d]
el.suertero: checks 
Edkar686: bets $2.97
app1e_j@ck: calls $2.97
el.suertero: folds 
*** SHOW DOWN ***
Edkar686: shows [9c Ah] (high card Ace)
app1e_j@ck: shows [Ad Qh] (a pair of Queens)
app1e_j@ck collected $11.58 from pot
*** SUMMARY ***
Total pot $12.19 | Rake $0.61 
Board [Kh Js Qd 3s 4d]
Seat 1: ardo888 (button) folded before Flop (didn't bet)
Seat 2: william87872 (small blind) folded before Flop
Seat 3: el.suertero (big blind) folded on the River
Seat 5: Edkar686 showed [9c Ah] and lost with high card Ace
Seat 6: matiko09 folded before Flop (didn't bet)
Seat 7: Lipton20088 folded before Flop (didn't bet)
Seat 8: Kukuryzka folded before Flop (didn't bet)
Seat 9: app1e_j@ck showed [Ad Qh] and won ($11.58) with a pair of Queens





PokerStars Hand #155302076291:  Hold'em No Limit ($0.25/$0.50 USD) - 2016/06/28 16:42:47 CET [2016/06/28 10:42:47 ET]
Table 'Lycomedes II' 9-max Seat #2 is the button
Seat 1: el.suertero ($96.50 in chips) 
Seat 2: NinjEH ($144.30 in chips) 
Seat 3: Xx7-Zeus-7xX ($37.24 in chips) 
Seat 4: matiko09 ($50 in chips) 
Seat 5: chata.iz ($45 in chips) 
Seat 6: mabbiche_007 ($56.96 in chips) 
Seat 7: william87872 ($50 in chips) 
Seat 8: pandalapa ($57.52 in chips) 
Seat 9: MINER68 ($54.15 in chips) 
Xx7-Zeus-7xX: posts small blind $0.25
matiko09: posts big blind $0.50
*** HOLE CARDS ***
Dealt to matiko09 [Jh Qh]
chata.iz: folds 
mabbiche_007: folds 
william87872: folds 
pandalapa: folds 
MINER68: folds 
el.suertero: raises $1 to $1.50
NinjEH: folds 
Xx7-Zeus-7xX: folds 
matiko09: calls $1
*** FLOP *** [9s Jd 9d]
matiko09: checks 
el.suertero: bets $1.08
matiko09: calls $1.08
*** TURN *** [9s Jd 9d] [Qs]
matiko09: checks 
el.suertero: bets $4.50
matiko09: calls $4.50
*** RIVER *** [9s Jd 9d Qs] [Ad]
matiko09: checks 
el.suertero: bets $11
matiko09: folds 
Uncalled bet ($11) returned to el.suertero
el.suertero collected $13.69 from pot
el.suertero: doesn't show hand 
*** SUMMARY ***
Total pot $14.41 | Rake $0.72 
Board [9s Jd 9d Qs Ad]
Seat 1: el.suertero collected ($13.69)
Seat 2: NinjEH (button) folded before Flop (didn't bet)
Seat 3: Xx7-Zeus-7xX (small blind) folded before Flop
Seat 4: matiko09 (big blind) folded on the River
Seat 5: chata.iz folded before Flop (didn't bet)
Seat 6: mabbiche_007 folded before Flop (didn't bet)
Seat 7: william87872 folded before Flop (didn't bet)
Seat 8: pandalapa folded before Flop (didn't bet)
Seat 9: MINER68 folded before Flop (didn't bet)





PokerStars Hand #155302079628:  Hold'em No Limit ($0.50/$1.00 USD) - 2016/06/28 16:42:53 CET [2016/06/28 10:42:53 ET]
Table 'Zerlina' 9-max Seat #6 is the button
Seat 1: arctur17 ($20.85 in chips) 
Seat 2: matiko09 ($100 in chips) 
Seat 4: phil_cheng ($100 in chips) 
Seat 5: mycka86 ($101 in chips) 
Seat 6: sanpidk ($119.67 in chips) 
Seat 7: f1reworks ($267.32 in chips) 
Seat 8: Orga_060670 ($100 in chips) 
Seat 9: r4mz3s ($113.74 in chips) 
f1reworks: posts small blind $0.50
Orga_060670: posts big blind $1
*** HOLE CARDS ***
Dealt to matiko09 [6d Jd]
r4mz3s: folds 
arctur17: folds 
matiko09: folds 
phil_cheng: folds 
mycka86: raises $1.10 to $2.10
sanpidk: folds 
f1reworks: calls $1.60
Orga_060670: folds 
*** FLOP *** [2s 8d Kd]
f1reworks: checks 
mycka86: checks 
*** TURN *** [2s 8d Kd] [Td]
f1reworks: bets $3
mycka86: calls $3
*** RIVER *** [2s 8d Kd Td] [Ac]
f1reworks: checks 
mycka86: checks 
*** SHOW DOWN ***
f1reworks: shows [Kh Qh] (a pair of Kings)
mycka86: mucks hand 
f1reworks collected $10.64 from pot
*** SUMMARY ***
Total pot $11.20 | Rake $0.56 
Board [2s 8d Kd Td Ac]
Seat 1: arctur17 folded before Flop (didn't bet)
Seat 2: matiko09 folded before Flop (didn't bet)
Seat 4: phil_cheng folded before Flop (didn't bet)
Seat 5: mycka86 mucked [Qs Qd]
Seat 6: sanpidk (button) folded before Flop (didn't bet)
Seat 7: f1reworks (small blind) showed [Kh Qh] and won ($10.64) with a pair of Kings
Seat 8: Orga_060670 (big blind) folded before Flop
Seat 9: r4mz3s folded before Flop (didn't bet)





PokerStars Hand #155302085135:  Hold'em No Limit ($0.50/$1.00 USD) - 2016/06/28 16:43:03 CET [2016/06/28 10:43:03 ET]
Table 'Dorado II' 9-max Seat #7 is the button
Seat 1: f1reworks ($164.43 in chips) 
Seat 2: vanilica ($100 in chips) 
Seat 3: ghostriderxu ($88.08 in chips) 
Seat 4: pyromid ($111 in chips) 
Seat 5: KovIFish89 ($106.07 in chips) 
Seat 6: mycka86 ($114.39 in chips) 
Seat 7: matiko09 ($100 in chips) 
Seat 8: flk.Dasas ($180.39 in chips) 
Seat 9: r4mz3s ($115.38 in chips) 
flk.Dasas: posts small blind $0.50
r4mz3s: posts big blind $1
*** HOLE CARDS ***
Dealt to matiko09 [3d 4s]
f1reworks: folds 
vanilica: raises $1.85 to $2.85
ghostriderxu: folds 
pyromid: folds 
KovIFish89: folds 
mycka86: folds 
matiko09: folds 
flk.Dasas: calls $2.35
r4mz3s: raises $10.15 to $13
vanilica: folds 
flk.Dasas: raises $167.39 to $180.39 and is all-in
r4mz3s: calls $102.38 and is all-in
Uncalled bet ($65.01) returned to flk.Dasas
*** FIRST FLOP *** [3h 2h 2s]
*** FIRST TURN *** [3h 2h 2s] [9h]
*** FIRST RIVER *** [3h 2h 2s 9h] [6s]
*** SECOND FLOP *** [Jc 6h Td]
*** SECOND TURN *** [Jc 6h Td] [8h]
*** SECOND RIVER *** [Jc 6h Td 8h] [5c]
*** FIRST SHOW DOWN ***
flk.Dasas: shows [Kh Ah] (a flush, Ace high)
r4mz3s: shows [Qd Qh] (two pair, Queens and Deuces)
flk.Dasas collected $115.56 from pot
*** SECOND SHOW DOWN ***
flk.Dasas: shows [Kh Ah] (high card Ace)
r4mz3s: shows [Qd Qh] (a pair of Queens)
r4mz3s collected $115.55 from pot
*** SUMMARY ***
Total pot $233.61 | Rake $2.50 
Hand was run twice
FIRST Board [3h 2h 2s 9h 6s]
SECOND Board [Jc 6h Td 8h 5c]
Seat 1: f1reworks folded before Flop (didn't bet)
Seat 2: vanilica folded before Flop
Seat 3: ghostriderxu folded before Flop (didn't bet)
Seat 4: pyromid folded before Flop (didn't bet)
Seat 5: KovIFish89 folded before Flop (didn't bet)
Seat 6: mycka86 folded before Flop (didn't bet)
Seat 7: matiko09 (button) folded before Flop (didn't bet)
Seat 8: flk.Dasas (small blind) showed [Kh Ah] and won ($115.56) with a flush, Ace high, and lost with high card Ace
Seat 9: r4mz3s (big blind) showed [Qd Qh] and lost with two pair, Queens and Deuces, and won ($115.55) with a pair of Queens





PokerStars Hand #155302088847:  Hold'em No Limit ($0.50/$1.00 USD) - 2016/06/28 16:43:10 CET [2016/06/28 10:43:10 ET]
Table 'Lyyli II' 9-max Seat #7 is the button
Seat 1: tipner ($124.53 in chips) 
Seat 2: CI58 ($132.52 in chips) 
Seat 4: Greha999 ($178.53 in chips) 
Seat 5: flk.Dasas ($100 in chips) 
Seat 6: matiko09 ($100 in chips) 
Seat 7: mycka86 ($105.65 in chips) 
Seat 8: r4mz3s ($121.67 in chips) 
Seat 9: f1reworks ($108.30 in chips) 
r4mz3s: posts small blind $0.50
f1reworks: posts big blind $1
*** HOLE CARDS ***
Dealt to matiko09 [4h 5c]
tipner: folds 
CI58: folds 
Greha999: folds 
flk.Dasas: folds 
matiko09: folds 
mycka86: folds 
r4mz3s: raises $2 to $3
f1reworks: calls $2
*** FLOP *** [Qs 9c Jd]
r4mz3s: checks 
f1reworks: checks 
*** TURN *** [Qs 9c Jd] [Ts]
r4mz3s: bets $4
f1reworks: folds 
Uncalled bet ($4) returned to r4mz3s
r4mz3s collected $5.70 from pot
r4mz3s: doesn't show hand 
*** SUMMARY ***
Total pot $6 | Rake $0.30 
Board [Qs 9c Jd Ts]
Seat 1: tipner folded before Flop (didn't bet)
Seat 2: CI58 folded before Flop (didn't bet)
Seat 4: Greha999 folded before Flop (didn't bet)
Seat 5: flk.Dasas folded before Flop (didn't bet)
Seat 6: matiko09 folded before Flop (didn't bet)
Seat 7: mycka86 (button) folded before Flop (didn't bet)
Seat 8: r4mz3s (small blind) collected ($5.70)
Seat 9: f1reworks (big blind) folded on the Turn





PokerStars Hand #155302099926:  Hold'em No Limit ($0.25/$0.50 USD) - 2016/06/28 16:43:30 CET [2016/06/28 10:43:30 ET]
Table 'Lacadiera' 9-max Seat #8 is the button
Seat 1: matiko09 ($50 in chips) 
Seat 2: Alexey_Kim2 ($50 in chips) 
Seat 3: el.suertero ($111.91 in chips) 
Seat 4: denitz21 ($100 in chips) 
Seat 6: Kukuryzka ($97.02 in chips) 
Seat 7: chenconhaste ($62.46 in chips) 
Seat 8: Vedpapa ($68.40 in chips) 
Seat 9: Fakespecial ($262.94 in chips) 
Fakespecial: posts small blind $0.25
matiko09: posts big blind $0.50
william87872: sits out 
*** HOLE CARDS ***
Dealt to matiko09 [2h 6s]
Alexey_Kim2: folds 
el.suertero: folds 
denitz21: raises $1.50 to $2
Kukuryzka: folds 
chenconhaste: folds 
Vedpapa: folds 
Fakespecial: folds 
matiko09: folds 
Uncalled bet ($1.50) returned to denitz21
denitz21 collected $1.25 from pot
denitz21: doesn't show hand 
*** SUMMARY ***
Total pot $1.25 | Rake $0 
Seat 1: matiko09 (big blind) folded before Flop
Seat 2: Alexey_Kim2 folded before Flop (didn't bet)
Seat 3: el.suertero folded before Flop (didn't bet)
Seat 4: denitz21 collected ($1.25)
Seat 6: Kukuryzka folded before Flop (didn't bet)
Seat 7: chenconhaste folded before Flop (didn't bet)
Seat 8: Vedpapa (button) folded before Flop (didn't bet)
Seat 9: Fakespecial (small blind) folded before Flop





PokerStars Hand #155302108003:  Hold'em No Limit ($0.50/$1.00 USD) - 2016/06/28 16:43:44 CET [2016/06/28 10:43:44 ET]
Table 'Tomita' 9-max Seat #9 is the button
Seat 1: CI58 ($100 in chips) 
Seat 2: vanilica ($101.50 in chips) 
Seat 3: r4mz3s ($100 in chips) 
Seat 4: f1reworks ($109.78 in chips) 
Seat 5: ANDY19911608 ($141.68 in chips) 
Seat 6: tipner ($109.52 in chips) 
Seat 7: matiko09 ($131.15 in chips) 
Seat 8: Noob0Saibot ($115.32 in chips) 
Seat 9: sanpidk ($161.30 in chips) 
CI58: posts small blind $0.50
vanilica: posts big blind $1
*** HOLE CARDS ***
Dealt to matiko09 [Qh 4d]
r4mz3s: folds 
f1reworks: folds 
ANDY19911608: raises $1 to $2
tipner: folds 
matiko09: folds 
Noob0Saibot: folds 
sanpidk: folds 
CI58: folds 
vanilica: folds 
Uncalled bet ($1) returned to ANDY19911608
ANDY19911608 collected $2.50 from pot
ANDY19911608: doesn't show hand 
*** SUMMARY ***
Total pot $2.50 | Rake $0 
Seat 1: CI58 (small blind) folded before Flop
Seat 2: vanilica (big blind) folded before Flop
Seat 3: r4mz3s folded before Flop (didn't bet)
Seat 4: f1reworks folded before Flop (didn't bet)
Seat 5: ANDY19911608 collected ($2.50)
Seat 6: tipner folded before Flop (didn't bet)
Seat 7: matiko09 folded before Flop (didn't bet)
Seat 8: Noob0Saibot folded before Flop (didn't bet)
Seat 9: sanpidk (button) folded before Flop (didn't bet)





PokerStars Hand #155302110867:  Hold'em No Limit ($0.25/$0.50 USD) - 2016/06/28 16:43:50 CET [2016/06/28 10:43:50 ET]
Table 'Lycomedes II' 9-max Seat #3 is the button
Seat 1: el.suertero ($103.11 in chips) 
Seat 2: NinjEH ($144.30 in chips) 
Seat 3: Xx7-Zeus-7xX ($50 in chips) 
Seat 4: matiko09 ($50 in chips) 
Seat 5: chata.iz ($45 in chips) 
Seat 6: mabbiche_007 ($56.96 in chips) 
Seat 7: william87872 ($50 in chips) 
Seat 8: pandalapa ($57.52 in chips) 
Seat 9: MINER68 ($54.15 in chips) 
matiko09: posts small blind $0.25
chata.iz: posts big blind $0.50
*** HOLE CARDS ***
Dealt to matiko09 [7d Jd]
mabbiche_007: folds 
william87872: folds 
pandalapa: folds 
MINER68: folds 
el.suertero: folds 
NinjEH: folds 
Xx7-Zeus-7xX: folds 
matiko09: raises $1 to $1.50
chata.iz: calls $1
*** FLOP *** [3d 8c Jh]
matiko09: bets $1.85
chata.iz: calls $1.85
*** TURN *** [3d 8c Jh] [Ah]
matiko09: checks 
chata.iz: bets $3.50
matiko09: folds 
Uncalled bet ($3.50) returned to chata.iz
chata.iz collected $6.36 from pot
chata.iz: doesn't show hand 
*** SUMMARY ***
Total pot $6.70 | Rake $0.34 
Board [3d 8c Jh Ah]
Seat 1: el.suertero folded before Flop (didn't bet)
Seat 2: NinjEH folded before Flop (didn't bet)
Seat 3: Xx7-Zeus-7xX (button) folded before Flop (didn't bet)
Seat 4: matiko09 (small blind) folded on the Turn
Seat 5: chata.iz (big blind) collected ($6.36)
Seat 6: mabbiche_007 folded before Flop (didn't bet)
Seat 7: william87872 folded before Flop (didn't bet)
Seat 8: pandalapa folded before Flop (didn't bet)
Seat 9: MINER68 folded before Flop (didn't bet)





PokerStars Hand #155302114372:  Hold'em No Limit ($0.50/$1.00 USD) - 2016/06/28 16:43:56 CET [2016/06/28 10:43:56 ET]
Table 'Zerlina' 9-max Seat #7 is the button
Seat 1: arctur17 ($20.85 in chips) 
Seat 2: matiko09 ($100 in chips) 
Seat 4: phil_cheng ($100 in chips) 
Seat 5: mycka86 ($100 in chips) 
Seat 6: sanpidk ($119.67 in chips) 
Seat 7: f1reworks ($272.86 in chips) 
Seat 8: Orga_060670 ($99 in chips) 
Seat 9: r4mz3s ($113.74 in chips) 
Orga_060670: posts small blind $0.50
r4mz3s: posts big blind $1
*** HOLE CARDS ***
Dealt to matiko09 [5s Qh]
arctur17: raises $2 to $3
matiko09: folds 
phil_cheng: folds 
mycka86: folds 
sanpidk: folds 
f1reworks: folds 
Orga_060670: folds 
r4mz3s: folds 
Uncalled bet ($2) returned to arctur17
arctur17 collected $2.50 from pot
arctur17: doesn't show hand 
*** SUMMARY ***
Total pot $2.50 | Rake $0 
Seat 1: arctur17 collected ($2.50)
Seat 2: matiko09 folded before Flop (didn't bet)
Seat 4: phil_cheng folded before Flop (didn't bet)
Seat 5: mycka86 folded before Flop (didn't bet)
Seat 6: sanpidk folded before Flop (didn't bet)
Seat 7: f1reworks (button) folded before Flop (didn't bet)
Seat 8: Orga_060670 (small blind) folded before Flop
Seat 9: r4mz3s (big blind) folded before Flop





PokerStars Hand #155302117304:  Hold'em No Limit ($0.25/$0.50 USD) - 2016/06/28 16:44:01 CET [2016/06/28 10:44:01 ET]
Table 'Antonia II' 9-max Seat #2 is the button
Seat 1: er13to ($58.41 in chips) 
Seat 2: myatiy 96 ($51.09 in chips) 
Seat 4: el.suertero ($70.37 in chips) 
Seat 6: matiko09 ($54.25 in chips) 
Seat 7: Kukuryzka ($53.81 in chips) 
Seat 8: app1e_j@ck ($51.04 in chips) 
Seat 9: Domotirko228 ($50 in chips) 
el.suertero: posts small blind $0.25
35LOBO35 has timed out while disconnected
35LOBO35: is sitting out 
matiko09: posts big blind $0.50
*** HOLE CARDS ***
Dealt to matiko09 [Qs Kc]
Kukuryzka: folds 
app1e_j@ck: folds 
Domotirko228: folds 
er13to: raises $0.86 to $1.36
myatiy 96: folds 
el.suertero: folds 
matiko09: calls $0.86
*** FLOP *** [7s 3h 2h]
matiko09: checks 
er13to: checks 
*** TURN *** [7s 3h 2h] [6c]
matiko09: bets $1.83
er13to: folds 
Uncalled bet ($1.83) returned to matiko09
matiko09 collected $2.82 from pot
matiko09: doesn't show hand 
*** SUMMARY ***
Total pot $2.97 | Rake $0.15 
Board [7s 3h 2h 6c]
Seat 1: er13to folded on the Turn
Seat 2: myatiy 96 (button) folded before Flop (didn't bet)
Seat 4: el.suertero (small blind) folded before Flop
Seat 6: matiko09 (big blind) collected ($2.82)
Seat 7: Kukuryzka folded before Flop (didn't bet)
Seat 8: app1e_j@ck folded before Flop (didn't bet)
Seat 9: Domotirko228 folded before Flop (didn't bet)





PokerStars Hand #155302123414:  Hold'em No Limit ($0.25/$0.50 USD) - 2016/06/28 16:44:12 CET [2016/06/28 10:44:12 ET]
Table 'Lacadiera' 9-max Seat #9 is the button
Seat 1: matiko09 ($50 in chips) 
Seat 2: Alexey_Kim2 ($50 in chips) 
Seat 3: el.suertero ($111.91 in chips) 
Seat 4: denitz21 ($100.75 in chips) 
Seat 6: Kukuryzka ($97.02 in chips) 
Seat 7: chenconhaste ($62.46 in chips) 
Seat 8: Vedpapa ($68.40 in chips) 
Seat 9: Fakespecial ($262.69 in chips) 
matiko09: posts small blind $0.25
Alexey_Kim2: posts big blind $0.50
william87872: sits out 
*** HOLE CARDS ***
Dealt to matiko09 [2c Ad]
el.suertero: folds 
denitz21: raises $1.50 to $2
Kukuryzka: folds 
chenconhaste: folds 
Vedpapa: folds 
Fakespecial: calls $2
matiko09: folds 
Alexey_Kim2: folds 
*** FLOP *** [3h 4h 6h]
denitz21: bets $4.50
Fakespecial: raises $4.50 to $9
denitz21: calls $4.50
*** TURN *** [3h 4h 6h] [Js]
denitz21: checks 
Fakespecial: checks 
*** RIVER *** [3h 4h 6h Js] [Kc]
denitz21: checks 
Fakespecial: bets $11
denitz21: calls $11
*** SHOW DOWN ***
Fakespecial: shows [Ah 4c] (a pair of Fours)
denitz21: shows [Ts Tc] (a pair of Tens)
denitz21 collected $42.75 from pot
*** SUMMARY ***
Total pot $44.75 | Rake $2 
Board [3h 4h 6h Js Kc]
Seat 1: matiko09 (small blind) folded before Flop
Seat 2: Alexey_Kim2 (big blind) folded before Flop
Seat 3: el.suertero folded before Flop (didn't bet)
Seat 4: denitz21 showed [Ts Tc] and won ($42.75) with a pair of Tens
Seat 6: Kukuryzka folded before Flop (didn't bet)
Seat 7: chenconhaste folded before Flop (didn't bet)
Seat 8: Vedpapa folded before Flop (didn't bet)
Seat 9: Fakespecial (button) showed [Ah 4c] and lost with a pair of Fours





PokerStars Hand #155302124409:  Hold'em No Limit ($0.50/$1.00 USD) - 2016/06/28 16:44:14 CET [2016/06/28 10:44:14 ET]
Table 'Tomita' 9-max Seat #1 is the button
Seat 1: CI58 ($100 in chips) 
Seat 2: vanilica ($100.50 in chips) 
Seat 3: r4mz3s ($100 in chips) 
Seat 4: f1reworks ($109.78 in chips) 
Seat 5: ANDY19911608 ($143.18 in chips) 
Seat 6: tipner ($109.52 in chips) 
Seat 7: matiko09 ($131.15 in chips) 
Seat 8: Noob0Saibot ($115.32 in chips) 
Seat 9: sanpidk ($161.30 in chips) 
vanilica: posts small blind $0.50
r4mz3s: posts big blind $1
*** HOLE CARDS ***
Dealt to matiko09 [Kc 8h]
f1reworks: folds 
ANDY19911608: raises $2 to $3
tipner: folds 
matiko09: folds 
Noob0Saibot: raises $6 to $9
sanpidk: folds 
CI58: folds 
vanilica: folds 
r4mz3s: folds 
ANDY19911608: calls $6
*** FLOP *** [6c Qd 7s]
ANDY19911608: checks 
Noob0Saibot: bets $5.92
ANDY19911608: raises $5.92 to $11.84
Noob0Saibot: calls $5.92
*** TURN *** [6c Qd 7s] [5d]
ANDY19911608: checks 
Noob0Saibot: checks 
*** RIVER *** [6c Qd 7s 5d] [Qh]
ANDY19911608: checks 
Noob0Saibot: checks 
*** SHOW DOWN ***
ANDY19911608: shows [6h Ad] (two pair, Queens and Sixes)
Noob0Saibot: mucks hand 
ANDY19911608 collected $41.02 from pot
*** SUMMARY ***
Total pot $43.18 | Rake $2.16 
Board [6c Qd 7s 5d Qh]
Seat 1: CI58 (button) folded before Flop (didn't bet)
Seat 2: vanilica (small blind) folded before Flop
Seat 3: r4mz3s (big blind) folded before Flop
Seat 4: f1reworks folded before Flop (didn't bet)
Seat 5: ANDY19911608 showed [6h Ad] and won ($41.02) with two pair, Queens and Sixes
Seat 6: tipner folded before Flop (didn't bet)
Seat 7: matiko09 folded before Flop (didn't bet)
Seat 8: Noob0Saibot mucked [As Ks]
Seat 9: sanpidk folded before Flop (didn't bet)





PokerStars Hand #155302125239:  Hold'em No Limit ($0.25/$0.50 USD) - 2016/06/28 16:44:16 CET [2016/06/28 10:44:16 ET]
Table 'Bruchsalia II' 9-max Seat #2 is the button
Seat 1: ardo888 ($50 in chips) 
Seat 2: william87872 ($50 in chips) 
Seat 3: el.suertero ($50 in chips) 
Seat 4: St.LaCoste ($43 in chips) 
Seat 5: Edkar686 ($37.67 in chips) 
Seat 6: matiko09 ($50 in chips) 
Seat 7: Lipton20088 ($22.06 in chips) 
Seat 8: Kukuryzka ($49.75 in chips) 
Seat 9: app1e_j@ck ($56.61 in chips) 
el.suertero: posts small blind $0.25
St.LaCoste: posts big blind $0.50
*** HOLE CARDS ***
Dealt to matiko09 [3h Ts]
Edkar686: calls $0.50
matiko09: folds 
Lipton20088: folds 
Kukuryzka: raises $1.50 to $2
app1e_j@ck: folds 
ardo888: folds 
william87872: folds 
el.suertero: folds 
St.LaCoste: folds 
Edkar686: calls $1.50
*** FLOP *** [Qh 6c 4d]
Edkar686: checks 
Kukuryzka: bets $2.26
Edkar686: folds 
Uncalled bet ($2.26) returned to Kukuryzka
Kukuryzka collected $4.51 from pot
Kukuryzka: doesn't show hand 
*** SUMMARY ***
Total pot $4.75 | Rake $0.24 
Board [Qh 6c 4d]
Seat 1: ardo888 folded before Flop (didn't bet)
Seat 2: william87872 (button) folded before Flop (didn't bet)
Seat 3: el.suertero (small blind) folded before Flop
Seat 4: St.LaCoste (big blind) folded before Flop
Seat 5: Edkar686 folded on the Flop
Seat 6: matiko09 folded before Flop (didn't bet)
Seat 7: Lipton20088 folded before Flop (didn't bet)
Seat 8: Kukuryzka collected ($4.51)
Seat 9: app1e_j@ck folded before Flop (didn't bet)





PokerStars Hand #155302127161:  Hold'em No Limit ($0.50/$1.00 USD) - 2016/06/28 16:44:19 CET [2016/06/28 10:44:19 ET]
Table 'Lyyli II' 9-max Seat #8 is the button
Seat 1: tipner ($124.53 in chips) 
Seat 2: CI58 ($132.52 in chips) 
Seat 4: Greha999 ($178.53 in chips) 
Seat 5: flk.Dasas ($100 in chips) 
Seat 6: matiko09 ($100 in chips) 
Seat 7: mycka86 ($105.65 in chips) 
Seat 8: r4mz3s ($124.37 in chips) 
Seat 9: f1reworks ($105.30 in chips) 
f1reworks: posts small blind $0.50
tipner: posts big blind $1
*** HOLE CARDS ***
Dealt to matiko09 [7c 9s]
CI58: folds 
Greha999: folds 
flk.Dasas: folds 
matiko09: folds 
mycka86: raises $1.10 to $2.10
r4mz3s: folds 
f1reworks: calls $1.60
tipner: folds 
*** FLOP *** [2c Jc 3h]
f1reworks: checks 
mycka86: bets $3.50
f1reworks: folds 
Uncalled bet ($3.50) returned to mycka86
mycka86 collected $4.94 from pot
*** SUMMARY ***
Total pot $5.20 | Rake $0.26 
Board [2c Jc 3h]
Seat 1: tipner (big blind) folded before Flop
Seat 2: CI58 folded before Flop (didn't bet)
Seat 4: Greha999 folded before Flop (didn't bet)
Seat 5: flk.Dasas folded before Flop (didn't bet)
Seat 6: matiko09 folded before Flop (didn't bet)
Seat 7: mycka86 collected ($4.94)
Seat 8: r4mz3s (button) folded before Flop (didn't bet)
Seat 9: f1reworks (small blind) folded on the Flop





PokerStars Hand #155302131399:  Hold'em No Limit ($0.50/$1.00 USD) - 2016/06/28 16:44:27 CET [2016/06/28 10:44:27 ET]
Table 'Zerlina' 9-max Seat #8 is the button
Seat 1: arctur17 ($22.35 in chips) 
Seat 2: matiko09 ($100 in chips) 
Seat 4: phil_cheng ($100 in chips) 
Seat 5: mycka86 ($100 in chips) 
Seat 6: sanpidk ($119.67 in chips) 
Seat 7: f1reworks ($272.86 in chips) 
Seat 8: Orga_060670 ($100 in chips) 
Seat 9: r4mz3s ($112.74 in chips) 
r4mz3s: posts small blind $0.50
arctur17: posts big blind $1
*** HOLE CARDS ***
Dealt to matiko09 [6h Jd]
matiko09: folds 
phil_cheng: raises $2 to $3
mycka86: folds 
sanpidk: folds 
f1reworks: folds 
Orga_060670: folds 
r4mz3s: folds 
arctur17: folds 
Uncalled bet ($2) returned to phil_cheng
phil_cheng collected $2.50 from pot
phil_cheng: doesn't show hand 
*** SUMMARY ***
Total pot $2.50 | Rake $0 
Seat 1: arctur17 (big blind) folded before Flop
Seat 2: matiko09 folded before Flop (didn't bet)
Seat 4: phil_cheng collected ($2.50)
Seat 5: mycka86 folded before Flop (didn't bet)
Seat 6: sanpidk folded before Flop (didn't bet)
Seat 7: f1reworks folded before Flop (didn't bet)
Seat 8: Orga_060670 (button) folded before Flop (didn't bet)
Seat 9: r4mz3s (small blind) folded before Flop





PokerStars Hand #155302136028:  Hold'em No Limit ($0.50/$1.00 USD) - 2016/06/28 16:44:35 CET [2016/06/28 10:44:35 ET]
Table 'Dorado II' 9-max Seat #8 is the button
Seat 1: f1reworks ($164.43 in chips) 
Seat 2: vanilica ($100 in chips) 
Seat 3: ghostriderxu ($88.08 in chips) 
Seat 4: pyromid ($111 in chips) 
Seat 5: KovIFish89 ($106.07 in chips) 
Seat 6: mycka86 ($114.39 in chips) 
Seat 7: matiko09 ($100 in chips) 
Seat 8: flk.Dasas ($180.57 in chips) 
Seat 9: r4mz3s ($115.55 in chips) 
r4mz3s: posts small blind $0.50
f1reworks: posts big blind $1
*** HOLE CARDS ***
Dealt to matiko09 [7s Kh]
vanilica: folds 
ghostriderxu: raises $1 to $2
pyromid: raises $6 to $8
KovIFish89: folds 
mycka86: folds 
matiko09: folds 
flk.Dasas: folds 
r4mz3s: folds 
f1reworks: folds 
ghostriderxu: calls $6
*** FLOP *** [3c 4s 5h]
ghostriderxu: checks 
pyromid: bets $10
ghostriderxu: folds 
Uncalled bet ($10) returned to pyromid
pyromid collected $16.62 from pot
pyromid: doesn't show hand 
*** SUMMARY ***
Total pot $17.50 | Rake $0.88 
Board [3c 4s 5h]
Seat 1: f1reworks (big blind) folded before Flop
Seat 2: vanilica folded before Flop (didn't bet)
Seat 3: ghostriderxu folded on the Flop
Seat 4: pyromid collected ($16.62)
Seat 5: KovIFish89 folded before Flop (didn't bet)
Seat 6: mycka86 folded before Flop (didn't bet)
Seat 7: matiko09 folded before Flop (didn't bet)
Seat 8: flk.Dasas (button) folded before Flop (didn't bet)
Seat 9: r4mz3s (small blind) folded before Flop





PokerStars Hand #155302141063:  Hold'em No Limit ($0.25/$0.50 USD) - 2016/06/28 16:44:44 CET [2016/06/28 10:44:44 ET]
Table 'Lycomedes II' 9-max Seat #4 is the button
Seat 1: el.suertero ($103.11 in chips) 
Seat 2: NinjEH ($144.30 in chips) 
Seat 3: Xx7-Zeus-7xX ($50 in chips) 
Seat 4: matiko09 ($50 in chips) 
Seat 5: chata.iz ($48.01 in chips) 
Seat 6: mabbiche_007 ($56.96 in chips) 
Seat 7: william87872 ($50 in chips) 
Seat 8: pandalapa ($57.52 in chips) 
Seat 9: MINER68 ($54.15 in chips) 
chata.iz: posts small blind $0.25
mabbiche_007: posts big blind $0.50
*** HOLE CARDS ***
Dealt to matiko09 [5s 2d]
william87872: folds 
pandalapa: folds 
MINER68: calls $0.50
el.suertero: folds 
NinjEH: raises $1 to $1.50
Xx7-Zeus-7xX: folds 
matiko09: folds 
chata.iz: folds 
mabbiche_007: folds 
MINER68: calls $1
*** FLOP *** [Ah 9s 3s]
MINER68: checks 
NinjEH: bets $1.78
MINER68: folds 
Uncalled bet ($1.78) returned to NinjEH
NinjEH collected $3.56 from pot
NinjEH: doesn't show hand 
*** SUMMARY ***
Total pot $3.75 | Rake $0.19 
Board [Ah 9s 3s]
Seat 1: el.suertero folded before Flop (didn't bet)
Seat 2: NinjEH collected ($3.56)
Seat 3: Xx7-Zeus-7xX folded before Flop (didn't bet)
Seat 4: matiko09 (button) folded before Flop (didn't bet)
Seat 5: chata.iz (small blind) folded before Flop
Seat 6: mabbiche_007 (big blind) folded before Flop
Seat 7: william87872 folded before Flop (didn't bet)
Seat 8: pandalapa folded before Flop (didn't bet)
Seat 9: MINER68 folded on the Flop





PokerStars Hand #155302142209:  Hold'em No Limit ($0.50/$1.00 USD) - 2016/06/28 16:44:46 CET [2016/06/28 10:44:46 ET]
Table 'Anitra' 9-max Seat #7 is the button
Seat 1: Klappspaten0 ($123.11 in chips) 
Seat 2: ardo888 ($100 in chips) 
Seat 3: facelessPPP ($102.98 in chips) 
Seat 4: Shakeelg ($179.30 in chips) 
Seat 5: er13to ($101.20 in chips) 
Seat 6: matiko09 ($102.25 in chips) 
Seat 7: phil_cheng ($100 in chips) 
Seat 8: yoshinoino ($26.75 in chips) 
Seat 9: chenconhaste ($100 in chips) 
yoshinoino: posts small blind $0.50
chenconhaste: posts big blind $1
*** HOLE CARDS ***
Dealt to matiko09 [8c 7s]
Klappspaten0: folds 
ardo888: folds 
facelessPPP: raises $2 to $3
Shakeelg: calls $3
er13to: folds 
Klappspaten0 leaves the table
matiko09: folds 
phil_cheng: folds 
yoshinoino: folds 
chenconhaste: folds 
*** FLOP *** [As 4c 5d]
facelessPPP: bets $4.12
Shakeelg: calls $4.12
*** TURN *** [As 4c 5d] [6c]
sanpidk joins the table at seat #1 
facelessPPP: checks 
sanpidk leaves the table
Shakeelg: bets $7
facelessPPP: folds 
Uncalled bet ($7) returned to Shakeelg
Shakeelg collected $14.95 from pot
Shakeelg: doesn't show hand 
*** SUMMARY ***
Total pot $15.74 | Rake $0.79 
Board [As 4c 5d 6c]
Seat 1: Klappspaten0 folded before Flop (didn't bet)
Seat 2: ardo888 folded before Flop (didn't bet)
Seat 3: facelessPPP folded on the Turn
Seat 4: Shakeelg collected ($14.95)
Seat 5: er13to folded before Flop (didn't bet)
Seat 6: matiko09 folded before Flop (didn't bet)
Seat 7: phil_cheng (button) folded before Flop (didn't bet)
Seat 8: yoshinoino (small blind) folded before Flop
Seat 9: chenconhaste (big blind) folded before Flop





PokerStars Hand #155302147458:  Hold'em No Limit ($0.50/$1.00 USD) - 2016/06/28 16:44:55 CET [2016/06/28 10:44:55 ET]
Table 'Lyyli II' 9-max Seat #9 is the button
Seat 1: tipner ($123.53 in chips) 
Seat 2: CI58 ($132.52 in chips) 
Seat 4: Greha999 ($178.53 in chips) 
Seat 5: flk.Dasas ($100 in chips) 
Seat 6: matiko09 ($100 in chips) 
Seat 7: mycka86 ($108.49 in chips) 
Seat 8: r4mz3s ($124.37 in chips) 
Seat 9: f1reworks ($103.20 in chips) 
tipner: posts small blind $0.50
CI58: posts big blind $1
*** HOLE CARDS ***
Dealt to matiko09 [5d Th]
Greha999: folds 
flk.Dasas: folds 
matiko09: folds 
mycka86: folds 
r4mz3s: folds 
f1reworks: raises $1.10 to $2.10
tipner: folds 
CI58: folds 
Uncalled bet ($1.10) returned to f1reworks
f1reworks collected $2.50 from pot
f1reworks: doesn't show hand 
*** SUMMARY ***
Total pot $2.50 | Rake $0 
Seat 1: tipner (small blind) folded before Flop
Seat 2: CI58 (big blind) folded before Flop
Seat 4: Greha999 folded before Flop (didn't bet)
Seat 5: flk.Dasas folded before Flop (didn't bet)
Seat 6: matiko09 folded before Flop (didn't bet)
Seat 7: mycka86 folded before Flop (didn't bet)
Seat 8: r4mz3s folded before Flop (didn't bet)
Seat 9: f1reworks (button) collected ($2.50)





PokerStars Hand #155302153868:  Hold'em No Limit ($0.25/$0.50 USD) - 2016/06/28 16:45:06 CET [2016/06/28 10:45:06 ET]
Table 'Bruchsalia II' 9-max Seat #3 is the button
Seat 1: ardo888 ($50 in chips) 
Seat 2: william87872 ($50 in chips) 
Seat 3: el.suertero ($50 in chips) 
Seat 4: St.LaCoste ($42.50 in chips) 
Seat 5: Edkar686 ($35.67 in chips) 
Seat 6: matiko09 ($50 in chips) 
Seat 7: Lipton20088 ($22.06 in chips) 
Seat 8: Kukuryzka ($52.26 in chips) 
Seat 9: app1e_j@ck ($56.61 in chips) 
St.LaCoste: posts small blind $0.25
Edkar686: posts big blind $0.50
*** HOLE CARDS ***
Dealt to matiko09 [2s 7c]
matiko09: folds 
Lipton20088: folds 
Kukuryzka: folds 
app1e_j@ck: folds 
ardo888: raises $1 to $1.50
william87872: folds 
el.suertero: folds 
St.LaCoste: folds 
Edkar686: calls $1
*** FLOP *** [6c 9s As]
Edkar686: checks 
ardo888: bets $2.34
Edkar686: folds 
Uncalled bet ($2.34) returned to ardo888
ardo888 collected $3.09 from pot
ardo888: doesn't show hand 
*** SUMMARY ***
Total pot $3.25 | Rake $0.16 
Board [6c 9s As]
Seat 1: ardo888 collected ($3.09)
Seat 2: william87872 folded before Flop (didn't bet)
Seat 3: el.suertero (button) folded before Flop (didn't bet)
Seat 4: St.LaCoste (small blind) folded before Flop
Seat 5: Edkar686 (big blind) folded on the Flop
Seat 6: matiko09 folded before Flop (didn't bet)
Seat 7: Lipton20088 folded before Flop (didn't bet)
Seat 8: Kukuryzka folded before Flop (didn't bet)
Seat 9: app1e_j@ck folded before Flop (didn't bet)





PokerStars Hand #155302155016:  Hold'em No Limit ($0.25/$0.50 USD) - 2016/06/28 16:45:08 CET [2016/06/28 10:45:08 ET]
Table 'Lacadiera' 9-max Seat #1 is the button
Seat 1: matiko09 ($50 in chips) 
Seat 2: Alexey_Kim2 ($50 in chips) 
Seat 3: el.suertero ($111.91 in chips) 
Seat 4: denitz21 ($121.50 in chips) 
Seat 6: Kukuryzka ($97.02 in chips) 
Seat 7: chenconhaste ($62.46 in chips) 
Seat 8: Vedpapa ($68.40 in chips) 
Seat 9: Fakespecial ($240.69 in chips) 
Alexey_Kim2: posts small blind $0.25
el.suertero: posts big blind $0.50
william87872: sits out 
*** HOLE CARDS ***
Dealt to matiko09 [9c 5d]
denitz21: folds 
Kukuryzka: folds 
chenconhaste: folds 
Vedpapa: raises $1 to $1.50
Fakespecial: calls $1.50
matiko09: folds 
Alexey_Kim2: folds 
el.suertero: raises $6 to $7.50
Vedpapa: folds 
Fakespecial: calls $6
*** FLOP *** [7s 5c Qd]
el.suertero: bets $8.75
Fakespecial: calls $8.75
*** TURN *** [7s 5c Qd] [7d]
el.suertero: checks 
Fakespecial: checks 
*** RIVER *** [7s 5c Qd 7d] [8s]
el.suertero: checks 
Fakespecial: bets $16.50
el.suertero: folds 
Uncalled bet ($16.50) returned to Fakespecial
Fakespecial collected $32.54 from pot
Fakespecial: doesn't show hand 
*** SUMMARY ***
Total pot $34.25 | Rake $1.71 
Board [7s 5c Qd 7d 8s]
Seat 1: matiko09 (button) folded before Flop (didn't bet)
Seat 2: Alexey_Kim2 (small blind) folded before Flop
Seat 3: el.suertero (big blind) folded on the River
Seat 4: denitz21 folded before Flop (didn't bet)
Seat 6: Kukuryzka folded before Flop (didn't bet)
Seat 7: chenconhaste folded before Flop (didn't bet)
Seat 8: Vedpapa folded before Flop
Seat 9: Fakespecial collected ($32.54)





PokerStars Hand #155302158065:  Hold'em No Limit ($0.50/$1.00 USD) - 2016/06/28 16:45:14 CET [2016/06/28 10:45:14 ET]
Table 'Dorado II' 9-max Seat #9 is the button
Seat 1: f1reworks ($163.43 in chips) 
Seat 2: vanilica ($100 in chips) 
Seat 3: ghostriderxu ($80.08 in chips) 
Seat 4: pyromid ($119.62 in chips) 
Seat 5: KovIFish89 ($106.07 in chips) 
Seat 6: mycka86 ($114.39 in chips) 
Seat 7: matiko09 ($100 in chips) 
Seat 8: flk.Dasas ($180.57 in chips) 
Seat 9: r4mz3s ($115.05 in chips) 
f1reworks: posts small blind $0.50
vanilica: posts big blind $1
*** HOLE CARDS ***
Dealt to matiko09 [5c 3d]
ghostriderxu: raises $2 to $3
pyromid: folds 
KovIFish89: folds 
mycka86: folds 
matiko09: folds 
flk.Dasas: calls $3
r4mz3s: folds 
f1reworks: folds 
vanilica: raises $10 to $13
ghostriderxu: calls $10
flk.Dasas: calls $10
*** FLOP *** [Jd 3c Js]
vanilica: bets $13
ghostriderxu: calls $13
flk.Dasas: folds 
*** TURN *** [Jd 3c Js] [7h]
vanilica: checks 
ghostriderxu: bets $27.70
vanilica: folds 
Uncalled bet ($27.70) returned to ghostriderxu
ghostriderxu collected $63 from pot
ghostriderxu: doesn't show hand 
*** SUMMARY ***
Total pot $65.50 | Rake $2.50 
Board [Jd 3c Js 7h]
Seat 1: f1reworks (small blind) folded before Flop
Seat 2: vanilica (big blind) folded on the Turn
Seat 3: ghostriderxu collected ($63)
Seat 4: pyromid folded before Flop (didn't bet)
Seat 5: KovIFish89 folded before Flop (didn't bet)
Seat 6: mycka86 folded before Flop (didn't bet)
Seat 7: matiko09 folded before Flop (didn't bet)
Seat 8: flk.Dasas folded on the Flop
Seat 9: r4mz3s (button) folded before Flop (didn't bet)





PokerStars Hand #155302160641:  Hold'em No Limit ($0.25/$0.50 USD) - 2016/06/28 16:45:19 CET [2016/06/28 10:45:19 ET]
Table 'Lycomedes II' 9-max Seat #5 is the button
Seat 1: el.suertero ($103.11 in chips) 
Seat 2: NinjEH ($146.36 in chips) 
Seat 3: Xx7-Zeus-7xX ($50 in chips) 
Seat 4: matiko09 ($50 in chips) 
Seat 5: chata.iz ($47.76 in chips) 
Seat 6: mabbiche_007 ($56.46 in chips) 
Seat 7: william87872 ($50 in chips) 
Seat 8: pandalapa ($57.52 in chips) 
Seat 9: MINER68 ($52.65 in chips) 
mabbiche_007: posts small blind $0.25
william87872: posts big blind $0.50
*** HOLE CARDS ***
Dealt to matiko09 [Jh 6c]
pandalapa: folds 
MINER68: folds 
el.suertero: folds 
NinjEH: folds 
Xx7-Zeus-7xX: folds 
matiko09: folds 
chata.iz: folds 
mabbiche_007: folds 
Uncalled bet ($0.25) returned to william87872
mabbiche_007 leaves the table
william87872 collected $0.50 from pot
william87872: doesn't show hand 
*** SUMMARY ***
Total pot $0.50 | Rake $0 
Seat 1: el.suertero folded before Flop (didn't bet)
Seat 2: NinjEH folded before Flop (didn't bet)
Seat 3: Xx7-Zeus-7xX folded before Flop (didn't bet)
Seat 4: matiko09 folded before Flop (didn't bet)
Seat 5: chata.iz (button) folded before Flop (didn't bet)
Seat 6: mabbiche_007 (small blind) folded before Flop
Seat 7: william87872 (big blind) collected ($0.50)
Seat 8: pandalapa folded before Flop (didn't bet)
Seat 9: MINER68 folded before Flop (didn't bet)





PokerStars Hand #155302161302:  Hold'em No Limit ($0.50/$1.00 USD) - 2016/06/28 16:45:20 CET [2016/06/28 10:45:20 ET]
Table 'Tomita' 9-max Seat #2 is the button
Seat 1: CI58 ($100 in chips) 
Seat 2: vanilica ($100 in chips) 
Seat 3: r4mz3s ($100 in chips) 
Seat 4: f1reworks ($109.78 in chips) 
Seat 5: ANDY19911608 ($163.36 in chips) 
Seat 6: tipner ($109.52 in chips) 
Seat 7: matiko09 ($131.15 in chips) 
Seat 8: Noob0Saibot ($100 in chips) 
Seat 9: sanpidk ($161.30 in chips) 
r4mz3s: posts small blind $0.50
f1reworks: posts big blind $1
*** HOLE CARDS ***
Dealt to matiko09 [Jh 2s]
ANDY19911608: folds 
tipner: folds 
matiko09: folds 
Noob0Saibot: folds 
sanpidk: folds 
CI58: folds 
vanilica: folds 
r4mz3s: raises $2 to $3
f1reworks: folds 
Uncalled bet ($2) returned to r4mz3s
r4mz3s collected $2 from pot
r4mz3s: doesn't show hand 
*** SUMMARY ***
Total pot $2 | Rake $0 
Seat 1: CI58 folded before Flop (didn't bet)
Seat 2: vanilica (button) folded before Flop (didn't bet)
Seat 3: r4mz3s (small blind) collected ($2)
Seat 4: f1reworks (big blind) folded before Flop
Seat 5: ANDY19911608 folded before Flop (didn't bet)
Seat 6: tipner folded before Flop (didn't bet)
Seat 7: matiko09 folded before Flop (didn't bet)
Seat 8: Noob0Saibot folded before Flop (didn't bet)
Seat 9: sanpidk folded before Flop (didn't bet)





PokerStars Hand #155302163748:  Hold'em No Limit ($0.25/$0.50 USD) - 2016/06/28 16:45:24 CET [2016/06/28 10:45:24 ET]
Table 'Antonia II' 9-max Seat #4 is the button
Seat 1: er13to ($57.05 in chips) 
Seat 2: myatiy 96 ($51.09 in chips) 
Seat 4: el.suertero ($70.12 in chips) 
Seat 6: matiko09 ($55.71 in chips) 
Seat 7: Kukuryzka ($53.81 in chips) 
Seat 8: app1e_j@ck ($51.04 in chips) 
Seat 9: Domotirko228 ($50 in chips) 
matiko09: posts small blind $0.25
Kukuryzka: posts big blind $0.50
*** HOLE CARDS ***
Dealt to matiko09 [4h 3h]
app1e_j@ck: folds 
Domotirko228: folds 
er13to: folds 
myatiy 96: raises $0.75 to $1.25
el.suertero: folds 
matiko09: folds 
Kukuryzka: folds 
Uncalled bet ($0.75) returned to myatiy 96
myatiy 96 collected $1.25 from pot
*** SUMMARY ***
Total pot $1.25 | Rake $0 
Seat 1: er13to folded before Flop (didn't bet)
Seat 2: myatiy 96 collected ($1.25)
Seat 4: el.suertero (button) folded before Flop (didn't bet)
Seat 6: matiko09 (small blind) folded before Flop
Seat 7: Kukuryzka (big blind) folded before Flop
Seat 8: app1e_j@ck folded before Flop (didn't bet)
Seat 9: Domotirko228 folded before Flop (didn't bet)





PokerStars Hand #155302165894:  Hold'em No Limit ($0.50/$1.00 USD) - 2016/06/28 16:45:28 CET [2016/06/28 10:45:28 ET]
Table 'Lyyli II' 9-max Seat #1 is the button
Seat 1: tipner ($123.03 in chips) 
Seat 2: CI58 ($131.52 in chips) 
Seat 4: Greha999 ($178.53 in chips) 
Seat 5: flk.Dasas ($100 in chips) 
Seat 6: matiko09 ($100 in chips) 
Seat 7: mycka86 ($108.49 in chips) 
Seat 8: r4mz3s ($124.37 in chips) 
Seat 9: f1reworks ($104.70 in chips) 
CI58: posts small blind $0.50
Greha999: posts big blind $1
*** HOLE CARDS ***
Dealt to matiko09 [Ad Qc]
flk.Dasas: folds 
matiko09: raises $2 to $3
mycka86: folds 
r4mz3s: folds 
f1reworks: folds 
tipner: folds 
CI58: folds 
Greha999: calls $2
*** FLOP *** [8s Ah 7d]
Greha999: checks 
matiko09: bets $4.02
Greha999: calls $4.02
*** TURN *** [8s Ah 7d] [2h]
Greha999: checks 
matiko09: bets $8.98
Greha999: calls $8.98
*** RIVER *** [8s Ah 7d 2h] [4d]
Greha999: bets $19
matiko09: calls $19
*** SHOW DOWN ***
Greha999: shows [6h 5h] (a straight, Four to Eight)
matiko09: mucks hand 
Greha999 collected $68 from pot
*** SUMMARY ***
Total pot $70.50 | Rake $2.50 
Board [8s Ah 7d 2h 4d]
Seat 1: tipner (button) folded before Flop (didn't bet)
Seat 2: CI58 (small blind) folded before Flop
Seat 4: Greha999 (big blind) showed [6h 5h] and won ($68) with a straight, Four to Eight
Seat 5: flk.Dasas folded before Flop (didn't bet)
Seat 6: matiko09 mucked [Ad Qc]
Seat 7: mycka86 folded before Flop (didn't bet)
Seat 8: r4mz3s folded before Flop (didn't bet)
Seat 9: f1reworks folded before Flop (didn't bet)





PokerStars Hand #155302168725:  Hold'em No Limit ($0.25/$0.50 USD) - 2016/06/28 16:45:33 CET [2016/06/28 10:45:33 ET]
Table 'Lycomedes II' 9-max Seat #7 is the button
Seat 1: el.suertero ($103.11 in chips) 
Seat 2: NinjEH ($146.36 in chips) 
Seat 3: Xx7-Zeus-7xX ($50 in chips) 
Seat 4: matiko09 ($50 in chips) 
Seat 5: chata.iz ($47.76 in chips) 
Seat 7: william87872 ($50.25 in chips) 
Seat 8: pandalapa ($57.52 in chips) 
Seat 9: MINER68 ($52.65 in chips) 
pandalapa: posts small blind $0.25
MINER68: posts big blind $0.50
*** HOLE CARDS ***
Dealt to matiko09 [2c Kd]
I_Freemen joins the table at seat #6 
el.suertero: folds 
NinjEH: folds 
Xx7-Zeus-7xX: folds 
matiko09: folds 
chata.iz: folds 
william87872: raises $1.25 to $1.75
pandalapa: folds 
MINER68: folds 
Uncalled bet ($1.25) returned to william87872
william87872 collected $1.25 from pot
william87872: doesn't show hand 
*** SUMMARY ***
Total pot $1.25 | Rake $0 
Seat 1: el.suertero folded before Flop (didn't bet)
Seat 2: NinjEH folded before Flop (didn't bet)
Seat 3: Xx7-Zeus-7xX folded before Flop (didn't bet)
Seat 4: matiko09 folded before Flop (didn't bet)
Seat 5: chata.iz folded before Flop (didn't bet)
Seat 7: william87872 (button) collected ($1.25)
Seat 8: pandalapa (small blind) folded before Flop
Seat 9: MINER68 (big blind) folded before Flop





PokerStars Hand #155302176020:  Hold'em No Limit ($0.50/$1.00 USD) - 2016/06/28 16:45:46 CET [2016/06/28 10:45:46 ET]
Table 'Anitra' 9-max Seat #8 is the button
Seat 2: ardo888 ($100 in chips) 
Seat 3: facelessPPP ($95.86 in chips) 
Seat 4: Shakeelg ($187.13 in chips) 
Seat 5: er13to ($101.20 in chips) 
Seat 6: matiko09 ($102.25 in chips) 
Seat 7: phil_cheng ($100 in chips) 
Seat 8: yoshinoino ($26.25 in chips) 
Seat 9: chenconhaste ($100 in chips) 
chenconhaste: posts small blind $0.50
ardo888: posts big blind $1
*** HOLE CARDS ***
Dealt to matiko09 [7h 4d]
facelessPPP: folds 
Shakeelg: folds 
er13to: folds 
matiko09: folds 
flk.Dasas joins the table at seat #1 
phil_cheng: folds 
yoshinoino: folds 
chenconhaste: raises $2 to $3
ardo888: raises $6 to $9
chenconhaste: raises $13 to $22
ardo888: folds 
Uncalled bet ($13) returned to chenconhaste
chenconhaste collected $18 from pot
*** SUMMARY ***
Total pot $18 | Rake $0 
Seat 2: ardo888 (big blind) folded before Flop
Seat 3: facelessPPP folded before Flop (didn't bet)
Seat 4: Shakeelg folded before Flop (didn't bet)
Seat 5: er13to folded before Flop (didn't bet)
Seat 6: matiko09 folded before Flop (didn't bet)
Seat 7: phil_cheng folded before Flop (didn't bet)
Seat 8: yoshinoino (button) folded before Flop (didn't bet)
Seat 9: chenconhaste (small blind) collected ($18)





PokerStars Hand #155302183367:  Hold'em No Limit ($0.25/$0.50 USD) - 2016/06/28 16:45:59 CET [2016/06/28 10:45:59 ET]
Table 'Bruchsalia II' 9-max Seat #4 is the button
Seat 1: ardo888 ($51.59 in chips) 
Seat 2: william87872 ($50 in chips) 
Seat 3: el.suertero ($50 in chips) 
Seat 4: St.LaCoste ($42.25 in chips) 
Seat 5: Edkar686 ($34.17 in chips) 
Seat 6: matiko09 ($50 in chips) 
Seat 7: Lipton20088 ($22.06 in chips) 
Seat 8: Kukuryzka ($52.26 in chips) 
Seat 9: app1e_j@ck ($56.61 in chips) 
Edkar686: posts small blind $0.25
matiko09: posts big blind $0.50
*** HOLE CARDS ***
Dealt to matiko09 [5d Ad]
Lipton20088: raises $1 to $1.50
Kukuryzka: folds 
app1e_j@ck: folds 
ardo888: folds 
william87872: folds 
el.suertero: folds 
St.LaCoste: folds 
Edkar686: calls $1.25
matiko09: folds 
*** FLOP *** [6s Kc 4d]
Edkar686: checks 
Lipton20088: bets $1.95
Edkar686: folds 
Uncalled bet ($1.95) returned to Lipton20088
Lipton20088 collected $3.32 from pot
Lipton20088: doesn't show hand 
*** SUMMARY ***
Total pot $3.50 | Rake $0.18 
Board [6s Kc 4d]
Seat 1: ardo888 folded before Flop (didn't bet)
Seat 2: william87872 folded before Flop (didn't bet)
Seat 3: el.suertero folded before Flop (didn't bet)
Seat 4: St.LaCoste (button) folded before Flop (didn't bet)
Seat 5: Edkar686 (small blind) folded on the Flop
Seat 6: matiko09 (big blind) folded before Flop
Seat 7: Lipton20088 collected ($3.32)
Seat 8: Kukuryzka folded before Flop (didn't bet)
Seat 9: app1e_j@ck folded before Flop (didn't bet)





PokerStars Hand #155302184480:  Hold'em No Limit ($0.50/$1.00 USD) - 2016/06/28 16:46:01 CET [2016/06/28 10:46:01 ET]
Table 'Tomita' 9-max Seat #3 is the button
Seat 1: CI58 ($100 in chips) 
Seat 2: vanilica ($100 in chips) 
Seat 3: r4mz3s ($101 in chips) 
Seat 4: f1reworks ($108.78 in chips) 
Seat 5: ANDY19911608 ($163.36 in chips) 
Seat 6: tipner ($109.52 in chips) 
Seat 7: matiko09 ($131.15 in chips) 
Seat 8: Noob0Saibot ($100 in chips) 
Seat 9: sanpidk ($161.30 in chips) 
f1reworks: posts small blind $0.50
ANDY19911608: posts big blind $1
*** HOLE CARDS ***
Dealt to matiko09 [Jd Qs]
tipner: folds 
matiko09: folds 
Noob0Saibot: raises $1 to $2
sanpidk: folds 
CI58: folds 
vanilica: folds 
r4mz3s: folds 
f1reworks: folds 
ANDY19911608: calls $1
*** FLOP *** [6c 4h 9d]
ANDY19911608: checks 
Noob0Saibot: bets $2.22
ANDY19911608: calls $2.22
*** TURN *** [6c 4h 9d] [2s]
ANDY19911608: checks 
Noob0Saibot: bets $10.18
ANDY19911608: raises $10.18 to $20.36
Noob0Saibot: folds 
Uncalled bet ($10.18) returned to ANDY19911608
ANDY19911608 collected $27.84 from pot
ANDY19911608: doesn't show hand 
*** SUMMARY ***
Total pot $29.30 | Rake $1.46 
Board [6c 4h 9d 2s]
Seat 1: CI58 folded before Flop (didn't bet)
Seat 2: vanilica folded before Flop (didn't bet)
Seat 3: r4mz3s (button) folded before Flop (didn't bet)
Seat 4: f1reworks (small blind) folded before Flop
Seat 5: ANDY19911608 (big blind) collected ($27.84)
Seat 6: tipner folded before Flop (didn't bet)
Seat 7: matiko09 folded before Flop (didn't bet)
Seat 8: Noob0Saibot folded on the Turn
Seat 9: sanpidk folded before Flop (didn't bet)





PokerStars Hand #155302186118:  Hold'em No Limit ($0.25/$0.50 USD) - 2016/06/28 16:46:04 CET [2016/06/28 10:46:04 ET]
Table 'Lycomedes II' 9-max Seat #8 is the button
Seat 1: el.suertero ($103.11 in chips) 
Seat 2: NinjEH ($146.36 in chips) 
Seat 3: Xx7-Zeus-7xX ($50 in chips) 
Seat 4: matiko09 ($50 in chips) 
Seat 5: chata.iz ($47.76 in chips) 
Seat 7: william87872 ($51 in chips) 
Seat 8: pandalapa ($57.27 in chips) 
Seat 9: MINER68 ($52.15 in chips) 
MINER68: posts small blind $0.25
el.suertero: posts big blind $0.50
I_Freemen: sits out 
*** HOLE CARDS ***
Dealt to matiko09 [5d Qc]
I_Freemen leaves the table
NinjEH: folds 
myatiy 96 joins the table at seat #6 
Xx7-Zeus-7xX: folds 
matiko09: folds 
myatiy 96 leaves the table
chata.iz: folds 
william87872: folds 
pandalapa: folds 
MINER68: folds 
Uncalled bet ($0.25) returned to el.suertero
el.suertero collected $0.50 from pot
el.suertero: doesn't show hand 
*** SUMMARY ***
Total pot $0.50 | Rake $0 
Seat 1: el.suertero (big blind) collected ($0.50)
Seat 2: NinjEH folded before Flop (didn't bet)
Seat 3: Xx7-Zeus-7xX folded before Flop (didn't bet)
Seat 4: matiko09 folded before Flop (didn't bet)
Seat 5: chata.iz folded before Flop (didn't bet)
Seat 7: william87872 folded before Flop (didn't bet)
Seat 8: pandalapa (button) folded before Flop (didn't bet)
Seat 9: MINER68 (small blind) folded before Flop





PokerStars Hand #155302199081:  Hold'em No Limit ($0.25/$0.50 USD) - 2016/06/28 16:46:28 CET [2016/06/28 10:46:28 ET]
Table 'Lacadiera' 9-max Seat #2 is the button
Seat 1: matiko09 ($50 in chips) 
Seat 2: Alexey_Kim2 ($50 in chips) 
Seat 3: el.suertero ($95.66 in chips) 
Seat 4: denitz21 ($121.50 in chips) 
Seat 6: Kukuryzka ($97.02 in chips) 
Seat 7: chenconhaste ($62.46 in chips) 
Seat 8: Vedpapa ($66.90 in chips) 
Seat 9: Fakespecial ($256.98 in chips) 
el.suertero: posts small blind $0.25
denitz21: posts big blind $0.50
william87872: sits out 
*** HOLE CARDS ***
Dealt to matiko09 [Ts 4h]
Kukuryzka: folds 
chenconhaste: folds 
Vedpapa: folds 
Fakespecial: calls $0.50
matiko09: folds 
Alexey_Kim2: folds 
el.suertero: calls $0.25
denitz21: checks 
*** FLOP *** [Ad 5d Ac]
el.suertero: checks 
denitz21: checks 
Fakespecial: bets $0.50
el.suertero: folds 
denitz21: folds 
Uncalled bet ($0.50) returned to Fakespecial
Fakespecial collected $1.42 from pot
Fakespecial: doesn't show hand 
*** SUMMARY ***
Total pot $1.50 | Rake $0.08 
Board [Ad 5d Ac]
Seat 1: matiko09 folded before Flop (didn't bet)
Seat 2: Alexey_Kim2 (button) folded before Flop (didn't bet)
Seat 3: el.suertero (small blind) folded on the Flop
Seat 4: denitz21 (big blind) folded on the Flop
Seat 6: Kukuryzka folded before Flop (didn't bet)
Seat 7: chenconhaste folded before Flop (didn't bet)
Seat 8: Vedpapa folded before Flop (didn't bet)
Seat 9: Fakespecial collected ($1.42)





PokerStars Hand #155302202132:  Hold'em No Limit ($0.50/$1.00 USD) - 2016/06/28 16:46:33 CET [2016/06/28 10:46:33 ET]
Table 'Lyyli II' 9-max Seat #2 is the button
Seat 1: tipner ($123.03 in chips) 
Seat 2: CI58 ($131.02 in chips) 
Seat 4: Greha999 ($211.53 in chips) 
Seat 5: flk.Dasas ($100 in chips) 
Seat 6: matiko09 ($100 in chips) 
Seat 7: mycka86 ($108.49 in chips) 
Seat 8: r4mz3s ($124.37 in chips) 
Seat 9: f1reworks ($104.70 in chips) 
Greha999: posts small blind $0.50
flk.Dasas: posts big blind $1
*** HOLE CARDS ***
Dealt to matiko09 [Js 7d]
matiko09: folds 
mycka86: folds 
r4mz3s: folds 
f1reworks: folds 
tipner: folds 
CI58: raises $1 to $2
Greha999: calls $1.50
flk.Dasas: calls $1
*** FLOP *** [8c 9d Qs]
Greha999: checks 
flk.Dasas: checks 
CI58: checks 
*** TURN *** [8c 9d Qs] [6h]
Greha999: bets $3
flk.Dasas: folds 
CI58: folds 
Uncalled bet ($3) returned to Greha999
Greha999 collected $5.70 from pot
*** SUMMARY ***
Total pot $6 | Rake $0.30 
Board [8c 9d Qs 6h]
Seat 1: tipner folded before Flop (didn't bet)
Seat 2: CI58 (button) folded on the Turn
Seat 4: Greha999 (small blind) collected ($5.70)
Seat 5: flk.Dasas (big blind) folded on the Turn
Seat 6: matiko09 folded before Flop (didn't bet)
Seat 7: mycka86 folded before Flop (didn't bet)
Seat 8: r4mz3s folded before Flop (didn't bet)
Seat 9: f1reworks folded before Flop (didn't bet)





PokerStars Hand #155302203481:  Hold'em No Limit ($0.25/$0.50 USD) - 2016/06/28 16:46:35 CET [2016/06/28 10:46:35 ET]
Table 'Antonia II' 9-max Seat #6 is the button
Seat 1: er13to ($57.05 in chips) 
Seat 2: myatiy 96 ($51.84 in chips) 
Seat 4: el.suertero ($70.12 in chips) 
Seat 5: 35LOBO35 ($23.44 in chips) 
Seat 6: matiko09 ($55.46 in chips) 
Seat 7: Kukuryzka ($53.31 in chips) 
Seat 9: Domotirko228 ($50 in chips) 
Kukuryzka: posts small blind $0.25
app1e_j@ck: is sitting out 
Domotirko228: posts big blind $0.50
app1e_j@ck leaves the table
35LOBO35: posts small & big blinds $0.75
*** HOLE CARDS ***
Dealt to matiko09 [5d 6d]
er13to: folds 
SumPosad joins the table at seat #8 
myatiy 96: raises $1.50 to $2
el.suertero: folds 
35LOBO35: calls $1.50
matiko09: calls $2
Kukuryzka: folds 
Domotirko228: folds 
*** FLOP *** [8d 5h 3h]
myatiy 96: checks 
35LOBO35: checks 
matiko09: bets $4
myatiy 96: calls $4
35LOBO35: calls $4
*** TURN *** [8d 5h 3h] [4d]
myatiy 96: checks 
35LOBO35: checks 
matiko09: bets $13.50
myatiy 96: calls $13.50
35LOBO35: folds 
*** RIVER *** [8d 5h 3h 4d] [6c]
myatiy 96: checks 
matiko09: checks 
*** SHOW DOWN ***
myatiy 96: shows [9h 8h] (a pair of Eights)
matiko09: shows [5d 6d] (two pair, Sixes and Fives)
matiko09 collected $44 from pot
*** SUMMARY ***
Total pot $46 | Rake $2 
Board [8d 5h 3h 4d 6c]
Seat 1: er13to folded before Flop (didn't bet)
Seat 2: myatiy 96 showed [9h 8h] and lost with a pair of Eights
Seat 4: el.suertero folded before Flop (didn't bet)
Seat 5: 35LOBO35 folded on the Turn
Seat 6: matiko09 (button) showed [5d 6d] and won ($44) with two pair, Sixes and Fives
Seat 7: Kukuryzka (small blind) folded before Flop
Seat 9: Domotirko228 (big blind) folded before Flop





PokerStars Hand #155302206844:  Hold'em No Limit ($0.50/$1.00 USD) - 2016/06/28 16:46:42 CET [2016/06/28 10:46:42 ET]
Table 'Anitra' 9-max Seat #9 is the button
Seat 2: ardo888 ($100 in chips) 
Seat 3: facelessPPP ($95.86 in chips) 
Seat 4: Shakeelg ($187.13 in chips) 
Seat 5: er13to ($101.20 in chips) 
Seat 6: matiko09 ($102.25 in chips) 
Seat 7: phil_cheng ($100 in chips) 
Seat 8: yoshinoino ($26.25 in chips) 
Seat 9: chenconhaste ($109 in chips) 
ardo888: posts small blind $0.50
facelessPPP: posts big blind $1
*** HOLE CARDS ***
Dealt to matiko09 [Th Ad]
Shakeelg: folds 
er13to: raises $1.72 to $2.72
matiko09: folds 
phil_cheng: folds 
yoshinoino: folds 
chenconhaste: calls $2.72
ardo888: folds 
facelessPPP: folds 
*** FLOP *** [Qh As 8c]
er13to: checks 
chenconhaste: checks 
*** TURN *** [Qh As 8c] [Qs]
er13to: checks 
chenconhaste: checks 
*** RIVER *** [Qh As 8c Qs] [Ts]
er13to: checks 
chenconhaste: bets $4
er13to: calls $4
*** SHOW DOWN ***
chenconhaste: shows [6c 6h] (two pair, Queens and Sixes)
er13to: shows [3h Ah] (two pair, Aces and Queens)
er13to collected $14.19 from pot
*** SUMMARY ***
Total pot $14.94 | Rake $0.75 
Board [Qh As 8c Qs Ts]
Seat 2: ardo888 (small blind) folded before Flop
Seat 3: facelessPPP (big blind) folded before Flop
Seat 4: Shakeelg folded before Flop (didn't bet)
Seat 5: er13to showed [3h Ah] and won ($14.19) with two pair, Aces and Queens
Seat 6: matiko09 folded before Flop (didn't bet)
Seat 7: phil_cheng folded before Flop (didn't bet)
Seat 8: yoshinoino folded before Flop (didn't bet)
Seat 9: chenconhaste (button) showed [6c 6h] and lost with two pair, Queens and Sixes





PokerStars Hand #155302210641:  Hold'em No Limit ($0.25/$0.50 USD) - 2016/06/28 16:46:49 CET [2016/06/28 10:46:49 ET]
Table 'Lycomedes II' 9-max Seat #9 is the button
Seat 1: el.suertero ($103.36 in chips) 
Seat 2: NinjEH ($146.36 in chips) 
Seat 3: Xx7-Zeus-7xX ($50 in chips) 
Seat 4: matiko09 ($50 in chips) 
Seat 5: chata.iz ($47.76 in chips) 
Seat 7: william87872 ($51 in chips) 
Seat 8: pandalapa ($57.27 in chips) 
Seat 9: MINER68 ($51.90 in chips) 
el.suertero: posts small blind $0.25
NinjEH: posts big blind $0.50
*** HOLE CARDS ***
Dealt to matiko09 [6d 8d]
Xx7-Zeus-7xX: folds 
matiko09: folds 
chata.iz: folds 
william87872: folds 
pandalapa: folds 
MINER68: folds 
el.suertero: raises $1 to $1.50
NinjEH: folds 
Uncalled bet ($1) returned to el.suertero
el.suertero collected $1 from pot
el.suertero: doesn't show hand 
*** SUMMARY ***
Total pot $1 | Rake $0 
Seat 1: el.suertero (small blind) collected ($1)
Seat 2: NinjEH (big blind) folded before Flop
Seat 3: Xx7-Zeus-7xX folded before Flop (didn't bet)
Seat 4: matiko09 folded before Flop (didn't bet)
Seat 5: chata.iz folded before Flop (didn't bet)
Seat 7: william87872 folded before Flop (didn't bet)
Seat 8: pandalapa folded before Flop (didn't bet)
Seat 9: MINER68 (button) folded before Flop (didn't bet)





PokerStars Hand #155302214408:  Hold'em No Limit ($0.25/$0.50 USD) - 2016/06/28 16:46:55 CET [2016/06/28 10:46:55 ET]
Table 'Bruchsalia II' 9-max Seat #5 is the button
Seat 1: ardo888 ($51.59 in chips) 
Seat 2: william87872 ($50 in chips) 
Seat 3: el.suertero ($50 in chips) 
Seat 4: St.LaCoste ($42.25 in chips) 
Seat 5: Edkar686 ($32.67 in chips) 
Seat 6: matiko09 ($50 in chips) 
Seat 7: Lipton20088 ($23.88 in chips) 
Seat 8: Kukuryzka ($52.26 in chips) 
Seat 9: app1e_j@ck ($56.61 in chips) 
matiko09: posts small blind $0.25
Lipton20088: posts big blind $0.50
*** HOLE CARDS ***
Dealt to matiko09 [Kc 5d]
Kukuryzka: folds 
app1e_j@ck: folds 
ardo888: folds 
william87872: folds 
el.suertero: folds 
St.LaCoste: folds 
Edkar686: calls $0.50
matiko09: folds 
Lipton20088: checks 
*** FLOP *** [3c Ks Qh]
Lipton20088: checks 
Edkar686: checks 
*** TURN *** [3c Ks Qh] [2c]
Lipton20088: checks 
Edkar686: bets $0.50
Lipton20088: calls $0.50
*** RIVER *** [3c Ks Qh 2c] [4s]
Lipton20088: checks 
Edkar686: bets $0.50
Lipton20088: calls $0.50
*** SHOW DOWN ***
Edkar686: shows [Qs Ah] (a pair of Queens)
Lipton20088: mucks hand 
Edkar686 collected $3.09 from pot
*** SUMMARY ***
Total pot $3.25 | Rake $0.16 
Board [3c Ks Qh 2c 4s]
Seat 1: ardo888 folded before Flop (didn't bet)
Seat 2: william87872 folded before Flop (didn't bet)
Seat 3: el.suertero folded before Flop (didn't bet)
Seat 4: St.LaCoste folded before Flop (didn't bet)
Seat 5: Edkar686 (button) showed [Qs Ah] and won ($3.09) with a pair of Queens
Seat 6: matiko09 (small blind) folded before Flop
Seat 7: Lipton20088 (big blind) mucked [Qd Ts]
Seat 8: Kukuryzka folded before Flop (didn't bet)
Seat 9: app1e_j@ck folded before Flop (didn't bet)





PokerStars Hand #155302216290:  Hold'em No Limit ($0.50/$1.00 USD) - 2016/06/28 16:46:59 CET [2016/06/28 10:46:59 ET]
Table 'Tomita' 9-max Seat #4 is the button
Seat 1: CI58 ($100 in chips) 
Seat 2: vanilica ($100 in chips) 
Seat 3: r4mz3s ($101 in chips) 
Seat 4: f1reworks ($108.28 in chips) 
Seat 5: ANDY19911608 ($176.80 in chips) 
Seat 6: tipner ($109.52 in chips) 
Seat 7: matiko09 ($131.15 in chips) 
Seat 8: Noob0Saibot ($100 in chips) 
Seat 9: sanpidk ($161.30 in chips) 
ANDY19911608: posts small blind $0.50
tipner: posts big blind $1
*** HOLE CARDS ***
Dealt to matiko09 [2c Qs]
matiko09: folds 
Noob0Saibot: folds 
sanpidk: folds 
CI58: folds 
vanilica: folds 
r4mz3s: folds 
f1reworks: raises $1.10 to $2.10
ANDY19911608: calls $1.60
tipner: calls $1.10
*** FLOP *** [8s Ks 7h]
ANDY19911608: checks 
tipner: checks 
f1reworks: checks 
*** TURN *** [8s Ks 7h] [5h]
ANDY19911608: bets $6
tipner: folds 
f1reworks: calls $6
*** RIVER *** [8s Ks 7h 5h] [Kh]
ANDY19911608: bets $10
f1reworks: calls $10
*** SHOW DOWN ***
ANDY19911608: shows [6h 9h] (a flush, King high)
f1reworks: mucks hand 
ANDY19911608 collected $36.38 from pot
*** SUMMARY ***
Total pot $38.30 | Rake $1.92 
Board [8s Ks 7h 5h Kh]
Seat 1: CI58 folded before Flop (didn't bet)
Seat 2: vanilica folded before Flop (didn't bet)
Seat 3: r4mz3s folded before Flop (didn't bet)
Seat 4: f1reworks (button) mucked [Ts Th]
Seat 5: ANDY19911608 (small blind) showed [6h 9h] and won ($36.38) with a flush, King high
Seat 6: tipner (big blind) folded on the Turn
Seat 7: matiko09 folded before Flop (didn't bet)
Seat 8: Noob0Saibot folded before Flop (didn't bet)
Seat 9: sanpidk folded before Flop (didn't bet)





PokerStars Hand #155302225527:  Hold'em No Limit ($0.25/$0.50 USD) - 2016/06/28 16:47:16 CET [2016/06/28 10:47:16 ET]
Table 'Lacadiera' 9-max Seat #3 is the button
Seat 1: matiko09 ($50 in chips) 
Seat 2: Alexey_Kim2 ($50 in chips) 
Seat 3: el.suertero ($95.16 in chips) 
Seat 4: denitz21 ($121 in chips) 
Seat 5: william87872 ($50 in chips) 
Seat 6: Kukuryzka ($97.02 in chips) 
Seat 7: chenconhaste ($62.46 in chips) 
Seat 8: Vedpapa ($66.90 in chips) 
Seat 9: Fakespecial ($257.90 in chips) 
denitz21: posts small blind $0.25
william87872: posts big blind $0.50
*** HOLE CARDS ***
Dealt to matiko09 [6c 3d]
Kukuryzka: folds 
chenconhaste: folds 
Vedpapa: folds 
Fakespecial: calls $0.50
matiko09: folds 
Alexey_Kim2: folds 
el.suertero: raises $1.50 to $2
denitz21: calls $1.75
william87872: folds 
Fakespecial: calls $1.50
*** FLOP *** [Td 8h Qs]
denitz21: checks 
Fakespecial: checks 
el.suertero: checks 
*** TURN *** [Td 8h Qs] [Jc]
denitz21: checks 
Fakespecial: checks 
el.suertero: checks 
*** RIVER *** [Td 8h Qs Jc] [Ad]
denitz21: checks 
Fakespecial: checks 
el.suertero: checks 
*** SHOW DOWN ***
denitz21: shows [6s 4s] (high card Ace)
Fakespecial: shows [Th 7h] (a pair of Tens)
el.suertero: mucks hand 
Fakespecial collected $6.18 from pot
*** SUMMARY ***
Total pot $6.50 | Rake $0.32 
Board [Td 8h Qs Jc Ad]
Seat 1: matiko09 folded before Flop (didn't bet)
Seat 2: Alexey_Kim2 folded before Flop (didn't bet)
Seat 3: el.suertero (button) mucked [4h 4c]
Seat 4: denitz21 (small blind) showed [6s 4s] and lost with high card Ace
Seat 5: william87872 (big blind) folded before Flop
Seat 6: Kukuryzka folded before Flop (didn't bet)
Seat 7: chenconhaste folded before Flop (didn't bet)
Seat 8: Vedpapa folded before Flop (didn't bet)
Seat 9: Fakespecial showed [Th 7h] and won ($6.18) with a pair of Tens





PokerStars Hand #155302230204:  Hold'em No Limit ($0.25/$0.50 USD) - 2016/06/28 16:47:25 CET [2016/06/28 10:47:25 ET]
Table 'Lycomedes II' 9-max Seat #1 is the button
Seat 1: el.suertero ($103.86 in chips) 
Seat 2: NinjEH ($145.86 in chips) 
Seat 3: Xx7-Zeus-7xX ($50 in chips) 
Seat 4: matiko09 ($50 in chips) 
Seat 5: chata.iz ($47.76 in chips) 
Seat 7: william87872 ($51 in chips) 
Seat 8: pandalapa ($57.27 in chips) 
Seat 9: MINER68 ($51.90 in chips) 
NinjEH: posts small blind $0.25
Xx7-Zeus-7xX: posts big blind $0.50
*** HOLE CARDS ***
Dealt to matiko09 [7s 8d]
matiko09: folds 
chata.iz: folds 
Kukuryzka joins the table at seat #6 
Kukuryzka leaves the table
william87872: folds 
pandalapa: folds 
MINER68: calls $0.50
el.suertero: folds 
NinjEH: raises $1 to $1.50
Xx7-Zeus-7xX: folds 
Mampa12 joins the table at seat #6 
MINER68: calls $1
*** FLOP *** [9c Jh 4c]
NinjEH: checks 
MINER68: bets $1
NinjEH: calls $1
*** TURN *** [9c Jh 4c] [2h]
NinjEH: checks 
MINER68: bets $1.50
NinjEH: calls $1.50
*** RIVER *** [9c Jh 4c 2h] [Jd]
NinjEH: bets $8.08
MINER68: raises $8.08 to $16.16
NinjEH: folds 
Uncalled bet ($8.08) returned to MINER68
MINER68 collected $23.43 from pot
*** SUMMARY ***
Total pot $24.66 | Rake $1.23 
Board [9c Jh 4c 2h Jd]
Seat 1: el.suertero (button) folded before Flop (didn't bet)
Seat 2: NinjEH (small blind) folded on the River
Seat 3: Xx7-Zeus-7xX (big blind) folded before Flop
Seat 4: matiko09 folded before Flop (didn't bet)
Seat 5: chata.iz folded before Flop (didn't bet)
Seat 7: william87872 folded before Flop (didn't bet)
Seat 8: pandalapa folded before Flop (didn't bet)
Seat 9: MINER68 collected ($23.43)





PokerStars Hand #155302230654:  Hold'em No Limit ($0.50/$1.00 USD) - 2016/06/28 16:47:25 CET [2016/06/28 10:47:25 ET]
Table 'Dorado II' 9-max Seat #1 is the button
Seat 1: f1reworks ($162.93 in chips) 
Seat 2: vanilica ($100 in chips) 
Seat 3: ghostriderxu ($117.08 in chips) 
Seat 4: pyromid ($119.62 in chips) 
Seat 5: KovIFish89 ($106.07 in chips) 
Seat 6: mycka86 ($114.39 in chips) 
Seat 7: matiko09 ($100 in chips) 
Seat 8: flk.Dasas ($167.57 in chips) 
Seat 9: r4mz3s ($115.05 in chips) 
vanilica: posts small blind $0.50
ghostriderxu: posts big blind $1
*** HOLE CARDS ***
Dealt to matiko09 [8d 5c]
pyromid: folds 
KovIFish89: folds 
mycka86: folds 
matiko09: folds 
flk.Dasas: folds 
r4mz3s: folds 
f1reworks: raises $1.10 to $2.10
vanilica: folds 
ghostriderxu: calls $1.10
*** FLOP *** [Ts 6d 8s]
ghostriderxu: checks 
f1reworks: bets $2.45
ghostriderxu: calls $2.45
*** TURN *** [Ts 6d 8s] [Tc]
ghostriderxu: checks 
f1reworks: checks 
*** RIVER *** [Ts 6d 8s Tc] [3h]
ghostriderxu: bets $4.60
f1reworks: folds 
Uncalled bet ($4.60) returned to ghostriderxu
ghostriderxu collected $9.12 from pot
ghostriderxu: doesn't show hand 
*** SUMMARY ***
Total pot $9.60 | Rake $0.48 
Board [Ts 6d 8s Tc 3h]
Seat 1: f1reworks (button) folded on the River
Seat 2: vanilica (small blind) folded before Flop
Seat 3: ghostriderxu (big blind) collected ($9.12)
Seat 4: pyromid folded before Flop (didn't bet)
Seat 5: KovIFish89 folded before Flop (didn't bet)
Seat 6: mycka86 folded before Flop (didn't bet)
Seat 7: matiko09 folded before Flop (didn't bet)
Seat 8: flk.Dasas folded before Flop (didn't bet)
Seat 9: r4mz3s folded before Flop (didn't bet)





PokerStars Hand #155302241987:  Hold'em No Limit ($0.50/$1.00 USD) - 2016/06/28 16:47:46 CET [2016/06/28 10:47:46 ET]
Table 'Anitra' 9-max Seat #2 is the button
Seat 2: ardo888 ($100 in chips) 
Seat 3: facelessPPP ($94.86 in chips) 
Seat 4: Shakeelg ($187.13 in chips) 
Seat 5: er13to ($108.67 in chips) 
Seat 6: matiko09 ($102.25 in chips) 
Seat 7: phil_cheng ($100 in chips) 
Seat 8: yoshinoino ($26.25 in chips) 
Seat 9: chenconhaste ($102.28 in chips) 
facelessPPP: posts small blind $0.50
Shakeelg: posts big blind $1
*** HOLE CARDS ***
Dealt to matiko09 [8c 2h]
er13to: folds 
matiko09: folds 
phil_cheng: folds 
flk.Dasas leaves the table
mbk88 joins the table at seat #1 
yoshinoino: folds 
chenconhaste: folds 
ardo888: raises $1.50 to $2.50
facelessPPP: folds 
Shakeelg: calls $1.50
*** FLOP *** [4c Ts 6s]
Shakeelg: checks 
ardo888: bets $3.96
Shakeelg: folds 
Uncalled bet ($3.96) returned to ardo888
ardo888 collected $5.22 from pot
ardo888: doesn't show hand 
*** SUMMARY ***
Total pot $5.50 | Rake $0.28 
Board [4c Ts 6s]
Seat 2: ardo888 (button) collected ($5.22)
Seat 3: facelessPPP (small blind) folded before Flop
Seat 4: Shakeelg (big blind) folded on the Flop
Seat 5: er13to folded before Flop (didn't bet)
Seat 6: matiko09 folded before Flop (didn't bet)
Seat 7: phil_cheng folded before Flop (didn't bet)
Seat 8: yoshinoino folded before Flop (didn't bet)
Seat 9: chenconhaste folded before Flop (didn't bet)





PokerStars Hand #155302243120:  Hold'em No Limit ($0.50/$1.00 USD) - 2016/06/28 16:47:48 CET [2016/06/28 10:47:48 ET]
Table 'Lyyli II' 9-max Seat #4 is the button
Seat 1: tipner ($123.03 in chips) 
Seat 2: CI58 ($129.02 in chips) 
Seat 4: Greha999 ($215.23 in chips) 
Seat 5: flk.Dasas ($100 in chips) 
Seat 6: matiko09 ($100 in chips) 
Seat 7: mycka86 ($108.49 in chips) 
Seat 8: r4mz3s ($124.37 in chips) 
Seat 9: f1reworks ($104.70 in chips) 
flk.Dasas: posts small blind $0.50
matiko09: posts big blind $1
Racushniak: sits out 
*** HOLE CARDS ***
Dealt to matiko09 [3s Ac]
mycka86: folds 
r4mz3s: folds 
f1reworks: folds 
tipner: folds 
CI58: folds 
Greha999: folds 
flk.Dasas: raises $2 to $3
matiko09: calls $2
*** FLOP *** [9h 9c 6c]
flk.Dasas: checks 
matiko09: checks 
*** TURN *** [9h 9c 6c] [Kd]
flk.Dasas: bets $3.88
matiko09: folds 
Uncalled bet ($3.88) returned to flk.Dasas
flk.Dasas collected $5.70 from pot
flk.Dasas: doesn't show hand 
*** SUMMARY ***
Total pot $6 | Rake $0.30 
Board [9h 9c 6c Kd]
Seat 1: tipner folded before Flop (didn't bet)
Seat 2: CI58 folded before Flop (didn't bet)
Seat 4: Greha999 (button) folded before Flop (didn't bet)
Seat 5: flk.Dasas (small blind) collected ($5.70)
Seat 6: matiko09 (big blind) folded on the Turn
Seat 7: mycka86 folded before Flop (didn't bet)
Seat 8: r4mz3s folded before Flop (didn't bet)
Seat 9: f1reworks folded before Flop (didn't bet)





PokerStars Hand #155302248762:  Hold'em No Limit ($0.25/$0.50 USD) - 2016/06/28 16:47:58 CET [2016/06/28 10:47:58 ET]
Table 'Bruchsalia II' 9-max Seat #6 is the button
Seat 1: ardo888 ($51.59 in chips) 
Seat 2: william87872 ($50 in chips) 
Seat 3: el.suertero ($50 in chips) 
Seat 4: St.LaCoste ($42.25 in chips) 
Seat 5: Edkar686 ($34.26 in chips) 
Seat 6: matiko09 ($50 in chips) 
Seat 7: Lipton20088 ($22.38 in chips) 
Seat 8: Kukuryzka ($52.26 in chips) 
Seat 9: app1e_j@ck ($56.61 in chips) 
Lipton20088: posts small blind $0.25
Kukuryzka: posts big blind $0.50
*** HOLE CARDS ***
Dealt to matiko09 [2d 5c]
app1e_j@ck: folds 
ardo888: folds 
william87872: folds 
el.suertero: raises $1 to $1.50
St.LaCoste: folds 
Edkar686: calls $1.50
matiko09: folds 
Lipton20088: folds 
Kukuryzka: folds 
*** FLOP *** [2h Ad 9c]
el.suertero: checks 
Edkar686: bets $1.78
el.suertero: folds 
Uncalled bet ($1.78) returned to Edkar686
Edkar686 collected $3.56 from pot
*** SUMMARY ***
Total pot $3.75 | Rake $0.19 
Board [2h Ad 9c]
Seat 1: ardo888 folded before Flop (didn't bet)
Seat 2: william87872 folded before Flop (didn't bet)
Seat 3: el.suertero folded on the Flop
Seat 4: St.LaCoste folded before Flop (didn't bet)
Seat 5: Edkar686 collected ($3.56)
Seat 6: matiko09 (button) folded before Flop (didn't bet)
Seat 7: Lipton20088 (small blind) folded before Flop
Seat 8: Kukuryzka (big blind) folded before Flop
Seat 9: app1e_j@ck folded before Flop (didn't bet)





PokerStars Hand #155302262269:  Hold'em No Limit ($0.50/$1.00 USD) - 2016/06/28 16:48:22 CET [2016/06/28 10:48:22 ET]
Table 'Anitra' 9-max Seat #3 is the button
Seat 2: ardo888 ($102.72 in chips) 
Seat 3: facelessPPP ($94.36 in chips) 
Seat 4: Shakeelg ($184.63 in chips) 
Seat 5: er13to ($108.67 in chips) 
Seat 6: matiko09 ($102.25 in chips) 
Seat 7: phil_cheng ($100 in chips) 
Seat 8: yoshinoino ($26.25 in chips) 
Seat 9: chenconhaste ($102.28 in chips) 
Shakeelg: posts small blind $0.50
er13to: posts big blind $1
mbk88: sits out 
*** HOLE CARDS ***
Dealt to matiko09 [Ah Kc]
matiko09: raises $2 to $3
phil_cheng: folds 
yoshinoino: folds 
chenconhaste: folds 
ardo888: folds 
facelessPPP: calls $3
Shakeelg: calls $2.50
er13to: folds 
*** FLOP *** [7h 7c 4h]
Shakeelg: checks 
matiko09: bets $6
facelessPPP: calls $6
Shakeelg: folds 
*** TURN *** [7h 7c 4h] [Qh]
matiko09: bets $12
facelessPPP: calls $12
*** RIVER *** [7h 7c 4h Qh] [Jd]
matiko09: checks 
facelessPPP: bets $13.70
matiko09: folds 
Uncalled bet ($13.70) returned to facelessPPP
facelessPPP collected $43.70 from pot
facelessPPP: doesn't show hand 
*** SUMMARY ***
Total pot $46 | Rake $2.30 
Board [7h 7c 4h Qh Jd]
Seat 2: ardo888 folded before Flop (didn't bet)
Seat 3: facelessPPP (button) collected ($43.70)
Seat 4: Shakeelg (small blind) folded on the Flop
Seat 5: er13to (big blind) folded before Flop
Seat 6: matiko09 folded on the River
Seat 7: phil_cheng folded before Flop (didn't bet)
Seat 8: yoshinoino folded before Flop (didn't bet)
Seat 9: chenconhaste folded before Flop (didn't bet)





PokerStars Hand #155302264347:  Hold'em No Limit ($0.25/$0.50 USD) - 2016/06/28 16:48:26 CET [2016/06/28 10:48:26 ET]
Table 'Lacadiera' 9-max Seat #4 is the button
Seat 1: matiko09 ($50 in chips) 
Seat 2: Alexey_Kim2 ($50 in chips) 
Seat 3: el.suertero ($93.16 in chips) 
Seat 4: denitz21 ($119 in chips) 
Seat 5: william87872 ($50 in chips) 
Seat 6: Kukuryzka ($97.02 in chips) 
Seat 7: chenconhaste ($62.46 in chips) 
Seat 8: Vedpapa ($66.90 in chips) 
Seat 9: Fakespecial ($262.08 in chips) 
william87872: posts small blind $0.25
Kukuryzka: posts big blind $0.50
*** HOLE CARDS ***
Dealt to matiko09 [Ac Jd]
chenconhaste: folds 
Vedpapa: folds 
Fakespecial: raises $0.50 to $1
matiko09: raises $2.50 to $3.50
Alexey_Kim2: folds 
el.suertero: calls $3.50
denitz21: calls $3.50
william87872: folds 
Kukuryzka: folds 
Fakespecial: raises $6.50 to $10
matiko09: folds 
el.suertero: calls $6.50
denitz21: calls $6.50
*** FLOP *** [As 3h 9c]
Fakespecial: bets $13.50
el.suertero: folds 
denitz21: folds 
Uncalled bet ($13.50) returned to Fakespecial
Fakespecial collected $32.54 from pot
Fakespecial: doesn't show hand 
*** SUMMARY ***
Total pot $34.25 | Rake $1.71 
Board [As 3h 9c]
Seat 1: matiko09 folded before Flop
Seat 2: Alexey_Kim2 folded before Flop (didn't bet)
Seat 3: el.suertero folded on the Flop
Seat 4: denitz21 (button) folded on the Flop
Seat 5: william87872 (small blind) folded before Flop
Seat 6: Kukuryzka (big blind) folded before Flop
Seat 7: chenconhaste folded before Flop (didn't bet)
Seat 8: Vedpapa folded before Flop (didn't bet)
Seat 9: Fakespecial collected ($32.54)





PokerStars Hand #155302266081:  Hold'em No Limit (€0.50/€1.00 EUR) - 2016/06/28 16:48:29 CET [2016/06/28 10:48:29 ET]
Table 'Sadalmelik II' 9-max Seat #9 is the button
Seat 1: aseban11 (€100.50 in chips) 
Seat 2: matiko09 (€100 in chips) 
Seat 3: Mukhin1 (€103.35 in chips) 
Seat 4: er13to (€113.50 in chips) 
Seat 5: ReMark_only (€45.12 in chips) 
Seat 7: mycka86 (€100 in chips) 
Seat 8: chaps1988 (€100 in chips) 
Seat 9: myatiy 96 (€100 in chips) 
aseban11: posts small blind €0.50
matiko09: posts big blind €1
*** HOLE CARDS ***
Dealt to matiko09 [4c Td]
Mukhin1: folds 
er13to: folds 
ReMark_only: folds 
Mukhin1 leaves the table
mycka86: folds 
chaps1988: folds 
myatiy 96: folds 
aseban11: folds 
Uncalled bet (€0.50) returned to matiko09
matiko09 collected €1 from pot
matiko09: doesn't show hand 
*** SUMMARY ***
Total pot €1 | Rake €0 
Seat 1: aseban11 (small blind) folded before Flop
Seat 2: matiko09 (big blind) collected (€1)
Seat 3: Mukhin1 folded before Flop (didn't bet)
Seat 4: er13to folded before Flop (didn't bet)
Seat 5: ReMark_only folded before Flop (didn't bet)
Seat 7: mycka86 folded before Flop (didn't bet)
Seat 8: chaps1988 folded before Flop (didn't bet)
Seat 9: myatiy 96 (button) folded before Flop (didn't bet)





PokerStars Hand #155302267890:  Hold'em No Limit ($0.50/$1.00 USD) - 2016/06/28 16:48:32 CET [2016/06/28 10:48:32 ET]
Table 'Dorado II' 9-max Seat #2 is the button
Seat 1: f1reworks ($158.38 in chips) 
Seat 2: vanilica ($100 in chips) 
Seat 3: ghostriderxu ($121.65 in chips) 
Seat 4: pyromid ($119.62 in chips) 
Seat 5: KovIFish89 ($106.07 in chips) 
Seat 6: mycka86 ($114.39 in chips) 
Seat 7: matiko09 ($100 in chips) 
Seat 8: flk.Dasas ($167.57 in chips) 
Seat 9: r4mz3s ($115.05 in chips) 
ghostriderxu: posts small blind $0.50
pyromid: posts big blind $1
*** HOLE CARDS ***
Dealt to matiko09 [8s 3s]
KovIFish89: folds 
mycka86: folds 
matiko09: folds 
flk.Dasas: folds 
r4mz3s: folds 
f1reworks: folds 
vanilica: raises $1.50 to $2.50
ghostriderxu: calls $2
pyromid: folds 
*** FLOP *** [8d Kh 6c]
ghostriderxu: checks 
vanilica: checks 
*** TURN *** [8d Kh 6c] [2h]
ghostriderxu: bets $3.10
vanilica: folds 
Uncalled bet ($3.10) returned to ghostriderxu
ghostriderxu collected $5.70 from pot
ghostriderxu: doesn't show hand 
*** SUMMARY ***
Total pot $6 | Rake $0.30 
Board [8d Kh 6c 2h]
Seat 1: f1reworks folded before Flop (didn't bet)
Seat 2: vanilica (button) folded on the Turn
Seat 3: ghostriderxu (small blind) collected ($5.70)
Seat 4: pyromid (big blind) folded before Flop
Seat 5: KovIFish89 folded before Flop (didn't bet)
Seat 6: mycka86 folded before Flop (didn't bet)
Seat 7: matiko09 folded before Flop (didn't bet)
Seat 8: flk.Dasas folded before Flop (didn't bet)
Seat 9: r4mz3s folded before Flop (didn't bet)





PokerStars Hand #155302269390:  Hold'em No Limit ($0.25/$0.50 USD) - 2016/06/28 16:48:35 CET [2016/06/28 10:48:35 ET]
Table 'Antonia II' 9-max Seat #7 is the button
Seat 1: er13to ($57.05 in chips) 
Seat 2: myatiy 96 ($50 in chips) 
Seat 4: el.suertero ($70.12 in chips) 
Seat 5: 35LOBO35 ($17.19 in chips) 
Seat 6: matiko09 ($79.96 in chips) 
Seat 7: Kukuryzka ($53.06 in chips) 
Seat 9: Domotirko228 ($50 in chips) 
SumPosad will be allowed to play after the button
Domotirko228: posts small blind $0.25
er13to: posts big blind $0.50
*** HOLE CARDS ***
Dealt to matiko09 [Kd 2h]
myatiy 96: folds 
el.suertero: folds 
35LOBO35: folds 
matiko09: folds 
Kukuryzka: raises $0.50 to $1
Domotirko228: folds 
er13to: calls $0.50
*** FLOP *** [Th Kh 9h]
er13to: checks 
Kukuryzka: checks 
*** TURN *** [Th Kh 9h] [8h]
er13to: checks 
Kukuryzka: bets $1.46
er13to: calls $1.46
*** RIVER *** [Th Kh 9h 8h] [Ah]
er13to: checks 
Kukuryzka: bets $3.50
er13to: folds 
Uncalled bet ($3.50) returned to Kukuryzka
Kukuryzka collected $4.91 from pot
Kukuryzka: doesn't show hand 
*** SUMMARY ***
Total pot $5.17 | Rake $0.26 
Board [Th Kh 9h 8h Ah]
Seat 1: er13to (big blind) folded on the River
Seat 2: myatiy 96 folded before Flop (didn't bet)
Seat 4: el.suertero folded before Flop (didn't bet)
Seat 5: 35LOBO35 folded before Flop (didn't bet)
Seat 6: matiko09 folded before Flop (didn't bet)
Seat 7: Kukuryzka (button) collected ($4.91)
Seat 9: Domotirko228 (small blind) folded before Flop





PokerStars Hand #155302273643:  Hold'em No Limit ($0.50/$1.00 USD) - 2016/06/28 16:48:43 CET [2016/06/28 10:48:43 ET]
Table 'Tomita' 9-max Seat #5 is the button
Seat 1: CI58 ($100 in chips) 
Seat 2: vanilica ($100 in chips) 
Seat 3: r4mz3s ($101 in chips) 
Seat 4: f1reworks ($100 in chips) 
Seat 5: ANDY19911608 ($195.08 in chips) 
Seat 6: tipner ($107.42 in chips) 
Seat 7: matiko09 ($131.15 in chips) 
Seat 8: Noob0Saibot ($100 in chips) 
Seat 9: sanpidk ($161.30 in chips) 
tipner: posts small blind $0.50
matiko09: posts big blind $1
*** HOLE CARDS ***
Dealt to matiko09 [Qd Jh]
Noob0Saibot: folds 
sanpidk: folds 
CI58: folds 
vanilica: folds 
r4mz3s: raises $1.55 to $2.55
f1reworks: calls $2.55
ANDY19911608: calls $2.55
tipner: folds 
matiko09: calls $1.55
*** FLOP *** [Jd 7s 2d]
matiko09: checks 
r4mz3s: checks 
f1reworks: bets $6
ANDY19911608: folds 
matiko09: calls $6
r4mz3s: folds 
*** TURN *** [Jd 7s 2d] [Qc]
matiko09: checks 
f1reworks: bets $18
matiko09: calls $18
*** RIVER *** [Jd 7s 2d Qc] [6c]
matiko09: checks 
f1reworks: checks 
*** SHOW DOWN ***
matiko09: shows [Qd Jh] (two pair, Queens and Jacks)
f1reworks: mucks hand 
matiko09 collected $56.20 from pot
*** SUMMARY ***
Total pot $58.70 | Rake $2.50 
Board [Jd 7s 2d Qc 6c]
Seat 1: CI58 folded before Flop (didn't bet)
Seat 2: vanilica folded before Flop (didn't bet)
Seat 3: r4mz3s folded on the Flop
Seat 4: f1reworks mucked [Ks Qh]
Seat 5: ANDY19911608 (button) folded on the Flop
Seat 6: tipner (small blind) folded before Flop
Seat 7: matiko09 (big blind) showed [Qd Jh] and won ($56.20) with two pair, Queens and Jacks
Seat 8: Noob0Saibot folded before Flop (didn't bet)
Seat 9: sanpidk folded before Flop (didn't bet)





PokerStars Hand #155302281437:  Hold'em No Limit (€0.50/€1.00 EUR) - 2016/06/28 16:48:57 CET [2016/06/28 10:48:57 ET]
Table 'Sadalmelik II' 9-max Seat #1 is the button
Seat 1: aseban11 (€100 in chips) 
Seat 2: matiko09 (€100.50 in chips) 
Seat 4: er13to (€113.50 in chips) 
Seat 5: ReMark_only (€45.12 in chips) 
Seat 7: mycka86 (€100 in chips) 
Seat 8: chaps1988 (€100 in chips) 
Seat 9: myatiy 96 (€100 in chips) 
matiko09: posts small blind €0.50
er13to: posts big blind €1
*** HOLE CARDS ***
Dealt to matiko09 [7c 2d]
ReMark_only: folds 
Filojoes joins the table at seat #3 
mycka86: folds 
chaps1988: folds 
myatiy 96: folds 
Filojoes leaves the table
aseban11: raises €1 to €2
matiko09: folds 
er13to: calls €1
*** FLOP *** [Ks 2c Jd]
er13to: checks 
aseban11: checks 
*** TURN *** [Ks 2c Jd] [Jh]
er13to: checks 
aseban11: checks 
*** RIVER *** [Ks 2c Jd Jh] [Ac]
er13to: checks 
aseban11: checks 
*** SHOW DOWN ***
er13to: shows [Qd 9c] (a pair of Jacks)
aseban11: shows [Ah 4h] (two pair, Aces and Jacks)
aseban11 collected €4.28 from pot
*** SUMMARY ***
Total pot €4.50 | Rake €0.22 
Board [Ks 2c Jd Jh Ac]
Seat 1: aseban11 (button) showed [Ah 4h] and won (€4.28) with two pair, Aces and Jacks
Seat 2: matiko09 (small blind) folded before Flop
Seat 4: er13to (big blind) showed [Qd 9c] and lost with a pair of Jacks
Seat 5: ReMark_only folded before Flop (didn't bet)
Seat 7: mycka86 folded before Flop (didn't bet)
Seat 8: chaps1988 folded before Flop (didn't bet)
Seat 9: myatiy 96 folded before Flop (didn't bet)





PokerStars Hand #155302281824:  Hold'em No Limit ($0.25/$0.50 USD) - 2016/06/28 16:48:57 CET [2016/06/28 10:48:57 ET]
Table 'Bruchsalia II' 9-max Seat #7 is the button
Seat 1: ardo888 ($51.59 in chips) 
Seat 2: william87872 ($50 in chips) 
Seat 3: el.suertero ($50 in chips) 
Seat 4: St.LaCoste ($42.25 in chips) 
Seat 5: Edkar686 ($36.32 in chips) 
Seat 6: matiko09 ($50 in chips) 
Seat 7: Lipton20088 ($22.13 in chips) 
Seat 8: Kukuryzka ($51.76 in chips) 
Seat 9: app1e_j@ck ($56.61 in chips) 
Kukuryzka: posts small blind $0.25
app1e_j@ck: posts big blind $0.50
*** HOLE CARDS ***
Dealt to matiko09 [4c Kc]
ardo888: folds 
william87872: folds 
el.suertero: folds 
St.LaCoste: folds 
Edkar686: calls $0.50
matiko09: folds 
Lipton20088: folds 
Kukuryzka: folds 
app1e_j@ck: checks 
*** FLOP *** [Th 5c Kd]
app1e_j@ck: checks 
Edkar686: bets $0.59
app1e_j@ck: folds 
Uncalled bet ($0.59) returned to Edkar686
Edkar686 collected $1.19 from pot
*** SUMMARY ***
Total pot $1.25 | Rake $0.06 
Board [Th 5c Kd]
Seat 1: ardo888 folded before Flop (didn't bet)
Seat 2: william87872 folded before Flop (didn't bet)
Seat 3: el.suertero folded before Flop (didn't bet)
Seat 4: St.LaCoste folded before Flop (didn't bet)
Seat 5: Edkar686 collected ($1.19)
Seat 6: matiko09 folded before Flop (didn't bet)
Seat 7: Lipton20088 (button) folded before Flop (didn't bet)
Seat 8: Kukuryzka (small blind) folded before Flop
Seat 9: app1e_j@ck (big blind) folded on the Flop





PokerStars Hand #155302300318:  Hold'em No Limit ($0.25/$0.50 USD) - 2016/06/28 16:49:20 CET [2016/06/28 10:49:20 ET]
Table 'Lycomedes II' 9-max Seat #2 is the button
Seat 1: el.suertero ($103.86 in chips) 
Seat 2: NinjEH ($133.78 in chips) 
Seat 3: Xx7-Zeus-7xX ($49.50 in chips) 
Seat 4: matiko09 ($50 in chips) 
Seat 5: chata.iz ($47.76 in chips) 
Seat 7: william87872 ($51 in chips) 
Seat 8: pandalapa ($57.27 in chips) 
Seat 9: MINER68 ($63.25 in chips) 
Xx7-Zeus-7xX: posts small blind $0.25
matiko09: posts big blind $0.50
Mampa12: sits out 
*** HOLE CARDS ***
Dealt to matiko09 [3h 6d]
chata.iz: folds 
william87872: folds 
pandalapa: folds 
MINER68: folds 
el.suertero: raises $1 to $1.50
NinjEH: calls $1.50
Xx7-Zeus-7xX: folds 
matiko09: folds 
*** FLOP *** [Jh Jd 4c]
el.suertero: bets $1.24
NinjEH: raises $1.24 to $2.48
el.suertero: folds 
Uncalled bet ($1.24) returned to NinjEH
NinjEH collected $5.92 from pot
NinjEH: doesn't show hand 
*** SUMMARY ***
Total pot $6.23 | Rake $0.31 
Board [Jh Jd 4c]
Seat 1: el.suertero folded on the Flop
Seat 2: NinjEH (button) collected ($5.92)
Seat 3: Xx7-Zeus-7xX (small blind) folded before Flop
Seat 4: matiko09 (big blind) folded before Flop
Seat 5: chata.iz folded before Flop (didn't bet)
Seat 7: william87872 folded before Flop (didn't bet)
Seat 8: pandalapa folded before Flop (didn't bet)
Seat 9: MINER68 folded before Flop (didn't bet)





PokerStars Hand #155302300638:  Hold'em No Limit ($0.50/$1.00 USD) - 2016/06/28 16:49:20 CET [2016/06/28 10:49:20 ET]
Table 'Dorado II' 9-max Seat #3 is the button
Seat 1: f1reworks ($158.38 in chips) 
Seat 2: vanilica ($100 in chips) 
Seat 3: ghostriderxu ($124.85 in chips) 
Seat 4: pyromid ($118.62 in chips) 
Seat 5: KovIFish89 ($106.07 in chips) 
Seat 6: mycka86 ($114.39 in chips) 
Seat 7: matiko09 ($100 in chips) 
Seat 8: flk.Dasas ($167.57 in chips) 
Seat 9: r4mz3s ($115.05 in chips) 
pyromid: posts small blind $0.50
KovIFish89: posts big blind $1
*** HOLE CARDS ***
Dealt to matiko09 [6c 6h]
mycka86: folds 
matiko09: raises $2 to $3
flk.Dasas: folds 
r4mz3s: folds 
f1reworks: folds 
vanilica: folds 
ghostriderxu: folds 
pyromid: folds 
KovIFish89: folds 
Uncalled bet ($2) returned to matiko09
matiko09 collected $2.50 from pot
matiko09: doesn't show hand 
*** SUMMARY ***
Total pot $2.50 | Rake $0 
Seat 1: f1reworks folded before Flop (didn't bet)
Seat 2: vanilica folded before Flop (didn't bet)
Seat 3: ghostriderxu (button) folded before Flop (didn't bet)
Seat 4: pyromid (small blind) folded before Flop
Seat 5: KovIFish89 (big blind) folded before Flop
Seat 6: mycka86 folded before Flop (didn't bet)
Seat 7: matiko09 collected ($2.50)
Seat 8: flk.Dasas folded before Flop (didn't bet)
Seat 9: r4mz3s folded before Flop (didn't bet)





PokerStars Hand #155302301210:  Hold'em No Limit ($0.50/$1.00 USD) - 2016/06/28 16:49:21 CET [2016/06/28 10:49:21 ET]
Table 'Lyyli II' 9-max Seat #5 is the button
Seat 1: tipner ($123.03 in chips) 
Seat 2: CI58 ($129.02 in chips) 
Seat 4: Greha999 ($215.23 in chips) 
Seat 5: flk.Dasas ($102.70 in chips) 
Seat 6: matiko09 ($100 in chips) 
Seat 7: mycka86 ($108.49 in chips) 
Seat 8: r4mz3s ($124.37 in chips) 
Seat 9: f1reworks ($104.70 in chips) 
matiko09: posts small blind $0.50
mycka86: posts big blind $1
Racushniak: sits out 
*** HOLE CARDS ***
Dealt to matiko09 [Kd Kh]
r4mz3s: raises $2 to $3
f1reworks: folds 
tipner: folds 
CI58: folds 
Greha999: folds 
flk.Dasas: folds 
matiko09: calls $2.50
mycka86: folds 
*** FLOP *** [6d 9c Jc]
matiko09: checks 
r4mz3s: checks 
*** TURN *** [6d 9c Jc] [Ad]
matiko09: checks 
r4mz3s: checks 
*** RIVER *** [6d 9c Jc Ad] [Th]
matiko09: checks 
r4mz3s: bets $3.50
matiko09: folds 
Uncalled bet ($3.50) returned to r4mz3s
r4mz3s collected $6.65 from pot
r4mz3s: doesn't show hand 
*** SUMMARY ***
Total pot $7 | Rake $0.35 
Board [6d 9c Jc Ad Th]
Seat 1: tipner folded before Flop (didn't bet)
Seat 2: CI58 folded before Flop (didn't bet)
Seat 4: Greha999 folded before Flop (didn't bet)
Seat 5: flk.Dasas (button) folded before Flop (didn't bet)
Seat 6: matiko09 (small blind) folded on the River
Seat 7: mycka86 (big blind) folded before Flop
Seat 8: r4mz3s collected ($6.65)
Seat 9: f1reworks folded before Flop (didn't bet)





PokerStars Hand #155302309407:  Hold'em No Limit (€0.50/€1.00 EUR) - 2016/06/28 16:49:36 CET [2016/06/28 10:49:36 ET]
Table 'Sadalmelik II' 9-max Seat #2 is the button
Seat 1: aseban11 (€102.28 in chips) 
Seat 2: matiko09 (€100 in chips) 
Seat 4: er13to (€111.50 in chips) 
Seat 5: ReMark_only (€45.12 in chips) 
Seat 7: mycka86 (€100 in chips) 
Seat 8: chaps1988 (€100 in chips) 
Seat 9: myatiy 96 (€100 in chips) 
er13to: posts small blind €0.50
ReMark_only: posts big blind €1
*** HOLE CARDS ***
Dealt to matiko09 [Kd 9h]
mycka86: folds 
chaps1988: folds 
myatiy 96: folds 
aseban11: folds 
simoniustin joins the table at seat #3 
matiko09: raises €1.27 to €2.27
er13to: folds 
ReMark_only: folds 
Uncalled bet (€1.27) returned to matiko09
matiko09 collected €2.50 from pot
matiko09: doesn't show hand 
*** SUMMARY ***
Total pot €2.50 | Rake €0 
Seat 1: aseban11 folded before Flop (didn't bet)
Seat 2: matiko09 (button) collected (€2.50)
Seat 4: er13to (small blind) folded before Flop
Seat 5: ReMark_only (big blind) folded before Flop
Seat 7: mycka86 folded before Flop (didn't bet)
Seat 8: chaps1988 folded before Flop (didn't bet)
Seat 9: myatiy 96 folded before Flop (didn't bet)





PokerStars Hand #155302313953:  Hold'em No Limit ($0.50/$1.00 USD) - 2016/06/28 16:49:45 CET [2016/06/28 10:49:45 ET]
Table 'Dorado II' 9-max Seat #4 is the button
Seat 1: f1reworks ($158.38 in chips) 
Seat 2: vanilica ($100 in chips) 
Seat 3: ghostriderxu ($124.85 in chips) 
Seat 4: pyromid ($118.12 in chips) 
Seat 5: KovIFish89 ($105.07 in chips) 
Seat 6: mycka86 ($114.39 in chips) 
Seat 7: matiko09 ($101.50 in chips) 
Seat 8: flk.Dasas ($167.57 in chips) 
Seat 9: r4mz3s ($115.05 in chips) 
KovIFish89: posts small blind $0.50
mycka86: posts big blind $1
*** HOLE CARDS ***
Dealt to matiko09 [9s 3d]
matiko09: folds 
flk.Dasas: folds 
r4mz3s: folds 
f1reworks: folds 
vanilica: folds 
ghostriderxu: folds 
pyromid: folds 
KovIFish89: raises $2 to $3
mycka86: calls $2
*** FLOP *** [6s Tc 7s]
KovIFish89: bets $3.79
mycka86: calls $3.79
*** TURN *** [6s Tc 7s] [8h]
KovIFish89: checks 
mycka86: checks 
*** RIVER *** [6s Tc 7s 8h] [Td]
KovIFish89: checks 
mycka86: checks 
*** SHOW DOWN ***
KovIFish89: shows [6d 7d] (two pair, Tens and Sevens)
mycka86: shows [8d Ah] (two pair, Tens and Eights)
mycka86 collected $12.90 from pot
*** SUMMARY ***
Total pot $13.58 | Rake $0.68 
Board [6s Tc 7s 8h Td]
Seat 1: f1reworks folded before Flop (didn't bet)
Seat 2: vanilica folded before Flop (didn't bet)
Seat 3: ghostriderxu folded before Flop (didn't bet)
Seat 4: pyromid (button) folded before Flop (didn't bet)
Seat 5: KovIFish89 (small blind) showed [6d 7d] and lost with two pair, Tens and Sevens
Seat 6: mycka86 (big blind) showed [8d Ah] and won ($12.90) with two pair, Tens and Eights
Seat 7: matiko09 folded before Flop (didn't bet)
Seat 8: flk.Dasas folded before Flop (didn't bet)
Seat 9: r4mz3s folded before Flop (didn't bet)





PokerStars Hand #155302314050:  Hold'em No Limit ($0.25/$0.50 USD) - 2016/06/28 16:49:45 CET [2016/06/28 10:49:45 ET]
Table 'Antonia II' 9-max Seat #9 is the button
Seat 1: er13to ($54.59 in chips) 
Seat 2: myatiy 96 ($50 in chips) 
Seat 4: el.suertero ($70.12 in chips) 
Seat 5: 35LOBO35 ($17.19 in chips) 
Seat 6: matiko09 ($79.96 in chips) 
Seat 7: Kukuryzka ($55.51 in chips) 
Seat 9: Domotirko228 ($50 in chips) 
er13to: posts small blind $0.25
myatiy 96: posts big blind $0.50
SumPosad: sits out 
*** HOLE CARDS ***
Dealt to matiko09 [8c Kh]
el.suertero: raises $1 to $1.50
35LOBO35: calls $1.50
matiko09: folds 
Kukuryzka: folds 
Domotirko228: folds 
er13to: folds 
myatiy 96: folds 
*** FLOP *** [4h Qd 4d]
el.suertero: bets $1.95
35LOBO35: folds 
Uncalled bet ($1.95) returned to el.suertero
el.suertero collected $3.56 from pot
el.suertero: doesn't show hand 
*** SUMMARY ***
Total pot $3.75 | Rake $0.19 
Board [4h Qd 4d]
Seat 1: er13to (small blind) folded before Flop
Seat 2: myatiy 96 (big blind) folded before Flop
Seat 4: el.suertero collected ($3.56)
Seat 5: 35LOBO35 folded on the Flop
Seat 6: matiko09 folded before Flop (didn't bet)
Seat 7: Kukuryzka folded before Flop (didn't bet)
Seat 9: Domotirko228 (button) folded before Flop (didn't bet)





PokerStars Hand #155302314962:  Hold'em No Limit ($0.25/$0.50 USD) - 2016/06/28 16:49:46 CET [2016/06/28 10:49:46 ET]
Table 'Bruchsalia II' 9-max Seat #8 is the button
Seat 1: ardo888 ($51.59 in chips) 
Seat 2: william87872 ($50 in chips) 
Seat 3: el.suertero ($50 in chips) 
Seat 4: St.LaCoste ($42.25 in chips) 
Seat 5: Edkar686 ($37.01 in chips) 
Seat 6: matiko09 ($50 in chips) 
Seat 7: Lipton20088 ($22.13 in chips) 
Seat 8: Kukuryzka ($51.51 in chips) 
Seat 9: app1e_j@ck ($56.11 in chips) 
app1e_j@ck: posts small blind $0.25
ardo888: posts big blind $0.50
*** HOLE CARDS ***
Dealt to matiko09 [Th Ad]
william87872: folds 
el.suertero: folds 
St.LaCoste: folds 
Edkar686: raises $1 to $1.50
matiko09: folds 
Lipton20088: folds 
Kukuryzka: folds 
app1e_j@ck: folds 
ardo888: folds 
Uncalled bet ($1) returned to Edkar686
Edkar686 collected $1.25 from pot
*** SUMMARY ***
Total pot $1.25 | Rake $0 
Seat 1: ardo888 (big blind) folded before Flop
Seat 2: william87872 folded before Flop (didn't bet)
Seat 3: el.suertero folded before Flop (didn't bet)
Seat 4: St.LaCoste folded before Flop (didn't bet)
Seat 5: Edkar686 collected ($1.25)
Seat 6: matiko09 folded before Flop (didn't bet)
Seat 7: Lipton20088 folded before Flop (didn't bet)
Seat 8: Kukuryzka (button) folded before Flop (didn't bet)
Seat 9: app1e_j@ck (small blind) folded before Flop





PokerStars Hand #155302326834:  Hold'em No Limit ($0.25/$0.50 USD) - 2016/06/28 16:50:08 CET [2016/06/28 10:50:08 ET]
Table 'Lacadiera' 9-max Seat #5 is the button
Seat 1: matiko09 ($50 in chips) 
Seat 2: Alexey_Kim2 ($50 in chips) 
Seat 3: el.suertero ($83.16 in chips) 
Seat 4: denitz21 ($109 in chips) 
Seat 5: william87872 ($50 in chips) 
Seat 6: Kukuryzka ($96.52 in chips) 
Seat 7: chenconhaste ($62.46 in chips) 
Seat 8: Vedpapa ($66.90 in chips) 
Seat 9: Fakespecial ($284.62 in chips) 
Kukuryzka: posts small blind $0.25
chenconhaste: posts big blind $0.50
*** HOLE CARDS ***
Dealt to matiko09 [Ah 4h]
Vedpapa: folds 
Fakespecial: calls $0.50
matiko09: raises $2 to $2.50
Alexey_Kim2: folds 
el.suertero: folds 
denitz21: folds 
william87872: raises $3.50 to $6
Kukuryzka: folds 
chenconhaste: folds 
Fakespecial: folds 
matiko09: folds 
Uncalled bet ($3.50) returned to william87872
william87872 collected $6.25 from pot
william87872: doesn't show hand 
*** SUMMARY ***
Total pot $6.25 | Rake $0 
Seat 1: matiko09 folded before Flop
Seat 2: Alexey_Kim2 folded before Flop (didn't bet)
Seat 3: el.suertero folded before Flop (didn't bet)
Seat 4: denitz21 folded before Flop (didn't bet)
Seat 5: william87872 (button) collected ($6.25)
Seat 6: Kukuryzka (small blind) folded before Flop
Seat 7: chenconhaste (big blind) folded before Flop
Seat 8: Vedpapa folded before Flop (didn't bet)
Seat 9: Fakespecial folded before Flop





PokerStars Hand #155302326779:  Hold'em No Limit ($0.50/$1.00 USD) - 2016/06/28 16:50:08 CET [2016/06/28 10:50:08 ET]
Table 'Tomita' 9-max Seat #6 is the button
Seat 1: CI58 ($100 in chips) 
Seat 2: vanilica ($100 in chips) 
Seat 3: r4mz3s ($100 in chips) 
Seat 4: f1reworks ($100 in chips) 
Seat 5: ANDY19911608 ($192.53 in chips) 
Seat 6: tipner ($106.92 in chips) 
Seat 7: matiko09 ($160.80 in chips) 
Seat 8: Noob0Saibot ($100 in chips) 
Seat 9: sanpidk ($161.30 in chips) 
matiko09: posts small blind $0.50
Noob0Saibot: posts big blind $1
*** HOLE CARDS ***
Dealt to matiko09 [Ks 7h]
sanpidk: folds 
CI58: folds 
vanilica: folds 
r4mz3s: folds 
f1reworks: folds 
ANDY19911608: raises $2 to $3
tipner has timed out
tipner: folds 
matiko09: folds 
Noob0Saibot: calls $2
*** FLOP *** [Kd Qs 4c]
Noob0Saibot: checks 
ANDY19911608: bets $2
Noob0Saibot: folds 
Uncalled bet ($2) returned to ANDY19911608
ANDY19911608 collected $6.18 from pot
ANDY19911608: doesn't show hand 
*** SUMMARY ***
Total pot $6.50 | Rake $0.32 
Board [Kd Qs 4c]
Seat 1: CI58 folded before Flop (didn't bet)
Seat 2: vanilica folded before Flop (didn't bet)
Seat 3: r4mz3s folded before Flop (didn't bet)
Seat 4: f1reworks folded before Flop (didn't bet)
Seat 5: ANDY19911608 collected ($6.18)
Seat 6: tipner (button) folded before Flop (didn't bet)
Seat 7: matiko09 (small blind) folded before Flop
Seat 8: Noob0Saibot (big blind) folded on the Flop
Seat 9: sanpidk folded before Flop (didn't bet)





PokerStars Hand #155302330896:  Hold'em No Limit (€0.50/€1.00 EUR) - 2016/06/28 16:50:15 CET [2016/06/28 10:50:15 ET]
Table 'Sadalmelik II' 9-max Seat #4 is the button
Seat 1: aseban11 (€102.28 in chips) 
Seat 2: matiko09 (€101.50 in chips) 
Seat 4: er13to (€111 in chips) 
Seat 5: ReMark_only (€44.12 in chips) 
Seat 7: mycka86 (€100 in chips) 
Seat 8: chaps1988 (€100 in chips) 
Seat 9: myatiy 96 (€100 in chips) 
ReMark_only: posts small blind €0.50
mycka86: posts big blind €1
simoniustin: sits out 
*** HOLE CARDS ***
Dealt to matiko09 [4c 4h]
chaps1988: folds 
chaps1988 leaves the table
Kukuryzka joins the table at seat #8 
myatiy 96: folds 
aseban11: folds 
matiko09: raises €1.50 to €2.50
er13to: folds 
ReMark_only: folds 
mycka86: folds 
Uncalled bet (€1.50) returned to matiko09
matiko09 collected €2.50 from pot
matiko09: doesn't show hand 
*** SUMMARY ***
Total pot €2.50 | Rake €0 
Seat 1: aseban11 folded before Flop (didn't bet)
Seat 2: matiko09 collected (€2.50)
Seat 4: er13to (button) folded before Flop (didn't bet)
Seat 5: ReMark_only (small blind) folded before Flop
Seat 7: mycka86 (big blind) folded before Flop
Seat 8: chaps1988 folded before Flop (didn't bet)
Seat 9: myatiy 96 folded before Flop (didn't bet)





PokerStars Hand #155302335534:  Hold'em No Limit ($0.25/$0.50 USD) - 2016/06/28 16:50:23 CET [2016/06/28 10:50:23 ET]
Table 'Bruchsalia II' 9-max Seat #9 is the button
Seat 1: ardo888 ($51.09 in chips) 
Seat 3: el.suertero ($50 in chips) 
Seat 4: St.LaCoste ($42.25 in chips) 
Seat 5: Edkar686 ($37.76 in chips) 
Seat 6: matiko09 ($50 in chips) 
Seat 7: Lipton20088 ($22.13 in chips) 
Seat 8: Kukuryzka ($51.51 in chips) 
Seat 9: app1e_j@ck ($55.86 in chips) 
ardo888: posts small blind $0.25
william87872: is sitting out 
william87872 leaves the table
el.suertero: posts big blind $0.50
*** HOLE CARDS ***
Dealt to matiko09 [9h Tc]
St.LaCoste: raises $1 to $1.50
Edkar686: folds 
matiko09: folds 
Lipton20088: calls $1.50
Kukuryzka: folds 
app1e_j@ck: folds 
ardo888: folds 
el.suertero: folds 
*** FLOP *** [6s 4s 3s]
denitz21 joins the table at seat #2 
St.LaCoste: bets $1.70
Lipton20088: folds 
Uncalled bet ($1.70) returned to St.LaCoste
St.LaCoste collected $3.56 from pot
St.LaCoste: doesn't show hand 
*** SUMMARY ***
Total pot $3.75 | Rake $0.19 
Board [6s 4s 3s]
Seat 1: ardo888 (small blind) folded before Flop
Seat 3: el.suertero (big blind) folded before Flop
Seat 4: St.LaCoste collected ($3.56)
Seat 5: Edkar686 folded before Flop (didn't bet)
Seat 6: matiko09 folded before Flop (didn't bet)
Seat 7: Lipton20088 folded on the Flop
Seat 8: Kukuryzka folded before Flop (didn't bet)
Seat 9: app1e_j@ck (button) folded before Flop (didn't bet)





PokerStars Hand #155302336668:  Hold'em No Limit ($0.25/$0.50 USD) - 2016/06/28 16:50:25 CET [2016/06/28 10:50:25 ET]
Table 'Antonia II' 9-max Seat #1 is the button
Seat 1: er13to ($54.34 in chips) 
Seat 2: myatiy 96 ($50 in chips) 
Seat 4: el.suertero ($72.18 in chips) 
Seat 5: 35LOBO35 ($15.69 in chips) 
Seat 6: matiko09 ($79.96 in chips) 
Seat 7: Kukuryzka ($55.51 in chips) 
Seat 9: Domotirko228 ($50 in chips) 
myatiy 96: posts small blind $0.25
el.suertero: posts big blind $0.50
SumPosad: sits out 
*** HOLE CARDS ***
Dealt to matiko09 [7d Td]
35LOBO35: calls $0.50
matiko09: folds 
Kukuryzka: folds 
Domotirko228: folds 
er13to: folds 
myatiy 96: folds 
el.suertero: checks 
*** FLOP *** [6h 7c 9d]
el.suertero: checks 
35LOBO35: bets $1.50
el.suertero: folds 
Uncalled bet ($1.50) returned to 35LOBO35
35LOBO35 collected $1.19 from pot
35LOBO35: doesn't show hand 
*** SUMMARY ***
Total pot $1.25 | Rake $0.06 
Board [6h 7c 9d]
Seat 1: er13to (button) folded before Flop (didn't bet)
Seat 2: myatiy 96 (small blind) folded before Flop
Seat 4: el.suertero (big blind) folded on the Flop
Seat 5: 35LOBO35 collected ($1.19)
Seat 6: matiko09 folded before Flop (didn't bet)
Seat 7: Kukuryzka folded before Flop (didn't bet)
Seat 9: Domotirko228 folded before Flop (didn't bet)





PokerStars Hand #155302341878:  Hold'em No Limit ($0.25/$0.50 USD) - 2016/06/28 16:50:35 CET [2016/06/28 10:50:35 ET]
Table 'Lycomedes II' 9-max Seat #3 is the button
Seat 1: el.suertero ($101.12 in chips) 
Seat 2: NinjEH ($136.96 in chips) 
Seat 3: Xx7-Zeus-7xX ($49.25 in chips) 
Seat 4: matiko09 ($50 in chips) 
Seat 5: chata.iz ($47.76 in chips) 
Seat 7: william87872 ($51 in chips) 
Seat 8: pandalapa ($57.27 in chips) 
Seat 9: MINER68 ($63.25 in chips) 
matiko09: posts small blind $0.25
chata.iz: posts big blind $0.50
Mampa12: sits out 
*** HOLE CARDS ***
Dealt to matiko09 [Ks 3s]
william87872: folds 
pandalapa: folds 
MINER68: raises $1 to $1.50
el.suertero: folds 
NinjEH: folds 
Xx7-Zeus-7xX: folds 
matiko09: folds 
chata.iz: folds 
Uncalled bet ($1) returned to MINER68
MINER68 collected $1.25 from pot
*** SUMMARY ***
Total pot $1.25 | Rake $0 
Seat 1: el.suertero folded before Flop (didn't bet)
Seat 2: NinjEH folded before Flop (didn't bet)
Seat 3: Xx7-Zeus-7xX (button) folded before Flop (didn't bet)
Seat 4: matiko09 (small blind) folded before Flop
Seat 5: chata.iz (big blind) folded before Flop
Seat 7: william87872 folded before Flop (didn't bet)
Seat 8: pandalapa folded before Flop (didn't bet)
Seat 9: MINER68 collected ($1.25)





PokerStars Hand #155302346879:  Hold'em No Limit (€0.50/€1.00 EUR) - 2016/06/28 16:50:44 CET [2016/06/28 10:50:44 ET]
Table 'Sadalmelik II' 9-max Seat #5 is the button
Seat 1: aseban11 (€102.28 in chips) 
Seat 2: matiko09 (€103 in chips) 
Seat 4: er13to (€111 in chips) 
Seat 5: ReMark_only (€43.62 in chips) 
Seat 7: mycka86 (€100 in chips) 
Seat 8: Kukuryzka (€100 in chips) 
Seat 9: myatiy 96 (€100 in chips) 
mycka86: posts small blind €0.50
Kukuryzka: posts big blind €1
simoniustin: sits out 
*** HOLE CARDS ***
Dealt to matiko09 [3d Jh]
myatiy 96: folds 
aseban11: folds 
matiko09: folds 
er13to: raises €1.35 to €2.35
ReMark_only: folds 
myatiy 96 leaves the table
mycka86: folds 
Kukuryzka: folds 
Uncalled bet (€1.35) returned to er13to
er13to collected €2.50 from pot
*** SUMMARY ***
Total pot €2.50 | Rake €0 
Seat 1: aseban11 folded before Flop (didn't bet)
Seat 2: matiko09 folded before Flop (didn't bet)
Seat 4: er13to collected (€2.50)
Seat 5: ReMark_only (button) folded before Flop (didn't bet)
Seat 7: mycka86 (small blind) folded before Flop
Seat 8: Kukuryzka (big blind) folded before Flop
Seat 9: myatiy 96 folded before Flop (didn't bet)





PokerStars Hand #155302351790:  Hold'em No Limit ($0.50/$1.00 USD) - 2016/06/28 16:50:52 CET [2016/06/28 10:50:52 ET]
Table 'Anitra' 9-max Seat #4 is the button
Seat 2: ardo888 ($102.72 in chips) 
Seat 3: facelessPPP ($117.06 in chips) 
Seat 4: Shakeelg ($181.63 in chips) 
Seat 5: er13to ($107.67 in chips) 
Seat 6: matiko09 ($100 in chips) 
Seat 7: phil_cheng ($100 in chips) 
Seat 8: yoshinoino ($26.25 in chips) 
Seat 9: chenconhaste ($102.28 in chips) 
er13to: posts small blind $0.50
matiko09: posts big blind $1
mbk88: sits out 
*** HOLE CARDS ***
Dealt to matiko09 [3c Jd]
phil_cheng: folds 
yoshinoino: folds 
chenconhaste: folds 
ardo888: folds 
facelessPPP: folds 
Shakeelg: folds 
er13to: raises $1.72 to $2.72
matiko09: folds 
Uncalled bet ($1.72) returned to er13to
er13to collected $2 from pot
*** SUMMARY ***
Total pot $2 | Rake $0 
Seat 2: ardo888 folded before Flop (didn't bet)
Seat 3: facelessPPP folded before Flop (didn't bet)
Seat 4: Shakeelg (button) folded before Flop (didn't bet)
Seat 5: er13to (small blind) collected ($2)
Seat 6: matiko09 (big blind) folded before Flop
Seat 7: phil_cheng folded before Flop (didn't bet)
Seat 8: yoshinoino folded before Flop (didn't bet)
Seat 9: chenconhaste folded before Flop (didn't bet)





PokerStars Hand #155302354635:  Hold'em No Limit ($0.50/$1.00 USD) - 2016/06/28 16:50:57 CET [2016/06/28 10:50:57 ET]
Table 'Lyyli II' 9-max Seat #6 is the button
Seat 2: CI58 ($129.02 in chips) 
Seat 4: Greha999 ($215.23 in chips) 
Seat 5: flk.Dasas ($102.70 in chips) 
Seat 6: matiko09 ($100 in chips) 
Seat 7: mycka86 ($107.49 in chips) 
Seat 8: r4mz3s ($128.02 in chips) 
Seat 9: f1reworks ($104.70 in chips) 
mycka86: posts small blind $0.50
r4mz3s: posts big blind $1
Racushniak: sits out 
*** HOLE CARDS ***
Dealt to matiko09 [8d 2d]
f1reworks: folds 
CI58: raises $2 to $3
Greha999: folds 
flk.Dasas: folds 
matiko09: folds 
mycka86: folds 
r4mz3s: folds 
Uncalled bet ($2) returned to CI58
CI58 collected $2.50 from pot
CI58: doesn't show hand 
*** SUMMARY ***
Total pot $2.50 | Rake $0 
Seat 2: CI58 collected ($2.50)
Seat 4: Greha999 folded before Flop (didn't bet)
Seat 5: flk.Dasas folded before Flop (didn't bet)
Seat 6: matiko09 (button) folded before Flop (didn't bet)
Seat 7: mycka86 (small blind) folded before Flop
Seat 8: r4mz3s (big blind) folded before Flop
Seat 9: f1reworks folded before Flop (didn't bet)





PokerStars Hand #155302355371:  Hold'em No Limit ($0.25/$0.50 USD) - 2016/06/28 16:50:59 CET [2016/06/28 10:50:59 ET]
Table 'Antonia II' 9-max Seat #2 is the button
Seat 1: er13to ($54.34 in chips) 
Seat 2: myatiy 96 ($50 in chips) 
Seat 4: el.suertero ($71.68 in chips) 
Seat 5: 35LOBO35 ($16.38 in chips) 
Seat 6: matiko09 ($79.96 in chips) 
Seat 7: Kukuryzka ($55.51 in chips) 
Seat 9: Domotirko228 ($50 in chips) 
el.suertero: posts small blind $0.25
35LOBO35: posts big blind $0.50
SumPosad: sits out 
*** HOLE CARDS ***
Dealt to matiko09 [3s As]
matiko09: folds 
Kukuryzka: folds 
Domotirko228: folds 
er13to: folds 
myatiy 96: folds 
el.suertero: folds 
Uncalled bet ($0.25) returned to 35LOBO35
35LOBO35 collected $0.50 from pot
35LOBO35: doesn't show hand 
*** SUMMARY ***
Total pot $0.50 | Rake $0 
Seat 1: er13to folded before Flop (didn't bet)
Seat 2: myatiy 96 (button) folded before Flop (didn't bet)
Seat 4: el.suertero (small blind) folded before Flop
Seat 5: 35LOBO35 (big blind) collected ($0.50)
Seat 6: matiko09 folded before Flop (didn't bet)
Seat 7: Kukuryzka folded before Flop (didn't bet)
Seat 9: Domotirko228 folded before Flop (didn't bet)





PokerStars Hand #155302357884:  Hold'em No Limit (€0.50/€1.00 EUR) - 2016/06/28 16:51:03 CET [2016/06/28 10:51:03 ET]
Table 'Sadalmelik II' 9-max Seat #7 is the button
Seat 1: aseban11 (€102.28 in chips) 
Seat 2: matiko09 (€103 in chips) 
Seat 4: er13to (€112.50 in chips) 
Seat 5: ReMark_only (€43.62 in chips) 
Seat 7: mycka86 (€100 in chips) 
Seat 8: Kukuryzka (€99 in chips) 
Kukuryzka: posts small blind €0.50
aseban11: posts big blind €1
simoniustin: sits out 
*** HOLE CARDS ***
Dealt to matiko09 [Kd Jc]
matiko09: folds 
er13to: raises €1.72 to €2.72
ReMark_only: folds 
mycka86: calls €2.72
matiko09 leaves the table
Filojoes joins the table at seat #2 
Kukuryzka: folds 
aseban11: folds 
*** FLOP *** [Qs Kh 3h]
er13to: checks 
mycka86: bets €5
er13to: folds 
Uncalled bet (€5) returned to mycka86
mycka86 collected €6.59 from pot
*** SUMMARY ***
Total pot €6.94 | Rake €0.35 
Board [Qs Kh 3h]
Seat 1: aseban11 (big blind) folded before Flop
Seat 2: matiko09 folded before Flop (didn't bet)
Seat 4: er13to folded on the Flop
Seat 5: ReMark_only folded before Flop (didn't bet)
Seat 7: mycka86 (button) collected (€6.59)
Seat 8: Kukuryzka (small blind) folded before Flop





PokerStars Hand #155302360855:  Hold'em No Limit ($0.50/$1.00 USD) - 2016/06/28 16:51:09 CET [2016/06/28 10:51:09 ET]
Table 'Anitra' 9-max Seat #5 is the button
Seat 2: ardo888 ($102.72 in chips) 
Seat 3: facelessPPP ($117.06 in chips) 
Seat 4: Shakeelg ($181.63 in chips) 
Seat 5: er13to ($108.67 in chips) 
Seat 6: matiko09 ($100 in chips) 
Seat 7: phil_cheng ($100 in chips) 
Seat 8: yoshinoino ($26.25 in chips) 
Seat 9: chenconhaste ($102.28 in chips) 
matiko09: posts small blind $0.50
phil_cheng: posts big blind $1
mbk88: sits out 
*** HOLE CARDS ***
Dealt to matiko09 [6d 7s]
yoshinoino: folds 
chenconhaste: folds 
ardo888: raises $2 to $3
facelessPPP: calls $3
Shakeelg: calls $3
er13to: calls $3
matiko09: folds 
phil_cheng: folds 
*** FLOP *** [3d 8d 3c]
ardo888: checks 
facelessPPP: checks 
Shakeelg: bets $5
er13to: folds 
ardo888: folds 
facelessPPP: calls $5
*** TURN *** [3d 8d 3c] [9d]
facelessPPP: checks 
Shakeelg: bets $15
facelessPPP: raises $26.16 to $41.16
Shakeelg: calls $26.16
*** RIVER *** [3d 8d 3c 9d] [7c]
facelessPPP: bets $67.90 and is all-in
Shakeelg: calls $67.90
*** SHOW DOWN ***
facelessPPP: shows [8s 8h] (a full house, Eights full of Threes)
Shakeelg: shows [9h Ad] (two pair, Nines and Threes)
facelessPPP collected $239.12 from pot
*** SUMMARY ***
Total pot $241.62 | Rake $2.50 
Board [3d 8d 3c 9d 7c]
Seat 2: ardo888 folded on the Flop
Seat 3: facelessPPP showed [8s 8h] and won ($239.12) with a full house, Eights full of Threes
Seat 4: Shakeelg showed [9h Ad] and lost with two pair, Nines and Threes
Seat 5: er13to (button) folded on the Flop
Seat 6: matiko09 (small blind) folded before Flop
Seat 7: phil_cheng (big blind) folded before Flop
Seat 8: yoshinoino folded before Flop (didn't bet)
Seat 9: chenconhaste folded before Flop (didn't bet)





PokerStars Hand #155302365553:  Hold'em No Limit ($0.25/$0.50 USD) - 2016/06/28 16:51:17 CET [2016/06/28 10:51:17 ET]
Table 'Lycomedes II' 9-max Seat #4 is the button
Seat 1: el.suertero ($101.12 in chips) 
Seat 2: NinjEH ($136.96 in chips) 
Seat 3: Xx7-Zeus-7xX ($49.25 in chips) 
Seat 4: matiko09 ($50 in chips) 
Seat 5: chata.iz ($47.26 in chips) 
Seat 6: Mampa12 ($50 in chips) 
Seat 7: william87872 ($51 in chips) 
Seat 8: pandalapa ($57.27 in chips) 
Seat 9: MINER68 ($64 in chips) 
chata.iz: posts small blind $0.25
Mampa12: posts big blind $0.50
*** HOLE CARDS ***
Dealt to matiko09 [3c Ts]
william87872: folds 
pandalapa: folds 
MINER68: calls $0.50
el.suertero: raises $1.50 to $2
NinjEH: folds 
Xx7-Zeus-7xX: folds 
matiko09: folds 
chata.iz: folds 
Mampa12: folds 
MINER68: calls $1.50
*** FLOP *** [Ac 9c 3d]
MINER68: checks 
el.suertero: checks 
*** TURN *** [Ac 9c 3d] [Td]
MINER68: bets $1.50
el.suertero: folds 
Uncalled bet ($1.50) returned to MINER68
MINER68 collected $4.51 from pot
*** SUMMARY ***
Total pot $4.75 | Rake $0.24 
Board [Ac 9c 3d Td]
Seat 1: el.suertero folded on the Turn
Seat 2: NinjEH folded before Flop (didn't bet)
Seat 3: Xx7-Zeus-7xX folded before Flop (didn't bet)
Seat 4: matiko09 (button) folded before Flop (didn't bet)
Seat 5: chata.iz (small blind) folded before Flop
Seat 6: Mampa12 (big blind) folded before Flop
Seat 7: william87872 folded before Flop (didn't bet)
Seat 8: pandalapa folded before Flop (didn't bet)
Seat 9: MINER68 collected ($4.51)





PokerStars Hand #155302367674:  Hold'em No Limit ($0.25/$0.50 USD) - 2016/06/28 16:51:21 CET [2016/06/28 10:51:21 ET]
Table 'Lacadiera' 9-max Seat #6 is the button
Seat 1: matiko09 ($50 in chips) 
Seat 2: Alexey_Kim2 ($50 in chips) 
Seat 3: el.suertero ($83.16 in chips) 
Seat 4: denitz21 ($109 in chips) 
Seat 5: william87872 ($53.75 in chips) 
Seat 6: Kukuryzka ($96.27 in chips) 
Seat 7: chenconhaste ($61.96 in chips) 
Seat 8: Vedpapa ($66.90 in chips) 
Seat 9: Fakespecial ($284.12 in chips) 
chenconhaste: posts small blind $0.25
Vedpapa: posts big blind $0.50
*** HOLE CARDS ***
Dealt to matiko09 [5d Jc]
Fakespecial: folds 
matiko09: folds 
Alexey_Kim2: folds 
el.suertero: folds 
denitz21: folds 
william87872: folds 
Kukuryzka: folds 
chenconhaste: folds 
Uncalled bet ($0.25) returned to Vedpapa
Vedpapa collected $0.50 from pot
Vedpapa: doesn't show hand 
*** SUMMARY ***
Total pot $0.50 | Rake $0 
Seat 1: matiko09 folded before Flop (didn't bet)
Seat 2: Alexey_Kim2 folded before Flop (didn't bet)
Seat 3: el.suertero folded before Flop (didn't bet)
Seat 4: denitz21 folded before Flop (didn't bet)
Seat 5: william87872 folded before Flop (didn't bet)
Seat 6: Kukuryzka (button) folded before Flop (didn't bet)
Seat 7: chenconhaste (small blind) folded before Flop
Seat 8: Vedpapa (big blind) collected ($0.50)
Seat 9: Fakespecial folded before Flop (didn't bet)





PokerStars Hand #155302368929:  Hold'em No Limit ($0.50/$1.00 USD) - 2016/06/28 16:51:23 CET [2016/06/28 10:51:23 ET]
Table 'Dorado II' 9-max Seat #5 is the button
Seat 1: f1reworks ($158.38 in chips) 
Seat 2: vanilica ($100 in chips) 
Seat 3: ghostriderxu ($124.85 in chips) 
Seat 4: pyromid ($118.12 in chips) 
Seat 5: KovIFish89 ($100 in chips) 
Seat 6: mycka86 ($120.50 in chips) 
Seat 7: matiko09 ($101.50 in chips) 
Seat 8: flk.Dasas ($167.57 in chips) 
Seat 9: r4mz3s ($115.05 in chips) 
mycka86: posts small blind $0.50
matiko09: posts big blind $1
*** HOLE CARDS ***
Dealt to matiko09 [8s Qd]
flk.Dasas: folds 
r4mz3s: folds 
f1reworks: folds 
vanilica: raises $1.85 to $2.85
ghostriderxu: folds 
pyromid: folds 
KovIFish89: folds 
mycka86: folds 
matiko09: folds 
Uncalled bet ($1.85) returned to vanilica
vanilica collected $2.50 from pot
vanilica: doesn't show hand 
*** SUMMARY ***
Total pot $2.50 | Rake $0 
Seat 1: f1reworks folded before Flop (didn't bet)
Seat 2: vanilica collected ($2.50)
Seat 3: ghostriderxu folded before Flop (didn't bet)
Seat 4: pyromid folded before Flop (didn't bet)
Seat 5: KovIFish89 (button) folded before Flop (didn't bet)
Seat 6: mycka86 (small blind) folded before Flop
Seat 7: matiko09 (big blind) folded before Flop
Seat 8: flk.Dasas folded before Flop (didn't bet)
Seat 9: r4mz3s folded before Flop (didn't bet)





PokerStars Hand #155302374184:  Hold'em No Limit ($0.25/$0.50 USD) - 2016/06/28 16:51:32 CET [2016/06/28 10:51:32 ET]
Table 'Antonia II' 9-max Seat #4 is the button
Seat 1: er13to ($54.34 in chips) 
Seat 2: myatiy 96 ($50 in chips) 
Seat 4: el.suertero ($71.43 in chips) 
Seat 5: 35LOBO35 ($16.63 in chips) 
Seat 6: matiko09 ($79.96 in chips) 
Seat 7: Kukuryzka ($55.51 in chips) 
Seat 9: Domotirko228 ($50 in chips) 
35LOBO35: posts small blind $0.25
matiko09: posts big blind $0.50
SumPosad: sits out 
*** HOLE CARDS ***
Dealt to matiko09 [Kd 5c]
Kukuryzka: folds 
Domotirko228: folds 
er13to: folds 
myatiy 96: folds 
el.suertero: folds 
35LOBO35: raises $1 to $1.50
matiko09: folds 
Uncalled bet ($1) returned to 35LOBO35
35LOBO35 collected $1 from pot
35LOBO35: doesn't show hand 
*** SUMMARY ***
Total pot $1 | Rake $0 
Seat 1: er13to folded before Flop (didn't bet)
Seat 2: myatiy 96 folded before Flop (didn't bet)
Seat 4: el.suertero (button) folded before Flop (didn't bet)
Seat 5: 35LOBO35 (small blind) collected ($1)
Seat 6: matiko09 (big blind) folded before Flop
Seat 7: Kukuryzka folded before Flop (didn't bet)
Seat 9: Domotirko228 folded before Flop (didn't bet)





PokerStars Hand #155302375604:  Hold'em No Limit ($0.50/$1.00 USD) - 2016/06/28 16:51:35 CET [2016/06/28 10:51:35 ET]
Table 'Tomita' 9-max Seat #7 is the button
Seat 1: CI58 ($100 in chips) 
Seat 2: vanilica ($100 in chips) 
Seat 3: r4mz3s ($100 in chips) 
Seat 4: f1reworks ($100 in chips) 
Seat 5: ANDY19911608 ($195.71 in chips) 
Seat 7: matiko09 ($160.30 in chips) 
Seat 8: Noob0Saibot ($100 in chips) 
Seat 9: sanpidk ($161.30 in chips) 
Noob0Saibot: posts small blind $0.50
sanpidk: posts big blind $1
*** HOLE CARDS ***
Dealt to matiko09 [6d 7s]
CI58: folds 
vanilica: folds 
r4mz3s: raises $1.55 to $2.55
f1reworks: folds 
ANDY19911608: folds 
matiko09: folds 
Noob0Saibot: folds 
sanpidk: folds 
Uncalled bet ($1.55) returned to r4mz3s
r4mz3s collected $2.50 from pot
r4mz3s: doesn't show hand 
*** SUMMARY ***
Total pot $2.50 | Rake $0 
Seat 1: CI58 folded before Flop (didn't bet)
Seat 2: vanilica folded before Flop (didn't bet)
Seat 3: r4mz3s collected ($2.50)
Seat 4: f1reworks folded before Flop (didn't bet)
Seat 5: ANDY19911608 folded before Flop (didn't bet)
Seat 7: matiko09 (button) folded before Flop (didn't bet)
Seat 8: Noob0Saibot (small blind) folded before Flop
Seat 9: sanpidk (big blind) folded before Flop





PokerStars Hand #155302377148:  Hold'em No Limit ($0.50/$1.00 USD) - 2016/06/28 16:51:38 CET [2016/06/28 10:51:38 ET]
Table 'Lyyli II' 9-max Seat #7 is the button
Seat 2: CI58 ($130.52 in chips) 
Seat 4: Greha999 ($215.23 in chips) 
Seat 5: flk.Dasas ($102.70 in chips) 
Seat 6: matiko09 ($100 in chips) 
Seat 7: mycka86 ($106.99 in chips) 
Seat 8: r4mz3s ($127.02 in chips) 
Seat 9: f1reworks ($104.70 in chips) 
r4mz3s: posts small blind $0.50
f1reworks: posts big blind $1
Racushniak: sits out 
*** HOLE CARDS ***
Dealt to matiko09 [4h 6s]
CI58: folds 
Greha999: folds 
flk.Dasas: raises $2 to $3
matiko09: folds 
mycka86: folds 
r4mz3s: folds 
f1reworks: folds 
Uncalled bet ($2) returned to flk.Dasas
flk.Dasas collected $2.50 from pot
flk.Dasas: doesn't show hand 
*** SUMMARY ***
Total pot $2.50 | Rake $0 
Seat 2: CI58 folded before Flop (didn't bet)
Seat 4: Greha999 folded before Flop (didn't bet)
Seat 5: flk.Dasas collected ($2.50)
Seat 6: matiko09 folded before Flop (didn't bet)
Seat 7: mycka86 (button) folded before Flop (didn't bet)
Seat 8: r4mz3s (small blind) folded before Flop
Seat 9: f1reworks (big blind) folded before Flop





PokerStars Hand #155302379615:  Hold'em No Limit ($0.25/$0.50 USD) - 2016/06/28 16:51:42 CET [2016/06/28 10:51:42 ET]
Table 'Bruchsalia II' 9-max Seat #1 is the button
Seat 1: ardo888 ($50.84 in chips) 
Seat 3: el.suertero ($50 in chips) 
Seat 4: St.LaCoste ($44.31 in chips) 
Seat 5: Edkar686 ($37.76 in chips) 
Seat 6: matiko09 ($50 in chips) 
Seat 7: Lipton20088 ($20.63 in chips) 
Seat 8: Kukuryzka ($51.51 in chips) 
Seat 9: app1e_j@ck ($55.86 in chips) 
denitz21 will be allowed to play after the button
el.suertero: posts small blind $0.25
St.LaCoste: posts big blind $0.50
*** HOLE CARDS ***
Dealt to matiko09 [5d 3d]
Edkar686: calls $0.50
matiko09: folds 
Lipton20088: folds 
Kukuryzka: folds 
app1e_j@ck: folds 
ardo888: raises $1.50 to $2
el.suertero: folds 
St.LaCoste: calls $1.50
Edkar686: calls $1.50
*** FLOP *** [9c Td 8c]
St.LaCoste: checks 
Edkar686: checks 
ardo888: checks 
*** TURN *** [9c Td 8c] [2d]
St.LaCoste: checks 
Edkar686: bets $2.97
ardo888: calls $2.97
St.LaCoste: folds 
*** RIVER *** [9c Td 8c 2d] [9s]
Edkar686: bets $5.79
ardo888: folds 
Uncalled bet ($5.79) returned to Edkar686
Edkar686 collected $11.58 from pot
*** SUMMARY ***
Total pot $12.19 | Rake $0.61 
Board [9c Td 8c 2d 9s]
Seat 1: ardo888 (button) folded on the River
Seat 3: el.suertero (small blind) folded before Flop
Seat 4: St.LaCoste (big blind) folded on the Turn
Seat 5: Edkar686 collected ($11.58)
Seat 6: matiko09 folded before Flop (didn't bet)
Seat 7: Lipton20088 folded before Flop (didn't bet)
Seat 8: Kukuryzka folded before Flop (didn't bet)
Seat 9: app1e_j@ck folded before Flop (didn't bet)





PokerStars Hand #155302389609:  Hold'em No Limit ($0.50/$1.00 USD) - 2016/06/28 16:52:00 CET [2016/06/28 10:52:00 ET]
Table 'Dorado II' 9-max Seat #6 is the button
Seat 1: f1reworks ($158.38 in chips) 
Seat 2: vanilica ($101.50 in chips) 
Seat 3: ghostriderxu ($124.85 in chips) 
Seat 4: pyromid ($118.12 in chips) 
Seat 5: KovIFish89 ($100 in chips) 
Seat 6: mycka86 ($120 in chips) 
Seat 7: matiko09 ($100.50 in chips) 
Seat 8: flk.Dasas ($167.57 in chips) 
Seat 9: r4mz3s ($115.05 in chips) 
matiko09: posts small blind $0.50
flk.Dasas: posts big blind $1
*** HOLE CARDS ***
Dealt to matiko09 [2h Js]
r4mz3s: raises $2 to $3
f1reworks: folds 
vanilica: folds 
ghostriderxu: calls $3
pyromid: folds 
KovIFish89: folds 
mycka86: folds 
matiko09: folds 
flk.Dasas: folds 
*** FLOP *** [9h 8s Th]
r4mz3s: checks 
ghostriderxu: bets $4.70
r4mz3s: calls $4.70
*** TURN *** [9h 8s Th] [9d]
r4mz3s: checks 
ghostriderxu: bets $11.20
r4mz3s: calls $11.20
*** RIVER *** [9h 8s Th 9d] [5d]
r4mz3s: checks 
ghostriderxu: checks 
*** SHOW DOWN ***
r4mz3s: shows [Ac Ad] (two pair, Aces and Nines)
ghostriderxu: mucks hand 
r4mz3s collected $37.34 from pot
*** SUMMARY ***
Total pot $39.30 | Rake $1.96 
Board [9h 8s Th 9d 5d]
Seat 1: f1reworks folded before Flop (didn't bet)
Seat 2: vanilica folded before Flop (didn't bet)
Seat 3: ghostriderxu mucked [Ah Tc]
Seat 4: pyromid folded before Flop (didn't bet)
Seat 5: KovIFish89 folded before Flop (didn't bet)
Seat 6: mycka86 (button) folded before Flop (didn't bet)
Seat 7: matiko09 (small blind) folded before Flop
Seat 8: flk.Dasas (big blind) folded before Flop
Seat 9: r4mz3s showed [Ac Ad] and won ($37.34) with two pair, Aces and Nines





PokerStars Hand #155302390783:  Hold'em No Limit ($0.25/$0.50 USD) - 2016/06/28 16:52:02 CET [2016/06/28 10:52:02 ET]
Table 'Lacadiera' 9-max Seat #7 is the button
Seat 1: matiko09 ($50 in chips) 
Seat 2: Alexey_Kim2 ($50 in chips) 
Seat 3: el.suertero ($83.16 in chips) 
Seat 4: denitz21 ($109 in chips) 
Seat 5: william87872 ($53.75 in chips) 
Seat 6: Kukuryzka ($96.27 in chips) 
Seat 7: chenconhaste ($61.71 in chips) 
Seat 8: Vedpapa ($67.15 in chips) 
Seat 9: Fakespecial ($284.12 in chips) 
Vedpapa: posts small blind $0.25
Fakespecial: posts big blind $0.50
*** HOLE CARDS ***
Dealt to matiko09 [8s 7c]
matiko09: folds 
Alexey_Kim2: folds 
el.suertero: raises $1 to $1.50
denitz21: folds 
william87872: folds 
Kukuryzka: calls $1.50
chenconhaste: folds 
Vedpapa: folds 
Fakespecial: calls $1
*** FLOP *** [Ts Js 8h]
Fakespecial: checks 
el.suertero: checks 
Kukuryzka: checks 
*** TURN *** [Ts Js 8h] [3d]
Fakespecial: bets $1.50
el.suertero: folds 
Kukuryzka: folds 
Uncalled bet ($1.50) returned to Fakespecial
Fakespecial collected $4.51 from pot
Fakespecial: doesn't show hand 
*** SUMMARY ***
Total pot $4.75 | Rake $0.24 
Board [Ts Js 8h 3d]
Seat 1: matiko09 folded before Flop (didn't bet)
Seat 2: Alexey_Kim2 folded before Flop (didn't bet)
Seat 3: el.suertero folded on the Turn
Seat 4: denitz21 folded before Flop (didn't bet)
Seat 5: william87872 folded before Flop (didn't bet)
Seat 6: Kukuryzka folded on the Turn
Seat 7: chenconhaste (button) folded before Flop (didn't bet)
Seat 8: Vedpapa (small blind) folded before Flop
Seat 9: Fakespecial (big blind) collected ($4.51)





PokerStars Hand #155302391603:  Hold'em No Limit ($0.50/$1.00 USD) - 2016/06/28 16:52:04 CET [2016/06/28 10:52:04 ET]
Table 'Lyyli II' 9-max Seat #8 is the button
Seat 2: CI58 ($130.52 in chips) 
Seat 4: Greha999 ($215.23 in chips) 
Seat 5: flk.Dasas ($104.20 in chips) 
Seat 6: matiko09 ($100 in chips) 
Seat 7: mycka86 ($106.99 in chips) 
Seat 8: r4mz3s ($126.52 in chips) 
Seat 9: f1reworks ($103.70 in chips) 
f1reworks: posts small blind $0.50
CI58: posts big blind $1
Racushniak: sits out 
*** HOLE CARDS ***
Dealt to matiko09 [5s 2h]
Greha999: folds 
flk.Dasas: folds 
matiko09: folds 
mycka86: folds 
r4mz3s: raises $1.14 to $2.14
f1reworks: folds 
CI58: folds 
Uncalled bet ($1.14) returned to r4mz3s
r4mz3s collected $2.50 from pot
r4mz3s: doesn't show hand 
*** SUMMARY ***
Total pot $2.50 | Rake $0 
Seat 2: CI58 (big blind) folded before Flop
Seat 4: Greha999 folded before Flop (didn't bet)
Seat 5: flk.Dasas folded before Flop (didn't bet)
Seat 6: matiko09 folded before Flop (didn't bet)
Seat 7: mycka86 folded before Flop (didn't bet)
Seat 8: r4mz3s (button) collected ($2.50)
Seat 9: f1reworks (small blind) folded before Flop





PokerStars Hand #155302394268:  Hold'em No Limit ($0.50/$1.00 USD) - 2016/06/28 16:52:08 CET [2016/06/28 10:52:08 ET]
Table 'Tomita' 9-max Seat #8 is the button
Seat 1: CI58 ($100 in chips) 
Seat 2: vanilica ($100 in chips) 
Seat 3: r4mz3s ($101.50 in chips) 
Seat 4: f1reworks ($100 in chips) 
Seat 5: ANDY19911608 ($195.71 in chips) 
Seat 7: matiko09 ($160.30 in chips) 
Seat 8: Noob0Saibot ($100 in chips) 
Seat 9: sanpidk ($160.30 in chips) 
sanpidk: posts small blind $0.50
CI58: posts big blind $1
*** HOLE CARDS ***
Dealt to matiko09 [4d Ts]
vanilica: folds 
r4mz3s: folds 
f1reworks: folds 
ANDY19911608: calls $1
matiko09: folds 
Noob0Saibot: calls $1
sanpidk: folds 
CI58: checks 
*** FLOP *** [4h Th Kh]
CI58: checks 
ANDY19911608: checks 
Noob0Saibot: checks 
*** TURN *** [4h Th Kh] [Jd]
CI58: checks 
ANDY19911608: checks 
Noob0Saibot: checks 
*** RIVER *** [4h Th Kh Jd] [As]
CI58: checks 
ANDY19911608: checks 
Noob0Saibot: checks 
*** SHOW DOWN ***
CI58: shows [4c 7s] (a pair of Fours)
ANDY19911608: shows [Qh Ks] (a straight, Ten to Ace)
Noob0Saibot: mucks hand 
ANDY19911608 collected $3.32 from pot
*** SUMMARY ***
Total pot $3.50 | Rake $0.18 
Board [4h Th Kh Jd As]
Seat 1: CI58 (big blind) showed [4c 7s] and lost with a pair of Fours
Seat 2: vanilica folded before Flop (didn't bet)
Seat 3: r4mz3s folded before Flop (didn't bet)
Seat 4: f1reworks folded before Flop (didn't bet)
Seat 5: ANDY19911608 showed [Qh Ks] and won ($3.32) with a straight, Ten to Ace
Seat 7: matiko09 folded before Flop (didn't bet)
Seat 8: Noob0Saibot (button) mucked [9d 5h]
Seat 9: sanpidk (small blind) folded before Flop





PokerStars Hand #155302397565:  Hold'em No Limit ($0.25/$0.50 USD) - 2016/06/28 16:52:14 CET [2016/06/28 10:52:14 ET]
Table 'Lycomedes II' 9-max Seat #5 is the button
Seat 1: el.suertero ($99.12 in chips) 
Seat 2: NinjEH ($136.96 in chips) 
Seat 3: Xx7-Zeus-7xX ($49.25 in chips) 
Seat 4: matiko09 ($50 in chips) 
Seat 5: chata.iz ($47.01 in chips) 
Seat 6: Mampa12 ($49.50 in chips) 
Seat 8: pandalapa ($57.27 in chips) 
Seat 9: MINER68 ($66.51 in chips) 
Mampa12: posts small blind $0.25
william87872: is sitting out 
pandalapa: posts big blind $0.50
*** HOLE CARDS ***
Dealt to matiko09 [Td 7s]
MINER68: calls $0.50
el.suertero: folds 
NinjEH: folds 
Xx7-Zeus-7xX: folds 
matiko09: folds 
chata.iz: raises $1.38 to $1.88
Mampa12: folds 
pandalapa: folds 
MINER68: calls $1.38
*** FLOP *** [6s 4d 8d]
MINER68: checks 
chata.iz: bets $2.50
MINER68: calls $2.50
*** TURN *** [6s 4d 8d] [8c]
MINER68: checks 
chata.iz: bets $4.51
MINER68: calls $4.51
*** RIVER *** [6s 4d 8d 8c] [7h]
MINER68: bets $4
chata.iz: calls $4
*** SHOW DOWN ***
MINER68: shows [6d Ad] (two pair, Eights and Sixes)
chata.iz: shows [Ts 8s] (three of a kind, Eights)
chata.iz collected $25.20 from pot
*** SUMMARY ***
Total pot $26.53 | Rake $1.33 
Board [6s 4d 8d 8c 7h]
Seat 1: el.suertero folded before Flop (didn't bet)
Seat 2: NinjEH folded before Flop (didn't bet)
Seat 3: Xx7-Zeus-7xX folded before Flop (didn't bet)
Seat 4: matiko09 folded before Flop (didn't bet)
Seat 5: chata.iz (button) showed [Ts 8s] and won ($25.20) with three of a kind, Eights
Seat 6: Mampa12 (small blind) folded before Flop
Seat 8: pandalapa (big blind) folded before Flop
Seat 9: MINER68 showed [6d Ad] and lost with two pair, Eights and Sixes





PokerStars Hand #155302398695:  Hold'em No Limit ($0.25/$0.50 USD) - 2016/06/28 16:52:17 CET [2016/06/28 10:52:17 ET]
Table 'Antonia II' 9-max Seat #5 is the button
Seat 1: er13to ($54.34 in chips) 
Seat 2: myatiy 96 ($50 in chips) 
Seat 4: el.suertero ($71.43 in chips) 
Seat 5: 35LOBO35 ($17.13 in chips) 
Seat 6: matiko09 ($79.46 in chips) 
Seat 7: Kukuryzka ($55.51 in chips) 
Seat 9: Domotirko228 ($50 in chips) 
matiko09: posts small blind $0.25
Kukuryzka: posts big blind $0.50
SumPosad: sits out 
*** HOLE CARDS ***
Dealt to matiko09 [3h Js]
Domotirko228: folds 
er13to: folds 
myatiy 96: folds 
el.suertero: folds 
35LOBO35: calls $0.50
matiko09: folds 
Kukuryzka: raises $1.75 to $2.25
35LOBO35: calls $1.75
*** FLOP *** [Ah 3s 9c]
Kukuryzka: checks 
35LOBO35: checks 
*** TURN *** [Ah 3s 9c] [Jh]
Kukuryzka: bets $1.48
35LOBO35: calls $1.48
*** RIVER *** [Ah 3s 9c Jh] [Kd]
Kukuryzka: checks 
35LOBO35: checks 
*** SHOW DOWN ***
Kukuryzka: shows [7h 7c] (a pair of Sevens)
35LOBO35: shows [9d 8h] (a pair of Nines)
35LOBO35 collected $7.32 from pot
*** SUMMARY ***
Total pot $7.71 | Rake $0.39 
Board [Ah 3s 9c Jh Kd]
Seat 1: er13to folded before Flop (didn't bet)
Seat 2: myatiy 96 folded before Flop (didn't bet)
Seat 4: el.suertero folded before Flop (didn't bet)
Seat 5: 35LOBO35 (button) showed [9d 8h] and won ($7.32) with a pair of Nines
Seat 6: matiko09 (small blind) folded before Flop
Seat 7: Kukuryzka (big blind) showed [7h 7c] and lost with a pair of Sevens
Seat 9: Domotirko228 folded before Flop (didn't bet)





PokerStars Hand #155302413175:  Hold'em No Limit ($0.50/$1.00 USD) - 2016/06/28 16:52:43 CET [2016/06/28 10:52:43 ET]
Table 'Lyyli II' 9-max Seat #9 is the button
Seat 2: CI58 ($129.52 in chips) 
Seat 3: Racushniak ($100 in chips) 
Seat 4: Greha999 ($215.23 in chips) 
Seat 5: flk.Dasas ($104.20 in chips) 
Seat 6: matiko09 ($100 in chips) 
Seat 7: mycka86 ($106.99 in chips) 
Seat 8: r4mz3s ($128.02 in chips) 
Seat 9: f1reworks ($103.20 in chips) 
CI58: posts small blind $0.50
Racushniak: posts big blind $1
*** HOLE CARDS ***
Dealt to matiko09 [6s 2h]
Greha999: folds 
flk.Dasas: folds 
matiko09: folds 
mycka86: raises $1.50 to $2.50
r4mz3s: folds 
f1reworks: folds 
CI58: folds 
Racushniak: folds 
Uncalled bet ($1.50) returned to mycka86
mycka86 collected $2.50 from pot
*** SUMMARY ***
Total pot $2.50 | Rake $0 
Seat 2: CI58 (small blind) folded before Flop
Seat 3: Racushniak (big blind) folded before Flop
Seat 4: Greha999 folded before Flop (didn't bet)
Seat 5: flk.Dasas folded before Flop (didn't bet)
Seat 6: matiko09 folded before Flop (didn't bet)
Seat 7: mycka86 collected ($2.50)
Seat 8: r4mz3s folded before Flop (didn't bet)
Seat 9: f1reworks (button) folded before Flop (didn't bet)





PokerStars Hand #155302414379:  Hold'em No Limit ($0.50/$1.00 USD) - 2016/06/28 16:52:45 CET [2016/06/28 10:52:45 ET]
Table 'Anitra' 9-max Seat #6 is the button
Seat 2: ardo888 ($100 in chips) 
Seat 3: facelessPPP ($239.12 in chips) 
Seat 4: Shakeelg ($64.57 in chips) 
Seat 5: er13to ($105.67 in chips) 
Seat 6: matiko09 ($100 in chips) 
Seat 7: phil_cheng ($100 in chips) 
Seat 8: yoshinoino ($26.25 in chips) 
Seat 9: chenconhaste ($102.28 in chips) 
phil_cheng: posts small blind $0.50
yoshinoino: posts big blind $1
mbk88: sits out 
*** HOLE CARDS ***
Dealt to matiko09 [2s 7h]
chenconhaste: folds 
ardo888: folds 
facelessPPP: folds 
Shakeelg: folds 
er13to: folds 
matiko09: folds 
phil_cheng: raises $2 to $3
yoshinoino: calls $2
*** FLOP *** [Qs 6c 2d]
phil_cheng: checks 
yoshinoino: checks 
*** TURN *** [Qs 6c 2d] [6s]
phil_cheng: bets $3.79
yoshinoino: calls $3.79
*** RIVER *** [Qs 6c 2d 6s] [Jd]
phil_cheng: checks 
yoshinoino: bets $6.45
phil_cheng: folds 
Uncalled bet ($6.45) returned to yoshinoino
yoshinoino collected $12.90 from pot
yoshinoino: doesn't show hand 
*** SUMMARY ***
Total pot $13.58 | Rake $0.68 
Board [Qs 6c 2d 6s Jd]
Seat 2: ardo888 folded before Flop (didn't bet)
Seat 3: facelessPPP folded before Flop (didn't bet)
Seat 4: Shakeelg folded before Flop (didn't bet)
Seat 5: er13to folded before Flop (didn't bet)
Seat 6: matiko09 (button) folded before Flop (didn't bet)
Seat 7: phil_cheng (small blind) folded on the River
Seat 8: yoshinoino (big blind) collected ($12.90)
Seat 9: chenconhaste folded before Flop (didn't bet)





PokerStars Hand #155302419224:  Hold'em No Limit ($0.50/$1.00 USD) - 2016/06/28 16:52:54 CET [2016/06/28 10:52:54 ET]
Table 'Tomita' 9-max Seat #9 is the button
Seat 1: CI58 ($100 in chips) 
Seat 2: vanilica ($100 in chips) 
Seat 3: r4mz3s ($101.50 in chips) 
Seat 4: f1reworks ($100 in chips) 
Seat 5: ANDY19911608 ($198.03 in chips) 
Seat 7: matiko09 ($160.30 in chips) 
Seat 8: Noob0Saibot ($100 in chips) 
Seat 9: sanpidk ($159.80 in chips) 
CI58: posts small blind $0.50
vanilica: posts big blind $1
*** HOLE CARDS ***
Dealt to matiko09 [Tc 6c]
r4mz3s: folds 
f1reworks: folds 
ANDY19911608: calls $1
matiko09: folds 
Noob0Saibot: raises $3 to $4
sanpidk: folds 
CI58: folds 
vanilica: folds 
ANDY19911608: raises $3 to $7
Noob0Saibot: calls $3
*** FLOP *** [Qh 8d 3h]
ANDY19911608: checks 
Noob0Saibot: checks 
*** TURN *** [Qh 8d 3h] [3c]
ANDY19911608: checks 
Noob0Saibot: checks 
*** RIVER *** [Qh 8d 3h 3c] [6d]
ANDY19911608: checks 
Noob0Saibot: checks 
*** SHOW DOWN ***
ANDY19911608: shows [Jh Ad] (a pair of Threes)
Noob0Saibot: mucks hand 
ANDY19911608 collected $14.72 from pot
*** SUMMARY ***
Total pot $15.50 | Rake $0.78 
Board [Qh 8d 3h 3c 6d]
Seat 1: CI58 (small blind) folded before Flop
Seat 2: vanilica (big blind) folded before Flop
Seat 3: r4mz3s folded before Flop (didn't bet)
Seat 4: f1reworks folded before Flop (didn't bet)
Seat 5: ANDY19911608 showed [Jh Ad] and won ($14.72) with a pair of Threes
Seat 7: matiko09 folded before Flop (didn't bet)
Seat 8: Noob0Saibot mucked [Ts 9s]
Seat 9: sanpidk (button) folded before Flop (didn't bet)





PokerStars Hand #155302423203:  Hold'em No Limit ($0.50/$1.00 USD) - 2016/06/28 16:53:01 CET [2016/06/28 10:53:01 ET]
Table 'Lyyli II' 9-max Seat #2 is the button
Seat 2: CI58 ($129.02 in chips) 
Seat 3: Racushniak ($100 in chips) 
Seat 4: Greha999 ($215.23 in chips) 
Seat 5: flk.Dasas ($104.20 in chips) 
Seat 6: matiko09 ($100 in chips) 
Seat 7: mycka86 ($108.49 in chips) 
Seat 8: r4mz3s ($128.02 in chips) 
Seat 9: f1reworks ($103.20 in chips) 
Racushniak: posts small blind $0.50
Greha999: posts big blind $1
*** HOLE CARDS ***
Dealt to matiko09 [2d 7h]
flk.Dasas: raises $2 to $3
matiko09: folds 
mycka86: folds 
r4mz3s: folds 
f1reworks: raises $6 to $9
CI58: folds 
Racushniak: folds 
Greha999: folds 
flk.Dasas: folds 
Uncalled bet ($6) returned to f1reworks
f1reworks collected $7.50 from pot
f1reworks: doesn't show hand 
*** SUMMARY ***
Total pot $7.50 | Rake $0 
Seat 2: CI58 (button) folded before Flop (didn't bet)
Seat 3: Racushniak (small blind) folded before Flop
Seat 4: Greha999 (big blind) folded before Flop
Seat 5: flk.Dasas folded before Flop
Seat 6: matiko09 folded before Flop (didn't bet)
Seat 7: mycka86 folded before Flop (didn't bet)
Seat 8: r4mz3s folded before Flop (didn't bet)
Seat 9: f1reworks collected ($7.50)





PokerStars Hand #155302434255:  Hold'em No Limit ($0.25/$0.50 USD) - 2016/06/28 16:53:21 CET [2016/06/28 10:53:21 ET]
Table 'Bruchsalia II' 9-max Seat #3 is the button
Seat 1: ardo888 ($50 in chips) 
Seat 3: el.suertero ($50 in chips) 
Seat 4: St.LaCoste ($42.31 in chips) 
Seat 5: Edkar686 ($44.37 in chips) 
Seat 6: matiko09 ($50 in chips) 
Seat 7: Lipton20088 ($20.63 in chips) 
Seat 8: Kukuryzka ($51.51 in chips) 
Seat 9: app1e_j@ck ($55.86 in chips) 
St.LaCoste: posts small blind $0.25
Edkar686: posts big blind $0.50
denitz21: sits out 
*** HOLE CARDS ***
Dealt to matiko09 [9d Ad]
matiko09: folds 
Lipton20088: folds 
Kukuryzka: folds 
app1e_j@ck: folds 
ardo888: folds 
el.suertero: folds 
St.LaCoste: raises $0.64 to $1.14
Edkar686: calls $0.64
*** FLOP *** [5h 6s 3c]
St.LaCoste: bets $1.31
Edkar686: calls $1.31
*** TURN *** [5h 6s 3c] [Ac]
St.LaCoste: checks 
Edkar686: checks 
*** RIVER *** [5h 6s 3c Ac] [6c]
St.LaCoste: checks 
Edkar686: checks 
*** SHOW DOWN ***
St.LaCoste: shows [9s Tc] (a pair of Sixes)
Edkar686: shows [Qs 3s] (two pair, Sixes and Threes)
Edkar686 collected $4.66 from pot
*** SUMMARY ***
Total pot $4.90 | Rake $0.24 
Board [5h 6s 3c Ac 6c]
Seat 1: ardo888 folded before Flop (didn't bet)
Seat 3: el.suertero (button) folded before Flop (didn't bet)
Seat 4: St.LaCoste (small blind) showed [9s Tc] and lost with a pair of Sixes
Seat 5: Edkar686 (big blind) showed [Qs 3s] and won ($4.66) with two pair, Sixes and Threes
Seat 6: matiko09 folded before Flop (didn't bet)
Seat 7: Lipton20088 folded before Flop (didn't bet)
Seat 8: Kukuryzka folded before Flop (didn't bet)
Seat 9: app1e_j@ck folded before Flop (didn't bet)





PokerStars Hand #155302440421:  Hold'em No Limit ($0.25/$0.50 USD) - 2016/06/28 16:53:32 CET [2016/06/28 10:53:32 ET]
Table 'Lacadiera' 9-max Seat #8 is the button
Seat 1: matiko09 ($50 in chips) 
Seat 2: Alexey_Kim2 ($50 in chips) 
Seat 3: el.suertero ($81.66 in chips) 
Seat 4: denitz21 ($109 in chips) 
Seat 5: william87872 ($53.75 in chips) 
Seat 6: Kukuryzka ($94.77 in chips) 
Seat 7: chenconhaste ($61.71 in chips) 
Seat 8: Vedpapa ($66.90 in chips) 
Seat 9: Fakespecial ($287.13 in chips) 
Fakespecial: posts small blind $0.25
matiko09: posts big blind $0.50
*** HOLE CARDS ***
Dealt to matiko09 [4d Td]
Alexey_Kim2: folds 
el.suertero: folds 
denitz21: raises $1.50 to $2
william87872: folds 
Kukuryzka: folds 
chenconhaste: folds 
Vedpapa: folds 
Fakespecial: folds 
matiko09: folds 
Uncalled bet ($1.50) returned to denitz21
denitz21 collected $1.25 from pot
denitz21: doesn't show hand 
*** SUMMARY ***
Total pot $1.25 | Rake $0 
Seat 1: matiko09 (big blind) folded before Flop
Seat 2: Alexey_Kim2 folded before Flop (didn't bet)
Seat 3: el.suertero folded before Flop (didn't bet)
Seat 4: denitz21 collected ($1.25)
Seat 5: william87872 folded before Flop (didn't bet)
Seat 6: Kukuryzka folded before Flop (didn't bet)
Seat 7: chenconhaste folded before Flop (didn't bet)
Seat 8: Vedpapa (button) folded before Flop (didn't bet)
Seat 9: Fakespecial (small blind) folded before Flop





PokerStars Hand #155302442755:  Hold'em No Limit ($0.25/$0.50 USD) - 2016/06/28 16:53:37 CET [2016/06/28 10:53:37 ET]
Table 'Antonia II' 9-max Seat #6 is the button
Seat 1: er13to ($54.34 in chips) 
Seat 2: myatiy 96 ($50 in chips) 
Seat 4: el.suertero ($71.43 in chips) 
Seat 5: 35LOBO35 ($20.72 in chips) 
Seat 6: matiko09 ($79.21 in chips) 
Seat 7: Kukuryzka ($51.78 in chips) 
Seat 8: SumPosad ($20 in chips) 
Seat 9: Domotirko228 ($50 in chips) 
Kukuryzka: posts small blind $0.25
SumPosad: posts big blind $0.50
*** HOLE CARDS ***
Dealt to matiko09 [5s 3s]
Domotirko228: folds 
er13to: folds 
myatiy 96: folds 
el.suertero: folds 
35LOBO35: folds 
matiko09: folds 
Kukuryzka: raises $0.75 to $1.25
SumPosad: folds 
Uncalled bet ($0.75) returned to Kukuryzka
Kukuryzka collected $1 from pot
Kukuryzka: doesn't show hand 
*** SUMMARY ***
Total pot $1 | Rake $0 
Seat 1: er13to folded before Flop (didn't bet)
Seat 2: myatiy 96 folded before Flop (didn't bet)
Seat 4: el.suertero folded before Flop (didn't bet)
Seat 5: 35LOBO35 folded before Flop (didn't bet)
Seat 6: matiko09 (button) folded before Flop (didn't bet)
Seat 7: Kukuryzka (small blind) collected ($1)
Seat 8: SumPosad (big blind) folded before Flop
Seat 9: Domotirko228 folded before Flop (didn't bet)





PokerStars Hand #155302444184:  Hold'em No Limit ($0.25/$0.50 USD) - 2016/06/28 16:53:39 CET [2016/06/28 10:53:39 ET]
Table 'Lycomedes II' 9-max Seat #6 is the button
Seat 1: el.suertero ($99.12 in chips) 
Seat 2: NinjEH ($136.96 in chips) 
Seat 3: Xx7-Zeus-7xX ($49.25 in chips) 
Seat 4: matiko09 ($50 in chips) 
Seat 5: chata.iz ($59.32 in chips) 
Seat 6: Mampa12 ($49.25 in chips) 
Seat 8: pandalapa ($56.77 in chips) 
Seat 9: MINER68 ($53.62 in chips) 
pandalapa: posts small blind $0.25
MINER68: posts big blind $0.50
*** HOLE CARDS ***
Dealt to matiko09 [8c 3c]
el.suertero: folds 
NinjEH: folds 
Xx7-Zeus-7xX: folds 
matiko09: folds 
chata.iz: calls $0.50
Mampa12: folds 
pandalapa: folds 
MINER68: checks 
*** FLOP *** [Tc 6h 8h]
MINER68: checks 
chata.iz: checks 
*** TURN *** [Tc 6h 8h] [4h]
MINER68: checks 
chata.iz: checks 
*** RIVER *** [Tc 6h 8h 4h] [4s]
MINER68: bets $1
chata.iz: calls $1
*** SHOW DOWN ***
MINER68: shows [2s 2h] (two pair, Fours and Deuces)
chata.iz: shows [5s 5c] (two pair, Fives and Fours)
chata.iz collected $3.09 from pot
*** SUMMARY ***
Total pot $3.25 | Rake $0.16 
Board [Tc 6h 8h 4h 4s]
Seat 1: el.suertero folded before Flop (didn't bet)
Seat 2: NinjEH folded before Flop (didn't bet)
Seat 3: Xx7-Zeus-7xX folded before Flop (didn't bet)
Seat 4: matiko09 folded before Flop (didn't bet)
Seat 5: chata.iz showed [5s 5c] and won ($3.09) with two pair, Fives and Fours
Seat 6: Mampa12 (button) folded before Flop (didn't bet)
Seat 8: pandalapa (small blind) folded before Flop
Seat 9: MINER68 (big blind) showed [2s 2h] and lost with two pair, Fours and Deuces





PokerStars Hand #155302446887:  Hold'em No Limit ($0.50/$1.00 USD) - 2016/06/28 16:53:44 CET [2016/06/28 10:53:44 ET]
Table 'Anitra' 9-max Seat #7 is the button
Seat 2: ardo888 ($100 in chips) 
Seat 3: facelessPPP ($239.12 in chips) 
Seat 4: Shakeelg ($64.57 in chips) 
Seat 5: er13to ($105.67 in chips) 
Seat 6: matiko09 ($100 in chips) 
Seat 7: phil_cheng ($100 in chips) 
Seat 8: yoshinoino ($32.36 in chips) 
Seat 9: chenconhaste ($102.28 in chips) 
yoshinoino: posts small blind $0.50
chenconhaste: posts big blind $1
mbk88: sits out 
*** HOLE CARDS ***
Dealt to matiko09 [Jd Jc]
ardo888: folds 
facelessPPP: folds 
Shakeelg: raises $2 to $3
er13to: raises $6 to $9
matiko09: calls $9
phil_cheng: folds 
yoshinoino: folds 
chenconhaste: folds 
Shakeelg: calls $6
*** FLOP *** [Kc 8s 5c]
Shakeelg: checks 
er13to: checks 
matiko09: checks 
*** TURN *** [Kc 8s 5c] [6d]
Shakeelg: checks 
er13to: bets $22.50
mbk88 leaves the table
myatiy 96 joins the table at seat #1 
myatiy 96 leaves the table
stds st joins the table at seat #1 
matiko09: folds 
Shakeelg: folds 
Uncalled bet ($22.50) returned to er13to
er13to collected $27.08 from pot
*** SUMMARY ***
Total pot $28.50 | Rake $1.42 
Board [Kc 8s 5c 6d]
Seat 2: ardo888 folded before Flop (didn't bet)
Seat 3: facelessPPP folded before Flop (didn't bet)
Seat 4: Shakeelg folded on the Turn
Seat 5: er13to collected ($27.08)
Seat 6: matiko09 folded on the Turn
Seat 7: phil_cheng (button) folded before Flop (didn't bet)
Seat 8: yoshinoino (small blind) folded before Flop
Seat 9: chenconhaste (big blind) folded before Flop





PokerStars Hand #155302448023:  Hold'em No Limit ($0.50/$1.00 USD) - 2016/06/28 16:53:46 CET [2016/06/28 10:53:46 ET]
Table 'Dorado II' 9-max Seat #7 is the button
Seat 1: f1reworks ($158.38 in chips) 
Seat 2: vanilica ($101.50 in chips) 
Seat 3: ghostriderxu ($105.95 in chips) 
Seat 4: pyromid ($118.12 in chips) 
Seat 5: KovIFish89 ($100 in chips) 
Seat 6: mycka86 ($120 in chips) 
Seat 7: matiko09 ($100 in chips) 
Seat 8: flk.Dasas ($166.57 in chips) 
Seat 9: r4mz3s ($133.49 in chips) 
flk.Dasas: posts small blind $0.50
r4mz3s: posts big blind $1
*** HOLE CARDS ***
Dealt to matiko09 [5s Qh]
f1reworks: folds 
vanilica: raises $1.85 to $2.85
ghostriderxu: folds 
pyromid: folds 
KovIFish89: folds 
mycka86: folds 
matiko09: folds 
flk.Dasas: folds 
r4mz3s: calls $1.85
*** FLOP *** [7h 7s Jh]
r4mz3s: checks 
vanilica: checks 
*** TURN *** [7h 7s Jh] [As]
r4mz3s: checks 
vanilica: checks 
*** RIVER *** [7h 7s Jh As] [8s]
r4mz3s: checks 
vanilica: checks 
*** SHOW DOWN ***
r4mz3s: shows [3h 3s] (two pair, Sevens and Threes)
vanilica: shows [9c 9d] (two pair, Nines and Sevens)
vanilica collected $5.89 from pot
*** SUMMARY ***
Total pot $6.20 | Rake $0.31 
Board [7h 7s Jh As 8s]
Seat 1: f1reworks folded before Flop (didn't bet)
Seat 2: vanilica showed [9c 9d] and won ($5.89) with two pair, Nines and Sevens
Seat 3: ghostriderxu folded before Flop (didn't bet)
Seat 4: pyromid folded before Flop (didn't bet)
Seat 5: KovIFish89 folded before Flop (didn't bet)
Seat 6: mycka86 folded before Flop (didn't bet)
Seat 7: matiko09 (button) folded before Flop (didn't bet)
Seat 8: flk.Dasas (small blind) folded before Flop
Seat 9: r4mz3s (big blind) showed [3h 3s] and lost with two pair, Sevens and Threes





PokerStars Hand #155302450020:  Hold'em No Limit ($0.50/$1.00 USD) - 2016/06/28 16:53:50 CET [2016/06/28 10:53:50 ET]
Table 'Tomita' 9-max Seat #1 is the button
Seat 1: CI58 ($100 in chips) 
Seat 2: vanilica ($100 in chips) 
Seat 3: r4mz3s ($101.50 in chips) 
Seat 4: f1reworks ($100 in chips) 
Seat 5: ANDY19911608 ($205.75 in chips) 
Seat 7: matiko09 ($160.30 in chips) 
Seat 8: Noob0Saibot ($100 in chips) 
Seat 9: sanpidk ($159.80 in chips) 
vanilica: posts small blind $0.50
r4mz3s: posts big blind $1
*** HOLE CARDS ***
Dealt to matiko09 [7s 7h]
f1reworks: raises $2 to $3
ANDY19911608: calls $3
matiko09: calls $3
Noob0Saibot: calls $3
sanpidk: folds 
CI58: calls $3
vanilica: folds 
r4mz3s: calls $2
*** FLOP *** [Kh Qc 4h]
r4mz3s: checks 
f1reworks: checks 
ANDY19911608: checks 
matiko09: checks 
Noob0Saibot: checks 
CI58: checks 
*** TURN *** [Kh Qc 4h] [Qd]
r4mz3s: checks 
f1reworks: checks 
ANDY19911608: checks 
matiko09: checks 
Noob0Saibot: checks 
CI58: checks 
*** RIVER *** [Kh Qc 4h Qd] [Th]
r4mz3s: checks 
f1reworks: bets $9.66
ANDY19911608: folds 
matiko09: folds 
Noob0Saibot: folds 
CI58: folds 
r4mz3s: folds 
Uncalled bet ($9.66) returned to f1reworks
f1reworks collected $17.58 from pot
f1reworks: doesn't show hand 
*** SUMMARY ***
Total pot $18.50 | Rake $0.92 
Board [Kh Qc 4h Qd Th]
Seat 1: CI58 (button) folded on the River
Seat 2: vanilica (small blind) folded before Flop
Seat 3: r4mz3s (big blind) folded on the River
Seat 4: f1reworks collected ($17.58)
Seat 5: ANDY19911608 folded on the River
Seat 7: matiko09 folded on the River
Seat 8: Noob0Saibot folded on the River
Seat 9: sanpidk folded before Flop (didn't bet)





PokerStars Hand #155302457372:  Hold'em No Limit ($0.25/$0.50 USD) - 2016/06/28 16:54:03 CET [2016/06/28 10:54:03 ET]
Table 'Lacadiera' 9-max Seat #9 is the button
Seat 1: matiko09 ($50 in chips) 
Seat 2: Alexey_Kim2 ($50 in chips) 
Seat 3: el.suertero ($81.66 in chips) 
Seat 4: denitz21 ($109.75 in chips) 
Seat 5: william87872 ($53.75 in chips) 
Seat 6: Kukuryzka ($94.77 in chips) 
Seat 7: chenconhaste ($61.71 in chips) 
Seat 8: Vedpapa ($66.90 in chips) 
Seat 9: Fakespecial ($286.88 in chips) 
matiko09: posts small blind $0.25
Alexey_Kim2: posts big blind $0.50
*** HOLE CARDS ***
Dealt to matiko09 [8h Ah]
el.suertero: folds 
denitz21: raises $1.50 to $2
william87872: folds 
Kukuryzka: folds 
chenconhaste: folds 
Vedpapa: folds 
Fakespecial: calls $2
matiko09: folds 
Alexey_Kim2: calls $1.50
*** FLOP *** [9c Td Qc]
Alexey_Kim2: checks 
denitz21: checks 
Fakespecial: checks 
*** TURN *** [9c Td Qc] [5c]
Alexey_Kim2: checks 
denitz21: checks 
Fakespecial: checks 
*** RIVER *** [9c Td Qc 5c] [Kh]
Alexey_Kim2: bets $48 and is all-in
denitz21: calls $48
Fakespecial: folds 
*** SHOW DOWN ***
Alexey_Kim2: shows [6c 7c] (a flush, Queen high)
denitz21: shows [Ac Tc] (a flush, Ace high)
denitz21 collected $100.25 from pot
*** SUMMARY ***
Total pot $102.25 | Rake $2 
Board [9c Td Qc 5c Kh]
Seat 1: matiko09 (small blind) folded before Flop
Seat 2: Alexey_Kim2 (big blind) showed [6c 7c] and lost with a flush, Queen high
Seat 3: el.suertero folded before Flop (didn't bet)
Seat 4: denitz21 showed [Ac Tc] and won ($100.25) with a flush, Ace high
Seat 5: william87872 folded before Flop (didn't bet)
Seat 6: Kukuryzka folded before Flop (didn't bet)
Seat 7: chenconhaste folded before Flop (didn't bet)
Seat 8: Vedpapa folded before Flop (didn't bet)
Seat 9: Fakespecial (button) folded on the River





PokerStars Hand #155302461554:  Hold'em No Limit ($0.25/$0.50 USD) - 2016/06/28 16:54:10 CET [2016/06/28 10:54:10 ET]
Table 'Antonia II' 9-max Seat #7 is the button
Seat 1: er13to ($54.34 in chips) 
Seat 2: myatiy 96 ($50 in chips) 
Seat 4: el.suertero ($71.43 in chips) 
Seat 5: 35LOBO35 ($20.72 in chips) 
Seat 6: matiko09 ($79.21 in chips) 
Seat 7: Kukuryzka ($52.28 in chips) 
Seat 8: SumPosad ($19.50 in chips) 
Seat 9: Domotirko228 ($50 in chips) 
SumPosad: posts small blind $0.25
Domotirko228: posts big blind $0.50
*** HOLE CARDS ***
Dealt to matiko09 [Th Jd]
er13to: folds 
myatiy 96: folds 
el.suertero: folds 
35LOBO35: calls $0.50
matiko09: raises $1.50 to $2
Kukuryzka: folds 
SumPosad: folds 
Domotirko228: folds 
35LOBO35 is disconnected 
35LOBO35 has timed out while disconnected
35LOBO35: folds 
Uncalled bet ($1.50) returned to matiko09
matiko09 collected $1.75 from pot
matiko09: doesn't show hand 
*** SUMMARY ***
Total pot $1.75 | Rake $0 
Seat 1: er13to folded before Flop (didn't bet)
Seat 2: myatiy 96 folded before Flop (didn't bet)
Seat 4: el.suertero folded before Flop (didn't bet)
Seat 5: 35LOBO35 folded before Flop
Seat 6: matiko09 collected ($1.75)
Seat 7: Kukuryzka (button) folded before Flop (didn't bet)
Seat 8: SumPosad (small blind) folded before Flop
Seat 9: Domotirko228 (big blind) folded before Flop





PokerStars Hand #155302461612:  Hold'em No Limit ($0.50/$1.00 USD) - 2016/06/28 16:54:11 CET [2016/06/28 10:54:11 ET]
Table 'Lyyli II' 9-max Seat #3 is the button
Seat 2: CI58 ($129.02 in chips) 
Seat 3: Racushniak ($100 in chips) 
Seat 4: Greha999 ($214.23 in chips) 
Seat 5: flk.Dasas ($101.20 in chips) 
Seat 6: matiko09 ($100 in chips) 
Seat 7: mycka86 ($108.49 in chips) 
Seat 8: r4mz3s ($128.02 in chips) 
Seat 9: f1reworks ($107.70 in chips) 
Greha999: posts small blind $0.50
flk.Dasas: posts big blind $1
*** HOLE CARDS ***
Dealt to matiko09 [5c Qs]
matiko09: folds 
mycka86: folds 
r4mz3s: folds 
f1reworks: folds 
CI58: raises $1.50 to $2.50
Racushniak: folds 
Greha999: folds 
flk.Dasas: folds 
Uncalled bet ($1.50) returned to CI58
CI58 collected $2.50 from pot
CI58: doesn't show hand 
*** SUMMARY ***
Total pot $2.50 | Rake $0 
Seat 2: CI58 collected ($2.50)
Seat 3: Racushniak (button) folded before Flop (didn't bet)
Seat 4: Greha999 (small blind) folded before Flop
Seat 5: flk.Dasas (big blind) folded before Flop
Seat 6: matiko09 folded before Flop (didn't bet)
Seat 7: mycka86 folded before Flop (didn't bet)
Seat 8: r4mz3s folded before Flop (didn't bet)
Seat 9: f1reworks folded before Flop (didn't bet)





PokerStars Hand #155302472188:  Hold'em No Limit ($0.50/$1.00 USD) - 2016/06/28 16:54:30 CET [2016/06/28 10:54:30 ET]
Table 'Lyyli II' 9-max Seat #4 is the button
Seat 2: CI58 ($130.52 in chips) 
Seat 3: Racushniak ($100 in chips) 
Seat 4: Greha999 ($213.73 in chips) 
Seat 5: flk.Dasas ($100.20 in chips) 
Seat 6: matiko09 ($100 in chips) 
Seat 7: mycka86 ($108.49 in chips) 
Seat 8: r4mz3s ($128.02 in chips) 
Seat 9: f1reworks ($107.70 in chips) 
flk.Dasas: posts small blind $0.50
matiko09: posts big blind $1
*** HOLE CARDS ***
Dealt to matiko09 [Ac 8d]
mycka86: folds 
r4mz3s: folds 
f1reworks: folds 
CI58: folds 
Racushniak: folds 
Greha999: folds 
flk.Dasas: folds 
Uncalled bet ($0.50) returned to matiko09
matiko09 collected $1 from pot
matiko09: doesn't show hand 
*** SUMMARY ***
Total pot $1 | Rake $0 
Seat 2: CI58 folded before Flop (didn't bet)
Seat 3: Racushniak folded before Flop (didn't bet)
Seat 4: Greha999 (button) folded before Flop (didn't bet)
Seat 5: flk.Dasas (small blind) folded before Flop
Seat 6: matiko09 (big blind) collected ($1)
Seat 7: mycka86 folded before Flop (didn't bet)
Seat 8: r4mz3s folded before Flop (didn't bet)
Seat 9: f1reworks folded before Flop (didn't bet)





PokerStars Hand #155302473495:  Hold'em No Limit ($0.25/$0.50 USD) - 2016/06/28 16:54:32 CET [2016/06/28 10:54:32 ET]
Table 'Lycomedes II' 9-max Seat #8 is the button
Seat 1: el.suertero ($99.12 in chips) 
Seat 2: NinjEH ($136.96 in chips) 
Seat 3: Xx7-Zeus-7xX ($49.25 in chips) 
Seat 4: matiko09 ($50 in chips) 
Seat 5: chata.iz ($60.91 in chips) 
Seat 6: Mampa12 ($49.25 in chips) 
Seat 8: pandalapa ($56.52 in chips) 
el.suertero: posts small blind $0.25
NinjEH: posts big blind $0.50
*** HOLE CARDS ***
Dealt to matiko09 [6c 2c]
Xx7-Zeus-7xX: folds 
matiko09: folds 
chata.iz: folds 
Mampa12: folds 
pandalapa: folds 
el.suertero: raises $1 to $1.50
MINER68 leaves the table
Kukuryzka joins the table at seat #9 
NinjEH: folds 
Uncalled bet ($1) returned to el.suertero
el.suertero collected $1 from pot
*** SUMMARY ***
Total pot $1 | Rake $0 
Seat 1: el.suertero (small blind) collected ($1)
Seat 2: NinjEH (big blind) folded before Flop
Seat 3: Xx7-Zeus-7xX folded before Flop (didn't bet)
Seat 4: matiko09 folded before Flop (didn't bet)
Seat 5: chata.iz folded before Flop (didn't bet)
Seat 6: Mampa12 folded before Flop (didn't bet)
Seat 8: pandalapa (button) folded before Flop (didn't bet)





PokerStars Hand #155302477949:  Hold'em No Limit ($0.25/$0.50 USD) - 2016/06/28 16:54:40 CET [2016/06/28 10:54:40 ET]
Table 'Bruchsalia II' 9-max Seat #4 is the button
Seat 1: ardo888 ($50 in chips) 
Seat 3: el.suertero ($50 in chips) 
Seat 4: St.LaCoste ($39.86 in chips) 
Seat 5: Edkar686 ($46.58 in chips) 
Seat 6: matiko09 ($50 in chips) 
Seat 7: Lipton20088 ($20.63 in chips) 
Seat 8: Kukuryzka ($51.51 in chips) 
Seat 9: app1e_j@ck ($55.86 in chips) 
Edkar686: posts small blind $0.25
matiko09: posts big blind $0.50
denitz21: sits out 
*** HOLE CARDS ***
Dealt to matiko09 [3c 8d]
Lipton20088: folds 
Kukuryzka: folds 
app1e_j@ck: folds 
ardo888: folds 
el.suertero: raises $1 to $1.50
St.LaCoste: folds 
Edkar686: raises $1.50 to $3
matiko09: folds 
el.suertero: calls $1.50
*** FLOP *** [Th 9s Jh]
Edkar686: bets $4
el.suertero: calls $4
*** TURN *** [Th 9s Jh] [Td]
Edkar686: bets $6.89
el.suertero: calls $6.89
*** RIVER *** [Th 9s Jh Td] [4h]
Edkar686: bets $13.43
el.suertero: calls $13.43
*** SHOW DOWN ***
Edkar686: shows [Qs Ah] (a pair of Tens)
el.suertero: shows [Tc As] (three of a kind, Tens)
el.suertero collected $53.14 from pot
*** SUMMARY ***
Total pot $55.14 | Rake $2 
Board [Th 9s Jh Td 4h]
Seat 1: ardo888 folded before Flop (didn't bet)
Seat 3: el.suertero showed [Tc As] and won ($53.14) with three of a kind, Tens
Seat 4: St.LaCoste (button) folded before Flop (didn't bet)
Seat 5: Edkar686 (small blind) showed [Qs Ah] and lost with a pair of Tens
Seat 6: matiko09 (big blind) folded before Flop
Seat 7: Lipton20088 folded before Flop (didn't bet)
Seat 8: Kukuryzka folded before Flop (didn't bet)
Seat 9: app1e_j@ck folded before Flop (didn't bet)





PokerStars Hand #155302481484:  Hold'em No Limit ($0.50/$1.00 USD) - 2016/06/28 16:54:47 CET [2016/06/28 10:54:47 ET]
Table 'Lyyli II' 9-max Seat #5 is the button
Seat 2: CI58 ($130.52 in chips) 
Seat 3: Racushniak ($100 in chips) 
Seat 4: Greha999 ($213.73 in chips) 
Seat 5: flk.Dasas ($100 in chips) 
Seat 6: matiko09 ($100.50 in chips) 
Seat 7: mycka86 ($108.49 in chips) 
Seat 8: r4mz3s ($128.02 in chips) 
Seat 9: f1reworks ($107.70 in chips) 
matiko09: posts small blind $0.50
mycka86: posts big blind $1
*** HOLE CARDS ***
Dealt to matiko09 [Ad 5c]
r4mz3s: folds 
f1reworks: folds 
CI58: folds 
Racushniak: folds 
Greha999: folds 
flk.Dasas: folds 
matiko09: raises $2 to $3
mycka86: calls $2
*** FLOP *** [Qd 9h Ac]
matiko09: checks 
mycka86: checks 
*** TURN *** [Qd 9h Ac] [Ks]
matiko09: checks 
mycka86: checks 
*** RIVER *** [Qd 9h Ac Ks] [5h]
matiko09: bets $2.96
mycka86: folds 
Uncalled bet ($2.96) returned to matiko09
matiko09 collected $5.70 from pot
matiko09: doesn't show hand 
*** SUMMARY ***
Total pot $6 | Rake $0.30 
Board [Qd 9h Ac Ks 5h]
Seat 2: CI58 folded before Flop (didn't bet)
Seat 3: Racushniak folded before Flop (didn't bet)
Seat 4: Greha999 folded before Flop (didn't bet)
Seat 5: flk.Dasas (button) folded before Flop (didn't bet)
Seat 6: matiko09 (small blind) collected ($5.70)
Seat 7: mycka86 (big blind) folded on the River
Seat 8: r4mz3s folded before Flop (didn't bet)
Seat 9: f1reworks folded before Flop (didn't bet)





PokerStars Hand #155302497228:  Hold'em No Limit ($0.50/$1.00 USD) - 2016/06/28 16:55:16 CET [2016/06/28 10:55:16 ET]
Table 'Dorado II' 9-max Seat #8 is the button
Seat 1: f1reworks ($158.38 in chips) 
Seat 2: vanilica ($104.54 in chips) 
Seat 3: ghostriderxu ($105.95 in chips) 
Seat 4: pyromid ($118.12 in chips) 
Seat 5: KovIFish89 ($100 in chips) 
Seat 6: mycka86 ($120 in chips) 
Seat 7: matiko09 ($100 in chips) 
Seat 8: flk.Dasas ($166.07 in chips) 
Seat 9: r4mz3s ($130.64 in chips) 
r4mz3s: posts small blind $0.50
f1reworks: posts big blind $1
*** HOLE CARDS ***
Dealt to matiko09 [Ah Tc]
vanilica: folds 
ghostriderxu: folds 
pyromid: folds 
KovIFish89: folds 
mycka86: folds 
matiko09: raises $1.50 to $2.50
flk.Dasas: folds 
r4mz3s: raises $6.50 to $9
f1reworks: folds 
matiko09: folds 
Uncalled bet ($6.50) returned to r4mz3s
r4mz3s collected $6 from pot
r4mz3s: doesn't show hand 
*** SUMMARY ***
Total pot $6 | Rake $0 
Seat 1: f1reworks (big blind) folded before Flop
Seat 2: vanilica folded before Flop (didn't bet)
Seat 3: ghostriderxu folded before Flop (didn't bet)
Seat 4: pyromid folded before Flop (didn't bet)
Seat 5: KovIFish89 folded before Flop (didn't bet)
Seat 6: mycka86 folded before Flop (didn't bet)
Seat 7: matiko09 folded before Flop
Seat 8: flk.Dasas (button) folded before Flop (didn't bet)
Seat 9: r4mz3s (small blind) collected ($6)





PokerStars Hand #155302504101:  Hold'em No Limit ($0.25/$0.50 USD) - 2016/06/28 16:55:31 CET [2016/06/28 10:55:31 ET]
Table 'Lacadiera' 9-max Seat #1 is the button
Seat 1: matiko09 ($50 in chips) 
Seat 2: Alexey_Kim2 ($50 in chips) 
Seat 3: el.suertero ($81.66 in chips) 
Seat 4: denitz21 ($160 in chips) 
Seat 5: william87872 ($53.75 in chips) 
Seat 6: Kukuryzka ($94.77 in chips) 
Seat 7: chenconhaste ($61.71 in chips) 
Seat 8: Vedpapa ($66.90 in chips) 
Seat 9: Fakespecial ($284.88 in chips) 
Alexey_Kim2: posts small blind $0.25
el.suertero: posts big blind $0.50
*** HOLE CARDS ***
Dealt to matiko09 [9d Kh]
denitz21: folds 
william87872: folds 
Kukuryzka: folds 
chenconhaste: folds 
Vedpapa: raises $1 to $1.50
Fakespecial: calls $1.50
matiko09: folds 
Alexey_Kim2: folds 
el.suertero: folds 
*** FLOP *** [Jc Jd 8c]
Vedpapa: checks 
Fakespecial: checks 
*** TURN *** [Jc Jd 8c] [Th]
Vedpapa: bets $2.67
Fakespecial: folds 
Uncalled bet ($2.67) returned to Vedpapa
Vedpapa collected $3.56 from pot
Vedpapa: doesn't show hand 
*** SUMMARY ***
Total pot $3.75 | Rake $0.19 
Board [Jc Jd 8c Th]
Seat 1: matiko09 (button) folded before Flop (didn't bet)
Seat 2: Alexey_Kim2 (small blind) folded before Flop
Seat 3: el.suertero (big blind) folded before Flop
Seat 4: denitz21 folded before Flop (didn't bet)
Seat 5: william87872 folded before Flop (didn't bet)
Seat 6: Kukuryzka folded before Flop (didn't bet)
Seat 7: chenconhaste folded before Flop (didn't bet)
Seat 8: Vedpapa collected ($3.56)
Seat 9: Fakespecial folded on the Turn





PokerStars Hand #155302507863:  Hold'em No Limit ($0.50/$1.00 USD) - 2016/06/28 16:55:39 CET [2016/06/28 10:55:39 ET]
Table 'Tomita' 9-max Seat #2 is the button
Seat 1: CI58 ($100 in chips) 
Seat 2: vanilica ($100 in chips) 
Seat 3: r4mz3s ($100 in chips) 
Seat 4: f1reworks ($114.58 in chips) 
Seat 5: ANDY19911608 ($202.75 in chips) 
Seat 7: matiko09 ($157.30 in chips) 
Seat 8: Noob0Saibot ($100 in chips) 
Seat 9: sanpidk ($159.80 in chips) 
r4mz3s: posts small blind $0.50
f1reworks: posts big blind $1
*** HOLE CARDS ***
Dealt to matiko09 [Js 2d]
ANDY19911608: folds 
matiko09: folds 
Noob0Saibot: folds 
sanpidk: folds 
CI58: raises $1.50 to $2.50
vanilica: folds 
r4mz3s: folds 
f1reworks: folds 
Uncalled bet ($1.50) returned to CI58
CI58 collected $2.50 from pot
CI58: doesn't show hand 
*** SUMMARY ***
Total pot $2.50 | Rake $0 
Seat 1: CI58 collected ($2.50)
Seat 2: vanilica (button) folded before Flop (didn't bet)
Seat 3: r4mz3s (small blind) folded before Flop
Seat 4: f1reworks (big blind) folded before Flop
Seat 5: ANDY19911608 folded before Flop (didn't bet)
Seat 7: matiko09 folded before Flop (didn't bet)
Seat 8: Noob0Saibot folded before Flop (didn't bet)
Seat 9: sanpidk folded before Flop (didn't bet)





PokerStars Hand #155302508727:  Hold'em No Limit ($0.50/$1.00 USD) - 2016/06/28 16:55:41 CET [2016/06/28 10:55:41 ET]
Table 'Anitra' 9-max Seat #8 is the button
Seat 1: stds st ($40 in chips) 
Seat 2: ardo888 ($100 in chips) 
Seat 3: facelessPPP ($239.12 in chips) 
Seat 4: Shakeelg ($55.57 in chips) 
Seat 5: er13to ($123.75 in chips) 
Seat 6: matiko09 ($100 in chips) 
Seat 7: phil_cheng ($100 in chips) 
Seat 8: yoshinoino ($31.86 in chips) 
Seat 9: chenconhaste ($101.28 in chips) 
chenconhaste: posts small blind $0.50
stds st: posts big blind $1
*** HOLE CARDS ***
Dealt to matiko09 [Kc 6s]
ardo888: folds 
facelessPPP: folds 
Shakeelg: raises $2 to $3
er13to: folds 
matiko09: folds 
phil_cheng: folds 
yoshinoino: folds 
chenconhaste: folds 
stds st: folds 
Uncalled bet ($2) returned to Shakeelg
Shakeelg collected $2.50 from pot
Shakeelg: doesn't show hand 
*** SUMMARY ***
Total pot $2.50 | Rake $0 
Seat 1: stds st (big blind) folded before Flop
Seat 2: ardo888 folded before Flop (didn't bet)
Seat 3: facelessPPP folded before Flop (didn't bet)
Seat 4: Shakeelg collected ($2.50)
Seat 5: er13to folded before Flop (didn't bet)
Seat 6: matiko09 folded before Flop (didn't bet)
Seat 7: phil_cheng folded before Flop (didn't bet)
Seat 8: yoshinoino (button) folded before Flop (didn't bet)
Seat 9: chenconhaste (small blind) folded before Flop





PokerStars Hand #155302509993:  Hold'em No Limit ($0.25/$0.50 USD) - 2016/06/28 16:55:43 CET [2016/06/28 10:55:43 ET]
Table 'Antonia II' 9-max Seat #8 is the button
Seat 1: er13to ($54.34 in chips) 
Seat 2: myatiy 96 ($50 in chips) 
Seat 4: el.suertero ($71.43 in chips) 
Seat 6: matiko09 ($80.46 in chips) 
Seat 7: Kukuryzka ($52.28 in chips) 
Seat 8: SumPosad ($19.25 in chips) 
Seat 9: Domotirko228 ($50 in chips) 
Domotirko228: posts small blind $0.25
er13to: posts big blind $0.50
*** HOLE CARDS ***
Dealt to matiko09 [Kh 4h]
myatiy 96: folds 
el.suertero: folds 
matiko09: folds 
Kukuryzka: raises $0.75 to $1.25
SumPosad: folds 
Domotirko228: folds 
er13to: folds 
Uncalled bet ($0.75) returned to Kukuryzka
Kukuryzka collected $1.25 from pot
Kukuryzka: doesn't show hand 
*** SUMMARY ***
Total pot $1.25 | Rake $0 
Seat 1: er13to (big blind) folded before Flop
Seat 2: myatiy 96 folded before Flop (didn't bet)
Seat 4: el.suertero folded before Flop (didn't bet)
Seat 6: matiko09 folded before Flop (didn't bet)
Seat 7: Kukuryzka collected ($1.25)
Seat 8: SumPosad (button) folded before Flop (didn't bet)
Seat 9: Domotirko228 (small blind) folded before Flop





PokerStars Hand #155302516665:  Hold'em No Limit ($0.50/$1.00 USD) - 2016/06/28 16:55:58 CET [2016/06/28 10:55:58 ET]
Table 'Lyyli II' 9-max Seat #6 is the button
Seat 2: CI58 ($130.52 in chips) 
Seat 3: Racushniak ($100 in chips) 
Seat 4: Greha999 ($213.73 in chips) 
Seat 5: flk.Dasas ($100 in chips) 
Seat 6: matiko09 ($103.20 in chips) 
Seat 7: mycka86 ($105.49 in chips) 
Seat 8: r4mz3s ($128.02 in chips) 
Seat 9: f1reworks ($107.70 in chips) 
mycka86: posts small blind $0.50
r4mz3s: posts big blind $1
*** HOLE CARDS ***
Dealt to matiko09 [As Kc]
f1reworks: folds 
CI58: folds 
Racushniak: raises $1.80 to $2.80
Greha999: folds 
flk.Dasas: folds 
matiko09: raises $7.20 to $10
mycka86: folds 
r4mz3s: folds 
Racushniak: calls $7.20
*** FLOP *** [8c Tc 6d]
Racushniak: checks 
matiko09: checks 
*** TURN *** [8c Tc 6d] [7s]
Racushniak: bets $13
matiko09: folds 
Uncalled bet ($13) returned to Racushniak
Racushniak collected $20.42 from pot
Racushniak: doesn't show hand 
*** SUMMARY ***
Total pot $21.50 | Rake $1.08 
Board [8c Tc 6d 7s]
Seat 2: CI58 folded before Flop (didn't bet)
Seat 3: Racushniak collected ($20.42)
Seat 4: Greha999 folded before Flop (didn't bet)
Seat 5: flk.Dasas folded before Flop (didn't bet)
Seat 6: matiko09 (button) folded on the Turn
Seat 7: mycka86 (small blind) folded before Flop
Seat 8: r4mz3s (big blind) folded before Flop
Seat 9: f1reworks folded before Flop (didn't bet)





PokerStars Hand #155302518043:  Hold'em No Limit ($0.50/$1.00 USD) - 2016/06/28 16:56:00 CET [2016/06/28 10:56:00 ET]
Table 'Tomita' 9-max Seat #3 is the button
Seat 1: CI58 ($101.50 in chips) 
Seat 2: vanilica ($100 in chips) 
Seat 3: r4mz3s ($100 in chips) 
Seat 4: f1reworks ($113.58 in chips) 
Seat 5: ANDY19911608 ($202.75 in chips) 
Seat 7: matiko09 ($157.30 in chips) 
Seat 8: Noob0Saibot ($100 in chips) 
Seat 9: sanpidk ($159.80 in chips) 
f1reworks: posts small blind $0.50
ANDY19911608: posts big blind $1
*** HOLE CARDS ***
Dealt to matiko09 [3c 4c]
matiko09: folds 
Noob0Saibot: folds 
sanpidk: folds 
CI58: folds 
vanilica: raises $1.50 to $2.50
r4mz3s: folds 
f1reworks: folds 
ANDY19911608: calls $1.50
*** FLOP *** [3d Qs Jd]
ANDY19911608: bets $1
vanilica: raises $5 to $6
ANDY19911608: folds 
Uncalled bet ($5) returned to vanilica
vanilica collected $7.12 from pot
vanilica: doesn't show hand 
*** SUMMARY ***
Total pot $7.50 | Rake $0.38 
Board [3d Qs Jd]
Seat 1: CI58 folded before Flop (didn't bet)
Seat 2: vanilica collected ($7.12)
Seat 3: r4mz3s (button) folded before Flop (didn't bet)
Seat 4: f1reworks (small blind) folded before Flop
Seat 5: ANDY19911608 (big blind) folded on the Flop
Seat 7: matiko09 folded before Flop (didn't bet)
Seat 8: Noob0Saibot folded before Flop (didn't bet)
Seat 9: sanpidk folded before Flop (didn't bet)





PokerStars Hand #155302518193:  Hold'em No Limit ($0.50/$1.00 USD) - 2016/06/28 16:56:01 CET [2016/06/28 10:56:01 ET]
Table 'Dorado II' 9-max Seat #9 is the button
Seat 1: f1reworks ($157.38 in chips) 
Seat 2: vanilica ($104.54 in chips) 
Seat 3: ghostriderxu ($105.95 in chips) 
Seat 4: pyromid ($118.12 in chips) 
Seat 5: KovIFish89 ($100 in chips) 
Seat 6: mycka86 ($120 in chips) 
Seat 7: matiko09 ($100 in chips) 
Seat 8: flk.Dasas ($166.07 in chips) 
Seat 9: r4mz3s ($134.14 in chips) 
f1reworks: posts small blind $0.50
vanilica: posts big blind $1
*** HOLE CARDS ***
Dealt to matiko09 [7d Kc]
ghostriderxu: folds 
pyromid: folds 
KovIFish89: folds 
mycka86: folds 
matiko09: folds 
flk.Dasas: folds 
r4mz3s: raises $1.14 to $2.14
f1reworks: calls $1.64
vanilica: folds 
*** FLOP *** [5d 9s 4s]
f1reworks: checks 
r4mz3s: bets $3.50
f1reworks: folds 
Uncalled bet ($3.50) returned to r4mz3s
r4mz3s collected $5.02 from pot
r4mz3s: doesn't show hand 
*** SUMMARY ***
Total pot $5.28 | Rake $0.26 
Board [5d 9s 4s]
Seat 1: f1reworks (small blind) folded on the Flop
Seat 2: vanilica (big blind) folded before Flop
Seat 3: ghostriderxu folded before Flop (didn't bet)
Seat 4: pyromid folded before Flop (didn't bet)
Seat 5: KovIFish89 folded before Flop (didn't bet)
Seat 6: mycka86 folded before Flop (didn't bet)
Seat 7: matiko09 folded before Flop (didn't bet)
Seat 8: flk.Dasas folded before Flop (didn't bet)
Seat 9: r4mz3s (button) collected ($5.02)





PokerStars Hand #155302523450:  Hold'em No Limit ($0.25/$0.50 USD) - 2016/06/28 16:56:12 CET [2016/06/28 10:56:12 ET]
Table 'Antonia II' 9-max Seat #9 is the button
Seat 1: er13to ($53.84 in chips) 
Seat 4: el.suertero ($71.43 in chips) 
Seat 6: matiko09 ($80.46 in chips) 
Seat 7: Kukuryzka ($53.03 in chips) 
Seat 8: SumPosad ($19.25 in chips) 
Seat 9: Domotirko228 ($50 in chips) 
er13to: posts small blind $0.25
myatiy 96: is sitting out 
el.suertero: posts big blind $0.50
*** HOLE CARDS ***
Dealt to matiko09 [2h Ah]
myatiy 96 leaves the table
matiko09: folds 
Kukuryzka: folds 
SumPosad: folds 
Domotirko228: raises $0.75 to $1.25
UnBent022 joins the table at seat #2 
er13to: folds 
el.suertero: folds 
Uncalled bet ($0.75) returned to Domotirko228
Domotirko228 collected $1.25 from pot
Domotirko228: doesn't show hand 
*** SUMMARY ***
Total pot $1.25 | Rake $0 
Seat 1: er13to (small blind) folded before Flop
Seat 4: el.suertero (big blind) folded before Flop
Seat 6: matiko09 folded before Flop (didn't bet)
Seat 7: Kukuryzka folded before Flop (didn't bet)
Seat 8: SumPosad folded before Flop (didn't bet)
Seat 9: Domotirko228 (button) collected ($1.25)





PokerStars Hand #155302526508:  Hold'em No Limit ($0.50/$1.00 USD) - 2016/06/28 16:56:18 CET [2016/06/28 10:56:18 ET]
Table 'Anitra' 9-max Seat #9 is the button
Seat 1: stds st ($39 in chips) 
Seat 2: ardo888 ($100 in chips) 
Seat 3: facelessPPP ($239.12 in chips) 
Seat 4: Shakeelg ($57.07 in chips) 
Seat 5: er13to ($123.75 in chips) 
Seat 6: matiko09 ($100 in chips) 
Seat 7: phil_cheng ($100 in chips) 
Seat 8: yoshinoino ($31.86 in chips) 
Seat 9: chenconhaste ($100.78 in chips) 
stds st: posts small blind $0.50
ardo888: posts big blind $1
*** HOLE CARDS ***
Dealt to matiko09 [Ac Qs]
facelessPPP: folds 
Shakeelg: folds 
er13to: folds 
matiko09: raises $2 to $3
phil_cheng: folds 
yoshinoino: folds 
chenconhaste: folds 
stds st: raises $4.50 to $7.50
ardo888: folds 
matiko09: folds 
Uncalled bet ($4.50) returned to stds st
stds st collected $7 from pot
stds st: doesn't show hand 
*** SUMMARY ***
Total pot $7 | Rake $0 
Seat 1: stds st (small blind) collected ($7)
Seat 2: ardo888 (big blind) folded before Flop
Seat 3: facelessPPP folded before Flop (didn't bet)
Seat 4: Shakeelg folded before Flop (didn't bet)
Seat 5: er13to folded before Flop (didn't bet)
Seat 6: matiko09 folded before Flop
Seat 7: phil_cheng folded before Flop (didn't bet)
Seat 8: yoshinoino folded before Flop (didn't bet)
Seat 9: chenconhaste (button) folded before Flop (didn't bet)





PokerStars Hand #155302527341:  Hold'em No Limit ($0.25/$0.50 USD) - 2016/06/28 16:56:20 CET [2016/06/28 10:56:20 ET]
Table 'Lacadiera' 9-max Seat #2 is the button
Seat 1: matiko09 ($50 in chips) 
Seat 2: Alexey_Kim2 ($50 in chips) 
Seat 3: el.suertero ($81.16 in chips) 
Seat 4: denitz21 ($160 in chips) 
Seat 5: william87872 ($53.75 in chips) 
Seat 6: Kukuryzka ($94.77 in chips) 
Seat 7: chenconhaste ($61.71 in chips) 
Seat 8: Vedpapa ($68.96 in chips) 
Seat 9: Fakespecial ($283.38 in chips) 
el.suertero: posts small blind $0.25
denitz21: posts big blind $0.50
*** HOLE CARDS ***
Dealt to matiko09 [9d Td]
william87872: folds 
Kukuryzka: folds 
chenconhaste: raises $0.62 to $1.12
Vedpapa: folds 
Fakespecial: calls $1.12
matiko09: calls $1.12
Alexey_Kim2: calls $1.12
el.suertero: folds 
denitz21: calls $0.62
*** FLOP *** [2d Jh Ad]
denitz21: checks 
chenconhaste: checks 
Fakespecial: checks 
matiko09: checks 
Alexey_Kim2: checks 
*** TURN *** [2d Jh Ad] [7c]
denitz21: bets $3
chenconhaste: raises $6 to $9
Fakespecial: folds 
matiko09: folds 
Alexey_Kim2: folds 
denitz21: folds 
Uncalled bet ($6) returned to chenconhaste
chenconhaste collected $11.26 from pot
*** SUMMARY ***
Total pot $11.85 | Rake $0.59 
Board [2d Jh Ad 7c]
Seat 1: matiko09 folded on the Turn
Seat 2: Alexey_Kim2 (button) folded on the Turn
Seat 3: el.suertero (small blind) folded before Flop
Seat 4: denitz21 (big blind) folded on the Turn
Seat 5: william87872 folded before Flop (didn't bet)
Seat 6: Kukuryzka folded before Flop (didn't bet)
Seat 7: chenconhaste collected ($11.26)
Seat 8: Vedpapa folded before Flop (didn't bet)
Seat 9: Fakespecial folded on the Turn





PokerStars Hand #155302532065:  Hold'em No Limit ($0.50/$1.00 USD) - 2016/06/28 16:56:30 CET [2016/06/28 10:56:30 ET]
Table 'Tomita' 9-max Seat #4 is the button
Seat 1: CI58 ($101.50 in chips) 
Seat 2: vanilica ($103.62 in chips) 
Seat 3: r4mz3s ($100 in chips) 
Seat 4: f1reworks ($113.08 in chips) 
Seat 5: ANDY19911608 ($199.25 in chips) 
Seat 7: matiko09 ($157.30 in chips) 
Seat 8: Noob0Saibot ($100 in chips) 
Seat 9: sanpidk ($159.80 in chips) 
ANDY19911608: posts small blind $0.50
matiko09: posts big blind $1
*** HOLE CARDS ***
Dealt to matiko09 [8c 8d]
Noob0Saibot: folds 
sanpidk: folds 
CI58: raises $2 to $3
vanilica: folds 
r4mz3s: folds 
f1reworks: folds 
ANDY19911608: folds 
matiko09: calls $2
*** FLOP *** [3c Kh 9h]
matiko09: checks 
CI58: checks 
*** TURN *** [3c Kh 9h] [Qs]
matiko09: checks 
CI58: checks 
*** RIVER *** [3c Kh 9h Qs] [5s]
matiko09: checks 
CI58: checks 
*** SHOW DOWN ***
matiko09: shows [8c 8d] (a pair of Eights)
CI58: mucks hand 
matiko09 collected $6.18 from pot
*** SUMMARY ***
Total pot $6.50 | Rake $0.32 
Board [3c Kh 9h Qs 5s]
Seat 1: CI58 mucked [6c 7c]
Seat 2: vanilica folded before Flop (didn't bet)
Seat 3: r4mz3s folded before Flop (didn't bet)
Seat 4: f1reworks (button) folded before Flop (didn't bet)
Seat 5: ANDY19911608 (small blind) folded before Flop
Seat 7: matiko09 (big blind) showed [8c 8d] and won ($6.18) with a pair of Eights
Seat 8: Noob0Saibot folded before Flop (didn't bet)
Seat 9: sanpidk folded before Flop (didn't bet)





PokerStars Hand #155302534929:  Hold'em No Limit ($0.25/$0.50 USD) - 2016/06/28 16:56:36 CET [2016/06/28 10:56:36 ET]
Table 'Bruchsalia II' 9-max Seat #5 is the button
Seat 1: ardo888 ($50 in chips) 
Seat 3: el.suertero ($75.82 in chips) 
Seat 4: St.LaCoste ($39.86 in chips) 
Seat 5: Edkar686 ($19.26 in chips) 
Seat 6: matiko09 ($50 in chips) 
Seat 7: Lipton20088 ($20.63 in chips) 
Seat 8: Kukuryzka ($51.51 in chips) 
Seat 9: app1e_j@ck ($55.86 in chips) 
matiko09: posts small blind $0.25
Lipton20088: posts big blind $0.50
denitz21: sits out 
*** HOLE CARDS ***
Dealt to matiko09 [Jc 6s]
Kukuryzka: folds 
app1e_j@ck: folds 
ardo888: folds 
el.suertero: folds 
St.LaCoste: folds 
Edkar686: raises $1 to $1.50
matiko09: folds 
Lipton20088: folds 
Uncalled bet ($1) returned to Edkar686
Edkar686 collected $1.25 from pot
*** SUMMARY ***
Total pot $1.25 | Rake $0 
Seat 1: ardo888 folded before Flop (didn't bet)
Seat 3: el.suertero folded before Flop (didn't bet)
Seat 4: St.LaCoste folded before Flop (didn't bet)
Seat 5: Edkar686 (button) collected ($1.25)
Seat 6: matiko09 (small blind) folded before Flop
Seat 7: Lipton20088 (big blind) folded before Flop
Seat 8: Kukuryzka folded before Flop (didn't bet)
Seat 9: app1e_j@ck folded before Flop (didn't bet)





PokerStars Hand #155302537800:  Hold'em No Limit ($0.50/$1.00 USD) - 2016/06/28 16:56:42 CET [2016/06/28 10:56:42 ET]
Table 'Lyyli II' 9-max Seat #7 is the button
Seat 2: CI58 ($130.52 in chips) 
Seat 3: Racushniak ($110.42 in chips) 
Seat 4: Greha999 ($213.73 in chips) 
Seat 5: flk.Dasas ($100 in chips) 
Seat 6: matiko09 ($100 in chips) 
Seat 7: mycka86 ($104.99 in chips) 
Seat 8: r4mz3s ($127.02 in chips) 
Seat 9: f1reworks ($107.70 in chips) 
r4mz3s: posts small blind $0.50
f1reworks: posts big blind $1
*** HOLE CARDS ***
Dealt to matiko09 [5s Ad]
CI58: folds 
Racushniak: folds 
Greha999: folds 
flk.Dasas: folds 
matiko09: folds 
mycka86: folds 
r4mz3s: folds 
Uncalled bet ($0.50) returned to f1reworks
f1reworks collected $1 from pot
f1reworks: doesn't show hand 
*** SUMMARY ***
Total pot $1 | Rake $0 
Seat 2: CI58 folded before Flop (didn't bet)
Seat 3: Racushniak folded before Flop (didn't bet)
Seat 4: Greha999 folded before Flop (didn't bet)
Seat 5: flk.Dasas folded before Flop (didn't bet)
Seat 6: matiko09 folded before Flop (didn't bet)
Seat 7: mycka86 (button) folded before Flop (didn't bet)
Seat 8: r4mz3s (small blind) folded before Flop
Seat 9: f1reworks (big blind) collected ($1)





PokerStars Hand #155302544044:  Hold'em No Limit ($0.25/$0.50 USD) - 2016/06/28 16:56:55 CET [2016/06/28 10:56:55 ET]
Table 'Antonia II' 9-max Seat #1 is the button
Seat 1: er13to ($53.59 in chips) 
Seat 4: el.suertero ($70.93 in chips) 
Seat 6: matiko09 ($80.46 in chips) 
Seat 7: Kukuryzka ($53.03 in chips) 
Seat 8: SumPosad ($19.25 in chips) 
Seat 9: Domotirko228 ($50.75 in chips) 
el.suertero: posts small blind $0.25
matiko09: posts big blind $0.50
*** HOLE CARDS ***
Dealt to matiko09 [Qc Ts]
Kukuryzka: folds 
SumPosad: folds 
Domotirko228: raises $0.75 to $1.25
er13to: folds 
el.suertero: calls $1
matiko09: calls $0.75
*** FLOP *** [5h Tc Ks]
el.suertero: checks 
matiko09: checks 
Domotirko228: checks 
*** TURN *** [5h Tc Ks] [5d]
el.suertero: checks 
matiko09: checks 
Domotirko228: bets $3
el.suertero: calls $3
matiko09: calls $3
*** RIVER *** [5h Tc Ks 5d] [6s]
el.suertero: checks 
matiko09: checks 
Domotirko228: bets $9.08
el.suertero: folds 
matiko09: folds 
Uncalled bet ($9.08) returned to Domotirko228
Domotirko228 collected $12.11 from pot
Domotirko228: doesn't show hand 
*** SUMMARY ***
Total pot $12.75 | Rake $0.64 
Board [5h Tc Ks 5d 6s]
Seat 1: er13to (button) folded before Flop (didn't bet)
Seat 4: el.suertero (small blind) folded on the River
Seat 6: matiko09 (big blind) folded on the River
Seat 7: Kukuryzka folded before Flop (didn't bet)
Seat 8: SumPosad folded before Flop (didn't bet)
Seat 9: Domotirko228 collected ($12.11)





PokerStars Hand #155302548129:  Hold'em No Limit ($0.50/$1.00 USD) - 2016/06/28 16:57:03 CET [2016/06/28 10:57:03 ET]
Table 'Dorado II' 9-max Seat #1 is the button
Seat 1: f1reworks ($155.24 in chips) 
Seat 2: vanilica ($103.54 in chips) 
Seat 3: ghostriderxu ($105.95 in chips) 
Seat 4: pyromid ($118.12 in chips) 
Seat 5: KovIFish89 ($100 in chips) 
Seat 6: mycka86 ($120 in chips) 
Seat 7: matiko09 ($100 in chips) 
Seat 8: flk.Dasas ($166.07 in chips) 
Seat 9: r4mz3s ($137.02 in chips) 
vanilica: posts small blind $0.50
ghostriderxu: posts big blind $1
*** HOLE CARDS ***
Dealt to matiko09 [3h 9d]
pyromid: raises $1 to $2
KovIFish89: folds 
mycka86: folds 
matiko09: folds 
flk.Dasas: folds 
r4mz3s: calls $2
f1reworks: folds 
vanilica: folds 
ghostriderxu: folds 
*** FLOP *** [Kh 4s Ac]
pyromid: checks 
r4mz3s: checks 
*** TURN *** [Kh 4s Ac] [7d]
pyromid: checks 
r4mz3s: checks 
*** RIVER *** [Kh 4s Ac 7d] [7s]
pyromid: bets $1.50
r4mz3s: calls $1.50
*** SHOW DOWN ***
pyromid: shows [3c 3s] (two pair, Sevens and Threes)
r4mz3s: shows [Tc Kc] (two pair, Kings and Sevens)
r4mz3s collected $8.08 from pot
*** SUMMARY ***
Total pot $8.50 | Rake $0.42 
Board [Kh 4s Ac 7d 7s]
Seat 1: f1reworks (button) folded before Flop (didn't bet)
Seat 2: vanilica (small blind) folded before Flop
Seat 3: ghostriderxu (big blind) folded before Flop
Seat 4: pyromid showed [3c 3s] and lost with two pair, Sevens and Threes
Seat 5: KovIFish89 folded before Flop (didn't bet)
Seat 6: mycka86 folded before Flop (didn't bet)
Seat 7: matiko09 folded before Flop (didn't bet)
Seat 8: flk.Dasas folded before Flop (didn't bet)
Seat 9: r4mz3s showed [Tc Kc] and won ($8.08) with two pair, Kings and Sevens





PokerStars Hand #155302552500:  Hold'em No Limit ($0.50/$1.00 USD) - 2016/06/28 16:57:12 CET [2016/06/28 10:57:12 ET]
Table 'Lyyli II' 9-max Seat #8 is the button
Seat 2: CI58 ($130.52 in chips) 
Seat 3: Racushniak ($110.42 in chips) 
Seat 4: Greha999 ($213.73 in chips) 
Seat 5: flk.Dasas ($100 in chips) 
Seat 6: matiko09 ($100 in chips) 
Seat 7: mycka86 ($104.99 in chips) 
Seat 8: r4mz3s ($126.52 in chips) 
Seat 9: f1reworks ($108.20 in chips) 
f1reworks: posts small blind $0.50
CI58: posts big blind $1
*** HOLE CARDS ***
Dealt to matiko09 [9s Ac]
Racushniak: folds 
Greha999: folds 
flk.Dasas: raises $2 to $3
matiko09: folds 
mycka86: folds 
r4mz3s: calls $3
f1reworks: folds 
CI58: raises $12 to $15
flk.Dasas: raises $14 to $29
r4mz3s: folds 
CI58: raises $101.52 to $130.52 and is all-in
flk.Dasas: calls $71 and is all-in
Uncalled bet ($30.52) returned to CI58
*** FLOP *** [Qd 8s 8h]
*** TURN *** [Qd 8s 8h] [6c]
*** RIVER *** [Qd 8s 8h 6c] [4c]
*** SHOW DOWN ***
CI58: shows [Ad As] (two pair, Aces and Eights)
flk.Dasas: shows [Kd Kc] (two pair, Kings and Eights)
CI58 collected $201 from pot
*** SUMMARY ***
Total pot $203.50 | Rake $2.50 
Board [Qd 8s 8h 6c 4c]
Seat 2: CI58 (big blind) showed [Ad As] and won ($201) with two pair, Aces and Eights
Seat 3: Racushniak folded before Flop (didn't bet)
Seat 4: Greha999 folded before Flop (didn't bet)
Seat 5: flk.Dasas showed [Kd Kc] and lost with two pair, Kings and Eights
Seat 6: matiko09 folded before Flop (didn't bet)
Seat 7: mycka86 folded before Flop (didn't bet)
Seat 8: r4mz3s (button) folded before Flop
Seat 9: f1reworks (small blind) folded before Flop





PokerStars Hand #155302553496:  Hold'em No Limit ($0.25/$0.50 USD) - 2016/06/28 16:57:14 CET [2016/06/28 10:57:14 ET]
Table 'Bruchsalia II' 9-max Seat #6 is the button
Seat 1: ardo888 ($50 in chips) 
Seat 3: el.suertero ($75.82 in chips) 
Seat 4: St.LaCoste ($39.86 in chips) 
Seat 5: Edkar686 ($20.01 in chips) 
Seat 6: matiko09 ($50 in chips) 
Seat 7: Lipton20088 ($20.13 in chips) 
Seat 8: Kukuryzka ($51.51 in chips) 
Seat 9: app1e_j@ck ($55.86 in chips) 
Lipton20088: posts small blind $0.25
Kukuryzka: posts big blind $0.50
denitz21: sits out 
*** HOLE CARDS ***
Dealt to matiko09 [5s 7d]
app1e_j@ck: folds 
ardo888: folds 
el.suertero: folds 
St.LaCoste: raises $1 to $1.50
Edkar686: calls $1.50
matiko09: folds 
Lipton20088: folds 
Kukuryzka: folds 
*** FLOP *** [2d 8s 4s]
St.LaCoste: bets $2.11
Edkar686: folds 
Uncalled bet ($2.11) returned to St.LaCoste
St.LaCoste collected $3.56 from pot
St.LaCoste: doesn't show hand 
*** SUMMARY ***
Total pot $3.75 | Rake $0.19 
Board [2d 8s 4s]
Seat 1: ardo888 folded before Flop (didn't bet)
Seat 3: el.suertero folded before Flop (didn't bet)
Seat 4: St.LaCoste collected ($3.56)
Seat 5: Edkar686 folded on the Flop
Seat 6: matiko09 (button) folded before Flop (didn't bet)
Seat 7: Lipton20088 (small blind) folded before Flop
Seat 8: Kukuryzka (big blind) folded before Flop
Seat 9: app1e_j@ck folded before Flop (didn't bet)





PokerStars Hand #155302557547:  Hold'em No Limit ($0.50/$1.00 USD) - 2016/06/28 16:57:23 CET [2016/06/28 10:57:23 ET]
Table 'Tomita' 9-max Seat #5 is the button
Seat 1: CI58 ($100 in chips) 
Seat 2: vanilica ($103.62 in chips) 
Seat 3: r4mz3s ($100 in chips) 
Seat 4: f1reworks ($113.08 in chips) 
Seat 5: ANDY19911608 ($198.75 in chips) 
Seat 7: matiko09 ($160.48 in chips) 
Seat 8: Noob0Saibot ($100 in chips) 
Seat 9: sanpidk ($159.80 in chips) 
matiko09: posts small blind $0.50
Noob0Saibot: posts big blind $1
*** HOLE CARDS ***
Dealt to matiko09 [Qd Qs]
sanpidk: folds 
CI58: raises $2 to $3
vanilica: folds 
r4mz3s: folds 
f1reworks: folds 
ANDY19911608: folds 
matiko09: calls $2.50
Noob0Saibot: folds 
*** FLOP *** [Jh 6s 7c]
matiko09: checks 
CI58: bets $3.99
matiko09: calls $3.99
*** TURN *** [Jh 6s 7c] [8h]
matiko09: bets $8
CI58: calls $8
*** RIVER *** [Jh 6s 7c 8h] [8s]
matiko09: checks 
CI58: bets $17.65
matiko09 has timed out
matiko09: folds 
Uncalled bet ($17.65) returned to CI58
CI58 collected $29.43 from pot
CI58: doesn't show hand 
*** SUMMARY ***
Total pot $30.98 | Rake $1.55 
Board [Jh 6s 7c 8h 8s]
Seat 1: CI58 collected ($29.43)
Seat 2: vanilica folded before Flop (didn't bet)
Seat 3: r4mz3s folded before Flop (didn't bet)
Seat 4: f1reworks folded before Flop (didn't bet)
Seat 5: ANDY19911608 (button) folded before Flop (didn't bet)
Seat 7: matiko09 (small blind) folded on the River
Seat 8: Noob0Saibot (big blind) folded before Flop
Seat 9: sanpidk folded before Flop (didn't bet)





PokerStars Hand #155302562474:  Hold'em No Limit ($0.50/$1.00 USD) - 2016/06/28 16:57:33 CET [2016/06/28 10:57:33 ET]
Table 'Anitra' 9-max Seat #1 is the button
Seat 1: stds st ($43 in chips) 
Seat 2: ardo888 ($100 in chips) 
Seat 3: facelessPPP ($239.12 in chips) 
Seat 4: Shakeelg ($57.07 in chips) 
Seat 5: er13to ($123.75 in chips) 
Seat 6: matiko09 ($100 in chips) 
Seat 7: phil_cheng ($100 in chips) 
Seat 8: yoshinoino ($31.86 in chips) 
Seat 9: chenconhaste ($100.78 in chips) 
ardo888: posts small blind $0.50
facelessPPP: posts big blind $1
*** HOLE CARDS ***
Dealt to matiko09 [Ah 2c]
Shakeelg: folds 
er13to: folds 
matiko09: folds 
phil_cheng: raises $2 to $3
yoshinoino: folds 
chenconhaste: raises $6 to $9
stds st: folds 
ardo888: folds 
facelessPPP: folds 
phil_cheng: folds 
Uncalled bet ($6) returned to chenconhaste
chenconhaste collected $7.50 from pot
*** SUMMARY ***
Total pot $7.50 | Rake $0 
Seat 1: stds st (button) folded before Flop (didn't bet)
Seat 2: ardo888 (small blind) folded before Flop
Seat 3: facelessPPP (big blind) folded before Flop
Seat 4: Shakeelg folded before Flop (didn't bet)
Seat 5: er13to folded before Flop (didn't bet)
Seat 6: matiko09 folded before Flop (didn't bet)
Seat 7: phil_cheng folded before Flop
Seat 8: yoshinoino folded before Flop (didn't bet)
Seat 9: chenconhaste collected ($7.50)





PokerStars Hand #155302565595:  Hold'em No Limit ($0.25/$0.50 USD) - 2016/06/28 16:57:39 CET [2016/06/28 10:57:39 ET]
Table 'Lacadiera' 9-max Seat #3 is the button
Seat 1: matiko09 ($50 in chips) 
Seat 2: Alexey_Kim2 ($50 in chips) 
Seat 3: el.suertero ($80.91 in chips) 
Seat 4: denitz21 ($155.88 in chips) 
Seat 6: Kukuryzka ($94.77 in chips) 
Seat 7: chenconhaste ($68.85 in chips) 
Seat 8: Vedpapa ($68.96 in chips) 
Seat 9: Fakespecial ($282.26 in chips) 
denitz21: posts small blind $0.25
william87872: is sitting out 
william87872 leaves the table
Kukuryzka: posts big blind $0.50
*** HOLE CARDS ***
Dealt to matiko09 [Ks 2d]
chenconhaste: folds 
Vedpapa: raises $1 to $1.50
Fakespecial: calls $1.50
matiko09: folds 
Alexey_Kim2: folds 
el.suertero: folds 
denitz21: folds 
Kukuryzka: folds 
*** FLOP *** [4d Ad 4s]
Vedpapa: checks 
Fakespecial: checks 
*** TURN *** [4d Ad 4s] [Jh]
AA i won joins the table at seat #5 
Vedpapa: bets $2
Fakespecial: folds 
Uncalled bet ($2) returned to Vedpapa
Vedpapa collected $3.56 from pot
Vedpapa: doesn't show hand 
*** SUMMARY ***
Total pot $3.75 | Rake $0.19 
Board [4d Ad 4s Jh]
Seat 1: matiko09 folded before Flop (didn't bet)
Seat 2: Alexey_Kim2 folded before Flop (didn't bet)
Seat 3: el.suertero (button) folded before Flop (didn't bet)
Seat 4: denitz21 (small blind) folded before Flop
Seat 6: Kukuryzka (big blind) folded before Flop
Seat 7: chenconhaste folded before Flop (didn't bet)
Seat 8: Vedpapa collected ($3.56)
Seat 9: Fakespecial folded on the Turn





PokerStars Hand #155302577881:  Hold'em No Limit ($0.50/$1.00 USD) - 2016/06/28 16:58:05 CET [2016/06/28 10:58:05 ET]
Table 'Dorado II' 9-max Seat #2 is the button
Seat 1: f1reworks ($155.24 in chips) 
Seat 2: vanilica ($103.04 in chips) 
Seat 3: ghostriderxu ($104.95 in chips) 
Seat 4: pyromid ($114.62 in chips) 
Seat 5: KovIFish89 ($100 in chips) 
Seat 6: mycka86 ($120 in chips) 
Seat 7: matiko09 ($100 in chips) 
Seat 8: flk.Dasas ($166.07 in chips) 
Seat 9: r4mz3s ($141.60 in chips) 
ghostriderxu: posts small blind $0.50
pyromid: posts big blind $1
*** HOLE CARDS ***
Dealt to matiko09 [5h Kh]
KovIFish89: folds 
mycka86: folds 
matiko09: folds 
flk.Dasas: folds 
r4mz3s: folds 
f1reworks: raises $2 to $3
vanilica: folds 
ghostriderxu: folds 
pyromid: calls $2
*** FLOP *** [Ac 9s 4c]
pyromid: checks 
f1reworks: bets $4
pyromid: folds 
Uncalled bet ($4) returned to f1reworks
f1reworks collected $6.18 from pot
f1reworks: doesn't show hand 
*** SUMMARY ***
Total pot $6.50 | Rake $0.32 
Board [Ac 9s 4c]
Seat 1: f1reworks collected ($6.18)
Seat 2: vanilica (button) folded before Flop (didn't bet)
Seat 3: ghostriderxu (small blind) folded before Flop
Seat 4: pyromid (big blind) folded on the Flop
Seat 5: KovIFish89 folded before Flop (didn't bet)
Seat 6: mycka86 folded before Flop (didn't bet)
Seat 7: matiko09 folded before Flop (didn't bet)
Seat 8: flk.Dasas folded before Flop (didn't bet)
Seat 9: r4mz3s folded before Flop (didn't bet)





PokerStars Hand #155302584206:  Hold'em No Limit ($0.25/$0.50 USD) - 2016/06/28 16:58:18 CET [2016/06/28 10:58:18 ET]
Table 'Bruchsalia II' 9-max Seat #7 is the button
Seat 1: ardo888 ($50 in chips) 
Seat 3: el.suertero ($75.82 in chips) 
Seat 4: St.LaCoste ($41.92 in chips) 
Seat 5: Edkar686 ($18.51 in chips) 
Seat 6: matiko09 ($50 in chips) 
Seat 7: Lipton20088 ($20 in chips) 
Seat 8: Kukuryzka ($51.01 in chips) 
Seat 9: app1e_j@ck ($55.86 in chips) 
Kukuryzka: posts small blind $0.25
app1e_j@ck: posts big blind $0.50
denitz21: sits out 
*** HOLE CARDS ***
Dealt to matiko09 [Td 9s]
ardo888: folds 
el.suertero: folds 
St.LaCoste: raises $1 to $1.50
Edkar686: folds 
matiko09: folds 
Lipton20088: folds 
Kukuryzka: folds 
app1e_j@ck: folds 
Uncalled bet ($1) returned to St.LaCoste
St.LaCoste collected $1.25 from pot
St.LaCoste: doesn't show hand 
*** SUMMARY ***
Total pot $1.25 | Rake $0 
Seat 1: ardo888 folded before Flop (didn't bet)
Seat 3: el.suertero folded before Flop (didn't bet)
Seat 4: St.LaCoste collected ($1.25)
Seat 5: Edkar686 folded before Flop (didn't bet)
Seat 6: matiko09 folded before Flop (didn't bet)
Seat 7: Lipton20088 (button) folded before Flop (didn't bet)
Seat 8: Kukuryzka (small blind) folded before Flop
Seat 9: app1e_j@ck (big blind) folded before Flop





PokerStars Hand #155302586414:  Hold'em No Limit ($0.25/$0.50 USD) - 2016/06/28 16:58:22 CET [2016/06/28 10:58:22 ET]
Table 'Lacadiera' 9-max Seat #4 is the button
Seat 1: matiko09 ($50 in chips) 
Seat 2: Alexey_Kim2 ($50 in chips) 
Seat 3: el.suertero ($80.91 in chips) 
Seat 4: denitz21 ($155.63 in chips) 
Seat 6: Kukuryzka ($94.27 in chips) 
Seat 7: chenconhaste ($68.85 in chips) 
Seat 8: Vedpapa ($71.02 in chips) 
Seat 9: Fakespecial ($280.76 in chips) 
AA i won will be allowed to play after the button
Kukuryzka: posts small blind $0.25
chenconhaste: posts big blind $0.50
*** HOLE CARDS ***
Dealt to matiko09 [3h 5s]
Vedpapa: folds 
Fakespecial: raises $0.50 to $1
matiko09: folds 
Alexey_Kim2: folds 
el.suertero: raises $5.50 to $6.50
denitz21: folds 
Kukuryzka: folds 
chenconhaste: folds 
Fakespecial: calls $5.50
*** FLOP *** [9h 6s 3d]
Fakespecial: bets $6.50
el.suertero: raises $9 to $15.50
Fakespecial: calls $9
*** TURN *** [9h 6s 3d] [Td]
Fakespecial: bets $21.50
el.suertero: raises $37.41 to $58.91 and is all-in
Fakespecial: folds 
Uncalled bet ($37.41) returned to el.suertero
el.suertero collected $85.75 from pot
el.suertero: doesn't show hand 
*** SUMMARY ***
Total pot $87.75 | Rake $2 
Board [9h 6s 3d Td]
Seat 1: matiko09 folded before Flop (didn't bet)
Seat 2: Alexey_Kim2 folded before Flop (didn't bet)
Seat 3: el.suertero collected ($85.75)
Seat 4: denitz21 (button) folded before Flop (didn't bet)
Seat 6: Kukuryzka (small blind) folded before Flop
Seat 7: chenconhaste (big blind) folded before Flop
Seat 8: Vedpapa folded before Flop (didn't bet)
Seat 9: Fakespecial folded on the Turn





PokerStars Hand #155302587358:  Hold'em No Limit ($0.50/$1.00 USD) - 2016/06/28 16:58:24 CET [2016/06/28 10:58:24 ET]
Table 'Lyyli II' 9-max Seat #9 is the button
Seat 2: CI58 ($231.52 in chips) 
Seat 3: Racushniak ($110.42 in chips) 
Seat 4: Greha999 ($213.73 in chips) 
Seat 5: flk.Dasas ($100 in chips) 
Seat 6: matiko09 ($100 in chips) 
Seat 7: mycka86 ($104.99 in chips) 
Seat 8: r4mz3s ($123.52 in chips) 
Seat 9: f1reworks ($107.70 in chips) 
CI58: posts small blind $0.50
Racushniak: posts big blind $1
*** HOLE CARDS ***
Dealt to matiko09 [8d Jd]
Greha999: folds 
flk.Dasas: folds 
matiko09: folds 
mycka86: folds 
r4mz3s: folds 
f1reworks: folds 
CI58: calls $0.50
Racushniak: checks 
*** FLOP *** [7h Ah 8c]
CI58: bets $1.14
Racushniak: folds 
Uncalled bet ($1.14) returned to CI58
CI58 collected $1.90 from pot
CI58: doesn't show hand 
*** SUMMARY ***
Total pot $2 | Rake $0.10 
Board [7h Ah 8c]
Seat 2: CI58 (small blind) collected ($1.90)
Seat 3: Racushniak (big blind) folded on the Flop
Seat 4: Greha999 folded before Flop (didn't bet)
Seat 5: flk.Dasas folded before Flop (didn't bet)
Seat 6: matiko09 folded before Flop (didn't bet)
Seat 7: mycka86 folded before Flop (didn't bet)
Seat 8: r4mz3s folded before Flop (didn't bet)
Seat 9: f1reworks (button) folded before Flop (didn't bet)





PokerStars Hand #155302591246:  Hold'em No Limit ($0.50/$1.00 USD) - 2016/06/28 16:58:32 CET [2016/06/28 10:58:32 ET]
Table 'Anitra' 9-max Seat #2 is the button
Seat 1: stds st ($43 in chips) 
Seat 2: ardo888 ($100 in chips) 
Seat 3: facelessPPP ($238.12 in chips) 
Seat 4: Shakeelg ($57.07 in chips) 
Seat 5: er13to ($123.75 in chips) 
Seat 6: matiko09 ($100 in chips) 
Seat 7: phil_cheng ($100 in chips) 
Seat 8: yoshinoino ($31.86 in chips) 
Seat 9: chenconhaste ($105.28 in chips) 
facelessPPP: posts small blind $0.50
Shakeelg: posts big blind $1
*** HOLE CARDS ***
Dealt to matiko09 [7h 9s]
er13to: folds 
matiko09: folds 
phil_cheng: folds 
yoshinoino: folds 
chenconhaste: folds 
stds st: folds 
ardo888: raises $1.50 to $2.50
facelessPPP: raises $5 to $7.50
Shakeelg: calls $6.50
ardo888: folds 
*** FLOP *** [Ad 5h 8s]
facelessPPP: bets $8.31
Shakeelg: folds 
Uncalled bet ($8.31) returned to facelessPPP
facelessPPP collected $16.62 from pot
facelessPPP: doesn't show hand 
*** SUMMARY ***
Total pot $17.50 | Rake $0.88 
Board [Ad 5h 8s]
Seat 1: stds st folded before Flop (didn't bet)
Seat 2: ardo888 (button) folded before Flop
Seat 3: facelessPPP (small blind) collected ($16.62)
Seat 4: Shakeelg (big blind) folded on the Flop
Seat 5: er13to folded before Flop (didn't bet)
Seat 6: matiko09 folded before Flop (didn't bet)
Seat 7: phil_cheng folded before Flop (didn't bet)
Seat 8: yoshinoino folded before Flop (didn't bet)
Seat 9: chenconhaste folded before Flop (didn't bet)





PokerStars Hand #155302594491:  Hold'em No Limit ($0.25/$0.50 USD) - 2016/06/28 16:58:39 CET [2016/06/28 10:58:39 ET]
Table 'Antonia II' 9-max Seat #4 is the button
Seat 1: er13to ($53.59 in chips) 
Seat 4: el.suertero ($66.68 in chips) 
Seat 6: matiko09 ($76.21 in chips) 
Seat 7: Kukuryzka ($53.03 in chips) 
Seat 8: SumPosad ($19.25 in chips) 
Seat 9: Domotirko228 ($58.61 in chips) 
matiko09: posts small blind $0.25
Kukuryzka: posts big blind $0.50
*** HOLE CARDS ***
Dealt to matiko09 [Ad 8h]
SumPosad: folds 
Domotirko228: folds 
er13to: raises $0.86 to $1.36
el.suertero: calls $1.36
matiko09: folds 
Kukuryzka: folds 
*** FLOP *** [9c As 9h]
er13to: checks 
el.suertero: checks 
*** TURN *** [9c As 9h] [Ac]
er13to: checks 
el.suertero: checks 
*** RIVER *** [9c As 9h Ac] [Ks]
er13to: checks 
el.suertero: checks 
*** SHOW DOWN ***
er13to: shows [Kc Kd] (a full house, Kings full of Aces)
el.suertero: mucks hand 
er13to collected $3.30 from pot
*** SUMMARY ***
Total pot $3.47 | Rake $0.17 
Board [9c As 9h Ac Ks]
Seat 1: er13to showed [Kc Kd] and won ($3.30) with a full house, Kings full of Aces
Seat 4: el.suertero (button) mucked [3d 3s]
Seat 6: matiko09 (small blind) folded before Flop
Seat 7: Kukuryzka (big blind) folded before Flop
Seat 8: SumPosad folded before Flop (didn't bet)
Seat 9: Domotirko228 folded before Flop (didn't bet)





PokerStars Hand #155302597755:  Hold'em No Limit (€0.50/€1.00 EUR) - 2016/06/28 16:58:46 CET [2016/06/28 10:58:46 ET]
Table 'Azalea' 9-max Seat #3 is the button
Seat 1: mikiej1993 (€77.95 in chips) 
Seat 2: thecurv (€100 in chips) 
Seat 3: simoniustin (€100 in chips) 
Seat 4: sanpidk (€100 in chips) 
Seat 5: matiko09 (€100 in chips) 
Seat 6: mbk88 (€109.50 in chips) 
Seat 7: vanilica (€116.87 in chips) 
Seat 9: aseban11 (€106.50 in chips) 
sanpidk: posts small blind €0.50
matiko09: posts big blind €1
*** HOLE CARDS ***
Dealt to matiko09 [6h Qs]
mbk88: folds 
vanilica: folds 
aseban11: folds 
mikiej1993: calls €1
thecurv: raises €3 to €4
simoniustin: folds 
sanpidk: folds 
matiko09: folds 
mikiej1993: calls €3
*** FLOP *** [4h Qh Th]
mikiej1993: checks 
thecurv: checks 
*** TURN *** [4h Qh Th] [4c]
mikiej1993: bets €3
thecurv: calls €3
*** RIVER *** [4h Qh Th 4c] [Ad]
mikiej1993: checks 
thecurv: checks 
*** SHOW DOWN ***
mikiej1993: shows [6d 7c] (a pair of Fours)
thecurv: shows [9h 9d] (two pair, Nines and Fours)
thecurv collected €14.72 from pot
*** SUMMARY ***
Total pot €15.50 | Rake €0.78 
Board [4h Qh Th 4c Ad]
Seat 1: mikiej1993 showed [6d 7c] and lost with a pair of Fours
Seat 2: thecurv showed [9h 9d] and won (€14.72) with two pair, Nines and Fours
Seat 3: simoniustin (button) folded before Flop (didn't bet)
Seat 4: sanpidk (small blind) folded before Flop
Seat 5: matiko09 (big blind) folded before Flop
Seat 6: mbk88 folded before Flop (didn't bet)
Seat 7: vanilica folded before Flop (didn't bet)
Seat 9: aseban11 folded before Flop (didn't bet)





PokerStars Hand #155302598144:  Hold'em No Limit ($0.50/$1.00 USD) - 2016/06/28 16:58:47 CET [2016/06/28 10:58:47 ET]
Table 'Tomita' 9-max Seat #7 is the button
Seat 1: CI58 ($114.44 in chips) 
Seat 2: vanilica ($103.62 in chips) 
Seat 3: r4mz3s ($100 in chips) 
Seat 4: f1reworks ($113.08 in chips) 
Seat 5: ANDY19911608 ($198.75 in chips) 
Seat 7: matiko09 ($145.49 in chips) 
Seat 8: Noob0Saibot ($100 in chips) 
Seat 9: sanpidk ($159.80 in chips) 
Noob0Saibot: posts small blind $0.50
sanpidk: posts big blind $1
*** HOLE CARDS ***
Dealt to matiko09 [Tc Th]
CI58: raises $2 to $3
vanilica: folds 
r4mz3s: folds 
f1reworks: folds 
ANDY19911608: calls $3
matiko09: calls $3
Noob0Saibot: folds 
sanpidk: folds 
*** FLOP *** [2d 7d 2c]
CI58: checks 
ANDY19911608: bets $2
matiko09: raises $7 to $9
CI58: folds 
ANDY19911608: folds 
Uncalled bet ($7) returned to matiko09
matiko09 collected $13.78 from pot
matiko09: doesn't show hand 
*** SUMMARY ***
Total pot $14.50 | Rake $0.72 
Board [2d 7d 2c]
Seat 1: CI58 folded on the Flop
Seat 2: vanilica folded before Flop (didn't bet)
Seat 3: r4mz3s folded before Flop (didn't bet)
Seat 4: f1reworks folded before Flop (didn't bet)
Seat 5: ANDY19911608 folded on the Flop
Seat 7: matiko09 (button) collected ($13.78)
Seat 8: Noob0Saibot (small blind) folded before Flop
Seat 9: sanpidk (big blind) folded before Flop





PokerStars Hand #155302601220:  Hold'em No Limit ($0.50/$1.00 USD) - 2016/06/28 16:58:53 CET [2016/06/28 10:58:53 ET]
Table 'Dorado II' 9-max Seat #3 is the button
Seat 1: f1reworks ($158.42 in chips) 
Seat 2: vanilica ($103.04 in chips) 
Seat 3: ghostriderxu ($104.45 in chips) 
Seat 4: pyromid ($111.62 in chips) 
Seat 5: KovIFish89 ($100 in chips) 
Seat 6: mycka86 ($120 in chips) 
Seat 7: matiko09 ($100 in chips) 
Seat 8: flk.Dasas ($166.07 in chips) 
Seat 9: r4mz3s ($141.60 in chips) 
pyromid: posts small blind $0.50
KovIFish89: posts big blind $1
*** HOLE CARDS ***
Dealt to matiko09 [Jd 7h]
mycka86: folds 
matiko09: folds 
flk.Dasas: folds 
r4mz3s: folds 
f1reworks: folds 
vanilica: raises $1.50 to $2.50
ghostriderxu: folds 
pyromid: folds 
KovIFish89: folds 
Uncalled bet ($1.50) returned to vanilica
vanilica collected $2.50 from pot
vanilica: doesn't show hand 
*** SUMMARY ***
Total pot $2.50 | Rake $0 
Seat 1: f1reworks folded before Flop (didn't bet)
Seat 2: vanilica collected ($2.50)
Seat 3: ghostriderxu (button) folded before Flop (didn't bet)
Seat 4: pyromid (small blind) folded before Flop
Seat 5: KovIFish89 (big blind) folded before Flop
Seat 6: mycka86 folded before Flop (didn't bet)
Seat 7: matiko09 folded before Flop (didn't bet)
Seat 8: flk.Dasas folded before Flop (didn't bet)
Seat 9: r4mz3s folded before Flop (didn't bet)





PokerStars Hand #155302602702:  Hold'em No Limit ($0.25/$0.50 USD) - 2016/06/28 16:58:56 CET [2016/06/28 10:58:56 ET]
Table 'Bruchsalia II' 9-max Seat #8 is the button
Seat 1: ardo888 ($50 in chips) 
Seat 3: el.suertero ($75.82 in chips) 
Seat 4: St.LaCoste ($42.67 in chips) 
Seat 5: Edkar686 ($18.51 in chips) 
Seat 6: matiko09 ($50 in chips) 
Seat 7: Lipton20088 ($20 in chips) 
Seat 8: Kukuryzka ($50.76 in chips) 
Seat 9: app1e_j@ck ($55.36 in chips) 
app1e_j@ck: posts small blind $0.25
ardo888: posts big blind $0.50
*** HOLE CARDS ***
Dealt to matiko09 [3d Ac]
el.suertero: raises $1 to $1.50
St.LaCoste: folds 
Edkar686: calls $1.50
matiko09: folds 
Lipton20088: folds 
Kukuryzka: folds 
app1e_j@ck: folds 
ardo888: raises $4.75 to $6.25
el.suertero: folds 
Edkar686: raises $12.26 to $18.51 and is all-in
ardo888: calls $12.26
*** FLOP *** [9s 4c Ks]
*** TURN *** [9s 4c Ks] [Ah]
*** RIVER *** [9s 4c Ks Ah] [9d]
*** SHOW DOWN ***
ardo888: shows [Ad Kh] (two pair, Aces and Kings)
Edkar686: shows [2d 2s] (two pair, Nines and Deuces)
ardo888 collected $36.83 from pot
*** SUMMARY ***
Total pot $38.77 | Rake $1.94 
Board [9s 4c Ks Ah 9d]
Seat 1: ardo888 (big blind) showed [Ad Kh] and won ($36.83) with two pair, Aces and Kings
Seat 3: el.suertero folded before Flop
Seat 4: St.LaCoste folded before Flop (didn't bet)
Seat 5: Edkar686 showed [2d 2s] and lost with two pair, Nines and Deuces
Seat 6: matiko09 folded before Flop (didn't bet)
Seat 7: Lipton20088 folded before Flop (didn't bet)
Seat 8: Kukuryzka (button) folded before Flop (didn't bet)
Seat 9: app1e_j@ck (small blind) folded before Flop





PokerStars Hand #155302607013:  Hold'em No Limit ($0.50/$1.00 USD) - 2016/06/28 16:59:05 CET [2016/06/28 10:59:05 ET]
Table 'Lyyli II' 9-max Seat #2 is the button
Seat 2: CI58 ($232.42 in chips) 
Seat 3: Racushniak ($109.42 in chips) 
Seat 4: Greha999 ($213.73 in chips) 
Seat 5: flk.Dasas ($100 in chips) 
Seat 6: matiko09 ($100 in chips) 
Seat 7: mycka86 ($104.99 in chips) 
Seat 8: r4mz3s ($123.52 in chips) 
Seat 9: f1reworks ($107.70 in chips) 
Racushniak: posts small blind $0.50
Greha999: posts big blind $1
*** HOLE CARDS ***
Dealt to matiko09 [Qd 5h]
flk.Dasas: folds 
matiko09: folds 
mycka86: folds 
r4mz3s: folds 
f1reworks: folds 
CI58: raises $1 to $2
Racushniak: folds 
Greha999: calls $1
*** FLOP *** [7d Kh 3s]
Greha999: checks 
CI58: checks 
*** TURN *** [7d Kh 3s] [5c]
Greha999: bets $2
CI58: folds 
Uncalled bet ($2) returned to Greha999
Greha999 collected $4.28 from pot
*** SUMMARY ***
Total pot $4.50 | Rake $0.22 
Board [7d Kh 3s 5c]
Seat 2: CI58 (button) folded on the Turn
Seat 3: Racushniak (small blind) folded before Flop
Seat 4: Greha999 (big blind) collected ($4.28)
Seat 5: flk.Dasas folded before Flop (didn't bet)
Seat 6: matiko09 folded before Flop (didn't bet)
Seat 7: mycka86 folded before Flop (didn't bet)
Seat 8: r4mz3s folded before Flop (didn't bet)
Seat 9: f1reworks folded before Flop (didn't bet)





PokerStars Hand #155302612274:  Hold'em No Limit ($0.50/$1.00 USD) - 2016/06/28 16:59:16 CET [2016/06/28 10:59:16 ET]
Table 'Anitra' 9-max Seat #3 is the button
Seat 1: stds st ($43 in chips) 
Seat 2: ardo888 ($100 in chips) 
Seat 3: facelessPPP ($247.24 in chips) 
Seat 4: Shakeelg ($49.57 in chips) 
Seat 5: er13to ($123.75 in chips) 
Seat 6: matiko09 ($100 in chips) 
Seat 7: phil_cheng ($100 in chips) 
Seat 8: yoshinoino ($31.86 in chips) 
Seat 9: chenconhaste ($105.28 in chips) 
Shakeelg: posts small blind $0.50
er13to: posts big blind $1
*** HOLE CARDS ***
Dealt to matiko09 [4s 5d]
matiko09: folds 
phil_cheng: raises $2 to $3
yoshinoino: folds 
chenconhaste: folds 
stds st: folds 
ardo888: folds 
facelessPPP: folds 
Shakeelg: calls $2.50
er13to: folds 
*** FLOP *** [4c 2d Jc]
Shakeelg: bets $4
phil_cheng: calls $4
*** TURN *** [4c 2d Jc] [As]
Shakeelg: checks 
phil_cheng: checks 
*** RIVER *** [4c 2d Jc As] [9d]
Shakeelg: bets $5
phil_cheng: calls $5
*** SHOW DOWN ***
Shakeelg: shows [8d Qd] (high card Ace)
phil_cheng: shows [7s 7c] (a pair of Sevens)
phil_cheng collected $23.75 from pot
*** SUMMARY ***
Total pot $25 | Rake $1.25 
Board [4c 2d Jc As 9d]
Seat 1: stds st folded before Flop (didn't bet)
Seat 2: ardo888 folded before Flop (didn't bet)
Seat 3: facelessPPP (button) folded before Flop (didn't bet)
Seat 4: Shakeelg (small blind) showed [8d Qd] and lost with high card Ace
Seat 5: er13to (big blind) folded before Flop
Seat 6: matiko09 folded before Flop (didn't bet)
Seat 7: phil_cheng showed [7s 7c] and won ($23.75) with a pair of Sevens
Seat 8: yoshinoino folded before Flop (didn't bet)
Seat 9: chenconhaste folded before Flop (didn't bet)





PokerStars Hand #155302618427:  Hold'em No Limit ($0.25/$0.50 USD) - 2016/06/28 16:59:29 CET [2016/06/28 10:59:29 ET]
Table 'Lacadiera' 9-max Seat #6 is the button
Seat 1: matiko09 ($50 in chips) 
Seat 2: Alexey_Kim2 ($50 in chips) 
Seat 3: el.suertero ($123.16 in chips) 
Seat 4: denitz21 ($155.63 in chips) 
Seat 6: Kukuryzka ($94.02 in chips) 
Seat 7: chenconhaste ($68.35 in chips) 
Seat 8: Vedpapa ($71.02 in chips) 
Seat 9: Fakespecial ($237.26 in chips) 
chenconhaste: posts small blind $0.25
Vedpapa: posts big blind $0.50
AA i won: sits out 
*** HOLE CARDS ***
Dealt to matiko09 [2h 2c]
Fakespecial: raises $0.50 to $1
matiko09: folds 
Alexey_Kim2: calls $1
el.suertero: calls $1
denitz21: folds 
Kukuryzka: folds 
chenconhaste: folds 
Vedpapa: raises $4.25 to $5.25
Fakespecial: calls $4.25
Alexey_Kim2: calls $4.25
el.suertero: calls $4.25
*** FLOP *** [9h 6d 5h]
Vedpapa: bets $15.14
Fakespecial: raises $15.14 to $30.28
Alexey_Kim2: folds 
el.suertero: folds 
Vedpapa: raises $35.49 to $65.77 and is all-in
Fakespecial: calls $35.49
*** TURN *** [9h 6d 5h] [Kh]
*** RIVER *** [9h 6d 5h Kh] [8h]
*** SHOW DOWN ***
Vedpapa: shows [Ah Jh] (a flush, Ace high)
Fakespecial: shows [9c Qd] (a pair of Nines)
Vedpapa collected $150.79 from pot
*** SUMMARY ***
Total pot $152.79 | Rake $2 
Board [9h 6d 5h Kh 8h]
Seat 1: matiko09 folded before Flop (didn't bet)
Seat 2: Alexey_Kim2 folded on the Flop
Seat 3: el.suertero folded on the Flop
Seat 4: denitz21 folded before Flop (didn't bet)
Seat 6: Kukuryzka (button) folded before Flop (didn't bet)
Seat 7: chenconhaste (small blind) folded before Flop
Seat 8: Vedpapa (big blind) showed [Ah Jh] and won ($150.79) with a flush, Ace high
Seat 9: Fakespecial showed [9c Qd] and lost with a pair of Nines





PokerStars Hand #155302619949:  Hold'em No Limit ($0.50/$1.00 USD) - 2016/06/28 16:59:32 CET [2016/06/28 10:59:32 ET]
Table 'Tomita' 9-max Seat #8 is the button
Seat 1: CI58 ($111.44 in chips) 
Seat 2: vanilica ($103.62 in chips) 
Seat 3: r4mz3s ($100 in chips) 
Seat 4: f1reworks ($113.08 in chips) 
Seat 5: ANDY19911608 ($193.75 in chips) 
Seat 7: matiko09 ($154.27 in chips) 
Seat 8: Noob0Saibot ($100 in chips) 
Seat 9: sanpidk ($158.80 in chips) 
sanpidk: posts small blind $0.50
CI58: posts big blind $1
*** HOLE CARDS ***
Dealt to matiko09 [Qd 5d]
vanilica: folds 
r4mz3s: folds 
f1reworks: folds 
ANDY19911608: calls $1
matiko09: folds 
Noob0Saibot: folds 
sanpidk: folds 
CI58: checks 
*** FLOP *** [5s 7h 8s]
CI58: checks 
ANDY19911608: checks 
*** TURN *** [5s 7h 8s] [7d]
CI58: checks 
ANDY19911608: checks 
*** RIVER *** [5s 7h 8s 7d] [Th]
CI58: checks 
ANDY19911608: bets $1
CI58: folds 
Uncalled bet ($1) returned to ANDY19911608
ANDY19911608 collected $2.38 from pot
ANDY19911608: doesn't show hand 
*** SUMMARY ***
Total pot $2.50 | Rake $0.12 
Board [5s 7h 8s 7d Th]
Seat 1: CI58 (big blind) folded on the River
Seat 2: vanilica folded before Flop (didn't bet)
Seat 3: r4mz3s folded before Flop (didn't bet)
Seat 4: f1reworks folded before Flop (didn't bet)
Seat 5: ANDY19911608 collected ($2.38)
Seat 7: matiko09 folded before Flop (didn't bet)
Seat 8: Noob0Saibot (button) folded before Flop (didn't bet)
Seat 9: sanpidk (small blind) folded before Flop





PokerStars Hand #155302621401:  Hold'em No Limit ($0.25/$0.50 USD) - 2016/06/28 16:59:35 CET [2016/06/28 10:59:35 ET]
Table 'Antonia II' 9-max Seat #6 is the button
Seat 1: er13to ($55.53 in chips) 
Seat 4: el.suertero ($65.32 in chips) 
Seat 5: 35LOBO35 ($20.22 in chips) 
Seat 6: matiko09 ($75.96 in chips) 
Seat 7: Kukuryzka ($52.53 in chips) 
Seat 9: Domotirko228 ($58.61 in chips) 
Kukuryzka: posts small blind $0.25
SumPosad: is sitting out 
Domotirko228: posts big blind $0.50
35LOBO35: posts small & big blinds $0.75
*** HOLE CARDS ***
Dealt to matiko09 [4c As]
er13to: folds 
el.suertero: raises $2.50 to $3
35LOBO35: calls $2.50
matiko09: folds 
Kukuryzka: folds 
Domotirko228: folds 
*** FLOP *** [Qh 6d 2h]
el.suertero: bets $3.65
35LOBO35: folds 
Uncalled bet ($3.65) returned to el.suertero
el.suertero collected $6.65 from pot
el.suertero: doesn't show hand 
*** SUMMARY ***
Total pot $7 | Rake $0.35 
Board [Qh 6d 2h]
Seat 1: er13to folded before Flop (didn't bet)
Seat 4: el.suertero collected ($6.65)
Seat 5: 35LOBO35 folded on the Flop
Seat 6: matiko09 (button) folded before Flop (didn't bet)
Seat 7: Kukuryzka (small blind) folded before Flop
Seat 9: Domotirko228 (big blind) folded before Flop





PokerStars Hand #155302626778:  Hold'em No Limit ($0.50/$1.00 USD) - 2016/06/28 16:59:46 CET [2016/06/28 10:59:46 ET]
Table 'Lyyli II' 9-max Seat #3 is the button
Seat 2: CI58 ($230.42 in chips) 
Seat 3: Racushniak ($108.92 in chips) 
Seat 4: Greha999 ($216.01 in chips) 
Seat 5: flk.Dasas ($100 in chips) 
Seat 6: matiko09 ($100 in chips) 
Seat 7: mycka86 ($104.99 in chips) 
Seat 8: r4mz3s ($123.52 in chips) 
Seat 9: f1reworks ($107.70 in chips) 
Greha999: posts small blind $0.50
flk.Dasas: posts big blind $1
*** HOLE CARDS ***
Dealt to matiko09 [Ts Js]
matiko09: raises $2 to $3
mycka86: folds 
r4mz3s: folds 
f1reworks: raises $6 to $9
CI58: folds 
Racushniak: folds 
Greha999: folds 
flk.Dasas: folds 
matiko09: folds 
Uncalled bet ($6) returned to f1reworks
f1reworks collected $7.50 from pot
f1reworks: doesn't show hand 
*** SUMMARY ***
Total pot $7.50 | Rake $0 
Seat 2: CI58 folded before Flop (didn't bet)
Seat 3: Racushniak (button) folded before Flop (didn't bet)
Seat 4: Greha999 (small blind) folded before Flop
Seat 5: flk.Dasas (big blind) folded before Flop
Seat 6: matiko09 folded before Flop
Seat 7: mycka86 folded before Flop (didn't bet)
Seat 8: r4mz3s folded before Flop (didn't bet)
Seat 9: f1reworks collected ($7.50)





PokerStars Hand #155302628685:  Hold'em No Limit (€0.50/€1.00 EUR) - 2016/06/28 16:59:50 CET [2016/06/28 10:59:50 ET]
Table 'Azalea' 9-max Seat #4 is the button
Seat 1: mikiej1993 (€70.95 in chips) 
Seat 2: thecurv (€107.72 in chips) 
Seat 3: simoniustin (€100 in chips) 
Seat 4: sanpidk (€100 in chips) 
Seat 5: matiko09 (€100 in chips) 
Seat 7: vanilica (€116.87 in chips) 
Seat 9: aseban11 (€106.50 in chips) 
matiko09: posts small blind €0.50
mbk88: is sitting out 
vanilica: posts big blind €1
*** HOLE CARDS ***
Dealt to matiko09 [9c 9d]
mbk88 leaves the table
aseban11: folds 
mikiej1993: raises €2 to €3
thecurv: folds 
simoniustin: folds 
Filojoes joins the table at seat #6 
sanpidk: calls €3
matiko09: calls €2.50
vanilica: folds 
*** FLOP *** [7h 7s 6d]
matiko09: bets €6
mikiej1993: folds 
mikiej1993 leaves the table
sanpidk: folds 
Uncalled bet (€6) returned to matiko09
matiko09 collected €9.50 from pot
matiko09: doesn't show hand 
*** SUMMARY ***
Total pot €10 | Rake €0.50 
Board [7h 7s 6d]
Seat 1: mikiej1993 folded on the Flop
Seat 2: thecurv folded before Flop (didn't bet)
Seat 3: simoniustin folded before Flop (didn't bet)
Seat 4: sanpidk (button) folded on the Flop
Seat 5: matiko09 (small blind) collected (€9.50)
Seat 7: vanilica (big blind) folded before Flop
Seat 9: aseban11 folded before Flop (didn't bet)





PokerStars Hand #155302638150:  Hold'em No Limit ($0.25/$0.50 USD) - 2016/06/28 17:00:09 CET [2016/06/28 11:00:09 ET]
Table 'Bruchsalia II' 9-max Seat #9 is the button
Seat 1: ardo888 ($68.32 in chips) 
Seat 3: el.suertero ($74.32 in chips) 
Seat 4: St.LaCoste ($42.67 in chips) 
Seat 6: matiko09 ($50 in chips) 
Seat 7: Lipton20088 ($20 in chips) 
Seat 8: Kukuryzka ($50.76 in chips) 
Seat 9: app1e_j@ck ($55.11 in chips) 
ardo888: posts small blind $0.25
el.suertero: posts big blind $0.50
*** HOLE CARDS ***
Dealt to matiko09 [7c 5h]
St.LaCoste: folds 
matiko09: folds 
St.LaCoste leaves the table
Lipton20088: folds 
Kukuryzka: folds 
app1e_j@ck: raises $0.55 to $1.05
ardo888: raises $3.45 to $4.50
el.suertero: folds 
UnBent022 joins the table at seat #4 
app1e_j@ck: folds 
Uncalled bet ($3.45) returned to ardo888
ardo888 collected $2.60 from pot
ardo888: doesn't show hand 
*** SUMMARY ***
Total pot $2.60 | Rake $0 
Seat 1: ardo888 (small blind) collected ($2.60)
Seat 3: el.suertero (big blind) folded before Flop
Seat 4: St.LaCoste folded before Flop (didn't bet)
Seat 6: matiko09 folded before Flop (didn't bet)
Seat 7: Lipton20088 folded before Flop (didn't bet)
Seat 8: Kukuryzka folded before Flop (didn't bet)
Seat 9: app1e_j@ck (button) folded before Flop





PokerStars Hand #155302643834:  Hold'em No Limit ($0.25/$0.50 USD) - 2016/06/28 17:00:20 CET [2016/06/28 11:00:20 ET]
Table 'Antonia II' 9-max Seat #7 is the button
Seat 1: er13to ($55.53 in chips) 
Seat 4: el.suertero ($68.97 in chips) 
Seat 5: 35LOBO35 ($16.97 in chips) 
Seat 6: matiko09 ($75.96 in chips) 
Seat 7: Kukuryzka ($52.28 in chips) 
Seat 9: Domotirko228 ($58.11 in chips) 
SumPosad will be allowed to play after the button
Domotirko228: posts small blind $0.25
er13to is disconnected 
er13to is connected 
er13to: posts big blind $0.50
*** HOLE CARDS ***
Dealt to matiko09 [6d Jh]
el.suertero: folds 
35LOBO35: raises $1 to $1.50
matiko09: folds 
Kukuryzka: raises $8.25 to $9.75
Domotirko228: folds 
er13to: folds 
35LOBO35: calls $8.25
*** FLOP *** [Kh 8c 7d]
35LOBO35: bets $7.22 and is all-in
Kukuryzka: calls $7.22
*** TURN *** [Kh 8c 7d] [Qd]
*** RIVER *** [Kh 8c 7d Qd] [Ts]
*** SHOW DOWN ***
35LOBO35: shows [9s Ks] (a pair of Kings)
Kukuryzka: shows [9d 9c] (a pair of Nines)
35LOBO35 collected $32.96 from pot
*** SUMMARY ***
Total pot $34.69 | Rake $1.73 
Board [Kh 8c 7d Qd Ts]
Seat 1: er13to (big blind) folded before Flop
Seat 4: el.suertero folded before Flop (didn't bet)
Seat 5: 35LOBO35 showed [9s Ks] and won ($32.96) with a pair of Kings
Seat 6: matiko09 folded before Flop (didn't bet)
Seat 7: Kukuryzka (button) showed [9d 9c] and lost with a pair of Nines
Seat 9: Domotirko228 (small blind) folded before Flop





PokerStars Hand #155302648185:  Hold'em No Limit ($0.50/$1.00 USD) - 2016/06/28 17:00:29 CET [2016/06/28 11:00:29 ET]
Table 'Tomita' 9-max Seat #9 is the button
Seat 1: CI58 ($110.44 in chips) 
Seat 2: vanilica ($103.62 in chips) 
Seat 3: r4mz3s ($100 in chips) 
Seat 4: f1reworks ($113.08 in chips) 
Seat 5: ANDY19911608 ($195.13 in chips) 
Seat 7: matiko09 ($154.27 in chips) 
Seat 8: Noob0Saibot ($100 in chips) 
Seat 9: sanpidk ($158.30 in chips) 
CI58: posts small blind $0.50
vanilica: posts big blind $1
*** HOLE CARDS ***
Dealt to matiko09 [Qc 3c]
r4mz3s: folds 
f1reworks: folds 
ANDY19911608: folds 
matiko09: folds 
Noob0Saibot: folds 
sanpidk: folds 
CI58: raises $2 to $3
vanilica: calls $2
*** FLOP *** [3d 6h Kc]
CI58: checks 
vanilica: checks 
*** TURN *** [3d 6h Kc] [9d]
CI58: checks 
vanilica: checks 
*** RIVER *** [3d 6h Kc 9d] [6d]
CI58: checks 
vanilica: checks 
*** SHOW DOWN ***
CI58: shows [7s 7c] (two pair, Sevens and Sixes)
vanilica: mucks hand 
CI58 collected $5.70 from pot
*** SUMMARY ***
Total pot $6 | Rake $0.30 
Board [3d 6h Kc 9d 6d]
Seat 1: CI58 (small blind) showed [7s 7c] and won ($5.70) with two pair, Sevens and Sixes
Seat 2: vanilica (big blind) mucked [8c Ac]
Seat 3: r4mz3s folded before Flop (didn't bet)
Seat 4: f1reworks folded before Flop (didn't bet)
Seat 5: ANDY19911608 folded before Flop (didn't bet)
Seat 7: matiko09 folded before Flop (didn't bet)
Seat 8: Noob0Saibot folded before Flop (didn't bet)
Seat 9: sanpidk (button) folded before Flop (didn't bet)





PokerStars Hand #155302650722:  Hold'em No Limit (€0.50/€1.00 EUR) - 2016/06/28 17:00:34 CET [2016/06/28 11:00:34 ET]
Table 'Azalea' 9-max Seat #5 is the button
Seat 2: thecurv (€107.72 in chips) 
Seat 3: simoniustin (€100 in chips) 
Seat 4: sanpidk (€100 in chips) 
Seat 5: matiko09 (€106.50 in chips) 
Seat 7: vanilica (€115.87 in chips) 
Seat 9: aseban11 (€106.50 in chips) 
Filojoes will be allowed to play after the button
vanilica: posts small blind €0.50
aseban11: posts big blind €1
*** HOLE CARDS ***
Dealt to matiko09 [Tc Th]
thecurv: folds 
simoniustin: folds 
sanpidk: folds 
matiko09: raises €1.27 to €2.27
vanilica: folds 
aseban11: folds 
Uncalled bet (€1.27) returned to matiko09
matiko09 collected €2.50 from pot
matiko09: doesn't show hand 
*** SUMMARY ***
Total pot €2.50 | Rake €0 
Seat 2: thecurv folded before Flop (didn't bet)
Seat 3: simoniustin folded before Flop (didn't bet)
Seat 4: sanpidk folded before Flop (didn't bet)
Seat 5: matiko09 (button) collected (€2.50)
Seat 7: vanilica (small blind) folded before Flop
Seat 9: aseban11 (big blind) folded before Flop





PokerStars Hand #155302659333:  Hold'em No Limit ($0.25/$0.50 USD) - 2016/06/28 17:00:51 CET [2016/06/28 11:00:51 ET]
Table 'Bruchsalia II' 9-max Seat #1 is the button
Seat 1: ardo888 ($69.87 in chips) 
Seat 3: el.suertero ($73.82 in chips) 
Seat 4: UnBent022 ($50 in chips) 
Seat 5: Edkar686 ($50 in chips) 
Seat 6: matiko09 ($50 in chips) 
Seat 7: Lipton20088 ($20 in chips) 
Seat 8: Kukuryzka ($50.76 in chips) 
Seat 9: app1e_j@ck ($54.06 in chips) 
el.suertero: posts small blind $0.25
UnBent022: posts big blind $0.50
*** HOLE CARDS ***
Dealt to matiko09 [2s Qc]
Edkar686: calls $0.50
matiko09: folds 
Lipton20088: raises $1.50 to $2
Kukuryzka: folds 
app1e_j@ck: folds 
ardo888: raises $4.50 to $6.50
el.suertero: folds 
UnBent022: folds 
Edkar686: folds 
Lipton20088: folds 
Uncalled bet ($4.50) returned to ardo888
ardo888 collected $5.25 from pot
ardo888: doesn't show hand 
*** SUMMARY ***
Total pot $5.25 | Rake $0 
Seat 1: ardo888 (button) collected ($5.25)
Seat 3: el.suertero (small blind) folded before Flop
Seat 4: UnBent022 (big blind) folded before Flop
Seat 5: Edkar686 folded before Flop
Seat 6: matiko09 folded before Flop (didn't bet)
Seat 7: Lipton20088 folded before Flop
Seat 8: Kukuryzka folded before Flop (didn't bet)
Seat 9: app1e_j@ck folded before Flop (didn't bet)





PokerStars Hand #155302661559:  Hold'em No Limit (€0.50/€1.00 EUR) - 2016/06/28 17:00:55 CET [2016/06/28 11:00:55 ET]
Table 'Azalea' 9-max Seat #7 is the button
Seat 3: simoniustin (€100 in chips) 
Seat 4: sanpidk (€100 in chips) 
Seat 5: matiko09 (€108 in chips) 
Seat 7: vanilica (€115.37 in chips) 
Seat 9: aseban11 (€105.50 in chips) 
aseban11: posts small blind €0.50
thecurv: is sitting out 
simoniustin: posts big blind €1
thecurv leaves the table
Filojoes: sits out 
*** HOLE CARDS ***
Dealt to matiko09 [Jd Kh]
sanpidk: folds 
matiko09: raises €1.50 to €2.50
vanilica: folds 
sanpidk leaves the table
aseban11: folds 
simoniustin: folds 
Uncalled bet (€1.50) returned to matiko09
matiko09 collected €2.50 from pot
matiko09: doesn't show hand 
*** SUMMARY ***
Total pot €2.50 | Rake €0 
Seat 3: simoniustin (big blind) folded before Flop
Seat 4: sanpidk folded before Flop (didn't bet)
Seat 5: matiko09 collected (€2.50)
Seat 7: vanilica (button) folded before Flop (didn't bet)
Seat 9: aseban11 (small blind) folded before Flop





PokerStars Hand #155302674363:  Hold'em No Limit ($0.25/$0.50 USD) - 2016/06/28 17:01:19 CET [2016/06/28 11:01:19 ET]
Table 'Lacadiera' 9-max Seat #7 is the button
Seat 1: matiko09 ($50 in chips) 
Seat 2: Alexey_Kim2 ($50 in chips) 
Seat 3: el.suertero ($117.91 in chips) 
Seat 4: denitz21 ($155.63 in chips) 
Seat 6: Kukuryzka ($94.02 in chips) 
Seat 7: chenconhaste ($68.10 in chips) 
Seat 8: Vedpapa ($150.79 in chips) 
Seat 9: Fakespecial ($166.24 in chips) 
Vedpapa: posts small blind $0.25
Fakespecial: posts big blind $0.50
AA i won: sits out 
*** HOLE CARDS ***
Dealt to matiko09 [4d Td]
matiko09: folds 
Alexey_Kim2: folds 
el.suertero: folds 
denitz21: raises $0.50 to $1
Kukuryzka: folds 
chenconhaste: folds 
Vedpapa: folds 
Fakespecial: calls $0.50
*** FLOP *** [Ah Qd Qh]
Fakespecial: checks 
denitz21: checks 
*** TURN *** [Ah Qd Qh] [3c]
Fakespecial: checks 
denitz21: checks 
*** RIVER *** [Ah Qd Qh 3c] [9h]
Fakespecial: bets $1
denitz21: raises $3.50 to $4.50
Fakespecial: calls $3.50
*** SHOW DOWN ***
denitz21: shows [Jh 8h] (a flush, Ace high)
Fakespecial: mucks hand 
denitz21 collected $10.69 from pot
*** SUMMARY ***
Total pot $11.25 | Rake $0.56 
Board [Ah Qd Qh 3c 9h]
Seat 1: matiko09 folded before Flop (didn't bet)
Seat 2: Alexey_Kim2 folded before Flop (didn't bet)
Seat 3: el.suertero folded before Flop (didn't bet)
Seat 4: denitz21 showed [Jh 8h] and won ($10.69) with a flush, Ace high
Seat 6: Kukuryzka folded before Flop (didn't bet)
Seat 7: chenconhaste (button) folded before Flop (didn't bet)
Seat 8: Vedpapa (small blind) folded before Flop
Seat 9: Fakespecial (big blind) mucked [9d 8c]





PokerStars Hand #155302688144:  Hold'em No Limit ($0.25/$0.50 USD) - 2016/06/28 17:01:44 CET [2016/06/28 11:01:44 ET]
Table 'Antonia II' 9-max Seat #9 is the button
Seat 1: er13to ($55.03 in chips) 
Seat 2: UnBent022 ($50 in chips) 
Seat 4: el.suertero ($68.97 in chips) 
Seat 5: 35LOBO35 ($32.96 in chips) 
Seat 6: matiko09 ($75.96 in chips) 
Seat 7: Kukuryzka ($50 in chips) 
Seat 9: Domotirko228 ($57.86 in chips) 
er13to: posts small blind $0.25
UnBent022: posts big blind $0.50
SumPosad: sits out 
*** HOLE CARDS ***
Dealt to matiko09 [5d 7h]
el.suertero: folds 
35LOBO35: calls $0.50
matiko09: folds 
Kukuryzka: folds 
Domotirko228: raises $1.50 to $2
er13to: folds 
UnBent022: folds 
35LOBO35: calls $1.50
*** FLOP *** [Qs 6c Kh]
35LOBO35: checks 
Domotirko228: checks 
*** TURN *** [Qs 6c Kh] [Jh]
35LOBO35: bets $2
Domotirko228: raises $4.25 to $6.25
35LOBO35: folds 
Uncalled bet ($4.25) returned to Domotirko228
Domotirko228 collected $8.31 from pot
Domotirko228: doesn't show hand 
*** SUMMARY ***
Total pot $8.75 | Rake $0.44 
Board [Qs 6c Kh Jh]
Seat 1: er13to (small blind) folded before Flop
Seat 2: UnBent022 (big blind) folded before Flop
Seat 4: el.suertero folded before Flop (didn't bet)
Seat 5: 35LOBO35 folded on the Turn
Seat 6: matiko09 folded before Flop (didn't bet)
Seat 7: Kukuryzka folded before Flop (didn't bet)
Seat 9: Domotirko228 (button) collected ($8.31)





PokerStars Hand #155302696650:  Hold'em No Limit ($0.50/$1.00 USD) - 2016/06/28 17:02:00 CET [2016/06/28 11:02:00 ET]
Table 'Tomita' 9-max Seat #1 is the button
Seat 1: CI58 ($113.14 in chips) 
Seat 2: vanilica ($100.62 in chips) 
Seat 3: r4mz3s ($100 in chips) 
Seat 4: f1reworks ($113.08 in chips) 
Seat 5: ANDY19911608 ($195.13 in chips) 
Seat 7: matiko09 ($154.27 in chips) 
Seat 8: Noob0Saibot ($100 in chips) 
Seat 9: sanpidk ($158.30 in chips) 
vanilica: posts small blind $0.50
r4mz3s: posts big blind $1
*** HOLE CARDS ***
Dealt to matiko09 [5c 9d]
f1reworks: folds 
ANDY19911608: calls $1
matiko09: folds 
Noob0Saibot: folds 
sanpidk: folds 
CI58: calls $1
vanilica: folds 
r4mz3s: checks 
*** FLOP *** [As Ah Qd]
r4mz3s: checks 
ANDY19911608: checks 
CI58: checks 
*** TURN *** [As Ah Qd] [2c]
r4mz3s: checks 
ANDY19911608: checks 
tipner leaves the table
CI58: checks 
*** RIVER *** [As Ah Qd 2c] [Kc]
r4mz3s: checks 
ANDY19911608: checks 
DomiVY joins the table at seat #6 
CI58: bets $1.66
r4mz3s: folds 
ANDY19911608: folds 
Uncalled bet ($1.66) returned to CI58
CI58 collected $3.32 from pot
CI58: doesn't show hand 
*** SUMMARY ***
Total pot $3.50 | Rake $0.18 
Board [As Ah Qd 2c Kc]
Seat 1: CI58 (button) collected ($3.32)
Seat 2: vanilica (small blind) folded before Flop
Seat 3: r4mz3s (big blind) folded on the River
Seat 4: f1reworks folded before Flop (didn't bet)
Seat 5: ANDY19911608 folded on the River
Seat 7: matiko09 folded before Flop (didn't bet)
Seat 8: Noob0Saibot folded before Flop (didn't bet)
Seat 9: sanpidk folded before Flop (didn't bet)





PokerStars Hand #155302696366:  Hold'em No Limit ($0.25/$0.50 USD) - 2016/06/28 17:02:00 CET [2016/06/28 11:02:00 ET]
Table 'Bruchsalia II' 9-max Seat #3 is the button
Seat 1: ardo888 ($73.12 in chips) 
Seat 3: el.suertero ($73.57 in chips) 
Seat 4: UnBent022 ($50 in chips) 
Seat 5: Edkar686 ($49.50 in chips) 
Seat 6: matiko09 ($50 in chips) 
Seat 7: Lipton20088 ($20 in chips) 
Seat 8: Kukuryzka ($50.76 in chips) 
Seat 9: app1e_j@ck ($54.06 in chips) 
UnBent022: posts small blind $0.25
Edkar686: posts big blind $0.50
*** HOLE CARDS ***
Dealt to matiko09 [3c Qc]
matiko09: folds 
Lipton20088: folds 
Kukuryzka: raises $1 to $1.50
app1e_j@ck: folds 
ardo888: folds 
el.suertero: folds 
UnBent022: folds 
Edkar686: calls $1
*** FLOP *** [9s Qs Qh]
Edkar686: checks 
Kukuryzka: bets $1.54
Edkar686: folds 
Uncalled bet ($1.54) returned to Kukuryzka
Kukuryzka collected $3.09 from pot
Kukuryzka: doesn't show hand 
*** SUMMARY ***
Total pot $3.25 | Rake $0.16 
Board [9s Qs Qh]
Seat 1: ardo888 folded before Flop (didn't bet)
Seat 3: el.suertero (button) folded before Flop (didn't bet)
Seat 4: UnBent022 (small blind) folded before Flop
Seat 5: Edkar686 (big blind) folded on the Flop
Seat 6: matiko09 folded before Flop (didn't bet)
Seat 7: Lipton20088 folded before Flop (didn't bet)
Seat 8: Kukuryzka collected ($3.09)
Seat 9: app1e_j@ck folded before Flop (didn't bet)





PokerStars Hand #155302719526:  Hold'em No Limit ($0.25/$0.50 USD) - 2016/06/28 17:02:43 CET [2016/06/28 11:02:43 ET]
Table 'Antonia II' 9-max Seat #1 is the button
Seat 1: er13to ($54.78 in chips) 
Seat 2: UnBent022 ($50 in chips) 
Seat 4: el.suertero ($68.97 in chips) 
Seat 5: 35LOBO35 ($28.96 in chips) 
Seat 6: matiko09 ($75.96 in chips) 
Seat 7: Kukuryzka ($50 in chips) 
Seat 9: Domotirko228 ($62.17 in chips) 
UnBent022: posts small blind $0.25
chenconhaste was removed from the table for failing to post
el.suertero: posts big blind $0.50
SumPosad: sits out 
*** HOLE CARDS ***
Dealt to matiko09 [6h 7c]
35LOBO35: raises $1 to $1.50
matiko09: folds 
Kukuryzka: folds 
Domotirko228: folds 
er13to: folds 
UnBent022: folds 
el.suertero: folds 
Uncalled bet ($1) returned to 35LOBO35
35LOBO35 collected $1.25 from pot
35LOBO35: doesn't show hand 
*** SUMMARY ***
Total pot $1.25 | Rake $0 
Seat 1: er13to (button) folded before Flop (didn't bet)
Seat 2: UnBent022 (small blind) folded before Flop
Seat 4: el.suertero (big blind) folded before Flop
Seat 5: 35LOBO35 collected ($1.25)
Seat 6: matiko09 folded before Flop (didn't bet)
Seat 7: Kukuryzka folded before Flop (didn't bet)
Seat 9: Domotirko228 folded before Flop (didn't bet)





PokerStars Hand #155302734264:  Hold'em No Limit ($0.25/$0.50 USD) - 2016/06/28 17:03:10 CET [2016/06/28 11:03:10 ET]
Table 'Antonia II' 9-max Seat #2 is the button
Seat 1: er13to ($54.78 in chips) 
Seat 2: UnBent022 ($50 in chips) 
Seat 4: el.suertero ($68.47 in chips) 
Seat 5: 35LOBO35 ($29.71 in chips) 
Seat 6: matiko09 ($75.96 in chips) 
Seat 7: Kukuryzka ($50 in chips) 
Seat 9: Domotirko228 ($62.17 in chips) 
el.suertero: posts small blind $0.25
35LOBO35: posts big blind $0.50
SumPosad: sits out 
*** HOLE CARDS ***
Dealt to matiko09 [As Qs]
matiko09: raises $1 to $1.50
Kukuryzka: folds 
Domotirko228: folds 
er13to: folds 
UnBent022: folds 
el.suertero: folds 
35LOBO35: folds 
Uncalled bet ($1) returned to matiko09
matiko09 collected $1.25 from pot
matiko09: doesn't show hand 
*** SUMMARY ***
Total pot $1.25 | Rake $0 
Seat 1: er13to folded before Flop (didn't bet)
Seat 2: UnBent022 (button) folded before Flop (didn't bet)
Seat 4: el.suertero (small blind) folded before Flop
Seat 5: 35LOBO35 (big blind) folded before Flop
Seat 6: matiko09 collected ($1.25)
Seat 7: Kukuryzka folded before Flop (didn't bet)
Seat 9: Domotirko228 folded before Flop (didn't bet)





PokerStars Hand #155302741545:  Hold'em No Limit ($0.50/$1.00 USD) - 2016/06/28 17:03:23 CET [2016/06/28 11:03:23 ET]
Table 'Tomita' 9-max Seat #2 is the button
Seat 1: CI58 ($115.46 in chips) 
Seat 2: vanilica ($100.12 in chips) 
Seat 3: r4mz3s ($100 in chips) 
Seat 5: ANDY19911608 ($194.13 in chips) 
Seat 7: matiko09 ($154.27 in chips) 
Seat 8: Noob0Saibot ($100 in chips) 
Seat 9: sanpidk ($158.30 in chips) 
r4mz3s: posts small blind $0.50
f1reworks: is sitting out 
f1reworks leaves the table
ANDY19911608: posts big blind $1
DomiVY: sits out 
*** HOLE CARDS ***
Dealt to matiko09 [Qh 2d]
matiko09: folds 
Noob0Saibot: raises $2 to $3
sanpidk: folds 
CI58: folds 
vanilica: folds 
phil_cheng joins the table at seat #4 
r4mz3s: folds 
ANDY19911608: folds 
Uncalled bet ($2) returned to Noob0Saibot
Noob0Saibot collected $2.50 from pot
Noob0Saibot: doesn't show hand 
*** SUMMARY ***
Total pot $2.50 | Rake $0 
Seat 1: CI58 folded before Flop (didn't bet)
Seat 2: vanilica (button) folded before Flop (didn't bet)
Seat 3: r4mz3s (small blind) folded before Flop
Seat 5: ANDY19911608 (big blind) folded before Flop
Seat 7: matiko09 folded before Flop (didn't bet)
Seat 8: Noob0Saibot collected ($2.50)
Seat 9: sanpidk folded before Flop (didn't bet)





PokerStars Hand #155302754969:  Hold'em No Limit ($0.50/$1.00 USD) - 2016/06/28 17:03:47 CET [2016/06/28 11:03:47 ET]
Table 'Tomita' 9-max Seat #3 is the button
Seat 1: CI58 ($115.46 in chips) 
Seat 2: vanilica ($100.12 in chips) 
Seat 3: r4mz3s ($100 in chips) 
Seat 5: ANDY19911608 ($193.13 in chips) 
Seat 6: DomiVY ($41.50 in chips) 
Seat 7: matiko09 ($154.27 in chips) 
Seat 8: Noob0Saibot ($101.50 in chips) 
Seat 9: sanpidk ($158.30 in chips) 
phil_cheng will be allowed to play after the button
ANDY19911608: posts small blind $0.50
DomiVY: posts big blind $1
*** HOLE CARDS ***
Dealt to matiko09 [Qh 4c]
matiko09: folds 
Noob0Saibot: calls $1
sanpidk: folds 
CI58: raises $3 to $4
vanilica: folds 
r4mz3s: folds 
ANDY19911608: folds 
DomiVY: raises $6 to $10
Noob0Saibot: folds 
CI58: folds 
Uncalled bet ($6) returned to DomiVY
DomiVY collected $9.50 from pot
DomiVY: doesn't show hand 
*** SUMMARY ***
Total pot $9.50 | Rake $0 
Seat 1: CI58 folded before Flop
Seat 2: vanilica folded before Flop (didn't bet)
Seat 3: r4mz3s (button) folded before Flop (didn't bet)
Seat 5: ANDY19911608 (small blind) folded before Flop
Seat 6: DomiVY (big blind) collected ($9.50)
Seat 7: matiko09 folded before Flop (didn't bet)
Seat 8: Noob0Saibot folded before Flop
Seat 9: sanpidk folded before Flop (didn't bet)





PokerStars Hand #155373294006:  Hold'em No Limit ($0.25/$0.50 USD) - 2016/06/30 8:01:35 CET [2016/06/30 2:01:35 ET]
Table 'Ducrosa' 9-max Seat #1 is the button
Seat 1: Dantist1122 ($50 in chips) 
Seat 2: John_les ($50 in chips) 
Seat 3: matiko09 ($50 in chips) 
Seat 4: Lita17 ($62 in chips) 
Seat 7: THREE FlDDY ($52.36 in chips) 
Seat 8: pikopikop ($47.25 in chips) 
Seat 9: ClassicWheel ($37.10 in chips) 
John_les: posts small blind $0.25
matiko09: posts big blind $0.50
POTAPENKO700: sits out 
*** HOLE CARDS ***
Dealt to matiko09 [3s 4c]
Lita17: raises $1.25 to $1.75
THREE FlDDY: calls $1.75
pikopikop: folds 
ClassicWheel: calls $1.75
Dantist1122: folds 
John_les: folds 
matiko09: folds 
*** FLOP *** [Tc 6h Ac]
Lita17: checks 
j.BoSCO.c leaves the table
THREE FlDDY: checks 
ClassicWheel: bets $1
Lita17: calls $1
THREE FlDDY: folds 
*** TURN *** [Tc 6h Ac] [Kh]
Lita17: checks 
ClassicWheel: bets $2
Lita17: calls $2
*** RIVER *** [Tc 6h Ac Kh] [Kd]
Lita17: checks 
ClassicWheel: checks 
*** SHOW DOWN ***
Lita17: shows [8h 8d] (two pair, Kings and Eights)
ClassicWheel: shows [Ad 5s] (two pair, Aces and Kings)
ClassicWheel collected $11.40 from pot
*** SUMMARY ***
Total pot $12 | Rake $0.60 
Board [Tc 6h Ac Kh Kd]
Seat 1: Dantist1122 (button) folded before Flop (didn't bet)
Seat 2: John_les (small blind) folded before Flop
Seat 3: matiko09 (big blind) folded before Flop
Seat 4: Lita17 showed [8h 8d] and lost with two pair, Kings and Eights
Seat 7: THREE FlDDY folded on the Flop
Seat 8: pikopikop folded before Flop (didn't bet)
Seat 9: ClassicWheel showed [Ad 5s] and won ($11.40) with two pair, Aces and Kings





PokerStars Hand #155373298996:  Hold'em No Limit ($0.50/$1.00 USD) - 2016/06/30 8:01:57 CET [2016/06/30 2:01:57 ET]
Table 'Asmodeus' 9-max Seat #9 is the button
Seat 2: gleam6619 ($96.27 in chips) 
Seat 4: matiko09 ($100 in chips) 
Seat 5: butcheN18 ($124.20 in chips) 
Seat 6: snow937022 ($108.12 in chips) 
Seat 7: master-udo ($42.91 in chips) 
Seat 9: flk.Dasas ($100 in chips) 
gleam6619: posts small blind $0.50
HasBigBiceps: is sitting out 
matiko09: posts big blind $1
*** HOLE CARDS ***
Dealt to matiko09 [9c 9s]
butcheN18: folds 
snow937022: folds 
master-udo: folds 
flk.Dasas: folds 
gleam6619: calls $0.50
matiko09: raises $3 to $4
gleam6619: folds 
Uncalled bet ($3) returned to matiko09
matiko09 collected $2 from pot
matiko09: doesn't show hand 
*** SUMMARY ***
Total pot $2 | Rake $0 
Seat 2: gleam6619 (small blind) folded before Flop
Seat 4: matiko09 (big blind) collected ($2)
Seat 5: butcheN18 folded before Flop (didn't bet)
Seat 6: snow937022 folded before Flop (didn't bet)
Seat 7: master-udo folded before Flop (didn't bet)
Seat 9: flk.Dasas (button) folded before Flop (didn't bet)





PokerStars Hand #155373304272:  Hold'em No Limit ($0.50/$1.00 USD) - 2016/06/30 8:02:19 CET [2016/06/30 2:02:19 ET]
Table 'Asmodeus' 9-max Seat #2 is the button
Seat 2: gleam6619 ($95.27 in chips) 
Seat 4: matiko09 ($101 in chips) 
Seat 5: butcheN18 ($124.20 in chips) 
Seat 6: snow937022 ($108.12 in chips) 
Seat 7: master-udo ($42.91 in chips) 
Seat 9: flk.Dasas ($100 in chips) 
matiko09: posts small blind $0.50
butcheN18: posts big blind $1
*** HOLE CARDS ***
Dealt to matiko09 [3c Tc]
snow937022: folds 
master-udo: folds 
Imbear8 joins the table at seat #1 
flk.Dasas: folds 
gleam6619: calls $1
matiko09: folds 
butcheN18: checks 
*** FLOP *** [7d 8c 8h]
butcheN18: checks 
gleam6619: bets $1.19
butcheN18: calls $1.19
*** TURN *** [7d 8c 8h] [3d]
butcheN18: checks 
gleam6619: checks 
*** RIVER *** [7d 8c 8h 3d] [5h]
butcheN18: checks 
gleam6619: checks 
*** SHOW DOWN ***
butcheN18: shows [Ad 7s] (two pair, Eights and Sevens)
gleam6619: mucks hand 
butcheN18 collected $4.64 from pot
*** SUMMARY ***
Total pot $4.88 | Rake $0.24 
Board [7d 8c 8h 3d 5h]
Seat 2: gleam6619 (button) mucked [Ac Jc]
Seat 4: matiko09 (small blind) folded before Flop
Seat 5: butcheN18 (big blind) showed [Ad 7s] and won ($4.64) with two pair, Eights and Sevens
Seat 6: snow937022 folded before Flop (didn't bet)
Seat 7: master-udo folded before Flop (didn't bet)
Seat 9: flk.Dasas folded before Flop (didn't bet)





PokerStars Hand #155373314512:  Hold'em No Limit ($0.50/$1.00 USD) - 2016/06/30 8:03:03 CET [2016/06/30 2:03:03 ET]
Table 'Euphrosyne' 9-max Seat #7 is the button
Seat 1: HasBigBiceps ($102 in chips) 
Seat 2: ilaviiitech ($100 in chips) 
Seat 3: picka4u ($36.25 in chips) 
Seat 4: John_les ($100 in chips) 
Seat 5: RoadtoNepal ($100 in chips) 
Seat 6: jeancalvi81 ($79.89 in chips) 
Seat 7: flk.Dasas ($104.15 in chips) 
Seat 8: Dantist1122 ($100 in chips) 
Seat 9: matiko09 ($100 in chips) 
Dantist1122: posts small blind $0.50
matiko09: posts big blind $1
*** HOLE CARDS ***
Dealt to matiko09 [9s Jd]
HasBigBiceps: folds 
HasBigBiceps leaves the table
ilaviiitech: raises $2 to $3
picka4u: folds 
John_les: folds 
RoadtoNepal: folds 
butcheN18 joins the table at seat #1 
jeancalvi81: folds 
flk.Dasas: calls $3
Dantist1122: folds 
matiko09: folds 
*** FLOP *** [6h Qd 8c]
ilaviiitech: bets $5
flk.Dasas: calls $5
*** TURN *** [6h Qd 8c] [Kc]
ilaviiitech: checks 
flk.Dasas: checks 
*** RIVER *** [6h Qd 8c Kc] [5h]
ilaviiitech: checks 
flk.Dasas: checks 
*** SHOW DOWN ***
ilaviiitech: shows [Th Ts] (a pair of Tens)
flk.Dasas: shows [Jh Js] (a pair of Jacks)
flk.Dasas collected $16.62 from pot
*** SUMMARY ***
Total pot $17.50 | Rake $0.88 
Board [6h Qd 8c Kc 5h]
Seat 1: HasBigBiceps folded before Flop (didn't bet)
Seat 2: ilaviiitech showed [Th Ts] and lost with a pair of Tens
Seat 3: picka4u folded before Flop (didn't bet)
Seat 4: John_les folded before Flop (didn't bet)
Seat 5: RoadtoNepal folded before Flop (didn't bet)
Seat 6: jeancalvi81 folded before Flop (didn't bet)
Seat 7: flk.Dasas (button) showed [Jh Js] and won ($16.62) with a pair of Jacks
Seat 8: Dantist1122 (small blind) folded before Flop
Seat 9: matiko09 (big blind) folded before Flop





PokerStars Hand #155373314946:  Hold'em No Limit ($0.50/$1.00 USD) - 2016/06/30 8:03:05 CET [2016/06/30 2:03:05 ET]
Table 'Asmodeus' 9-max Seat #4 is the button
Seat 1: Imbear8 ($100 in chips) 
Seat 2: gleam6619 ($93.08 in chips) 
Seat 4: matiko09 ($100.50 in chips) 
Seat 5: butcheN18 ($126.65 in chips) 
Seat 6: snow937022 ($108.12 in chips) 
Seat 7: master-udo ($42.91 in chips) 
Seat 9: flk.Dasas ($100 in chips) 
butcheN18: posts small blind $0.50
snow937022: posts big blind $1
Imbear8: posts big blind $1
*** HOLE CARDS ***
Dealt to matiko09 [Ad Th]
master-udo: folds 
flk.Dasas: raises $3 to $4
Imbear8: calls $3
gleam6619: folds 
matiko09: calls $4
butcheN18: calls $3.50
snow937022: folds 
*** FLOP *** [Qs 3d 4h]
butcheN18: checks 
flk.Dasas: bets $7.75
Imbear8: calls $7.75
matiko09: folds 
butcheN18: folds 
*** TURN *** [Qs 3d 4h] [Jc]
flk.Dasas: checks 
Imbear8: bets $15.44
flk.Dasas: folds 
Uncalled bet ($15.44) returned to Imbear8
Imbear8 collected $30.88 from pot
*** SUMMARY ***
Total pot $32.50 | Rake $1.62 
Board [Qs 3d 4h Jc]
Seat 1: Imbear8 collected ($30.88)
Seat 2: gleam6619 folded before Flop (didn't bet)
Seat 4: matiko09 (button) folded on the Flop
Seat 5: butcheN18 (small blind) folded on the Flop
Seat 6: snow937022 (big blind) folded before Flop
Seat 7: master-udo folded before Flop (didn't bet)
Seat 9: flk.Dasas folded on the Turn





PokerStars Hand #155373316405:  Hold'em No Limit ($0.25/$0.50 USD) - 2016/06/30 8:03:11 CET [2016/06/30 2:03:11 ET]
Table 'Ducrosa' 9-max Seat #2 is the button
Seat 1: Dantist1122 ($50 in chips) 
Seat 2: John_les ($50 in chips) 
Seat 3: matiko09 ($50 in chips) 
Seat 4: Lita17 ($57.25 in chips) 
Seat 7: THREE FlDDY ($50.61 in chips) 
Seat 8: pikopikop ($47.25 in chips) 
Seat 9: ClassicWheel ($43.75 in chips) 
matiko09: posts small blind $0.25
Lita17: posts big blind $0.50
POTAPENKO700: sits out 
*** HOLE CARDS ***
Dealt to matiko09 [7c Tc]
THREE FlDDY: folds 
pikopikop: folds 
ClassicWheel: folds 
Dantist1122: folds 
John_les: folds 
matiko09: raises $1 to $1.50
Lita17: calls $1
*** FLOP *** [9h Ts 5d]
matiko09: bets $1.85
Lita17: calls $1.85
*** TURN *** [9h Ts 5d] [Jc]
matiko09: checks 
Lita17: checks 
*** RIVER *** [9h Ts 5d Jc] [Kd]
matiko09: checks 
Lita17: checks 
*** SHOW DOWN ***
matiko09: shows [7c Tc] (a pair of Tens)
Lita17: shows [Th Ad] (a pair of Tens - Ace kicker)
Lita17 collected $6.36 from pot
*** SUMMARY ***
Total pot $6.70 | Rake $0.34 
Board [9h Ts 5d Jc Kd]
Seat 1: Dantist1122 folded before Flop (didn't bet)
Seat 2: John_les (button) folded before Flop (didn't bet)
Seat 3: matiko09 (small blind) showed [7c Tc] and lost with a pair of Tens
Seat 4: Lita17 (big blind) showed [Th Ad] and won ($6.36) with a pair of Tens
Seat 7: THREE FlDDY folded before Flop (didn't bet)
Seat 8: pikopikop folded before Flop (didn't bet)
Seat 9: ClassicWheel folded before Flop (didn't bet)





PokerStars Hand #155373327464:  Hold'em No Limit ($0.25/$0.50 USD) - 2016/06/30 8:03:58 CET [2016/06/30 2:03:58 ET]
Table 'Ducrosa' 9-max Seat #3 is the button
Seat 1: Dantist1122 ($50 in chips) 
Seat 2: John_les ($50 in chips) 
Seat 3: matiko09 ($50 in chips) 
Seat 4: Lita17 ($60.26 in chips) 
Seat 6: POTAPENKO700 ($50 in chips) 
Seat 7: THREE FlDDY ($50.61 in chips) 
Seat 8: pikopikop ($47.25 in chips) 
Seat 9: ClassicWheel ($43.75 in chips) 
Lita17: posts small blind $0.25
POTAPENKO700: posts big blind $0.50
*** HOLE CARDS ***
Dealt to matiko09 [3d 9h]
THREE FlDDY: folds 
pikopikop has timed out
pikopikop: folds 
ClassicWheel: folds 
Dantist1122: raises $1 to $1.50
John_les: folds 
matiko09: folds 
Lita17: calls $1.25
POTAPENKO700: folds 
*** FLOP *** [Qc Ts Td]
Lita17: checks 
Dantist1122: bets $1.82
Lita17: folds [Ah]
Uncalled bet ($1.82) returned to Dantist1122
Dantist1122 collected $3.32 from pot
Dantist1122: doesn't show hand 
*** SUMMARY ***
Total pot $3.50 | Rake $0.18 
Board [Qc Ts Td]
Seat 1: Dantist1122 collected ($3.32)
Seat 2: John_les folded before Flop (didn't bet)
Seat 3: matiko09 (button) folded before Flop (didn't bet)
Seat 4: Lita17 (small blind) folded on the Flop
Seat 6: POTAPENKO700 (big blind) folded before Flop
Seat 7: THREE FlDDY folded before Flop (didn't bet)
Seat 8: pikopikop folded before Flop (didn't bet)
Seat 9: ClassicWheel folded before Flop (didn't bet)





PokerStars Hand #155373338497:  Hold'em No Limit ($0.50/$1.00 USD) - 2016/06/30 8:04:44 CET [2016/06/30 2:04:44 ET]
Table 'Euphrosyne' 9-max Seat #8 is the button
Seat 1: butcheN18 ($100 in chips) 
Seat 2: ilaviiitech ($100 in chips) 
Seat 3: picka4u ($36.25 in chips) 
Seat 4: John_les ($100 in chips) 
Seat 5: RoadtoNepal ($100 in chips) 
Seat 6: jeancalvi81 ($79.89 in chips) 
Seat 7: flk.Dasas ($112.77 in chips) 
Seat 8: Dantist1122 ($100 in chips) 
Seat 9: matiko09 ($100 in chips) 
matiko09: posts small blind $0.50
butcheN18: posts big blind $1
*** HOLE CARDS ***
Dealt to matiko09 [Qd Jd]
ilaviiitech: folds 
picka4u: folds 
John_les: folds 
RoadtoNepal: folds 
jeancalvi81: folds 
flk.Dasas: raises $1.50 to $2.50
Dantist1122: folds 
matiko09: raises $6.50 to $9
butcheN18: folds 
flk.Dasas: folds 
Uncalled bet ($6.50) returned to matiko09
matiko09 collected $6 from pot
matiko09: doesn't show hand 
*** SUMMARY ***
Total pot $6 | Rake $0 
Seat 1: butcheN18 (big blind) folded before Flop
Seat 2: ilaviiitech folded before Flop (didn't bet)
Seat 3: picka4u folded before Flop (didn't bet)
Seat 4: John_les folded before Flop (didn't bet)
Seat 5: RoadtoNepal folded before Flop (didn't bet)
Seat 6: jeancalvi81 folded before Flop (didn't bet)
Seat 7: flk.Dasas folded before Flop
Seat 8: Dantist1122 (button) folded before Flop (didn't bet)
Seat 9: matiko09 (small blind) collected ($6)





PokerStars Hand #155373342125:  Hold'em No Limit ($0.50/$1.00 USD) - 2016/06/30 8:04:59 CET [2016/06/30 2:04:59 ET]
Table 'Asmodeus' 9-max Seat #5 is the button
Seat 1: Imbear8 ($119.13 in chips) 
Seat 2: gleam6619 ($93.08 in chips) 
Seat 4: matiko09 ($100 in chips) 
Seat 5: butcheN18 ($122.65 in chips) 
Seat 6: snow937022 ($107.12 in chips) 
Seat 7: master-udo ($42.91 in chips) 
Seat 9: flk.Dasas ($100 in chips) 
snow937022: posts small blind $0.50
master-udo: posts big blind $1
HasBigBiceps: sits out 
*** HOLE CARDS ***
Dealt to matiko09 [Ah 6c]
flk.Dasas: raises $2 to $3
Imbear8: folds 
gleam6619: folds 
matiko09: folds 
butcheN18: folds 
snow937022: folds 
master-udo: raises $5 to $8
flk.Dasas: raises $92 to $100 and is all-in
master-udo: calls $34.91 and is all-in
Uncalled bet ($57.09) returned to flk.Dasas
*** FLOP *** [Kh 7s 2d]
*** TURN *** [Kh 7s 2d] [9s]
*** RIVER *** [Kh 7s 2d 9s] [3h]
*** SHOW DOWN ***
master-udo: shows [Qs Qc] (a pair of Queens)
flk.Dasas: shows [As Ks] (a pair of Kings)
flk.Dasas collected $83.82 from pot
*** SUMMARY ***
Total pot $86.32 | Rake $2.50 
Board [Kh 7s 2d 9s 3h]
Seat 1: Imbear8 folded before Flop (didn't bet)
Seat 2: gleam6619 folded before Flop (didn't bet)
Seat 4: matiko09 folded before Flop (didn't bet)
Seat 5: butcheN18 (button) folded before Flop (didn't bet)
Seat 6: snow937022 (small blind) folded before Flop
Seat 7: master-udo (big blind) showed [Qs Qc] and lost with a pair of Queens
Seat 9: flk.Dasas showed [As Ks] and won ($83.82) with a pair of Kings





PokerStars Hand #155373342272:  Hold'em No Limit ($0.25/$0.50 USD) - 2016/06/30 8:05:00 CET [2016/06/30 2:05:00 ET]
Table 'Ducrosa' 9-max Seat #4 is the button
Seat 1: Dantist1122 ($51.82 in chips) 
Seat 2: John_les ($50 in chips) 
Seat 3: matiko09 ($50 in chips) 
Seat 4: Lita17 ($58.76 in chips) 
Seat 6: POTAPENKO700 ($50 in chips) 
Seat 7: THREE FlDDY ($50.61 in chips) 
Seat 8: pikopikop ($47.25 in chips) 
Seat 9: ClassicWheel ($43.75 in chips) 
POTAPENKO700: posts small blind $0.25
THREE FlDDY: posts big blind $0.50
*** HOLE CARDS ***
Dealt to matiko09 [4d 5h]
pikopikop: raises $1 to $1.50
ClassicWheel: folds 
Dantist1122: folds 
John_les: folds 
matiko09: folds 
Lita17: calls $1.50
POTAPENKO700: folds 
THREE FlDDY: folds 
*** FLOP *** [Qc 6c 5d]
pikopikop: bets $3.56
Lita17: calls $3.56
*** TURN *** [Qc 6c 5d] [8c]
pikopikop: bets $9
beetge joins the table at seat #5 
Lita17: calls $9
*** RIVER *** [Qc 6c 5d 8c] [Jc]
pikopikop: checks 
Lita17: bets $15.50
pikopikop: folds 
Uncalled bet ($15.50) returned to Lita17
Lita17 collected $27.43 from pot
Lita17: doesn't show hand 
*** SUMMARY ***
Total pot $28.87 | Rake $1.44 
Board [Qc 6c 5d 8c Jc]
Seat 1: Dantist1122 folded before Flop (didn't bet)
Seat 2: John_les folded before Flop (didn't bet)
Seat 3: matiko09 folded before Flop (didn't bet)
Seat 4: Lita17 (button) collected ($27.43)
Seat 6: POTAPENKO700 (small blind) folded before Flop
Seat 7: THREE FlDDY (big blind) folded before Flop
Seat 8: pikopikop folded on the River
Seat 9: ClassicWheel folded before Flop (didn't bet)





PokerStars Hand #155373346989:  Hold'em No Limit ($0.50/$1.00 USD) - 2016/06/30 8:05:20 CET [2016/06/30 2:05:20 ET]
Table 'Apisaon II' 9-max Seat #1 is the button
Seat 1: Adyboo ($79.53 in chips) 
Seat 2: FroggyPlay ($100.70 in chips) 
Seat 4: matiko09 ($100 in chips) 
FroggyPlay: posts small blind $0.50
matiko09: posts big blind $1
Adyboo: posts the ante $0.20
FroggyPlay: posts the ante $0.20
matiko09: posts the ante $0.20
*** HOLE CARDS ***
Dealt to matiko09 [Jd 8c]
Adyboo: folds 
FroggyPlay: raises $2 to $3
matiko09: calls $2
*** FLOP *** [Qc 3h Jc]
Adyboo leaves the table
Dantist1122 joins the table at seat #5 
FroggyPlay: checks 
matiko09: checks 
*** TURN *** [Qc 3h Jc] [Th]
HasBigBiceps leaves the table
FroggyPlay: checks 
matiko09: checks 
*** RIVER *** [Qc 3h Jc Th] [2d]
FroggyPlay: checks 
matiko09: checks 
*** SHOW DOWN ***
FroggyPlay: shows [Ah 5h] (high card Ace)
matiko09: shows [Jd 8c] (a pair of Jacks)
matiko09 collected $6.27 from pot
*** SUMMARY ***
Total pot $6.60 | Rake $0.33 
Board [Qc 3h Jc Th 2d]
Seat 1: Adyboo (button) folded before Flop (didn't bet)
Seat 2: FroggyPlay (small blind) showed [Ah 5h] and lost with high card Ace
Seat 4: matiko09 (big blind) showed [Jd 8c] and won ($6.27) with a pair of Jacks





PokerStars Hand #155373359146:  Hold'em No Limit ($0.50/$1.00 USD) - 2016/06/30 8:06:11 CET [2016/06/30 2:06:11 ET]
Table 'Asmodeus' 9-max Seat #6 is the button
Seat 2: gleam6619 ($93.08 in chips) 
Seat 4: matiko09 ($100 in chips) 
Seat 5: butcheN18 ($122.65 in chips) 
Seat 6: snow937022 ($106.62 in chips) 
Seat 9: flk.Dasas ($140.91 in chips) 
flk.Dasas: posts small blind $0.50
Imbear8 is disconnected 
Imbear8 is connected 
master-udo leaves the table
Imbear8 has timed out while being disconnected
Imbear8: is sitting out 
gleam6619: posts big blind $1
HasBigBiceps: sits out 
*** HOLE CARDS ***
Dealt to matiko09 [Th 5d]
matiko09: folds 
butcheN18: folds 
snow937022: raises $1.25 to $2.25
picka4u joins the table at seat #7 
Imbear8 is disconnected 
flk.Dasas: folds 
gleam6619: folds 
Uncalled bet ($1.25) returned to snow937022
snow937022 collected $2.50 from pot
snow937022: doesn't show hand 
*** SUMMARY ***
Total pot $2.50 | Rake $0 
Seat 2: gleam6619 (big blind) folded before Flop
Seat 4: matiko09 folded before Flop (didn't bet)
Seat 5: butcheN18 folded before Flop (didn't bet)
Seat 6: snow937022 (button) collected ($2.50)
Seat 9: flk.Dasas (small blind) folded before Flop





PokerStars Hand #155373359559:  Hold'em No Limit ($0.50/$1.00 USD) - 2016/06/30 8:06:12 CET [2016/06/30 2:06:12 ET]
Table 'Euphrosyne' 9-max Seat #9 is the button
Seat 1: butcheN18 ($100 in chips) 
Seat 2: ilaviiitech ($100 in chips) 
Seat 3: picka4u ($36.25 in chips) 
Seat 4: John_les ($100 in chips) 
Seat 5: RoadtoNepal ($100 in chips) 
Seat 6: jeancalvi81 ($79.89 in chips) 
Seat 7: flk.Dasas ($110.27 in chips) 
Seat 8: Dantist1122 ($100 in chips) 
Seat 9: matiko09 ($103.50 in chips) 
butcheN18: posts small blind $0.50
ilaviiitech: posts big blind $1
*** HOLE CARDS ***
Dealt to matiko09 [4h Kd]
picka4u: folds 
John_les: raises $2.50 to $3.50
RoadtoNepal: folds 
jeancalvi81: calls $3.50
flk.Dasas: folds 
Dantist1122: folds 
matiko09: folds 
butcheN18: folds 
ilaviiitech: folds 
*** FLOP *** [Tc Td 7c]
John_les: bets $5.41
jeancalvi81: calls $5.41
*** TURN *** [Tc Td 7c] [Qs]
John_les: checks 
jeancalvi81: checks 
*** RIVER *** [Tc Td 7c Qs] [7d]
John_les: checks 
jeancalvi81: bets $8
John_les: calls $8
*** SHOW DOWN ***
jeancalvi81: shows [6c 6h] (two pair, Tens and Sevens)
John_les: shows [Kc As] (two pair, Tens and Sevens - Ace kicker)
John_les collected $33.55 from pot
*** SUMMARY ***
Total pot $35.32 | Rake $1.77 
Board [Tc Td 7c Qs 7d]
Seat 1: butcheN18 (small blind) folded before Flop
Seat 2: ilaviiitech (big blind) folded before Flop
Seat 3: picka4u folded before Flop (didn't bet)
Seat 4: John_les showed [Kc As] and won ($33.55) with two pair, Tens and Sevens
Seat 5: RoadtoNepal folded before Flop (didn't bet)
Seat 6: jeancalvi81 showed [6c 6h] and lost with two pair, Tens and Sevens
Seat 7: flk.Dasas folded before Flop (didn't bet)
Seat 8: Dantist1122 folded before Flop (didn't bet)
Seat 9: matiko09 (button) folded before Flop (didn't bet)





PokerStars Hand #155373360650:  Hold'em No Limit ($0.50/$1.00 USD) - 2016/06/30 8:06:17 CET [2016/06/30 2:06:17 ET]
Table 'Apisaon II' 9-max Seat #2 is the button
Seat 2: FroggyPlay ($97.50 in chips) 
Seat 4: matiko09 ($103.07 in chips) 
Seat 5: Dantist1122 ($100 in chips) 
matiko09: posts small blind $0.50
Dantist1122: posts big blind $1
FroggyPlay: posts the ante $0.20
matiko09: posts the ante $0.20
Dantist1122: posts the ante $0.20
*** HOLE CARDS ***
Dealt to matiko09 [8d Ks]
FroggyPlay: raises $1 to $2
matiko09: folds 
Dantist1122: calls $1
*** FLOP *** [4h 9d Qh]
Dantist1122: checks 
FroggyPlay: bets $2.42
matiko09 leaves the table
Dantist1122: folds 
Uncalled bet ($2.42) returned to FroggyPlay
FroggyPlay collected $4.84 from pot
FroggyPlay: doesn't show hand 
*** SUMMARY ***
Total pot $5.10 | Rake $0.26 
Board [4h 9d Qh]
Seat 2: FroggyPlay (button) collected ($4.84)
Seat 4: matiko09 (small blind) folded before Flop
Seat 5: Dantist1122 (big blind) folded on the Flop





PokerStars Hand #155373368466:  Hold'em No Limit ($0.25/$0.50 USD) - 2016/06/30 8:06:50 CET [2016/06/30 2:06:50 ET]
Table 'Ducrosa' 9-max Seat #6 is the button
Seat 1: Dantist1122 ($51.82 in chips) 
Seat 2: John_les ($50 in chips) 
Seat 3: matiko09 ($50 in chips) 
Seat 4: Lita17 ($72.13 in chips) 
Seat 5: beetge ($40 in chips) 
Seat 6: POTAPENKO700 ($50 in chips) 
Seat 7: THREE FlDDY ($50.11 in chips) 
Seat 8: pikopikop ($33.19 in chips) 
Seat 9: ClassicWheel ($43.75 in chips) 
THREE FlDDY: posts small blind $0.25
pikopikop: posts big blind $0.50
beetge: posts big blind $0.50
*** HOLE CARDS ***
Dealt to matiko09 [Jh Qc]
ClassicWheel: folds 
Dantist1122: raises $1.50 to $2
John_les: folds 
matiko09: folds 
Lita17: folds 
beetge: folds 
POTAPENKO700: folds 
THREE FlDDY: folds 
pikopikop: folds 
Uncalled bet ($1.50) returned to Dantist1122
Dantist1122 collected $1.75 from pot
Dantist1122: doesn't show hand 
*** SUMMARY ***
Total pot $1.75 | Rake $0 
Seat 1: Dantist1122 collected ($1.75)
Seat 2: John_les folded before Flop (didn't bet)
Seat 3: matiko09 folded before Flop (didn't bet)
Seat 4: Lita17 folded before Flop (didn't bet)
Seat 5: beetge folded before Flop
Seat 6: POTAPENKO700 (button) folded before Flop (didn't bet)
Seat 7: THREE FlDDY (small blind) folded before Flop
Seat 8: pikopikop (big blind) folded before Flop
Seat 9: ClassicWheel folded before Flop (didn't bet)





PokerStars Hand #155373376939:  Hold'em No Limit ($0.25/$0.50 USD) - 2016/06/30 8:07:25 CET [2016/06/30 2:07:25 ET]
Table 'Ducrosa' 9-max Seat #7 is the button
Seat 1: Dantist1122 ($53.07 in chips) 
Seat 2: John_les ($50 in chips) 
Seat 3: matiko09 ($50 in chips) 
Seat 4: Lita17 ($72.13 in chips) 
Seat 5: beetge ($39.50 in chips) 
Seat 6: POTAPENKO700 ($50 in chips) 
Seat 7: THREE FlDDY ($50 in chips) 
Seat 8: pikopikop ($32.69 in chips) 
Seat 9: ClassicWheel ($43.75 in chips) 
pikopikop: posts small blind $0.25
ClassicWheel: posts big blind $0.50
*** HOLE CARDS ***
Dealt to matiko09 [5c 2d]
Dantist1122: folds 
John_les: folds 
matiko09: folds 
Lita17: folds 
beetge: folds 
POTAPENKO700: raises $0.75 to $1.25
THREE FlDDY: folds 
pikopikop: folds 
ClassicWheel: folds 
Uncalled bet ($0.75) returned to POTAPENKO700
POTAPENKO700 collected $1.25 from pot
POTAPENKO700: doesn't show hand 
*** SUMMARY ***
Total pot $1.25 | Rake $0 
Seat 1: Dantist1122 folded before Flop (didn't bet)
Seat 2: John_les folded before Flop (didn't bet)
Seat 3: matiko09 folded before Flop (didn't bet)
Seat 4: Lita17 folded before Flop (didn't bet)
Seat 5: beetge folded before Flop (didn't bet)
Seat 6: POTAPENKO700 collected ($1.25)
Seat 7: THREE FlDDY (button) folded before Flop (didn't bet)
Seat 8: pikopikop (small blind) folded before Flop
Seat 9: ClassicWheel (big blind) folded before Flop





PokerStars Hand #155373379783:  Hold'em No Limit ($0.50/$1.00 USD) - 2016/06/30 8:07:38 CET [2016/06/30 2:07:38 ET]
Table 'Asmodeus' 9-max Seat #9 is the button
Seat 2: gleam6619 ($92.08 in chips) 
Seat 4: matiko09 ($100 in chips) 
Seat 5: butcheN18 ($122.65 in chips) 
Seat 6: snow937022 ($108.12 in chips) 
Seat 9: flk.Dasas ($140.41 in chips) 
gleam6619: posts small blind $0.50
matiko09: posts big blind $1
picka4u: sits out 
*** HOLE CARDS ***
Dealt to matiko09 [Ts 3d]
HasBigBiceps leaves the table
L4zy_FiSh joins the table at seat #3 
butcheN18: folds 
snow937022: folds 
flk.Dasas has timed out
flk.Dasas: folds 
gleam6619: folds 
Uncalled bet ($0.50) returned to matiko09
matiko09 collected $1 from pot
matiko09: doesn't show hand 
*** SUMMARY ***
Total pot $1 | Rake $0 
Seat 2: gleam6619 (small blind) folded before Flop
Seat 4: matiko09 (big blind) collected ($1)
Seat 5: butcheN18 folded before Flop (didn't bet)
Seat 6: snow937022 folded before Flop (didn't bet)
Seat 9: flk.Dasas (button) folded before Flop (didn't bet)





PokerStars Hand #155373382506:  Hold'em No Limit ($0.25/$0.50 USD) - 2016/06/30 8:07:49 CET [2016/06/30 2:07:49 ET]
Table 'Ducrosa' 9-max Seat #8 is the button
Seat 1: Dantist1122 ($53.07 in chips) 
Seat 2: John_les ($50 in chips) 
Seat 3: matiko09 ($50 in chips) 
Seat 4: Lita17 ($72.13 in chips) 
Seat 5: beetge ($39.50 in chips) 
Seat 6: POTAPENKO700 ($50.75 in chips) 
Seat 7: THREE FlDDY ($50 in chips) 
Seat 8: pikopikop ($32.44 in chips) 
Seat 9: ClassicWheel ($43.25 in chips) 
ClassicWheel: posts small blind $0.25
Dantist1122: posts big blind $0.50
*** HOLE CARDS ***
Dealt to matiko09 [3s 4h]
John_les: raises $1.25 to $1.75
matiko09: folds 
Lita17: folds 
beetge: folds 
POTAPENKO700: folds 
THREE FlDDY: calls $1.75
pikopikop: calls $1.75
ClassicWheel: calls $1.50
Dantist1122: folds 
*** FLOP *** [2s Ts Jc]
ClassicWheel: checks 
John_les: checks 
THREE FlDDY: checks 
pikopikop: bets $7.12
ClassicWheel: folds 
John_les: folds 
THREE FlDDY: folds 
Uncalled bet ($7.12) returned to pikopikop
pikopikop collected $7.12 from pot
pikopikop: doesn't show hand 
*** SUMMARY ***
Total pot $7.50 | Rake $0.38 
Board [2s Ts Jc]
Seat 1: Dantist1122 (big blind) folded before Flop
Seat 2: John_les folded on the Flop
Seat 3: matiko09 folded before Flop (didn't bet)
Seat 4: Lita17 folded before Flop (didn't bet)
Seat 5: beetge folded before Flop (didn't bet)
Seat 6: POTAPENKO700 folded before Flop (didn't bet)
Seat 7: THREE FlDDY folded on the Flop
Seat 8: pikopikop (button) collected ($7.12)
Seat 9: ClassicWheel (small blind) folded on the Flop





PokerStars Hand #155373382709:  Hold'em No Limit ($0.50/$1.00 USD) - 2016/06/30 8:07:50 CET [2016/06/30 2:07:50 ET]
Table 'Hippokoon' 9-max Seat #1 is the button
Seat 1: Adyboo ($157.66 in chips) 
Seat 5: ryalambert ($20.67 in chips) 
Seat 6: matiko09 ($100 in chips) 
HasBigBiceps will be allowed to play after the button
ryalambert: posts small blind $0.50
matiko09: posts big blind $1
Dantist1122: sits out 
Adyboo: posts the ante $0.20
ryalambert: posts the ante $0.20
matiko09: posts the ante $0.20
*** HOLE CARDS ***
Dealt to matiko09 [5d Kd]
Adyboo: folds 
Adyboo leaves the table
ryalambert: calls $0.50
HasBigBiceps leaves the table
matiko09: checks 
*** FLOP *** [8s 9h Jd]
ryalambert: bets $2
matiko09: folds 
Uncalled bet ($2) returned to ryalambert
ryalambert collected $2.47 from pot
ryalambert: doesn't show hand 
*** SUMMARY ***
Total pot $2.60 | Rake $0.13 
Board [8s 9h Jd]
Seat 1: Adyboo (button) folded before Flop (didn't bet)
Seat 5: ryalambert (small blind) collected ($2.47)
Seat 6: matiko09 (big blind) folded on the Flop





PokerStars Hand #155373382917:  Hold'em No Limit ($0.25/$0.50 USD) - 2016/06/30 8:07:51 CET [2016/06/30 2:07:51 ET]
Table 'Praxidike' 9-max Seat #4 is the button
Seat 1: Sniper1717 ($50 in chips) 
Seat 2: prominente ($177.25 in chips) 
Seat 3: THREE FlDDY ($50 in chips) 
Seat 4: nicklasrossd ($21.75 in chips) 
Seat 5: shiangshuina ($50.65 in chips) 
Seat 7: matiko09 ($50 in chips) 
Seat 8: Alexey_Kim2 ($50 in chips) 
Seat 9: santa88188 ($46.67 in chips) 
shiangshuina: posts small blind $0.25
matiko09: posts big blind $0.50
*** HOLE CARDS ***
Dealt to matiko09 [7s 9d]
Alexey_Kim2: folds 
santa88188: folds 
Sniper1717: folds 
prominente: folds 
THREE FlDDY: folds 
nicklasrossd: folds 
shiangshuina: raises $0.50 to $1
matiko09: folds 
Uncalled bet ($0.50) returned to shiangshuina
shiangshuina collected $1 from pot
shiangshuina: doesn't show hand 
*** SUMMARY ***
Total pot $1 | Rake $0 
Seat 1: Sniper1717 folded before Flop (didn't bet)
Seat 2: prominente folded before Flop (didn't bet)
Seat 3: THREE FlDDY folded before Flop (didn't bet)
Seat 4: nicklasrossd (button) folded before Flop (didn't bet)
Seat 5: shiangshuina (small blind) collected ($1)
Seat 7: matiko09 (big blind) folded before Flop
Seat 8: Alexey_Kim2 folded before Flop (didn't bet)
Seat 9: santa88188 folded before Flop (didn't bet)





PokerStars Hand #155373390123:  Hold'em No Limit ($0.25/$0.50 USD) - 2016/06/30 8:08:21 CET [2016/06/30 2:08:21 ET]
Table 'Praxidike' 9-max Seat #5 is the button
Seat 1: Sniper1717 ($50 in chips) 
Seat 2: prominente ($177.25 in chips) 
Seat 3: THREE FlDDY ($50 in chips) 
Seat 4: nicklasrossd ($21.75 in chips) 
Seat 5: shiangshuina ($51.15 in chips) 
Seat 7: matiko09 ($50 in chips) 
Seat 8: Alexey_Kim2 ($50 in chips) 
Seat 9: santa88188 ($46.67 in chips) 
matiko09: posts small blind $0.25
Alexey_Kim2: posts big blind $0.50
*** HOLE CARDS ***
Dealt to matiko09 [2c Ac]
santa88188: folds 
Sniper1717: folds 
prominente: folds 
THREE FlDDY: folds 
nicklasrossd: calls $0.50
shiangshuina: folds 
matiko09: raises $1.50 to $2
Alexey_Kim2: folds 
nicklasrossd: calls $1.50
*** FLOP *** [4c 8c Qh]
matiko09: checks 
nicklasrossd: checks 
*** TURN *** [4c 8c Qh] [8d]
matiko09: checks 
nicklasrossd: bets $2
matiko09: calls $2
*** RIVER *** [4c 8c Qh 8d] [8s]
matiko09: checks 
nicklasrossd: bets $4
matiko09: folds 
Uncalled bet ($4) returned to nicklasrossd
nicklasrossd collected $8.08 from pot
nicklasrossd: doesn't show hand 
*** SUMMARY ***
Total pot $8.50 | Rake $0.42 
Board [4c 8c Qh 8d 8s]
Seat 1: Sniper1717 folded before Flop (didn't bet)
Seat 2: prominente folded before Flop (didn't bet)
Seat 3: THREE FlDDY folded before Flop (didn't bet)
Seat 4: nicklasrossd collected ($8.08)
Seat 5: shiangshuina (button) folded before Flop (didn't bet)
Seat 7: matiko09 (small blind) folded on the River
Seat 8: Alexey_Kim2 (big blind) folded before Flop
Seat 9: santa88188 folded before Flop (didn't bet)





PokerStars Hand #155373391046:  Hold'em No Limit ($0.50/$1.00 USD) - 2016/06/30 8:08:25 CET [2016/06/30 2:08:25 ET]
Table 'Asmodeus' 9-max Seat #2 is the button
Seat 2: gleam6619 ($91.58 in chips) 
Seat 4: matiko09 ($100.50 in chips) 
Seat 5: butcheN18 ($122.65 in chips) 
Seat 6: snow937022 ($108.12 in chips) 
L4zy_FiSh will be allowed to play after the button
matiko09: posts small blind $0.50
butcheN18: posts big blind $1
picka4u: sits out 
*** HOLE CARDS ***
Dealt to matiko09 [7c Ad]
snow937022: folds 
gleam6619: folds 
matiko09: raises $2 to $3
butcheN18: raises $6 to $9
matiko09: folds 
Uncalled bet ($6) returned to butcheN18
butcheN18 collected $6 from pot
butcheN18: doesn't show hand 
*** SUMMARY ***
Total pot $6 | Rake $0 
Seat 2: gleam6619 (button) folded before Flop (didn't bet)
Seat 4: matiko09 (small blind) folded before Flop
Seat 5: butcheN18 (big blind) collected ($6)
Seat 6: snow937022 folded before Flop (didn't bet)





PokerStars Hand #155373391318:  Hold'em No Limit ($0.50/$1.00 USD) - 2016/06/30 8:08:26 CET [2016/06/30 2:08:26 ET]
Table 'Hippokoon' 9-max Seat #5 is the button
Seat 5: ryalambert ($21.94 in chips) 
Seat 6: matiko09 ($100 in chips) 
Seat 7: Dantist1122 ($100 in chips) 
matiko09: posts small blind $0.50
Dantist1122: posts big blind $1
ryalambert: posts the ante $0.20
matiko09: posts the ante $0.20
Dantist1122: posts the ante $0.20
*** HOLE CARDS ***
Dealt to matiko09 [2s Qc]
ryalambert: calls $1
matiko09: folds 
Dantist1122: checks 
*** FLOP *** [3c 6d 8d]
Dantist1122: bets $2.26
ryalambert: calls $2.26
*** TURN *** [3c 6d 8d] [Ks]
Dantist1122: checks 
ryalambert: bets $5
Dantist1122: folds 
Uncalled bet ($5) returned to ryalambert
ryalambert collected $7.24 from pot
ryalambert: doesn't show hand 
*** SUMMARY ***
Total pot $7.62 | Rake $0.38 
Board [3c 6d 8d Ks]
Seat 5: ryalambert (button) collected ($7.24)
Seat 6: matiko09 (small blind) folded before Flop
Seat 7: Dantist1122 (big blind) folded on the Turn





PokerStars Hand #155373397500:  Hold'em No Limit ($0.50/$1.00 USD) - 2016/06/30 8:08:53 CET [2016/06/30 2:08:53 ET]
Table 'Asmodeus' 9-max Seat #4 is the button
Seat 2: gleam6619 ($91.58 in chips) 
Seat 4: matiko09 ($100 in chips) 
Seat 5: butcheN18 ($125.65 in chips) 
Seat 6: snow937022 ($108.12 in chips) 
Seat 9: flk.Dasas ($140.41 in chips) 
butcheN18: posts small blind $0.50
snow937022: posts big blind $1
picka4u: sits out 
RoadtoNepal: sits out 
L4zy_FiSh: sits out 
*** HOLE CARDS ***
Dealt to matiko09 [Jh 5c]
flk.Dasas: folds 
gleam6619: folds 
matiko09: folds 
butcheN18: raises $1.44 to $2.44
snow937022: folds 
Uncalled bet ($1.44) returned to butcheN18
butcheN18 collected $2 from pot
butcheN18: doesn't show hand 
*** SUMMARY ***
Total pot $2 | Rake $0 
Seat 2: gleam6619 folded before Flop (didn't bet)
Seat 4: matiko09 (button) folded before Flop (didn't bet)
Seat 5: butcheN18 (small blind) collected ($2)
Seat 6: snow937022 (big blind) folded before Flop
Seat 9: flk.Dasas folded before Flop (didn't bet)





PokerStars Hand #155373397673:  Hold'em No Limit ($0.50/$1.00 USD) - 2016/06/30 8:08:53 CET [2016/06/30 2:08:53 ET]
Table 'Euphrosyne' 9-max Seat #1 is the button
Seat 1: butcheN18 ($100 in chips) 
Seat 2: ilaviiitech ($100 in chips) 
Seat 3: picka4u ($36.25 in chips) 
Seat 4: John_les ($116.64 in chips) 
Seat 5: RoadtoNepal ($100 in chips) 
Seat 6: jeancalvi81 ($62.98 in chips) 
Seat 7: flk.Dasas ($110.27 in chips) 
Seat 8: Dantist1122 ($100 in chips) 
Seat 9: matiko09 ($103.50 in chips) 
ilaviiitech: posts small blind $0.50
picka4u: posts big blind $1
*** HOLE CARDS ***
Dealt to matiko09 [As 9s]
John_les: folds 
RoadtoNepal: folds 
jeancalvi81: raises $1.50 to $2.50
flk.Dasas: raises $5.50 to $8
Dantist1122: folds 
matiko09: folds 
butcheN18: folds 
ilaviiitech: folds 
picka4u: raises $28.25 to $36.25 and is all-in
jeancalvi81: folds 
flk.Dasas: folds 
Uncalled bet ($28.25) returned to picka4u
picka4u collected $19 from pot
picka4u: doesn't show hand 
*** SUMMARY ***
Total pot $19 | Rake $0 
Seat 1: butcheN18 (button) folded before Flop (didn't bet)
Seat 2: ilaviiitech (small blind) folded before Flop
Seat 3: picka4u (big blind) collected ($19)
Seat 4: John_les folded before Flop (didn't bet)
Seat 5: RoadtoNepal folded before Flop (didn't bet)
Seat 6: jeancalvi81 folded before Flop
Seat 7: flk.Dasas folded before Flop
Seat 8: Dantist1122 folded before Flop (didn't bet)
Seat 9: matiko09 folded before Flop (didn't bet)





PokerStars Hand #155373400385:  Hold'em No Limit ($0.25/$0.50 USD) - 2016/06/30 8:09:05 CET [2016/06/30 2:09:05 ET]
Table 'Ducrosa' 9-max Seat #9 is the button
Seat 1: Dantist1122 ($52.57 in chips) 
Seat 2: John_les ($50 in chips) 
Seat 3: matiko09 ($50 in chips) 
Seat 4: Lita17 ($72.13 in chips) 
Seat 5: beetge ($39.50 in chips) 
Seat 6: POTAPENKO700 ($50.75 in chips) 
Seat 7: THREE FlDDY ($50 in chips) 
Seat 8: pikopikop ($37.81 in chips) 
Seat 9: ClassicWheel ($41.50 in chips) 
Dantist1122: posts small blind $0.25
John_les: posts big blind $0.50
*** HOLE CARDS ***
Dealt to matiko09 [8h 2s]
matiko09: folds 
Lita17: folds 
beetge: folds 
POTAPENKO700 has timed out
POTAPENKO700: folds 
THREE FlDDY: folds 
pikopikop: folds 
ClassicWheel: raises $1 to $1.50
Dantist1122: folds 
John_les: folds 
Uncalled bet ($1) returned to ClassicWheel
ClassicWheel collected $1.25 from pot
ClassicWheel: doesn't show hand 
*** SUMMARY ***
Total pot $1.25 | Rake $0 
Seat 1: Dantist1122 (small blind) folded before Flop
Seat 2: John_les (big blind) folded before Flop
Seat 3: matiko09 folded before Flop (didn't bet)
Seat 4: Lita17 folded before Flop (didn't bet)
Seat 5: beetge folded before Flop (didn't bet)
Seat 6: POTAPENKO700 folded before Flop (didn't bet)
Seat 7: THREE FlDDY folded before Flop (didn't bet)
Seat 8: pikopikop folded before Flop (didn't bet)
Seat 9: ClassicWheel (button) collected ($1.25)





PokerStars Hand #155373403606:  Hold'em No Limit ($0.50/$1.00 USD) - 2016/06/30 8:09:19 CET [2016/06/30 2:09:19 ET]
Table 'Asmodeus' 9-max Seat #5 is the button
Seat 2: gleam6619 ($91.58 in chips) 
Seat 4: matiko09 ($100 in chips) 
Seat 5: butcheN18 ($126.65 in chips) 
Seat 6: snow937022 ($107.12 in chips) 
Seat 7: picka4u ($40 in chips) 
Seat 9: flk.Dasas ($140.41 in chips) 
snow937022: posts small blind $0.50
picka4u: posts big blind $1
RoadtoNepal: sits out 
L4zy_FiSh: sits out 
*** HOLE CARDS ***
Dealt to matiko09 [6c 2h]
flk.Dasas: folds 
gleam6619: raises $1 to $2
matiko09: folds 
butcheN18: calls $2
snow937022: folds 
picka4u: folds 
*** FLOP *** [Jd 8c 4c]
gleam6619: bets $2.61
butcheN18: calls $2.61
*** TURN *** [Jd 8c 4c] [2d]
gleam6619: bets $5.09
butcheN18: folds 
Uncalled bet ($5.09) returned to gleam6619
gleam6619 collected $10.18 from pot
gleam6619: doesn't show hand 
*** SUMMARY ***
Total pot $10.72 | Rake $0.54 
Board [Jd 8c 4c 2d]
Seat 2: gleam6619 collected ($10.18)
Seat 4: matiko09 folded before Flop (didn't bet)
Seat 5: butcheN18 (button) folded on the Turn
Seat 6: snow937022 (small blind) folded before Flop
Seat 7: picka4u (big blind) folded before Flop
Seat 9: flk.Dasas folded before Flop (didn't bet)





PokerStars Hand #155373408648:  Hold'em No Limit ($0.50/$1.00 USD) - 2016/06/30 8:09:40 CET [2016/06/30 2:09:40 ET]
Table 'Hippokoon' 9-max Seat #6 is the button
Seat 5: ryalambert ($25.72 in chips) 
Seat 6: matiko09 ($100 in chips) 
Seat 7: Dantist1122 ($100 in chips) 
Dantist1122: posts small blind $0.50
ryalambert: posts big blind $1
ryalambert: posts the ante $0.20
matiko09: posts the ante $0.20
Dantist1122: posts the ante $0.20
*** HOLE CARDS ***
Dealt to matiko09 [Ac 4c]
matiko09: raises $1.27 to $2.27
Dantist1122: folds 
ryalambert: folds 
Uncalled bet ($1.27) returned to matiko09
ryalambert leaves the table
matiko09 collected $3.10 from pot
matiko09: doesn't show hand 
*** SUMMARY ***
Total pot $3.10 | Rake $0 
Seat 5: ryalambert (big blind) folded before Flop
Seat 6: matiko09 (button) collected ($3.10)
Seat 7: Dantist1122 (small blind) folded before Flop





PokerStars Hand #155373410202:  Hold'em No Limit ($0.25/$0.50 USD) - 2016/06/30 8:09:46 CET [2016/06/30 2:09:46 ET]
Table 'Ducrosa' 9-max Seat #1 is the button
Seat 1: Dantist1122 ($52.32 in chips) 
Seat 2: John_les ($50 in chips) 
Seat 3: matiko09 ($50 in chips) 
Seat 4: Lita17 ($72.13 in chips) 
Seat 5: beetge ($39.50 in chips) 
Seat 7: THREE FlDDY ($50 in chips) 
Seat 8: pikopikop ($37.81 in chips) 
Seat 9: ClassicWheel ($42.25 in chips) 
John_les: posts small blind $0.25
matiko09: posts big blind $0.50
*** HOLE CARDS ***
Dealt to matiko09 [Ah 6c]
Lita17: raises $1 to $1.50
beetge: folds 
THREE FlDDY: folds 
pikopikop: folds 
ClassicWheel: folds 
Dantist1122: folds 
John_les: folds 
matiko09: folds 
Uncalled bet ($1) returned to Lita17
Lita17 collected $1.25 from pot
Lita17: doesn't show hand 
*** SUMMARY ***
Total pot $1.25 | Rake $0 
Seat 1: Dantist1122 (button) folded before Flop (didn't bet)
Seat 2: John_les (small blind) folded before Flop
Seat 3: matiko09 (big blind) folded before Flop
Seat 4: Lita17 collected ($1.25)
Seat 5: beetge folded before Flop (didn't bet)
Seat 7: THREE FlDDY folded before Flop (didn't bet)
Seat 8: pikopikop folded before Flop (didn't bet)
Seat 9: ClassicWheel folded before Flop (didn't bet)





PokerStars Hand #155373410227:  Hold'em No Limit ($0.50/$1.00 USD) - 2016/06/30 8:09:47 CET [2016/06/30 2:09:47 ET]
Table 'Euphrosyne' 9-max Seat #2 is the button
Seat 1: butcheN18 ($100 in chips) 
Seat 2: ilaviiitech ($100 in chips) 
Seat 3: picka4u ($47.25 in chips) 
Seat 5: RoadtoNepal ($100 in chips) 
Seat 6: jeancalvi81 ($60.48 in chips) 
Seat 7: flk.Dasas ($102.27 in chips) 
Seat 8: Dantist1122 ($100 in chips) 
Seat 9: matiko09 ($103.50 in chips) 
picka4u: posts small blind $0.50
John_les: is sitting out 
RoadtoNepal: posts big blind $1
*** HOLE CARDS ***
Dealt to matiko09 [8h Kd]
jeancalvi81: folds 
John_les leaves the table
flk.Dasas: folds 
bargs33 joins the table at seat #4 
Dantist1122: folds 
matiko09: folds 
butcheN18: folds 
ilaviiitech: folds 
picka4u: raises $1.25 to $2.25
RoadtoNepal: folds 
Uncalled bet ($1.25) returned to picka4u
picka4u collected $2 from pot
picka4u: doesn't show hand 
*** SUMMARY ***
Total pot $2 | Rake $0 
Seat 1: butcheN18 folded before Flop (didn't bet)
Seat 2: ilaviiitech (button) folded before Flop (didn't bet)
Seat 3: picka4u (small blind) collected ($2)
Seat 5: RoadtoNepal (big blind) folded before Flop
Seat 6: jeancalvi81 folded before Flop (didn't bet)
Seat 7: flk.Dasas folded before Flop (didn't bet)
Seat 8: Dantist1122 folded before Flop (didn't bet)
Seat 9: matiko09 folded before Flop (didn't bet)





PokerStars Hand #155373411078:  Hold'em No Limit ($0.50/$1.00 USD) - 2016/06/30 8:09:50 CET [2016/06/30 2:09:50 ET]
Table 'Asmodeus' 9-max Seat #6 is the button
Seat 2: gleam6619 ($97.15 in chips) 
Seat 4: matiko09 ($100 in chips) 
Seat 5: butcheN18 ($122.04 in chips) 
Seat 6: snow937022 ($106.62 in chips) 
Seat 7: picka4u ($39 in chips) 
Seat 8: RoadtoNepal ($100 in chips) 
Seat 9: flk.Dasas ($140.41 in chips) 
picka4u: posts small blind $0.50
RoadtoNepal: posts big blind $1
L4zy_FiSh: sits out 
*** HOLE CARDS ***
Dealt to matiko09 [Jc 3s]
flk.Dasas: folds 
gleam6619: folds 
matiko09: folds 
butcheN18: folds 
snow937022: folds 
picka4u: folds 
Uncalled bet ($0.50) returned to RoadtoNepal
RoadtoNepal collected $1 from pot
*** SUMMARY ***
Total pot $1 | Rake $0 
Seat 2: gleam6619 folded before Flop (didn't bet)
Seat 4: matiko09 folded before Flop (didn't bet)
Seat 5: butcheN18 folded before Flop (didn't bet)
Seat 6: snow937022 (button) folded before Flop (didn't bet)
Seat 7: picka4u (small blind) folded before Flop
Seat 8: RoadtoNepal (big blind) collected ($1)
Seat 9: flk.Dasas folded before Flop (didn't bet)





PokerStars Hand #155373413157:  Hold'em No Limit ($0.50/$1.00 USD) - 2016/06/30 8:09:59 CET [2016/06/30 2:09:59 ET]
Table 'Hippokoon' 9-max Seat #7 is the button
Seat 6: matiko09 ($101.90 in chips) 
Seat 7: Dantist1122 ($100 in chips) 
Dantist1122: posts small blind $0.50
matiko09: posts big blind $1
matiko09: posts the ante $0.20
Dantist1122: posts the ante $0.20
*** HOLE CARDS ***
Dealt to matiko09 [Kd Qh]
Dantist1122: calls $0.50
matiko09: raises $3.50 to $4.50
Dantist1122: folds 
Uncalled bet ($3.50) returned to matiko09
matiko09 collected $2.40 from pot
matiko09: doesn't show hand 
*** SUMMARY ***
Total pot $2.40 | Rake $0 
Seat 6: matiko09 (big blind) collected ($2.40)
Seat 7: Dantist1122 (button) (small blind) folded before Flop





PokerStars Hand #155373414054:  Hold'em No Limit ($0.50/$1.00 USD) - 2016/06/30 8:10:02 CET [2016/06/30 2:10:02 ET]
Table 'Asmodeus' 9-max Seat #7 is the button
Seat 2: gleam6619 ($97.15 in chips) 
Seat 4: matiko09 ($100 in chips) 
Seat 5: butcheN18 ($122.04 in chips) 
Seat 6: snow937022 ($106.62 in chips) 
Seat 7: picka4u ($38.50 in chips) 
Seat 8: RoadtoNepal ($100.50 in chips) 
Seat 9: flk.Dasas ($140.41 in chips) 
RoadtoNepal: posts small blind $0.50
flk.Dasas: posts big blind $1
L4zy_FiSh: sits out 
*** HOLE CARDS ***
Dealt to matiko09 [Jh Jc]
gleam6619: folds 
matiko09: raises $2 to $3
butcheN18: folds 
snow937022: raises $4 to $7
picka4u: folds 
RoadtoNepal: folds 
flk.Dasas: folds 
matiko09: calls $4
*** FLOP *** [9c Ts Qc]
matiko09: checks 
snow937022: bets $8.09
matiko09: calls $8.09
*** TURN *** [9c Ts Qc] [Js]
matiko09: checks 
snow937022: bets $10.53
matiko09: calls $10.53
*** RIVER *** [9c Ts Qc Js] [4h]
matiko09: checks 
snow937022: bets $17.58
matiko09: folds 
Uncalled bet ($17.58) returned to snow937022
snow937022 collected $50.24 from pot
snow937022: doesn't show hand 
*** SUMMARY ***
Total pot $52.74 | Rake $2.50 
Board [9c Ts Qc Js 4h]
Seat 2: gleam6619 folded before Flop (didn't bet)
Seat 4: matiko09 folded on the River
Seat 5: butcheN18 folded before Flop (didn't bet)
Seat 6: snow937022 collected ($50.24)
Seat 7: picka4u (button) folded before Flop (didn't bet)
Seat 8: RoadtoNepal (small blind) folded before Flop
Seat 9: flk.Dasas (big blind) folded before Flop





PokerStars Hand #155373414619:  Hold'em No Limit ($0.25/$0.50 USD) - 2016/06/30 8:10:05 CET [2016/06/30 2:10:05 ET]
Table 'Praxidike' 9-max Seat #7 is the button
Seat 1: Sniper1717 ($50 in chips) 
Seat 2: prominente ($177.25 in chips) 
Seat 3: THREE FlDDY ($50 in chips) 
Seat 4: nicklasrossd ($25.83 in chips) 
Seat 5: shiangshuina ($51.15 in chips) 
Seat 7: matiko09 ($50 in chips) 
Seat 8: Alexey_Kim2 ($50 in chips) 
Alexey_Kim2: posts small blind $0.25
santa88188: is sitting out 
Sniper1717: posts big blind $0.50
*** HOLE CARDS ***
Dealt to matiko09 [5h 4d]
prominente: folds 
THREE FlDDY: folds 
santa88188 leaves the table
nicklasrossd: folds 
shiangshuina: folds 
KABAL_ua joins the table at seat #9 
matiko09: folds 
Alexey_Kim2: folds 
Uncalled bet ($0.25) returned to Sniper1717
Sniper1717 collected $0.50 from pot
Sniper1717: doesn't show hand 
*** SUMMARY ***
Total pot $0.50 | Rake $0 
Seat 1: Sniper1717 (big blind) collected ($0.50)
Seat 2: prominente folded before Flop (didn't bet)
Seat 3: THREE FlDDY folded before Flop (didn't bet)
Seat 4: nicklasrossd folded before Flop (didn't bet)
Seat 5: shiangshuina folded before Flop (didn't bet)
Seat 7: matiko09 (button) folded before Flop (didn't bet)
Seat 8: Alexey_Kim2 (small blind) folded before Flop





PokerStars Hand #155373419676:  Hold'em No Limit ($0.50/$1.00 USD) - 2016/06/30 8:10:26 CET [2016/06/30 2:10:26 ET]
Table 'Euphrosyne' 9-max Seat #3 is the button
Seat 1: butcheN18 ($100 in chips) 
Seat 2: ilaviiitech ($100 in chips) 
Seat 3: picka4u ($48.25 in chips) 
Seat 5: RoadtoNepal ($100 in chips) 
Seat 6: jeancalvi81 ($60.48 in chips) 
Seat 7: flk.Dasas ($102.27 in chips) 
Seat 8: Dantist1122 ($100 in chips) 
Seat 9: matiko09 ($103.50 in chips) 
bargs33 will be allowed to play after the button
RoadtoNepal: posts small blind $0.50
jeancalvi81: posts big blind $1
*** HOLE CARDS ***
Dealt to matiko09 [3d Tc]
flk.Dasas: folds 
Dantist1122: folds 
matiko09: folds 
butcheN18: raises $2 to $3
ilaviiitech: folds 
picka4u: folds 
RoadtoNepal: folds 
jeancalvi81: calls $2
*** FLOP *** [2d 2h 8c]
jeancalvi81: checks 
butcheN18: checks 
*** TURN *** [2d 2h 8c] [2s]
jeancalvi81: checks 
butcheN18: checks 
*** RIVER *** [2d 2h 8c 2s] [8h]
jeancalvi81: checks 
butcheN18: checks 
*** SHOW DOWN ***
jeancalvi81: shows [6d Ac] (a full house, Deuces full of Eights)
butcheN18: shows [Ad 5d] (a full house, Deuces full of Eights)
jeancalvi81 collected $3.09 from pot
butcheN18 collected $3.09 from pot
*** SUMMARY ***
Total pot $6.50 | Rake $0.32 
Board [2d 2h 8c 2s 8h]
Seat 1: butcheN18 showed [Ad 5d] and won ($3.09) with a full house, Deuces full of Eights
Seat 2: ilaviiitech folded before Flop (didn't bet)
Seat 3: picka4u (button) folded before Flop (didn't bet)
Seat 5: RoadtoNepal (small blind) folded before Flop
Seat 6: jeancalvi81 (big blind) showed [6d Ac] and won ($3.09) with a full house, Deuces full of Eights
Seat 7: flk.Dasas folded before Flop (didn't bet)
Seat 8: Dantist1122 folded before Flop (didn't bet)
Seat 9: matiko09 folded before Flop (didn't bet)





PokerStars Hand #155373419714:  Hold'em No Limit ($0.25/$0.50 USD) - 2016/06/30 8:10:27 CET [2016/06/30 2:10:27 ET]
Table 'Ducrosa' 9-max Seat #2 is the button
Seat 1: Dantist1122 ($52.32 in chips) 
Seat 2: John_les ($50 in chips) 
Seat 3: matiko09 ($50 in chips) 
Seat 4: Lita17 ($72.88 in chips) 
Seat 5: beetge ($39.50 in chips) 
Seat 6: POTAPENKO700 ($50.75 in chips) 
Seat 7: THREE FlDDY ($50 in chips) 
Seat 8: pikopikop ($37.81 in chips) 
Seat 9: ClassicWheel ($42.25 in chips) 
matiko09: posts small blind $0.25
Lita17: posts big blind $0.50
*** HOLE CARDS ***
Dealt to matiko09 [Jh 8c]
beetge: folds 
POTAPENKO700: folds 
THREE FlDDY: folds 
pikopikop: folds 
ClassicWheel: calls $0.50
Dantist1122: folds 
John_les: raises $1.75 to $2.25
matiko09: folds 
Lita17: raises $3.75 to $6
ClassicWheel: folds 
John_les: folds 
Uncalled bet ($3.75) returned to Lita17
Lita17 collected $5.25 from pot
Lita17: doesn't show hand 
*** SUMMARY ***
Total pot $5.25 | Rake $0 
Seat 1: Dantist1122 folded before Flop (didn't bet)
Seat 2: John_les (button) folded before Flop
Seat 3: matiko09 (small blind) folded before Flop
Seat 4: Lita17 (big blind) collected ($5.25)
Seat 5: beetge folded before Flop (didn't bet)
Seat 6: POTAPENKO700 folded before Flop (didn't bet)
Seat 7: THREE FlDDY folded before Flop (didn't bet)
Seat 8: pikopikop folded before Flop (didn't bet)
Seat 9: ClassicWheel folded before Flop





PokerStars Hand #155373427340:  Hold'em No Limit ($0.25/$0.50 USD) - 2016/06/30 8:10:59 CET [2016/06/30 2:10:59 ET]
Table 'Praxidike' 9-max Seat #8 is the button
Seat 1: Sniper1717 ($50.25 in chips) 
Seat 2: prominente ($177.25 in chips) 
Seat 3: THREE FlDDY ($50 in chips) 
Seat 4: nicklasrossd ($25.83 in chips) 
Seat 5: shiangshuina ($51.15 in chips) 
Seat 7: matiko09 ($50 in chips) 
Seat 8: Alexey_Kim2 ($50 in chips) 
KABAL_ua will be allowed to play after the button
Sniper1717: posts small blind $0.25
prominente: posts big blind $0.50
*** HOLE CARDS ***
Dealt to matiko09 [Qd Td]
THREE FlDDY: folds 
nicklasrossd: calls $0.50
shiangshuina: calls $0.50
matiko09: raises $2 to $2.50
Alexey_Kim2: folds 
Sniper1717: folds 
prominente: folds 
nicklasrossd: folds 
shiangshuina: folds 
Uncalled bet ($2) returned to matiko09
matiko09 collected $2.25 from pot
matiko09: doesn't show hand 
*** SUMMARY ***
Total pot $2.25 | Rake $0 
Seat 1: Sniper1717 (small blind) folded before Flop
Seat 2: prominente (big blind) folded before Flop
Seat 3: THREE FlDDY folded before Flop (didn't bet)
Seat 4: nicklasrossd folded before Flop
Seat 5: shiangshuina folded before Flop
Seat 7: matiko09 collected ($2.25)
Seat 8: Alexey_Kim2 (button) folded before Flop (didn't bet)





PokerStars Hand #155373434557:  Hold'em No Limit ($0.25/$0.50 USD) - 2016/06/30 8:11:30 CET [2016/06/30 2:11:30 ET]
Table 'Praxidike' 9-max Seat #1 is the button
Seat 1: Sniper1717 ($50 in chips) 
Seat 2: prominente ($176.75 in chips) 
Seat 3: THREE FlDDY ($50 in chips) 
Seat 4: nicklasrossd ($25.33 in chips) 
Seat 5: shiangshuina ($50.65 in chips) 
Seat 7: matiko09 ($51.75 in chips) 
Seat 8: Alexey_Kim2 ($50 in chips) 
prominente: posts small blind $0.25
THREE FlDDY: posts big blind $0.50
KABAL_ua: sits out 
*** HOLE CARDS ***
Dealt to matiko09 [4h Ah]
nicklasrossd: folds 
shiangshuina: folds 
matiko09: raises $1 to $1.50
Alexey_Kim2: folds 
Sniper1717: folds 
prominente: folds 
THREE FlDDY: folds 
Uncalled bet ($1) returned to matiko09
matiko09 collected $1.25 from pot
matiko09: doesn't show hand 
*** SUMMARY ***
Total pot $1.25 | Rake $0 
Seat 1: Sniper1717 (button) folded before Flop (didn't bet)
Seat 2: prominente (small blind) folded before Flop
Seat 3: THREE FlDDY (big blind) folded before Flop
Seat 4: nicklasrossd folded before Flop (didn't bet)
Seat 5: shiangshuina folded before Flop (didn't bet)
Seat 7: matiko09 collected ($1.25)
Seat 8: Alexey_Kim2 folded before Flop (didn't bet)





PokerStars Hand #155373434779:  Hold'em No Limit ($0.25/$0.50 USD) - 2016/06/30 8:11:31 CET [2016/06/30 2:11:31 ET]
Table 'Ducrosa' 9-max Seat #3 is the button
Seat 1: Dantist1122 ($52.32 in chips) 
Seat 2: John_les ($50 in chips) 
Seat 3: matiko09 ($50 in chips) 
Seat 4: Lita17 ($75.88 in chips) 
Seat 5: beetge ($39.50 in chips) 
Seat 6: POTAPENKO700 ($50.75 in chips) 
Seat 7: THREE FlDDY ($50 in chips) 
Seat 8: pikopikop ($37.81 in chips) 
Seat 9: ClassicWheel ($41.75 in chips) 
Lita17: posts small blind $0.25
beetge: posts big blind $0.50
*** HOLE CARDS ***
Dealt to matiko09 [Th 7s]
POTAPENKO700: folds 
THREE FlDDY: folds 
pikopikop: folds 
ClassicWheel: calls $0.50
pikopikop leaves the table
Dantist1122: folds 
John_les: folds 
matiko09: folds 
Lita17: folds 
beetge: checks 
*** FLOP *** [8s 6d 9s]
beetge: checks 
ClassicWheel: bets $1.19
beetge: folds 
Uncalled bet ($1.19) returned to ClassicWheel
ClassicWheel collected $1.19 from pot
ClassicWheel: doesn't show hand 
*** SUMMARY ***
Total pot $1.25 | Rake $0.06 
Board [8s 6d 9s]
Seat 1: Dantist1122 folded before Flop (didn't bet)
Seat 2: John_les folded before Flop (didn't bet)
Seat 3: matiko09 (button) folded before Flop (didn't bet)
Seat 4: Lita17 (small blind) folded before Flop
Seat 5: beetge (big blind) folded on the Flop
Seat 6: POTAPENKO700 folded before Flop (didn't bet)
Seat 7: THREE FlDDY folded before Flop (didn't bet)
Seat 8: pikopikop folded before Flop (didn't bet)
Seat 9: ClassicWheel collected ($1.19)





PokerStars Hand #155373436683:  Hold'em No Limit ($0.50/$1.00 USD) - 2016/06/30 8:11:39 CET [2016/06/30 2:11:39 ET]
Table 'Asmodeus' 9-max Seat #8 is the button
Seat 1: Imbear8 ($119.13 in chips) 
Seat 2: gleam6619 ($97.15 in chips) 
Seat 4: matiko09 ($100 in chips) 
Seat 5: butcheN18 ($122.04 in chips) 
Seat 6: snow937022 ($131.24 in chips) 
Seat 7: picka4u ($38.50 in chips) 
Seat 8: RoadtoNepal ($100 in chips) 
Seat 9: flk.Dasas ($139.41 in chips) 
flk.Dasas: posts small blind $0.50
Imbear8: posts big blind $1
L4zy_FiSh: sits out 
*** HOLE CARDS ***
Dealt to matiko09 [3c 7h]
gleam6619: folds 
matiko09: folds 
butcheN18: raises $2 to $3
snow937022: folds 
picka4u: folds 
RoadtoNepal: folds 
flk.Dasas: folds 
Imbear8: calls $2
*** FLOP *** [Qs 3h 8h]
Imbear8: checks 
butcheN18: checks 
*** TURN *** [Qs 3h 8h] [4c]
Imbear8: checks 
butcheN18: checks 
*** RIVER *** [Qs 3h 8h 4c] [8s]
Imbear8: checks 
butcheN18: checks 
*** SHOW DOWN ***
Imbear8: shows [7s As] (a pair of Eights)
butcheN18: shows [Jd Ad] (a pair of Eights - Ace+Queen+Jack kicker)
butcheN18 collected $6.18 from pot
*** SUMMARY ***
Total pot $6.50 | Rake $0.32 
Board [Qs 3h 8h 4c 8s]
Seat 1: Imbear8 (big blind) showed [7s As] and lost with a pair of Eights
Seat 2: gleam6619 folded before Flop (didn't bet)
Seat 4: matiko09 folded before Flop (didn't bet)
Seat 5: butcheN18 showed [Jd Ad] and won ($6.18) with a pair of Eights
Seat 6: snow937022 folded before Flop (didn't bet)
Seat 7: picka4u folded before Flop (didn't bet)
Seat 8: RoadtoNepal (button) folded before Flop (didn't bet)
Seat 9: flk.Dasas (small blind) folded before Flop





PokerStars Hand #155373437728:  Hold'em No Limit ($0.50/$1.00 USD) - 2016/06/30 8:11:44 CET [2016/06/30 2:11:44 ET]
Table 'Euphrosyne' 9-max Seat #5 is the button
Seat 1: butcheN18 ($100.09 in chips) 
Seat 2: ilaviiitech ($100 in chips) 
Seat 3: picka4u ($48.25 in chips) 
Seat 5: RoadtoNepal ($100 in chips) 
Seat 6: jeancalvi81 ($60.57 in chips) 
Seat 7: flk.Dasas ($102.27 in chips) 
Seat 8: Dantist1122 ($100 in chips) 
Seat 9: matiko09 ($103.50 in chips) 
jeancalvi81: posts small blind $0.50
flk.Dasas: posts big blind $1
bargs33: sits out 
*** HOLE CARDS ***
Dealt to matiko09 [Kd 9d]
Dantist1122: folds 
matiko09: folds 
butcheN18: raises $2 to $3
ilaviiitech: folds 
picka4u: folds 
RoadtoNepal: folds 
jeancalvi81: calls $2.50
flk.Dasas: folds 
*** FLOP *** [9h 8h 2s]
jeancalvi81: bets $4
butcheN18: raises $9.37 to $13.37
jeancalvi81: folds 
Uncalled bet ($9.37) returned to butcheN18
butcheN18 collected $14.25 from pot
butcheN18: doesn't show hand 
*** SUMMARY ***
Total pot $15 | Rake $0.75 
Board [9h 8h 2s]
Seat 1: butcheN18 collected ($14.25)
Seat 2: ilaviiitech folded before Flop (didn't bet)
Seat 3: picka4u folded before Flop (didn't bet)
Seat 5: RoadtoNepal (button) folded before Flop (didn't bet)
Seat 6: jeancalvi81 (small blind) folded on the Flop
Seat 7: flk.Dasas (big blind) folded before Flop
Seat 8: Dantist1122 folded before Flop (didn't bet)
Seat 9: matiko09 folded before Flop (didn't bet)





PokerStars Hand #155373439571:  Hold'em No Limit ($0.25/$0.50 USD) - 2016/06/30 8:11:51 CET [2016/06/30 2:11:51 ET]
Table 'Praxidike' 9-max Seat #2 is the button
Seat 1: Sniper1717 ($50 in chips) 
Seat 2: prominente ($176.50 in chips) 
Seat 3: THREE FlDDY ($50 in chips) 
Seat 4: nicklasrossd ($25.33 in chips) 
Seat 5: shiangshuina ($50.65 in chips) 
Seat 7: matiko09 ($52.50 in chips) 
Seat 8: Alexey_Kim2 ($50 in chips) 
THREE FlDDY: posts small blind $0.25
nicklasrossd: posts big blind $0.50
KABAL_ua: sits out 
*** HOLE CARDS ***
Dealt to matiko09 [Jd Tc]
shiangshuina: folds 
matiko09: folds 
Alexey_Kim2: folds 
Sniper1717: folds 
prominente: raises $0.50 to $1
THREE FlDDY: folds 
nicklasrossd: calls $0.50
*** FLOP *** [2s 3h Kd]
nicklasrossd: checks 
prominente: bets $1.25
nicklasrossd: folds 
Uncalled bet ($1.25) returned to prominente
prominente collected $2.14 from pot
prominente: doesn't show hand 
*** SUMMARY ***
Total pot $2.25 | Rake $0.11 
Board [2s 3h Kd]
Seat 1: Sniper1717 folded before Flop (didn't bet)
Seat 2: prominente (button) collected ($2.14)
Seat 3: THREE FlDDY (small blind) folded before Flop
Seat 4: nicklasrossd (big blind) folded on the Flop
Seat 5: shiangshuina folded before Flop (didn't bet)
Seat 7: matiko09 folded before Flop (didn't bet)
Seat 8: Alexey_Kim2 folded before Flop (didn't bet)





PokerStars Hand #155373446640:  Hold'em No Limit ($0.50/$1.00 USD) - 2016/06/30 8:12:22 CET [2016/06/30 2:12:22 ET]
Table 'Asmodeus' 9-max Seat #9 is the button
Seat 1: Imbear8 ($116.13 in chips) 
Seat 2: gleam6619 ($97.15 in chips) 
Seat 4: matiko09 ($100 in chips) 
Seat 5: butcheN18 ($125.22 in chips) 
Seat 6: snow937022 ($131.24 in chips) 
Seat 7: picka4u ($38.50 in chips) 
Seat 8: RoadtoNepal ($100 in chips) 
Seat 9: flk.Dasas ($138.91 in chips) 
Imbear8: posts small blind $0.50
gleam6619: posts big blind $1
L4zy_FiSh: sits out 
*** HOLE CARDS ***
Dealt to matiko09 [Jh 7c]
matiko09: folds 
butcheN18: folds 
snow937022: raises $1.25 to $2.25
picka4u: folds 
RoadtoNepal: folds 
flk.Dasas: folds 
Imbear8: calls $1.75
gleam6619: folds 
*** FLOP *** [3c Td 7d]
Imbear8: checks 
snow937022: checks 
*** TURN *** [3c Td 7d] [5h]
Imbear8: bets $2.61
snow937022: raises $2.61 to $5.22
Imbear8: calls $2.61
*** RIVER *** [3c Td 7d 5h] [8c]
Imbear8: checks 
snow937022: bets $11.35
Imbear8: calls $11.35
*** SHOW DOWN ***
snow937022: shows [5s 5d] (three of a kind, Fives)
Imbear8: mucks hand 
snow937022 collected $36.71 from pot
*** SUMMARY ***
Total pot $38.64 | Rake $1.93 
Board [3c Td 7d 5h 8c]
Seat 1: Imbear8 (small blind) mucked [8s 9c]
Seat 2: gleam6619 (big blind) folded before Flop
Seat 4: matiko09 folded before Flop (didn't bet)
Seat 5: butcheN18 folded before Flop (didn't bet)
Seat 6: snow937022 showed [5s 5d] and won ($36.71) with three of a kind, Fives
Seat 7: picka4u folded before Flop (didn't bet)
Seat 8: RoadtoNepal folded before Flop (didn't bet)
Seat 9: flk.Dasas (button) folded before Flop (didn't bet)





PokerStars Hand #155373450578:  Hold'em No Limit ($0.25/$0.50 USD) - 2016/06/30 8:12:39 CET [2016/06/30 2:12:39 ET]
Table 'Praxidike' 9-max Seat #3 is the button
Seat 1: Sniper1717 ($50 in chips) 
Seat 2: prominente ($177.64 in chips) 
Seat 3: THREE FlDDY ($50 in chips) 
Seat 4: nicklasrossd ($24.33 in chips) 
Seat 5: shiangshuina ($50.65 in chips) 
Seat 7: matiko09 ($52.50 in chips) 
Seat 8: Alexey_Kim2 ($50 in chips) 
nicklasrossd: posts small blind $0.25
shiangshuina: posts big blind $0.50
KABAL_ua: sits out 
*** HOLE CARDS ***
Dealt to matiko09 [9s 2s]
matiko09: folds 
Alexey_Kim2: folds 
Sniper1717: folds 
prominente: raises $0.75 to $1.25
THREE FlDDY: folds 
nicklasrossd: folds 
shiangshuina: calls $0.75
*** FLOP *** [Qd 6h 7h]
shiangshuina: checks 
prominente: bets $2
shiangshuina: calls $2
*** TURN *** [Qd 6h 7h] [8d]
shiangshuina: checks 
prominente: bets $5
shiangshuina: raises $6 to $11
prominente: folds 
Uncalled bet ($6) returned to shiangshuina
shiangshuina collected $15.91 from pot
shiangshuina: doesn't show hand 
*** SUMMARY ***
Total pot $16.75 | Rake $0.84 
Board [Qd 6h 7h 8d]
Seat 1: Sniper1717 folded before Flop (didn't bet)
Seat 2: prominente folded on the Turn
Seat 3: THREE FlDDY (button) folded before Flop (didn't bet)
Seat 4: nicklasrossd (small blind) folded before Flop
Seat 5: shiangshuina (big blind) collected ($15.91)
Seat 7: matiko09 folded before Flop (didn't bet)
Seat 8: Alexey_Kim2 folded before Flop (didn't bet)





PokerStars Hand #155373450726:  Hold'em No Limit ($0.25/$0.50 USD) - 2016/06/30 8:12:39 CET [2016/06/30 2:12:39 ET]
Table 'Ducrosa' 9-max Seat #4 is the button
Seat 1: Dantist1122 ($52.32 in chips) 
Seat 2: John_les ($50 in chips) 
Seat 3: matiko09 ($50 in chips) 
Seat 4: Lita17 ($75.63 in chips) 
Seat 5: beetge ($39 in chips) 
Seat 6: POTAPENKO700 ($50.75 in chips) 
Seat 7: THREE FlDDY ($50 in chips) 
Seat 9: ClassicWheel ($42.44 in chips) 
beetge: posts small blind $0.25
POTAPENKO700: posts big blind $0.50
*** HOLE CARDS ***
Dealt to matiko09 [3c Ts]
THREE FlDDY: folds 
ClassicWheel: raises $0.50 to $1
Dantist1122: folds 
John_les: folds 
matiko09: folds 
Lita17: folds 
beetge: calls $0.75
POTAPENKO700: folds 
*** FLOP *** [7c 4d 5h]
beetge: checks 
ClassicWheel: checks 
*** TURN *** [7c 4d 5h] [6s]
beetge: checks 
ClassicWheel: bets $1.19
beetge: folds 
Uncalled bet ($1.19) returned to ClassicWheel
ClassicWheel collected $2.38 from pot
ClassicWheel: doesn't show hand 
*** SUMMARY ***
Total pot $2.50 | Rake $0.12 
Board [7c 4d 5h 6s]
Seat 1: Dantist1122 folded before Flop (didn't bet)
Seat 2: John_les folded before Flop (didn't bet)
Seat 3: matiko09 folded before Flop (didn't bet)
Seat 4: Lita17 (button) folded before Flop (didn't bet)
Seat 5: beetge (small blind) folded on the Turn
Seat 6: POTAPENKO700 (big blind) folded before Flop
Seat 7: THREE FlDDY folded before Flop (didn't bet)
Seat 9: ClassicWheel collected ($2.38)





PokerStars Hand #155373451407:  Hold'em No Limit ($0.50/$1.00 USD) - 2016/06/30 8:12:42 CET [2016/06/30 2:12:42 ET]
Table 'Euphrosyne' 9-max Seat #6 is the button
Seat 1: butcheN18 ($107.34 in chips) 
Seat 2: ilaviiitech ($100 in chips) 
Seat 3: picka4u ($48.25 in chips) 
Seat 5: RoadtoNepal ($100 in chips) 
Seat 6: jeancalvi81 ($53.57 in chips) 
Seat 7: flk.Dasas ($101.27 in chips) 
Seat 8: Dantist1122 ($100 in chips) 
Seat 9: matiko09 ($103.50 in chips) 
flk.Dasas: posts small blind $0.50
Dantist1122: posts big blind $1
bargs33: sits out 
*** HOLE CARDS ***
Dealt to matiko09 [8s Kc]
matiko09: folds 
butcheN18: folds 
ilaviiitech: folds 
picka4u: raises $1.25 to $2.25
RoadtoNepal: folds 
jeancalvi81: folds 
flk.Dasas: folds 
Dantist1122: folds 
Uncalled bet ($1.25) returned to picka4u
picka4u collected $2.50 from pot
picka4u: doesn't show hand 
*** SUMMARY ***
Total pot $2.50 | Rake $0 
Seat 1: butcheN18 folded before Flop (didn't bet)
Seat 2: ilaviiitech folded before Flop (didn't bet)
Seat 3: picka4u collected ($2.50)
Seat 5: RoadtoNepal folded before Flop (didn't bet)
Seat 6: jeancalvi81 (button) folded before Flop (didn't bet)
Seat 7: flk.Dasas (small blind) folded before Flop
Seat 8: Dantist1122 (big blind) folded before Flop
Seat 9: matiko09 folded before Flop (didn't bet)





PokerStars Hand #155373456748:  Hold'em No Limit ($0.50/$1.00 USD) - 2016/06/30 8:13:05 CET [2016/06/30 2:13:05 ET]
Table 'Lucretia II' 9-max Seat #8 is the button
Seat 1: matiko09 ($100 in chips) 
Seat 2: picka4u ($60.55 in chips) 
Seat 4: John_les ($100 in chips) 
Seat 5: butcheN18 ($101.50 in chips) 
Seat 7: kingmaker209 ($41.54 in chips) 
Seat 8: snow937022 ($131.55 in chips) 
Seat 9: misko123 ($34.80 in chips) 
misko123: posts small blind $0.50
matiko09: posts big blind $1
Alex Frider: sits out 
flk.Dasas: sits out 
kingmaker209: posts big blind $1
*** HOLE CARDS ***
Dealt to matiko09 [5d 4d]
picka4u: folds 
John_les: folds 
butcheN18: folds 
kingmaker209: checks 
snow937022: folds 
misko123: calls $0.50
matiko09: checks 
*** FLOP *** [Ks 5s Ts]
misko123: checks 
matiko09: checks 
kingmaker209: checks 
*** TURN *** [Ks 5s Ts] [Jh]
misko123: checks 
matiko09: checks 
kingmaker209: bets $1
misko123: calls $1
matiko09: folds 
*** RIVER *** [Ks 5s Ts Jh] [8c]
misko123: checks 
kingmaker209: bets $1
misko123: folds 
Uncalled bet ($1) returned to kingmaker209
kingmaker209 collected $4.75 from pot
kingmaker209: doesn't show hand 
*** SUMMARY ***
Total pot $5 | Rake $0.25 
Board [Ks 5s Ts Jh 8c]
Seat 1: matiko09 (big blind) folded on the Turn
Seat 2: picka4u folded before Flop (didn't bet)
Seat 4: John_les folded before Flop (didn't bet)
Seat 5: butcheN18 folded before Flop (didn't bet)
Seat 7: kingmaker209 collected ($4.75)
Seat 8: snow937022 (button) folded before Flop (didn't bet)
Seat 9: misko123 (small blind) folded on the River





PokerStars Hand #155373459390:  Hold'em No Limit ($0.50/$1.00 USD) - 2016/06/30 8:13:16 CET [2016/06/30 2:13:16 ET]
Table 'Euphrosyne' 9-max Seat #7 is the button
Seat 1: butcheN18 ($107.34 in chips) 
Seat 2: ilaviiitech ($100 in chips) 
Seat 3: picka4u ($49.75 in chips) 
Seat 5: RoadtoNepal ($100 in chips) 
Seat 6: jeancalvi81 ($53.57 in chips) 
Seat 7: flk.Dasas ($100.77 in chips) 
Seat 8: Dantist1122 ($100 in chips) 
Seat 9: matiko09 ($103.50 in chips) 
Dantist1122: posts small blind $0.50
matiko09: posts big blind $1
bargs33: sits out 
*** HOLE CARDS ***
Dealt to matiko09 [3c 2s]
butcheN18: raises $2 to $3
ilaviiitech: folds 
picka4u: folds 
RoadtoNepal: folds 
jeancalvi81: folds 
jeancalvi81 leaves the table
flk.Dasas: folds 
Dantist1122: folds 
matiko09: folds 
Uncalled bet ($2) returned to butcheN18
butcheN18 collected $2.50 from pot
butcheN18: doesn't show hand 
*** SUMMARY ***
Total pot $2.50 | Rake $0 
Seat 1: butcheN18 collected ($2.50)
Seat 2: ilaviiitech folded before Flop (didn't bet)
Seat 3: picka4u folded before Flop (didn't bet)
Seat 5: RoadtoNepal folded before Flop (didn't bet)
Seat 6: jeancalvi81 folded before Flop (didn't bet)
Seat 7: flk.Dasas (button) folded before Flop (didn't bet)
Seat 8: Dantist1122 (small blind) folded before Flop
Seat 9: matiko09 (big blind) folded before Flop





PokerStars Hand #155373460431:  Hold'em No Limit ($0.25/$0.50 USD) - 2016/06/30 8:13:21 CET [2016/06/30 2:13:21 ET]
Table 'Ducrosa' 9-max Seat #5 is the button
Seat 1: Dantist1122 ($52.32 in chips) 
Seat 2: John_les ($50 in chips) 
Seat 3: matiko09 ($50 in chips) 
Seat 4: Lita17 ($75.63 in chips) 
Seat 5: beetge ($38 in chips) 
Seat 6: POTAPENKO700 ($50.25 in chips) 
Seat 7: THREE FlDDY ($50 in chips) 
Seat 9: ClassicWheel ($43.82 in chips) 
POTAPENKO700: posts small blind $0.25
THREE FlDDY: posts big blind $0.50
*** HOLE CARDS ***
Dealt to matiko09 [4s 8d]
ClassicWheel: folds 
Dantist1122: folds 
John_les: folds 
matiko09: folds 
Lita17: folds 
beetge: folds 
POTAPENKO700: folds 
Uncalled bet ($0.25) returned to THREE FlDDY
THREE FlDDY collected $0.50 from pot
THREE FlDDY: doesn't show hand 
*** SUMMARY ***
Total pot $0.50 | Rake $0 
Seat 1: Dantist1122 folded before Flop (didn't bet)
Seat 2: John_les folded before Flop (didn't bet)
Seat 3: matiko09 folded before Flop (didn't bet)
Seat 4: Lita17 folded before Flop (didn't bet)
Seat 5: beetge (button) folded before Flop (didn't bet)
Seat 6: POTAPENKO700 (small blind) folded before Flop
Seat 7: THREE FlDDY (big blind) collected ($0.50)
Seat 9: ClassicWheel folded before Flop (didn't bet)





PokerStars Hand #155373463448:  Hold'em No Limit ($0.25/$0.50 USD) - 2016/06/30 8:13:34 CET [2016/06/30 2:13:34 ET]
Table 'Ducrosa' 9-max Seat #6 is the button
Seat 1: Dantist1122 ($52.32 in chips) 
Seat 2: John_les ($50 in chips) 
Seat 3: matiko09 ($50 in chips) 
Seat 4: Lita17 ($75.63 in chips) 
Seat 5: beetge ($38 in chips) 
Seat 6: POTAPENKO700 ($50 in chips) 
Seat 7: THREE FlDDY ($50.25 in chips) 
Seat 9: ClassicWheel ($43.82 in chips) 
THREE FlDDY: posts small blind $0.25
ClassicWheel: posts big blind $0.50
*** HOLE CARDS ***
Dealt to matiko09 [Kd 3c]
Dantist1122: folds 
John_les: raises $1.25 to $1.75
matiko09: folds 
Lita17: calls $1.75
beetge: folds 
POTAPENKO700: folds 
THREE FlDDY: raises $5.75 to $7.50
ClassicWheel: folds 
John_les: folds 
Lita17: folds 
Uncalled bet ($5.75) returned to THREE FlDDY
THREE FlDDY collected $5.75 from pot
THREE FlDDY: doesn't show hand 
*** SUMMARY ***
Total pot $5.75 | Rake $0 
Seat 1: Dantist1122 folded before Flop (didn't bet)
Seat 2: John_les folded before Flop
Seat 3: matiko09 folded before Flop (didn't bet)
Seat 4: Lita17 folded before Flop
Seat 5: beetge folded before Flop (didn't bet)
Seat 6: POTAPENKO700 (button) folded before Flop (didn't bet)
Seat 7: THREE FlDDY (small blind) collected ($5.75)
Seat 9: ClassicWheel (big blind) folded before Flop





PokerStars Hand #155373463437:  Hold'em No Limit ($0.50/$1.00 USD) - 2016/06/30 8:13:34 CET [2016/06/30 2:13:34 ET]
Table 'Asmodeus' 9-max Seat #1 is the button
Seat 1: Imbear8 ($97.31 in chips) 
Seat 2: gleam6619 ($96.15 in chips) 
Seat 3: L4zy_FiSh ($100 in chips) 
Seat 4: matiko09 ($100 in chips) 
Seat 5: butcheN18 ($125.22 in chips) 
Seat 6: snow937022 ($149.13 in chips) 
Seat 7: picka4u ($38.50 in chips) 
Seat 8: RoadtoNepal ($100 in chips) 
Seat 9: flk.Dasas ($138.91 in chips) 
gleam6619: posts small blind $0.50
L4zy_FiSh: posts big blind $1
*** HOLE CARDS ***
Dealt to matiko09 [2s As]
matiko09: folds 
butcheN18: folds 
snow937022: folds 
picka4u: folds 
RoadtoNepal: folds 
flk.Dasas: folds 
Imbear8: raises $1.50 to $2.50
gleam6619: folds 
L4zy_FiSh: folds 
Uncalled bet ($1.50) returned to Imbear8
Imbear8 collected $2.50 from pot
Imbear8: doesn't show hand 
*** SUMMARY ***
Total pot $2.50 | Rake $0 
Seat 1: Imbear8 (button) collected ($2.50)
Seat 2: gleam6619 (small blind) folded before Flop
Seat 3: L4zy_FiSh (big blind) folded before Flop
Seat 4: matiko09 folded before Flop (didn't bet)
Seat 5: butcheN18 folded before Flop (didn't bet)
Seat 6: snow937022 folded before Flop (didn't bet)
Seat 7: picka4u folded before Flop (didn't bet)
Seat 8: RoadtoNepal folded before Flop (didn't bet)
Seat 9: flk.Dasas folded before Flop (didn't bet)





PokerStars Hand #155373467706:  Hold'em No Limit ($0.50/$1.00 USD) - 2016/06/30 8:13:51 CET [2016/06/30 2:13:51 ET]
Table 'Euphrosyne' 9-max Seat #8 is the button
Seat 1: butcheN18 ($108.84 in chips) 
Seat 2: ilaviiitech ($100 in chips) 
Seat 3: picka4u ($49.75 in chips) 
Seat 5: RoadtoNepal ($100 in chips) 
Seat 7: flk.Dasas ($100.77 in chips) 
Seat 8: Dantist1122 ($100 in chips) 
Seat 9: matiko09 ($102.50 in chips) 
matiko09: posts small blind $0.50
butcheN18: posts big blind $1
bargs33: sits out 
*** HOLE CARDS ***
Dealt to matiko09 [Td 3c]
ilaviiitech: folds 
picka4u: raises $1.25 to $2.25
RoadtoNepal: folds 
flk.Dasas: folds 
Dantist1122: folds 
matiko09: folds 
Alex Frider joins the table at seat #6 
butcheN18: folds 
Uncalled bet ($1.25) returned to picka4u
picka4u collected $2.50 from pot
picka4u: doesn't show hand 
*** SUMMARY ***
Total pot $2.50 | Rake $0 
Seat 1: butcheN18 (big blind) folded before Flop
Seat 2: ilaviiitech folded before Flop (didn't bet)
Seat 3: picka4u collected ($2.50)
Seat 5: RoadtoNepal folded before Flop (didn't bet)
Seat 7: flk.Dasas folded before Flop (didn't bet)
Seat 8: Dantist1122 (button) folded before Flop (didn't bet)
Seat 9: matiko09 (small blind) folded before Flop





PokerStars Hand #155373468993:  Hold'em No Limit ($0.25/$0.50 USD) - 2016/06/30 8:13:56 CET [2016/06/30 2:13:56 ET]
Table 'Praxidike' 9-max Seat #4 is the button
Seat 1: Sniper1717 ($50 in chips) 
Seat 2: prominente ($169.39 in chips) 
Seat 3: THREE FlDDY ($50 in chips) 
Seat 4: nicklasrossd ($24.08 in chips) 
Seat 5: shiangshuina ($58.31 in chips) 
Seat 7: matiko09 ($52.50 in chips) 
Seat 8: Alexey_Kim2 ($50 in chips) 
shiangshuina: posts small blind $0.25
matiko09: posts big blind $0.50
KABAL_ua: sits out 
*** HOLE CARDS ***
Dealt to matiko09 [Jd 4d]
Alexey_Kim2: folds 
Sniper1717: folds 
prominente: raises $0.75 to $1.25
THREE FlDDY: folds 
nicklasrossd is disconnected 
nicklasrossd is connected 
nicklasrossd: folds 
shiangshuina: folds 
matiko09: folds 
Uncalled bet ($0.75) returned to prominente
prominente collected $1.25 from pot
prominente: doesn't show hand 
*** SUMMARY ***
Total pot $1.25 | Rake $0 
Seat 1: Sniper1717 folded before Flop (didn't bet)
Seat 2: prominente collected ($1.25)
Seat 3: THREE FlDDY folded before Flop (didn't bet)
Seat 4: nicklasrossd (button) folded before Flop (didn't bet)
Seat 5: shiangshuina (small blind) folded before Flop
Seat 7: matiko09 (big blind) folded before Flop
Seat 8: Alexey_Kim2 folded before Flop (didn't bet)





PokerStars Hand #155373468845:  Hold'em No Limit ($0.50/$1.00 USD) - 2016/06/30 8:13:56 CET [2016/06/30 2:13:56 ET]
Table 'Peiraios' 9-max Seat #4 is the button
Seat 2: flk.Dasas ($101.50 in chips) 
Seat 4: nald6232 ($93.04 in chips) 
Seat 6: Alex Frider ($159.29 in chips) 
Seat 8: matiko09 ($100 in chips) 
Seat 9: Painkiller72 ($128.02 in chips) 
bargs33 will be allowed to play after the button
Alex Frider: posts small blind $0.50
RoadtoNepal: is sitting out 
matiko09: posts big blind $1
L4zy_FiSh: sits out 
*** HOLE CARDS ***
Dealt to matiko09 [7d Qs]
Painkiller72: folds 
flk.Dasas: raises $1.50 to $2.50
nald6232: folds 
Alex Frider: folds 
matiko09: folds 
Uncalled bet ($1.50) returned to flk.Dasas
flk.Dasas collected $2.50 from pot
flk.Dasas: doesn't show hand 
*** SUMMARY ***
Total pot $2.50 | Rake $0 
Seat 2: flk.Dasas collected ($2.50)
Seat 4: nald6232 (button) folded before Flop (didn't bet)
Seat 6: Alex Frider (small blind) folded before Flop
Seat 8: matiko09 (big blind) folded before Flop
Seat 9: Painkiller72 folded before Flop (didn't bet)





PokerStars Hand #155373469294:  Hold'em No Limit ($0.50/$1.00 USD) - 2016/06/30 8:13:58 CET [2016/06/30 2:13:58 ET]
Table 'Lucretia II' 9-max Seat #9 is the button
Seat 1: matiko09 ($100 in chips) 
Seat 2: picka4u ($60.55 in chips) 
Seat 4: John_les ($100 in chips) 
Seat 5: butcheN18 ($101.50 in chips) 
Seat 7: kingmaker209 ($44.29 in chips) 
Seat 8: snow937022 ($131.55 in chips) 
Seat 9: misko123 ($32.80 in chips) 
matiko09: posts small blind $0.50
picka4u: posts big blind $1
Alex Frider: sits out 
flk.Dasas: sits out 
*** HOLE CARDS ***
Dealt to matiko09 [3h Ad]
John_les: folds 
butcheN18: folds 
kingmaker209: calls $1
snow937022: folds 
misko123: folds 
matiko09: calls $0.50
picka4u: raises $3 to $4
kingmaker209: folds 
matiko09: folds 
Uncalled bet ($3) returned to picka4u
picka4u collected $3 from pot
picka4u: doesn't show hand 
*** SUMMARY ***
Total pot $3 | Rake $0 
Seat 1: matiko09 (small blind) folded before Flop
Seat 2: picka4u (big blind) collected ($3)
Seat 4: John_les folded before Flop (didn't bet)
Seat 5: butcheN18 folded before Flop (didn't bet)
Seat 7: kingmaker209 folded before Flop
Seat 8: snow937022 folded before Flop (didn't bet)
Seat 9: misko123 (button) folded before Flop (didn't bet)





PokerStars Hand #155373470743:  Hold'em No Limit ($0.50/$1.00 USD) - 2016/06/30 8:14:04 CET [2016/06/30 2:14:04 ET]
Table 'Asmodeus' 9-max Seat #2 is the button
Seat 1: Imbear8 ($98.81 in chips) 
Seat 2: gleam6619 ($95.65 in chips) 
Seat 3: L4zy_FiSh ($100 in chips) 
Seat 4: matiko09 ($100 in chips) 
Seat 5: butcheN18 ($125.22 in chips) 
Seat 6: snow937022 ($149.13 in chips) 
Seat 7: picka4u ($38.50 in chips) 
Seat 8: RoadtoNepal ($100 in chips) 
Seat 9: flk.Dasas ($138.91 in chips) 
L4zy_FiSh: posts small blind $0.50
matiko09: posts big blind $1
*** HOLE CARDS ***
Dealt to matiko09 [4s Jd]
butcheN18: folds 
snow937022: folds 
picka4u: folds 
RoadtoNepal: folds 
flk.Dasas: folds 
Imbear8: raises $1.50 to $2.50
gleam6619: calls $2.50
L4zy_FiSh: folds 
matiko09: folds 
*** FLOP *** [Qd 4c Kh]
Imbear8: bets $3.09
gleam6619: folds 
Uncalled bet ($3.09) returned to Imbear8
Imbear8 collected $6.18 from pot
*** SUMMARY ***
Total pot $6.50 | Rake $0.32 
Board [Qd 4c Kh]
Seat 1: Imbear8 collected ($6.18)
Seat 2: gleam6619 (button) folded on the Flop
Seat 3: L4zy_FiSh (small blind) folded before Flop
Seat 4: matiko09 (big blind) folded before Flop
Seat 5: butcheN18 folded before Flop (didn't bet)
Seat 6: snow937022 folded before Flop (didn't bet)
Seat 7: picka4u folded before Flop (didn't bet)
Seat 8: RoadtoNepal folded before Flop (didn't bet)
Seat 9: flk.Dasas folded before Flop (didn't bet)





PokerStars Hand #155373472031:  Hold'em No Limit ($0.50/$1.00 USD) - 2016/06/30 8:14:09 CET [2016/06/30 2:14:09 ET]
Table 'Euphrosyne' 9-max Seat #9 is the button
Seat 1: butcheN18 ($107.84 in chips) 
Seat 2: ilaviiitech ($100 in chips) 
Seat 3: picka4u ($51.25 in chips) 
Seat 5: RoadtoNepal ($100 in chips) 
Seat 7: flk.Dasas ($100.77 in chips) 
Seat 8: Dantist1122 ($100 in chips) 
Seat 9: matiko09 ($102 in chips) 
butcheN18: posts small blind $0.50
ilaviiitech: posts big blind $1
bargs33: sits out 
Alex Frider: sits out 
*** HOLE CARDS ***
Dealt to matiko09 [6c Qc]
picka4u: folds 
RoadtoNepal: folds 
flk.Dasas: folds 
Dantist1122: raises $1.70 to $2.70
matiko09: folds 
butcheN18: folds 
ilaviiitech: folds 
Uncalled bet ($1.70) returned to Dantist1122
Dantist1122 collected $2.50 from pot
Dantist1122: doesn't show hand 
*** SUMMARY ***
Total pot $2.50 | Rake $0 
Seat 1: butcheN18 (small blind) folded before Flop
Seat 2: ilaviiitech (big blind) folded before Flop
Seat 3: picka4u folded before Flop (didn't bet)
Seat 5: RoadtoNepal folded before Flop (didn't bet)
Seat 7: flk.Dasas folded before Flop (didn't bet)
Seat 8: Dantist1122 collected ($2.50)
Seat 9: matiko09 (button) folded before Flop (didn't bet)





PokerStars Hand #155373480735:  Hold'em No Limit ($0.50/$1.00 USD) - 2016/06/30 8:14:21 CET [2016/06/30 2:14:21 ET]
Table 'Lucretia II' 9-max Seat #1 is the button
Seat 1: matiko09 ($100 in chips) 
Seat 2: picka4u ($62.55 in chips) 
Seat 3: Alex Frider ($170.32 in chips) 
Seat 4: John_les ($100 in chips) 
Seat 5: butcheN18 ($101.50 in chips) 
Seat 7: kingmaker209 ($43.29 in chips) 
Seat 8: snow937022 ($131.55 in chips) 
Seat 9: misko123 ($32.80 in chips) 
picka4u: posts small blind $0.50
Alex Frider: posts big blind $1
flk.Dasas: sits out 
*** HOLE CARDS ***
Dealt to matiko09 [Ac Kh]
John_les: folds 
butcheN18: folds 
kingmaker209: folds 
snow937022: folds 
misko123: calls $1
matiko09: raises $3 to $4
picka4u: folds 
Alex Frider: folds 
misko123: calls $3
*** FLOP *** [Js 5c 9d]
misko123: checks 
matiko09: checks 
*** TURN *** [Js 5c 9d] [8c]
misko123: checks 
matiko09: checks 
*** RIVER *** [Js 5c 9d 8c] [6d]
misko123: checks 
matiko09: checks 
*** SHOW DOWN ***
misko123: shows [As Qh] (high card Ace)
matiko09: shows [Ac Kh] (high card Ace - King kicker)
matiko09 collected $9.02 from pot
*** SUMMARY ***
Total pot $9.50 | Rake $0.48 
Board [Js 5c 9d 8c 6d]
Seat 1: matiko09 (button) showed [Ac Kh] and won ($9.02) with high card Ace
Seat 2: picka4u (small blind) folded before Flop
Seat 3: Alex Frider (big blind) folded before Flop
Seat 4: John_les folded before Flop (didn't bet)
Seat 5: butcheN18 folded before Flop (didn't bet)
Seat 7: kingmaker209 folded before Flop (didn't bet)
Seat 8: snow937022 folded before Flop (didn't bet)
Seat 9: misko123 showed [As Qh] and lost with high card Ace





PokerStars Hand #155373481236:  Hold'em No Limit ($0.50/$1.00 USD) - 2016/06/30 8:14:23 CET [2016/06/30 2:14:23 ET]
Table 'Peiraios' 9-max Seat #6 is the button
Seat 1: L4zy_FiSh ($115.66 in chips) 
Seat 2: flk.Dasas ($103 in chips) 
Seat 4: nald6232 ($93.04 in chips) 
Seat 6: Alex Frider ($158.79 in chips) 
Seat 8: matiko09 ($100 in chips) 
matiko09: posts small blind $0.50
Painkiller72: is sitting out 
L4zy_FiSh: posts big blind $1
Painkiller72 leaves the table
bargs33: sits out 
*** HOLE CARDS ***
Dealt to matiko09 [4c 2s]
ricksdogs77 joins the table at seat #3 
flk.Dasas: folds 
nald6232: folds 
ka100pka527 joins the table at seat #9 
Alex Frider: raises $1.15 to $2.15
matiko09: folds 
L4zy_FiSh: raises $6.85 to $9
Alex Frider: folds 
Uncalled bet ($6.85) returned to L4zy_FiSh
L4zy_FiSh collected $4.80 from pot
*** SUMMARY ***
Total pot $4.80 | Rake $0 
Seat 1: L4zy_FiSh (big blind) collected ($4.80)
Seat 2: flk.Dasas folded before Flop (didn't bet)
Seat 4: nald6232 folded before Flop (didn't bet)
Seat 6: Alex Frider (button) folded before Flop
Seat 8: matiko09 (small blind) folded before Flop





PokerStars Hand #155373483309:  Hold'em No Limit ($0.50/$1.00 USD) - 2016/06/30 8:14:32 CET [2016/06/30 2:14:32 ET]
Table 'Aunus' 9-max Seat #2 is the button
Seat 1: dboy604 ($56.33 in chips) 
Seat 2: HasBigBiceps ($100 in chips) 
Seat 3: matiko09 ($100 in chips) 
Seat 4: ilaviiitech ($100 in chips) 
Painkiller72 joins the table at seat #6 
matiko09: posts small blind $0.50
ilaviiitech: posts big blind $1
*** HOLE CARDS ***
Dealt to matiko09 [2c 4d]
dboy604: raises $4 to $5
HasBigBiceps: folds 
ka100pka527 joins the table at seat #7 
matiko09: folds 
ilaviiitech: folds 
Uncalled bet ($4) returned to dboy604
dboy604 collected $2.50 from pot
dboy604: doesn't show hand 
*** SUMMARY ***
Total pot $2.50 | Rake $0 
Seat 1: dboy604 collected ($2.50)
Seat 2: HasBigBiceps (button) folded before Flop (didn't bet)
Seat 3: matiko09 (small blind) folded before Flop
Seat 4: ilaviiitech (big blind) folded before Flop





PokerStars Hand #155373484904:  Hold'em No Limit ($0.50/$1.00 USD) - 2016/06/30 8:14:38 CET [2016/06/30 2:14:38 ET]
Table 'Euphrosyne' 9-max Seat #1 is the button
Seat 1: butcheN18 ($107.34 in chips) 
Seat 2: ilaviiitech ($100 in chips) 
Seat 3: picka4u ($51.25 in chips) 
Seat 5: RoadtoNepal ($100 in chips) 
Seat 7: flk.Dasas ($100.77 in chips) 
Seat 8: Dantist1122 ($101.50 in chips) 
Seat 9: matiko09 ($102 in chips) 
ilaviiitech: posts small blind $0.50
picka4u: posts big blind $1
bargs33: sits out 
Alex Frider: sits out 
*** HOLE CARDS ***
Dealt to matiko09 [Tc Ad]
RoadtoNepal: folds 
flk.Dasas: folds 
Dantist1122: folds 
matiko09: raises $1.50 to $2.50
butcheN18: folds 
ilaviiitech: folds 
picka4u: folds 
Uncalled bet ($1.50) returned to matiko09
matiko09 collected $2.50 from pot
matiko09: doesn't show hand 
*** SUMMARY ***
Total pot $2.50 | Rake $0 
Seat 1: butcheN18 (button) folded before Flop (didn't bet)
Seat 2: ilaviiitech (small blind) folded before Flop
Seat 3: picka4u (big blind) folded before Flop
Seat 5: RoadtoNepal folded before Flop (didn't bet)
Seat 7: flk.Dasas folded before Flop (didn't bet)
Seat 8: Dantist1122 folded before Flop (didn't bet)
Seat 9: matiko09 collected ($2.50)





PokerStars Hand #155373485112:  Hold'em No Limit ($0.25/$0.50 USD) - 2016/06/30 8:14:39 CET [2016/06/30 2:14:39 ET]
Table 'Ducrosa' 9-max Seat #7 is the button
Seat 1: Dantist1122 ($52.32 in chips) 
Seat 2: John_les ($50 in chips) 
Seat 3: matiko09 ($50 in chips) 
Seat 4: Lita17 ($73.88 in chips) 
Seat 5: beetge ($38 in chips) 
Seat 6: POTAPENKO700 ($50 in chips) 
Seat 7: THREE FlDDY ($54.25 in chips) 
Seat 9: ClassicWheel ($43.32 in chips) 
ClassicWheel: posts small blind $0.25
Dantist1122: posts big blind $0.50
*** HOLE CARDS ***
Dealt to matiko09 [Qd 8d]
John_les: folds 
matiko09: folds 
Lita17: folds 
beetge: folds 
POTAPENKO700: folds 
Dantistcopra joins the table at seat #8 
THREE FlDDY: raises $0.76 to $1.26
ClassicWheel: calls $1.01
Dantist1122: folds 
*** FLOP *** [2s Th 3h]
ClassicWheel: bets $1
THREE FlDDY: calls $1
*** TURN *** [2s Th 3h] [Qc]
ClassicWheel: bets $1.50
THREE FlDDY: calls $1.50
*** RIVER *** [2s Th 3h Qc] [3s]
ClassicWheel: bets $2.50
THREE FlDDY: folds 
Uncalled bet ($2.50) returned to ClassicWheel
ClassicWheel collected $7.62 from pot
ClassicWheel: doesn't show hand 
*** SUMMARY ***
Total pot $8.02 | Rake $0.40 
Board [2s Th 3h Qc 3s]
Seat 1: Dantist1122 (big blind) folded before Flop
Seat 2: John_les folded before Flop (didn't bet)
Seat 3: matiko09 folded before Flop (didn't bet)
Seat 4: Lita17 folded before Flop (didn't bet)
Seat 5: beetge folded before Flop (didn't bet)
Seat 6: POTAPENKO700 folded before Flop (didn't bet)
Seat 7: THREE FlDDY (button) folded on the River
Seat 9: ClassicWheel (small blind) collected ($7.62)





PokerStars Hand #155373488212:  Hold'em No Limit ($0.50/$1.00 USD) - 2016/06/30 8:14:52 CET [2016/06/30 2:14:52 ET]
Table 'Aunus' 9-max Seat #3 is the button
Seat 1: dboy604 ($57.83 in chips) 
Seat 2: HasBigBiceps ($100 in chips) 
Seat 3: matiko09 ($100 in chips) 
Seat 4: ilaviiitech ($100 in chips) 
Seat 6: Painkiller72 ($100 in chips) 
ilaviiitech: posts small blind $0.50
Painkiller72: posts big blind $1
ka100pka527: sits out 
*** HOLE CARDS ***
Dealt to matiko09 [9s 3c]
dboy604: raises $4 to $5
HasBigBiceps: calls $5
Dantist1122 joins the table at seat #8 
matiko09: folds 
ilaviiitech: folds 
Painkiller72: folds 
*** FLOP *** [Kh 5s 8s]
dboy604: bets $5
hammerwife is disconnected 
HasBigBiceps: folds 
Uncalled bet ($5) returned to dboy604
dboy604 collected $10.92 from pot
dboy604: doesn't show hand 
*** SUMMARY ***
Total pot $11.50 | Rake $0.58 
Board [Kh 5s 8s]
Seat 1: dboy604 collected ($10.92)
Seat 2: HasBigBiceps folded on the Flop
Seat 3: matiko09 (button) folded before Flop (didn't bet)
Seat 4: ilaviiitech (small blind) folded before Flop
Seat 6: Painkiller72 (big blind) folded before Flop





PokerStars Hand #155373489309:  Hold'em No Limit ($0.50/$1.00 USD) - 2016/06/30 8:14:57 CET [2016/06/30 2:14:57 ET]
Table 'Lucretia II' 9-max Seat #2 is the button
Seat 1: matiko09 ($105.02 in chips) 
Seat 2: picka4u ($62.05 in chips) 
Seat 3: Alex Frider ($169.32 in chips) 
Seat 4: John_les ($100 in chips) 
Seat 5: butcheN18 ($101.50 in chips) 
Seat 7: kingmaker209 ($43.29 in chips) 
Seat 8: snow937022 ($131.55 in chips) 
Seat 9: misko123 ($28.80 in chips) 
Alex Frider: posts small blind $0.50
John_les: posts big blind $1
flk.Dasas: sits out 
*** HOLE CARDS ***
Dealt to matiko09 [As Th]
butcheN18: raises $2 to $3
kingmaker209 has timed out
kingmaker209: folds 
snow937022: folds 
misko123: calls $3
matiko09: folds 
picka4u: folds 
Alex Frider: folds 
John_les: folds 
*** FLOP *** [Jc 4d 7c]
butcheN18: bets $4.55
misko123: calls $4.55
*** TURN *** [Jc 4d 7c] [2d]
butcheN18: checks 
misko123: bets $4
butcheN18: calls $4
*** RIVER *** [Jc 4d 7c 2d] [7d]
butcheN18: checks 
misko123: bets $8
butcheN18: folds 
Uncalled bet ($8) returned to misko123
misko123 collected $23.37 from pot
*** SUMMARY ***
Total pot $24.60 | Rake $1.23 
Board [Jc 4d 7c 2d 7d]
Seat 1: matiko09 folded before Flop (didn't bet)
Seat 2: picka4u (button) folded before Flop (didn't bet)
Seat 3: Alex Frider (small blind) folded before Flop
Seat 4: John_les (big blind) folded before Flop
Seat 5: butcheN18 folded on the River
Seat 7: kingmaker209 folded before Flop (didn't bet)
Seat 8: snow937022 folded before Flop (didn't bet)
Seat 9: misko123 collected ($23.37)





PokerStars Hand #155373490214:  Hold'em No Limit ($0.25/$0.50 USD) - 2016/06/30 8:15:01 CET [2016/06/30 2:15:01 ET]
Table 'Praxidike' 9-max Seat #5 is the button
Seat 1: Sniper1717 ($50 in chips) 
Seat 2: prominente ($170.14 in chips) 
Seat 3: THREE FlDDY ($50 in chips) 
Seat 4: nicklasrossd ($24.08 in chips) 
Seat 5: shiangshuina ($58.06 in chips) 
Seat 7: matiko09 ($52 in chips) 
Seat 8: Alexey_Kim2 ($50 in chips) 
matiko09: posts small blind $0.25
Alexey_Kim2: posts big blind $0.50
KABAL_ua: sits out 
*** HOLE CARDS ***
Dealt to matiko09 [9h Jc]
Sniper1717: folds 
prominente: folds 
THREE FlDDY: folds 
nicklasrossd: folds 
shiangshuina: folds 
matiko09: raises $1 to $1.50
Alexey_Kim2: calls $1
*** FLOP *** [5d Qs 2h]
matiko09: bets $1.85
Alexey_Kim2: calls $1.85
*** TURN *** [5d Qs 2h] [8d]
matiko09: bets $4
Alexey_Kim2: folds 
Uncalled bet ($4) returned to matiko09
matiko09 collected $6.36 from pot
matiko09: doesn't show hand 
*** SUMMARY ***
Total pot $6.70 | Rake $0.34 
Board [5d Qs 2h 8d]
Seat 1: Sniper1717 folded before Flop (didn't bet)
Seat 2: prominente folded before Flop (didn't bet)
Seat 3: THREE FlDDY folded before Flop (didn't bet)
Seat 4: nicklasrossd folded before Flop (didn't bet)
Seat 5: shiangshuina (button) folded before Flop (didn't bet)
Seat 7: matiko09 (small blind) collected ($6.36)
Seat 8: Alexey_Kim2 (big blind) folded on the Turn





PokerStars Hand #155373490395:  Hold'em No Limit ($0.50/$1.00 USD) - 2016/06/30 8:15:02 CET [2016/06/30 2:15:02 ET]
Table 'Peiraios' 9-max Seat #8 is the button
Seat 1: L4zy_FiSh ($118.31 in chips) 
Seat 2: flk.Dasas ($103 in chips) 
Seat 4: nald6232 ($93.04 in chips) 
Seat 6: Alex Frider ($156.64 in chips) 
Seat 8: matiko09 ($100 in chips) 
ka100pka527 will be allowed to play after the button
L4zy_FiSh: posts small blind $0.50
flk.Dasas: posts big blind $1
ricksdogs77: sits out 
bargs33: sits out 
*** HOLE CARDS ***
Dealt to matiko09 [7h 2s]
nald6232: folds 
Alex Frider: folds 
matiko09: folds 
L4zy_FiSh: raises $1.50 to $2.50
flk.Dasas: calls $1.50
*** FLOP *** [4c 8c Qd]
L4zy_FiSh: bets $2
flk.Dasas: calls $2
*** TURN *** [4c 8c Qd] [Js]
L4zy_FiSh: bets $4.50
flk.Dasas: folds 
Uncalled bet ($4.50) returned to L4zy_FiSh
L4zy_FiSh collected $8.55 from pot
*** SUMMARY ***
Total pot $9 | Rake $0.45 
Board [4c 8c Qd Js]
Seat 1: L4zy_FiSh (small blind) collected ($8.55)
Seat 2: flk.Dasas (big blind) folded on the Turn
Seat 4: nald6232 folded before Flop (didn't bet)
Seat 6: Alex Frider folded before Flop (didn't bet)
Seat 8: matiko09 (button) folded before Flop (didn't bet)





PokerStars Hand #155373490790:  Hold'em No Limit ($0.50/$1.00 USD) - 2016/06/30 8:15:03 CET [2016/06/30 2:15:03 ET]
Table 'Asmodeus' 9-max Seat #3 is the button
Seat 1: Imbear8 ($102.49 in chips) 
Seat 2: gleam6619 ($93.15 in chips) 
Seat 3: L4zy_FiSh ($100 in chips) 
Seat 4: matiko09 ($100 in chips) 
Seat 5: butcheN18 ($125.22 in chips) 
Seat 6: snow937022 ($149.13 in chips) 
Seat 7: picka4u ($38.50 in chips) 
Seat 8: RoadtoNepal ($100 in chips) 
Seat 9: flk.Dasas ($138.91 in chips) 
matiko09: posts small blind $0.50
butcheN18: posts big blind $1
*** HOLE CARDS ***
Dealt to matiko09 [Ks Jc]
snow937022: folds 
picka4u: folds 
RoadtoNepal: folds 
flk.Dasas: folds 
Imbear8: folds 
gleam6619: folds 
L4zy_FiSh: folds 
matiko09: raises $2 to $3
butcheN18: folds 
Uncalled bet ($2) returned to matiko09
matiko09 collected $2 from pot
matiko09: doesn't show hand 
*** SUMMARY ***
Total pot $2 | Rake $0 
Seat 1: Imbear8 folded before Flop (didn't bet)
Seat 2: gleam6619 folded before Flop (didn't bet)
Seat 3: L4zy_FiSh (button) folded before Flop (didn't bet)
Seat 4: matiko09 (small blind) collected ($2)
Seat 5: butcheN18 (big blind) folded before Flop
Seat 6: snow937022 folded before Flop (didn't bet)
Seat 7: picka4u folded before Flop (didn't bet)
Seat 8: RoadtoNepal folded before Flop (didn't bet)
Seat 9: flk.Dasas folded before Flop (didn't bet)





PokerStars Hand #155373493365:  Hold'em No Limit ($0.50/$1.00 USD) - 2016/06/30 8:15:14 CET [2016/06/30 2:15:14 ET]
Table 'Aunus' 9-max Seat #4 is the button
Seat 1: dboy604 ($63.75 in chips) 
Seat 2: HasBigBiceps ($100 in chips) 
Seat 3: matiko09 ($100 in chips) 
Seat 4: ilaviiitech ($100 in chips) 
Seat 6: Painkiller72 ($100 in chips) 
Seat 7: ka100pka527 ($40 in chips) 
Painkiller72: posts small blind $0.50
ka100pka527: posts big blind $1
Dantist1122: sits out 
*** HOLE CARDS ***
Dealt to matiko09 [Ts 3c]
dboy604: raises $5 to $6
HasBigBiceps: folds 
matiko09: folds 
ilaviiitech: folds 
Painkiller72: folds 
ka100pka527: folds 
Uncalled bet ($5) returned to dboy604
dboy604 collected $2.50 from pot
dboy604: doesn't show hand 
*** SUMMARY ***
Total pot $2.50 | Rake $0 
Seat 1: dboy604 collected ($2.50)
Seat 2: HasBigBiceps folded before Flop (didn't bet)
Seat 3: matiko09 folded before Flop (didn't bet)
Seat 4: ilaviiitech (button) folded before Flop (didn't bet)
Seat 6: Painkiller72 (small blind) folded before Flop
Seat 7: ka100pka527 (big blind) folded before Flop





PokerStars Hand #155373495631:  Hold'em No Limit ($0.50/$1.00 USD) - 2016/06/30 8:15:24 CET [2016/06/30 2:15:24 ET]
Table 'Asmodeus' 9-max Seat #4 is the button
Seat 1: Imbear8 ($102.49 in chips) 
Seat 2: gleam6619 ($93.15 in chips) 
Seat 3: L4zy_FiSh ($100 in chips) 
Seat 4: matiko09 ($101 in chips) 
Seat 5: butcheN18 ($124.22 in chips) 
Seat 6: snow937022 ($149.13 in chips) 
Seat 7: picka4u ($38.50 in chips) 
Seat 8: RoadtoNepal ($100 in chips) 
Seat 9: flk.Dasas ($138.91 in chips) 
butcheN18: posts small blind $0.50
snow937022: posts big blind $1
*** HOLE CARDS ***
Dealt to matiko09 [5d 5s]
picka4u: folds 
RoadtoNepal: raises $2 to $3
flk.Dasas: folds 
Imbear8: folds 
gleam6619: folds 
L4zy_FiSh: folds 
matiko09: calls $3
butcheN18: folds 
snow937022: folds 
*** FLOP *** [As Th 6d]
RoadtoNepal: bets $5.34
matiko09: folds 
Uncalled bet ($5.34) returned to RoadtoNepal
RoadtoNepal collected $7.12 from pot
*** SUMMARY ***
Total pot $7.50 | Rake $0.38 
Board [As Th 6d]
Seat 1: Imbear8 folded before Flop (didn't bet)
Seat 2: gleam6619 folded before Flop (didn't bet)
Seat 3: L4zy_FiSh folded before Flop (didn't bet)
Seat 4: matiko09 (button) folded on the Flop
Seat 5: butcheN18 (small blind) folded before Flop
Seat 6: snow937022 (big blind) folded before Flop
Seat 7: picka4u folded before Flop (didn't bet)
Seat 8: RoadtoNepal collected ($7.12)
Seat 9: flk.Dasas folded before Flop (didn't bet)





PokerStars Hand #155373497131:  Hold'em No Limit ($0.50/$1.00 USD) - 2016/06/30 8:15:31 CET [2016/06/30 2:15:31 ET]
Table 'Euphrosyne' 9-max Seat #2 is the button
Seat 1: butcheN18 ($107.34 in chips) 
Seat 2: ilaviiitech ($100 in chips) 
Seat 3: picka4u ($50.25 in chips) 
Seat 4: bargs33 ($100 in chips) 
Seat 5: RoadtoNepal ($100 in chips) 
Seat 7: flk.Dasas ($100.77 in chips) 
Seat 8: Dantist1122 ($101.50 in chips) 
Seat 9: matiko09 ($103.50 in chips) 
picka4u: posts small blind $0.50
bargs33: posts big blind $1
Alex Frider: sits out 
*** HOLE CARDS ***
Dealt to matiko09 [Jh 8s]
RoadtoNepal: folds 
flk.Dasas: raises $2 to $3
Dantist1122: folds 
RoadtoNepal leaves the table
L4zy_FiSh joins the table at seat #5 
matiko09: folds 
butcheN18: folds 
ilaviiitech: folds 
picka4u: folds 
bargs33: folds 
Uncalled bet ($2) returned to flk.Dasas
flk.Dasas collected $2.50 from pot
flk.Dasas: doesn't show hand 
*** SUMMARY ***
Total pot $2.50 | Rake $0 
Seat 1: butcheN18 folded before Flop (didn't bet)
Seat 2: ilaviiitech (button) folded before Flop (didn't bet)
Seat 3: picka4u (small blind) folded before Flop
Seat 4: bargs33 (big blind) folded before Flop
Seat 5: RoadtoNepal folded before Flop (didn't bet)
Seat 7: flk.Dasas collected ($2.50)
Seat 8: Dantist1122 folded before Flop (didn't bet)
Seat 9: matiko09 folded before Flop (didn't bet)





PokerStars Hand #155373501843:  Hold'em No Limit ($0.50/$1.00 USD) - 2016/06/30 8:15:51 CET [2016/06/30 2:15:51 ET]
Table 'Aunus' 9-max Seat #6 is the button
Seat 1: dboy604 ($65.25 in chips) 
Seat 2: HasBigBiceps ($100 in chips) 
Seat 3: matiko09 ($100 in chips) 
Seat 4: ilaviiitech ($100 in chips) 
Seat 6: Painkiller72 ($100 in chips) 
Seat 7: ka100pka527 ($39 in chips) 
Seat 8: Dantist1122 ($100 in chips) 
ka100pka527: posts small blind $0.50
Dantist1122: posts big blind $1
*** HOLE CARDS ***
Dealt to matiko09 [3d 8h]
dboy604: folds 
HasBigBiceps: folds 
matiko09: folds 
ilaviiitech: folds 
Painkiller72: folds 
ka100pka527: folds 
Uncalled bet ($0.50) returned to Dantist1122
Dantist1122 collected $1 from pot
Dantist1122: doesn't show hand 
*** SUMMARY ***
Total pot $1 | Rake $0 
Seat 1: dboy604 folded before Flop (didn't bet)
Seat 2: HasBigBiceps folded before Flop (didn't bet)
Seat 3: matiko09 folded before Flop (didn't bet)
Seat 4: ilaviiitech folded before Flop (didn't bet)
Seat 6: Painkiller72 (button) folded before Flop (didn't bet)
Seat 7: ka100pka527 (small blind) folded before Flop
Seat 8: Dantist1122 (big blind) collected ($1)





PokerStars Hand #155373502949:  Hold'em No Limit ($0.50/$1.00 USD) - 2016/06/30 8:15:56 CET [2016/06/30 2:15:56 ET]
Table 'Euphrosyne' 9-max Seat #3 is the button
Seat 1: butcheN18 ($107.34 in chips) 
Seat 2: ilaviiitech ($100 in chips) 
Seat 3: picka4u ($49.75 in chips) 
Seat 4: bargs33 ($99 in chips) 
Seat 5: L4zy_FiSh ($100 in chips) 
Seat 7: flk.Dasas ($102.27 in chips) 
Seat 8: Dantist1122 ($101.50 in chips) 
Seat 9: matiko09 ($103.50 in chips) 
bargs33: posts small blind $0.50
L4zy_FiSh: posts big blind $1
Alex Frider: sits out 
*** HOLE CARDS ***
Dealt to matiko09 [5h 8h]
flk.Dasas: folds 
Dantist1122: folds 
matiko09: folds 
butcheN18: folds 
ilaviiitech: raises $2 to $3
picka4u: folds 
bargs33: folds 
L4zy_FiSh: folds 
Uncalled bet ($2) returned to ilaviiitech
ilaviiitech collected $2.50 from pot
ilaviiitech: doesn't show hand 
*** SUMMARY ***
Total pot $2.50 | Rake $0 
Seat 1: butcheN18 folded before Flop (didn't bet)
Seat 2: ilaviiitech collected ($2.50)
Seat 3: picka4u (button) folded before Flop (didn't bet)
Seat 4: bargs33 (small blind) folded before Flop
Seat 5: L4zy_FiSh (big blind) folded before Flop
Seat 7: flk.Dasas folded before Flop (didn't bet)
Seat 8: Dantist1122 folded before Flop (didn't bet)
Seat 9: matiko09 folded before Flop (didn't bet)





PokerStars Hand #155373505062:  Hold'em No Limit ($0.25/$0.50 USD) - 2016/06/30 8:16:05 CET [2016/06/30 2:16:05 ET]
Table 'Ducrosa' 9-max Seat #9 is the button
Seat 1: Dantist1122 ($51.82 in chips) 
Seat 2: John_les ($50 in chips) 
Seat 3: matiko09 ($50 in chips) 
Seat 4: Lita17 ($73.88 in chips) 
Seat 5: beetge ($38 in chips) 
Seat 6: POTAPENKO700 ($50 in chips) 
Seat 7: THREE FlDDY ($50.49 in chips) 
Seat 9: ClassicWheel ($47.18 in chips) 
Dantist1122: posts small blind $0.25
John_les: posts big blind $0.50
Dantistcopra: sits out 
*** HOLE CARDS ***
Dealt to matiko09 [3c Kc]
matiko09: folds 
Lita17: folds 
beetge: raises $1.50 to $2
POTAPENKO700: folds 
THREE FlDDY: folds 
ClassicWheel: folds 
Dantist1122: folds 
John_les: folds 
Uncalled bet ($1.50) returned to beetge
beetge collected $1.25 from pot
beetge: doesn't show hand 
*** SUMMARY ***
Total pot $1.25 | Rake $0 
Seat 1: Dantist1122 (small blind) folded before Flop
Seat 2: John_les (big blind) folded before Flop
Seat 3: matiko09 folded before Flop (didn't bet)
Seat 4: Lita17 folded before Flop (didn't bet)
Seat 5: beetge collected ($1.25)
Seat 6: POTAPENKO700 folded before Flop (didn't bet)
Seat 7: THREE FlDDY folded before Flop (didn't bet)
Seat 9: ClassicWheel (button) folded before Flop (didn't bet)





PokerStars Hand #155373505258:  Hold'em No Limit ($0.25/$0.50 USD) - 2016/06/30 8:16:06 CET [2016/06/30 2:16:06 ET]
Table 'Praxidike' 9-max Seat #7 is the button
Seat 1: Sniper1717 ($50 in chips) 
Seat 2: prominente ($170.14 in chips) 
Seat 3: THREE FlDDY ($50 in chips) 
Seat 4: nicklasrossd ($24.08 in chips) 
Seat 5: shiangshuina ($58.06 in chips) 
Seat 7: matiko09 ($55.01 in chips) 
Seat 8: Alexey_Kim2 ($50 in chips) 
Seat 9: KABAL_ua ($50.68 in chips) 
Alexey_Kim2: posts small blind $0.25
KABAL_ua: posts big blind $0.50
Dantistcopra: sits out 
*** HOLE CARDS ***
Dealt to matiko09 [8h Ad]
Sniper1717: folds 
prominente: folds 
THREE FlDDY: folds 
nicklasrossd: calls $0.50
shiangshuina: folds 
matiko09: raises $1.50 to $2
Alexey_Kim2: folds 
KABAL_ua: folds 
nicklasrossd: calls $1.50
*** FLOP *** [8c Qs Ah]
nicklasrossd: bets $2
matiko09: calls $2
*** TURN *** [8c Qs Ah] [Qd]
nicklasrossd: checks 
matiko09: checks 
*** RIVER *** [8c Qs Ah Qd] [2h]
nicklasrossd: bets $4
matiko09: calls $4
*** SHOW DOWN ***
nicklasrossd: shows [7c 5c] (a pair of Queens)
matiko09: shows [8h Ad] (two pair, Aces and Queens)
matiko09 collected $15.91 from pot
*** SUMMARY ***
Total pot $16.75 | Rake $0.84 
Board [8c Qs Ah Qd 2h]
Seat 1: Sniper1717 folded before Flop (didn't bet)
Seat 2: prominente folded before Flop (didn't bet)
Seat 3: THREE FlDDY folded before Flop (didn't bet)
Seat 4: nicklasrossd showed [7c 5c] and lost with a pair of Queens
Seat 5: shiangshuina folded before Flop (didn't bet)
Seat 7: matiko09 (button) showed [8h Ad] and won ($15.91) with two pair, Aces and Queens
Seat 8: Alexey_Kim2 (small blind) folded before Flop
Seat 9: KABAL_ua (big blind) folded before Flop





PokerStars Hand #155373505777:  Hold'em No Limit ($0.50/$1.00 USD) - 2016/06/30 8:16:08 CET [2016/06/30 2:16:08 ET]
Table 'Peiraios' 9-max Seat #1 is the button
Seat 1: L4zy_FiSh ($122.36 in chips) 
Seat 2: flk.Dasas ($100 in chips) 
Seat 3: ricksdogs77 ($40 in chips) 
Seat 4: nald6232 ($93.04 in chips) 
Seat 6: Alex Frider ($156.64 in chips) 
Seat 8: matiko09 ($100 in chips) 
flk.Dasas: posts small blind $0.50
ricksdogs77: posts big blind $1
bargs33: sits out 
ka100pka527: sits out 
*** HOLE CARDS ***
Dealt to matiko09 [2c Jd]
nald6232: folds 
Alex Frider: raises $2 to $3
matiko09: folds 
L4zy_FiSh: folds 
flk.Dasas: calls $2.50
ricksdogs77 has timed out
ricksdogs77: folds 
*** FLOP *** [6c Td 5c]
flk.Dasas: checks 
Alex Frider: checks 
*** TURN *** [6c Td 5c] [7d]
flk.Dasas: bets $4.52
Alex Frider: folds 
Uncalled bet ($4.52) returned to flk.Dasas
flk.Dasas collected $6.65 from pot
flk.Dasas: doesn't show hand 
*** SUMMARY ***
Total pot $7 | Rake $0.35 
Board [6c Td 5c 7d]
Seat 1: L4zy_FiSh (button) folded before Flop (didn't bet)
Seat 2: flk.Dasas (small blind) collected ($6.65)
Seat 3: ricksdogs77 (big blind) folded before Flop
Seat 4: nald6232 folded before Flop (didn't bet)
Seat 6: Alex Frider folded on the Turn
Seat 8: matiko09 folded before Flop (didn't bet)





PokerStars Hand #155373507110:  Hold'em No Limit ($0.50/$1.00 USD) - 2016/06/30 8:16:13 CET [2016/06/30 2:16:13 ET]
Table 'Aunus' 9-max Seat #7 is the button
Seat 1: dboy604 ($65.25 in chips) 
Seat 2: HasBigBiceps ($100 in chips) 
Seat 3: matiko09 ($100 in chips) 
Seat 4: ilaviiitech ($100 in chips) 
Seat 6: Painkiller72 ($100 in chips) 
Seat 7: ka100pka527 ($38.50 in chips) 
Seat 8: Dantist1122 ($100.50 in chips) 
Dantist1122: posts small blind $0.50
dboy604: posts big blind $1
*** HOLE CARDS ***
Dealt to matiko09 [Kh Ts]
HasBigBiceps: folds 
matiko09: raises $2 to $3
ilaviiitech: folds 
Painkiller72: folds 
ka100pka527: folds 
Dantist1122: folds 
dboy604: calls $2
*** FLOP *** [Jd 9c 8d]
dboy604: bets $4
matiko09: calls $4
*** TURN *** [Jd 9c 8d] [5s]
dboy604: bets $16
matiko09: folds 
Uncalled bet ($16) returned to dboy604
dboy604 collected $13.78 from pot
dboy604: doesn't show hand 
*** SUMMARY ***
Total pot $14.50 | Rake $0.72 
Board [Jd 9c 8d 5s]
Seat 1: dboy604 (big blind) collected ($13.78)
Seat 2: HasBigBiceps folded before Flop (didn't bet)
Seat 3: matiko09 folded on the Turn
Seat 4: ilaviiitech folded before Flop (didn't bet)
Seat 6: Painkiller72 folded before Flop (didn't bet)
Seat 7: ka100pka527 (button) folded before Flop (didn't bet)
Seat 8: Dantist1122 (small blind) folded before Flop





PokerStars Hand #155373509444:  Hold'em No Limit ($0.50/$1.00 USD) - 2016/06/30 8:16:24 CET [2016/06/30 2:16:24 ET]
Table 'Lucretia II' 9-max Seat #3 is the button
Seat 1: matiko09 ($105.02 in chips) 
Seat 2: picka4u ($62.05 in chips) 
Seat 3: Alex Frider ($168.82 in chips) 
Seat 4: John_les ($100 in chips) 
Seat 5: butcheN18 ($100 in chips) 
Seat 7: kingmaker209 ($43.29 in chips) 
Seat 8: snow937022 ($131.55 in chips) 
Seat 9: misko123 ($40.62 in chips) 
John_les: posts small blind $0.50
butcheN18: posts big blind $1
flk.Dasas: sits out 
*** HOLE CARDS ***
Dealt to matiko09 [5h 3d]
kingmaker209: calls $1
snow937022: folds 
misko123: folds 
matiko09: folds 
picka4u: folds 
Alex Frider: folds 
John_les: calls $0.50
butcheN18: checks 
*** FLOP *** [7s 3c Ah]
John_les: bets $1.91
butcheN18: folds 
kingmaker209: calls $1.91
*** TURN *** [7s 3c Ah] [5s]
John_les: bets $4
kingmaker209: folds 
Uncalled bet ($4) returned to John_les
John_les collected $6.48 from pot
John_les: doesn't show hand 
*** SUMMARY ***
Total pot $6.82 | Rake $0.34 
Board [7s 3c Ah 5s]
Seat 1: matiko09 folded before Flop (didn't bet)
Seat 2: picka4u folded before Flop (didn't bet)
Seat 3: Alex Frider (button) folded before Flop (didn't bet)
Seat 4: John_les (small blind) collected ($6.48)
Seat 5: butcheN18 (big blind) folded on the Flop
Seat 7: kingmaker209 folded on the Turn
Seat 8: snow937022 folded before Flop (didn't bet)
Seat 9: misko123 folded before Flop (didn't bet)





PokerStars Hand #155373510374:  Hold'em No Limit ($0.25/$0.50 USD) - 2016/06/30 8:16:27 CET [2016/06/30 2:16:27 ET]
Table 'Ducrosa' 9-max Seat #1 is the button
Seat 1: Dantist1122 ($51.57 in chips) 
Seat 2: John_les ($50 in chips) 
Seat 3: matiko09 ($50 in chips) 
Seat 4: Lita17 ($73.88 in chips) 
Seat 5: beetge ($38.75 in chips) 
Seat 6: POTAPENKO700 ($50 in chips) 
Seat 7: THREE FlDDY ($50.49 in chips) 
Seat 9: ClassicWheel ($47.18 in chips) 
John_les: posts small blind $0.25
matiko09: posts big blind $0.50
Dantistcopra: sits out 
*** HOLE CARDS ***
Dealt to matiko09 [5c 4c]
Lita17: folds 
beetge: folds 
POTAPENKO700: folds 
THREE FlDDY: folds 
ClassicWheel: raises $1 to $1.50
Dantist1122: folds 
John_les: folds 
matiko09: folds 
Uncalled bet ($1) returned to ClassicWheel
ClassicWheel collected $1.25 from pot
ClassicWheel: doesn't show hand 
*** SUMMARY ***
Total pot $1.25 | Rake $0 
Seat 1: Dantist1122 (button) folded before Flop (didn't bet)
Seat 2: John_les (small blind) folded before Flop
Seat 3: matiko09 (big blind) folded before Flop
Seat 4: Lita17 folded before Flop (didn't bet)
Seat 5: beetge folded before Flop (didn't bet)
Seat 6: POTAPENKO700 folded before Flop (didn't bet)
Seat 7: THREE FlDDY folded before Flop (didn't bet)
Seat 9: ClassicWheel collected ($1.25)





PokerStars Hand #155373510870:  Hold'em No Limit ($0.50/$1.00 USD) - 2016/06/30 8:16:30 CET [2016/06/30 2:16:30 ET]
Table 'Asmodeus' 9-max Seat #5 is the button
Seat 1: Imbear8 ($102.49 in chips) 
Seat 2: gleam6619 ($93.15 in chips) 
Seat 3: L4zy_FiSh ($100 in chips) 
Seat 4: matiko09 ($100 in chips) 
Seat 5: butcheN18 ($123.72 in chips) 
Seat 6: snow937022 ($148.13 in chips) 
Seat 7: picka4u ($38.50 in chips) 
Seat 8: RoadtoNepal ($104.12 in chips) 
Seat 9: flk.Dasas ($138.91 in chips) 
snow937022: posts small blind $0.50
picka4u: posts big blind $1
*** HOLE CARDS ***
Dealt to matiko09 [7s 8d]
RoadtoNepal: folds 
flk.Dasas: folds 
Imbear8: folds 
gleam6619: folds 
L4zy_FiSh: folds 
matiko09: folds 
butcheN18: folds 
snow937022: folds 
Uncalled bet ($0.50) returned to picka4u
picka4u collected $1 from pot
picka4u: doesn't show hand 
*** SUMMARY ***
Total pot $1 | Rake $0 
Seat 1: Imbear8 folded before Flop (didn't bet)
Seat 2: gleam6619 folded before Flop (didn't bet)
Seat 3: L4zy_FiSh folded before Flop (didn't bet)
Seat 4: matiko09 folded before Flop (didn't bet)
Seat 5: butcheN18 (button) folded before Flop (didn't bet)
Seat 6: snow937022 (small blind) folded before Flop
Seat 7: picka4u (big blind) collected ($1)
Seat 8: RoadtoNepal folded before Flop (didn't bet)
Seat 9: flk.Dasas folded before Flop (didn't bet)





PokerStars Hand #155373511925:  Hold'em No Limit ($0.50/$1.00 USD) - 2016/06/30 8:16:34 CET [2016/06/30 2:16:34 ET]
Table 'Euphrosyne' 9-max Seat #4 is the button
Seat 1: butcheN18 ($107.34 in chips) 
Seat 2: ilaviiitech ($101.50 in chips) 
Seat 3: picka4u ($49.75 in chips) 
Seat 4: bargs33 ($98.50 in chips) 
Seat 5: L4zy_FiSh ($100 in chips) 
Seat 6: Alex Frider ($100 in chips) 
Seat 7: flk.Dasas ($102.27 in chips) 
Seat 8: Dantist1122 ($101.50 in chips) 
Seat 9: matiko09 ($103.50 in chips) 
L4zy_FiSh: posts small blind $0.50
Alex Frider: posts big blind $1
*** HOLE CARDS ***
Dealt to matiko09 [6c 2h]
flk.Dasas: folds 
Dantist1122: folds 
matiko09: folds 
butcheN18: raises $2 to $3
ilaviiitech: folds 
picka4u: folds 
bargs33: calls $3
L4zy_FiSh: folds 
Alex Frider: calls $2
*** FLOP *** [2c 8h Qh]
Alex Frider: checks 
butcheN18: bets $6
bargs33: folds 
Alex Frider: calls $6
*** TURN *** [2c 8h Qh] [4c]
Alex Frider: checks 
butcheN18: checks 
*** RIVER *** [2c 8h Qh 4c] [5s]
Alex Frider: bets $10.50
butcheN18: calls $10.50
*** SHOW DOWN ***
Alex Frider: shows [Kd Qd] (a pair of Queens)
butcheN18: mucks hand 
Alex Frider collected $40.38 from pot
*** SUMMARY ***
Total pot $42.50 | Rake $2.12 
Board [2c 8h Qh 4c 5s]
Seat 1: butcheN18 mucked [Tc 8c]
Seat 2: ilaviiitech folded before Flop (didn't bet)
Seat 3: picka4u folded before Flop (didn't bet)
Seat 4: bargs33 (button) folded on the Flop
Seat 5: L4zy_FiSh (small blind) folded before Flop
Seat 6: Alex Frider (big blind) showed [Kd Qd] and won ($40.38) with a pair of Queens
Seat 7: flk.Dasas folded before Flop (didn't bet)
Seat 8: Dantist1122 folded before Flop (didn't bet)
Seat 9: matiko09 folded before Flop (didn't bet)





PokerStars Hand #155373516391:  Hold'em No Limit ($0.50/$1.00 USD) - 2016/06/30 8:16:54 CET [2016/06/30 2:16:54 ET]
Table 'Asmodeus' 9-max Seat #6 is the button
Seat 1: Imbear8 ($102.49 in chips) 
Seat 2: gleam6619 ($93.15 in chips) 
Seat 3: L4zy_FiSh ($100 in chips) 
Seat 4: matiko09 ($100 in chips) 
Seat 5: butcheN18 ($123.72 in chips) 
Seat 6: snow937022 ($147.63 in chips) 
Seat 7: picka4u ($39 in chips) 
Seat 8: RoadtoNepal ($104.12 in chips) 
Seat 9: flk.Dasas ($138.91 in chips) 
picka4u: posts small blind $0.50
RoadtoNepal: posts big blind $1
*** HOLE CARDS ***
Dealt to matiko09 [2s 5c]
flk.Dasas: folds 
Imbear8: folds 
gleam6619: raises $2 to $3
L4zy_FiSh: folds 
matiko09: folds 
butcheN18: folds 
snow937022: folds 
picka4u: folds 
RoadtoNepal: raises $6 to $9
gleam6619: folds 
Uncalled bet ($6) returned to RoadtoNepal
RoadtoNepal collected $6.50 from pot
*** SUMMARY ***
Total pot $6.50 | Rake $0 
Seat 1: Imbear8 folded before Flop (didn't bet)
Seat 2: gleam6619 folded before Flop
Seat 3: L4zy_FiSh folded before Flop (didn't bet)
Seat 4: matiko09 folded before Flop (didn't bet)
Seat 5: butcheN18 folded before Flop (didn't bet)
Seat 6: snow937022 (button) folded before Flop (didn't bet)
Seat 7: picka4u (small blind) folded before Flop
Seat 8: RoadtoNepal (big blind) collected ($6.50)
Seat 9: flk.Dasas folded before Flop (didn't bet)





PokerStars Hand #155373517699:  Hold'em No Limit ($0.25/$0.50 USD) - 2016/06/30 8:16:59 CET [2016/06/30 2:16:59 ET]
Table 'Ducrosa' 9-max Seat #2 is the button
Seat 1: Dantist1122 ($51.57 in chips) 
Seat 2: John_les ($50 in chips) 
Seat 3: matiko09 ($50 in chips) 
Seat 4: Lita17 ($73.88 in chips) 
Seat 5: beetge ($38.75 in chips) 
Seat 6: POTAPENKO700 ($50 in chips) 
Seat 7: THREE FlDDY ($50.49 in chips) 
Seat 9: ClassicWheel ($47.93 in chips) 
matiko09: posts small blind $0.25
Lita17: posts big blind $0.50
Dantistcopra: sits out 
*** HOLE CARDS ***
Dealt to matiko09 [Td 2d]
beetge: folds 
POTAPENKO700: raises $0.75 to $1.25
THREE FlDDY: raises $3.25 to $4.50
ClassicWheel: folds 
Dantist1122: folds 
John_les: folds 
matiko09: folds 
Lita17: folds 
POTAPENKO700: folds 
Uncalled bet ($3.25) returned to THREE FlDDY
THREE FlDDY collected $3.25 from pot
THREE FlDDY: doesn't show hand 
*** SUMMARY ***
Total pot $3.25 | Rake $0 
Seat 1: Dantist1122 folded before Flop (didn't bet)
Seat 2: John_les (button) folded before Flop (didn't bet)
Seat 3: matiko09 (small blind) folded before Flop
Seat 4: Lita17 (big blind) folded before Flop
Seat 5: beetge folded before Flop (didn't bet)
Seat 6: POTAPENKO700 folded before Flop
Seat 7: THREE FlDDY collected ($3.25)
Seat 9: ClassicWheel folded before Flop (didn't bet)





PokerStars Hand #155373519438:  Hold'em No Limit ($0.50/$1.00 USD) - 2016/06/30 8:17:07 CET [2016/06/30 2:17:07 ET]
Table 'Aunus' 9-max Seat #8 is the button
Seat 1: dboy604 ($72.03 in chips) 
Seat 2: HasBigBiceps ($100 in chips) 
Seat 3: matiko09 ($100 in chips) 
Seat 4: ilaviiitech ($100 in chips) 
Seat 6: Painkiller72 ($100 in chips) 
Seat 7: ka100pka527 ($38.50 in chips) 
Seat 8: Dantist1122 ($100 in chips) 
dboy604: posts small blind $0.50
HasBigBiceps: posts big blind $1
hammerwife: sits out 
*** HOLE CARDS ***
Dealt to matiko09 [Td 7h]
matiko09: folds 
ilaviiitech: folds 
Painkiller72: raises $1.50 to $2.50
ka100pka527: folds 
Dantist1122: folds 
dboy604: folds 
HasBigBiceps: calls $1.50
*** FLOP *** [8d 3s 4h]
HasBigBiceps: checks 
Painkiller72: bets $3.65
HasBigBiceps: calls $3.65
*** TURN *** [8d 3s 4h] [9h]
HasBigBiceps: checks 
Painkiller72: bets $8.51
HasBigBiceps: folds 
Uncalled bet ($8.51) returned to Painkiller72
dboy604 said, "wooo"
Painkiller72 collected $12.16 from pot
Painkiller72: doesn't show hand 
*** SUMMARY ***
Total pot $12.80 | Rake $0.64 
Board [8d 3s 4h 9h]
Seat 1: dboy604 (small blind) folded before Flop
Seat 2: HasBigBiceps (big blind) folded on the Turn
Seat 3: matiko09 folded before Flop (didn't bet)
Seat 4: ilaviiitech folded before Flop (didn't bet)
Seat 6: Painkiller72 collected ($12.16)
Seat 7: ka100pka527 folded before Flop (didn't bet)
Seat 8: Dantist1122 (button) folded before Flop (didn't bet)





PokerStars Hand #155373522030:  Hold'em No Limit ($0.25/$0.50 USD) - 2016/06/30 8:17:18 CET [2016/06/30 2:17:18 ET]
Table 'Praxidike' 9-max Seat #8 is the button
Seat 1: Sniper1717 ($50 in chips) 
Seat 2: prominente ($170.14 in chips) 
Seat 3: THREE FlDDY ($50 in chips) 
Seat 4: nicklasrossd ($16.08 in chips) 
Seat 5: shiangshuina ($58.06 in chips) 
Seat 7: matiko09 ($62.92 in chips) 
Seat 8: Alexey_Kim2 ($50 in chips) 
Seat 9: KABAL_ua ($50.18 in chips) 
KABAL_ua: posts small blind $0.25
Sniper1717: posts big blind $0.50
Dantistcopra: sits out 
*** HOLE CARDS ***
Dealt to matiko09 [7h 8d]
prominente: folds 
THREE FlDDY: folds 
nicklasrossd: folds 
shiangshuina: folds 
matiko09: folds 
Alexey_Kim2: raises $0.75 to $1.25
KABAL_ua: folds 
Sniper1717: folds 
Uncalled bet ($0.75) returned to Alexey_Kim2
Alexey_Kim2 collected $1.25 from pot
Alexey_Kim2: doesn't show hand 
*** SUMMARY ***
Total pot $1.25 | Rake $0 
Seat 1: Sniper1717 (big blind) folded before Flop
Seat 2: prominente folded before Flop (didn't bet)
Seat 3: THREE FlDDY folded before Flop (didn't bet)
Seat 4: nicklasrossd folded before Flop (didn't bet)
Seat 5: shiangshuina folded before Flop (didn't bet)
Seat 7: matiko09 folded before Flop (didn't bet)
Seat 8: Alexey_Kim2 (button) collected ($1.25)
Seat 9: KABAL_ua (small blind) folded before Flop





PokerStars Hand #155373524553:  Hold'em No Limit ($0.50/$1.00 USD) - 2016/06/30 8:17:28 CET [2016/06/30 2:17:28 ET]
Table 'Lucretia II' 9-max Seat #4 is the button
Seat 1: matiko09 ($105.02 in chips) 
Seat 2: picka4u ($62.05 in chips) 
Seat 3: Alex Frider ($168.82 in chips) 
Seat 4: John_les ($103.57 in chips) 
Seat 5: butcheN18 ($100 in chips) 
Seat 6: flk.Dasas ($100 in chips) 
Seat 7: kingmaker209 ($40.38 in chips) 
Seat 8: snow937022 ($131.55 in chips) 
Seat 9: misko123 ($40.62 in chips) 
butcheN18: posts small blind $0.50
flk.Dasas: posts big blind $1
*** HOLE CARDS ***
Dealt to matiko09 [6s 2c]
kingmaker209: calls $1
snow937022: folds 
misko123: calls $1
matiko09: folds 
picka4u: folds 
Alex Frider: raises $5 to $6
John_les: folds 
butcheN18: folds 
flk.Dasas: folds 
kingmaker209: folds 
misko123: calls $5
*** FLOP *** [Ac 8c 4s]
misko123: checks 
Alex Frider: bets $6.02
misko123: raises $6.02 to $12.04
Alex Frider: raises $27.26 to $39.30
misko123: folds 
Uncalled bet ($27.26) returned to Alex Frider
Alex Frider collected $36.65 from pot
Alex Frider: doesn't show hand 
*** SUMMARY ***
Total pot $38.58 | Rake $1.93 
Board [Ac 8c 4s]
Seat 1: matiko09 folded before Flop (didn't bet)
Seat 2: picka4u folded before Flop (didn't bet)
Seat 3: Alex Frider collected ($36.65)
Seat 4: John_les (button) folded before Flop (didn't bet)
Seat 5: butcheN18 (small blind) folded before Flop
Seat 6: flk.Dasas (big blind) folded before Flop
Seat 7: kingmaker209 folded before Flop
Seat 8: snow937022 folded before Flop (didn't bet)
Seat 9: misko123 folded on the Flop





PokerStars Hand #155373524676:  Hold'em No Limit ($0.25/$0.50 USD) - 2016/06/30 8:17:29 CET [2016/06/30 2:17:29 ET]
Table 'Ducrosa' 9-max Seat #3 is the button
Seat 1: Dantist1122 ($51.57 in chips) 
Seat 2: John_les ($50 in chips) 
Seat 3: matiko09 ($50 in chips) 
Seat 4: Lita17 ($73.38 in chips) 
Seat 5: beetge ($38.75 in chips) 
Seat 6: POTAPENKO700 ($50 in chips) 
Seat 7: THREE FlDDY ($52.49 in chips) 
Seat 9: ClassicWheel ($47.93 in chips) 
Lita17: posts small blind $0.25
beetge: posts big blind $0.50
Dantistcopra: sits out 
*** HOLE CARDS ***
Dealt to matiko09 [Ts 3h]
POTAPENKO700: folds 
THREE FlDDY: folds 
ClassicWheel: folds 
Dantist1122: folds 
John_les: raises $1 to $1.50
matiko09: folds 
Lita17: folds 
beetge: calls $1
*** FLOP *** [Ac Js Kc]
beetge: checks 
John_les: bets $2.07
beetge: calls $2.07
*** TURN *** [Ac Js Kc] [2d]
beetge: checks 
John_les: checks 
*** RIVER *** [Ac Js Kc 2d] [As]
beetge: checks 
John_les: checks 
*** SHOW DOWN ***
beetge: shows [9d Ah] (three of a kind, Aces)
John_les: mucks hand 
beetge collected $7.02 from pot
*** SUMMARY ***
Total pot $7.39 | Rake $0.37 
Board [Ac Js Kc 2d As]
Seat 1: Dantist1122 folded before Flop (didn't bet)
Seat 2: John_les mucked [7h 7d]
Seat 3: matiko09 (button) folded before Flop (didn't bet)
Seat 4: Lita17 (small blind) folded before Flop
Seat 5: beetge (big blind) showed [9d Ah] and won ($7.02) with three of a kind, Aces
Seat 6: POTAPENKO700 folded before Flop (didn't bet)
Seat 7: THREE FlDDY folded before Flop (didn't bet)
Seat 9: ClassicWheel folded before Flop (didn't bet)





PokerStars Hand #155373526405:  Hold'em No Limit ($0.50/$1.00 USD) - 2016/06/30 8:17:36 CET [2016/06/30 2:17:36 ET]
Table 'Asmodeus' 9-max Seat #7 is the button
Seat 1: Imbear8 ($102.49 in chips) 
Seat 2: gleam6619 ($90.15 in chips) 
Seat 3: L4zy_FiSh ($100 in chips) 
Seat 4: matiko09 ($100 in chips) 
Seat 5: butcheN18 ($123.72 in chips) 
Seat 6: snow937022 ($147.63 in chips) 
Seat 7: picka4u ($38.50 in chips) 
Seat 8: RoadtoNepal ($107.62 in chips) 
Seat 9: flk.Dasas ($138.91 in chips) 
RoadtoNepal: posts small blind $0.50
flk.Dasas: posts big blind $1
*** HOLE CARDS ***
Dealt to matiko09 [4s 8d]
Imbear8 is disconnected 
Imbear8 has timed out while disconnected
Imbear8: folds 
gleam6619: folds 
L4zy_FiSh: raises $2 to $3
matiko09: folds 
butcheN18: folds 
snow937022: folds 
picka4u: folds 
RoadtoNepal: folds 
flk.Dasas: folds 
Uncalled bet ($2) returned to L4zy_FiSh
L4zy_FiSh collected $2.50 from pot
*** SUMMARY ***
Total pot $2.50 | Rake $0 
Seat 1: Imbear8 folded before Flop (didn't bet)
Seat 2: gleam6619 folded before Flop (didn't bet)
Seat 3: L4zy_FiSh collected ($2.50)
Seat 4: matiko09 folded before Flop (didn't bet)
Seat 5: butcheN18 folded before Flop (didn't bet)
Seat 6: snow937022 folded before Flop (didn't bet)
Seat 7: picka4u (button) folded before Flop (didn't bet)
Seat 8: RoadtoNepal (small blind) folded before Flop
Seat 9: flk.Dasas (big blind) folded before Flop





PokerStars Hand #155373530401:  Hold'em No Limit ($0.25/$0.50 USD) - 2016/06/30 8:17:53 CET [2016/06/30 2:17:53 ET]
Table 'Praxidike' 9-max Seat #9 is the button
Seat 1: Sniper1717 ($50 in chips) 
Seat 2: prominente ($170.14 in chips) 
Seat 3: THREE FlDDY ($50 in chips) 
Seat 4: nicklasrossd ($16.08 in chips) 
Seat 5: shiangshuina ($58.06 in chips) 
Seat 7: matiko09 ($62.92 in chips) 
Seat 8: Alexey_Kim2 ($50.75 in chips) 
Seat 9: KABAL_ua ($50 in chips) 
Sniper1717: posts small blind $0.25
prominente: posts big blind $0.50
Dantistcopra: sits out 
*** HOLE CARDS ***
Dealt to matiko09 [9h 4d]
THREE FlDDY: folds 
nicklasrossd: folds 
shiangshuina: folds 
matiko09: folds 
Alexey_Kim2: folds 
KABAL_ua: raises $0.70 to $1.20
Sniper1717: folds 
prominente: calls $0.70
*** FLOP *** [8c Jc Js]
prominente: checks 
KABAL_ua: bets $1.68
prominente: calls $1.68
*** TURN *** [8c Jc Js] [Ac]
prominente: checks 
KABAL_ua: bets $4.33
prominente: calls $4.33
*** RIVER *** [8c Jc Js Ac] [8h]
prominente: checks 
KABAL_ua: checks 
*** SHOW DOWN ***
prominente: shows [7h Ah] (two pair, Aces and Jacks)
KABAL_ua: shows [Tc Kc] (a flush, Ace high)
KABAL_ua collected $13.94 from pot
*** SUMMARY ***
Total pot $14.67 | Rake $0.73 
Board [8c Jc Js Ac 8h]
Seat 1: Sniper1717 (small blind) folded before Flop
Seat 2: prominente (big blind) showed [7h Ah] and lost with two pair, Aces and Jacks
Seat 3: THREE FlDDY folded before Flop (didn't bet)
Seat 4: nicklasrossd folded before Flop (didn't bet)
Seat 5: shiangshuina folded before Flop (didn't bet)
Seat 7: matiko09 folded before Flop (didn't bet)
Seat 8: Alexey_Kim2 folded before Flop (didn't bet)
Seat 9: KABAL_ua (button) showed [Tc Kc] and won ($13.94) with a flush, Ace high





PokerStars Hand #155373530650:  Hold'em No Limit ($0.50/$1.00 USD) - 2016/06/30 8:17:54 CET [2016/06/30 2:17:54 ET]
Table 'Euphrosyne' 9-max Seat #5 is the button
Seat 1: butcheN18 ($100 in chips) 
Seat 2: ilaviiitech ($101.50 in chips) 
Seat 3: picka4u ($49.75 in chips) 
Seat 4: bargs33 ($95.50 in chips) 
Seat 5: L4zy_FiSh ($100 in chips) 
Seat 6: Alex Frider ($120.88 in chips) 
Seat 7: flk.Dasas ($102.27 in chips) 
Seat 8: Dantist1122 ($101.50 in chips) 
Seat 9: matiko09 ($103.50 in chips) 
Alex Frider: posts small blind $0.50
flk.Dasas: posts big blind $1
*** HOLE CARDS ***
Dealt to matiko09 [8s As]
Dantist1122: folds 
matiko09: folds 
butcheN18: folds 
ilaviiitech: folds 
picka4u: folds 
bargs33: raises $2 to $3
L4zy_FiSh: folds 
Alex Frider: folds 
flk.Dasas: folds 
Uncalled bet ($2) returned to bargs33
bargs33 collected $2.50 from pot
*** SUMMARY ***
Total pot $2.50 | Rake $0 
Seat 1: butcheN18 folded before Flop (didn't bet)
Seat 2: ilaviiitech folded before Flop (didn't bet)
Seat 3: picka4u folded before Flop (didn't bet)
Seat 4: bargs33 collected ($2.50)
Seat 5: L4zy_FiSh (button) folded before Flop (didn't bet)
Seat 6: Alex Frider (small blind) folded before Flop
Seat 7: flk.Dasas (big blind) folded before Flop
Seat 8: Dantist1122 folded before Flop (didn't bet)
Seat 9: matiko09 folded before Flop (didn't bet)





PokerStars Hand #155373530717:  Hold'em No Limit ($0.50/$1.00 USD) - 2016/06/30 8:17:54 CET [2016/06/30 2:17:54 ET]
Table 'Aunus' 9-max Seat #1 is the button
Seat 1: dboy604 ($71.53 in chips) 
Seat 2: HasBigBiceps ($100 in chips) 
Seat 3: matiko09 ($100 in chips) 
Seat 4: ilaviiitech ($100 in chips) 
Seat 6: Painkiller72 ($106.01 in chips) 
Seat 7: ka100pka527 ($38.50 in chips) 
Seat 8: Dantist1122 ($100 in chips) 
HasBigBiceps: posts small blind $0.50
matiko09: posts big blind $1
hammerwife: sits out 
*** HOLE CARDS ***
Dealt to matiko09 [9d Ks]
ilaviiitech: folds 
Painkiller72: folds 
ka100pka527: folds 
Dantist1122: folds 
dboy604: folds 
HasBigBiceps: raises $1.06 to $2.06
matiko09: calls $1.06
*** FLOP *** [5c 8s 3c]
HasBigBiceps: bets $1.32
matiko09: folds 
Uncalled bet ($1.32) returned to HasBigBiceps
HasBigBiceps collected $3.91 from pot
HasBigBiceps: doesn't show hand 
*** SUMMARY ***
Total pot $4.12 | Rake $0.21 
Board [5c 8s 3c]
Seat 1: dboy604 (button) folded before Flop (didn't bet)
Seat 2: HasBigBiceps (small blind) collected ($3.91)
Seat 3: matiko09 (big blind) folded on the Flop
Seat 4: ilaviiitech folded before Flop (didn't bet)
Seat 6: Painkiller72 folded before Flop (didn't bet)
Seat 7: ka100pka527 folded before Flop (didn't bet)
Seat 8: Dantist1122 folded before Flop (didn't bet)





PokerStars Hand #155373536591:  Hold'em No Limit ($0.25/$0.50 USD) - 2016/06/30 8:18:19 CET [2016/06/30 2:18:19 ET]
Table 'Ducrosa' 9-max Seat #4 is the button
Seat 1: Dantist1122 ($51.57 in chips) 
Seat 2: John_les ($50 in chips) 
Seat 3: matiko09 ($50 in chips) 
Seat 4: Lita17 ($73.13 in chips) 
Seat 5: beetge ($42.20 in chips) 
Seat 6: POTAPENKO700 ($50 in chips) 
Seat 7: THREE FlDDY ($52.49 in chips) 
Seat 9: ClassicWheel ($47.93 in chips) 
beetge: posts small blind $0.25
POTAPENKO700: posts big blind $0.50
Dantistcopra: sits out 
*** HOLE CARDS ***
Dealt to matiko09 [Th Jd]
THREE FlDDY: folds 
ClassicWheel: folds 
Dantist1122: folds 
John_les: raises $1.25 to $1.75
matiko09: folds 
Lita17: folds 
beetge: folds 
POTAPENKO700: folds 
Uncalled bet ($1.25) returned to John_les
John_les collected $1.25 from pot
John_les: doesn't show hand 
*** SUMMARY ***
Total pot $1.25 | Rake $0 
Seat 1: Dantist1122 folded before Flop (didn't bet)
Seat 2: John_les collected ($1.25)
Seat 3: matiko09 folded before Flop (didn't bet)
Seat 4: Lita17 (button) folded before Flop (didn't bet)
Seat 5: beetge (small blind) folded before Flop
Seat 6: POTAPENKO700 (big blind) folded before Flop
Seat 7: THREE FlDDY folded before Flop (didn't bet)
Seat 9: ClassicWheel folded before Flop (didn't bet)





PokerStars Hand #155373540012:  Hold'em No Limit ($0.50/$1.00 USD) - 2016/06/30 8:18:34 CET [2016/06/30 2:18:34 ET]
Table 'Lucretia II' 9-max Seat #5 is the button
Seat 1: matiko09 ($105.02 in chips) 
Seat 2: picka4u ($62.05 in chips) 
Seat 3: Alex Frider ($187.43 in chips) 
Seat 4: John_les ($103.57 in chips) 
Seat 5: butcheN18 ($100 in chips) 
Seat 6: flk.Dasas ($100 in chips) 
Seat 7: kingmaker209 ($39.38 in chips) 
Seat 8: snow937022 ($131.55 in chips) 
Seat 9: misko123 ($22.58 in chips) 
flk.Dasas: posts small blind $0.50
kingmaker209: posts big blind $1
*** HOLE CARDS ***
Dealt to matiko09 [4d 8s]
snow937022: folds 
misko123: calls $1
matiko09: folds 
picka4u: folds 
Alex Frider: folds 
John_les: folds 
butcheN18: folds 
flk.Dasas: folds 
kingmaker209: checks 
*** FLOP *** [8c 9s As]
kingmaker209: checks 
misko123: bets $1
kingmaker209: folds 
Uncalled bet ($1) returned to misko123
misko123 collected $2.38 from pot
*** SUMMARY ***
Total pot $2.50 | Rake $0.12 
Board [8c 9s As]
Seat 1: matiko09 folded before Flop (didn't bet)
Seat 2: picka4u folded before Flop (didn't bet)
Seat 3: Alex Frider folded before Flop (didn't bet)
Seat 4: John_les folded before Flop (didn't bet)
Seat 5: butcheN18 (button) folded before Flop (didn't bet)
Seat 6: flk.Dasas (small blind) folded before Flop
Seat 7: kingmaker209 (big blind) folded on the Flop
Seat 8: snow937022 folded before Flop (didn't bet)
Seat 9: misko123 collected ($2.38)





PokerStars Hand #155373540359:  Hold'em No Limit ($0.50/$1.00 USD) - 2016/06/30 8:18:35 CET [2016/06/30 2:18:35 ET]
Table 'Asmodeus' 9-max Seat #8 is the button
Seat 2: gleam6619 ($90.15 in chips) 
Seat 3: L4zy_FiSh ($101.50 in chips) 
Seat 4: matiko09 ($100 in chips) 
Seat 5: butcheN18 ($123.72 in chips) 
Seat 6: snow937022 ($147.63 in chips) 
Seat 7: picka4u ($38.50 in chips) 
Seat 8: RoadtoNepal ($107.12 in chips) 
Seat 9: flk.Dasas ($137.91 in chips) 
flk.Dasas: posts small blind $0.50
gleam6619: posts big blind $1
*** HOLE CARDS ***
Dealt to matiko09 [Kh 4h]
L4zy_FiSh: folds 
matiko09: folds 
butcheN18: folds 
snow937022: folds 
picka4u: folds 
RoadtoNepal: folds 
flk.Dasas: raises $2 to $3
gleam6619: calls $2
*** FLOP *** [Td Ac Ks]
flk.Dasas: checks 
gleam6619: checks 
*** TURN *** [Td Ac Ks] [6s]
flk.Dasas: checks 
gleam6619: checks 
*** RIVER *** [Td Ac Ks 6s] [9h]
flk.Dasas: checks 
gleam6619: checks 
*** SHOW DOWN ***
flk.Dasas: shows [Kc Jc] (a pair of Kings)
gleam6619: mucks hand 
flk.Dasas collected $5.70 from pot
*** SUMMARY ***
Total pot $6 | Rake $0.30 
Board [Td Ac Ks 6s 9h]
Seat 2: gleam6619 (big blind) mucked [Qc 9c]
Seat 3: L4zy_FiSh folded before Flop (didn't bet)
Seat 4: matiko09 folded before Flop (didn't bet)
Seat 5: butcheN18 folded before Flop (didn't bet)
Seat 6: snow937022 folded before Flop (didn't bet)
Seat 7: picka4u folded before Flop (didn't bet)
Seat 8: RoadtoNepal (button) folded before Flop (didn't bet)
Seat 9: flk.Dasas (small blind) showed [Kc Jc] and won ($5.70) with a pair of Kings





PokerStars Hand #155373540475:  Hold'em No Limit ($0.50/$1.00 USD) - 2016/06/30 8:18:36 CET [2016/06/30 2:18:36 ET]
Table 'Aunus' 9-max Seat #2 is the button
Seat 1: dboy604 ($71.53 in chips) 
Seat 2: HasBigBiceps ($101.85 in chips) 
Seat 3: matiko09 ($100 in chips) 
Seat 4: ilaviiitech ($100 in chips) 
Seat 6: Painkiller72 ($106.01 in chips) 
Seat 7: ka100pka527 ($38.50 in chips) 
Seat 8: Dantist1122 ($100 in chips) 
matiko09: posts small blind $0.50
ilaviiitech: posts big blind $1
hammerwife: sits out 
*** HOLE CARDS ***
Dealt to matiko09 [Kd 4h]
Painkiller72: folds 
ka100pka527: folds 
Dantist1122: raises $2 to $3
dboy604: folds 
HasBigBiceps: folds 
matiko09: folds 
ilaviiitech: folds 
Uncalled bet ($2) returned to Dantist1122
Dantist1122 collected $2.50 from pot
Dantist1122: doesn't show hand 
*** SUMMARY ***
Total pot $2.50 | Rake $0 
Seat 1: dboy604 folded before Flop (didn't bet)
Seat 2: HasBigBiceps (button) folded before Flop (didn't bet)
Seat 3: matiko09 (small blind) folded before Flop
Seat 4: ilaviiitech (big blind) folded before Flop
Seat 6: Painkiller72 folded before Flop (didn't bet)
Seat 7: ka100pka527 folded before Flop (didn't bet)
Seat 8: Dantist1122 collected ($2.50)





PokerStars Hand #155373540757:  Hold'em No Limit ($0.50/$1.00 USD) - 2016/06/30 8:18:37 CET [2016/06/30 2:18:37 ET]
Table 'Peiraios' 9-max Seat #2 is the button
Seat 1: L4zy_FiSh ($122.36 in chips) 
Seat 2: flk.Dasas ($103.65 in chips) 
Seat 4: nald6232 ($93.04 in chips) 
Seat 5: bargs33 ($100 in chips) 
Seat 6: Alex Frider ($153.64 in chips) 
Seat 8: matiko09 ($100 in chips) 
nald6232: posts small blind $0.50
bargs33: posts big blind $1
ka100pka527: sits out 
*** HOLE CARDS ***
Dealt to matiko09 [8h 6h]
Alex Frider: folds 
matiko09: folds 
L4zy_FiSh: raises $1.50 to $2.50
flk.Dasas: folds 
nald6232: folds 
bargs33: calls $1.50
*** FLOP *** [2h 7h Ts]
bargs33: checks 
L4zy_FiSh: bets $2.50
bargs33: folds 
Uncalled bet ($2.50) returned to L4zy_FiSh
L4zy_FiSh collected $5.22 from pot
*** SUMMARY ***
Total pot $5.50 | Rake $0.28 
Board [2h 7h Ts]
Seat 1: L4zy_FiSh collected ($5.22)
Seat 2: flk.Dasas (button) folded before Flop (didn't bet)
Seat 4: nald6232 (small blind) folded before Flop
Seat 5: bargs33 (big blind) folded on the Flop
Seat 6: Alex Frider folded before Flop (didn't bet)
Seat 8: matiko09 folded before Flop (didn't bet)





PokerStars Hand #155373541734:  Hold'em No Limit ($0.25/$0.50 USD) - 2016/06/30 8:18:41 CET [2016/06/30 2:18:41 ET]
Table 'Ducrosa' 9-max Seat #5 is the button
Seat 1: Dantist1122 ($51.57 in chips) 
Seat 2: John_les ($50.75 in chips) 
Seat 3: matiko09 ($50 in chips) 
Seat 4: Lita17 ($73.13 in chips) 
Seat 5: beetge ($41.95 in chips) 
Seat 6: POTAPENKO700 ($50 in chips) 
Seat 7: THREE FlDDY ($52.49 in chips) 
Seat 9: ClassicWheel ($47.93 in chips) 
POTAPENKO700: posts small blind $0.25
THREE FlDDY: posts big blind $0.50
Dantistcopra: sits out 
*** HOLE CARDS ***
Dealt to matiko09 [Kh 8h]
ClassicWheel: calls $0.50
Dantist1122: raises $2 to $2.50
John_les: folds 
matiko09: folds 
Lita17: folds 
beetge: folds 
POTAPENKO700: folds 
THREE FlDDY: folds 
ClassicWheel: folds 
Uncalled bet ($2) returned to Dantist1122
Dantist1122 collected $1.75 from pot
Dantist1122: doesn't show hand 
*** SUMMARY ***
Total pot $1.75 | Rake $0 
Seat 1: Dantist1122 collected ($1.75)
Seat 2: John_les folded before Flop (didn't bet)
Seat 3: matiko09 folded before Flop (didn't bet)
Seat 4: Lita17 folded before Flop (didn't bet)
Seat 5: beetge (button) folded before Flop (didn't bet)
Seat 6: POTAPENKO700 (small blind) folded before Flop
Seat 7: THREE FlDDY (big blind) folded before Flop
Seat 9: ClassicWheel folded before Flop





PokerStars Hand #155373544531:  Hold'em No Limit ($0.25/$0.50 USD) - 2016/06/30 8:18:53 CET [2016/06/30 2:18:53 ET]
Table 'Praxidike' 9-max Seat #1 is the button
Seat 1: Sniper1717 ($50 in chips) 
Seat 2: prominente ($162.93 in chips) 
Seat 3: THREE FlDDY ($50 in chips) 
Seat 4: nicklasrossd ($16.08 in chips) 
Seat 5: shiangshuina ($58.06 in chips) 
Seat 7: matiko09 ($62.92 in chips) 
Seat 8: Alexey_Kim2 ($50.75 in chips) 
Seat 9: KABAL_ua ($56.73 in chips) 
prominente: posts small blind $0.25
THREE FlDDY: posts big blind $0.50
Dantistcopra: sits out 
*** HOLE CARDS ***
Dealt to matiko09 [5s Tc]
nicklasrossd: folds 
shiangshuina: folds 
matiko09: folds 
Alexey_Kim2: folds 
KABAL_ua: folds 
Sniper1717: raises $1 to $1.50
prominente: folds 
THREE FlDDY: folds 
Uncalled bet ($1) returned to Sniper1717
Sniper1717 collected $1.25 from pot
Sniper1717: doesn't show hand 
*** SUMMARY ***
Total pot $1.25 | Rake $0 
Seat 1: Sniper1717 (button) collected ($1.25)
Seat 2: prominente (small blind) folded before Flop
Seat 3: THREE FlDDY (big blind) folded before Flop
Seat 4: nicklasrossd folded before Flop (didn't bet)
Seat 5: shiangshuina folded before Flop (didn't bet)
Seat 7: matiko09 folded before Flop (didn't bet)
Seat 8: Alexey_Kim2 folded before Flop (didn't bet)
Seat 9: KABAL_ua folded before Flop (didn't bet)





PokerStars Hand #155373544718:  Hold'em No Limit ($0.50/$1.00 USD) - 2016/06/30 8:18:54 CET [2016/06/30 2:18:54 ET]
Table 'Aunus' 9-max Seat #3 is the button
Seat 1: dboy604 ($71.53 in chips) 
Seat 2: HasBigBiceps ($101.85 in chips) 
Seat 3: matiko09 ($100 in chips) 
Seat 4: ilaviiitech ($100 in chips) 
Seat 5: hammerwife ($100 in chips) 
Seat 6: Painkiller72 ($106.01 in chips) 
Seat 7: ka100pka527 ($38.50 in chips) 
Seat 8: Dantist1122 ($101.50 in chips) 
ilaviiitech: posts small blind $0.50
hammerwife: posts big blind $1
*** HOLE CARDS ***
Dealt to matiko09 [Kh 5h]
Painkiller72: folds 
ka100pka527: folds 
Dantist1122: folds 
dboy604: calls $1
HasBigBiceps: folds 
matiko09: raises $3 to $4
ilaviiitech: folds 
hammerwife: folds 
dboy604: calls $3
*** FLOP *** [9d 3c Jh]
dboy604: bets $5
matiko09: folds 
Uncalled bet ($5) returned to dboy604
dboy604 collected $9.02 from pot
dboy604: doesn't show hand 
*** SUMMARY ***
Total pot $9.50 | Rake $0.48 
Board [9d 3c Jh]
Seat 1: dboy604 collected ($9.02)
Seat 2: HasBigBiceps folded before Flop (didn't bet)
Seat 3: matiko09 (button) folded on the Flop
Seat 4: ilaviiitech (small blind) folded before Flop
Seat 5: hammerwife (big blind) folded before Flop
Seat 6: Painkiller72 folded before Flop (didn't bet)
Seat 7: ka100pka527 folded before Flop (didn't bet)
Seat 8: Dantist1122 folded before Flop (didn't bet)





PokerStars Hand #155373548785:  Hold'em No Limit ($0.25/$0.50 USD) - 2016/06/30 8:19:12 CET [2016/06/30 2:19:12 ET]
Table 'Ducrosa' 9-max Seat #6 is the button
Seat 1: Dantist1122 ($52.82 in chips) 
Seat 2: John_les ($50.75 in chips) 
Seat 3: matiko09 ($50 in chips) 
Seat 4: Lita17 ($73.13 in chips) 
Seat 5: beetge ($41.95 in chips) 
Seat 6: POTAPENKO700 ($50 in chips) 
Seat 7: THREE FlDDY ($51.99 in chips) 
Seat 8: Dantistcopra ($50 in chips) 
Seat 9: ClassicWheel ($47.43 in chips) 
THREE FlDDY: posts small blind $0.25
Dantistcopra: posts big blind $0.50
*** HOLE CARDS ***
Dealt to matiko09 [3s 6s]
ClassicWheel: folds 
Dantist1122: folds 
John_les: folds 
matiko09: folds 
Lita17: folds 
beetge: raises $1.50 to $2
POTAPENKO700: folds 
THREE FlDDY: folds 
Dantistcopra: folds 
Uncalled bet ($1.50) returned to beetge
beetge collected $1.25 from pot
beetge: doesn't show hand 
*** SUMMARY ***
Total pot $1.25 | Rake $0 
Seat 1: Dantist1122 folded before Flop (didn't bet)
Seat 2: John_les folded before Flop (didn't bet)
Seat 3: matiko09 folded before Flop (didn't bet)
Seat 4: Lita17 folded before Flop (didn't bet)
Seat 5: beetge collected ($1.25)
Seat 6: POTAPENKO700 (button) folded before Flop (didn't bet)
Seat 7: THREE FlDDY (small blind) folded before Flop
Seat 8: Dantistcopra (big blind) folded before Flop
Seat 9: ClassicWheel folded before Flop (didn't bet)





PokerStars Hand #155373549608:  Hold'em No Limit ($0.50/$1.00 USD) - 2016/06/30 8:19:16 CET [2016/06/30 2:19:16 ET]
Table 'Peiraios' 9-max Seat #4 is the button
Seat 1: L4zy_FiSh ($125.08 in chips) 
Seat 2: flk.Dasas ($103.65 in chips) 
Seat 4: nald6232 ($92.54 in chips) 
Seat 5: bargs33 ($97.50 in chips) 
Seat 6: Alex Frider ($153.64 in chips) 
Seat 8: matiko09 ($100 in chips) 
bargs33: posts small blind $0.50
Alex Frider: posts big blind $1
ka100pka527: sits out 
*** HOLE CARDS ***
Dealt to matiko09 [Tc 7d]
matiko09: folds 
L4zy_FiSh: folds 
flk.Dasas: folds 
nald6232: folds 
bargs33: calls $0.50
Alex Frider: checks 
*** FLOP *** [Jh 3d 9c]
bargs33: checks 
Alex Frider: bets $1.37
bargs33: folds 
Uncalled bet ($1.37) returned to Alex Frider
Alex Frider collected $1.90 from pot
Alex Frider: doesn't show hand 
*** SUMMARY ***
Total pot $2 | Rake $0.10 
Board [Jh 3d 9c]
Seat 1: L4zy_FiSh folded before Flop (didn't bet)
Seat 2: flk.Dasas folded before Flop (didn't bet)
Seat 4: nald6232 (button) folded before Flop (didn't bet)
Seat 5: bargs33 (small blind) folded on the Flop
Seat 6: Alex Frider (big blind) collected ($1.90)
Seat 8: matiko09 folded before Flop (didn't bet)





PokerStars Hand #155373549891:  Hold'em No Limit ($0.50/$1.00 USD) - 2016/06/30 8:19:17 CET [2016/06/30 2:19:17 ET]
Table 'Lucretia II' 9-max Seat #6 is the button
Seat 1: matiko09 ($105.02 in chips) 
Seat 2: picka4u ($62.05 in chips) 
Seat 3: Alex Frider ($187.43 in chips) 
Seat 4: John_les ($103.57 in chips) 
Seat 5: butcheN18 ($100 in chips) 
Seat 6: flk.Dasas ($100 in chips) 
Seat 7: kingmaker209 ($38.38 in chips) 
Seat 8: snow937022 ($131.55 in chips) 
Seat 9: misko123 ($23.96 in chips) 
kingmaker209: posts small blind $0.50
snow937022: posts big blind $1
*** HOLE CARDS ***
Dealt to matiko09 [Qd 2s]
misko123: folds 
matiko09: folds 
picka4u: folds 
Alex Frider: folds 
John_les: folds 
butcheN18: folds 
flk.Dasas: folds 
kingmaker209: calls $0.50
snow937022: checks 
*** FLOP *** [9h Kc 5h]
kingmaker209: checks 
snow937022: bets $1
kingmaker209: folds 
Uncalled bet ($1) returned to snow937022
snow937022 collected $1.90 from pot
snow937022: doesn't show hand 
*** SUMMARY ***
Total pot $2 | Rake $0.10 
Board [9h Kc 5h]
Seat 1: matiko09 folded before Flop (didn't bet)
Seat 2: picka4u folded before Flop (didn't bet)
Seat 3: Alex Frider folded before Flop (didn't bet)
Seat 4: John_les folded before Flop (didn't bet)
Seat 5: butcheN18 folded before Flop (didn't bet)
Seat 6: flk.Dasas (button) folded before Flop (didn't bet)
Seat 7: kingmaker209 (small blind) folded on the Flop
Seat 8: snow937022 (big blind) collected ($1.90)
Seat 9: misko123 folded before Flop (didn't bet)





PokerStars Hand #155373550717:  Hold'em No Limit ($0.25/$0.50 USD) - 2016/06/30 8:19:21 CET [2016/06/30 2:19:21 ET]
Table 'Praxidike' 9-max Seat #2 is the button
Seat 1: Sniper1717 ($50.75 in chips) 
Seat 2: prominente ($162.68 in chips) 
Seat 3: THREE FlDDY ($50 in chips) 
Seat 4: nicklasrossd ($16.08 in chips) 
Seat 5: shiangshuina ($58.06 in chips) 
Seat 7: matiko09 ($62.92 in chips) 
Seat 8: Alexey_Kim2 ($50.75 in chips) 
Seat 9: KABAL_ua ($56.73 in chips) 
THREE FlDDY: posts small blind $0.25
nicklasrossd: posts big blind $0.50
Dantistcopra: sits out 
*** HOLE CARDS ***
Dealt to matiko09 [3s Jc]
shiangshuina: folds 
matiko09: folds 
shiangshuina leaves the table
Alexey_Kim2: folds 
KABAL_ua: folds 
Sniper1717: folds 
John_les joins the table at seat #5 
prominente: raises $0.75 to $1.25
THREE FlDDY: folds 
nicklasrossd: folds 
Uncalled bet ($0.75) returned to prominente
prominente collected $1.25 from pot
prominente: doesn't show hand 
*** SUMMARY ***
Total pot $1.25 | Rake $0 
Seat 1: Sniper1717 folded before Flop (didn't bet)
Seat 2: prominente (button) collected ($1.25)
Seat 3: THREE FlDDY (small blind) folded before Flop
Seat 4: nicklasrossd (big blind) folded before Flop
Seat 5: shiangshuina folded before Flop (didn't bet)
Seat 7: matiko09 folded before Flop (didn't bet)
Seat 8: Alexey_Kim2 folded before Flop (didn't bet)
Seat 9: KABAL_ua folded before Flop (didn't bet)





PokerStars Hand #155373554838:  Hold'em No Limit ($0.25/$0.50 USD) - 2016/06/30 8:19:39 CET [2016/06/30 2:19:39 ET]
Table 'Ducrosa' 9-max Seat #7 is the button
Seat 1: Dantist1122 ($52.82 in chips) 
Seat 2: John_les ($50.75 in chips) 
Seat 3: matiko09 ($50 in chips) 
Seat 4: Lita17 ($73.13 in chips) 
Seat 5: beetge ($42.70 in chips) 
Seat 6: POTAPENKO700 ($50 in chips) 
Seat 7: THREE FlDDY ($51.74 in chips) 
Seat 8: Dantistcopra ($50 in chips) 
Seat 9: ClassicWheel ($47.43 in chips) 
Dantistcopra: posts small blind $0.25
ClassicWheel: posts big blind $0.50
*** HOLE CARDS ***
Dealt to matiko09 [8c 9s]
Dantist1122: folds 
John_les: folds 
matiko09: folds 
Lita17: folds 
beetge: folds 
POTAPENKO700: folds 
THREE FlDDY: raises $0.76 to $1.26
Dantistcopra: folds 
ClassicWheel: raises $2.77 to $4.03
THREE FlDDY: folds 
Uncalled bet ($2.77) returned to ClassicWheel
ClassicWheel collected $2.77 from pot
ClassicWheel: doesn't show hand 
*** SUMMARY ***
Total pot $2.77 | Rake $0 
Seat 1: Dantist1122 folded before Flop (didn't bet)
Seat 2: John_les folded before Flop (didn't bet)
Seat 3: matiko09 folded before Flop (didn't bet)
Seat 4: Lita17 folded before Flop (didn't bet)
Seat 5: beetge folded before Flop (didn't bet)
Seat 6: POTAPENKO700 folded before Flop (didn't bet)
Seat 7: THREE FlDDY (button) folded before Flop
Seat 8: Dantistcopra (small blind) folded before Flop
Seat 9: ClassicWheel (big blind) collected ($2.77)





PokerStars Hand #155373555096:  Hold'em No Limit ($0.50/$1.00 USD) - 2016/06/30 8:19:40 CET [2016/06/30 2:19:40 ET]
Table 'Aunus' 9-max Seat #4 is the button
Seat 1: dboy604 ($76.55 in chips) 
Seat 2: HasBigBiceps ($101.85 in chips) 
Seat 3: matiko09 ($100 in chips) 
Seat 4: ilaviiitech ($100 in chips) 
Seat 5: hammerwife ($100 in chips) 
Seat 6: Painkiller72 ($106.01 in chips) 
Seat 7: ka100pka527 ($38.50 in chips) 
Seat 8: Dantist1122 ($101.50 in chips) 
hammerwife: posts small blind $0.50
Painkiller72: posts big blind $1
*** HOLE CARDS ***
Dealt to matiko09 [3h 6c]
ka100pka527: folds 
Dantist1122: folds 
dboy604: raises $5 to $6
HasBigBiceps: folds 
matiko09: folds 
ilaviiitech: folds 
hammerwife: folds 
Painkiller72: calls $5
*** FLOP *** [8h 8c 5h]
Painkiller72: checks 
dboy604: bets $5
Painkiller72: calls $5
*** TURN *** [8h 8c 5h] [8d]
Painkiller72: checks 
dboy604: checks 
*** RIVER *** [8h 8c 5h 8d] [Kh]
Painkiller72: checks 
dboy604: bets $21.38
Painkiller72: calls $21.38
*** SHOW DOWN ***
dboy604: shows [Tc Kc] (a full house, Eights full of Kings)
Painkiller72: mucks hand 
dboy604 collected $62.76 from pot
*** SUMMARY ***
Total pot $65.26 | Rake $2.50 
Board [8h 8c 5h 8d Kh]
Seat 1: dboy604 showed [Tc Kc] and won ($62.76) with a full house, Eights full of Kings
Seat 2: HasBigBiceps folded before Flop (didn't bet)
Seat 3: matiko09 folded before Flop (didn't bet)
Seat 4: ilaviiitech (button) folded before Flop (didn't bet)
Seat 5: hammerwife (small blind) folded before Flop
Seat 6: Painkiller72 (big blind) mucked [Th Td]
Seat 7: ka100pka527 folded before Flop (didn't bet)
Seat 8: Dantist1122 folded before Flop (didn't bet)





PokerStars Hand #155373560229:  Hold'em No Limit ($0.50/$1.00 USD) - 2016/06/30 8:20:02 CET [2016/06/30 2:20:02 ET]
Table 'Asmodeus' 9-max Seat #9 is the button
Seat 2: gleam6619 ($87.15 in chips) 
Seat 3: L4zy_FiSh ($101.50 in chips) 
Seat 4: matiko09 ($100 in chips) 
Seat 5: butcheN18 ($123.72 in chips) 
Seat 6: snow937022 ($147.63 in chips) 
Seat 7: picka4u ($38.50 in chips) 
Seat 8: RoadtoNepal ($107.12 in chips) 
Seat 9: flk.Dasas ($140.61 in chips) 
gleam6619: posts small blind $0.50
L4zy_FiSh: posts big blind $1
*** HOLE CARDS ***
Dealt to matiko09 [3s 8d]
matiko09: folds 
butcheN18: folds 
snow937022: raises $1.25 to $2.25
picka4u: folds 
RoadtoNepal: folds 
flk.Dasas: calls $2.25
gleam6619: folds 
L4zy_FiSh: calls $1.25
*** FLOP *** [3c 9h 8h]
L4zy_FiSh: checks 
snow937022: checks 
flk.Dasas: bets $4.69
L4zy_FiSh: folds 
snow937022: calls $4.69
*** TURN *** [3c 9h 8h] [6c]
snow937022: checks 
flk.Dasas: bets $15.33
snow937022: folds 
Uncalled bet ($15.33) returned to flk.Dasas
flk.Dasas collected $15.80 from pot
flk.Dasas: doesn't show hand 
*** SUMMARY ***
Total pot $16.63 | Rake $0.83 
Board [3c 9h 8h 6c]
Seat 2: gleam6619 (small blind) folded before Flop
Seat 3: L4zy_FiSh (big blind) folded on the Flop
Seat 4: matiko09 folded before Flop (didn't bet)
Seat 5: butcheN18 folded before Flop (didn't bet)
Seat 6: snow937022 folded on the Turn
Seat 7: picka4u folded before Flop (didn't bet)
Seat 8: RoadtoNepal folded before Flop (didn't bet)
Seat 9: flk.Dasas (button) collected ($15.80)





PokerStars Hand #155373560653:  Hold'em No Limit ($0.50/$1.00 USD) - 2016/06/30 8:20:04 CET [2016/06/30 2:20:04 ET]
Table 'Peiraios' 9-max Seat #5 is the button
Seat 1: L4zy_FiSh ($125.08 in chips) 
Seat 2: flk.Dasas ($103.65 in chips) 
Seat 5: bargs33 ($99.50 in chips) 
Seat 6: Alex Frider ($154.54 in chips) 
Seat 8: matiko09 ($100 in chips) 
Alex Frider: posts small blind $0.50
matiko09: posts big blind $1
ka100pka527: sits out 
*** HOLE CARDS ***
Dealt to matiko09 [Tc 4s]
L4zy_FiSh: folds 
flk.Dasas: raises $1.50 to $2.50
bargs33: folds 
Alex Frider: folds 
matiko09: folds 
Uncalled bet ($1.50) returned to flk.Dasas
flk.Dasas collected $2.50 from pot
flk.Dasas: doesn't show hand 
*** SUMMARY ***
Total pot $2.50 | Rake $0 
Seat 1: L4zy_FiSh folded before Flop (didn't bet)
Seat 2: flk.Dasas collected ($2.50)
Seat 5: bargs33 (button) folded before Flop (didn't bet)
Seat 6: Alex Frider (small blind) folded before Flop
Seat 8: matiko09 (big blind) folded before Flop





PokerStars Hand #155373561011:  Hold'em No Limit ($0.25/$0.50 USD) - 2016/06/30 8:20:05 CET [2016/06/30 2:20:05 ET]
Table 'Praxidike' 9-max Seat #3 is the button
Seat 1: Sniper1717 ($50.75 in chips) 
Seat 2: prominente ($163.43 in chips) 
Seat 3: THREE FlDDY ($50 in chips) 
Seat 4: nicklasrossd ($15.58 in chips) 
Seat 5: John_les ($50 in chips) 
Seat 7: matiko09 ($62.92 in chips) 
Seat 8: Alexey_Kim2 ($50.75 in chips) 
Seat 9: KABAL_ua ($56.73 in chips) 
nicklasrossd: posts small blind $0.25
John_les: posts big blind $0.50
Dantistcopra: sits out 
*** HOLE CARDS ***
Dealt to matiko09 [As Jd]
matiko09: raises $1 to $1.50
Alexey_Kim2: folds 
KABAL_ua: folds 
Sniper1717: folds 
prominente: folds 
THREE FlDDY: folds 
nicklasrossd: calls $1.25
John_les: folds 
*** FLOP *** [Qd 7h 4d]
nicklasrossd: checks 
matiko09: bets $1.72
nicklasrossd: folds 
Uncalled bet ($1.72) returned to matiko09
matiko09 collected $3.32 from pot
matiko09: doesn't show hand 
*** SUMMARY ***
Total pot $3.50 | Rake $0.18 
Board [Qd 7h 4d]
Seat 1: Sniper1717 folded before Flop (didn't bet)
Seat 2: prominente folded before Flop (didn't bet)
Seat 3: THREE FlDDY (button) folded before Flop (didn't bet)
Seat 4: nicklasrossd (small blind) folded on the Flop
Seat 5: John_les (big blind) folded before Flop
Seat 7: matiko09 collected ($3.32)
Seat 8: Alexey_Kim2 folded before Flop (didn't bet)
Seat 9: KABAL_ua folded before Flop (didn't bet)





PokerStars Hand #155373564891:  Hold'em No Limit ($0.25/$0.50 USD) - 2016/06/30 8:20:22 CET [2016/06/30 2:20:22 ET]
Table 'Ducrosa' 9-max Seat #8 is the button
Seat 1: Dantist1122 ($52.82 in chips) 
Seat 2: John_les ($50.75 in chips) 
Seat 3: matiko09 ($50 in chips) 
Seat 4: Lita17 ($73.13 in chips) 
Seat 5: beetge ($42.70 in chips) 
Seat 6: POTAPENKO700 ($50 in chips) 
Seat 7: THREE FlDDY ($50.48 in chips) 
Seat 8: Dantistcopra ($50 in chips) 
Seat 9: ClassicWheel ($48.94 in chips) 
ClassicWheel: posts small blind $0.25
Dantist1122: posts big blind $0.50
*** HOLE CARDS ***
Dealt to matiko09 [Kc 9h]
John_les: folds 
matiko09: folds 
Lita17: folds 
beetge: folds 
POTAPENKO700: raises $0.75 to $1.25
beetge leaves the table
THREE FlDDY: folds 
Dantistcopra: folds 
ClassicWheel: calls $1
KABAL_ua joins the table at seat #5 
Dantist1122: calls $0.75
*** FLOP *** [Qd 8h 8d]
ClassicWheel: bets $1
Dantist1122: folds 
POTAPENKO700: folds 
Uncalled bet ($1) returned to ClassicWheel
ClassicWheel collected $3.56 from pot
ClassicWheel: doesn't show hand 
*** SUMMARY ***
Total pot $3.75 | Rake $0.19 
Board [Qd 8h 8d]
Seat 1: Dantist1122 (big blind) folded on the Flop
Seat 2: John_les folded before Flop (didn't bet)
Seat 3: matiko09 folded before Flop (didn't bet)
Seat 4: Lita17 folded before Flop (didn't bet)
Seat 5: beetge folded before Flop (didn't bet)
Seat 6: POTAPENKO700 folded on the Flop
Seat 7: THREE FlDDY folded before Flop (didn't bet)
Seat 8: Dantistcopra (button) folded before Flop (didn't bet)
Seat 9: ClassicWheel (small blind) collected ($3.56)





PokerStars Hand #155373565252:  Hold'em No Limit ($0.50/$1.00 USD) - 2016/06/30 8:20:23 CET [2016/06/30 2:20:23 ET]
Table 'Peiraios' 9-max Seat #6 is the button
Seat 1: L4zy_FiSh ($125.08 in chips) 
Seat 2: flk.Dasas ($105.15 in chips) 
Seat 5: bargs33 ($99.50 in chips) 
Seat 6: Alex Frider ($154.04 in chips) 
Seat 8: matiko09 ($100 in chips) 
Seat 9: ka100pka527 ($40 in chips) 
matiko09: posts small blind $0.50
ka100pka527: posts big blind $1
*** HOLE CARDS ***
Dealt to matiko09 [9c Qd]
L4zy_FiSh: folds 
flk.Dasas: folds 
bargs33: raises $1.25 to $2.25
Alex Frider: folds 
matiko09: folds 
ka100pka527: folds 
Uncalled bet ($1.25) returned to bargs33
bargs33 collected $2.50 from pot
*** SUMMARY ***
Total pot $2.50 | Rake $0 
Seat 1: L4zy_FiSh folded before Flop (didn't bet)
Seat 2: flk.Dasas folded before Flop (didn't bet)
Seat 5: bargs33 collected ($2.50)
Seat 6: Alex Frider (button) folded before Flop (didn't bet)
Seat 8: matiko09 (small blind) folded before Flop
Seat 9: ka100pka527 (big blind) folded before Flop





PokerStars Hand #155373567108:  Hold'em No Limit ($0.50/$1.00 USD) - 2016/06/30 8:20:31 CET [2016/06/30 2:20:31 ET]
Table 'Aunus' 9-max Seat #5 is the button
Seat 1: dboy604 ($106.93 in chips) 
Seat 2: HasBigBiceps ($101.85 in chips) 
Seat 3: matiko09 ($100 in chips) 
Seat 4: ilaviiitech ($100 in chips) 
Seat 5: hammerwife ($100 in chips) 
Seat 6: Painkiller72 ($100 in chips) 
Seat 7: ka100pka527 ($38.50 in chips) 
Seat 8: Dantist1122 ($101.50 in chips) 
Painkiller72: posts small blind $0.50
ka100pka527: posts big blind $1
*** HOLE CARDS ***
Dealt to matiko09 [Kc 5d]
Dantist1122: folds 
dboy604: folds 
HasBigBiceps: folds 
matiko09: folds 
ilaviiitech: folds 
hammerwife: folds 
Painkiller72: folds 
Uncalled bet ($0.50) returned to ka100pka527
ka100pka527 collected $1 from pot
ka100pka527: doesn't show hand 
*** SUMMARY ***
Total pot $1 | Rake $0 
Seat 1: dboy604 folded before Flop (didn't bet)
Seat 2: HasBigBiceps folded before Flop (didn't bet)
Seat 3: matiko09 folded before Flop (didn't bet)
Seat 4: ilaviiitech folded before Flop (didn't bet)
Seat 5: hammerwife (button) folded before Flop (didn't bet)
Seat 6: Painkiller72 (small blind) folded before Flop
Seat 7: ka100pka527 (big blind) collected ($1)
Seat 8: Dantist1122 folded before Flop (didn't bet)





PokerStars Hand #155373567698:  Hold'em No Limit ($0.50/$1.00 USD) - 2016/06/30 8:20:33 CET [2016/06/30 2:20:33 ET]
Table 'Lucretia II' 9-max Seat #7 is the button
Seat 1: matiko09 ($105.02 in chips) 
Seat 2: picka4u ($62.05 in chips) 
Seat 3: Alex Frider ($187.43 in chips) 
Seat 4: John_les ($103.57 in chips) 
Seat 5: butcheN18 ($100 in chips) 
Seat 6: flk.Dasas ($100 in chips) 
Seat 7: kingmaker209 ($37.38 in chips) 
Seat 8: snow937022 ($132.45 in chips) 
Seat 9: misko123 ($23.96 in chips) 
snow937022: posts small blind $0.50
misko123: posts big blind $1
*** HOLE CARDS ***
Dealt to matiko09 [9d Ks]
matiko09: folds 
picka4u: folds 
Alex Frider: folds 
John_les: raises $2.50 to $3.50
butcheN18: folds 
flk.Dasas: folds 
kingmaker209: folds 
snow937022: folds 
misko123: folds 
Uncalled bet ($2.50) returned to John_les
John_les collected $2.50 from pot
John_les: doesn't show hand 
*** SUMMARY ***
Total pot $2.50 | Rake $0 
Seat 1: matiko09 folded before Flop (didn't bet)
Seat 2: picka4u folded before Flop (didn't bet)
Seat 3: Alex Frider folded before Flop (didn't bet)
Seat 4: John_les collected ($2.50)
Seat 5: butcheN18 folded before Flop (didn't bet)
Seat 6: flk.Dasas folded before Flop (didn't bet)
Seat 7: kingmaker209 (button) folded before Flop (didn't bet)
Seat 8: snow937022 (small blind) folded before Flop
Seat 9: misko123 (big blind) folded before Flop





PokerStars Hand #155373570659:  Hold'em No Limit ($0.50/$1.00 USD) - 2016/06/30 8:20:46 CET [2016/06/30 2:20:46 ET]
Table 'Aunus' 9-max Seat #6 is the button
Seat 1: dboy604 ($106.93 in chips) 
Seat 2: HasBigBiceps ($101.85 in chips) 
Seat 3: matiko09 ($100 in chips) 
Seat 4: ilaviiitech ($100 in chips) 
Seat 5: hammerwife ($100 in chips) 
Seat 6: Painkiller72 ($100 in chips) 
Seat 7: ka100pka527 ($39 in chips) 
Seat 8: Dantist1122 ($101.50 in chips) 
ka100pka527: posts small blind $0.50
Dantist1122: posts big blind $1
*** HOLE CARDS ***
Dealt to matiko09 [9s 5c]
dboy604 said, ":*"
dboy604: folds 
HasBigBiceps: folds 
matiko09: folds 
ilaviiitech: folds 
hammerwife: folds 
Painkiller72: raises $1 to $2
ka100pka527: raises $5 to $7
Dantist1122: folds 
Painkiller72: folds 
Uncalled bet ($5) returned to ka100pka527
ka100pka527 collected $5 from pot
ka100pka527: doesn't show hand 
*** SUMMARY ***
Total pot $5 | Rake $0 
Seat 1: dboy604 folded before Flop (didn't bet)
Seat 2: HasBigBiceps folded before Flop (didn't bet)
Seat 3: matiko09 folded before Flop (didn't bet)
Seat 4: ilaviiitech folded before Flop (didn't bet)
Seat 5: hammerwife folded before Flop (didn't bet)
Seat 6: Painkiller72 (button) folded before Flop
Seat 7: ka100pka527 (small blind) collected ($5)
Seat 8: Dantist1122 (big blind) folded before Flop





PokerStars Hand #155373572911:  Hold'em No Limit ($0.25/$0.50 USD) - 2016/06/30 8:20:56 CET [2016/06/30 2:20:56 ET]
Table 'Praxidike' 9-max Seat #4 is the button
Seat 1: Sniper1717 ($50.75 in chips) 
Seat 2: prominente ($163.43 in chips) 
Seat 3: THREE FlDDY ($50 in chips) 
Seat 4: nicklasrossd ($14.08 in chips) 
Seat 5: John_les ($50 in chips) 
Seat 6: Dantistcopra ($50 in chips) 
Seat 7: matiko09 ($64.74 in chips) 
Seat 8: Alexey_Kim2 ($50.75 in chips) 
Seat 9: KABAL_ua ($56.73 in chips) 
John_les: posts small blind $0.25
Dantistcopra: posts big blind $0.50
*** HOLE CARDS ***
Dealt to matiko09 [Ah Th]
matiko09: raises $1 to $1.50
Alexey_Kim2: folds 
KABAL_ua: folds 
Sniper1717: folds 
prominente: folds 
THREE FlDDY: folds 
nicklasrossd: folds 
John_les: folds 
Dantistcopra: folds 
Uncalled bet ($1) returned to matiko09
matiko09 collected $1.25 from pot
matiko09: doesn't show hand 
*** SUMMARY ***
Total pot $1.25 | Rake $0 
Seat 1: Sniper1717 folded before Flop (didn't bet)
Seat 2: prominente folded before Flop (didn't bet)
Seat 3: THREE FlDDY folded before Flop (didn't bet)
Seat 4: nicklasrossd (button) folded before Flop (didn't bet)
Seat 5: John_les (small blind) folded before Flop
Seat 6: Dantistcopra (big blind) folded before Flop
Seat 7: matiko09 collected ($1.25)
Seat 8: Alexey_Kim2 folded before Flop (didn't bet)
Seat 9: KABAL_ua folded before Flop (didn't bet)





PokerStars Hand #155373573115:  Hold'em No Limit ($0.50/$1.00 USD) - 2016/06/30 8:20:57 CET [2016/06/30 2:20:57 ET]
Table 'Peiraios' 9-max Seat #8 is the button
Seat 1: L4zy_FiSh ($125.08 in chips) 
Seat 2: flk.Dasas ($105.15 in chips) 
Seat 5: bargs33 ($101 in chips) 
Seat 6: Alex Frider ($154.04 in chips) 
Seat 8: matiko09 ($100 in chips) 
Seat 9: ka100pka527 ($39 in chips) 
ka100pka527: posts small blind $0.50
L4zy_FiSh: posts big blind $1
*** HOLE CARDS ***
Dealt to matiko09 [Jc As]
flk.Dasas: folds 
bargs33: raises $1 to $2
Alex Frider: folds 
matiko09: raises $5 to $7
ka100pka527: folds 
L4zy_FiSh: folds 
bargs33: calls $5
*** FLOP *** [8d 3c Ac]
bargs33: checks 
matiko09: checks 
*** TURN *** [8d 3c Ac] [3h]
bargs33: bets $7
matiko09: calls $7
*** RIVER *** [8d 3c Ac 3h] [9s]
bargs33: checks 
matiko09: bets $8.68
bargs33: folds 
Uncalled bet ($8.68) returned to matiko09
matiko09 collected $28.02 from pot
matiko09: doesn't show hand 
*** SUMMARY ***
Total pot $29.50 | Rake $1.48 
Board [8d 3c Ac 3h 9s]
Seat 1: L4zy_FiSh (big blind) folded before Flop
Seat 2: flk.Dasas folded before Flop (didn't bet)
Seat 5: bargs33 folded on the River
Seat 6: Alex Frider folded before Flop (didn't bet)
Seat 8: matiko09 (button) collected ($28.02)
Seat 9: ka100pka527 (small blind) folded before Flop





PokerStars Hand #155373573447:  Hold'em No Limit ($0.50/$1.00 USD) - 2016/06/30 8:20:58 CET [2016/06/30 2:20:58 ET]
Table 'Lucretia II' 9-max Seat #8 is the button
Seat 1: matiko09 ($105.02 in chips) 
Seat 2: picka4u ($62.05 in chips) 
Seat 3: Alex Frider ($187.43 in chips) 
Seat 4: John_les ($105.07 in chips) 
Seat 5: butcheN18 ($100 in chips) 
Seat 6: flk.Dasas ($100 in chips) 
Seat 7: kingmaker209 ($37.38 in chips) 
Seat 8: snow937022 ($131.95 in chips) 
Seat 9: misko123 ($22.96 in chips) 
misko123: posts small blind $0.50
matiko09: posts big blind $1
*** HOLE CARDS ***
Dealt to matiko09 [8s 3h]
picka4u: folds 
Alex Frider: folds 
John_les: folds 
butcheN18: folds 
flk.Dasas: folds 
kingmaker209: calls $1
snow937022: calls $1
misko123: raises $1 to $2
matiko09: folds 
kingmaker209: calls $1
snow937022: calls $1
*** FLOP *** [3c Js 4s]
misko123: bets $3
kingmaker209: folds 
snow937022: folds 
Uncalled bet ($3) returned to misko123
misko123 collected $6.65 from pot
*** SUMMARY ***
Total pot $7 | Rake $0.35 
Board [3c Js 4s]
Seat 1: matiko09 (big blind) folded before Flop
Seat 2: picka4u folded before Flop (didn't bet)
Seat 3: Alex Frider folded before Flop (didn't bet)
Seat 4: John_les folded before Flop (didn't bet)
Seat 5: butcheN18 folded before Flop (didn't bet)
Seat 6: flk.Dasas folded before Flop (didn't bet)
Seat 7: kingmaker209 folded on the Flop
Seat 8: snow937022 (button) folded on the Flop
Seat 9: misko123 (small blind) collected ($6.65)





PokerStars Hand #155373576435:  Hold'em No Limit ($0.25/$0.50 USD) - 2016/06/30 8:21:11 CET [2016/06/30 2:21:11 ET]
Table 'Ducrosa' 9-max Seat #9 is the button
Seat 1: Dantist1122 ($51.57 in chips) 
Seat 2: John_les ($50.75 in chips) 
Seat 3: matiko09 ($50 in chips) 
Seat 4: Lita17 ($73.13 in chips) 
Seat 6: POTAPENKO700 ($50 in chips) 
Seat 7: THREE FlDDY ($50.48 in chips) 
Seat 8: Dantistcopra ($50 in chips) 
Seat 9: ClassicWheel ($51.25 in chips) 
Dantist1122: posts small blind $0.25
John_les: posts big blind $0.50
KABAL_ua: sits out 
*** HOLE CARDS ***
Dealt to matiko09 [Th 4s]
matiko09: folds 
Lita17: folds 
POTAPENKO700: raises $0.75 to $1.25
THREE FlDDY: calls $1.25
Dantistcopra: folds 
ClassicWheel: calls $1.25
Dantist1122: folds 
John_les: folds 
*** FLOP *** [Js 5d 5s]
POTAPENKO700: bets $2.85
THREE FlDDY: folds 
ClassicWheel: calls $2.85
*** TURN *** [Js 5d 5s] [Td]
POTAPENKO700: bets $6.25
ClassicWheel: calls $6.25
*** RIVER *** [Js 5d 5s Td] [3c]
POTAPENKO700: checks 
ClassicWheel: checks 
*** SHOW DOWN ***
POTAPENKO700: shows [Qc Ks] (a pair of Fives)
ClassicWheel: shows [Jc Ac] (two pair, Jacks and Fives)
ClassicWheel collected $21.56 from pot
*** SUMMARY ***
Total pot $22.70 | Rake $1.14 
Board [Js 5d 5s Td 3c]
Seat 1: Dantist1122 (small blind) folded before Flop
Seat 2: John_les (big blind) folded before Flop
Seat 3: matiko09 folded before Flop (didn't bet)
Seat 4: Lita17 folded before Flop (didn't bet)
Seat 6: POTAPENKO700 showed [Qc Ks] and lost with a pair of Fives
Seat 7: THREE FlDDY folded on the Flop
Seat 8: Dantistcopra folded before Flop (didn't bet)
Seat 9: ClassicWheel (button) showed [Jc Ac] and won ($21.56) with two pair, Jacks and Fives





PokerStars Hand #155373578207:  Hold'em No Limit ($0.50/$1.00 USD) - 2016/06/30 8:21:18 CET [2016/06/30 2:21:18 ET]
Table 'Aunus' 9-max Seat #7 is the button
Seat 1: dboy604 ($106.93 in chips) 
Seat 2: HasBigBiceps ($101.85 in chips) 
Seat 3: matiko09 ($100 in chips) 
Seat 4: ilaviiitech ($100 in chips) 
Seat 5: hammerwife ($100 in chips) 
Seat 6: Painkiller72 ($100 in chips) 
Seat 7: ka100pka527 ($42 in chips) 
Seat 8: Dantist1122 ($100.50 in chips) 
Seat 9: flk.Dasas ($100 in chips) 
Dantist1122: posts small blind $0.50
flk.Dasas: posts big blind $1
*** HOLE CARDS ***
Dealt to matiko09 [6d 2c]
dboy604: calls $1
HasBigBiceps: folds 
matiko09: folds 
ilaviiitech: folds 
hammerwife: folds 
Painkiller72: raises $3.50 to $4.50
ka100pka527: folds 
Dantist1122: folds 
flk.Dasas: folds 
dboy604: calls $3.50
*** FLOP *** [Kc 9h Jd]
dboy604: bets $5
Painkiller72: calls $5
*** TURN *** [Kc 9h Jd] [2s]
dboy604: checks 
Painkiller72: checks 
*** RIVER *** [Kc 9h Jd 2s] [Kh]
dboy604: bets $8
Painkiller72: calls $8
*** SHOW DOWN ***
dboy604: shows [7d Kd] (three of a kind, Kings)
Painkiller72: mucks hand 
dboy604 collected $34.68 from pot
*** SUMMARY ***
Total pot $36.50 | Rake $1.82 
Board [Kc 9h Jd 2s Kh]
Seat 1: dboy604 showed [7d Kd] and won ($34.68) with three of a kind, Kings
Seat 2: HasBigBiceps folded before Flop (didn't bet)
Seat 3: matiko09 folded before Flop (didn't bet)
Seat 4: ilaviiitech folded before Flop (didn't bet)
Seat 5: hammerwife folded before Flop (didn't bet)
Seat 6: Painkiller72 mucked [8c 9c]
Seat 7: ka100pka527 (button) folded before Flop (didn't bet)
Seat 8: Dantist1122 (small blind) folded before Flop
Seat 9: flk.Dasas (big blind) folded before Flop





PokerStars Hand #155373580796:  Hold'em No Limit ($0.25/$0.50 USD) - 2016/06/30 8:21:29 CET [2016/06/30 2:21:29 ET]
Table 'Praxidike' 9-max Seat #5 is the button
Seat 1: Sniper1717 ($50.75 in chips) 
Seat 2: prominente ($163.43 in chips) 
Seat 3: THREE FlDDY ($50 in chips) 
Seat 4: nicklasrossd ($14.08 in chips) 
Seat 5: John_les ($50 in chips) 
Seat 6: Dantistcopra ($50 in chips) 
Seat 7: matiko09 ($65.49 in chips) 
Seat 8: Alexey_Kim2 ($50.75 in chips) 
Seat 9: KABAL_ua ($56.73 in chips) 
Dantistcopra: posts small blind $0.25
matiko09: posts big blind $0.50
*** HOLE CARDS ***
Dealt to matiko09 [6h Ks]
Alexey_Kim2: folds 
KABAL_ua: folds 
Sniper1717: folds 
Alexey_Kim2 leaves the table
prominente: folds 
Dantist1122 joins the table at seat #8 
THREE FlDDY: folds 
nicklasrossd has timed out while being disconnected
nicklasrossd: folds 
John_les: folds 
Dantistcopra: folds 
Uncalled bet ($0.25) returned to matiko09
matiko09 collected $0.50 from pot
matiko09: doesn't show hand 
*** SUMMARY ***
Total pot $0.50 | Rake $0 
Seat 1: Sniper1717 folded before Flop (didn't bet)
Seat 2: prominente folded before Flop (didn't bet)
Seat 3: THREE FlDDY folded before Flop (didn't bet)
Seat 4: nicklasrossd folded before Flop (didn't bet)
Seat 5: John_les (button) folded before Flop (didn't bet)
Seat 6: Dantistcopra (small blind) folded before Flop
Seat 7: matiko09 (big blind) collected ($0.50)
Seat 8: Alexey_Kim2 folded before Flop (didn't bet)
Seat 9: KABAL_ua folded before Flop (didn't bet)





PokerStars Hand #155373582052:  Hold'em No Limit ($0.50/$1.00 USD) - 2016/06/30 8:21:34 CET [2016/06/30 2:21:34 ET]
Table 'Asmodeus' 9-max Seat #2 is the button
Seat 2: gleam6619 ($86.65 in chips) 
Seat 3: L4zy_FiSh ($100 in chips) 
Seat 4: matiko09 ($100 in chips) 
Seat 5: butcheN18 ($123.72 in chips) 
Seat 6: snow937022 ($140.69 in chips) 
Seat 7: picka4u ($38.50 in chips) 
Seat 8: RoadtoNepal ($107.12 in chips) 
Seat 9: flk.Dasas ($149.47 in chips) 
L4zy_FiSh: posts small blind $0.50
matiko09: posts big blind $1
Imbear8: sits out 
*** HOLE CARDS ***
Dealt to matiko09 [Qh 4c]
butcheN18: raises $2 to $3
snow937022: raises $7.50 to $10.50
picka4u: folds 
RoadtoNepal: folds 
flk.Dasas: folds 
gleam6619: folds 
L4zy_FiSh: folds 
matiko09: folds 
butcheN18: folds 
Uncalled bet ($7.50) returned to snow937022
snow937022 collected $7.50 from pot
snow937022: doesn't show hand 
*** SUMMARY ***
Total pot $7.50 | Rake $0 
Seat 2: gleam6619 (button) folded before Flop (didn't bet)
Seat 3: L4zy_FiSh (small blind) folded before Flop
Seat 4: matiko09 (big blind) folded before Flop
Seat 5: butcheN18 folded before Flop
Seat 6: snow937022 collected ($7.50)
Seat 7: picka4u folded before Flop (didn't bet)
Seat 8: RoadtoNepal folded before Flop (didn't bet)
Seat 9: flk.Dasas folded before Flop (didn't bet)





PokerStars Hand #155373588255:  Hold'em No Limit ($0.50/$1.00 USD) - 2016/06/30 8:22:01 CET [2016/06/30 2:22:01 ET]
Table 'Lucretia II' 9-max Seat #9 is the button
Seat 1: matiko09 ($104.02 in chips) 
Seat 2: picka4u ($62.05 in chips) 
Seat 3: Alex Frider ($187.43 in chips) 
Seat 4: John_les ($105.07 in chips) 
Seat 5: butcheN18 ($100 in chips) 
Seat 6: flk.Dasas ($100 in chips) 
Seat 7: kingmaker209 ($35.38 in chips) 
Seat 8: snow937022 ($129.95 in chips) 
Seat 9: misko123 ($27.61 in chips) 
matiko09: posts small blind $0.50
picka4u: posts big blind $1
*** HOLE CARDS ***
Dealt to matiko09 [5d Th]
Alex Frider: folds 
John_les: folds 
butcheN18: folds 
flk.Dasas: folds 
kingmaker209: calls $1
snow937022 is connected 
snow937022: folds 
misko123: folds 
matiko09: folds 
picka4u: checks 
*** FLOP *** [Jd 3d Kd]
picka4u: bets $1.36
kingmaker209: folds 
Uncalled bet ($1.36) returned to picka4u
picka4u collected $2.38 from pot
picka4u: doesn't show hand 
*** SUMMARY ***
Total pot $2.50 | Rake $0.12 
Board [Jd 3d Kd]
Seat 1: matiko09 (small blind) folded before Flop
Seat 2: picka4u (big blind) collected ($2.38)
Seat 3: Alex Frider folded before Flop (didn't bet)
Seat 4: John_les folded before Flop (didn't bet)
Seat 5: butcheN18 folded before Flop (didn't bet)
Seat 6: flk.Dasas folded before Flop (didn't bet)
Seat 7: kingmaker209 folded on the Flop
Seat 8: snow937022 folded before Flop (didn't bet)
Seat 9: misko123 (button) folded before Flop (didn't bet)





PokerStars Hand #155373590568:  Hold'em No Limit ($0.50/$1.00 USD) - 2016/06/30 8:22:11 CET [2016/06/30 2:22:11 ET]
Table 'Asmodeus' 9-max Seat #3 is the button
Seat 2: gleam6619 ($86.65 in chips) 
Seat 3: L4zy_FiSh ($100 in chips) 
Seat 4: matiko09 ($100 in chips) 
Seat 5: butcheN18 ($120.72 in chips) 
Seat 6: snow937022 ($145.19 in chips) 
Seat 7: picka4u ($38.50 in chips) 
Seat 8: RoadtoNepal ($107.12 in chips) 
Seat 9: flk.Dasas ($149.47 in chips) 
matiko09: posts small blind $0.50
butcheN18: posts big blind $1
Imbear8: sits out 
*** HOLE CARDS ***
Dealt to matiko09 [Kh 4s]
snow937022 has timed out while being disconnected
snow937022: folds 
picka4u: folds 
snow937022 is disconnected 
RoadtoNepal: raises $2 to $3
flk.Dasas: folds 
gleam6619: folds 
L4zy_FiSh: folds 
matiko09: folds 
butcheN18: folds 
Uncalled bet ($2) returned to RoadtoNepal
RoadtoNepal collected $2.50 from pot
*** SUMMARY ***
Total pot $2.50 | Rake $0 
Seat 2: gleam6619 folded before Flop (didn't bet)
Seat 3: L4zy_FiSh (button) folded before Flop (didn't bet)
Seat 4: matiko09 (small blind) folded before Flop
Seat 5: butcheN18 (big blind) folded before Flop
Seat 6: snow937022 folded before Flop (didn't bet)
Seat 7: picka4u folded before Flop (didn't bet)
Seat 8: RoadtoNepal collected ($2.50)
Seat 9: flk.Dasas folded before Flop (didn't bet)





PokerStars Hand #155373591105:  Hold'em No Limit ($0.25/$0.50 USD) - 2016/06/30 8:22:13 CET [2016/06/30 2:22:13 ET]
Table 'Praxidike' 9-max Seat #6 is the button
Seat 1: Sniper1717 ($50.75 in chips) 
Seat 2: prominente ($163.43 in chips) 
Seat 3: THREE FlDDY ($50 in chips) 
Seat 5: John_les ($50 in chips) 
Seat 6: Dantistcopra ($50 in chips) 
Seat 7: matiko09 ($65.74 in chips) 
Seat 8: Dantist1122 ($57.07 in chips) 
Seat 9: KABAL_ua ($56.73 in chips) 
matiko09: posts small blind $0.25
Dantist1122: posts big blind $0.50
*** HOLE CARDS ***
Dealt to matiko09 [2d 8h]
KABAL_ua: folds 
nicklasrossd is disconnected 
Sniper1717: folds 
prominente: folds 
THREE FlDDY: raises $0.76 to $1.26
John_les: folds 
Dantistcopra: folds 
matiko09: folds 
Dantist1122: folds 
Uncalled bet ($0.76) returned to THREE FlDDY
THREE FlDDY collected $1.25 from pot
THREE FlDDY: doesn't show hand 
*** SUMMARY ***
Total pot $1.25 | Rake $0 
Seat 1: Sniper1717 folded before Flop (didn't bet)
Seat 2: prominente folded before Flop (didn't bet)
Seat 3: THREE FlDDY collected ($1.25)
Seat 5: John_les folded before Flop (didn't bet)
Seat 6: Dantistcopra (button) folded before Flop (didn't bet)
Seat 7: matiko09 (small blind) folded before Flop
Seat 8: Dantist1122 (big blind) folded before Flop
Seat 9: KABAL_ua folded before Flop (didn't bet)





PokerStars Hand #155373592282:  Hold'em No Limit ($0.50/$1.00 USD) - 2016/06/30 8:22:18 CET [2016/06/30 2:22:18 ET]
Table 'Aunus' 9-max Seat #8 is the button
Seat 1: dboy604 ($124.11 in chips) 
Seat 2: HasBigBiceps ($101.85 in chips) 
Seat 3: matiko09 ($100 in chips) 
Seat 4: ilaviiitech ($100 in chips) 
Seat 5: hammerwife ($100 in chips) 
Seat 6: Painkiller72 ($100 in chips) 
Seat 7: ka100pka527 ($42 in chips) 
Seat 8: Dantist1122 ($100 in chips) 
Seat 9: flk.Dasas ($100 in chips) 
flk.Dasas: posts small blind $0.50
dboy604: posts big blind $1
*** HOLE CARDS ***
Dealt to matiko09 [2s Js]
HasBigBiceps: folds 
matiko09: folds 
ilaviiitech: folds 
hammerwife: folds 
Painkiller72: folds 
ka100pka527: folds 
Dantist1122: raises $2 to $3
flk.Dasas: folds 
dboy604: folds 
Uncalled bet ($2) returned to Dantist1122
Dantist1122 collected $2.50 from pot
Dantist1122: doesn't show hand 
*** SUMMARY ***
Total pot $2.50 | Rake $0 
Seat 1: dboy604 (big blind) folded before Flop
Seat 2: HasBigBiceps folded before Flop (didn't bet)
Seat 3: matiko09 folded before Flop (didn't bet)
Seat 4: ilaviiitech folded before Flop (didn't bet)
Seat 5: hammerwife folded before Flop (didn't bet)
Seat 6: Painkiller72 folded before Flop (didn't bet)
Seat 7: ka100pka527 folded before Flop (didn't bet)
Seat 8: Dantist1122 (button) collected ($2.50)
Seat 9: flk.Dasas (small blind) folded before Flop





PokerStars Hand #155373595809:  Hold'em No Limit ($0.50/$1.00 USD) - 2016/06/30 8:22:33 CET [2016/06/30 2:22:33 ET]
Table 'Peiraios' 9-max Seat #9 is the button
Seat 1: L4zy_FiSh ($124.08 in chips) 
Seat 6: Alex Frider ($154.04 in chips) 
Seat 8: matiko09 ($114.02 in chips) 
Seat 9: ka100pka527 ($38.50 in chips) 
L4zy_FiSh: posts small blind $0.50
flk.Dasas: is sitting out 
bargs33: is sitting out 
Alex Frider: posts big blind $1
*** HOLE CARDS ***
Dealt to matiko09 [Td 8c]
matiko09: folds 
bargs33 leaves the table
ka100pka527: folds 
L4zy_FiSh: raises $1.50 to $2.50
Alex Frider: folds 
Uncalled bet ($1.50) returned to L4zy_FiSh
L4zy_FiSh collected $2 from pot
*** SUMMARY ***
Total pot $2 | Rake $0 
Seat 1: L4zy_FiSh (small blind) collected ($2)
Seat 6: Alex Frider (big blind) folded before Flop
Seat 8: matiko09 folded before Flop (didn't bet)
Seat 9: ka100pka527 (button) folded before Flop (didn't bet)





PokerStars Hand #155373596624:  Hold'em No Limit ($0.25/$0.50 USD) - 2016/06/30 8:22:37 CET [2016/06/30 2:22:37 ET]
Table 'Ducrosa' 9-max Seat #1 is the button
Seat 1: Dantist1122 ($51.32 in chips) 
Seat 2: John_les ($50.25 in chips) 
Seat 3: matiko09 ($50 in chips) 
Seat 4: Lita17 ($73.13 in chips) 
Seat 6: POTAPENKO700 ($50 in chips) 
Seat 7: THREE FlDDY ($50 in chips) 
Seat 8: Dantistcopra ($50 in chips) 
Seat 9: ClassicWheel ($62.46 in chips) 
John_les: posts small blind $0.25
matiko09: posts big blind $0.50
KABAL_ua: sits out 
*** HOLE CARDS ***
Dealt to matiko09 [2h 3d]
Lita17: folds 
POTAPENKO700: folds 
THREE FlDDY: folds 
Dantistcopra: folds 
ClassicWheel: raises $0.50 to $1
Dantist1122: folds 
John_les: folds 
matiko09: folds 
Uncalled bet ($0.50) returned to ClassicWheel
ClassicWheel collected $1.25 from pot
ClassicWheel: doesn't show hand 
*** SUMMARY ***
Total pot $1.25 | Rake $0 
Seat 1: Dantist1122 (button) folded before Flop (didn't bet)
Seat 2: John_les (small blind) folded before Flop
Seat 3: matiko09 (big blind) folded before Flop
Seat 4: Lita17 folded before Flop (didn't bet)
Seat 6: POTAPENKO700 folded before Flop (didn't bet)
Seat 7: THREE FlDDY folded before Flop (didn't bet)
Seat 8: Dantistcopra folded before Flop (didn't bet)
Seat 9: ClassicWheel collected ($1.25)





PokerStars Hand #155373598426:  Hold'em No Limit ($0.25/$0.50 USD) - 2016/06/30 8:22:44 CET [2016/06/30 2:22:44 ET]
Table 'Praxidike' 9-max Seat #7 is the button
Seat 1: Sniper1717 ($50.75 in chips) 
Seat 2: prominente ($163.43 in chips) 
Seat 3: THREE FlDDY ($50.75 in chips) 
Seat 4: nicklasrossd ($14.08 in chips) 
Seat 5: John_les ($50 in chips) 
Seat 6: Dantistcopra ($50 in chips) 
Seat 7: matiko09 ($65.49 in chips) 
Seat 8: Dantist1122 ($56.57 in chips) 
Seat 9: KABAL_ua ($56.73 in chips) 
Dantist1122: posts small blind $0.25
KABAL_ua: posts big blind $0.50
*** HOLE CARDS ***
Dealt to matiko09 [5d 3d]
Sniper1717: folds 
prominente: folds 
THREE FlDDY: folds 
nicklasrossd: calls $0.50
John_les: folds 
Dantistcopra: folds 
matiko09: folds 
Dantist1122: folds 
KABAL_ua: checks 
*** FLOP *** [8s 2d 6s]
KABAL_ua: checks 
nicklasrossd: checks 
*** TURN *** [8s 2d 6s] [7s]
KABAL_ua: checks 
nicklasrossd: checks 
*** RIVER *** [8s 2d 6s 7s] [2h]
KABAL_ua: bets $0.90
nicklasrossd: folds 
Uncalled bet ($0.90) returned to KABAL_ua
KABAL_ua collected $1.19 from pot
KABAL_ua: doesn't show hand 
*** SUMMARY ***
Total pot $1.25 | Rake $0.06 
Board [8s 2d 6s 7s 2h]
Seat 1: Sniper1717 folded before Flop (didn't bet)
Seat 2: prominente folded before Flop (didn't bet)
Seat 3: THREE FlDDY folded before Flop (didn't bet)
Seat 4: nicklasrossd folded on the River
Seat 5: John_les folded before Flop (didn't bet)
Seat 6: Dantistcopra folded before Flop (didn't bet)
Seat 7: matiko09 (button) folded before Flop (didn't bet)
Seat 8: Dantist1122 (small blind) folded before Flop
Seat 9: KABAL_ua (big blind) collected ($1.19)





PokerStars Hand #155373598437:  Hold'em No Limit ($0.50/$1.00 USD) - 2016/06/30 8:22:44 CET [2016/06/30 2:22:44 ET]
Table 'Aunus' 9-max Seat #9 is the button
Seat 1: dboy604 ($123.11 in chips) 
Seat 2: HasBigBiceps ($101.85 in chips) 
Seat 3: matiko09 ($100 in chips) 
Seat 4: ilaviiitech ($100 in chips) 
Seat 5: hammerwife ($100 in chips) 
Seat 6: Painkiller72 ($100 in chips) 
Seat 7: ka100pka527 ($42 in chips) 
Seat 8: Dantist1122 ($101.50 in chips) 
Seat 9: flk.Dasas ($100 in chips) 
dboy604: posts small blind $0.50
HasBigBiceps: posts big blind $1
*** HOLE CARDS ***
Dealt to matiko09 [7d 3h]
matiko09: folds 
ilaviiitech: folds 
hammerwife: folds 
Painkiller72: folds 
ka100pka527: raises $2 to $3
Dantist1122: folds 
flk.Dasas: folds 
dboy604: raises $4 to $7
HasBigBiceps: folds 
ka100pka527: calls $4
*** FLOP *** [5h 9c Ks]
dboy604: checks 
ka100pka527: checks 
*** TURN *** [5h 9c Ks] [2c]
dboy604: checks 
ka100pka527: checks 
*** RIVER *** [5h 9c Ks 2c] [6d]
dboy604: checks 
ka100pka527: checks 
*** SHOW DOWN ***
dboy604: shows [7c 7h] (a pair of Sevens)
ka100pka527: mucks hand 
dboy604 collected $14.25 from pot
*** SUMMARY ***
Total pot $15 | Rake $0.75 
Board [5h 9c Ks 2c 6d]
Seat 1: dboy604 (small blind) showed [7c 7h] and won ($14.25) with a pair of Sevens
Seat 2: HasBigBiceps (big blind) folded before Flop
Seat 3: matiko09 folded before Flop (didn't bet)
Seat 4: ilaviiitech folded before Flop (didn't bet)
Seat 5: hammerwife folded before Flop (didn't bet)
Seat 6: Painkiller72 folded before Flop (didn't bet)
Seat 7: ka100pka527 mucked [Ac Qh]
Seat 8: Dantist1122 folded before Flop (didn't bet)
Seat 9: flk.Dasas (button) folded before Flop (didn't bet)





PokerStars Hand #155373601588:  Hold'em No Limit ($0.25/$0.50 USD) - 2016/06/30 8:22:58 CET [2016/06/30 2:22:58 ET]
Table 'Ducrosa' 9-max Seat #2 is the button
Seat 1: Dantist1122 ($51.32 in chips) 
Seat 2: John_les ($50 in chips) 
Seat 3: matiko09 ($50 in chips) 
Seat 4: Lita17 ($73.13 in chips) 
Seat 6: POTAPENKO700 ($50 in chips) 
Seat 7: THREE FlDDY ($50 in chips) 
Seat 8: Dantistcopra ($50 in chips) 
Seat 9: ClassicWheel ($63.21 in chips) 
matiko09: posts small blind $0.25
Lita17: posts big blind $0.50
KABAL_ua: sits out 
*** HOLE CARDS ***
Dealt to matiko09 [Jh 6h]
POTAPENKO700: folds 
THREE FlDDY: folds 
Dantistcopra: folds 
ClassicWheel: folds 
Dantist1122: folds 
John_les: folds 
matiko09: folds 
Uncalled bet ($0.25) returned to Lita17
Lita17 collected $0.50 from pot
Lita17: doesn't show hand 
*** SUMMARY ***
Total pot $0.50 | Rake $0 
Seat 1: Dantist1122 folded before Flop (didn't bet)
Seat 2: John_les (button) folded before Flop (didn't bet)
Seat 3: matiko09 (small blind) folded before Flop
Seat 4: Lita17 (big blind) collected ($0.50)
Seat 6: POTAPENKO700 folded before Flop (didn't bet)
Seat 7: THREE FlDDY folded before Flop (didn't bet)
Seat 8: Dantistcopra folded before Flop (didn't bet)
Seat 9: ClassicWheel folded before Flop (didn't bet)





PokerStars Hand #155373602209:  Hold'em No Limit ($0.50/$1.00 USD) - 2016/06/30 8:23:00 CET [2016/06/30 2:23:00 ET]
Table 'Asmodeus' 9-max Seat #4 is the button
Seat 1: Imbear8 ($102.49 in chips) 
Seat 2: gleam6619 ($86.65 in chips) 
Seat 3: L4zy_FiSh ($100 in chips) 
Seat 4: matiko09 ($100 in chips) 
Seat 5: butcheN18 ($119.72 in chips) 
Seat 6: snow937022 ($145.19 in chips) 
Seat 7: picka4u ($38.50 in chips) 
Seat 8: RoadtoNepal ($108.62 in chips) 
Seat 9: flk.Dasas ($149.47 in chips) 
butcheN18: posts small blind $0.50
snow937022: posts big blind $1
Imbear8: posts small & big blinds $1.50
*** HOLE CARDS ***
Dealt to matiko09 [Th 5d]
picka4u: folds 
RoadtoNepal: folds 
flk.Dasas: raises $3 to $4
Imbear8: calls $3
gleam6619: folds 
L4zy_FiSh: folds 
matiko09: folds 
butcheN18: folds 
snow937022: calls $3
*** FLOP *** [Ac 6d 8h]
snow937022: checks 
flk.Dasas: bets $3
Imbear8: folds 
snow937022: calls $3
*** TURN *** [Ac 6d 8h] [As]
snow937022: checks 
flk.Dasas: bets $5
snow937022: folds 
Uncalled bet ($5) returned to flk.Dasas
flk.Dasas collected $18.05 from pot
flk.Dasas: doesn't show hand 
*** SUMMARY ***
Total pot $19 | Rake $0.95 
Board [Ac 6d 8h As]
Seat 1: Imbear8 folded on the Flop
Seat 2: gleam6619 folded before Flop (didn't bet)
Seat 3: L4zy_FiSh folded before Flop (didn't bet)
Seat 4: matiko09 (button) folded before Flop (didn't bet)
Seat 5: butcheN18 (small blind) folded before Flop
Seat 6: snow937022 (big blind) folded on the Turn
Seat 7: picka4u folded before Flop (didn't bet)
Seat 8: RoadtoNepal folded before Flop (didn't bet)
Seat 9: flk.Dasas collected ($18.05)





PokerStars Hand #155373604546:  Hold'em No Limit ($0.50/$1.00 USD) - 2016/06/30 8:23:10 CET [2016/06/30 2:23:10 ET]
Table 'Peiraios' 9-max Seat #1 is the button
Seat 1: L4zy_FiSh ($125.08 in chips) 
Seat 6: Alex Frider ($153.04 in chips) 
Seat 8: matiko09 ($114.02 in chips) 
Seat 9: ka100pka527 ($38.50 in chips) 
Alex Frider: posts small blind $0.50
matiko09: posts big blind $1
*** HOLE CARDS ***
Dealt to matiko09 [7c As]
ka100pka527: raises $1 to $2
L4zy_FiSh: folds 
Alex Frider: folds 
matiko09: folds 
Uncalled bet ($1) returned to ka100pka527
ka100pka527 collected $2.50 from pot
ka100pka527: doesn't show hand 
*** SUMMARY ***
Total pot $2.50 | Rake $0 
Seat 1: L4zy_FiSh (button) folded before Flop (didn't bet)
Seat 6: Alex Frider (small blind) folded before Flop
Seat 8: matiko09 (big blind) folded before Flop
Seat 9: ka100pka527 collected ($2.50)





PokerStars Hand #155373604978:  Hold'em No Limit ($0.50/$1.00 USD) - 2016/06/30 8:23:12 CET [2016/06/30 2:23:12 ET]
Table 'Lucretia II' 9-max Seat #1 is the button
Seat 1: matiko09 ($103.52 in chips) 
Seat 2: picka4u ($63.43 in chips) 
Seat 3: Alex Frider ($187.43 in chips) 
Seat 4: John_les ($105.07 in chips) 
Seat 5: butcheN18 ($100 in chips) 
Seat 6: flk.Dasas ($100 in chips) 
Seat 7: kingmaker209 ($34.38 in chips) 
Seat 8: snow937022 ($129.95 in chips) 
Seat 9: misko123 ($27.61 in chips) 
picka4u: posts small blind $0.50
Alex Frider: posts big blind $1
*** HOLE CARDS ***
Dealt to matiko09 [3h 9d]
John_les: folds 
butcheN18: folds 
flk.Dasas: folds 
kingmaker209: folds 
kingmaker209 leaves the table
snow937022: folds 
misko123: folds 
Dantist1122 joins the table at seat #7 
matiko09: folds 
picka4u: raises $1.25 to $2.25
Alex Frider: raises $4.60 to $6.85
picka4u: folds 
Uncalled bet ($4.60) returned to Alex Frider
Alex Frider collected $4.50 from pot
Alex Frider: doesn't show hand 
*** SUMMARY ***
Total pot $4.50 | Rake $0 
Seat 1: matiko09 (button) folded before Flop (didn't bet)
Seat 2: picka4u (small blind) folded before Flop
Seat 3: Alex Frider (big blind) collected ($4.50)
Seat 4: John_les folded before Flop (didn't bet)
Seat 5: butcheN18 folded before Flop (didn't bet)
Seat 6: flk.Dasas folded before Flop (didn't bet)
Seat 7: kingmaker209 folded before Flop (didn't bet)
Seat 8: snow937022 folded before Flop (didn't bet)
Seat 9: misko123 folded before Flop (didn't bet)





PokerStars Hand #155373606190:  Hold'em No Limit ($0.25/$0.50 USD) - 2016/06/30 8:23:17 CET [2016/06/30 2:23:17 ET]
Table 'Ducrosa' 9-max Seat #3 is the button
Seat 1: Dantist1122 ($51.32 in chips) 
Seat 2: John_les ($50 in chips) 
Seat 3: matiko09 ($50 in chips) 
Seat 4: Lita17 ($73.38 in chips) 
Seat 5: KABAL_ua ($50 in chips) 
Seat 6: POTAPENKO700 ($50 in chips) 
Seat 7: THREE FlDDY ($50 in chips) 
Seat 8: Dantistcopra ($50 in chips) 
Seat 9: ClassicWheel ($63.21 in chips) 
Lita17: posts small blind $0.25
KABAL_ua: posts big blind $0.50
*** HOLE CARDS ***
Dealt to matiko09 [9c 5h]
POTAPENKO700: folds 
THREE FlDDY: folds 
Dantistcopra: folds 
ClassicWheel: folds 
Dantist1122: folds 
John_les: folds 
matiko09: folds 
Lita17: folds 
Uncalled bet ($0.25) returned to KABAL_ua
KABAL_ua collected $0.50 from pot
KABAL_ua: doesn't show hand 
*** SUMMARY ***
Total pot $0.50 | Rake $0 
Seat 1: Dantist1122 folded before Flop (didn't bet)
Seat 2: John_les folded before Flop (didn't bet)
Seat 3: matiko09 (button) folded before Flop (didn't bet)
Seat 4: Lita17 (small blind) folded before Flop
Seat 5: KABAL_ua (big blind) collected ($0.50)
Seat 6: POTAPENKO700 folded before Flop (didn't bet)
Seat 7: THREE FlDDY folded before Flop (didn't bet)
Seat 8: Dantistcopra folded before Flop (didn't bet)
Seat 9: ClassicWheel folded before Flop (didn't bet)





PokerStars Hand #155373607356:  Hold'em No Limit ($0.50/$1.00 USD) - 2016/06/30 8:23:22 CET [2016/06/30 2:23:22 ET]
Table 'Peiraios' 9-max Seat #8 is the button
Seat 6: Alex Frider ($152.54 in chips) 
Seat 8: matiko09 ($113.02 in chips) 
matiko09: posts small blind $0.50
ka100pka527: is sitting out 
L4zy_FiSh: is sitting out 
Alex Frider: posts big blind $1
*** HOLE CARDS ***
Dealt to matiko09 [3c Td]
L4zy_FiSh leaves the table
matiko09: folds 
Uncalled bet ($0.50) returned to Alex Frider
Alex Frider collected $1 from pot
Alex Frider: doesn't show hand 
*** SUMMARY ***
Total pot $1 | Rake $0 
Seat 6: Alex Frider (big blind) collected ($1)
Seat 8: matiko09 (button) (small blind) folded before Flop





PokerStars Hand #155373610995:  Hold'em No Limit ($0.50/$1.00 USD) - 2016/06/30 8:23:38 CET [2016/06/30 2:23:38 ET]
Table 'Lucretia II' 9-max Seat #2 is the button
Seat 1: matiko09 ($103.52 in chips) 
Seat 2: picka4u ($61.18 in chips) 
Seat 3: Alex Frider ($189.68 in chips) 
Seat 4: John_les ($105.07 in chips) 
Seat 5: butcheN18 ($100 in chips) 
Seat 6: flk.Dasas ($100 in chips) 
Seat 8: snow937022 ($129.95 in chips) 
Seat 9: misko123 ($27.61 in chips) 
Alex Frider: posts small blind $0.50
John_les: posts big blind $1
Dantist1122: sits out 
*** HOLE CARDS ***
Dealt to matiko09 [Ts 5h]
butcheN18: folds 
flk.Dasas: folds 
snow937022: folds 
misko123: folds 
matiko09: folds 
picka4u: raises $1.05 to $2.05
Alex Frider: folds 
John_les: folds 
Uncalled bet ($1.05) returned to picka4u
picka4u collected $2.50 from pot
picka4u: doesn't show hand 
*** SUMMARY ***
Total pot $2.50 | Rake $0 
Seat 1: matiko09 folded before Flop (didn't bet)
Seat 2: picka4u (button) collected ($2.50)
Seat 3: Alex Frider (small blind) folded before Flop
Seat 4: John_les (big blind) folded before Flop
Seat 5: butcheN18 folded before Flop (didn't bet)
Seat 6: flk.Dasas folded before Flop (didn't bet)
Seat 8: snow937022 folded before Flop (didn't bet)
Seat 9: misko123 folded before Flop (didn't bet)





PokerStars Hand #155373613753:  Hold'em No Limit ($0.25/$0.50 USD) - 2016/06/30 8:23:49 CET [2016/06/30 2:23:49 ET]
Table 'Ducrosa' 9-max Seat #4 is the button
Seat 1: Dantist1122 ($51.32 in chips) 
Seat 2: John_les ($50 in chips) 
Seat 3: matiko09 ($50 in chips) 
Seat 4: Lita17 ($73.13 in chips) 
Seat 5: KABAL_ua ($50.25 in chips) 
Seat 6: POTAPENKO700 ($50 in chips) 
Seat 7: THREE FlDDY ($50 in chips) 
Seat 8: Dantistcopra ($50 in chips) 
Seat 9: ClassicWheel ($63.21 in chips) 
KABAL_ua: posts small blind $0.25
POTAPENKO700: posts big blind $0.50
*** HOLE CARDS ***
Dealt to matiko09 [9d 5h]
THREE FlDDY: folds 
Dantistcopra: folds 
ClassicWheel: raises $1 to $1.50
Dantist1122: folds 
John_les: folds 
matiko09: folds 
Lita17: folds 
KABAL_ua: folds 
POTAPENKO700: folds 
Uncalled bet ($1) returned to ClassicWheel
ClassicWheel collected $1.25 from pot
ClassicWheel: doesn't show hand 
*** SUMMARY ***
Total pot $1.25 | Rake $0 
Seat 1: Dantist1122 folded before Flop (didn't bet)
Seat 2: John_les folded before Flop (didn't bet)
Seat 3: matiko09 folded before Flop (didn't bet)
Seat 4: Lita17 (button) folded before Flop (didn't bet)
Seat 5: KABAL_ua (small blind) folded before Flop
Seat 6: POTAPENKO700 (big blind) folded before Flop
Seat 7: THREE FlDDY folded before Flop (didn't bet)
Seat 8: Dantistcopra folded before Flop (didn't bet)
Seat 9: ClassicWheel collected ($1.25)





PokerStars Hand #155373614429:  Hold'em No Limit ($0.25/$0.50 USD) - 2016/06/30 8:23:52 CET [2016/06/30 2:23:52 ET]
Table 'Praxidike' 9-max Seat #8 is the button
Seat 1: Sniper1717 ($50.75 in chips) 
Seat 2: prominente ($163.43 in chips) 
Seat 3: THREE FlDDY ($50.75 in chips) 
Seat 4: nicklasrossd ($13.58 in chips) 
Seat 5: John_les ($50 in chips) 
Seat 6: Dantistcopra ($50 in chips) 
Seat 7: matiko09 ($65.49 in chips) 
Seat 8: Dantist1122 ($56.32 in chips) 
Seat 9: KABAL_ua ($57.42 in chips) 
KABAL_ua: posts small blind $0.25
Sniper1717: posts big blind $0.50
*** HOLE CARDS ***
Dealt to matiko09 [Td Ah]
prominente: raises $1 to $1.50
THREE FlDDY: folds 
nicklasrossd: calls $1.50
John_les: folds 
Dantistcopra: folds 
matiko09: folds 
Dantist1122: folds 
KABAL_ua: folds 
Sniper1717: folds 
*** FLOP *** [4h 5c 8s]
prominente: bets $1.75
nicklasrossd: calls $1.75
*** TURN *** [4h 5c 8s] [4d]
prominente: checks 
nicklasrossd: checks 
*** RIVER *** [4h 5c 8s 4d] [9h]
prominente: checks 
nicklasrossd: checks 
*** SHOW DOWN ***
prominente: shows [7d 7s] (two pair, Sevens and Fours)
nicklasrossd: mucks hand 
prominente collected $6.89 from pot
*** SUMMARY ***
Total pot $7.25 | Rake $0.36 
Board [4h 5c 8s 4d 9h]
Seat 1: Sniper1717 (big blind) folded before Flop
Seat 2: prominente showed [7d 7s] and won ($6.89) with two pair, Sevens and Fours
Seat 3: THREE FlDDY folded before Flop (didn't bet)
Seat 4: nicklasrossd mucked [2h 2d]
Seat 5: John_les folded before Flop (didn't bet)
Seat 6: Dantistcopra folded before Flop (didn't bet)
Seat 7: matiko09 folded before Flop (didn't bet)
Seat 8: Dantist1122 (button) folded before Flop (didn't bet)
Seat 9: KABAL_ua (small blind) folded before Flop





PokerStars Hand #155373617904:  Hold'em No Limit ($0.50/$1.00 USD) - 2016/06/30 8:24:07 CET [2016/06/30 2:24:07 ET]
Table 'Lucretia II' 9-max Seat #3 is the button
Seat 1: matiko09 ($103.52 in chips) 
Seat 2: picka4u ($62.68 in chips) 
Seat 3: Alex Frider ($189.18 in chips) 
Seat 4: John_les ($104.07 in chips) 
Seat 5: butcheN18 ($100 in chips) 
Seat 6: flk.Dasas ($100 in chips) 
Seat 8: snow937022 ($129.95 in chips) 
Seat 9: misko123 ($27.61 in chips) 
John_les: posts small blind $0.50
butcheN18: posts big blind $1
Dantist1122: sits out 
*** HOLE CARDS ***
Dealt to matiko09 [3h 6h]
flk.Dasas: folds 
snow937022: raises $1.25 to $2.25
misko123: calls $2.25
matiko09: folds 
picka4u: raises $5.75 to $8
Alex Frider: folds 
John_les: folds 
butcheN18: folds 
snow937022: raises $13 to $21
misko123: folds 
picka4u: raises $41.68 to $62.68 and is all-in
snow937022: calls $41.68
*** FIRST FLOP *** [2c 3d Qd]
*** FIRST TURN *** [2c 3d Qd] [7c]
*** FIRST RIVER *** [2c 3d Qd 7c] [Th]
*** SECOND FLOP *** [4h Qh Qc]
*** SECOND TURN *** [4h Qh Qc] [9d]
*** SECOND RIVER *** [4h Qh Qc 9d] [Jh]
*** FIRST SHOW DOWN ***
snow937022: shows [Ks Kh] (a pair of Kings)
picka4u: shows [Kc Ad] (high card Ace)
snow937022 collected $63.31 from pot
*** SECOND SHOW DOWN ***
snow937022: shows [Ks Kh] (two pair, Kings and Queens)
picka4u: shows [Kc Ad] (a pair of Queens)
snow937022 collected $63.30 from pot
*** SUMMARY ***
Total pot $129.11 | Rake $2.50 
Hand was run twice
FIRST Board [2c 3d Qd 7c Th]
SECOND Board [4h Qh Qc 9d Jh]
Seat 1: matiko09 folded before Flop (didn't bet)
Seat 2: picka4u showed [Kc Ad] and lost with high card Ace, and lost with a pair of Queens
Seat 3: Alex Frider (button) folded before Flop (didn't bet)
Seat 4: John_les (small blind) folded before Flop
Seat 5: butcheN18 (big blind) folded before Flop
Seat 6: flk.Dasas folded before Flop (didn't bet)
Seat 8: snow937022 showed [Ks Kh] and won ($63.31) with a pair of Kings, and won ($63.30) with two pair, Kings and Queens
Seat 9: misko123 folded before Flop





PokerStars Hand #155373620483:  Hold'em No Limit ($0.25/$0.50 USD) - 2016/06/30 8:24:18 CET [2016/06/30 2:24:18 ET]
Table 'Ducrosa' 9-max Seat #5 is the button
Seat 1: Dantist1122 ($51.32 in chips) 
Seat 2: John_les ($50 in chips) 
Seat 3: matiko09 ($50 in chips) 
Seat 4: Lita17 ($73.13 in chips) 
Seat 5: KABAL_ua ($50 in chips) 
Seat 6: POTAPENKO700 ($50 in chips) 
Seat 7: THREE FlDDY ($50 in chips) 
Seat 8: Dantistcopra ($50 in chips) 
Seat 9: ClassicWheel ($63.96 in chips) 
POTAPENKO700: posts small blind $0.25
THREE FlDDY: posts big blind $0.50
*** HOLE CARDS ***
Dealt to matiko09 [Qd 9d]
Dantistcopra: folds 
ClassicWheel: folds 
Dantist1122: folds 
John_les: folds 
matiko09: folds 
Lita17: folds 
KABAL_ua: raises $0.70 to $1.20
POTAPENKO700: folds 
THREE FlDDY: folds 
Uncalled bet ($0.70) returned to KABAL_ua
KABAL_ua collected $1.25 from pot
KABAL_ua: doesn't show hand 
*** SUMMARY ***
Total pot $1.25 | Rake $0 
Seat 1: Dantist1122 folded before Flop (didn't bet)
Seat 2: John_les folded before Flop (didn't bet)
Seat 3: matiko09 folded before Flop (didn't bet)
Seat 4: Lita17 folded before Flop (didn't bet)
Seat 5: KABAL_ua (button) collected ($1.25)
Seat 6: POTAPENKO700 (small blind) folded before Flop
Seat 7: THREE FlDDY (big blind) folded before Flop
Seat 8: Dantistcopra folded before Flop (didn't bet)
Seat 9: ClassicWheel folded before Flop (didn't bet)





PokerStars Hand #155373624765:  Hold'em No Limit ($0.50/$1.00 USD) - 2016/06/30 8:24:37 CET [2016/06/30 2:24:37 ET]
Table 'Aunus' 9-max Seat #1 is the button
Seat 1: dboy604 ($130.36 in chips) 
Seat 2: HasBigBiceps ($100.85 in chips) 
Seat 3: matiko09 ($100 in chips) 
Seat 4: ilaviiitech ($100 in chips) 
Seat 5: hammerwife ($100 in chips) 
Seat 6: Painkiller72 ($100 in chips) 
Seat 7: ka100pka527 ($35 in chips) 
Seat 8: Dantist1122 ($101.50 in chips) 
Seat 9: flk.Dasas ($100 in chips) 
HasBigBiceps: posts small blind $0.50
matiko09: posts big blind $1
*** HOLE CARDS ***
Dealt to matiko09 [Qc Th]
ilaviiitech: folds 
hammerwife: folds 
Painkiller72: raises $1.50 to $2.50
ka100pka527: folds 
Dantist1122: folds 
flk.Dasas: folds 
dboy604: calls $2.50
HasBigBiceps: folds 
matiko09: folds 
*** FLOP *** [8s 2h 8h]
Painkiller72: bets $4.32
dboy604: folds 
Uncalled bet ($4.32) returned to Painkiller72
Painkiller72 collected $6.18 from pot
Painkiller72: doesn't show hand 
*** SUMMARY ***
Total pot $6.50 | Rake $0.32 
Board [8s 2h 8h]
Seat 1: dboy604 (button) folded on the Flop
Seat 2: HasBigBiceps (small blind) folded before Flop
Seat 3: matiko09 (big blind) folded before Flop
Seat 4: ilaviiitech folded before Flop (didn't bet)
Seat 5: hammerwife folded before Flop (didn't bet)
Seat 6: Painkiller72 collected ($6.18)
Seat 7: ka100pka527 folded before Flop (didn't bet)
Seat 8: Dantist1122 folded before Flop (didn't bet)
Seat 9: flk.Dasas folded before Flop (didn't bet)





PokerStars Hand #155373625687:  Hold'em No Limit ($0.50/$1.00 USD) - 2016/06/30 8:24:41 CET [2016/06/30 2:24:41 ET]
Table 'Asmodeus' 9-max Seat #5 is the button
Seat 1: Imbear8 ($97.99 in chips) 
Seat 2: gleam6619 ($86.65 in chips) 
Seat 3: L4zy_FiSh ($100 in chips) 
Seat 4: matiko09 ($100 in chips) 
Seat 5: butcheN18 ($119.22 in chips) 
Seat 6: snow937022 ($138.19 in chips) 
Seat 7: picka4u ($38.50 in chips) 
Seat 8: RoadtoNepal ($108.62 in chips) 
Seat 9: flk.Dasas ($160.52 in chips) 
snow937022: posts small blind $0.50
picka4u: posts big blind $1
*** HOLE CARDS ***
Dealt to matiko09 [2s 4c]
RoadtoNepal has timed out
RoadtoNepal: folds 
flk.Dasas: folds 
Imbear8: folds 
gleam6619: folds 
L4zy_FiSh: folds 
matiko09: folds 
butcheN18: folds 
snow937022: raises $1.25 to $2.25
picka4u: raises $3.75 to $6
snow937022: calls $3.75
*** FLOP *** [6d Kh 7d]
snow937022: checks 
picka4u: checks 
*** TURN *** [6d Kh 7d] [7c]
snow937022: checks 
picka4u: bets $7.50
snow937022: folds 
Uncalled bet ($7.50) returned to picka4u
picka4u collected $11.40 from pot
picka4u: doesn't show hand 
*** SUMMARY ***
Total pot $12 | Rake $0.60 
Board [6d Kh 7d 7c]
Seat 1: Imbear8 folded before Flop (didn't bet)
Seat 2: gleam6619 folded before Flop (didn't bet)
Seat 3: L4zy_FiSh folded before Flop (didn't bet)
Seat 4: matiko09 folded before Flop (didn't bet)
Seat 5: butcheN18 (button) folded before Flop (didn't bet)
Seat 6: snow937022 (small blind) folded on the Turn
Seat 7: picka4u (big blind) collected ($11.40)
Seat 8: RoadtoNepal folded before Flop (didn't bet)
Seat 9: flk.Dasas folded before Flop (didn't bet)





PokerStars Hand #155373628280:  Hold'em No Limit ($0.25/$0.50 USD) - 2016/06/30 8:24:52 CET [2016/06/30 2:24:52 ET]
Table 'Ducrosa' 9-max Seat #6 is the button
Seat 1: Dantist1122 ($51.32 in chips) 
Seat 2: John_les ($50 in chips) 
Seat 3: matiko09 ($50 in chips) 
Seat 4: Lita17 ($73.13 in chips) 
Seat 5: KABAL_ua ($50.75 in chips) 
Seat 6: POTAPENKO700 ($50 in chips) 
Seat 7: THREE FlDDY ($50 in chips) 
Seat 8: Dantistcopra ($50 in chips) 
Seat 9: ClassicWheel ($63.96 in chips) 
THREE FlDDY: posts small blind $0.25
Dantistcopra: posts big blind $0.50
*** HOLE CARDS ***
Dealt to matiko09 [2d Jh]
ClassicWheel: calls $0.50
Dantist1122: folds 
John_les: folds 
matiko09: folds 
Lita17: folds 
KABAL_ua: folds 
POTAPENKO700: folds 
THREE FlDDY: folds 
Dantistcopra: checks 
*** FLOP *** [5c 3d Ks]
Dantistcopra: checks 
ClassicWheel: bets $1.19
Dantistcopra: folds 
Uncalled bet ($1.19) returned to ClassicWheel
ClassicWheel collected $1.19 from pot
ClassicWheel: doesn't show hand 
*** SUMMARY ***
Total pot $1.25 | Rake $0.06 
Board [5c 3d Ks]
Seat 1: Dantist1122 folded before Flop (didn't bet)
Seat 2: John_les folded before Flop (didn't bet)
Seat 3: matiko09 folded before Flop (didn't bet)
Seat 4: Lita17 folded before Flop (didn't bet)
Seat 5: KABAL_ua folded before Flop (didn't bet)
Seat 6: POTAPENKO700 (button) folded before Flop (didn't bet)
Seat 7: THREE FlDDY (small blind) folded before Flop
Seat 8: Dantistcopra (big blind) folded on the Flop
Seat 9: ClassicWheel collected ($1.19)





PokerStars Hand #155373632139:  Hold'em No Limit ($0.50/$1.00 USD) - 2016/06/30 8:25:08 CET [2016/06/30 2:25:08 ET]
Table 'Lucretia II' 9-max Seat #4 is the button
Seat 1: matiko09 ($103.52 in chips) 
Seat 2: picka4u ($40 in chips) 
Seat 3: Alex Frider ($189.18 in chips) 
Seat 4: John_les ($103.57 in chips) 
Seat 5: butcheN18 ($100 in chips) 
Seat 6: flk.Dasas ($100 in chips) 
Seat 8: snow937022 ($193.88 in chips) 
Seat 9: misko123 ($25.36 in chips) 
butcheN18: posts small blind $0.50
flk.Dasas: posts big blind $1
Dantist1122: sits out 
*** HOLE CARDS ***
Dealt to matiko09 [Ac Kc]
snow937022: folds 
misko123: folds 
matiko09: raises $2 to $3
picka4u: folds 
Alex Frider: folds 
John_les: folds 
butcheN18: folds 
flk.Dasas: folds 
Uncalled bet ($2) returned to matiko09
matiko09 collected $2.50 from pot
matiko09: doesn't show hand 
*** SUMMARY ***
Total pot $2.50 | Rake $0 
Seat 1: matiko09 collected ($2.50)
Seat 2: picka4u folded before Flop (didn't bet)
Seat 3: Alex Frider folded before Flop (didn't bet)
Seat 4: John_les (button) folded before Flop (didn't bet)
Seat 5: butcheN18 (small blind) folded before Flop
Seat 6: flk.Dasas (big blind) folded before Flop
Seat 8: snow937022 folded before Flop (didn't bet)
Seat 9: misko123 folded before Flop (didn't bet)





PokerStars Hand #155373633420:  Hold'em No Limit ($0.50/$1.00 USD) - 2016/06/30 8:25:14 CET [2016/06/30 2:25:14 ET]
Table 'Aunus' 9-max Seat #2 is the button
Seat 1: dboy604 ($127.86 in chips) 
Seat 2: HasBigBiceps ($100.35 in chips) 
Seat 3: matiko09 ($100 in chips) 
Seat 4: ilaviiitech ($100 in chips) 
Seat 5: hammerwife ($100 in chips) 
Seat 6: Painkiller72 ($103.68 in chips) 
Seat 7: ka100pka527 ($35 in chips) 
Seat 8: Dantist1122 ($101.50 in chips) 
Seat 9: flk.Dasas ($100 in chips) 
matiko09: posts small blind $0.50
ilaviiitech: posts big blind $1
*** HOLE CARDS ***
Dealt to matiko09 [6c Jh]
hammerwife: folds 
Painkiller72: raises $1.50 to $2.50
ka100pka527: folds 
Dantist1122: folds 
flk.Dasas: folds 
dboy604: folds 
HasBigBiceps: folds 
matiko09: folds 
ilaviiitech: folds 
Uncalled bet ($1.50) returned to Painkiller72
Painkiller72 collected $2.50 from pot
Painkiller72: doesn't show hand 
*** SUMMARY ***
Total pot $2.50 | Rake $0 
Seat 1: dboy604 folded before Flop (didn't bet)
Seat 2: HasBigBiceps (button) folded before Flop (didn't bet)
Seat 3: matiko09 (small blind) folded before Flop
Seat 4: ilaviiitech (big blind) folded before Flop
Seat 5: hammerwife folded before Flop (didn't bet)
Seat 6: Painkiller72 collected ($2.50)
Seat 7: ka100pka527 folded before Flop (didn't bet)
Seat 8: Dantist1122 folded before Flop (didn't bet)
Seat 9: flk.Dasas folded before Flop (didn't bet)





PokerStars Hand #155373634053:  Hold'em No Limit ($0.25/$0.50 USD) - 2016/06/30 8:25:17 CET [2016/06/30 2:25:17 ET]
Table 'Praxidike' 9-max Seat #9 is the button
Seat 1: Sniper1717 ($50.25 in chips) 
Seat 3: THREE FlDDY ($50.75 in chips) 
Seat 4: nicklasrossd ($10.33 in chips) 
Seat 5: John_les ($50 in chips) 
Seat 6: Dantistcopra ($50 in chips) 
Seat 7: matiko09 ($65.49 in chips) 
Seat 8: Dantist1122 ($56.32 in chips) 
Seat 9: KABAL_ua ($57.17 in chips) 
Sniper1717: posts small blind $0.25
prominente: is sitting out 
THREE FlDDY: posts big blind $0.50
*** HOLE CARDS ***
Dealt to matiko09 [Qc Jd]
nicklasrossd: calls $0.50
John_les: folds 
prominente leaves the table
Dantistcopra: folds 
matiko09: raises $1.25 to $1.75
Dantist1122: folds 
KABAL_ua: folds 
Sniper1717: folds 
THREE FlDDY: folds 
nicklasrossd: calls $1.25
*** FLOP *** [As Qs 9d]
nicklasrossd: bets $8.58 and is all-in
matiko09: calls $8.58
*** TURN *** [As Qs 9d] [4c]
*** RIVER *** [As Qs 9d 4c] [5c]
BlackHawk901 joins the table at seat #2 
*** SHOW DOWN ***
nicklasrossd: shows [Ah 7h] (a pair of Aces)
matiko09: shows [Qc Jd] (a pair of Queens)
nicklasrossd collected $20.34 from pot
*** SUMMARY ***
Total pot $21.41 | Rake $1.07 
Board [As Qs 9d 4c 5c]
Seat 1: Sniper1717 (small blind) folded before Flop
Seat 3: THREE FlDDY (big blind) folded before Flop
Seat 4: nicklasrossd showed [Ah 7h] and won ($20.34) with a pair of Aces
Seat 5: John_les folded before Flop (didn't bet)
Seat 6: Dantistcopra folded before Flop (didn't bet)
Seat 7: matiko09 showed [Qc Jd] and lost with a pair of Queens
Seat 8: Dantist1122 folded before Flop (didn't bet)
Seat 9: KABAL_ua (button) folded before Flop (didn't bet)





PokerStars Hand #155373635957:  Hold'em No Limit ($0.50/$1.00 USD) - 2016/06/30 8:25:24 CET [2016/06/30 2:25:24 ET]
Table 'Lucretia II' 9-max Seat #5 is the button
Seat 1: matiko09 ($105.02 in chips) 
Seat 2: picka4u ($40 in chips) 
Seat 3: Alex Frider ($189.18 in chips) 
Seat 4: John_les ($103.57 in chips) 
Seat 5: butcheN18 ($100 in chips) 
Seat 6: flk.Dasas ($100 in chips) 
Seat 7: Dantist1122 ($100 in chips) 
Seat 8: snow937022 ($193.88 in chips) 
Seat 9: misko123 ($25.36 in chips) 
flk.Dasas: posts small blind $0.50
Dantist1122: posts big blind $1
*** HOLE CARDS ***
Dealt to matiko09 [6c 4h]
snow937022: folds 
misko123: calls $1
matiko09: folds 
picka4u: folds 
Alex Frider: folds 
John_les: raises $3.50 to $4.50
butcheN18: folds 
flk.Dasas: folds 
Dantist1122: folds 
misko123: calls $3.50
*** FLOP *** [Qc 9c 7s]
misko123: checks 
John_les: bets $6
misko123: calls $6
*** TURN *** [Qc 9c 7s] [6h]
misko123: checks 
John_les: checks 
*** RIVER *** [Qc 9c 7s 6h] [Qh]
misko123: bets $1
John_les: calls $1
*** SHOW DOWN ***
misko123: shows [6s 8s] (two pair, Queens and Sixes)
John_les: mucks hand 
misko123 collected $23.28 from pot
*** SUMMARY ***
Total pot $24.50 | Rake $1.22 
Board [Qc 9c 7s 6h Qh]
Seat 1: matiko09 folded before Flop (didn't bet)
Seat 2: picka4u folded before Flop (didn't bet)
Seat 3: Alex Frider folded before Flop (didn't bet)
Seat 4: John_les mucked [Kh As]
Seat 5: butcheN18 (button) folded before Flop (didn't bet)
Seat 6: flk.Dasas (small blind) folded before Flop
Seat 7: Dantist1122 (big blind) folded before Flop
Seat 8: snow937022 folded before Flop (didn't bet)
Seat 9: misko123 showed [6s 8s] and won ($23.28) with two pair, Queens and Sixes





PokerStars Hand #155373639295:  Hold'em No Limit ($0.50/$1.00 USD) - 2016/06/30 8:25:39 CET [2016/06/30 2:25:39 ET]
Table 'Aunus' 9-max Seat #3 is the button
Seat 1: dboy604 ($127.86 in chips) 
Seat 2: HasBigBiceps ($100.35 in chips) 
Seat 3: matiko09 ($100 in chips) 
Seat 4: ilaviiitech ($100 in chips) 
Seat 5: hammerwife ($100 in chips) 
Seat 6: Painkiller72 ($105.18 in chips) 
Seat 7: ka100pka527 ($35 in chips) 
Seat 8: Dantist1122 ($101.50 in chips) 
Seat 9: flk.Dasas ($100 in chips) 
ilaviiitech: posts small blind $0.50
hammerwife: posts big blind $1
*** HOLE CARDS ***
Dealt to matiko09 [Ac 8h]
Painkiller72: folds 
ka100pka527: folds 
Painkiller72 leaves the table
Dantist1122: folds 
flk.Dasas: folds 
dboy604: folds 
HasBigBiceps: folds 
matiko09: raises $1.27 to $2.27
ilaviiitech: calls $1.77
hammerwife: folds 
*** FLOP *** [Th Qs 8s]
ilaviiitech: checks 
matiko09: checks 
*** TURN *** [Th Qs 8s] [Td]
ilaviiitech: checks 
RoadtoNepal joins the table at seat #6 
matiko09: bets $1.63
ilaviiitech: calls $1.63
*** RIVER *** [Th Qs 8s Td] [Ah]
ilaviiitech: checks 
matiko09: bets $2.59
ilaviiitech: folds 
Uncalled bet ($2.59) returned to matiko09
matiko09 collected $8.36 from pot
matiko09: doesn't show hand 
*** SUMMARY ***
Total pot $8.80 | Rake $0.44 
Board [Th Qs 8s Td Ah]
Seat 1: dboy604 folded before Flop (didn't bet)
Seat 2: HasBigBiceps folded before Flop (didn't bet)
Seat 3: matiko09 (button) collected ($8.36)
Seat 4: ilaviiitech (small blind) folded on the River
Seat 5: hammerwife (big blind) folded before Flop
Seat 6: Painkiller72 folded before Flop (didn't bet)
Seat 7: ka100pka527 folded before Flop (didn't bet)
Seat 8: Dantist1122 folded before Flop (didn't bet)
Seat 9: flk.Dasas folded before Flop (didn't bet)





PokerStars Hand #155373640059:  Hold'em No Limit ($0.25/$0.50 USD) - 2016/06/30 8:25:42 CET [2016/06/30 2:25:42 ET]
Table 'Ducrosa' 9-max Seat #7 is the button
Seat 1: Dantist1122 ($51.32 in chips) 
Seat 2: John_les ($50 in chips) 
Seat 3: matiko09 ($50 in chips) 
Seat 4: Lita17 ($73.13 in chips) 
Seat 5: KABAL_ua ($50.75 in chips) 
Seat 6: POTAPENKO700 ($50 in chips) 
Seat 7: THREE FlDDY ($50 in chips) 
Seat 8: Dantistcopra ($50 in chips) 
Seat 9: ClassicWheel ($64.65 in chips) 
Dantistcopra: posts small blind $0.25
ClassicWheel: posts big blind $0.50
*** HOLE CARDS ***
Dealt to matiko09 [Jh 9h]
Dantist1122: folds 
John_les: raises $1.25 to $1.75
matiko09: folds 
Lita17: folds 
KABAL_ua: folds 
POTAPENKO700: folds 
THREE FlDDY: folds 
Dantistcopra: folds 
ClassicWheel: folds 
Uncalled bet ($1.25) returned to John_les
John_les collected $1.25 from pot
John_les: doesn't show hand 
*** SUMMARY ***
Total pot $1.25 | Rake $0 
Seat 1: Dantist1122 folded before Flop (didn't bet)
Seat 2: John_les collected ($1.25)
Seat 3: matiko09 folded before Flop (didn't bet)
Seat 4: Lita17 folded before Flop (didn't bet)
Seat 5: KABAL_ua folded before Flop (didn't bet)
Seat 6: POTAPENKO700 folded before Flop (didn't bet)
Seat 7: THREE FlDDY (button) folded before Flop (didn't bet)
Seat 8: Dantistcopra (small blind) folded before Flop
Seat 9: ClassicWheel (big blind) folded before Flop





PokerStars Hand #155373644115:  Hold'em No Limit ($0.50/$1.00 USD) - 2016/06/30 8:25:59 CET [2016/06/30 2:25:59 ET]
Table 'Asmodeus' 9-max Seat #6 is the button
Seat 1: Imbear8 ($97.99 in chips) 
Seat 2: gleam6619 ($86.65 in chips) 
Seat 3: L4zy_FiSh ($100 in chips) 
Seat 4: matiko09 ($100 in chips) 
Seat 5: butcheN18 ($119.22 in chips) 
Seat 6: snow937022 ($132.19 in chips) 
Seat 7: picka4u ($43.90 in chips) 
Seat 8: RoadtoNepal ($108.62 in chips) 
Seat 9: flk.Dasas ($160.52 in chips) 
picka4u: posts small blind $0.50
RoadtoNepal: posts big blind $1
*** HOLE CARDS ***
Dealt to matiko09 [Qh Qs]
flk.Dasas: raises $2 to $3
Imbear8: folds 
gleam6619: raises $3 to $6
L4zy_FiSh: folds 
matiko09: raises $7 to $13
butcheN18: folds 
snow937022: folds 
picka4u: folds 
RoadtoNepal: folds 
flk.Dasas: raises $10 to $23
gleam6619: raises $23 to $46
matiko09: folds 
flk.Dasas: raises $114.52 to $160.52 and is all-in
gleam6619: calls $40.65 and is all-in
Uncalled bet ($73.87) returned to flk.Dasas
*** FLOP *** [2s Qc 6c]
*** TURN *** [2s Qc 6c] [6s]
*** RIVER *** [2s Qc 6c 6s] [2c]
*** SHOW DOWN ***
flk.Dasas: shows [Ah Ad] (two pair, Aces and Sixes)
gleam6619: shows [Ks As] (two pair, Sixes and Deuces)
flk.Dasas collected $185.30 from pot
*** SUMMARY ***
Total pot $187.80 | Rake $2.50 
Board [2s Qc 6c 6s 2c]
Seat 1: Imbear8 folded before Flop (didn't bet)
Seat 2: gleam6619 showed [Ks As] and lost with two pair, Sixes and Deuces
Seat 3: L4zy_FiSh folded before Flop (didn't bet)
Seat 4: matiko09 folded before Flop
Seat 5: butcheN18 folded before Flop (didn't bet)
Seat 6: snow937022 (button) folded before Flop (didn't bet)
Seat 7: picka4u (small blind) folded before Flop
Seat 8: RoadtoNepal (big blind) folded before Flop
Seat 9: flk.Dasas showed [Ah Ad] and won ($185.30) with two pair, Aces and Sixes





PokerStars Hand #155373646072:  Hold'em No Limit ($0.25/$0.50 USD) - 2016/06/30 8:26:08 CET [2016/06/30 2:26:08 ET]
Table 'Ducrosa' 9-max Seat #8 is the button
Seat 1: Dantist1122 ($51.32 in chips) 
Seat 2: John_les ($50.75 in chips) 
Seat 3: matiko09 ($50 in chips) 
Seat 4: Lita17 ($73.13 in chips) 
Seat 5: KABAL_ua ($50.75 in chips) 
Seat 6: POTAPENKO700 ($50 in chips) 
Seat 7: THREE FlDDY ($50 in chips) 
Seat 8: Dantistcopra ($50 in chips) 
Seat 9: ClassicWheel ($64.15 in chips) 
ClassicWheel: posts small blind $0.25
Dantist1122: posts big blind $0.50
*** HOLE CARDS ***
Dealt to matiko09 [4c Kd]
John_les: folds 
matiko09: folds 
Lita17: raises $0.75 to $1.25
KABAL_ua: folds 
POTAPENKO700: folds 
THREE FlDDY: folds 
Dantistcopra: raises $3 to $4.25
ClassicWheel: folds 
Dantist1122: folds 
Lita17: folds [Ah]
Uncalled bet ($3) returned to Dantistcopra
Dantistcopra collected $3.25 from pot
*** SUMMARY ***
Total pot $3.25 | Rake $0 
Seat 1: Dantist1122 (big blind) folded before Flop
Seat 2: John_les folded before Flop (didn't bet)
Seat 3: matiko09 folded before Flop (didn't bet)
Seat 4: Lita17 folded before Flop
Seat 5: KABAL_ua folded before Flop (didn't bet)
Seat 6: POTAPENKO700 folded before Flop (didn't bet)
Seat 7: THREE FlDDY folded before Flop (didn't bet)
Seat 8: Dantistcopra (button) collected ($3.25)
Seat 9: ClassicWheel (small blind) folded before Flop





PokerStars Hand #155373648519:  Hold'em No Limit ($0.25/$0.50 USD) - 2016/06/30 8:26:18 CET [2016/06/30 2:26:18 ET]
Table 'Praxidike' 9-max Seat #1 is the button
Seat 1: Sniper1717 ($50 in chips) 
Seat 3: THREE FlDDY ($50.25 in chips) 
Seat 5: John_les ($50 in chips) 
Seat 6: Dantistcopra ($50 in chips) 
Seat 7: matiko09 ($55.16 in chips) 
Seat 8: Dantist1122 ($56.32 in chips) 
Seat 9: KABAL_ua ($57.17 in chips) 
BlackHawk901 will be allowed to play after the button
THREE FlDDY: posts small blind $0.25
John_les: posts big blind $0.50
*** HOLE CARDS ***
Dealt to matiko09 [6c Kd]
Dantistcopra: folds 
matiko09: folds 
Dantist1122: folds 
KABAL_ua: folds 
Sniper1717: folds 
THREE FlDDY: folds 
Uncalled bet ($0.25) returned to John_les
John_les collected $0.50 from pot
John_les: doesn't show hand 
*** SUMMARY ***
Total pot $0.50 | Rake $0 
Seat 1: Sniper1717 (button) folded before Flop (didn't bet)
Seat 3: THREE FlDDY (small blind) folded before Flop
Seat 5: John_les (big blind) collected ($0.50)
Seat 6: Dantistcopra folded before Flop (didn't bet)
Seat 7: matiko09 folded before Flop (didn't bet)
Seat 8: Dantist1122 folded before Flop (didn't bet)
Seat 9: KABAL_ua folded before Flop (didn't bet)





PokerStars Hand #155373649906:  Hold'em No Limit ($0.50/$1.00 USD) - 2016/06/30 8:26:24 CET [2016/06/30 2:26:24 ET]
Table 'Lucretia II' 9-max Seat #6 is the button
Seat 1: matiko09 ($105.02 in chips) 
Seat 2: picka4u ($40 in chips) 
Seat 3: Alex Frider ($189.18 in chips) 
Seat 4: John_les ($100 in chips) 
Seat 5: butcheN18 ($100 in chips) 
Seat 6: flk.Dasas ($100 in chips) 
Seat 7: Dantist1122 ($100 in chips) 
Seat 8: snow937022 ($193.88 in chips) 
Seat 9: misko123 ($37.14 in chips) 
Dantist1122: posts small blind $0.50
snow937022: posts big blind $1
*** HOLE CARDS ***
Dealt to matiko09 [7s 5d]
misko123: calls $1
matiko09: folds 
picka4u: folds 
Alex Frider: folds 
John_les: folds 
butcheN18: raises $3.18 to $4.18
flk.Dasas: folds 
Dantist1122: folds 
snow937022: raises $9.86 to $14.04
misko123: folds 
butcheN18: folds 
Uncalled bet ($9.86) returned to snow937022
snow937022 collected $9.86 from pot
snow937022: doesn't show hand 
*** SUMMARY ***
Total pot $9.86 | Rake $0 
Seat 1: matiko09 folded before Flop (didn't bet)
Seat 2: picka4u folded before Flop (didn't bet)
Seat 3: Alex Frider folded before Flop (didn't bet)
Seat 4: John_les folded before Flop (didn't bet)
Seat 5: butcheN18 folded before Flop
Seat 6: flk.Dasas (button) folded before Flop (didn't bet)
Seat 7: Dantist1122 (small blind) folded before Flop
Seat 8: snow937022 (big blind) collected ($9.86)
Seat 9: misko123 folded before Flop





PokerStars Hand #155373655307:  Hold'em No Limit ($0.25/$0.50 USD) - 2016/06/30 8:26:47 CET [2016/06/30 2:26:47 ET]
Table 'Praxidike' 9-max Seat #3 is the button
Seat 1: Sniper1717 ($50 in chips) 
Seat 3: THREE FlDDY ($50 in chips) 
Seat 5: John_les ($50.25 in chips) 
Seat 6: Dantistcopra ($50 in chips) 
Seat 7: matiko09 ($55.16 in chips) 
Seat 8: Dantist1122 ($56.32 in chips) 
Seat 9: KABAL_ua ($57.17 in chips) 
nicklasrossd will be allowed to play after the button
John_les: posts small blind $0.25
Dantistcopra: posts big blind $0.50
BlackHawk901: sits out 
*** HOLE CARDS ***
Dealt to matiko09 [7h 8h]
matiko09: raises $1 to $1.50
Dantist1122: folds 
nicklasrossd is disconnected 
KABAL_ua: folds 
Sniper1717: folds 
THREE FlDDY: folds 
John_les: folds 
Dantistcopra: calls $1
*** FLOP *** [9d 3h 6c]
Dantistcopra: checks 
matiko09: bets $2
Dantistcopra: folds 
Uncalled bet ($2) returned to matiko09
matiko09 collected $3.09 from pot
matiko09: doesn't show hand 
*** SUMMARY ***
Total pot $3.25 | Rake $0.16 
Board [9d 3h 6c]
Seat 1: Sniper1717 folded before Flop (didn't bet)
Seat 3: THREE FlDDY (button) folded before Flop (didn't bet)
Seat 5: John_les (small blind) folded before Flop
Seat 6: Dantistcopra (big blind) folded on the Flop
Seat 7: matiko09 collected ($3.09)
Seat 8: Dantist1122 folded before Flop (didn't bet)
Seat 9: KABAL_ua folded before Flop (didn't bet)





PokerStars Hand #155373656419:  Hold'em No Limit ($0.50/$1.00 USD) - 2016/06/30 8:26:51 CET [2016/06/30 2:26:51 ET]
Table 'Gaby' 9-max Seat #5 is the button
Seat 2: ka100pka527 ($41 in chips) 
Seat 5: ilaviiitech ($100 in chips) 
Seat 7: stel19 ($40.50 in chips) 
Seat 8: matiko09 ($100 in chips) 
stel19: posts small blind $0.50
matiko09: posts big blind $1
*** HOLE CARDS ***
Dealt to matiko09 [6s 3d]
ka100pka527: folds 
ilaviiitech: folds 
Dantist1122 joins the table at seat #3 
RoadtoNepal joins the table at seat #6 
stel19: calls $0.50
matiko09: checks 
*** FLOP *** [Ks 5s 4h]
stel19: checks 
matiko09: bets $1.24
stel19: calls $1.24
*** TURN *** [Ks 5s 4h] [Kd]
stel19: checks 
Alex Frider joins the table at seat #4 
matiko09: checks 
*** RIVER *** [Ks 5s 4h Kd] [8h]
Alex Frider leaves the table
stel19: bets $2.13
matiko09: folds 
Uncalled bet ($2.13) returned to stel19
stel19 collected $4.26 from pot
stel19: doesn't show hand 
*** SUMMARY ***
Total pot $4.48 | Rake $0.22 
Board [Ks 5s 4h Kd 8h]
Seat 2: ka100pka527 folded before Flop (didn't bet)
Seat 5: ilaviiitech (button) folded before Flop (didn't bet)
Seat 7: stel19 (small blind) collected ($4.26)
Seat 8: matiko09 (big blind) folded on the River





PokerStars Hand #155373658190:  Hold'em No Limit ($0.25/$0.50 USD) - 2016/06/30 8:26:59 CET [2016/06/30 2:26:59 ET]
Table 'Ducrosa' 9-max Seat #9 is the button
Seat 1: Dantist1122 ($50.82 in chips) 
Seat 2: John_les ($50.75 in chips) 
Seat 3: matiko09 ($50 in chips) 
Seat 4: Lita17 ($71.88 in chips) 
Seat 5: KABAL_ua ($50.75 in chips) 
Seat 6: POTAPENKO700 ($50 in chips) 
Seat 7: THREE FlDDY ($50 in chips) 
Seat 8: Dantistcopra ($52 in chips) 
Seat 9: ClassicWheel ($63.90 in chips) 
Dantist1122: posts small blind $0.25
John_les: posts big blind $0.50
*** HOLE CARDS ***
Dealt to matiko09 [Kd 7c]
matiko09: folds 
Lita17: folds 
KABAL_ua: folds 
POTAPENKO700: folds 
THREE FlDDY: raises $0.76 to $1.26
Dantistcopra: folds 
ClassicWheel: folds 
Dantist1122: folds 
John_les: folds 
Uncalled bet ($0.76) returned to THREE FlDDY
THREE FlDDY collected $1.25 from pot
THREE FlDDY: doesn't show hand 
*** SUMMARY ***
Total pot $1.25 | Rake $0 
Seat 1: Dantist1122 (small blind) folded before Flop
Seat 2: John_les (big blind) folded before Flop
Seat 3: matiko09 folded before Flop (didn't bet)
Seat 4: Lita17 folded before Flop (didn't bet)
Seat 5: KABAL_ua folded before Flop (didn't bet)
Seat 6: POTAPENKO700 folded before Flop (didn't bet)
Seat 7: THREE FlDDY collected ($1.25)
Seat 8: Dantistcopra folded before Flop (didn't bet)
Seat 9: ClassicWheel (button) folded before Flop (didn't bet)





PokerStars Hand #155373660148:  Hold'em No Limit ($0.50/$1.00 USD) - 2016/06/30 8:27:07 CET [2016/06/30 2:27:07 ET]
Table 'Aunus' 9-max Seat #4 is the button
Seat 1: dboy604 ($127.86 in chips) 
Seat 2: HasBigBiceps ($100.35 in chips) 
Seat 3: matiko09 ($104.46 in chips) 
Seat 4: ilaviiitech ($100 in chips) 
Seat 5: hammerwife ($100 in chips) 
Seat 6: RoadtoNepal ($100 in chips) 
Seat 7: ka100pka527 ($35 in chips) 
Seat 8: Dantist1122 ($101.50 in chips) 
Seat 9: flk.Dasas ($100 in chips) 
hammerwife: posts small blind $0.50
RoadtoNepal: posts big blind $1
*** HOLE CARDS ***
Dealt to matiko09 [Ad As]
ka100pka527: folds 
Dantist1122: folds 
flk.Dasas: folds 
dboy604: calls $1
HasBigBiceps: folds 
matiko09: raises $3 to $4
ilaviiitech: calls $4
hammerwife: folds 
RoadtoNepal: folds 
dboy604: calls $3
*** FLOP *** [2d 5d Kh]
dboy604: checks 
matiko09: bets $8.33
ilaviiitech: folds 
dboy604: folds 
Uncalled bet ($8.33) returned to matiko09
matiko09 collected $12.82 from pot
matiko09: doesn't show hand 
*** SUMMARY ***
Total pot $13.50 | Rake $0.68 
Board [2d 5d Kh]
Seat 1: dboy604 folded on the Flop
Seat 2: HasBigBiceps folded before Flop (didn't bet)
Seat 3: matiko09 collected ($12.82)
Seat 4: ilaviiitech (button) folded on the Flop
Seat 5: hammerwife (small blind) folded before Flop
Seat 6: RoadtoNepal (big blind) folded before Flop
Seat 7: ka100pka527 folded before Flop (didn't bet)
Seat 8: Dantist1122 folded before Flop (didn't bet)
Seat 9: flk.Dasas folded before Flop (didn't bet)





PokerStars Hand #155373664100:  Hold'em No Limit ($0.50/$1.00 USD) - 2016/06/30 8:27:24 CET [2016/06/30 2:27:24 ET]
Table 'Lucretia II' 9-max Seat #7 is the button
Seat 1: matiko09 ($105.02 in chips) 
Seat 2: picka4u ($40 in chips) 
Seat 3: Alex Frider ($189.18 in chips) 
Seat 4: John_les ($100 in chips) 
Seat 5: butcheN18 ($100 in chips) 
Seat 6: flk.Dasas ($100 in chips) 
Seat 7: Dantist1122 ($100 in chips) 
Seat 8: snow937022 ($199.56 in chips) 
Seat 9: misko123 ($36.14 in chips) 
snow937022: posts small blind $0.50
misko123: posts big blind $1
*** HOLE CARDS ***
Dealt to matiko09 [Jc 4h]
matiko09: folds 
picka4u: folds 
Alex Frider: folds 
John_les: folds 
butcheN18: folds 
flk.Dasas: folds 
Dantist1122: raises $2 to $3
snow937022: folds 
misko123: folds 
Uncalled bet ($2) returned to Dantist1122
Dantist1122 collected $2.50 from pot
Dantist1122: doesn't show hand 
*** SUMMARY ***
Total pot $2.50 | Rake $0 
Seat 1: matiko09 folded before Flop (didn't bet)
Seat 2: picka4u folded before Flop (didn't bet)
Seat 3: Alex Frider folded before Flop (didn't bet)
Seat 4: John_les folded before Flop (didn't bet)
Seat 5: butcheN18 folded before Flop (didn't bet)
Seat 6: flk.Dasas folded before Flop (didn't bet)
Seat 7: Dantist1122 (button) collected ($2.50)
Seat 8: snow937022 (small blind) folded before Flop
Seat 9: misko123 (big blind) folded before Flop





PokerStars Hand #155373664671:  Hold'em No Limit ($0.25/$0.50 USD) - 2016/06/30 8:27:26 CET [2016/06/30 2:27:26 ET]
Table 'Ducrosa' 9-max Seat #1 is the button
Seat 1: Dantist1122 ($50.57 in chips) 
Seat 2: John_les ($50.25 in chips) 
Seat 3: matiko09 ($50 in chips) 
Seat 4: Lita17 ($71.88 in chips) 
Seat 5: KABAL_ua ($50.75 in chips) 
Seat 6: POTAPENKO700 ($50 in chips) 
Seat 7: THREE FlDDY ($50.75 in chips) 
Seat 8: Dantistcopra ($52 in chips) 
Seat 9: ClassicWheel ($63.90 in chips) 
John_les: posts small blind $0.25
matiko09: posts big blind $0.50
*** HOLE CARDS ***
Dealt to matiko09 [7d 8c]
Lita17: folds 
KABAL_ua: folds 
POTAPENKO700: raises $0.75 to $1.25
THREE FlDDY: calls $1.25
Dantistcopra: calls $1.25
ClassicWheel: folds 
Dantist1122: folds 
John_les: folds 
matiko09: folds 
*** FLOP *** [3d 6h 7h]
POTAPENKO700: bets $2.25
THREE FlDDY: folds 
Dantistcopra: calls $2.25
*** TURN *** [3d 6h 7h] [6c]
POTAPENKO700: checks 
Dantistcopra: bets $6.93
POTAPENKO700: calls $6.93
*** RIVER *** [3d 6h 7h 6c] [7c]
POTAPENKO700: checks 
Dantistcopra: checks 
*** SHOW DOWN ***
POTAPENKO700: shows [Td Th] (two pair, Tens and Sevens)
Dantistcopra: shows [Jd Js] (two pair, Jacks and Sevens)
Dantistcopra collected $21.72 from pot
*** SUMMARY ***
Total pot $22.86 | Rake $1.14 
Board [3d 6h 7h 6c 7c]
Seat 1: Dantist1122 (button) folded before Flop (didn't bet)
Seat 2: John_les (small blind) folded before Flop
Seat 3: matiko09 (big blind) folded before Flop
Seat 4: Lita17 folded before Flop (didn't bet)
Seat 5: KABAL_ua folded before Flop (didn't bet)
Seat 6: POTAPENKO700 showed [Td Th] and lost with two pair, Tens and Sevens
Seat 7: THREE FlDDY folded on the Flop
Seat 8: Dantistcopra showed [Jd Js] and won ($21.72) with two pair, Jacks and Sevens
Seat 9: ClassicWheel folded before Flop (didn't bet)





PokerStars Hand #155373666972:  Hold'em No Limit ($0.25/$0.50 USD) - 2016/06/30 8:27:36 CET [2016/06/30 2:27:36 ET]
Table 'Praxidike' 9-max Seat #5 is the button
Seat 1: Sniper1717 ($50 in chips) 
Seat 3: THREE FlDDY ($50 in chips) 
Seat 5: John_les ($50 in chips) 
Seat 6: Dantistcopra ($50 in chips) 
Seat 7: matiko09 ($56.75 in chips) 
Seat 8: Dantist1122 ($56.32 in chips) 
Seat 9: KABAL_ua ($57.17 in chips) 
Dantistcopra: posts small blind $0.25
matiko09: posts big blind $0.50
BlackHawk901: sits out 
nicklasrossd has timed out while disconnected
nicklasrossd: is sitting out 
*** HOLE CARDS ***
Dealt to matiko09 [Kh Td]
Dantist1122: folds 
KABAL_ua: folds 
Sniper1717: folds 
THREE FlDDY: folds 
John_les: folds 
Dantistcopra: raises $0.52 to $1.02
matiko09: calls $0.52
*** FLOP *** [4c Kd 6h]
Dantistcopra: bets $1.29
matiko09: calls $1.29
*** TURN *** [4c Kd 6h] [Jc]
Dantistcopra: checks 
matiko09: checks 
*** RIVER *** [4c Kd 6h Jc] [8s]
Dantistcopra: bets $3.56
matiko09: calls $3.56
*** SHOW DOWN ***
Dantistcopra: shows [Jd 8h] (two pair, Jacks and Eights)
matiko09: mucks hand 
Dantistcopra collected $11.15 from pot
*** SUMMARY ***
Total pot $11.74 | Rake $0.59 
Board [4c Kd 6h Jc 8s]
Seat 1: Sniper1717 folded before Flop (didn't bet)
Seat 3: THREE FlDDY folded before Flop (didn't bet)
Seat 5: John_les (button) folded before Flop (didn't bet)
Seat 6: Dantistcopra (small blind) showed [Jd 8h] and won ($11.15) with two pair, Jacks and Eights
Seat 7: matiko09 (big blind) mucked [Kh Td]
Seat 8: Dantist1122 folded before Flop (didn't bet)
Seat 9: KABAL_ua folded before Flop (didn't bet)





PokerStars Hand #155373673266:  Hold'em No Limit ($0.50/$1.00 USD) - 2016/06/30 8:28:03 CET [2016/06/30 2:28:03 ET]
Table 'Lucretia II' 9-max Seat #8 is the button
Seat 1: matiko09 ($105.02 in chips) 
Seat 2: picka4u ($40 in chips) 
Seat 3: Alex Frider ($189.18 in chips) 
Seat 4: John_les ($100 in chips) 
Seat 5: butcheN18 ($100 in chips) 
Seat 6: flk.Dasas ($100 in chips) 
Seat 7: Dantist1122 ($101.50 in chips) 
Seat 8: snow937022 ($199.06 in chips) 
Seat 9: misko123 ($35.14 in chips) 
misko123: posts small blind $0.50
matiko09: posts big blind $1
*** HOLE CARDS ***
Dealt to matiko09 [Qh As]
picka4u: folds 
Alex Frider: folds 
John_les: folds 
butcheN18: folds 
flk.Dasas: folds 
Dantist1122: folds 
snow937022: raises $1.25 to $2.25
misko123: calls $1.75
matiko09: raises $7.75 to $10
snow937022: calls $7.75
misko123: folds 
*** FLOP *** [Ad 7c 5d]
matiko09: checks 
snow937022: bets $15.85
matiko09: calls $15.85
*** TURN *** [Ad 7c 5d] [2s]
matiko09: checks 
snow937022: bets $38.58
matiko09: raises $40.59 to $79.17 and is all-in
snow937022: calls $40.59
*** RIVER *** [Ad 7c 5d 2s] [Jc]
*** SHOW DOWN ***
matiko09: shows [Qh As] (a pair of Aces)
snow937022: shows [7d 6d] (a pair of Sevens)
matiko09 collected $209.79 from pot
*** SUMMARY ***
Total pot $212.29 | Rake $2.50 
Board [Ad 7c 5d 2s Jc]
Seat 1: matiko09 (big blind) showed [Qh As] and won ($209.79) with a pair of Aces
Seat 2: picka4u folded before Flop (didn't bet)
Seat 3: Alex Frider folded before Flop (didn't bet)
Seat 4: John_les folded before Flop (didn't bet)
Seat 5: butcheN18 folded before Flop (didn't bet)
Seat 6: flk.Dasas folded before Flop (didn't bet)
Seat 7: Dantist1122 folded before Flop (didn't bet)
Seat 8: snow937022 (button) showed [7d 6d] and lost with a pair of Sevens
Seat 9: misko123 (small blind) folded before Flop





PokerStars Hand #155373673168:  Hold'em No Limit ($0.50/$1.00 USD) - 2016/06/30 8:28:03 CET [2016/06/30 2:28:03 ET]
Table 'Asmodeus' 9-max Seat #7 is the button
Seat 1: Imbear8 ($97.99 in chips) 
Seat 3: L4zy_FiSh ($100 in chips) 
Seat 4: matiko09 ($100 in chips) 
Seat 5: butcheN18 ($119.22 in chips) 
Seat 6: snow937022 ($132.19 in chips) 
Seat 7: picka4u ($43.40 in chips) 
Seat 8: RoadtoNepal ($107.62 in chips) 
Seat 9: flk.Dasas ($259.17 in chips) 
RoadtoNepal: posts small blind $0.50
flk.Dasas: posts big blind $1
*** HOLE CARDS ***
Dealt to matiko09 [8s Ks]
Imbear8: calls $1
L4zy_FiSh: raises $3 to $4
gleam6619 leaves the table
matiko09: folds 
butcheN18: folds 
John_les joins the table at seat #2 
snow937022: folds 
picka4u: folds 
RoadtoNepal: calls $3.50
flk.Dasas: folds 
Imbear8: calls $3
*** FLOP *** [9c 3d Ad]
RoadtoNepal: checks 
Imbear8: bets $7
L4zy_FiSh: calls $7
RoadtoNepal: calls $7
*** TURN *** [9c 3d Ad] [As]
RoadtoNepal: checks 
Imbear8: checks 
L4zy_FiSh: bets $16
RoadtoNepal: folds 
Imbear8: folds 
Uncalled bet ($16) returned to L4zy_FiSh
L4zy_FiSh collected $32.30 from pot
*** SUMMARY ***
Total pot $34 | Rake $1.70 
Board [9c 3d Ad As]
Seat 1: Imbear8 folded on the Turn
Seat 3: L4zy_FiSh collected ($32.30)
Seat 4: matiko09 folded before Flop (didn't bet)
Seat 5: butcheN18 folded before Flop (didn't bet)
Seat 6: snow937022 folded before Flop (didn't bet)
Seat 7: picka4u (button) folded before Flop (didn't bet)
Seat 8: RoadtoNepal (small blind) folded on the Turn
Seat 9: flk.Dasas (big blind) folded before Flop





PokerStars Hand #155373675650:  Hold'em No Limit ($0.50/$1.00 USD) - 2016/06/30 8:28:13 CET [2016/06/30 2:28:13 ET]
Table 'Gaby' 9-max Seat #7 is the button
Seat 2: ka100pka527 ($41 in chips) 
Seat 5: ilaviiitech ($100 in chips) 
Seat 7: stel19 ($42.52 in chips) 
Seat 8: matiko09 ($100 in chips) 
Seat 9: hammerwife ($100 in chips) 
matiko09: posts small blind $0.50
hammerwife: posts big blind $1
Dantist1122: sits out 
RoadtoNepal: sits out 
*** HOLE CARDS ***
Dealt to matiko09 [Ts 8s]
ka100pka527: raises $1 to $2
arctur17 joins the table at seat #4 
ilaviiitech: folds 
stel19: folds 
matiko09: folds 
hammerwife: folds 
Uncalled bet ($1) returned to ka100pka527
ka100pka527 collected $2.50 from pot
ka100pka527: doesn't show hand 
*** SUMMARY ***
Total pot $2.50 | Rake $0 
Seat 2: ka100pka527 collected ($2.50)
Seat 5: ilaviiitech folded before Flop (didn't bet)
Seat 7: stel19 (button) folded before Flop (didn't bet)
Seat 8: matiko09 (small blind) folded before Flop
Seat 9: hammerwife (big blind) folded before Flop





PokerStars Hand #155373676010:  Hold'em No Limit ($0.50/$1.00 USD) - 2016/06/30 8:28:15 CET [2016/06/30 2:28:15 ET]
Table 'Aunus' 9-max Seat #5 is the button
Seat 1: dboy604 ($123.86 in chips) 
Seat 2: HasBigBiceps ($100.35 in chips) 
Seat 3: matiko09 ($113.28 in chips) 
Seat 4: ilaviiitech ($100 in chips) 
Seat 5: hammerwife ($100 in chips) 
Seat 6: RoadtoNepal ($100 in chips) 
Seat 7: ka100pka527 ($35 in chips) 
Seat 8: Dantist1122 ($101.50 in chips) 
Seat 9: flk.Dasas ($100 in chips) 
RoadtoNepal: posts small blind $0.50
ka100pka527: posts big blind $1
*** HOLE CARDS ***
Dealt to matiko09 [8c 3s]
Dantist1122: folds 
flk.Dasas: folds 
dboy604: calls $1
HasBigBiceps: folds 
matiko09: folds 
ilaviiitech: folds 
hammerwife: raises $4 to $5
RoadtoNepal: calls $4.50
ka100pka527: folds 
dboy604: folds 
*** FLOP *** [Ks 2c 5h]
RoadtoNepal: checks 
hammerwife: bets $6
RoadtoNepal: calls $6
*** TURN *** [Ks 2c 5h] [Kd]
RoadtoNepal: checks 
hammerwife: checks 
*** RIVER *** [Ks 2c 5h Kd] [4h]
RoadtoNepal: checks 
hammerwife: bets $16
RoadtoNepal: folds 
Uncalled bet ($16) returned to hammerwife
hammerwife collected $22.80 from pot
hammerwife: doesn't show hand 
*** SUMMARY ***
Total pot $24 | Rake $1.20 
Board [Ks 2c 5h Kd 4h]
Seat 1: dboy604 folded before Flop
Seat 2: HasBigBiceps folded before Flop (didn't bet)
Seat 3: matiko09 folded before Flop (didn't bet)
Seat 4: ilaviiitech folded before Flop (didn't bet)
Seat 5: hammerwife (button) collected ($22.80)
Seat 6: RoadtoNepal (small blind) folded on the River
Seat 7: ka100pka527 (big blind) folded before Flop
Seat 8: Dantist1122 folded before Flop (didn't bet)
Seat 9: flk.Dasas folded before Flop (didn't bet)





PokerStars Hand #155373682698:  Hold'em No Limit ($0.25/$0.50 USD) - 2016/06/30 8:28:44 CET [2016/06/30 2:28:44 ET]
Table 'Ducrosa' 9-max Seat #2 is the button
Seat 1: Dantist1122 ($50.57 in chips) 
Seat 2: John_les ($50 in chips) 
Seat 3: matiko09 ($50 in chips) 
Seat 4: Lita17 ($71.88 in chips) 
Seat 5: KABAL_ua ($50.75 in chips) 
Seat 6: POTAPENKO700 ($50 in chips) 
Seat 7: THREE FlDDY ($50 in chips) 
Seat 8: Dantistcopra ($63.29 in chips) 
Seat 9: ClassicWheel ($63.90 in chips) 
matiko09: posts small blind $0.25
Lita17: posts big blind $0.50
*** HOLE CARDS ***
Dealt to matiko09 [7d 3c]
KABAL_ua: folds 
POTAPENKO700: folds 
THREE FlDDY: folds 
Dantistcopra: raises $1 to $1.50
ClassicWheel: folds 
Dantist1122: folds 
John_les: folds 
matiko09: folds 
Lita17: folds 
Uncalled bet ($1) returned to Dantistcopra
Dantistcopra collected $1.25 from pot
*** SUMMARY ***
Total pot $1.25 | Rake $0 
Seat 1: Dantist1122 folded before Flop (didn't bet)
Seat 2: John_les (button) folded before Flop (didn't bet)
Seat 3: matiko09 (small blind) folded before Flop
Seat 4: Lita17 (big blind) folded before Flop
Seat 5: KABAL_ua folded before Flop (didn't bet)
Seat 6: POTAPENKO700 folded before Flop (didn't bet)
Seat 7: THREE FlDDY folded before Flop (didn't bet)
Seat 8: Dantistcopra collected ($1.25)
Seat 9: ClassicWheel folded before Flop (didn't bet)





PokerStars Hand #155373683258:  Hold'em No Limit ($0.50/$1.00 USD) - 2016/06/30 8:28:47 CET [2016/06/30 2:28:47 ET]
Table 'Gaby' 9-max Seat #8 is the button
Seat 2: ka100pka527 ($42.50 in chips) 
Seat 5: ilaviiitech ($100 in chips) 
Seat 7: stel19 ($42.52 in chips) 
Seat 8: matiko09 ($100 in chips) 
Seat 9: hammerwife ($100 in chips) 
hammerwife: posts small blind $0.50
ka100pka527: posts big blind $1
Dantist1122: sits out 
arctur17: sits out 
RoadtoNepal: sits out 
*** HOLE CARDS ***
Dealt to matiko09 [Qs 5s]
ilaviiitech: raises $2 to $3
stel19: calls $3
matiko09: folds 
hammerwife: folds 
ka100pka527: folds 
*** FLOP *** [8c Ac 8h]
ilaviiitech: bets $4.62
stel19: calls $4.62
*** TURN *** [8c Ac 8h] [Ah]
ilaviiitech: checks 
stel19: checks 
*** RIVER *** [8c Ac 8h Ah] [Th]
ilaviiitech: checks 
stel19: bets $15.90
ilaviiitech: folds 
Uncalled bet ($15.90) returned to stel19
stel19 collected $15.90 from pot
stel19: doesn't show hand 
*** SUMMARY ***
Total pot $16.74 | Rake $0.84 
Board [8c Ac 8h Ah Th]
Seat 2: ka100pka527 (big blind) folded before Flop
Seat 5: ilaviiitech folded on the River
Seat 7: stel19 collected ($15.90)
Seat 8: matiko09 (button) folded before Flop (didn't bet)
Seat 9: hammerwife (small blind) folded before Flop





PokerStars Hand #155373688021:  Hold'em No Limit ($0.25/$0.50 USD) - 2016/06/30 8:29:07 CET [2016/06/30 2:29:07 ET]
Table 'Ducrosa' 9-max Seat #3 is the button
Seat 1: Dantist1122 ($50.57 in chips) 
Seat 2: John_les ($50 in chips) 
Seat 3: matiko09 ($50 in chips) 
Seat 4: Lita17 ($71.38 in chips) 
Seat 5: KABAL_ua ($50.75 in chips) 
Seat 6: POTAPENKO700 ($50 in chips) 
Seat 7: THREE FlDDY ($50 in chips) 
Seat 8: Dantistcopra ($64.04 in chips) 
Seat 9: ClassicWheel ($63.90 in chips) 
Lita17: posts small blind $0.25
KABAL_ua: posts big blind $0.50
*** HOLE CARDS ***
Dealt to matiko09 [Ad 6h]
POTAPENKO700: folds 
THREE FlDDY: folds 
Dantistcopra: folds 
ClassicWheel: raises $1 to $1.50
Dantist1122: folds 
John_les: folds 
matiko09: folds 
Lita17: folds 
KABAL_ua: folds 
Uncalled bet ($1) returned to ClassicWheel
ClassicWheel collected $1.25 from pot
ClassicWheel: doesn't show hand 
*** SUMMARY ***
Total pot $1.25 | Rake $0 
Seat 1: Dantist1122 folded before Flop (didn't bet)
Seat 2: John_les folded before Flop (didn't bet)
Seat 3: matiko09 (button) folded before Flop (didn't bet)
Seat 4: Lita17 (small blind) folded before Flop
Seat 5: KABAL_ua (big blind) folded before Flop
Seat 6: POTAPENKO700 folded before Flop (didn't bet)
Seat 7: THREE FlDDY folded before Flop (didn't bet)
Seat 8: Dantistcopra folded before Flop (didn't bet)
Seat 9: ClassicWheel collected ($1.25)





PokerStars Hand #155373688375:  Hold'em No Limit ($0.25/$0.50 USD) - 2016/06/30 8:29:08 CET [2016/06/30 2:29:08 ET]
Table 'Praxidike' 9-max Seat #6 is the button
Seat 1: Sniper1717 ($50 in chips) 
Seat 3: THREE FlDDY ($50 in chips) 
Seat 5: John_les ($50 in chips) 
Seat 6: Dantistcopra ($55.28 in chips) 
Seat 7: matiko09 ($50.88 in chips) 
Seat 8: Dantist1122 ($56.32 in chips) 
Seat 9: KABAL_ua ($57.17 in chips) 
matiko09: posts small blind $0.25
Dantist1122: posts big blind $0.50
BlackHawk901: sits out 
*** HOLE CARDS ***
Dealt to matiko09 [3s 5c]
KABAL_ua: raises $1 to $1.50
Sniper1717: folds 
THREE FlDDY: folds 
John_les: folds 
Dantistcopra: folds 
matiko09: folds 
Dantist1122: folds 
Uncalled bet ($1) returned to KABAL_ua
KABAL_ua collected $1.25 from pot
KABAL_ua: doesn't show hand 
*** SUMMARY ***
Total pot $1.25 | Rake $0 
Seat 1: Sniper1717 folded before Flop (didn't bet)
Seat 3: THREE FlDDY folded before Flop (didn't bet)
Seat 5: John_les folded before Flop (didn't bet)
Seat 6: Dantistcopra (button) folded before Flop (didn't bet)
Seat 7: matiko09 (small blind) folded before Flop
Seat 8: Dantist1122 (big blind) folded before Flop
Seat 9: KABAL_ua collected ($1.25)





PokerStars Hand #155373694680:  Hold'em No Limit ($0.25/$0.50 USD) - 2016/06/30 8:29:35 CET [2016/06/30 2:29:35 ET]
Table 'Praxidike' 9-max Seat #7 is the button
Seat 1: Sniper1717 ($50 in chips) 
Seat 3: THREE FlDDY ($50 in chips) 
Seat 5: John_les ($50 in chips) 
Seat 7: matiko09 ($50.63 in chips) 
Seat 8: Dantist1122 ($55.82 in chips) 
Seat 9: KABAL_ua ($57.92 in chips) 
Dantist1122: posts small blind $0.25
KABAL_ua: posts big blind $0.50
BlackHawk901: sits out 
*** HOLE CARDS ***
Dealt to matiko09 [6h 4h]
Sniper1717: folds 
THREE FlDDY: folds 
John_les: folds 
matiko09: folds 
Dantist1122: calls $0.25
KABAL_ua: checks 
*** FLOP *** [8c 7s Ks]
Dantist1122: bets $0.73
KABAL_ua: calls $0.73
*** TURN *** [8c 7s Ks] [3s]
Dantist1122: checks 
KABAL_ua: bets $1.56
Dantist1122: folds 
Uncalled bet ($1.56) returned to KABAL_ua
KABAL_ua collected $2.34 from pot
KABAL_ua: doesn't show hand 
*** SUMMARY ***
Total pot $2.46 | Rake $0.12 
Board [8c 7s Ks 3s]
Seat 1: Sniper1717 folded before Flop (didn't bet)
Seat 3: THREE FlDDY folded before Flop (didn't bet)
Seat 5: John_les folded before Flop (didn't bet)
Seat 7: matiko09 (button) folded before Flop (didn't bet)
Seat 8: Dantist1122 (small blind) folded on the Turn
Seat 9: KABAL_ua (big blind) collected ($2.34)





PokerStars Hand #155373695718:  Hold'em No Limit ($0.50/$1.00 USD) - 2016/06/30 8:29:39 CET [2016/06/30 2:29:39 ET]
Table 'Lucretia II' 9-max Seat #9 is the button
Seat 1: matiko09 ($209.79 in chips) 
Seat 2: picka4u ($40 in chips) 
Seat 3: Alex Frider ($189.18 in chips) 
Seat 4: John_les ($100 in chips) 
Seat 5: butcheN18 ($100 in chips) 
Seat 6: flk.Dasas ($100 in chips) 
Seat 7: Dantist1122 ($101.50 in chips) 
Seat 8: snow937022 ($100 in chips) 
Seat 9: misko123 ($32.89 in chips) 
matiko09: posts small blind $0.50
picka4u: posts big blind $1
*** HOLE CARDS ***
Dealt to matiko09 [Th 5d]
Alex Frider: folds 
John_les: folds 
butcheN18: folds 
flk.Dasas: folds 
Dantist1122: folds 
snow937022: folds 
misko123: folds 
matiko09: folds 
Uncalled bet ($0.50) returned to picka4u
picka4u collected $1 from pot
picka4u: doesn't show hand 
*** SUMMARY ***
Total pot $1 | Rake $0 
Seat 1: matiko09 (small blind) folded before Flop
Seat 2: picka4u (big blind) collected ($1)
Seat 3: Alex Frider folded before Flop (didn't bet)
Seat 4: John_les folded before Flop (didn't bet)
Seat 5: butcheN18 folded before Flop (didn't bet)
Seat 6: flk.Dasas folded before Flop (didn't bet)
Seat 7: Dantist1122 folded before Flop (didn't bet)
Seat 8: snow937022 folded before Flop (didn't bet)
Seat 9: misko123 (button) folded before Flop (didn't bet)





PokerStars Hand #155373697104:  Hold'em No Limit ($0.50/$1.00 USD) - 2016/06/30 8:29:45 CET [2016/06/30 2:29:45 ET]
Table 'Asmodeus' 9-max Seat #8 is the button
Seat 1: Imbear8 ($86.99 in chips) 
Seat 3: L4zy_FiSh ($121.30 in chips) 
Seat 4: matiko09 ($100 in chips) 
Seat 5: butcheN18 ($119.22 in chips) 
Seat 6: snow937022 ($132.19 in chips) 
Seat 7: picka4u ($43.40 in chips) 
Seat 8: RoadtoNepal ($100 in chips) 
Seat 9: flk.Dasas ($258.17 in chips) 
flk.Dasas: posts small blind $0.50
Imbear8: posts big blind $1
John_les: sits out 
*** HOLE CARDS ***
Dealt to matiko09 [Js As]
L4zy_FiSh: folds 
matiko09: raises $2 to $3
butcheN18: folds 
snow937022: calls $3
picka4u: folds 
RoadtoNepal: folds 
flk.Dasas: folds 
Imbear8: calls $2
*** FLOP *** [8c 5s 6h]
Imbear8: checks 
matiko09: checks 
snow937022: checks 
*** TURN *** [8c 5s 6h] [Th]
Imbear8: checks 
matiko09: checks 
snow937022: bets $8.11
Imbear8: folds 
matiko09: folds 
Uncalled bet ($8.11) returned to snow937022
snow937022 collected $9.02 from pot
snow937022: doesn't show hand 
*** SUMMARY ***
Total pot $9.50 | Rake $0.48 
Board [8c 5s 6h Th]
Seat 1: Imbear8 (big blind) folded on the Turn
Seat 3: L4zy_FiSh folded before Flop (didn't bet)
Seat 4: matiko09 folded on the Turn
Seat 5: butcheN18 folded before Flop (didn't bet)
Seat 6: snow937022 collected ($9.02)
Seat 7: picka4u folded before Flop (didn't bet)
Seat 8: RoadtoNepal (button) folded before Flop (didn't bet)
Seat 9: flk.Dasas (small blind) folded before Flop





PokerStars Hand #155373699377:  Hold'em No Limit ($0.50/$1.00 USD) - 2016/06/30 8:29:55 CET [2016/06/30 2:29:55 ET]
Table 'Gaby' 9-max Seat #9 is the button
Seat 2: ka100pka527 ($41.50 in chips) 
Seat 3: Dantist1122 ($100 in chips) 
Seat 5: ilaviiitech ($100 in chips) 
Seat 7: stel19 ($50.80 in chips) 
Seat 8: matiko09 ($100 in chips) 
Seat 9: hammerwife ($100 in chips) 
ka100pka527: posts small blind $0.50
Dantist1122: posts big blind $1
arctur17: sits out 
RoadtoNepal: sits out 
*** HOLE CARDS ***
Dealt to matiko09 [4h 2d]
ilaviiitech: folds 
stel19: calls $1
matiko09: folds 
hammerwife: folds 
ka100pka527: folds 
Dantist1122: checks 
*** FLOP *** [5c 6d 8c]
Dantist1122: bets $1.83
stel19: calls $1.83
*** TURN *** [5c 6d 8c] [Kh]
Dantist1122: checks 
stel19: bets $5.85
Dantist1122: folds 
Uncalled bet ($5.85) returned to stel19
stel19 collected $5.85 from pot
stel19: doesn't show hand 
*** SUMMARY ***
Total pot $6.16 | Rake $0.31 
Board [5c 6d 8c Kh]
Seat 2: ka100pka527 (small blind) folded before Flop
Seat 3: Dantist1122 (big blind) folded on the Turn
Seat 5: ilaviiitech folded before Flop (didn't bet)
Seat 7: stel19 collected ($5.85)
Seat 8: matiko09 folded before Flop (didn't bet)
Seat 9: hammerwife (button) folded before Flop (didn't bet)





PokerStars Hand #155373700090:  Hold'em No Limit ($0.50/$1.00 USD) - 2016/06/30 8:29:58 CET [2016/06/30 2:29:58 ET]
Table 'Lucretia II' 9-max Seat #1 is the button
Seat 1: matiko09 ($209.29 in chips) 
Seat 2: picka4u ($40.50 in chips) 
Seat 3: Alex Frider ($189.18 in chips) 
Seat 4: John_les ($100 in chips) 
Seat 5: butcheN18 ($100 in chips) 
Seat 6: flk.Dasas ($100 in chips) 
Seat 7: Dantist1122 ($101.50 in chips) 
Seat 8: snow937022 ($100 in chips) 
Seat 9: misko123 ($32.89 in chips) 
picka4u: posts small blind $0.50
Alex Frider: posts big blind $1
*** HOLE CARDS ***
Dealt to matiko09 [9d 3d]
John_les: folds 
butcheN18: folds 
flk.Dasas: raises $2 to $3
Dantist1122: calls $3
snow937022: folds 
misko123: folds 
matiko09: folds 
picka4u: folds 
Alex Frider: folds 
*** FLOP *** [2d 7s 5c]
flk.Dasas: bets $4.84
Dantist1122: calls $4.84
*** TURN *** [2d 7s 5c] [5s]
flk.Dasas: checks 
Dantist1122: checks 
*** RIVER *** [2d 7s 5c 5s] [2h]
flk.Dasas: bets $11.10
Dantist1122: calls $11.10
*** SHOW DOWN ***
flk.Dasas: shows [Ad Kc] (two pair, Fives and Deuces)
Dantist1122: shows [Jd Js] (two pair, Jacks and Fives)
Dantist1122 collected $37.41 from pot
*** SUMMARY ***
Total pot $39.38 | Rake $1.97 
Board [2d 7s 5c 5s 2h]
Seat 1: matiko09 (button) folded before Flop (didn't bet)
Seat 2: picka4u (small blind) folded before Flop
Seat 3: Alex Frider (big blind) folded before Flop
Seat 4: John_les folded before Flop (didn't bet)
Seat 5: butcheN18 folded before Flop (didn't bet)
Seat 6: flk.Dasas showed [Ad Kc] and lost with two pair, Fives and Deuces
Seat 7: Dantist1122 showed [Jd Js] and won ($37.41) with two pair, Jacks and Fives
Seat 8: snow937022 folded before Flop (didn't bet)
Seat 9: misko123 folded before Flop (didn't bet)





PokerStars Hand #155373702464:  Hold'em No Limit ($0.25/$0.50 USD) - 2016/06/30 8:30:08 CET [2016/06/30 2:30:08 ET]
Table 'Ducrosa' 9-max Seat #4 is the button
Seat 1: Dantist1122 ($50.57 in chips) 
Seat 2: John_les ($50 in chips) 
Seat 3: matiko09 ($50 in chips) 
Seat 4: Lita17 ($71.13 in chips) 
Seat 5: KABAL_ua ($50.25 in chips) 
Seat 6: POTAPENKO700 ($50 in chips) 
Seat 7: THREE FlDDY ($50 in chips) 
Seat 9: ClassicWheel ($64.65 in chips) 
KABAL_ua: posts small blind $0.25
POTAPENKO700: posts big blind $0.50
*** HOLE CARDS ***
Dealt to matiko09 [8c Kh]
THREE FlDDY: folds 
ClassicWheel: raises $0.50 to $1
Dantist1122: folds 
John_les: folds 
matiko09: folds 
Lita17: folds 
KABAL_ua: folds 
POTAPENKO700: calls $0.50
*** FLOP *** [8h 7s 9d]
POTAPENKO700: checks 
ClassicWheel: checks 
*** TURN *** [8h 7s 9d] [Td]
POTAPENKO700: checks 
ClassicWheel: bets $1
POTAPENKO700: raises $4.14 to $5.14
ClassicWheel: calls $4.14
*** RIVER *** [8h 7s 9d Td] [5c]
POTAPENKO700: bets $7.93
ClassicWheel: calls $7.93
*** SHOW DOWN ***
POTAPENKO700: shows [Jc Kc] (a straight, Seven to Jack)
ClassicWheel: mucks hand 
POTAPENKO700 collected $26.97 from pot
*** SUMMARY ***
Total pot $28.39 | Rake $1.42 
Board [8h 7s 9d Td 5c]
Seat 1: Dantist1122 folded before Flop (didn't bet)
Seat 2: John_les folded before Flop (didn't bet)
Seat 3: matiko09 folded before Flop (didn't bet)
Seat 4: Lita17 (button) folded before Flop (didn't bet)
Seat 5: KABAL_ua (small blind) folded before Flop
Seat 6: POTAPENKO700 (big blind) showed [Jc Kc] and won ($26.97) with a straight, Seven to Jack
Seat 7: THREE FlDDY folded before Flop (didn't bet)
Seat 9: ClassicWheel mucked [Qh Th]





PokerStars Hand #155373706128:  Hold'em No Limit ($0.50/$1.00 USD) - 2016/06/30 8:30:24 CET [2016/06/30 2:30:24 ET]
Table 'Aunus' 9-max Seat #6 is the button
Seat 1: dboy604 ($122.86 in chips) 
Seat 2: HasBigBiceps ($100.35 in chips) 
Seat 3: matiko09 ($113.28 in chips) 
Seat 4: ilaviiitech ($100 in chips) 
Seat 5: hammerwife ($111.80 in chips) 
Seat 6: RoadtoNepal ($100 in chips) 
Seat 7: ka100pka527 ($40 in chips) 
Seat 8: Dantist1122 ($101.50 in chips) 
Seat 9: flk.Dasas ($100 in chips) 
ka100pka527: posts small blind $0.50
Dantist1122: posts big blind $1
*** HOLE CARDS ***
Dealt to matiko09 [9c Jh]
flk.Dasas: raises $2 to $3
dboy604: folds 
HasBigBiceps: folds 
matiko09: folds 
ilaviiitech: folds 
hammerwife: folds 
RoadtoNepal: folds 
ka100pka527: folds 
Dantist1122: folds 
Uncalled bet ($2) returned to flk.Dasas
flk.Dasas collected $2.50 from pot
flk.Dasas: doesn't show hand 
*** SUMMARY ***
Total pot $2.50 | Rake $0 
Seat 1: dboy604 folded before Flop (didn't bet)
Seat 2: HasBigBiceps folded before Flop (didn't bet)
Seat 3: matiko09 folded before Flop (didn't bet)
Seat 4: ilaviiitech folded before Flop (didn't bet)
Seat 5: hammerwife folded before Flop (didn't bet)
Seat 6: RoadtoNepal (button) folded before Flop (didn't bet)
Seat 7: ka100pka527 (small blind) folded before Flop
Seat 8: Dantist1122 (big blind) folded before Flop
Seat 9: flk.Dasas collected ($2.50)





PokerStars Hand #155373707868:  Hold'em No Limit ($0.50/$1.00 USD) - 2016/06/30 8:30:31 CET [2016/06/30 2:30:31 ET]
Table 'Asmodeus' 9-max Seat #9 is the button
Seat 1: Imbear8 ($83.99 in chips) 
Seat 2: John_les ($146.38 in chips) 
Seat 3: L4zy_FiSh ($121.30 in chips) 
Seat 4: matiko09 ($100 in chips) 
Seat 5: butcheN18 ($119.22 in chips) 
Seat 6: snow937022 ($138.21 in chips) 
Seat 7: picka4u ($43.40 in chips) 
Seat 8: RoadtoNepal ($100 in chips) 
Seat 9: flk.Dasas ($257.67 in chips) 
Imbear8: posts small blind $0.50
John_les: posts big blind $1
*** HOLE CARDS ***
Dealt to matiko09 [5s 2s]
L4zy_FiSh: folds 
matiko09: folds 
butcheN18: folds 
snow937022: folds 
picka4u: folds 
RoadtoNepal: folds 
flk.Dasas: raises $1.50 to $2.50
Imbear8: calls $2
John_les: folds 
*** FLOP *** [Ac 6d 9s]
Imbear8: bets $2.85
flk.Dasas: folds 
Uncalled bet ($2.85) returned to Imbear8
Imbear8 collected $5.70 from pot
Imbear8: doesn't show hand 
*** SUMMARY ***
Total pot $6 | Rake $0.30 
Board [Ac 6d 9s]
Seat 1: Imbear8 (small blind) collected ($5.70)
Seat 2: John_les (big blind) folded before Flop
Seat 3: L4zy_FiSh folded before Flop (didn't bet)
Seat 4: matiko09 folded before Flop (didn't bet)
Seat 5: butcheN18 folded before Flop (didn't bet)
Seat 6: snow937022 folded before Flop (didn't bet)
Seat 7: picka4u folded before Flop (didn't bet)
Seat 8: RoadtoNepal folded before Flop (didn't bet)
Seat 9: flk.Dasas (button) folded on the Flop





PokerStars Hand #155373711102:  Hold'em No Limit ($0.50/$1.00 USD) - 2016/06/30 8:30:45 CET [2016/06/30 2:30:45 ET]
Table 'Barto' 9-max Seat #5 is the button
Seat 5: Mervovabanda ($100 in chips) 
Seat 6: HasBigBiceps ($100 in chips) 
Seat 7: ilaviiitech ($100 in chips) 
Seat 8: matiko09 ($100 in chips) 
HasBigBiceps: posts small blind $0.50
ilaviiitech: posts big blind $1
*** HOLE CARDS ***
Dealt to matiko09 [Ts 5c]
matiko09: folds 
Mervovabanda: raises $2 to $3
HasBigBiceps: raises $6 to $9
ilaviiitech: folds 
greg dean joins the table at seat #9 
Mervovabanda: calls $6
*** FLOP *** [3d 7d 3c]
HasBigBiceps: bets $16.06
Mervovabanda: folds 
Uncalled bet ($16.06) returned to HasBigBiceps
HasBigBiceps collected $18.05 from pot
HasBigBiceps: doesn't show hand 
*** SUMMARY ***
Total pot $19 | Rake $0.95 
Board [3d 7d 3c]
Seat 5: Mervovabanda (button) folded on the Flop
Seat 6: HasBigBiceps (small blind) collected ($18.05)
Seat 7: ilaviiitech (big blind) folded before Flop
Seat 8: matiko09 folded before Flop (didn't bet)





PokerStars Hand #155373713030:  Hold'em No Limit ($0.50/$1.00 USD) - 2016/06/30 8:30:53 CET [2016/06/30 2:30:53 ET]
Table 'Aunus' 9-max Seat #7 is the button
Seat 1: dboy604 ($122.86 in chips) 
Seat 2: HasBigBiceps ($100.35 in chips) 
Seat 3: matiko09 ($113.28 in chips) 
Seat 4: ilaviiitech ($100 in chips) 
Seat 5: hammerwife ($111.80 in chips) 
Seat 6: RoadtoNepal ($100 in chips) 
Seat 7: ka100pka527 ($39.50 in chips) 
Seat 8: Dantist1122 ($100.50 in chips) 
Seat 9: flk.Dasas ($101.50 in chips) 
Dantist1122: posts small blind $0.50
flk.Dasas: posts big blind $1
*** HOLE CARDS ***
Dealt to matiko09 [7s 4c]
dboy604: calls $1
HasBigBiceps: folds 
matiko09: folds 
ilaviiitech: folds 
hammerwife: raises $4 to $5
RoadtoNepal: folds 
ka100pka527: folds 
Dantist1122: folds 
flk.Dasas: folds 
dboy604: folds 
Uncalled bet ($4) returned to hammerwife
hammerwife collected $3.50 from pot
hammerwife: doesn't show hand 
*** SUMMARY ***
Total pot $3.50 | Rake $0 
Seat 1: dboy604 folded before Flop
Seat 2: HasBigBiceps folded before Flop (didn't bet)
Seat 3: matiko09 folded before Flop (didn't bet)
Seat 4: ilaviiitech folded before Flop (didn't bet)
Seat 5: hammerwife collected ($3.50)
Seat 6: RoadtoNepal folded before Flop (didn't bet)
Seat 7: ka100pka527 (button) folded before Flop (didn't bet)
Seat 8: Dantist1122 (small blind) folded before Flop
Seat 9: flk.Dasas (big blind) folded before Flop





PokerStars Hand #155373714955:  Hold'em No Limit ($0.25/$0.50 USD) - 2016/06/30 8:31:02 CET [2016/06/30 2:31:02 ET]
Table 'Praxidike' 9-max Seat #8 is the button
Seat 1: Sniper1717 ($50 in chips) 
Seat 3: THREE FlDDY ($50 in chips) 
Seat 5: John_les ($50 in chips) 
Seat 7: matiko09 ($50.63 in chips) 
Seat 8: Dantist1122 ($54.59 in chips) 
Seat 9: KABAL_ua ($59.03 in chips) 
KABAL_ua: posts small blind $0.25
Sniper1717: posts big blind $0.50
BlackHawk901: sits out 
*** HOLE CARDS ***
Dealt to matiko09 [7s 2d]
THREE FlDDY: folds 
John_les: folds 
matiko09: folds 
Dantist1122: folds 
KABAL_ua: raises $0.70 to $1.20
Sniper1717: folds 
Uncalled bet ($0.70) returned to KABAL_ua
KABAL_ua collected $1 from pot
KABAL_ua: doesn't show hand 
*** SUMMARY ***
Total pot $1 | Rake $0 
Seat 1: Sniper1717 (big blind) folded before Flop
Seat 3: THREE FlDDY folded before Flop (didn't bet)
Seat 5: John_les folded before Flop (didn't bet)
Seat 7: matiko09 folded before Flop (didn't bet)
Seat 8: Dantist1122 (button) folded before Flop (didn't bet)
Seat 9: KABAL_ua (small blind) collected ($1)





PokerStars Hand #155373715466:  Hold'em No Limit ($0.50/$1.00 USD) - 2016/06/30 8:31:04 CET [2016/06/30 2:31:04 ET]
Table 'Gaby' 9-max Seat #2 is the button
Seat 2: ka100pka527 ($41 in chips) 
Seat 3: Dantist1122 ($100 in chips) 
Seat 4: arctur17 ($77.63 in chips) 
Seat 5: ilaviiitech ($100 in chips) 
Seat 7: stel19 ($53.82 in chips) 
Seat 8: matiko09 ($100 in chips) 
Seat 9: hammerwife ($100 in chips) 
Dantist1122: posts small blind $0.50
arctur17: posts big blind $1
RoadtoNepal: sits out 
*** HOLE CARDS ***
Dealt to matiko09 [Js 8d]
ilaviiitech: folds 
stel19: folds 
ilaviiitech leaves the table
matiko09: folds 
hammerwife: raises $1.50 to $2.50
ka100pka527: folds 
Dantist1122: folds 
arctur17: folds 
Uncalled bet ($1.50) returned to hammerwife
hammerwife collected $2.50 from pot
hammerwife: doesn't show hand 
*** SUMMARY ***
Total pot $2.50 | Rake $0 
Seat 2: ka100pka527 (button) folded before Flop (didn't bet)
Seat 3: Dantist1122 (small blind) folded before Flop
Seat 4: arctur17 (big blind) folded before Flop
Seat 5: ilaviiitech folded before Flop (didn't bet)
Seat 7: stel19 folded before Flop (didn't bet)
Seat 8: matiko09 folded before Flop (didn't bet)
Seat 9: hammerwife collected ($2.50)





PokerStars Hand #155373716617:  Hold'em No Limit ($0.25/$0.50 USD) - 2016/06/30 8:31:09 CET [2016/06/30 2:31:09 ET]
Table 'Ducrosa' 9-max Seat #5 is the button
Seat 1: Dantist1122 ($50.57 in chips) 
Seat 2: John_les ($50 in chips) 
Seat 3: matiko09 ($50 in chips) 
Seat 4: Lita17 ($71.13 in chips) 
Seat 5: KABAL_ua ($50 in chips) 
Seat 6: POTAPENKO700 ($62.90 in chips) 
Seat 9: ClassicWheel ($50.58 in chips) 
POTAPENKO700: posts small blind $0.25
THREE FlDDY: is sitting out 
ClassicWheel: posts big blind $0.50
*** HOLE CARDS ***
Dealt to matiko09 [Qs Ad]
Dantist1122: folds 
John_les: folds 
matiko09: raises $1 to $1.50
Lita17: folds 
KABAL_ua: folds 
POTAPENKO700: folds 
ClassicWheel: folds 
Uncalled bet ($1) returned to matiko09
ClassicWheel leaves the table
matiko09 collected $1.25 from pot
matiko09: doesn't show hand 
*** SUMMARY ***
Total pot $1.25 | Rake $0 
Seat 1: Dantist1122 folded before Flop (didn't bet)
Seat 2: John_les folded before Flop (didn't bet)
Seat 3: matiko09 collected ($1.25)
Seat 4: Lita17 folded before Flop (didn't bet)
Seat 5: KABAL_ua (button) folded before Flop (didn't bet)
Seat 6: POTAPENKO700 (small blind) folded before Flop
Seat 9: ClassicWheel (big blind) folded before Flop





PokerStars Hand #155373716565:  Hold'em No Limit ($0.50/$1.00 USD) - 2016/06/30 8:31:09 CET [2016/06/30 2:31:09 ET]
Table 'Barto' 9-max Seat #6 is the button
Seat 5: Mervovabanda ($91 in chips) 
Seat 6: HasBigBiceps ($109.05 in chips) 
Seat 7: ilaviiitech ($100 in chips) 
Seat 8: matiko09 ($100 in chips) 
Seat 9: greg dean ($63.12 in chips) 
ilaviiitech: posts small blind $0.50
matiko09: posts big blind $1
greg dean: posts big blind $1
*** HOLE CARDS ***
Dealt to matiko09 [7s Kc]
greg dean: checks 
Mervovabanda: calls $1
HasBigBiceps: folds 
hammerwife joins the table at seat #1 
Yaaaazz joins the table at seat #2 
ilaviiitech: raises $5 to $6
John_les joins the table at seat #3 
ricksdogs77 joins the table at seat #4 
matiko09: folds 
greg dean: calls $5
Mervovabanda: folds 
*** FLOP *** [6c Ah 2s]
ilaviiitech: bets $7
greg dean: folds 
Uncalled bet ($7) returned to ilaviiitech
ilaviiitech collected $13.30 from pot
ilaviiitech: doesn't show hand 
*** SUMMARY ***
Total pot $14 | Rake $0.70 
Board [6c Ah 2s]
Seat 5: Mervovabanda folded before Flop
Seat 6: HasBigBiceps (button) folded before Flop (didn't bet)
Seat 7: ilaviiitech (small blind) collected ($13.30)
Seat 8: matiko09 (big blind) folded before Flop
Seat 9: greg dean folded on the Flop





PokerStars Hand #155373721162:  Hold'em No Limit ($0.50/$1.00 USD) - 2016/06/30 8:31:28 CET [2016/06/30 2:31:28 ET]
Table 'Gaby' 9-max Seat #3 is the button
Seat 2: ka100pka527 ($41 in chips) 
Seat 3: Dantist1122 ($100 in chips) 
Seat 4: arctur17 ($76.63 in chips) 
Seat 6: RoadtoNepal ($100 in chips) 
Seat 7: stel19 ($53.82 in chips) 
Seat 8: matiko09 ($100 in chips) 
Seat 9: hammerwife ($101.50 in chips) 
arctur17: posts small blind $0.50
RoadtoNepal: posts big blind $1
*** HOLE CARDS ***
Dealt to matiko09 [6c 8s]
stel19: calls $1
matiko09: folds 
hammerwife: folds 
ka100pka527: folds 
Dantist1122: folds 
arctur17: folds 
RoadtoNepal: checks 
*** FLOP *** [Td 7c Ks]
RoadtoNepal: checks 
stel19: checks 
*** TURN *** [Td 7c Ks] [Ac]
RoadtoNepal: bets $1.78
stel19: calls $1.78
*** RIVER *** [Td 7c Ks Ac] [Th]
RoadtoNepal: bets $3.80
stel19: folds 
Uncalled bet ($3.80) returned to RoadtoNepal
RoadtoNepal collected $5.76 from pot
*** SUMMARY ***
Total pot $6.06 | Rake $0.30 
Board [Td 7c Ks Ac Th]
Seat 2: ka100pka527 folded before Flop (didn't bet)
Seat 3: Dantist1122 (button) folded before Flop (didn't bet)
Seat 4: arctur17 (small blind) folded before Flop
Seat 6: RoadtoNepal (big blind) collected ($5.76)
Seat 7: stel19 folded on the River
Seat 8: matiko09 folded before Flop (didn't bet)
Seat 9: hammerwife folded before Flop (didn't bet)





PokerStars Hand #155373721518:  Hold'em No Limit ($0.25/$0.50 USD) - 2016/06/30 8:31:30 CET [2016/06/30 2:31:30 ET]
Table 'Praxidike' 9-max Seat #9 is the button
Seat 1: Sniper1717 ($50 in chips) 
Seat 2: BlackHawk901 ($50 in chips) 
Seat 3: THREE FlDDY ($50 in chips) 
Seat 5: John_les ($50 in chips) 
Seat 7: matiko09 ($50.63 in chips) 
Seat 8: Dantist1122 ($54.59 in chips) 
Seat 9: KABAL_ua ($59.53 in chips) 
Sniper1717: posts small blind $0.25
BlackHawk901: posts big blind $0.50
*** HOLE CARDS ***
Dealt to matiko09 [Jh 7s]
THREE FlDDY: folds 
John_les: folds 
matiko09: folds 
Dantist1122: raises $0.85 to $1.35
KABAL_ua: folds 
Sniper1717: calls $1.10
BlackHawk901: folds 
*** FLOP *** [Td 5h Tc]
Sniper1717: checks 
Dantist1122: bets $1.67
Sniper1717: calls $1.67
*** TURN *** [Td 5h Tc] [6c]
Sniper1717: checks 
Dantist1122: checks 
*** RIVER *** [Td 5h Tc 6c] [8d]
Sniper1717: bets $4.50
Dantist1122: folds 
Uncalled bet ($4.50) returned to Sniper1717
Sniper1717 collected $6.21 from pot
*** SUMMARY ***
Total pot $6.54 | Rake $0.33 
Board [Td 5h Tc 6c 8d]
Seat 1: Sniper1717 (small blind) collected ($6.21)
Seat 2: BlackHawk901 (big blind) folded before Flop
Seat 3: THREE FlDDY folded before Flop (didn't bet)
Seat 5: John_les folded before Flop (didn't bet)
Seat 7: matiko09 folded before Flop (didn't bet)
Seat 8: Dantist1122 folded on the River
Seat 9: KABAL_ua (button) folded before Flop (didn't bet)





PokerStars Hand #155373722397:  Hold'em No Limit ($0.50/$1.00 USD) - 2016/06/30 8:31:34 CET [2016/06/30 2:31:34 ET]
Table 'Asmodeus' 9-max Seat #1 is the button
Seat 1: Imbear8 ($87.19 in chips) 
Seat 2: John_les ($145.38 in chips) 
Seat 3: L4zy_FiSh ($121.30 in chips) 
Seat 4: matiko09 ($100 in chips) 
Seat 5: butcheN18 ($119.22 in chips) 
Seat 6: snow937022 ($138.21 in chips) 
Seat 7: picka4u ($43.40 in chips) 
Seat 8: RoadtoNepal ($100 in chips) 
Seat 9: flk.Dasas ($255.17 in chips) 
John_les: posts small blind $0.50
L4zy_FiSh: posts big blind $1
*** HOLE CARDS ***
Dealt to matiko09 [4s 8d]
matiko09: folds 
butcheN18: folds 
snow937022: folds 
picka4u: folds 
RoadtoNepal: folds 
flk.Dasas: raises $1.50 to $2.50
Imbear8: folds 
John_les: folds 
L4zy_FiSh: calls $1.50
*** FLOP *** [Tc Jh 3c]
L4zy_FiSh: checks 
flk.Dasas: bets $4.02
L4zy_FiSh: calls $4.02
*** TURN *** [Tc Jh 3c] [Ks]
L4zy_FiSh: checks 
flk.Dasas: checks 
*** RIVER *** [Tc Jh 3c Ks] [2d]
L4zy_FiSh: bets $10
flk.Dasas: folds 
Uncalled bet ($10) returned to L4zy_FiSh
L4zy_FiSh collected $12.86 from pot
*** SUMMARY ***
Total pot $13.54 | Rake $0.68 
Board [Tc Jh 3c Ks 2d]
Seat 1: Imbear8 (button) folded before Flop (didn't bet)
Seat 2: John_les (small blind) folded before Flop
Seat 3: L4zy_FiSh (big blind) collected ($12.86)
Seat 4: matiko09 folded before Flop (didn't bet)
Seat 5: butcheN18 folded before Flop (didn't bet)
Seat 6: snow937022 folded before Flop (didn't bet)
Seat 7: picka4u folded before Flop (didn't bet)
Seat 8: RoadtoNepal folded before Flop (didn't bet)
Seat 9: flk.Dasas folded on the River





PokerStars Hand #155373722916:  Hold'em No Limit ($0.50/$1.00 USD) - 2016/06/30 8:31:36 CET [2016/06/30 2:31:36 ET]
Table 'Aunus' 9-max Seat #8 is the button
Seat 1: dboy604 ($121.86 in chips) 
Seat 2: HasBigBiceps ($100.35 in chips) 
Seat 3: matiko09 ($113.28 in chips) 
Seat 4: ilaviiitech ($100 in chips) 
Seat 5: hammerwife ($114.30 in chips) 
Seat 6: RoadtoNepal ($100 in chips) 
Seat 7: ka100pka527 ($39.50 in chips) 
Seat 8: Dantist1122 ($100 in chips) 
Seat 9: flk.Dasas ($100.50 in chips) 
flk.Dasas: posts small blind $0.50
dboy604: posts big blind $1
*** HOLE CARDS ***
Dealt to matiko09 [Jh 7h]
HasBigBiceps: folds 
matiko09: folds 
ilaviiitech: folds 
hammerwife: folds 
RoadtoNepal: folds 
ka100pka527: raises $1 to $2
Dantist1122: folds 
flk.Dasas: folds 
dboy604: calls $1
*** FLOP *** [Js 6h 9d]
dboy604: checks 
ka100pka527: bets $2.44
dboy604: calls $2.44
*** TURN *** [Js 6h 9d] [Ks]
dboy604: bets $8
ka100pka527: calls $8
*** RIVER *** [Js 6h 9d Ks] [Jc]
dboy604: checks 
ka100pka527: bets $8.05
dboy604: calls $8.05
*** SHOW DOWN ***
ka100pka527: shows [Ts 7s] (a pair of Jacks)
dboy604: shows [9h Kd] (two pair, Kings and Jacks)
dboy604 collected $39.41 from pot
*** SUMMARY ***
Total pot $41.48 | Rake $2.07 
Board [Js 6h 9d Ks Jc]
Seat 1: dboy604 (big blind) showed [9h Kd] and won ($39.41) with two pair, Kings and Jacks
Seat 2: HasBigBiceps folded before Flop (didn't bet)
Seat 3: matiko09 folded before Flop (didn't bet)
Seat 4: ilaviiitech folded before Flop (didn't bet)
Seat 5: hammerwife folded before Flop (didn't bet)
Seat 6: RoadtoNepal folded before Flop (didn't bet)
Seat 7: ka100pka527 showed [Ts 7s] and lost with a pair of Jacks
Seat 8: Dantist1122 (button) folded before Flop (didn't bet)
Seat 9: flk.Dasas (small blind) folded before Flop





PokerStars Hand #155373724385:  Hold'em No Limit ($0.50/$1.00 USD) - 2016/06/30 8:31:42 CET [2016/06/30 2:31:42 ET]
Table 'Lucretia II' 9-max Seat #2 is the button
Seat 1: matiko09 ($209.29 in chips) 
Seat 2: picka4u ($40 in chips) 
Seat 3: Alex Frider ($188.18 in chips) 
Seat 4: John_les ($100 in chips) 
Seat 5: butcheN18 ($100 in chips) 
Seat 6: flk.Dasas ($100 in chips) 
Seat 7: Dantist1122 ($119.97 in chips) 
Seat 8: snow937022 ($100 in chips) 
Seat 9: misko123 ($32.89 in chips) 
Alex Frider: posts small blind $0.50
John_les: posts big blind $1
*** HOLE CARDS ***
Dealt to matiko09 [3d 6c]
butcheN18: folds 
flk.Dasas: folds 
Dantist1122: folds 
snow937022 has timed out while being disconnected
snow937022: folds 
misko123: folds 
matiko09: folds 
picka4u: folds 
Alex Frider: raises $1.15 to $2.15
John_les: calls $1.15
*** FLOP *** [2d 9s Jc]
Alex Frider: checks 
John_les: bets $2.73
Alex Frider: calls $2.73
*** TURN *** [2d 9s Jc] [4d]
Alex Frider: checks 
John_les: checks 
*** RIVER *** [2d 9s Jc 4d] [7s]
Alex Frider: checks 
John_les: checks 
*** SHOW DOWN ***
Alex Frider: shows [Ad 9c] (a pair of Nines)
John_les: mucks hand 
Alex Frider collected $9.27 from pot
*** SUMMARY ***
Total pot $9.76 | Rake $0.49 
Board [2d 9s Jc 4d 7s]
Seat 1: matiko09 folded before Flop (didn't bet)
Seat 2: picka4u (button) folded before Flop (didn't bet)
Seat 3: Alex Frider (small blind) showed [Ad 9c] and won ($9.27) with a pair of Nines
Seat 4: John_les (big blind) mucked [6s Ks]
Seat 5: butcheN18 folded before Flop (didn't bet)
Seat 6: flk.Dasas folded before Flop (didn't bet)
Seat 7: Dantist1122 folded before Flop (didn't bet)
Seat 8: snow937022 folded before Flop (didn't bet)
Seat 9: misko123 folded before Flop (didn't bet)





PokerStars Hand #155373725084:  Hold'em No Limit ($0.50/$1.00 USD) - 2016/06/30 8:31:45 CET [2016/06/30 2:31:45 ET]
Table 'Barto' 9-max Seat #7 is the button
Seat 4: ricksdogs77 ($77.63 in chips) 
Seat 5: Mervovabanda ($93.90 in chips) 
Seat 6: HasBigBiceps ($109.05 in chips) 
Seat 7: ilaviiitech ($107.30 in chips) 
Seat 8: matiko09 ($100 in chips) 
Seat 9: greg dean ($57.12 in chips) 
matiko09: posts small blind $0.50
greg dean: posts big blind $1
hammerwife: sits out 
Yaaaazz: sits out 
John_les: sits out 
ricksdogs77: posts big blind $1
*** HOLE CARDS ***
Dealt to matiko09 [Qh 2s]
ricksdogs77: checks 
Mervovabanda: folds 
HasBigBiceps: folds 
ilaviiitech: folds 
matiko09: folds 
greg dean: checks 
*** FLOP *** [7c Qc Kd]
greg dean: checks 
ricksdogs77: bets $2
greg dean: folds 
Uncalled bet ($2) returned to ricksdogs77
ricksdogs77 collected $2.38 from pot
ricksdogs77: doesn't show hand 
*** SUMMARY ***
Total pot $2.50 | Rake $0.12 
Board [7c Qc Kd]
Seat 4: ricksdogs77 collected ($2.38)
Seat 5: Mervovabanda folded before Flop (didn't bet)
Seat 6: HasBigBiceps folded before Flop (didn't bet)
Seat 7: ilaviiitech (button) folded before Flop (didn't bet)
Seat 8: matiko09 (small blind) folded before Flop
Seat 9: greg dean (big blind) folded on the Flop





PokerStars Hand #155373732680:  Hold'em No Limit ($0.50/$1.00 USD) - 2016/06/30 8:32:18 CET [2016/06/30 2:32:18 ET]
Table 'Barto' 9-max Seat #8 is the button
Seat 1: hammerwife ($100 in chips) 
Seat 4: ricksdogs77 ($79.01 in chips) 
Seat 5: Mervovabanda ($93.90 in chips) 
Seat 6: HasBigBiceps ($109.05 in chips) 
Seat 7: ilaviiitech ($107.30 in chips) 
Seat 8: matiko09 ($100 in chips) 
Seat 9: greg dean ($56.12 in chips) 
greg dean: posts small blind $0.50
hammerwife: posts big blind $1
Yaaaazz: sits out 
John_les: sits out 
*** HOLE CARDS ***
Dealt to matiko09 [5h 6s]
ricksdogs77: folds 
Mervovabanda: folds 
HasBigBiceps: folds 
ilaviiitech: folds 
matiko09: folds 
greg dean: calls $0.50
hammerwife: raises $4 to $5
greg dean: calls $4
*** FLOP *** [Kh 9d 4h]
greg dean: checks 
hammerwife: bets $5
greg dean: folds 
Uncalled bet ($5) returned to hammerwife
hammerwife collected $9.50 from pot
hammerwife: doesn't show hand 
*** SUMMARY ***
Total pot $10 | Rake $0.50 
Board [Kh 9d 4h]
Seat 1: hammerwife (big blind) collected ($9.50)
Seat 4: ricksdogs77 folded before Flop (didn't bet)
Seat 5: Mervovabanda folded before Flop (didn't bet)
Seat 6: HasBigBiceps folded before Flop (didn't bet)
Seat 7: ilaviiitech folded before Flop (didn't bet)
Seat 8: matiko09 (button) folded before Flop (didn't bet)
Seat 9: greg dean (small blind) folded on the Flop





PokerStars Hand #155373739520:  Hold'em No Limit ($0.25/$0.50 USD) - 2016/06/30 8:32:47 CET [2016/06/30 2:32:47 ET]
Table 'Praxidike' 9-max Seat #1 is the button
Seat 1: Sniper1717 ($53.19 in chips) 
Seat 2: BlackHawk901 ($50 in chips) 
Seat 7: matiko09 ($50.63 in chips) 
Seat 8: Dantist1122 ($51.57 in chips) 
Seat 9: KABAL_ua ($59.53 in chips) 
BlackHawk901: posts small blind $0.25
THREE FlDDY: is sitting out 
John_les: is sitting out 
matiko09: posts big blind $0.50
*** HOLE CARDS ***
Dealt to matiko09 [9h 2h]
Dantist1122: folds 
KABAL_ua: folds 
Sniper1717: folds 
BlackHawk901: raises $1 to $1.50
matiko09: folds 
Uncalled bet ($1) returned to BlackHawk901
BlackHawk901 collected $1 from pot
BlackHawk901: doesn't show hand 
*** SUMMARY ***
Total pot $1 | Rake $0 
Seat 1: Sniper1717 (button) folded before Flop (didn't bet)
Seat 2: BlackHawk901 (small blind) collected ($1)
Seat 7: matiko09 (big blind) folded before Flop
Seat 8: Dantist1122 folded before Flop (didn't bet)
Seat 9: KABAL_ua folded before Flop (didn't bet)





PokerStars Hand #155373742472:  Hold'em No Limit ($0.50/$1.00 USD) - 2016/06/30 8:33:00 CET [2016/06/30 2:33:00 ET]
Table 'Gaby' 9-max Seat #4 is the button
Seat 2: ka100pka527 ($41 in chips) 
Seat 3: Dantist1122 ($100 in chips) 
Seat 4: arctur17 ($76.13 in chips) 
Seat 6: RoadtoNepal ($102.98 in chips) 
Seat 7: stel19 ($51.04 in chips) 
Seat 8: matiko09 ($100 in chips) 
Seat 9: hammerwife ($101.50 in chips) 
RoadtoNepal: posts small blind $0.50
stel19: posts big blind $1
*** HOLE CARDS ***
Dealt to matiko09 [Jd 2c]
kalcumite joins the table at seat #5 
matiko09: folds 
hammerwife: folds 
ka100pka527: folds 
Dantist1122: folds 
arctur17: folds 
RoadtoNepal: folds 
Uncalled bet ($0.50) returned to stel19
stel19 collected $1 from pot
stel19: doesn't show hand 
*** SUMMARY ***
Total pot $1 | Rake $0 
Seat 2: ka100pka527 folded before Flop (didn't bet)
Seat 3: Dantist1122 folded before Flop (didn't bet)
Seat 4: arctur17 (button) folded before Flop (didn't bet)
Seat 6: RoadtoNepal (small blind) folded before Flop
Seat 7: stel19 (big blind) collected ($1)
Seat 8: matiko09 folded before Flop (didn't bet)
Seat 9: hammerwife folded before Flop (didn't bet)





PokerStars Hand #155373744276:  Hold'em No Limit ($0.50/$1.00 USD) - 2016/06/30 8:33:08 CET [2016/06/30 2:33:08 ET]
Table 'Barto' 9-max Seat #9 is the button
Seat 1: hammerwife ($104.50 in chips) 
Seat 2: Yaaaazz ($100 in chips) 
Seat 4: ricksdogs77 ($79.01 in chips) 
Seat 5: Mervovabanda ($93.90 in chips) 
Seat 6: HasBigBiceps ($109.05 in chips) 
Seat 7: ilaviiitech ($107.30 in chips) 
Seat 8: matiko09 ($100 in chips) 
Seat 9: greg dean ($51.12 in chips) 
hammerwife: posts small blind $0.50
Yaaaazz: posts big blind $1
John_les: sits out 
*** HOLE CARDS ***
Dealt to matiko09 [Ah Jc]
ricksdogs77: folds 
Mervovabanda: calls $1
HasBigBiceps: folds 
ilaviiitech: folds 
matiko09: raises $3 to $4
greg dean: calls $4
hammerwife: raises $14 to $18
Yaaaazz: folds 
Mervovabanda: folds 
matiko09: folds 
greg dean: folds 
Uncalled bet ($14) returned to hammerwife
hammerwife collected $14 from pot
hammerwife: doesn't show hand 
*** SUMMARY ***
Total pot $14 | Rake $0 
Seat 1: hammerwife (small blind) collected ($14)
Seat 2: Yaaaazz (big blind) folded before Flop
Seat 4: ricksdogs77 folded before Flop (didn't bet)
Seat 5: Mervovabanda folded before Flop
Seat 6: HasBigBiceps folded before Flop (didn't bet)
Seat 7: ilaviiitech folded before Flop (didn't bet)
Seat 8: matiko09 folded before Flop
Seat 9: greg dean (button) folded before Flop





PokerStars Hand #155373745219:  Hold'em No Limit ($0.25/$0.50 USD) - 2016/06/30 8:33:12 CET [2016/06/30 2:33:12 ET]
Table 'Praxidike' 9-max Seat #2 is the button
Seat 1: Sniper1717 ($53.19 in chips) 
Seat 2: BlackHawk901 ($50.50 in chips) 
Seat 7: matiko09 ($50.13 in chips) 
Seat 8: Dantist1122 ($51.57 in chips) 
Seat 9: KABAL_ua ($59.53 in chips) 
matiko09: posts small blind $0.25
Dantist1122: posts big blind $0.50
*** HOLE CARDS ***
Dealt to matiko09 [3s 6s]
KABAL_ua: folds 
Sniper1717: folds 
BlackHawk901: raises $0.75 to $1.25
matiko09: folds 
Dantist1122: calls $0.75
*** FLOP *** [9c 7d Js]
John_les leaves the table
Dantist1122: checks 
BlackHawk901: bets $1.50
Dantist1122: calls $1.50
*** TURN *** [9c 7d Js] [Td]
Dantist1122: checks 
BlackHawk901: checks 
*** RIVER *** [9c 7d Js Td] [8d]
nicklasrossd is disconnected 
Dantist1122: bets $4.50
BlackHawk901: calls $4.50
*** SHOW DOWN ***
Dantist1122: shows [Qc Jd] (a straight, Eight to Queen)
BlackHawk901: shows [Jh Qs] (a straight, Eight to Queen)
Dantist1122 collected $7.01 from pot
BlackHawk901 collected $7 from pot
*** SUMMARY ***
Total pot $14.75 | Rake $0.74 
Board [9c 7d Js Td 8d]
Seat 1: Sniper1717 folded before Flop (didn't bet)
Seat 2: BlackHawk901 (button) showed [Jh Qs] and won ($7) with a straight, Eight to Queen
Seat 7: matiko09 (small blind) folded before Flop
Seat 8: Dantist1122 (big blind) showed [Qc Jd] and won ($7.01) with a straight, Eight to Queen
Seat 9: KABAL_ua folded before Flop (didn't bet)





PokerStars Hand #155373745821:  Hold'em No Limit ($0.50/$1.00 USD) - 2016/06/30 8:33:14 CET [2016/06/30 2:33:14 ET]
Table 'Lucretia II' 9-max Seat #3 is the button
Seat 1: matiko09 ($209.29 in chips) 
Seat 2: picka4u ($40 in chips) 
Seat 3: Alex Frider ($192.57 in chips) 
Seat 4: John_les ($100 in chips) 
Seat 5: butcheN18 ($100 in chips) 
Seat 6: flk.Dasas ($100 in chips) 
Seat 7: Dantist1122 ($119.97 in chips) 
Seat 8: snow937022 ($100 in chips) 
Seat 9: misko123 ($32.89 in chips) 
John_les: posts small blind $0.50
butcheN18: posts big blind $1
*** HOLE CARDS ***
Dealt to matiko09 [Ad 5c]
flk.Dasas: folds 
Dantist1122: raises $2 to $3
snow937022: folds 
misko123: folds 
matiko09: folds 
picka4u: folds 
Alex Frider: folds 
John_les: folds 
butcheN18: folds 
Uncalled bet ($2) returned to Dantist1122
Dantist1122 collected $2.50 from pot
Dantist1122: doesn't show hand 
*** SUMMARY ***
Total pot $2.50 | Rake $0 
Seat 1: matiko09 folded before Flop (didn't bet)
Seat 2: picka4u folded before Flop (didn't bet)
Seat 3: Alex Frider (button) folded before Flop (didn't bet)
Seat 4: John_les (small blind) folded before Flop
Seat 5: butcheN18 (big blind) folded before Flop
Seat 6: flk.Dasas folded before Flop (didn't bet)
Seat 7: Dantist1122 collected ($2.50)
Seat 8: snow937022 folded before Flop (didn't bet)
Seat 9: misko123 folded before Flop (didn't bet)





PokerStars Hand #155373751294:  Hold'em No Limit ($0.50/$1.00 USD) - 2016/06/30 8:33:38 CET [2016/06/30 2:33:38 ET]
Table 'Asmodeus' 9-max Seat #2 is the button
Seat 1: Imbear8 ($100 in chips) 
Seat 2: John_les ($144.88 in chips) 
Seat 3: L4zy_FiSh ($127.64 in chips) 
Seat 4: matiko09 ($100 in chips) 
Seat 5: butcheN18 ($119.22 in chips) 
Seat 6: snow937022 ($138.21 in chips) 
Seat 7: picka4u ($43.40 in chips) 
Seat 8: RoadtoNepal ($100 in chips) 
Seat 9: flk.Dasas ($248.65 in chips) 
L4zy_FiSh: posts small blind $0.50
matiko09: posts big blind $1
*** HOLE CARDS ***
Dealt to matiko09 [8c 7s]
butcheN18: raises $2 to $3
snow937022: calls $3
picka4u: folds 
RoadtoNepal: folds 
flk.Dasas: folds 
Imbear8: folds 
John_les: folds 
L4zy_FiSh: folds 
matiko09: folds 
*** FLOP *** [2c 5s 7c]
butcheN18: bets $4.55
snow937022: folds 
Uncalled bet ($4.55) returned to butcheN18
butcheN18 collected $7.12 from pot
butcheN18: doesn't show hand 
*** SUMMARY ***
Total pot $7.50 | Rake $0.38 
Board [2c 5s 7c]
Seat 1: Imbear8 folded before Flop (didn't bet)
Seat 2: John_les (button) folded before Flop (didn't bet)
Seat 3: L4zy_FiSh (small blind) folded before Flop
Seat 4: matiko09 (big blind) folded before Flop
Seat 5: butcheN18 collected ($7.12)
Seat 6: snow937022 folded on the Flop
Seat 7: picka4u folded before Flop (didn't bet)
Seat 8: RoadtoNepal folded before Flop (didn't bet)
Seat 9: flk.Dasas folded before Flop (didn't bet)





PokerStars Hand #155373751611:  Hold'em No Limit ($0.50/$1.00 USD) - 2016/06/30 8:33:39 CET [2016/06/30 2:33:39 ET]
Table 'Gaby' 9-max Seat #6 is the button
Seat 2: ka100pka527 ($41 in chips) 
Seat 3: Dantist1122 ($100 in chips) 
Seat 4: arctur17 ($76.13 in chips) 
Seat 5: kalcumite ($100 in chips) 
Seat 6: RoadtoNepal ($102.48 in chips) 
Seat 7: stel19 ($51.54 in chips) 
Seat 8: matiko09 ($100 in chips) 
Seat 9: hammerwife ($101.50 in chips) 
stel19: posts small blind $0.50
matiko09: posts big blind $1
kalcumite: posts big blind $1
*** HOLE CARDS ***
Dealt to matiko09 [9d 2h]
hammerwife: folds 
ka100pka527: folds 
Dantist1122: folds 
arctur17: folds 
kalcumite: raises $2 to $3
RoadtoNepal: folds 
stel19: folds 
matiko09: folds 
Uncalled bet ($2) returned to kalcumite
kalcumite collected $2.50 from pot
kalcumite: doesn't show hand 
*** SUMMARY ***
Total pot $2.50 | Rake $0 
Seat 2: ka100pka527 folded before Flop (didn't bet)
Seat 3: Dantist1122 folded before Flop (didn't bet)
Seat 4: arctur17 folded before Flop (didn't bet)
Seat 5: kalcumite collected ($2.50)
Seat 6: RoadtoNepal (button) folded before Flop (didn't bet)
Seat 7: stel19 (small blind) folded before Flop
Seat 8: matiko09 (big blind) folded before Flop
Seat 9: hammerwife folded before Flop (didn't bet)





PokerStars Hand #155373752609:  Hold'em No Limit ($0.50/$1.00 USD) - 2016/06/30 8:33:43 CET [2016/06/30 2:33:43 ET]
Table 'Aunus' 9-max Seat #9 is the button
Seat 1: dboy604 ($140.78 in chips) 
Seat 2: HasBigBiceps ($100.35 in chips) 
Seat 3: matiko09 ($113.28 in chips) 
Seat 4: ilaviiitech ($100 in chips) 
Seat 5: hammerwife ($114.30 in chips) 
Seat 6: RoadtoNepal ($100 in chips) 
Seat 7: ka100pka527 ($40 in chips) 
Seat 8: Dantist1122 ($100 in chips) 
Seat 9: flk.Dasas ($100 in chips) 
dboy604: posts small blind $0.50
HasBigBiceps: posts big blind $1
*** HOLE CARDS ***
Dealt to matiko09 [8d 3h]
matiko09: folds 
ilaviiitech: folds 
hammerwife: folds 
dboy604 said, ":*"
RoadtoNepal: folds 
ka100pka527: folds 
Dantist1122: folds 
flk.Dasas: raises $1.50 to $2.50
dboy604: folds 
HasBigBiceps: folds 
Uncalled bet ($1.50) returned to flk.Dasas
flk.Dasas collected $2.50 from pot
flk.Dasas: doesn't show hand 
*** SUMMARY ***
Total pot $2.50 | Rake $0 
Seat 1: dboy604 (small blind) folded before Flop
Seat 2: HasBigBiceps (big blind) folded before Flop
Seat 3: matiko09 folded before Flop (didn't bet)
Seat 4: ilaviiitech folded before Flop (didn't bet)
Seat 5: hammerwife folded before Flop (didn't bet)
Seat 6: RoadtoNepal folded before Flop (didn't bet)
Seat 7: ka100pka527 folded before Flop (didn't bet)
Seat 8: Dantist1122 folded before Flop (didn't bet)
Seat 9: flk.Dasas (button) collected ($2.50)





PokerStars Hand #155373752752:  Hold'em No Limit ($0.50/$1.00 USD) - 2016/06/30 8:33:44 CET [2016/06/30 2:33:44 ET]
Table 'Barto' 9-max Seat #1 is the button
Seat 1: hammerwife ($114.50 in chips) 
Seat 2: Yaaaazz ($100 in chips) 
Seat 3: John_les ($100 in chips) 
Seat 4: ricksdogs77 ($79.01 in chips) 
Seat 5: Mervovabanda ($92.90 in chips) 
Seat 6: HasBigBiceps ($109.05 in chips) 
Seat 7: ilaviiitech ($107.30 in chips) 
Seat 8: matiko09 ($100 in chips) 
Seat 9: greg dean ($47.12 in chips) 
Yaaaazz: posts small blind $0.50
John_les: posts big blind $1
*** HOLE CARDS ***
Dealt to matiko09 [6h Kd]
ricksdogs77: folds 
Mervovabanda: folds 
HasBigBiceps: folds 
ilaviiitech: folds 
matiko09: folds 
greg dean: folds 
hammerwife: folds 
Yaaaazz: raises $1.51 to $2.51
John_les: folds 
Uncalled bet ($1.51) returned to Yaaaazz
Yaaaazz collected $2 from pot
*** SUMMARY ***
Total pot $2 | Rake $0 
Seat 1: hammerwife (button) folded before Flop (didn't bet)
Seat 2: Yaaaazz (small blind) collected ($2)
Seat 3: John_les (big blind) folded before Flop
Seat 4: ricksdogs77 folded before Flop (didn't bet)
Seat 5: Mervovabanda folded before Flop (didn't bet)
Seat 6: HasBigBiceps folded before Flop (didn't bet)
Seat 7: ilaviiitech folded before Flop (didn't bet)
Seat 8: matiko09 folded before Flop (didn't bet)
Seat 9: greg dean folded before Flop (didn't bet)





PokerStars Hand #155373755627:  Hold'em No Limit ($0.50/$1.00 USD) - 2016/06/30 8:33:56 CET [2016/06/30 2:33:56 ET]
Table 'Lucretia II' 9-max Seat #4 is the button
Seat 1: matiko09 ($209.29 in chips) 
Seat 2: picka4u ($40 in chips) 
Seat 3: Alex Frider ($192.57 in chips) 
Seat 4: John_les ($100 in chips) 
Seat 5: butcheN18 ($100 in chips) 
Seat 6: flk.Dasas ($100 in chips) 
Seat 7: Dantist1122 ($121.47 in chips) 
Seat 8: snow937022 ($100 in chips) 
Seat 9: misko123 ($32.89 in chips) 
butcheN18: posts small blind $0.50
flk.Dasas: posts big blind $1
*** HOLE CARDS ***
Dealt to matiko09 [4s Jd]
Dantist1122: folds 
snow937022: folds 
misko123: calls $1
matiko09: folds 
picka4u: folds 
Alex Frider: folds 
John_les: folds 
butcheN18: folds 
flk.Dasas: checks 
*** FLOP *** [Kh As 9h]
flk.Dasas: checks 
misko123: checks 
*** TURN *** [Kh As 9h] [6d]
flk.Dasas: bets $1.62
misko123: raises $1.62 to $3.24
flk.Dasas: folds 
Uncalled bet ($1.62) returned to misko123
misko123 collected $5.45 from pot
*** SUMMARY ***
Total pot $5.74 | Rake $0.29 
Board [Kh As 9h 6d]
Seat 1: matiko09 folded before Flop (didn't bet)
Seat 2: picka4u folded before Flop (didn't bet)
Seat 3: Alex Frider folded before Flop (didn't bet)
Seat 4: John_les (button) folded before Flop (didn't bet)
Seat 5: butcheN18 (small blind) folded before Flop
Seat 6: flk.Dasas (big blind) folded on the Turn
Seat 7: Dantist1122 folded before Flop (didn't bet)
Seat 8: snow937022 folded before Flop (didn't bet)
Seat 9: misko123 collected ($5.45)





PokerStars Hand #155373757719:  Hold'em No Limit ($0.50/$1.00 USD) - 2016/06/30 8:34:05 CET [2016/06/30 2:34:05 ET]
Table 'Barto' 9-max Seat #2 is the button
Seat 1: hammerwife ($114.50 in chips) 
Seat 2: Yaaaazz ($101 in chips) 
Seat 3: John_les ($100 in chips) 
Seat 4: ricksdogs77 ($79.01 in chips) 
Seat 5: Mervovabanda ($92.90 in chips) 
Seat 6: HasBigBiceps ($109.05 in chips) 
Seat 7: ilaviiitech ($107.30 in chips) 
Seat 8: matiko09 ($100 in chips) 
Seat 9: greg dean ($47.12 in chips) 
John_les: posts small blind $0.50
ricksdogs77: posts big blind $1
*** HOLE CARDS ***
Dealt to matiko09 [As Qd]
Mervovabanda: folds 
HasBigBiceps: folds 
ilaviiitech: folds 
Mervovabanda leaves the table
matiko09: raises $2 to $3
greg dean: calls $3
Ronfar3 joins the table at seat #5 
hammerwife: folds 
Yaaaazz: folds 
John_les: folds 
ricksdogs77: calls $2
*** FLOP *** [Kd Qc Ac]
ricksdogs77: checks 
matiko09: bets $6
greg dean: raises $6 to $12
ricksdogs77: folds 
matiko09: raises $13 to $25
greg dean: raises $13 to $38
hammerwife is disconnected 
matiko09: raises $13 to $51
greg dean: calls $6.12 and is all-in
Uncalled bet ($6.88) returned to matiko09
*** TURN *** [Kd Qc Ac] [8s]
*** RIVER *** [Kd Qc Ac 8s] [2s]
*** SHOW DOWN ***
matiko09: shows [As Qd] (two pair, Aces and Queens)
greg dean: shows [Ks 7c] (a pair of Kings)
matiko09 collected $95.24 from pot
*** SUMMARY ***
Total pot $97.74 | Rake $2.50 
Board [Kd Qc Ac 8s 2s]
Seat 1: hammerwife folded before Flop (didn't bet)
Seat 2: Yaaaazz (button) folded before Flop (didn't bet)
Seat 3: John_les (small blind) folded before Flop
Seat 4: ricksdogs77 (big blind) folded on the Flop
Seat 5: Mervovabanda folded before Flop (didn't bet)
Seat 6: HasBigBiceps folded before Flop (didn't bet)
Seat 7: ilaviiitech folded before Flop (didn't bet)
Seat 8: matiko09 showed [As Qd] and won ($95.24) with two pair, Aces and Queens
Seat 9: greg dean showed [Ks 7c] and lost with a pair of Kings





PokerStars Hand #155373760740:  Hold'em No Limit ($0.50/$1.00 USD) - 2016/06/30 8:34:18 CET [2016/06/30 2:34:18 ET]
Table 'Gaby' 9-max Seat #7 is the button
Seat 2: ka100pka527 ($41 in chips) 
Seat 3: Dantist1122 ($100 in chips) 
Seat 4: arctur17 ($76.13 in chips) 
Seat 5: kalcumite ($101.50 in chips) 
Seat 6: RoadtoNepal ($102.48 in chips) 
Seat 7: stel19 ($51.04 in chips) 
Seat 8: matiko09 ($100 in chips) 
Seat 9: hammerwife ($101.50 in chips) 
matiko09: posts small blind $0.50
hammerwife: posts big blind $1
*** HOLE CARDS ***
Dealt to matiko09 [4c 8s]
ka100pka527: raises $2 to $3
Dantist1122: folds 
arctur17: calls $3
kalcumite: folds 
RoadtoNepal: folds 
stel19: folds 
matiko09: folds 
hammerwife: folds 
*** FLOP *** [4h 3c 5d]
ka100pka527: bets $3.56
arctur17: calls $3.56
*** TURN *** [4h 3c 5d] [6s]
ka100pka527: bets $9.25
arctur17: folds 
Uncalled bet ($9.25) returned to ka100pka527
ka100pka527 collected $13.89 from pot
ka100pka527: doesn't show hand 
hammerwife is disconnected 
*** SUMMARY ***
Total pot $14.62 | Rake $0.73 
Board [4h 3c 5d 6s]
Seat 2: ka100pka527 collected ($13.89)
Seat 3: Dantist1122 folded before Flop (didn't bet)
Seat 4: arctur17 folded on the Turn
Seat 5: kalcumite folded before Flop (didn't bet)
Seat 6: RoadtoNepal folded before Flop (didn't bet)
Seat 7: stel19 (button) folded before Flop (didn't bet)
Seat 8: matiko09 (small blind) folded before Flop
Seat 9: hammerwife (big blind) folded before Flop





PokerStars Hand #155373761928:  Hold'em No Limit ($0.50/$1.00 USD) - 2016/06/30 8:34:22 CET [2016/06/30 2:34:22 ET]
Table 'Asmodeus' 9-max Seat #3 is the button
Seat 1: Imbear8 ($100 in chips) 
Seat 2: John_les ($144.88 in chips) 
Seat 3: L4zy_FiSh ($127.14 in chips) 
Seat 4: matiko09 ($100 in chips) 
Seat 5: butcheN18 ($123.34 in chips) 
Seat 6: snow937022 ($135.21 in chips) 
Seat 7: picka4u ($43.40 in chips) 
Seat 8: RoadtoNepal ($100 in chips) 
Seat 9: flk.Dasas ($248.65 in chips) 
matiko09: posts small blind $0.50
butcheN18: posts big blind $1
*** HOLE CARDS ***
Dealt to matiko09 [2d 6d]
snow937022: folds 
picka4u: raises $1.25 to $2.25
RoadtoNepal: folds 
flk.Dasas: folds 
Imbear8: folds 
John_les: folds 
L4zy_FiSh: folds 
matiko09: folds 
butcheN18: folds 
Uncalled bet ($1.25) returned to picka4u
picka4u collected $2.50 from pot
picka4u: doesn't show hand 
*** SUMMARY ***
Total pot $2.50 | Rake $0 
Seat 1: Imbear8 folded before Flop (didn't bet)
Seat 2: John_les folded before Flop (didn't bet)
Seat 3: L4zy_FiSh (button) folded before Flop (didn't bet)
Seat 4: matiko09 (small blind) folded before Flop
Seat 5: butcheN18 (big blind) folded before Flop
Seat 6: snow937022 folded before Flop (didn't bet)
Seat 7: picka4u collected ($2.50)
Seat 8: RoadtoNepal folded before Flop (didn't bet)
Seat 9: flk.Dasas folded before Flop (didn't bet)





PokerStars Hand #155373766314:  Hold'em No Limit ($0.25/$0.50 USD) - 2016/06/30 8:34:41 CET [2016/06/30 2:34:41 ET]
Table 'Praxidike' 9-max Seat #7 is the button
Seat 1: Sniper1717 ($53.19 in chips) 
Seat 2: BlackHawk901 ($50.25 in chips) 
Seat 7: matiko09 ($50 in chips) 
Seat 8: Dantist1122 ($51.33 in chips) 
Seat 9: KABAL_ua ($59.53 in chips) 
Dantist1122: posts small blind $0.25
KABAL_ua: posts big blind $0.50
Alexey_Kim2 joins the table at seat #5 
nicklasrossd has timed out while disconnected
nicklasrossd: is sitting out 
*** HOLE CARDS ***
Dealt to matiko09 [6c 9h]
Sniper1717: folds 
BlackHawk901: folds 
matiko09: folds 
Dantist1122: folds 
Uncalled bet ($0.25) returned to KABAL_ua
KABAL_ua collected $0.50 from pot
KABAL_ua: doesn't show hand 
*** SUMMARY ***
Total pot $0.50 | Rake $0 
Seat 1: Sniper1717 folded before Flop (didn't bet)
Seat 2: BlackHawk901 folded before Flop (didn't bet)
Seat 7: matiko09 (button) folded before Flop (didn't bet)
Seat 8: Dantist1122 (small blind) folded before Flop
Seat 9: KABAL_ua (big blind) collected ($0.50)





PokerStars Hand #155373766646:  Hold'em No Limit ($0.50/$1.00 USD) - 2016/06/30 8:34:43 CET [2016/06/30 2:34:43 ET]
Table 'Aunus' 9-max Seat #1 is the button
Seat 1: dboy604 ($140.28 in chips) 
Seat 2: HasBigBiceps ($100 in chips) 
Seat 3: matiko09 ($113.28 in chips) 
Seat 4: ilaviiitech ($100 in chips) 
Seat 5: hammerwife ($114.30 in chips) 
Seat 6: RoadtoNepal ($100 in chips) 
Seat 7: ka100pka527 ($40 in chips) 
Seat 8: Dantist1122 ($100 in chips) 
Seat 9: flk.Dasas ($101.50 in chips) 
HasBigBiceps: posts small blind $0.50
matiko09: posts big blind $1
*** HOLE CARDS ***
Dealt to matiko09 [9c As]
ilaviiitech: folds 
hammerwife: folds 
RoadtoNepal: folds 
ka100pka527: folds 
Dantist1122: folds 
flk.Dasas: folds 
dboy604: calls $1
HasBigBiceps: folds 
matiko09: raises $3 to $4
dboy604 is disconnected 
hammerwife is disconnected 
dboy604 is connected 
dboy604: calls $3
*** FLOP *** [8s 4h 3c]
matiko09: bets $5
dboy604: calls $5
*** TURN *** [8s 4h 3c] [Kd]
matiko09: checks 
dboy604: checks 
*** RIVER *** [8s 4h 3c Kd] [3h]
matiko09: checks 
dboy604: bets $5
matiko09: calls $5
*** SHOW DOWN ***
dboy604: shows [8h Ts] (two pair, Eights and Threes)
matiko09: mucks hand 
dboy604 collected $27.08 from pot
*** SUMMARY ***
Total pot $28.50 | Rake $1.42 
Board [8s 4h 3c Kd 3h]
Seat 1: dboy604 (button) showed [8h Ts] and won ($27.08) with two pair, Eights and Threes
Seat 2: HasBigBiceps (small blind) folded before Flop
Seat 3: matiko09 (big blind) mucked [9c As]
Seat 4: ilaviiitech folded before Flop (didn't bet)
Seat 5: hammerwife folded before Flop (didn't bet)
Seat 6: RoadtoNepal folded before Flop (didn't bet)
Seat 7: ka100pka527 folded before Flop (didn't bet)
Seat 8: Dantist1122 folded before Flop (didn't bet)
Seat 9: flk.Dasas folded before Flop (didn't bet)





PokerStars Hand #155373767941:  Hold'em No Limit ($0.50/$1.00 USD) - 2016/06/30 8:34:48 CET [2016/06/30 2:34:48 ET]
Table 'Asmodeus' 9-max Seat #4 is the button
Seat 1: Imbear8 ($100 in chips) 
Seat 2: John_les ($144.88 in chips) 
Seat 3: L4zy_FiSh ($127.14 in chips) 
Seat 4: matiko09 ($100 in chips) 
Seat 5: butcheN18 ($122.34 in chips) 
Seat 6: snow937022 ($135.21 in chips) 
Seat 7: picka4u ($44.90 in chips) 
Seat 8: RoadtoNepal ($100 in chips) 
Seat 9: flk.Dasas ($248.65 in chips) 
butcheN18: posts small blind $0.50
snow937022: posts big blind $1
*** HOLE CARDS ***
Dealt to matiko09 [7s Qd]
picka4u: folds 
RoadtoNepal: folds 
flk.Dasas: folds 
Imbear8: raises $1 to $2
John_les: folds 
L4zy_FiSh: folds 
matiko09: folds 
butcheN18: folds 
snow937022: calls $1
*** FLOP *** [Qh 9d Qc]
snow937022: checks 
Imbear8: bets $2.14
snow937022: folds 
Uncalled bet ($2.14) returned to Imbear8
Imbear8 collected $4.28 from pot
Imbear8: doesn't show hand 
*** SUMMARY ***
Total pot $4.50 | Rake $0.22 
Board [Qh 9d Qc]
Seat 1: Imbear8 collected ($4.28)
Seat 2: John_les folded before Flop (didn't bet)
Seat 3: L4zy_FiSh folded before Flop (didn't bet)
Seat 4: matiko09 (button) folded before Flop (didn't bet)
Seat 5: butcheN18 (small blind) folded before Flop
Seat 6: snow937022 (big blind) folded on the Flop
Seat 7: picka4u folded before Flop (didn't bet)
Seat 8: RoadtoNepal folded before Flop (didn't bet)
Seat 9: flk.Dasas folded before Flop (didn't bet)





PokerStars Hand #155373773288:  Hold'em No Limit ($0.50/$1.00 USD) - 2016/06/30 8:35:11 CET [2016/06/30 2:35:11 ET]
Table 'Lucretia II' 9-max Seat #5 is the button
Seat 1: matiko09 ($209.29 in chips) 
Seat 2: picka4u ($40 in chips) 
Seat 3: Alex Frider ($192.57 in chips) 
Seat 4: John_les ($100 in chips) 
Seat 5: butcheN18 ($100 in chips) 
Seat 6: flk.Dasas ($100 in chips) 
Seat 7: Dantist1122 ($121.47 in chips) 
Seat 8: snow937022 ($100 in chips) 
Seat 9: misko123 ($35.72 in chips) 
flk.Dasas: posts small blind $0.50
Dantist1122: posts big blind $1
*** HOLE CARDS ***
Dealt to matiko09 [Jc 3c]
snow937022: folds 
misko123: calls $1
matiko09: folds 
picka4u: raises $1.50 to $2.50
Alex Frider: folds 
John_les: folds 
butcheN18: calls $2.50
flk.Dasas: folds 
Dantist1122: folds 
misko123: calls $1.50
*** FLOP *** [5s 7d Tc]
misko123: checks 
picka4u: checks 
butcheN18: bets $6
misko123: calls $6
picka4u: folds 
*** TURN *** [5s 7d Tc] [2h]
misko123: checks 
butcheN18: bets $12
misko123: folds 
Uncalled bet ($12) returned to butcheN18
butcheN18 collected $19.95 from pot
butcheN18: doesn't show hand 
*** SUMMARY ***
Total pot $21 | Rake $1.05 
Board [5s 7d Tc 2h]
Seat 1: matiko09 folded before Flop (didn't bet)
Seat 2: picka4u folded on the Flop
Seat 3: Alex Frider folded before Flop (didn't bet)
Seat 4: John_les folded before Flop (didn't bet)
Seat 5: butcheN18 (button) collected ($19.95)
Seat 6: flk.Dasas (small blind) folded before Flop
Seat 7: Dantist1122 (big blind) folded before Flop
Seat 8: snow937022 folded before Flop (didn't bet)
Seat 9: misko123 folded on the Turn





PokerStars Hand #155373775593:  Hold'em No Limit ($0.50/$1.00 USD) - 2016/06/30 8:35:21 CET [2016/06/30 2:35:21 ET]
Table 'Asmodeus' 9-max Seat #5 is the button
Seat 1: Imbear8 ($102.28 in chips) 
Seat 2: John_les ($144.88 in chips) 
Seat 3: L4zy_FiSh ($127.14 in chips) 
Seat 4: matiko09 ($100 in chips) 
Seat 5: butcheN18 ($121.84 in chips) 
Seat 6: snow937022 ($133.21 in chips) 
Seat 7: picka4u ($44.90 in chips) 
Seat 8: RoadtoNepal ($100 in chips) 
Seat 9: flk.Dasas ($248.65 in chips) 
snow937022: posts small blind $0.50
picka4u: posts big blind $1
*** HOLE CARDS ***
Dealt to matiko09 [6c 6s]
RoadtoNepal: folds 
flk.Dasas: folds 
Imbear8: raises $2.50 to $3.50
John_les: folds 
L4zy_FiSh: folds 
matiko09: calls $3.50
butcheN18: folds 
snow937022: folds 
picka4u: folds 
*** FLOP *** [Th 9d Jc]
Imbear8: checks 
matiko09: checks 
*** TURN *** [Th 9d Jc] [2d]
Imbear8: bets $7
matiko09: folds 
Uncalled bet ($7) returned to Imbear8
Imbear8 collected $8.08 from pot
Imbear8: doesn't show hand 
*** SUMMARY ***
Total pot $8.50 | Rake $0.42 
Board [Th 9d Jc 2d]
Seat 1: Imbear8 collected ($8.08)
Seat 2: John_les folded before Flop (didn't bet)
Seat 3: L4zy_FiSh folded before Flop (didn't bet)
Seat 4: matiko09 folded on the Turn
Seat 5: butcheN18 (button) folded before Flop (didn't bet)
Seat 6: snow937022 (small blind) folded before Flop
Seat 7: picka4u (big blind) folded before Flop
Seat 8: RoadtoNepal folded before Flop (didn't bet)
Seat 9: flk.Dasas folded before Flop (didn't bet)





PokerStars Hand #155373777121:  Hold'em No Limit ($0.25/$0.50 USD) - 2016/06/30 8:35:27 CET [2016/06/30 2:35:27 ET]
Table 'Praxidike' 9-max Seat #8 is the button
Seat 1: Sniper1717 ($53.19 in chips) 
Seat 2: BlackHawk901 ($50.25 in chips) 
Seat 7: matiko09 ($50 in chips) 
Seat 8: Dantist1122 ($51.08 in chips) 
Seat 9: KABAL_ua ($59.78 in chips) 
KABAL_ua: posts small blind $0.25
Sniper1717: posts big blind $0.50
*** HOLE CARDS ***
Dealt to matiko09 [2h Ah]
BlackHawk901: folds 
matiko09: raises $0.75 to $1.25
Dantist1122: folds 
KABAL_ua: folds 
Sniper1717: folds 
Uncalled bet ($0.75) returned to matiko09
matiko09 collected $1.25 from pot
matiko09: doesn't show hand 
*** SUMMARY ***
Total pot $1.25 | Rake $0 
Seat 1: Sniper1717 (big blind) folded before Flop
Seat 2: BlackHawk901 folded before Flop (didn't bet)
Seat 7: matiko09 collected ($1.25)
Seat 8: Dantist1122 (button) folded before Flop (didn't bet)
Seat 9: KABAL_ua (small blind) folded before Flop





PokerStars Hand #155373778299:  Hold'em No Limit ($0.50/$1.00 USD) - 2016/06/30 8:35:32 CET [2016/06/30 2:35:32 ET]
Table 'Gaby' 9-max Seat #8 is the button
Seat 2: ka100pka527 ($48.33 in chips) 
Seat 3: Dantist1122 ($100 in chips) 
Seat 4: arctur17 ($69.57 in chips) 
Seat 5: kalcumite ($101.50 in chips) 
Seat 6: RoadtoNepal ($102.48 in chips) 
Seat 7: stel19 ($51.04 in chips) 
Seat 8: matiko09 ($100 in chips) 
hammerwife has timed out while disconnected
hammerwife: is sitting out 
ka100pka527: posts small blind $0.50
Dantist1122: posts big blind $1
*** HOLE CARDS ***
Dealt to matiko09 [5s 4s]
arctur17: folds 
kalcumite: raises $2 to $3
RoadtoNepal: folds 
stel19: calls $3
matiko09: folds 
ka100pka527: folds 
Dantist1122: folds 
*** FLOP *** [9s 4d 2d]
kalcumite: bets $5
stel19: calls $5
*** TURN *** [9s 4d 2d] [6d]
kalcumite: checks 
stel19: checks 
*** RIVER *** [9s 4d 2d 6d] [8c]
kalcumite: bets $15
stel19: calls $15
*** SHOW DOWN ***
kalcumite: shows [2c 2s] (three of a kind, Deuces)
stel19: mucks hand 
kalcumite collected $45.12 from pot
*** SUMMARY ***
Total pot $47.50 | Rake $2.38 
Board [9s 4d 2d 6d 8c]
Seat 2: ka100pka527 (small blind) folded before Flop
Seat 3: Dantist1122 (big blind) folded before Flop
Seat 4: arctur17 folded before Flop (didn't bet)
Seat 5: kalcumite showed [2c 2s] and won ($45.12) with three of a kind, Deuces
Seat 6: RoadtoNepal folded before Flop (didn't bet)
Seat 7: stel19 mucked [7c 9c]
Seat 8: matiko09 (button) folded before Flop (didn't bet)





PokerStars Hand #155373781096:  Hold'em No Limit ($0.50/$1.00 USD) - 2016/06/30 8:35:44 CET [2016/06/30 2:35:44 ET]
Table 'Barto' 9-max Seat #3 is the button
Seat 1: hammerwife ($114.50 in chips) 
Seat 2: Yaaaazz ($101 in chips) 
Seat 3: John_les ($100 in chips) 
Seat 4: ricksdogs77 ($76.01 in chips) 
Seat 5: Ronfar3 ($100 in chips) 
Seat 6: HasBigBiceps ($109.05 in chips) 
Seat 7: ilaviiitech ($107.30 in chips) 
Seat 8: matiko09 ($148.12 in chips) 
ricksdogs77: posts small blind $0.50
Ronfar3: posts big blind $1
*** HOLE CARDS ***
Dealt to matiko09 [4c 8d]
HasBigBiceps: folds 
ilaviiitech: folds 
matiko09: folds 
hammerwife has timed out while disconnected
hammerwife: folds 
Yaaaazz: folds 
John_les: folds 
ricksdogs77: calls $0.50
Ronfar3: checks 
*** FLOP *** [Jh 6s 5c]
ricksdogs77: bets $2
Ronfar3: folds 
Uncalled bet ($2) returned to ricksdogs77
ricksdogs77 collected $1.90 from pot
ricksdogs77: doesn't show hand 
*** SUMMARY ***
Total pot $2 | Rake $0.10 
Board [Jh 6s 5c]
Seat 1: hammerwife folded before Flop (didn't bet)
Seat 2: Yaaaazz folded before Flop (didn't bet)
Seat 3: John_les (button) folded before Flop (didn't bet)
Seat 4: ricksdogs77 (small blind) collected ($1.90)
Seat 5: Ronfar3 (big blind) folded on the Flop
Seat 6: HasBigBiceps folded before Flop (didn't bet)
Seat 7: ilaviiitech folded before Flop (didn't bet)
Seat 8: matiko09 folded before Flop (didn't bet)





PokerStars Hand #155373781119:  Hold'em No Limit ($0.25/$0.50 USD) - 2016/06/30 8:35:44 CET [2016/06/30 2:35:44 ET]
Table 'Praxidike' 9-max Seat #9 is the button
Seat 1: Sniper1717 ($52.69 in chips) 
Seat 7: matiko09 ($50.75 in chips) 
Seat 8: Dantist1122 ($51.08 in chips) 
Seat 9: KABAL_ua ($59.53 in chips) 
Sniper1717: posts small blind $0.25
BlackHawk901: is sitting out 
matiko09: posts big blind $0.50
*** HOLE CARDS ***
Dealt to matiko09 [3h 2d]
Dantist1122: folds 
Dantist1122 leaves the table
BlackHawk901 leaves the table
KABAL_ua: raises $0.70 to $1.20
Sniper1717: folds 
matiko09: folds 
Uncalled bet ($0.70) returned to KABAL_ua
KABAL_ua collected $1.25 from pot
KABAL_ua: doesn't show hand 
*** SUMMARY ***
Total pot $1.25 | Rake $0 
Seat 1: Sniper1717 (small blind) folded before Flop
Seat 7: matiko09 (big blind) folded before Flop
Seat 8: Dantist1122 folded before Flop (didn't bet)
Seat 9: KABAL_ua (button) collected ($1.25)





PokerStars Hand #155373783933:  Hold'em No Limit ($0.50/$1.00 USD) - 2016/06/30 8:35:56 CET [2016/06/30 2:35:56 ET]
Table 'Lucretia II' 9-max Seat #6 is the button
Seat 1: matiko09 ($209.29 in chips) 
Seat 2: picka4u ($37.50 in chips) 
Seat 3: Alex Frider ($192.57 in chips) 
Seat 4: John_les ($100 in chips) 
Seat 5: butcheN18 ($111.45 in chips) 
Seat 6: flk.Dasas ($100 in chips) 
Seat 7: Dantist1122 ($120.47 in chips) 
Seat 8: snow937022 ($100 in chips) 
Seat 9: misko123 ($27.22 in chips) 
Dantist1122: posts small blind $0.50
snow937022: posts big blind $1
*** HOLE CARDS ***
Dealt to matiko09 [Td 6h]
misko123: folds 
matiko09: folds 
picka4u: raises $1.25 to $2.25
Alex Frider: folds 
John_les: raises $4.75 to $7
butcheN18: folds 
flk.Dasas: folds 
Dantist1122: folds 
snow937022: folds 
picka4u: folds 
Uncalled bet ($4.75) returned to John_les
John_les collected $6 from pot
John_les: doesn't show hand 
*** SUMMARY ***
Total pot $6 | Rake $0 
Seat 1: matiko09 folded before Flop (didn't bet)
Seat 2: picka4u folded before Flop
Seat 3: Alex Frider folded before Flop (didn't bet)
Seat 4: John_les collected ($6)
Seat 5: butcheN18 folded before Flop (didn't bet)
Seat 6: flk.Dasas (button) folded before Flop (didn't bet)
Seat 7: Dantist1122 (small blind) folded before Flop
Seat 8: snow937022 (big blind) folded before Flop
Seat 9: misko123 folded before Flop (didn't bet)





PokerStars Hand #155373786383:  Hold'em No Limit ($0.25/$0.50 USD) - 2016/06/30 8:36:06 CET [2016/06/30 2:36:06 ET]
Table 'Praxidike' 9-max Seat #7 is the button
Seat 1: Sniper1717 ($52.44 in chips) 
Seat 7: matiko09 ($50.25 in chips) 
matiko09: posts small blind $0.25
KABAL_ua: is sitting out 
Sniper1717: posts big blind $0.50
*** HOLE CARDS ***
Dealt to matiko09 [8c 5d]
matiko09: folds 
Uncalled bet ($0.25) returned to Sniper1717
Sniper1717 collected $0.50 from pot
Sniper1717: doesn't show hand 
*** SUMMARY ***
Total pot $0.50 | Rake $0 
Seat 1: Sniper1717 (big blind) collected ($0.50)
Seat 7: matiko09 (button) (small blind) folded before Flop





PokerStars Hand #155373788158:  Hold'em No Limit ($0.25/$0.50 USD) - 2016/06/30 8:36:14 CET [2016/06/30 2:36:14 ET]
Table 'Praxidike' 9-max Seat #1 is the button
Seat 1: Sniper1717 ($52.69 in chips) 
Seat 7: matiko09 ($50 in chips) 
Sniper1717: posts small blind $0.25
matiko09: posts big blind $0.50
*** HOLE CARDS ***
Dealt to matiko09 [8c Ah]
Sniper1717: calls $0.25
Dantist1122 joins the table at seat #8 
matiko09: checks 
*** FLOP *** [3c 3d 5d]
matiko09: checks 
Sniper1717: checks 
*** TURN *** [3c 3d 5d] [7c]
KABAL_ua leaves the table
matiko09: checks 
Sniper1717: checks 
*** RIVER *** [3c 3d 5d 7c] [Jd]
matiko09: checks 
Sniper1717: checks 
*** SHOW DOWN ***
matiko09: shows [8c Ah] (a pair of Threes)
Sniper1717: shows [6c Jh] (two pair, Jacks and Threes)
Sniper1717 collected $0.95 from pot
*** SUMMARY ***
Total pot $1 | Rake $0.05 
Board [3c 3d 5d 7c Jd]
Seat 1: Sniper1717 (button) (small blind) showed [6c Jh] and won ($0.95) with two pair, Jacks and Threes
Seat 7: matiko09 (big blind) showed [8c Ah] and lost with a pair of Threes





PokerStars Hand #155373791056:  Hold'em No Limit ($0.50/$1.00 USD) - 2016/06/30 8:36:26 CET [2016/06/30 2:36:26 ET]
Table 'Aunus' 9-max Seat #2 is the button
Seat 1: dboy604 ($153.36 in chips) 
Seat 2: HasBigBiceps ($100 in chips) 
Seat 3: matiko09 ($100 in chips) 
Seat 4: ilaviiitech ($100 in chips) 
Seat 5: hammerwife ($114.30 in chips) 
Seat 6: RoadtoNepal ($100 in chips) 
Seat 7: ka100pka527 ($40 in chips) 
Seat 8: Dantist1122 ($100 in chips) 
Seat 9: flk.Dasas ($101.50 in chips) 
matiko09: posts small blind $0.50
ilaviiitech: posts big blind $1
*** HOLE CARDS ***
Dealt to matiko09 [Ah Qd]
hammerwife: folds 
RoadtoNepal: folds 
ka100pka527: raises $2 to $3
Dantist1122: folds 
flk.Dasas: folds 
dboy604: folds 
HasBigBiceps: folds 
matiko09: folds 
ilaviiitech: folds 
Uncalled bet ($2) returned to ka100pka527
ka100pka527 collected $2.50 from pot
ka100pka527: doesn't show hand 
*** SUMMARY ***
Total pot $2.50 | Rake $0 
Seat 1: dboy604 folded before Flop (didn't bet)
Seat 2: HasBigBiceps (button) folded before Flop (didn't bet)
Seat 3: matiko09 (small blind) folded before Flop
Seat 4: ilaviiitech (big blind) folded before Flop
Seat 5: hammerwife folded before Flop (didn't bet)
Seat 6: RoadtoNepal folded before Flop (didn't bet)
Seat 7: ka100pka527 collected ($2.50)
Seat 8: Dantist1122 folded before Flop (didn't bet)
Seat 9: flk.Dasas folded before Flop (didn't bet)





PokerStars Hand #155373795273:  Hold'em No Limit ($0.50/$1.00 USD) - 2016/06/30 8:36:43 CET [2016/06/30 2:36:43 ET]
Table 'Barto' 9-max Seat #4 is the button
Seat 1: hammerwife ($114.50 in chips) 
Seat 2: Yaaaazz ($101 in chips) 
Seat 3: John_les ($100 in chips) 
Seat 4: ricksdogs77 ($76.91 in chips) 
Seat 5: Ronfar3 ($100 in chips) 
Seat 8: matiko09 ($148.12 in chips) 
Ronfar3: posts small blind $0.50
HasBigBiceps: is sitting out 
ilaviiitech: is sitting out 
matiko09: posts big blind $1
*** HOLE CARDS ***
Dealt to matiko09 [Kc Jh]
hammerwife: folds 
Yaaaazz: folds 
John_les: folds 
HasBigBiceps leaves the table
ricksdogs77: folds 
Dantist1122 joins the table at seat #6 
Ronfar3: folds 
Uncalled bet ($0.50) returned to matiko09
ilaviiitech leaves the table
matiko09 collected $1 from pot
matiko09: doesn't show hand 
*** SUMMARY ***
Total pot $1 | Rake $0 
Seat 1: hammerwife folded before Flop (didn't bet)
Seat 2: Yaaaazz folded before Flop (didn't bet)
Seat 3: John_les folded before Flop (didn't bet)
Seat 4: ricksdogs77 (button) folded before Flop (didn't bet)
Seat 5: Ronfar3 (small blind) folded before Flop
Seat 8: matiko09 (big blind) collected ($1)





PokerStars Hand #155373796581:  Hold'em No Limit ($0.50/$1.00 USD) - 2016/06/30 8:36:49 CET [2016/06/30 2:36:49 ET]
Table 'Asmodeus' 9-max Seat #6 is the button
Seat 1: Imbear8 ($106.86 in chips) 
Seat 2: John_les ($144.88 in chips) 
Seat 3: L4zy_FiSh ($127.14 in chips) 
Seat 4: matiko09 ($100 in chips) 
Seat 5: butcheN18 ($121.84 in chips) 
Seat 6: snow937022 ($132.71 in chips) 
Seat 7: picka4u ($43.90 in chips) 
Seat 9: flk.Dasas ($248.65 in chips) 
picka4u: posts small blind $0.50
RoadtoNepal: is sitting out 
flk.Dasas: posts big blind $1
*** HOLE CARDS ***
Dealt to matiko09 [6h 8h]
Imbear8: folds 
John_les: raises $2.50 to $3.50
L4zy_FiSh: folds 
matiko09: folds 
butcheN18: folds 
snow937022: calls $3.50
picka4u: calls $3
flk.Dasas: folds 
*** FLOP *** [As 4h Tc]
picka4u: checks 
John_les: bets $6
snow937022: calls $6
picka4u: calls $6
*** TURN *** [As 4h Tc] [7s]
picka4u: checks 
John_les: checks 
snow937022: checks 
*** RIVER *** [As 4h Tc 7s] [5s]
picka4u: checks 
John_les: checks 
snow937022: checks 
*** SHOW DOWN ***
picka4u: shows [Jc Qc] (high card Ace)
John_les: shows [9c 9h] (a pair of Nines)
snow937022: mucks hand 
John_les collected $28.02 from pot
*** SUMMARY ***
Total pot $29.50 | Rake $1.48 
Board [As 4h Tc 7s 5s]
Seat 1: Imbear8 folded before Flop (didn't bet)
Seat 2: John_les showed [9c 9h] and won ($28.02) with a pair of Nines
Seat 3: L4zy_FiSh folded before Flop (didn't bet)
Seat 4: matiko09 folded before Flop (didn't bet)
Seat 5: butcheN18 folded before Flop (didn't bet)
Seat 6: snow937022 (button) mucked [Js Kh]
Seat 7: picka4u (small blind) showed [Jc Qc] and lost with high card Ace
Seat 9: flk.Dasas (big blind) folded before Flop





PokerStars Hand #155373797024:  Hold'em No Limit ($0.50/$1.00 USD) - 2016/06/30 8:36:51 CET [2016/06/30 2:36:51 ET]
Table 'Lucretia II' 9-max Seat #7 is the button
Seat 1: matiko09 ($209.29 in chips) 
Seat 2: picka4u ($35.25 in chips) 
Seat 3: Alex Frider ($192.57 in chips) 
Seat 4: John_les ($103.75 in chips) 
Seat 5: butcheN18 ($111.45 in chips) 
Seat 6: flk.Dasas ($100 in chips) 
Seat 7: Dantist1122 ($119.97 in chips) 
Seat 8: snow937022 ($100 in chips) 
Seat 9: misko123 ($27.22 in chips) 
snow937022: posts small blind $0.50
misko123: posts big blind $1
*** HOLE CARDS ***
Dealt to matiko09 [4h 2d]
matiko09: folds 
picka4u: folds 
Alex Frider: raises $1.50 to $2.50
John_les: folds 
butcheN18: folds 
flk.Dasas: folds 
Dantist1122: folds 
snow937022: calls $2
misko123: calls $1.50
*** FLOP *** [7s Jd Ac]
snow937022: checks 
misko123: bets $4
Alex Frider: calls $4
snow937022: folds 
*** TURN *** [7s Jd Ac] [Ad]
misko123: checks 
Alex Frider: bets $10.50
misko123: folds 
Uncalled bet ($10.50) returned to Alex Frider
Alex Frider collected $14.72 from pot
Alex Frider: doesn't show hand 
*** SUMMARY ***
Total pot $15.50 | Rake $0.78 
Board [7s Jd Ac Ad]
Seat 1: matiko09 folded before Flop (didn't bet)
Seat 2: picka4u folded before Flop (didn't bet)
Seat 3: Alex Frider collected ($14.72)
Seat 4: John_les folded before Flop (didn't bet)
Seat 5: butcheN18 folded before Flop (didn't bet)
Seat 6: flk.Dasas folded before Flop (didn't bet)
Seat 7: Dantist1122 (button) folded before Flop (didn't bet)
Seat 8: snow937022 (small blind) folded on the Flop
Seat 9: misko123 (big blind) folded on the Turn





PokerStars Hand #155373797792:  Hold'em No Limit ($0.50/$1.00 USD) - 2016/06/30 8:36:54 CET [2016/06/30 2:36:54 ET]
Table 'Barto' 9-max Seat #5 is the button
Seat 1: hammerwife ($114.50 in chips) 
Seat 2: Yaaaazz ($101 in chips) 
Seat 3: John_les ($100 in chips) 
Seat 4: ricksdogs77 ($76.91 in chips) 
Seat 5: Ronfar3 ($100 in chips) 
Seat 8: matiko09 ($148.62 in chips) 
Seat 9: greg dean ($80 in chips) 
Dantist1122 will be allowed to play after the button
matiko09: posts small blind $0.50
greg dean: posts big blind $1
*** HOLE CARDS ***
Dealt to matiko09 [5d 9d]
hammerwife: folds 
RoadtoNepal joins the table at seat #7 
Yaaaazz: folds 
John_les: folds 
ricksdogs77: folds 
Ronfar3: folds 
matiko09: calls $0.50
greg dean: checks 
*** FLOP *** [4s 7s 8c]
matiko09: checks 
greg dean: checks 
*** TURN *** [4s 7s 8c] [7h]
matiko09: checks 
greg dean: checks 
*** RIVER *** [4s 7s 8c 7h] [3s]
matiko09: checks 
greg dean: checks 
*** SHOW DOWN ***
matiko09: shows [5d 9d] (a pair of Sevens)
greg dean: shows [5h Qh] (a pair of Sevens - Queen kicker)
greg dean collected $1.90 from pot
*** SUMMARY ***
Total pot $2 | Rake $0.10 
Board [4s 7s 8c 7h 3s]
Seat 1: hammerwife folded before Flop (didn't bet)
Seat 2: Yaaaazz folded before Flop (didn't bet)
Seat 3: John_les folded before Flop (didn't bet)
Seat 4: ricksdogs77 folded before Flop (didn't bet)
Seat 5: Ronfar3 (button) folded before Flop (didn't bet)
Seat 8: matiko09 (small blind) showed [5d 9d] and lost with a pair of Sevens
Seat 9: greg dean (big blind) showed [5h Qh] and won ($1.90) with a pair of Sevens





PokerStars Hand #155373799813:  Hold'em No Limit ($0.25/$0.50 USD) - 2016/06/30 8:37:03 CET [2016/06/30 2:37:03 ET]
Table 'Praxidike' 9-max Seat #1 is the button
Seat 1: Sniper1717 ($53.14 in chips) 
Seat 7: matiko09 ($50 in chips) 
Seat 8: Dantist1122 ($51.08 in chips) 
matiko09: posts small blind $0.25
Dantist1122: posts big blind $0.50
*** HOLE CARDS ***
Dealt to matiko09 [9s Qh]
Sniper1717: folds 
matiko09: raises $1 to $1.50
Dantist1122: calls $1
*** FLOP *** [6c 4d Qd]
matiko09: bets $1.85
Dantist1122: calls $1.85
*** TURN *** [6c 4d Qd] [8s]
matiko09: checks 
Dantist1122: checks 
*** RIVER *** [6c 4d Qd 8s] [Jh]
matiko09: bets $3
Dantist1122: calls $3
*** SHOW DOWN ***
matiko09: shows [9s Qh] (a pair of Queens)
Dantist1122: shows [Ah Qc] (a pair of Queens - Ace kicker)
Dantist1122 collected $12.06 from pot
*** SUMMARY ***
Total pot $12.70 | Rake $0.64 
Board [6c 4d Qd 8s Jh]
Seat 1: Sniper1717 (button) folded before Flop (didn't bet)
Seat 7: matiko09 (small blind) showed [9s Qh] and lost with a pair of Queens
Seat 8: Dantist1122 (big blind) showed [Ah Qc] and won ($12.06) with a pair of Queens





PokerStars Hand #155373800801:  Hold'em No Limit ($0.50/$1.00 USD) - 2016/06/30 8:37:07 CET [2016/06/30 2:37:07 ET]
Table 'Gaby' 9-max Seat #2 is the button
Seat 2: ka100pka527 ($47.83 in chips) 
Seat 3: Dantist1122 ($100 in chips) 
Seat 4: arctur17 ($69.57 in chips) 
Seat 5: kalcumite ($123.62 in chips) 
Seat 6: RoadtoNepal ($102.48 in chips) 
Seat 7: stel19 ($28.04 in chips) 
Seat 8: matiko09 ($100 in chips) 
Dantist1122: posts small blind $0.50
arctur17: posts big blind $1
hammerwife: sits out 
flk.Dasas: sits out 
*** HOLE CARDS ***
Dealt to matiko09 [8s Jd]
kalcumite: folds 
RoadtoNepal: folds 
stel19: folds 
matiko09: folds 
ka100pka527: folds 
Dantist1122: raises $1.05 to $2.05
arctur17: raises $6.95 to $9
Dantist1122: folds 
Uncalled bet ($6.95) returned to arctur17
arctur17 collected $4.10 from pot
arctur17: doesn't show hand 
*** SUMMARY ***
Total pot $4.10 | Rake $0 
Seat 2: ka100pka527 (button) folded before Flop (didn't bet)
Seat 3: Dantist1122 (small blind) folded before Flop
Seat 4: arctur17 (big blind) collected ($4.10)
Seat 5: kalcumite folded before Flop (didn't bet)
Seat 6: RoadtoNepal folded before Flop (didn't bet)
Seat 7: stel19 folded before Flop (didn't bet)
Seat 8: matiko09 folded before Flop (didn't bet)





PokerStars Hand #155373811618:  Hold'em No Limit ($0.50/$1.00 USD) - 2016/06/30 8:37:18 CET [2016/06/30 2:37:18 ET]
Table 'Aunus' 9-max Seat #3 is the button
Seat 1: dboy604 ($153.36 in chips) 
Seat 2: HasBigBiceps ($100 in chips) 
Seat 3: matiko09 ($100 in chips) 
Seat 4: ilaviiitech ($100 in chips) 
Seat 5: hammerwife ($114.30 in chips) 
Seat 6: RoadtoNepal ($100 in chips) 
Seat 7: ka100pka527 ($41.50 in chips) 
Seat 8: Dantist1122 ($100 in chips) 
Seat 9: flk.Dasas ($101.50 in chips) 
ilaviiitech: posts small blind $0.50
hammerwife: posts big blind $1
*** HOLE CARDS ***
Dealt to matiko09 [8d Kd]
RoadtoNepal: folds 
ka100pka527: raises $2 to $3
Dantist1122: folds 
flk.Dasas: folds 
dboy604: calls $3
HasBigBiceps: folds 
matiko09: folds 
ilaviiitech: folds 
hammerwife: folds 
*** FLOP *** [Ts Ac 8c]
ka100pka527: bets $3.56
dboy604: calls $3.56
*** TURN *** [Ts Ac 8c] [8h]
ka100pka527: checks 
dboy604: bets $7
ka100pka527: folds 
Uncalled bet ($7) returned to dboy604
dboy604 collected $13.89 from pot
*** SUMMARY ***
Total pot $14.62 | Rake $0.73 
Board [Ts Ac 8c 8h]
Seat 1: dboy604 collected ($13.89)
Seat 2: HasBigBiceps folded before Flop (didn't bet)
Seat 3: matiko09 (button) folded before Flop (didn't bet)
Seat 4: ilaviiitech (small blind) folded before Flop
Seat 5: hammerwife (big blind) folded before Flop
Seat 6: RoadtoNepal folded before Flop (didn't bet)
Seat 7: ka100pka527 folded on the Turn
Seat 8: Dantist1122 folded before Flop (didn't bet)
Seat 9: flk.Dasas folded before Flop (didn't bet)





PokerStars Hand #155373813351:  Hold'em No Limit ($0.50/$1.00 USD) - 2016/06/30 8:37:25 CET [2016/06/30 2:37:25 ET]
Table 'Jarmila' 9-max Seat #4 is the button
Seat 4: Rohitbarve ($38 in chips) 
Seat 5: ilaviiitech ($102 in chips) 
Seat 6: matiko09 ($100 in chips) 
ilaviiitech: posts small blind $0.50
matiko09: posts big blind $1
Bid'daum: sits out 
*** HOLE CARDS ***
Dealt to matiko09 [8s Th]
Rohitbarve: raises $2 to $3
ilaviiitech: folds 
matiko09: folds 
Uncalled bet ($2) returned to Rohitbarve
Rohitbarve collected $2.50 from pot
Rohitbarve: doesn't show hand 
*** SUMMARY ***
Total pot $2.50 | Rake $0 
Seat 4: Rohitbarve (button) collected ($2.50)
Seat 5: ilaviiitech (small blind) folded before Flop
Seat 6: matiko09 (big blind) folded before Flop





PokerStars Hand #155373815435:  Hold'em No Limit ($0.50/$1.00 USD) - 2016/06/30 8:37:34 CET [2016/06/30 2:37:34 ET]
Table 'Barto' 9-max Seat #8 is the button
Seat 1: hammerwife ($114.50 in chips) 
Seat 2: Yaaaazz ($101 in chips) 
Seat 3: John_les ($100 in chips) 
Seat 4: ricksdogs77 ($76.91 in chips) 
Seat 5: Ronfar3 ($100 in chips) 
Seat 8: matiko09 ($147.62 in chips) 
Seat 9: greg dean ($80.90 in chips) 
greg dean: posts small blind $0.50
hammerwife: posts big blind $1
Dantist1122: sits out 
RoadtoNepal: sits out 
*** HOLE CARDS ***
Dealt to matiko09 [9c 6h]
Yaaaazz: folds 
John_les: folds 
ricksdogs77: folds 
Ronfar3: folds 
matiko09: folds 
greg dean: calls $0.50
hammerwife: raises $4 to $5
greg dean: calls $4
*** FLOP *** [5h Jh 4h]
greg dean: checks 
hammerwife: bets $5
greg dean: calls $5
*** TURN *** [5h Jh 4h] [Ts]
greg dean: checks 
hammerwife: checks 
*** RIVER *** [5h Jh 4h Ts] [5s]
greg dean: checks 
hammerwife: checks 
*** SHOW DOWN ***
greg dean: shows [2d 3d] (a pair of Fives)
hammerwife: shows [Qh Ad] (a pair of Fives - Ace kicker)
hammerwife collected $19 from pot
*** SUMMARY ***
Total pot $20 | Rake $1 
Board [5h Jh 4h Ts 5s]
Seat 1: hammerwife (big blind) showed [Qh Ad] and won ($19) with a pair of Fives
Seat 2: Yaaaazz folded before Flop (didn't bet)
Seat 3: John_les folded before Flop (didn't bet)
Seat 4: ricksdogs77 folded before Flop (didn't bet)
Seat 5: Ronfar3 folded before Flop (didn't bet)
Seat 8: matiko09 (button) folded before Flop (didn't bet)
Seat 9: greg dean (small blind) showed [2d 3d] and lost with a pair of Fives





PokerStars Hand #155373815549:  Hold'em No Limit ($0.50/$1.00 USD) - 2016/06/30 8:37:35 CET [2016/06/30 2:37:35 ET]
Table 'Jarmila' 9-max Seat #5 is the button
Seat 4: Rohitbarve ($39.50 in chips) 
Seat 5: ilaviiitech ($101.50 in chips) 
Seat 6: matiko09 ($100 in chips) 
Seat 7: Bid'daum ($80 in chips) 
matiko09: posts small blind $0.50
Bid'daum: posts big blind $1
*** HOLE CARDS ***
Dealt to matiko09 [4c Th]
Rohitbarve: folds 
ilaviiitech: folds 
DIMAN_324 joins the table at seat #8 
matiko09: folds 
Uncalled bet ($0.50) returned to Bid'daum
Bid'daum collected $1 from pot
Bid'daum: doesn't show hand 
*** SUMMARY ***
Total pot $1 | Rake $0 
Seat 4: Rohitbarve folded before Flop (didn't bet)
Seat 5: ilaviiitech (button) folded before Flop (didn't bet)
Seat 6: matiko09 (small blind) folded before Flop
Seat 7: Bid'daum (big blind) collected ($1)





PokerStars Hand #155373815947:  Hold'em No Limit ($0.25/$0.50 USD) - 2016/06/30 8:37:36 CET [2016/06/30 2:37:36 ET]
Table 'Adeona III' 9-max Seat #9 is the button
Seat 1: John_les ($51.56 in chips) 
Seat 2: matiko09 ($50 in chips) 
Seat 3: POTAPENKO700 ($54.37 in chips) 
Seat 4: antwon914 ($85.47 in chips) 
Seat 6: KABAL_ua ($89.84 in chips) 
Seat 7: Sniper1717 ($50.56 in chips) 
Seat 9: ja crisham ($46.87 in chips) 
John_les: posts small blind $0.25
matiko09: posts big blind $0.50
*** HOLE CARDS ***
Dealt to matiko09 [8s 5h]
POTAPENKO700: folds 
antwon914: calls $0.50
KABAL_ua: folds 
Sniper1717: raises $1 to $1.50
ja crisham: calls $1.50
John_les: calls $1.25
matiko09: folds 
antwon914: calls $1
*** FLOP *** [7s 9s 5d]
John_les: checks 
antwon914: checks 
Sniper1717: bets $3.50
ja crisham: folds 
John_les: folds 
antwon914: folds 
Uncalled bet ($3.50) returned to Sniper1717
Sniper1717 collected $6.18 from pot
Sniper1717: doesn't show hand 
*** SUMMARY ***
Total pot $6.50 | Rake $0.32 
Board [7s 9s 5d]
Seat 1: John_les (small blind) folded on the Flop
Seat 2: matiko09 (big blind) folded before Flop
Seat 3: POTAPENKO700 folded before Flop (didn't bet)
Seat 4: antwon914 folded on the Flop
Seat 6: KABAL_ua folded before Flop (didn't bet)
Seat 7: Sniper1717 collected ($6.18)
Seat 9: ja crisham (button) folded on the Flop





PokerStars Hand #155373817811:  Hold'em No Limit ($0.50/$1.00 USD) - 2016/06/30 8:37:44 CET [2016/06/30 2:37:44 ET]
Table 'Jarmila' 9-max Seat #6 is the button
Seat 4: Rohitbarve ($39.50 in chips) 
Seat 5: ilaviiitech ($101.50 in chips) 
Seat 6: matiko09 ($100 in chips) 
Seat 7: Bid'daum ($80.50 in chips) 
Seat 8: DIMAN_324 ($100 in chips) 
Bid'daum: posts small blind $0.50
DIMAN_324: posts big blind $1
*** HOLE CARDS ***
Dealt to matiko09 [2c Jh]
ka100pka527 joins the table at seat #9 
Rohitbarve: folds 
ilaviiitech: folds 
matiko09: folds 
Bid'daum: raises $2 to $3
Ronfar3 joins the table at seat #1 
DIMAN_324: folds 
Uncalled bet ($2) returned to Bid'daum
Bid'daum collected $2 from pot
Bid'daum: doesn't show hand 
*** SUMMARY ***
Total pot $2 | Rake $0 
Seat 4: Rohitbarve folded before Flop (didn't bet)
Seat 5: ilaviiitech folded before Flop (didn't bet)
Seat 6: matiko09 (button) folded before Flop (didn't bet)
Seat 7: Bid'daum (small blind) collected ($2)
Seat 8: DIMAN_324 (big blind) folded before Flop





PokerStars Hand #155373817917:  Hold'em No Limit ($0.25/$0.50 USD) - 2016/06/30 8:37:45 CET [2016/06/30 2:37:45 ET]
Table 'Nuwa' 9-max Seat #7 is the button
Seat 2: Dantist1122 ($90.21 in chips) 
Seat 3: matiko09 ($50 in chips) 
Seat 4: prominente ($50 in chips) 
Seat 5: Sniper1717 ($59.66 in chips) 
Seat 6: KABAL_ua ($120.73 in chips) 
Seat 7: ABLAKETKA ($57.01 in chips) 
Dantist1122: posts small blind $0.25
matiko09: posts big blind $0.50
*** HOLE CARDS ***
Dealt to matiko09 [9d 3h]
prominente: folds 
prominente leaves the table
Sniper1717: folds 
KABAL_ua said, "ncioe bluf :)"
Suitedjaks leaves the table
KABAL_ua: folds 
ABLAKETKA: folds 
Dantist1122: folds 
Uncalled bet ($0.25) returned to matiko09
BlackHawk901 joins the table at seat #4 
matiko09 collected $0.50 from pot
matiko09: doesn't show hand 
*** SUMMARY ***
Total pot $0.50 | Rake $0 
Seat 2: Dantist1122 (small blind) folded before Flop
Seat 3: matiko09 (big blind) collected ($0.50)
Seat 4: prominente folded before Flop (didn't bet)
Seat 5: Sniper1717 folded before Flop (didn't bet)
Seat 6: KABAL_ua folded before Flop (didn't bet)
Seat 7: ABLAKETKA (button) folded before Flop (didn't bet)





PokerStars Hand #155373818565:  Hold'em No Limit ($0.50/$1.00 USD) - 2016/06/30 8:37:47 CET [2016/06/30 2:37:47 ET]
Table 'Lucretia II' 9-max Seat #8 is the button
Seat 1: matiko09 ($209.29 in chips) 
Seat 2: picka4u ($35.25 in chips) 
Seat 3: Alex Frider ($200.79 in chips) 
Seat 4: John_les ($103.75 in chips) 
Seat 5: butcheN18 ($111.45 in chips) 
Seat 6: flk.Dasas ($100 in chips) 
Seat 7: Dantist1122 ($119.97 in chips) 
Seat 8: snow937022 ($100 in chips) 
Seat 9: misko123 ($20.72 in chips) 
misko123: posts small blind $0.50
matiko09: posts big blind $1
*** HOLE CARDS ***
Dealt to matiko09 [9s 6h]
picka4u: raises $1.25 to $2.25
Alex Frider: folds 
John_les: folds 
butcheN18: folds 
flk.Dasas: folds 
Dantist1122: folds 
snow937022: folds 
misko123: calls $1.75
matiko09: folds 
*** FLOP *** [2d 7d Qh]
misko123: checks 
picka4u: bets $3.50
misko123: calls $3.50
*** TURN *** [2d 7d Qh] [8s]
misko123: checks 
picka4u: bets $9
misko123: folds 
Uncalled bet ($9) returned to picka4u
picka4u collected $11.88 from pot
picka4u: doesn't show hand 
*** SUMMARY ***
Total pot $12.50 | Rake $0.62 
Board [2d 7d Qh 8s]
Seat 1: matiko09 (big blind) folded before Flop
Seat 2: picka4u collected ($11.88)
Seat 3: Alex Frider folded before Flop (didn't bet)
Seat 4: John_les folded before Flop (didn't bet)
Seat 5: butcheN18 folded before Flop (didn't bet)
Seat 6: flk.Dasas folded before Flop (didn't bet)
Seat 7: Dantist1122 folded before Flop (didn't bet)
Seat 8: snow937022 (button) folded before Flop (didn't bet)
Seat 9: misko123 (small blind) folded on the Turn





PokerStars Hand #155373819591:  Hold'em No Limit ($0.50/$1.00 USD) - 2016/06/30 8:37:52 CET [2016/06/30 2:37:52 ET]
Table 'Gaby' 9-max Seat #3 is the button
Seat 2: ka100pka527 ($47.83 in chips) 
Seat 3: Dantist1122 ($100 in chips) 
Seat 4: arctur17 ($71.62 in chips) 
Seat 5: kalcumite ($123.62 in chips) 
Seat 6: RoadtoNepal ($102.48 in chips) 
Seat 7: stel19 ($28.04 in chips) 
Seat 8: matiko09 ($100 in chips) 
arctur17: posts small blind $0.50
kalcumite: posts big blind $1
hammerwife: sits out 
flk.Dasas: sits out 
*** HOLE CARDS ***
Dealt to matiko09 [4c 7c]
RoadtoNepal: folds 
stel19: calls $1
matiko09: folds 
ka100pka527: folds 
Dantist1122: raises $4 to $5
arctur17: folds 
kalcumite: calls $4
stel19: calls $4
*** FLOP *** [Qc Th Tc]
kalcumite: checks 
hammerwife is disconnected 
stel19: checks 
Dantist1122: bets $8
kalcumite: folds 
stel19: folds 
Uncalled bet ($8) returned to Dantist1122
Dantist1122 collected $14.72 from pot
Dantist1122: doesn't show hand 
*** SUMMARY ***
Total pot $15.50 | Rake $0.78 
Board [Qc Th Tc]
Seat 2: ka100pka527 folded before Flop (didn't bet)
Seat 3: Dantist1122 (button) collected ($14.72)
Seat 4: arctur17 (small blind) folded before Flop
Seat 5: kalcumite (big blind) folded on the Flop
Seat 6: RoadtoNepal folded before Flop (didn't bet)
Seat 7: stel19 folded on the Flop
Seat 8: matiko09 folded before Flop (didn't bet)





PokerStars Hand #155373820882:  Hold'em No Limit ($0.25/$0.50 USD) - 2016/06/30 8:37:57 CET [2016/06/30 2:37:57 ET]
Table 'Praxidike' 9-max Seat #7 is the button
Seat 1: Sniper1717 ($53.14 in chips) 
Seat 7: matiko09 ($50 in chips) 
Seat 8: Dantist1122 ($56.79 in chips) 
Dantist1122: posts small blind $0.25
Sniper1717: posts big blind $0.50
*** HOLE CARDS ***
Dealt to matiko09 [7c Qd]
matiko09: folds 
Dantist1122: raises $0.52 to $1.02
Sniper1717: calls $0.52
*** FLOP *** [8c Kh Jd]
Dantist1122: bets $1.06
Sniper1717: folds 
Uncalled bet ($1.06) returned to Dantist1122
Dantist1122 collected $1.94 from pot
Dantist1122: doesn't show hand 
*** SUMMARY ***
Total pot $2.04 | Rake $0.10 
Board [8c Kh Jd]
Seat 1: Sniper1717 (big blind) folded on the Flop
Seat 7: matiko09 (button) folded before Flop (didn't bet)
Seat 8: Dantist1122 (small blind) collected ($1.94)





PokerStars Hand #155373822204:  Hold'em No Limit ($0.25/$0.50 USD) - 2016/06/30 8:38:03 CET [2016/06/30 2:38:03 ET]
Table 'Nuwa' 9-max Seat #2 is the button
Seat 2: Dantist1122 ($89.96 in chips) 
Seat 3: matiko09 ($50.25 in chips) 
Seat 4: BlackHawk901 ($50 in chips) 
Seat 5: Sniper1717 ($59.66 in chips) 
Seat 6: KABAL_ua ($120.73 in chips) 
Seat 7: ABLAKETKA ($57.01 in chips) 
matiko09: posts small blind $0.25
BlackHawk901: posts big blind $0.50
*** HOLE CARDS ***
Dealt to matiko09 [5d Jc]
Sniper1717: folds 
KABAL_ua: folds 
ABLAKETKA: folds 
Dantist1122: raises $0.52 to $1.02
matiko09: folds 
POTAPENKO700 joins the table at seat #1 
BlackHawk901: folds 
Uncalled bet ($0.52) returned to Dantist1122
POTAPENKO700 leaves the table
Dantist1122 collected $1.25 from pot
Dantist1122: doesn't show hand 
*** SUMMARY ***
Total pot $1.25 | Rake $0 
Seat 2: Dantist1122 (button) collected ($1.25)
Seat 3: matiko09 (small blind) folded before Flop
Seat 4: BlackHawk901 (big blind) folded before Flop
Seat 5: Sniper1717 folded before Flop (didn't bet)
Seat 6: KABAL_ua folded before Flop (didn't bet)
Seat 7: ABLAKETKA folded before Flop (didn't bet)





PokerStars Hand #155373823034:  Hold'em No Limit ($0.50/$1.00 USD) - 2016/06/30 8:38:06 CET [2016/06/30 2:38:06 ET]
Table 'Jarmila' 9-max Seat #7 is the button
Seat 4: Rohitbarve ($39.50 in chips) 
Seat 5: ilaviiitech ($101.50 in chips) 
Seat 6: matiko09 ($100 in chips) 
Seat 7: Bid'daum ($81.50 in chips) 
Seat 8: DIMAN_324 ($100 in chips) 
Seat 9: ka100pka527 ($40 in chips) 
DIMAN_324: posts small blind $0.50
ka100pka527: posts big blind $1
Ronfar3: sits out 
*** HOLE CARDS ***
Dealt to matiko09 [Kh Jd]
Rohitbarve: folds 
ilaviiitech: folds 
matiko09: raises $1.50 to $2.50
Bid'daum: folds 
DIMAN_324: folds 
ka100pka527: raises $3.50 to $6
AA-man-AA27 joins the table at seat #2 
matiko09: calls $3.50
*** FLOP *** [3d 5d Qh]
Dantist1122 joins the table at seat #3 
ka100pka527: bets $4.94
matiko09: folds 
Uncalled bet ($4.94) returned to ka100pka527
ka100pka527 collected $11.88 from pot
ka100pka527: doesn't show hand 
*** SUMMARY ***
Total pot $12.50 | Rake $0.62 
Board [3d 5d Qh]
Seat 4: Rohitbarve folded before Flop (didn't bet)
Seat 5: ilaviiitech folded before Flop (didn't bet)
Seat 6: matiko09 folded on the Flop
Seat 7: Bid'daum (button) folded before Flop (didn't bet)
Seat 8: DIMAN_324 (small blind) folded before Flop
Seat 9: ka100pka527 (big blind) collected ($11.88)





PokerStars Hand #155373824355:  Hold'em No Limit ($0.50/$1.00 USD) - 2016/06/30 8:38:12 CET [2016/06/30 2:38:12 ET]
Table 'Barto' 9-max Seat #9 is the button
Seat 1: hammerwife ($123.50 in chips) 
Seat 2: Yaaaazz ($101 in chips) 
Seat 3: John_les ($100 in chips) 
Seat 4: ricksdogs77 ($76.91 in chips) 
Seat 5: Ronfar3 ($100 in chips) 
Seat 8: matiko09 ($147.62 in chips) 
Seat 9: greg dean ($70.90 in chips) 
hammerwife: posts small blind $0.50
Yaaaazz: posts big blind $1
Dantist1122: sits out 
RoadtoNepal: sits out 
*** HOLE CARDS ***
Dealt to matiko09 [2h 3s]
John_les: folds 
ricksdogs77: folds 
Ronfar3: folds 
matiko09: folds 
greg dean: raises $5 to $6
hammerwife is disconnected 
hammerwife has timed out while disconnected
hammerwife: folds 
Yaaaazz: folds 
Uncalled bet ($5) returned to greg dean
greg dean collected $2.50 from pot
*** SUMMARY ***
Total pot $2.50 | Rake $0 
Seat 1: hammerwife (small blind) folded before Flop
Seat 2: Yaaaazz (big blind) folded before Flop
Seat 3: John_les folded before Flop (didn't bet)
Seat 4: ricksdogs77 folded before Flop (didn't bet)
Seat 5: Ronfar3 folded before Flop (didn't bet)
Seat 8: matiko09 folded before Flop (didn't bet)
Seat 9: greg dean (button) collected ($2.50)





PokerStars Hand #155373826765:  Hold'em No Limit ($0.50/$1.00 USD) - 2016/06/30 8:38:22 CET [2016/06/30 2:38:22 ET]
Table 'Asmodeus' 9-max Seat #7 is the button
Seat 1: Imbear8 ($106.86 in chips) 
Seat 2: John_les ($163.40 in chips) 
Seat 3: L4zy_FiSh ($127.14 in chips) 
Seat 4: matiko09 ($100 in chips) 
Seat 5: butcheN18 ($121.84 in chips) 
Seat 6: snow937022 ($123.21 in chips) 
Seat 7: picka4u ($40 in chips) 
Seat 9: flk.Dasas ($247.65 in chips) 
flk.Dasas: posts small blind $0.50
Imbear8: posts big blind $1
*** HOLE CARDS ***
Dealt to matiko09 [3d Qh]
John_les: raises $2.50 to $3.50
L4zy_FiSh: folds 
matiko09: folds 
butcheN18: folds 
snow937022: folds 
picka4u: folds 
flk.Dasas: folds 
Imbear8: calls $2.50
*** FLOP *** [Jd 2h Ks]
Imbear8: checks 
John_les: bets $5
Imbear8: calls $5
*** TURN *** [Jd 2h Ks] [Ad]
Imbear8: checks 
John_les: checks 
*** RIVER *** [Jd 2h Ks Ad] [5s]
Imbear8: checks 
John_les: checks 
*** SHOW DOWN ***
Imbear8: shows [Kh 3s] (a pair of Kings)
John_les: mucks hand 
Imbear8 collected $16.62 from pot
*** SUMMARY ***
Total pot $17.50 | Rake $0.88 
Board [Jd 2h Ks Ad 5s]
Seat 1: Imbear8 (big blind) showed [Kh 3s] and won ($16.62) with a pair of Kings
Seat 2: John_les mucked [5c 4c]
Seat 3: L4zy_FiSh folded before Flop (didn't bet)
Seat 4: matiko09 folded before Flop (didn't bet)
Seat 5: butcheN18 folded before Flop (didn't bet)
Seat 6: snow937022 folded before Flop (didn't bet)
Seat 7: picka4u (button) folded before Flop (didn't bet)
Seat 9: flk.Dasas (small blind) folded before Flop





PokerStars Hand #155373829809:  Hold'em No Limit ($0.25/$0.50 USD) - 2016/06/30 8:38:35 CET [2016/06/30 2:38:35 ET]
Table 'Praxidike' 9-max Seat #8 is the button
Seat 1: Sniper1717 ($52.12 in chips) 
Seat 7: matiko09 ($50 in chips) 
Seat 8: Dantist1122 ($57.71 in chips) 
Sniper1717: posts small blind $0.25
nicklasrossd was removed from the table for failing to post
matiko09: posts big blind $0.50
*** HOLE CARDS ***
Dealt to matiko09 [Ts 5h]
Dantist1122: folds 
Sniper1717: calls $0.25
matiko09: checks 
*** FLOP *** [2h 9d 6s]
Sniper1717: bets $1
matiko09: folds 
Uncalled bet ($1) returned to Sniper1717
Sniper1717 collected $0.95 from pot
Sniper1717: doesn't show hand 
*** SUMMARY ***
Total pot $1 | Rake $0.05 
Board [2h 9d 6s]
Seat 1: Sniper1717 (small blind) collected ($0.95)
Seat 7: matiko09 (big blind) folded on the Flop
Seat 8: Dantist1122 (button) folded before Flop (didn't bet)





PokerStars Hand #155373830668:  Hold'em No Limit ($0.50/$1.00 USD) - 2016/06/30 8:38:38 CET [2016/06/30 2:38:38 ET]
Table 'Aunus' 9-max Seat #4 is the button
Seat 1: dboy604 ($160.69 in chips) 
Seat 2: HasBigBiceps ($100 in chips) 
Seat 3: matiko09 ($100 in chips) 
Seat 4: ilaviiitech ($100 in chips) 
Seat 6: RoadtoNepal ($100 in chips) 
Seat 7: ka100pka527 ($40 in chips) 
Seat 8: Dantist1122 ($100 in chips) 
Seat 9: flk.Dasas ($101.50 in chips) 
hammerwife is disconnected 
hammerwife has timed out while disconnected
hammerwife: is sitting out 
RoadtoNepal: posts small blind $0.50
ka100pka527: posts big blind $1
*** HOLE CARDS ***
Dealt to matiko09 [Qh 2d]
Dantist1122: folds 
flk.Dasas: folds 
dboy604: folds 
HasBigBiceps: folds 
matiko09: folds 
ilaviiitech: folds 
RoadtoNepal: raises $2 to $3
ka100pka527: folds 
Uncalled bet ($2) returned to RoadtoNepal
RoadtoNepal collected $2 from pot
*** SUMMARY ***
Total pot $2 | Rake $0 
Seat 1: dboy604 folded before Flop (didn't bet)
Seat 2: HasBigBiceps folded before Flop (didn't bet)
Seat 3: matiko09 folded before Flop (didn't bet)
Seat 4: ilaviiitech (button) folded before Flop (didn't bet)
Seat 6: RoadtoNepal (small blind) collected ($2)
Seat 7: ka100pka527 (big blind) folded before Flop
Seat 8: Dantist1122 folded before Flop (didn't bet)
Seat 9: flk.Dasas folded before Flop (didn't bet)





PokerStars Hand #155373830919:  Hold'em No Limit ($0.25/$0.50 USD) - 2016/06/30 8:38:39 CET [2016/06/30 2:38:39 ET]
Table 'Nuwa' 9-max Seat #3 is the button
Seat 2: Dantist1122 ($90.71 in chips) 
Seat 3: matiko09 ($50 in chips) 
Seat 4: BlackHawk901 ($50 in chips) 
Seat 5: Sniper1717 ($59.66 in chips) 
Seat 6: KABAL_ua ($120.73 in chips) 
Seat 7: ABLAKETKA ($57.01 in chips) 
BlackHawk901: posts small blind $0.25
Sniper1717: posts big blind $0.50
*** HOLE CARDS ***
Dealt to matiko09 [7d 6s]
KABAL_ua: folds 
ABLAKETKA: folds 
Dantist1122: folds 
matiko09: folds 
BlackHawk901: raises $1 to $1.50
Sniper1717: calls $1
*** FLOP *** [5s 2d Ah]
BlackHawk901: checks 
Sniper1717: bets $1.50
BlackHawk901: folds 
Uncalled bet ($1.50) returned to Sniper1717
Sniper1717 collected $2.85 from pot
Sniper1717: doesn't show hand 
*** SUMMARY ***
Total pot $3 | Rake $0.15 
Board [5s 2d Ah]
Seat 2: Dantist1122 folded before Flop (didn't bet)
Seat 3: matiko09 (button) folded before Flop (didn't bet)
Seat 4: BlackHawk901 (small blind) folded on the Flop
Seat 5: Sniper1717 (big blind) collected ($2.85)
Seat 6: KABAL_ua folded before Flop (didn't bet)
Seat 7: ABLAKETKA folded before Flop (didn't bet)





PokerStars Hand #155373833342:  Hold'em No Limit ($0.25/$0.50 USD) - 2016/06/30 8:38:49 CET [2016/06/30 2:38:49 ET]
Table 'Adeona III' 9-max Seat #1 is the button
Seat 1: John_les ($50.06 in chips) 
Seat 2: matiko09 ($50 in chips) 
Seat 3: POTAPENKO700 ($54.37 in chips) 
Seat 4: antwon914 ($83.97 in chips) 
Seat 6: KABAL_ua ($89.84 in chips) 
Seat 7: Sniper1717 ($55.24 in chips) 
Seat 9: ja crisham ($45.37 in chips) 
matiko09: posts small blind $0.25
POTAPENKO700: posts big blind $0.50
*** HOLE CARDS ***
Dealt to matiko09 [3d Ah]
antwon914: folds 
KABAL_ua: folds 
Sniper1717: folds 
ja crisham: calls $0.50
John_les: folds 
matiko09: calls $0.25
POTAPENKO700: checks 
*** FLOP *** [6s 5d 8c]
matiko09: checks 
POTAPENKO700: checks 
ja crisham: bets $1
matiko09: folds 
POTAPENKO700: folds 
Uncalled bet ($1) returned to ja crisham
ja crisham collected $1.42 from pot
ja crisham: doesn't show hand 
*** SUMMARY ***
Total pot $1.50 | Rake $0.08 
Board [6s 5d 8c]
Seat 1: John_les (button) folded before Flop (didn't bet)
Seat 2: matiko09 (small blind) folded on the Flop
Seat 3: POTAPENKO700 (big blind) folded on the Flop
Seat 4: antwon914 folded before Flop (didn't bet)
Seat 6: KABAL_ua folded before Flop (didn't bet)
Seat 7: Sniper1717 folded before Flop (didn't bet)
Seat 9: ja crisham collected ($1.42)





PokerStars Hand #155373835578:  Hold'em No Limit ($0.50/$1.00 USD) - 2016/06/30 8:38:59 CET [2016/06/30 2:38:59 ET]
Table 'Lucretia II' 9-max Seat #9 is the button
Seat 1: matiko09 ($208.29 in chips) 
Seat 2: picka4u ($41.38 in chips) 
Seat 3: Alex Frider ($200.79 in chips) 
Seat 4: John_les ($103.75 in chips) 
Seat 5: butcheN18 ($111.45 in chips) 
Seat 6: flk.Dasas ($100 in chips) 
Seat 7: Dantist1122 ($119.97 in chips) 
Seat 8: snow937022 ($100 in chips) 
Seat 9: misko123 ($14.97 in chips) 
matiko09: posts small blind $0.50
picka4u: posts big blind $1
*** HOLE CARDS ***
Dealt to matiko09 [5d 3d]
Alex Frider: folds 
John_les: folds 
butcheN18: folds 
flk.Dasas: folds 
Dantist1122: folds 
snow937022: folds 
misko123: folds 
matiko09: folds 
Uncalled bet ($0.50) returned to picka4u
picka4u collected $1 from pot
picka4u: doesn't show hand 
*** SUMMARY ***
Total pot $1 | Rake $0 
Seat 1: matiko09 (small blind) folded before Flop
Seat 2: picka4u (big blind) collected ($1)
Seat 3: Alex Frider folded before Flop (didn't bet)
Seat 4: John_les folded before Flop (didn't bet)
Seat 5: butcheN18 folded before Flop (didn't bet)
Seat 6: flk.Dasas folded before Flop (didn't bet)
Seat 7: Dantist1122 folded before Flop (didn't bet)
Seat 8: snow937022 folded before Flop (didn't bet)
Seat 9: misko123 (button) folded before Flop (didn't bet)





PokerStars Hand #155373839155:  Hold'em No Limit ($0.50/$1.00 USD) - 2016/06/30 8:39:14 CET [2016/06/30 2:39:14 ET]
Table 'Jarmila' 9-max Seat #8 is the button
Seat 1: Ronfar3 ($100 in chips) 
Seat 2: AA-man-AA27 ($55.63 in chips) 
Seat 4: Rohitbarve ($39.50 in chips) 
Seat 5: ilaviiitech ($101.50 in chips) 
Seat 6: matiko09 ($100 in chips) 
Seat 7: Bid'daum ($81.50 in chips) 
Seat 8: DIMAN_324 ($100 in chips) 
Seat 9: ka100pka527 ($45.88 in chips) 
ka100pka527: posts small blind $0.50
Ronfar3: posts big blind $1
AA-man-AA27: posts big blind $1
Dantist1122: sits out 
*** HOLE CARDS ***
Dealt to matiko09 [9c Tc]
AA-man-AA27: checks 
Rohitbarve: folds 
ilaviiitech: folds 
matiko09: raises $3 to $4
Bid'daum: calls $4
DIMAN_324: raises $11.50 to $15.50
ka100pka527: folds 
Ronfar3: folds 
AA-man-AA27: folds 
matiko09: folds 
Bid'daum: calls $11.50
*** FLOP *** [2d Qh 8d]
Bid'daum: checks 
DIMAN_324: bets $14.50
Bid'daum: folds 
Uncalled bet ($14.50) returned to DIMAN_324
DIMAN_324 collected $35.62 from pot
DIMAN_324: doesn't show hand 
*** SUMMARY ***
Total pot $37.50 | Rake $1.88 
Board [2d Qh 8d]
Seat 1: Ronfar3 (big blind) folded before Flop
Seat 2: AA-man-AA27 folded before Flop
Seat 4: Rohitbarve folded before Flop (didn't bet)
Seat 5: ilaviiitech folded before Flop (didn't bet)
Seat 6: matiko09 folded before Flop
Seat 7: Bid'daum folded on the Flop
Seat 8: DIMAN_324 (button) collected ($35.62)
Seat 9: ka100pka527 (small blind) folded before Flop





PokerStars Hand #155373839644:  Hold'em No Limit ($0.50/$1.00 USD) - 2016/06/30 8:39:16 CET [2016/06/30 2:39:16 ET]
Table 'Asmodeus' 9-max Seat #9 is the button
Seat 1: Imbear8 ($114.98 in chips) 
Seat 2: John_les ($154.90 in chips) 
Seat 3: L4zy_FiSh ($127.14 in chips) 
Seat 4: matiko09 ($100 in chips) 
Seat 5: butcheN18 ($121.84 in chips) 
Seat 6: snow937022 ($123.21 in chips) 
Seat 7: picka4u ($40 in chips) 
Seat 9: flk.Dasas ($247.15 in chips) 
Imbear8: posts small blind $0.50
John_les: posts big blind $1
*** HOLE CARDS ***
Dealt to matiko09 [Tc Ks]
L4zy_FiSh: folds 
matiko09: folds 
butcheN18: folds 
snow937022: raises $1.25 to $2.25
picka4u: folds 
flk.Dasas: folds 
Imbear8: folds 
John_les: folds 
Uncalled bet ($1.25) returned to snow937022
snow937022 collected $2.50 from pot
snow937022: doesn't show hand 
*** SUMMARY ***
Total pot $2.50 | Rake $0 
Seat 1: Imbear8 (small blind) folded before Flop
Seat 2: John_les (big blind) folded before Flop
Seat 3: L4zy_FiSh folded before Flop (didn't bet)
Seat 4: matiko09 folded before Flop (didn't bet)
Seat 5: butcheN18 folded before Flop (didn't bet)
Seat 6: snow937022 collected ($2.50)
Seat 7: picka4u folded before Flop (didn't bet)
Seat 9: flk.Dasas (button) folded before Flop (didn't bet)





PokerStars Hand #155373840027:  Hold'em No Limit ($0.50/$1.00 USD) - 2016/06/30 8:39:18 CET [2016/06/30 2:39:18 ET]
Table 'Barto' 9-max Seat #2 is the button
Seat 2: Yaaaazz ($100 in chips) 
Seat 3: John_les ($100 in chips) 
Seat 4: ricksdogs77 ($76.91 in chips) 
Seat 5: Ronfar3 ($100 in chips) 
Seat 8: matiko09 ($147.62 in chips) 
Seat 9: greg dean ($72.40 in chips) 
John_les: posts small blind $0.50
ricksdogs77: posts big blind $1
Dantist1122: sits out 
RoadtoNepal: sits out 
*** HOLE CARDS ***
Dealt to matiko09 [8d Jh]
Ronfar3: folds 
matiko09: folds 
greg dean: calls $1
Yaaaazz: raises $2 to $3
John_les: raises $8 to $11
ricksdogs77: folds 
greg dean: folds 
Yaaaazz: calls $8
*** FLOP *** [9c 9h Ks]
John_les: checks 
Yaaaazz: bets $7.06
ricksdogs77 is disconnected 
John_les: calls $7.06
*** TURN *** [9c 9h Ks] [5d]
John_les: checks 
Yaaaazz: bets $11.22
John_les: folds 
Uncalled bet ($11.22) returned to Yaaaazz
Yaaaazz collected $36.21 from pot
*** SUMMARY ***
Total pot $38.12 | Rake $1.91 
Board [9c 9h Ks 5d]
Seat 2: Yaaaazz (button) collected ($36.21)
Seat 3: John_les (small blind) folded on the Turn
Seat 4: ricksdogs77 (big blind) folded before Flop
Seat 5: Ronfar3 folded before Flop (didn't bet)
Seat 8: matiko09 folded before Flop (didn't bet)
Seat 9: greg dean folded before Flop





PokerStars Hand #155373840501:  Hold'em No Limit ($0.25/$0.50 USD) - 2016/06/30 8:39:20 CET [2016/06/30 2:39:20 ET]
Table 'Nuwa' 9-max Seat #4 is the button
Seat 2: Dantist1122 ($90.71 in chips) 
Seat 3: matiko09 ($50 in chips) 
Seat 4: BlackHawk901 ($50 in chips) 
Seat 5: Sniper1717 ($61.01 in chips) 
Seat 6: KABAL_ua ($120.73 in chips) 
Seat 7: ABLAKETKA ($57.01 in chips) 
Sniper1717: posts small blind $0.25
KABAL_ua: posts big blind $0.50
*** HOLE CARDS ***
Dealt to matiko09 [5d Kh]
ABLAKETKA: folds 
Dantist1122: folds 
matiko09: folds 
BlackHawk901: raises $0.75 to $1.25
Sniper1717: folds 
KABAL_ua: folds 
Uncalled bet ($0.75) returned to BlackHawk901
BlackHawk901 collected $1.25 from pot
BlackHawk901: doesn't show hand 
*** SUMMARY ***
Total pot $1.25 | Rake $0 
Seat 2: Dantist1122 folded before Flop (didn't bet)
Seat 3: matiko09 folded before Flop (didn't bet)
Seat 4: BlackHawk901 (button) collected ($1.25)
Seat 5: Sniper1717 (small blind) folded before Flop
Seat 6: KABAL_ua (big blind) folded before Flop
Seat 7: ABLAKETKA folded before Flop (didn't bet)





PokerStars Hand #155373840683:  Hold'em No Limit ($0.50/$1.00 USD) - 2016/06/30 8:39:20 CET [2016/06/30 2:39:20 ET]
Table 'Gaby' 9-max Seat #4 is the button
Seat 2: ka100pka527 ($47.83 in chips) 
Seat 3: Dantist1122 ($109.72 in chips) 
Seat 4: arctur17 ($71.12 in chips) 
Seat 5: kalcumite ($118.62 in chips) 
Seat 6: RoadtoNepal ($102.48 in chips) 
Seat 7: stel19 ($23.04 in chips) 
Seat 8: matiko09 ($100 in chips) 
kalcumite: posts small blind $0.50
RoadtoNepal: posts big blind $1
hammerwife is connected 
hammerwife: sits out 
flk.Dasas: sits out 
*** HOLE CARDS ***
Dealt to matiko09 [Qd 7s]
stel19: folds 
matiko09: folds 
ka100pka527: folds 
Dantist1122: folds 
arctur17: folds 
kalcumite: raises $2 to $3
RoadtoNepal: folds 
Uncalled bet ($2) returned to kalcumite
kalcumite collected $2 from pot
kalcumite: doesn't show hand 
*** SUMMARY ***
Total pot $2 | Rake $0 
Seat 2: ka100pka527 folded before Flop (didn't bet)
Seat 3: Dantist1122 folded before Flop (didn't bet)
Seat 4: arctur17 (button) folded before Flop (didn't bet)
Seat 5: kalcumite (small blind) collected ($2)
Seat 6: RoadtoNepal (big blind) folded before Flop
Seat 7: stel19 folded before Flop (didn't bet)
Seat 8: matiko09 folded before Flop (didn't bet)





PokerStars Hand #155373841486:  Hold'em No Limit ($0.50/$1.00 USD) - 2016/06/30 8:39:24 CET [2016/06/30 2:39:24 ET]
Table 'Lucretia II' 9-max Seat #1 is the button
Seat 1: matiko09 ($207.79 in chips) 
Seat 2: picka4u ($41.88 in chips) 
Seat 3: Alex Frider ($200.79 in chips) 
Seat 4: John_les ($103.75 in chips) 
Seat 5: butcheN18 ($111.45 in chips) 
Seat 6: flk.Dasas ($100 in chips) 
Seat 7: Dantist1122 ($119.97 in chips) 
Seat 8: snow937022 ($100 in chips) 
Seat 9: misko123 ($14.97 in chips) 
picka4u: posts small blind $0.50
Alex Frider: posts big blind $1
*** HOLE CARDS ***
Dealt to matiko09 [7s 8s]
John_les: folds 
butcheN18: folds 
flk.Dasas: folds 
Dantist1122: folds 
snow937022: folds 
misko123: calls $1
matiko09: folds 
picka4u: raises $3 to $4
Alex Frider: folds 
misko123: calls $3
*** FLOP *** [4c 2d 9d]
picka4u: bets $6
misko123: raises $4.97 to $10.97 and is all-in
picka4u: calls $4.97
*** TURN *** [4c 2d 9d] [Jd]
*** RIVER *** [4c 2d 9d Jd] [4h]
*** SHOW DOWN ***
picka4u: shows [9c Kc] (two pair, Nines and Fours)
misko123: shows [2c As] (two pair, Fours and Deuces)
picka4u collected $29.39 from pot
*** SUMMARY ***
Total pot $30.94 | Rake $1.55 
Board [4c 2d 9d Jd 4h]
Seat 1: matiko09 (button) folded before Flop (didn't bet)
Seat 2: picka4u (small blind) showed [9c Kc] and won ($29.39) with two pair, Nines and Fours
Seat 3: Alex Frider (big blind) folded before Flop
Seat 4: John_les folded before Flop (didn't bet)
Seat 5: butcheN18 folded before Flop (didn't bet)
Seat 6: flk.Dasas folded before Flop (didn't bet)
Seat 7: Dantist1122 folded before Flop (didn't bet)
Seat 8: snow937022 folded before Flop (didn't bet)
Seat 9: misko123 showed [2c As] and lost with two pair, Fours and Deuces





PokerStars Hand #155373844136:  Hold'em No Limit ($0.50/$1.00 USD) - 2016/06/30 8:39:35 CET [2016/06/30 2:39:35 ET]
Table 'Asmodeus' 9-max Seat #1 is the button
Seat 1: Imbear8 ($114.48 in chips) 
Seat 2: John_les ($153.90 in chips) 
Seat 3: L4zy_FiSh ($127.14 in chips) 
Seat 4: matiko09 ($100 in chips) 
Seat 5: butcheN18 ($121.84 in chips) 
Seat 6: snow937022 ($124.71 in chips) 
Seat 7: picka4u ($40 in chips) 
Seat 9: flk.Dasas ($247.15 in chips) 
John_les: posts small blind $0.50
L4zy_FiSh: posts big blind $1
*** HOLE CARDS ***
Dealt to matiko09 [5h 9c]
matiko09: folds 
butcheN18: folds 
snow937022: folds 
RoadtoNepal leaves the table
picka4u: folds 
flk.Dasas: folds 
Imbear8: folds 
John_les: folds 
Uncalled bet ($0.50) returned to L4zy_FiSh
Alex Frider joins the table at seat #8 
L4zy_FiSh collected $1 from pot
*** SUMMARY ***
Total pot $1 | Rake $0 
Seat 1: Imbear8 (button) folded before Flop (didn't bet)
Seat 2: John_les (small blind) folded before Flop
Seat 3: L4zy_FiSh (big blind) collected ($1)
Seat 4: matiko09 folded before Flop (didn't bet)
Seat 5: butcheN18 folded before Flop (didn't bet)
Seat 6: snow937022 folded before Flop (didn't bet)
Seat 7: picka4u folded before Flop (didn't bet)
Seat 9: flk.Dasas folded before Flop (didn't bet)





PokerStars Hand #155373845922:  Hold'em No Limit ($0.50/$1.00 USD) - 2016/06/30 8:39:43 CET [2016/06/30 2:39:43 ET]
Table 'Aunus' 9-max Seat #6 is the button
Seat 1: dboy604 ($160.69 in chips) 
Seat 2: HasBigBiceps ($100 in chips) 
Seat 3: matiko09 ($100 in chips) 
Seat 4: ilaviiitech ($100 in chips) 
Seat 6: RoadtoNepal ($101 in chips) 
Seat 7: ka100pka527 ($39 in chips) 
Seat 8: Dantist1122 ($100 in chips) 
Seat 9: flk.Dasas ($101.50 in chips) 
ka100pka527: posts small blind $0.50
Dantist1122: posts big blind $1
hammerwife: sits out 
*** HOLE CARDS ***
Dealt to matiko09 [7d Ah]
flk.Dasas: folds 
dboy604: folds 
HasBigBiceps: raises $2 to $3
matiko09: folds 
ilaviiitech: folds 
RoadtoNepal: folds 
ka100pka527: folds 
Dantist1122: raises $6 to $9
HasBigBiceps: calls $6
*** FLOP *** [Jc Th Jh]
Dantist1122: bets $9.66
HasBigBiceps: calls $9.66
*** TURN *** [Jc Th Jh] [Ac]
Dantist1122: checks 
HasBigBiceps: checks 
*** RIVER *** [Jc Th Jh Ac] [2d]
Dantist1122: checks 
HasBigBiceps: bets $18.68
Dantist1122: folds 
Uncalled bet ($18.68) returned to HasBigBiceps
HasBigBiceps collected $35.93 from pot
HasBigBiceps: doesn't show hand 
*** SUMMARY ***
Total pot $37.82 | Rake $1.89 
Board [Jc Th Jh Ac 2d]
Seat 1: dboy604 folded before Flop (didn't bet)
Seat 2: HasBigBiceps collected ($35.93)
Seat 3: matiko09 folded before Flop (didn't bet)
Seat 4: ilaviiitech folded before Flop (didn't bet)
Seat 6: RoadtoNepal (button) folded before Flop (didn't bet)
Seat 7: ka100pka527 (small blind) folded before Flop
Seat 8: Dantist1122 (big blind) folded on the River
Seat 9: flk.Dasas folded before Flop (didn't bet)





PokerStars Hand #155373845934:  Hold'em No Limit ($0.25/$0.50 USD) - 2016/06/30 8:39:43 CET [2016/06/30 2:39:43 ET]
Table 'Adeona III' 9-max Seat #2 is the button
Seat 1: John_les ($50.06 in chips) 
Seat 2: matiko09 ($50 in chips) 
Seat 3: POTAPENKO700 ($53.87 in chips) 
Seat 4: antwon914 ($83.97 in chips) 
Seat 6: KABAL_ua ($89.84 in chips) 
Seat 7: Sniper1717 ($55.24 in chips) 
Seat 9: ja crisham ($46.29 in chips) 
POTAPENKO700: posts small blind $0.25
antwon914: posts big blind $0.50
*** HOLE CARDS ***
Dealt to matiko09 [9c Ah]
KABAL_ua: folds 
Sniper1717: folds 
ja crisham: raises $1 to $1.50
John_les: folds 
matiko09: folds 
POTAPENKO700: folds 
antwon914: folds 
Uncalled bet ($1) returned to ja crisham
ja crisham collected $1.25 from pot
ja crisham: doesn't show hand 
*** SUMMARY ***
Total pot $1.25 | Rake $0 
Seat 1: John_les folded before Flop (didn't bet)
Seat 2: matiko09 (button) folded before Flop (didn't bet)
Seat 3: POTAPENKO700 (small blind) folded before Flop
Seat 4: antwon914 (big blind) folded before Flop
Seat 6: KABAL_ua folded before Flop (didn't bet)
Seat 7: Sniper1717 folded before Flop (didn't bet)
Seat 9: ja crisham collected ($1.25)





PokerStars Hand #155373846407:  Hold'em No Limit ($0.25/$0.50 USD) - 2016/06/30 8:39:45 CET [2016/06/30 2:39:45 ET]
Table 'Nuwa' 9-max Seat #5 is the button
Seat 2: Dantist1122 ($90.71 in chips) 
Seat 3: matiko09 ($50 in chips) 
Seat 4: BlackHawk901 ($50.75 in chips) 
Seat 5: Sniper1717 ($60.76 in chips) 
Seat 6: KABAL_ua ($120.23 in chips) 
Seat 7: ABLAKETKA ($57.01 in chips) 
KABAL_ua: posts small blind $0.25
ABLAKETKA: posts big blind $0.50
*** HOLE CARDS ***
Dealt to matiko09 [4c As]
Dantist1122: folds 
matiko09: folds 
BlackHawk901: raises $0.75 to $1.25
Sniper1717: folds 
KABAL_ua: folds 
ABLAKETKA: calls $0.75
*** FLOP *** [3s 8c Jc]
ABLAKETKA: checks 
BlackHawk901: bets $1.50
ABLAKETKA: calls $1.50
*** TURN *** [3s 8c Jc] [4s]
ABLAKETKA: checks 
BlackHawk901: checks 
*** RIVER *** [3s 8c Jc 4s] [Jd]
ABLAKETKA: bets $2.73
BlackHawk901: folds 
Uncalled bet ($2.73) returned to ABLAKETKA
ABLAKETKA collected $5.46 from pot
ABLAKETKA: doesn't show hand 
*** SUMMARY ***
Total pot $5.75 | Rake $0.29 
Board [3s 8c Jc 4s Jd]
Seat 2: Dantist1122 folded before Flop (didn't bet)
Seat 3: matiko09 folded before Flop (didn't bet)
Seat 4: BlackHawk901 folded on the River
Seat 5: Sniper1717 (button) folded before Flop (didn't bet)
Seat 6: KABAL_ua (small blind) folded before Flop
Seat 7: ABLAKETKA (big blind) collected ($5.46)





PokerStars Hand #155373847930:  Hold'em No Limit ($0.50/$1.00 USD) - 2016/06/30 8:39:52 CET [2016/06/30 2:39:52 ET]
Table 'Gaby' 9-max Seat #5 is the button
Seat 2: ka100pka527 ($47.83 in chips) 
Seat 3: Dantist1122 ($109.72 in chips) 
Seat 4: arctur17 ($71.12 in chips) 
Seat 5: kalcumite ($119.62 in chips) 
Seat 6: RoadtoNepal ($101.48 in chips) 
Seat 7: stel19 ($23.04 in chips) 
Seat 8: matiko09 ($100 in chips) 
RoadtoNepal: posts small blind $0.50
stel19: posts big blind $1
hammerwife: sits out 
flk.Dasas: sits out 
*** HOLE CARDS ***
Dealt to matiko09 [6d Qs]
matiko09: folds 
ka100pka527: folds 
Dantist1122: folds 
arctur17: folds 
kalcumite: folds 
RoadtoNepal: folds 
Uncalled bet ($0.50) returned to stel19
stel19 collected $1 from pot
stel19: doesn't show hand 
*** SUMMARY ***
Total pot $1 | Rake $0 
Seat 2: ka100pka527 folded before Flop (didn't bet)
Seat 3: Dantist1122 folded before Flop (didn't bet)
Seat 4: arctur17 folded before Flop (didn't bet)
Seat 5: kalcumite (button) folded before Flop (didn't bet)
Seat 6: RoadtoNepal (small blind) folded before Flop
Seat 7: stel19 (big blind) collected ($1)
Seat 8: matiko09 folded before Flop (didn't bet)





PokerStars Hand #155373849654:  Hold'em No Limit ($0.50/$1.00 USD) - 2016/06/30 8:39:59 CET [2016/06/30 2:39:59 ET]
Table 'Asmodeus' 9-max Seat #2 is the button
Seat 1: Imbear8 ($114.48 in chips) 
Seat 2: John_les ($153.40 in chips) 
Seat 3: L4zy_FiSh ($127.64 in chips) 
Seat 4: matiko09 ($100 in chips) 
Seat 5: butcheN18 ($121.84 in chips) 
Seat 6: snow937022 ($124.71 in chips) 
Seat 7: picka4u ($40 in chips) 
Seat 9: flk.Dasas ($247.15 in chips) 
L4zy_FiSh: posts small blind $0.50
matiko09: posts big blind $1
Alex Frider: is sitting out 
Alex Frider leaves the table
*** HOLE CARDS ***
Dealt to matiko09 [6s Js]
ka100pka527 joins the table at seat #8 
butcheN18: folds 
snow937022: raises $1.25 to $2.25
picka4u: folds 
flk.Dasas: folds 
Imbear8: folds 
John_les: folds 
L4zy_FiSh: folds 
matiko09: folds 
Uncalled bet ($1.25) returned to snow937022
snow937022 collected $2.50 from pot
snow937022: doesn't show hand 
*** SUMMARY ***
Total pot $2.50 | Rake $0 
Seat 1: Imbear8 folded before Flop (didn't bet)
Seat 2: John_les (button) folded before Flop (didn't bet)
Seat 3: L4zy_FiSh (small blind) folded before Flop
Seat 4: matiko09 (big blind) folded before Flop
Seat 5: butcheN18 folded before Flop (didn't bet)
Seat 6: snow937022 collected ($2.50)
Seat 7: picka4u folded before Flop (didn't bet)
Seat 9: flk.Dasas folded before Flop (didn't bet)





PokerStars Hand #155373851657:  Hold'em No Limit ($0.25/$0.50 USD) - 2016/06/30 8:40:07 CET [2016/06/30 2:40:07 ET]
Table 'Adeona III' 9-max Seat #3 is the button
Seat 1: John_les ($50.06 in chips) 
Seat 2: matiko09 ($50 in chips) 
Seat 3: POTAPENKO700 ($53.62 in chips) 
Seat 4: antwon914 ($83.47 in chips) 
Seat 6: KABAL_ua ($89.84 in chips) 
Seat 7: Sniper1717 ($55.24 in chips) 
Seat 9: ja crisham ($47.04 in chips) 
antwon914: posts small blind $0.25
KABAL_ua: posts big blind $0.50
*** HOLE CARDS ***
Dealt to matiko09 [8c Tc]
Sniper1717: folds 
ja crisham: folds 
John_les: folds 
matiko09: raises $0.75 to $1.25
POTAPENKO700: raises $3.25 to $4.50
antwon914: folds 
KABAL_ua: folds 
matiko09: folds 
Uncalled bet ($3.25) returned to POTAPENKO700
POTAPENKO700 collected $3.25 from pot
POTAPENKO700: doesn't show hand 
*** SUMMARY ***
Total pot $3.25 | Rake $0 
Seat 1: John_les folded before Flop (didn't bet)
Seat 2: matiko09 folded before Flop
Seat 3: POTAPENKO700 (button) collected ($3.25)
Seat 4: antwon914 (small blind) folded before Flop
Seat 6: KABAL_ua (big blind) folded before Flop
Seat 7: Sniper1717 folded before Flop (didn't bet)
Seat 9: ja crisham folded before Flop (didn't bet)





PokerStars Hand #155373852549:  Hold'em No Limit ($0.50/$1.00 USD) - 2016/06/30 8:40:11 CET [2016/06/30 2:40:11 ET]
Table 'Jarmila' 9-max Seat #9 is the button
Seat 1: Ronfar3 ($100 in chips) 
Seat 2: AA-man-AA27 ($54.63 in chips) 
Seat 4: Rohitbarve ($39.50 in chips) 
Seat 5: ilaviiitech ($101.50 in chips) 
Seat 6: matiko09 ($100 in chips) 
Seat 7: Bid'daum ($80.93 in chips) 
Seat 8: DIMAN_324 ($120.12 in chips) 
Seat 9: ka100pka527 ($45.38 in chips) 
Ronfar3: posts small blind $0.50
AA-man-AA27: posts big blind $1
Dantist1122: sits out 
*** HOLE CARDS ***
Dealt to matiko09 [8c 6h]
Rohitbarve: raises $2 to $3
ilaviiitech: folds 
matiko09: folds 
Bid'daum: folds 
DIMAN_324: folds 
ka100pka527: folds 
Ronfar3: folds 
AA-man-AA27: calls $2
*** FLOP *** [7h 5s 2d]
AA-man-AA27: bets $1
Rohitbarve: raises $5 to $6
AA-man-AA27: folds 
Uncalled bet ($5) returned to Rohitbarve
Rohitbarve collected $8.08 from pot
*** SUMMARY ***
Total pot $8.50 | Rake $0.42 
Board [7h 5s 2d]
Seat 1: Ronfar3 (small blind) folded before Flop
Seat 2: AA-man-AA27 (big blind) folded on the Flop
Seat 4: Rohitbarve collected ($8.08)
Seat 5: ilaviiitech folded before Flop (didn't bet)
Seat 6: matiko09 folded before Flop (didn't bet)
Seat 7: Bid'daum folded before Flop (didn't bet)
Seat 8: DIMAN_324 folded before Flop (didn't bet)
Seat 9: ka100pka527 (button) folded before Flop (didn't bet)





PokerStars Hand #155373852790:  Hold'em No Limit ($0.50/$1.00 USD) - 2016/06/30 8:40:12 CET [2016/06/30 2:40:12 ET]
Table 'Lucretia II' 9-max Seat #2 is the button
Seat 1: matiko09 ($207.79 in chips) 
Seat 2: picka4u ($56.30 in chips) 
Seat 3: Alex Frider ($199.79 in chips) 
Seat 4: John_les ($103.75 in chips) 
Seat 5: butcheN18 ($111.45 in chips) 
Seat 6: flk.Dasas ($100 in chips) 
Seat 7: Dantist1122 ($119.97 in chips) 
Seat 8: snow937022 ($100 in chips) 
Alex Frider: posts small blind $0.50
John_les: posts big blind $1
*** HOLE CARDS ***
Dealt to matiko09 [6c Jh]
butcheN18: folds 
flk.Dasas: folds 
Dantist1122: folds 
snow937022: folds 
matiko09: folds 
picka4u: folds 
Alex Frider: folds 
Uncalled bet ($0.50) returned to John_les
John_les collected $1 from pot
John_les: doesn't show hand 
*** SUMMARY ***
Total pot $1 | Rake $0 
Seat 1: matiko09 folded before Flop (didn't bet)
Seat 2: picka4u (button) folded before Flop (didn't bet)
Seat 3: Alex Frider (small blind) folded before Flop
Seat 4: John_les (big blind) collected ($1)
Seat 5: butcheN18 folded before Flop (didn't bet)
Seat 6: flk.Dasas folded before Flop (didn't bet)
Seat 7: Dantist1122 folded before Flop (didn't bet)
Seat 8: snow937022 folded before Flop (didn't bet)





PokerStars Hand #155373855155:  Hold'em No Limit ($0.50/$1.00 USD) - 2016/06/30 8:40:21 CET [2016/06/30 2:40:21 ET]
Table 'Gaby' 9-max Seat #6 is the button
Seat 2: ka100pka527 ($47.83 in chips) 
Seat 3: Dantist1122 ($109.72 in chips) 
Seat 4: arctur17 ($71.12 in chips) 
Seat 5: kalcumite ($119.62 in chips) 
Seat 6: RoadtoNepal ($100.98 in chips) 
Seat 7: stel19 ($23.54 in chips) 
Seat 8: matiko09 ($100 in chips) 
stel19: posts small blind $0.50
matiko09: posts big blind $1
hammerwife: sits out 
flk.Dasas: sits out 
*** HOLE CARDS ***
Dealt to matiko09 [7s 9c]
ka100pka527: folds 
Dantist1122: folds 
arctur17: folds 
kalcumite: folds 
RoadtoNepal: folds 
stel19: calls $0.50
matiko09: checks 
*** FLOP *** [Jd 3h Ts]
stel19: checks 
matiko09: bets $1.24
stel19: calls $1.24
*** TURN *** [Jd 3h Ts] [7h]
stel19: checks 
matiko09: checks 
*** RIVER *** [Jd 3h Ts 7h] [9h]
stel19: bets $4.26
matiko09: folds 
Uncalled bet ($4.26) returned to stel19
stel19 collected $4.26 from pot
stel19: doesn't show hand 
*** SUMMARY ***
Total pot $4.48 | Rake $0.22 
Board [Jd 3h Ts 7h 9h]
Seat 2: ka100pka527 folded before Flop (didn't bet)
Seat 3: Dantist1122 folded before Flop (didn't bet)
Seat 4: arctur17 folded before Flop (didn't bet)
Seat 5: kalcumite folded before Flop (didn't bet)
Seat 6: RoadtoNepal (button) folded before Flop (didn't bet)
Seat 7: stel19 (small blind) collected ($4.26)
Seat 8: matiko09 (big blind) folded on the River





PokerStars Hand #155373856674:  Hold'em No Limit ($0.50/$1.00 USD) - 2016/06/30 8:40:28 CET [2016/06/30 2:40:28 ET]
Table 'Barto' 9-max Seat #3 is the button
Seat 1: hammerwife ($123 in chips) 
Seat 2: Yaaaazz ($118.15 in chips) 
Seat 3: John_les ($100 in chips) 
Seat 4: ricksdogs77 ($75.91 in chips) 
Seat 5: Ronfar3 ($100 in chips) 
Seat 8: matiko09 ($147.62 in chips) 
Seat 9: greg dean ($71.40 in chips) 
ricksdogs77: posts small blind $0.50
Ronfar3: posts big blind $1
Dantist1122: sits out 
RoadtoNepal: sits out 
*** HOLE CARDS ***
Dealt to matiko09 [6s 4d]
matiko09: folds 
greg dean: folds 
hammerwife: folds 
Yaaaazz: folds 
John_les: raises $2 to $3
ricksdogs77: calls $2.50
Ronfar3: calls $2
*** FLOP *** [7d 5c Jc]
ricksdogs77: bets $4
Ronfar3: raises $11 to $15
John_les: folds 
ricksdogs77: folds 
Uncalled bet ($11) returned to Ronfar3
Ronfar3 collected $16.15 from pot
Ronfar3: doesn't show hand 
*** SUMMARY ***
Total pot $17 | Rake $0.85 
Board [7d 5c Jc]
Seat 1: hammerwife folded before Flop (didn't bet)
Seat 2: Yaaaazz folded before Flop (didn't bet)
Seat 3: John_les (button) folded on the Flop
Seat 4: ricksdogs77 (small blind) folded on the Flop
Seat 5: Ronfar3 (big blind) collected ($16.15)
Seat 8: matiko09 folded before Flop (didn't bet)
Seat 9: greg dean folded before Flop (didn't bet)





PokerStars Hand #155373857426:  Hold'em No Limit ($0.50/$1.00 USD) - 2016/06/30 8:40:31 CET [2016/06/30 2:40:31 ET]
Table 'Asmodeus' 9-max Seat #3 is the button
Seat 1: Imbear8 ($114.48 in chips) 
Seat 2: John_les ($153.40 in chips) 
Seat 3: L4zy_FiSh ($127.14 in chips) 
Seat 4: matiko09 ($100 in chips) 
Seat 5: butcheN18 ($121.84 in chips) 
Seat 6: snow937022 ($126.21 in chips) 
Seat 7: picka4u ($40 in chips) 
Seat 9: flk.Dasas ($247.15 in chips) 
matiko09: posts small blind $0.50
butcheN18: posts big blind $1
ka100pka527: sits out 
*** HOLE CARDS ***
Dealt to matiko09 [3c 9h]
snow937022: folds 
picka4u: folds 
flk.Dasas: folds 
Imbear8: raises $2.50 to $3.50
John_les: folds 
L4zy_FiSh: folds 
matiko09: folds 
butcheN18: folds 
Uncalled bet ($2.50) returned to Imbear8
Imbear8 collected $2.50 from pot
Imbear8: doesn't show hand 
*** SUMMARY ***
Total pot $2.50 | Rake $0 
Seat 1: Imbear8 collected ($2.50)
Seat 2: John_les folded before Flop (didn't bet)
Seat 3: L4zy_FiSh (button) folded before Flop (didn't bet)
Seat 4: matiko09 (small blind) folded before Flop
Seat 5: butcheN18 (big blind) folded before Flop
Seat 6: snow937022 folded before Flop (didn't bet)
Seat 7: picka4u folded before Flop (didn't bet)
Seat 9: flk.Dasas folded before Flop (didn't bet)





PokerStars Hand #155373860272:  Hold'em No Limit ($0.25/$0.50 USD) - 2016/06/30 8:40:43 CET [2016/06/30 2:40:43 ET]
Table 'Adeona III' 9-max Seat #4 is the button
Seat 1: John_les ($50.06 in chips) 
Seat 2: matiko09 ($50 in chips) 
Seat 3: POTAPENKO700 ($55.62 in chips) 
Seat 4: antwon914 ($83.22 in chips) 
Seat 6: KABAL_ua ($89.34 in chips) 
Seat 7: Sniper1717 ($55.24 in chips) 
Seat 9: ja crisham ($47.04 in chips) 
KABAL_ua: posts small blind $0.25
Sniper1717: posts big blind $0.50
*** HOLE CARDS ***
Dealt to matiko09 [5d Jh]
ja crisham: calls $0.50
John_les: folds 
matiko09: folds 
POTAPENKO700: folds 
antwon914: folds 
KABAL_ua: folds 
Sniper1717: checks 
*** FLOP *** [3c As 4h]
Sniper1717: checks 
ja crisham: checks 
*** TURN *** [3c As 4h] [7d]
Sniper1717: bets $1
ja crisham: calls $1
*** RIVER *** [3c As 4h 7d] [2s]
Sniper1717: checks 
ja crisham: bets $1.50
Sniper1717: calls $1.50
*** SHOW DOWN ***
ja crisham: shows [8c 7h] (a pair of Sevens)
Sniper1717: shows [3d 7c] (two pair, Sevens and Threes)
Sniper1717 collected $5.94 from pot
*** SUMMARY ***
Total pot $6.25 | Rake $0.31 
Board [3c As 4h 7d 2s]
Seat 1: John_les folded before Flop (didn't bet)
Seat 2: matiko09 folded before Flop (didn't bet)
Seat 3: POTAPENKO700 folded before Flop (didn't bet)
Seat 4: antwon914 (button) folded before Flop (didn't bet)
Seat 6: KABAL_ua (small blind) folded before Flop
Seat 7: Sniper1717 (big blind) showed [3d 7c] and won ($5.94) with two pair, Sevens and Threes
Seat 9: ja crisham showed [8c 7h] and lost with a pair of Sevens





PokerStars Hand #155373862109:  Hold'em No Limit ($0.50/$1.00 USD) - 2016/06/30 8:40:51 CET [2016/06/30 2:40:51 ET]
Table 'Lucretia II' 9-max Seat #3 is the button
Seat 1: matiko09 ($207.79 in chips) 
Seat 2: picka4u ($56.30 in chips) 
Seat 3: Alex Frider ($199.29 in chips) 
Seat 4: John_les ($104.25 in chips) 
Seat 5: butcheN18 ($111.45 in chips) 
Seat 6: flk.Dasas ($100 in chips) 
Seat 7: Dantist1122 ($119.97 in chips) 
Seat 8: snow937022 ($100 in chips) 
John_les: posts small blind $0.50
butcheN18: posts big blind $1
*** HOLE CARDS ***
Dealt to matiko09 [Qc 6d]
misko123 leaves the table
flk.Dasas: folds 
ka100pka527 joins the table at seat #9 
Dantist1122: folds 
snow937022: folds 
matiko09: folds 
picka4u: folds 
Alex Frider: folds 
John_les: folds 
Uncalled bet ($0.50) returned to butcheN18
butcheN18 collected $1 from pot
butcheN18: doesn't show hand 
*** SUMMARY ***
Total pot $1 | Rake $0 
Seat 1: matiko09 folded before Flop (didn't bet)
Seat 2: picka4u folded before Flop (didn't bet)
Seat 3: Alex Frider (button) folded before Flop (didn't bet)
Seat 4: John_les (small blind) folded before Flop
Seat 5: butcheN18 (big blind) collected ($1)
Seat 6: flk.Dasas folded before Flop (didn't bet)
Seat 7: Dantist1122 folded before Flop (didn't bet)
Seat 8: snow937022 folded before Flop (didn't bet)





PokerStars Hand #155373864830:  Hold'em No Limit ($0.50/$1.00 USD) - 2016/06/30 8:41:02 CET [2016/06/30 2:41:02 ET]
Table 'Asmodeus' 9-max Seat #4 is the button
Seat 1: Imbear8 ($115.98 in chips) 
Seat 2: John_les ($153.40 in chips) 
Seat 3: L4zy_FiSh ($127.14 in chips) 
Seat 4: matiko09 ($100 in chips) 
Seat 5: butcheN18 ($120.84 in chips) 
Seat 6: snow937022 ($126.21 in chips) 
Seat 7: picka4u ($40 in chips) 
Seat 9: flk.Dasas ($247.15 in chips) 
butcheN18: posts small blind $0.50
snow937022: posts big blind $1
ka100pka527: sits out 
*** HOLE CARDS ***
Dealt to matiko09 [8c 5h]
picka4u: folds 
flk.Dasas: folds 
Imbear8: calls $1
John_les: folds 
L4zy_FiSh: folds 
matiko09: folds 
butcheN18: folds 
snow937022: checks 
*** FLOP *** [Kc 5d Qh]
snow937022: checks 
Imbear8: bets $2.38
snow937022: folds 
Uncalled bet ($2.38) returned to Imbear8
Imbear8 collected $2.38 from pot
Imbear8: doesn't show hand 
*** SUMMARY ***
Total pot $2.50 | Rake $0.12 
Board [Kc 5d Qh]
Seat 1: Imbear8 collected ($2.38)
Seat 2: John_les folded before Flop (didn't bet)
Seat 3: L4zy_FiSh folded before Flop (didn't bet)
Seat 4: matiko09 (button) folded before Flop (didn't bet)
Seat 5: butcheN18 (small blind) folded before Flop
Seat 6: snow937022 (big blind) folded on the Flop
Seat 7: picka4u folded before Flop (didn't bet)
Seat 9: flk.Dasas folded before Flop (didn't bet)





PokerStars Hand #155373867876:  Hold'em No Limit ($0.50/$1.00 USD) - 2016/06/30 8:41:15 CET [2016/06/30 2:41:15 ET]
Table 'Barto' 9-max Seat #4 is the button
Seat 1: hammerwife ($123 in chips) 
Seat 2: Yaaaazz ($118.15 in chips) 
Seat 3: John_les ($100 in chips) 
Seat 4: ricksdogs77 ($68.91 in chips) 
Seat 5: Ronfar3 ($109.15 in chips) 
Seat 6: Dantist1122 ($100 in chips) 
Seat 8: matiko09 ($147.62 in chips) 
Seat 9: greg dean ($71.40 in chips) 
Ronfar3: posts small blind $0.50
Dantist1122: posts big blind $1
RoadtoNepal: sits out 
*** HOLE CARDS ***
Dealt to matiko09 [Ac Qh]
matiko09: raises $2 to $3
greg dean: calls $3
hammerwife: folds 
Yaaaazz: folds 
John_les: folds 
ricksdogs77: calls $3
Ronfar3: folds 
Dantist1122: folds 
*** FLOP *** [9c Tc 8c]
matiko09: checks 
greg dean: bets $11
ricksdogs77: calls $11
matiko09: raises $133.62 to $144.62 and is all-in
greg dean: calls $57.40 and is all-in
ricksdogs77: folds 
Uncalled bet ($76.22) returned to matiko09
*** TURN *** [9c Tc 8c] [4s]
*** RIVER *** [9c Tc 8c 4s] [6s]
*** SHOW DOWN ***
matiko09: shows [Ac Qh] (high card Ace)
greg dean: shows [Qd Jh] (a straight, Eight to Queen)
greg dean collected $155.80 from pot
*** SUMMARY ***
Total pot $158.30 | Rake $2.50 
Board [9c Tc 8c 4s 6s]
Seat 1: hammerwife folded before Flop (didn't bet)
Seat 2: Yaaaazz folded before Flop (didn't bet)
Seat 3: John_les folded before Flop (didn't bet)
Seat 4: ricksdogs77 (button) folded on the Flop
Seat 5: Ronfar3 (small blind) folded before Flop
Seat 6: Dantist1122 (big blind) folded before Flop
Seat 8: matiko09 showed [Ac Qh] and lost with high card Ace
Seat 9: greg dean showed [Qd Jh] and won ($155.80) with a straight, Eight to Queen





PokerStars Hand #155373868394:  Hold'em No Limit ($0.50/$1.00 USD) - 2016/06/30 8:41:17 CET [2016/06/30 2:41:17 ET]
Table 'Armisticia' 9-max Seat #5 is the button
Seat 1: butcheN18 ($108 in chips) 
Seat 2: Yaaaazz ($100 in chips) 
Seat 3: Alex Frider ($105.35 in chips) 
Seat 5: picka4u ($44.31 in chips) 
Seat 7: Ronfar3 ($126.57 in chips) 
Seat 8: matiko09 ($100 in chips) 
Seat 9: MarioDong ($127.05 in chips) 
Ronfar3: posts small blind $0.50
matiko09: posts big blind $1
L4zy_FiSh: sits out 
*** HOLE CARDS ***
Dealt to matiko09 [Kc 6d]
MarioDong: folds 
butcheN18: folds 
Yaaaazz: folds 
Alex Frider: raises $1.50 to $2.50
picka4u: raises $4 to $6.50
Ronfar3: folds 
matiko09: folds 
Alex Frider: folds 
Uncalled bet ($4) returned to picka4u
picka4u collected $6.50 from pot
picka4u: doesn't show hand 
*** SUMMARY ***
Total pot $6.50 | Rake $0 
Seat 1: butcheN18 folded before Flop (didn't bet)
Seat 2: Yaaaazz folded before Flop (didn't bet)
Seat 3: Alex Frider folded before Flop
Seat 5: picka4u (button) collected ($6.50)
Seat 7: Ronfar3 (small blind) folded before Flop
Seat 8: matiko09 (big blind) folded before Flop
Seat 9: MarioDong folded before Flop (didn't bet)





PokerStars Hand #155373869467:  Hold'em No Limit ($0.50/$1.00 USD) - 2016/06/30 8:41:22 CET [2016/06/30 2:41:22 ET]
Table 'Lucretia II' 9-max Seat #4 is the button
Seat 1: matiko09 ($207.79 in chips) 
Seat 2: picka4u ($56.30 in chips) 
Seat 3: Alex Frider ($199.29 in chips) 
Seat 4: John_les ($103.75 in chips) 
Seat 5: butcheN18 ($111.95 in chips) 
Seat 6: flk.Dasas ($100 in chips) 
Seat 7: Dantist1122 ($119.97 in chips) 
Seat 8: snow937022 ($100 in chips) 
butcheN18: posts small blind $0.50
flk.Dasas: posts big blind $1
ka100pka527: sits out 
*** HOLE CARDS ***
Dealt to matiko09 [5h 3c]
Dantist1122: folds 
snow937022: raises $1.25 to $2.25
matiko09: folds 
picka4u: folds 
Alex Frider: folds 
John_les: folds 
butcheN18: folds 
flk.Dasas: calls $1.25
*** FLOP *** [7h 7s 8c]
flk.Dasas: checks 
snow937022: bets $2.61
flk.Dasas: calls $2.61
*** TURN *** [7h 7s 8c] [6s]
flk.Dasas: checks 
snow937022: checks 
*** RIVER *** [7h 7s 8c 6s] [Js]
flk.Dasas: checks 
snow937022: checks 
*** SHOW DOWN ***
flk.Dasas: shows [2d 2s] (two pair, Sevens and Deuces)
snow937022: shows [5c 5s] (two pair, Sevens and Fives)
snow937022 collected $9.71 from pot
*** SUMMARY ***
Total pot $10.22 | Rake $0.51 
Board [7h 7s 8c 6s Js]
Seat 1: matiko09 folded before Flop (didn't bet)
Seat 2: picka4u folded before Flop (didn't bet)
Seat 3: Alex Frider folded before Flop (didn't bet)
Seat 4: John_les (button) folded before Flop (didn't bet)
Seat 5: butcheN18 (small blind) folded before Flop
Seat 6: flk.Dasas (big blind) showed [2d 2s] and lost with two pair, Sevens and Deuces
Seat 7: Dantist1122 folded before Flop (didn't bet)
Seat 8: snow937022 showed [5c 5s] and won ($9.71) with two pair, Sevens and Fives





PokerStars Hand #155373870218:  Hold'em No Limit ($0.50/$1.00 USD) - 2016/06/30 8:41:25 CET [2016/06/30 2:41:25 ET]
Table 'Gaby' 9-max Seat #7 is the button
Seat 2: ka100pka527 ($47.83 in chips) 
Seat 3: Dantist1122 ($109.72 in chips) 
Seat 4: arctur17 ($71.12 in chips) 
Seat 5: kalcumite ($119.62 in chips) 
Seat 6: RoadtoNepal ($100.98 in chips) 
Seat 7: stel19 ($25.56 in chips) 
Seat 8: matiko09 ($100 in chips) 
Seat 9: hammerwife ($100.50 in chips) 
matiko09: posts small blind $0.50
hammerwife: posts big blind $1
flk.Dasas: sits out 
*** HOLE CARDS ***
Dealt to matiko09 [Jh 9d]
ka100pka527: folds 
Dantist1122: raises $2 to $3
arctur17: folds 
kalcumite: folds 
RoadtoNepal: folds 
stel19: folds 
matiko09: folds 
hammerwife: folds 
Uncalled bet ($2) returned to Dantist1122
Dantist1122 collected $2.50 from pot
Dantist1122: doesn't show hand 
*** SUMMARY ***
Total pot $2.50 | Rake $0 
Seat 2: ka100pka527 folded before Flop (didn't bet)
Seat 3: Dantist1122 collected ($2.50)
Seat 4: arctur17 folded before Flop (didn't bet)
Seat 5: kalcumite folded before Flop (didn't bet)
Seat 6: RoadtoNepal folded before Flop (didn't bet)
Seat 7: stel19 (button) folded before Flop (didn't bet)
Seat 8: matiko09 (small blind) folded before Flop
Seat 9: hammerwife (big blind) folded before Flop





PokerStars Hand #155373871721:  Hold'em No Limit ($0.50/$1.00 USD) - 2016/06/30 8:41:31 CET [2016/06/30 2:41:31 ET]
Table 'Asmodeus' 9-max Seat #5 is the button
Seat 1: Imbear8 ($117.36 in chips) 
Seat 2: John_les ($153.40 in chips) 
Seat 3: L4zy_FiSh ($127.14 in chips) 
Seat 4: matiko09 ($100 in chips) 
Seat 5: butcheN18 ($120.34 in chips) 
Seat 6: snow937022 ($125.21 in chips) 
Seat 7: picka4u ($40 in chips) 
Seat 9: flk.Dasas ($247.15 in chips) 
snow937022: posts small blind $0.50
picka4u: posts big blind $1
ka100pka527: sits out 
*** HOLE CARDS ***
Dealt to matiko09 [2c 6h]
flk.Dasas: folds 
Imbear8: calls $1
John_les: folds 
L4zy_FiSh: folds 
matiko09: folds 
butcheN18: raises $3.18 to $4.18
snow937022: folds 
picka4u: folds 
Imbear8: calls $3.18
*** FLOP *** [Jc 8c 4h]
Imbear8: checks 
butcheN18: bets $5.99
Imbear8: calls $5.99
*** TURN *** [Jc 8c 4h] [6c]
Imbear8: checks 
butcheN18: bets $14
Imbear8: raises $16 to $30
butcheN18: calls $16
*** RIVER *** [Jc 8c 4h 6c] [7s]
Imbear8: bets $77.19 and is all-in
butcheN18: calls $77.19
*** SHOW DOWN ***
Imbear8: shows [Jd Th] (a pair of Jacks)
butcheN18: shows [5c Ac] (a flush, Ace high)
butcheN18 collected $233.72 from pot
*** SUMMARY ***
Total pot $236.22 | Rake $2.50 
Board [Jc 8c 4h 6c 7s]
Seat 1: Imbear8 showed [Jd Th] and lost with a pair of Jacks
Seat 2: John_les folded before Flop (didn't bet)
Seat 3: L4zy_FiSh folded before Flop (didn't bet)
Seat 4: matiko09 folded before Flop (didn't bet)
Seat 5: butcheN18 (button) showed [5c Ac] and won ($233.72) with a flush, Ace high
Seat 6: snow937022 (small blind) folded before Flop
Seat 7: picka4u (big blind) folded before Flop
Seat 9: flk.Dasas folded before Flop (didn't bet)





PokerStars Hand #155373872697:  Hold'em No Limit ($0.25/$0.50 USD) - 2016/06/30 8:41:35 CET [2016/06/30 2:41:35 ET]
Table 'Adeona III' 9-max Seat #6 is the button
Seat 1: John_les ($50.06 in chips) 
Seat 2: matiko09 ($50 in chips) 
Seat 3: POTAPENKO700 ($55.62 in chips) 
Seat 4: antwon914 ($83.22 in chips) 
Seat 6: KABAL_ua ($89.09 in chips) 
Seat 7: Sniper1717 ($58.18 in chips) 
Seat 9: ja crisham ($44.04 in chips) 
Sniper1717: posts small blind $0.25
ja crisham: posts big blind $0.50
*** HOLE CARDS ***
Dealt to matiko09 [Ah 4h]
John_les: folds 
matiko09: raises $1 to $1.50
POTAPENKO700: folds 
antwon914: calls $1.50
KABAL_ua: folds 
Sniper1717: folds 
ja crisham: calls $1
*** FLOP *** [7s 3d 5d]
ja crisham: bets $1.50
matiko09: raises $3 to $4.50
antwon914: folds 
ja crisham: calls $3
*** TURN *** [7s 3d 5d] [5s]
ja crisham: checks 
matiko09: checks 
*** RIVER *** [7s 3d 5d 5s] [8s]
ja crisham: bets $2.50
matiko09: folds 
Uncalled bet ($2.50) returned to ja crisham
ja crisham collected $13.06 from pot
ja crisham: doesn't show hand 
*** SUMMARY ***
Total pot $13.75 | Rake $0.69 
Board [7s 3d 5d 5s 8s]
Seat 1: John_les folded before Flop (didn't bet)
Seat 2: matiko09 folded on the River
Seat 3: POTAPENKO700 folded before Flop (didn't bet)
Seat 4: antwon914 folded on the Flop
Seat 6: KABAL_ua (button) folded before Flop (didn't bet)
Seat 7: Sniper1717 (small blind) folded before Flop
Seat 9: ja crisham (big blind) collected ($13.06)





PokerStars Hand #155373872839:  Hold'em No Limit ($0.50/$1.00 USD) - 2016/06/30 8:41:36 CET [2016/06/30 2:41:36 ET]
Table 'Jarmila' 9-max Seat #1 is the button
Seat 1: Ronfar3 ($100 in chips) 
Seat 2: AA-man-AA27 ($50.63 in chips) 
Seat 3: Dantist1122 ($100 in chips) 
Seat 4: Rohitbarve ($43.58 in chips) 
Seat 5: ilaviiitech ($101.50 in chips) 
Seat 6: matiko09 ($100 in chips) 
Seat 7: Bid'daum ($80.93 in chips) 
Seat 8: DIMAN_324 ($120.12 in chips) 
Seat 9: ka100pka527 ($45.38 in chips) 
AA-man-AA27: posts small blind $0.50
Dantist1122: posts big blind $1
*** HOLE CARDS ***
Dealt to matiko09 [5s 6c]
Rohitbarve: raises $2 to $3
ilaviiitech: raises $6 to $9
matiko09: folds 
Bid'daum: folds 
DIMAN_324: folds 
ka100pka527: folds 
Ronfar3: folds 
AA-man-AA27: folds 
Dantist1122: folds 
Rohitbarve: calls $6
*** FLOP *** [6d Ks 3d]
Rohitbarve: checks 
ilaviiitech: bets $10.50
Rohitbarve: raises $24.08 to $34.58 and is all-in
ilaviiitech: folds 
Uncalled bet ($24.08) returned to Rohitbarve
Rohitbarve collected $38.48 from pot
*** SUMMARY ***
Total pot $40.50 | Rake $2.02 
Board [6d Ks 3d]
Seat 1: Ronfar3 (button) folded before Flop (didn't bet)
Seat 2: AA-man-AA27 (small blind) folded before Flop
Seat 3: Dantist1122 (big blind) folded before Flop
Seat 4: Rohitbarve collected ($38.48)
Seat 5: ilaviiitech folded on the Flop
Seat 6: matiko09 folded before Flop (didn't bet)
Seat 7: Bid'daum folded before Flop (didn't bet)
Seat 8: DIMAN_324 folded before Flop (didn't bet)
Seat 9: ka100pka527 folded before Flop (didn't bet)





PokerStars Hand #155373873145:  Hold'em No Limit ($0.50/$1.00 USD) - 2016/06/30 8:41:37 CET [2016/06/30 2:41:37 ET]
Table 'Aunus' 9-max Seat #7 is the button
Seat 1: dboy604 ($160.69 in chips) 
Seat 2: HasBigBiceps ($117.27 in chips) 
Seat 3: matiko09 ($100 in chips) 
Seat 4: ilaviiitech ($100 in chips) 
Seat 6: RoadtoNepal ($101 in chips) 
Seat 7: ka100pka527 ($38.50 in chips) 
Seat 8: Dantist1122 ($100 in chips) 
Seat 9: flk.Dasas ($101.50 in chips) 
Dantist1122: posts small blind $0.50
flk.Dasas: posts big blind $1
hammerwife: sits out 
*** HOLE CARDS ***
Dealt to matiko09 [8s 6c]
dboy604: calls $1
HasBigBiceps: folds 
matiko09: folds 
ilaviiitech: folds 
RoadtoNepal: folds 
ka100pka527: folds 
Dantist1122: folds 
flk.Dasas: checks 
*** FLOP *** [8h 4c 7c]
flk.Dasas: checks 
dboy604: checks 
*** TURN *** [8h 4c 7c] [8c]
flk.Dasas: checks 
dboy604: bets $5
flk.Dasas: folds 
Uncalled bet ($5) returned to dboy604
dboy604 collected $2.38 from pot
dboy604: doesn't show hand 
*** SUMMARY ***
Total pot $2.50 | Rake $0.12 
Board [8h 4c 7c 8c]
Seat 1: dboy604 collected ($2.38)
Seat 2: HasBigBiceps folded before Flop (didn't bet)
Seat 3: matiko09 folded before Flop (didn't bet)
Seat 4: ilaviiitech folded before Flop (didn't bet)
Seat 6: RoadtoNepal folded before Flop (didn't bet)
Seat 7: ka100pka527 (button) folded before Flop (didn't bet)
Seat 8: Dantist1122 (small blind) folded before Flop
Seat 9: flk.Dasas (big blind) folded on the Turn





PokerStars Hand #155373873524:  Hold'em No Limit ($0.50/$1.00 USD) - 2016/06/30 8:41:39 CET [2016/06/30 2:41:39 ET]
Table 'Armisticia' 9-max Seat #7 is the button
Seat 1: butcheN18 ($108 in chips) 
Seat 2: Yaaaazz ($100 in chips) 
Seat 3: Alex Frider ($102.85 in chips) 
Seat 5: picka4u ($48.31 in chips) 
Seat 7: Ronfar3 ($126.07 in chips) 
Seat 8: matiko09 ($100 in chips) 
Seat 9: MarioDong ($127.05 in chips) 
matiko09: posts small blind $0.50
MarioDong: posts big blind $1
L4zy_FiSh: sits out 
*** HOLE CARDS ***
Dealt to matiko09 [5s 2c]
butcheN18: folds 
Yaaaazz: raises $2 to $3
Alex Frider: folds 
picka4u: folds 
Ronfar3: folds 
matiko09: folds 
MarioDong: folds 
Uncalled bet ($2) returned to Yaaaazz
Yaaaazz collected $2.50 from pot
*** SUMMARY ***
Total pot $2.50 | Rake $0 
Seat 1: butcheN18 folded before Flop (didn't bet)
Seat 2: Yaaaazz collected ($2.50)
Seat 3: Alex Frider folded before Flop (didn't bet)
Seat 5: picka4u folded before Flop (didn't bet)
Seat 7: Ronfar3 (button) folded before Flop (didn't bet)
Seat 8: matiko09 (small blind) folded before Flop
Seat 9: MarioDong (big blind) folded before Flop





PokerStars Hand #155373877700:  Hold'em No Limit ($0.50/$1.00 USD) - 2016/06/30 8:41:57 CET [2016/06/30 2:41:57 ET]
Table 'Gaby' 9-max Seat #8 is the button
Seat 1: flk.Dasas ($100 in chips) 
Seat 2: ka100pka527 ($47.83 in chips) 
Seat 3: Dantist1122 ($111.22 in chips) 
Seat 4: arctur17 ($71.12 in chips) 
Seat 5: kalcumite ($119.62 in chips) 
Seat 6: RoadtoNepal ($100.98 in chips) 
Seat 7: stel19 ($25.56 in chips) 
Seat 8: matiko09 ($100 in chips) 
Seat 9: hammerwife ($100 in chips) 
hammerwife: posts small blind $0.50
flk.Dasas: posts big blind $1
*** HOLE CARDS ***
Dealt to matiko09 [9d 4h]
ka100pka527: folds 
Dantist1122: folds 
arctur17: folds 
kalcumite: folds 
RoadtoNepal: folds 
stel19: folds 
stel19 leaves the table
matiko09: folds 
Yaaaazz joins the table at seat #7 
hammerwife: folds 
Uncalled bet ($0.50) returned to flk.Dasas
flk.Dasas collected $1 from pot
flk.Dasas: doesn't show hand 
*** SUMMARY ***
Total pot $1 | Rake $0 
Seat 1: flk.Dasas (big blind) collected ($1)
Seat 2: ka100pka527 folded before Flop (didn't bet)
Seat 3: Dantist1122 folded before Flop (didn't bet)
Seat 4: arctur17 folded before Flop (didn't bet)
Seat 5: kalcumite folded before Flop (didn't bet)
Seat 6: RoadtoNepal folded before Flop (didn't bet)
Seat 7: stel19 folded before Flop (didn't bet)
Seat 8: matiko09 (button) folded before Flop (didn't bet)
Seat 9: hammerwife (small blind) folded before Flop





PokerStars Hand #155373882346:  Hold'em No Limit ($0.50/$1.00 USD) - 2016/06/30 8:42:16 CET [2016/06/30 2:42:16 ET]
Table 'Lucretia II' 9-max Seat #5 is the button
Seat 1: matiko09 ($207.79 in chips) 
Seat 2: picka4u ($56.30 in chips) 
Seat 3: Alex Frider ($199.29 in chips) 
Seat 4: John_les ($103.75 in chips) 
Seat 5: butcheN18 ($111.45 in chips) 
Seat 6: flk.Dasas ($100 in chips) 
Seat 7: Dantist1122 ($119.97 in chips) 
Seat 8: snow937022 ($104.85 in chips) 
flk.Dasas: posts small blind $0.50
Dantist1122: posts big blind $1
ka100pka527: sits out 
*** HOLE CARDS ***
Dealt to matiko09 [Kc 2s]
snow937022: folds 
matiko09: folds 
picka4u: folds 
Alex Frider: folds 
John_les: folds 
butcheN18: folds 
flk.Dasas: folds 
Uncalled bet ($0.50) returned to Dantist1122
Dantist1122 collected $1 from pot
Dantist1122: doesn't show hand 
*** SUMMARY ***
Total pot $1 | Rake $0 
Seat 1: matiko09 folded before Flop (didn't bet)
Seat 2: picka4u folded before Flop (didn't bet)
Seat 3: Alex Frider folded before Flop (didn't bet)
Seat 4: John_les folded before Flop (didn't bet)
Seat 5: butcheN18 (button) folded before Flop (didn't bet)
Seat 6: flk.Dasas (small blind) folded before Flop
Seat 7: Dantist1122 (big blind) collected ($1)
Seat 8: snow937022 folded before Flop (didn't bet)





PokerStars Hand #155373882665:  Hold'em No Limit ($0.50/$1.00 USD) - 2016/06/30 8:42:17 CET [2016/06/30 2:42:17 ET]
Table 'Armisticia' 9-max Seat #8 is the button
Seat 1: butcheN18 ($108 in chips) 
Seat 2: Yaaaazz ($101.50 in chips) 
Seat 3: Alex Frider ($102.85 in chips) 
Seat 5: picka4u ($48.31 in chips) 
Seat 7: Ronfar3 ($126.07 in chips) 
Seat 8: matiko09 ($100 in chips) 
Seat 9: MarioDong ($126.05 in chips) 
MarioDong: posts small blind $0.50
butcheN18: posts big blind $1
L4zy_FiSh: sits out 
*** HOLE CARDS ***
Dealt to matiko09 [Kh 4c]
Yaaaazz: folds 
Alex Frider: folds 
picka4u: folds 
Ronfar3: folds 
matiko09: folds 
MarioDong: folds 
Uncalled bet ($0.50) returned to butcheN18
butcheN18 collected $1 from pot
butcheN18: doesn't show hand 
*** SUMMARY ***
Total pot $1 | Rake $0 
Seat 1: butcheN18 (big blind) collected ($1)
Seat 2: Yaaaazz folded before Flop (didn't bet)
Seat 3: Alex Frider folded before Flop (didn't bet)
Seat 5: picka4u folded before Flop (didn't bet)
Seat 7: Ronfar3 folded before Flop (didn't bet)
Seat 8: matiko09 (button) folded before Flop (didn't bet)
Seat 9: MarioDong (small blind) folded before Flop





PokerStars Hand #155373883329:  Hold'em No Limit ($0.50/$1.00 USD) - 2016/06/30 8:42:20 CET [2016/06/30 2:42:20 ET]
Table 'Gaby' 9-max Seat #9 is the button
Seat 1: flk.Dasas ($100.50 in chips) 
Seat 2: ka100pka527 ($47.83 in chips) 
Seat 3: Dantist1122 ($111.22 in chips) 
Seat 4: arctur17 ($71.12 in chips) 
Seat 5: kalcumite ($119.62 in chips) 
Seat 6: RoadtoNepal ($100.98 in chips) 
Seat 8: matiko09 ($100 in chips) 
Seat 9: hammerwife ($100 in chips) 
flk.Dasas: posts small blind $0.50
ka100pka527: posts big blind $1
Yaaaazz: sits out 
*** HOLE CARDS ***
Dealt to matiko09 [Kc 3c]
Dantist1122: folds 
arctur17: folds 
kalcumite: raises $2 to $3
RoadtoNepal: folds 
matiko09: folds 
hammerwife: folds 
flk.Dasas: raises $7 to $10
ka100pka527: folds 
kalcumite: raises $19 to $29
flk.Dasas: folds 
Uncalled bet ($19) returned to kalcumite
kalcumite collected $21 from pot
kalcumite: doesn't show hand 
*** SUMMARY ***
Total pot $21 | Rake $0 
Seat 1: flk.Dasas (small blind) folded before Flop
Seat 2: ka100pka527 (big blind) folded before Flop
Seat 3: Dantist1122 folded before Flop (didn't bet)
Seat 4: arctur17 folded before Flop (didn't bet)
Seat 5: kalcumite collected ($21)
Seat 6: RoadtoNepal folded before Flop (didn't bet)
Seat 8: matiko09 folded before Flop (didn't bet)
Seat 9: hammerwife (button) folded before Flop (didn't bet)





PokerStars Hand #155373883696:  Hold'em No Limit ($0.50/$1.00 USD) - 2016/06/30 8:42:22 CET [2016/06/30 2:42:22 ET]
Table 'Barto' 9-max Seat #5 is the button
Seat 1: hammerwife ($123 in chips) 
Seat 2: Yaaaazz ($118.15 in chips) 
Seat 3: John_les ($100 in chips) 
Seat 4: ricksdogs77 ($54.91 in chips) 
Seat 5: Ronfar3 ($108.65 in chips) 
Seat 6: Dantist1122 ($100 in chips) 
Seat 7: RoadtoNepal ($100 in chips) 
Seat 8: matiko09 ($100 in chips) 
Seat 9: greg dean ($155.80 in chips) 
Dantist1122: posts small blind $0.50
RoadtoNepal: posts big blind $1
*** HOLE CARDS ***
Dealt to matiko09 [6d 7c]
matiko09: folds 
greg dean: folds 
hammerwife: folds 
Yaaaazz: folds 
John_les: folds 
ricksdogs77: calls $1
Ronfar3: folds 
Dantist1122: folds 
RoadtoNepal: checks 
*** FLOP *** [3h Th Qd]
RoadtoNepal: checks 
ricksdogs77: bets $2
RoadtoNepal: folds 
Uncalled bet ($2) returned to ricksdogs77
ricksdogs77 collected $2.38 from pot
ricksdogs77: doesn't show hand 
*** SUMMARY ***
Total pot $2.50 | Rake $0.12 
Board [3h Th Qd]
Seat 1: hammerwife folded before Flop (didn't bet)
Seat 2: Yaaaazz folded before Flop (didn't bet)
Seat 3: John_les folded before Flop (didn't bet)
Seat 4: ricksdogs77 collected ($2.38)
Seat 5: Ronfar3 (button) folded before Flop (didn't bet)
Seat 6: Dantist1122 (small blind) folded before Flop
Seat 7: RoadtoNepal (big blind) folded on the Flop
Seat 8: matiko09 folded before Flop (didn't bet)
Seat 9: greg dean folded before Flop (didn't bet)





PokerStars Hand #155373885511:  Hold'em No Limit ($0.50/$1.00 USD) - 2016/06/30 8:42:29 CET [2016/06/30 2:42:29 ET]
Table 'Aunus' 9-max Seat #8 is the button
Seat 1: dboy604 ($162.07 in chips) 
Seat 2: HasBigBiceps ($117.27 in chips) 
Seat 3: matiko09 ($100 in chips) 
Seat 4: ilaviiitech ($100 in chips) 
Seat 6: RoadtoNepal ($101 in chips) 
Seat 7: ka100pka527 ($38.50 in chips) 
Seat 8: Dantist1122 ($100 in chips) 
Seat 9: flk.Dasas ($100.50 in chips) 
flk.Dasas: posts small blind $0.50
dboy604: posts big blind $1
hammerwife: sits out 
*** HOLE CARDS ***
Dealt to matiko09 [4d 8d]
HasBigBiceps: folds 
matiko09: folds 
ilaviiitech: folds 
RoadtoNepal: raises $1.50 to $2.50
ka100pka527: folds 
Dantist1122: folds 
flk.Dasas: folds 
dboy604: calls $1.50
*** FLOP *** [2s 3c 7h]
dboy604: bets $4
RoadtoNepal: folds 
Uncalled bet ($4) returned to dboy604
dboy604 collected $5.22 from pot
dboy604: doesn't show hand 
*** SUMMARY ***
Total pot $5.50 | Rake $0.28 
Board [2s 3c 7h]
Seat 1: dboy604 (big blind) collected ($5.22)
Seat 2: HasBigBiceps folded before Flop (didn't bet)
Seat 3: matiko09 folded before Flop (didn't bet)
Seat 4: ilaviiitech folded before Flop (didn't bet)
Seat 6: RoadtoNepal folded on the Flop
Seat 7: ka100pka527 folded before Flop (didn't bet)
Seat 8: Dantist1122 (button) folded before Flop (didn't bet)
Seat 9: flk.Dasas (small blind) folded before Flop





PokerStars Hand #155373885935:  Hold'em No Limit ($0.50/$1.00 USD) - 2016/06/30 8:42:31 CET [2016/06/30 2:42:31 ET]
Table 'Lucretia II' 9-max Seat #6 is the button
Seat 1: matiko09 ($207.79 in chips) 
Seat 2: picka4u ($56.30 in chips) 
Seat 3: Alex Frider ($199.29 in chips) 
Seat 4: John_les ($103.75 in chips) 
Seat 5: butcheN18 ($111.45 in chips) 
Seat 6: flk.Dasas ($100 in chips) 
Seat 7: Dantist1122 ($120.47 in chips) 
Seat 8: snow937022 ($104.85 in chips) 
Dantist1122: posts small blind $0.50
snow937022: posts big blind $1
ka100pka527: sits out 
*** HOLE CARDS ***
Dealt to matiko09 [6s 8c]
matiko09: folds 
picka4u: folds 
Alex Frider: folds 
John_les: folds 
butcheN18: folds 
flk.Dasas: raises $1.50 to $2.50
Dantist1122: raises $6 to $8.50
snow937022: folds 
flk.Dasas: folds 
Uncalled bet ($6) returned to Dantist1122
Dantist1122 collected $6 from pot
Dantist1122: doesn't show hand 
*** SUMMARY ***
Total pot $6 | Rake $0 
Seat 1: matiko09 folded before Flop (didn't bet)
Seat 2: picka4u folded before Flop (didn't bet)
Seat 3: Alex Frider folded before Flop (didn't bet)
Seat 4: John_les folded before Flop (didn't bet)
Seat 5: butcheN18 folded before Flop (didn't bet)
Seat 6: flk.Dasas (button) folded before Flop
Seat 7: Dantist1122 (small blind) collected ($6)
Seat 8: snow937022 (big blind) folded before Flop





PokerStars Hand #155373887658:  Hold'em No Limit ($0.50/$1.00 USD) - 2016/06/30 8:42:38 CET [2016/06/30 2:42:38 ET]
Table 'Jarmila' 9-max Seat #2 is the button
Seat 1: Ronfar3 ($100 in chips) 
Seat 2: AA-man-AA27 ($50.13 in chips) 
Seat 3: Dantist1122 ($100 in chips) 
Seat 4: Rohitbarve ($62.56 in chips) 
Seat 5: ilaviiitech ($100 in chips) 
Seat 6: matiko09 ($100 in chips) 
Seat 7: Bid'daum ($80.93 in chips) 
Seat 8: DIMAN_324 ($120.12 in chips) 
Seat 9: ka100pka527 ($45.38 in chips) 
Dantist1122: posts small blind $0.50
Rohitbarve: posts big blind $1
*** HOLE CARDS ***
Dealt to matiko09 [Qd 7h]
ilaviiitech: folds 
matiko09: folds 
Bid'daum: folds 
DIMAN_324: raises $1.50 to $2.50
ka100pka527: raises $3.50 to $6
Ronfar3: folds 
AA-man-AA27: folds 
Dantist1122: folds 
Rohitbarve: calls $5
DIMAN_324: calls $3.50
*** FLOP *** [9c 6d 6s]
Rohitbarve: checks 
DIMAN_324: checks 
ka100pka527: checks 
*** TURN *** [9c 6d 6s] [3c]
Rohitbarve: checks 
DIMAN_324: bets $11.50
ka100pka527: folds 
Rohitbarve: folds 
Uncalled bet ($11.50) returned to DIMAN_324
DIMAN_324 collected $17.58 from pot
DIMAN_324: doesn't show hand 
*** SUMMARY ***
Total pot $18.50 | Rake $0.92 
Board [9c 6d 6s 3c]
Seat 1: Ronfar3 folded before Flop (didn't bet)
Seat 2: AA-man-AA27 (button) folded before Flop (didn't bet)
Seat 3: Dantist1122 (small blind) folded before Flop
Seat 4: Rohitbarve (big blind) folded on the Turn
Seat 5: ilaviiitech folded before Flop (didn't bet)
Seat 6: matiko09 folded before Flop (didn't bet)
Seat 7: Bid'daum folded before Flop (didn't bet)
Seat 8: DIMAN_324 collected ($17.58)
Seat 9: ka100pka527 folded on the Turn





PokerStars Hand #155373889287:  Hold'em No Limit ($0.50/$1.00 USD) - 2016/06/30 8:42:45 CET [2016/06/30 2:42:45 ET]
Table 'Armisticia' 9-max Seat #9 is the button
Seat 1: butcheN18 ($108.50 in chips) 
Seat 2: Yaaaazz ($101.50 in chips) 
Seat 3: Alex Frider ($102.85 in chips) 
Seat 5: picka4u ($48.31 in chips) 
Seat 7: Ronfar3 ($126.07 in chips) 
Seat 8: matiko09 ($100 in chips) 
Seat 9: MarioDong ($125.55 in chips) 
butcheN18: posts small blind $0.50
Yaaaazz: posts big blind $1
L4zy_FiSh: sits out 
*** HOLE CARDS ***
Dealt to matiko09 [3d 8s]
Alex Frider: folds 
picka4u: folds 
Ronfar3: folds 
matiko09: folds 
MarioDong: folds 
butcheN18: folds 
Uncalled bet ($0.50) returned to Yaaaazz
Yaaaazz collected $1 from pot
*** SUMMARY ***
Total pot $1 | Rake $0 
Seat 1: butcheN18 (small blind) folded before Flop
Seat 2: Yaaaazz (big blind) collected ($1)
Seat 3: Alex Frider folded before Flop (didn't bet)
Seat 5: picka4u folded before Flop (didn't bet)
Seat 7: Ronfar3 folded before Flop (didn't bet)
Seat 8: matiko09 folded before Flop (didn't bet)
Seat 9: MarioDong (button) folded before Flop (didn't bet)





PokerStars Hand #155373892951:  Hold'em No Limit ($0.50/$1.00 USD) - 2016/06/30 8:43:00 CET [2016/06/30 2:43:00 ET]
Table 'Asmodeus' 9-max Seat #6 is the button
Seat 2: John_les ($153.40 in chips) 
Seat 3: L4zy_FiSh ($127.14 in chips) 
Seat 4: matiko09 ($100 in chips) 
Seat 5: butcheN18 ($236.70 in chips) 
Seat 6: snow937022 ($124.71 in chips) 
Seat 7: picka4u ($39 in chips) 
Seat 8: ka100pka527 ($40 in chips) 
Seat 9: flk.Dasas ($247.15 in chips) 
picka4u: posts small blind $0.50
ka100pka527: posts big blind $1
*** HOLE CARDS ***
Dealt to matiko09 [Jd 5h]
flk.Dasas: folds 
John_les: raises $2.50 to $3.50
L4zy_FiSh: folds 
matiko09: folds 
butcheN18: folds 
snow937022: calls $3.50
picka4u: folds 
ka100pka527: calls $2.50
*** FLOP *** [Qc 6c 7s]
ka100pka527: checks 
John_les: checks 
Imbear8 leaves the table
snow937022: bets $9.40
ka100pka527: folds 
John_les: folds 
Uncalled bet ($9.40) returned to snow937022
snow937022 collected $10.45 from pot
snow937022: doesn't show hand 
*** SUMMARY ***
Total pot $11 | Rake $0.55 
Board [Qc 6c 7s]
Seat 2: John_les folded on the Flop
Seat 3: L4zy_FiSh folded before Flop (didn't bet)
Seat 4: matiko09 folded before Flop (didn't bet)
Seat 5: butcheN18 folded before Flop (didn't bet)
Seat 6: snow937022 (button) collected ($10.45)
Seat 7: picka4u (small blind) folded before Flop
Seat 8: ka100pka527 (big blind) folded on the Flop
Seat 9: flk.Dasas folded before Flop (didn't bet)





PokerStars Hand #155373893327:  Hold'em No Limit ($0.25/$0.50 USD) - 2016/06/30 8:43:02 CET [2016/06/30 2:43:02 ET]
Table 'Adeona III' 9-max Seat #7 is the button
Seat 1: John_les ($50.06 in chips) 
Seat 2: matiko09 ($50 in chips) 
Seat 3: POTAPENKO700 ($55.62 in chips) 
Seat 4: antwon914 ($81.72 in chips) 
Seat 6: KABAL_ua ($89.09 in chips) 
Seat 7: Sniper1717 ($57.93 in chips) 
Seat 9: ja crisham ($51.10 in chips) 
ja crisham: posts small blind $0.25
John_les: posts big blind $0.50
THREE FlDDY: sits out 
*** HOLE CARDS ***
Dealt to matiko09 [Qh 5c]
matiko09: folds 
POTAPENKO700: folds 
antwon914: folds 
KABAL_ua: folds 
Sniper1717: calls $0.50
ja crisham: calls $0.25
John_les: raises $3 to $3.50
Sniper1717: folds 
ja crisham: folds 
Uncalled bet ($3) returned to John_les
John_les collected $1.50 from pot
John_les: doesn't show hand 
*** SUMMARY ***
Total pot $1.50 | Rake $0 
Seat 1: John_les (big blind) collected ($1.50)
Seat 2: matiko09 folded before Flop (didn't bet)
Seat 3: POTAPENKO700 folded before Flop (didn't bet)
Seat 4: antwon914 folded before Flop (didn't bet)
Seat 6: KABAL_ua folded before Flop (didn't bet)
Seat 7: Sniper1717 (button) folded before Flop
Seat 9: ja crisham (small blind) folded before Flop





PokerStars Hand #155373893429:  Hold'em No Limit ($0.50/$1.00 USD) - 2016/06/30 8:43:02 CET [2016/06/30 2:43:02 ET]
Table 'Aunus' 9-max Seat #9 is the button
Seat 1: dboy604 ($164.79 in chips) 
Seat 2: HasBigBiceps ($117.27 in chips) 
Seat 3: matiko09 ($100 in chips) 
Seat 4: ilaviiitech ($100 in chips) 
Seat 6: RoadtoNepal ($100 in chips) 
Seat 7: ka100pka527 ($38.50 in chips) 
Seat 8: Dantist1122 ($100 in chips) 
Seat 9: flk.Dasas ($100 in chips) 
dboy604: posts small blind $0.50
HasBigBiceps: posts big blind $1
hammerwife: sits out 
*** HOLE CARDS ***
Dealt to matiko09 [3d Js]
matiko09: folds 
ilaviiitech: folds 
RoadtoNepal: raises $1.50 to $2.50
ka100pka527: folds 
Dantist1122: folds 
flk.Dasas: folds 
dboy604: calls $2
HasBigBiceps: calls $1.50
*** FLOP *** [Kc 9d Ac]
dboy604: checks 
HasBigBiceps: checks 
RoadtoNepal: bets $5
dboy604: folds 
HasBigBiceps: calls $5
*** TURN *** [Kc 9d Ac] [9s]
HasBigBiceps: checks 
RoadtoNepal: bets $12.46
HasBigBiceps: folds 
Uncalled bet ($12.46) returned to RoadtoNepal
RoadtoNepal collected $16.62 from pot
*** SUMMARY ***
Total pot $17.50 | Rake $0.88 
Board [Kc 9d Ac 9s]
Seat 1: dboy604 (small blind) folded on the Flop
Seat 2: HasBigBiceps (big blind) folded on the Turn
Seat 3: matiko09 folded before Flop (didn't bet)
Seat 4: ilaviiitech folded before Flop (didn't bet)
Seat 6: RoadtoNepal collected ($16.62)
Seat 7: ka100pka527 folded before Flop (didn't bet)
Seat 8: Dantist1122 folded before Flop (didn't bet)
Seat 9: flk.Dasas (button) folded before Flop (didn't bet)





PokerStars Hand #155373894491:  Hold'em No Limit ($0.50/$1.00 USD) - 2016/06/30 8:43:07 CET [2016/06/30 2:43:07 ET]
Table 'Armisticia' 9-max Seat #1 is the button
Seat 1: butcheN18 ($108 in chips) 
Seat 2: Yaaaazz ($102 in chips) 
Seat 3: Alex Frider ($102.85 in chips) 
Seat 5: picka4u ($48.31 in chips) 
Seat 7: Ronfar3 ($126.07 in chips) 
Seat 8: matiko09 ($100 in chips) 
Seat 9: MarioDong ($125.55 in chips) 
Yaaaazz: posts small blind $0.50
Alex Frider: posts big blind $1
L4zy_FiSh: sits out 
*** HOLE CARDS ***
Dealt to matiko09 [Kc Th]
picka4u: folds 
Ronfar3: folds 
matiko09: folds 
MarioDong: raises $2 to $3
butcheN18: folds 
Yaaaazz: folds 
Alex Frider: calls $2
*** FLOP *** [Jh Qh Js]
Alex Frider: checks 
MarioDong: checks 
*** TURN *** [Jh Qh Js] [3c]
Alex Frider: checks 
MarioDong: checks 
*** RIVER *** [Jh Qh Js 3c] [Jd]
Alex Frider: checks 
MarioDong: checks 
*** SHOW DOWN ***
Alex Frider: shows [6h 6d] (a full house, Jacks full of Sixes)
MarioDong: mucks hand 
Alex Frider collected $6.18 from pot
*** SUMMARY ***
Total pot $6.50 | Rake $0.32 
Board [Jh Qh Js 3c Jd]
Seat 1: butcheN18 (button) folded before Flop (didn't bet)
Seat 2: Yaaaazz (small blind) folded before Flop
Seat 3: Alex Frider (big blind) showed [6h 6d] and won ($6.18) with a full house, Jacks full of Sixes
Seat 5: picka4u folded before Flop (didn't bet)
Seat 7: Ronfar3 folded before Flop (didn't bet)
Seat 8: matiko09 folded before Flop (didn't bet)
Seat 9: MarioDong mucked [Ad 5s]





PokerStars Hand #155373897717:  Hold'em No Limit ($0.50/$1.00 USD) - 2016/06/30 8:43:21 CET [2016/06/30 2:43:21 ET]
Table 'Barto' 9-max Seat #6 is the button
Seat 1: hammerwife ($123 in chips) 
Seat 2: Yaaaazz ($118.15 in chips) 
Seat 3: John_les ($100 in chips) 
Seat 4: ricksdogs77 ($56.29 in chips) 
Seat 5: Ronfar3 ($108.65 in chips) 
Seat 6: Dantist1122 ($100 in chips) 
Seat 7: RoadtoNepal ($100 in chips) 
Seat 8: matiko09 ($100 in chips) 
Seat 9: greg dean ($155.80 in chips) 
RoadtoNepal: posts small blind $0.50
matiko09: posts big blind $1
*** HOLE CARDS ***
Dealt to matiko09 [9s Kh]
greg dean: calls $1
hammerwife: folds 
Yaaaazz: folds 
John_les: folds 
ricksdogs77: calls $1
Ronfar3: folds 
Dantist1122: folds 
RoadtoNepal: folds 
matiko09: checks 
*** FLOP *** [Qh 3c 2s]
matiko09: checks 
greg dean: checks 
ricksdogs77: bets $3
matiko09: folds 
greg dean: raises $18 to $21
ricksdogs77: folds 
Uncalled bet ($18) returned to greg dean
greg dean collected $9.02 from pot
*** SUMMARY ***
Total pot $9.50 | Rake $0.48 
Board [Qh 3c 2s]
Seat 1: hammerwife folded before Flop (didn't bet)
Seat 2: Yaaaazz folded before Flop (didn't bet)
Seat 3: John_les folded before Flop (didn't bet)
Seat 4: ricksdogs77 folded on the Flop
Seat 5: Ronfar3 folded before Flop (didn't bet)
Seat 6: Dantist1122 (button) folded before Flop (didn't bet)
Seat 7: RoadtoNepal (small blind) folded before Flop
Seat 8: matiko09 (big blind) folded on the Flop
Seat 9: greg dean collected ($9.02)





PokerStars Hand #155373900326:  Hold'em No Limit ($0.50/$1.00 USD) - 2016/06/30 8:43:31 CET [2016/06/30 2:43:31 ET]
Table 'Gaby' 9-max Seat #1 is the button
Seat 1: flk.Dasas ($100 in chips) 
Seat 2: ka100pka527 ($46.83 in chips) 
Seat 4: arctur17 ($71.12 in chips) 
Seat 5: kalcumite ($130.62 in chips) 
Seat 6: RoadtoNepal ($100.98 in chips) 
Seat 8: matiko09 ($100 in chips) 
Seat 9: hammerwife ($100 in chips) 
ka100pka527: posts small blind $0.50
Dantist1122: is sitting out 
arctur17: posts big blind $1
Yaaaazz: sits out 
*** HOLE CARDS ***
Dealt to matiko09 [4c 4d]
kalcumite: folds 
RoadtoNepal: folds 
matiko09: raises $2 to $3
Dantist1122 leaves the table
hammerwife: raises $7 to $10
flk.Dasas: folds 
ka100pka527: raises $36.83 to $46.83 and is all-in
arctur17: folds 
matiko09: folds 
L4zy_FiSh joins the table at seat #3 
L4zy_FiSh leaves the table
DIMAN_324 joins the table at seat #3 
DIMAN_324 leaves the table
hammerwife: folds 
Uncalled bet ($36.83) returned to ka100pka527
ka100pka527 collected $24 from pot
ka100pka527: doesn't show hand 
*** SUMMARY ***
Total pot $24 | Rake $0 
Seat 1: flk.Dasas (button) folded before Flop (didn't bet)
Seat 2: ka100pka527 (small blind) collected ($24)
Seat 4: arctur17 (big blind) folded before Flop
Seat 5: kalcumite folded before Flop (didn't bet)
Seat 6: RoadtoNepal folded before Flop (didn't bet)
Seat 8: matiko09 folded before Flop
Seat 9: hammerwife folded before Flop





PokerStars Hand #155373900878:  Hold'em No Limit ($0.50/$1.00 USD) - 2016/06/30 8:43:34 CET [2016/06/30 2:43:34 ET]
Table 'Lucretia II' 9-max Seat #7 is the button
Seat 1: matiko09 ($207.79 in chips) 
Seat 2: picka4u ($56.30 in chips) 
Seat 3: Alex Frider ($199.29 in chips) 
Seat 4: John_les ($103.75 in chips) 
Seat 5: butcheN18 ($111.45 in chips) 
Seat 6: flk.Dasas ($100 in chips) 
Seat 7: Dantist1122 ($123.97 in chips) 
Seat 8: snow937022 ($103.85 in chips) 
Seat 9: ka100pka527 ($40 in chips) 
snow937022: posts small blind $0.50
ka100pka527: posts big blind $1
*** HOLE CARDS ***
Dealt to matiko09 [3h Jh]
matiko09: folds 
picka4u: folds 
Alex Frider: folds 
John_les: folds 
butcheN18: folds 
flk.Dasas: folds 
matiko09 leaves the table
Dantist1122: folds 
L4zy_FiSh joins the table at seat #1 
L4zy_FiSh leaves the table
snow937022: folds 
Uncalled bet ($0.50) returned to ka100pka527
ka100pka527 collected $1 from pot
ka100pka527: doesn't show hand 
*** SUMMARY ***
Total pot $1 | Rake $0 
Seat 1: matiko09 folded before Flop (didn't bet)
Seat 2: picka4u folded before Flop (didn't bet)
Seat 3: Alex Frider folded before Flop (didn't bet)
Seat 4: John_les folded before Flop (didn't bet)
Seat 5: butcheN18 folded before Flop (didn't bet)
Seat 6: flk.Dasas folded before Flop (didn't bet)
Seat 7: Dantist1122 (button) folded before Flop (didn't bet)
Seat 8: snow937022 (small blind) folded before Flop
Seat 9: ka100pka527 (big blind) collected ($1)





PokerStars Hand #155373902218:  Hold'em No Limit ($0.25/$0.50 USD) - 2016/06/30 8:43:39 CET [2016/06/30 2:43:39 ET]
Table 'Adeona III' 9-max Seat #9 is the button
Seat 1: John_les ($51.06 in chips) 
Seat 2: matiko09 ($50 in chips) 
Seat 3: POTAPENKO700 ($55.62 in chips) 
Seat 4: antwon914 ($81.72 in chips) 
Seat 6: KABAL_ua ($89.09 in chips) 
Seat 7: Sniper1717 ($57.43 in chips) 
Seat 9: ja crisham ($50.60 in chips) 
John_les: posts small blind $0.25
matiko09: posts big blind $0.50
THREE FlDDY: sits out 
*** HOLE CARDS ***
Dealt to matiko09 [8c 9d]
POTAPENKO700: folds 
antwon914: folds 
KABAL_ua: folds 
Sniper1717: folds 
ja crisham: calls $0.50
John_les: folds 
matiko09: checks 
*** FLOP *** [Qc 8s Tc]
matiko09: checks 
ja crisham: bets $1
matiko09: calls $1
*** TURN *** [Qc 8s Tc] [6d]
matiko09: checks 
ja crisham: bets $1.50
matiko09: folds 
Uncalled bet ($1.50) returned to ja crisham
ja crisham collected $3.09 from pot
ja crisham: doesn't show hand 
*** SUMMARY ***
Total pot $3.25 | Rake $0.16 
Board [Qc 8s Tc 6d]
Seat 1: John_les (small blind) folded before Flop
Seat 2: matiko09 (big blind) folded on the Turn
Seat 3: POTAPENKO700 folded before Flop (didn't bet)
Seat 4: antwon914 folded before Flop (didn't bet)
Seat 6: KABAL_ua folded before Flop (didn't bet)
Seat 7: Sniper1717 folded before Flop (didn't bet)
Seat 9: ja crisham (button) collected ($3.09)





PokerStars Hand #155373905571:  Hold'em No Limit ($0.50/$1.00 USD) - 2016/06/30 8:43:53 CET [2016/06/30 2:43:53 ET]
Table 'Armisticia' 9-max Seat #2 is the button
Seat 1: butcheN18 ($108 in chips) 
Seat 2: Yaaaazz ($101.50 in chips) 
Seat 3: Alex Frider ($106.03 in chips) 
Seat 4: L4zy_FiSh ($100 in chips) 
Seat 5: picka4u ($48.31 in chips) 
Seat 7: Ronfar3 ($126.07 in chips) 
Seat 8: matiko09 ($100 in chips) 
Seat 9: MarioDong ($122.55 in chips) 
Alex Frider: posts small blind $0.50
L4zy_FiSh: posts big blind $1
*** HOLE CARDS ***
Dealt to matiko09 [Tc 5c]
picka4u: raises $1.25 to $2.25
Ronfar3: calls $2.25
matiko09: folds 
MarioDong: folds 
butcheN18: folds 
Yaaaazz: folds 
Alex Frider: folds 
L4zy_FiSh: folds 
*** FLOP *** [Ad 6h 2s]
picka4u: bets $3.56
Ronfar3: folds 
Uncalled bet ($3.56) returned to picka4u
picka4u collected $5.70 from pot
picka4u: doesn't show hand 
*** SUMMARY ***
Total pot $6 | Rake $0.30 
Board [Ad 6h 2s]
Seat 1: butcheN18 folded before Flop (didn't bet)
Seat 2: Yaaaazz (button) folded before Flop (didn't bet)
Seat 3: Alex Frider (small blind) folded before Flop
Seat 4: L4zy_FiSh (big blind) folded before Flop
Seat 5: picka4u collected ($5.70)
Seat 7: Ronfar3 folded on the Flop
Seat 8: matiko09 folded before Flop (didn't bet)
Seat 9: MarioDong folded before Flop (didn't bet)





PokerStars Hand #155373907415:  Hold'em No Limit ($0.50/$1.00 USD) - 2016/06/30 8:44:01 CET [2016/06/30 2:44:01 ET]
Table 'Aunus' 9-max Seat #1 is the button
Seat 1: dboy604 ($162.29 in chips) 
Seat 2: HasBigBiceps ($109.77 in chips) 
Seat 3: matiko09 ($100 in chips) 
Seat 4: ilaviiitech ($100 in chips) 
Seat 6: RoadtoNepal ($109.12 in chips) 
Seat 7: ka100pka527 ($38.50 in chips) 
Seat 8: Dantist1122 ($100 in chips) 
Seat 9: flk.Dasas ($100 in chips) 
HasBigBiceps: posts small blind $0.50
matiko09: posts big blind $1
hammerwife: sits out 
*** HOLE CARDS ***
Dealt to matiko09 [6h Jd]
ilaviiitech: folds 
dboy604 said, "</3"
RoadtoNepal has timed out
RoadtoNepal: folds 
ka100pka527: folds 
Dantist1122: folds 
flk.Dasas: raises $1.50 to $2.50
dboy604: raises $2.50 to $5
HasBigBiceps: folds 
matiko09: folds 
flk.Dasas: raises $5 to $10
dboy604: calls $5
*** FLOP *** [3d Kc Ah]
flk.Dasas: bets $12.05
dboy604: calls $12.05
*** TURN *** [3d Kc Ah] [Qd]
flk.Dasas: bets $28.52
dboy604: folds 
Uncalled bet ($28.52) returned to flk.Dasas
flk.Dasas collected $43.32 from pot
flk.Dasas: doesn't show hand 
*** SUMMARY ***
Total pot $45.60 | Rake $2.28 
Board [3d Kc Ah Qd]
Seat 1: dboy604 (button) folded on the Turn
Seat 2: HasBigBiceps (small blind) folded before Flop
Seat 3: matiko09 (big blind) folded before Flop
Seat 4: ilaviiitech folded before Flop (didn't bet)
Seat 6: RoadtoNepal folded before Flop (didn't bet)
Seat 7: ka100pka527 folded before Flop (didn't bet)
Seat 8: Dantist1122 folded before Flop (didn't bet)
Seat 9: flk.Dasas collected ($43.32)





PokerStars Hand #155373908425:  Hold'em No Limit ($0.50/$1.00 USD) - 2016/06/30 8:44:05 CET [2016/06/30 2:44:05 ET]
Table 'Asmodeus' 9-max Seat #7 is the button
Seat 2: John_les ($149.90 in chips) 
Seat 3: L4zy_FiSh ($127.14 in chips) 
Seat 4: matiko09 ($100 in chips) 
Seat 5: butcheN18 ($236.70 in chips) 
Seat 6: snow937022 ($131.66 in chips) 
Seat 7: picka4u ($38.50 in chips) 
Seat 8: ka100pka527 ($36.50 in chips) 
Seat 9: flk.Dasas ($247.15 in chips) 
ka100pka527: posts small blind $0.50
flk.Dasas: posts big blind $1
*** HOLE CARDS ***
Dealt to matiko09 [9h 4h]
John_les: folds 
L4zy_FiSh: folds 
matiko09: folds 
butcheN18: folds 
snow937022: folds 
picka4u: raises $1.05 to $2.05
ka100pka527: folds 
flk.Dasas: calls $1.05
*** FLOP *** [6s Th Td]
flk.Dasas: checks 
RoadtoNepal joins the table at seat #1 
picka4u: bets $2.50
RoadtoNepal leaves the table
dlazechk joins the table at seat #1 
flk.Dasas: raises $4.50 to $7
picka4u: calls $4.50
*** TURN *** [6s Th Td] [As]
dlazechk leaves the table
flk.Dasas: checks 
picka4u: checks 
*** RIVER *** [6s Th Td As] [Jh]
flk.Dasas: checks 
picka4u: checks 
*** SHOW DOWN ***
flk.Dasas: shows [Js Qd] (two pair, Jacks and Tens)
picka4u: shows [Ad Qh] (two pair, Aces and Tens)
picka4u collected $17.67 from pot
*** SUMMARY ***
Total pot $18.60 | Rake $0.93 
Board [6s Th Td As Jh]
Seat 2: John_les folded before Flop (didn't bet)
Seat 3: L4zy_FiSh folded before Flop (didn't bet)
Seat 4: matiko09 folded before Flop (didn't bet)
Seat 5: butcheN18 folded before Flop (didn't bet)
Seat 6: snow937022 folded before Flop (didn't bet)
Seat 7: picka4u (button) showed [Ad Qh] and won ($17.67) with two pair, Aces and Tens
Seat 8: ka100pka527 (small blind) folded before Flop
Seat 9: flk.Dasas (big blind) showed [Js Qd] and lost with two pair, Jacks and Tens





PokerStars Hand #155373910132:  Hold'em No Limit ($0.50/$1.00 USD) - 2016/06/30 8:44:12 CET [2016/06/30 2:44:12 ET]
Table 'Barto' 9-max Seat #7 is the button
Seat 1: hammerwife ($123 in chips) 
Seat 2: Yaaaazz ($118.15 in chips) 
Seat 3: John_les ($100 in chips) 
Seat 4: ricksdogs77 ($52.29 in chips) 
Seat 5: Ronfar3 ($108.65 in chips) 
Seat 6: Dantist1122 ($100 in chips) 
Seat 7: RoadtoNepal ($100 in chips) 
Seat 8: matiko09 ($100 in chips) 
Seat 9: greg dean ($160.82 in chips) 
matiko09: posts small blind $0.50
greg dean: posts big blind $1
*** HOLE CARDS ***
Dealt to matiko09 [Ac Th]
hammerwife: folds 
Yaaaazz: folds 
John_les: folds 
ricksdogs77: folds 
Ronfar3: folds 
Dantist1122: raises $1.70 to $2.70
RoadtoNepal: folds 
matiko09: folds 
greg dean: calls $1.70
*** FLOP *** [7h Ah Ks]
greg dean: checks 
Dantist1122: checks 
*** TURN *** [7h Ah Ks] [5d]
greg dean: bets $15
Dantist1122: folds 
Uncalled bet ($15) returned to greg dean
greg dean collected $5.60 from pot
*** SUMMARY ***
Total pot $5.90 | Rake $0.30 
Board [7h Ah Ks 5d]
Seat 1: hammerwife folded before Flop (didn't bet)
Seat 2: Yaaaazz folded before Flop (didn't bet)
Seat 3: John_les folded before Flop (didn't bet)
Seat 4: ricksdogs77 folded before Flop (didn't bet)
Seat 5: Ronfar3 folded before Flop (didn't bet)
Seat 6: Dantist1122 folded on the Turn
Seat 7: RoadtoNepal (button) folded before Flop (didn't bet)
Seat 8: matiko09 (small blind) folded before Flop
Seat 9: greg dean (big blind) collected ($5.60)





PokerStars Hand #155373913635:  Hold'em No Limit ($0.25/$0.50 USD) - 2016/06/30 8:44:27 CET [2016/06/30 2:44:27 ET]
Table 'Adeona III' 9-max Seat #1 is the button
Seat 1: John_les ($50.81 in chips) 
Seat 2: matiko09 ($50 in chips) 
Seat 3: POTAPENKO700 ($55.62 in chips) 
Seat 4: antwon914 ($81.72 in chips) 
Seat 6: KABAL_ua ($89.09 in chips) 
Seat 7: Sniper1717 ($57.43 in chips) 
Seat 9: ja crisham ($52.19 in chips) 
matiko09: posts small blind $0.25
POTAPENKO700: posts big blind $0.50
THREE FlDDY: sits out 
Dantistcopra: sits out 
*** HOLE CARDS ***
Dealt to matiko09 [Tc 6h]
antwon914: folds 
KABAL_ua: folds 
Sniper1717: raises $1 to $1.50
ja crisham: folds 
John_les: folds 
matiko09: folds 
POTAPENKO700: folds 
Uncalled bet ($1) returned to Sniper1717
Sniper1717 collected $1.25 from pot
Sniper1717: doesn't show hand 
*** SUMMARY ***
Total pot $1.25 | Rake $0 
Seat 1: John_les (button) folded before Flop (didn't bet)
Seat 2: matiko09 (small blind) folded before Flop
Seat 3: POTAPENKO700 (big blind) folded before Flop
Seat 4: antwon914 folded before Flop (didn't bet)
Seat 6: KABAL_ua folded before Flop (didn't bet)
Seat 7: Sniper1717 collected ($1.25)
Seat 9: ja crisham folded before Flop (didn't bet)





PokerStars Hand #155373914248:  Hold'em No Limit ($0.50/$1.00 USD) - 2016/06/30 8:44:29 CET [2016/06/30 2:44:29 ET]
Table 'Jarmila' 9-max Seat #3 is the button
Seat 1: Ronfar3 ($100 in chips) 
Seat 2: AA-man-AA27 ($50.13 in chips) 
Seat 3: Dantist1122 ($100 in chips) 
Seat 4: Rohitbarve ($56.56 in chips) 
Seat 5: ilaviiitech ($100 in chips) 
Seat 6: matiko09 ($100 in chips) 
Seat 7: Bid'daum ($80.93 in chips) 
Seat 8: DIMAN_324 ($131.70 in chips) 
Seat 9: ka100pka527 ($39.38 in chips) 
Rohitbarve: posts small blind $0.50
ilaviiitech: posts big blind $1
*** HOLE CARDS ***
Dealt to matiko09 [4s Ac]
matiko09: folds 
Bid'daum: folds 
DIMAN_324: folds 
ka100pka527: folds 
Ronfar3: folds 
AA-man-AA27: raises $1 to $2
Dantist1122: folds 
Rohitbarve: folds 
ilaviiitech: folds 
Uncalled bet ($1) returned to AA-man-AA27
AA-man-AA27 collected $2.50 from pot
AA-man-AA27: doesn't show hand 
*** SUMMARY ***
Total pot $2.50 | Rake $0 
Seat 1: Ronfar3 folded before Flop (didn't bet)
Seat 2: AA-man-AA27 collected ($2.50)
Seat 3: Dantist1122 (button) folded before Flop (didn't bet)
Seat 4: Rohitbarve (small blind) folded before Flop
Seat 5: ilaviiitech (big blind) folded before Flop
Seat 6: matiko09 folded before Flop (didn't bet)
Seat 7: Bid'daum folded before Flop (didn't bet)
Seat 8: DIMAN_324 folded before Flop (didn't bet)
Seat 9: ka100pka527 folded before Flop (didn't bet)





PokerStars Hand #155373915068:  Hold'em No Limit ($0.50/$1.00 USD) - 2016/06/30 8:44:33 CET [2016/06/30 2:44:33 ET]
Table 'Armisticia' 9-max Seat #3 is the button
Seat 1: butcheN18 ($108 in chips) 
Seat 2: Yaaaazz ($101.50 in chips) 
Seat 3: Alex Frider ($105.53 in chips) 
Seat 4: L4zy_FiSh ($100 in chips) 
Seat 5: picka4u ($51.76 in chips) 
Seat 7: Ronfar3 ($123.82 in chips) 
Seat 8: matiko09 ($100 in chips) 
Seat 9: MarioDong ($122.55 in chips) 
L4zy_FiSh: posts small blind $0.50
picka4u: posts big blind $1
*** HOLE CARDS ***
Dealt to matiko09 [Ah 9s]
Ronfar3: folds 
matiko09: folds 
MarioDong: folds 
butcheN18: folds 
Yaaaazz: raises $1.50 to $2.50
Alex Frider: folds 
L4zy_FiSh: folds 
picka4u: folds 
Uncalled bet ($1.50) returned to Yaaaazz
Yaaaazz collected $2.50 from pot
*** SUMMARY ***
Total pot $2.50 | Rake $0 
Seat 1: butcheN18 folded before Flop (didn't bet)
Seat 2: Yaaaazz collected ($2.50)
Seat 3: Alex Frider (button) folded before Flop (didn't bet)
Seat 4: L4zy_FiSh (small blind) folded before Flop
Seat 5: picka4u (big blind) folded before Flop
Seat 7: Ronfar3 folded before Flop (didn't bet)
Seat 8: matiko09 folded before Flop (didn't bet)
Seat 9: MarioDong folded before Flop (didn't bet)





PokerStars Hand #155373915907:  Hold'em No Limit ($0.50/$1.00 USD) - 2016/06/30 8:44:36 CET [2016/06/30 2:44:36 ET]
Table 'Euphrosyne' 9-max Seat #4 is the button
Seat 1: heehon99 ($74.22 in chips) 
Seat 3: picka4u ($50.51 in chips) 
Seat 4: bargs33 ($101.79 in chips) 
Seat 5: L4zy_FiSh ($100 in chips) 
Seat 6: matiko09 ($103.50 in chips) 
Seat 7: flk.Dasas ($125.62 in chips) 
Seat 8: ka100pka527 ($57.50 in chips) 
Seat 9: ratzo64 ($86.48 in chips) 
L4zy_FiSh: posts small blind $0.50
matiko09: posts big blind $1
butcheN18: sits out 
*** HOLE CARDS ***
Dealt to matiko09 [As 5d]
flk.Dasas: folds 
ka100pka527: folds 
ratzo64: folds 
heehon99: calls $1
picka4u: raises $2.50 to $3.50
bargs33: folds 
L4zy_FiSh: raises $7 to $10.50
matiko09: folds 
heehon99: folds 
picka4u: calls $7
*** FLOP *** [8c Qs 3s]
L4zy_FiSh: checks 
picka4u: checks 
*** TURN *** [8c Qs 3s] [6d]
L4zy_FiSh: bets $12.50
picka4u: raises $27.51 to $40.01 and is all-in
L4zy_FiSh: calls $27.51
*** FIRST RIVER *** [8c Qs 3s 6d] [5s]
*** SECOND RIVER *** [8c Qs 3s 6d] [2d]
*** FIRST SHOW DOWN ***
L4zy_FiSh: shows [Kc Kh] (a pair of Kings)
picka4u: shows [Qd Ah] (a pair of Queens)
L4zy_FiSh collected $50.26 from pot
*** SECOND SHOW DOWN ***
L4zy_FiSh: shows [Kc Kh] (a pair of Kings)
picka4u: shows [Qd Ah] (a pair of Queens)
L4zy_FiSh collected $50.26 from pot
*** SUMMARY ***
Total pot $103.02 | Rake $2.50 
Hand was run twice
FIRST Board [8c Qs 3s 6d 5s]
SECOND Board [8c Qs 3s 6d 2d]
Seat 1: heehon99 folded before Flop
Seat 3: picka4u showed [Qd Ah] and lost with a pair of Queens, and lost with a pair of Queens
Seat 4: bargs33 (button) folded before Flop (didn't bet)
Seat 5: L4zy_FiSh (small blind) showed [Kc Kh] and won ($50.26) with a pair of Kings, and won ($50.26) with a pair of Kings
Seat 6: matiko09 (big blind) folded before Flop
Seat 7: flk.Dasas folded before Flop (didn't bet)
Seat 8: ka100pka527 folded before Flop (didn't bet)
Seat 9: ratzo64 folded before Flop (didn't bet)





PokerStars Hand #155373918110:  Hold'em No Limit ($0.25/$0.50 USD) - 2016/06/30 8:44:45 CET [2016/06/30 2:44:45 ET]
Table 'Adeona III' 9-max Seat #2 is the button
Seat 1: John_les ($50.81 in chips) 
Seat 2: matiko09 ($50 in chips) 
Seat 3: POTAPENKO700 ($55.12 in chips) 
Seat 4: antwon914 ($81.72 in chips) 
Seat 6: KABAL_ua ($89.09 in chips) 
Seat 7: Sniper1717 ($58.18 in chips) 
Seat 9: ja crisham ($52.19 in chips) 
POTAPENKO700: posts small blind $0.25
antwon914: posts big blind $0.50
THREE FlDDY: sits out 
Dantistcopra: sits out 
*** HOLE CARDS ***
Dealt to matiko09 [8c 7c]
KABAL_ua: folds 
Sniper1717: folds 
ja crisham: folds 
John_les: folds 
matiko09: raises $0.63 to $1.13
POTAPENKO700: folds 
antwon914: calls $0.63
*** FLOP *** [Ad 4h Js]
antwon914: checks 
matiko09: bets $1.55
antwon914: calls $1.55
*** TURN *** [Ad 4h Js] [6s]
antwon914: checks 
matiko09: checks 
*** RIVER *** [Ad 4h Js 6s] [8d]
antwon914: bets $2.13
matiko09: folds 
Uncalled bet ($2.13) returned to antwon914
antwon914 collected $5.33 from pot
antwon914: doesn't show hand 
*** SUMMARY ***
Total pot $5.61 | Rake $0.28 
Board [Ad 4h Js 6s 8d]
Seat 1: John_les folded before Flop (didn't bet)
Seat 2: matiko09 (button) folded on the River
Seat 3: POTAPENKO700 (small blind) folded before Flop
Seat 4: antwon914 (big blind) collected ($5.33)
Seat 6: KABAL_ua folded before Flop (didn't bet)
Seat 7: Sniper1717 folded before Flop (didn't bet)
Seat 9: ja crisham folded before Flop (didn't bet)





PokerStars Hand #155373918382:  Hold'em No Limit ($0.50/$1.00 USD) - 2016/06/30 8:44:46 CET [2016/06/30 2:44:46 ET]
Table 'Barto' 9-max Seat #8 is the button
Seat 1: hammerwife ($123 in chips) 
Seat 2: Yaaaazz ($118.15 in chips) 
Seat 3: John_les ($100 in chips) 
Seat 4: ricksdogs77 ($52.29 in chips) 
Seat 5: Ronfar3 ($108.65 in chips) 
Seat 6: Dantist1122 ($100 in chips) 
Seat 7: RoadtoNepal ($100 in chips) 
Seat 8: matiko09 ($100 in chips) 
Seat 9: greg dean ($163.72 in chips) 
greg dean: posts small blind $0.50
hammerwife: posts big blind $1
*** HOLE CARDS ***
Dealt to matiko09 [6d 9h]
Yaaaazz: folds 
John_les: raises $2.50 to $3.50
ricksdogs77: folds 
Ronfar3: folds 
Dantist1122: folds 
RoadtoNepal: folds 
matiko09: folds 
greg dean: calls $3
hammerwife: folds 
*** FLOP *** [3d Ac Jc]
greg dean: checks 
John_les: bets $5
greg dean: raises $5 to $10
John_les: folds 
Uncalled bet ($5) returned to greg dean
greg dean collected $17.10 from pot
*** SUMMARY ***
Total pot $18 | Rake $0.90 
Board [3d Ac Jc]
Seat 1: hammerwife (big blind) folded before Flop
Seat 2: Yaaaazz folded before Flop (didn't bet)
Seat 3: John_les folded on the Flop
Seat 4: ricksdogs77 folded before Flop (didn't bet)
Seat 5: Ronfar3 folded before Flop (didn't bet)
Seat 6: Dantist1122 folded before Flop (didn't bet)
Seat 7: RoadtoNepal folded before Flop (didn't bet)
Seat 8: matiko09 (button) folded before Flop (didn't bet)
Seat 9: greg dean (small blind) collected ($17.10)





PokerStars Hand #155373919304:  Hold'em No Limit ($0.50/$1.00 USD) - 2016/06/30 8:44:50 CET [2016/06/30 2:44:50 ET]
Table 'Jarmila' 9-max Seat #4 is the button
Seat 1: Ronfar3 ($100 in chips) 
Seat 2: AA-man-AA27 ($51.63 in chips) 
Seat 3: Dantist1122 ($100 in chips) 
Seat 4: Rohitbarve ($56.06 in chips) 
Seat 5: ilaviiitech ($100 in chips) 
Seat 6: matiko09 ($100 in chips) 
Seat 7: Bid'daum ($80.93 in chips) 
Seat 8: DIMAN_324 ($131.70 in chips) 
Seat 9: ka100pka527 ($39.38 in chips) 
ilaviiitech: posts small blind $0.50
matiko09: posts big blind $1
*** HOLE CARDS ***
Dealt to matiko09 [Kc Js]
Bid'daum: folds 
DIMAN_324: folds 
ka100pka527: raises $1 to $2
Ronfar3: folds 
AA-man-AA27: calls $2
Dantist1122: folds 
Rohitbarve: folds 
ilaviiitech: folds 
matiko09: calls $1
*** FLOP *** [Qs Td 2c]
matiko09: checks 
ka100pka527: checks 
AA-man-AA27: checks 
*** TURN *** [Qs Td 2c] [Qd]
matiko09: bets $4.02
ka100pka527: folds 
AA-man-AA27: folds 
Uncalled bet ($4.02) returned to matiko09
matiko09 collected $6.18 from pot
matiko09: doesn't show hand 
*** SUMMARY ***
Total pot $6.50 | Rake $0.32 
Board [Qs Td 2c Qd]
Seat 1: Ronfar3 folded before Flop (didn't bet)
Seat 2: AA-man-AA27 folded on the Turn
Seat 3: Dantist1122 folded before Flop (didn't bet)
Seat 4: Rohitbarve (button) folded before Flop (didn't bet)
Seat 5: ilaviiitech (small blind) folded before Flop
Seat 6: matiko09 (big blind) collected ($6.18)
Seat 7: Bid'daum folded before Flop (didn't bet)
Seat 8: DIMAN_324 folded before Flop (didn't bet)
Seat 9: ka100pka527 folded on the Turn





PokerStars Hand #155373923913:  Hold'em No Limit ($0.50/$1.00 USD) - 2016/06/30 8:45:10 CET [2016/06/30 2:45:10 ET]
Table 'Gaby' 9-max Seat #2 is the button
Seat 1: flk.Dasas ($100 in chips) 
Seat 2: ka100pka527 ($60.83 in chips) 
Seat 4: arctur17 ($70.12 in chips) 
Seat 5: kalcumite ($130.62 in chips) 
Seat 6: RoadtoNepal ($100.98 in chips) 
Seat 8: matiko09 ($100 in chips) 
Seat 9: hammerwife ($100 in chips) 
arctur17: posts small blind $0.50
kalcumite: posts big blind $1
Yaaaazz: sits out 
*** HOLE CARDS ***
Dealt to matiko09 [7s 3d]
x Flyer25 joins the table at seat #3 
RoadtoNepal: folds 
matiko09: folds 
hammerwife: folds 
flk.Dasas: folds 
ka100pka527: raises $1 to $2
arctur17: folds 
kalcumite: calls $1
*** FLOP *** [Qd 5h 6h]
kalcumite: bets $4
ka100pka527: folds 
Uncalled bet ($4) returned to kalcumite
kalcumite collected $4.28 from pot
kalcumite: doesn't show hand 
*** SUMMARY ***
Total pot $4.50 | Rake $0.22 
Board [Qd 5h 6h]
Seat 1: flk.Dasas folded before Flop (didn't bet)
Seat 2: ka100pka527 (button) folded on the Flop
Seat 4: arctur17 (small blind) folded before Flop
Seat 5: kalcumite (big blind) collected ($4.28)
Seat 6: RoadtoNepal folded before Flop (didn't bet)
Seat 8: matiko09 folded before Flop (didn't bet)
Seat 9: hammerwife folded before Flop (didn't bet)





PokerStars Hand #155373928057:  Hold'em No Limit ($0.50/$1.00 USD) - 2016/06/30 8:45:27 CET [2016/06/30 2:45:27 ET]
Table 'Asmodeus' 9-max Seat #8 is the button
Seat 3: L4zy_FiSh ($127.14 in chips) 
Seat 4: matiko09 ($100 in chips) 
Seat 5: butcheN18 ($236.70 in chips) 
Seat 6: snow937022 ($131.66 in chips) 
Seat 7: picka4u ($47.12 in chips) 
Seat 8: ka100pka527 ($36 in chips) 
Seat 9: flk.Dasas ($238.10 in chips) 
flk.Dasas: posts small blind $0.50
John_les: is sitting out 
L4zy_FiSh: posts big blind $1
*** HOLE CARDS ***
Dealt to matiko09 [8d 6d]
John_les leaves the table
matiko09: folds 
butcheN18: folds 
snow937022: folds 
matiko09 leaves the table
picka4u: folds 
ka100pka527: raises $1 to $2
flk.Dasas: folds 
L4zy_FiSh: raises $5 to $7
mickdmac joins the table at seat #1 
tanglawyer joins the table at seat #4 
DIMAN_324 joins the table at seat #2 
ka100pka527: folds 
Uncalled bet ($5) returned to L4zy_FiSh
L4zy_FiSh collected $4.50 from pot
*** SUMMARY ***
Total pot $4.50 | Rake $0 
Seat 3: L4zy_FiSh (big blind) collected ($4.50)
Seat 4: matiko09 folded before Flop (didn't bet)
Seat 5: butcheN18 folded before Flop (didn't bet)
Seat 6: snow937022 folded before Flop (didn't bet)
Seat 7: picka4u folded before Flop (didn't bet)
Seat 8: ka100pka527 (button) folded before Flop
Seat 9: flk.Dasas (small blind) folded before Flop





PokerStars Hand #155373930104:  Hold'em No Limit ($0.50/$1.00 USD) - 2016/06/30 8:45:35 CET [2016/06/30 2:45:35 ET]
Table 'Barto' 9-max Seat #9 is the button
Seat 1: hammerwife ($122 in chips) 
Seat 2: Yaaaazz ($118.15 in chips) 
Seat 3: John_les ($100 in chips) 
Seat 4: ricksdogs77 ($52.29 in chips) 
Seat 5: Ronfar3 ($108.65 in chips) 
Seat 6: Dantist1122 ($100 in chips) 
Seat 7: RoadtoNepal ($100 in chips) 
Seat 8: matiko09 ($100 in chips) 
Seat 9: greg dean ($172.32 in chips) 
hammerwife: posts small blind $0.50
Yaaaazz: posts big blind $1
*** HOLE CARDS ***
Dealt to matiko09 [4d 2h]
John_les: folds 
ricksdogs77: folds 
Ronfar3: folds 
Dantist1122: folds 
RoadtoNepal: folds 
matiko09: folds 
greg dean: calls $1
hammerwife: folds 
Yaaaazz: raises $2.50 to $3.50
greg dean: calls $2.50
*** FLOP *** [3h 8c 8h]
Yaaaazz: checks 
greg dean: checks 
*** TURN *** [3h 8c 8h] [Jc]
Yaaaazz: checks 
greg dean: checks 
*** RIVER *** [3h 8c 8h Jc] [Ad]
Yaaaazz: checks 
greg dean: bets $1
Yaaaazz: folds 
Uncalled bet ($1) returned to greg dean
greg dean collected $7.12 from pot
*** SUMMARY ***
Total pot $7.50 | Rake $0.38 
Board [3h 8c 8h Jc Ad]
Seat 1: hammerwife (small blind) folded before Flop
Seat 2: Yaaaazz (big blind) folded on the River
Seat 3: John_les folded before Flop (didn't bet)
Seat 4: ricksdogs77 folded before Flop (didn't bet)
Seat 5: Ronfar3 folded before Flop (didn't bet)
Seat 6: Dantist1122 folded before Flop (didn't bet)
Seat 7: RoadtoNepal folded before Flop (didn't bet)
Seat 8: matiko09 folded before Flop (didn't bet)
Seat 9: greg dean (button) collected ($7.12)





PokerStars Hand #155373935163:  Hold'em No Limit ($0.50/$1.00 USD) - 2016/06/30 8:45:56 CET [2016/06/30 2:45:56 ET]
Table 'Aunus' 9-max Seat #2 is the button
Seat 1: dboy604 ($140.24 in chips) 
Seat 2: HasBigBiceps ($109.27 in chips) 
Seat 3: matiko09 ($100 in chips) 
Seat 4: ilaviiitech ($100 in chips) 
Seat 6: RoadtoNepal ($109.12 in chips) 
Seat 7: ka100pka527 ($38.50 in chips) 
Seat 8: Dantist1122 ($100 in chips) 
Seat 9: flk.Dasas ($121.27 in chips) 
matiko09: posts small blind $0.50
ilaviiitech: posts big blind $1
hammerwife: sits out 
*** HOLE CARDS ***
Dealt to matiko09 [Ah As]
RoadtoNepal has timed out
RoadtoNepal: folds 
ka100pka527: folds 
Dantist1122: raises $2 to $3
flk.Dasas: folds 
dboy604: folds 
dboy604 leaves the table
HasBigBiceps: calls $3
matiko09: raises $10 to $13
ilaviiitech: folds 
Dantist1122: folds 
HasBigBiceps: calls $10
*** FLOP *** [6d 8c 2h]
L4zy_FiSh joins the table at seat #1 
L4zy_FiSh leaves the table
matiko09: bets $10
HasBigBiceps: folds 
Uncalled bet ($10) returned to matiko09
matiko09 collected $28.50 from pot
matiko09: doesn't show hand 
*** SUMMARY ***
Total pot $30 | Rake $1.50 
Board [6d 8c 2h]
Seat 1: dboy604 folded before Flop (didn't bet)
Seat 2: HasBigBiceps (button) folded on the Flop
Seat 3: matiko09 (small blind) collected ($28.50)
Seat 4: ilaviiitech (big blind) folded before Flop
Seat 6: RoadtoNepal folded before Flop (didn't bet)
Seat 7: ka100pka527 folded before Flop (didn't bet)
Seat 8: Dantist1122 folded before Flop
Seat 9: flk.Dasas folded before Flop (didn't bet)





PokerStars Hand #155373935990:  Hold'em No Limit ($0.50/$1.00 USD) - 2016/06/30 8:46:00 CET [2016/06/30 2:46:00 ET]
Table 'Jarmila' 9-max Seat #5 is the button
Seat 1: Ronfar3 ($100 in chips) 
Seat 2: AA-man-AA27 ($49.63 in chips) 
Seat 3: Dantist1122 ($100 in chips) 
Seat 4: Rohitbarve ($56.06 in chips) 
Seat 5: ilaviiitech ($100 in chips) 
Seat 6: matiko09 ($104.18 in chips) 
Seat 7: Bid'daum ($80.93 in chips) 
Seat 8: DIMAN_324 ($131.70 in chips) 
Seat 9: ka100pka527 ($37.38 in chips) 
matiko09: posts small blind $0.50
Bid'daum: posts big blind $1
*** HOLE CARDS ***
Dealt to matiko09 [Ac 6h]
DIMAN_324: folds 
ka100pka527: folds 
Ronfar3: folds 
AA-man-AA27: folds 
Dantist1122: raises $2 to $3
Rohitbarve: raises $7.50 to $10.50
ilaviiitech: folds 
matiko09: folds 
Bid'daum: folds 
Dantist1122: folds 
Uncalled bet ($7.50) returned to Rohitbarve
Rohitbarve collected $7.50 from pot
Rohitbarve: doesn't show hand 
*** SUMMARY ***
Total pot $7.50 | Rake $0 
Seat 1: Ronfar3 folded before Flop (didn't bet)
Seat 2: AA-man-AA27 folded before Flop (didn't bet)
Seat 3: Dantist1122 folded before Flop
Seat 4: Rohitbarve collected ($7.50)
Seat 5: ilaviiitech (button) folded before Flop (didn't bet)
Seat 6: matiko09 (small blind) folded before Flop
Seat 7: Bid'daum (big blind) folded before Flop
Seat 8: DIMAN_324 folded before Flop (didn't bet)
Seat 9: ka100pka527 folded before Flop (didn't bet)





PokerStars Hand #155373937830:  Hold'em No Limit ($0.50/$1.00 USD) - 2016/06/30 8:46:07 CET [2016/06/30 2:46:07 ET]
Table 'Euphrosyne' 9-max Seat #5 is the button
Seat 1: heehon99 ($73.22 in chips) 
Seat 3: picka4u ($40 in chips) 
Seat 4: bargs33 ($101.79 in chips) 
Seat 5: L4zy_FiSh ($150.01 in chips) 
Seat 6: matiko09 ($102.50 in chips) 
Seat 7: flk.Dasas ($125.62 in chips) 
Seat 8: ka100pka527 ($57.50 in chips) 
Seat 9: ratzo64 ($86.48 in chips) 
matiko09: posts small blind $0.50
flk.Dasas: posts big blind $1
butcheN18: sits out 
*** HOLE CARDS ***
Dealt to matiko09 [5d 5h]
ka100pka527: folds 
ratzo64: folds 
heehon99: folds 
picka4u: folds 
bargs33: folds 
L4zy_FiSh: folds 
matiko09: raises $2 to $3
flk.Dasas: folds 
Uncalled bet ($2) returned to matiko09
matiko09 collected $2 from pot
matiko09: doesn't show hand 
*** SUMMARY ***
Total pot $2 | Rake $0 
Seat 1: heehon99 folded before Flop (didn't bet)
Seat 3: picka4u folded before Flop (didn't bet)
Seat 4: bargs33 folded before Flop (didn't bet)
Seat 5: L4zy_FiSh (button) folded before Flop (didn't bet)
Seat 6: matiko09 (small blind) collected ($2)
Seat 7: flk.Dasas (big blind) folded before Flop
Seat 8: ka100pka527 folded before Flop (didn't bet)
Seat 9: ratzo64 folded before Flop (didn't bet)





PokerStars Hand #155373941175:  Hold'em No Limit ($0.25/$0.50 USD) - 2016/06/30 8:46:22 CET [2016/06/30 2:46:22 ET]
Table 'Adeona III' 9-max Seat #3 is the button
Seat 1: John_les ($50.81 in chips) 
Seat 2: matiko09 ($50 in chips) 
Seat 3: POTAPENKO700 ($54.87 in chips) 
Seat 4: antwon914 ($84.37 in chips) 
Seat 5: THREE FlDDY ($50.87 in chips) 
Seat 6: KABAL_ua ($89.09 in chips) 
Seat 7: Sniper1717 ($58.18 in chips) 
Seat 9: ja crisham ($52.19 in chips) 
antwon914: posts small blind $0.25
THREE FlDDY: posts big blind $0.50
Dantistcopra: sits out 
*** HOLE CARDS ***
Dealt to matiko09 [As 3s]
KABAL_ua: folds 
Sniper1717: folds 
ja crisham: raises $1 to $1.50
John_les: folds 
matiko09: folds 
POTAPENKO700: folds 
antwon914: folds 
THREE FlDDY: calls $1
*** FLOP *** [Qh Jh 5h]
THREE FlDDY: checks 
ja crisham: checks 
*** TURN *** [Qh Jh 5h] [9c]
THREE FlDDY: bets $2.31
ja crisham: calls $2.31
*** RIVER *** [Qh Jh 5h 9c] [9s]
THREE FlDDY: bets $5.61
ja crisham: calls $5.61
*** SHOW DOWN ***
THREE FlDDY: shows [Ts Kh] (a straight, Nine to King)
ja crisham: mucks hand 
THREE FlDDY collected $18.14 from pot
*** SUMMARY ***
Total pot $19.09 | Rake $0.95 
Board [Qh Jh 5h 9c 9s]
Seat 1: John_les folded before Flop (didn't bet)
Seat 2: matiko09 folded before Flop (didn't bet)
Seat 3: POTAPENKO700 (button) folded before Flop (didn't bet)
Seat 4: antwon914 (small blind) folded before Flop
Seat 5: THREE FlDDY (big blind) showed [Ts Kh] and won ($18.14) with a straight, Nine to King
Seat 6: KABAL_ua folded before Flop (didn't bet)
Seat 7: Sniper1717 folded before Flop (didn't bet)
Seat 9: ja crisham mucked [2c 5s]





PokerStars Hand #155373942464:  Hold'em No Limit ($0.50/$1.00 USD) - 2016/06/30 8:46:27 CET [2016/06/30 2:46:27 ET]
Table 'Gaby' 9-max Seat #4 is the button
Seat 1: flk.Dasas ($100 in chips) 
Seat 2: ka100pka527 ($58.83 in chips) 
Seat 3: x Flyer25 ($100 in chips) 
Seat 4: arctur17 ($69.62 in chips) 
Seat 5: kalcumite ($132.90 in chips) 
Seat 7: Yaaaazz ($100 in chips) 
Seat 8: matiko09 ($100 in chips) 
Seat 9: hammerwife ($100 in chips) 
kalcumite: posts small blind $0.50
RoadtoNepal: is sitting out 
Yaaaazz: posts big blind $1
x Flyer25: posts big blind $1
*** HOLE CARDS ***
Dealt to matiko09 [Kh 9d]
matiko09: folds 
hammerwife: folds 
flk.Dasas: folds 
ka100pka527: raises $3 to $4
x Flyer25: calls $3
arctur17: folds 
kalcumite: folds 
Yaaaazz: folds 
*** FLOP *** [7s Jh 4h]
ka100pka527: bets $4.51
x Flyer25: calls $4.51
*** TURN *** [7s Jh 4h] [6c]
ka100pka527: checks 
x Flyer25: bets $8.79
ka100pka527: folds 
Uncalled bet ($8.79) returned to x Flyer25
x Flyer25 collected $17.59 from pot
x Flyer25: doesn't show hand 
*** SUMMARY ***
Total pot $18.52 | Rake $0.93 
Board [7s Jh 4h 6c]
Seat 1: flk.Dasas folded before Flop (didn't bet)
Seat 2: ka100pka527 folded on the Turn
Seat 3: x Flyer25 collected ($17.59)
Seat 4: arctur17 (button) folded before Flop (didn't bet)
Seat 5: kalcumite (small blind) folded before Flop
Seat 7: Yaaaazz (big blind) folded before Flop
Seat 8: matiko09 folded before Flop (didn't bet)
Seat 9: hammerwife folded before Flop (didn't bet)





PokerStars Hand #155373944471:  Hold'em No Limit ($0.50/$1.00 USD) - 2016/06/30 8:46:35 CET [2016/06/30 2:46:35 ET]
Table 'Jarmila' 9-max Seat #6 is the button
Seat 1: Ronfar3 ($100 in chips) 
Seat 2: AA-man-AA27 ($49.63 in chips) 
Seat 3: Dantist1122 ($100 in chips) 
Seat 4: Rohitbarve ($60.56 in chips) 
Seat 5: ilaviiitech ($100 in chips) 
Seat 6: matiko09 ($103.68 in chips) 
Seat 7: Bid'daum ($79.93 in chips) 
Seat 8: DIMAN_324 ($131.70 in chips) 
Seat 9: ka100pka527 ($37.38 in chips) 
Bid'daum: posts small blind $0.50
DIMAN_324: posts big blind $1
*** HOLE CARDS ***
Dealt to matiko09 [7c Ad]
ka100pka527: folds 
Ronfar3: raises $2 to $3
AA-man-AA27: folds 
Dantist1122: folds 
Rohitbarve: folds 
ilaviiitech: folds 
matiko09: folds 
Bid'daum: raises $7 to $10
DIMAN_324: folds 
Ronfar3: folds 
Uncalled bet ($7) returned to Bid'daum
Bid'daum collected $7 from pot
Bid'daum: doesn't show hand 
*** SUMMARY ***
Total pot $7 | Rake $0 
Seat 1: Ronfar3 folded before Flop
Seat 2: AA-man-AA27 folded before Flop (didn't bet)
Seat 3: Dantist1122 folded before Flop (didn't bet)
Seat 4: Rohitbarve folded before Flop (didn't bet)
Seat 5: ilaviiitech folded before Flop (didn't bet)
Seat 6: matiko09 (button) folded before Flop (didn't bet)
Seat 7: Bid'daum (small blind) collected ($7)
Seat 8: DIMAN_324 (big blind) folded before Flop
Seat 9: ka100pka527 folded before Flop (didn't bet)





PokerStars Hand #155373947418:  Hold'em No Limit ($0.50/$1.00 USD) - 2016/06/30 8:46:47 CET [2016/06/30 2:46:47 ET]
Table 'Barto' 9-max Seat #1 is the button
Seat 1: hammerwife ($121.50 in chips) 
Seat 2: Yaaaazz ($114.65 in chips) 
Seat 3: John_les ($100 in chips) 
Seat 4: ricksdogs77 ($52.29 in chips) 
Seat 5: Ronfar3 ($108.65 in chips) 
Seat 6: Dantist1122 ($100 in chips) 
Seat 7: RoadtoNepal ($100 in chips) 
Seat 8: matiko09 ($100 in chips) 
Seat 9: greg dean ($175.94 in chips) 
Yaaaazz: posts small blind $0.50
John_les: posts big blind $1
*** HOLE CARDS ***
Dealt to matiko09 [7c Js]
ricksdogs77: folds 
Ronfar3: folds 
Dantist1122: raises $2 to $3
RoadtoNepal: folds 
matiko09: folds 
greg dean: calls $3
hammerwife: folds 
Yaaaazz: folds 
John_les: folds 
*** FLOP *** [3d 6c 3c]
Dantist1122: bets $3.91
greg dean: calls $3.91
*** TURN *** [3d 6c 3c] [8s]
Dantist1122: bets $8
greg dean: raises $8 to $16
Dantist1122: calls $8
*** RIVER *** [3d 6c 3c 8s] [3s]
Dantist1122: checks 
greg dean: bets $1
Dantist1122: calls $1
*** SHOW DOWN ***
greg dean: shows [8d Kd] (a full house, Threes full of Eights)
Dantist1122: mucks hand 
greg dean collected $46.85 from pot
*** SUMMARY ***
Total pot $49.32 | Rake $2.47 
Board [3d 6c 3c 8s 3s]
Seat 1: hammerwife (button) folded before Flop (didn't bet)
Seat 2: Yaaaazz (small blind) folded before Flop
Seat 3: John_les (big blind) folded before Flop
Seat 4: ricksdogs77 folded before Flop (didn't bet)
Seat 5: Ronfar3 folded before Flop (didn't bet)
Seat 6: Dantist1122 mucked [Kc Jc]
Seat 7: RoadtoNepal folded before Flop (didn't bet)
Seat 8: matiko09 folded before Flop (didn't bet)
Seat 9: greg dean showed [8d Kd] and won ($46.85) with a full house, Threes full of Eights





PokerStars Hand #155373949534:  Hold'em No Limit ($0.50/$1.00 USD) - 2016/06/30 8:46:56 CET [2016/06/30 2:46:56 ET]
Table 'Aunus' 9-max Seat #3 is the button
Seat 2: HasBigBiceps ($100 in chips) 
Seat 3: matiko09 ($115.50 in chips) 
Seat 4: ilaviiitech ($100 in chips) 
Seat 5: hammerwife ($113.30 in chips) 
Seat 6: RoadtoNepal ($109.12 in chips) 
Seat 7: ka100pka527 ($38.50 in chips) 
Seat 8: Dantist1122 ($100 in chips) 
Seat 9: flk.Dasas ($121.27 in chips) 
ilaviiitech: posts small blind $0.50
hammerwife: posts big blind $1
*** HOLE CARDS ***
Dealt to matiko09 [7d 7c]
RoadtoNepal: folds 
ka100pka527: folds 
Dantist1122: folds 
flk.Dasas: folds 
HasBigBiceps: folds 
matiko09: raises $1.27 to $2.27
ilaviiitech: folds 
hammerwife: calls $1.27
*** FLOP *** [9s Jh Ad]
hammerwife: checks 
matiko09: checks 
*** TURN *** [9s Jh Ad] [Ac]
ASabir joins the table at seat #1 
hammerwife: bets $4.79
matiko09: folds 
Uncalled bet ($4.79) returned to hammerwife
hammerwife collected $4.79 from pot
hammerwife: doesn't show hand 
*** SUMMARY ***
Total pot $5.04 | Rake $0.25 
Board [9s Jh Ad Ac]
Seat 2: HasBigBiceps folded before Flop (didn't bet)
Seat 3: matiko09 (button) folded on the Turn
Seat 4: ilaviiitech (small blind) folded before Flop
Seat 5: hammerwife (big blind) collected ($4.79)
Seat 6: RoadtoNepal folded before Flop (didn't bet)
Seat 7: ka100pka527 folded before Flop (didn't bet)
Seat 8: Dantist1122 folded before Flop (didn't bet)
Seat 9: flk.Dasas folded before Flop (didn't bet)





PokerStars Hand #155373950648:  Hold'em No Limit ($0.50/$1.00 USD) - 2016/06/30 8:47:00 CET [2016/06/30 2:47:00 ET]
Table 'Euphrosyne' 9-max Seat #6 is the button
Seat 1: heehon99 ($73.22 in chips) 
Seat 3: picka4u ($40 in chips) 
Seat 4: bargs33 ($101.79 in chips) 
Seat 5: L4zy_FiSh ($150.01 in chips) 
Seat 6: matiko09 ($103.50 in chips) 
Seat 7: flk.Dasas ($124.62 in chips) 
Seat 8: ka100pka527 ($57.50 in chips) 
Seat 9: ratzo64 ($86.48 in chips) 
flk.Dasas: posts small blind $0.50
ka100pka527: posts big blind $1
butcheN18: sits out 
*** HOLE CARDS ***
Dealt to matiko09 [8d 8h]
ratzo64: folds 
heehon99: folds 
picka4u: folds 
bargs33: raises $2 to $3
L4zy_FiSh: folds 
matiko09: calls $3
flk.Dasas: folds 
ka100pka527: folds 
*** FLOP *** [7c Js Qs]
bargs33: checks 
matiko09: checks 
*** TURN *** [7c Js Qs] [Jd]
bargs33: bets $4
matiko09: calls $4
*** RIVER *** [7c Js Qs Jd] [6s]
bargs33: checks 
matiko09: checks 
*** SHOW DOWN ***
bargs33: shows [2h 2c] (two pair, Jacks and Deuces)
matiko09: shows [8d 8h] (two pair, Jacks and Eights)
matiko09 collected $14.72 from pot
*** SUMMARY ***
Total pot $15.50 | Rake $0.78 
Board [7c Js Qs Jd 6s]
Seat 1: heehon99 folded before Flop (didn't bet)
Seat 3: picka4u folded before Flop (didn't bet)
Seat 4: bargs33 showed [2h 2c] and lost with two pair, Jacks and Deuces
Seat 5: L4zy_FiSh folded before Flop (didn't bet)
Seat 6: matiko09 (button) showed [8d 8h] and won ($14.72) with two pair, Jacks and Eights
Seat 7: flk.Dasas (small blind) folded before Flop
Seat 8: ka100pka527 (big blind) folded before Flop
Seat 9: ratzo64 folded before Flop (didn't bet)





PokerStars Hand #155373955929:  Hold'em No Limit ($0.50/$1.00 USD) - 2016/06/30 8:47:22 CET [2016/06/30 2:47:22 ET]
Table 'Jarmila' 9-max Seat #7 is the button
Seat 1: Ronfar3 ($100 in chips) 
Seat 2: AA-man-AA27 ($49.63 in chips) 
Seat 3: Dantist1122 ($100 in chips) 
Seat 4: Rohitbarve ($60.56 in chips) 
Seat 5: ilaviiitech ($100 in chips) 
Seat 6: matiko09 ($103.68 in chips) 
Seat 7: Bid'daum ($83.93 in chips) 
Seat 8: DIMAN_324 ($130.70 in chips) 
Seat 9: ka100pka527 ($37.38 in chips) 
DIMAN_324: posts small blind $0.50
ka100pka527: posts big blind $1
*** HOLE CARDS ***
Dealt to matiko09 [Tc 7c]
Ronfar3: folds 
AA-man-AA27: raises $2 to $3
Dantist1122: folds 
Rohitbarve: folds 
ilaviiitech: calls $3
matiko09: folds 
Bid'daum: folds 
DIMAN_324: calls $2.50
ka100pka527: folds 
*** FLOP *** [8c 9d Qc]
DIMAN_324: checks 
AA-man-AA27: bets $2
ilaviiitech: raises $4 to $6
DIMAN_324: folds 
AA-man-AA27: calls $4
*** TURN *** [8c 9d Qc] [5c]
AA-man-AA27: checks 
ilaviiitech: checks 
*** RIVER *** [8c 9d Qc 5c] [5h]
AA-man-AA27: bets $7
ilaviiitech: calls $7
*** SHOW DOWN ***
AA-man-AA27: shows [Jh Ac] (a pair of Fives)
ilaviiitech: shows [Qh Ad] (two pair, Queens and Fives)
ilaviiitech collected $34.20 from pot
*** SUMMARY ***
Total pot $36 | Rake $1.80 
Board [8c 9d Qc 5c 5h]
Seat 1: Ronfar3 folded before Flop (didn't bet)
Seat 2: AA-man-AA27 showed [Jh Ac] and lost with a pair of Fives
Seat 3: Dantist1122 folded before Flop (didn't bet)
Seat 4: Rohitbarve folded before Flop (didn't bet)
Seat 5: ilaviiitech showed [Qh Ad] and won ($34.20) with two pair, Queens and Fives
Seat 6: matiko09 folded before Flop (didn't bet)
Seat 7: Bid'daum (button) folded before Flop (didn't bet)
Seat 8: DIMAN_324 (small blind) folded on the Flop
Seat 9: ka100pka527 (big blind) folded before Flop





PokerStars Hand #155373957329:  Hold'em No Limit ($0.50/$1.00 USD) - 2016/06/30 8:47:28 CET [2016/06/30 2:47:28 ET]
Table 'Gaby' 9-max Seat #5 is the button
Seat 1: flk.Dasas ($100 in chips) 
Seat 2: ka100pka527 ($50.32 in chips) 
Seat 3: x Flyer25 ($109.08 in chips) 
Seat 4: arctur17 ($69.62 in chips) 
Seat 5: kalcumite ($132.40 in chips) 
Seat 7: Yaaaazz ($100 in chips) 
Seat 8: matiko09 ($100 in chips) 
Seat 9: hammerwife ($100 in chips) 
RoadtoNepal will be allowed to play after the button
Yaaaazz: posts small blind $0.50
matiko09: posts big blind $1
*** HOLE CARDS ***
Dealt to matiko09 [9h 3h]
hammerwife: folds 
flk.Dasas: folds 
ka100pka527: raises $2 to $3
x Flyer25: folds 
arctur17: calls $3
kalcumite: folds 
Yaaaazz: folds 
matiko09: folds 
*** FLOP *** [3s 7s Tc]
ka100pka527: bets $3.56
arctur17: calls $3.56
*** TURN *** [3s 7s Tc] [8d]
ka100pka527: bets $9.25
arctur17: folds 
Uncalled bet ($9.25) returned to ka100pka527
ka100pka527 collected $13.89 from pot
ka100pka527: doesn't show hand 
*** SUMMARY ***
Total pot $14.62 | Rake $0.73 
Board [3s 7s Tc 8d]
Seat 1: flk.Dasas folded before Flop (didn't bet)
Seat 2: ka100pka527 collected ($13.89)
Seat 3: x Flyer25 folded before Flop (didn't bet)
Seat 4: arctur17 folded on the Turn
Seat 5: kalcumite (button) folded before Flop (didn't bet)
Seat 7: Yaaaazz (small blind) folded before Flop
Seat 8: matiko09 (big blind) folded before Flop
Seat 9: hammerwife folded before Flop (didn't bet)





PokerStars Hand #155373960361:  Hold'em No Limit ($0.25/$0.50 USD) - 2016/06/30 8:47:41 CET [2016/06/30 2:47:41 ET]
Table 'Adeona III' 9-max Seat #4 is the button
Seat 1: John_les ($50.81 in chips) 
Seat 2: matiko09 ($50 in chips) 
Seat 3: POTAPENKO700 ($54.87 in chips) 
Seat 4: antwon914 ($84.12 in chips) 
Seat 5: THREE FlDDY ($59.59 in chips) 
Seat 6: KABAL_ua ($89.09 in chips) 
Seat 7: Sniper1717 ($58.18 in chips) 
Seat 9: ja crisham ($42.77 in chips) 
THREE FlDDY: posts small blind $0.25
KABAL_ua: posts big blind $0.50
Dantistcopra: sits out 
*** HOLE CARDS ***
Dealt to matiko09 [Ah 7c]
Sniper1717: folds 
ja crisham: raises $2 to $2.50
John_les: folds 
matiko09: folds 
POTAPENKO700: calls $2.50
antwon914: folds 
THREE FlDDY: folds 
KABAL_ua: folds 
*** FLOP *** [Jh Jc 6h]
ja crisham: bets $3.50
POTAPENKO700: folds 
Uncalled bet ($3.50) returned to ja crisham
ja crisham collected $5.46 from pot
ja crisham: doesn't show hand 
*** SUMMARY ***
Total pot $5.75 | Rake $0.29 
Board [Jh Jc 6h]
Seat 1: John_les folded before Flop (didn't bet)
Seat 2: matiko09 folded before Flop (didn't bet)
Seat 3: POTAPENKO700 folded on the Flop
Seat 4: antwon914 (button) folded before Flop (didn't bet)
Seat 5: THREE FlDDY (small blind) folded before Flop
Seat 6: KABAL_ua (big blind) folded before Flop
Seat 7: Sniper1717 folded before Flop (didn't bet)
Seat 9: ja crisham collected ($5.46)





PokerStars Hand #155373964029:  Hold'em No Limit (€0.25/€0.50 EUR) - 2016/06/30 8:47:56 CET [2016/06/30 2:47:56 ET]
Table 'Erda III' 9-max Seat #8 is the button
Seat 5: BlackHawk901 (€50 in chips) 
Seat 8: Gigi201133 (€40 in chips) 
Seat 9: matiko09 (€50 in chips) 
matiko09: posts small blind €0.25
BlackHawk901: posts big blind €0.50
*** HOLE CARDS ***
Dealt to matiko09 [Kc 6s]
Gigi201133: folds 
matiko09: folds 
Uncalled bet (€0.25) returned to BlackHawk901
BlackHawk901 collected €0.50 from pot
BlackHawk901: doesn't show hand 
*** SUMMARY ***
Total pot €0.50 | Rake €0 
Seat 5: BlackHawk901 (big blind) collected (€0.50)
Seat 8: Gigi201133 (button) folded before Flop (didn't bet)
Seat 9: matiko09 (small blind) folded before Flop





PokerStars Hand #155373967568:  Hold'em No Limit (€0.25/€0.50 EUR) - 2016/06/30 8:48:11 CET [2016/06/30 2:48:11 ET]
Table 'Erda III' 9-max Seat #9 is the button
Seat 5: BlackHawk901 (€50.25 in chips) 
Seat 8: Gigi201133 (€40 in chips) 
Seat 9: matiko09 (€50 in chips) 
BlackHawk901: posts small blind €0.25
Gigi201133: posts big blind €0.50
*** HOLE CARDS ***
Dealt to matiko09 [7d Qh]
Bailey Dew joins the table at seat #1 
matiko09: folds 
BlackHawk901: folds 
Uncalled bet (€0.25) returned to Gigi201133
Gigi201133 collected €0.50 from pot
*** SUMMARY ***
Total pot €0.50 | Rake €0 
Seat 5: BlackHawk901 (small blind) folded before Flop
Seat 8: Gigi201133 (big blind) collected (€0.50)
Seat 9: matiko09 (button) folded before Flop (didn't bet)





PokerStars Hand #155373967851:  Hold'em No Limit ($0.50/$1.00 USD) - 2016/06/30 8:48:12 CET [2016/06/30 2:48:12 ET]
Table 'Barto' 9-max Seat #2 is the button
Seat 1: hammerwife ($121.50 in chips) 
Seat 2: Yaaaazz ($114.15 in chips) 
Seat 3: John_les ($100 in chips) 
Seat 4: ricksdogs77 ($52.29 in chips) 
Seat 5: Ronfar3 ($108.65 in chips) 
Seat 6: Dantist1122 ($100 in chips) 
Seat 7: RoadtoNepal ($100 in chips) 
Seat 8: matiko09 ($100 in chips) 
Seat 9: greg dean ($198.88 in chips) 
John_les: posts small blind $0.50
ricksdogs77: posts big blind $1
*** HOLE CARDS ***
Dealt to matiko09 [Ts 3d]
Ronfar3: folds 
Dantist1122: raises $2 to $3
RoadtoNepal: folds 
matiko09: folds 
greg dean: calls $3
hammerwife: folds 
Yaaaazz: folds 
John_les: folds 
ricksdogs77: folds 
*** FLOP *** [2d 7s 8s]
Dantist1122: checks 
greg dean: bets $8
Dantist1122: folds 
Uncalled bet ($8) returned to greg dean
greg dean collected $7.12 from pot
*** SUMMARY ***
Total pot $7.50 | Rake $0.38 
Board [2d 7s 8s]
Seat 1: hammerwife folded before Flop (didn't bet)
Seat 2: Yaaaazz (button) folded before Flop (didn't bet)
Seat 3: John_les (small blind) folded before Flop
Seat 4: ricksdogs77 (big blind) folded before Flop
Seat 5: Ronfar3 folded before Flop (didn't bet)
Seat 6: Dantist1122 folded on the Flop
Seat 7: RoadtoNepal folded before Flop (didn't bet)
Seat 8: matiko09 folded before Flop (didn't bet)
Seat 9: greg dean collected ($7.12)





PokerStars Hand #155373970066:  Hold'em No Limit (€0.25/€0.50 EUR) - 2016/06/30 8:48:21 CET [2016/06/30 2:48:21 ET]
Table 'Erda III' 9-max Seat #5 is the button
Seat 5: BlackHawk901 (€50 in chips) 
Seat 8: Gigi201133 (€40.25 in chips) 
Seat 9: matiko09 (€50 in chips) 
Gigi201133: posts small blind €0.25
matiko09: posts big blind €0.50
Bailey Dew: sits out 
*** HOLE CARDS ***
Dealt to matiko09 [Qc Qs]
BlackHawk901: folds 
Gigi201133: raises €1 to €1.50
matiko09: raises €3 to €4.50
Gigi201133: calls €3
*** FLOP *** [7d Jh 7h]
Gigi201133: bets €4.50
matiko09: raises €7 to €11.50
Gigi201133: raises €24.25 to €35.75 and is all-in
matiko09: calls €24.25
*** TURN *** [7d Jh 7h] [6h]
*** RIVER *** [7d Jh 7h 6h] [Jc]
*** SHOW DOWN ***
Gigi201133: shows [Js Td] (a full house, Jacks full of Sevens)
matiko09: shows [Qc Qs] (two pair, Queens and Jacks)
Gigi201133 collected €79.80 from pot
*** SUMMARY ***
Total pot €80.50 | Rake €0.70 
Board [7d Jh 7h 6h Jc]
Seat 5: BlackHawk901 (button) folded before Flop (didn't bet)
Seat 8: Gigi201133 (small blind) showed [Js Td] and won (€79.80) with a full house, Jacks full of Sevens
Seat 9: matiko09 (big blind) showed [Qc Qs] and lost with two pair, Queens and Jacks





PokerStars Hand #155373975214:  Hold'em No Limit ($0.50/$1.00 USD) - 2016/06/30 8:48:42 CET [2016/06/30 2:48:42 ET]
Table 'Aunus' 9-max Seat #4 is the button
Seat 2: HasBigBiceps ($100 in chips) 
Seat 3: matiko09 ($113.23 in chips) 
Seat 4: ilaviiitech ($100 in chips) 
Seat 5: hammerwife ($115.82 in chips) 
Seat 6: RoadtoNepal ($109.12 in chips) 
Seat 7: ka100pka527 ($38.50 in chips) 
Seat 8: Dantist1122 ($100 in chips) 
Seat 9: flk.Dasas ($121.27 in chips) 
hammerwife: posts small blind $0.50
RoadtoNepal: posts big blind $1
ASabir: sits out 
*** HOLE CARDS ***
Dealt to matiko09 [4s 2c]
ka100pka527: folds 
Dantist1122: raises $2 to $3
flk.Dasas: folds 
HasBigBiceps: folds 
matiko09: folds 
ilaviiitech: folds 
hammerwife: folds 
RoadtoNepal: folds 
Uncalled bet ($2) returned to Dantist1122
Dantist1122 collected $2.50 from pot
Dantist1122: doesn't show hand 
*** SUMMARY ***
Total pot $2.50 | Rake $0 
Seat 2: HasBigBiceps folded before Flop (didn't bet)
Seat 3: matiko09 folded before Flop (didn't bet)
Seat 4: ilaviiitech (button) folded before Flop (didn't bet)
Seat 5: hammerwife (small blind) folded before Flop
Seat 6: RoadtoNepal (big blind) folded before Flop
Seat 7: ka100pka527 folded before Flop (didn't bet)
Seat 8: Dantist1122 collected ($2.50)
Seat 9: flk.Dasas folded before Flop (didn't bet)





PokerStars Hand #155373975429:  Hold'em No Limit ($0.50/$1.00 USD) - 2016/06/30 8:48:43 CET [2016/06/30 2:48:43 ET]
Table 'Barto' 9-max Seat #3 is the button
Seat 1: hammerwife ($121.50 in chips) 
Seat 2: Yaaaazz ($114.15 in chips) 
Seat 3: John_les ($100 in chips) 
Seat 4: ricksdogs77 ($51.29 in chips) 
Seat 5: Ronfar3 ($108.65 in chips) 
Seat 6: Dantist1122 ($100 in chips) 
Seat 7: RoadtoNepal ($100 in chips) 
Seat 8: matiko09 ($100 in chips) 
Seat 9: greg dean ($203 in chips) 
ricksdogs77: posts small blind $0.50
Ronfar3: posts big blind $1
*** HOLE CARDS ***
Dealt to matiko09 [9h 5d]
Dantist1122: raises $2 to $3
RoadtoNepal: folds 
matiko09: folds 
greg dean: calls $3
hammerwife: folds 
Yaaaazz: calls $3
John_les: folds 
ricksdogs77: folds 
Ronfar3: folds 
*** FLOP *** [3s 5c 8d]
Dantist1122: checks 
greg dean: checks 
Yaaaazz: bets $3
Dantist1122: folds 
greg dean: calls $3
*** TURN *** [3s 5c 8d] [2d]
greg dean: checks 
Yaaaazz: checks 
*** RIVER *** [3s 5c 8d 2d] [4d]
greg dean: bets $1
Yaaaazz: calls $1
*** SHOW DOWN ***
greg dean: shows [Th 7c] (high card Ten)
Yaaaazz: shows [7h 7s] (a pair of Sevens)
Yaaaazz collected $17.58 from pot
*** SUMMARY ***
Total pot $18.50 | Rake $0.92 
Board [3s 5c 8d 2d 4d]
Seat 1: hammerwife folded before Flop (didn't bet)
Seat 2: Yaaaazz showed [7h 7s] and won ($17.58) with a pair of Sevens
Seat 3: John_les (button) folded before Flop (didn't bet)
Seat 4: ricksdogs77 (small blind) folded before Flop
Seat 5: Ronfar3 (big blind) folded before Flop
Seat 6: Dantist1122 folded on the Flop
Seat 7: RoadtoNepal folded before Flop (didn't bet)
Seat 8: matiko09 folded before Flop (didn't bet)
Seat 9: greg dean showed [Th 7c] and lost with high card Ten





PokerStars Hand #155373977503:  Hold'em No Limit ($0.50/$1.00 USD) - 2016/06/30 8:48:52 CET [2016/06/30 2:48:52 ET]
Table 'Euphrosyne' 9-max Seat #7 is the button
Seat 1: heehon99 ($73.22 in chips) 
Seat 3: picka4u ($40 in chips) 
Seat 4: bargs33 ($94.79 in chips) 
Seat 5: L4zy_FiSh ($150.01 in chips) 
Seat 6: matiko09 ($111.22 in chips) 
Seat 7: flk.Dasas ($124.12 in chips) 
Seat 8: ka100pka527 ($56.50 in chips) 
Seat 9: ratzo64 ($86.48 in chips) 
ka100pka527: posts small blind $0.50
ratzo64: posts big blind $1
butcheN18: sits out 
*** HOLE CARDS ***
Dealt to matiko09 [Ts 9c]
heehon99: folds 
picka4u: folds 
bargs33: folds 
L4zy_FiSh: folds 
matiko09: folds 
flk.Dasas: raises $1.50 to $2.50
ka100pka527: folds 
ratzo64: calls $1.50
*** FLOP *** [2h 9d 9s]
ratzo64: checks 
flk.Dasas: bets $2.51
ratzo64: folds 
Uncalled bet ($2.51) returned to flk.Dasas
flk.Dasas collected $5.22 from pot
flk.Dasas: doesn't show hand 
*** SUMMARY ***
Total pot $5.50 | Rake $0.28 
Board [2h 9d 9s]
Seat 1: heehon99 folded before Flop (didn't bet)
Seat 3: picka4u folded before Flop (didn't bet)
Seat 4: bargs33 folded before Flop (didn't bet)
Seat 5: L4zy_FiSh folded before Flop (didn't bet)
Seat 6: matiko09 folded before Flop (didn't bet)
Seat 7: flk.Dasas (button) collected ($5.22)
Seat 8: ka100pka527 (small blind) folded before Flop
Seat 9: ratzo64 (big blind) folded on the Flop





PokerStars Hand #155373978487:  Hold'em No Limit ($0.50/$1.00 USD) - 2016/06/30 8:48:56 CET [2016/06/30 2:48:56 ET]
Table 'Gaby' 9-max Seat #7 is the button
Seat 1: flk.Dasas ($100 in chips) 
Seat 2: ka100pka527 ($57.65 in chips) 
Seat 3: x Flyer25 ($109.08 in chips) 
Seat 4: arctur17 ($63.06 in chips) 
Seat 5: kalcumite ($132.40 in chips) 
Seat 6: RoadtoNepal ($100.98 in chips) 
Seat 7: Yaaaazz ($100 in chips) 
Seat 8: matiko09 ($100 in chips) 
Seat 9: hammerwife ($100 in chips) 
matiko09: posts small blind $0.50
hammerwife: posts big blind $1
RoadtoNepal: posts small & big blinds $1.50
*** HOLE CARDS ***
Dealt to matiko09 [Jd 8c]
flk.Dasas: raises $3 to $4
ka100pka527: folds 
x Flyer25: calls $4
arctur17: folds 
kalcumite: folds 
RoadtoNepal: folds 
Yaaaazz: folds 
matiko09: folds 
hammerwife: folds 
*** FLOP *** [As Ks 3s]
flk.Dasas: bets $7.11
x Flyer25: calls $7.11
*** TURN *** [As Ks 3s] [Th]
flk.Dasas: checks 
x Flyer25: bets $11.98
flk.Dasas: folds 
Uncalled bet ($11.98) returned to x Flyer25
x Flyer25 collected $23.96 from pot
x Flyer25: doesn't show hand 
*** SUMMARY ***
Total pot $25.22 | Rake $1.26 
Board [As Ks 3s Th]
Seat 1: flk.Dasas folded on the Turn
Seat 2: ka100pka527 folded before Flop (didn't bet)
Seat 3: x Flyer25 collected ($23.96)
Seat 4: arctur17 folded before Flop (didn't bet)
Seat 5: kalcumite folded before Flop (didn't bet)
Seat 6: RoadtoNepal folded before Flop
Seat 7: Yaaaazz (button) folded before Flop (didn't bet)
Seat 8: matiko09 (small blind) folded before Flop
Seat 9: hammerwife (big blind) folded before Flop





PokerStars Hand #155373978784:  Hold'em No Limit ($0.25/$0.50 USD) - 2016/06/30 8:48:57 CET [2016/06/30 2:48:57 ET]
Table 'Adeona III' 9-max Seat #5 is the button
Seat 1: John_les ($50.81 in chips) 
Seat 2: matiko09 ($50 in chips) 
Seat 3: POTAPENKO700 ($52.37 in chips) 
Seat 4: antwon914 ($84.12 in chips) 
Seat 5: THREE FlDDY ($59.34 in chips) 
Seat 6: KABAL_ua ($88.59 in chips) 
Seat 7: Sniper1717 ($58.18 in chips) 
Seat 9: ja crisham ($45.73 in chips) 
KABAL_ua: posts small blind $0.25
Sniper1717: posts big blind $0.50
Dantistcopra: sits out 
*** HOLE CARDS ***
Dealt to matiko09 [3h 2h]
ja crisham: raises $0.50 to $1
John_les: calls $1
matiko09: folds 
POTAPENKO700: calls $1
antwon914: folds 
THREE FlDDY: calls $1
KABAL_ua: folds 
Sniper1717: calls $0.50
*** FLOP *** [As 4s 7c]
Sniper1717: checks 
ja crisham: bets $2
John_les: folds 
POTAPENKO700: folds 
THREE FlDDY: calls $2
Sniper1717: folds 
*** TURN *** [As 4s 7c] [Kd]
ja crisham: bets $2
THREE FlDDY: folds 
Uncalled bet ($2) returned to ja crisham
ja crisham collected $8.79 from pot
ja crisham: doesn't show hand 
*** SUMMARY ***
Total pot $9.25 | Rake $0.46 
Board [As 4s 7c Kd]
Seat 1: John_les folded on the Flop
Seat 2: matiko09 folded before Flop (didn't bet)
Seat 3: POTAPENKO700 folded on the Flop
Seat 4: antwon914 folded before Flop (didn't bet)
Seat 5: THREE FlDDY (button) folded on the Turn
Seat 6: KABAL_ua (small blind) folded before Flop
Seat 7: Sniper1717 (big blind) folded on the Flop
Seat 9: ja crisham collected ($8.79)





PokerStars Hand #155373980281:  Hold'em No Limit (€0.25/€0.50 EUR) - 2016/06/30 8:49:03 CET [2016/06/30 2:49:03 ET]
Table 'Erda III' 9-max Seat #8 is the button
Seat 1: Bailey Dew (€50 in chips) 
Seat 5: BlackHawk901 (€50 in chips) 
Seat 8: Gigi201133 (€79.80 in chips) 
Seat 9: matiko09 (€50 in chips) 
matiko09: posts small blind €0.25
Bailey Dew: posts big blind €0.50
*** HOLE CARDS ***
Dealt to matiko09 [4d 8s]
BlackHawk901: raises €0.75 to €1.25
Gigi201133: folds 
matiko09: folds 
Bailey Dew: folds 
Uncalled bet (€0.75) returned to BlackHawk901
BlackHawk901 collected €1.25 from pot
BlackHawk901: doesn't show hand 
*** SUMMARY ***
Total pot €1.25 | Rake €0 
Seat 1: Bailey Dew (big blind) folded before Flop
Seat 5: BlackHawk901 collected (€1.25)
Seat 8: Gigi201133 (button) folded before Flop (didn't bet)
Seat 9: matiko09 (small blind) folded before Flop





PokerStars Hand #155373980582:  Hold'em No Limit ($0.50/$1.00 USD) - 2016/06/30 8:49:05 CET [2016/06/30 2:49:05 ET]
Table 'Jarmila' 9-max Seat #8 is the button
Seat 1: Ronfar3 ($100 in chips) 
Seat 2: AA-man-AA27 ($33.63 in chips) 
Seat 3: Dantist1122 ($100 in chips) 
Seat 4: Rohitbarve ($60.56 in chips) 
Seat 5: ilaviiitech ($118.20 in chips) 
Seat 6: matiko09 ($103.68 in chips) 
Seat 7: Bid'daum ($83.93 in chips) 
Seat 8: DIMAN_324 ($127.70 in chips) 
Seat 9: ka100pka527 ($36.38 in chips) 
ka100pka527: posts small blind $0.50
Ronfar3: posts big blind $1
*** HOLE CARDS ***
Dealt to matiko09 [Th Kd]
AA-man-AA27: folds 
Dantist1122: folds 
Rohitbarve: folds 
ilaviiitech: folds 
matiko09: folds 
Bid'daum: raises $2.50 to $3.50
DIMAN_324: folds 
ka100pka527: folds 
Ronfar3: folds 
Uncalled bet ($2.50) returned to Bid'daum
Bid'daum collected $2.50 from pot
Bid'daum: doesn't show hand 
*** SUMMARY ***
Total pot $2.50 | Rake $0 
Seat 1: Ronfar3 (big blind) folded before Flop
Seat 2: AA-man-AA27 folded before Flop (didn't bet)
Seat 3: Dantist1122 folded before Flop (didn't bet)
Seat 4: Rohitbarve folded before Flop (didn't bet)
Seat 5: ilaviiitech folded before Flop (didn't bet)
Seat 6: matiko09 folded before Flop (didn't bet)
Seat 7: Bid'daum collected ($2.50)
Seat 8: DIMAN_324 (button) folded before Flop (didn't bet)
Seat 9: ka100pka527 (small blind) folded before Flop





PokerStars Hand #155373981693:  Hold'em No Limit ($0.50/$1.00 USD) - 2016/06/30 8:49:09 CET [2016/06/30 2:49:09 ET]
Table 'Aunus' 9-max Seat #5 is the button
Seat 2: HasBigBiceps ($100 in chips) 
Seat 3: matiko09 ($113.23 in chips) 
Seat 4: ilaviiitech ($100 in chips) 
Seat 5: hammerwife ($115.32 in chips) 
Seat 6: RoadtoNepal ($108.12 in chips) 
Seat 7: ka100pka527 ($38.50 in chips) 
Seat 8: Dantist1122 ($101.50 in chips) 
Seat 9: flk.Dasas ($121.27 in chips) 
RoadtoNepal: posts small blind $0.50
ka100pka527: posts big blind $1
ASabir: sits out 
*** HOLE CARDS ***
Dealt to matiko09 [Jh 2c]
Dantist1122: folds 
Dantist1122 leaves the table
flk.Dasas: folds 
HasBigBiceps: folds 
matiko09: folds 
ilaviiitech: folds 
hammerwife: folds 
RoadtoNepal: folds 
Uncalled bet ($0.50) returned to ka100pka527
ka100pka527 collected $1 from pot
ka100pka527: doesn't show hand 
*** SUMMARY ***
Total pot $1 | Rake $0 
Seat 2: HasBigBiceps folded before Flop (didn't bet)
Seat 3: matiko09 folded before Flop (didn't bet)
Seat 4: ilaviiitech folded before Flop (didn't bet)
Seat 5: hammerwife (button) folded before Flop (didn't bet)
Seat 6: RoadtoNepal (small blind) folded before Flop
Seat 7: ka100pka527 (big blind) collected ($1)
Seat 8: Dantist1122 folded before Flop (didn't bet)
Seat 9: flk.Dasas folded before Flop (didn't bet)





PokerStars Hand #155373989090:  Hold'em No Limit ($0.50/$1.00 USD) - 2016/06/30 8:49:40 CET [2016/06/30 2:49:40 ET]
Table 'Aunus' 9-max Seat #6 is the button
Seat 2: HasBigBiceps ($100 in chips) 
Seat 3: matiko09 ($113.23 in chips) 
Seat 4: ilaviiitech ($100 in chips) 
Seat 5: hammerwife ($115.32 in chips) 
Seat 6: RoadtoNepal ($107.62 in chips) 
Seat 7: ka100pka527 ($39 in chips) 
Seat 9: flk.Dasas ($121.27 in chips) 
ka100pka527: posts small blind $0.50
flk.Dasas: posts big blind $1
ASabir: sits out 
*** HOLE CARDS ***
Dealt to matiko09 [Js 6c]
HasBigBiceps: raises $2 to $3
matiko09: folds 
i am owsome joins the table at seat #8 
ilaviiitech: calls $3
hammerwife: folds 
RoadtoNepal: calls $3
ka100pka527: folds 
flk.Dasas: calls $2
*** FLOP *** [7d 8d Qc]
flk.Dasas: checks 
HasBigBiceps: bets $10.57
ilaviiitech: folds 
RoadtoNepal: calls $10.57
flk.Dasas: folds 
*** TURN *** [7d 8d Qc] [Td]
HasBigBiceps: checks 
RoadtoNepal: checks 
*** RIVER *** [7d 8d Qc Td] [4h]
HasBigBiceps: bets $16.62
RoadtoNepal: folds 
Uncalled bet ($16.62) returned to HasBigBiceps
HasBigBiceps collected $31.96 from pot
HasBigBiceps: doesn't show hand 
*** SUMMARY ***
Total pot $33.64 | Rake $1.68 
Board [7d 8d Qc Td 4h]
Seat 2: HasBigBiceps collected ($31.96)
Seat 3: matiko09 folded before Flop (didn't bet)
Seat 4: ilaviiitech folded on the Flop
Seat 5: hammerwife folded before Flop (didn't bet)
Seat 6: RoadtoNepal (button) folded on the River
Seat 7: ka100pka527 (small blind) folded before Flop
Seat 9: flk.Dasas (big blind) folded on the Flop





PokerStars Hand #155373989364:  Hold'em No Limit (€0.25/€0.50 EUR) - 2016/06/30 8:49:41 CET [2016/06/30 2:49:41 ET]
Table 'Erda III' 9-max Seat #9 is the button
Seat 1: Bailey Dew (€50 in chips) 
Seat 5: BlackHawk901 (€50.75 in chips) 
Seat 8: Gigi201133 (€79.80 in chips) 
Seat 9: matiko09 (€50 in chips) 
Bailey Dew: posts small blind €0.25
BlackHawk901: posts big blind €0.50
*** HOLE CARDS ***
Dealt to matiko09 [Kd 2h]
Gigi201133: folds 
matiko09: folds 
Bailey Dew: folds 
Uncalled bet (€0.25) returned to BlackHawk901
BlackHawk901 collected €0.50 from pot
BlackHawk901: doesn't show hand 
*** SUMMARY ***
Total pot €0.50 | Rake €0 
Seat 1: Bailey Dew (small blind) folded before Flop
Seat 5: BlackHawk901 (big blind) collected (€0.50)
Seat 8: Gigi201133 folded before Flop (didn't bet)
Seat 9: matiko09 (button) folded before Flop (didn't bet)





PokerStars Hand #155373991698:  Hold'em No Limit ($0.50/$1.00 USD) - 2016/06/30 8:49:50 CET [2016/06/30 2:49:50 ET]
Table 'Jarmila' 9-max Seat #9 is the button
Seat 1: Ronfar3 ($100 in chips) 
Seat 2: AA-man-AA27 ($33.63 in chips) 
Seat 3: Dantist1122 ($100 in chips) 
Seat 4: Rohitbarve ($60.56 in chips) 
Seat 5: ilaviiitech ($118.20 in chips) 
Seat 6: matiko09 ($103.68 in chips) 
Seat 7: Bid'daum ($85.43 in chips) 
Seat 8: DIMAN_324 ($127.70 in chips) 
Seat 9: ka100pka527 ($35.88 in chips) 
Ronfar3: posts small blind $0.50
AA-man-AA27: posts big blind $1
*** HOLE CARDS ***
Dealt to matiko09 [9s Ks]
Dantist1122: folds 
Rohitbarve: folds 
ilaviiitech: folds 
matiko09: folds 
Bid'daum: raises $2.50 to $3.50
DIMAN_324: folds 
ka100pka527: folds 
Ronfar3: folds 
AA-man-AA27: calls $2.50
*** FLOP *** [6c 8h Qs]
AA-man-AA27: checks 
Bid'daum: checks 
*** TURN *** [6c 8h Qs] [As]
AA-man-AA27: checks 
Bid'daum: checks 
*** RIVER *** [6c 8h Qs As] [4c]
AA-man-AA27: bets $4
Bid'daum: folds 
Uncalled bet ($4) returned to AA-man-AA27
AA-man-AA27 collected $7.12 from pot
AA-man-AA27: doesn't show hand 
*** SUMMARY ***
Total pot $7.50 | Rake $0.38 
Board [6c 8h Qs As 4c]
Seat 1: Ronfar3 (small blind) folded before Flop
Seat 2: AA-man-AA27 (big blind) collected ($7.12)
Seat 3: Dantist1122 folded before Flop (didn't bet)
Seat 4: Rohitbarve folded before Flop (didn't bet)
Seat 5: ilaviiitech folded before Flop (didn't bet)
Seat 6: matiko09 folded before Flop (didn't bet)
Seat 7: Bid'daum folded on the River
Seat 8: DIMAN_324 folded before Flop (didn't bet)
Seat 9: ka100pka527 (button) folded before Flop (didn't bet)





PokerStars Hand #155373991910:  Hold'em No Limit (€0.25/€0.50 EUR) - 2016/06/30 8:49:51 CET [2016/06/30 2:49:51 ET]
Table 'Erda III' 9-max Seat #1 is the button
Seat 1: Bailey Dew (€50 in chips) 
Seat 5: BlackHawk901 (€51 in chips) 
Seat 8: Gigi201133 (€79.80 in chips) 
Seat 9: matiko09 (€50 in chips) 
BlackHawk901: posts small blind €0.25
Gigi201133: posts big blind €0.50
*** HOLE CARDS ***
Dealt to matiko09 [4c 4s]
matiko09: raises €0.75 to €1.25
Bailey Dew: raises €2.50 to €3.75
BlackHawk901: folds 
Gigi201133: folds 
matiko09: folds 
Uncalled bet (€2.50) returned to Bailey Dew
Bailey Dew collected €3.25 from pot
Bailey Dew: doesn't show hand 
*** SUMMARY ***
Total pot €3.25 | Rake €0 
Seat 1: Bailey Dew (button) collected (€3.25)
Seat 5: BlackHawk901 (small blind) folded before Flop
Seat 8: Gigi201133 (big blind) folded before Flop
Seat 9: matiko09 folded before Flop





PokerStars Hand #155373994404:  Hold'em No Limit ($0.50/$1.00 USD) - 2016/06/30 8:50:01 CET [2016/06/30 2:50:01 ET]
Table 'Barto' 9-max Seat #4 is the button
Seat 1: hammerwife ($121.50 in chips) 
Seat 2: Yaaaazz ($124.73 in chips) 
Seat 3: John_les ($100 in chips) 
Seat 4: ricksdogs77 ($50.79 in chips) 
Seat 5: Ronfar3 ($107.65 in chips) 
Seat 7: RoadtoNepal ($100 in chips) 
Seat 8: matiko09 ($100 in chips) 
Seat 9: greg dean ($196 in chips) 
Ronfar3: posts small blind $0.50
Dantist1122: is sitting out 
RoadtoNepal: posts big blind $1
*** HOLE CARDS ***
Dealt to matiko09 [8c 3d]
matiko09: folds 
greg dean: calls $1
hammerwife: raises $4 to $5
Yaaaazz: folds 
John_les: folds 
ricksdogs77: folds 
Ronfar3: folds 
RoadtoNepal: folds 
greg dean: calls $4
*** FLOP *** [Ah Jh 6s]
greg dean: checks 
hammerwife: bets $8
greg dean: calls $8
*** TURN *** [Ah Jh 6s] [9d]
greg dean: checks 
hammerwife: bets $24.50
greg dean: calls $24.50
*** RIVER *** [Ah Jh 6s 9d] [2d]
greg dean: checks 
hammerwife: bets $84 and is all-in
greg dean: folds 
Uncalled bet ($84) returned to hammerwife
hammerwife collected $74 from pot
hammerwife: doesn't show hand 
*** SUMMARY ***
Total pot $76.50 | Rake $2.50 
Board [Ah Jh 6s 9d 2d]
Seat 1: hammerwife collected ($74)
Seat 2: Yaaaazz folded before Flop (didn't bet)
Seat 3: John_les folded before Flop (didn't bet)
Seat 4: ricksdogs77 (button) folded before Flop (didn't bet)
Seat 5: Ronfar3 (small blind) folded before Flop
Seat 7: RoadtoNepal (big blind) folded before Flop
Seat 8: matiko09 folded before Flop (didn't bet)
Seat 9: greg dean folded on the River





PokerStars Hand #155373996065:  Hold'em No Limit ($0.50/$1.00 USD) - 2016/06/30 8:50:08 CET [2016/06/30 2:50:08 ET]
Table 'Gaby' 9-max Seat #8 is the button
Seat 1: flk.Dasas ($100 in chips) 
Seat 2: ka100pka527 ($57.65 in chips) 
Seat 3: x Flyer25 ($121.93 in chips) 
Seat 4: arctur17 ($63.06 in chips) 
Seat 5: kalcumite ($132.40 in chips) 
Seat 6: RoadtoNepal ($100 in chips) 
Seat 7: Yaaaazz ($100 in chips) 
Seat 8: matiko09 ($100 in chips) 
Seat 9: hammerwife ($100 in chips) 
hammerwife: posts small blind $0.50
flk.Dasas: posts big blind $1
*** HOLE CARDS ***
Dealt to matiko09 [Jc 2c]
ka100pka527: folds 
x Flyer25: folds 
arctur17: raises $2 to $3
kalcumite: folds 
RoadtoNepal: folds 
Yaaaazz: folds 
matiko09: folds 
hammerwife: folds 
flk.Dasas: folds 
Uncalled bet ($2) returned to arctur17
arctur17 collected $2.50 from pot
arctur17: doesn't show hand 
*** SUMMARY ***
Total pot $2.50 | Rake $0 
Seat 1: flk.Dasas (big blind) folded before Flop
Seat 2: ka100pka527 folded before Flop (didn't bet)
Seat 3: x Flyer25 folded before Flop (didn't bet)
Seat 4: arctur17 collected ($2.50)
Seat 5: kalcumite folded before Flop (didn't bet)
Seat 6: RoadtoNepal folded before Flop (didn't bet)
Seat 7: Yaaaazz folded before Flop (didn't bet)
Seat 8: matiko09 (button) folded before Flop (didn't bet)
Seat 9: hammerwife (small blind) folded before Flop





PokerStars Hand #155373997421:  Hold'em No Limit (€0.25/€0.50 EUR) - 2016/06/30 8:50:14 CET [2016/06/30 2:50:14 ET]
Table 'Erda III' 9-max Seat #5 is the button
Seat 1: Bailey Dew (€52 in chips) 
Seat 5: BlackHawk901 (€50.75 in chips) 
Seat 8: Gigi201133 (€79.30 in chips) 
Seat 9: matiko09 (€50 in chips) 
Gigi201133: posts small blind €0.25
matiko09: posts big blind €0.50
*** HOLE CARDS ***
Dealt to matiko09 [Ts 4d]
Bailey Dew: folds 
BlackHawk901: folds 
POTAPENKO700 joins the table at seat #2 
Gigi201133: calls €0.25
matiko09: checks 
*** FLOP *** [Qh 2s 3c]
Gigi201133: checks 
matiko09: checks 
*** TURN *** [Qh 2s 3c] [Jh]
Gigi201133: checks 
matiko09: checks 
*** RIVER *** [Qh 2s 3c Jh] [7c]
Gigi201133: checks 
matiko09: checks 
*** SHOW DOWN ***
Gigi201133: shows [8c 6c] (high card Queen)
matiko09: shows [Ts 4d] (high card Queen - Jack+Ten kicker)
matiko09 collected €0.95 from pot
*** SUMMARY ***
Total pot €1 | Rake €0.05 
Board [Qh 2s 3c Jh 7c]
Seat 1: Bailey Dew folded before Flop (didn't bet)
Seat 5: BlackHawk901 (button) folded before Flop (didn't bet)
Seat 8: Gigi201133 (small blind) showed [8c 6c] and lost with high card Queen
Seat 9: matiko09 (big blind) showed [Ts 4d] and won (€0.95) with high card Queen





PokerStars Hand #155374000004:  Hold'em No Limit ($0.50/$1.00 USD) - 2016/06/30 8:50:25 CET [2016/06/30 2:50:25 ET]
Table 'Euphrosyne' 9-max Seat #8 is the button
Seat 1: heehon99 ($73.22 in chips) 
Seat 3: picka4u ($40 in chips) 
Seat 4: bargs33 ($100 in chips) 
Seat 5: L4zy_FiSh ($150.01 in chips) 
Seat 6: matiko09 ($111.22 in chips) 
Seat 7: flk.Dasas ($126.84 in chips) 
Seat 8: ka100pka527 ($56 in chips) 
Seat 9: ratzo64 ($83.98 in chips) 
ratzo64: posts small blind $0.50
heehon99: posts big blind $1
butcheN18: sits out 
*** HOLE CARDS ***
Dealt to matiko09 [As 4c]
picka4u: raises $1.25 to $2.25
bargs33: folds 
L4zy_FiSh: calls $2.25
matiko09: folds 
flk.Dasas: raises $4.75 to $7
ka100pka527: folds 
ratzo64: folds 
heehon99: folds 
picka4u: folds 
L4zy_FiSh: calls $4.75
*** FLOP *** [Qs 4d 8s]
L4zy_FiSh: checks 
flk.Dasas: checks 
*** TURN *** [Qs 4d 8s] [Jh]
L4zy_FiSh: bets $11
flk.Dasas: folds 
Uncalled bet ($11) returned to L4zy_FiSh
L4zy_FiSh collected $16.86 from pot
*** SUMMARY ***
Total pot $17.75 | Rake $0.89 
Board [Qs 4d 8s Jh]
Seat 1: heehon99 (big blind) folded before Flop
Seat 3: picka4u folded before Flop
Seat 4: bargs33 folded before Flop (didn't bet)
Seat 5: L4zy_FiSh collected ($16.86)
Seat 6: matiko09 folded before Flop (didn't bet)
Seat 7: flk.Dasas folded on the Turn
Seat 8: ka100pka527 (button) folded before Flop (didn't bet)
Seat 9: ratzo64 (small blind) folded before Flop





PokerStars Hand #155374002377:  Hold'em No Limit ($0.25/$0.50 USD) - 2016/06/30 8:50:34 CET [2016/06/30 2:50:34 ET]
Table 'Arcturus' 9-max Seat #8 is the button
Seat 1: shyboy25 ($21.14 in chips) 
Seat 2: matiko09 ($50 in chips) 
Seat 3: Dantistcopra ($50 in chips) 
Seat 4: x Flyer25 ($48.50 in chips) 
Seat 5: DeathcorePkr ($55.78 in chips) 
Seat 6: Sniper1717 ($52.48 in chips) 
Seat 8: KABAL_ua ($58.43 in chips) 
shyboy25: posts small blind $0.25
matiko09: posts big blind $0.50
*** HOLE CARDS ***
Dealt to matiko09 [Th 5d]
Dantistcopra: folds 
x Flyer25: calls $0.50
DeathcorePkr: folds 
Sniper1717: raises $1 to $1.50
KABAL_ua: folds 
shyboy25: folds 
matiko09: folds 
x Flyer25: calls $1
*** FLOP *** [Kh As 9d]
x Flyer25: checks 
Sniper1717: checks 
*** TURN *** [Kh As 9d] [2s]
x Flyer25: checks 
Sniper1717: checks 
*** RIVER *** [Kh As 9d 2s] [Qc]
x Flyer25: checks 
Sniper1717: bets $3
x Flyer25: folds 
Uncalled bet ($3) returned to Sniper1717
Sniper1717 collected $3.56 from pot
Sniper1717: doesn't show hand 
*** SUMMARY ***
Total pot $3.75 | Rake $0.19 
Board [Kh As 9d 2s Qc]
Seat 1: shyboy25 (small blind) folded before Flop
Seat 2: matiko09 (big blind) folded before Flop
Seat 3: Dantistcopra folded before Flop (didn't bet)
Seat 4: x Flyer25 folded on the River
Seat 5: DeathcorePkr folded before Flop (didn't bet)
Seat 6: Sniper1717 collected ($3.56)
Seat 8: KABAL_ua (button) folded before Flop (didn't bet)





PokerStars Hand #155374004766:  Hold'em No Limit ($0.50/$1.00 USD) - 2016/06/30 8:50:44 CET [2016/06/30 2:50:44 ET]
Table 'Gaby' 9-max Seat #9 is the button
Seat 1: flk.Dasas ($100 in chips) 
Seat 2: ka100pka527 ($57.65 in chips) 
Seat 3: x Flyer25 ($121.93 in chips) 
Seat 4: arctur17 ($64.56 in chips) 
Seat 5: kalcumite ($132.40 in chips) 
Seat 6: RoadtoNepal ($100 in chips) 
Seat 7: Yaaaazz ($100 in chips) 
Seat 8: matiko09 ($100 in chips) 
Seat 9: hammerwife ($100 in chips) 
flk.Dasas: posts small blind $0.50
ka100pka527: posts big blind $1
*** HOLE CARDS ***
Dealt to matiko09 [9c Ah]
x Flyer25: calls $1
arctur17: folds 
kalcumite: folds 
RoadtoNepal: folds 
Yaaaazz: folds 
matiko09: raises $3 to $4
hammerwife: raises $9 to $13
flk.Dasas: folds 
ka100pka527: folds 
x Flyer25: folds 
matiko09: raises $14 to $27
hammerwife: folds 
Uncalled bet ($14) returned to matiko09
matiko09 collected $28.50 from pot
matiko09: doesn't show hand 
*** SUMMARY ***
Total pot $28.50 | Rake $0 
Seat 1: flk.Dasas (small blind) folded before Flop
Seat 2: ka100pka527 (big blind) folded before Flop
Seat 3: x Flyer25 folded before Flop
Seat 4: arctur17 folded before Flop (didn't bet)
Seat 5: kalcumite folded before Flop (didn't bet)
Seat 6: RoadtoNepal folded before Flop (didn't bet)
Seat 7: Yaaaazz folded before Flop (didn't bet)
Seat 8: matiko09 collected ($28.50)
Seat 9: hammerwife (button) folded before Flop





PokerStars Hand #155374004996:  Hold'em No Limit ($0.25/$0.50 USD) - 2016/06/30 8:50:45 CET [2016/06/30 2:50:45 ET]
Table 'Adeona III' 9-max Seat #6 is the button
Seat 1: John_les ($50 in chips) 
Seat 2: matiko09 ($50 in chips) 
Seat 3: POTAPENKO700 ($51.37 in chips) 
Seat 4: antwon914 ($84.12 in chips) 
Seat 5: THREE FlDDY ($56.34 in chips) 
Seat 6: KABAL_ua ($88.34 in chips) 
Seat 7: Sniper1717 ($57.18 in chips) 
Seat 8: Dantistcopra ($50 in chips) 
Seat 9: ja crisham ($51.52 in chips) 
Sniper1717: posts small blind $0.25
Dantistcopra: posts big blind $0.50
*** HOLE CARDS ***
Dealt to matiko09 [7d 8h]
ja crisham: folds 
John_les: folds 
matiko09: folds 
POTAPENKO700: folds 
antwon914: folds 
THREE FlDDY: raises $0.76 to $1.26
KABAL_ua: folds 
Sniper1717: folds 
Dantistcopra: calls $0.76
*** FLOP *** [5h 4d Qd]
Dantistcopra: checks 
THREE FlDDY: checks 
*** TURN *** [5h 4d Qd] [Ad]
Dantistcopra: bets $2.25
THREE FlDDY: folds 
Uncalled bet ($2.25) returned to Dantistcopra
Dantistcopra collected $2.63 from pot
*** SUMMARY ***
Total pot $2.77 | Rake $0.14 
Board [5h 4d Qd Ad]
Seat 1: John_les folded before Flop (didn't bet)
Seat 2: matiko09 folded before Flop (didn't bet)
Seat 3: POTAPENKO700 folded before Flop (didn't bet)
Seat 4: antwon914 folded before Flop (didn't bet)
Seat 5: THREE FlDDY folded on the Turn
Seat 6: KABAL_ua (button) folded before Flop (didn't bet)
Seat 7: Sniper1717 (small blind) folded before Flop
Seat 8: Dantistcopra (big blind) collected ($2.63)
Seat 9: ja crisham folded before Flop (didn't bet)





PokerStars Hand #155374007312:  Hold'em No Limit (€0.25/€0.50 EUR) - 2016/06/30 8:50:54 CET [2016/06/30 2:50:54 ET]
Table 'Erda III' 9-max Seat #8 is the button
Seat 1: Bailey Dew (€52 in chips) 
Seat 5: BlackHawk901 (€50.75 in chips) 
Seat 8: Gigi201133 (€78.80 in chips) 
Seat 9: matiko09 (€50.45 in chips) 
matiko09: posts small blind €0.25
Bailey Dew: posts big blind €0.50
POTAPENKO700: sits out 
*** HOLE CARDS ***
Dealt to matiko09 [2h 8h]
BlackHawk901: raises €0.75 to €1.25
Gigi201133: folds 
matiko09: folds 
Bailey Dew: folds 
Uncalled bet (€0.75) returned to BlackHawk901
BlackHawk901 collected €1.25 from pot
BlackHawk901: doesn't show hand 
*** SUMMARY ***
Total pot €1.25 | Rake €0 
Seat 1: Bailey Dew (big blind) folded before Flop
Seat 5: BlackHawk901 collected (€1.25)
Seat 8: Gigi201133 (button) folded before Flop (didn't bet)
Seat 9: matiko09 (small blind) folded before Flop





PokerStars Hand #155374008214:  Hold'em No Limit ($0.25/$0.50 USD) - 2016/06/30 8:50:58 CET [2016/06/30 2:50:58 ET]
Table 'Alfaterna II' 9-max Seat #4 is the button
Seat 1: BlackHawk901 ($57.77 in chips) 
Seat 2: KABAL_ua ($50 in chips) 
Seat 3: Lita17 ($64.85 in chips) 
Seat 4: santamaria26 ($19 in chips) 
Seat 5: THREE FlDDY ($68.46 in chips) 
Seat 6: matiko09 ($50 in chips) 
Seat 7: Sniper1717 ($50.75 in chips) 
Seat 8: Dantistcopra ($61.03 in chips) 
Seat 9: POTAPENKO700 ($52.78 in chips) 
THREE FlDDY: posts small blind $0.25
matiko09: posts big blind $0.50
*** HOLE CARDS ***
Dealt to matiko09 [5c Kh]
Sniper1717: folds 
Dantistcopra: folds 
POTAPENKO700: folds 
BlackHawk901: raises $1 to $1.50
KABAL_ua: folds 
Lita17: folds 
santamaria26: folds 
THREE FlDDY: folds 
matiko09: folds 
Uncalled bet ($1) returned to BlackHawk901
BlackHawk901 collected $1.25 from pot
BlackHawk901: doesn't show hand 
*** SUMMARY ***
Total pot $1.25 | Rake $0 
Seat 1: BlackHawk901 collected ($1.25)
Seat 2: KABAL_ua folded before Flop (didn't bet)
Seat 3: Lita17 folded before Flop (didn't bet)
Seat 4: santamaria26 (button) folded before Flop (didn't bet)
Seat 5: THREE FlDDY (small blind) folded before Flop
Seat 6: matiko09 (big blind) folded before Flop
Seat 7: Sniper1717 folded before Flop (didn't bet)
Seat 8: Dantistcopra folded before Flop (didn't bet)
Seat 9: POTAPENKO700 folded before Flop (didn't bet)





PokerStars Hand #155374011846:  Hold'em No Limit (€0.25/€0.50 EUR) - 2016/06/30 8:51:14 CET [2016/06/30 2:51:14 ET]
Table 'Erda III' 9-max Seat #9 is the button
Seat 1: Bailey Dew (€51.50 in chips) 
Seat 2: POTAPENKO700 (€50 in chips) 
Seat 5: BlackHawk901 (€51.50 in chips) 
Seat 8: Gigi201133 (€78.80 in chips) 
Seat 9: matiko09 (€50.20 in chips) 
Bailey Dew: posts small blind €0.25
POTAPENKO700: posts big blind €0.50
*** HOLE CARDS ***
Dealt to matiko09 [Js 5c]
BlackHawk901: raises €1 to €1.50
Gigi201133: folds 
matiko09: folds 
Bailey Dew: folds 
POTAPENKO700: folds 
Uncalled bet (€1) returned to BlackHawk901
BlackHawk901 collected €1.25 from pot
BlackHawk901: doesn't show hand 
*** SUMMARY ***
Total pot €1.25 | Rake €0 
Seat 1: Bailey Dew (small blind) folded before Flop
Seat 2: POTAPENKO700 (big blind) folded before Flop
Seat 5: BlackHawk901 collected (€1.25)
Seat 8: Gigi201133 folded before Flop (didn't bet)
Seat 9: matiko09 (button) folded before Flop (didn't bet)





PokerStars Hand #155374012298:  Hold'em No Limit ($0.50/$1.00 USD) - 2016/06/30 8:51:15 CET [2016/06/30 2:51:15 ET]
Table 'Jarmila' 9-max Seat #1 is the button
Seat 1: Ronfar3 ($100 in chips) 
Seat 2: AA-man-AA27 ($37.25 in chips) 
Seat 4: Rohitbarve ($60.56 in chips) 
Seat 5: ilaviiitech ($118.20 in chips) 
Seat 6: matiko09 ($103.68 in chips) 
Seat 7: Bid'daum ($81.93 in chips) 
Seat 8: DIMAN_324 ($127.70 in chips) 
Seat 9: ka100pka527 ($35.88 in chips) 
AA-man-AA27: posts small blind $0.50
Rohitbarve: posts big blind $1
*** HOLE CARDS ***
Dealt to matiko09 [5c Kh]
ilaviiitech: folds 
matiko09: folds 
Bid'daum: folds 
DIMAN_324: folds 
ka100pka527: raises $2 to $3
Ronfar3: folds 
AA-man-AA27: folds 
Rohitbarve: folds 
Uncalled bet ($2) returned to ka100pka527
ka100pka527 collected $2.50 from pot
ka100pka527: doesn't show hand 
*** SUMMARY ***
Total pot $2.50 | Rake $0 
Seat 1: Ronfar3 (button) folded before Flop (didn't bet)
Seat 2: AA-man-AA27 (small blind) folded before Flop
Seat 4: Rohitbarve (big blind) folded before Flop
Seat 5: ilaviiitech folded before Flop (didn't bet)
Seat 6: matiko09 folded before Flop (didn't bet)
Seat 7: Bid'daum folded before Flop (didn't bet)
Seat 8: DIMAN_324 folded before Flop (didn't bet)
Seat 9: ka100pka527 collected ($2.50)





PokerStars Hand #155374015498:  Hold'em No Limit ($0.25/$0.50 USD) - 2016/06/30 8:51:28 CET [2016/06/30 2:51:28 ET]
Table 'Arcturus' 9-max Seat #1 is the button
Seat 1: shyboy25 ($20.89 in chips) 
Seat 2: matiko09 ($50 in chips) 
Seat 3: Dantistcopra ($50 in chips) 
Seat 4: x Flyer25 ($47 in chips) 
Seat 5: DeathcorePkr ($55.78 in chips) 
Seat 6: Sniper1717 ($54.54 in chips) 
Seat 8: KABAL_ua ($58.43 in chips) 
matiko09: posts small blind $0.25
Dantistcopra: posts big blind $0.50
THREE FlDDY: sits out 
*** HOLE CARDS ***
Dealt to matiko09 [3s 4d]
x Flyer25: calls $0.50
DeathcorePkr: folds 
Sniper1717: folds 
KABAL_ua: folds 
shyboy25: folds 
matiko09: folds 
Dantistcopra: checks 
*** FLOP *** [2d 5d Kc]
Dantistcopra: checks 
x Flyer25: bets $0.50
Dantistcopra: folds 
Uncalled bet ($0.50) returned to x Flyer25
x Flyer25 collected $1.19 from pot
x Flyer25: doesn't show hand 
*** SUMMARY ***
Total pot $1.25 | Rake $0.06 
Board [2d 5d Kc]
Seat 1: shyboy25 (button) folded before Flop (didn't bet)
Seat 2: matiko09 (small blind) folded before Flop
Seat 3: Dantistcopra (big blind) folded on the Flop
Seat 4: x Flyer25 collected ($1.19)
Seat 5: DeathcorePkr folded before Flop (didn't bet)
Seat 6: Sniper1717 folded before Flop (didn't bet)
Seat 8: KABAL_ua folded before Flop (didn't bet)





PokerStars Hand #155374015416:  Hold'em No Limit ($0.25/$0.50 USD) - 2016/06/30 8:51:28 CET [2016/06/30 2:51:28 ET]
Table 'Adeona III' 9-max Seat #7 is the button
Seat 1: John_les ($50 in chips) 
Seat 2: matiko09 ($50 in chips) 
Seat 3: POTAPENKO700 ($51.37 in chips) 
Seat 4: antwon914 ($84.12 in chips) 
Seat 5: THREE FlDDY ($55.08 in chips) 
Seat 6: KABAL_ua ($88.34 in chips) 
Seat 7: Sniper1717 ($56.93 in chips) 
Seat 8: Dantistcopra ($51.37 in chips) 
Seat 9: ja crisham ($51.52 in chips) 
Dantistcopra: posts small blind $0.25
ja crisham: posts big blind $0.50
*** HOLE CARDS ***
Dealt to matiko09 [6d Ks]
John_les: raises $1.25 to $1.75
matiko09: folds 
POTAPENKO700: folds 
antwon914: folds 
THREE FlDDY: folds 
KABAL_ua: folds 
Sniper1717: folds 
Dantistcopra: folds 
ja crisham: folds 
Uncalled bet ($1.25) returned to John_les
John_les collected $1.25 from pot
John_les: doesn't show hand 
*** SUMMARY ***
Total pot $1.25 | Rake $0 
Seat 1: John_les collected ($1.25)
Seat 2: matiko09 folded before Flop (didn't bet)
Seat 3: POTAPENKO700 folded before Flop (didn't bet)
Seat 4: antwon914 folded before Flop (didn't bet)
Seat 5: THREE FlDDY folded before Flop (didn't bet)
Seat 6: KABAL_ua folded before Flop (didn't bet)
Seat 7: Sniper1717 (button) folded before Flop (didn't bet)
Seat 8: Dantistcopra (small blind) folded before Flop
Seat 9: ja crisham (big blind) folded before Flop





PokerStars Hand #155374015569:  Hold'em No Limit ($0.25/$0.50 USD) - 2016/06/30 8:51:29 CET [2016/06/30 2:51:29 ET]
Table 'Alfaterna II' 9-max Seat #5 is the button
Seat 1: BlackHawk901 ($58.52 in chips) 
Seat 2: KABAL_ua ($50 in chips) 
Seat 3: Lita17 ($64.85 in chips) 
Seat 4: santamaria26 ($19 in chips) 
Seat 5: THREE FlDDY ($68.21 in chips) 
Seat 6: matiko09 ($50 in chips) 
Seat 7: Sniper1717 ($50.75 in chips) 
Seat 8: Dantistcopra ($61.03 in chips) 
Seat 9: POTAPENKO700 ($52.78 in chips) 
matiko09: posts small blind $0.25
Sniper1717: posts big blind $0.50
*** HOLE CARDS ***
Dealt to matiko09 [Kc Tc]
Dantistcopra: folds 
POTAPENKO700: folds 
BlackHawk901: raises $1 to $1.50
KABAL_ua: folds 
Lita17: calls $1.50
santamaria26: folds 
THREE FlDDY: folds 
matiko09: folds 
Sniper1717: folds 
*** FLOP *** [Ks 8d 9h]
BlackHawk901: checks 
Lita17: bets $3
BlackHawk901: calls $3
*** TURN *** [Ks 8d 9h] [Qd]
BlackHawk901: checks 
Lita17: checks 
*** RIVER *** [Ks 8d 9h Qd] [9s]
BlackHawk901: bets $6.48
Lita17: folds 
Uncalled bet ($6.48) returned to BlackHawk901
BlackHawk901 collected $9.26 from pot
BlackHawk901: doesn't show hand 
*** SUMMARY ***
Total pot $9.75 | Rake $0.49 
Board [Ks 8d 9h Qd 9s]
Seat 1: BlackHawk901 collected ($9.26)
Seat 2: KABAL_ua folded before Flop (didn't bet)
Seat 3: Lita17 folded on the River
Seat 4: santamaria26 folded before Flop (didn't bet)
Seat 5: THREE FlDDY (button) folded before Flop (didn't bet)
Seat 6: matiko09 (small blind) folded before Flop
Seat 7: Sniper1717 (big blind) folded before Flop
Seat 8: Dantistcopra folded before Flop (didn't bet)
Seat 9: POTAPENKO700 folded before Flop (didn't bet)





PokerStars Hand #155374015825:  Hold'em No Limit ($0.50/$1.00 USD) - 2016/06/30 8:51:30 CET [2016/06/30 2:51:30 ET]
Table 'Aunus' 9-max Seat #7 is the button
Seat 1: ASabir ($40 in chips) 
Seat 2: HasBigBiceps ($118.39 in chips) 
Seat 3: matiko09 ($113.23 in chips) 
Seat 4: ilaviiitech ($100 in chips) 
Seat 5: hammerwife ($115.32 in chips) 
Seat 6: RoadtoNepal ($100 in chips) 
Seat 7: ka100pka527 ($38.50 in chips) 
Seat 9: flk.Dasas ($118.27 in chips) 
i am owsome will be allowed to play after the button
flk.Dasas: posts small blind $0.50
ASabir: posts big blind $1
*** HOLE CARDS ***
Dealt to matiko09 [5s 5d]
HasBigBiceps: folds 
matiko09: folds 
ilaviiitech: folds 
hammerwife: folds 
RoadtoNepal: folds 
ka100pka527: raises $1 to $2
flk.Dasas: calls $1.50
ASabir: folds 
*** FLOP *** [Kh 4h 2s]
flk.Dasas: checks 
ka100pka527: bets $3.16
flk.Dasas: calls $3.16
*** TURN *** [Kh 4h 2s] [Ts]
flk.Dasas: checks 
ka100pka527: bets $8.16
flk.Dasas: calls $8.16
*** RIVER *** [Kh 4h 2s Ts] [9d]
flk.Dasas: checks 
ka100pka527: bets $25.18 and is all-in
flk.Dasas: folds 
Uncalled bet ($25.18) returned to ka100pka527
ka100pka527 collected $26.26 from pot
ka100pka527: doesn't show hand 
*** SUMMARY ***
Total pot $27.64 | Rake $1.38 
Board [Kh 4h 2s Ts 9d]
Seat 1: ASabir (big blind) folded before Flop
Seat 2: HasBigBiceps folded before Flop (didn't bet)
Seat 3: matiko09 folded before Flop (didn't bet)
Seat 4: ilaviiitech folded before Flop (didn't bet)
Seat 5: hammerwife folded before Flop (didn't bet)
Seat 6: RoadtoNepal folded before Flop (didn't bet)
Seat 7: ka100pka527 (button) collected ($26.26)
Seat 9: flk.Dasas (small blind) folded on the River





PokerStars Hand #155374016947:  Hold'em No Limit (€0.25/€0.50 EUR) - 2016/06/30 8:51:34 CET [2016/06/30 2:51:34 ET]
Table 'Erda III' 9-max Seat #1 is the button
Seat 1: Bailey Dew (€51.25 in chips) 
Seat 2: POTAPENKO700 (€50 in chips) 
Seat 5: BlackHawk901 (€52.25 in chips) 
Seat 8: Gigi201133 (€78.80 in chips) 
Seat 9: matiko09 (€50.20 in chips) 
POTAPENKO700: posts small blind €0.25
BlackHawk901: posts big blind €0.50
*** HOLE CARDS ***
Dealt to matiko09 [Ad 2c]
Gigi201133: folds 
matiko09: folds 
Bailey Dew: folds 
POTAPENKO700: folds 
Uncalled bet (€0.25) returned to BlackHawk901
BlackHawk901 collected €0.50 from pot
BlackHawk901: doesn't show hand 
*** SUMMARY ***
Total pot €0.50 | Rake €0 
Seat 1: Bailey Dew (button) folded before Flop (didn't bet)
Seat 2: POTAPENKO700 (small blind) folded before Flop
Seat 5: BlackHawk901 (big blind) collected (€0.50)
Seat 8: Gigi201133 folded before Flop (didn't bet)
Seat 9: matiko09 folded before Flop (didn't bet)





