PokerStars Hand #154797660684:  Hold'em No Limit ($0.50/$1.00 USD) - 2016/06/16 9:24:50 CET [2016/06/16 3:24:50 ET]
Table 'Solstice' 9-max Seat #9 is the button
Seat 2: ruslik_by ($102.20 in chips) 
Seat 3: arctur17 ($37.59 in chips) 
Seat 4: jezzaber ($96 in chips) 
Seat 5: mycka86 ($115.48 in chips) 
Seat 6: CoolFireX ($106 in chips) 
Seat 7: apple130 ($153.63 in chips) 
Seat 8: matiko09 ($102 in chips) 
Seat 9: butcheN18 ($106.69 in chips) 
maxxmeister will be allowed to play after the button
ruslik_by: posts small blind $0.50
arctur17: posts big blind $1
*** HOLE CARDS ***
Dealt to matiko09 [4h 6d]
jezzaber: folds 
mycka86: folds 
CoolFireX: folds 
apple130: raises $2 to $3
matiko09: folds 
butcheN18: folds 
ruslik_by: folds 
arctur17: folds 
Uncalled bet ($2) returned to apple130
apple130 collected $2.50 from pot
apple130: doesn't show hand 
*** SUMMARY ***
Total pot $2.50 | Rake $0 
Seat 2: ruslik_by (small blind) folded before Flop
Seat 3: arctur17 (big blind) folded before Flop
Seat 4: jezzaber folded before Flop (didn't bet)
Seat 5: mycka86 folded before Flop (didn't bet)
Seat 6: CoolFireX folded before Flop (didn't bet)
Seat 7: apple130 collected ($2.50)
Seat 8: matiko09 folded before Flop (didn't bet)
Seat 9: butcheN18 (button) folded before Flop (didn't bet)





PokerStars Hand #154797661365:  Hold'em No Limit ($0.50/$1.00 USD) - 2016/06/16 9:24:52 CET [2016/06/16 3:24:52 ET]
Table 'Pasiphae II' 9-max Seat #4 is the button
Seat 2: flk.Dasas ($100 in chips) 
Seat 3: matiko09 ($102.52 in chips) 
Seat 4: ruslik_by ($202.94 in chips) 
Seat 5: CoolFireX ($152.61 in chips) 
Seat 6: m@xXx89 ($113.20 in chips) 
Seat 7: butcheN18 ($144.53 in chips) 
Seat 8: maxxmeister ($111.45 in chips) 
Seat 9: teerajaja ($101.50 in chips) 
CoolFireX: posts small blind $0.50
m@xXx89: posts big blind $1
mycka86: sits out 
*** HOLE CARDS ***
Dealt to matiko09 [Td 3c]
butcheN18: folds 
maxxmeister: folds 
teerajaja: folds 
flk.Dasas: folds 
matiko09: folds 
ruslik_by: folds 
CoolFireX: folds 
Uncalled bet ($0.50) returned to m@xXx89
m@xXx89 collected $1 from pot
*** SUMMARY ***
Total pot $1 | Rake $0 
Seat 2: flk.Dasas folded before Flop (didn't bet)
Seat 3: matiko09 folded before Flop (didn't bet)
Seat 4: ruslik_by (button) folded before Flop (didn't bet)
Seat 5: CoolFireX (small blind) folded before Flop
Seat 6: m@xXx89 (big blind) collected ($1)
Seat 7: butcheN18 folded before Flop (didn't bet)
Seat 8: maxxmeister folded before Flop (didn't bet)
Seat 9: teerajaja folded before Flop (didn't bet)





PokerStars Hand #154797663595:  Hold'em No Limit ($0.50/$1.00 USD) - 2016/06/16 9:25:01 CET [2016/06/16 3:25:01 ET]
Table 'Stroobantia II' 9-max Seat #1 is the button
Seat 1: mycka86 ($100 in chips) 
Seat 2: Lipton20088 ($82.47 in chips) 
Seat 3: matiko09 ($100 in chips) 
Seat 9: chrisauy ($83.24 in chips) 
Lipton20088: posts small blind $0.50
matiko09: posts big blind $1
CoolFireX: sits out 
butcheN18: sits out 
ruslik_by: sits out 
*** HOLE CARDS ***
Dealt to matiko09 [2h 9h]
chrisauy: raises $2 to $3
mycka86: folds 
Lipton20088: folds 
matiko09: folds 
Uncalled bet ($2) returned to chrisauy
chrisauy collected $2.50 from pot
chrisauy: doesn't show hand 
*** SUMMARY ***
Total pot $2.50 | Rake $0 
Seat 1: mycka86 (button) folded before Flop (didn't bet)
Seat 2: Lipton20088 (small blind) folded before Flop
Seat 3: matiko09 (big blind) folded before Flop
Seat 9: chrisauy collected ($2.50)





PokerStars Hand #154797664443:  Hold'em No Limit ($0.50/$1.00 USD) - 2016/06/16 9:25:04 CET [2016/06/16 3:25:04 ET]
Table 'Alekto' 9-max Seat #3 is the button
Seat 1: Kukuryzka ($123 in chips) 
Seat 2: brotas232323 ($95.50 in chips) 
Seat 3: butcheN18 ($100 in chips) 
Seat 4: hammerwife ($115.77 in chips) 
Seat 5: matiko09 ($115.81 in chips) 
Seat 6: ilaviiitech ($124.81 in chips) 
Seat 7: flk.Dasas ($104.32 in chips) 
Seat 8: Dantist1122 ($100 in chips) 
Seat 9: ruslik_by ($101.50 in chips) 
hammerwife: posts small blind $0.50
matiko09: posts big blind $1
*** HOLE CARDS ***
Dealt to matiko09 [5s 9s]
ilaviiitech: folds 
flk.Dasas: folds 
Dantist1122: folds 
ruslik_by: folds 
Kukuryzka: folds 
brotas232323: folds 
butcheN18: raises $1.44 to $2.44
hammerwife: folds 
matiko09: folds 
Uncalled bet ($1.44) returned to butcheN18
butcheN18 collected $2.50 from pot
butcheN18: doesn't show hand 
*** SUMMARY ***
Total pot $2.50 | Rake $0 
Seat 1: Kukuryzka folded before Flop (didn't bet)
Seat 2: brotas232323 folded before Flop (didn't bet)
Seat 3: butcheN18 (button) collected ($2.50)
Seat 4: hammerwife (small blind) folded before Flop
Seat 5: matiko09 (big blind) folded before Flop
Seat 6: ilaviiitech folded before Flop (didn't bet)
Seat 7: flk.Dasas folded before Flop (didn't bet)
Seat 8: Dantist1122 folded before Flop (didn't bet)
Seat 9: ruslik_by folded before Flop (didn't bet)





PokerStars Hand #154797664646:  Hold'em No Limit ($0.50/$1.00 USD) - 2016/06/16 9:25:05 CET [2016/06/16 3:25:05 ET]
Table 'Hercynia II' 9-max Seat #4 is the button
Seat 1: flk.Dasas ($100 in chips) 
Seat 2: hammerwife ($202.50 in chips) 
Seat 3: ilaviiitech ($122.61 in chips) 
Seat 4: ruslik_by ($100 in chips) 
Seat 5: matiko09 ($100 in chips) 
Seat 6: Kalacs74 ($71 in chips) 
Seat 7: ozone2003 ($101.50 in chips) 
Seat 8: mycka86 ($115.75 in chips) 
Seat 9: Juniorquiapo ($81.52 in chips) 
matiko09: posts small blind $0.50
Kalacs74: posts big blind $1
*** HOLE CARDS ***
Dealt to matiko09 [7c Jc]
ozone2003: folds 
mycka86: raises $2 to $3
Juniorquiapo: folds 
flk.Dasas: folds 
hammerwife: folds 
ilaviiitech: folds 
ruslik_by said, "da ni gde prosto tvoi diapazoni 3beta zashkalivaut"
ruslik_by: folds 
matiko09: folds 
Kalacs74: calls $2
*** FLOP *** [Qh 4c 5h]
Kalacs74: checks 
mycka86: bets $4.50
Kalacs74: raises $4.50 to $9
mycka86: raises $103.75 to $112.75 and is all-in
Kalacs74: calls $59 and is all-in
Uncalled bet ($44.75) returned to mycka86
*** TURN *** [Qh 4c 5h] [8d]
*** RIVER *** [Qh 4c 5h 8d] [2d]
*** SHOW DOWN ***
Kalacs74: shows [Ah 5s] (a pair of Fives)
mycka86: shows [As Ac] (a pair of Aces)
mycka86 collected $140 from pot
hammerwife said, "eto da"
*** SUMMARY ***
Total pot $142.50 | Rake $2.50 
Board [Qh 4c 5h 8d 2d]
Seat 1: flk.Dasas folded before Flop (didn't bet)
Seat 2: hammerwife folded before Flop (didn't bet)
Seat 3: ilaviiitech folded before Flop (didn't bet)
Seat 4: ruslik_by (button) folded before Flop (didn't bet)
Seat 5: matiko09 (small blind) folded before Flop
Seat 6: Kalacs74 (big blind) showed [Ah 5s] and lost with a pair of Fives
Seat 7: ozone2003 folded before Flop (didn't bet)
Seat 8: mycka86 showed [As Ac] and won ($140) with a pair of Aces
Seat 9: Juniorquiapo folded before Flop (didn't bet)





PokerStars Hand #154797668423:  Hold'em No Limit ($0.25/$0.50 USD) - 2016/06/16 9:25:18 CET [2016/06/16 3:25:18 ET]
Table 'Gaea' 9-max Seat #3 is the button
Seat 1: Mark Calder ($50.46 in chips) 
Seat 2: mi$$I$Elena ($103.17 in chips) 
Seat 3: Crazyfish87 ($40 in chips) 
Seat 4: matiko09 ($58.01 in chips) 
Seat 6: Alex Frider ($60.12 in chips) 
Seat 7: au318 ($47.82 in chips) 
Seat 8: Lipton20088 ($33.42 in chips) 
Seat 9: Prophet1906 ($61.29 in chips) 
matiko09: posts small blind $0.25
teerajaja: is sitting out 
Alex Frider: posts big blind $0.50
*** HOLE CARDS ***
Dealt to matiko09 [8d 5s]
teerajaja leaves the table
Kapa09 joins the table at seat #5 
au318: folds 
Lipton20088: folds 
Prophet1906: folds 
Mark Calder: folds 
mi$$I$Elena: folds 
Crazyfish87: folds 
matiko09: folds 
Uncalled bet ($0.25) returned to Alex Frider
Alex Frider collected $0.50 from pot
Alex Frider: doesn't show hand 
*** SUMMARY ***
Total pot $0.50 | Rake $0 
Seat 1: Mark Calder folded before Flop (didn't bet)
Seat 2: mi$$I$Elena folded before Flop (didn't bet)
Seat 3: Crazyfish87 (button) folded before Flop (didn't bet)
Seat 4: matiko09 (small blind) folded before Flop
Seat 6: Alex Frider (big blind) collected ($0.50)
Seat 7: au318 folded before Flop (didn't bet)
Seat 8: Lipton20088 folded before Flop (didn't bet)
Seat 9: Prophet1906 folded before Flop (didn't bet)





PokerStars Hand #154797669372:  Hold'em No Limit ($0.50/$1.00 USD) - 2016/06/16 9:25:22 CET [2016/06/16 3:25:22 ET]
Table 'Stroobantia II' 9-max Seat #2 is the button
Seat 1: mycka86 ($100 in chips) 
Seat 2: Lipton20088 ($81.97 in chips) 
Seat 3: matiko09 ($100 in chips) 
Seat 4: CoolFireX ($100 in chips) 
Seat 9: chrisauy ($84.74 in chips) 
matiko09: posts small blind $0.50
CoolFireX: posts big blind $1
butcheN18: sits out 
ruslik_by: sits out 
*** HOLE CARDS ***
Dealt to matiko09 [Ad Ac]
chrisauy: folds 
mycka86: folds 
Lipton20088: raises $1.20 to $2.20
chrisauy leaves the table
matiko09: raises $6.80 to $9
CoolFireX: folds 
Lipton20088: calls $6.80
*** FLOP *** [5s 6s Td]
matiko09: bets $11
Lipton20088: calls $11
*** TURN *** [5s 6s Td] [Jd]
matiko09: bets $25
Lipton20088: raises $36.97 to $61.97 and is all-in
matiko09: calls $36.97
*** RIVER *** [5s 6s Td Jd] [7d]
*** SHOW DOWN ***
matiko09: shows [Ad Ac] (a pair of Aces)
Lipton20088: shows [Jc Ts] (two pair, Jacks and Tens)
Lipton20088 collected $162.44 from pot
*** SUMMARY ***
Total pot $164.94 | Rake $2.50 
Board [5s 6s Td Jd 7d]
Seat 1: mycka86 folded before Flop (didn't bet)
Seat 2: Lipton20088 (button) showed [Jc Ts] and won ($162.44) with two pair, Jacks and Tens
Seat 3: matiko09 (small blind) showed [Ad Ac] and lost with a pair of Aces
Seat 4: CoolFireX (big blind) folded before Flop
Seat 9: chrisauy folded before Flop (didn't bet)





PokerStars Hand #154797672371:  Hold'em No Limit ($0.25/$0.50 USD) - 2016/06/16 9:25:33 CET [2016/06/16 3:25:33 ET]
Table 'Gaea' 9-max Seat #4 is the button
Seat 1: Mark Calder ($50.46 in chips) 
Seat 2: mi$$I$Elena ($103.17 in chips) 
Seat 3: Crazyfish87 ($40 in chips) 
Seat 4: matiko09 ($57.76 in chips) 
Seat 6: Alex Frider ($60.37 in chips) 
Seat 7: au318 ($47.82 in chips) 
Seat 8: Lipton20088 ($33.42 in chips) 
Seat 9: Prophet1906 ($61.29 in chips) 
Kapa09 will be allowed to play after the button
Alex Frider: posts small blind $0.25
au318: posts big blind $0.50
*** HOLE CARDS ***
Dealt to matiko09 [8h Ks]
Lipton20088: folds 
Prophet1906: folds 
Mark Calder: calls $0.50
mi$$I$Elena: folds 
Crazyfish87: folds 
matiko09: raises $1.50 to $2
Alex Frider: folds 
au318: folds 
Mark Calder: calls $1.50
*** FLOP *** [2s Qs Js]
Mark Calder: checks 
matiko09: bets $2.50
Mark Calder: calls $2.50
*** TURN *** [2s Qs Js] [8s]
Mark Calder: checks 
matiko09: bets $4.81
Mark Calder: raises $5.19 to $10
matiko09: calls $5.19
*** RIVER *** [2s Qs Js 8s] [9s]
Mark Calder: checks 
matiko09: checks 
*** SHOW DOWN ***
Mark Calder: shows [Qd Th] (a flush, Queen high)
matiko09: shows [8h Ks] (a flush, King high)
matiko09 collected $28.26 from pot
*** SUMMARY ***
Total pot $29.75 | Rake $1.49 
Board [2s Qs Js 8s 9s]
Seat 1: Mark Calder showed [Qd Th] and lost with a flush, Queen high
Seat 2: mi$$I$Elena folded before Flop (didn't bet)
Seat 3: Crazyfish87 folded before Flop (didn't bet)
Seat 4: matiko09 (button) showed [8h Ks] and won ($28.26) with a flush, King high
Seat 6: Alex Frider (small blind) folded before Flop
Seat 7: au318 (big blind) folded before Flop
Seat 8: Lipton20088 folded before Flop (didn't bet)
Seat 9: Prophet1906 folded before Flop (didn't bet)





PokerStars Hand #154797674239:  Hold'em No Limit ($0.25/$0.50 USD) - 2016/06/16 9:25:40 CET [2016/06/16 3:25:40 ET]
Table 'Mekbuda II' 9-max Seat #7 is the button
Seat 1: matiko09 ($50 in chips) 
Seat 3: Kapa09 ($52.99 in chips) 
Seat 5: teerajaja ($50 in chips) 
Seat 6: Dantist1122 ($53.19 in chips) 
Seat 7: Kukuryzka ($88.43 in chips) 
Seat 8: WKBelinda ($46.03 in chips) 
Seat 9: Alex Frider ($54.54 in chips) 
WKBelinda: posts small blind $0.25
Alex Frider: posts big blind $0.50
tibi_c87: sits out 
*** HOLE CARDS ***
Dealt to matiko09 [9s 8d]
matiko09: folds 
Kapa09: folds 
teerajaja: folds 
Dantist1122: raises $0.85 to $1.35
Kukuryzka: folds 
WKBelinda: folds 
Alex Frider: calls $0.85
*** FLOP *** [5d 7h 6s]
Alex Frider: checks 
Dantist1122: checks 
*** TURN *** [5d 7h 6s] [6d]
Alex Frider: checks 
Dantist1122: bets $2.24
Alex Frider: calls $2.24
*** RIVER *** [5d 7h 6s 6d] [9c]
Alex Frider: bets $5.71
Dantist1122: folds 
Uncalled bet ($5.71) returned to Alex Frider
Alex Frider collected $7.06 from pot
Alex Frider: doesn't show hand 
*** SUMMARY ***
Total pot $7.43 | Rake $0.37 
Board [5d 7h 6s 6d 9c]
Seat 1: matiko09 folded before Flop (didn't bet)
Seat 3: Kapa09 folded before Flop (didn't bet)
Seat 5: teerajaja folded before Flop (didn't bet)
Seat 6: Dantist1122 folded on the River
Seat 7: Kukuryzka (button) folded before Flop (didn't bet)
Seat 8: WKBelinda (small blind) folded before Flop
Seat 9: Alex Frider (big blind) collected ($7.06)





PokerStars Hand #154797677368:  Hold'em No Limit ($0.50/$1.00 USD) - 2016/06/16 9:25:51 CET [2016/06/16 3:25:51 ET]
Table 'Pasiphae II' 9-max Seat #5 is the button
Seat 2: flk.Dasas ($100 in chips) 
Seat 3: matiko09 ($102.52 in chips) 
Seat 4: ruslik_by ($202.94 in chips) 
Seat 5: CoolFireX ($152.11 in chips) 
Seat 6: m@xXx89 ($113.70 in chips) 
Seat 7: butcheN18 ($144.53 in chips) 
Seat 8: maxxmeister ($111.45 in chips) 
Seat 9: teerajaja ($101.50 in chips) 
m@xXx89: posts small blind $0.50
butcheN18: posts big blind $1
mycka86: sits out 
*** HOLE CARDS ***
Dealt to matiko09 [Jh 9s]
maxxmeister has timed out
maxxmeister: folds 
teerajaja: folds 
flk.Dasas: folds 
matiko09: folds 
maxxmeister leaves the table
ruslik_by: folds 
Lipton20088 joins the table at seat #8 
CoolFireX: folds 
m@xXx89: raises $1 to $2
butcheN18: calls $1
*** FLOP *** [Jd 2s Kh]
m@xXx89: bets $2
butcheN18: calls $2
*** TURN *** [Jd 2s Kh] [7s]
m@xXx89: bets $4
butcheN18: raises $9 to $13
m@xXx89: calls $9
*** RIVER *** [Jd 2s Kh 7s] [Ac]
m@xXx89: checks 
butcheN18: checks 
*** SHOW DOWN ***
m@xXx89: shows [Kd 6d] (a pair of Kings)
butcheN18: shows [7c Jc] (two pair, Jacks and Sevens)
butcheN18 collected $32.30 from pot
*** SUMMARY ***
Total pot $34 | Rake $1.70 
Board [Jd 2s Kh 7s Ac]
Seat 2: flk.Dasas folded before Flop (didn't bet)
Seat 3: matiko09 folded before Flop (didn't bet)
Seat 4: ruslik_by folded before Flop (didn't bet)
Seat 5: CoolFireX (button) folded before Flop (didn't bet)
Seat 6: m@xXx89 (small blind) showed [Kd 6d] and lost with a pair of Kings
Seat 7: butcheN18 (big blind) showed [7c Jc] and won ($32.30) with two pair, Jacks and Sevens
Seat 8: maxxmeister folded before Flop (didn't bet)
Seat 9: teerajaja folded before Flop (didn't bet)





PokerStars Hand #154797679216:  Hold'em No Limit ($0.50/$1.00 USD) - 2016/06/16 9:25:58 CET [2016/06/16 3:25:58 ET]
Table 'Solstice' 9-max Seat #2 is the button
Seat 2: ruslik_by ($101.70 in chips) 
Seat 3: arctur17 ($36.59 in chips) 
Seat 4: jezzaber ($96 in chips) 
Seat 5: mycka86 ($115.48 in chips) 
Seat 6: CoolFireX ($106 in chips) 
Seat 7: apple130 ($155.13 in chips) 
Seat 8: matiko09 ($102 in chips) 
Seat 9: butcheN18 ($106.69 in chips) 
arctur17: posts small blind $0.50
jezzaber: posts big blind $1
maxxmeister: sits out 
*** HOLE CARDS ***
Dealt to matiko09 [Js Td]
mycka86: folds 
CoolFireX: folds 
apple130: raises $2 to $3
matiko09: folds 
butcheN18: folds 
ruslik_by: folds 
arctur17: calls $2.50
jezzaber: folds 
*** FLOP *** [7h 4s 3d]
arctur17: bets $4
apple130: folds 
Uncalled bet ($4) returned to arctur17
arctur17 collected $6.65 from pot
arctur17: doesn't show hand 
*** SUMMARY ***
Total pot $7 | Rake $0.35 
Board [7h 4s 3d]
Seat 2: ruslik_by (button) folded before Flop (didn't bet)
Seat 3: arctur17 (small blind) collected ($6.65)
Seat 4: jezzaber (big blind) folded before Flop
Seat 5: mycka86 folded before Flop (didn't bet)
Seat 6: CoolFireX folded before Flop (didn't bet)
Seat 7: apple130 folded on the Flop
Seat 8: matiko09 folded before Flop (didn't bet)
Seat 9: butcheN18 folded before Flop (didn't bet)





PokerStars Hand #154797679430:  Hold'em No Limit ($0.50/$1.00 USD) - 2016/06/16 9:25:59 CET [2016/06/16 3:25:59 ET]
Table 'Alekto' 9-max Seat #4 is the button
Seat 1: Kukuryzka ($123 in chips) 
Seat 2: brotas232323 ($95.50 in chips) 
Seat 3: butcheN18 ($101.50 in chips) 
Seat 4: hammerwife ($115.27 in chips) 
Seat 5: matiko09 ($114.81 in chips) 
Seat 6: ilaviiitech ($124.81 in chips) 
Seat 7: flk.Dasas ($104.32 in chips) 
Seat 8: Dantist1122 ($100 in chips) 
Seat 9: ruslik_by ($101.50 in chips) 
matiko09: posts small blind $0.50
ilaviiitech: posts big blind $1
*** HOLE CARDS ***
Dealt to matiko09 [5c 8c]
flk.Dasas: folds 
Dantist1122: folds 
ruslik_by: folds 
Kukuryzka: raises $2 to $3
brotas232323: calls $3
butcheN18: raises $9 to $12
hammerwife: folds 
matiko09: folds 
ilaviiitech: folds 
Kukuryzka: folds 
brotas232323: calls $9
*** FLOP *** [Qh Ks Kh]
brotas232323: checks 
butcheN18: bets $12.18
brotas232323: folds 
Uncalled bet ($12.18) returned to butcheN18
butcheN18 collected $27.08 from pot
butcheN18: doesn't show hand 
*** SUMMARY ***
Total pot $28.50 | Rake $1.42 
Board [Qh Ks Kh]
Seat 1: Kukuryzka folded before Flop
Seat 2: brotas232323 folded on the Flop
Seat 3: butcheN18 collected ($27.08)
Seat 4: hammerwife (button) folded before Flop (didn't bet)
Seat 5: matiko09 (small blind) folded before Flop
Seat 6: ilaviiitech (big blind) folded before Flop
Seat 7: flk.Dasas folded before Flop (didn't bet)
Seat 8: Dantist1122 folded before Flop (didn't bet)
Seat 9: ruslik_by folded before Flop (didn't bet)





PokerStars Hand #154797683332:  Hold'em No Limit ($0.50/$1.00 USD) - 2016/06/16 9:26:13 CET [2016/06/16 3:26:13 ET]
Table 'Astyanax' 9-max Seat #8 is the button
Seat 2: matiko09 ($105.69 in chips) 
Seat 4: teerajaja ($101.40 in chips) 
Seat 6: Dantist1122 ($136.14 in chips) 
Seat 7: flk.Dasas ($100 in chips) 
Seat 8: Edgey444 ($98.38 in chips) 
Seat 9: CoolFireX ($100.34 in chips) 
CoolFireX: posts small blind $0.50
matiko09: posts big blind $1
hammerwife: sits out 
butcheN18: sits out 
matiko09: posts the ante $0.20
teerajaja: posts the ante $0.20
Dantist1122: posts the ante $0.20
flk.Dasas: posts the ante $0.20
Edgey444: posts the ante $0.20
CoolFireX: posts the ante $0.20
*** HOLE CARDS ***
Dealt to matiko09 [Qh 4c]
teerajaja: folds 
Dantist1122: folds 
flk.Dasas: folds 
Edgey444: calls $1
CoolFireX: raises $4.20 to $5.20
matiko09: folds 
Edgey444: folds 
Uncalled bet ($4.20) returned to CoolFireX
CoolFireX collected $4.20 from pot
CoolFireX: doesn't show hand 
*** SUMMARY ***
Total pot $4.20 | Rake $0 
Seat 2: matiko09 (big blind) folded before Flop
Seat 4: teerajaja folded before Flop (didn't bet)
Seat 6: Dantist1122 folded before Flop (didn't bet)
Seat 7: flk.Dasas folded before Flop (didn't bet)
Seat 8: Edgey444 (button) folded before Flop
Seat 9: CoolFireX (small blind) collected ($4.20)





PokerStars Hand #154797690368:  Hold'em No Limit ($0.50/$1.00 USD) - 2016/06/16 9:26:39 CET [2016/06/16 3:26:39 ET]
Table 'Hercynia II' 9-max Seat #5 is the button
Seat 1: flk.Dasas ($100 in chips) 
Seat 2: hammerwife ($202.50 in chips) 
Seat 3: ilaviiitech ($122.61 in chips) 
Seat 4: ruslik_by ($100 in chips) 
Seat 5: matiko09 ($100 in chips) 
Seat 7: ozone2003 ($101.50 in chips) 
Seat 8: mycka86 ($184.75 in chips) 
Seat 9: Juniorquiapo ($81.52 in chips) 
ozone2003: posts small blind $0.50
mycka86: posts big blind $1
*** HOLE CARDS ***
Dealt to matiko09 [6d 5h]
Kalacs74 leaves the table
Juniorquiapo: calls $1
flk.Dasas: folds 
hammerwife: raises $3.50 to $4.50
ilaviiitech: folds 
hammerwife said, "no i ft5bet est je)"
ruslik_by: folds 
CoolFireX joins the table at seat #6 
matiko09: folds 
ozone2003: folds 
mycka86: folds 
hammerwife said, "4bet"
Juniorquiapo: folds 
Uncalled bet ($3.50) returned to hammerwife
hammerwife collected $3.50 from pot
hammerwife: doesn't show hand 
*** SUMMARY ***
Total pot $3.50 | Rake $0 
Seat 1: flk.Dasas folded before Flop (didn't bet)
Seat 2: hammerwife collected ($3.50)
Seat 3: ilaviiitech folded before Flop (didn't bet)
Seat 4: ruslik_by folded before Flop (didn't bet)
Seat 5: matiko09 (button) folded before Flop (didn't bet)
Seat 7: ozone2003 (small blind) folded before Flop
Seat 8: mycka86 (big blind) folded before Flop
Seat 9: Juniorquiapo folded before Flop





PokerStars Hand #154797691458:  Hold'em No Limit ($0.50/$1.00 USD) - 2016/06/16 9:26:43 CET [2016/06/16 3:26:43 ET]
Table 'Solstice' 9-max Seat #3 is the button
Seat 2: ruslik_by ($101.70 in chips) 
Seat 3: arctur17 ($40.24 in chips) 
Seat 4: jezzaber ($95 in chips) 
Seat 5: mycka86 ($115.48 in chips) 
Seat 6: CoolFireX ($106 in chips) 
Seat 7: apple130 ($152.13 in chips) 
Seat 8: matiko09 ($102 in chips) 
Seat 9: butcheN18 ($106.69 in chips) 
jezzaber: posts small blind $0.50
mycka86: posts big blind $1
maxxmeister: sits out 
*** HOLE CARDS ***
Dealt to matiko09 [As Jh]
CoolFireX: raises $2 to $3
apple130: folds 
matiko09: folds 
butcheN18: folds 
ruslik_by: folds 
arctur17: folds 
jezzaber: folds 
mycka86: folds 
Uncalled bet ($2) returned to CoolFireX
CoolFireX collected $2.50 from pot
CoolFireX: doesn't show hand 
*** SUMMARY ***
Total pot $2.50 | Rake $0 
Seat 2: ruslik_by folded before Flop (didn't bet)
Seat 3: arctur17 (button) folded before Flop (didn't bet)
Seat 4: jezzaber (small blind) folded before Flop
Seat 5: mycka86 (big blind) folded before Flop
Seat 6: CoolFireX collected ($2.50)
Seat 7: apple130 folded before Flop (didn't bet)
Seat 8: matiko09 folded before Flop (didn't bet)
Seat 9: butcheN18 folded before Flop (didn't bet)





PokerStars Hand #154797692312:  Hold'em No Limit ($0.25/$0.50 USD) - 2016/06/16 9:26:47 CET [2016/06/16 3:26:47 ET]
Table 'Mekbuda II' 9-max Seat #8 is the button
Seat 1: matiko09 ($50 in chips) 
Seat 3: Kapa09 ($52.99 in chips) 
Seat 5: teerajaja ($50 in chips) 
Seat 6: Dantist1122 ($50 in chips) 
Seat 7: Kukuryzka ($88.43 in chips) 
Seat 8: WKBelinda ($45.78 in chips) 
Seat 9: Alex Frider ($58.01 in chips) 
Alex Frider: posts small blind $0.25
matiko09: posts big blind $0.50
tibi_c87: sits out 
*** HOLE CARDS ***
Dealt to matiko09 [7s 9h]
Kapa09 has timed out
Kapa09: folds 
teerajaja: folds 
Dantist1122: folds 
Kukuryzka: raises $0.75 to $1.25
WKBelinda: folds 
Alex Frider: folds 
matiko09: folds 
Uncalled bet ($0.75) returned to Kukuryzka
Kukuryzka collected $1.25 from pot
Kukuryzka: doesn't show hand 
*** SUMMARY ***
Total pot $1.25 | Rake $0 
Seat 1: matiko09 (big blind) folded before Flop
Seat 3: Kapa09 folded before Flop (didn't bet)
Seat 5: teerajaja folded before Flop (didn't bet)
Seat 6: Dantist1122 folded before Flop (didn't bet)
Seat 7: Kukuryzka collected ($1.25)
Seat 8: WKBelinda (button) folded before Flop (didn't bet)
Seat 9: Alex Frider (small blind) folded before Flop





PokerStars Hand #154797692455:  Hold'em No Limit ($0.50/$1.00 USD) - 2016/06/16 9:26:47 CET [2016/06/16 3:26:47 ET]
Table 'Stroobantia II' 9-max Seat #3 is the button
Seat 1: mycka86 ($100 in chips) 
Seat 2: Lipton20088 ($162.44 in chips) 
Seat 3: matiko09 ($100 in chips) 
Seat 4: CoolFireX ($100 in chips) 
Seat 5: butcheN18 ($100 in chips) 
CoolFireX: posts small blind $0.50
butcheN18: posts big blind $1
ruslik_by: sits out 
*** HOLE CARDS ***
Dealt to matiko09 [3c 5d]
mycka86: folds 
Lipton20088: folds 
matiko09: folds 
CoolFireX: folds 
Uncalled bet ($0.50) returned to butcheN18
butcheN18 collected $1 from pot
butcheN18: doesn't show hand 
*** SUMMARY ***
Total pot $1 | Rake $0 
Seat 1: mycka86 folded before Flop (didn't bet)
Seat 2: Lipton20088 folded before Flop (didn't bet)
Seat 3: matiko09 (button) folded before Flop (didn't bet)
Seat 4: CoolFireX (small blind) folded before Flop
Seat 5: butcheN18 (big blind) collected ($1)





PokerStars Hand #154797698485:  Hold'em No Limit ($0.25/$0.50 USD) - 2016/06/16 9:27:09 CET [2016/06/16 3:27:09 ET]
Table 'Gaea' 9-max Seat #6 is the button
Seat 1: Mark Calder ($35.96 in chips) 
Seat 2: mi$$I$Elena ($103.17 in chips) 
Seat 3: Crazyfish87 ($40 in chips) 
Seat 4: matiko09 ($71.52 in chips) 
Seat 6: Alex Frider ($60.12 in chips) 
Seat 7: au318 ($47.32 in chips) 
Seat 9: Prophet1906 ($61.29 in chips) 
au318: posts small blind $0.25
Lipton20088: is sitting out 
Prophet1906: posts big blind $0.50
Kapa09: sits out 
*** HOLE CARDS ***
Dealt to matiko09 [Js 2s]
Lipton20088 leaves the table
Red_Warning joins the table at seat #8 
Mark Calder: folds 
mi$$I$Elena: folds 
Crazyfish87: folds 
matiko09: folds 
Mark Calder leaves the table
Alex Frider: raises $0.52 to $1.02
au318: folds 
Prophet1906: folds 
Uncalled bet ($0.52) returned to Alex Frider
letto77 joins the table at seat #1 
Alex Frider collected $1.25 from pot
Alex Frider: doesn't show hand 
*** SUMMARY ***
Total pot $1.25 | Rake $0 
Seat 1: Mark Calder folded before Flop (didn't bet)
Seat 2: mi$$I$Elena folded before Flop (didn't bet)
Seat 3: Crazyfish87 folded before Flop (didn't bet)
Seat 4: matiko09 folded before Flop (didn't bet)
Seat 6: Alex Frider (button) collected ($1.25)
Seat 7: au318 (small blind) folded before Flop
Seat 9: Prophet1906 (big blind) folded before Flop





PokerStars Hand #154797699206:  Hold'em No Limit ($0.50/$1.00 USD) - 2016/06/16 9:27:12 CET [2016/06/16 3:27:12 ET]
Table 'Alekto' 9-max Seat #5 is the button
Seat 1: Kukuryzka ($120 in chips) 
Seat 2: brotas232323 ($88 in chips) 
Seat 3: butcheN18 ($116.58 in chips) 
Seat 4: hammerwife ($115.27 in chips) 
Seat 5: matiko09 ($114.31 in chips) 
Seat 6: ilaviiitech ($123.81 in chips) 
Seat 7: flk.Dasas ($104.32 in chips) 
Seat 8: Dantist1122 ($100 in chips) 
Seat 9: ruslik_by ($101.50 in chips) 
ilaviiitech: posts small blind $0.50
flk.Dasas: posts big blind $1
*** HOLE CARDS ***
Dealt to matiko09 [9d 4s]
Dantist1122: folds 
ruslik_by: raises $2 to $3
Kukuryzka: folds 
brotas232323: folds 
butcheN18: folds 
hammerwife: folds 
matiko09: folds 
ilaviiitech: folds 
flk.Dasas: folds 
Uncalled bet ($2) returned to ruslik_by
ruslik_by collected $2.50 from pot
ruslik_by: doesn't show hand 
*** SUMMARY ***
Total pot $2.50 | Rake $0 
Seat 1: Kukuryzka folded before Flop (didn't bet)
Seat 2: brotas232323 folded before Flop (didn't bet)
Seat 3: butcheN18 folded before Flop (didn't bet)
Seat 4: hammerwife folded before Flop (didn't bet)
Seat 5: matiko09 (button) folded before Flop (didn't bet)
Seat 6: ilaviiitech (small blind) folded before Flop
Seat 7: flk.Dasas (big blind) folded before Flop
Seat 8: Dantist1122 folded before Flop (didn't bet)
Seat 9: ruslik_by collected ($2.50)





PokerStars Hand #154797701477:  Hold'em No Limit ($0.50/$1.00 USD) - 2016/06/16 9:27:20 CET [2016/06/16 3:27:20 ET]
Table 'Astyanax' 9-max Seat #9 is the button
Seat 2: matiko09 ($104.49 in chips) 
Seat 3: hammerwife ($106.54 in chips) 
Seat 4: teerajaja ($101.20 in chips) 
Seat 6: Dantist1122 ($135.94 in chips) 
Seat 7: flk.Dasas ($100 in chips) 
Seat 8: Edgey444 ($97.18 in chips) 
Seat 9: CoolFireX ($103.34 in chips) 
pokerich462 will be allowed to play after the button
matiko09: posts small blind $0.50
hammerwife: posts big blind $1
butcheN18: sits out 
matiko09: posts the ante $0.20
hammerwife: posts the ante $0.20
teerajaja: posts the ante $0.20
Dantist1122: posts the ante $0.20
flk.Dasas: posts the ante $0.20
Edgey444: posts the ante $0.20
CoolFireX: posts the ante $0.20
*** HOLE CARDS ***
Dealt to matiko09 [5s Th]
teerajaja: folds 
Dantist1122: folds 
flk.Dasas: folds 
Edgey444: folds 
CoolFireX: raises $1.50 to $2.50
matiko09: folds 
hammerwife: folds 
Uncalled bet ($1.50) returned to CoolFireX
CoolFireX collected $3.90 from pot
CoolFireX: doesn't show hand 
*** SUMMARY ***
Total pot $3.90 | Rake $0 
Seat 2: matiko09 (small blind) folded before Flop
Seat 3: hammerwife (big blind) folded before Flop
Seat 4: teerajaja folded before Flop (didn't bet)
Seat 6: Dantist1122 folded before Flop (didn't bet)
Seat 7: flk.Dasas folded before Flop (didn't bet)
Seat 8: Edgey444 folded before Flop (didn't bet)
Seat 9: CoolFireX (button) collected ($3.90)





PokerStars Hand #154797702142:  Hold'em No Limit ($0.50/$1.00 USD) - 2016/06/16 9:27:23 CET [2016/06/16 3:27:23 ET]
Table 'Hercynia II' 9-max Seat #7 is the button
Seat 1: flk.Dasas ($100 in chips) 
Seat 2: hammerwife ($205 in chips) 
Seat 3: ilaviiitech ($122.61 in chips) 
Seat 4: ruslik_by ($100 in chips) 
Seat 5: matiko09 ($100 in chips) 
Seat 7: ozone2003 ($101 in chips) 
Seat 8: mycka86 ($183.75 in chips) 
Seat 9: Juniorquiapo ($80.52 in chips) 
mycka86: posts small blind $0.50
Juniorquiapo: posts big blind $1
CoolFireX: sits out 
*** HOLE CARDS ***
Dealt to matiko09 [Tc 2h]
flk.Dasas: folds 
hammerwife: folds 
ilaviiitech: folds 
ruslik_by: folds 
matiko09: folds 
ozone2003: raises $1.20 to $2.20
mycka86: folds 
Juniorquiapo: folds 
Uncalled bet ($1.20) returned to ozone2003
ozone2003 collected $2.50 from pot
ozone2003: doesn't show hand 
*** SUMMARY ***
Total pot $2.50 | Rake $0 
Seat 1: flk.Dasas folded before Flop (didn't bet)
Seat 2: hammerwife folded before Flop (didn't bet)
Seat 3: ilaviiitech folded before Flop (didn't bet)
Seat 4: ruslik_by folded before Flop (didn't bet)
Seat 5: matiko09 folded before Flop (didn't bet)
Seat 7: ozone2003 (button) collected ($2.50)
Seat 8: mycka86 (small blind) folded before Flop
Seat 9: Juniorquiapo (big blind) folded before Flop





PokerStars Hand #154797703874:  Hold'em No Limit ($0.25/$0.50 USD) - 2016/06/16 9:27:29 CET [2016/06/16 3:27:29 ET]
Table 'Mekbuda II' 9-max Seat #9 is the button
Seat 1: matiko09 ($50 in chips) 
Seat 2: tibi_c87 ($50 in chips) 
Seat 3: Kapa09 ($52.99 in chips) 
Seat 5: teerajaja ($50 in chips) 
Seat 6: Dantist1122 ($50 in chips) 
Seat 7: Kukuryzka ($89.18 in chips) 
Seat 8: WKBelinda ($45.78 in chips) 
Seat 9: Alex Frider ($57.76 in chips) 
matiko09: posts small blind $0.25
tibi_c87: posts big blind $0.50
*** HOLE CARDS ***
Dealt to matiko09 [4d 5s]
Kapa09: folds 
teerajaja: folds 
Dantist1122: raises $1 to $1.50
Kukuryzka: folds 
WKBelinda: folds 
Alex Frider: folds 
matiko09: folds 
tibi_c87: folds 
Uncalled bet ($1) returned to Dantist1122
Dantist1122 collected $1.25 from pot
Dantist1122: doesn't show hand 
*** SUMMARY ***
Total pot $1.25 | Rake $0 
Seat 1: matiko09 (small blind) folded before Flop
Seat 2: tibi_c87 (big blind) folded before Flop
Seat 3: Kapa09 folded before Flop (didn't bet)
Seat 5: teerajaja folded before Flop (didn't bet)
Seat 6: Dantist1122 collected ($1.25)
Seat 7: Kukuryzka folded before Flop (didn't bet)
Seat 8: WKBelinda folded before Flop (didn't bet)
Seat 9: Alex Frider (button) folded before Flop (didn't bet)





PokerStars Hand #154797704061:  Hold'em No Limit ($0.50/$1.00 USD) - 2016/06/16 9:27:30 CET [2016/06/16 3:27:30 ET]
Table 'Solstice' 9-max Seat #4 is the button
Seat 2: ruslik_by ($101.70 in chips) 
Seat 3: arctur17 ($40.24 in chips) 
Seat 4: jezzaber ($94.50 in chips) 
Seat 5: mycka86 ($114.48 in chips) 
Seat 6: CoolFireX ($107.50 in chips) 
Seat 7: apple130 ($152.13 in chips) 
Seat 8: matiko09 ($102 in chips) 
Seat 9: butcheN18 ($106.69 in chips) 
mycka86: posts small blind $0.50
CoolFireX: posts big blind $1
maxxmeister: sits out 
*** HOLE CARDS ***
Dealt to matiko09 [3h 7d]
apple130: folds 
matiko09: folds 
apple130 leaves the table
butcheN18: folds 
ruslik_by: folds 
arctur17: folds 
jezzaber: raises $2 to $3
tatimora joins the table at seat #7 
mycka86: folds 
CoolFireX: folds 
Uncalled bet ($2) returned to jezzaber
jezzaber collected $2.50 from pot
jezzaber: doesn't show hand 
*** SUMMARY ***
Total pot $2.50 | Rake $0 
Seat 2: ruslik_by folded before Flop (didn't bet)
Seat 3: arctur17 folded before Flop (didn't bet)
Seat 4: jezzaber (button) collected ($2.50)
Seat 5: mycka86 (small blind) folded before Flop
Seat 6: CoolFireX (big blind) folded before Flop
Seat 7: apple130 folded before Flop (didn't bet)
Seat 8: matiko09 folded before Flop (didn't bet)
Seat 9: butcheN18 folded before Flop (didn't bet)





PokerStars Hand #154797704286:  Hold'em No Limit ($0.25/$0.50 USD) - 2016/06/16 9:27:30 CET [2016/06/16 3:27:30 ET]
Table 'Gaea' 9-max Seat #7 is the button
Seat 1: letto77 ($50 in chips) 
Seat 2: mi$$I$Elena ($103.17 in chips) 
Seat 3: Crazyfish87 ($40 in chips) 
Seat 4: matiko09 ($71.52 in chips) 
Seat 6: Alex Frider ($60.87 in chips) 
Seat 7: au318 ($47.07 in chips) 
Seat 9: Prophet1906 ($60.79 in chips) 
Red_Warning will be allowed to play after the button
Prophet1906: posts small blind $0.25
letto77: posts big blind $0.50
Kapa09: sits out 
*** HOLE CARDS ***
Dealt to matiko09 [8d Qh]
mi$$I$Elena: folds 
Crazyfish87: folds 
matiko09: folds 
mi$$I$Elena leaves the table
Alex Frider: folds 
au318: raises $0.50 to $1
magzi777 joins the table at seat #2 
Prophet1906: folds 
letto77: calls $0.50
*** FLOP *** [Js Qc 4h]
letto77: bets $1.50
au318: calls $1.50
*** TURN *** [Js Qc 4h] [4c]
letto77: bets $3
au318: calls $3
*** RIVER *** [Js Qc 4h 4c] [9d]
letto77: checks 
au318: bets $6
letto77: folds 
Uncalled bet ($6) returned to au318
au318 collected $10.69 from pot
au318: doesn't show hand 
*** SUMMARY ***
Total pot $11.25 | Rake $0.56 
Board [Js Qc 4h 4c 9d]
Seat 1: letto77 (big blind) folded on the River
Seat 2: mi$$I$Elena folded before Flop (didn't bet)
Seat 3: Crazyfish87 folded before Flop (didn't bet)
Seat 4: matiko09 folded before Flop (didn't bet)
Seat 6: Alex Frider folded before Flop (didn't bet)
Seat 7: au318 (button) collected ($10.69)
Seat 9: Prophet1906 (small blind) folded before Flop





PokerStars Hand #154797704657:  Hold'em No Limit ($0.50/$1.00 USD) - 2016/06/16 9:27:32 CET [2016/06/16 3:27:32 ET]
Table 'Stroobantia II' 9-max Seat #4 is the button
Seat 1: mycka86 ($100 in chips) 
Seat 2: Lipton20088 ($162.44 in chips) 
Seat 3: matiko09 ($100 in chips) 
Seat 4: CoolFireX ($100 in chips) 
Seat 5: butcheN18 ($100.50 in chips) 
Seat 8: ruslik_by ($100 in chips) 
butcheN18: posts small blind $0.50
ruslik_by: posts big blind $1
*** HOLE CARDS ***
Dealt to matiko09 [Kc 4c]
mycka86: folds 
Lipton20088: folds 
matiko09: folds 
CoolFireX has timed out
CoolFireX: folds 
butcheN18: raises $1.44 to $2.44
ruslik_by: folds 
Uncalled bet ($1.44) returned to butcheN18
jakub249 joins the table at seat #9 
butcheN18 collected $2 from pot
butcheN18: doesn't show hand 
*** SUMMARY ***
Total pot $2 | Rake $0 
Seat 1: mycka86 folded before Flop (didn't bet)
Seat 2: Lipton20088 folded before Flop (didn't bet)
Seat 3: matiko09 folded before Flop (didn't bet)
Seat 4: CoolFireX (button) folded before Flop (didn't bet)
Seat 5: butcheN18 (small blind) collected ($2)
Seat 8: ruslik_by (big blind) folded before Flop





PokerStars Hand #154797707495:  Hold'em No Limit ($0.50/$1.00 USD) - 2016/06/16 9:27:42 CET [2016/06/16 3:27:42 ET]
Table 'Hercynia II' 9-max Seat #8 is the button
Seat 1: flk.Dasas ($100 in chips) 
Seat 2: hammerwife ($205 in chips) 
Seat 3: ilaviiitech ($122.61 in chips) 
Seat 4: ruslik_by ($100 in chips) 
Seat 5: matiko09 ($100 in chips) 
Seat 7: ozone2003 ($102.50 in chips) 
Seat 8: mycka86 ($183.25 in chips) 
Seat 9: Juniorquiapo ($79.52 in chips) 
Juniorquiapo: posts small blind $0.50
flk.Dasas: posts big blind $1
CoolFireX: sits out 
*** HOLE CARDS ***
Dealt to matiko09 [5s Th]
hammerwife: folds 
ilaviiitech: folds 
ruslik_by: folds 
matiko09: folds 
ozone2003: raises $1.50 to $2.50
mycka86: folds 
Juniorquiapo: folds 
hammerwife said, "TT ok, no AQ v4era...)"
flk.Dasas: folds 
Uncalled bet ($1.50) returned to ozone2003
ozone2003 collected $2.50 from pot
ozone2003: doesn't show hand 
*** SUMMARY ***
Total pot $2.50 | Rake $0 
Seat 1: flk.Dasas (big blind) folded before Flop
Seat 2: hammerwife folded before Flop (didn't bet)
Seat 3: ilaviiitech folded before Flop (didn't bet)
Seat 4: ruslik_by folded before Flop (didn't bet)
Seat 5: matiko09 folded before Flop (didn't bet)
Seat 7: ozone2003 collected ($2.50)
Seat 8: mycka86 (button) folded before Flop (didn't bet)
Seat 9: Juniorquiapo (small blind) folded before Flop





PokerStars Hand #154797710720:  Hold'em No Limit ($0.50/$1.00 USD) - 2016/06/16 9:27:54 CET [2016/06/16 3:27:54 ET]
Table 'Alekto' 9-max Seat #6 is the button
Seat 1: Kukuryzka ($120 in chips) 
Seat 2: brotas232323 ($100 in chips) 
Seat 3: butcheN18 ($116.58 in chips) 
Seat 4: hammerwife ($115.27 in chips) 
Seat 5: matiko09 ($114.31 in chips) 
Seat 6: ilaviiitech ($123.31 in chips) 
Seat 7: flk.Dasas ($103.32 in chips) 
Seat 9: ruslik_by ($103 in chips) 
flk.Dasas: posts small blind $0.50
Dantist1122: is sitting out 
ruslik_by: posts big blind $1
*** HOLE CARDS ***
Dealt to matiko09 [Th 6h]
Dantist1122 leaves the table
Kukuryzka: folds 
brotas232323: folds 
ozone2003 joins the table at seat #8 
butcheN18: folds 
hammerwife: folds 
matiko09: folds 
ilaviiitech: raises $2 to $3
flk.Dasas: folds 
ruslik_by: folds 
Uncalled bet ($2) returned to ilaviiitech
ilaviiitech collected $2.50 from pot
ilaviiitech: doesn't show hand 
*** SUMMARY ***
Total pot $2.50 | Rake $0 
Seat 1: Kukuryzka folded before Flop (didn't bet)
Seat 2: brotas232323 folded before Flop (didn't bet)
Seat 3: butcheN18 folded before Flop (didn't bet)
Seat 4: hammerwife folded before Flop (didn't bet)
Seat 5: matiko09 folded before Flop (didn't bet)
Seat 6: ilaviiitech (button) collected ($2.50)
Seat 7: flk.Dasas (small blind) folded before Flop
Seat 9: ruslik_by (big blind) folded before Flop





PokerStars Hand #154797710765:  Hold'em No Limit ($0.25/$0.50 USD) - 2016/06/16 9:27:54 CET [2016/06/16 3:27:54 ET]
Table 'Mekbuda II' 9-max Seat #1 is the button
Seat 1: matiko09 ($50 in chips) 
Seat 2: tibi_c87 ($50 in chips) 
Seat 3: Kapa09 ($52.99 in chips) 
Seat 5: teerajaja ($50 in chips) 
Seat 6: Dantist1122 ($50.75 in chips) 
Seat 7: Kukuryzka ($89.18 in chips) 
Seat 8: WKBelinda ($45.78 in chips) 
Seat 9: Alex Frider ($57.76 in chips) 
tibi_c87: posts small blind $0.25
Kapa09: posts big blind $0.50
*** HOLE CARDS ***
Dealt to matiko09 [2c 7d]
teerajaja: folds 
Dantist1122: folds 
Kukuryzka: folds 
WKBelinda: folds 
Alex Frider: folds 
matiko09: folds 
tibi_c87: folds 
Uncalled bet ($0.25) returned to Kapa09
Kapa09 collected $0.50 from pot
Kapa09: doesn't show hand 
*** SUMMARY ***
Total pot $0.50 | Rake $0 
Seat 1: matiko09 (button) folded before Flop (didn't bet)
Seat 2: tibi_c87 (small blind) folded before Flop
Seat 3: Kapa09 (big blind) collected ($0.50)
Seat 5: teerajaja folded before Flop (didn't bet)
Seat 6: Dantist1122 folded before Flop (didn't bet)
Seat 7: Kukuryzka folded before Flop (didn't bet)
Seat 8: WKBelinda folded before Flop (didn't bet)
Seat 9: Alex Frider folded before Flop (didn't bet)





PokerStars Hand #154797711944:  Hold'em No Limit ($0.50/$1.00 USD) - 2016/06/16 9:27:59 CET [2016/06/16 3:27:59 ET]
Table 'Astyanax' 9-max Seat #2 is the button
Seat 1: pokerich462 ($147.24 in chips) 
Seat 2: matiko09 ($103.79 in chips) 
Seat 3: hammerwife ($105.34 in chips) 
Seat 4: teerajaja ($101 in chips) 
Seat 6: Dantist1122 ($135.74 in chips) 
Seat 7: flk.Dasas ($100 in chips) 
Seat 8: Edgey444 ($96.98 in chips) 
Seat 9: CoolFireX ($106.04 in chips) 
hammerwife: posts small blind $0.50
teerajaja: posts big blind $1
butcheN18: sits out 
pokerich462: posts small & big blinds $1.50
pokerich462: posts the ante $0.20
matiko09: posts the ante $0.20
hammerwife: posts the ante $0.20
teerajaja: posts the ante $0.20
Dantist1122: posts the ante $0.20
flk.Dasas: posts the ante $0.20
Edgey444: posts the ante $0.20
CoolFireX: posts the ante $0.20
*** HOLE CARDS ***
Dealt to matiko09 [2h 3d]
Dantist1122: folds 
flk.Dasas: folds 
Edgey444: calls $1
CoolFireX: folds 
pokerich462: checks 
matiko09: folds 
hammerwife: raises $4 to $5
teerajaja: calls $4
Edgey444: calls $4
pokerich462: folds 
*** FLOP *** [Ac Js 6d]
hammerwife: bets $8.50
teerajaja: folds 
Edgey444: folds 
Uncalled bet ($8.50) returned to hammerwife
hammerwife collected $17.20 from pot
hammerwife: doesn't show hand 
*** SUMMARY ***
Total pot $18.10 | Rake $0.90 
Board [Ac Js 6d]
Seat 1: pokerich462 folded before Flop
Seat 2: matiko09 (button) folded before Flop (didn't bet)
Seat 3: hammerwife (small blind) collected ($17.20)
Seat 4: teerajaja (big blind) folded on the Flop
Seat 6: Dantist1122 folded before Flop (didn't bet)
Seat 7: flk.Dasas folded before Flop (didn't bet)
Seat 8: Edgey444 folded on the Flop
Seat 9: CoolFireX folded before Flop (didn't bet)





PokerStars Hand #154797713783:  Hold'em No Limit ($0.50/$1.00 USD) - 2016/06/16 9:28:05 CET [2016/06/16 3:28:05 ET]
Table 'Solstice' 9-max Seat #5 is the button
Seat 2: ruslik_by ($101.70 in chips) 
Seat 3: arctur17 ($40.24 in chips) 
Seat 4: jezzaber ($96 in chips) 
Seat 5: mycka86 ($113.98 in chips) 
Seat 6: CoolFireX ($106.50 in chips) 
Seat 7: tatimora ($100 in chips) 
Seat 8: matiko09 ($102 in chips) 
Seat 9: butcheN18 ($106.69 in chips) 
CoolFireX: posts small blind $0.50
tatimora: posts big blind $1
maxxmeister: sits out 
*** HOLE CARDS ***
Dealt to matiko09 [2d 9d]
matiko09: folds 
butcheN18: folds 
ruslik_by: folds 
arctur17: folds 
jezzaber: folds 
mycka86: raises $1.10 to $2.10
CoolFireX: folds 
tatimora: folds 
Uncalled bet ($1.10) returned to mycka86
mycka86 collected $2.50 from pot
*** SUMMARY ***
Total pot $2.50 | Rake $0 
Seat 2: ruslik_by folded before Flop (didn't bet)
Seat 3: arctur17 folded before Flop (didn't bet)
Seat 4: jezzaber folded before Flop (didn't bet)
Seat 5: mycka86 (button) collected ($2.50)
Seat 6: CoolFireX (small blind) folded before Flop
Seat 7: tatimora (big blind) folded before Flop
Seat 8: matiko09 folded before Flop (didn't bet)
Seat 9: butcheN18 folded before Flop (didn't bet)





PokerStars Hand #154797717125:  Hold'em No Limit ($0.50/$1.00 USD) - 2016/06/16 9:28:18 CET [2016/06/16 3:28:18 ET]
Table 'Stroobantia II' 9-max Seat #5 is the button
Seat 1: mycka86 ($100 in chips) 
Seat 2: Lipton20088 ($162.44 in chips) 
Seat 3: matiko09 ($100 in chips) 
Seat 4: CoolFireX ($100 in chips) 
Seat 5: butcheN18 ($101.50 in chips) 
Seat 8: ruslik_by ($100 in chips) 
Seat 9: jakub249 ($80 in chips) 
ruslik_by: posts small blind $0.50
jakub249: posts big blind $1
*** HOLE CARDS ***
Dealt to matiko09 [5c As]
mycka86: raises $2 to $3
Lipton20088: folds 
matiko09: folds 
CoolFireX: folds 
butcheN18: folds 
ruslik_by: folds 
jakub249: calls $2
*** FLOP *** [9c Ac Kd]
jakub249: checks 
mycka86: bets $4.70
andrewtomaz joins the table at seat #6 
AlKatrone joins the table at seat #7 
jakub249: folds 
Uncalled bet ($4.70) returned to mycka86
mycka86 collected $6.18 from pot
*** SUMMARY ***
Total pot $6.50 | Rake $0.32 
Board [9c Ac Kd]
Seat 1: mycka86 collected ($6.18)
Seat 2: Lipton20088 folded before Flop (didn't bet)
Seat 3: matiko09 folded before Flop (didn't bet)
Seat 4: CoolFireX folded before Flop (didn't bet)
Seat 5: butcheN18 (button) folded before Flop (didn't bet)
Seat 8: ruslik_by (small blind) folded before Flop
Seat 9: jakub249 (big blind) folded on the Flop





PokerStars Hand #154797718843:  Hold'em No Limit ($0.50/$1.00 USD) - 2016/06/16 9:28:24 CET [2016/06/16 3:28:24 ET]
Table 'Hercynia II' 9-max Seat #9 is the button
Seat 1: flk.Dasas ($100 in chips) 
Seat 2: hammerwife ($205 in chips) 
Seat 3: ilaviiitech ($122.61 in chips) 
Seat 4: ruslik_by ($100 in chips) 
Seat 5: matiko09 ($100 in chips) 
Seat 7: ozone2003 ($104 in chips) 
Seat 8: mycka86 ($183.25 in chips) 
Seat 9: Juniorquiapo ($79.02 in chips) 
flk.Dasas: posts small blind $0.50
hammerwife: posts big blind $1
CoolFireX: sits out 
*** HOLE CARDS ***
Dealt to matiko09 [9s 2h]
ilaviiitech: folds 
ruslik_by: raises $2 to $3
ilaviiitech leaves the table
matiko09: folds 
ozone2003: folds 
mycka86: folds 
Juniorquiapo: folds 
flk.Dasas: folds 
hammerwife: calls $2
*** FLOP *** [7h 8s 4c]
hammerwife: checks 
ruslik_by: bets $2.10
butcheN18 joins the table at seat #3 
hammerwife: calls $2.10
*** TURN *** [7h 8s 4c] [Qh]
hammerwife: checks 
ruslik_by: checks 
*** RIVER *** [7h 8s 4c Qh] [9d]
hammerwife: bets $7
ruslik_by: folds 
Uncalled bet ($7) returned to hammerwife
hammerwife collected $10.16 from pot
hammerwife: doesn't show hand 
*** SUMMARY ***
Total pot $10.70 | Rake $0.54 
Board [7h 8s 4c Qh 9d]
Seat 1: flk.Dasas (small blind) folded before Flop
Seat 2: hammerwife (big blind) collected ($10.16)
Seat 3: ilaviiitech folded before Flop (didn't bet)
Seat 4: ruslik_by folded on the River
Seat 5: matiko09 folded before Flop (didn't bet)
Seat 7: ozone2003 folded before Flop (didn't bet)
Seat 8: mycka86 folded before Flop (didn't bet)
Seat 9: Juniorquiapo (button) folded before Flop (didn't bet)





PokerStars Hand #154797720366:  Hold'em No Limit ($0.50/$1.00 USD) - 2016/06/16 9:28:30 CET [2016/06/16 3:28:30 ET]
Table 'Alekto' 9-max Seat #7 is the button
Seat 2: brotas232323 ($100 in chips) 
Seat 3: butcheN18 ($116.58 in chips) 
Seat 4: hammerwife ($115.27 in chips) 
Seat 5: matiko09 ($114.31 in chips) 
Seat 6: ilaviiitech ($124.81 in chips) 
Seat 7: flk.Dasas ($102.82 in chips) 
Seat 9: ruslik_by ($102 in chips) 
ozone2003 will be allowed to play after the button
ruslik_by: posts small blind $0.50
Kukuryzka: is sitting out 
Kukuryzka leaves the table
brotas232323: posts big blind $1
*** HOLE CARDS ***
Dealt to matiko09 [6c 6s]
mycka86 joins the table at seat #1 
butcheN18: folds 
hammerwife: folds 
matiko09: raises $2 to $3
ilaviiitech: folds 
flk.Dasas: folds 
ruslik_by: folds 
brotas232323: calls $2
*** FLOP *** [4s 4c 2s]
brotas232323: checks 
matiko09: bets $4.02
brotas232323: folds 
Uncalled bet ($4.02) returned to matiko09
matiko09 collected $6.18 from pot
matiko09: doesn't show hand 
*** SUMMARY ***
Total pot $6.50 | Rake $0.32 
Board [4s 4c 2s]
Seat 2: brotas232323 (big blind) folded on the Flop
Seat 3: butcheN18 folded before Flop (didn't bet)
Seat 4: hammerwife folded before Flop (didn't bet)
Seat 5: matiko09 collected ($6.18)
Seat 6: ilaviiitech folded before Flop (didn't bet)
Seat 7: flk.Dasas (button) folded before Flop (didn't bet)
Seat 9: ruslik_by (small blind) folded before Flop





PokerStars Hand #154797722101:  Hold'em No Limit ($0.25/$0.50 USD) - 2016/06/16 9:28:36 CET [2016/06/16 3:28:36 ET]
Table 'Mekbuda II' 9-max Seat #2 is the button
Seat 1: matiko09 ($50 in chips) 
Seat 2: tibi_c87 ($50 in chips) 
Seat 3: Kapa09 ($53.24 in chips) 
Seat 5: teerajaja ($50 in chips) 
Seat 6: Dantist1122 ($50.75 in chips) 
Seat 7: Kukuryzka ($89.18 in chips) 
Seat 8: WKBelinda ($45.78 in chips) 
Seat 9: Alex Frider ($57.76 in chips) 
Kapa09: posts small blind $0.25
teerajaja: posts big blind $0.50
*** HOLE CARDS ***
Dealt to matiko09 [2d 5d]
Dantist1122: folds 
Kukuryzka: folds 
WKBelinda: calls $0.50
Alex Frider: folds 
matiko09: folds 
tibi_c87: folds 
Kapa09: folds 
teerajaja: checks 
*** FLOP *** [3c 7s As]
teerajaja: checks 
WKBelinda: bets $1
teerajaja: folds 
Uncalled bet ($1) returned to WKBelinda
WKBelinda collected $1.19 from pot
WKBelinda: doesn't show hand 
*** SUMMARY ***
Total pot $1.25 | Rake $0.06 
Board [3c 7s As]
Seat 1: matiko09 folded before Flop (didn't bet)
Seat 2: tibi_c87 (button) folded before Flop (didn't bet)
Seat 3: Kapa09 (small blind) folded before Flop
Seat 5: teerajaja (big blind) folded on the Flop
Seat 6: Dantist1122 folded before Flop (didn't bet)
Seat 7: Kukuryzka folded before Flop (didn't bet)
Seat 8: WKBelinda collected ($1.19)
Seat 9: Alex Frider folded before Flop (didn't bet)





PokerStars Hand #154797725037:  Hold'em No Limit ($0.50/$1.00 USD) - 2016/06/16 9:28:47 CET [2016/06/16 3:28:47 ET]
Table 'Solstice' 9-max Seat #6 is the button
Seat 2: ruslik_by ($101.70 in chips) 
Seat 3: arctur17 ($40.24 in chips) 
Seat 4: jezzaber ($96 in chips) 
Seat 5: mycka86 ($115.48 in chips) 
Seat 6: CoolFireX ($106 in chips) 
Seat 7: tatimora ($99 in chips) 
Seat 8: matiko09 ($102 in chips) 
Seat 9: butcheN18 ($106.69 in chips) 
tatimora: posts small blind $0.50
matiko09: posts big blind $1
maxxmeister: sits out 
*** HOLE CARDS ***
Dealt to matiko09 [6s 8s]
butcheN18: folds 
ruslik_by: folds 
arctur17: raises $1 to $2
jezzaber: folds 
mycka86: folds 
CoolFireX: calls $2
tatimora: folds 
matiko09: calls $1
*** FLOP *** [Js Jh Tc]
matiko09: checks 
arctur17: checks 
CoolFireX: bets $4.11
matiko09: folds 
arctur17: folds 
Uncalled bet ($4.11) returned to CoolFireX
CoolFireX collected $6.18 from pot
CoolFireX: doesn't show hand 
*** SUMMARY ***
Total pot $6.50 | Rake $0.32 
Board [Js Jh Tc]
Seat 2: ruslik_by folded before Flop (didn't bet)
Seat 3: arctur17 folded on the Flop
Seat 4: jezzaber folded before Flop (didn't bet)
Seat 5: mycka86 folded before Flop (didn't bet)
Seat 6: CoolFireX (button) collected ($6.18)
Seat 7: tatimora (small blind) folded before Flop
Seat 8: matiko09 (big blind) folded on the Flop
Seat 9: butcheN18 folded before Flop (didn't bet)





PokerStars Hand #154797728188:  Hold'em No Limit ($0.25/$0.50 USD) - 2016/06/16 9:28:58 CET [2016/06/16 3:28:58 ET]
Table 'Gaea' 9-max Seat #9 is the button
Seat 1: letto77 ($50 in chips) 
Seat 2: magzi777 ($50 in chips) 
Seat 3: Crazyfish87 ($40 in chips) 
Seat 4: matiko09 ($71.52 in chips) 
Seat 6: Alex Frider ($60.87 in chips) 
Seat 7: au318 ($52.26 in chips) 
Seat 9: Prophet1906 ($60.54 in chips) 
letto77: posts small blind $0.25
magzi777: posts big blind $0.50
Kapa09: sits out 
Red_Warning: sits out 
*** HOLE CARDS ***
Dealt to matiko09 [2c Ts]
Crazyfish87: folds 
matiko09: folds 
Alex Frider: folds 
au318: folds 
Prophet1906: raises $1 to $1.50
letto77: folds 
magzi777: folds 
Uncalled bet ($1) returned to Prophet1906
Prophet1906 collected $1.25 from pot
Prophet1906: doesn't show hand 
*** SUMMARY ***
Total pot $1.25 | Rake $0 
Seat 1: letto77 (small blind) folded before Flop
Seat 2: magzi777 (big blind) folded before Flop
Seat 3: Crazyfish87 folded before Flop (didn't bet)
Seat 4: matiko09 folded before Flop (didn't bet)
Seat 6: Alex Frider folded before Flop (didn't bet)
Seat 7: au318 folded before Flop (didn't bet)
Seat 9: Prophet1906 (button) collected ($1.25)





PokerStars Hand #154797729158:  Hold'em No Limit ($0.50/$1.00 USD) - 2016/06/16 9:29:02 CET [2016/06/16 3:29:02 ET]
Table 'Astyanax' 9-max Seat #3 is the button
Seat 1: pokerich462 ($145.54 in chips) 
Seat 2: matiko09 ($103.59 in chips) 
Seat 3: hammerwife ($117.34 in chips) 
Seat 4: teerajaja ($100 in chips) 
Seat 5: butcheN18 ($103.90 in chips) 
Seat 6: Dantist1122 ($135.54 in chips) 
Seat 7: flk.Dasas ($100 in chips) 
Seat 9: CoolFireX ($105.84 in chips) 
teerajaja: posts small blind $0.50
butcheN18: posts big blind $1
pokerich462: posts the ante $0.20
matiko09: posts the ante $0.20
hammerwife: posts the ante $0.20
teerajaja: posts the ante $0.20
butcheN18: posts the ante $0.20
Dantist1122: posts the ante $0.20
flk.Dasas: posts the ante $0.20
CoolFireX: posts the ante $0.20
*** HOLE CARDS ***
Dealt to matiko09 [Ac 3h]
Dantist1122: folds 
flk.Dasas: raises $3 to $4
CoolFireX: folds 
pokerich462: folds 
matiko09: folds 
Edgey444 leaves the table
hammerwife: folds 
teerajaja: folds 
mycka86 joins the table at seat #8 
butcheN18: folds 
Uncalled bet ($3) returned to flk.Dasas
flk.Dasas collected $4.10 from pot
flk.Dasas: doesn't show hand 
*** SUMMARY ***
Total pot $4.10 | Rake $0 
Seat 1: pokerich462 folded before Flop (didn't bet)
Seat 2: matiko09 folded before Flop (didn't bet)
Seat 3: hammerwife (button) folded before Flop (didn't bet)
Seat 4: teerajaja (small blind) folded before Flop
Seat 5: butcheN18 (big blind) folded before Flop
Seat 6: Dantist1122 folded before Flop (didn't bet)
Seat 7: flk.Dasas collected ($4.10)
Seat 9: CoolFireX folded before Flop (didn't bet)





PokerStars Hand #154797732149:  Hold'em No Limit ($0.50/$1.00 USD) - 2016/06/16 9:29:13 CET [2016/06/16 3:29:13 ET]
Table 'Stroobantia II' 9-max Seat #8 is the button
Seat 1: mycka86 ($103.18 in chips) 
Seat 2: Lipton20088 ($162.44 in chips) 
Seat 3: matiko09 ($100 in chips) 
Seat 4: CoolFireX ($100 in chips) 
Seat 5: butcheN18 ($101.50 in chips) 
Seat 8: ruslik_by ($100 in chips) 
Seat 9: jakub249 ($77 in chips) 
jakub249: posts small blind $0.50
mycka86: posts big blind $1
andrewtomaz: sits out 
*** HOLE CARDS ***
Dealt to matiko09 [2c 4h]
Lipton20088: folds 
matiko09: folds 
CoolFireX: raises $2 to $3
butcheN18: folds 
ruslik_by: folds 
jakub249: calls $2.50
mycka86: calls $2
*** FLOP *** [2d 9c Ks]
jakub249: checks 
mycka86: checks 
CoolFireX: bets $5
jakub249: folds 
mycka86: folds 
Uncalled bet ($5) returned to CoolFireX
CoolFireX collected $8.55 from pot
*** SUMMARY ***
Total pot $9 | Rake $0.45 
Board [2d 9c Ks]
Seat 1: mycka86 (big blind) folded on the Flop
Seat 2: Lipton20088 folded before Flop (didn't bet)
Seat 3: matiko09 folded before Flop (didn't bet)
Seat 4: CoolFireX collected ($8.55)
Seat 5: butcheN18 folded before Flop (didn't bet)
Seat 8: ruslik_by (button) folded before Flop (didn't bet)
Seat 9: jakub249 (small blind) folded on the Flop





PokerStars Hand #154797734982:  Hold'em No Limit ($0.50/$1.00 USD) - 2016/06/16 9:29:23 CET [2016/06/16 3:29:23 ET]
Table 'Solstice' 9-max Seat #7 is the button
Seat 2: ruslik_by ($101.70 in chips) 
Seat 3: arctur17 ($38.24 in chips) 
Seat 4: jezzaber ($96 in chips) 
Seat 5: mycka86 ($115.48 in chips) 
Seat 6: CoolFireX ($110.18 in chips) 
Seat 7: tatimora ($98.50 in chips) 
Seat 8: matiko09 ($100 in chips) 
Seat 9: butcheN18 ($106.69 in chips) 
matiko09: posts small blind $0.50
butcheN18: posts big blind $1
maxxmeister: sits out 
*** HOLE CARDS ***
Dealt to matiko09 [As Kc]
ruslik_by: folds 
arctur17: folds 
jezzaber: folds 
mycka86: folds 
CoolFireX: folds 
tatimora: raises $2 to $3
matiko09: raises $7 to $10
butcheN18: folds 
tatimora: folds [Kd]
Uncalled bet ($7) returned to matiko09
matiko09 collected $7 from pot
matiko09: doesn't show hand 
*** SUMMARY ***
Total pot $7 | Rake $0 
Seat 2: ruslik_by folded before Flop (didn't bet)
Seat 3: arctur17 folded before Flop (didn't bet)
Seat 4: jezzaber folded before Flop (didn't bet)
Seat 5: mycka86 folded before Flop (didn't bet)
Seat 6: CoolFireX folded before Flop (didn't bet)
Seat 7: tatimora (button) folded before Flop
Seat 8: matiko09 (small blind) collected ($7)
Seat 9: butcheN18 (big blind) folded before Flop





PokerStars Hand #154797735961:  Hold'em No Limit ($0.50/$1.00 USD) - 2016/06/16 9:29:27 CET [2016/06/16 3:29:27 ET]
Table 'Pasiphae II' 9-max Seat #6 is the button
Seat 2: flk.Dasas ($100 in chips) 
Seat 3: matiko09 ($102.52 in chips) 
Seat 4: ruslik_by ($202.94 in chips) 
Seat 5: CoolFireX ($152.11 in chips) 
Seat 6: m@xXx89 ($96.70 in chips) 
Seat 7: butcheN18 ($159.83 in chips) 
Seat 8: Lipton20088 ($66.84 in chips) 
Seat 9: teerajaja ($101.50 in chips) 
butcheN18: posts small blind $0.50
Lipton20088: posts big blind $1
mycka86: sits out 
*** HOLE CARDS ***
Dealt to matiko09 [Kd Qh]
teerajaja: folds 
flk.Dasas: folds 
matiko09: raises $2 to $3
ruslik_by: folds 
CoolFireX: folds 
m@xXx89: folds 
butcheN18: folds 
Lipton20088: raises $6 to $9
matiko09: folds 
Uncalled bet ($6) returned to Lipton20088
Lipton20088 collected $6.50 from pot
Lipton20088: doesn't show hand 
*** SUMMARY ***
Total pot $6.50 | Rake $0 
Seat 2: flk.Dasas folded before Flop (didn't bet)
Seat 3: matiko09 folded before Flop
Seat 4: ruslik_by folded before Flop (didn't bet)
Seat 5: CoolFireX folded before Flop (didn't bet)
Seat 6: m@xXx89 (button) folded before Flop (didn't bet)
Seat 7: butcheN18 (small blind) folded before Flop
Seat 8: Lipton20088 (big blind) collected ($6.50)
Seat 9: teerajaja folded before Flop (didn't bet)





PokerStars Hand #154797736505:  Hold'em No Limit ($0.25/$0.50 USD) - 2016/06/16 9:29:29 CET [2016/06/16 3:29:29 ET]
Table 'Gaea' 9-max Seat #1 is the button
Seat 1: letto77 ($49.75 in chips) 
Seat 2: magzi777 ($50 in chips) 
Seat 3: Crazyfish87 ($40 in chips) 
Seat 4: matiko09 ($71.52 in chips) 
Seat 6: Alex Frider ($60.87 in chips) 
Seat 7: au318 ($52.26 in chips) 
Seat 9: Prophet1906 ($61.29 in chips) 
magzi777: posts small blind $0.25
Crazyfish87: posts big blind $0.50
Kapa09: sits out 
Red_Warning: sits out 
*** HOLE CARDS ***
Dealt to matiko09 [Th 7s]
matiko09: folds 
Alex Frider: folds 
au318: raises $0.50 to $1
Prophet1906: calls $1
letto77: folds 
magzi777: folds 
Crazyfish87: folds 
*** FLOP *** [9s 8d 2s]
au318: checks 
Prophet1906: bets $1.50
au318: folds 
Uncalled bet ($1.50) returned to Prophet1906
Prophet1906 collected $2.61 from pot
*** SUMMARY ***
Total pot $2.75 | Rake $0.14 
Board [9s 8d 2s]
Seat 1: letto77 (button) folded before Flop (didn't bet)
Seat 2: magzi777 (small blind) folded before Flop
Seat 3: Crazyfish87 (big blind) folded before Flop
Seat 4: matiko09 folded before Flop (didn't bet)
Seat 6: Alex Frider folded before Flop (didn't bet)
Seat 7: au318 folded on the Flop
Seat 9: Prophet1906 collected ($2.61)





PokerStars Hand #154797736581:  Hold'em No Limit ($0.50/$1.00 USD) - 2016/06/16 9:29:29 CET [2016/06/16 3:29:29 ET]
Table 'Hercynia II' 9-max Seat #1 is the button
Seat 1: flk.Dasas ($100 in chips) 
Seat 2: hammerwife ($210.06 in chips) 
Seat 3: butcheN18 ($100 in chips) 
Seat 4: ruslik_by ($100 in chips) 
Seat 5: matiko09 ($100 in chips) 
Seat 7: ozone2003 ($104 in chips) 
Seat 8: mycka86 ($183.25 in chips) 
Seat 9: Juniorquiapo ($79.02 in chips) 
hammerwife: posts small blind $0.50
butcheN18: posts big blind $1
CoolFireX: sits out 
*** HOLE CARDS ***
Dealt to matiko09 [Qh Tc]
ruslik_by said, "u tebia v pushe TT+ ya dumau"
ruslik_by said, "potomu i na AQ vistavilsia"
ruslik_by: folds 
matiko09: folds 
ozone2003: folds 
mycka86: folds 
Juniorquiapo: raises $2 to $3
flk.Dasas: folds 
hammerwife: folds 
butcheN18: folds 
Uncalled bet ($2) returned to Juniorquiapo
Juniorquiapo collected $2.50 from pot
*** SUMMARY ***
Total pot $2.50 | Rake $0 
Seat 1: flk.Dasas (button) folded before Flop (didn't bet)
Seat 2: hammerwife (small blind) folded before Flop
Seat 3: butcheN18 (big blind) folded before Flop
Seat 4: ruslik_by folded before Flop (didn't bet)
Seat 5: matiko09 folded before Flop (didn't bet)
Seat 7: ozone2003 folded before Flop (didn't bet)
Seat 8: mycka86 folded before Flop (didn't bet)
Seat 9: Juniorquiapo collected ($2.50)





PokerStars Hand #154797738579:  Hold'em No Limit ($0.50/$1.00 USD) - 2016/06/16 9:29:37 CET [2016/06/16 3:29:37 ET]
Table 'Alekto' 9-max Seat #9 is the button
Seat 2: brotas232323 ($97 in chips) 
Seat 3: butcheN18 ($116.58 in chips) 
Seat 4: hammerwife ($115.27 in chips) 
Seat 5: matiko09 ($117.49 in chips) 
Seat 6: ilaviiitech ($124.81 in chips) 
Seat 7: flk.Dasas ($102.82 in chips) 
Seat 9: ruslik_by ($101.50 in chips) 
mycka86 will be allowed to play after the button
brotas232323: posts small blind $0.50
butcheN18: posts big blind $1
ozone2003: sits out 
*** HOLE CARDS ***
Dealt to matiko09 [3h 9h]
hammerwife: folds 
matiko09: folds 
ilaviiitech: raises $2 to $3
flk.Dasas: folds 
ruslik_by: folds 
brotas232323: folds 
butcheN18: folds 
Uncalled bet ($2) returned to ilaviiitech
ilaviiitech collected $2.50 from pot
ilaviiitech: doesn't show hand 
*** SUMMARY ***
Total pot $2.50 | Rake $0 
Seat 2: brotas232323 (small blind) folded before Flop
Seat 3: butcheN18 (big blind) folded before Flop
Seat 4: hammerwife folded before Flop (didn't bet)
Seat 5: matiko09 folded before Flop (didn't bet)
Seat 6: ilaviiitech collected ($2.50)
Seat 7: flk.Dasas folded before Flop (didn't bet)
Seat 9: ruslik_by (button) folded before Flop (didn't bet)





PokerStars Hand #154797740706:  Hold'em No Limit ($0.25/$0.50 USD) - 2016/06/16 9:29:44 CET [2016/06/16 3:29:44 ET]
Table 'Mekbuda II' 9-max Seat #3 is the button
Seat 1: matiko09 ($50 in chips) 
Seat 2: tibi_c87 ($50 in chips) 
Seat 3: Kapa09 ($52.99 in chips) 
Seat 5: teerajaja ($50 in chips) 
Seat 6: Dantist1122 ($50.75 in chips) 
Seat 7: Kukuryzka ($89.18 in chips) 
Seat 8: WKBelinda ($46.47 in chips) 
Seat 9: Alex Frider ($57.76 in chips) 
Vvalrond will be allowed to play after the button
teerajaja: posts small blind $0.25
Dantist1122: posts big blind $0.50
*** HOLE CARDS ***
Dealt to matiko09 [Jc 8h]
Kukuryzka: folds 
WKBelinda: raises $1.50 to $2
Alex Frider: folds 
matiko09: folds 
tibi_c87: folds 
Kapa09: folds 
teerajaja: folds 
Dantist1122: raises $4 to $6
WKBelinda: raises $14.75 to $20.75
Dantist1122: raises $30 to $50.75 and is all-in
WKBelinda: calls $25.72 and is all-in
Uncalled bet ($4.28) returned to Dantist1122
*** FLOP *** [4c Tc 5c]
*** TURN *** [4c Tc 5c] [8d]
*** RIVER *** [4c Tc 5c 8d] [7s]
*** SHOW DOWN ***
Dantist1122: shows [Ks Kc] (a pair of Kings)
WKBelinda: shows [As Ac] (a pair of Aces)
WKBelinda collected $91.19 from pot
*** SUMMARY ***
Total pot $93.19 | Rake $2 
Board [4c Tc 5c 8d 7s]
Seat 1: matiko09 folded before Flop (didn't bet)
Seat 2: tibi_c87 folded before Flop (didn't bet)
Seat 3: Kapa09 (button) folded before Flop (didn't bet)
Seat 5: teerajaja (small blind) folded before Flop
Seat 6: Dantist1122 (big blind) showed [Ks Kc] and lost with a pair of Kings
Seat 7: Kukuryzka folded before Flop (didn't bet)
Seat 8: WKBelinda showed [As Ac] and won ($91.19) with a pair of Aces
Seat 9: Alex Frider folded before Flop (didn't bet)





PokerStars Hand #154797740620:  Hold'em No Limit ($0.50/$1.00 USD) - 2016/06/16 9:29:44 CET [2016/06/16 3:29:44 ET]
Table 'Astyanax' 9-max Seat #4 is the button
Seat 1: pokerich462 ($145.34 in chips) 
Seat 2: matiko09 ($103.39 in chips) 
Seat 3: hammerwife ($117.14 in chips) 
Seat 4: teerajaja ($100 in chips) 
Seat 5: butcheN18 ($102.70 in chips) 
Seat 6: Dantist1122 ($135.34 in chips) 
Seat 7: flk.Dasas ($102.90 in chips) 
Seat 9: CoolFireX ($105.64 in chips) 
butcheN18: posts small blind $0.50
Dantist1122: posts big blind $1
mycka86: sits out 
pokerich462: posts the ante $0.20
matiko09: posts the ante $0.20
hammerwife: posts the ante $0.20
teerajaja: posts the ante $0.20
butcheN18: posts the ante $0.20
Dantist1122: posts the ante $0.20
flk.Dasas: posts the ante $0.20
CoolFireX: posts the ante $0.20
*** HOLE CARDS ***
Dealt to matiko09 [As Tc]
flk.Dasas: folds 
CoolFireX: folds 
pokerich462: raises $1 to $2
matiko09: raises $5 to $7
hammerwife: folds 
teerajaja: folds 
butcheN18: folds 
Dantist1122: folds 
pokerich462: calls $5
*** FLOP *** [2c 2s 7s]
pokerich462: checks 
matiko09: checks 
*** TURN *** [2c 2s 7s] [Kd]
pokerich462: bets $8.14
matiko09: folds 
Uncalled bet ($8.14) returned to pokerich462
pokerich462 collected $16.24 from pot
pokerich462: doesn't show hand 
*** SUMMARY ***
Total pot $17.10 | Rake $0.86 
Board [2c 2s 7s Kd]
Seat 1: pokerich462 collected ($16.24)
Seat 2: matiko09 folded on the Turn
Seat 3: hammerwife folded before Flop (didn't bet)
Seat 4: teerajaja (button) folded before Flop (didn't bet)
Seat 5: butcheN18 (small blind) folded before Flop
Seat 6: Dantist1122 (big blind) folded before Flop
Seat 7: flk.Dasas folded before Flop (didn't bet)
Seat 9: CoolFireX folded before Flop (didn't bet)





PokerStars Hand #154797745541:  Hold'em No Limit ($0.25/$0.50 USD) - 2016/06/16 9:30:02 CET [2016/06/16 3:30:02 ET]
Table 'Gaea' 9-max Seat #2 is the button
Seat 1: letto77 ($49.75 in chips) 
Seat 2: magzi777 ($50 in chips) 
Seat 3: Crazyfish87 ($40 in chips) 
Seat 4: matiko09 ($71.52 in chips) 
Seat 6: Alex Frider ($60.87 in chips) 
Seat 7: au318 ($51.26 in chips) 
Seat 9: Prophet1906 ($62.90 in chips) 
Crazyfish87: posts small blind $0.25
matiko09: posts big blind $0.50
Kapa09: sits out 
Red_Warning: sits out 
*** HOLE CARDS ***
Dealt to matiko09 [6h Qc]
Alex Frider: raises $0.75 to $1.25
au318: folds 
Prophet1906: folds 
letto77: folds 
magzi777: folds 
Crazyfish87: folds 
matiko09: folds 
Uncalled bet ($0.75) returned to Alex Frider
Alex Frider collected $1.25 from pot
Alex Frider: doesn't show hand 
*** SUMMARY ***
Total pot $1.25 | Rake $0 
Seat 1: letto77 folded before Flop (didn't bet)
Seat 2: magzi777 (button) folded before Flop (didn't bet)
Seat 3: Crazyfish87 (small blind) folded before Flop
Seat 4: matiko09 (big blind) folded before Flop
Seat 6: Alex Frider collected ($1.25)
Seat 7: au318 folded before Flop (didn't bet)
Seat 9: Prophet1906 folded before Flop (didn't bet)





PokerStars Hand #154797746443:  Hold'em No Limit ($0.50/$1.00 USD) - 2016/06/16 9:30:06 CET [2016/06/16 3:30:06 ET]
Table 'Alekto' 9-max Seat #2 is the button
Seat 2: brotas232323 ($100 in chips) 
Seat 3: butcheN18 ($115.58 in chips) 
Seat 4: hammerwife ($115.27 in chips) 
Seat 5: matiko09 ($117.49 in chips) 
Seat 6: ilaviiitech ($126.31 in chips) 
Seat 7: flk.Dasas ($102.82 in chips) 
Seat 9: ruslik_by ($101.50 in chips) 
butcheN18: posts small blind $0.50
hammerwife: posts big blind $1
ozone2003: sits out 
mycka86: sits out 
*** HOLE CARDS ***
Dealt to matiko09 [8h 8s]
matiko09: raises $2 to $3
ilaviiitech: folds 
flk.Dasas: folds 
ruslik_by: folds 
brotas232323: folds 
butcheN18: folds 
hammerwife: folds 
Uncalled bet ($2) returned to matiko09
matiko09 collected $2.50 from pot
matiko09: doesn't show hand 
*** SUMMARY ***
Total pot $2.50 | Rake $0 
Seat 2: brotas232323 (button) folded before Flop (didn't bet)
Seat 3: butcheN18 (small blind) folded before Flop
Seat 4: hammerwife (big blind) folded before Flop
Seat 5: matiko09 collected ($2.50)
Seat 6: ilaviiitech folded before Flop (didn't bet)
Seat 7: flk.Dasas folded before Flop (didn't bet)
Seat 9: ruslik_by folded before Flop (didn't bet)





PokerStars Hand #154797750435:  Hold'em No Limit ($0.50/$1.00 USD) - 2016/06/16 9:30:20 CET [2016/06/16 3:30:20 ET]
Table 'Pasiphae II' 9-max Seat #7 is the button
Seat 1: mycka86 ($100 in chips) 
Seat 2: flk.Dasas ($100 in chips) 
Seat 3: matiko09 ($100 in chips) 
Seat 4: ruslik_by ($202.94 in chips) 
Seat 5: CoolFireX ($152.11 in chips) 
Seat 6: m@xXx89 ($96.70 in chips) 
Seat 7: butcheN18 ($159.33 in chips) 
Seat 8: Lipton20088 ($70.34 in chips) 
Lipton20088: posts small blind $0.50
teerajaja: is sitting out 
teerajaja leaves the table
mycka86: posts big blind $1
*** HOLE CARDS ***
Dealt to matiko09 [9h 8h]
flk.Dasas: folds 
ilaviiitech joins the table at seat #9 
matiko09: raises $2 to $3
ruslik_by: raises $6 to $9
CoolFireX: calls $9
m@xXx89: folds 
butcheN18: folds 
Lipton20088: folds 
mycka86: folds 
matiko09: calls $6
*** FLOP *** [5c Qh Qc]
matiko09: checks 
ruslik_by: bets $9.20
CoolFireX: calls $9.20
matiko09: folds 
*** TURN *** [5c Qh Qc] [2d]
ruslik_by: bets $22.28
CoolFireX: folds 
Uncalled bet ($22.28) returned to ruslik_by
ruslik_by collected $44.56 from pot
ruslik_by: doesn't show hand 
*** SUMMARY ***
Total pot $46.90 | Rake $2.34 
Board [5c Qh Qc 2d]
Seat 1: mycka86 (big blind) folded before Flop
Seat 2: flk.Dasas folded before Flop (didn't bet)
Seat 3: matiko09 folded on the Flop
Seat 4: ruslik_by collected ($44.56)
Seat 5: CoolFireX folded on the Turn
Seat 6: m@xXx89 folded before Flop (didn't bet)
Seat 7: butcheN18 (button) folded before Flop (didn't bet)
Seat 8: Lipton20088 (small blind) folded before Flop





PokerStars Hand #154797751101:  Hold'em No Limit ($0.50/$1.00 USD) - 2016/06/16 9:30:23 CET [2016/06/16 3:30:23 ET]
Table 'Hercynia II' 9-max Seat #2 is the button
Seat 1: flk.Dasas ($100 in chips) 
Seat 2: hammerwife ($209.56 in chips) 
Seat 3: butcheN18 ($100 in chips) 
Seat 4: ruslik_by ($100 in chips) 
Seat 5: matiko09 ($100 in chips) 
Seat 7: ozone2003 ($104 in chips) 
Seat 8: mycka86 ($183.25 in chips) 
Seat 9: Juniorquiapo ($80.52 in chips) 
butcheN18: posts small blind $0.50
ruslik_by: posts big blind $1
CoolFireX: sits out 
*** HOLE CARDS ***
Dealt to matiko09 [Kd 7s]
matiko09: folds 
ozone2003: folds 
mycka86: folds 
Juniorquiapo: folds 
flk.Dasas: folds 
hammerwife: folds 
butcheN18: folds 
Uncalled bet ($0.50) returned to ruslik_by
ruslik_by collected $1 from pot
ruslik_by: doesn't show hand 
*** SUMMARY ***
Total pot $1 | Rake $0 
Seat 1: flk.Dasas folded before Flop (didn't bet)
Seat 2: hammerwife (button) folded before Flop (didn't bet)
Seat 3: butcheN18 (small blind) folded before Flop
Seat 4: ruslik_by (big blind) collected ($1)
Seat 5: matiko09 folded before Flop (didn't bet)
Seat 7: ozone2003 folded before Flop (didn't bet)
Seat 8: mycka86 folded before Flop (didn't bet)
Seat 9: Juniorquiapo folded before Flop (didn't bet)





PokerStars Hand #154797753469:  Hold'em No Limit ($0.50/$1.00 USD) - 2016/06/16 9:30:31 CET [2016/06/16 3:30:31 ET]
Table 'Alekto' 9-max Seat #3 is the button
Seat 2: brotas232323 ($100 in chips) 
Seat 3: butcheN18 ($115.08 in chips) 
Seat 4: hammerwife ($114.27 in chips) 
Seat 5: matiko09 ($118.99 in chips) 
Seat 6: ilaviiitech ($126.31 in chips) 
Seat 7: flk.Dasas ($102.82 in chips) 
Seat 9: ruslik_by ($101.50 in chips) 
hammerwife: posts small blind $0.50
matiko09: posts big blind $1
ozone2003: sits out 
mycka86: sits out 
*** HOLE CARDS ***
Dealt to matiko09 [8c 5h]
ilaviiitech: folds 
flk.Dasas: folds 
ruslik_by: folds 
brotas232323: folds 
butcheN18: folds 
hammerwife: raises $1.60 to $2.60
matiko09: folds 
Uncalled bet ($1.60) returned to hammerwife
hammerwife collected $2 from pot
hammerwife: doesn't show hand 
*** SUMMARY ***
Total pot $2 | Rake $0 
Seat 2: brotas232323 folded before Flop (didn't bet)
Seat 3: butcheN18 (button) folded before Flop (didn't bet)
Seat 4: hammerwife (small blind) collected ($2)
Seat 5: matiko09 (big blind) folded before Flop
Seat 6: ilaviiitech folded before Flop (didn't bet)
Seat 7: flk.Dasas folded before Flop (didn't bet)
Seat 9: ruslik_by folded before Flop (didn't bet)





PokerStars Hand #154797753380:  Hold'em No Limit ($0.50/$1.00 USD) - 2016/06/16 9:30:31 CET [2016/06/16 3:30:31 ET]
Table 'Stroobantia II' 9-max Seat #9 is the button
Seat 1: mycka86 ($100.18 in chips) 
Seat 3: matiko09 ($100 in chips) 
Seat 4: CoolFireX ($105.55 in chips) 
Seat 5: butcheN18 ($101.50 in chips) 
Seat 8: ruslik_by ($100 in chips) 
Seat 9: jakub249 ($74 in chips) 
mycka86: posts small blind $0.50
Lipton20088: is sitting out 
matiko09: posts big blind $1
andrewtomaz: sits out 
*** HOLE CARDS ***
Dealt to matiko09 [Ah 3h]
CoolFireX: folds 
butcheN18: folds 
ruslik_by: folds 
jakub249: folds 
mycka86: raises $1.75 to $2.75
matiko09: calls $1.75
*** FLOP *** [4s Ks 4c]
mycka86: checks 
matiko09: checks 
*** TURN *** [4s Ks 4c] [As]
mycka86: checks 
matiko09: bets $2.71
mycka86: folds 
Uncalled bet ($2.71) returned to matiko09
matiko09 collected $5.22 from pot
matiko09: doesn't show hand 
*** SUMMARY ***
Total pot $5.50 | Rake $0.28 
Board [4s Ks 4c As]
Seat 1: mycka86 (small blind) folded on the Turn
Seat 3: matiko09 (big blind) collected ($5.22)
Seat 4: CoolFireX folded before Flop (didn't bet)
Seat 5: butcheN18 folded before Flop (didn't bet)
Seat 8: ruslik_by folded before Flop (didn't bet)
Seat 9: jakub249 (button) folded before Flop (didn't bet)





PokerStars Hand #154797753875:  Hold'em No Limit ($0.50/$1.00 USD) - 2016/06/16 9:30:33 CET [2016/06/16 3:30:33 ET]
Table 'Solstice' 9-max Seat #8 is the button
Seat 1: maxxmeister ($135.37 in chips) 
Seat 2: ruslik_by ($101.70 in chips) 
Seat 3: arctur17 ($38.24 in chips) 
Seat 4: jezzaber ($96 in chips) 
Seat 5: mycka86 ($115.48 in chips) 
Seat 6: CoolFireX ($110.18 in chips) 
Seat 7: tatimora ($95.50 in chips) 
Seat 8: matiko09 ($104 in chips) 
Seat 9: butcheN18 ($105.69 in chips) 
butcheN18: posts small blind $0.50
maxxmeister: posts big blind $1
*** HOLE CARDS ***
Dealt to matiko09 [8s Qd]
ruslik_by: folds 
arctur17: folds 
jezzaber: raises $2 to $3
mycka86: folds 
CoolFireX: folds 
tatimora: folds 
matiko09: folds 
butcheN18: folds 
maxxmeister: folds 
Uncalled bet ($2) returned to jezzaber
jezzaber collected $2.50 from pot
jezzaber: doesn't show hand 
*** SUMMARY ***
Total pot $2.50 | Rake $0 
Seat 1: maxxmeister (big blind) folded before Flop
Seat 2: ruslik_by folded before Flop (didn't bet)
Seat 3: arctur17 folded before Flop (didn't bet)
Seat 4: jezzaber collected ($2.50)
Seat 5: mycka86 folded before Flop (didn't bet)
Seat 6: CoolFireX folded before Flop (didn't bet)
Seat 7: tatimora folded before Flop (didn't bet)
Seat 8: matiko09 (button) folded before Flop (didn't bet)
Seat 9: butcheN18 (small blind) folded before Flop





PokerStars Hand #154797758114:  Hold'em No Limit ($0.25/$0.50 USD) - 2016/06/16 9:30:49 CET [2016/06/16 3:30:49 ET]
Table 'Gaea' 9-max Seat #3 is the button
Seat 1: letto77 ($49.75 in chips) 
Seat 2: magzi777 ($50 in chips) 
Seat 3: Crazyfish87 ($40 in chips) 
Seat 4: matiko09 ($71.02 in chips) 
Seat 5: Kapa09 ($50 in chips) 
Seat 6: Alex Frider ($61.62 in chips) 
Seat 7: au318 ($51.26 in chips) 
Seat 9: Prophet1906 ($62.90 in chips) 
matiko09: posts small blind $0.25
Kapa09: posts big blind $0.50
Red_Warning: sits out 
*** HOLE CARDS ***
Dealt to matiko09 [2s Jc]
Alex Frider: folds 
au318: folds 
Prophet1906: folds 
letto77 has timed out
letto77: folds 
magzi777: folds 
Crazyfish87: raises $0.60 to $1.10
matiko09: folds 
Kapa09: calls $0.60
*** FLOP *** [Js 6s Tc]
Kapa09: checks 
letto77 leaves the table
jasonhan416 joins the table at seat #1 
Crazyfish87: checks 
*** TURN *** [Js 6s Tc] [Kc]
Kapa09: bets $1.63
Crazyfish87: calls $1.63
*** RIVER *** [Js 6s Tc Kc] [Jh]
Kapa09: checks 
Crazyfish87: bets $2.50
Kapa09: folds 
Uncalled bet ($2.50) returned to Crazyfish87
Crazyfish87 collected $5.42 from pot
Crazyfish87: doesn't show hand 
*** SUMMARY ***
Total pot $5.71 | Rake $0.29 
Board [Js 6s Tc Kc Jh]
Seat 1: letto77 folded before Flop (didn't bet)
Seat 2: magzi777 folded before Flop (didn't bet)
Seat 3: Crazyfish87 (button) collected ($5.42)
Seat 4: matiko09 (small blind) folded before Flop
Seat 5: Kapa09 (big blind) folded on the River
Seat 6: Alex Frider folded before Flop (didn't bet)
Seat 7: au318 folded before Flop (didn't bet)
Seat 9: Prophet1906 folded before Flop (didn't bet)





PokerStars Hand #154797761444:  Hold'em No Limit ($0.50/$1.00 USD) - 2016/06/16 9:31:01 CET [2016/06/16 3:31:01 ET]
Table 'Astyanax' 9-max Seat #5 is the button
Seat 1: pokerich462 ($154.38 in chips) 
Seat 2: matiko09 ($100 in chips) 
Seat 3: hammerwife ($116.94 in chips) 
Seat 4: teerajaja ($100 in chips) 
Seat 5: butcheN18 ($102 in chips) 
Seat 6: Dantist1122 ($134.14 in chips) 
Seat 7: flk.Dasas ($102.70 in chips) 
Seat 9: CoolFireX ($105.44 in chips) 
Dantist1122: posts small blind $0.50
flk.Dasas: posts big blind $1
mycka86: sits out 
pokerich462: posts the ante $0.20
matiko09: posts the ante $0.20
hammerwife: posts the ante $0.20
teerajaja: posts the ante $0.20
butcheN18: posts the ante $0.20
Dantist1122: posts the ante $0.20
flk.Dasas: posts the ante $0.20
CoolFireX: posts the ante $0.20
*** HOLE CARDS ***
Dealt to matiko09 [3s 5h]
CoolFireX: folds 
pokerich462: raises $1 to $2
matiko09: folds 
hammerwife: folds 
teerajaja: calls $2
butcheN18: folds 
Dantist1122: folds 
flk.Dasas: calls $1
*** FLOP *** [5d Jd 8s]
flk.Dasas: checks 
pokerich462: checks 
teerajaja: bets $5
flk.Dasas: folds 
pokerich462: calls $5
*** TURN *** [5d Jd 8s] [6h]
pokerich462: bets $10
teerajaja: calls $10
*** RIVER *** [5d Jd 8s 6h] [4d]
pokerich462: checks 
teerajaja: checks 
*** SHOW DOWN ***
pokerich462: shows [5c 5s] (three of a kind, Fives)
teerajaja: mucks hand 
pokerich462 collected $36.20 from pot
*** SUMMARY ***
Total pot $38.10 | Rake $1.90 
Board [5d Jd 8s 6h 4d]
Seat 1: pokerich462 showed [5c 5s] and won ($36.20) with three of a kind, Fives
Seat 2: matiko09 folded before Flop (didn't bet)
Seat 3: hammerwife folded before Flop (didn't bet)
Seat 4: teerajaja mucked [Qc Jh]
Seat 5: butcheN18 (button) folded before Flop (didn't bet)
Seat 6: Dantist1122 (small blind) folded before Flop
Seat 7: flk.Dasas (big blind) folded on the Flop
Seat 9: CoolFireX folded before Flop (didn't bet)





PokerStars Hand #154797761966:  Hold'em No Limit ($0.50/$1.00 USD) - 2016/06/16 9:31:02 CET [2016/06/16 3:31:02 ET]
Table 'Hercynia II' 9-max Seat #3 is the button
Seat 1: flk.Dasas ($100 in chips) 
Seat 2: hammerwife ($209.56 in chips) 
Seat 3: butcheN18 ($100 in chips) 
Seat 4: ruslik_by ($100.50 in chips) 
Seat 5: matiko09 ($100 in chips) 
Seat 7: ozone2003 ($104 in chips) 
Seat 8: mycka86 ($183.25 in chips) 
Seat 9: Juniorquiapo ($80.52 in chips) 
ruslik_by: posts small blind $0.50
matiko09: posts big blind $1
CoolFireX: sits out 
*** HOLE CARDS ***
Dealt to matiko09 [7d 7h]
ozone2003: folds 
mycka86: folds 
Juniorquiapo: calls $1
flk.Dasas: folds 
hammerwife: folds 
butcheN18: raises $3.18 to $4.18
ruslik_by: calls $3.68
matiko09: calls $3.18
Juniorquiapo: folds 
*** FLOP *** [Js 5s Kc]
ruslik_by: checks 
matiko09: checks 
butcheN18: bets $9
ruslik_by: calls $9
matiko09: folds 
*** TURN *** [Js 5s Kc] [5c]
ruslik_by: checks 
butcheN18: bets $19
ruslik_by: folds 
Uncalled bet ($19) returned to butcheN18
butcheN18 collected $29.96 from pot
butcheN18: doesn't show hand 
*** SUMMARY ***
Total pot $31.54 | Rake $1.58 
Board [Js 5s Kc 5c]
Seat 1: flk.Dasas folded before Flop (didn't bet)
Seat 2: hammerwife folded before Flop (didn't bet)
Seat 3: butcheN18 (button) collected ($29.96)
Seat 4: ruslik_by (small blind) folded on the Turn
Seat 5: matiko09 (big blind) folded on the Flop
Seat 7: ozone2003 folded before Flop (didn't bet)
Seat 8: mycka86 folded before Flop (didn't bet)
Seat 9: Juniorquiapo folded before Flop





PokerStars Hand #154797762455:  Hold'em No Limit ($0.25/$0.50 USD) - 2016/06/16 9:31:04 CET [2016/06/16 3:31:04 ET]
Table 'Mekbuda II' 9-max Seat #5 is the button
Seat 1: matiko09 ($50 in chips) 
Seat 2: tibi_c87 ($50 in chips) 
Seat 3: Kapa09 ($52.99 in chips) 
Seat 4: Vvalrond ($26.74 in chips) 
Seat 5: teerajaja ($50 in chips) 
Seat 6: Dantist1122 ($50 in chips) 
Seat 8: WKBelinda ($91.19 in chips) 
Seat 9: Alex Frider ($57.76 in chips) 
Dantist1122: posts small blind $0.25
Kukuryzka: is sitting out 
Kukuryzka leaves the table
WKBelinda: posts big blind $0.50
Vvalrond: posts small & big blinds $0.75
*** HOLE CARDS ***
Dealt to matiko09 [6h 3c]
Alex Frider: folds 
Lipton20088 joins the table at seat #7 
matiko09: folds 
tibi_c87: folds 
Kapa09: folds 
Vvalrond: checks 
teerajaja: raises $1 to $1.50
Dantist1122: raises $3.50 to $5
WKBelinda: folds 
Vvalrond: folds 
teerajaja: folds 
Uncalled bet ($3.50) returned to Dantist1122
Dantist1122 collected $4.25 from pot
Dantist1122: doesn't show hand 
*** SUMMARY ***
Total pot $4.25 | Rake $0 
Seat 1: matiko09 folded before Flop (didn't bet)
Seat 2: tibi_c87 folded before Flop (didn't bet)
Seat 3: Kapa09 folded before Flop (didn't bet)
Seat 4: Vvalrond folded before Flop
Seat 5: teerajaja (button) folded before Flop
Seat 6: Dantist1122 (small blind) collected ($4.25)
Seat 8: WKBelinda (big blind) folded before Flop
Seat 9: Alex Frider folded before Flop (didn't bet)





PokerStars Hand #154797770667:  Hold'em No Limit ($0.50/$1.00 USD) - 2016/06/16 9:31:11 CET [2016/06/16 3:31:11 ET]
Table 'Solstice' 9-max Seat #9 is the button
Seat 1: maxxmeister ($134.37 in chips) 
Seat 2: ruslik_by ($101.70 in chips) 
Seat 3: arctur17 ($38.24 in chips) 
Seat 4: jezzaber ($97.50 in chips) 
Seat 5: mycka86 ($115.48 in chips) 
Seat 6: CoolFireX ($110.18 in chips) 
Seat 7: tatimora ($95.50 in chips) 
Seat 8: matiko09 ($104 in chips) 
Seat 9: butcheN18 ($105.19 in chips) 
maxxmeister: posts small blind $0.50
ruslik_by: posts big blind $1
*** HOLE CARDS ***
Dealt to matiko09 [9s Ah]
arctur17: folds 
jezzaber: folds 
mycka86: folds 
CoolFireX: folds 
tatimora: raises $1 to $2
matiko09: folds 
butcheN18: calls $2
maxxmeister: folds 
ruslik_by: calls $1
*** FLOP *** [2s Kh 3d]
ruslik_by: checks 
tatimora: checks 
butcheN18: bets $4
ruslik_by: calls $4
tatimora: folds 
*** TURN *** [2s Kh 3d] [Js]
ruslik_by: checks 
butcheN18: bets $9.50
ruslik_by: calls $9.50
*** RIVER *** [2s Kh 3d Js] [Qh]
ruslik_by: checks 
butcheN18: checks 
*** SHOW DOWN ***
ruslik_by: shows [9h Ks] (a pair of Kings)
butcheN18: shows [Kc Jh] (two pair, Kings and Jacks)
butcheN18 collected $31.82 from pot
*** SUMMARY ***
Total pot $33.50 | Rake $1.68 
Board [2s Kh 3d Js Qh]
Seat 1: maxxmeister (small blind) folded before Flop
Seat 2: ruslik_by (big blind) showed [9h Ks] and lost with a pair of Kings
Seat 3: arctur17 folded before Flop (didn't bet)
Seat 4: jezzaber folded before Flop (didn't bet)
Seat 5: mycka86 folded before Flop (didn't bet)
Seat 6: CoolFireX folded before Flop (didn't bet)
Seat 7: tatimora folded on the Flop
Seat 8: matiko09 folded before Flop (didn't bet)
Seat 9: butcheN18 (button) showed [Kc Jh] and won ($31.82) with two pair, Kings and Jacks





PokerStars Hand #154797770828:  Hold'em No Limit ($0.50/$1.00 USD) - 2016/06/16 9:31:12 CET [2016/06/16 3:31:12 ET]
Table 'Alekto' 9-max Seat #4 is the button
Seat 2: brotas232323 ($100 in chips) 
Seat 3: butcheN18 ($115.08 in chips) 
Seat 4: hammerwife ($115.27 in chips) 
Seat 5: matiko09 ($117.99 in chips) 
Seat 6: ilaviiitech ($126.31 in chips) 
Seat 7: flk.Dasas ($102.82 in chips) 
Seat 9: ruslik_by ($101.50 in chips) 
matiko09: posts small blind $0.50
ilaviiitech: posts big blind $1
ozone2003: sits out 
mycka86: sits out 
*** HOLE CARDS ***
Dealt to matiko09 [Th Qd]
flk.Dasas: folds 
ruslik_by: folds 
brotas232323: calls $1
butcheN18: folds 
hammerwife: folds 
matiko09: raises $3.50 to $4.50
ilaviiitech: folds 
brotas232323: calls $3.50
*** FLOP *** [5s 9s Ah]
matiko09: bets $5
brotas232323: calls $5
*** TURN *** [5s 9s Ah] [Qs]
matiko09: checks 
brotas232323: checks 
*** RIVER *** [5s 9s Ah Qs] [7s]
matiko09: checks 
brotas232323: checks 
*** SHOW DOWN ***
matiko09: shows [Th Qd] (a pair of Queens)
brotas232323: shows [Ad 2d] (a pair of Aces)
brotas232323 collected $19 from pot
*** SUMMARY ***
Total pot $20 | Rake $1 
Board [5s 9s Ah Qs 7s]
Seat 2: brotas232323 showed [Ad 2d] and won ($19) with a pair of Aces
Seat 3: butcheN18 folded before Flop (didn't bet)
Seat 4: hammerwife (button) folded before Flop (didn't bet)
Seat 5: matiko09 (small blind) showed [Th Qd] and lost with a pair of Queens
Seat 6: ilaviiitech (big blind) folded before Flop
Seat 7: flk.Dasas folded before Flop (didn't bet)
Seat 9: ruslik_by folded before Flop (didn't bet)





PokerStars Hand #154797779314:  Hold'em No Limit ($0.50/$1.00 USD) - 2016/06/16 9:31:43 CET [2016/06/16 3:31:43 ET]
Table 'Stroobantia II' 9-max Seat #1 is the button
Seat 1: mycka86 ($100 in chips) 
Seat 3: matiko09 ($102.47 in chips) 
Seat 4: CoolFireX ($105.55 in chips) 
Seat 5: butcheN18 ($101.50 in chips) 
Seat 8: ruslik_by ($100 in chips) 
Seat 9: jakub249 ($74 in chips) 
Lipton20088 will be allowed to play after the button
matiko09: posts small blind $0.50
CoolFireX: posts big blind $1
andrewtomaz: sits out 
AlKatrone: sits out 
*** HOLE CARDS ***
Dealt to matiko09 [Qc 9d]
butcheN18: folds 
ruslik_by: folds 
jakub249: folds 
mycka86: raises $1.10 to $2.10
matiko09: folds 
CoolFireX: folds 
Uncalled bet ($1.10) returned to mycka86
mycka86 collected $2.50 from pot
*** SUMMARY ***
Total pot $2.50 | Rake $0 
Seat 1: mycka86 (button) collected ($2.50)
Seat 3: matiko09 (small blind) folded before Flop
Seat 4: CoolFireX (big blind) folded before Flop
Seat 5: butcheN18 folded before Flop (didn't bet)
Seat 8: ruslik_by folded before Flop (didn't bet)
Seat 9: jakub249 folded before Flop (didn't bet)





PokerStars Hand #154797780154:  Hold'em No Limit ($0.25/$0.50 USD) - 2016/06/16 9:31:46 CET [2016/06/16 3:31:46 ET]
Table 'Mekbuda II' 9-max Seat #6 is the button
Seat 1: matiko09 ($50 in chips) 
Seat 2: tibi_c87 ($50 in chips) 
Seat 3: Kapa09 ($52.99 in chips) 
Seat 4: Vvalrond ($25.99 in chips) 
Seat 5: teerajaja ($50 in chips) 
Seat 6: Dantist1122 ($52.75 in chips) 
Seat 8: WKBelinda ($90.69 in chips) 
Seat 9: Alex Frider ($57.76 in chips) 
Lipton20088 will be allowed to play after the button
WKBelinda: posts small blind $0.25
Alex Frider: posts big blind $0.50
*** HOLE CARDS ***
Dealt to matiko09 [3h 4s]
matiko09: folds 
tibi_c87: folds 
Kapa09: folds 
Vvalrond: calls $0.50
teerajaja: folds 
Dantist1122: folds 
WKBelinda: calls $0.25
Alex Frider: checks 
*** FLOP *** [Kc Qs 8s]
WKBelinda: checks 
Alex Frider: checks 
Vvalrond: bets $1
WKBelinda: folds 
Alex Frider: folds 
Uncalled bet ($1) returned to Vvalrond
Vvalrond collected $1.42 from pot
Vvalrond: doesn't show hand 
*** SUMMARY ***
Total pot $1.50 | Rake $0.08 
Board [Kc Qs 8s]
Seat 1: matiko09 folded before Flop (didn't bet)
Seat 2: tibi_c87 folded before Flop (didn't bet)
Seat 3: Kapa09 folded before Flop (didn't bet)
Seat 4: Vvalrond collected ($1.42)
Seat 5: teerajaja folded before Flop (didn't bet)
Seat 6: Dantist1122 (button) folded before Flop (didn't bet)
Seat 8: WKBelinda (small blind) folded on the Flop
Seat 9: Alex Frider (big blind) folded on the Flop





PokerStars Hand #154797784679:  Hold'em No Limit ($0.50/$1.00 USD) - 2016/06/16 9:32:02 CET [2016/06/16 3:32:02 ET]
Table 'Alekto' 9-max Seat #5 is the button
Seat 2: brotas232323 ($109.50 in chips) 
Seat 3: butcheN18 ($115.08 in chips) 
Seat 4: hammerwife ($115.27 in chips) 
Seat 5: matiko09 ($108.49 in chips) 
Seat 6: ilaviiitech ($125.31 in chips) 
Seat 7: flk.Dasas ($102.82 in chips) 
Seat 9: ruslik_by ($101.50 in chips) 
ilaviiitech: posts small blind $0.50
flk.Dasas: posts big blind $1
ozone2003: sits out 
mycka86: sits out 
*** HOLE CARDS ***
Dealt to matiko09 [Td 7s]
ruslik_by: folds 
brotas232323: folds 
butcheN18: folds 
hammerwife: raises $1.50 to $2.50
matiko09: folds 
ilaviiitech: folds 
flk.Dasas: folds 
Uncalled bet ($1.50) returned to hammerwife
hammerwife collected $2.50 from pot
hammerwife: doesn't show hand 
*** SUMMARY ***
Total pot $2.50 | Rake $0 
Seat 2: brotas232323 folded before Flop (didn't bet)
Seat 3: butcheN18 folded before Flop (didn't bet)
Seat 4: hammerwife collected ($2.50)
Seat 5: matiko09 (button) folded before Flop (didn't bet)
Seat 6: ilaviiitech (small blind) folded before Flop
Seat 7: flk.Dasas (big blind) folded before Flop
Seat 9: ruslik_by folded before Flop (didn't bet)





PokerStars Hand #154797788451:  Hold'em No Limit ($0.50/$1.00 USD) - 2016/06/16 9:32:16 CET [2016/06/16 3:32:16 ET]
Table 'Stroobantia II' 9-max Seat #3 is the button
Seat 1: mycka86 ($101.50 in chips) 
Seat 3: matiko09 ($101.97 in chips) 
Seat 4: CoolFireX ($104.55 in chips) 
Seat 5: butcheN18 ($101.50 in chips) 
Seat 8: ruslik_by ($100 in chips) 
Seat 9: jakub249 ($74 in chips) 
CoolFireX: posts small blind $0.50
butcheN18: posts big blind $1
andrewtomaz: sits out 
AlKatrone: sits out 
Lipton20088: sits out 
*** HOLE CARDS ***
Dealt to matiko09 [2h 4d]
ruslik_by: folds 
jakub249: folds 
mycka86: folds 
matiko09: folds 
CoolFireX: folds 
Uncalled bet ($0.50) returned to butcheN18
butcheN18 collected $1 from pot
butcheN18: doesn't show hand 
*** SUMMARY ***
Total pot $1 | Rake $0 
Seat 1: mycka86 folded before Flop (didn't bet)
Seat 3: matiko09 (button) folded before Flop (didn't bet)
Seat 4: CoolFireX (small blind) folded before Flop
Seat 5: butcheN18 (big blind) collected ($1)
Seat 8: ruslik_by folded before Flop (didn't bet)
Seat 9: jakub249 folded before Flop (didn't bet)





PokerStars Hand #154797790463:  Hold'em No Limit ($0.50/$1.00 USD) - 2016/06/16 9:32:23 CET [2016/06/16 3:32:23 ET]
Table 'Markab II' 9-max Seat #4 is the button
Seat 2: mycka86 ($106.39 in chips) 
Seat 3: f4life1521 ($85.89 in chips) 
Seat 4: ruslik_by ($200.12 in chips) 
Seat 6: butcheN18 ($189.49 in chips) 
Seat 7: matiko09 ($108.75 in chips) 
Seat 8: CoolFireX ($141.26 in chips) 
butcheN18: posts small blind $0.50
matiko09: posts big blind $1
*** HOLE CARDS ***
Dealt to matiko09 [Jc 2s]
CoolFireX: folds 
mycka86: raises $1.50 to $2.50
greyman571 joins the table at seat #9 
Peremogec8 joins the table at seat #1 
f4life1521: folds 
ruslik_by: folds 
butcheN18: calls $2
matiko09: folds 
*** FLOP *** [Jh Qh 6h]
butcheN18: checks 
maxxmeister joins the table at seat #5 
mycka86: checks 
*** TURN *** [Jh Qh 6h] [7c]
butcheN18: bets $3.53
mycka86: folds 
Uncalled bet ($3.53) returned to butcheN18
butcheN18 collected $5.70 from pot
butcheN18: doesn't show hand 
*** SUMMARY ***
Total pot $6 | Rake $0.30 
Board [Jh Qh 6h 7c]
Seat 2: mycka86 folded on the Turn
Seat 3: f4life1521 folded before Flop (didn't bet)
Seat 4: ruslik_by (button) folded before Flop (didn't bet)
Seat 6: butcheN18 (small blind) collected ($5.70)
Seat 7: matiko09 (big blind) folded before Flop
Seat 8: CoolFireX folded before Flop (didn't bet)





PokerStars Hand #154797791379:  Hold'em No Limit ($0.50/$1.00 USD) - 2016/06/16 9:32:27 CET [2016/06/16 3:32:27 ET]
Table 'Hercynia II' 9-max Seat #4 is the button
Seat 1: flk.Dasas ($100 in chips) 
Seat 2: hammerwife ($209.56 in chips) 
Seat 3: butcheN18 ($116.78 in chips) 
Seat 4: ruslik_by ($100 in chips) 
Seat 5: matiko09 ($100 in chips) 
Seat 6: CoolFireX ($100 in chips) 
Seat 7: ozone2003 ($104 in chips) 
Seat 8: mycka86 ($183.25 in chips) 
Seat 9: Juniorquiapo ($79.52 in chips) 
matiko09: posts small blind $0.50
CoolFireX: posts big blind $1
*** HOLE CARDS ***
Dealt to matiko09 [8h 9c]
ozone2003: folds 
mycka86: raises $2 to $3
Juniorquiapo: raises $4 to $7
flk.Dasas: folds 
hammerwife: folds 
butcheN18: folds 
ruslik_by: folds 
matiko09: folds 
CoolFireX: folds 
mycka86: calls $4
*** FLOP *** [Jd 6h 8d]
hammerwife said, "ne hvataet) 30, a nado 40"
mycka86: checks 
Juniorquiapo: bets $9
mycka86: calls $9
*** TURN *** [Jd 6h 8d] [5s]
mycka86: bets $1.99
Juniorquiapo: raises $9.99 to $11.98
mycka86: calls $9.99
*** RIVER *** [Jd 6h 8d 5s] [4h]
mycka86: checks 
Juniorquiapo: checks 
*** SHOW DOWN ***
mycka86: shows [Td Qd] (high card Queen)
Juniorquiapo: shows [Kh Kd] (a pair of Kings)
Juniorquiapo collected $54.96 from pot
*** SUMMARY ***
Total pot $57.46 | Rake $2.50 
Board [Jd 6h 8d 5s 4h]
Seat 1: flk.Dasas folded before Flop (didn't bet)
Seat 2: hammerwife folded before Flop (didn't bet)
Seat 3: butcheN18 folded before Flop (didn't bet)
Seat 4: ruslik_by (button) folded before Flop (didn't bet)
Seat 5: matiko09 (small blind) folded before Flop
Seat 6: CoolFireX (big blind) folded before Flop
Seat 7: ozone2003 folded before Flop (didn't bet)
Seat 8: mycka86 showed [Td Qd] and lost with high card Queen
Seat 9: Juniorquiapo showed [Kh Kd] and won ($54.96) with a pair of Kings





PokerStars Hand #154797792255:  Hold'em No Limit ($0.50/$1.00 USD) - 2016/06/16 9:32:30 CET [2016/06/16 3:32:30 ET]
Table 'Stroobantia II' 9-max Seat #4 is the button
Seat 1: mycka86 ($101.50 in chips) 
Seat 3: matiko09 ($101.97 in chips) 
Seat 4: CoolFireX ($104.05 in chips) 
Seat 5: butcheN18 ($102 in chips) 
Seat 6: andrewtomaz ($99 in chips) 
Seat 8: ruslik_by ($100 in chips) 
Seat 9: jakub249 ($74 in chips) 
butcheN18: posts small blind $0.50
andrewtomaz: posts big blind $1
AlKatrone: sits out 
Lipton20088: sits out 
*** HOLE CARDS ***
Dealt to matiko09 [4d Ks]
ruslik_by: folds 
jakub249: folds 
mycka86: folds 
matiko09: folds 
CoolFireX: folds 
butcheN18: folds 
Uncalled bet ($0.50) returned to andrewtomaz
andrewtomaz collected $1 from pot
*** SUMMARY ***
Total pot $1 | Rake $0 
Seat 1: mycka86 folded before Flop (didn't bet)
Seat 3: matiko09 folded before Flop (didn't bet)
Seat 4: CoolFireX (button) folded before Flop (didn't bet)
Seat 5: butcheN18 (small blind) folded before Flop
Seat 6: andrewtomaz (big blind) collected ($1)
Seat 8: ruslik_by folded before Flop (didn't bet)
Seat 9: jakub249 folded before Flop (didn't bet)





PokerStars Hand #154797793182:  Hold'em No Limit ($0.50/$1.00 USD) - 2016/06/16 9:32:33 CET [2016/06/16 3:32:33 ET]
Table 'Alekto' 9-max Seat #6 is the button
Seat 2: brotas232323 ($109.50 in chips) 
Seat 3: butcheN18 ($115.08 in chips) 
Seat 4: hammerwife ($116.77 in chips) 
Seat 5: matiko09 ($108.49 in chips) 
Seat 6: ilaviiitech ($124.81 in chips) 
Seat 7: flk.Dasas ($101.82 in chips) 
Seat 8: ozone2003 ($100 in chips) 
Seat 9: ruslik_by ($101.50 in chips) 
flk.Dasas: posts small blind $0.50
ozone2003: posts big blind $1
mycka86: sits out 
*** HOLE CARDS ***
Dealt to matiko09 [9s 3h]
ruslik_by: folds 
brotas232323: calls $1
butcheN18: folds 
hammerwife: raises $4 to $5
matiko09: folds 
ilaviiitech: folds 
flk.Dasas: folds 
ozone2003: folds 
brotas232323: calls $4
*** FLOP *** [Jh 3c 7c]
brotas232323: bets $1
hammerwife: raises $9.50 to $10.50
brotas232323: folds 
Uncalled bet ($9.50) returned to hammerwife
hammerwife collected $12.82 from pot
hammerwife: doesn't show hand 
*** SUMMARY ***
Total pot $13.50 | Rake $0.68 
Board [Jh 3c 7c]
Seat 2: brotas232323 folded on the Flop
Seat 3: butcheN18 folded before Flop (didn't bet)
Seat 4: hammerwife collected ($12.82)
Seat 5: matiko09 folded before Flop (didn't bet)
Seat 6: ilaviiitech (button) folded before Flop (didn't bet)
Seat 7: flk.Dasas (small blind) folded before Flop
Seat 8: ozone2003 (big blind) folded before Flop
Seat 9: ruslik_by folded before Flop (didn't bet)





PokerStars Hand #154797794772:  Hold'em No Limit ($0.25/$0.50 USD) - 2016/06/16 9:32:39 CET [2016/06/16 3:32:39 ET]
Table 'Gaea' 9-max Seat #4 is the button
Seat 2: magzi777 ($50 in chips) 
Seat 3: Crazyfish87 ($42.69 in chips) 
Seat 4: matiko09 ($70.77 in chips) 
Seat 5: Kapa09 ($50 in chips) 
Seat 6: Alex Frider ($61.62 in chips) 
Seat 7: au318 ($51.26 in chips) 
Seat 9: Prophet1906 ($62.90 in chips) 
Kapa09: posts small blind $0.25
Alex Frider: posts big blind $0.50
Red_Warning: sits out 
jasonhan416: sits out 
*** HOLE CARDS ***
Dealt to matiko09 [Td 7c]
au318: folds 
au318 leaves the table
Prophet1906: folds 
magzi777: folds 
Crazyfish87: folds 
matiko09: folds 
Kapa09: folds 
Uncalled bet ($0.25) returned to Alex Frider
Alex Frider collected $0.50 from pot
Alex Frider: doesn't show hand 
*** SUMMARY ***
Total pot $0.50 | Rake $0 
Seat 2: magzi777 folded before Flop (didn't bet)
Seat 3: Crazyfish87 folded before Flop (didn't bet)
Seat 4: matiko09 (button) folded before Flop (didn't bet)
Seat 5: Kapa09 (small blind) folded before Flop
Seat 6: Alex Frider (big blind) collected ($0.50)
Seat 7: au318 folded before Flop (didn't bet)
Seat 9: Prophet1906 folded before Flop (didn't bet)





PokerStars Hand #154797797499:  Hold'em No Limit ($0.50/$1.00 USD) - 2016/06/16 9:32:49 CET [2016/06/16 3:32:49 ET]
Table 'Stroobantia II' 9-max Seat #5 is the button
Seat 1: mycka86 ($101.50 in chips) 
Seat 3: matiko09 ($101.97 in chips) 
Seat 4: CoolFireX ($104.05 in chips) 
Seat 5: butcheN18 ($101.50 in chips) 
Seat 6: andrewtomaz ($99.50 in chips) 
Seat 7: AlKatrone ($100 in chips) 
Seat 8: ruslik_by ($100 in chips) 
Seat 9: jakub249 ($74 in chips) 
andrewtomaz: posts small blind $0.50
AlKatrone: posts big blind $1
Lipton20088: sits out 
*** HOLE CARDS ***
Dealt to matiko09 [Qh As]
ruslik_by: raises $2 to $3
jakub249: folds 
mycka86: folds 
matiko09: calls $3
CoolFireX: folds 
butcheN18: folds 
andrewtomaz: folds 
AlKatrone: calls $2
*** FLOP *** [2d Kh Ks]
AlKatrone: checks 
ruslik_by: bets $3.06
matiko09: folds 
AlKatrone: folds 
Uncalled bet ($3.06) returned to ruslik_by
ruslik_by collected $9.02 from pot
ruslik_by: doesn't show hand 
*** SUMMARY ***
Total pot $9.50 | Rake $0.48 
Board [2d Kh Ks]
Seat 1: mycka86 folded before Flop (didn't bet)
Seat 3: matiko09 folded on the Flop
Seat 4: CoolFireX folded before Flop (didn't bet)
Seat 5: butcheN18 (button) folded before Flop (didn't bet)
Seat 6: andrewtomaz (small blind) folded before Flop
Seat 7: AlKatrone (big blind) folded on the Flop
Seat 8: ruslik_by collected ($9.02)
Seat 9: jakub249 folded before Flop (didn't bet)





PokerStars Hand #154797802862:  Hold'em No Limit ($0.25/$0.50 USD) - 2016/06/16 9:33:08 CET [2016/06/16 3:33:08 ET]
Table 'Gaea' 9-max Seat #5 is the button
Seat 2: magzi777 ($50 in chips) 
Seat 3: Crazyfish87 ($42.69 in chips) 
Seat 4: matiko09 ($70.77 in chips) 
Seat 5: Kapa09 ($49.75 in chips) 
Seat 6: Alex Frider ($61.87 in chips) 
Seat 8: Red_Warning ($50 in chips) 
Seat 9: Prophet1906 ($62.90 in chips) 
Alex Frider: posts small blind $0.25
Red_Warning: posts big blind $0.50
jasonhan416: sits out 
*** HOLE CARDS ***
Dealt to matiko09 [Qd 5d]
Prophet1906: folds 
magzi777: folds 
Crazyfish87: folds 
matiko09: folds 
Kapa09: raises $0.75 to $1.25
Alex Frider: folds 
Red_Warning: folds 
Uncalled bet ($0.75) returned to Kapa09
Kapa09 collected $1.25 from pot
Kapa09: doesn't show hand 
Dantist1122 joins the table at seat #7 
*** SUMMARY ***
Total pot $1.25 | Rake $0 
Seat 2: magzi777 folded before Flop (didn't bet)
Seat 3: Crazyfish87 folded before Flop (didn't bet)
Seat 4: matiko09 folded before Flop (didn't bet)
Seat 5: Kapa09 (button) collected ($1.25)
Seat 6: Alex Frider (small blind) folded before Flop
Seat 8: Red_Warning (big blind) folded before Flop
Seat 9: Prophet1906 folded before Flop (didn't bet)





PokerStars Hand #154797805429:  Hold'em No Limit ($0.50/$1.00 USD) - 2016/06/16 9:33:17 CET [2016/06/16 3:33:17 ET]
Table 'Astyanax' 9-max Seat #6 is the button
Seat 1: pokerich462 ($173.38 in chips) 
Seat 2: matiko09 ($100 in chips) 
Seat 3: hammerwife ($116.74 in chips) 
Seat 4: teerajaja ($100 in chips) 
Seat 5: butcheN18 ($101.80 in chips) 
Seat 6: Dantist1122 ($133.44 in chips) 
Seat 7: flk.Dasas ($100.50 in chips) 
Seat 8: mycka86 ($100 in chips) 
Seat 9: CoolFireX ($105.24 in chips) 
flk.Dasas: posts small blind $0.50
mycka86: posts big blind $1
pokerich462: posts the ante $0.20
matiko09: posts the ante $0.20
hammerwife: posts the ante $0.20
teerajaja: posts the ante $0.20
butcheN18: posts the ante $0.20
Dantist1122: posts the ante $0.20
flk.Dasas: posts the ante $0.20
mycka86: posts the ante $0.20
CoolFireX: posts the ante $0.20
*** HOLE CARDS ***
Dealt to matiko09 [6s Th]
CoolFireX: folds 
pokerich462: raises $4 to $5
matiko09: folds 
hammerwife: folds 
teerajaja: calls $5
butcheN18: folds 
Dantist1122: folds 
flk.Dasas: folds 
mycka86: folds 
*** FLOP *** [5s 5h 3c]
pokerich462: bets $12.64
teerajaja: calls $12.64
*** TURN *** [5s 5h 3c] [As]
pokerich462: checks 
teerajaja: checks 
*** RIVER *** [5s 5h 3c As] [7s]
pokerich462: checks 
teerajaja: checks 
*** SHOW DOWN ***
pokerich462: shows [Kc Kh] (two pair, Kings and Fives)
teerajaja: mucks hand 
pokerich462 collected $36.65 from pot
*** SUMMARY ***
Total pot $38.58 | Rake $1.93 
Board [5s 5h 3c As 7s]
Seat 1: pokerich462 showed [Kc Kh] and won ($36.65) with two pair, Kings and Fives
Seat 2: matiko09 folded before Flop (didn't bet)
Seat 3: hammerwife folded before Flop (didn't bet)
Seat 4: teerajaja mucked [Jc Jh]
Seat 5: butcheN18 folded before Flop (didn't bet)
Seat 6: Dantist1122 (button) folded before Flop (didn't bet)
Seat 7: flk.Dasas (small blind) folded before Flop
Seat 8: mycka86 (big blind) folded before Flop
Seat 9: CoolFireX folded before Flop (didn't bet)





PokerStars Hand #154797805570:  Hold'em No Limit ($0.50/$1.00 USD) - 2016/06/16 9:33:18 CET [2016/06/16 3:33:18 ET]
Table 'Markab II' 9-max Seat #6 is the button
Seat 2: mycka86 ($103.89 in chips) 
Seat 3: f4life1521 ($85.89 in chips) 
Seat 4: ruslik_by ($200.12 in chips) 
Seat 6: butcheN18 ($192.69 in chips) 
Seat 7: matiko09 ($107.75 in chips) 
Seat 8: CoolFireX ($141.26 in chips) 
matiko09: posts small blind $0.50
CoolFireX: posts big blind $1
greyman571: sits out 
maxxmeister: sits out 
*** HOLE CARDS ***
Dealt to matiko09 [6s 4s]
Peremogec8 leaves the table
AlKatrone joins the table at seat #1 
mycka86: folds 
f4life1521: folds 
ruslik_by: folds 
butcheN18: raises $1.14 to $2.14
matiko09: folds 
CoolFireX: calls $1.14
*** FLOP *** [2s As Tc]
CoolFireX: checks 
butcheN18: bets $2.81
CoolFireX: calls $2.81
*** TURN *** [2s As Tc] [9d]
CoolFireX: checks 
butcheN18: bets $6.12
CoolFireX: calls $6.12
*** RIVER *** [2s As Tc 9d] [9h]
CoolFireX: checks 
butcheN18: checks 
*** SHOW DOWN ***
CoolFireX: shows [Ts Kd] (two pair, Tens and Nines)
butcheN18: mucks hand 
CoolFireX collected $21.51 from pot
*** SUMMARY ***
Total pot $22.64 | Rake $1.13 
Board [2s As Tc 9d 9h]
Seat 2: mycka86 folded before Flop (didn't bet)
Seat 3: f4life1521 folded before Flop (didn't bet)
Seat 4: ruslik_by folded before Flop (didn't bet)
Seat 6: butcheN18 (button) mucked [Jd Qh]
Seat 7: matiko09 (small blind) folded before Flop
Seat 8: CoolFireX (big blind) showed [Ts Kd] and won ($21.51) with two pair, Tens and Nines





PokerStars Hand #154797806329:  Hold'em No Limit ($0.50/$1.00 USD) - 2016/06/16 9:33:21 CET [2016/06/16 3:33:21 ET]
Table 'Solstice' 9-max Seat #1 is the button
Seat 1: maxxmeister ($133.87 in chips) 
Seat 2: ruslik_by ($100 in chips) 
Seat 3: arctur17 ($38.24 in chips) 
Seat 4: jezzaber ($97.50 in chips) 
Seat 5: mycka86 ($115.48 in chips) 
Seat 6: CoolFireX ($110.18 in chips) 
Seat 7: tatimora ($93.50 in chips) 
Seat 8: matiko09 ($104 in chips) 
Seat 9: butcheN18 ($121.51 in chips) 
ruslik_by: posts small blind $0.50
arctur17: posts big blind $1
*** HOLE CARDS ***
Dealt to matiko09 [Ac 5s]
jezzaber: folds 
mycka86: folds 
CoolFireX: folds 
tatimora: folds 
matiko09: folds 
butcheN18: folds 
maxxmeister: folds 
ruslik_by: folds 
Uncalled bet ($0.50) returned to arctur17
arctur17 collected $1 from pot
arctur17: doesn't show hand 
*** SUMMARY ***
Total pot $1 | Rake $0 
Seat 1: maxxmeister (button) folded before Flop (didn't bet)
Seat 2: ruslik_by (small blind) folded before Flop
Seat 3: arctur17 (big blind) collected ($1)
Seat 4: jezzaber folded before Flop (didn't bet)
Seat 5: mycka86 folded before Flop (didn't bet)
Seat 6: CoolFireX folded before Flop (didn't bet)
Seat 7: tatimora folded before Flop (didn't bet)
Seat 8: matiko09 folded before Flop (didn't bet)
Seat 9: butcheN18 folded before Flop (didn't bet)





PokerStars Hand #154797809082:  Hold'em No Limit ($0.25/$0.50 USD) - 2016/06/16 9:33:31 CET [2016/06/16 3:33:31 ET]
Table 'Gaea' 9-max Seat #6 is the button
Seat 2: magzi777 ($50 in chips) 
Seat 3: Crazyfish87 ($42.69 in chips) 
Seat 4: matiko09 ($70.77 in chips) 
Seat 5: Kapa09 ($50.50 in chips) 
Seat 6: Alex Frider ($61.62 in chips) 
Seat 8: Red_Warning ($50 in chips) 
Seat 9: Prophet1906 ($62.90 in chips) 
Dantist1122 will be allowed to play after the button
Red_Warning: posts small blind $0.25
Prophet1906: posts big blind $0.50
jasonhan416: sits out 
*** HOLE CARDS ***
Dealt to matiko09 [6h Qc]
magzi777: folds 
Crazyfish87: folds 
matiko09: folds 
Kapa09: raises $0.50 to $1
Alex Frider: folds 
Red_Warning: folds 
Prophet1906: folds 
Uncalled bet ($0.50) returned to Kapa09
Kapa09 collected $1.25 from pot
Kapa09: doesn't show hand 
*** SUMMARY ***
Total pot $1.25 | Rake $0 
Seat 2: magzi777 folded before Flop (didn't bet)
Seat 3: Crazyfish87 folded before Flop (didn't bet)
Seat 4: matiko09 folded before Flop (didn't bet)
Seat 5: Kapa09 collected ($1.25)
Seat 6: Alex Frider (button) folded before Flop (didn't bet)
Seat 8: Red_Warning (small blind) folded before Flop
Seat 9: Prophet1906 (big blind) folded before Flop





PokerStars Hand #154797810580:  Hold'em No Limit ($0.25/$0.50 USD) - 2016/06/16 9:33:36 CET [2016/06/16 3:33:36 ET]
Table 'Mekbuda II' 9-max Seat #8 is the button
Seat 1: matiko09 ($50 in chips) 
Seat 2: tibi_c87 ($50 in chips) 
Seat 3: Kapa09 ($52.99 in chips) 
Seat 4: Vvalrond ($26.91 in chips) 
Seat 5: teerajaja ($50 in chips) 
Seat 6: Dantist1122 ($52.75 in chips) 
Seat 8: WKBelinda ($90.19 in chips) 
Seat 9: Alex Frider ($57.26 in chips) 
Alex Frider: posts small blind $0.25
matiko09: posts big blind $0.50
Lipton20088: sits out 
*** HOLE CARDS ***
Dealt to matiko09 [As 6c]
tibi_c87: folds 
Kapa09: folds 
Vvalrond: raises $0.50 to $1
teerajaja: folds 
Dantist1122: folds 
WKBelinda: calls $1
Alex Frider: calls $0.75
matiko09: folds 
*** FLOP *** [8h 3d Td]
Alex Frider: checks 
Vvalrond: bets $2
WKBelinda: folds 
Alex Frider: folds 
Uncalled bet ($2) returned to Vvalrond
Vvalrond collected $3.32 from pot
Vvalrond: doesn't show hand 
*** SUMMARY ***
Total pot $3.50 | Rake $0.18 
Board [8h 3d Td]
Seat 1: matiko09 (big blind) folded before Flop
Seat 2: tibi_c87 folded before Flop (didn't bet)
Seat 3: Kapa09 folded before Flop (didn't bet)
Seat 4: Vvalrond collected ($3.32)
Seat 5: teerajaja folded before Flop (didn't bet)
Seat 6: Dantist1122 folded before Flop (didn't bet)
Seat 8: WKBelinda (button) folded on the Flop
Seat 9: Alex Frider (small blind) folded on the Flop





PokerStars Hand #154797814210:  Hold'em No Limit ($0.50/$1.00 USD) - 2016/06/16 9:33:49 CET [2016/06/16 3:33:49 ET]
Table 'Stroobantia II' 9-max Seat #6 is the button
Seat 1: mycka86 ($101.50 in chips) 
Seat 3: matiko09 ($100 in chips) 
Seat 4: CoolFireX ($104.05 in chips) 
Seat 5: butcheN18 ($101.50 in chips) 
Seat 6: andrewtomaz ($99 in chips) 
Seat 7: AlKatrone ($100 in chips) 
Seat 8: ruslik_by ($106.02 in chips) 
Seat 9: jakub249 ($74 in chips) 
AlKatrone: posts small blind $0.50
ruslik_by: posts big blind $1
Lipton20088: sits out 
*** HOLE CARDS ***
Dealt to matiko09 [5d 2s]
jakub249: folds 
mycka86: folds 
matiko09: folds 
CoolFireX: raises $2 to $3
butcheN18: folds 
andrewtomaz: folds 
AlKatrone: folds 
ruslik_by: folds 
Uncalled bet ($2) returned to CoolFireX
CoolFireX collected $2.50 from pot
CoolFireX: doesn't show hand 
*** SUMMARY ***
Total pot $2.50 | Rake $0 
Seat 1: mycka86 folded before Flop (didn't bet)
Seat 3: matiko09 folded before Flop (didn't bet)
Seat 4: CoolFireX collected ($2.50)
Seat 5: butcheN18 folded before Flop (didn't bet)
Seat 6: andrewtomaz (button) folded before Flop (didn't bet)
Seat 7: AlKatrone (small blind) folded before Flop
Seat 8: ruslik_by (big blind) folded before Flop
Seat 9: jakub249 folded before Flop (didn't bet)





PokerStars Hand #154797815586:  Hold'em No Limit ($0.50/$1.00 USD) - 2016/06/16 9:33:54 CET [2016/06/16 3:33:54 ET]
Table 'Solstice' 9-max Seat #2 is the button
Seat 1: maxxmeister ($133.87 in chips) 
Seat 2: ruslik_by ($100 in chips) 
Seat 3: arctur17 ($38.74 in chips) 
Seat 4: jezzaber ($97.50 in chips) 
Seat 5: mycka86 ($115.48 in chips) 
Seat 6: CoolFireX ($110.18 in chips) 
Seat 7: tatimora ($93.50 in chips) 
Seat 8: matiko09 ($104 in chips) 
Seat 9: butcheN18 ($121.51 in chips) 
arctur17: posts small blind $0.50
jezzaber: posts big blind $1
*** HOLE CARDS ***
Dealt to matiko09 [7s Ah]
mycka86: folds 
CoolFireX: folds 
tatimora: folds 
tatimora leaves the table
matiko09: folds 
butcheN18: folds 
maxxmeister: folds 
ruslik_by: raises $1 to $2
arctur17: folds 
jezzaber: folds 
Uncalled bet ($1) returned to ruslik_by
ruslik_by collected $2.50 from pot
ruslik_by: doesn't show hand 
*** SUMMARY ***
Total pot $2.50 | Rake $0 
Seat 1: maxxmeister folded before Flop (didn't bet)
Seat 2: ruslik_by (button) collected ($2.50)
Seat 3: arctur17 (small blind) folded before Flop
Seat 4: jezzaber (big blind) folded before Flop
Seat 5: mycka86 folded before Flop (didn't bet)
Seat 6: CoolFireX folded before Flop (didn't bet)
Seat 7: tatimora folded before Flop (didn't bet)
Seat 8: matiko09 folded before Flop (didn't bet)
Seat 9: butcheN18 folded before Flop (didn't bet)





PokerStars Hand #154797815807:  Hold'em No Limit ($0.50/$1.00 USD) - 2016/06/16 9:33:55 CET [2016/06/16 3:33:55 ET]
Table 'Alekto' 9-max Seat #7 is the button
Seat 2: brotas232323 ($103.50 in chips) 
Seat 3: butcheN18 ($115.08 in chips) 
Seat 4: hammerwife ($123.59 in chips) 
Seat 5: matiko09 ($108.49 in chips) 
Seat 6: ilaviiitech ($124.81 in chips) 
Seat 7: flk.Dasas ($101.32 in chips) 
Seat 8: ozone2003 ($100 in chips) 
Seat 9: ruslik_by ($101.50 in chips) 
ozone2003: posts small blind $0.50
ruslik_by: posts big blind $1
mycka86: sits out 
*** HOLE CARDS ***
Dealt to matiko09 [8s 7h]
brotas232323: folds 
butcheN18: folds 
hammerwife: raises $1.50 to $2.50
matiko09: folds 
ilaviiitech: calls $2.50
flk.Dasas: folds 
ozone2003: folds 
ruslik_by: calls $1.50
*** FLOP *** [Kc 6d Td]
ruslik_by: checks 
hammerwife: bets $4
ilaviiitech: folds 
ruslik_by: folds 
Uncalled bet ($4) returned to hammerwife
hammerwife collected $7.60 from pot
hammerwife: doesn't show hand 
*** SUMMARY ***
Total pot $8 | Rake $0.40 
Board [Kc 6d Td]
Seat 2: brotas232323 folded before Flop (didn't bet)
Seat 3: butcheN18 folded before Flop (didn't bet)
Seat 4: hammerwife collected ($7.60)
Seat 5: matiko09 folded before Flop (didn't bet)
Seat 6: ilaviiitech folded on the Flop
Seat 7: flk.Dasas (button) folded before Flop (didn't bet)
Seat 8: ozone2003 (small blind) folded before Flop
Seat 9: ruslik_by (big blind) folded on the Flop





PokerStars Hand #154797816373:  Hold'em No Limit ($0.25/$0.50 USD) - 2016/06/16 9:33:57 CET [2016/06/16 3:33:57 ET]
Table 'Gaea' 9-max Seat #8 is the button
Seat 1: jasonhan416 ($50 in chips) 
Seat 2: magzi777 ($50 in chips) 
Seat 3: Crazyfish87 ($42.69 in chips) 
Seat 4: matiko09 ($70.77 in chips) 
Seat 5: Kapa09 ($51.25 in chips) 
Seat 6: Alex Frider ($61.62 in chips) 
Seat 8: Red_Warning ($50 in chips) 
Seat 9: Prophet1906 ($62.40 in chips) 
Prophet1906: posts small blind $0.25
jasonhan416: posts big blind $0.50
Dantist1122: sits out 
*** HOLE CARDS ***
Dealt to matiko09 [8d 6h]
magzi777: folds 
Crazyfish87: folds 
matiko09: folds 
Kapa09: folds 
Alex Frider: folds 
Red_Warning: folds 
Prophet1906: folds 
Uncalled bet ($0.25) returned to jasonhan416
jasonhan416 collected $0.50 from pot
jasonhan416: doesn't show hand 
*** SUMMARY ***
Total pot $0.50 | Rake $0 
Seat 1: jasonhan416 (big blind) collected ($0.50)
Seat 2: magzi777 folded before Flop (didn't bet)
Seat 3: Crazyfish87 folded before Flop (didn't bet)
Seat 4: matiko09 folded before Flop (didn't bet)
Seat 5: Kapa09 folded before Flop (didn't bet)
Seat 6: Alex Frider folded before Flop (didn't bet)
Seat 8: Red_Warning (button) folded before Flop (didn't bet)
Seat 9: Prophet1906 (small blind) folded before Flop





PokerStars Hand #154797821491:  Hold'em No Limit ($0.50/$1.00 USD) - 2016/06/16 9:34:15 CET [2016/06/16 3:34:15 ET]
Table 'Stroobantia II' 9-max Seat #7 is the button
Seat 1: mycka86 ($101.50 in chips) 
Seat 3: matiko09 ($100 in chips) 
Seat 4: CoolFireX ($105.55 in chips) 
Seat 5: butcheN18 ($101.50 in chips) 
Seat 6: andrewtomaz ($99 in chips) 
Seat 7: AlKatrone ($100 in chips) 
Seat 8: ruslik_by ($105.02 in chips) 
Seat 9: jakub249 ($74 in chips) 
ruslik_by: posts small blind $0.50
jakub249: posts big blind $1
Lipton20088: sits out 
*** HOLE CARDS ***
Dealt to matiko09 [4c 5h]
mycka86: raises $2 to $3
matiko09: folds 
CoolFireX: folds 
butcheN18: folds 
andrewtomaz: folds 
AlKatrone: folds 
ruslik_by: folds 
jakub249: calls $2
*** FLOP *** [8s Jh As]
jakub249: checks 
mycka86: bets $4.30
jakub249: calls $4.30
*** TURN *** [8s Jh As] [7c]
jakub249: checks 
mycka86: bets $10.50
jakub249: raises $56.20 to $66.70 and is all-in
mycka86: folds 
Uncalled bet ($56.20) returned to jakub249
jakub249 collected $34.30 from pot
jakub249: doesn't show hand 
*** SUMMARY ***
Total pot $36.10 | Rake $1.80 
Board [8s Jh As 7c]
Seat 1: mycka86 folded on the Turn
Seat 3: matiko09 folded before Flop (didn't bet)
Seat 4: CoolFireX folded before Flop (didn't bet)
Seat 5: butcheN18 folded before Flop (didn't bet)
Seat 6: andrewtomaz folded before Flop (didn't bet)
Seat 7: AlKatrone (button) folded before Flop (didn't bet)
Seat 8: ruslik_by (small blind) folded before Flop
Seat 9: jakub249 (big blind) collected ($34.30)





PokerStars Hand #154797822650:  Hold'em No Limit ($0.50/$1.00 USD) - 2016/06/16 9:34:19 CET [2016/06/16 3:34:19 ET]
Table 'Solstice' 9-max Seat #3 is the button
Seat 1: maxxmeister ($133.87 in chips) 
Seat 2: ruslik_by ($101.50 in chips) 
Seat 3: arctur17 ($38.24 in chips) 
Seat 4: jezzaber ($96.50 in chips) 
Seat 5: mycka86 ($115.48 in chips) 
Seat 6: CoolFireX ($110.18 in chips) 
Seat 8: matiko09 ($104 in chips) 
Seat 9: butcheN18 ($121.51 in chips) 
jezzaber: posts small blind $0.50
mycka86: posts big blind $1
*** HOLE CARDS ***
Dealt to matiko09 [Qs 4c]
CoolFireX: raises $2 to $3
matiko09: folds 
butcheN18: folds 
maxxmeister: folds 
ruslik_by: folds 
arctur17: folds 
jezzaber: folds 
mycka86: folds 
Uncalled bet ($2) returned to CoolFireX
CoolFireX collected $2.50 from pot
CoolFireX: doesn't show hand 
*** SUMMARY ***
Total pot $2.50 | Rake $0 
Seat 1: maxxmeister folded before Flop (didn't bet)
Seat 2: ruslik_by folded before Flop (didn't bet)
Seat 3: arctur17 (button) folded before Flop (didn't bet)
Seat 4: jezzaber (small blind) folded before Flop
Seat 5: mycka86 (big blind) folded before Flop
Seat 6: CoolFireX collected ($2.50)
Seat 8: matiko09 folded before Flop (didn't bet)
Seat 9: butcheN18 folded before Flop (didn't bet)





PokerStars Hand #154797822479:  Hold'em No Limit ($0.50/$1.00 USD) - 2016/06/16 9:34:19 CET [2016/06/16 3:34:19 ET]
Table 'Hercynia II' 9-max Seat #5 is the button
Seat 1: flk.Dasas ($100 in chips) 
Seat 2: hammerwife ($209.56 in chips) 
Seat 3: butcheN18 ($116.78 in chips) 
Seat 4: ruslik_by ($100 in chips) 
Seat 5: matiko09 ($100 in chips) 
Seat 6: CoolFireX ($100 in chips) 
Seat 7: ozone2003 ($104 in chips) 
Seat 8: mycka86 ($155.27 in chips) 
Seat 9: Juniorquiapo ($106.50 in chips) 
CoolFireX: posts small blind $0.50
ozone2003: posts big blind $1
*** HOLE CARDS ***
Dealt to matiko09 [5c 4d]
mycka86: folds 
Juniorquiapo: folds 
flk.Dasas: folds 
hammerwife: raises $1.50 to $2.50
butcheN18: calls $2.50
ruslik_by: folds 
matiko09: folds 
CoolFireX: folds 
ozone2003: folds 
*** FLOP *** [Ks Ts 6d]
hammerwife: checks 
butcheN18: checks 
*** TURN *** [Ks Ts 6d] [7h]
hammerwife: checks 
butcheN18: bets $4
hammerwife: folds 
Uncalled bet ($4) returned to butcheN18
butcheN18 collected $6.18 from pot
butcheN18: doesn't show hand 
*** SUMMARY ***
Total pot $6.50 | Rake $0.32 
Board [Ks Ts 6d 7h]
Seat 1: flk.Dasas folded before Flop (didn't bet)
Seat 2: hammerwife folded on the Turn
Seat 3: butcheN18 collected ($6.18)
Seat 4: ruslik_by folded before Flop (didn't bet)
Seat 5: matiko09 (button) folded before Flop (didn't bet)
Seat 6: CoolFireX (small blind) folded before Flop
Seat 7: ozone2003 (big blind) folded before Flop
Seat 8: mycka86 folded before Flop (didn't bet)
Seat 9: Juniorquiapo folded before Flop (didn't bet)





PokerStars Hand #154797827846:  Hold'em No Limit ($0.25/$0.50 USD) - 2016/06/16 9:34:38 CET [2016/06/16 3:34:38 ET]
Table 'Gaea' 9-max Seat #9 is the button
Seat 1: jasonhan416 ($50.25 in chips) 
Seat 2: magzi777 ($50 in chips) 
Seat 3: Crazyfish87 ($42.69 in chips) 
Seat 4: matiko09 ($70.77 in chips) 
Seat 5: Kapa09 ($51.25 in chips) 
Seat 6: Alex Frider ($61.62 in chips) 
Seat 8: Red_Warning ($50 in chips) 
Seat 9: Prophet1906 ($62.15 in chips) 
jasonhan416: posts small blind $0.25
magzi777: posts big blind $0.50
Dantist1122: sits out 
*** HOLE CARDS ***
Dealt to matiko09 [3s 6s]
Crazyfish87: folds 
matiko09: folds 
Kapa09: folds 
Alex Frider: folds 
Red_Warning: folds 
Prophet1906: raises $1 to $1.50
jasonhan416: calls $1.25
magzi777: calls $1
*** FLOP *** [Jd 3d 8c]
jasonhan416: checks 
magzi777: checks 
Prophet1906: bets $2.25
jasonhan416: raises $6.50 to $8.75
magzi777: folds 
Prophet1906: folds 
Uncalled bet ($6.50) returned to jasonhan416
jasonhan416 collected $8.55 from pot
jasonhan416: doesn't show hand 
*** SUMMARY ***
Total pot $9 | Rake $0.45 
Board [Jd 3d 8c]
Seat 1: jasonhan416 (small blind) collected ($8.55)
Seat 2: magzi777 (big blind) folded on the Flop
Seat 3: Crazyfish87 folded before Flop (didn't bet)
Seat 4: matiko09 folded before Flop (didn't bet)
Seat 5: Kapa09 folded before Flop (didn't bet)
Seat 6: Alex Frider folded before Flop (didn't bet)
Seat 8: Red_Warning folded before Flop (didn't bet)
Seat 9: Prophet1906 (button) folded on the Flop





PokerStars Hand #154797828227:  Hold'em No Limit ($0.25/$0.50 USD) - 2016/06/16 9:34:39 CET [2016/06/16 3:34:39 ET]
Table 'Mekbuda II' 9-max Seat #9 is the button
Seat 1: matiko09 ($50 in chips) 
Seat 2: tibi_c87 ($50 in chips) 
Seat 3: Kapa09 ($52.99 in chips) 
Seat 4: Vvalrond ($29.23 in chips) 
Seat 5: teerajaja ($50 in chips) 
Seat 6: Dantist1122 ($52.75 in chips) 
Seat 8: WKBelinda ($89.19 in chips) 
Seat 9: Alex Frider ($56.26 in chips) 
matiko09: posts small blind $0.25
tibi_c87: posts big blind $0.50
Lipton20088: sits out 
*** HOLE CARDS ***
Dealt to matiko09 [Th 9s]
Kapa09: folds 
Vvalrond: calls $0.50
teerajaja: folds 
Dantist1122: raises $2 to $2.50
WKBelinda: folds 
Alex Frider: folds 
matiko09: folds 
tibi_c87: folds 
Vvalrond: calls $2
*** FLOP *** [As 8c 8d]
Vvalrond: checks 
Dantist1122: bets $3
Vvalrond: folds 
Uncalled bet ($3) returned to Dantist1122
Dantist1122 collected $5.46 from pot
Dantist1122: doesn't show hand 
*** SUMMARY ***
Total pot $5.75 | Rake $0.29 
Board [As 8c 8d]
Seat 1: matiko09 (small blind) folded before Flop
Seat 2: tibi_c87 (big blind) folded before Flop
Seat 3: Kapa09 folded before Flop (didn't bet)
Seat 4: Vvalrond folded on the Flop
Seat 5: teerajaja folded before Flop (didn't bet)
Seat 6: Dantist1122 collected ($5.46)
Seat 8: WKBelinda folded before Flop (didn't bet)
Seat 9: Alex Frider (button) folded before Flop (didn't bet)





PokerStars Hand #154797832306:  Hold'em No Limit ($0.50/$1.00 USD) - 2016/06/16 9:34:54 CET [2016/06/16 3:34:54 ET]
Table 'Markab II' 9-max Seat #7 is the button
Seat 2: mycka86 ($103.89 in chips) 
Seat 3: f4life1521 ($85.89 in chips) 
Seat 4: ruslik_by ($200.12 in chips) 
Seat 6: butcheN18 ($181.62 in chips) 
Seat 7: matiko09 ($107.25 in chips) 
Seat 8: CoolFireX ($151.70 in chips) 
Seat 9: greyman571 ($98.77 in chips) 
CoolFireX: posts small blind $0.50
greyman571: posts big blind $1
AlKatrone: sits out 
maxxmeister: sits out 
*** HOLE CARDS ***
Dealt to matiko09 [9d 2s]
mycka86: raises $2 to $3
f4life1521: folds 
ruslik_by: folds 
butcheN18: raises $6 to $9
matiko09: folds 
CoolFireX: folds 
greyman571: folds 
mycka86: folds 
Uncalled bet ($6) returned to butcheN18
butcheN18 collected $7.50 from pot
butcheN18: doesn't show hand 
*** SUMMARY ***
Total pot $7.50 | Rake $0 
Seat 2: mycka86 folded before Flop
Seat 3: f4life1521 folded before Flop (didn't bet)
Seat 4: ruslik_by folded before Flop (didn't bet)
Seat 6: butcheN18 collected ($7.50)
Seat 7: matiko09 (button) folded before Flop (didn't bet)
Seat 8: CoolFireX (small blind) folded before Flop
Seat 9: greyman571 (big blind) folded before Flop





PokerStars Hand #154797834221:  Hold'em No Limit ($0.50/$1.00 USD) - 2016/06/16 9:35:01 CET [2016/06/16 3:35:01 ET]
Table 'Alekto' 9-max Seat #8 is the button
Seat 1: mycka86 ($100 in chips) 
Seat 2: brotas232323 ($103.50 in chips) 
Seat 3: butcheN18 ($115.08 in chips) 
Seat 4: hammerwife ($128.69 in chips) 
Seat 5: matiko09 ($108.49 in chips) 
Seat 6: ilaviiitech ($122.31 in chips) 
Seat 7: flk.Dasas ($101.32 in chips) 
Seat 8: ozone2003 ($100 in chips) 
Seat 9: ruslik_by ($100 in chips) 
ruslik_by: posts small blind $0.50
mycka86: posts big blind $1
*** HOLE CARDS ***
Dealt to matiko09 [Th Td]
brotas232323: calls $1
butcheN18: folds 
hammerwife: folds 
matiko09: raises $3 to $4
ilaviiitech: folds 
flk.Dasas: folds 
ozone2003: folds 
ruslik_by: folds 
mycka86: folds 
brotas232323: calls $3
*** FLOP *** [3h Ah 7c]
brotas232323: checks 
matiko09: bets $4.69
brotas232323: folds 
Uncalled bet ($4.69) returned to matiko09
matiko09 collected $9.02 from pot
matiko09: doesn't show hand 
*** SUMMARY ***
Total pot $9.50 | Rake $0.48 
Board [3h Ah 7c]
Seat 1: mycka86 (big blind) folded before Flop
Seat 2: brotas232323 folded on the Flop
Seat 3: butcheN18 folded before Flop (didn't bet)
Seat 4: hammerwife folded before Flop (didn't bet)
Seat 5: matiko09 collected ($9.02)
Seat 6: ilaviiitech folded before Flop (didn't bet)
Seat 7: flk.Dasas folded before Flop (didn't bet)
Seat 8: ozone2003 (button) folded before Flop (didn't bet)
Seat 9: ruslik_by (small blind) folded before Flop





PokerStars Hand #154797835086:  Hold'em No Limit ($0.50/$1.00 USD) - 2016/06/16 9:35:05 CET [2016/06/16 3:35:05 ET]
Table 'Astyanax' 9-max Seat #7 is the button
Seat 1: pokerich462 ($192.19 in chips) 
Seat 2: matiko09 ($100 in chips) 
Seat 3: hammerwife ($116.54 in chips) 
Seat 4: teerajaja ($100 in chips) 
Seat 5: butcheN18 ($101.60 in chips) 
Seat 6: Dantist1122 ($133.24 in chips) 
Seat 7: flk.Dasas ($100 in chips) 
Seat 8: mycka86 ($100 in chips) 
Seat 9: CoolFireX ($105.04 in chips) 
mycka86: posts small blind $0.50
CoolFireX: posts big blind $1
pokerich462: posts the ante $0.20
matiko09: posts the ante $0.20
hammerwife: posts the ante $0.20
teerajaja: posts the ante $0.20
butcheN18: posts the ante $0.20
Dantist1122: posts the ante $0.20
flk.Dasas: posts the ante $0.20
mycka86: posts the ante $0.20
CoolFireX: posts the ante $0.20
*** HOLE CARDS ***
Dealt to matiko09 [4c 9d]
pokerich462: folds 
matiko09: folds 
hammerwife: folds 
teerajaja: folds 
butcheN18: raises $2 to $3
Dantist1122: folds 
flk.Dasas: folds 
mycka86: folds 
CoolFireX: folds 
Uncalled bet ($2) returned to butcheN18
butcheN18 collected $4.30 from pot
butcheN18: doesn't show hand 
*** SUMMARY ***
Total pot $4.30 | Rake $0 
Seat 1: pokerich462 folded before Flop (didn't bet)
Seat 2: matiko09 folded before Flop (didn't bet)
Seat 3: hammerwife folded before Flop (didn't bet)
Seat 4: teerajaja folded before Flop (didn't bet)
Seat 5: butcheN18 collected ($4.30)
Seat 6: Dantist1122 folded before Flop (didn't bet)
Seat 7: flk.Dasas (button) folded before Flop (didn't bet)
Seat 8: mycka86 (small blind) folded before Flop
Seat 9: CoolFireX (big blind) folded before Flop





PokerStars Hand #154797839071:  Hold'em No Limit ($0.25/$0.50 USD) - 2016/06/16 9:35:19 CET [2016/06/16 3:35:19 ET]
Table 'Mekbuda II' 9-max Seat #1 is the button
Seat 1: matiko09 ($50 in chips) 
Seat 2: tibi_c87 ($50 in chips) 
Seat 3: Kapa09 ($52.99 in chips) 
Seat 4: Vvalrond ($26.73 in chips) 
Seat 5: teerajaja ($50 in chips) 
Seat 6: Dantist1122 ($55.71 in chips) 
Seat 8: WKBelinda ($89.19 in chips) 
Seat 9: Alex Frider ($56.26 in chips) 
tibi_c87: posts small blind $0.25
Kapa09: posts big blind $0.50
Lipton20088: sits out 
*** HOLE CARDS ***
Dealt to matiko09 [4s Th]
Vvalrond: raises $0.50 to $1
teerajaja: folds 
Dantist1122: folds 
WKBelinda: calls $1
Alex Frider: folds 
matiko09: folds 
tibi_c87: calls $0.75
Kapa09: raises $5.50 to $6.50
Vvalrond: calls $5.50
WKBelinda: folds 
tibi_c87: folds 
*** FLOP *** [8d Ad Jc]
Kapa09: checks 
Vvalrond: bets $20.23 and is all-in
Kapa09: folds 
Uncalled bet ($20.23) returned to Vvalrond
Vvalrond collected $14.25 from pot
Vvalrond: doesn't show hand 
*** SUMMARY ***
Total pot $15 | Rake $0.75 
Board [8d Ad Jc]
Seat 1: matiko09 (button) folded before Flop (didn't bet)
Seat 2: tibi_c87 (small blind) folded before Flop
Seat 3: Kapa09 (big blind) folded on the Flop
Seat 4: Vvalrond collected ($14.25)
Seat 5: teerajaja folded before Flop (didn't bet)
Seat 6: Dantist1122 folded before Flop (didn't bet)
Seat 8: WKBelinda folded before Flop
Seat 9: Alex Frider folded before Flop (didn't bet)





PokerStars Hand #154797841811:  Hold'em No Limit ($0.50/$1.00 USD) - 2016/06/16 9:35:29 CET [2016/06/16 3:35:29 ET]
Table 'Markab II' 9-max Seat #8 is the button
Seat 1: AlKatrone ($105.42 in chips) 
Seat 2: mycka86 ($100.89 in chips) 
Seat 3: f4life1521 ($85.89 in chips) 
Seat 4: ruslik_by ($200.12 in chips) 
Seat 6: butcheN18 ($186.12 in chips) 
Seat 7: matiko09 ($107.25 in chips) 
Seat 8: CoolFireX ($151.20 in chips) 
Seat 9: greyman571 ($97.77 in chips) 
greyman571: posts small blind $0.50
AlKatrone: posts big blind $1
maxxmeister: sits out 
*** HOLE CARDS ***
Dealt to matiko09 [As 5d]
mycka86: raises $2 to $3
f4life1521: folds 
ruslik_by: folds 
butcheN18: calls $3
matiko09: folds 
CoolFireX: folds 
greyman571: folds 
AlKatrone: calls $2
*** FLOP *** [8s 5s Qc]
AlKatrone: checks 
mycka86: bets $6.90
butcheN18: calls $6.90
AlKatrone: folds 
*** TURN *** [8s 5s Qc] [Qh]
mycka86: checks 
butcheN18: bets $14
mycka86: folds 
Uncalled bet ($14) returned to butcheN18
butcheN18 collected $22.14 from pot
butcheN18: doesn't show hand 
*** SUMMARY ***
Total pot $23.30 | Rake $1.16 
Board [8s 5s Qc Qh]
Seat 1: AlKatrone (big blind) folded on the Flop
Seat 2: mycka86 folded on the Turn
Seat 3: f4life1521 folded before Flop (didn't bet)
Seat 4: ruslik_by folded before Flop (didn't bet)
Seat 6: butcheN18 collected ($22.14)
Seat 7: matiko09 folded before Flop (didn't bet)
Seat 8: CoolFireX (button) folded before Flop (didn't bet)
Seat 9: greyman571 (small blind) folded before Flop





PokerStars Hand #154797844215:  Hold'em No Limit ($0.50/$1.00 USD) - 2016/06/16 9:35:37 CET [2016/06/16 3:35:37 ET]
Table 'Alekto' 9-max Seat #9 is the button
Seat 1: mycka86 ($100 in chips) 
Seat 2: brotas232323 ($99.50 in chips) 
Seat 3: butcheN18 ($115.08 in chips) 
Seat 4: hammerwife ($128.69 in chips) 
Seat 5: matiko09 ($113.51 in chips) 
Seat 6: ilaviiitech ($122.31 in chips) 
Seat 7: flk.Dasas ($101.32 in chips) 
Seat 8: ozone2003 ($100 in chips) 
Seat 9: ruslik_by ($100 in chips) 
mycka86: posts small blind $0.50
brotas232323: posts big blind $1
*** HOLE CARDS ***
Dealt to matiko09 [4d 7c]
butcheN18: raises $2 to $3
hammerwife: folds 
matiko09: folds 
ilaviiitech: folds 
flk.Dasas: folds 
ozone2003: folds 
ruslik_by: folds 
mycka86: folds 
brotas232323: folds 
Uncalled bet ($2) returned to butcheN18
butcheN18 collected $2.50 from pot
butcheN18: doesn't show hand 
*** SUMMARY ***
Total pot $2.50 | Rake $0 
Seat 1: mycka86 (small blind) folded before Flop
Seat 2: brotas232323 (big blind) folded before Flop
Seat 3: butcheN18 collected ($2.50)
Seat 4: hammerwife folded before Flop (didn't bet)
Seat 5: matiko09 folded before Flop (didn't bet)
Seat 6: ilaviiitech folded before Flop (didn't bet)
Seat 7: flk.Dasas folded before Flop (didn't bet)
Seat 8: ozone2003 folded before Flop (didn't bet)
Seat 9: ruslik_by (button) folded before Flop (didn't bet)





PokerStars Hand #154797845967:  Hold'em No Limit ($0.50/$1.00 USD) - 2016/06/16 9:35:44 CET [2016/06/16 3:35:44 ET]
Table 'Astyanax' 9-max Seat #8 is the button
Seat 1: pokerich462 ($191.99 in chips) 
Seat 2: matiko09 ($100 in chips) 
Seat 3: hammerwife ($116.34 in chips) 
Seat 4: teerajaja ($100 in chips) 
Seat 5: butcheN18 ($104.70 in chips) 
Seat 6: Dantist1122 ($133.04 in chips) 
Seat 7: flk.Dasas ($100 in chips) 
Seat 8: mycka86 ($100 in chips) 
Seat 9: CoolFireX ($103.84 in chips) 
CoolFireX: posts small blind $0.50
pokerich462: posts big blind $1
pokerich462: posts the ante $0.20
matiko09: posts the ante $0.20
hammerwife: posts the ante $0.20
teerajaja: posts the ante $0.20
butcheN18: posts the ante $0.20
Dantist1122: posts the ante $0.20
flk.Dasas: posts the ante $0.20
mycka86: posts the ante $0.20
CoolFireX: posts the ante $0.20
*** HOLE CARDS ***
Dealt to matiko09 [9h 2c]
matiko09: folds 
hammerwife: folds 
teerajaja: folds 
butcheN18: folds 
Dantist1122: folds 
flk.Dasas: folds 
mycka86: folds 
CoolFireX: folds 
Uncalled bet ($0.50) returned to pokerich462
pokerich462 collected $2.80 from pot
pokerich462: doesn't show hand 
*** SUMMARY ***
Total pot $2.80 | Rake $0 
Seat 1: pokerich462 (big blind) collected ($2.80)
Seat 2: matiko09 folded before Flop (didn't bet)
Seat 3: hammerwife folded before Flop (didn't bet)
Seat 4: teerajaja folded before Flop (didn't bet)
Seat 5: butcheN18 folded before Flop (didn't bet)
Seat 6: Dantist1122 folded before Flop (didn't bet)
Seat 7: flk.Dasas folded before Flop (didn't bet)
Seat 8: mycka86 (button) folded before Flop (didn't bet)
Seat 9: CoolFireX (small blind) folded before Flop





PokerStars Hand #154797846342:  Hold'em No Limit ($0.50/$1.00 USD) - 2016/06/16 9:35:45 CET [2016/06/16 3:35:45 ET]
Table 'Stroobantia II' 9-max Seat #8 is the button
Seat 1: mycka86 ($100 in chips) 
Seat 3: matiko09 ($100 in chips) 
Seat 4: CoolFireX ($105.55 in chips) 
Seat 5: butcheN18 ($101.50 in chips) 
Seat 6: andrewtomaz ($99 in chips) 
Seat 7: AlKatrone ($100 in chips) 
Seat 8: ruslik_by ($104.52 in chips) 
Seat 9: jakub249 ($90.50 in chips) 
jakub249: posts small blind $0.50
mycka86: posts big blind $1
Lipton20088: sits out 
*** HOLE CARDS ***
Dealt to matiko09 [4h 9d]
matiko09: folds 
CoolFireX: folds 
butcheN18: folds 
andrewtomaz: folds 
AlKatrone: folds 
ruslik_by: folds 
jakub249: calls $0.50
mycka86: raises $3 to $4
jakub249: calls $3
*** FLOP *** [Ks Kd 4c]
jakub249: checks 
mycka86: checks 
*** TURN *** [Ks Kd 4c] [Js]
jakub249: checks 
mycka86: checks 
*** RIVER *** [Ks Kd 4c Js] [Jd]
jakub249: checks 
mycka86: checks 
*** SHOW DOWN ***
jakub249: shows [7s 7c] (two pair, Kings and Jacks)
mycka86: shows [Ah Qc] (two pair, Kings and Jacks - Ace kicker)
mycka86 collected $7.60 from pot
*** SUMMARY ***
Total pot $8 | Rake $0.40 
Board [Ks Kd 4c Js Jd]
Seat 1: mycka86 (big blind) showed [Ah Qc] and won ($7.60) with two pair, Kings and Jacks
Seat 3: matiko09 folded before Flop (didn't bet)
Seat 4: CoolFireX folded before Flop (didn't bet)
Seat 5: butcheN18 folded before Flop (didn't bet)
Seat 6: andrewtomaz folded before Flop (didn't bet)
Seat 7: AlKatrone folded before Flop (didn't bet)
Seat 8: ruslik_by (button) folded before Flop (didn't bet)
Seat 9: jakub249 (small blind) showed [7s 7c] and lost with two pair, Kings and Jacks





PokerStars Hand #154797850911:  Hold'em No Limit ($0.50/$1.00 USD) - 2016/06/16 9:36:01 CET [2016/06/16 3:36:01 ET]
Table 'Hercynia II' 9-max Seat #6 is the button
Seat 1: flk.Dasas ($100 in chips) 
Seat 2: hammerwife ($207.06 in chips) 
Seat 3: butcheN18 ($120.46 in chips) 
Seat 4: ruslik_by ($100 in chips) 
Seat 5: matiko09 ($100 in chips) 
Seat 6: CoolFireX ($100 in chips) 
Seat 7: ozone2003 ($103 in chips) 
Seat 8: mycka86 ($155.27 in chips) 
Seat 9: Juniorquiapo ($106.50 in chips) 
ozone2003: posts small blind $0.50
mycka86: posts big blind $1
*** HOLE CARDS ***
Dealt to matiko09 [Th 4d]
Juniorquiapo: folds 
flk.Dasas: folds 
hammerwife: folds 
butcheN18: raises $2 to $3
ruslik_by: folds 
matiko09: folds 
CoolFireX: calls $3
ozone2003: folds 
mycka86: calls $2
*** FLOP *** [5h 6d 8h]
mycka86: checks 
butcheN18: checks 
CoolFireX: checks 
*** TURN *** [5h 6d 8h] [4h]
mycka86: checks 
butcheN18: checks 
CoolFireX: checks 
*** RIVER *** [5h 6d 8h 4h] [6s]
mycka86: checks 
butcheN18: checks 
CoolFireX: checks 
*** SHOW DOWN ***
mycka86: shows [As 3s] (a pair of Sixes)
butcheN18: mucks hand 
CoolFireX: mucks hand 
mycka86 collected $9.02 from pot
*** SUMMARY ***
Total pot $9.50 | Rake $0.48 
Board [5h 6d 8h 4h 6s]
Seat 1: flk.Dasas folded before Flop (didn't bet)
Seat 2: hammerwife folded before Flop (didn't bet)
Seat 3: butcheN18 mucked [Ts 9s]
Seat 4: ruslik_by folded before Flop (didn't bet)
Seat 5: matiko09 folded before Flop (didn't bet)
Seat 6: CoolFireX (button) mucked [Kd Qs]
Seat 7: ozone2003 (small blind) folded before Flop
Seat 8: mycka86 (big blind) showed [As 3s] and won ($9.02) with a pair of Sixes
Seat 9: Juniorquiapo folded before Flop (didn't bet)





PokerStars Hand #154797853303:  Hold'em No Limit ($0.25/$0.50 USD) - 2016/06/16 9:36:10 CET [2016/06/16 3:36:10 ET]
Table 'Gaea' 9-max Seat #1 is the button
Seat 1: jasonhan416 ($55.05 in chips) 
Seat 2: magzi777 ($50 in chips) 
Seat 4: matiko09 ($70.77 in chips) 
Seat 5: Kapa09 ($51.25 in chips) 
Seat 6: Alex Frider ($61.62 in chips) 
Seat 8: Red_Warning ($50 in chips) 
Seat 9: Prophet1906 ($58.40 in chips) 
magzi777: posts small blind $0.25
Crazyfish87: is sitting out 
matiko09: posts big blind $0.50
Dantist1122: sits out 
*** HOLE CARDS ***
Dealt to matiko09 [4h 3d]
Kapa09: folds 
Alex Frider: folds 
Red_Warning: folds 
Prophet1906: raises $1 to $1.50
jasonhan416: calls $1.50
magzi777: folds 
matiko09: folds 
*** FLOP *** [Ad 4c 5h]
Prophet1906: bets $1.75
jasonhan416: folds 
Uncalled bet ($1.75) returned to Prophet1906
Prophet1906 collected $3.56 from pot
Prophet1906: doesn't show hand 
*** SUMMARY ***
Total pot $3.75 | Rake $0.19 
Board [Ad 4c 5h]
Seat 1: jasonhan416 (button) folded on the Flop
Seat 2: magzi777 (small blind) folded before Flop
Seat 4: matiko09 (big blind) folded before Flop
Seat 5: Kapa09 folded before Flop (didn't bet)
Seat 6: Alex Frider folded before Flop (didn't bet)
Seat 8: Red_Warning folded before Flop (didn't bet)
Seat 9: Prophet1906 collected ($3.56)





PokerStars Hand #154797853689:  Hold'em No Limit ($0.50/$1.00 USD) - 2016/06/16 9:36:12 CET [2016/06/16 3:36:12 ET]
Table 'Alekto' 9-max Seat #1 is the button
Seat 1: mycka86 ($100 in chips) 
Seat 2: brotas232323 ($99.20 in chips) 
Seat 3: butcheN18 ($116.58 in chips) 
Seat 4: hammerwife ($128.69 in chips) 
Seat 5: matiko09 ($113.51 in chips) 
Seat 6: ilaviiitech ($122.31 in chips) 
Seat 7: flk.Dasas ($101.32 in chips) 
Seat 8: ozone2003 ($100 in chips) 
Seat 9: ruslik_by ($100 in chips) 
brotas232323: posts small blind $0.50
butcheN18: posts big blind $1
*** HOLE CARDS ***
Dealt to matiko09 [3c 9s]
hammerwife: folds 
matiko09: folds 
ilaviiitech: folds 
flk.Dasas: folds 
ozone2003: raises $2 to $3
ruslik_by: calls $3
mycka86: folds 
brotas232323: folds 
butcheN18: folds 
*** FLOP *** [Ac Jh 4c]
ozone2003: checks 
ruslik_by: checks 
*** TURN *** [Ac Jh 4c] [2c]
ozone2003: checks 
ruslik_by: bets $2.42
ozone2003: calls $2.42
*** RIVER *** [Ac Jh 4c 2c] [Kc]
ozone2003: checks 
ruslik_by: checks 
*** SHOW DOWN ***
ozone2003: shows [8h 8c] (a flush, Ace high)
ruslik_by: mucks hand 
ozone2003 collected $11.72 from pot
*** SUMMARY ***
Total pot $12.34 | Rake $0.62 
Board [Ac Jh 4c 2c Kc]
Seat 1: mycka86 (button) folded before Flop (didn't bet)
Seat 2: brotas232323 (small blind) folded before Flop
Seat 3: butcheN18 (big blind) folded before Flop
Seat 4: hammerwife folded before Flop (didn't bet)
Seat 5: matiko09 folded before Flop (didn't bet)
Seat 6: ilaviiitech folded before Flop (didn't bet)
Seat 7: flk.Dasas folded before Flop (didn't bet)
Seat 8: ozone2003 showed [8h 8c] and won ($11.72) with a flush, Ace high
Seat 9: ruslik_by mucked [Qs Qd]





PokerStars Hand #154797858064:  Hold'em No Limit ($0.50/$1.00 USD) - 2016/06/16 9:36:28 CET [2016/06/16 3:36:28 ET]
Table 'Astyanax' 9-max Seat #9 is the button
Seat 1: pokerich462 ($194.09 in chips) 
Seat 2: matiko09 ($100 in chips) 
Seat 3: hammerwife ($116.14 in chips) 
Seat 4: teerajaja ($100 in chips) 
Seat 5: butcheN18 ($104.50 in chips) 
Seat 6: Dantist1122 ($132.84 in chips) 
Seat 7: flk.Dasas ($100 in chips) 
Seat 8: mycka86 ($100 in chips) 
Seat 9: CoolFireX ($103.14 in chips) 
pokerich462: posts small blind $0.50
matiko09: posts big blind $1
pokerich462: posts the ante $0.20
matiko09: posts the ante $0.20
hammerwife: posts the ante $0.20
teerajaja: posts the ante $0.20
butcheN18: posts the ante $0.20
Dantist1122: posts the ante $0.20
flk.Dasas: posts the ante $0.20
mycka86: posts the ante $0.20
CoolFireX: posts the ante $0.20
*** HOLE CARDS ***
Dealt to matiko09 [3d 9d]
hammerwife: folds 
teerajaja: folds 
butcheN18: raises $2 to $3
Dantist1122: raises $6 to $9
flk.Dasas: folds 
mycka86: folds 
CoolFireX: folds 
pokerich462: folds 
matiko09: folds 
butcheN18: calls $6
*** FLOP *** [5d 2d 3s]
butcheN18: checks 
Dantist1122: checks 
*** TURN *** [5d 2d 3s] [Qd]
butcheN18: checks 
Dantist1122: bets $11.13
butcheN18: calls $11.13
*** RIVER *** [5d 2d 3s Qd] [Th]
butcheN18: checks 
Dantist1122: checks 
*** SHOW DOWN ***
butcheN18: shows [Ts Tc] (three of a kind, Tens)
Dantist1122: mucks hand 
butcheN18 collected $41.38 from pot
*** SUMMARY ***
Total pot $43.56 | Rake $2.18 
Board [5d 2d 3s Qd Th]
Seat 1: pokerich462 (small blind) folded before Flop
Seat 2: matiko09 (big blind) folded before Flop
Seat 3: hammerwife folded before Flop (didn't bet)
Seat 4: teerajaja folded before Flop (didn't bet)
Seat 5: butcheN18 showed [Ts Tc] and won ($41.38) with three of a kind, Tens
Seat 6: Dantist1122 mucked [Qc Ac]
Seat 7: flk.Dasas folded before Flop (didn't bet)
Seat 8: mycka86 folded before Flop (didn't bet)
Seat 9: CoolFireX (button) folded before Flop (didn't bet)





PokerStars Hand #154797863518:  Hold'em No Limit ($0.25/$0.50 USD) - 2016/06/16 9:36:48 CET [2016/06/16 3:36:48 ET]
Table 'Gaea' 9-max Seat #2 is the button
Seat 1: jasonhan416 ($53.55 in chips) 
Seat 2: magzi777 ($50 in chips) 
Seat 4: matiko09 ($70.27 in chips) 
Seat 5: Kapa09 ($51.25 in chips) 
Seat 6: Alex Frider ($61.62 in chips) 
Seat 8: Red_Warning ($50 in chips) 
Seat 9: Prophet1906 ($60.46 in chips) 
Crazyfish87 will be allowed to play after the button
matiko09: posts small blind $0.25
Kapa09: posts big blind $0.50
Dantist1122: sits out 
*** HOLE CARDS ***
Dealt to matiko09 [Qd 7c]
Alex Frider: folds 
Red_Warning: folds 
Prophet1906: folds 
jasonhan416: folds 
magzi777: raises $0.75 to $1.25
matiko09: folds 
Kapa09: folds 
Uncalled bet ($0.75) returned to magzi777
magzi777 collected $1.25 from pot
magzi777: doesn't show hand 
*** SUMMARY ***
Total pot $1.25 | Rake $0 
Seat 1: jasonhan416 folded before Flop (didn't bet)
Seat 2: magzi777 (button) collected ($1.25)
Seat 4: matiko09 (small blind) folded before Flop
Seat 5: Kapa09 (big blind) folded before Flop
Seat 6: Alex Frider folded before Flop (didn't bet)
Seat 8: Red_Warning folded before Flop (didn't bet)
Seat 9: Prophet1906 folded before Flop (didn't bet)





PokerStars Hand #154797864462:  Hold'em No Limit ($0.50/$1.00 USD) - 2016/06/16 9:36:51 CET [2016/06/16 3:36:51 ET]
Table 'Stroobantia II' 9-max Seat #9 is the button
Seat 1: mycka86 ($103.60 in chips) 
Seat 2: Lipton20088 ($162.44 in chips) 
Seat 3: matiko09 ($100 in chips) 
Seat 4: CoolFireX ($105.55 in chips) 
Seat 5: butcheN18 ($101.50 in chips) 
Seat 6: andrewtomaz ($99 in chips) 
Seat 7: AlKatrone ($100 in chips) 
Seat 8: ruslik_by ($104.52 in chips) 
Seat 9: jakub249 ($86.50 in chips) 
mycka86: posts small blind $0.50
Lipton20088: posts big blind $1
*** HOLE CARDS ***
Dealt to matiko09 [5s 2s]
matiko09: folds 
CoolFireX: folds 
butcheN18: folds 
andrewtomaz: folds 
AlKatrone: folds 
ruslik_by: folds 
jakub249: folds 
mycka86: folds 
Uncalled bet ($0.50) returned to Lipton20088
Lipton20088 collected $1 from pot
Lipton20088: doesn't show hand 
*** SUMMARY ***
Total pot $1 | Rake $0 
Seat 1: mycka86 (small blind) folded before Flop
Seat 2: Lipton20088 (big blind) collected ($1)
Seat 3: matiko09 folded before Flop (didn't bet)
Seat 4: CoolFireX folded before Flop (didn't bet)
Seat 5: butcheN18 folded before Flop (didn't bet)
Seat 6: andrewtomaz folded before Flop (didn't bet)
Seat 7: AlKatrone folded before Flop (didn't bet)
Seat 8: ruslik_by folded before Flop (didn't bet)
Seat 9: jakub249 (button) folded before Flop (didn't bet)





PokerStars Hand #154797866251:  Hold'em No Limit ($0.25/$0.50 USD) - 2016/06/16 9:36:58 CET [2016/06/16 3:36:58 ET]
Table 'Mekbuda II' 9-max Seat #2 is the button
Seat 1: matiko09 ($50 in chips) 
Seat 2: tibi_c87 ($50 in chips) 
Seat 3: Kapa09 ($50 in chips) 
Seat 4: Vvalrond ($34.48 in chips) 
Seat 5: teerajaja ($50 in chips) 
Seat 6: Dantist1122 ($55.71 in chips) 
Seat 8: WKBelinda ($88.19 in chips) 
Seat 9: Alex Frider ($56.26 in chips) 
Kapa09: posts small blind $0.25
Vvalrond: posts big blind $0.50
Lipton20088: sits out 
*** HOLE CARDS ***
Dealt to matiko09 [Ks Qd]
teerajaja: folds 
Dantist1122: folds 
WKBelinda: calls $0.50
Alex Frider: folds 
matiko09: raises $1.50 to $2
tibi_c87: folds 
Kapa09: folds 
Vvalrond: folds 
WKBelinda: calls $1.50
*** FLOP *** [Ad 2d 2s]
WKBelinda: checks 
matiko09: checks 
*** TURN *** [Ad 2d 2s] [7h]
WKBelinda: bets $2.50
matiko09: folds 
Uncalled bet ($2.50) returned to WKBelinda
WKBelinda collected $4.51 from pot
WKBelinda: doesn't show hand 
*** SUMMARY ***
Total pot $4.75 | Rake $0.24 
Board [Ad 2d 2s 7h]
Seat 1: matiko09 folded on the Turn
Seat 2: tibi_c87 (button) folded before Flop (didn't bet)
Seat 3: Kapa09 (small blind) folded before Flop
Seat 4: Vvalrond (big blind) folded before Flop
Seat 5: teerajaja folded before Flop (didn't bet)
Seat 6: Dantist1122 folded before Flop (didn't bet)
Seat 8: WKBelinda collected ($4.51)
Seat 9: Alex Frider folded before Flop (didn't bet)





PokerStars Hand #154797870164:  Hold'em No Limit ($0.50/$1.00 USD) - 2016/06/16 9:37:12 CET [2016/06/16 3:37:12 ET]
Table 'Alekto' 9-max Seat #2 is the button
Seat 1: mycka86 ($100 in chips) 
Seat 2: brotas232323 ($98.70 in chips) 
Seat 3: butcheN18 ($115.58 in chips) 
Seat 4: hammerwife ($128.69 in chips) 
Seat 5: matiko09 ($113.51 in chips) 
Seat 6: ilaviiitech ($122.31 in chips) 
Seat 7: flk.Dasas ($101.32 in chips) 
Seat 8: ozone2003 ($106.30 in chips) 
Seat 9: ruslik_by ($100 in chips) 
butcheN18: posts small blind $0.50
hammerwife: posts big blind $1
*** HOLE CARDS ***
Dealt to matiko09 [Qc Js]
matiko09: folds 
ilaviiitech: folds 
flk.Dasas: folds 
ozone2003: folds 
ruslik_by: folds 
mycka86: folds 
brotas232323: calls $1
butcheN18: folds 
hammerwife: checks 
*** FLOP *** [7c 8d 2s]
hammerwife: checks 
brotas232323: checks 
*** TURN *** [7c 8d 2s] [Ah]
hammerwife: checks 
brotas232323: bets $1
hammerwife: folds 
Uncalled bet ($1) returned to brotas232323
brotas232323 collected $2.38 from pot
brotas232323: doesn't show hand 
*** SUMMARY ***
Total pot $2.50 | Rake $0.12 
Board [7c 8d 2s Ah]
Seat 1: mycka86 folded before Flop (didn't bet)
Seat 2: brotas232323 (button) collected ($2.38)
Seat 3: butcheN18 (small blind) folded before Flop
Seat 4: hammerwife (big blind) folded on the Turn
Seat 5: matiko09 folded before Flop (didn't bet)
Seat 6: ilaviiitech folded before Flop (didn't bet)
Seat 7: flk.Dasas folded before Flop (didn't bet)
Seat 8: ozone2003 folded before Flop (didn't bet)
Seat 9: ruslik_by folded before Flop (didn't bet)





PokerStars Hand #154797873064:  Hold'em No Limit ($0.50/$1.00 USD) - 2016/06/16 9:37:22 CET [2016/06/16 3:37:22 ET]
Table 'Stroobantia II' 9-max Seat #1 is the button
Seat 1: mycka86 ($103.10 in chips) 
Seat 2: Lipton20088 ($162.94 in chips) 
Seat 3: matiko09 ($100 in chips) 
Seat 4: CoolFireX ($105.55 in chips) 
Seat 5: butcheN18 ($101.50 in chips) 
Seat 6: andrewtomaz ($99 in chips) 
Seat 7: AlKatrone ($100 in chips) 
Seat 8: ruslik_by ($104.52 in chips) 
Seat 9: jakub249 ($86.50 in chips) 
Lipton20088: posts small blind $0.50
matiko09: posts big blind $1
*** HOLE CARDS ***
Dealt to matiko09 [8h 5s]
CoolFireX: raises $2 to $3
butcheN18: folds 
andrewtomaz: folds 
AlKatrone: raises $6 to $9
ruslik_by: folds 
jakub249: folds 
mycka86: folds 
Lipton20088: folds 
matiko09: folds 
CoolFireX: folds 
Uncalled bet ($6) returned to AlKatrone
AlKatrone collected $7.50 from pot
*** SUMMARY ***
Total pot $7.50 | Rake $0 
Seat 1: mycka86 (button) folded before Flop (didn't bet)
Seat 2: Lipton20088 (small blind) folded before Flop
Seat 3: matiko09 (big blind) folded before Flop
Seat 4: CoolFireX folded before Flop
Seat 5: butcheN18 folded before Flop (didn't bet)
Seat 6: andrewtomaz folded before Flop (didn't bet)
Seat 7: AlKatrone collected ($7.50)
Seat 8: ruslik_by folded before Flop (didn't bet)
Seat 9: jakub249 folded before Flop (didn't bet)





PokerStars Hand #154797874142:  Hold'em No Limit ($0.50/$1.00 USD) - 2016/06/16 9:37:26 CET [2016/06/16 3:37:26 ET]
Table 'Markab II' 9-max Seat #9 is the button
Seat 1: AlKatrone ($102.42 in chips) 
Seat 2: mycka86 ($100 in chips) 
Seat 3: f4life1521 ($85.89 in chips) 
Seat 4: ruslik_by ($200.12 in chips) 
Seat 6: butcheN18 ($198.36 in chips) 
Seat 7: matiko09 ($107.25 in chips) 
Seat 8: CoolFireX ($151.20 in chips) 
Seat 9: greyman571 ($97.27 in chips) 
AlKatrone: posts small blind $0.50
mycka86: posts big blind $1
maxxmeister: sits out 
*** HOLE CARDS ***
Dealt to matiko09 [9c Ah]
f4life1521: folds 
ruslik_by: folds 
butcheN18: folds 
matiko09: folds 
CoolFireX: folds 
greyman571: raises $2 to $3
AlKatrone: folds 
mycka86: calls $2
*** FLOP *** [7c 6s 5h]
mycka86: checks 
greyman571: bets $3.09
mycka86: calls $3.09
*** TURN *** [7c 6s 5h] [9s]
mycka86: checks 
greyman571: checks 
*** RIVER *** [7c 6s 5h 9s] [2h]
mycka86: bets $8.40
greyman571: calls $8.40
*** SHOW DOWN ***
mycka86: shows [4h Qh] (high card Queen)
greyman571: shows [2c 2s] (three of a kind, Deuces)
greyman571 collected $28.01 from pot
*** SUMMARY ***
Total pot $29.48 | Rake $1.47 
Board [7c 6s 5h 9s 2h]
Seat 1: AlKatrone (small blind) folded before Flop
Seat 2: mycka86 (big blind) showed [4h Qh] and lost with high card Queen
Seat 3: f4life1521 folded before Flop (didn't bet)
Seat 4: ruslik_by folded before Flop (didn't bet)
Seat 6: butcheN18 folded before Flop (didn't bet)
Seat 7: matiko09 folded before Flop (didn't bet)
Seat 8: CoolFireX folded before Flop (didn't bet)
Seat 9: greyman571 (button) showed [2c 2s] and won ($28.01) with three of a kind, Deuces





PokerStars Hand #154797874352:  Hold'em No Limit ($0.25/$0.50 USD) - 2016/06/16 9:37:27 CET [2016/06/16 3:37:27 ET]
Table 'Gaea' 9-max Seat #4 is the button
Seat 1: jasonhan416 ($53.55 in chips) 
Seat 2: magzi777 ($50.75 in chips) 
Seat 4: matiko09 ($70.02 in chips) 
Seat 5: Kapa09 ($50.75 in chips) 
Seat 6: Alex Frider ($61.62 in chips) 
Seat 8: Red_Warning ($50 in chips) 
Seat 9: Prophet1906 ($60.46 in chips) 
Kapa09: posts small blind $0.25
Alex Frider: posts big blind $0.50
Dantist1122: sits out 
Crazyfish87: sits out 
*** HOLE CARDS ***
Dealt to matiko09 [5s 6d]
Red_Warning: folds 
Prophet1906: folds 
jasonhan416: calls $0.50
magzi777: folds 
matiko09: folds 
Kapa09: folds 
Alex Frider: raises $1.75 to $2.25
jasonhan416: calls $1.75
*** FLOP *** [6h 8s 8c]
Alex Frider: bets $3.25
jasonhan416: calls $3.25
*** TURN *** [6h 8s 8c] [3s]
Alex Frider: checks 
jasonhan416: checks 
*** RIVER *** [6h 8s 8c 3s] [4c]
Alex Frider: checks 
jasonhan416: checks 
*** SHOW DOWN ***
Alex Frider: shows [Jd As] (a pair of Eights)
jasonhan416: mucks hand 
Alex Frider collected $10.69 from pot
*** SUMMARY ***
Total pot $11.25 | Rake $0.56 
Board [6h 8s 8c 3s 4c]
Seat 1: jasonhan416 mucked [9s Th]
Seat 2: magzi777 folded before Flop (didn't bet)
Seat 4: matiko09 (button) folded before Flop (didn't bet)
Seat 5: Kapa09 (small blind) folded before Flop
Seat 6: Alex Frider (big blind) showed [Jd As] and won ($10.69) with a pair of Eights
Seat 8: Red_Warning folded before Flop (didn't bet)
Seat 9: Prophet1906 folded before Flop (didn't bet)





PokerStars Hand #154797878172:  Hold'em No Limit ($0.25/$0.50 USD) - 2016/06/16 9:37:41 CET [2016/06/16 3:37:41 ET]
Table 'Mekbuda II' 9-max Seat #3 is the button
Seat 1: matiko09 ($50 in chips) 
Seat 2: tibi_c87 ($50 in chips) 
Seat 3: Kapa09 ($49.75 in chips) 
Seat 4: Vvalrond ($33.98 in chips) 
Seat 5: teerajaja ($50 in chips) 
Seat 6: Dantist1122 ($55.71 in chips) 
Seat 8: WKBelinda ($90.70 in chips) 
Seat 9: Alex Frider ($56.26 in chips) 
Vvalrond: posts small blind $0.25
teerajaja: posts big blind $0.50
Lipton20088: sits out 
*** HOLE CARDS ***
Dealt to matiko09 [3s Ah]
Dantist1122: raises $1 to $1.50
WKBelinda: calls $1.50
Alex Frider: folds 
matiko09: folds 
tibi_c87: folds 
Kapa09: folds 
Vvalrond: calls $1.25
teerajaja: folds 
*** FLOP *** [4s Kd As]
Vvalrond: bets $2
Dantist1122: folds 
WKBelinda: folds 
Uncalled bet ($2) returned to Vvalrond
Vvalrond collected $4.75 from pot
Vvalrond: doesn't show hand 
*** SUMMARY ***
Total pot $5 | Rake $0.25 
Board [4s Kd As]
Seat 1: matiko09 folded before Flop (didn't bet)
Seat 2: tibi_c87 folded before Flop (didn't bet)
Seat 3: Kapa09 (button) folded before Flop (didn't bet)
Seat 4: Vvalrond (small blind) collected ($4.75)
Seat 5: teerajaja (big blind) folded before Flop
Seat 6: Dantist1122 folded on the Flop
Seat 8: WKBelinda folded on the Flop
Seat 9: Alex Frider folded before Flop (didn't bet)





PokerStars Hand #154797881549:  Hold'em No Limit ($0.50/$1.00 USD) - 2016/06/16 9:37:53 CET [2016/06/16 3:37:53 ET]
Table 'Astyanax' 9-max Seat #1 is the button
Seat 1: pokerich462 ($193.39 in chips) 
Seat 2: matiko09 ($100 in chips) 
Seat 3: hammerwife ($115.94 in chips) 
Seat 4: teerajaja ($100 in chips) 
Seat 5: butcheN18 ($125.55 in chips) 
Seat 6: Dantist1122 ($112.51 in chips) 
Seat 7: flk.Dasas ($100 in chips) 
Seat 8: mycka86 ($100 in chips) 
Seat 9: CoolFireX ($102.94 in chips) 
matiko09: posts small blind $0.50
hammerwife: posts big blind $1
pokerich462: posts the ante $0.20
matiko09: posts the ante $0.20
hammerwife: posts the ante $0.20
teerajaja: posts the ante $0.20
butcheN18: posts the ante $0.20
Dantist1122: posts the ante $0.20
flk.Dasas: posts the ante $0.20
mycka86: posts the ante $0.20
CoolFireX: posts the ante $0.20
*** HOLE CARDS ***
Dealt to matiko09 [Qh 7h]
teerajaja: folds 
butcheN18: folds 
Dantist1122: folds 
flk.Dasas: raises $3 to $4
mycka86: folds 
CoolFireX: folds 
pokerich462: folds 
matiko09: folds 
hammerwife: calls $3
*** FLOP *** [Th 5d Ah]
hammerwife: checks 
flk.Dasas: checks 
*** TURN *** [Th 5d Ah] [8c]
hammerwife: bets $7.50
flk.Dasas: folds 
Uncalled bet ($7.50) returned to hammerwife
hammerwife collected $9.78 from pot
hammerwife: doesn't show hand 
*** SUMMARY ***
Total pot $10.30 | Rake $0.52 
Board [Th 5d Ah 8c]
Seat 1: pokerich462 (button) folded before Flop (didn't bet)
Seat 2: matiko09 (small blind) folded before Flop
Seat 3: hammerwife (big blind) collected ($9.78)
Seat 4: teerajaja folded before Flop (didn't bet)
Seat 5: butcheN18 folded before Flop (didn't bet)
Seat 6: Dantist1122 folded before Flop (didn't bet)
Seat 7: flk.Dasas folded on the Turn
Seat 8: mycka86 folded before Flop (didn't bet)
Seat 9: CoolFireX folded before Flop (didn't bet)





PokerStars Hand #154797883707:  Hold'em No Limit ($0.50/$1.00 USD) - 2016/06/16 9:38:01 CET [2016/06/16 3:38:01 ET]
Table 'Alekto' 9-max Seat #3 is the button
Seat 1: mycka86 ($100 in chips) 
Seat 2: brotas232323 ($100.08 in chips) 
Seat 3: butcheN18 ($115.08 in chips) 
Seat 4: hammerwife ($127.69 in chips) 
Seat 5: matiko09 ($113.51 in chips) 
Seat 6: ilaviiitech ($122.31 in chips) 
Seat 7: flk.Dasas ($101.32 in chips) 
Seat 8: ozone2003 ($106.30 in chips) 
Seat 9: ruslik_by ($100 in chips) 
hammerwife: posts small blind $0.50
matiko09: posts big blind $1
*** HOLE CARDS ***
Dealt to matiko09 [9d Jd]
ilaviiitech: folds 
flk.Dasas: folds 
ozone2003: raises $2 to $3
ruslik_by: folds 
mycka86: folds 
brotas232323: folds 
butcheN18: folds 
hammerwife: folds 
matiko09: folds 
Uncalled bet ($2) returned to ozone2003
ozone2003 collected $2.50 from pot
ozone2003: doesn't show hand 
*** SUMMARY ***
Total pot $2.50 | Rake $0 
Seat 1: mycka86 folded before Flop (didn't bet)
Seat 2: brotas232323 folded before Flop (didn't bet)
Seat 3: butcheN18 (button) folded before Flop (didn't bet)
Seat 4: hammerwife (small blind) folded before Flop
Seat 5: matiko09 (big blind) folded before Flop
Seat 6: ilaviiitech folded before Flop (didn't bet)
Seat 7: flk.Dasas folded before Flop (didn't bet)
Seat 8: ozone2003 collected ($2.50)
Seat 9: ruslik_by folded before Flop (didn't bet)





PokerStars Hand #154797884677:  Hold'em No Limit ($0.50/$1.00 USD) - 2016/06/16 9:38:04 CET [2016/06/16 3:38:04 ET]
Table 'Hercynia II' 9-max Seat #7 is the button
Seat 1: flk.Dasas ($100 in chips) 
Seat 2: hammerwife ($207.06 in chips) 
Seat 3: butcheN18 ($117.46 in chips) 
Seat 4: ruslik_by ($100 in chips) 
Seat 5: matiko09 ($100 in chips) 
Seat 6: CoolFireX ($100 in chips) 
Seat 7: ozone2003 ($102.50 in chips) 
Seat 8: mycka86 ($161.29 in chips) 
Seat 9: Juniorquiapo ($106.50 in chips) 
mycka86: posts small blind $0.50
Juniorquiapo: posts big blind $1
*** HOLE CARDS ***
Dealt to matiko09 [8s Jh]
flk.Dasas: folds 
hammerwife: raises $2 to $3
butcheN18: folds 
ruslik_by: folds 
matiko09: folds 
CoolFireX: calls $3
ozone2003: raises $6 to $9
mycka86: folds 
Juniorquiapo: folds 
hammerwife: calls $6
CoolFireX: calls $6
*** FLOP *** [Td 2c Kd]
hammerwife: checks 
CoolFireX: checks 
ozone2003: bets $17.60
hammerwife: folds 
CoolFireX: folds 
Uncalled bet ($17.60) returned to ozone2003
ozone2003 collected $27.08 from pot
ozone2003: doesn't show hand 
*** SUMMARY ***
Total pot $28.50 | Rake $1.42 
Board [Td 2c Kd]
Seat 1: flk.Dasas folded before Flop (didn't bet)
Seat 2: hammerwife folded on the Flop
Seat 3: butcheN18 folded before Flop (didn't bet)
Seat 4: ruslik_by folded before Flop (didn't bet)
Seat 5: matiko09 folded before Flop (didn't bet)
Seat 6: CoolFireX folded on the Flop
Seat 7: ozone2003 (button) collected ($27.08)
Seat 8: mycka86 (small blind) folded before Flop
Seat 9: Juniorquiapo (big blind) folded before Flop





PokerStars Hand #154797886276:  Hold'em No Limit ($0.50/$1.00 USD) - 2016/06/16 9:38:10 CET [2016/06/16 3:38:10 ET]
Table 'Stroobantia II' 9-max Seat #2 is the button
Seat 1: mycka86 ($103.10 in chips) 
Seat 2: Lipton20088 ($162.44 in chips) 
Seat 3: matiko09 ($100 in chips) 
Seat 4: CoolFireX ($102.55 in chips) 
Seat 5: butcheN18 ($101.50 in chips) 
Seat 6: andrewtomaz ($99 in chips) 
Seat 7: AlKatrone ($104.50 in chips) 
Seat 8: ruslik_by ($104.52 in chips) 
Seat 9: jakub249 ($86.50 in chips) 
matiko09: posts small blind $0.50
CoolFireX: posts big blind $1
*** HOLE CARDS ***
Dealt to matiko09 [4d 9s]
butcheN18: folds 
andrewtomaz: folds 
AlKatrone: folds 
ruslik_by: folds 
jakub249: folds 
mycka86: folds 
Lipton20088: folds 
matiko09: folds 
Uncalled bet ($0.50) returned to CoolFireX
CoolFireX collected $1 from pot
CoolFireX: doesn't show hand 
*** SUMMARY ***
Total pot $1 | Rake $0 
Seat 1: mycka86 folded before Flop (didn't bet)
Seat 2: Lipton20088 (button) folded before Flop (didn't bet)
Seat 3: matiko09 (small blind) folded before Flop
Seat 4: CoolFireX (big blind) collected ($1)
Seat 5: butcheN18 folded before Flop (didn't bet)
Seat 6: andrewtomaz folded before Flop (didn't bet)
Seat 7: AlKatrone folded before Flop (didn't bet)
Seat 8: ruslik_by folded before Flop (didn't bet)
Seat 9: jakub249 folded before Flop (didn't bet)





PokerStars Hand #154797890746:  Hold'em No Limit ($0.50/$1.00 USD) - 2016/06/16 9:38:26 CET [2016/06/16 3:38:26 ET]
Table 'Markab II' 9-max Seat #1 is the button
Seat 1: AlKatrone ($101.92 in chips) 
Seat 2: mycka86 ($100 in chips) 
Seat 3: f4life1521 ($85.89 in chips) 
Seat 4: ruslik_by ($200.12 in chips) 
Seat 6: butcheN18 ($198.36 in chips) 
Seat 7: matiko09 ($107.25 in chips) 
Seat 8: CoolFireX ($151.20 in chips) 
Seat 9: greyman571 ($110.79 in chips) 
mycka86: posts small blind $0.50
f4life1521: posts big blind $1
maxxmeister: sits out 
*** HOLE CARDS ***
Dealt to matiko09 [Ah 5h]
ruslik_by: folds 
butcheN18: raises $2 to $3
matiko09: folds 
CoolFireX: folds 
greyman571: folds 
AlKatrone: folds 
mycka86: folds 
f4life1521: folds 
Uncalled bet ($2) returned to butcheN18
butcheN18 collected $2.50 from pot
butcheN18: doesn't show hand 
*** SUMMARY ***
Total pot $2.50 | Rake $0 
Seat 1: AlKatrone (button) folded before Flop (didn't bet)
Seat 2: mycka86 (small blind) folded before Flop
Seat 3: f4life1521 (big blind) folded before Flop
Seat 4: ruslik_by folded before Flop (didn't bet)
Seat 6: butcheN18 collected ($2.50)
Seat 7: matiko09 folded before Flop (didn't bet)
Seat 8: CoolFireX folded before Flop (didn't bet)
Seat 9: greyman571 folded before Flop (didn't bet)





PokerStars Hand #154797891539:  Hold'em No Limit ($0.50/$1.00 USD) - 2016/06/16 9:38:29 CET [2016/06/16 3:38:29 ET]
Table 'Alekto' 9-max Seat #4 is the button
Seat 1: mycka86 ($100 in chips) 
Seat 2: brotas232323 ($100.08 in chips) 
Seat 3: butcheN18 ($115.08 in chips) 
Seat 4: hammerwife ($127.19 in chips) 
Seat 5: matiko09 ($112.51 in chips) 
Seat 6: ilaviiitech ($122.31 in chips) 
Seat 7: flk.Dasas ($101.32 in chips) 
Seat 8: ozone2003 ($107.80 in chips) 
Seat 9: ruslik_by ($100 in chips) 
matiko09: posts small blind $0.50
ilaviiitech: posts big blind $1
*** HOLE CARDS ***
Dealt to matiko09 [Qc 5h]
flk.Dasas: folds 
ozone2003: folds 
ruslik_by: folds 
mycka86: folds 
brotas232323: folds 
butcheN18: raises $1.44 to $2.44
hammerwife: folds 
matiko09: folds 
ilaviiitech: folds 
Uncalled bet ($1.44) returned to butcheN18
butcheN18 collected $2.50 from pot
butcheN18: doesn't show hand 
*** SUMMARY ***
Total pot $2.50 | Rake $0 
Seat 1: mycka86 folded before Flop (didn't bet)
Seat 2: brotas232323 folded before Flop (didn't bet)
Seat 3: butcheN18 collected ($2.50)
Seat 4: hammerwife (button) folded before Flop (didn't bet)
Seat 5: matiko09 (small blind) folded before Flop
Seat 6: ilaviiitech (big blind) folded before Flop
Seat 7: flk.Dasas folded before Flop (didn't bet)
Seat 8: ozone2003 folded before Flop (didn't bet)
Seat 9: ruslik_by folded before Flop (didn't bet)





PokerStars Hand #154797891594:  Hold'em No Limit ($0.50/$1.00 USD) - 2016/06/16 9:38:29 CET [2016/06/16 3:38:29 ET]
Table 'Nuki' 9-max Seat #1 is the button
Seat 1: Sreshta222 ($40 in chips) 
Seat 2: TideHan ($100 in chips) 
Seat 3: matiko09 ($100 in chips) 
Seat 8: Marcelek_El ($79.19 in chips) 
Seat 9: maxxmeister ($100 in chips) 
TideHan: posts small blind $0.50
matiko09: posts big blind $1
*** HOLE CARDS ***
Dealt to matiko09 [As 3h]
Marcelek_El: folds 
ruslik_by joins the table at seat #7 
teerajaja joins the table at seat #4 
maxxmeister: raises $2 to $3
Sreshta222: folds 
TideHan: folds 
matiko09: folds 
Uncalled bet ($2) returned to maxxmeister
maxxmeister collected $2.50 from pot
maxxmeister: doesn't show hand 
*** SUMMARY ***
Total pot $2.50 | Rake $0 
Seat 1: Sreshta222 (button) folded before Flop (didn't bet)
Seat 2: TideHan (small blind) folded before Flop
Seat 3: matiko09 (big blind) folded before Flop
Seat 8: Marcelek_El folded before Flop (didn't bet)
Seat 9: maxxmeister collected ($2.50)





PokerStars Hand #154797894368:  Hold'em No Limit ($0.25/$0.50 USD) - 2016/06/16 9:38:39 CET [2016/06/16 3:38:39 ET]
Table 'Mekbuda II' 9-max Seat #4 is the button
Seat 1: matiko09 ($50 in chips) 
Seat 2: tibi_c87 ($50 in chips) 
Seat 3: Kapa09 ($49.75 in chips) 
Seat 4: Vvalrond ($37.23 in chips) 
Seat 5: teerajaja ($50 in chips) 
Seat 6: Dantist1122 ($54.21 in chips) 
Seat 8: WKBelinda ($89.20 in chips) 
Seat 9: Alex Frider ($56.26 in chips) 
teerajaja: posts small blind $0.25
Dantist1122: posts big blind $0.50
Lipton20088: sits out 
*** HOLE CARDS ***
Dealt to matiko09 [Th 5c]
WKBelinda: folds 
Alex Frider: raises $0.75 to $1.25
matiko09: folds 
tibi_c87: folds 
Kapa09: folds 
Vvalrond: calls $1.25
teerajaja: folds 
Dantist1122: calls $0.75
*** FLOP *** [4s 3h 2h]
Dantist1122: bets $2.47
Alex Frider: calls $2.47
Vvalrond: folds 
*** TURN *** [4s 3h 2h] [5h]
Dantist1122: bets $6.75
Alex Frider: calls $6.75
*** RIVER *** [4s 3h 2h 5h] [5d]
Dantist1122: checks 
Alex Frider: bets $10.66
Dantist1122: calls $10.66
*** SHOW DOWN ***
Alex Frider: shows [6c 6s] (a straight, Deuce to Six)
Dantist1122: shows [9h 6h] (a flush, Nine high)
Dantist1122 collected $41.76 from pot
*** SUMMARY ***
Total pot $43.76 | Rake $2 
Board [4s 3h 2h 5h 5d]
Seat 1: matiko09 folded before Flop (didn't bet)
Seat 2: tibi_c87 folded before Flop (didn't bet)
Seat 3: Kapa09 folded before Flop (didn't bet)
Seat 4: Vvalrond (button) folded on the Flop
Seat 5: teerajaja (small blind) folded before Flop
Seat 6: Dantist1122 (big blind) showed [9h 6h] and won ($41.76) with a flush, Nine high
Seat 8: WKBelinda folded before Flop (didn't bet)
Seat 9: Alex Frider showed [6c 6s] and lost with a straight, Deuce to Six





PokerStars Hand #154797894692:  Hold'em No Limit ($0.25/$0.50 USD) - 2016/06/16 9:38:41 CET [2016/06/16 3:38:41 ET]
Table 'Gaea' 9-max Seat #5 is the button
Seat 1: jasonhan416 ($48.05 in chips) 
Seat 2: magzi777 ($50.75 in chips) 
Seat 4: matiko09 ($70.02 in chips) 
Seat 5: Kapa09 ($50.50 in chips) 
Seat 6: Alex Frider ($66.81 in chips) 
Seat 7: Dantist1122 ($50 in chips) 
Seat 8: Red_Warning ($50 in chips) 
Seat 9: Prophet1906 ($60.46 in chips) 
Alex Frider: posts small blind $0.25
Dantist1122: posts big blind $0.50
Crazyfish87: sits out 
*** HOLE CARDS ***
Dealt to matiko09 [5d 9h]
Red_Warning: folds 
Prophet1906: folds 
jasonhan416: folds 
magzi777: folds 
matiko09: folds 
Kapa09: raises $0.75 to $1.25
Alex Frider: folds 
Dantist1122: folds 
Uncalled bet ($0.75) returned to Kapa09
Kapa09 collected $1.25 from pot
Kapa09: doesn't show hand 
*** SUMMARY ***
Total pot $1.25 | Rake $0 
Seat 1: jasonhan416 folded before Flop (didn't bet)
Seat 2: magzi777 folded before Flop (didn't bet)
Seat 4: matiko09 folded before Flop (didn't bet)
Seat 5: Kapa09 (button) collected ($1.25)
Seat 6: Alex Frider (small blind) folded before Flop
Seat 7: Dantist1122 (big blind) folded before Flop
Seat 8: Red_Warning folded before Flop (didn't bet)
Seat 9: Prophet1906 folded before Flop (didn't bet)





PokerStars Hand #154797896461:  Hold'em No Limit ($0.50/$1.00 USD) - 2016/06/16 9:38:47 CET [2016/06/16 3:38:47 ET]
Table 'Stroobantia II' 9-max Seat #3 is the button
Seat 1: mycka86 ($103.10 in chips) 
Seat 2: Lipton20088 ($162.44 in chips) 
Seat 3: matiko09 ($100 in chips) 
Seat 4: CoolFireX ($103.05 in chips) 
Seat 5: butcheN18 ($101.50 in chips) 
Seat 6: andrewtomaz ($99 in chips) 
Seat 7: AlKatrone ($104.50 in chips) 
Seat 8: ruslik_by ($104.52 in chips) 
Seat 9: jakub249 ($86.50 in chips) 
CoolFireX: posts small blind $0.50
butcheN18: posts big blind $1
*** HOLE CARDS ***
Dealt to matiko09 [3c Qc]
andrewtomaz said, "lights camera"
andrewtomaz: folds 
AlKatrone: folds 
andrewtomaz said, "nooo action"
ruslik_by: folds 
jakub249: folds 
mycka86: folds 
Lipton20088: folds 
matiko09: folds 
CoolFireX: folds 
Uncalled bet ($0.50) returned to butcheN18
butcheN18 collected $1 from pot
butcheN18: doesn't show hand 
*** SUMMARY ***
Total pot $1 | Rake $0 
Seat 1: mycka86 folded before Flop (didn't bet)
Seat 2: Lipton20088 folded before Flop (didn't bet)
Seat 3: matiko09 (button) folded before Flop (didn't bet)
Seat 4: CoolFireX (small blind) folded before Flop
Seat 5: butcheN18 (big blind) collected ($1)
Seat 6: andrewtomaz folded before Flop (didn't bet)
Seat 7: AlKatrone folded before Flop (didn't bet)
Seat 8: ruslik_by folded before Flop (didn't bet)
Seat 9: jakub249 folded before Flop (didn't bet)





PokerStars Hand #154797898705:  Hold'em No Limit ($0.50/$1.00 USD) - 2016/06/16 9:38:55 CET [2016/06/16 3:38:55 ET]
Table 'Nuki' 9-max Seat #2 is the button
Seat 1: Sreshta222 ($40 in chips) 
Seat 2: TideHan ($100 in chips) 
Seat 3: matiko09 ($100 in chips) 
Seat 4: teerajaja ($100 in chips) 
Seat 8: Marcelek_El ($79.19 in chips) 
Seat 9: maxxmeister ($101.50 in chips) 
matiko09: posts small blind $0.50
teerajaja: posts big blind $1
ruslik_by: sits out 
*** HOLE CARDS ***
Dealt to matiko09 [Jc 3h]
Marcelek_El: raises $2 to $3
maxxmeister: calls $3
Sreshta222: folds 
TideHan: folds 
matiko09: folds 
teerajaja: folds 
*** FLOP *** [6c 2d 4d]
Marcelek_El: bets $3
maxxmeister: folds 
Uncalled bet ($3) returned to Marcelek_El
Marcelek_El collected $7.12 from pot
Marcelek_El: doesn't show hand 
*** SUMMARY ***
Total pot $7.50 | Rake $0.38 
Board [6c 2d 4d]
Seat 1: Sreshta222 folded before Flop (didn't bet)
Seat 2: TideHan (button) folded before Flop (didn't bet)
Seat 3: matiko09 (small blind) folded before Flop
Seat 4: teerajaja (big blind) folded before Flop
Seat 8: Marcelek_El collected ($7.12)
Seat 9: maxxmeister folded on the Flop





PokerStars Hand #154797899903:  Hold'em No Limit ($0.50/$1.00 USD) - 2016/06/16 9:38:59 CET [2016/06/16 3:38:59 ET]
Table 'Markab II' 9-max Seat #2 is the button
Seat 1: AlKatrone ($101.92 in chips) 
Seat 2: mycka86 ($100 in chips) 
Seat 3: f4life1521 ($84.89 in chips) 
Seat 4: ruslik_by ($200.12 in chips) 
Seat 6: butcheN18 ($199.86 in chips) 
Seat 7: matiko09 ($107.25 in chips) 
Seat 8: CoolFireX ($151.20 in chips) 
Seat 9: greyman571 ($110.79 in chips) 
f4life1521: posts small blind $0.50
ruslik_by: posts big blind $1
maxxmeister: sits out 
*** HOLE CARDS ***
Dealt to matiko09 [8h 5c]
butcheN18: folds 
matiko09: folds 
CoolFireX: folds 
greyman571: raises $2 to $3
AlKatrone: folds 
mycka86: folds 
f4life1521: folds 
ruslik_by: raises $6.50 to $9.50
greyman571: calls $6.50
*** FLOP *** [Qd 3s Ts]
ruslik_by: bets $6.29
greyman571: raises $31.10 to $37.39
ruslik_by: folds 
Uncalled bet ($31.10) returned to greyman571
greyman571 collected $30.48 from pot
greyman571: doesn't show hand 
*** SUMMARY ***
Total pot $32.08 | Rake $1.60 
Board [Qd 3s Ts]
Seat 1: AlKatrone folded before Flop (didn't bet)
Seat 2: mycka86 (button) folded before Flop (didn't bet)
Seat 3: f4life1521 (small blind) folded before Flop
Seat 4: ruslik_by (big blind) folded on the Flop
Seat 6: butcheN18 folded before Flop (didn't bet)
Seat 7: matiko09 folded before Flop (didn't bet)
Seat 8: CoolFireX folded before Flop (didn't bet)
Seat 9: greyman571 collected ($30.48)





PokerStars Hand #154797900611:  Hold'em No Limit ($0.50/$1.00 USD) - 2016/06/16 9:39:02 CET [2016/06/16 3:39:02 ET]
Table 'Alekto' 9-max Seat #5 is the button
Seat 1: mycka86 ($100 in chips) 
Seat 2: brotas232323 ($100.08 in chips) 
Seat 3: butcheN18 ($116.58 in chips) 
Seat 4: hammerwife ($127.19 in chips) 
Seat 5: matiko09 ($112.01 in chips) 
Seat 6: ilaviiitech ($121.31 in chips) 
Seat 8: ozone2003 ($107.80 in chips) 
Seat 9: ruslik_by ($100 in chips) 
ilaviiitech: posts small blind $0.50
flk.Dasas: is sitting out 
ozone2003: posts big blind $1
*** HOLE CARDS ***
Dealt to matiko09 [4c 6c]
ruslik_by: folds 
mycka86: folds 
brotas232323: calls $1
butcheN18: calls $1
hammerwife: folds 
matiko09: folds 
ilaviiitech: folds 
ozone2003: raises $4 to $5
brotas232323: calls $4
butcheN18: calls $4
*** FLOP *** [Kd Js 2d]
ozone2003: checks 
brotas232323: checks 
butcheN18: checks 
*** TURN *** [Kd Js 2d] [6d]
ozone2003: bets $8.83
brotas232323: folds 
butcheN18: folds 
Uncalled bet ($8.83) returned to ozone2003
ozone2003 collected $14.72 from pot
ozone2003: doesn't show hand 
*** SUMMARY ***
Total pot $15.50 | Rake $0.78 
Board [Kd Js 2d 6d]
Seat 1: mycka86 folded before Flop (didn't bet)
Seat 2: brotas232323 folded on the Turn
Seat 3: butcheN18 folded on the Turn
Seat 4: hammerwife folded before Flop (didn't bet)
Seat 5: matiko09 (button) folded before Flop (didn't bet)
Seat 6: ilaviiitech (small blind) folded before Flop
Seat 8: ozone2003 (big blind) collected ($14.72)
Seat 9: ruslik_by folded before Flop (didn't bet)





PokerStars Hand #154797904368:  Hold'em No Limit ($0.25/$0.50 USD) - 2016/06/16 9:39:15 CET [2016/06/16 3:39:15 ET]
Table 'Gaea' 9-max Seat #6 is the button
Seat 1: jasonhan416 ($48.05 in chips) 
Seat 2: magzi777 ($50.75 in chips) 
Seat 4: matiko09 ($70.02 in chips) 
Seat 5: Kapa09 ($51.25 in chips) 
Seat 6: Alex Frider ($66.56 in chips) 
Seat 7: Dantist1122 ($50 in chips) 
Seat 8: Red_Warning ($50 in chips) 
Seat 9: Prophet1906 ($60.46 in chips) 
Dantist1122: posts small blind $0.25
Red_Warning: posts big blind $0.50
Crazyfish87: sits out 
*** HOLE CARDS ***
Dealt to matiko09 [Qc 7s]
Prophet1906: folds 
jasonhan416: raises $1 to $1.50
magzi777: raises $2.75 to $4.25
matiko09: folds 
Kapa09: folds 
Alex Frider: folds 
Dantist1122: folds 
Red_Warning: folds 
jasonhan416: calls $2.75
*** FLOP *** [4d Qd 9h]
jasonhan416: checks 
magzi777: bets $3.75
jasonhan416: folds 
Uncalled bet ($3.75) returned to magzi777
magzi777 collected $8.79 from pot
magzi777: doesn't show hand 
*** SUMMARY ***
Total pot $9.25 | Rake $0.46 
Board [4d Qd 9h]
Seat 1: jasonhan416 folded on the Flop
Seat 2: magzi777 collected ($8.79)
Seat 4: matiko09 folded before Flop (didn't bet)
Seat 5: Kapa09 folded before Flop (didn't bet)
Seat 6: Alex Frider (button) folded before Flop (didn't bet)
Seat 7: Dantist1122 (small blind) folded before Flop
Seat 8: Red_Warning (big blind) folded before Flop
Seat 9: Prophet1906 folded before Flop (didn't bet)





PokerStars Hand #154797908052:  Hold'em No Limit ($0.50/$1.00 USD) - 2016/06/16 9:39:29 CET [2016/06/16 3:39:29 ET]
Table 'Astyanax' 9-max Seat #2 is the button
Seat 1: pokerich462 ($193.19 in chips) 
Seat 2: matiko09 ($100 in chips) 
Seat 3: hammerwife ($121.52 in chips) 
Seat 4: teerajaja ($100 in chips) 
Seat 5: butcheN18 ($125.35 in chips) 
Seat 6: Dantist1122 ($112.31 in chips) 
Seat 7: flk.Dasas ($100 in chips) 
Seat 8: mycka86 ($100 in chips) 
Seat 9: CoolFireX ($102.74 in chips) 
hammerwife: posts small blind $0.50
teerajaja: posts big blind $1
pokerich462: posts the ante $0.20
matiko09: posts the ante $0.20
hammerwife: posts the ante $0.20
teerajaja: posts the ante $0.20
butcheN18: posts the ante $0.20
Dantist1122: posts the ante $0.20
flk.Dasas: posts the ante $0.20
mycka86: posts the ante $0.20
CoolFireX: posts the ante $0.20
*** HOLE CARDS ***
Dealt to matiko09 [2d 9d]
butcheN18: raises $2 to $3
Dantist1122: folds 
flk.Dasas: folds 
mycka86: folds 
CoolFireX: folds 
pokerich462: folds 
matiko09: folds 
hammerwife: folds 
teerajaja: folds 
Uncalled bet ($2) returned to butcheN18
butcheN18 collected $4.30 from pot
butcheN18: doesn't show hand 
*** SUMMARY ***
Total pot $4.30 | Rake $0 
Seat 1: pokerich462 folded before Flop (didn't bet)
Seat 2: matiko09 (button) folded before Flop (didn't bet)
Seat 3: hammerwife (small blind) folded before Flop
Seat 4: teerajaja (big blind) folded before Flop
Seat 5: butcheN18 collected ($4.30)
Seat 6: Dantist1122 folded before Flop (didn't bet)
Seat 7: flk.Dasas folded before Flop (didn't bet)
Seat 8: mycka86 folded before Flop (didn't bet)
Seat 9: CoolFireX folded before Flop (didn't bet)





PokerStars Hand #154797911104:  Hold'em No Limit ($0.50/$1.00 USD) - 2016/06/16 9:39:40 CET [2016/06/16 3:39:40 ET]
Table 'Nuki' 9-max Seat #3 is the button
Seat 1: Sreshta222 ($40 in chips) 
Seat 2: TideHan ($100 in chips) 
Seat 3: matiko09 ($100 in chips) 
Seat 4: teerajaja ($100 in chips) 
Seat 7: ruslik_by ($100 in chips) 
Seat 8: Marcelek_El ($83.31 in chips) 
Seat 9: maxxmeister ($100 in chips) 
teerajaja: posts small blind $0.50
ruslik_by: posts big blind $1
*** HOLE CARDS ***
Dealt to matiko09 [Ad 4s]
Marcelek_El: folds 
maxxmeister: folds 
Sreshta222: folds 
TideHan: folds 
matiko09: raises $1.27 to $2.27
teerajaja: folds 
ruslik_by: folds 
Uncalled bet ($1.27) returned to matiko09
matiko09 collected $2.50 from pot
matiko09: doesn't show hand 
*** SUMMARY ***
Total pot $2.50 | Rake $0 
Seat 1: Sreshta222 folded before Flop (didn't bet)
Seat 2: TideHan folded before Flop (didn't bet)
Seat 3: matiko09 (button) collected ($2.50)
Seat 4: teerajaja (small blind) folded before Flop
Seat 7: ruslik_by (big blind) folded before Flop
Seat 8: Marcelek_El folded before Flop (didn't bet)
Seat 9: maxxmeister folded before Flop (didn't bet)





PokerStars Hand #154797911267:  Hold'em No Limit ($0.25/$0.50 USD) - 2016/06/16 9:39:40 CET [2016/06/16 3:39:40 ET]
Table 'Mekbuda II' 9-max Seat #5 is the button
Seat 1: matiko09 ($50 in chips) 
Seat 2: tibi_c87 ($50 in chips) 
Seat 3: Kapa09 ($49.75 in chips) 
Seat 4: Vvalrond ($35.98 in chips) 
Seat 5: teerajaja ($50 in chips) 
Seat 6: Dantist1122 ($74.84 in chips) 
Seat 7: Lipton20088 ($22.01 in chips) 
Seat 8: WKBelinda ($89.20 in chips) 
Seat 9: Alex Frider ($50 in chips) 
Dantist1122: posts small blind $0.25
Lipton20088: posts big blind $0.50
*** HOLE CARDS ***
Dealt to matiko09 [Ad Ks]
WKBelinda: folds 
Alex Frider: raises $1 to $1.50
matiko09: calls $1.50
tibi_c87: folds 
Kapa09: folds 
Vvalrond: calls $1.50
teerajaja: folds 
Dantist1122: folds 
Lipton20088: folds 
*** FLOP *** [As 7d Kc]
Alex Frider: bets $3.59
matiko09: calls $3.59
Vvalrond: folds 
*** TURN *** [As 7d Kc] [Jc]
Alex Frider: bets $6.50
matiko09: calls $6.50
*** RIVER *** [As 7d Kc Jc] [4d]
Alex Frider: checks 
matiko09: bets $5.50
Alex Frider: folds 
Uncalled bet ($5.50) returned to matiko09
matiko09 collected $24.16 from pot
matiko09: doesn't show hand 
*** SUMMARY ***
Total pot $25.43 | Rake $1.27 
Board [As 7d Kc Jc 4d]
Seat 1: matiko09 collected ($24.16)
Seat 2: tibi_c87 folded before Flop (didn't bet)
Seat 3: Kapa09 folded before Flop (didn't bet)
Seat 4: Vvalrond folded on the Flop
Seat 5: teerajaja (button) folded before Flop (didn't bet)
Seat 6: Dantist1122 (small blind) folded before Flop
Seat 7: Lipton20088 (big blind) folded before Flop
Seat 8: WKBelinda folded before Flop (didn't bet)
Seat 9: Alex Frider folded on the River





PokerStars Hand #154797912177:  Hold'em No Limit ($0.50/$1.00 USD) - 2016/06/16 9:39:44 CET [2016/06/16 3:39:44 ET]
Table 'Stroobantia II' 9-max Seat #4 is the button
Seat 1: mycka86 ($103.10 in chips) 
Seat 2: Lipton20088 ($162.44 in chips) 
Seat 3: matiko09 ($100 in chips) 
Seat 4: CoolFireX ($102.55 in chips) 
Seat 5: butcheN18 ($102 in chips) 
Seat 6: andrewtomaz ($99 in chips) 
Seat 7: AlKatrone ($104.50 in chips) 
Seat 8: ruslik_by ($104.52 in chips) 
Seat 9: jakub249 ($86.50 in chips) 
butcheN18: posts small blind $0.50
andrewtomaz: posts big blind $1
*** HOLE CARDS ***
Dealt to matiko09 [4s Jh]
AlKatrone: folds 
ruslik_by: raises $2 to $3
jakub249: folds 
mycka86: folds 
Lipton20088: folds 
matiko09: folds 
CoolFireX: folds 
butcheN18: folds 
andrewtomaz: calls $2
*** FLOP *** [3c 6d 8d]
andrewtomaz: bets $1
ruslik_by: raises $4.09 to $5.09
andrewtomaz: calls $4.09
*** TURN *** [3c 6d 8d] [Jc]
andrewtomaz: bets $2
ruslik_by: calls $2
*** RIVER *** [3c 6d 8d Jc] [As]
andrewtomaz: bets $5
ruslik_by: calls $5
*** SHOW DOWN ***
andrewtomaz: shows [5s 6c] (a pair of Sixes)
ruslik_by: shows [4h 6h] (a pair of Sixes)
andrewtomaz collected $14.58 from pot
ruslik_by collected $14.57 from pot
*** SUMMARY ***
Total pot $30.68 | Rake $1.53 
Board [3c 6d 8d Jc As]
Seat 1: mycka86 folded before Flop (didn't bet)
Seat 2: Lipton20088 folded before Flop (didn't bet)
Seat 3: matiko09 folded before Flop (didn't bet)
Seat 4: CoolFireX (button) folded before Flop (didn't bet)
Seat 5: butcheN18 (small blind) folded before Flop
Seat 6: andrewtomaz (big blind) showed [5s 6c] and won ($14.58) with a pair of Sixes
Seat 7: AlKatrone folded before Flop (didn't bet)
Seat 8: ruslik_by showed [4h 6h] and won ($14.57) with a pair of Sixes
Seat 9: jakub249 folded before Flop (didn't bet)





PokerStars Hand #154797914844:  Hold'em No Limit ($0.50/$1.00 USD) - 2016/06/16 9:39:53 CET [2016/06/16 3:39:53 ET]
Table 'Markab II' 9-max Seat #3 is the button
Seat 1: AlKatrone ($101.92 in chips) 
Seat 2: mycka86 ($100 in chips) 
Seat 3: f4life1521 ($84.39 in chips) 
Seat 4: ruslik_by ($184.33 in chips) 
Seat 5: maxxmeister ($100 in chips) 
Seat 6: butcheN18 ($199.86 in chips) 
Seat 7: matiko09 ($107.25 in chips) 
Seat 8: CoolFireX ($151.20 in chips) 
Seat 9: greyman571 ($125.48 in chips) 
ruslik_by: posts small blind $0.50
maxxmeister: posts big blind $1
*** HOLE CARDS ***
Dealt to matiko09 [9s 6s]
butcheN18: folds 
matiko09: folds 
CoolFireX: raises $2 to $3
greyman571: folds 
AlKatrone: folds 
mycka86: folds 
f4life1521: folds 
ruslik_by: folds 
maxxmeister: folds 
Uncalled bet ($2) returned to CoolFireX
CoolFireX collected $2.50 from pot
CoolFireX: doesn't show hand 
*** SUMMARY ***
Total pot $2.50 | Rake $0 
Seat 1: AlKatrone folded before Flop (didn't bet)
Seat 2: mycka86 folded before Flop (didn't bet)
Seat 3: f4life1521 (button) folded before Flop (didn't bet)
Seat 4: ruslik_by (small blind) folded before Flop
Seat 5: maxxmeister (big blind) folded before Flop
Seat 6: butcheN18 folded before Flop (didn't bet)
Seat 7: matiko09 folded before Flop (didn't bet)
Seat 8: CoolFireX collected ($2.50)
Seat 9: greyman571 folded before Flop (didn't bet)





PokerStars Hand #154797916808:  Hold'em No Limit ($0.50/$1.00 USD) - 2016/06/16 9:40:00 CET [2016/06/16 3:40:00 ET]
Table 'Nuki' 9-max Seat #4 is the button
Seat 1: Sreshta222 ($40 in chips) 
Seat 2: TideHan ($100 in chips) 
Seat 3: matiko09 ($101.50 in chips) 
Seat 4: teerajaja ($100 in chips) 
Seat 7: ruslik_by ($100 in chips) 
Seat 8: Marcelek_El ($83.31 in chips) 
Seat 9: maxxmeister ($100 in chips) 
ruslik_by: posts small blind $0.50
Marcelek_El: posts big blind $1
*** HOLE CARDS ***
Dealt to matiko09 [Ac 5h]
maxxmeister: folds 
Sreshta222: raises $1.50 to $2.50
TideHan: folds 
matiko09: folds 
teerajaja: folds 
ruslik_by: folds 
Marcelek_El: folds 
Uncalled bet ($1.50) returned to Sreshta222
Sreshta222 collected $2.50 from pot
Sreshta222: doesn't show hand 
*** SUMMARY ***
Total pot $2.50 | Rake $0 
Seat 1: Sreshta222 collected ($2.50)
Seat 2: TideHan folded before Flop (didn't bet)
Seat 3: matiko09 folded before Flop (didn't bet)
Seat 4: teerajaja (button) folded before Flop (didn't bet)
Seat 7: ruslik_by (small blind) folded before Flop
Seat 8: Marcelek_El (big blind) folded before Flop
Seat 9: maxxmeister folded before Flop (didn't bet)





PokerStars Hand #154797920380:  Hold'em No Limit ($0.50/$1.00 USD) - 2016/06/16 9:40:13 CET [2016/06/16 3:40:13 ET]
Table 'Astyanax' 9-max Seat #3 is the button
Seat 1: pokerich462 ($192.99 in chips) 
Seat 2: matiko09 ($100 in chips) 
Seat 3: hammerwife ($120.82 in chips) 
Seat 4: teerajaja ($100 in chips) 
Seat 5: butcheN18 ($128.45 in chips) 
Seat 6: Dantist1122 ($112.11 in chips) 
Seat 7: flk.Dasas ($100 in chips) 
Seat 8: mycka86 ($100 in chips) 
Seat 9: CoolFireX ($102.54 in chips) 
teerajaja: posts small blind $0.50
butcheN18: posts big blind $1
pokerich462: posts the ante $0.20
matiko09: posts the ante $0.20
hammerwife: posts the ante $0.20
teerajaja: posts the ante $0.20
butcheN18: posts the ante $0.20
Dantist1122: posts the ante $0.20
flk.Dasas: posts the ante $0.20
mycka86: posts the ante $0.20
CoolFireX: posts the ante $0.20
*** HOLE CARDS ***
Dealt to matiko09 [9d 3h]
Dantist1122: folds 
flk.Dasas: folds 
mycka86: folds 
CoolFireX: raises $2 to $3
pokerich462: folds 
matiko09: folds 
hammerwife: folds 
teerajaja: folds 
butcheN18: folds 
Uncalled bet ($2) returned to CoolFireX
CoolFireX collected $4.30 from pot
CoolFireX: doesn't show hand 
*** SUMMARY ***
Total pot $4.30 | Rake $0 
Seat 1: pokerich462 folded before Flop (didn't bet)
Seat 2: matiko09 folded before Flop (didn't bet)
Seat 3: hammerwife (button) folded before Flop (didn't bet)
Seat 4: teerajaja (small blind) folded before Flop
Seat 5: butcheN18 (big blind) folded before Flop
Seat 6: Dantist1122 folded before Flop (didn't bet)
Seat 7: flk.Dasas folded before Flop (didn't bet)
Seat 8: mycka86 folded before Flop (didn't bet)
Seat 9: CoolFireX collected ($4.30)





PokerStars Hand #154797922068:  Hold'em No Limit ($0.25/$0.50 USD) - 2016/06/16 9:40:19 CET [2016/06/16 3:40:19 ET]
Table 'Gaea' 9-max Seat #7 is the button
Seat 1: jasonhan416 ($43.80 in chips) 
Seat 2: magzi777 ($55.29 in chips) 
Seat 4: matiko09 ($70.02 in chips) 
Seat 5: Kapa09 ($51.25 in chips) 
Seat 6: Alex Frider ($66.56 in chips) 
Seat 7: Dantist1122 ($50 in chips) 
Seat 8: Red_Warning ($50 in chips) 
Seat 9: Prophet1906 ($60.46 in chips) 
Red_Warning: posts small blind $0.25
Prophet1906: posts big blind $0.50
Crazyfish87: sits out 
*** HOLE CARDS ***
Dealt to matiko09 [4s 7d]
jasonhan416: calls $0.50
magzi777: folds 
matiko09: folds 
Kapa09: folds 
Alex Frider: folds 
Dantist1122: folds 
Red_Warning: raises $1.50 to $2
Prophet1906: folds 
jasonhan416: calls $1.50
*** FLOP *** [Kh 4h Qh]
Red_Warning: checks 
jasonhan416: bets $2.14
Red_Warning: folds 
Uncalled bet ($2.14) returned to jasonhan416
jasonhan416 collected $4.28 from pot
jasonhan416: doesn't show hand 
*** SUMMARY ***
Total pot $4.50 | Rake $0.22 
Board [Kh 4h Qh]
Seat 1: jasonhan416 collected ($4.28)
Seat 2: magzi777 folded before Flop (didn't bet)
Seat 4: matiko09 folded before Flop (didn't bet)
Seat 5: Kapa09 folded before Flop (didn't bet)
Seat 6: Alex Frider folded before Flop (didn't bet)
Seat 7: Dantist1122 (button) folded before Flop (didn't bet)
Seat 8: Red_Warning (small blind) folded on the Flop
Seat 9: Prophet1906 (big blind) folded before Flop





PokerStars Hand #154797922477:  Hold'em No Limit ($0.50/$1.00 USD) - 2016/06/16 9:40:21 CET [2016/06/16 3:40:21 ET]
Table 'Nuki' 9-max Seat #7 is the button
Seat 1: Sreshta222 ($41.50 in chips) 
Seat 2: TideHan ($100 in chips) 
Seat 3: matiko09 ($101.50 in chips) 
Seat 4: teerajaja ($100 in chips) 
Seat 7: ruslik_by ($100 in chips) 
Seat 8: Marcelek_El ($82.31 in chips) 
Marcelek_El: posts small blind $0.50
maxxmeister: is sitting out 
Sreshta222: posts big blind $1
*** HOLE CARDS ***
Dealt to matiko09 [Kd 5s]
TideHan: folds 
matiko09: folds 
ozone2003 joins the table at seat #5 
maxxmeister leaves the table
teerajaja: folds 
Lipton20088 joins the table at seat #9 
ruslik_by: raises $1 to $2
Marcelek_El: folds 
mycka86 joins the table at seat #6 
Sreshta222: calls $1
*** FLOP *** [7d 7s 5d]
Sreshta222: checks 
ruslik_by: bets $1.45
Sreshta222: folds 
Uncalled bet ($1.45) returned to ruslik_by
ruslik_by collected $4.28 from pot
ruslik_by: doesn't show hand 
*** SUMMARY ***
Total pot $4.50 | Rake $0.22 
Board [7d 7s 5d]
Seat 1: Sreshta222 (big blind) folded on the Flop
Seat 2: TideHan folded before Flop (didn't bet)
Seat 3: matiko09 folded before Flop (didn't bet)
Seat 4: teerajaja folded before Flop (didn't bet)
Seat 7: ruslik_by (button) collected ($4.28)
Seat 8: Marcelek_El (small blind) folded before Flop





PokerStars Hand #154797923508:  Hold'em No Limit ($0.50/$1.00 USD) - 2016/06/16 9:40:24 CET [2016/06/16 3:40:24 ET]
Table 'Hercynia II' 9-max Seat #8 is the button
Seat 2: hammerwife ($198.06 in chips) 
Seat 3: butcheN18 ($117.46 in chips) 
Seat 4: ruslik_by ($100 in chips) 
Seat 5: matiko09 ($100 in chips) 
Seat 6: CoolFireX ($100 in chips) 
Seat 7: ozone2003 ($120.58 in chips) 
Seat 8: mycka86 ($160.79 in chips) 
Seat 9: Juniorquiapo ($105.50 in chips) 
Juniorquiapo: posts small blind $0.50
flk.Dasas: is sitting out 
hammerwife: posts big blind $1
*** HOLE CARDS ***
Dealt to matiko09 [Jc Ac]
butcheN18: folds 
ruslik_by: raises $2 to $3
matiko09: calls $3
CoolFireX: folds 
ozone2003: folds 
mycka86: folds 
Juniorquiapo: folds 
hammerwife: folds 
*** FLOP *** [Qc 3c 5d]
ruslik_by: bets $2.42
matiko09: raises $7.58 to $10
ruslik_by: folds 
Uncalled bet ($7.58) returned to matiko09
matiko09 collected $11.72 from pot
matiko09: doesn't show hand 
*** SUMMARY ***
Total pot $12.34 | Rake $0.62 
Board [Qc 3c 5d]
Seat 2: hammerwife (big blind) folded before Flop
Seat 3: butcheN18 folded before Flop (didn't bet)
Seat 4: ruslik_by folded on the Flop
Seat 5: matiko09 collected ($11.72)
Seat 6: CoolFireX folded before Flop (didn't bet)
Seat 7: ozone2003 folded before Flop (didn't bet)
Seat 8: mycka86 (button) folded before Flop (didn't bet)
Seat 9: Juniorquiapo (small blind) folded before Flop





PokerStars Hand #154797926566:  Hold'em No Limit ($0.50/$1.00 USD) - 2016/06/16 9:40:35 CET [2016/06/16 3:40:35 ET]
Table 'Markab II' 9-max Seat #4 is the button
Seat 1: AlKatrone ($101.92 in chips) 
Seat 2: mycka86 ($100 in chips) 
Seat 3: f4life1521 ($84.39 in chips) 
Seat 4: ruslik_by ($183.83 in chips) 
Seat 5: maxxmeister ($100 in chips) 
Seat 6: butcheN18 ($199.86 in chips) 
Seat 7: matiko09 ($107.25 in chips) 
Seat 8: CoolFireX ($152.70 in chips) 
Seat 9: greyman571 ($125.48 in chips) 
maxxmeister: posts small blind $0.50
butcheN18: posts big blind $1
*** HOLE CARDS ***
Dealt to matiko09 [4s 6h]
matiko09: folds 
CoolFireX: folds 
greyman571: folds 
AlKatrone: folds 
mycka86: folds 
f4life1521: folds 
ruslik_by: raises $1 to $2
maxxmeister: folds 
butcheN18: folds 
Uncalled bet ($1) returned to ruslik_by
ruslik_by collected $2.50 from pot
ruslik_by: doesn't show hand 
*** SUMMARY ***
Total pot $2.50 | Rake $0 
Seat 1: AlKatrone folded before Flop (didn't bet)
Seat 2: mycka86 folded before Flop (didn't bet)
Seat 3: f4life1521 folded before Flop (didn't bet)
Seat 4: ruslik_by (button) collected ($2.50)
Seat 5: maxxmeister (small blind) folded before Flop
Seat 6: butcheN18 (big blind) folded before Flop
Seat 7: matiko09 folded before Flop (didn't bet)
Seat 8: CoolFireX folded before Flop (didn't bet)
Seat 9: greyman571 folded before Flop (didn't bet)





PokerStars Hand #154797926970:  Hold'em No Limit ($0.50/$1.00 USD) - 2016/06/16 9:40:37 CET [2016/06/16 3:40:37 ET]
Table 'Alekto' 9-max Seat #6 is the button
Seat 1: mycka86 ($100 in chips) 
Seat 2: brotas232323 ($95.08 in chips) 
Seat 3: butcheN18 ($111.58 in chips) 
Seat 4: hammerwife ($127.19 in chips) 
Seat 5: matiko09 ($112.01 in chips) 
Seat 6: ilaviiitech ($120.81 in chips) 
Seat 8: ozone2003 ($117.52 in chips) 
Seat 9: ruslik_by ($100 in chips) 
ozone2003: posts small blind $0.50
ruslik_by: posts big blind $1
*** HOLE CARDS ***
Dealt to matiko09 [Ad Qc]
mycka86: folds 
brotas232323: folds 
butcheN18: folds 
hammerwife: folds 
brotas232323 leaves the table
matiko09: raises $1.50 to $2.50
CoolFireX joins the table at seat #2 
ilaviiitech: calls $2.50
ozone2003: folds 
ruslik_by: calls $1.50
*** FLOP *** [5d 8d Qs]
ruslik_by: checks 
matiko09: bets $4.94
ilaviiitech: raises $13.98 to $18.92
ruslik_by: folds 
matiko09: folds 
Uncalled bet ($13.98) returned to ilaviiitech
ilaviiitech collected $16.99 from pot
ilaviiitech: doesn't show hand 
*** SUMMARY ***
Total pot $17.88 | Rake $0.89 
Board [5d 8d Qs]
Seat 1: mycka86 folded before Flop (didn't bet)
Seat 2: brotas232323 folded before Flop (didn't bet)
Seat 3: butcheN18 folded before Flop (didn't bet)
Seat 4: hammerwife folded before Flop (didn't bet)
Seat 5: matiko09 folded on the Flop
Seat 6: ilaviiitech (button) collected ($16.99)
Seat 8: ozone2003 (small blind) folded before Flop
Seat 9: ruslik_by (big blind) folded on the Flop





PokerStars Hand #154797932521:  Hold'em No Limit ($0.50/$1.00 USD) - 2016/06/16 9:40:57 CET [2016/06/16 3:40:57 ET]
Table 'Astyanax' 9-max Seat #4 is the button
Seat 1: pokerich462 ($192.79 in chips) 
Seat 2: matiko09 ($100 in chips) 
Seat 3: hammerwife ($120.62 in chips) 
Seat 4: teerajaja ($100 in chips) 
Seat 5: butcheN18 ($127.25 in chips) 
Seat 8: mycka86 ($100 in chips) 
Seat 9: CoolFireX ($105.64 in chips) 
butcheN18: posts small blind $0.50
Dantist1122: is sitting out 
flk.Dasas: is sitting out 
Dantist1122 leaves the table
mycka86: posts big blind $1
pokerich462: posts the ante $0.20
matiko09: posts the ante $0.20
hammerwife: posts the ante $0.20
teerajaja: posts the ante $0.20
butcheN18: posts the ante $0.20
mycka86: posts the ante $0.20
CoolFireX: posts the ante $0.20
*** HOLE CARDS ***
Dealt to matiko09 [Js 8s]
CoolFireX: folds 
pokerich462: folds 
matiko09: folds 
hammerwife: folds 
teerajaja: folds 
butcheN18: folds 
Uncalled bet ($0.50) returned to mycka86
mycka86 collected $2.40 from pot
*** SUMMARY ***
Total pot $2.40 | Rake $0 
Seat 1: pokerich462 folded before Flop (didn't bet)
Seat 2: matiko09 folded before Flop (didn't bet)
Seat 3: hammerwife folded before Flop (didn't bet)
Seat 4: teerajaja (button) folded before Flop (didn't bet)
Seat 5: butcheN18 (small blind) folded before Flop
Seat 8: mycka86 (big blind) collected ($2.40)
Seat 9: CoolFireX folded before Flop (didn't bet)





PokerStars Hand #154797936639:  Hold'em No Limit ($0.50/$1.00 USD) - 2016/06/16 9:41:12 CET [2016/06/16 3:41:12 ET]
Table 'Astyanax' 9-max Seat #5 is the button
Seat 1: pokerich462 ($192.59 in chips) 
Seat 2: matiko09 ($100 in chips) 
Seat 3: hammerwife ($120.42 in chips) 
Seat 4: teerajaja ($100 in chips) 
Seat 5: butcheN18 ($126.55 in chips) 
Seat 8: mycka86 ($101.70 in chips) 
Seat 9: CoolFireX ($105.44 in chips) 
mycka86: posts small blind $0.50
CoolFireX: posts big blind $1
pokerich462: posts the ante $0.20
matiko09: posts the ante $0.20
hammerwife: posts the ante $0.20
teerajaja: posts the ante $0.20
butcheN18: posts the ante $0.20
mycka86: posts the ante $0.20
CoolFireX: posts the ante $0.20
*** HOLE CARDS ***
Dealt to matiko09 [2d 3c]
pokerich462: folds 
matiko09: folds 
hammerwife: folds 
teerajaja: folds 
butcheN18: folds 
mycka86: raises $2 to $3
CoolFireX: raises $6 to $9
mycka86: folds 
Uncalled bet ($6) returned to CoolFireX
CoolFireX collected $7.40 from pot
CoolFireX: doesn't show hand 
*** SUMMARY ***
Total pot $7.40 | Rake $0 
Seat 1: pokerich462 folded before Flop (didn't bet)
Seat 2: matiko09 folded before Flop (didn't bet)
Seat 3: hammerwife folded before Flop (didn't bet)
Seat 4: teerajaja folded before Flop (didn't bet)
Seat 5: butcheN18 (button) folded before Flop (didn't bet)
Seat 8: mycka86 (small blind) folded before Flop
Seat 9: CoolFireX (big blind) collected ($7.40)





PokerStars Hand #154797936754:  Hold'em No Limit ($0.25/$0.50 USD) - 2016/06/16 9:41:12 CET [2016/06/16 3:41:12 ET]
Table 'Gaea' 9-max Seat #8 is the button
Seat 1: jasonhan416 ($46.08 in chips) 
Seat 2: magzi777 ($55.29 in chips) 
Seat 4: matiko09 ($70.02 in chips) 
Seat 5: Kapa09 ($51.25 in chips) 
Seat 6: Alex Frider ($66.56 in chips) 
Seat 7: Dantist1122 ($50 in chips) 
Seat 8: Red_Warning ($50 in chips) 
Seat 9: Prophet1906 ($59.96 in chips) 
Prophet1906: posts small blind $0.25
jasonhan416: posts big blind $0.50
Crazyfish87: sits out 
*** HOLE CARDS ***
Dealt to matiko09 [8d 8h]
magzi777: raises $0.75 to $1.25
matiko09: calls $1.25
Kapa09: folds 
Alex Frider: folds 
Dantist1122: folds 
Red_Warning: folds 
Prophet1906: folds 
jasonhan416: calls $0.75
*** FLOP *** [Qs 6s 6d]
jasonhan416: checks 
magzi777: checks 
matiko09: checks 
*** TURN *** [Qs 6s 6d] [3c]
jasonhan416: bets $1.90
magzi777: calls $1.90
matiko09: folds 
*** RIVER *** [Qs 6s 6d 3c] [8s]
jasonhan416: bets $8.50
magzi777: folds 
Uncalled bet ($8.50) returned to jasonhan416
jasonhan416 collected $7.41 from pot
jasonhan416: doesn't show hand 
*** SUMMARY ***
Total pot $7.80 | Rake $0.39 
Board [Qs 6s 6d 3c 8s]
Seat 1: jasonhan416 (big blind) collected ($7.41)
Seat 2: magzi777 folded on the River
Seat 4: matiko09 folded on the Turn
Seat 5: Kapa09 folded before Flop (didn't bet)
Seat 6: Alex Frider folded before Flop (didn't bet)
Seat 7: Dantist1122 folded before Flop (didn't bet)
Seat 8: Red_Warning (button) folded before Flop (didn't bet)
Seat 9: Prophet1906 (small blind) folded before Flop





PokerStars Hand #154797936771:  Hold'em No Limit ($0.25/$0.50 USD) - 2016/06/16 9:41:12 CET [2016/06/16 3:41:12 ET]
Table 'Mekbuda II' 9-max Seat #6 is the button
Seat 1: matiko09 ($62.57 in chips) 
Seat 2: tibi_c87 ($50 in chips) 
Seat 3: Kapa09 ($49.75 in chips) 
Seat 4: Vvalrond ($34.48 in chips) 
Seat 5: teerajaja ($50 in chips) 
Seat 6: Dantist1122 ($74.59 in chips) 
Seat 7: Lipton20088 ($21.51 in chips) 
Seat 8: WKBelinda ($89.20 in chips) 
Seat 9: Alex Frider ($50 in chips) 
Lipton20088: posts small blind $0.25
WKBelinda: posts big blind $0.50
*** HOLE CARDS ***
Dealt to matiko09 [9s 2h]
Alex Frider: folds 
matiko09: folds 
tibi_c87: folds 
Vvalrond is disconnected 
Kapa09: folds 
Vvalrond is connected 
Vvalrond: folds 
teerajaja: folds 
Dantist1122: raises $0.52 to $1.02
Lipton20088: folds 
WKBelinda: calls $0.52
*** FLOP *** [3d Jh Kd]
WKBelinda: checks 
Dantist1122: checks 
*** TURN *** [3d Jh Kd] [5d]
WKBelinda: bets $1
Dantist1122: folds 
Uncalled bet ($1) returned to WKBelinda
WKBelinda collected $2.18 from pot
WKBelinda: doesn't show hand 
*** SUMMARY ***
Total pot $2.29 | Rake $0.11 
Board [3d Jh Kd 5d]
Seat 1: matiko09 folded before Flop (didn't bet)
Seat 2: tibi_c87 folded before Flop (didn't bet)
Seat 3: Kapa09 folded before Flop (didn't bet)
Seat 4: Vvalrond folded before Flop (didn't bet)
Seat 5: teerajaja folded before Flop (didn't bet)
Seat 6: Dantist1122 (button) folded on the Turn
Seat 7: Lipton20088 (small blind) folded before Flop
Seat 8: WKBelinda (big blind) collected ($2.18)
Seat 9: Alex Frider folded before Flop (didn't bet)





PokerStars Hand #154797940267:  Hold'em No Limit ($0.50/$1.00 USD) - 2016/06/16 9:41:25 CET [2016/06/16 3:41:25 ET]
Table 'Stroobantia II' 9-max Seat #5 is the button
Seat 1: mycka86 ($103.10 in chips) 
Seat 2: Lipton20088 ($162.44 in chips) 
Seat 3: matiko09 ($100 in chips) 
Seat 4: CoolFireX ($102.55 in chips) 
Seat 5: butcheN18 ($101.50 in chips) 
Seat 6: andrewtomaz ($98.49 in chips) 
Seat 7: AlKatrone ($104.50 in chips) 
Seat 8: ruslik_by ($104 in chips) 
Seat 9: jakub249 ($86.50 in chips) 
andrewtomaz: posts small blind $0.50
AlKatrone: posts big blind $1
*** HOLE CARDS ***
Dealt to matiko09 [7h 7d]
ruslik_by: folds 
andrewtomaz said, "ouuuu balls"
jakub249: calls $1
andrewtomaz said, ":)"
mycka86: folds 
Lipton20088: folds 
matiko09: raises $3 to $4
CoolFireX: folds 
butcheN18: folds 
andrewtomaz: calls $3.50
AlKatrone: folds 
jakub249: calls $3
*** FLOP *** [Ts 8h 9c]
andrewtomaz: checks 
jakub249: checks 
matiko09: checks 
*** TURN *** [Ts 8h 9c] [9s]
andrewtomaz: bets $2
jakub249: calls $2
matiko09: calls $2
*** RIVER *** [Ts 8h 9c 9s] [Td]
andrewtomaz: bets $4
jakub249: folds 
matiko09: folds 
Uncalled bet ($4) returned to andrewtomaz
andrewtomaz collected $18.05 from pot
*** SUMMARY ***
Total pot $19 | Rake $0.95 
Board [Ts 8h 9c 9s Td]
Seat 1: mycka86 folded before Flop (didn't bet)
Seat 2: Lipton20088 folded before Flop (didn't bet)
Seat 3: matiko09 folded on the River
Seat 4: CoolFireX folded before Flop (didn't bet)
Seat 5: butcheN18 (button) folded before Flop (didn't bet)
Seat 6: andrewtomaz (small blind) collected ($18.05)
Seat 7: AlKatrone (big blind) folded before Flop
Seat 8: ruslik_by folded before Flop (didn't bet)
Seat 9: jakub249 folded on the River





PokerStars Hand #154797943193:  Hold'em No Limit ($0.50/$1.00 USD) - 2016/06/16 9:41:35 CET [2016/06/16 3:41:35 ET]
Table 'Nuki' 9-max Seat #8 is the button
Seat 1: Sreshta222 ($39.50 in chips) 
Seat 2: TideHan ($100 in chips) 
Seat 3: matiko09 ($101.50 in chips) 
Seat 4: teerajaja ($100 in chips) 
Seat 7: ruslik_by ($102.28 in chips) 
Seat 8: Marcelek_El ($81.81 in chips) 
Lipton20088 will be allowed to play after the button
Sreshta222: posts small blind $0.50
TideHan: posts big blind $1
ozone2003: sits out 
mycka86: sits out 
*** HOLE CARDS ***
Dealt to matiko09 [4d Qd]
matiko09: folds 
teerajaja: raises $1.50 to $2.50
ruslik_by: folds 
Marcelek_El: folds 
Sreshta222: raises $4.50 to $7
TideHan: folds 
teerajaja: folds 
Uncalled bet ($4.50) returned to Sreshta222
Sreshta222 collected $6 from pot
Sreshta222: doesn't show hand 
*** SUMMARY ***
Total pot $6 | Rake $0 
Seat 1: Sreshta222 (small blind) collected ($6)
Seat 2: TideHan (big blind) folded before Flop
Seat 3: matiko09 folded before Flop (didn't bet)
Seat 4: teerajaja folded before Flop
Seat 7: ruslik_by folded before Flop (didn't bet)
Seat 8: Marcelek_El (button) folded before Flop (didn't bet)





PokerStars Hand #154797943543:  Hold'em No Limit ($0.50/$1.00 USD) - 2016/06/16 9:41:36 CET [2016/06/16 3:41:36 ET]
Table 'Markab II' 9-max Seat #5 is the button
Seat 1: AlKatrone ($101.92 in chips) 
Seat 2: mycka86 ($100 in chips) 
Seat 3: f4life1521 ($84.39 in chips) 
Seat 4: ruslik_by ($185.33 in chips) 
Seat 5: maxxmeister ($100 in chips) 
Seat 6: butcheN18 ($198.86 in chips) 
Seat 7: matiko09 ($107.25 in chips) 
Seat 8: CoolFireX ($152.70 in chips) 
Seat 9: greyman571 ($125.48 in chips) 
butcheN18: posts small blind $0.50
matiko09: posts big blind $1
*** HOLE CARDS ***
Dealt to matiko09 [Jd Qh]
CoolFireX: folds 
greyman571: folds 
AlKatrone: folds 
mycka86: folds 
f4life1521: raises $1 to $2
ruslik_by: folds 
maxxmeister: calls $2
butcheN18: folds 
matiko09: calls $1
*** FLOP *** [3s 8h 9s]
matiko09: checks 
f4life1521: bets $3.55
maxxmeister: folds 
matiko09: folds 
Uncalled bet ($3.55) returned to f4life1521
f4life1521 collected $6.18 from pot
f4life1521: doesn't show hand 
*** SUMMARY ***
Total pot $6.50 | Rake $0.32 
Board [3s 8h 9s]
Seat 1: AlKatrone folded before Flop (didn't bet)
Seat 2: mycka86 folded before Flop (didn't bet)
Seat 3: f4life1521 collected ($6.18)
Seat 4: ruslik_by folded before Flop (didn't bet)
Seat 5: maxxmeister (button) folded on the Flop
Seat 6: butcheN18 (small blind) folded before Flop
Seat 7: matiko09 (big blind) folded on the Flop
Seat 8: CoolFireX folded before Flop (didn't bet)
Seat 9: greyman571 folded before Flop (didn't bet)





PokerStars Hand #154797946840:  Hold'em No Limit ($0.50/$1.00 USD) - 2016/06/16 9:41:48 CET [2016/06/16 3:41:48 ET]
Table 'Hercynia II' 9-max Seat #9 is the button
Seat 2: hammerwife ($197.06 in chips) 
Seat 3: butcheN18 ($117.46 in chips) 
Seat 4: ruslik_by ($100 in chips) 
Seat 5: matiko09 ($106.30 in chips) 
Seat 6: CoolFireX ($100 in chips) 
Seat 7: ozone2003 ($120.58 in chips) 
Seat 8: mycka86 ($160.79 in chips) 
Seat 9: Juniorquiapo ($105 in chips) 
hammerwife: posts small blind $0.50
butcheN18: posts big blind $1
*** HOLE CARDS ***
Dealt to matiko09 [3s 6d]
ruslik_by: folds 
matiko09: folds 
CoolFireX: folds 
ozone2003: folds 
mycka86: raises $1.10 to $2.10
Juniorquiapo: folds 
hammerwife: folds 
butcheN18: folds 
Uncalled bet ($1.10) returned to mycka86
mycka86 collected $2.50 from pot
*** SUMMARY ***
Total pot $2.50 | Rake $0 
Seat 2: hammerwife (small blind) folded before Flop
Seat 3: butcheN18 (big blind) folded before Flop
Seat 4: ruslik_by folded before Flop (didn't bet)
Seat 5: matiko09 folded before Flop (didn't bet)
Seat 6: CoolFireX folded before Flop (didn't bet)
Seat 7: ozone2003 folded before Flop (didn't bet)
Seat 8: mycka86 collected ($2.50)
Seat 9: Juniorquiapo (button) folded before Flop (didn't bet)





PokerStars Hand #154797948609:  Hold'em No Limit ($0.50/$1.00 USD) - 2016/06/16 9:41:55 CET [2016/06/16 3:41:55 ET]
Table 'Astyanax' 9-max Seat #8 is the button
Seat 1: pokerich462 ($192.39 in chips) 
Seat 2: matiko09 ($100 in chips) 
Seat 3: hammerwife ($120.22 in chips) 
Seat 4: teerajaja ($100 in chips) 
Seat 5: butcheN18 ($126.35 in chips) 
Seat 8: mycka86 ($100 in chips) 
Seat 9: CoolFireX ($109.64 in chips) 
CoolFireX: posts small blind $0.50
pokerich462: posts big blind $1
pokerich462: posts the ante $0.20
matiko09: posts the ante $0.20
hammerwife: posts the ante $0.20
teerajaja: posts the ante $0.20
butcheN18: posts the ante $0.20
mycka86: posts the ante $0.20
CoolFireX: posts the ante $0.20
*** HOLE CARDS ***
Dealt to matiko09 [Kh 6s]
matiko09: folds 
ruslik_by joins the table at seat #6 
hammerwife: folds 
teerajaja: folds 
butcheN18: raises $2 to $3
mycka86: folds 
CoolFireX: folds 
pokerich462: folds 
Uncalled bet ($2) returned to butcheN18
butcheN18 collected $3.90 from pot
butcheN18: doesn't show hand 
*** SUMMARY ***
Total pot $3.90 | Rake $0 
Seat 1: pokerich462 (big blind) folded before Flop
Seat 2: matiko09 folded before Flop (didn't bet)
Seat 3: hammerwife folded before Flop (didn't bet)
Seat 4: teerajaja folded before Flop (didn't bet)
Seat 5: butcheN18 collected ($3.90)
Seat 8: mycka86 (button) folded before Flop (didn't bet)
Seat 9: CoolFireX (small blind) folded before Flop





PokerStars Hand #154797957663:  Hold'em No Limit ($0.50/$1.00 USD) - 2016/06/16 9:42:26 CET [2016/06/16 3:42:26 ET]
Table 'Astyanax' 9-max Seat #9 is the button
Seat 1: pokerich462 ($191.19 in chips) 
Seat 2: matiko09 ($100 in chips) 
Seat 3: hammerwife ($120.02 in chips) 
Seat 4: teerajaja ($100 in chips) 
Seat 5: butcheN18 ($129.05 in chips) 
Seat 8: mycka86 ($100 in chips) 
Seat 9: CoolFireX ($108.94 in chips) 
pokerich462: posts small blind $0.50
matiko09: posts big blind $1
ruslik_by: sits out 
pokerich462: posts the ante $0.20
matiko09: posts the ante $0.20
hammerwife: posts the ante $0.20
teerajaja: posts the ante $0.20
butcheN18: posts the ante $0.20
mycka86: posts the ante $0.20
CoolFireX: posts the ante $0.20
*** HOLE CARDS ***
Dealt to matiko09 [7s Qc]
hammerwife: folds 
teerajaja: folds 
butcheN18: folds 
mycka86: raises $2 to $3
CoolFireX: folds 
pokerich462: folds 
matiko09: folds 
Uncalled bet ($2) returned to mycka86
mycka86 collected $3.90 from pot
*** SUMMARY ***
Total pot $3.90 | Rake $0 
Seat 1: pokerich462 (small blind) folded before Flop
Seat 2: matiko09 (big blind) folded before Flop
Seat 3: hammerwife folded before Flop (didn't bet)
Seat 4: teerajaja folded before Flop (didn't bet)
Seat 5: butcheN18 folded before Flop (didn't bet)
Seat 8: mycka86 collected ($3.90)
Seat 9: CoolFireX (button) folded before Flop (didn't bet)





PokerStars Hand #154797957744:  Hold'em No Limit ($0.25/$0.50 USD) - 2016/06/16 9:42:27 CET [2016/06/16 3:42:27 ET]
Table 'Mekbuda II' 9-max Seat #7 is the button
Seat 1: matiko09 ($62.57 in chips) 
Seat 2: tibi_c87 ($50 in chips) 
Seat 3: Kapa09 ($49.75 in chips) 
Seat 4: Vvalrond ($34.48 in chips) 
Seat 5: teerajaja ($50 in chips) 
Seat 6: Dantist1122 ($73.57 in chips) 
Seat 7: Lipton20088 ($21.26 in chips) 
Seat 8: WKBelinda ($90.36 in chips) 
Seat 9: Alex Frider ($50 in chips) 
WKBelinda: posts small blind $0.25
Alex Frider: posts big blind $0.50
*** HOLE CARDS ***
Dealt to matiko09 [Kd 7h]
matiko09: folds 
tibi_c87: raises $1 to $1.50
Kapa09: folds 
Vvalrond: calls $1.50
teerajaja: calls $1.50
Dantist1122: calls $1.50
Lipton20088: folds 
WKBelinda: calls $1.25
Alex Frider: folds 
*** FLOP *** [7s 5s 5c]
WKBelinda: checks 
tibi_c87: bets $5
Vvalrond: folds 
teerajaja: folds 
Dantist1122: folds 
WKBelinda: folds 
Uncalled bet ($5) returned to tibi_c87
tibi_c87 collected $7.60 from pot
tibi_c87: doesn't show hand 
*** SUMMARY ***
Total pot $8 | Rake $0.40 
Board [7s 5s 5c]
Seat 1: matiko09 folded before Flop (didn't bet)
Seat 2: tibi_c87 collected ($7.60)
Seat 3: Kapa09 folded before Flop (didn't bet)
Seat 4: Vvalrond folded on the Flop
Seat 5: teerajaja folded on the Flop
Seat 6: Dantist1122 folded on the Flop
Seat 7: Lipton20088 (button) folded before Flop (didn't bet)
Seat 8: WKBelinda (small blind) folded on the Flop
Seat 9: Alex Frider (big blind) folded before Flop





PokerStars Hand #154797958265:  Hold'em No Limit ($0.25/$0.50 USD) - 2016/06/16 9:42:29 CET [2016/06/16 3:42:29 ET]
Table 'Gaea' 9-max Seat #9 is the button
Seat 1: jasonhan416 ($50.34 in chips) 
Seat 2: magzi777 ($52.14 in chips) 
Seat 4: matiko09 ($68.77 in chips) 
Seat 5: Kapa09 ($51.25 in chips) 
Seat 6: Alex Frider ($66.56 in chips) 
Seat 7: Dantist1122 ($50 in chips) 
Seat 8: Red_Warning ($50 in chips) 
Seat 9: Prophet1906 ($59.71 in chips) 
jasonhan416: posts small blind $0.25
magzi777: posts big blind $0.50
Crazyfish87: sits out 
*** HOLE CARDS ***
Dealt to matiko09 [4d 6s]
matiko09: folds 
Kapa09: folds 
Alex Frider has timed out
Alex Frider: folds 
Dantist1122: folds 
Red_Warning: folds 
Prophet1906: folds 
jasonhan416: calls $0.25
magzi777: checks 
*** FLOP *** [9h 7s Ah]
jasonhan416: checks 
magzi777: checks 
*** TURN *** [9h 7s Ah] [5s]
jasonhan416: bets $0.50
magzi777: folds 
Uncalled bet ($0.50) returned to jasonhan416
jasonhan416 collected $0.95 from pot
jasonhan416: doesn't show hand 
*** SUMMARY ***
Total pot $1 | Rake $0.05 
Board [9h 7s Ah 5s]
Seat 1: jasonhan416 (small blind) collected ($0.95)
Seat 2: magzi777 (big blind) folded on the Turn
Seat 4: matiko09 folded before Flop (didn't bet)
Seat 5: Kapa09 folded before Flop (didn't bet)
Seat 6: Alex Frider folded before Flop (didn't bet)
Seat 7: Dantist1122 folded before Flop (didn't bet)
Seat 8: Red_Warning folded before Flop (didn't bet)
Seat 9: Prophet1906 (button) folded before Flop (didn't bet)





PokerStars Hand #154797959653:  Hold'em No Limit ($0.50/$1.00 USD) - 2016/06/16 9:42:34 CET [2016/06/16 3:42:34 ET]
Table 'Hercynia II' 9-max Seat #2 is the button
Seat 2: hammerwife ($196.56 in chips) 
Seat 3: butcheN18 ($116.46 in chips) 
Seat 4: ruslik_by ($100 in chips) 
Seat 5: matiko09 ($106.30 in chips) 
Seat 6: CoolFireX ($100 in chips) 
Seat 7: ozone2003 ($120.58 in chips) 
Seat 8: mycka86 ($162.29 in chips) 
Seat 9: Juniorquiapo ($105 in chips) 
butcheN18: posts small blind $0.50
ruslik_by: posts big blind $1
*** HOLE CARDS ***
Dealt to matiko09 [2h 2d]
matiko09: folds 
CoolFireX: folds 
ozone2003: folds 
mycka86: folds 
Juniorquiapo: folds 
hammerwife: folds 
butcheN18: raises $1.44 to $2.44
ruslik_by: raises $6.06 to $8.50
butcheN18: folds 
Uncalled bet ($6.06) returned to ruslik_by
ruslik_by collected $4.88 from pot
ruslik_by: doesn't show hand 
*** SUMMARY ***
Total pot $4.88 | Rake $0 
Seat 2: hammerwife (button) folded before Flop (didn't bet)
Seat 3: butcheN18 (small blind) folded before Flop
Seat 4: ruslik_by (big blind) collected ($4.88)
Seat 5: matiko09 folded before Flop (didn't bet)
Seat 6: CoolFireX folded before Flop (didn't bet)
Seat 7: ozone2003 folded before Flop (didn't bet)
Seat 8: mycka86 folded before Flop (didn't bet)
Seat 9: Juniorquiapo folded before Flop (didn't bet)





PokerStars Hand #154797962708:  Hold'em No Limit ($0.50/$1.00 USD) - 2016/06/16 9:42:45 CET [2016/06/16 3:42:45 ET]
Table 'Stroobantia II' 9-max Seat #6 is the button
Seat 1: mycka86 ($103.10 in chips) 
Seat 2: Lipton20088 ($162.44 in chips) 
Seat 3: matiko09 ($100 in chips) 
Seat 4: CoolFireX ($102.55 in chips) 
Seat 5: butcheN18 ($101.50 in chips) 
Seat 6: andrewtomaz ($110.54 in chips) 
Seat 7: AlKatrone ($103.50 in chips) 
Seat 8: ruslik_by ($104 in chips) 
Seat 9: jakub249 ($80.50 in chips) 
AlKatrone: posts small blind $0.50
ruslik_by: posts big blind $1
*** HOLE CARDS ***
Dealt to matiko09 [7s 4h]
jakub249: calls $1
mycka86: folds 
Lipton20088: folds 
matiko09: folds 
CoolFireX: folds 
butcheN18: folds 
andrewtomaz: calls $1
AlKatrone: calls $0.50
ruslik_by: checks 
*** FLOP *** [9c Qs Ah]
AlKatrone: checks 
ruslik_by: checks 
jakub249: bets $3.80
andrewtomaz: calls $3.80
AlKatrone: folds 
ruslik_by: folds 
*** TURN *** [9c Qs Ah] [Jc]
jakub249: bets $5.51
andrewtomaz: calls $5.51
*** RIVER *** [9c Qs Ah Jc] [9h]
jakub249: bets $10.74
andrewtomaz: calls $10.74
*** SHOW DOWN ***
jakub249: shows [Ad Kc] (two pair, Aces and Nines)
andrewtomaz: shows [8d Td] (a straight, Eight to Queen)
andrewtomaz collected $41.90 from pot
*** SUMMARY ***
Total pot $44.10 | Rake $2.20 
Board [9c Qs Ah Jc 9h]
Seat 1: mycka86 folded before Flop (didn't bet)
Seat 2: Lipton20088 folded before Flop (didn't bet)
Seat 3: matiko09 folded before Flop (didn't bet)
Seat 4: CoolFireX folded before Flop (didn't bet)
Seat 5: butcheN18 folded before Flop (didn't bet)
Seat 6: andrewtomaz (button) showed [8d Td] and won ($41.90) with a straight, Eight to Queen
Seat 7: AlKatrone (small blind) folded on the Flop
Seat 8: ruslik_by (big blind) folded on the Flop
Seat 9: jakub249 showed [Ad Kc] and lost with two pair, Aces and Nines





PokerStars Hand #154797964163:  Hold'em No Limit ($0.50/$1.00 USD) - 2016/06/16 9:42:50 CET [2016/06/16 3:42:50 ET]
Table 'Alekto' 9-max Seat #8 is the button
Seat 1: mycka86 ($100 in chips) 
Seat 3: butcheN18 ($111.58 in chips) 
Seat 4: hammerwife ($127.19 in chips) 
Seat 5: matiko09 ($104.57 in chips) 
Seat 6: ilaviiitech ($130.36 in chips) 
Seat 8: ozone2003 ($117.02 in chips) 
Seat 9: ruslik_by ($100 in chips) 
ruslik_by: posts small blind $0.50
mycka86: posts big blind $1
CoolFireX: sits out 
*** HOLE CARDS ***
Dealt to matiko09 [6c Qd]
butcheN18: folds 
hammerwife: folds 
matiko09: folds 
ilaviiitech: folds 
ozone2003: folds 
ruslik_by: raises $2 to $3
mycka86: raises $5.40 to $8.40
ruslik_by: calls $5.40
*** FLOP *** [Td 7h 4d]
ruslik_by: checks 
mycka86: checks 
*** TURN *** [Td 7h 4d] [7c]
ruslik_by: bets $5.42
mycka86: folds 
Uncalled bet ($5.42) returned to ruslik_by
ruslik_by collected $15.96 from pot
ruslik_by: doesn't show hand 
*** SUMMARY ***
Total pot $16.80 | Rake $0.84 
Board [Td 7h 4d 7c]
Seat 1: mycka86 (big blind) folded on the Turn
Seat 3: butcheN18 folded before Flop (didn't bet)
Seat 4: hammerwife folded before Flop (didn't bet)
Seat 5: matiko09 folded before Flop (didn't bet)
Seat 6: ilaviiitech folded before Flop (didn't bet)
Seat 8: ozone2003 (button) folded before Flop (didn't bet)
Seat 9: ruslik_by (small blind) collected ($15.96)





PokerStars Hand #154797964299:  Hold'em No Limit ($0.50/$1.00 USD) - 2016/06/16 9:42:50 CET [2016/06/16 3:42:50 ET]
Table 'Nuki' 9-max Seat #1 is the button
Seat 1: Sreshta222 ($43 in chips) 
Seat 2: TideHan ($100 in chips) 
Seat 3: matiko09 ($101.50 in chips) 
Seat 4: teerajaja ($100 in chips) 
Seat 7: ruslik_by ($102.28 in chips) 
Seat 8: Marcelek_El ($81.81 in chips) 
TideHan: posts small blind $0.50
matiko09: posts big blind $1
ozone2003: sits out 
mycka86: sits out 
Lipton20088: sits out 
*** HOLE CARDS ***
Dealt to matiko09 [5s 5d]
teerajaja: folds 
ruslik_by: folds 
Marcelek_El: folds 
Sreshta222: raises $1 to $2
TideHan: folds 
matiko09: calls $1
*** FLOP *** [7h 5c 9h]
matiko09: checks 
Sreshta222: checks 
*** TURN *** [7h 5c 9h] [5h]
matiko09: bets $2.22
Sreshta222: calls $2.22
*** RIVER *** [7h 5c 9h 5h] [As]
matiko09: bets $4.41
Sreshta222: calls $4.41
*** SHOW DOWN ***
matiko09: shows [5s 5d] (four of a kind, Fives)
Sreshta222: mucks hand 
matiko09 collected $16.87 from pot
*** SUMMARY ***
Total pot $17.76 | Rake $0.89 
Board [7h 5c 9h 5h As]
Seat 1: Sreshta222 (button) mucked [Ac 6s]
Seat 2: TideHan (small blind) folded before Flop
Seat 3: matiko09 (big blind) showed [5s 5d] and won ($16.87) with four of a kind, Fives
Seat 4: teerajaja folded before Flop (didn't bet)
Seat 7: ruslik_by folded before Flop (didn't bet)
Seat 8: Marcelek_El folded before Flop (didn't bet)





PokerStars Hand #154797968420:  Hold'em No Limit ($0.50/$1.00 USD) - 2016/06/16 9:43:05 CET [2016/06/16 3:43:05 ET]
Table 'Hercynia II' 9-max Seat #3 is the button
Seat 2: hammerwife ($196.56 in chips) 
Seat 3: butcheN18 ($114.02 in chips) 
Seat 4: ruslik_by ($102.44 in chips) 
Seat 5: matiko09 ($106.30 in chips) 
Seat 6: CoolFireX ($100 in chips) 
Seat 7: ozone2003 ($120.58 in chips) 
Seat 8: mycka86 ($162.29 in chips) 
Seat 9: Juniorquiapo ($105 in chips) 
ruslik_by: posts small blind $0.50
matiko09: posts big blind $1
*** HOLE CARDS ***
Dealt to matiko09 [5d Td]
CoolFireX: folds 
ozone2003: folds 
mycka86: raises $2 to $3
Juniorquiapo: folds 
hammerwife: folds 
butcheN18: folds 
ruslik_by: raises $6.50 to $9.50
matiko09: folds 
mycka86: folds 
Uncalled bet ($6.50) returned to ruslik_by
ruslik_by collected $7 from pot
ruslik_by: doesn't show hand 
*** SUMMARY ***
Total pot $7 | Rake $0 
Seat 2: hammerwife folded before Flop (didn't bet)
Seat 3: butcheN18 (button) folded before Flop (didn't bet)
Seat 4: ruslik_by (small blind) collected ($7)
Seat 5: matiko09 (big blind) folded before Flop
Seat 6: CoolFireX folded before Flop (didn't bet)
Seat 7: ozone2003 folded before Flop (didn't bet)
Seat 8: mycka86 folded before Flop
Seat 9: Juniorquiapo folded before Flop (didn't bet)





PokerStars Hand #154797968911:  Hold'em No Limit ($0.50/$1.00 USD) - 2016/06/16 9:43:07 CET [2016/06/16 3:43:07 ET]
Table 'Markab II' 9-max Seat #6 is the button
Seat 1: AlKatrone ($101.92 in chips) 
Seat 2: mycka86 ($100 in chips) 
Seat 3: f4life1521 ($88.57 in chips) 
Seat 4: ruslik_by ($185.33 in chips) 
Seat 5: maxxmeister ($100 in chips) 
Seat 6: butcheN18 ($198.36 in chips) 
Seat 7: matiko09 ($105.25 in chips) 
Seat 8: CoolFireX ($152.70 in chips) 
Seat 9: greyman571 ($125.48 in chips) 
matiko09: posts small blind $0.50
CoolFireX: posts big blind $1
*** HOLE CARDS ***
Dealt to matiko09 [2h Ts]
greyman571: folds 
AlKatrone: folds 
mycka86: folds 
f4life1521: folds 
ruslik_by: folds 
maxxmeister: raises $2 to $3
butcheN18: folds 
matiko09: folds 
CoolFireX: folds 
Uncalled bet ($2) returned to maxxmeister
maxxmeister collected $2.50 from pot
maxxmeister: doesn't show hand 
*** SUMMARY ***
Total pot $2.50 | Rake $0 
Seat 1: AlKatrone folded before Flop (didn't bet)
Seat 2: mycka86 folded before Flop (didn't bet)
Seat 3: f4life1521 folded before Flop (didn't bet)
Seat 4: ruslik_by folded before Flop (didn't bet)
Seat 5: maxxmeister collected ($2.50)
Seat 6: butcheN18 (button) folded before Flop (didn't bet)
Seat 7: matiko09 (small blind) folded before Flop
Seat 8: CoolFireX (big blind) folded before Flop
Seat 9: greyman571 folded before Flop (didn't bet)





PokerStars Hand #154797969759:  Hold'em No Limit ($0.50/$1.00 USD) - 2016/06/16 9:43:10 CET [2016/06/16 3:43:10 ET]
Table 'Astyanax' 9-max Seat #1 is the button
Seat 1: pokerich462 ($190.49 in chips) 
Seat 2: matiko09 ($100 in chips) 
Seat 3: hammerwife ($119.82 in chips) 
Seat 4: teerajaja ($100 in chips) 
Seat 5: butcheN18 ($128.85 in chips) 
Seat 8: mycka86 ($102.70 in chips) 
Seat 9: CoolFireX ($108.74 in chips) 
matiko09: posts small blind $0.50
hammerwife: posts big blind $1
ruslik_by: sits out 
pokerich462: posts the ante $0.20
matiko09: posts the ante $0.20
hammerwife: posts the ante $0.20
teerajaja: posts the ante $0.20
butcheN18: posts the ante $0.20
mycka86: posts the ante $0.20
CoolFireX: posts the ante $0.20
*** HOLE CARDS ***
Dealt to matiko09 [9s Qs]
teerajaja: folds 
butcheN18: folds 
mycka86: folds 
CoolFireX: raises $1.50 to $2.50
pokerich462: folds 
matiko09: folds 
hammerwife: folds 
Uncalled bet ($1.50) returned to CoolFireX
CoolFireX collected $3.90 from pot
CoolFireX: doesn't show hand 
*** SUMMARY ***
Total pot $3.90 | Rake $0 
Seat 1: pokerich462 (button) folded before Flop (didn't bet)
Seat 2: matiko09 (small blind) folded before Flop
Seat 3: hammerwife (big blind) folded before Flop
Seat 4: teerajaja folded before Flop (didn't bet)
Seat 5: butcheN18 folded before Flop (didn't bet)
Seat 8: mycka86 folded before Flop (didn't bet)
Seat 9: CoolFireX collected ($3.90)





PokerStars Hand #154797974082:  Hold'em No Limit ($0.25/$0.50 USD) - 2016/06/16 9:43:25 CET [2016/06/16 3:43:25 ET]
Table 'Gaea' 9-max Seat #1 is the button
Seat 1: jasonhan416 ($50.79 in chips) 
Seat 2: magzi777 ($51.64 in chips) 
Seat 3: Crazyfish87 ($42.69 in chips) 
Seat 4: matiko09 ($68.77 in chips) 
Seat 5: Kapa09 ($51.25 in chips) 
Seat 6: Alex Frider ($66.56 in chips) 
Seat 7: Dantist1122 ($50 in chips) 
Seat 8: Red_Warning ($50 in chips) 
Seat 9: Prophet1906 ($59.71 in chips) 
magzi777: posts small blind $0.25
Crazyfish87: posts big blind $0.50
*** HOLE CARDS ***
Dealt to matiko09 [9s 8s]
matiko09: raises $1 to $1.50
Kapa09: folds 
Alex Frider: calls $1.50
Dantist1122: folds 
Red_Warning: folds 
Prophet1906: folds 
jasonhan416: folds 
magzi777: folds 
Crazyfish87: folds 
*** FLOP *** [Qc Td 7c]
matiko09: bets $2.31
Alex Frider: folds 
Uncalled bet ($2.31) returned to matiko09
matiko09 collected $3.56 from pot
matiko09: doesn't show hand 
*** SUMMARY ***
Total pot $3.75 | Rake $0.19 
Board [Qc Td 7c]
Seat 1: jasonhan416 (button) folded before Flop (didn't bet)
Seat 2: magzi777 (small blind) folded before Flop
Seat 3: Crazyfish87 (big blind) folded before Flop
Seat 4: matiko09 collected ($3.56)
Seat 5: Kapa09 folded before Flop (didn't bet)
Seat 6: Alex Frider folded on the Flop
Seat 7: Dantist1122 folded before Flop (didn't bet)
Seat 8: Red_Warning folded before Flop (didn't bet)
Seat 9: Prophet1906 folded before Flop (didn't bet)





PokerStars Hand #154797976625:  Hold'em No Limit ($0.50/$1.00 USD) - 2016/06/16 9:43:34 CET [2016/06/16 3:43:34 ET]
Table 'Astyanax' 9-max Seat #2 is the button
Seat 1: pokerich462 ($190.29 in chips) 
Seat 2: matiko09 ($100 in chips) 
Seat 3: hammerwife ($118.62 in chips) 
Seat 5: butcheN18 ($128.65 in chips) 
Seat 8: mycka86 ($102.50 in chips) 
Seat 9: CoolFireX ($111.44 in chips) 
hammerwife: posts small blind $0.50
teerajaja: is sitting out 
teerajaja leaves the table
butcheN18: posts big blind $1
ruslik_by: sits out 
pokerich462: posts the ante $0.20
matiko09: posts the ante $0.20
hammerwife: posts the ante $0.20
butcheN18: posts the ante $0.20
mycka86: posts the ante $0.20
CoolFireX: posts the ante $0.20
*** HOLE CARDS ***
Dealt to matiko09 [4h 6d]
mycka86: raises $2 to $3
CoolFireX: folds 
pokerich462: folds 
matiko09: folds 
pokerich462 leaves the table
hammerwife: folds 
butcheN18: folds 
Uncalled bet ($2) returned to mycka86
mycka86 collected $3.70 from pot
*** SUMMARY ***
Total pot $3.70 | Rake $0 
Seat 1: pokerich462 folded before Flop (didn't bet)
Seat 2: matiko09 (button) folded before Flop (didn't bet)
Seat 3: hammerwife (small blind) folded before Flop
Seat 5: butcheN18 (big blind) folded before Flop
Seat 8: mycka86 collected ($3.70)
Seat 9: CoolFireX folded before Flop (didn't bet)





PokerStars Hand #154797980531:  Hold'em No Limit ($0.50/$1.00 USD) - 2016/06/16 9:43:48 CET [2016/06/16 3:43:48 ET]
Table 'Markab II' 9-max Seat #7 is the button
Seat 1: AlKatrone ($101.92 in chips) 
Seat 2: mycka86 ($100 in chips) 
Seat 3: f4life1521 ($88.57 in chips) 
Seat 4: ruslik_by ($185.33 in chips) 
Seat 5: maxxmeister ($101.50 in chips) 
Seat 6: butcheN18 ($198.36 in chips) 
Seat 7: matiko09 ($104.75 in chips) 
Seat 8: CoolFireX ($151.70 in chips) 
Seat 9: greyman571 ($125.48 in chips) 
CoolFireX: posts small blind $0.50
greyman571: posts big blind $1
*** HOLE CARDS ***
Dealt to matiko09 [4c Td]
AlKatrone: raises $2 to $3
mycka86: folds 
f4life1521: folds 
ruslik_by: folds 
maxxmeister: folds 
butcheN18: folds 
matiko09: folds 
CoolFireX: calls $2.50
greyman571: folds 
*** FLOP *** [Ad Jh 5h]
CoolFireX: checks 
AlKatrone: bets $4.98
CoolFireX: folds 
Uncalled bet ($4.98) returned to AlKatrone
AlKatrone collected $6.65 from pot
*** SUMMARY ***
Total pot $7 | Rake $0.35 
Board [Ad Jh 5h]
Seat 1: AlKatrone collected ($6.65)
Seat 2: mycka86 folded before Flop (didn't bet)
Seat 3: f4life1521 folded before Flop (didn't bet)
Seat 4: ruslik_by folded before Flop (didn't bet)
Seat 5: maxxmeister folded before Flop (didn't bet)
Seat 6: butcheN18 folded before Flop (didn't bet)
Seat 7: matiko09 (button) folded before Flop (didn't bet)
Seat 8: CoolFireX (small blind) folded on the Flop
Seat 9: greyman571 (big blind) folded before Flop





PokerStars Hand #154797980918:  Hold'em No Limit ($0.50/$1.00 USD) - 2016/06/16 9:43:49 CET [2016/06/16 3:43:49 ET]
Table 'Nuki' 9-max Seat #2 is the button
Seat 1: Sreshta222 ($40 in chips) 
Seat 2: TideHan ($100 in chips) 
Seat 3: matiko09 ($109.74 in chips) 
Seat 4: teerajaja ($100 in chips) 
Seat 7: ruslik_by ($102.28 in chips) 
Seat 8: Marcelek_El ($81.81 in chips) 
matiko09: posts small blind $0.50
teerajaja: posts big blind $1
ozone2003: sits out 
mycka86: sits out 
Lipton20088: sits out 
*** HOLE CARDS ***
Dealt to matiko09 [7h 9s]
ruslik_by: folds 
Marcelek_El: folds 
Sreshta222: folds 
TideHan: raises $1.25 to $2.25
matiko09: folds 
teerajaja: folds 
Uncalled bet ($1.25) returned to TideHan
TideHan collected $2.50 from pot
TideHan: doesn't show hand 
*** SUMMARY ***
Total pot $2.50 | Rake $0 
Seat 1: Sreshta222 folded before Flop (didn't bet)
Seat 2: TideHan (button) collected ($2.50)
Seat 3: matiko09 (small blind) folded before Flop
Seat 4: teerajaja (big blind) folded before Flop
Seat 7: ruslik_by folded before Flop (didn't bet)
Seat 8: Marcelek_El folded before Flop (didn't bet)





PokerStars Hand #154797982919:  Hold'em No Limit ($0.50/$1.00 USD) - 2016/06/16 9:43:57 CET [2016/06/16 3:43:57 ET]
Table 'Hercynia II' 9-max Seat #4 is the button
Seat 2: hammerwife ($196.56 in chips) 
Seat 3: butcheN18 ($114.02 in chips) 
Seat 4: ruslik_by ($106.44 in chips) 
Seat 5: matiko09 ($105.30 in chips) 
Seat 6: CoolFireX ($100 in chips) 
Seat 7: ozone2003 ($120.58 in chips) 
Seat 8: mycka86 ($159.29 in chips) 
Seat 9: Juniorquiapo ($105 in chips) 
matiko09: posts small blind $0.50
CoolFireX: posts big blind $1
*** HOLE CARDS ***
Dealt to matiko09 [9d 6d]
ozone2003: folds 
mycka86: raises $2 to $3
Juniorquiapo: folds 
hammerwife: folds 
butcheN18: folds 
ruslik_by: folds 
matiko09: folds 
CoolFireX: folds 
Uncalled bet ($2) returned to mycka86
mycka86 collected $2.50 from pot
*** SUMMARY ***
Total pot $2.50 | Rake $0 
Seat 2: hammerwife folded before Flop (didn't bet)
Seat 3: butcheN18 folded before Flop (didn't bet)
Seat 4: ruslik_by (button) folded before Flop (didn't bet)
Seat 5: matiko09 (small blind) folded before Flop
Seat 6: CoolFireX (big blind) folded before Flop
Seat 7: ozone2003 folded before Flop (didn't bet)
Seat 8: mycka86 collected ($2.50)
Seat 9: Juniorquiapo folded before Flop (didn't bet)





PokerStars Hand #154797983582:  Hold'em No Limit ($0.50/$1.00 USD) - 2016/06/16 9:43:59 CET [2016/06/16 3:43:59 ET]
Table 'Astyanax' 9-max Seat #3 is the button
Seat 2: matiko09 ($100 in chips) 
Seat 3: hammerwife ($117.92 in chips) 
Seat 5: butcheN18 ($127.45 in chips) 
Seat 6: ruslik_by ($100 in chips) 
Seat 8: mycka86 ($105 in chips) 
Seat 9: CoolFireX ($111.24 in chips) 
butcheN18: posts small blind $0.50
ruslik_by: posts big blind $1
matiko09: posts the ante $0.20
hammerwife: posts the ante $0.20
butcheN18: posts the ante $0.20
ruslik_by: posts the ante $0.20
mycka86: posts the ante $0.20
CoolFireX: posts the ante $0.20
*** HOLE CARDS ***
Dealt to matiko09 [Qc 2c]
mycka86: folds 
CoolFireX: folds 
Sreshta222 joins the table at seat #4 
matiko09: folds 
hammerwife: folds 
Sreshta222 leaves the table
butcheN18: raises $2 to $3
ruslik_by: calls $2
*** FLOP *** [As Ah Qs]
butcheN18: bets $3.55
ruslik_by: folds 
Uncalled bet ($3.55) returned to butcheN18
butcheN18 collected $6.84 from pot
butcheN18: doesn't show hand 
*** SUMMARY ***
Total pot $7.20 | Rake $0.36 
Board [As Ah Qs]
Seat 2: matiko09 folded before Flop (didn't bet)
Seat 3: hammerwife (button) folded before Flop (didn't bet)
Seat 5: butcheN18 (small blind) collected ($6.84)
Seat 6: ruslik_by (big blind) folded on the Flop
Seat 8: mycka86 folded before Flop (didn't bet)
Seat 9: CoolFireX folded before Flop (didn't bet)





PokerStars Hand #154797985508:  Hold'em No Limit ($0.50/$1.00 USD) - 2016/06/16 9:44:06 CET [2016/06/16 3:44:06 ET]
Table 'Nuki' 9-max Seat #3 is the button
Seat 1: Sreshta222 ($40 in chips) 
Seat 2: TideHan ($101.50 in chips) 
Seat 3: matiko09 ($109.24 in chips) 
Seat 4: teerajaja ($100 in chips) 
Seat 5: ozone2003 ($100 in chips) 
Seat 7: ruslik_by ($102.28 in chips) 
Seat 8: Marcelek_El ($81.81 in chips) 
teerajaja: posts small blind $0.50
ozone2003: posts big blind $1
mycka86: sits out 
Lipton20088: sits out 
*** HOLE CARDS ***
Dealt to matiko09 [4h 2s]
ruslik_by: folds 
Marcelek_El: folds 
Sreshta222: folds 
TideHan: folds 
matiko09: folds 
teerajaja: folds 
Uncalled bet ($0.50) returned to ozone2003
ozone2003 collected $1 from pot
ozone2003: doesn't show hand 
*** SUMMARY ***
Total pot $1 | Rake $0 
Seat 1: Sreshta222 folded before Flop (didn't bet)
Seat 2: TideHan folded before Flop (didn't bet)
Seat 3: matiko09 (button) folded before Flop (didn't bet)
Seat 4: teerajaja (small blind) folded before Flop
Seat 5: ozone2003 (big blind) collected ($1)
Seat 7: ruslik_by folded before Flop (didn't bet)
Seat 8: Marcelek_El folded before Flop (didn't bet)





PokerStars Hand #154797986157:  Hold'em No Limit ($0.50/$1.00 USD) - 2016/06/16 9:44:08 CET [2016/06/16 3:44:08 ET]
Table 'Alekto' 9-max Seat #9 is the button
Seat 1: mycka86 ($100 in chips) 
Seat 2: CoolFireX ($100 in chips) 
Seat 3: butcheN18 ($111.58 in chips) 
Seat 4: hammerwife ($127.19 in chips) 
Seat 5: matiko09 ($104.57 in chips) 
Seat 6: ilaviiitech ($130.36 in chips) 
Seat 8: ozone2003 ($117.02 in chips) 
Seat 9: ruslik_by ($107.56 in chips) 
mycka86: posts small blind $0.50
CoolFireX: posts big blind $1
*** HOLE CARDS ***
Dealt to matiko09 [Ah 7c]
butcheN18: folds 
hammerwife: raises $2 to $3
matiko09: folds 
ilaviiitech: folds 
ozone2003: folds 
ruslik_by: folds 
mycka86: folds 
CoolFireX: folds 
Uncalled bet ($2) returned to hammerwife
hammerwife collected $2.50 from pot
hammerwife: doesn't show hand 
*** SUMMARY ***
Total pot $2.50 | Rake $0 
Seat 1: mycka86 (small blind) folded before Flop
Seat 2: CoolFireX (big blind) folded before Flop
Seat 3: butcheN18 folded before Flop (didn't bet)
Seat 4: hammerwife collected ($2.50)
Seat 5: matiko09 folded before Flop (didn't bet)
Seat 6: ilaviiitech folded before Flop (didn't bet)
Seat 8: ozone2003 folded before Flop (didn't bet)
Seat 9: ruslik_by (button) folded before Flop (didn't bet)





PokerStars Hand #154797992388:  Hold'em No Limit ($0.50/$1.00 USD) - 2016/06/16 9:44:30 CET [2016/06/16 3:44:30 ET]
Table 'Nuki' 9-max Seat #4 is the button
Seat 1: Sreshta222 ($40 in chips) 
Seat 2: TideHan ($101.50 in chips) 
Seat 3: matiko09 ($109.24 in chips) 
Seat 4: teerajaja ($100 in chips) 
Seat 5: ozone2003 ($100.50 in chips) 
Seat 6: mycka86 ($100 in chips) 
Seat 7: ruslik_by ($102.28 in chips) 
Seat 8: Marcelek_El ($81.81 in chips) 
ozone2003: posts small blind $0.50
mycka86: posts big blind $1
Lipton20088: sits out 
*** HOLE CARDS ***
Dealt to matiko09 [9c 8s]
ruslik_by: folds 
Marcelek_El: folds 
Sreshta222: folds 
TideHan: folds 
matiko09: folds 
teerajaja: raises $1.40 to $2.40
ozone2003: folds 
mycka86: folds 
Uncalled bet ($1.40) returned to teerajaja
teerajaja collected $2.50 from pot
teerajaja: doesn't show hand 
*** SUMMARY ***
Total pot $2.50 | Rake $0 
Seat 1: Sreshta222 folded before Flop (didn't bet)
Seat 2: TideHan folded before Flop (didn't bet)
Seat 3: matiko09 folded before Flop (didn't bet)
Seat 4: teerajaja (button) collected ($2.50)
Seat 5: ozone2003 (small blind) folded before Flop
Seat 6: mycka86 (big blind) folded before Flop
Seat 7: ruslik_by folded before Flop (didn't bet)
Seat 8: Marcelek_El folded before Flop (didn't bet)





PokerStars Hand #154797995393:  Hold'em No Limit ($0.50/$1.00 USD) - 2016/06/16 9:44:40 CET [2016/06/16 3:44:40 ET]
Table 'Markab II' 9-max Seat #8 is the button
Seat 1: AlKatrone ($105.57 in chips) 
Seat 2: mycka86 ($100 in chips) 
Seat 3: f4life1521 ($88.57 in chips) 
Seat 4: ruslik_by ($185.33 in chips) 
Seat 5: maxxmeister ($101.50 in chips) 
Seat 6: butcheN18 ($198.36 in chips) 
Seat 7: matiko09 ($104.75 in chips) 
Seat 8: CoolFireX ($148.70 in chips) 
Seat 9: greyman571 ($124.48 in chips) 
greyman571: posts small blind $0.50
AlKatrone: posts big blind $1
*** HOLE CARDS ***
Dealt to matiko09 [Td Tc]
mycka86: raises $2 to $3
f4life1521: folds 
ruslik_by: folds 
maxxmeister: folds 
butcheN18: folds 
matiko09: calls $3
CoolFireX: folds 
greyman571: folds 
AlKatrone: folds 
*** FLOP *** [Qd 2d 5d]
mycka86: checks 
matiko09: checks 
*** TURN *** [Qd 2d 5d] [Qs]
mycka86: bets $5
matiko09: calls $5
*** RIVER *** [Qd 2d 5d Qs] [4c]
mycka86: checks 
matiko09: checks 
*** SHOW DOWN ***
mycka86: shows [6d 6s] (two pair, Queens and Sixes)
matiko09: shows [Td Tc] (two pair, Queens and Tens)
matiko09 collected $16.62 from pot
*** SUMMARY ***
Total pot $17.50 | Rake $0.88 
Board [Qd 2d 5d Qs 4c]
Seat 1: AlKatrone (big blind) folded before Flop
Seat 2: mycka86 showed [6d 6s] and lost with two pair, Queens and Sixes
Seat 3: f4life1521 folded before Flop (didn't bet)
Seat 4: ruslik_by folded before Flop (didn't bet)
Seat 5: maxxmeister folded before Flop (didn't bet)
Seat 6: butcheN18 folded before Flop (didn't bet)
Seat 7: matiko09 showed [Td Tc] and won ($16.62) with two pair, Queens and Tens
Seat 8: CoolFireX (button) folded before Flop (didn't bet)
Seat 9: greyman571 (small blind) folded before Flop





PokerStars Hand #154797996716:  Hold'em No Limit ($0.50/$1.00 USD) - 2016/06/16 9:44:45 CET [2016/06/16 3:44:45 ET]
Table 'Alekto' 9-max Seat #1 is the button
Seat 1: mycka86 ($100 in chips) 
Seat 2: CoolFireX ($100 in chips) 
Seat 4: hammerwife ($128.69 in chips) 
Seat 5: matiko09 ($104.57 in chips) 
Seat 6: ilaviiitech ($130.36 in chips) 
Seat 8: ozone2003 ($117.02 in chips) 
Seat 9: ruslik_by ($107.56 in chips) 
CoolFireX: posts small blind $0.50
butcheN18: is sitting out 
hammerwife: posts big blind $1
*** HOLE CARDS ***
Dealt to matiko09 [4d 9s]
butcheN18 leaves the table
matiko09: folds 
ilaviiitech: folds 
ozone2003: folds 
ruslik_by: folds 
mycka86: raises $1.10 to $2.10
CoolFireX: folds 
hammerwife: folds 
Uncalled bet ($1.10) returned to mycka86
mycka86 collected $2.50 from pot
*** SUMMARY ***
Total pot $2.50 | Rake $0 
Seat 1: mycka86 (button) collected ($2.50)
Seat 2: CoolFireX (small blind) folded before Flop
Seat 4: hammerwife (big blind) folded before Flop
Seat 5: matiko09 folded before Flop (didn't bet)
Seat 6: ilaviiitech folded before Flop (didn't bet)
Seat 8: ozone2003 folded before Flop (didn't bet)
Seat 9: ruslik_by folded before Flop (didn't bet)





PokerStars Hand #154797997159:  Hold'em No Limit ($0.50/$1.00 USD) - 2016/06/16 9:44:47 CET [2016/06/16 3:44:47 ET]
Table 'Astyanax' 9-max Seat #5 is the button
Seat 2: matiko09 ($100 in chips) 
Seat 3: hammerwife ($117.72 in chips) 
Seat 5: butcheN18 ($131.09 in chips) 
Seat 6: ruslik_by ($100 in chips) 
Seat 9: CoolFireX ($111.04 in chips) 
ruslik_by: posts small blind $0.50
mycka86: is sitting out 
CoolFireX: posts big blind $1
matiko09: posts the ante $0.20
hammerwife: posts the ante $0.20
butcheN18: posts the ante $0.20
ruslik_by: posts the ante $0.20
CoolFireX: posts the ante $0.20
*** HOLE CARDS ***
Dealt to matiko09 [5c Js]
matiko09: folds 
hammerwife: folds 
butcheN18: folds 
mycka86 leaves the table
ruslik_by: folds 
Uncalled bet ($0.50) returned to CoolFireX
CoolFireX collected $2 from pot
CoolFireX: doesn't show hand 
*** SUMMARY ***
Total pot $2 | Rake $0 
Seat 2: matiko09 folded before Flop (didn't bet)
Seat 3: hammerwife folded before Flop (didn't bet)
Seat 5: butcheN18 (button) folded before Flop (didn't bet)
Seat 6: ruslik_by (small blind) folded before Flop
Seat 9: CoolFireX (big blind) collected ($2)





PokerStars Hand #154797997868:  Hold'em No Limit ($0.50/$1.00 USD) - 2016/06/16 9:44:49 CET [2016/06/16 3:44:49 ET]
Table 'Hercynia II' 9-max Seat #5 is the button
Seat 2: hammerwife ($196.56 in chips) 
Seat 3: butcheN18 ($114.02 in chips) 
Seat 4: ruslik_by ($106.44 in chips) 
Seat 5: matiko09 ($104.80 in chips) 
Seat 6: CoolFireX ($100 in chips) 
Seat 7: ozone2003 ($120.58 in chips) 
Seat 8: mycka86 ($160.79 in chips) 
Seat 9: Juniorquiapo ($105 in chips) 
CoolFireX: posts small blind $0.50
ozone2003: posts big blind $1
*** HOLE CARDS ***
Dealt to matiko09 [Ad 5s]
mycka86: folds 
Juniorquiapo: calls $1
hammerwife: folds 
butcheN18: folds 
ruslik_by: folds 
matiko09: raises $3 to $4
CoolFireX: folds 
ozone2003: folds 
Juniorquiapo: calls $3
*** FLOP *** [Qh 6s 9c]
Juniorquiapo: checks 
matiko09: checks 
*** TURN *** [Qh 6s 9c] [6d]
Juniorquiapo: checks 
matiko09: checks 
*** RIVER *** [Qh 6s 9c 6d] [Ah]
Juniorquiapo: checks 
matiko09: bets $2.79
Juniorquiapo: folds 
Uncalled bet ($2.79) returned to matiko09
matiko09 collected $9.02 from pot
matiko09: doesn't show hand 
*** SUMMARY ***
Total pot $9.50 | Rake $0.48 
Board [Qh 6s 9c 6d Ah]
Seat 2: hammerwife folded before Flop (didn't bet)
Seat 3: butcheN18 folded before Flop (didn't bet)
Seat 4: ruslik_by folded before Flop (didn't bet)
Seat 5: matiko09 (button) collected ($9.02)
Seat 6: CoolFireX (small blind) folded before Flop
Seat 7: ozone2003 (big blind) folded before Flop
Seat 8: mycka86 folded before Flop (didn't bet)
Seat 9: Juniorquiapo folded on the River





PokerStars Hand #154797998010:  Hold'em No Limit ($0.50/$1.00 USD) - 2016/06/16 9:44:50 CET [2016/06/16 3:44:50 ET]
Table 'Stroobantia II' 9-max Seat #7 is the button
Seat 1: mycka86 ($103.10 in chips) 
Seat 2: Lipton20088 ($162.44 in chips) 
Seat 3: matiko09 ($100 in chips) 
Seat 4: CoolFireX ($102.55 in chips) 
Seat 5: butcheN18 ($101.50 in chips) 
Seat 6: andrewtomaz ($131.39 in chips) 
Seat 7: AlKatrone ($102.50 in chips) 
Seat 8: ruslik_by ($103 in chips) 
Seat 9: jakub249 ($59.45 in chips) 
ruslik_by: posts small blind $0.50
jakub249: posts big blind $1
*** HOLE CARDS ***
Dealt to matiko09 [Td 3s]
mycka86: folds 
Lipton20088: folds 
matiko09: folds 
CoolFireX: folds 
butcheN18: raises $2 to $3
andrewtomaz: folds 
AlKatrone: folds 
ruslik_by: folds 
jakub249: calls $2
*** FLOP *** [Tc 4d 5c]
jakub249: checks 
butcheN18: bets $3.83
jakub249: folds 
Uncalled bet ($3.83) returned to butcheN18
butcheN18 collected $6.18 from pot
butcheN18: doesn't show hand 
*** SUMMARY ***
Total pot $6.50 | Rake $0.32 
Board [Tc 4d 5c]
Seat 1: mycka86 folded before Flop (didn't bet)
Seat 2: Lipton20088 folded before Flop (didn't bet)
Seat 3: matiko09 folded before Flop (didn't bet)
Seat 4: CoolFireX folded before Flop (didn't bet)
Seat 5: butcheN18 collected ($6.18)
Seat 6: andrewtomaz folded before Flop (didn't bet)
Seat 7: AlKatrone (button) folded before Flop (didn't bet)
Seat 8: ruslik_by (small blind) folded before Flop
Seat 9: jakub249 (big blind) folded on the Flop





PokerStars Hand #154798001872:  Hold'em No Limit ($0.50/$1.00 USD) - 2016/06/16 9:45:03 CET [2016/06/16 3:45:03 ET]
Table 'Nuki' 9-max Seat #5 is the button
Seat 1: Sreshta222 ($40 in chips) 
Seat 2: TideHan ($101.50 in chips) 
Seat 3: matiko09 ($109.24 in chips) 
Seat 4: teerajaja ($101.50 in chips) 
Seat 5: ozone2003 ($100 in chips) 
Seat 6: mycka86 ($100 in chips) 
Seat 7: ruslik_by ($102.28 in chips) 
Seat 8: Marcelek_El ($81.81 in chips) 
mycka86: posts small blind $0.50
ruslik_by: posts big blind $1
Lipton20088: sits out 
*** HOLE CARDS ***
Dealt to matiko09 [3s 4d]
Marcelek_El: raises $1.50 to $2.50
Sreshta222: folds 
TideHan: folds 
matiko09: folds 
teerajaja: folds 
ozone2003: folds 
mycka86: folds 
ruslik_by: folds 
Uncalled bet ($1.50) returned to Marcelek_El
Marcelek_El collected $2.50 from pot
Marcelek_El: doesn't show hand 
*** SUMMARY ***
Total pot $2.50 | Rake $0 
Seat 1: Sreshta222 folded before Flop (didn't bet)
Seat 2: TideHan folded before Flop (didn't bet)
Seat 3: matiko09 folded before Flop (didn't bet)
Seat 4: teerajaja folded before Flop (didn't bet)
Seat 5: ozone2003 (button) folded before Flop (didn't bet)
Seat 6: mycka86 (small blind) folded before Flop
Seat 7: ruslik_by (big blind) folded before Flop
Seat 8: Marcelek_El collected ($2.50)





PokerStars Hand #154798014465:  Hold'em No Limit ($0.50/$1.00 USD) - 2016/06/16 9:45:48 CET [2016/06/16 3:45:48 ET]
Table 'Hercynia II' 9-max Seat #6 is the button
Seat 2: hammerwife ($196.56 in chips) 
Seat 3: butcheN18 ($114.02 in chips) 
Seat 4: ruslik_by ($106.44 in chips) 
Seat 5: matiko09 ($109.82 in chips) 
Seat 6: CoolFireX ($100 in chips) 
Seat 7: ozone2003 ($119.58 in chips) 
Seat 8: mycka86 ($160.79 in chips) 
Seat 9: Juniorquiapo ($101 in chips) 
ozone2003: posts small blind $0.50
mycka86: posts big blind $1
*** HOLE CARDS ***
Dealt to matiko09 [4h 7h]
Juniorquiapo: calls $1
hammerwife: folds 
butcheN18: folds 
ruslik_by: folds 
matiko09: folds 
CoolFireX: folds 
ozone2003: folds 
mycka86: checks 
*** FLOP *** [Ac Qc 3h]
mycka86: checks 
Juniorquiapo: checks 
*** TURN *** [Ac Qc 3h] [6d]
mycka86: checks 
Juniorquiapo: bets $2
mycka86: folds 
Uncalled bet ($2) returned to Juniorquiapo
Juniorquiapo collected $2.38 from pot
*** SUMMARY ***
Total pot $2.50 | Rake $0.12 
Board [Ac Qc 3h 6d]
Seat 2: hammerwife folded before Flop (didn't bet)
Seat 3: butcheN18 folded before Flop (didn't bet)
Seat 4: ruslik_by folded before Flop (didn't bet)
Seat 5: matiko09 folded before Flop (didn't bet)
Seat 6: CoolFireX (button) folded before Flop (didn't bet)
Seat 7: ozone2003 (small blind) folded before Flop
Seat 8: mycka86 (big blind) folded on the Turn
Seat 9: Juniorquiapo collected ($2.38)





PokerStars Hand #154798015216:  Hold'em No Limit ($0.50/$1.00 USD) - 2016/06/16 9:45:51 CET [2016/06/16 3:45:51 ET]
Table 'Markab II' 9-max Seat #9 is the button
Seat 1: AlKatrone ($104.57 in chips) 
Seat 2: mycka86 ($100 in chips) 
Seat 3: f4life1521 ($88.57 in chips) 
Seat 4: ruslik_by ($185.33 in chips) 
Seat 5: maxxmeister ($101.50 in chips) 
Seat 6: butcheN18 ($198.36 in chips) 
Seat 7: matiko09 ($113.37 in chips) 
Seat 8: CoolFireX ($148.70 in chips) 
Seat 9: greyman571 ($123.98 in chips) 
AlKatrone: posts small blind $0.50
mycka86: posts big blind $1
*** HOLE CARDS ***
Dealt to matiko09 [Js 5c]
f4life1521: folds 
ruslik_by: folds 
maxxmeister: raises $2 to $3
butcheN18: folds 
matiko09: folds 
CoolFireX: folds 
greyman571: folds 
AlKatrone: folds 
mycka86: folds 
Uncalled bet ($2) returned to maxxmeister
maxxmeister collected $2.50 from pot
maxxmeister: doesn't show hand 
*** SUMMARY ***
Total pot $2.50 | Rake $0 
Seat 1: AlKatrone (small blind) folded before Flop
Seat 2: mycka86 (big blind) folded before Flop
Seat 3: f4life1521 folded before Flop (didn't bet)
Seat 4: ruslik_by folded before Flop (didn't bet)
Seat 5: maxxmeister collected ($2.50)
Seat 6: butcheN18 folded before Flop (didn't bet)
Seat 7: matiko09 folded before Flop (didn't bet)
Seat 8: CoolFireX folded before Flop (didn't bet)
Seat 9: greyman571 (button) folded before Flop (didn't bet)





PokerStars Hand #154798017359:  Hold'em No Limit ($0.50/$1.00 USD) - 2016/06/16 9:45:58 CET [2016/06/16 3:45:58 ET]
Table 'Nuki' 9-max Seat #6 is the button
Seat 1: Sreshta222 ($40 in chips) 
Seat 2: TideHan ($101.50 in chips) 
Seat 3: matiko09 ($109.24 in chips) 
Seat 4: teerajaja ($101.50 in chips) 
Seat 5: ozone2003 ($100 in chips) 
Seat 6: mycka86 ($100 in chips) 
Seat 7: ruslik_by ($101.28 in chips) 
Seat 8: Marcelek_El ($83.31 in chips) 
ruslik_by: posts small blind $0.50
Marcelek_El: posts big blind $1
Lipton20088: sits out 
*** HOLE CARDS ***
Dealt to matiko09 [Qd Th]
Sreshta222: folds 
TideHan: folds 
matiko09: folds 
teerajaja: folds 
ozone2003: folds 
mycka86: raises $1.10 to $2.10
ruslik_by: raises $6.40 to $8.50
Marcelek_El: folds 
mycka86: raises $9.40 to $17.90
ruslik_by: raises $15.10 to $33
mycka86: folds 
Uncalled bet ($15.10) returned to ruslik_by
ruslik_by collected $36.80 from pot
ruslik_by: doesn't show hand 
*** SUMMARY ***
Total pot $36.80 | Rake $0 
Seat 1: Sreshta222 folded before Flop (didn't bet)
Seat 2: TideHan folded before Flop (didn't bet)
Seat 3: matiko09 folded before Flop (didn't bet)
Seat 4: teerajaja folded before Flop (didn't bet)
Seat 5: ozone2003 folded before Flop (didn't bet)
Seat 6: mycka86 (button) folded before Flop
Seat 7: ruslik_by (small blind) collected ($36.80)
Seat 8: Marcelek_El (big blind) folded before Flop





PokerStars Hand #154798019300:  Hold'em No Limit ($0.50/$1.00 USD) - 2016/06/16 9:46:05 CET [2016/06/16 3:46:05 ET]
Table 'Stroobantia II' 9-max Seat #8 is the button
Seat 1: mycka86 ($103.10 in chips) 
Seat 2: Lipton20088 ($162.44 in chips) 
Seat 3: matiko09 ($100 in chips) 
Seat 4: CoolFireX ($102.55 in chips) 
Seat 5: butcheN18 ($104.68 in chips) 
Seat 6: andrewtomaz ($131.39 in chips) 
Seat 7: AlKatrone ($102.50 in chips) 
Seat 8: ruslik_by ($102.50 in chips) 
Seat 9: jakub249 ($56.45 in chips) 
jakub249: posts small blind $0.50
mycka86: posts big blind $1
*** HOLE CARDS ***
Dealt to matiko09 [6c As]
Lipton20088: folds 
matiko09: folds 
CoolFireX: folds 
butcheN18: raises $2 to $3
andrewtomaz: calls $3
AlKatrone: folds 
ruslik_by: folds 
jakub249: folds 
mycka86: folds 
*** FLOP *** [5s Tc Jh]
butcheN18: checks 
andrewtomaz: bets $3
butcheN18: calls $3
*** TURN *** [5s Tc Jh] [7s]
butcheN18: checks 
andrewtomaz: bets $5
butcheN18: folds 
Uncalled bet ($5) returned to andrewtomaz
andrewtomaz collected $12.82 from pot
*** SUMMARY ***
Total pot $13.50 | Rake $0.68 
Board [5s Tc Jh 7s]
Seat 1: mycka86 (big blind) folded before Flop
Seat 2: Lipton20088 folded before Flop (didn't bet)
Seat 3: matiko09 folded before Flop (didn't bet)
Seat 4: CoolFireX folded before Flop (didn't bet)
Seat 5: butcheN18 folded on the Turn
Seat 6: andrewtomaz collected ($12.82)
Seat 7: AlKatrone folded before Flop (didn't bet)
Seat 8: ruslik_by (button) folded before Flop (didn't bet)
Seat 9: jakub249 (small blind) folded before Flop





PokerStars Hand #154798030394:  Hold'em No Limit ($0.50/$1.00 USD) - 2016/06/16 9:46:44 CET [2016/06/16 3:46:44 ET]
Table 'Hercynia II' 9-max Seat #7 is the button
Seat 2: hammerwife ($196.56 in chips) 
Seat 3: butcheN18 ($114.02 in chips) 
Seat 4: ruslik_by ($106.44 in chips) 
Seat 5: matiko09 ($109.82 in chips) 
Seat 6: CoolFireX ($100 in chips) 
Seat 7: ozone2003 ($119.08 in chips) 
Seat 8: mycka86 ($159.79 in chips) 
Seat 9: Juniorquiapo ($102.38 in chips) 
mycka86: posts small blind $0.50
Juniorquiapo: posts big blind $1
*** HOLE CARDS ***
Dealt to matiko09 [Kc 3s]
hammerwife: raises $2 to $3
butcheN18: folds 
ruslik_by: folds 
matiko09: folds 
CoolFireX: folds 
ozone2003: folds 
mycka86: folds 
Juniorquiapo: folds 
Uncalled bet ($2) returned to hammerwife
hammerwife collected $2.50 from pot
hammerwife: doesn't show hand 
*** SUMMARY ***
Total pot $2.50 | Rake $0 
Seat 2: hammerwife collected ($2.50)
Seat 3: butcheN18 folded before Flop (didn't bet)
Seat 4: ruslik_by folded before Flop (didn't bet)
Seat 5: matiko09 folded before Flop (didn't bet)
Seat 6: CoolFireX folded before Flop (didn't bet)
Seat 7: ozone2003 (button) folded before Flop (didn't bet)
Seat 8: mycka86 (small blind) folded before Flop
Seat 9: Juniorquiapo (big blind) folded before Flop





PokerStars Hand #154798033365:  Hold'em No Limit ($0.50/$1.00 USD) - 2016/06/16 9:46:55 CET [2016/06/16 3:46:55 ET]
Table 'Markab II' 9-max Seat #1 is the button
Seat 1: AlKatrone ($104.07 in chips) 
Seat 2: mycka86 ($100 in chips) 
Seat 3: f4life1521 ($88.57 in chips) 
Seat 4: ruslik_by ($185.33 in chips) 
Seat 5: maxxmeister ($103 in chips) 
Seat 6: butcheN18 ($198.36 in chips) 
Seat 7: matiko09 ($113.37 in chips) 
Seat 8: CoolFireX ($148.70 in chips) 
Seat 9: greyman571 ($123.98 in chips) 
mycka86: posts small blind $0.50
f4life1521: posts big blind $1
*** HOLE CARDS ***
Dealt to matiko09 [3c Ac]
ruslik_by: folds 
maxxmeister: folds 
butcheN18: folds 
matiko09: raises $2 to $3
CoolFireX: folds 
greyman571: folds 
AlKatrone: folds 
mycka86: folds 
f4life1521 is disconnected 
f4life1521 has timed out while disconnected
f4life1521: folds 
Uncalled bet ($2) returned to matiko09
matiko09 collected $2.50 from pot
matiko09: doesn't show hand 
*** SUMMARY ***
Total pot $2.50 | Rake $0 
Seat 1: AlKatrone (button) folded before Flop (didn't bet)
Seat 2: mycka86 (small blind) folded before Flop
Seat 3: f4life1521 (big blind) folded before Flop
Seat 4: ruslik_by folded before Flop (didn't bet)
Seat 5: maxxmeister folded before Flop (didn't bet)
Seat 6: butcheN18 folded before Flop (didn't bet)
Seat 7: matiko09 collected ($2.50)
Seat 8: CoolFireX folded before Flop (didn't bet)
Seat 9: greyman571 folded before Flop (didn't bet)





PokerStars Hand #154798034452:  Hold'em No Limit ($0.50/$1.00 USD) - 2016/06/16 9:46:59 CET [2016/06/16 3:46:59 ET]
Table 'Stroobantia II' 9-max Seat #9 is the button
Seat 1: mycka86 ($102.10 in chips) 
Seat 2: Lipton20088 ($162.44 in chips) 
Seat 3: matiko09 ($100 in chips) 
Seat 4: CoolFireX ($102.55 in chips) 
Seat 5: butcheN18 ($100 in chips) 
Seat 6: andrewtomaz ($138.21 in chips) 
Seat 7: AlKatrone ($102.50 in chips) 
Seat 8: ruslik_by ($102.50 in chips) 
Seat 9: jakub249 ($55.95 in chips) 
mycka86: posts small blind $0.50
Lipton20088: posts big blind $1
*** HOLE CARDS ***
Dealt to matiko09 [Qh 3c]
matiko09: folds 
CoolFireX: folds 
butcheN18: folds 
andrewtomaz: folds 
AlKatrone: folds 
ruslik_by: folds 
jakub249: folds 
mycka86: raises $1.75 to $2.75
Lipton20088: calls $1.75
*** FLOP *** [8c 6d 9d]
mycka86: bets $3.80
Lipton20088: raises $7.21 to $11.01
mycka86: folds 
Uncalled bet ($7.21) returned to Lipton20088
Lipton20088 collected $12.44 from pot
Lipton20088: doesn't show hand 
*** SUMMARY ***
Total pot $13.10 | Rake $0.66 
Board [8c 6d 9d]
Seat 1: mycka86 (small blind) folded on the Flop
Seat 2: Lipton20088 (big blind) collected ($12.44)
Seat 3: matiko09 folded before Flop (didn't bet)
Seat 4: CoolFireX folded before Flop (didn't bet)
Seat 5: butcheN18 folded before Flop (didn't bet)
Seat 6: andrewtomaz folded before Flop (didn't bet)
Seat 7: AlKatrone folded before Flop (didn't bet)
Seat 8: ruslik_by folded before Flop (didn't bet)
Seat 9: jakub249 (button) folded before Flop (didn't bet)





PokerStars Hand #154798040171:  Hold'em No Limit ($0.50/$1.00 USD) - 2016/06/16 9:47:19 CET [2016/06/16 3:47:19 ET]
Table 'Hercynia II' 9-max Seat #8 is the button
Seat 2: hammerwife ($198.06 in chips) 
Seat 3: butcheN18 ($114.02 in chips) 
Seat 4: ruslik_by ($106.44 in chips) 
Seat 5: matiko09 ($109.82 in chips) 
Seat 6: CoolFireX ($100 in chips) 
Seat 7: ozone2003 ($119.08 in chips) 
Seat 8: mycka86 ($159.29 in chips) 
Seat 9: Juniorquiapo ($101.38 in chips) 
Juniorquiapo: posts small blind $0.50
hammerwife: posts big blind $1
*** HOLE CARDS ***
Dealt to matiko09 [3d 3s]
butcheN18: folds 
ruslik_by: folds 
matiko09: raises $2 to $3
CoolFireX: folds 
ozone2003: calls $3
mycka86: folds 
Juniorquiapo: raises $5 to $8
hammerwife: folds 
matiko09: calls $5
ozone2003: calls $5
*** FLOP *** [9h Tc Ah]
Juniorquiapo: bets $15
matiko09: folds 
ozone2003: calls $15
*** TURN *** [9h Tc Ah] [4c]
Juniorquiapo: bets $16
ozone2003: calls $16
*** RIVER *** [9h Tc Ah 4c] [2s]
Juniorquiapo: bets $21
ozone2003: folds 
Uncalled bet ($21) returned to Juniorquiapo
Juniorquiapo collected $84.50 from pot
*** SUMMARY ***
Total pot $87 | Rake $2.50 
Board [9h Tc Ah 4c 2s]
Seat 2: hammerwife (big blind) folded before Flop
Seat 3: butcheN18 folded before Flop (didn't bet)
Seat 4: ruslik_by folded before Flop (didn't bet)
Seat 5: matiko09 folded on the Flop
Seat 6: CoolFireX folded before Flop (didn't bet)
Seat 7: ozone2003 folded on the River
Seat 8: mycka86 (button) folded before Flop (didn't bet)
Seat 9: Juniorquiapo (small blind) collected ($84.50)





PokerStars Hand #154798044291:  Hold'em No Limit ($0.50/$1.00 USD) - 2016/06/16 9:47:34 CET [2016/06/16 3:47:34 ET]
Table 'Nuki' 9-max Seat #7 is the button
Seat 1: Sreshta222 ($40 in chips) 
Seat 2: TideHan ($101.50 in chips) 
Seat 3: matiko09 ($109.24 in chips) 
Seat 4: teerajaja ($101.50 in chips) 
Seat 5: ozone2003 ($100 in chips) 
Seat 6: mycka86 ($100 in chips) 
Seat 7: ruslik_by ($120.18 in chips) 
Seat 8: Marcelek_El ($82.31 in chips) 
Seat 9: Lipton20088 ($49.74 in chips) 
Marcelek_El: posts small blind $0.50
Lipton20088: posts big blind $1
*** HOLE CARDS ***
Dealt to matiko09 [2d 9d]
Sreshta222: folds 
TideHan: raises $2 to $3
matiko09: folds 
teerajaja: folds 
ozone2003: folds 
mycka86: folds 
ruslik_by: folds 
Marcelek_El: raises $6 to $9
Lipton20088: folds 
TideHan: raises $13 to $22
Marcelek_El: calls $13
*** FLOP *** [5h 5s 4s]
Marcelek_El: bets $10
TideHan: calls $10
*** TURN *** [5h 5s 4s] [8c]
Marcelek_El: bets $10
Lipton20088 is disconnected 
TideHan: calls $10
*** RIVER *** [5h 5s 4s 8c] [Qh]
Marcelek_El: bets $10
TideHan: folds 
Uncalled bet ($10) returned to Marcelek_El
Marcelek_El collected $82.50 from pot
Marcelek_El: doesn't show hand 
*** SUMMARY ***
Total pot $85 | Rake $2.50 
Board [5h 5s 4s 8c Qh]
Seat 1: Sreshta222 folded before Flop (didn't bet)
Seat 2: TideHan folded on the River
Seat 3: matiko09 folded before Flop (didn't bet)
Seat 4: teerajaja folded before Flop (didn't bet)
Seat 5: ozone2003 folded before Flop (didn't bet)
Seat 6: mycka86 folded before Flop (didn't bet)
Seat 7: ruslik_by (button) folded before Flop (didn't bet)
Seat 8: Marcelek_El (small blind) collected ($82.50)
Seat 9: Lipton20088 (big blind) folded before Flop





PokerStars Hand #154798056078:  Hold'em No Limit ($0.50/$1.00 USD) - 2016/06/16 9:48:14 CET [2016/06/16 3:48:14 ET]
Table 'Markab II' 9-max Seat #2 is the button
Seat 2: mycka86 ($100 in chips) 
Seat 4: ruslik_by ($185.33 in chips) 
Seat 5: maxxmeister ($103 in chips) 
Seat 6: butcheN18 ($198.36 in chips) 
Seat 7: matiko09 ($114.87 in chips) 
Seat 8: CoolFireX ($148.70 in chips) 
Seat 9: greyman571 ($123.98 in chips) 
ruslik_by: posts small blind $0.50
maxxmeister: posts big blind $1
*** HOLE CARDS ***
Dealt to matiko09 [5d Qh]
butcheN18: folds 
matiko09: folds 
CoolFireX: folds 
greyman571: folds 
mycka86: raises $1.10 to $2.10
ruslik_by: folds 
maxxmeister: folds 
Uncalled bet ($1.10) returned to mycka86
mycka86 collected $2.50 from pot
*** SUMMARY ***
Total pot $2.50 | Rake $0 
Seat 2: mycka86 (button) collected ($2.50)
Seat 4: ruslik_by (small blind) folded before Flop
Seat 5: maxxmeister (big blind) folded before Flop
Seat 6: butcheN18 folded before Flop (didn't bet)
Seat 7: matiko09 folded before Flop (didn't bet)
Seat 8: CoolFireX folded before Flop (didn't bet)
Seat 9: greyman571 folded before Flop (didn't bet)





PokerStars Hand #154798066409:  Hold'em No Limit ($0.50/$1.00 USD) - 2016/06/16 9:48:50 CET [2016/06/16 3:48:50 ET]
Table 'Markab II' 9-max Seat #4 is the button
Seat 2: mycka86 ($101.50 in chips) 
Seat 4: ruslik_by ($184.83 in chips) 
Seat 5: maxxmeister ($102 in chips) 
Seat 6: butcheN18 ($198.36 in chips) 
Seat 7: matiko09 ($114.87 in chips) 
Seat 8: CoolFireX ($148.70 in chips) 
Seat 9: greyman571 ($123.98 in chips) 
maxxmeister: posts small blind $0.50
butcheN18: posts big blind $1
f4life1521: sits out 
*** HOLE CARDS ***
Dealt to matiko09 [Tc Kd]
matiko09: folds 
CoolFireX: raises $2 to $3
greyman571: folds 
mycka86: folds 
ruslik_by: folds 
maxxmeister: folds 
butcheN18: folds 
Uncalled bet ($2) returned to CoolFireX
CoolFireX collected $2.50 from pot
*** SUMMARY ***
Total pot $2.50 | Rake $0 
Seat 2: mycka86 folded before Flop (didn't bet)
Seat 4: ruslik_by (button) folded before Flop (didn't bet)
Seat 5: maxxmeister (small blind) folded before Flop
Seat 6: butcheN18 (big blind) folded before Flop
Seat 7: matiko09 folded before Flop (didn't bet)
Seat 8: CoolFireX collected ($2.50)
Seat 9: greyman571 folded before Flop (didn't bet)





PokerStars Hand #154798069350:  Hold'em No Limit ($0.50/$1.00 USD) - 2016/06/16 9:49:01 CET [2016/06/16 3:49:01 ET]
Table 'Hercynia II' 9-max Seat #9 is the button
Seat 2: hammerwife ($197.06 in chips) 
Seat 3: butcheN18 ($114.02 in chips) 
Seat 4: ruslik_by ($106.44 in chips) 
Seat 5: matiko09 ($101.82 in chips) 
Seat 6: CoolFireX ($100 in chips) 
Seat 7: ozone2003 ($100 in chips) 
Seat 8: mycka86 ($159.29 in chips) 
Seat 9: Juniorquiapo ($146.88 in chips) 
flk.Dasas will be allowed to play after the button
hammerwife: posts small blind $0.50
butcheN18: posts big blind $1
*** HOLE CARDS ***
Dealt to matiko09 [6s 5d]
ruslik_by: folds 
matiko09: folds 
CoolFireX: folds 
ozone2003: folds 
mycka86: folds 
Juniorquiapo: raises $2 to $3
hammerwife: folds 
butcheN18: folds 
Uncalled bet ($2) returned to Juniorquiapo
Juniorquiapo collected $2.50 from pot
*** SUMMARY ***
Total pot $2.50 | Rake $0 
Seat 2: hammerwife (small blind) folded before Flop
Seat 3: butcheN18 (big blind) folded before Flop
Seat 4: ruslik_by folded before Flop (didn't bet)
Seat 5: matiko09 folded before Flop (didn't bet)
Seat 6: CoolFireX folded before Flop (didn't bet)
Seat 7: ozone2003 folded before Flop (didn't bet)
Seat 8: mycka86 folded before Flop (didn't bet)
Seat 9: Juniorquiapo (button) collected ($2.50)





PokerStars Hand #154798079481:  Hold'em No Limit ($0.50/$1.00 USD) - 2016/06/16 9:49:36 CET [2016/06/16 3:49:36 ET]
Table 'Hercynia II' 9-max Seat #2 is the button
Seat 2: hammerwife ($196.56 in chips) 
Seat 3: butcheN18 ($113.02 in chips) 
Seat 4: ruslik_by ($106.44 in chips) 
Seat 5: matiko09 ($101.82 in chips) 
Seat 6: CoolFireX ($100 in chips) 
Seat 7: ozone2003 ($100 in chips) 
Seat 8: mycka86 ($159.29 in chips) 
Seat 9: Juniorquiapo ($148.38 in chips) 
butcheN18: posts small blind $0.50
ruslik_by: posts big blind $1
flk.Dasas: sits out 
*** HOLE CARDS ***
Dealt to matiko09 [2s Ac]
matiko09: folds 
CoolFireX: folds 
ozone2003: raises $2 to $3
mycka86: folds 
Juniorquiapo: folds 
hammerwife: folds 
butcheN18: folds 
ruslik_by: folds 
Uncalled bet ($2) returned to ozone2003
ozone2003 collected $2.50 from pot
ozone2003: doesn't show hand 
*** SUMMARY ***
Total pot $2.50 | Rake $0 
Seat 2: hammerwife (button) folded before Flop (didn't bet)
Seat 3: butcheN18 (small blind) folded before Flop
Seat 4: ruslik_by (big blind) folded before Flop
Seat 5: matiko09 folded before Flop (didn't bet)
Seat 6: CoolFireX folded before Flop (didn't bet)
Seat 7: ozone2003 collected ($2.50)
Seat 8: mycka86 folded before Flop (didn't bet)
Seat 9: Juniorquiapo folded before Flop (didn't bet)





PokerStars Hand #154798082126:  Hold'em No Limit ($0.50/$1.00 USD) - 2016/06/16 9:49:45 CET [2016/06/16 3:49:45 ET]
Table 'Nuki' 9-max Seat #8 is the button
Seat 1: Sreshta222 ($40 in chips) 
Seat 2: TideHan ($100 in chips) 
Seat 3: matiko09 ($109.24 in chips) 
Seat 4: teerajaja ($101.50 in chips) 
Seat 5: ozone2003 ($100 in chips) 
Seat 6: mycka86 ($100 in chips) 
Seat 7: ruslik_by ($120.18 in chips) 
Seat 8: Marcelek_El ($122.81 in chips) 
Seat 9: Lipton20088 ($48.74 in chips) 
Lipton20088: posts small blind $0.50
Sreshta222: posts big blind $1
*** HOLE CARDS ***
Dealt to matiko09 [6d 6h]
TideHan: folds 
matiko09: raises $2 to $3
teerajaja: folds 
ozone2003: folds 
mycka86: folds 
ruslik_by: folds 
Marcelek_El: raises $6 to $9
Lipton20088: folds 
Sreshta222: folds 
matiko09: folds 
Uncalled bet ($6) returned to Marcelek_El
Marcelek_El collected $7.50 from pot
Marcelek_El: doesn't show hand 
*** SUMMARY ***
Total pot $7.50 | Rake $0 
Seat 1: Sreshta222 (big blind) folded before Flop
Seat 2: TideHan folded before Flop (didn't bet)
Seat 3: matiko09 folded before Flop
Seat 4: teerajaja folded before Flop (didn't bet)
Seat 5: ozone2003 folded before Flop (didn't bet)
Seat 6: mycka86 folded before Flop (didn't bet)
Seat 7: ruslik_by folded before Flop (didn't bet)
Seat 8: Marcelek_El (button) collected ($7.50)
Seat 9: Lipton20088 (small blind) folded before Flop





PokerStars Hand #154798093107:  Hold'em No Limit ($0.50/$1.00 USD) - 2016/06/16 9:50:24 CET [2016/06/16 3:50:24 ET]
Table 'Nuki' 9-max Seat #9 is the button
Seat 1: Sreshta222 ($39 in chips) 
Seat 2: TideHan ($100 in chips) 
Seat 3: matiko09 ($106.24 in chips) 
Seat 4: teerajaja ($101.50 in chips) 
Seat 5: ozone2003 ($100 in chips) 
Seat 6: mycka86 ($100 in chips) 
Seat 7: ruslik_by ($120.18 in chips) 
Seat 8: Marcelek_El ($127.31 in chips) 
Seat 9: Lipton20088 ($48.24 in chips) 
Sreshta222: posts small blind $0.50
TideHan: posts big blind $1
*** HOLE CARDS ***
Dealt to matiko09 [6d Tc]
matiko09: folds 
teerajaja: folds 
ozone2003: raises $2 to $3
mycka86: folds 
ruslik_by: folds 
Marcelek_El: folds 
Lipton20088: folds 
Sreshta222: folds 
TideHan: calls $2
*** FLOP *** [6c Ac Jc]
TideHan: checks 
ozone2003: checks 
*** TURN *** [6c Ac Jc] [6s]
TideHan: checks 
ozone2003: bets $4.89
TideHan: calls $4.89
*** RIVER *** [6c Ac Jc 6s] [9c]
TideHan: checks 
ozone2003: bets $9.75
TideHan: folds 
Uncalled bet ($9.75) returned to ozone2003
ozone2003 collected $15.47 from pot
ozone2003: doesn't show hand 
*** SUMMARY ***
Total pot $16.28 | Rake $0.81 
Board [6c Ac Jc 6s 9c]
Seat 1: Sreshta222 (small blind) folded before Flop
Seat 2: TideHan (big blind) folded on the River
Seat 3: matiko09 folded before Flop (didn't bet)
Seat 4: teerajaja folded before Flop (didn't bet)
Seat 5: ozone2003 collected ($15.47)
Seat 6: mycka86 folded before Flop (didn't bet)
Seat 7: ruslik_by folded before Flop (didn't bet)
Seat 8: Marcelek_El folded before Flop (didn't bet)
Seat 9: Lipton20088 (button) folded before Flop (didn't bet)





PokerStars Zoom Hand #154801155020:  Hold'em No Limit ($0.01/$0.02) - 2016/06/16 12:21:55 CET [2016/06/16 6:21:55 ET]
Table 'Halley' 6-max Seat #1 is the button
Seat 1: inarixx ($1.94 in chips) 
Seat 2: Machairodont ($2.10 in chips) 
Seat 3: matiko09 ($2 in chips) 
Seat 4: WiliamHero ($3.49 in chips) 
Seat 5: simex93 ($2.08 in chips) 
Seat 6: lundolai ($2.07 in chips) 
Machairodont: posts small blind $0.01
matiko09: posts big blind $0.02
*** HOLE CARDS ***
Dealt to matiko09 [Th Ts]
WiliamHero: folds 
simex93: folds 
lundolai: folds 
inarixx: folds 
Machairodont: folds 
Uncalled bet ($0.01) returned to matiko09
matiko09 collected $0.02 from pot
matiko09: doesn't show hand 
*** SUMMARY ***
Total pot $0.02 | Rake $0 
Seat 1: inarixx (button) folded before Flop (didn't bet)
Seat 2: Machairodont (small blind) folded before Flop
Seat 3: matiko09 (big blind) collected ($0.02)
Seat 4: WiliamHero folded before Flop (didn't bet)
Seat 5: simex93 folded before Flop (didn't bet)
Seat 6: lundolai folded before Flop (didn't bet)





PokerStars Zoom Hand #154801160125:  Hold'em No Limit ($0.01/$0.02) - 2016/06/16 12:22:08 CET [2016/06/16 6:22:08 ET]
Table 'Halley' 6-max Seat #1 is the button
Seat 1: 1timeluck ($2.08 in chips) 
Seat 2: matiko09 ($2.01 in chips) 
Seat 3: rextorex ($2 in chips) 
Seat 4: jeroninho ($2.25 in chips) 
Seat 5: duvallwbb ($1.90 in chips) 
Seat 6: shavemen ($1.01 in chips) 
matiko09: posts small blind $0.01
rextorex: posts big blind $0.02
*** HOLE CARDS ***
Dealt to matiko09 [Ts Ks]
jeroninho: folds 
duvallwbb: raises $0.04 to $0.06
shavemen: folds 
1timeluck: folds 
matiko09: folds 
rextorex: folds 
Uncalled bet ($0.04) returned to duvallwbb
duvallwbb collected $0.05 from pot
duvallwbb: doesn't show hand 
*** SUMMARY ***
Total pot $0.05 | Rake $0 
Seat 1: 1timeluck (button) folded before Flop (didn't bet)
Seat 2: matiko09 (small blind) folded before Flop
Seat 3: rextorex (big blind) folded before Flop
Seat 4: jeroninho folded before Flop (didn't bet)
Seat 5: duvallwbb collected ($0.05)
Seat 6: shavemen folded before Flop (didn't bet)





PokerStars Hand #154969511789:  Hold'em No Limit ($0.25/$0.50 USD) - 2016/06/20 11:58:50 CET [2016/06/20 5:58:50 ET]
Table 'Ampella' 9-max Seat #9 is the button
Seat 1: ljryviltj ($50.69 in chips) 
Seat 2: matiko09 ($50 in chips) 
Seat 5: nuuaber ($40.78 in chips) 
Seat 6: Wwwasian ($50 in chips) 
Seat 7: FartApple ($20 in chips) 
Seat 8: Nakyoruto ($24.41 in chips) 
Seat 9: geiranger011 ($50.89 in chips) 
ljryviltj: posts small blind $0.25
matiko09: posts big blind $0.50
djammusic: sits out 
norineo11: sits out 
*** HOLE CARDS ***
Dealt to matiko09 [Jc 8h]
nuuaber: folds 
Wwwasian: folds 
FartApple: raises $0.62 to $1.12
Nakyoruto: folds 
geiranger011: folds 
ljryviltj: raises $3.38 to $4.50
matiko09: folds 
FartApple: raises $14.50 to $19
ljryviltj: folds 
Uncalled bet ($14.50) returned to FartApple
FartApple collected $9.50 from pot
FartApple: doesn't show hand 
*** SUMMARY ***
Total pot $9.50 | Rake $0 
Seat 1: ljryviltj (small blind) folded before Flop
Seat 2: matiko09 (big blind) folded before Flop
Seat 5: nuuaber folded before Flop (didn't bet)
Seat 6: Wwwasian folded before Flop (didn't bet)
Seat 7: FartApple collected ($9.50)
Seat 8: Nakyoruto folded before Flop (didn't bet)
Seat 9: geiranger011 (button) folded before Flop (didn't bet)





PokerStars Hand #154969535515:  Hold'em No Limit ($0.25/$0.50 USD) - 2016/06/20 12:00:05 CET [2016/06/20 6:00:05 ET]
Table 'Ampella' 9-max Seat #1 is the button
Seat 1: ljryviltj ($50 in chips) 
Seat 2: matiko09 ($50 in chips) 
Seat 3: djammusic ($20 in chips) 
Seat 5: nuuaber ($40.78 in chips) 
Seat 6: Wwwasian ($50 in chips) 
Seat 7: FartApple ($25 in chips) 
Seat 8: Nakyoruto ($24.41 in chips) 
Seat 9: geiranger011 ($50.89 in chips) 
matiko09: posts small blind $0.25
djammusic: posts big blind $0.50
norineo11: sits out 
*** HOLE CARDS ***
Dealt to matiko09 [3c 2s]
nuuaber: folds 
Wwwasian: folds 
FartApple: folds 
Nakyoruto: folds 
geiranger011 has timed out
geiranger011: folds 
ljryviltj: folds 
matiko09: folds 
Uncalled bet ($0.25) returned to djammusic
djammusic collected $0.50 from pot
djammusic: doesn't show hand 
*** SUMMARY ***
Total pot $0.50 | Rake $0 
Seat 1: ljryviltj (button) folded before Flop (didn't bet)
Seat 2: matiko09 (small blind) folded before Flop
Seat 3: djammusic (big blind) collected ($0.50)
Seat 5: nuuaber folded before Flop (didn't bet)
Seat 6: Wwwasian folded before Flop (didn't bet)
Seat 7: FartApple folded before Flop (didn't bet)
Seat 8: Nakyoruto folded before Flop (didn't bet)
Seat 9: geiranger011 folded before Flop (didn't bet)





PokerStars Hand #154969549958:  Hold'em No Limit ($0.25/$0.50 USD) - 2016/06/20 12:00:50 CET [2016/06/20 6:00:50 ET]
Table 'Ampella' 9-max Seat #2 is the button
Seat 1: ljryviltj ($50 in chips) 
Seat 2: matiko09 ($50 in chips) 
Seat 3: djammusic ($20.25 in chips) 
Seat 4: norineo11 ($50 in chips) 
Seat 5: nuuaber ($40.78 in chips) 
Seat 6: Wwwasian ($50 in chips) 
Seat 7: FartApple ($25 in chips) 
Seat 8: Nakyoruto ($24.41 in chips) 
djammusic: posts small blind $0.25
norineo11: posts big blind $0.50
*** HOLE CARDS ***
Dealt to matiko09 [Qc Js]
nuuaber: folds 
Wwwasian: folds 
FartApple: folds 
Nakyoruto: folds 
ljryviltj: folds 
matiko09: raises $0.63 to $1.13
djammusic: folds 
norineo11: folds 
Uncalled bet ($0.63) returned to matiko09
matiko09 collected $1.25 from pot
matiko09: doesn't show hand 
*** SUMMARY ***
Total pot $1.25 | Rake $0 
Seat 1: ljryviltj folded before Flop (didn't bet)
Seat 2: matiko09 (button) collected ($1.25)
Seat 3: djammusic (small blind) folded before Flop
Seat 4: norineo11 (big blind) folded before Flop
Seat 5: nuuaber folded before Flop (didn't bet)
Seat 6: Wwwasian folded before Flop (didn't bet)
Seat 7: FartApple folded before Flop (didn't bet)
Seat 8: Nakyoruto folded before Flop (didn't bet)





PokerStars Hand #154969562584:  Hold'em No Limit ($0.25/$0.50 USD) - 2016/06/20 12:01:26 CET [2016/06/20 6:01:26 ET]
Table 'Ampella' 9-max Seat #3 is the button
Seat 1: ljryviltj ($50 in chips) 
Seat 2: matiko09 ($50.75 in chips) 
Seat 3: djammusic ($20 in chips) 
Seat 4: norineo11 ($49.50 in chips) 
Seat 5: nuuaber ($40.78 in chips) 
Seat 6: Wwwasian ($50 in chips) 
Seat 7: FartApple ($25 in chips) 
Seat 8: Nakyoruto ($24.41 in chips) 
Seat 9: geiranger011 ($50.89 in chips) 
norineo11: posts small blind $0.25
nuuaber: posts big blind $0.50
*** HOLE CARDS ***
Dealt to matiko09 [4s 7c]
Wwwasian: folds 
FartApple: raises $0.62 to $1.12
Nakyoruto: folds 
geiranger011: calls $1.12
ljryviltj: folds 
matiko09: folds 
djammusic: folds 
norineo11: folds 
nuuaber: folds 
*** FLOP *** [8d Jd Jc]
FartApple: checks 
geiranger011: bets $3
FartApple: calls $3
*** TURN *** [8d Jd Jc] [Qc]
FartApple: checks 
geiranger011: bets $8.50
FartApple: raises $12.38 to $20.88 and is all-in
geiranger011: calls $12.38
*** FIRST RIVER *** [8d Jd Jc Qc] [Jh]
*** SECOND RIVER *** [8d Jd Jc Qc] [As]
*** FIRST SHOW DOWN ***
FartApple: shows [8s 8h] (a full house, Jacks full of Eights)
geiranger011: shows [9d Qd] (a full house, Jacks full of Queens)
geiranger011 collected $24.38 from pot
*** SECOND SHOW DOWN ***
FartApple: shows [8s 8h] (a full house, Eights full of Jacks)
geiranger011: shows [9d Qd] (two pair, Queens and Jacks)
FartApple collected $24.37 from pot
*** SUMMARY ***
Total pot $50.75 | Rake $2 
Hand was run twice
FIRST Board [8d Jd Jc Qc Jh]
SECOND Board [8d Jd Jc Qc As]
Seat 1: ljryviltj folded before Flop (didn't bet)
Seat 2: matiko09 folded before Flop (didn't bet)
Seat 3: djammusic (button) folded before Flop (didn't bet)
Seat 4: norineo11 (small blind) folded before Flop
Seat 5: nuuaber (big blind) folded before Flop
Seat 6: Wwwasian folded before Flop (didn't bet)
Seat 7: FartApple showed [8s 8h] and lost with a full house, Jacks full of Eights, and won ($24.37) with a full house, Eights full of Jacks
Seat 8: Nakyoruto folded before Flop (didn't bet)
Seat 9: geiranger011 showed [9d Qd] and won ($24.38) with a full house, Jacks full of Queens, and lost with two pair, Queens and Jacks





PokerStars Hand #154969563189:  Hold'em No Limit (£0.25/£0.50 GBP) - 2016/06/20 12:01:28 CET [2016/06/20 6:01:28 ET]
Table 'Ani' 6-max Seat #2 is the button
Seat 2: joker180785 (£50 in chips) 
Seat 3: Doobes8555 (£71.74 in chips) 
Seat 4: matiko09 (£50 in chips) 
Seat 5: Wwwasian (£51.50 in chips) 
Seat 6: faceMyBallz_ (£75.74 in chips) 
Doobes8555: posts small blind £0.25
matiko09: posts big blind £0.50
*** HOLE CARDS ***
Dealt to matiko09 [Qh 6c]
Wwwasian: folds 
faceMyBallz_: folds 
joker180785: folds 
Doobes8555: folds 
Uncalled bet (£0.25) returned to matiko09
matiko09 collected £0.50 from pot
matiko09: doesn't show hand 
*** SUMMARY ***
Total pot £0.50 | Rake £0 
Seat 2: joker180785 (button) folded before Flop (didn't bet)
Seat 3: Doobes8555 (small blind) folded before Flop
Seat 4: matiko09 (big blind) collected (£0.50)
Seat 5: Wwwasian folded before Flop (didn't bet)
Seat 6: faceMyBallz_ folded before Flop (didn't bet)





PokerStars Hand #154969567104:  Hold'em No Limit (£0.25/£0.50 GBP) - 2016/06/20 12:01:40 CET [2016/06/20 6:01:40 ET]
Table 'Azalea' 6-max Seat #1 is the button
Seat 1: Rubleff85 (£40 in chips) 
Seat 2: matiko09 (£50 in chips) 
Rubleff85: posts small blind £0.25
VahTang_89 joins the table at seat #3 
matiko09: posts big blind £0.50
*** HOLE CARDS ***
Dealt to matiko09 [6s 6c]
Rubleff85: calls £0.25
matiko09: checks 
*** FLOP *** [5d 7h 8h]
matiko09: bets £0.50
Rubleff85: calls £0.50
*** TURN *** [5d 7h 8h] [Ah]
matiko09: checks 
Rubleff85: bets £0.95
matiko09: folds 
Uncalled bet (£0.95) returned to Rubleff85
Rubleff85 collected £1.90 from pot
Rubleff85: doesn't show hand 
*** SUMMARY ***
Total pot £2 | Rake £0.10 
Board [5d 7h 8h Ah]
Seat 1: Rubleff85 (button) (small blind) collected (£1.90)
Seat 2: matiko09 (big blind) folded on the Turn





PokerStars Hand #154969568446:  Hold'em No Limit (£0.25/£0.50 GBP) - 2016/06/20 12:01:44 CET [2016/06/20 6:01:44 ET]
Table 'Ani' 6-max Seat #3 is the button
Seat 2: joker180785 (£50 in chips) 
Seat 3: Doobes8555 (£71.49 in chips) 
Seat 4: matiko09 (£50.25 in chips) 
Seat 5: Wwwasian (£51.50 in chips) 
Seat 6: faceMyBallz_ (£75.74 in chips) 
matiko09: posts small blind £0.25
Wwwasian: posts big blind £0.50
*** HOLE CARDS ***
Dealt to matiko09 [6h 2s]
faceMyBallz_: folds 
joker180785: folds 
Doobes8555: folds 
matiko09: folds 
Uncalled bet (£0.25) returned to Wwwasian
Wwwasian collected £0.50 from pot
Wwwasian: doesn't show hand 
*** SUMMARY ***
Total pot £0.50 | Rake £0 
Seat 2: joker180785 folded before Flop (didn't bet)
Seat 3: Doobes8555 (button) folded before Flop (didn't bet)
Seat 4: matiko09 (small blind) folded before Flop
Seat 5: Wwwasian (big blind) collected (£0.50)
Seat 6: faceMyBallz_ folded before Flop (didn't bet)





PokerStars Hand #154969574527:  Hold'em No Limit (£0.25/£0.50 GBP) - 2016/06/20 12:02:01 CET [2016/06/20 6:02:01 ET]
Table 'Ani' 6-max Seat #4 is the button
Seat 2: joker180785 (£50 in chips) 
Seat 3: Doobes8555 (£71.49 in chips) 
Seat 4: matiko09 (£50 in chips) 
Seat 5: Wwwasian (£51.75 in chips) 
Seat 6: faceMyBallz_ (£75.74 in chips) 
Wwwasian: posts small blind £0.25
faceMyBallz_: posts big blind £0.50
*** HOLE CARDS ***
Dealt to matiko09 [4d 9c]
joker180785: folds 
Doobes8555: folds 
matiko09: folds 
Wwwasian: folds 
Uncalled bet (£0.25) returned to faceMyBallz_
faceMyBallz_ collected £0.50 from pot
faceMyBallz_: doesn't show hand 
*** SUMMARY ***
Total pot £0.50 | Rake £0 
Seat 2: joker180785 folded before Flop (didn't bet)
Seat 3: Doobes8555 folded before Flop (didn't bet)
Seat 4: matiko09 (button) folded before Flop (didn't bet)
Seat 5: Wwwasian (small blind) folded before Flop
Seat 6: faceMyBallz_ (big blind) collected (£0.50)





PokerStars Hand #154969582450:  Hold'em No Limit ($0.25/$0.50 USD) - 2016/06/20 12:02:23 CET [2016/06/20 6:02:23 ET]
Table 'Ampella' 9-max Seat #4 is the button
Seat 1: ljryviltj ($50 in chips) 
Seat 2: matiko09 ($50.75 in chips) 
Seat 3: djammusic ($20 in chips) 
Seat 4: norineo11 ($49.25 in chips) 
Seat 5: nuuaber ($40.28 in chips) 
Seat 6: Wwwasian ($50 in chips) 
Seat 7: FartApple ($24.37 in chips) 
Seat 8: Nakyoruto ($24.41 in chips) 
Seat 9: geiranger011 ($50.27 in chips) 
nuuaber: posts small blind $0.25
Wwwasian: posts big blind $0.50
*** HOLE CARDS ***
Dealt to matiko09 [Ks 2c]
FartApple: folds 
Nakyoruto: folds 
geiranger011: folds 
ljryviltj: folds 
matiko09: folds 
djammusic: raises $0.75 to $1.25
norineo11: folds 
nuuaber: folds 
Wwwasian: folds 
Uncalled bet ($0.75) returned to djammusic
djammusic collected $1.25 from pot
djammusic: doesn't show hand 
*** SUMMARY ***
Total pot $1.25 | Rake $0 
Seat 1: ljryviltj folded before Flop (didn't bet)
Seat 2: matiko09 folded before Flop (didn't bet)
Seat 3: djammusic collected ($1.25)
Seat 4: norineo11 (button) folded before Flop (didn't bet)
Seat 5: nuuaber (small blind) folded before Flop
Seat 6: Wwwasian (big blind) folded before Flop
Seat 7: FartApple folded before Flop (didn't bet)
Seat 8: Nakyoruto folded before Flop (didn't bet)
Seat 9: geiranger011 folded before Flop (didn't bet)





PokerStars Hand #154969582619:  Hold'em No Limit (£0.25/£0.50 GBP) - 2016/06/20 12:02:24 CET [2016/06/20 6:02:24 ET]
Table 'Azalea' 6-max Seat #1 is the button
Seat 1: Rubleff85 (£40.90 in chips) 
Seat 2: matiko09 (£50 in chips) 
Seat 3: VahTang_89 (£50 in chips) 
matiko09: posts small blind £0.25
VahTang_89: posts big blind £0.50
*** HOLE CARDS ***
Dealt to matiko09 [6d 6h]
Rubleff85: raises £0.50 to £1
matiko09: calls £0.75
VahTang_89: folds 
*** FLOP *** [Ts 5c 3h]
matiko09: checks 
mudders693 joins the table at seat #5 
Rubleff85: bets £1.25
matiko09: calls £1.25
*** TURN *** [Ts 5c 3h] [Ac]
Bënedic10 joins the table at seat #6 
matiko09: checks 
Rubleff85: bets £3.15
matiko09: folds 
Uncalled bet (£3.15) returned to Rubleff85
Rubleff85 collected £4.75 from pot
Rubleff85: doesn't show hand 
*** SUMMARY ***
Total pot £5 | Rake £0.25 
Board [Ts 5c 3h Ac]
Seat 1: Rubleff85 (button) collected (£4.75)
Seat 2: matiko09 (small blind) folded on the Turn
Seat 3: VahTang_89 (big blind) folded before Flop





PokerStars Hand #154969583676:  Hold'em No Limit (£0.25/£0.50 GBP) - 2016/06/20 12:02:27 CET [2016/06/20 6:02:27 ET]
Table 'Ani' 6-max Seat #5 is the button
Seat 2: joker180785 (£50 in chips) 
Seat 3: Doobes8555 (£71.49 in chips) 
Seat 4: matiko09 (£50 in chips) 
Seat 5: Wwwasian (£51.50 in chips) 
Seat 6: faceMyBallz_ (£75.99 in chips) 
faceMyBallz_: posts small blind £0.25
joker180785: posts big blind £0.50
*** HOLE CARDS ***
Dealt to matiko09 [5c Ac]
Doobes8555: calls £0.50
matiko09: raises £1.50 to £2
Wwwasian: folds 
faceMyBallz_: raises £4.50 to £6.50
joker180785: folds 
Doobes8555: calls £6
matiko09: folds 
*** FLOP *** [8s Qd 8c]
faceMyBallz_: bets £5
rewq99887788 joins the table at seat #1 
Doobes8555: calls £5
*** TURN *** [8s Qd 8c] [9c]
faceMyBallz_: checks 
Doobes8555: bets £12
faceMyBallz_: folds 
Uncalled bet (£12) returned to Doobes8555
Doobes8555 collected £24.22 from pot
Doobes8555: doesn't show hand 
*** SUMMARY ***
Total pot £25.50 | Rake £1.28 
Board [8s Qd 8c 9c]
Seat 2: joker180785 (big blind) folded before Flop
Seat 3: Doobes8555 collected (£24.22)
Seat 4: matiko09 folded before Flop
Seat 5: Wwwasian (button) folded before Flop (didn't bet)
Seat 6: faceMyBallz_ (small blind) folded on the Turn





PokerStars Hand #154969598885:  Hold'em No Limit ($0.25/$0.50 USD) - 2016/06/20 12:03:10 CET [2016/06/20 6:03:10 ET]
Table 'Ampella' 9-max Seat #5 is the button
Seat 1: ljryviltj ($50 in chips) 
Seat 2: matiko09 ($50.75 in chips) 
Seat 3: djammusic ($20.75 in chips) 
Seat 4: norineo11 ($49.25 in chips) 
Seat 5: nuuaber ($40.03 in chips) 
Seat 6: Wwwasian ($50 in chips) 
Seat 7: FartApple ($24.37 in chips) 
Seat 8: Nakyoruto ($24.41 in chips) 
Seat 9: geiranger011 ($50.27 in chips) 
Wwwasian: posts small blind $0.25
FartApple: posts big blind $0.50
*** HOLE CARDS ***
Dealt to matiko09 [9s Jc]
Nakyoruto: folds 
geiranger011: folds 
ljryviltj: folds 
matiko09: folds 
djammusic: raises $0.62 to $1.12
norineo11: folds 
nuuaber: folds 
Wwwasian: folds 
FartApple: folds 
Uncalled bet ($0.62) returned to djammusic
djammusic collected $1.25 from pot
djammusic: doesn't show hand 
*** SUMMARY ***
Total pot $1.25 | Rake $0 
Seat 1: ljryviltj folded before Flop (didn't bet)
Seat 2: matiko09 folded before Flop (didn't bet)
Seat 3: djammusic collected ($1.25)
Seat 4: norineo11 folded before Flop (didn't bet)
Seat 5: nuuaber (button) folded before Flop (didn't bet)
Seat 6: Wwwasian (small blind) folded before Flop
Seat 7: FartApple (big blind) folded before Flop
Seat 8: Nakyoruto folded before Flop (didn't bet)
Seat 9: geiranger011 folded before Flop (didn't bet)





PokerStars Hand #154969599374:  Hold'em No Limit (£0.25/£0.50 GBP) - 2016/06/20 12:03:11 CET [2016/06/20 6:03:11 ET]
Table 'Azalea' 6-max Seat #2 is the button
Seat 1: Rubleff85 (£43.40 in chips) 
Seat 2: matiko09 (£50 in chips) 
Seat 3: VahTang_89 (£50 in chips) 
Seat 5: mudders693 (£50 in chips) 
VahTang_89: posts small blind £0.25
mudders693: posts big blind £0.50
Bënedic10: sits out 
*** HOLE CARDS ***
Dealt to matiko09 [Ts 6d]
Rubleff85: folds 
matiko09: folds 
VahTang_89: folds 
Uncalled bet (£0.25) returned to mudders693
mudders693 collected £0.50 from pot
mudders693: doesn't show hand 
*** SUMMARY ***
Total pot £0.50 | Rake £0 
Seat 1: Rubleff85 folded before Flop (didn't bet)
Seat 2: matiko09 (button) folded before Flop (didn't bet)
Seat 3: VahTang_89 (small blind) folded before Flop
Seat 5: mudders693 (big blind) collected (£0.50)





PokerStars Hand #154969603579:  Hold'em No Limit (£0.25/£0.50 GBP) - 2016/06/20 12:03:23 CET [2016/06/20 6:03:23 ET]
Table 'Ani' 6-max Seat #6 is the button
Seat 2: joker180785 (£50 in chips) 
Seat 3: Doobes8555 (£84.21 in chips) 
Seat 4: matiko09 (£50 in chips) 
Seat 5: Wwwasian (£51.50 in chips) 
Seat 6: faceMyBallz_ (£64.49 in chips) 
rewq99887788 will be allowed to play after the button
joker180785: posts small blind £0.25
Doobes8555: posts big blind £0.50
*** HOLE CARDS ***
Dealt to matiko09 [5d Ad]
matiko09: raises £1 to £1.50
Wwwasian: folds 
faceMyBallz_: folds 
joker180785: folds 
Doobes8555: folds 
Uncalled bet (£1) returned to matiko09
matiko09 collected £1.25 from pot
matiko09: doesn't show hand 
*** SUMMARY ***
Total pot £1.25 | Rake £0 
Seat 2: joker180785 (small blind) folded before Flop
Seat 3: Doobes8555 (big blind) folded before Flop
Seat 4: matiko09 collected (£1.25)
Seat 5: Wwwasian folded before Flop (didn't bet)
Seat 6: faceMyBallz_ (button) folded before Flop (didn't bet)





PokerStars Hand #154969603492:  Hold'em No Limit (£0.25/£0.50 GBP) - 2016/06/20 12:03:23 CET [2016/06/20 6:03:23 ET]
Table 'Azalea' 6-max Seat #3 is the button
Seat 1: Rubleff85 (£43.40 in chips) 
Seat 2: matiko09 (£50 in chips) 
Seat 3: VahTang_89 (£50 in chips) 
Seat 5: mudders693 (£50.25 in chips) 
Seat 6: Bënedic10 (£50 in chips) 
mudders693: posts small blind £0.25
Bënedic10: posts big blind £0.50
*** HOLE CARDS ***
Dealt to matiko09 [Jd Js]
Rubleff85: folds 
matiko09: raises £1 to £1.50
VahTang_89: folds 
mudders693: folds 
Bënedic10: folds 
Uncalled bet (£1) returned to matiko09
matiko09 collected £1.25 from pot
matiko09: doesn't show hand 
*** SUMMARY ***
Total pot £1.25 | Rake £0 
Seat 1: Rubleff85 folded before Flop (didn't bet)
Seat 2: matiko09 collected (£1.25)
Seat 3: VahTang_89 (button) folded before Flop (didn't bet)
Seat 5: mudders693 (small blind) folded before Flop
Seat 6: Bënedic10 (big blind) folded before Flop





PokerStars Hand #154969609376:  Hold'em No Limit (£0.25/£0.50 GBP) - 2016/06/20 12:03:39 CET [2016/06/20 6:03:39 ET]
Table 'Ani' 6-max Seat #2 is the button
Seat 1: rewq99887788 (£40 in chips) 
Seat 2: joker180785 (£50 in chips) 
Seat 3: Doobes8555 (£83.71 in chips) 
Seat 4: matiko09 (£50.75 in chips) 
Seat 5: Wwwasian (£51.50 in chips) 
Seat 6: faceMyBallz_ (£64.49 in chips) 
Doobes8555: posts small blind £0.25
matiko09: posts big blind £0.50
rewq99887788: posts big blind £0.50
*** HOLE CARDS ***
Dealt to matiko09 [5s 9d]
Wwwasian: folds 
faceMyBallz_: folds 
rewq99887788: raises £1 to £1.50
joker180785: folds 
Doobes8555: calls £1.25
matiko09: folds 
*** FLOP *** [8c 4h Qd]
Doobes8555: checks 
rewq99887788: bets £1.50
Doobes8555: folds 
Uncalled bet (£1.50) returned to rewq99887788
rewq99887788 collected £3.32 from pot
*** SUMMARY ***
Total pot £3.50 | Rake £0.18 
Board [8c 4h Qd]
Seat 1: rewq99887788 collected (£3.32)
Seat 2: joker180785 (button) folded before Flop (didn't bet)
Seat 3: Doobes8555 (small blind) folded on the Flop
Seat 4: matiko09 (big blind) folded before Flop
Seat 5: Wwwasian folded before Flop (didn't bet)
Seat 6: faceMyBallz_ folded before Flop (didn't bet)





PokerStars Hand #154969609452:  Hold'em No Limit (£0.25/£0.50 GBP) - 2016/06/20 12:03:40 CET [2016/06/20 6:03:40 ET]
Table 'Azalea' 6-max Seat #5 is the button
Seat 1: Rubleff85 (£43.40 in chips) 
Seat 2: matiko09 (£50.75 in chips) 
Seat 3: VahTang_89 (£50 in chips) 
Seat 5: mudders693 (£50 in chips) 
Seat 6: Bënedic10 (£50 in chips) 
Bënedic10: posts small blind £0.25
Rubleff85: posts big blind £0.50
*** HOLE CARDS ***
Dealt to matiko09 [Kh 8d]
matiko09: folds 
VahTang_89: folds 
mudders693: calls £0.50
Bënedic10: calls £0.25
Rubleff85: checks 
*** FLOP *** [Jd 8s 9c]
Bënedic10: checks 
Rubleff85: checks 
mudders693: bets £0.50
Bënedic10: calls £0.50
Rubleff85: folds 
*** TURN *** [Jd 8s 9c] [2h]
Bënedic10: checks 
mudders693: bets £0.50
Bënedic10: calls £0.50
*** RIVER *** [Jd 8s 9c 2h] [2s]
Bënedic10: checks 
mudders693: bets £0.50
Bënedic10: calls £0.50
*** SHOW DOWN ***
mudders693: shows [4h 8h] (two pair, Eights and Deuces)
Bënedic10: mucks hand 
mudders693 collected £4.28 from pot
*** SUMMARY ***
Total pot £4.50 | Rake £0.22 
Board [Jd 8s 9c 2h 2s]
Seat 1: Rubleff85 (big blind) folded on the Flop
Seat 2: matiko09 folded before Flop (didn't bet)
Seat 3: VahTang_89 folded before Flop (didn't bet)
Seat 5: mudders693 (button) showed [4h 8h] and won (£4.28) with two pair, Eights and Deuces
Seat 6: Bënedic10 (small blind) mucked [Ts Ah]





PokerStars Hand #154969619192:  Hold'em No Limit (£0.25/£0.50 GBP) - 2016/06/20 12:04:07 CET [2016/06/20 6:04:07 ET]
Table 'Ani' 6-max Seat #3 is the button
Seat 1: rewq99887788 (£41.82 in chips) 
Seat 2: joker180785 (£50 in chips) 
Seat 3: Doobes8555 (£82.21 in chips) 
Seat 4: matiko09 (£50.25 in chips) 
Seat 5: Wwwasian (£51.50 in chips) 
Seat 6: faceMyBallz_ (£64.49 in chips) 
matiko09: posts small blind £0.25
Wwwasian: posts big blind £0.50
*** HOLE CARDS ***
Dealt to matiko09 [Tc 4s]
faceMyBallz_: folds 
rewq99887788: folds 
joker180785: raises £0.75 to £1.25
Doobes8555: folds 
matiko09: folds 
Wwwasian: folds 
Uncalled bet (£0.75) returned to joker180785
joker180785 collected £1.25 from pot
*** SUMMARY ***
Total pot £1.25 | Rake £0 
Seat 1: rewq99887788 folded before Flop (didn't bet)
Seat 2: joker180785 collected (£1.25)
Seat 3: Doobes8555 (button) folded before Flop (didn't bet)
Seat 4: matiko09 (small blind) folded before Flop
Seat 5: Wwwasian (big blind) folded before Flop
Seat 6: faceMyBallz_ folded before Flop (didn't bet)





PokerStars Hand #154969624961:  Hold'em No Limit (£0.25/£0.50 GBP) - 2016/06/20 12:04:23 CET [2016/06/20 6:04:23 ET]
Table 'Ani' 6-max Seat #4 is the button
Seat 1: rewq99887788 (£41.82 in chips) 
Seat 2: joker180785 (£50.75 in chips) 
Seat 3: Doobes8555 (£82.21 in chips) 
Seat 4: matiko09 (£50 in chips) 
Seat 5: Wwwasian (£51 in chips) 
Seat 6: faceMyBallz_ (£64.49 in chips) 
Wwwasian: posts small blind £0.25
faceMyBallz_: posts big blind £0.50
*** HOLE CARDS ***
Dealt to matiko09 [Ah As]
rewq99887788: calls £0.50
joker180785: folds 
Doobes8555: folds 
matiko09: raises £1.50 to £2
Wwwasian: folds 
faceMyBallz_: folds 
rewq99887788: folds 
Uncalled bet (£1.50) returned to matiko09
matiko09 collected £1.75 from pot
matiko09: doesn't show hand 
*** SUMMARY ***
Total pot £1.75 | Rake £0 
Seat 1: rewq99887788 folded before Flop
Seat 2: joker180785 folded before Flop (didn't bet)
Seat 3: Doobes8555 folded before Flop (didn't bet)
Seat 4: matiko09 (button) collected (£1.75)
Seat 5: Wwwasian (small blind) folded before Flop
Seat 6: faceMyBallz_ (big blind) folded before Flop





PokerStars Hand #154969632671:  Hold'em No Limit (£0.25/£0.50 GBP) - 2016/06/20 12:04:44 CET [2016/06/20 6:04:44 ET]
Table 'Ani' 6-max Seat #5 is the button
Seat 1: rewq99887788 (£41.32 in chips) 
Seat 2: joker180785 (£50.75 in chips) 
Seat 3: Doobes8555 (£82.21 in chips) 
Seat 4: matiko09 (£51.25 in chips) 
Seat 5: Wwwasian (£50.75 in chips) 
Seat 6: faceMyBallz_ (£63.99 in chips) 
faceMyBallz_: posts small blind £0.25
rewq99887788: posts big blind £0.50
*** HOLE CARDS ***
Dealt to matiko09 [Ad 2s]
joker180785: folds 
Doobes8555: folds 
matiko09: folds 
Wwwasian: folds 
faceMyBallz_: raises £0.75 to £1.25
rewq99887788: folds 
Uncalled bet (£0.75) returned to faceMyBallz_
faceMyBallz_ collected £1 from pot
faceMyBallz_: doesn't show hand 
*** SUMMARY ***
Total pot £1 | Rake £0 
Seat 1: rewq99887788 (big blind) folded before Flop
Seat 2: joker180785 folded before Flop (didn't bet)
Seat 3: Doobes8555 folded before Flop (didn't bet)
Seat 4: matiko09 folded before Flop (didn't bet)
Seat 5: Wwwasian (button) folded before Flop (didn't bet)
Seat 6: faceMyBallz_ (small blind) collected (£1)





PokerStars Hand #154969633431:  Hold'em No Limit ($0.50/$1.00 USD) - 2016/06/20 12:04:46 CET [2016/06/20 6:04:46 ET]
Table 'Anhui' 9-max Seat #5 is the button
Seat 1: SkUhNi ($142 in chips) 
Seat 2: ruslik_by ($261.73 in chips) 
Seat 4: mavin80 ($32.46 in chips) 
Seat 5: mi$$I$Elena ($106.52 in chips) 
Seat 6: 23SmOkEr07 ($103 in chips) 
Seat 7: matiko09 ($100 in chips) 
Seat 8: nubpoker ($108.11 in chips) 
Seat 9: blackw0lf_03 ($104.80 in chips) 
23SmOkEr07: posts small blind $0.50
matiko09: posts big blind $1
nowi1980: sits out 
*** HOLE CARDS ***
Dealt to matiko09 [2h Ks]
nubpoker: folds 
blackw0lf_03: raises $2 to $3
SkUhNi: folds 
ruslik_by: folds 
mavin80: folds 
mi$$I$Elena: folds 
23SmOkEr07: folds 
matiko09: folds 
Uncalled bet ($2) returned to blackw0lf_03
blackw0lf_03 collected $2.50 from pot
blackw0lf_03: doesn't show hand 
*** SUMMARY ***
Total pot $2.50 | Rake $0 
Seat 1: SkUhNi folded before Flop (didn't bet)
Seat 2: ruslik_by folded before Flop (didn't bet)
Seat 4: mavin80 folded before Flop (didn't bet)
Seat 5: mi$$I$Elena (button) folded before Flop (didn't bet)
Seat 6: 23SmOkEr07 (small blind) folded before Flop
Seat 7: matiko09 (big blind) folded before Flop
Seat 8: nubpoker folded before Flop (didn't bet)
Seat 9: blackw0lf_03 collected ($2.50)





PokerStars Hand #154969635357:  Hold'em No Limit (£0.25/£0.50 GBP) - 2016/06/20 12:04:52 CET [2016/06/20 6:04:52 ET]
Table 'Azalea' 6-max Seat #6 is the button
Seat 1: Rubleff85 (£42.90 in chips) 
Seat 2: matiko09 (£50.75 in chips) 
Seat 3: VahTang_89 (£50 in chips) 
Seat 5: mudders693 (£52.28 in chips) 
Seat 6: Bënedic10 (£50 in chips) 
Rubleff85: posts small blind £0.25
matiko09: posts big blind £0.50
*** HOLE CARDS ***
Dealt to matiko09 [4s 5c]
VahTang_89: folds 
mudders693: folds 
Bënedic10: raises £1 to £1.50
Rubleff85: folds 
matiko09: folds 
Uncalled bet (£1) returned to Bënedic10
Bënedic10 collected £1.25 from pot
Bënedic10: doesn't show hand 
*** SUMMARY ***
Total pot £1.25 | Rake £0 
Seat 1: Rubleff85 (small blind) folded before Flop
Seat 2: matiko09 (big blind) folded before Flop
Seat 3: VahTang_89 folded before Flop (didn't bet)
Seat 5: mudders693 folded before Flop (didn't bet)
Seat 6: Bënedic10 (button) collected (£1.25)





PokerStars Hand #154969640270:  Hold'em No Limit ($0.25/$0.50 USD) - 2016/06/20 12:05:05 CET [2016/06/20 6:05:05 ET]
Table 'Memoria II' 9-max Seat #2 is the button
Seat 1: theluckyjoe ($40 in chips) 
Seat 2: matiko09 ($50 in chips) 
matiko09: posts small blind $0.25
djammusic: is sitting out 
theluckyjoe: posts big blind $0.50
*** HOLE CARDS ***
Dealt to matiko09 [4s 9d]
ljryviltj joins the table at seat #3 
djammusic leaves the table
matiko09: folds 
Uncalled bet ($0.25) returned to theluckyjoe
St.LaCoste joins the table at seat #4 
theluckyjoe collected $0.50 from pot
theluckyjoe: doesn't show hand 
*** SUMMARY ***
Total pot $0.50 | Rake $0 
Seat 1: theluckyjoe (big blind) collected ($0.50)
Seat 2: matiko09 (button) (small blind) folded before Flop





PokerStars Hand #154969640346:  Hold'em No Limit (£0.25/£0.50 GBP) - 2016/06/20 12:05:05 CET [2016/06/20 6:05:05 ET]
Table 'Azalea' 6-max Seat #1 is the button
Seat 1: Rubleff85 (£42.65 in chips) 
Seat 2: matiko09 (£50.25 in chips) 
Seat 3: VahTang_89 (£50 in chips) 
Seat 5: mudders693 (£52.28 in chips) 
Seat 6: Bënedic10 (£50.75 in chips) 
matiko09: posts small blind £0.25
VahTang_89: posts big blind £0.50
*** HOLE CARDS ***
Dealt to matiko09 [9d 8d]
mudders693: raises £1 to £1.50
Bënedic10: folds 
Rubleff85: folds 
matiko09: folds 
VahTang_89: folds 
Uncalled bet (£1) returned to mudders693
mudders693 collected £1.25 from pot
mudders693: doesn't show hand 
*** SUMMARY ***
Total pot £1.25 | Rake £0 
Seat 1: Rubleff85 (button) folded before Flop (didn't bet)
Seat 2: matiko09 (small blind) folded before Flop
Seat 3: VahTang_89 (big blind) folded before Flop
Seat 5: mudders693 collected (£1.25)
Seat 6: Bënedic10 folded before Flop (didn't bet)





PokerStars Hand #154969641612:  Hold'em No Limit (£0.25/£0.50 GBP) - 2016/06/20 12:05:09 CET [2016/06/20 6:05:09 ET]
Table 'Ani' 6-max Seat #6 is the button
Seat 1: rewq99887788 (£40.82 in chips) 
Seat 2: joker180785 (£50.75 in chips) 
Seat 3: Doobes8555 (£82.21 in chips) 
Seat 4: matiko09 (£51.25 in chips) 
Seat 5: Wwwasian (£50.75 in chips) 
Seat 6: faceMyBallz_ (£64.49 in chips) 
rewq99887788: posts small blind £0.25
joker180785: posts big blind £0.50
*** HOLE CARDS ***
Dealt to matiko09 [2s 9s]
Doobes8555: calls £0.50
matiko09: folds 
Wwwasian: folds 
faceMyBallz_: folds 
rewq99887788: raises £2 to £2.50
joker180785: calls £2
Doobes8555: calls £2
*** FLOP *** [Kh Qh 5c]
rewq99887788: bets £2.50
joker180785: folds 
Doobes8555: folds 
Uncalled bet (£2.50) returned to rewq99887788
rewq99887788 collected £7.12 from pot
*** SUMMARY ***
Total pot £7.50 | Rake £0.38 
Board [Kh Qh 5c]
Seat 1: rewq99887788 (small blind) collected (£7.12)
Seat 2: joker180785 (big blind) folded on the Flop
Seat 3: Doobes8555 folded on the Flop
Seat 4: matiko09 folded before Flop (didn't bet)
Seat 5: Wwwasian folded before Flop (didn't bet)
Seat 6: faceMyBallz_ (button) folded before Flop (didn't bet)





PokerStars Hand #154969645018:  Hold'em No Limit ($0.25/$0.50 USD) - 2016/06/20 12:05:18 CET [2016/06/20 6:05:18 ET]
Table 'Memoria II' 9-max Seat #1 is the button
Seat 1: theluckyjoe ($40.25 in chips) 
Seat 2: matiko09 ($50 in chips) 
theluckyjoe: posts small blind $0.25
matiko09: posts big blind $0.50
*** HOLE CARDS ***
Dealt to matiko09 [4d 7d]
kiev-city12 joins the table at seat #5 
theluckyjoe: raises $0.50 to $1
matiko09: folds 
Uncalled bet ($0.50) returned to theluckyjoe
theluckyjoe collected $1 from pot
theluckyjoe: doesn't show hand 
*** SUMMARY ***
Total pot $1 | Rake $0 
Seat 1: theluckyjoe (button) (small blind) collected ($1)
Seat 2: matiko09 (big blind) folded before Flop





PokerStars Hand #154969647438:  Hold'em No Limit (£0.25/£0.50 GBP) - 2016/06/20 12:05:25 CET [2016/06/20 6:05:25 ET]
Table 'Azalea' 6-max Seat #2 is the button
Seat 1: Rubleff85 (£42.65 in chips) 
Seat 2: matiko09 (£50 in chips) 
Seat 3: VahTang_89 (£50 in chips) 
Seat 5: mudders693 (£53.03 in chips) 
Seat 6: Bënedic10 (£50.75 in chips) 
VahTang_89: posts small blind £0.25
mudders693: posts big blind £0.50
*** HOLE CARDS ***
Dealt to matiko09 [8h Th]
Bënedic10: raises £0.75 to £1.25
Rubleff85: folds 
matiko09: folds 
VahTang_89: folds 
mudders693: raises £2.75 to £4
Bënedic10: calls £2.75
*** FLOP *** [5h Kc Ks]
mudders693: checks 
Bënedic10: checks 
*** TURN *** [5h Kc Ks] [6s]
mudders693: bets £5
Bënedic10: folds 
Uncalled bet (£5) returned to mudders693
mudders693 collected £7.84 from pot
mudders693: doesn't show hand 
*** SUMMARY ***
Total pot £8.25 | Rake £0.41 
Board [5h Kc Ks 6s]
Seat 1: Rubleff85 folded before Flop (didn't bet)
Seat 2: matiko09 (button) folded before Flop (didn't bet)
Seat 3: VahTang_89 (small blind) folded before Flop
Seat 5: mudders693 (big blind) collected (£7.84)
Seat 6: Bënedic10 folded on the Turn





PokerStars Hand #154969647931:  Hold'em No Limit ($0.25/$0.50 USD) - 2016/06/20 12:05:27 CET [2016/06/20 6:05:27 ET]
Table 'Memoria II' 9-max Seat #1 is the button
Seat 1: theluckyjoe ($40.75 in chips) 
Seat 2: matiko09 ($50 in chips) 
Seat 3: ljryviltj ($50 in chips) 
matiko09: posts small blind $0.25
ljryviltj: posts big blind $0.50
St.LaCoste: sits out 
kiev-city12: sits out 
*** HOLE CARDS ***
Dealt to matiko09 [6d 2s]
theluckyjoe: calls $0.50
matiko09: folds 
ljryviltj: checks 
*** FLOP *** [Qd 5d 8c]
Kukuryzka joins the table at seat #6 
ljryviltj: checks 
mi$$I$Elena joins the table at seat #8 
theluckyjoe: bets $1
ljryviltj: folds 
Uncalled bet ($1) returned to theluckyjoe
theluckyjoe collected $1.19 from pot
theluckyjoe: doesn't show hand 
*** SUMMARY ***
Total pot $1.25 | Rake $0.06 
Board [Qd 5d 8c]
Seat 1: theluckyjoe (button) collected ($1.19)
Seat 2: matiko09 (small blind) folded before Flop
Seat 3: ljryviltj (big blind) folded on the Flop





PokerStars Hand #154969649017:  Hold'em No Limit ($0.50/$1.00 USD) - 2016/06/20 12:05:29 CET [2016/06/20 6:05:29 ET]
Table 'Anhui' 9-max Seat #6 is the button
Seat 1: SkUhNi ($142 in chips) 
Seat 2: ruslik_by ($261.73 in chips) 
Seat 3: nowi1980 ($40 in chips) 
Seat 4: mavin80 ($32.46 in chips) 
Seat 5: mi$$I$Elena ($106.52 in chips) 
Seat 6: 23SmOkEr07 ($102.50 in chips) 
Seat 7: matiko09 ($100 in chips) 
Seat 8: nubpoker ($108.11 in chips) 
Seat 9: blackw0lf_03 ($106.30 in chips) 
matiko09: posts small blind $0.50
nubpoker: posts big blind $1
nowi1980: posts big blind $1
*** HOLE CARDS ***
Dealt to matiko09 [3c 7c]
blackw0lf_03: folds 
SkUhNi: folds 
ruslik_by: folds 
nowi1980: checks 
mavin80: folds 
mi$$I$Elena: folds 
23SmOkEr07: folds 
matiko09: calls $0.50
nubpoker: checks 
*** FLOP *** [6h 2d Jc]
matiko09: checks 
nubpoker: checks 
nowi1980: checks 
*** TURN *** [6h 2d Jc] [Qs]
matiko09: checks 
nubpoker: checks 
nowi1980: bets $1
matiko09: folds 
nubpoker: calls $1
*** RIVER *** [6h 2d Jc Qs] [Js]
nubpoker: checks 
nowi1980: checks 
*** SHOW DOWN ***
nubpoker: shows [Ks 6s] (two pair, Jacks and Sixes)
nowi1980: mucks hand 
nubpoker collected $4.75 from pot
*** SUMMARY ***
Total pot $5 | Rake $0.25 
Board [6h 2d Jc Qs Js]
Seat 1: SkUhNi folded before Flop (didn't bet)
Seat 2: ruslik_by folded before Flop (didn't bet)
Seat 3: nowi1980 mucked [2s Kh]
Seat 4: mavin80 folded before Flop (didn't bet)
Seat 5: mi$$I$Elena folded before Flop (didn't bet)
Seat 6: 23SmOkEr07 (button) folded before Flop (didn't bet)
Seat 7: matiko09 (small blind) folded on the Turn
Seat 8: nubpoker (big blind) showed [Ks 6s] and won ($4.75) with two pair, Jacks and Sixes
Seat 9: blackw0lf_03 folded before Flop (didn't bet)





PokerStars Hand #154969658971:  Hold'em No Limit (£0.25/£0.50 GBP) - 2016/06/20 12:05:57 CET [2016/06/20 6:05:57 ET]
Table 'Ani' 6-max Seat #1 is the button
Seat 1: rewq99887788 (£45.44 in chips) 
Seat 2: joker180785 (£50 in chips) 
Seat 3: Doobes8555 (£79.71 in chips) 
Seat 4: matiko09 (£51.25 in chips) 
Seat 5: Wwwasian (£50.75 in chips) 
Seat 6: faceMyBallz_ (£64.49 in chips) 
joker180785: posts small blind £0.25
Doobes8555: posts big blind £0.50
*** HOLE CARDS ***
Dealt to matiko09 [Qh 4c]
matiko09: folds 
Wwwasian: folds 
faceMyBallz_: raises £0.75 to £1.25
rewq99887788: folds 
joker180785: calls £1
Doobes8555: folds 
*** FLOP *** [2h 7d 7h]
joker180785: checks 
faceMyBallz_: bets £1.42
joker180785: calls £1.42
*** TURN *** [2h 7d 7h] [Th]
joker180785: checks 
faceMyBallz_: checks 
*** RIVER *** [2h 7d 7h Th] [8h]
joker180785: bets £4.27
faceMyBallz_: folds 
Uncalled bet (£4.27) returned to joker180785
joker180785 collected £5.55 from pot
*** SUMMARY ***
Total pot £5.84 | Rake £0.29 
Board [2h 7d 7h Th 8h]
Seat 1: rewq99887788 (button) folded before Flop (didn't bet)
Seat 2: joker180785 (small blind) collected (£5.55)
Seat 3: Doobes8555 (big blind) folded before Flop
Seat 4: matiko09 folded before Flop (didn't bet)
Seat 5: Wwwasian folded before Flop (didn't bet)
Seat 6: faceMyBallz_ folded on the River





PokerStars Hand #154969661578:  Hold'em No Limit ($0.25/$0.50 USD) - 2016/06/20 12:06:04 CET [2016/06/20 6:06:04 ET]
Table 'Memoria II' 9-max Seat #2 is the button
Seat 1: theluckyjoe ($41.44 in chips) 
Seat 2: matiko09 ($50 in chips) 
Seat 3: ljryviltj ($50 in chips) 
Seat 4: St.LaCoste ($50 in chips) 
ljryviltj: posts small blind $0.25
St.LaCoste: posts big blind $0.50
kiev-city12: sits out 
Kukuryzka: sits out 
mi$$I$Elena: sits out 
*** HOLE CARDS ***
Dealt to matiko09 [Ts 4c]
theluckyjoe: raises $1 to $1.50
matiko09: folds 
djammusic joins the table at seat #9 
ljryviltj: raises $3.50 to $5
St.LaCoste: folds 
theluckyjoe: calls $3.50
*** FLOP *** [9s 2d Ah]
Zeeshka joins the table at seat #7 
ljryviltj: checks 
theluckyjoe: checks 
*** TURN *** [9s 2d Ah] [8d]
ljryviltj: bets $7
theluckyjoe: folds 
Uncalled bet ($7) returned to ljryviltj
ljryviltj collected $9.98 from pot
ljryviltj: doesn't show hand 
*** SUMMARY ***
Total pot $10.50 | Rake $0.52 
Board [9s 2d Ah 8d]
Seat 1: theluckyjoe folded on the Turn
Seat 2: matiko09 (button) folded before Flop (didn't bet)
Seat 3: ljryviltj (small blind) collected ($9.98)
Seat 4: St.LaCoste (big blind) folded before Flop





PokerStars Hand #154969662921:  Hold'em No Limit (£0.25/£0.50 GBP) - 2016/06/20 12:06:08 CET [2016/06/20 6:06:08 ET]
Table 'Azalea' 6-max Seat #3 is the button
Seat 1: Rubleff85 (£42.65 in chips) 
Seat 2: matiko09 (£50 in chips) 
Seat 3: VahTang_89 (£50 in chips) 
Seat 5: mudders693 (£56.87 in chips) 
Seat 6: Bënedic10 (£50 in chips) 
mudders693: posts small blind £0.25
Bënedic10: posts big blind £0.50
*** HOLE CARDS ***
Dealt to matiko09 [3s Ad]
Rubleff85: folds 
matiko09: folds 
VahTang_89: raises £1 to £1.50
mudders693: folds 
Bënedic10: raises £3 to £4.50
VahTang_89: folds 
Uncalled bet (£3) returned to Bënedic10
Bënedic10 collected £3.25 from pot
Bënedic10: doesn't show hand 
*** SUMMARY ***
Total pot £3.25 | Rake £0 
Seat 1: Rubleff85 folded before Flop (didn't bet)
Seat 2: matiko09 folded before Flop (didn't bet)
Seat 3: VahTang_89 (button) folded before Flop
Seat 5: mudders693 (small blind) folded before Flop
Seat 6: Bënedic10 (big blind) collected (£3.25)





PokerStars Hand #154969673104:  Hold'em No Limit (£0.25/£0.50 GBP) - 2016/06/20 12:06:36 CET [2016/06/20 6:06:36 ET]
Table 'Azalea' 6-max Seat #5 is the button
Seat 1: Rubleff85 (£42.65 in chips) 
Seat 2: matiko09 (£50 in chips) 
Seat 3: VahTang_89 (£50 in chips) 
Seat 5: mudders693 (£56.62 in chips) 
Seat 6: Bënedic10 (£51.75 in chips) 
Bënedic10: posts small blind £0.25
Rubleff85: posts big blind £0.50
*** HOLE CARDS ***
Dealt to matiko09 [5d 7s]
matiko09: folds 
VahTang_89: raises £0.50 to £1
mudders693: calls £1
Bënedic10: folds 
Rubleff85: calls £0.50
*** FLOP *** [5h Jh Qs]
Rubleff85: checks 
VahTang_89: checks 
mudders693: checks 
*** TURN *** [5h Jh Qs] [Ks]
Rubleff85: bets £1.75
VahTang_89: folds 
mudders693: folds 
Uncalled bet (£1.75) returned to Rubleff85
Rubleff85 collected £3.09 from pot
Rubleff85: doesn't show hand 
*** SUMMARY ***
Total pot £3.25 | Rake £0.16 
Board [5h Jh Qs Ks]
Seat 1: Rubleff85 (big blind) collected (£3.09)
Seat 2: matiko09 folded before Flop (didn't bet)
Seat 3: VahTang_89 folded on the Turn
Seat 5: mudders693 (button) folded on the Turn
Seat 6: Bënedic10 (small blind) folded before Flop





PokerStars Hand #154969675807:  Hold'em No Limit (£0.25/£0.50 GBP) - 2016/06/20 12:06:44 CET [2016/06/20 6:06:44 ET]
Table 'Ani' 6-max Seat #2 is the button
Seat 1: rewq99887788 (£45.44 in chips) 
Seat 2: joker180785 (£52.88 in chips) 
Seat 3: Doobes8555 (£79.21 in chips) 
Seat 4: matiko09 (£51.25 in chips) 
Seat 5: Wwwasian (£50.75 in chips) 
Seat 6: faceMyBallz_ (£61.82 in chips) 
Doobes8555: posts small blind £0.25
matiko09: posts big blind £0.50
*** HOLE CARDS ***
Dealt to matiko09 [Ac 3c]
Wwwasian: folds 
faceMyBallz_: folds 
rewq99887788: folds 
joker180785: raises £0.50 to £1
Doobes8555: folds 
matiko09: calls £0.50
*** FLOP *** [5h 8h Jd]
matiko09: checks 
joker180785: bets £1.34
matiko09: folds 
Uncalled bet (£1.34) returned to joker180785
joker180785 collected £2.14 from pot
*** SUMMARY ***
Total pot £2.25 | Rake £0.11 
Board [5h 8h Jd]
Seat 1: rewq99887788 folded before Flop (didn't bet)
Seat 2: joker180785 (button) collected (£2.14)
Seat 3: Doobes8555 (small blind) folded before Flop
Seat 4: matiko09 (big blind) folded on the Flop
Seat 5: Wwwasian folded before Flop (didn't bet)
Seat 6: faceMyBallz_ folded before Flop (didn't bet)





PokerStars Hand #154969677735:  Hold'em No Limit ($0.50/$1.00 USD) - 2016/06/20 12:06:49 CET [2016/06/20 6:06:49 ET]
Table 'Anhui' 9-max Seat #7 is the button
Seat 1: SkUhNi ($142 in chips) 
Seat 2: ruslik_by ($261.73 in chips) 
Seat 3: nowi1980 ($38 in chips) 
Seat 4: mavin80 ($32.46 in chips) 
Seat 5: mi$$I$Elena ($106.52 in chips) 
Seat 6: 23SmOkEr07 ($102.50 in chips) 
Seat 7: matiko09 ($100 in chips) 
Seat 8: nubpoker ($110.86 in chips) 
Seat 9: blackw0lf_03 ($106.30 in chips) 
nubpoker: posts small blind $0.50
blackw0lf_03: posts big blind $1
*** HOLE CARDS ***
Dealt to matiko09 [6c 8c]
SkUhNi: folds 
ruslik_by: folds 
nowi1980: folds 
mavin80: folds 
mi$$I$Elena: raises $1.38 to $2.38
23SmOkEr07: folds 
matiko09: folds 
nubpoker: raises $6.62 to $9
blackw0lf_03: folds 
mi$$I$Elena: folds 
Uncalled bet ($6.62) returned to nubpoker
nubpoker collected $5.76 from pot
nubpoker: doesn't show hand 
*** SUMMARY ***
Total pot $5.76 | Rake $0 
Seat 1: SkUhNi folded before Flop (didn't bet)
Seat 2: ruslik_by folded before Flop (didn't bet)
Seat 3: nowi1980 folded before Flop (didn't bet)
Seat 4: mavin80 folded before Flop (didn't bet)
Seat 5: mi$$I$Elena folded before Flop
Seat 6: 23SmOkEr07 folded before Flop (didn't bet)
Seat 7: matiko09 (button) folded before Flop (didn't bet)
Seat 8: nubpoker (small blind) collected ($5.76)
Seat 9: blackw0lf_03 (big blind) folded before Flop





PokerStars Hand #154969679150:  Hold'em No Limit ($0.25/$0.50 USD) - 2016/06/20 12:06:53 CET [2016/06/20 6:06:53 ET]
Table 'Memoria II' 9-max Seat #3 is the button
Seat 1: theluckyjoe ($36.44 in chips) 
Seat 2: matiko09 ($50 in chips) 
Seat 3: ljryviltj ($54.98 in chips) 
Seat 4: St.LaCoste ($49.50 in chips) 
Seat 5: kiev-city12 ($50 in chips) 
St.LaCoste: posts small blind $0.25
kiev-city12: posts big blind $0.50
Kukuryzka: sits out 
Zeeshka: sits out 
mi$$I$Elena: sits out 
djammusic: sits out 
*** HOLE CARDS ***
Dealt to matiko09 [Ad 7c]
theluckyjoe: raises $1 to $1.50
matiko09: folds 
ljryviltj: folds 
St.LaCoste: folds 
kiev-city12: calls $1
*** FLOP *** [8c 9s 8h]
kiev-city12: checks 
theluckyjoe: bets $3
kiev-city12: folds 
Uncalled bet ($3) returned to theluckyjoe
theluckyjoe collected $3.09 from pot
theluckyjoe: doesn't show hand 
*** SUMMARY ***
Total pot $3.25 | Rake $0.16 
Board [8c 9s 8h]
Seat 1: theluckyjoe collected ($3.09)
Seat 2: matiko09 folded before Flop (didn't bet)
Seat 3: ljryviltj (button) folded before Flop (didn't bet)
Seat 4: St.LaCoste (small blind) folded before Flop
Seat 5: kiev-city12 (big blind) folded on the Flop





PokerStars Hand #154969686848:  Hold'em No Limit (£0.25/£0.50 GBP) - 2016/06/20 12:07:14 CET [2016/06/20 6:07:14 ET]
Table 'Ani' 6-max Seat #3 is the button
Seat 1: rewq99887788 (£45.44 in chips) 
Seat 2: joker180785 (£54.02 in chips) 
Seat 3: Doobes8555 (£78.96 in chips) 
Seat 4: matiko09 (£50.25 in chips) 
Seat 5: Wwwasian (£50.75 in chips) 
Seat 6: faceMyBallz_ (£61.82 in chips) 
matiko09: posts small blind £0.25
Wwwasian: posts big blind £0.50
*** HOLE CARDS ***
Dealt to matiko09 [Jh Td]
faceMyBallz_: folds 
rewq99887788: raises £0.50 to £1
joker180785: folds 
Doobes8555: folds 
matiko09: folds 
Wwwasian: folds 
Uncalled bet (£0.50) returned to rewq99887788
rewq99887788 collected £1.25 from pot
*** SUMMARY ***
Total pot £1.25 | Rake £0 
Seat 1: rewq99887788 collected (£1.25)
Seat 2: joker180785 folded before Flop (didn't bet)
Seat 3: Doobes8555 (button) folded before Flop (didn't bet)
Seat 4: matiko09 (small blind) folded before Flop
Seat 5: Wwwasian (big blind) folded before Flop
Seat 6: faceMyBallz_ folded before Flop (didn't bet)





PokerStars Hand #154969689662:  Hold'em No Limit (£0.25/£0.50 GBP) - 2016/06/20 12:07:22 CET [2016/06/20 6:07:22 ET]
Table 'Azalea' 6-max Seat #6 is the button
Seat 1: Rubleff85 (£44.74 in chips) 
Seat 2: matiko09 (£50 in chips) 
Seat 3: VahTang_89 (£50 in chips) 
Seat 5: mudders693 (£55.62 in chips) 
Seat 6: Bënedic10 (£51.50 in chips) 
Rubleff85: posts small blind £0.25
matiko09: posts big blind £0.50
*** HOLE CARDS ***
Dealt to matiko09 [Ks 4h]
VahTang_89: folds 
mudders693: folds 
Bënedic10: folds 
Rubleff85: raises £1 to £1.50
matiko09: folds 
Uncalled bet (£1) returned to Rubleff85
Rubleff85 collected £1 from pot
Rubleff85: doesn't show hand 
*** SUMMARY ***
Total pot £1 | Rake £0 
Seat 1: Rubleff85 (small blind) collected (£1)
Seat 2: matiko09 (big blind) folded before Flop
Seat 3: VahTang_89 folded before Flop (didn't bet)
Seat 5: mudders693 folded before Flop (didn't bet)
Seat 6: Bënedic10 (button) folded before Flop (didn't bet)





PokerStars Hand #154969690144:  Hold'em No Limit ($0.25/$0.50 USD) - 2016/06/20 12:07:24 CET [2016/06/20 6:07:24 ET]
Table 'Memoria II' 9-max Seat #4 is the button
Seat 1: theluckyjoe ($38.03 in chips) 
Seat 2: matiko09 ($50 in chips) 
Seat 3: ljryviltj ($54.98 in chips) 
Seat 4: St.LaCoste ($49.25 in chips) 
Seat 5: kiev-city12 ($48.50 in chips) 
Seat 6: Kukuryzka ($50 in chips) 
kiev-city12: posts small blind $0.25
Kukuryzka: posts big blind $0.50
Zeeshka: sits out 
mi$$I$Elena: sits out 
djammusic: sits out 
*** HOLE CARDS ***
Dealt to matiko09 [Kc 3c]
theluckyjoe: folds 
matiko09: folds 
ljryviltj: folds 
St.LaCoste: raises $0.56 to $1.06
kiev-city12: folds 
Kukuryzka: calls $0.56
*** FLOP *** [6h 4d 2c]
Kukuryzka: checks 
St.LaCoste: checks 
*** TURN *** [6h 4d 2c] [5d]
Kukuryzka: bets $1.50
St.LaCoste: calls $1.50
*** RIVER *** [6h 4d 2c 5d] [2d]
Kukuryzka: bets $3.57
St.LaCoste: raises $7.43 to $11
Kukuryzka: folds 
Uncalled bet ($7.43) returned to St.LaCoste
St.LaCoste collected $11.88 from pot
St.LaCoste: doesn't show hand 
*** SUMMARY ***
Total pot $12.51 | Rake $0.63 
Board [6h 4d 2c 5d 2d]
Seat 1: theluckyjoe folded before Flop (didn't bet)
Seat 2: matiko09 folded before Flop (didn't bet)
Seat 3: ljryviltj folded before Flop (didn't bet)
Seat 4: St.LaCoste (button) collected ($11.88)
Seat 5: kiev-city12 (small blind) folded before Flop
Seat 6: Kukuryzka (big blind) folded on the River





PokerStars Hand #154969692239:  Hold'em No Limit (£0.25/£0.50 GBP) - 2016/06/20 12:07:30 CET [2016/06/20 6:07:30 ET]
Table 'Ani' 6-max Seat #4 is the button
Seat 1: rewq99887788 (£46.19 in chips) 
Seat 2: joker180785 (£54.02 in chips) 
Seat 3: Doobes8555 (£78.96 in chips) 
Seat 4: matiko09 (£50 in chips) 
Seat 5: Wwwasian (£50.25 in chips) 
Seat 6: faceMyBallz_ (£61.82 in chips) 
Wwwasian: posts small blind £0.25
faceMyBallz_: posts big blind £0.50
*** HOLE CARDS ***
Dealt to matiko09 [Td 8d]
Doobes8555 said, "England 4 Slovakia 0"
rewq99887788: raises £1 to £1.50
joker180785: folds 
Doobes8555: folds 
matiko09 said, ":D"
matiko09: folds 
Wwwasian: folds 
faceMyBallz_: folds 
Uncalled bet (£1) returned to rewq99887788
rewq99887788 collected £1.25 from pot
*** SUMMARY ***
Total pot £1.25 | Rake £0 
Seat 1: rewq99887788 collected (£1.25)
Seat 2: joker180785 folded before Flop (didn't bet)
Seat 3: Doobes8555 folded before Flop (didn't bet)
Seat 4: matiko09 (button) folded before Flop (didn't bet)
Seat 5: Wwwasian (small blind) folded before Flop
Seat 6: faceMyBallz_ (big blind) folded before Flop





PokerStars Hand #154969694484:  Hold'em No Limit (£0.25/£0.50 GBP) - 2016/06/20 12:07:36 CET [2016/06/20 6:07:36 ET]
Table 'Azalea' 6-max Seat #1 is the button
Seat 1: Rubleff85 (£45.24 in chips) 
Seat 2: matiko09 (£50 in chips) 
Seat 3: VahTang_89 (£50 in chips) 
Seat 5: mudders693 (£55.62 in chips) 
Seat 6: Bënedic10 (£51.50 in chips) 
matiko09: posts small blind £0.25
VahTang_89: posts big blind £0.50
*** HOLE CARDS ***
Dealt to matiko09 [Js Th]
mudders693: raises £1 to £1.50
Bënedic10: folds 
Rubleff85: folds 
matiko09: folds 
VahTang_89: calls £1
*** FLOP *** [3c 3h 8h]
VahTang_89: checks 
mudders693: checks 
*** TURN *** [3c 3h 8h] [5c]
VahTang_89: bets £1.54
mudders693: calls £1.54
*** RIVER *** [3c 3h 8h 5c] [Ks]
VahTang_89: bets £7.51
mudders693: folds 
Uncalled bet (£7.51) returned to VahTang_89
VahTang_89 collected £6.01 from pot
VahTang_89: doesn't show hand 
*** SUMMARY ***
Total pot £6.33 | Rake £0.32 
Board [3c 3h 8h 5c Ks]
Seat 1: Rubleff85 (button) folded before Flop (didn't bet)
Seat 2: matiko09 (small blind) folded before Flop
Seat 3: VahTang_89 (big blind) collected (£6.01)
Seat 5: mudders693 folded on the River
Seat 6: Bënedic10 folded before Flop (didn't bet)





PokerStars Hand #154969704491:  Hold'em No Limit (£0.25/£0.50 GBP) - 2016/06/20 12:08:04 CET [2016/06/20 6:08:04 ET]
Table 'Ani' 6-max Seat #5 is the button
Seat 1: rewq99887788 (£46.94 in chips) 
Seat 2: joker180785 (£54.02 in chips) 
Seat 3: Doobes8555 (£78.96 in chips) 
Seat 4: matiko09 (£50 in chips) 
Seat 5: Wwwasian (£50 in chips) 
Seat 6: faceMyBallz_ (£61.32 in chips) 
faceMyBallz_: posts small blind £0.25
rewq99887788: posts big blind £0.50
*** HOLE CARDS ***
Dealt to matiko09 [7d Ad]
joker180785: folds 
Doobes8555: calls £0.50
matiko09: raises £1.50 to £2
Wwwasian: folds 
faceMyBallz_: raises £4 to £6
rewq99887788: folds 
Doobes8555: folds 
matiko09: folds 
Uncalled bet (£4) returned to faceMyBallz_
faceMyBallz_ collected £5 from pot
faceMyBallz_: doesn't show hand 
*** SUMMARY ***
Total pot £5 | Rake £0 
Seat 1: rewq99887788 (big blind) folded before Flop
Seat 2: joker180785 folded before Flop (didn't bet)
Seat 3: Doobes8555 folded before Flop
Seat 4: matiko09 folded before Flop
Seat 5: Wwwasian (button) folded before Flop (didn't bet)
Seat 6: faceMyBallz_ (small blind) collected (£5)





PokerStars Hand #154969707777:  Hold'em No Limit ($0.50/$1.00 USD) - 2016/06/20 12:08:13 CET [2016/06/20 6:08:13 ET]
Table 'Anhui' 9-max Seat #8 is the button
Seat 1: SkUhNi ($142 in chips) 
Seat 2: ruslik_by ($261.73 in chips) 
Seat 3: nowi1980 ($38 in chips) 
Seat 4: mavin80 ($32.46 in chips) 
Seat 5: mi$$I$Elena ($104.14 in chips) 
Seat 6: 23SmOkEr07 ($102.50 in chips) 
Seat 7: matiko09 ($100 in chips) 
Seat 8: nubpoker ($114.24 in chips) 
Seat 9: blackw0lf_03 ($105.30 in chips) 
blackw0lf_03: posts small blind $0.50
SkUhNi: posts big blind $1
*** HOLE CARDS ***
Dealt to matiko09 [Ks Tc]
ruslik_by: raises $2 to $3
nowi1980: calls $3
mavin80: folds 
mi$$I$Elena: folds 
23SmOkEr07: folds 
matiko09: folds 
nubpoker: folds 
blackw0lf_03: folds 
SkUhNi: folds 
*** FLOP *** [Ts Ah 3d]
ruslik_by: bets $2.42
nowi1980: folds 
Uncalled bet ($2.42) returned to ruslik_by
ruslik_by collected $7.12 from pot
ruslik_by: doesn't show hand 
*** SUMMARY ***
Total pot $7.50 | Rake $0.38 
Board [Ts Ah 3d]
Seat 1: SkUhNi (big blind) folded before Flop
Seat 2: ruslik_by collected ($7.12)
Seat 3: nowi1980 folded on the Flop
Seat 4: mavin80 folded before Flop (didn't bet)
Seat 5: mi$$I$Elena folded before Flop (didn't bet)
Seat 6: 23SmOkEr07 folded before Flop (didn't bet)
Seat 7: matiko09 folded before Flop (didn't bet)
Seat 8: nubpoker (button) folded before Flop (didn't bet)
Seat 9: blackw0lf_03 (small blind) folded before Flop





PokerStars Hand #154969712057:  Hold'em No Limit ($0.50/$1.00 USD) - 2016/06/20 12:08:25 CET [2016/06/20 6:08:25 ET]
Table 'Ambrosia II' 9-max Seat #5 is the button
Seat 1: 23SmOkEr07 ($114.45 in chips) 
Seat 2: blackw0lf_03 ($188.11 in chips) 
Seat 3: mavin80 ($76.11 in chips) 
Seat 4: mi$$I$Elena ($100 in chips) 
Seat 5: Mattulh ($100 in chips) 
Seat 6: ruslik_by ($139.98 in chips) 
Seat 7: matiko09 ($100 in chips) 
Seat 8: hammerwife ($132.80 in chips) 
Seat 9: SkUhNi ($100 in chips) 
ruslik_by: posts small blind $0.50
matiko09: posts big blind $1
*** HOLE CARDS ***
Dealt to matiko09 [3s 3h]
hammerwife: folds 
SkUhNi: folds 
23SmOkEr07: folds 
blackw0lf_03: folds 
mavin80: raises $1.50 to $2.50
mi$$I$Elena: folds 
Mattulh: raises $5.50 to $8
ruslik_by: folds 
matiko09: folds 
mavin80: calls $5.50
*** FLOP *** [2s 2h Qc]
mavin80: checks 
Mattulh: bets $6
mavin80: calls $6
*** TURN *** [2s 2h Qc] [Ks]
mavin80: checks 
Mattulh: bets $13
mavin80: folds 
Uncalled bet ($13) returned to Mattulh
Mattulh collected $28.02 from pot
Mattulh: doesn't show hand 
*** SUMMARY ***
Total pot $29.50 | Rake $1.48 
Board [2s 2h Qc Ks]
Seat 1: 23SmOkEr07 folded before Flop (didn't bet)
Seat 2: blackw0lf_03 folded before Flop (didn't bet)
Seat 3: mavin80 folded on the Turn
Seat 4: mi$$I$Elena folded before Flop (didn't bet)
Seat 5: Mattulh (button) collected ($28.02)
Seat 6: ruslik_by (small blind) folded before Flop
Seat 7: matiko09 (big blind) folded before Flop
Seat 8: hammerwife folded before Flop (didn't bet)
Seat 9: SkUhNi folded before Flop (didn't bet)





PokerStars Hand #154969712807:  Hold'em No Limit (£0.25/£0.50 GBP) - 2016/06/20 12:08:27 CET [2016/06/20 6:08:27 ET]
Table 'Azalea' 6-max Seat #2 is the button
Seat 1: Rubleff85 (£45.24 in chips) 
Seat 2: matiko09 (£50 in chips) 
Seat 3: VahTang_89 (£52.97 in chips) 
Seat 5: mudders693 (£52.58 in chips) 
Seat 6: Bënedic10 (£51.50 in chips) 
VahTang_89: posts small blind £0.25
mudders693: posts big blind £0.50
*** HOLE CARDS ***
Dealt to matiko09 [Ac Qd]
Bënedic10: folds 
Rubleff85: calls £0.50
matiko09: raises £1.50 to £2
VahTang_89: folds 
mudders693: raises £4.50 to £6.50
Rubleff85: folds 
matiko09: calls £4.50
*** FLOP *** [5c Kd 6c]
mudders693: bets £8
matiko09: folds 
Uncalled bet (£8) returned to mudders693
mudders693 collected £13.06 from pot
mudders693: doesn't show hand 
*** SUMMARY ***
Total pot £13.75 | Rake £0.69 
Board [5c Kd 6c]
Seat 1: Rubleff85 folded before Flop
Seat 2: matiko09 (button) folded on the Flop
Seat 3: VahTang_89 (small blind) folded before Flop
Seat 5: mudders693 (big blind) collected (£13.06)
Seat 6: Bënedic10 folded before Flop (didn't bet)





PokerStars Hand #154969719632:  Hold'em No Limit (£0.25/£0.50 GBP) - 2016/06/20 12:08:46 CET [2016/06/20 6:08:46 ET]
Table 'Ani' 6-max Seat #6 is the button
Seat 1: rewq99887788 (£46.44 in chips) 
Seat 2: joker180785 (£54.02 in chips) 
Seat 3: Doobes8555 (£78.46 in chips) 
Seat 4: matiko09 (£50 in chips) 
Seat 5: Wwwasian (£50 in chips) 
Seat 6: faceMyBallz_ (£64.32 in chips) 
rewq99887788: posts small blind £0.25
joker180785: posts big blind £0.50
*** HOLE CARDS ***
Dealt to matiko09 [Kh Tc]
Doobes8555: folds 
matiko09: folds 
Wwwasian: raises £0.90 to £1.40
faceMyBallz_: raises £2.60 to £4
rewq99887788: folds 
joker180785: folds 
Wwwasian: calls £2.60
*** FLOP *** [8c 7s 2d]
Doobes8555 is disconnected 
Wwwasian: checks 
faceMyBallz_: bets £4.15
Wwwasian: raises £11.85 to £16
faceMyBallz_: folds 
Uncalled bet (£11.85) returned to Wwwasian
Wwwasian collected £16.20 from pot
Wwwasian: doesn't show hand 
*** SUMMARY ***
Total pot £17.05 | Rake £0.85 
Board [8c 7s 2d]
Seat 1: rewq99887788 (small blind) folded before Flop
Seat 2: joker180785 (big blind) folded before Flop
Seat 3: Doobes8555 folded before Flop (didn't bet)
Seat 4: matiko09 folded before Flop (didn't bet)
Seat 5: Wwwasian collected (£16.20)
Seat 6: faceMyBallz_ (button) folded on the Flop





PokerStars Hand #154969721747:  Hold'em No Limit ($0.50/$1.00 USD) - 2016/06/20 12:08:52 CET [2016/06/20 6:08:52 ET]
Table 'Anhui' 9-max Seat #9 is the button
Seat 1: SkUhNi ($141 in chips) 
Seat 2: ruslik_by ($265.85 in chips) 
Seat 3: nowi1980 ($35 in chips) 
Seat 4: mavin80 ($32.46 in chips) 
Seat 5: mi$$I$Elena ($104.14 in chips) 
Seat 6: 23SmOkEr07 ($102.50 in chips) 
Seat 7: matiko09 ($100 in chips) 
Seat 8: nubpoker ($114.24 in chips) 
Seat 9: blackw0lf_03 ($104.80 in chips) 
SkUhNi: posts small blind $0.50
ruslik_by: posts big blind $1
*** HOLE CARDS ***
Dealt to matiko09 [6s 3d]
nowi1980: calls $1
mavin80: raises $2.50 to $3.50
mi$$I$Elena: folds 
23SmOkEr07: calls $3.50
matiko09: folds 
nubpoker: folds 
blackw0lf_03: folds 
SkUhNi: folds 
ruslik_by: folds 
nowi1980: calls $2.50
*** FLOP *** [2h 7h 7s]
nowi1980: checks 
mavin80: bets $5
23SmOkEr07: folds 
nowi1980: folds 
Uncalled bet ($5) returned to mavin80
mavin80 collected $11.40 from pot
*** SUMMARY ***
Total pot $12 | Rake $0.60 
Board [2h 7h 7s]
Seat 1: SkUhNi (small blind) folded before Flop
Seat 2: ruslik_by (big blind) folded before Flop
Seat 3: nowi1980 folded on the Flop
Seat 4: mavin80 collected ($11.40)
Seat 5: mi$$I$Elena folded before Flop (didn't bet)
Seat 6: 23SmOkEr07 folded on the Flop
Seat 7: matiko09 folded before Flop (didn't bet)
Seat 8: nubpoker folded before Flop (didn't bet)
Seat 9: blackw0lf_03 (button) folded before Flop (didn't bet)





PokerStars Hand #154969722755:  Hold'em No Limit ($0.50/$1.00 USD) - 2016/06/20 12:08:55 CET [2016/06/20 6:08:55 ET]
Table 'Pongola' 9-max Seat #8 is the button
Seat 1: matiko09 ($100 in chips) 
Seat 2: ruslik_by ($137.50 in chips) 
Seat 3: SkUhNi ($100 in chips) 
Seat 4: karllv ($98.74 in chips) 
Seat 5: joker180785 ($107.43 in chips) 
Seat 6: 23SmOkEr07 ($100 in chips) 
Seat 7: Prophet1906 ($100 in chips) 
Seat 8: phrantique ($123.70 in chips) 
Seat 9: blackw0lf_03 ($100 in chips) 
blackw0lf_03: posts small blind $0.50
matiko09: posts big blind $1
*** HOLE CARDS ***
Dealt to matiko09 [7c Kh]
ruslik_by: folds 
SkUhNi: folds 
karllv: folds 
joker180785: folds 
23SmOkEr07: folds 
Prophet1906: raises $2 to $3
phrantique: calls $3
blackw0lf_03: folds 
matiko09: folds 
*** FLOP *** [4s 9s 5s]
Prophet1906: bets $4
phrantique: calls $4
*** TURN *** [4s 9s 5s] [Kc]
Prophet1906: checks 
phrantique: checks 
*** RIVER *** [4s 9s 5s Kc] [7s]
Prophet1906: checks 
phrantique: bets $9.31
Prophet1906: folds 
Uncalled bet ($9.31) returned to phrantique
phrantique collected $14.72 from pot
*** SUMMARY ***
Total pot $15.50 | Rake $0.78 
Board [4s 9s 5s Kc 7s]
Seat 1: matiko09 (big blind) folded before Flop
Seat 2: ruslik_by folded before Flop (didn't bet)
Seat 3: SkUhNi folded before Flop (didn't bet)
Seat 4: karllv folded before Flop (didn't bet)
Seat 5: joker180785 folded before Flop (didn't bet)
Seat 6: 23SmOkEr07 folded before Flop (didn't bet)
Seat 7: Prophet1906 folded on the River
Seat 8: phrantique (button) collected ($14.72)
Seat 9: blackw0lf_03 (small blind) folded before Flop





PokerStars Hand #154969727324:  Hold'em No Limit (£0.25/£0.50 GBP) - 2016/06/20 12:09:07 CET [2016/06/20 6:09:07 ET]
Table 'Azalea' 6-max Seat #3 is the button
Seat 1: Rubleff85 (£44.74 in chips) 
Seat 2: matiko09 (£50 in chips) 
Seat 3: VahTang_89 (£52.72 in chips) 
Seat 5: mudders693 (£59.14 in chips) 
Seat 6: Bënedic10 (£51.50 in chips) 
mudders693: posts small blind £0.25
Bënedic10: posts big blind £0.50
*** HOLE CARDS ***
Dealt to matiko09 [5h 2c]
Rubleff85: calls £0.50
matiko09: folds 
VahTang_89: folds 
mudders693: raises £1 to £1.50
Bënedic10: folds 
Rubleff85: calls £1
*** FLOP *** [7h 6s Qs]
mudders693: bets £3.50
Rubleff85: calls £3.50
*** TURN *** [7h 6s Qs] [Kd]
mudders693: checks 
Rubleff85: bets £6
mudders693: calls £6
*** RIVER *** [7h 6s Qs Kd] [Kh]
mudders693: checks 
Rubleff85: bets £13
mudders693: calls £13
*** SHOW DOWN ***
Rubleff85: shows [9d 8h] (a pair of Kings)
mudders693: shows [Ad Qh] (two pair, Kings and Queens)
mudders693 collected £47.10 from pot
*** SUMMARY ***
Total pot £48.50 | Rake £1.40 
Board [7h 6s Qs Kd Kh]
Seat 1: Rubleff85 showed [9d 8h] and lost with a pair of Kings
Seat 2: matiko09 folded before Flop (didn't bet)
Seat 3: VahTang_89 (button) folded before Flop (didn't bet)
Seat 5: mudders693 (small blind) showed [Ad Qh] and won (£47.10) with two pair, Kings and Queens
Seat 6: Bënedic10 (big blind) folded before Flop





PokerStars Hand #154969728980:  Hold'em No Limit ($0.25/$0.50 USD) - 2016/06/20 12:09:12 CET [2016/06/20 6:09:12 ET]
Table 'Memoria II' 9-max Seat #5 is the button
Seat 1: theluckyjoe ($38.03 in chips) 
Seat 2: matiko09 ($50 in chips) 
Seat 3: ljryviltj ($54.98 in chips) 
Seat 4: St.LaCoste ($55 in chips) 
Seat 5: kiev-city12 ($48.25 in chips) 
Seat 6: Kukuryzka ($50 in chips) 
Seat 7: Zeeshka ($50 in chips) 
Kukuryzka: posts small blind $0.25
Zeeshka: posts big blind $0.50
mi$$I$Elena: sits out 
djammusic: sits out 
*** HOLE CARDS ***
Dealt to matiko09 [4h 3h]
theluckyjoe: calls $0.50
matiko09: folds 
ljryviltj: folds 
St.LaCoste: raises $2 to $2.50
kiev-city12: folds 
Kukuryzka: folds 
Zeeshka: folds 
theluckyjoe: calls $2
*** FLOP *** [Kc 6c 8s]
theluckyjoe: checks 
St.LaCoste: checks 
*** TURN *** [Kc 6c 8s] [4c]
theluckyjoe: checks 
St.LaCoste: bets $3.11
theluckyjoe: folds 
Uncalled bet ($3.11) returned to St.LaCoste
St.LaCoste collected $5.46 from pot
St.LaCoste: doesn't show hand 
*** SUMMARY ***
Total pot $5.75 | Rake $0.29 
Board [Kc 6c 8s 4c]
Seat 1: theluckyjoe folded on the Turn
Seat 2: matiko09 folded before Flop (didn't bet)
Seat 3: ljryviltj folded before Flop (didn't bet)
Seat 4: St.LaCoste collected ($5.46)
Seat 5: kiev-city12 (button) folded before Flop (didn't bet)
Seat 6: Kukuryzka (small blind) folded before Flop
Seat 7: Zeeshka (big blind) folded before Flop





PokerStars Hand #154969742312:  Hold'em No Limit ($0.50/$1.00 USD) - 2016/06/20 12:09:49 CET [2016/06/20 6:09:49 ET]
Table 'Ambrosia II' 9-max Seat #6 is the button
Seat 1: 23SmOkEr07 ($114.45 in chips) 
Seat 2: blackw0lf_03 ($188.11 in chips) 
Seat 3: mavin80 ($62.11 in chips) 
Seat 4: mi$$I$Elena ($100 in chips) 
Seat 5: Mattulh ($114.02 in chips) 
Seat 6: ruslik_by ($139.48 in chips) 
Seat 7: matiko09 ($100 in chips) 
Seat 8: hammerwife ($132.80 in chips) 
Seat 9: SkUhNi ($100 in chips) 
matiko09: posts small blind $0.50
hammerwife: posts big blind $1
*** HOLE CARDS ***
Dealt to matiko09 [7s 6d]
SkUhNi: raises $2 to $3
23SmOkEr07: folds 
blackw0lf_03: folds 
mavin80: raises $6 to $9
mi$$I$Elena: folds 
Mattulh: folds 
ruslik_by: folds 
matiko09: folds 
hammerwife: folds 
SkUhNi: calls $6
*** FLOP *** [Js 5d Ac]
SkUhNi: checks 
mavin80: bets $11
SkUhNi: folds 
Uncalled bet ($11) returned to mavin80
mavin80 collected $18.52 from pot
*** SUMMARY ***
Total pot $19.50 | Rake $0.98 
Board [Js 5d Ac]
Seat 1: 23SmOkEr07 folded before Flop (didn't bet)
Seat 2: blackw0lf_03 folded before Flop (didn't bet)
Seat 3: mavin80 collected ($18.52)
Seat 4: mi$$I$Elena folded before Flop (didn't bet)
Seat 5: Mattulh folded before Flop (didn't bet)
Seat 6: ruslik_by (button) folded before Flop (didn't bet)
Seat 7: matiko09 (small blind) folded before Flop
Seat 8: hammerwife (big blind) folded before Flop
Seat 9: SkUhNi folded on the Flop





PokerStars Hand #154969745091:  Hold'em No Limit (£0.25/£0.50 GBP) - 2016/06/20 12:09:56 CET [2016/06/20 6:09:56 ET]
Table 'Azalea' 6-max Seat #5 is the button
Seat 1: Rubleff85 (£20.74 in chips) 
Seat 2: matiko09 (£50 in chips) 
Seat 3: VahTang_89 (£52.72 in chips) 
Seat 5: mudders693 (£82.24 in chips) 
Seat 6: Bënedic10 (£51 in chips) 
Bënedic10: posts small blind £0.25
Rubleff85: posts big blind £0.50
*** HOLE CARDS ***
Dealt to matiko09 [9h 8s]
matiko09: folds 
VahTang_89: folds 
mudders693: raises £1 to £1.50
Bënedic10: folds 
Rubleff85: calls £1
*** FLOP *** [4h Qh 4s]
Rubleff85: bets £1.54
mudders693: calls £1.54
*** TURN *** [4h Qh 4s] [2d]
Rubleff85: bets £5
mudders693: folds 
Uncalled bet (£5) returned to Rubleff85
Rubleff85 collected £6.01 from pot
Rubleff85: doesn't show hand 
*** SUMMARY ***
Total pot £6.33 | Rake £0.32 
Board [4h Qh 4s 2d]
Seat 1: Rubleff85 (big blind) collected (£6.01)
Seat 2: matiko09 folded before Flop (didn't bet)
Seat 3: VahTang_89 folded before Flop (didn't bet)
Seat 5: mudders693 (button) folded on the Turn
Seat 6: Bënedic10 (small blind) folded before Flop





PokerStars Hand #154969752210:  Hold'em No Limit (£0.25/£0.50 GBP) - 2016/06/20 12:10:16 CET [2016/06/20 6:10:16 ET]
Table 'Ani' 6-max Seat #1 is the button
Seat 1: rewq99887788 (£46.19 in chips) 
Seat 2: joker180785 (£53.52 in chips) 
Seat 3: Doobes8555 (£78.46 in chips) 
Seat 4: matiko09 (£50 in chips) 
Seat 5: Wwwasian (£58.05 in chips) 
Seat 6: faceMyBallz_ (£56.17 in chips) 
joker180785: posts small blind £0.25
Doobes8555 is connected 
Doobes8555: posts big blind £0.50
*** HOLE CARDS ***
Dealt to matiko09 [Jd Ad]
matiko09: raises £1 to £1.50
Wwwasian: folds 
faceMyBallz_: folds 
rewq99887788: folds 
joker180785: folds 
Doobes8555: folds 
Uncalled bet (£1) returned to matiko09
matiko09 collected £1.25 from pot
matiko09: doesn't show hand 
*** SUMMARY ***
Total pot £1.25 | Rake £0 
Seat 1: rewq99887788 (button) folded before Flop (didn't bet)
Seat 2: joker180785 (small blind) folded before Flop
Seat 3: Doobes8555 (big blind) folded before Flop
Seat 4: matiko09 collected (£1.25)
Seat 5: Wwwasian folded before Flop (didn't bet)
Seat 6: faceMyBallz_ folded before Flop (didn't bet)





PokerStars Hand #154969754272:  Hold'em No Limit ($0.50/$1.00 USD) - 2016/06/20 12:10:22 CET [2016/06/20 6:10:22 ET]
Table 'Anhui' 9-max Seat #1 is the button
Seat 1: SkUhNi ($140.50 in chips) 
Seat 2: ruslik_by ($264.85 in chips) 
Seat 3: nowi1980 ($31.50 in chips) 
Seat 4: mavin80 ($40.36 in chips) 
Seat 5: mi$$I$Elena ($104.14 in chips) 
Seat 6: 23SmOkEr07 ($100 in chips) 
Seat 7: matiko09 ($100 in chips) 
Seat 8: nubpoker ($114.24 in chips) 
Seat 9: blackw0lf_03 ($104.80 in chips) 
ruslik_by: posts small blind $0.50
nowi1980: posts big blind $1
*** HOLE CARDS ***
Dealt to matiko09 [5h Js]
mavin80: folds 
mi$$I$Elena: folds 
23SmOkEr07: raises $1.50 to $2.50
matiko09: folds 
nubpoker: folds 
blackw0lf_03: folds 
SkUhNi: calls $2.50
ruslik_by: folds 
nowi1980: calls $1.50
*** FLOP *** [2h 4s 5c]
nowi1980: checks 
23SmOkEr07: bets $4.25
SkUhNi: calls $4.25
nowi1980: calls $4.25
*** TURN *** [2h 4s 5c] [8s]
nowi1980: checks 
23SmOkEr07: bets $11.03
SkUhNi: folds 
nowi1980: raises $13.72 to $24.75 and is all-in
23SmOkEr07: calls $13.72
*** RIVER *** [2h 4s 5c 8s] [Kh]
*** SHOW DOWN ***
nowi1980: shows [5s Ts] (a pair of Fives)
23SmOkEr07: shows [7h 6h] (a straight, Four to Eight)
23SmOkEr07 collected $67.75 from pot
*** SUMMARY ***
Total pot $70.25 | Rake $2.50 
Board [2h 4s 5c 8s Kh]
Seat 1: SkUhNi (button) folded on the Turn
Seat 2: ruslik_by (small blind) folded before Flop
Seat 3: nowi1980 (big blind) showed [5s Ts] and lost with a pair of Fives
Seat 4: mavin80 folded before Flop (didn't bet)
Seat 5: mi$$I$Elena folded before Flop (didn't bet)
Seat 6: 23SmOkEr07 showed [7h 6h] and won ($67.75) with a straight, Four to Eight
Seat 7: matiko09 folded before Flop (didn't bet)
Seat 8: nubpoker folded before Flop (didn't bet)
Seat 9: blackw0lf_03 folded before Flop (didn't bet)





PokerStars Hand #154969755709:  Hold'em No Limit ($0.50/$1.00 USD) - 2016/06/20 12:10:25 CET [2016/06/20 6:10:25 ET]
Table 'Pongola' 9-max Seat #9 is the button
Seat 1: matiko09 ($100 in chips) 
Seat 2: ruslik_by ($137.50 in chips) 
Seat 3: SkUhNi ($100 in chips) 
Seat 4: karllv ($98.74 in chips) 
Seat 5: joker180785 ($107.43 in chips) 
Seat 6: 23SmOkEr07 ($100 in chips) 
Seat 7: Prophet1906 ($100 in chips) 
Seat 8: phrantique ($131.42 in chips) 
Seat 9: blackw0lf_03 ($100 in chips) 
matiko09: posts small blind $0.50
ruslik_by: posts big blind $1
*** HOLE CARDS ***
Dealt to matiko09 [6s 9d]
SkUhNi: folds 
karllv: calls $1
joker180785: folds 
23SmOkEr07: folds 
Prophet1906: folds 
phrantique: folds 
blackw0lf_03: folds 
matiko09: folds 
ruslik_by: checks 
*** FLOP *** [2d 7c Jh]
ruslik_by: checks 
karllv: checks 
*** TURN *** [2d 7c Jh] [2s]
ruslik_by: checks 
karllv: checks 
*** RIVER *** [2d 7c Jh 2s] [Jd]
ruslik_by: checks 
karllv: checks 
*** SHOW DOWN ***
ruslik_by: shows [8c Kd] (two pair, Jacks and Deuces)
karllv: shows [Ah 9h] (two pair, Jacks and Deuces - Ace kicker)
karllv collected $2.38 from pot
*** SUMMARY ***
Total pot $2.50 | Rake $0.12 
Board [2d 7c Jh 2s Jd]
Seat 1: matiko09 (small blind) folded before Flop
Seat 2: ruslik_by (big blind) showed [8c Kd] and lost with two pair, Jacks and Deuces
Seat 3: SkUhNi folded before Flop (didn't bet)
Seat 4: karllv showed [Ah 9h] and won ($2.38) with two pair, Jacks and Deuces
Seat 5: joker180785 folded before Flop (didn't bet)
Seat 6: 23SmOkEr07 folded before Flop (didn't bet)
Seat 7: Prophet1906 folded before Flop (didn't bet)
Seat 8: phrantique folded before Flop (didn't bet)
Seat 9: blackw0lf_03 (button) folded before Flop (didn't bet)





PokerStars Hand #154969757429:  Hold'em No Limit (£0.25/£0.50 GBP) - 2016/06/20 12:10:30 CET [2016/06/20 6:10:30 ET]
Table 'Azalea' 6-max Seat #6 is the button
Seat 1: Rubleff85 (£23.71 in chips) 
Seat 2: matiko09 (£50 in chips) 
Seat 3: VahTang_89 (£52.72 in chips) 
Seat 5: mudders693 (£79.20 in chips) 
Seat 6: Bënedic10 (£50.75 in chips) 
Rubleff85: posts small blind £0.25
matiko09: posts big blind £0.50
*** HOLE CARDS ***
Dealt to matiko09 [Ac 3d]
VahTang_89: folds 
mudders693: folds 
Bënedic10: raises £0.75 to £1.25
Rubleff85: calls £1
matiko09: calls £0.75
*** FLOP *** [4s 5h 2c]
Rubleff85: checks 
matiko09: bets £2
Bënedic10: folds 
Rubleff85: calls £2
*** TURN *** [4s 5h 2c] [Js]
Rubleff85: checks 
matiko09: bets £3.50
Rubleff85: raises £3.64 to £7.14
matiko09: calls £3.64
*** RIVER *** [4s 5h 2c Js] [6h]
Rubleff85: bets £13
matiko09: calls £13
*** SHOW DOWN ***
Rubleff85: shows [3c Jc] (a straight, Deuce to Six)
matiko09: shows [Ac 3d] (a straight, Deuce to Six)
Rubleff85 collected £23.32 from pot
matiko09 collected £23.31 from pot
*** SUMMARY ***
Total pot £48.03 | Rake £1.40 
Board [4s 5h 2c Js 6h]
Seat 1: Rubleff85 (small blind) showed [3c Jc] and won (£23.32) with a straight, Deuce to Six
Seat 2: matiko09 (big blind) showed [Ac 3d] and won (£23.31) with a straight, Deuce to Six
Seat 3: VahTang_89 folded before Flop (didn't bet)
Seat 5: mudders693 folded before Flop (didn't bet)
Seat 6: Bënedic10 (button) folded on the Flop





PokerStars Hand #154969757729:  Hold'em No Limit (£0.25/£0.50 GBP) - 2016/06/20 12:10:31 CET [2016/06/20 6:10:31 ET]
Table 'Ani' 6-max Seat #2 is the button
Seat 1: rewq99887788 (£46.19 in chips) 
Seat 2: joker180785 (£53.27 in chips) 
Seat 3: Doobes8555 (£77.96 in chips) 
Seat 4: matiko09 (£50.75 in chips) 
Seat 5: Wwwasian (£58.05 in chips) 
Seat 6: faceMyBallz_ (£56.17 in chips) 
Doobes8555: posts small blind £0.25
matiko09: posts big blind £0.50
*** HOLE CARDS ***
Dealt to matiko09 [4c Qc]
Wwwasian: folds 
faceMyBallz_: folds 
rewq99887788: folds 
joker180785: folds 
Doobes8555: folds 
Uncalled bet (£0.25) returned to matiko09
matiko09 collected £0.50 from pot
matiko09: doesn't show hand 
*** SUMMARY ***
Total pot £0.50 | Rake £0 
Seat 1: rewq99887788 folded before Flop (didn't bet)
Seat 2: joker180785 (button) folded before Flop (didn't bet)
Seat 3: Doobes8555 (small blind) folded before Flop
Seat 4: matiko09 (big blind) collected (£0.50)
Seat 5: Wwwasian folded before Flop (didn't bet)
Seat 6: faceMyBallz_ folded before Flop (didn't bet)





PokerStars Hand #154969766498:  Hold'em No Limit ($0.50/$1.00 USD) - 2016/06/20 12:10:55 CET [2016/06/20 6:10:55 ET]
Table 'Ambrosia II' 9-max Seat #7 is the button
Seat 1: 23SmOkEr07 ($114.45 in chips) 
Seat 2: blackw0lf_03 ($188.11 in chips) 
Seat 3: mavin80 ($71.63 in chips) 
Seat 4: mi$$I$Elena ($100 in chips) 
Seat 5: Mattulh ($114.02 in chips) 
Seat 6: ruslik_by ($139.48 in chips) 
Seat 7: matiko09 ($100 in chips) 
Seat 8: hammerwife ($131.80 in chips) 
Seat 9: SkUhNi ($100 in chips) 
hammerwife: posts small blind $0.50
SkUhNi: posts big blind $1
*** HOLE CARDS ***
Dealt to matiko09 [2c 3c]
23SmOkEr07: folds 
blackw0lf_03: folds 
mavin80: folds 
mi$$I$Elena: raises $1.38 to $2.38
Mattulh: folds 
ruslik_by: folds 
matiko09: folds 
hammerwife: raises $6.62 to $9
SkUhNi: folds 
mi$$I$Elena: calls $6.62
*** FLOP *** [5h Qh Th]
hammerwife: checks 
mi$$I$Elena: bets $10
hammerwife: calls $10
*** TURN *** [5h Qh Th] [Jc]
hammerwife: checks 
mi$$I$Elena: checks 
*** RIVER *** [5h Qh Th Jc] [6c]
hammerwife: bets $18.50
mi$$I$Elena: calls $18.50
*** SHOW DOWN ***
hammerwife: shows [Kh Kd] (a pair of Kings)
mi$$I$Elena: shows [Js Ts] (two pair, Jacks and Tens)
mi$$I$Elena collected $73.50 from pot
*** SUMMARY ***
Total pot $76 | Rake $2.50 
Board [5h Qh Th Jc 6c]
Seat 1: 23SmOkEr07 folded before Flop (didn't bet)
Seat 2: blackw0lf_03 folded before Flop (didn't bet)
Seat 3: mavin80 folded before Flop (didn't bet)
Seat 4: mi$$I$Elena showed [Js Ts] and won ($73.50) with two pair, Jacks and Tens
Seat 5: Mattulh folded before Flop (didn't bet)
Seat 6: ruslik_by folded before Flop (didn't bet)
Seat 7: matiko09 (button) folded before Flop (didn't bet)
Seat 8: hammerwife (small blind) showed [Kh Kd] and lost with a pair of Kings
Seat 9: SkUhNi (big blind) folded before Flop





PokerStars Hand #154969768017:  Hold'em No Limit ($0.25/$0.50 USD) - 2016/06/20 12:10:59 CET [2016/06/20 6:10:59 ET]
Table 'Scheddi II' 9-max Seat #8 is the button
Seat 1: matiko09 ($50 in chips) 
Seat 3: St.LaCoste ($59.61 in chips) 
Seat 4: BlackHawk901 ($50 in chips) 
Seat 6: joker180785 ($59.40 in chips) 
Seat 7: Komodo1311 ($30.29 in chips) 
Seat 8: nubpoker ($50 in chips) 
Seat 9: Infinitinium ($92.63 in chips) 
Infinitinium: posts small blind $0.25
matiko09: posts big blind $0.50
matiko09: posts the ante $0.10
St.LaCoste: posts the ante $0.10
BlackHawk901: posts the ante $0.10
joker180785: posts the ante $0.10
Komodo1311: posts the ante $0.10
nubpoker: posts the ante $0.10
Infinitinium: posts the ante $0.10
*** HOLE CARDS ***
Dealt to matiko09 [Kc Jd]
St.LaCoste: folds 
BlackHawk901: folds 
joker180785: folds 
Komodo1311: raises $1 to $1.50
nubpoker: folds 
Infinitinium: calls $1.25
matiko09: calls $1
*** FLOP *** [2s 4c 3s]
Infinitinium: checks 
matiko09: checks 
Komodo1311: bets $4.94
Infinitinium: calls $4.94
matiko09: folds 
*** TURN *** [2s 4c 3s] [8c]
Infinitinium: checks 
Komodo1311: bets $14.33
Infinitinium: raises $14.33 to $28.66
Komodo1311: calls $9.42 and is all-in
Uncalled bet ($4.91) returned to Infinitinium
*** RIVER *** [2s 4c 3s 8c] [6d]
*** SHOW DOWN ***
Infinitinium: shows [4h 5h] (a straight, Deuce to Six)
Komodo1311: shows [Qs Ks] (high card King)
Infinitinium collected $60.58 from pot
*** SUMMARY ***
Total pot $62.58 | Rake $2 
Board [2s 4c 3s 8c 6d]
Seat 1: matiko09 (big blind) folded on the Flop
Seat 3: St.LaCoste folded before Flop (didn't bet)
Seat 4: BlackHawk901 folded before Flop (didn't bet)
Seat 6: joker180785 folded before Flop (didn't bet)
Seat 7: Komodo1311 showed [Qs Ks] and lost with high card King
Seat 8: nubpoker (button) folded before Flop (didn't bet)
Seat 9: Infinitinium (small blind) showed [4h 5h] and won ($60.58) with a straight, Deuce to Six





PokerStars Hand #154969768396:  Hold'em No Limit ($0.25/$0.50 USD) - 2016/06/20 12:11:00 CET [2016/06/20 6:11:00 ET]
Table 'Memoria II' 9-max Seat #6 is the button
Seat 1: theluckyjoe ($35.53 in chips) 
Seat 2: matiko09 ($50 in chips) 
Seat 3: ljryviltj ($54.98 in chips) 
Seat 4: St.LaCoste ($57.96 in chips) 
Seat 5: kiev-city12 ($48.25 in chips) 
Seat 6: Kukuryzka ($49.75 in chips) 
Seat 7: Zeeshka ($50 in chips) 
Seat 8: mi$$I$Elena ($50 in chips) 
Zeeshka: posts small blind $0.25
mi$$I$Elena: posts big blind $0.50
djammusic: sits out 
*** HOLE CARDS ***
Dealt to matiko09 [Kd 7s]
theluckyjoe: calls $0.50
matiko09: folds 
ljryviltj: folds 
St.LaCoste: folds 
kiev-city12: raises $1.50 to $2
Kukuryzka: folds 
Zeeshka: folds 
mi$$I$Elena: folds 
theluckyjoe: calls $1.50
*** FLOP *** [3h 9h Qc]
theluckyjoe: checks 
kiev-city12: bets $4.50
theluckyjoe: folds 
Uncalled bet ($4.50) returned to kiev-city12
kiev-city12 collected $4.51 from pot
kiev-city12: doesn't show hand 
*** SUMMARY ***
Total pot $4.75 | Rake $0.24 
Board [3h 9h Qc]
Seat 1: theluckyjoe folded on the Flop
Seat 2: matiko09 folded before Flop (didn't bet)
Seat 3: ljryviltj folded before Flop (didn't bet)
Seat 4: St.LaCoste folded before Flop (didn't bet)
Seat 5: kiev-city12 collected ($4.51)
Seat 6: Kukuryzka (button) folded before Flop (didn't bet)
Seat 7: Zeeshka (small blind) folded before Flop
Seat 8: mi$$I$Elena (big blind) folded before Flop





PokerStars Hand #154969774768:  Hold'em No Limit (£0.25/£0.50 GBP) - 2016/06/20 12:11:18 CET [2016/06/20 6:11:18 ET]
Table 'Ani' 6-max Seat #3 is the button
Seat 1: rewq99887788 (£46.19 in chips) 
Seat 2: joker180785 (£53.27 in chips) 
Seat 3: Doobes8555 (£77.71 in chips) 
Seat 4: matiko09 (£51 in chips) 
Seat 5: Wwwasian (£58.05 in chips) 
Seat 6: faceMyBallz_ (£56.17 in chips) 
matiko09: posts small blind £0.25
Wwwasian: posts big blind £0.50
*** HOLE CARDS ***
Dealt to matiko09 [9s 3s]
faceMyBallz_: folds 
rewq99887788: folds 
joker180785: folds 
Doobes8555: folds 
matiko09: folds 
Uncalled bet (£0.25) returned to Wwwasian
Wwwasian collected £0.50 from pot
Wwwasian: doesn't show hand 
*** SUMMARY ***
Total pot £0.50 | Rake £0 
Seat 1: rewq99887788 folded before Flop (didn't bet)
Seat 2: joker180785 folded before Flop (didn't bet)
Seat 3: Doobes8555 (button) folded before Flop (didn't bet)
Seat 4: matiko09 (small blind) folded before Flop
Seat 5: Wwwasian (big blind) collected (£0.50)
Seat 6: faceMyBallz_ folded before Flop (didn't bet)





PokerStars Hand #154969780885:  Hold'em No Limit (£0.25/£0.50 GBP) - 2016/06/20 12:11:35 CET [2016/06/20 6:11:35 ET]
Table 'Ani' 6-max Seat #4 is the button
Seat 1: rewq99887788 (£46.19 in chips) 
Seat 2: joker180785 (£53.27 in chips) 
Seat 3: Doobes8555 (£77.71 in chips) 
Seat 4: matiko09 (£50.75 in chips) 
Seat 5: Wwwasian (£58.30 in chips) 
Seat 6: faceMyBallz_ (£56.17 in chips) 
Wwwasian: posts small blind £0.25
faceMyBallz_: posts big blind £0.50
*** HOLE CARDS ***
Dealt to matiko09 [Kd 6s]
rewq99887788: calls £0.50
joker180785: folds 
Doobes8555: calls £0.50
matiko09: folds 
Wwwasian: calls £0.25
faceMyBallz_: checks 
*** FLOP *** [9c Jd 6h]
Wwwasian: checks 
faceMyBallz_: checks 
rewq99887788: bets £1
Doobes8555: calls £1
Wwwasian: folds 
faceMyBallz_: folds 
*** TURN *** [9c Jd 6h] [5h]
rewq99887788: bets £2.50
Doobes8555: calls £2.50
*** RIVER *** [9c Jd 6h 5h] [2c]
rewq99887788: bets £3.50
Doobes8555: folds 
Uncalled bet (£3.50) returned to rewq99887788
rewq99887788 collected £8.55 from pot
*** SUMMARY ***
Total pot £9 | Rake £0.45 
Board [9c Jd 6h 5h 2c]
Seat 1: rewq99887788 collected (£8.55)
Seat 2: joker180785 folded before Flop (didn't bet)
Seat 3: Doobes8555 folded on the River
Seat 4: matiko09 (button) folded before Flop (didn't bet)
Seat 5: Wwwasian (small blind) folded on the Flop
Seat 6: faceMyBallz_ (big blind) folded on the Flop





PokerStars Hand #154969785039:  Hold'em No Limit ($0.50/$1.00 USD) - 2016/06/20 12:11:46 CET [2016/06/20 6:11:46 ET]
Table 'Pongola' 9-max Seat #1 is the button
Seat 1: matiko09 ($100 in chips) 
Seat 2: ruslik_by ($136.50 in chips) 
Seat 3: SkUhNi ($100 in chips) 
Seat 4: karllv ($100.12 in chips) 
Seat 5: joker180785 ($107.43 in chips) 
Seat 6: 23SmOkEr07 ($100 in chips) 
Seat 7: Prophet1906 ($100 in chips) 
Seat 8: phrantique ($131.42 in chips) 
Seat 9: blackw0lf_03 ($100 in chips) 
ruslik_by: posts small blind $0.50
SkUhNi: posts big blind $1
*** HOLE CARDS ***
Dealt to matiko09 [Jd Tc]
karllv: calls $1
joker180785: folds 
23SmOkEr07: folds 
Prophet1906: folds 
phrantique: folds 
blackw0lf_03: folds 
matiko09: raises $3 to $4
ruslik_by: folds 
SkUhNi: folds 
karllv: calls $3
*** FLOP *** [2h 4h Th]
karllv: checks 
matiko09: bets $5
karllv: calls $5
*** TURN *** [2h 4h Th] [4c]
karllv: checks 
matiko09: bets $9
karllv: raises $9 to $18
matiko09: folds 
Uncalled bet ($9) returned to karllv
karllv collected $35.62 from pot
*** SUMMARY ***
Total pot $37.50 | Rake $1.88 
Board [2h 4h Th 4c]
Seat 1: matiko09 (button) folded on the Turn
Seat 2: ruslik_by (small blind) folded before Flop
Seat 3: SkUhNi (big blind) folded before Flop
Seat 4: karllv collected ($35.62)
Seat 5: joker180785 folded before Flop (didn't bet)
Seat 6: 23SmOkEr07 folded before Flop (didn't bet)
Seat 7: Prophet1906 folded before Flop (didn't bet)
Seat 8: phrantique folded before Flop (didn't bet)
Seat 9: blackw0lf_03 folded before Flop (didn't bet)





PokerStars Hand #154969788474:  Hold'em No Limit (£0.25/£0.50 GBP) - 2016/06/20 12:11:55 CET [2016/06/20 6:11:55 ET]
Table 'Azalea' 6-max Seat #1 is the button
Seat 1: Rubleff85 (£23.64 in chips) 
Seat 2: matiko09 (£50 in chips) 
Seat 3: VahTang_89 (£52.72 in chips) 
Seat 5: mudders693 (£79.20 in chips) 
Seat 6: Bënedic10 (£50 in chips) 
matiko09: posts small blind £0.25
VahTang_89: posts big blind £0.50
*** HOLE CARDS ***
Dealt to matiko09 [8h 2d]
mudders693: folds 
Bënedic10: folds 
Rubleff85 said, " nh"
Rubleff85: folds 
matiko09: folds 
Uncalled bet (£0.25) returned to VahTang_89
VahTang_89 collected £0.50 from pot
VahTang_89: doesn't show hand 
*** SUMMARY ***
Total pot £0.50 | Rake £0 
Seat 1: Rubleff85 (button) folded before Flop (didn't bet)
Seat 2: matiko09 (small blind) folded before Flop
Seat 3: VahTang_89 (big blind) collected (£0.50)
Seat 5: mudders693 folded before Flop (didn't bet)
Seat 6: Bënedic10 folded before Flop (didn't bet)





PokerStars Hand #154969790360:  Hold'em No Limit ($0.50/$1.00 USD) - 2016/06/20 12:12:00 CET [2016/06/20 6:12:00 ET]
Table 'Anhui' 9-max Seat #2 is the button
Seat 1: SkUhNi ($133.75 in chips) 
Seat 2: ruslik_by ($264.35 in chips) 
Seat 4: mavin80 ($40.36 in chips) 
Seat 5: mi$$I$Elena ($104.14 in chips) 
Seat 6: 23SmOkEr07 ($136.25 in chips) 
Seat 7: matiko09 ($100 in chips) 
Seat 8: nubpoker ($114.24 in chips) 
Seat 9: blackw0lf_03 ($104.80 in chips) 
mavin80: posts small blind $0.50
mi$$I$Elena: posts big blind $1
*** HOLE CARDS ***
Dealt to matiko09 [7d 5c]
23SmOkEr07: folds 
matiko09: folds 
nowi1980 leaves the table
Filojoes joins the table at seat #3 
nubpoker: folds 
blackw0lf_03: folds 
SkUhNi: raises $1.50 to $2.50
ruslik_by: folds 
mavin80: folds 
mi$$I$Elena: folds 
Uncalled bet ($1.50) returned to SkUhNi
SkUhNi collected $2.50 from pot
SkUhNi: doesn't show hand 
*** SUMMARY ***
Total pot $2.50 | Rake $0 
Seat 1: SkUhNi collected ($2.50)
Seat 2: ruslik_by (button) folded before Flop (didn't bet)
Seat 4: mavin80 (small blind) folded before Flop
Seat 5: mi$$I$Elena (big blind) folded before Flop
Seat 6: 23SmOkEr07 folded before Flop (didn't bet)
Seat 7: matiko09 folded before Flop (didn't bet)
Seat 8: nubpoker folded before Flop (didn't bet)
Seat 9: blackw0lf_03 folded before Flop (didn't bet)





PokerStars Hand #154969793631:  Hold'em No Limit ($0.25/$0.50 USD) - 2016/06/20 12:12:09 CET [2016/06/20 6:12:09 ET]
Table 'Memoria II' 9-max Seat #7 is the button
Seat 1: theluckyjoe ($33.53 in chips) 
Seat 2: matiko09 ($50 in chips) 
Seat 3: ljryviltj ($54.98 in chips) 
Seat 4: St.LaCoste ($57.96 in chips) 
Seat 5: kiev-city12 ($50.76 in chips) 
Seat 6: Kukuryzka ($49.75 in chips) 
Seat 7: Zeeshka ($50 in chips) 
Seat 8: mi$$I$Elena ($50 in chips) 
Seat 9: djammusic ($20 in chips) 
mi$$I$Elena: posts small blind $0.25
djammusic: posts big blind $0.50
*** HOLE CARDS ***
Dealt to matiko09 [Td 7h]
theluckyjoe: folds 
matiko09: folds 
ljryviltj: folds 
St.LaCoste: raises $1 to $1.50
kiev-city12: calls $1.50
Kukuryzka: folds 
Zeeshka: folds 
mi$$I$Elena: folds 
djammusic: folds 
*** FLOP *** [3s 8h Kc]
St.LaCoste: bets $2.59
kiev-city12: folds 
Uncalled bet ($2.59) returned to St.LaCoste
St.LaCoste collected $3.56 from pot
St.LaCoste: doesn't show hand 
*** SUMMARY ***
Total pot $3.75 | Rake $0.19 
Board [3s 8h Kc]
Seat 1: theluckyjoe folded before Flop (didn't bet)
Seat 2: matiko09 folded before Flop (didn't bet)
Seat 3: ljryviltj folded before Flop (didn't bet)
Seat 4: St.LaCoste collected ($3.56)
Seat 5: kiev-city12 folded on the Flop
Seat 6: Kukuryzka folded before Flop (didn't bet)
Seat 7: Zeeshka (button) folded before Flop (didn't bet)
Seat 8: mi$$I$Elena (small blind) folded before Flop
Seat 9: djammusic (big blind) folded before Flop





PokerStars Hand #154969795487:  Hold'em No Limit (£0.25/£0.50 GBP) - 2016/06/20 12:12:14 CET [2016/06/20 6:12:14 ET]
Table 'Azalea' 6-max Seat #2 is the button
Seat 1: Rubleff85 (£23.64 in chips) 
Seat 2: matiko09 (£50 in chips) 
Seat 3: VahTang_89 (£52.97 in chips) 
Seat 5: mudders693 (£79.20 in chips) 
Seat 6: Bënedic10 (£50 in chips) 
VahTang_89: posts small blind £0.25
mudders693: posts big blind £0.50
*** HOLE CARDS ***
Dealt to matiko09 [Ac 7d]
Bënedic10: raises £1 to £1.50
Rubleff85: folds 
matiko09: folds 
VahTang_89: folds 
mudders693: folds 
Uncalled bet (£1) returned to Bënedic10
Bënedic10 collected £1.25 from pot
Bënedic10: doesn't show hand 
*** SUMMARY ***
Total pot £1.25 | Rake £0 
Seat 1: Rubleff85 folded before Flop (didn't bet)
Seat 2: matiko09 (button) folded before Flop (didn't bet)
Seat 3: VahTang_89 (small blind) folded before Flop
Seat 5: mudders693 (big blind) folded before Flop
Seat 6: Bënedic10 collected (£1.25)





PokerStars Hand #154969798225:  Hold'em No Limit ($0.25/$0.50 USD) - 2016/06/20 12:12:22 CET [2016/06/20 6:12:22 ET]
Table 'Scheddi II' 9-max Seat #9 is the button
Seat 1: matiko09 ($50 in chips) 
Seat 3: St.LaCoste ($59.51 in chips) 
Seat 4: BlackHawk901 ($50 in chips) 
Seat 6: joker180785 ($59.30 in chips) 
Seat 8: nubpoker ($50 in chips) 
Seat 9: Infinitinium ($122.92 in chips) 
matiko09: posts small blind $0.25
St.LaCoste: posts big blind $0.50
matiko09: posts the ante $0.10
St.LaCoste: posts the ante $0.10
BlackHawk901: posts the ante $0.10
joker180785: posts the ante $0.10
nubpoker: posts the ante $0.10
Infinitinium: posts the ante $0.10
*** HOLE CARDS ***
Dealt to matiko09 [Qh 2c]
Komodo1311 leaves the table
BlackHawk901: folds 
joker180785: raises $1 to $1.50
nubpoker: folds 
Infinitinium: folds 
matiko09: folds 
St.LaCoste: folds 
Uncalled bet ($1) returned to joker180785
joker180785 collected $1.85 from pot
*** SUMMARY ***
Total pot $1.85 | Rake $0 
Seat 1: matiko09 (small blind) folded before Flop
Seat 3: St.LaCoste (big blind) folded before Flop
Seat 4: BlackHawk901 folded before Flop (didn't bet)
Seat 6: joker180785 collected ($1.85)
Seat 8: nubpoker folded before Flop (didn't bet)
Seat 9: Infinitinium (button) folded before Flop (didn't bet)





PokerStars Hand #154969801754:  Hold'em No Limit (£0.25/£0.50 GBP) - 2016/06/20 12:12:31 CET [2016/06/20 6:12:31 ET]
Table 'Ani' 6-max Seat #5 is the button
Seat 1: rewq99887788 (£50.74 in chips) 
Seat 2: joker180785 (£53.27 in chips) 
Seat 3: Doobes8555 (£73.71 in chips) 
Seat 4: matiko09 (£50.75 in chips) 
Seat 5: Wwwasian (£57.80 in chips) 
Seat 6: faceMyBallz_ (£55.67 in chips) 
faceMyBallz_: posts small blind £0.25
rewq99887788: posts big blind £0.50
*** HOLE CARDS ***
Dealt to matiko09 [Qd 9d]
joker180785: folds 
Doobes8555: folds 
matiko09: raises £1 to £1.50
Wwwasian: folds 
faceMyBallz_: folds 
rewq99887788: raises £3 to £4.50
matiko09: folds 
Uncalled bet (£3) returned to rewq99887788
rewq99887788 collected £3.25 from pot
*** SUMMARY ***
Total pot £3.25 | Rake £0 
Seat 1: rewq99887788 (big blind) collected (£3.25)
Seat 2: joker180785 folded before Flop (didn't bet)
Seat 3: Doobes8555 folded before Flop (didn't bet)
Seat 4: matiko09 folded before Flop
Seat 5: Wwwasian (button) folded before Flop (didn't bet)
Seat 6: faceMyBallz_ (small blind) folded before Flop





PokerStars Hand #154969801516:  Hold'em No Limit ($0.50/$1.00 USD) - 2016/06/20 12:12:31 CET [2016/06/20 6:12:31 ET]
Table 'Ambrosia II' 9-max Seat #8 is the button
Seat 1: 23SmOkEr07 ($114.45 in chips) 
Seat 2: blackw0lf_03 ($188.11 in chips) 
Seat 3: mavin80 ($71.63 in chips) 
Seat 4: mi$$I$Elena ($136 in chips) 
Seat 5: Mattulh ($114.02 in chips) 
Seat 6: ruslik_by ($139.48 in chips) 
Seat 7: matiko09 ($100 in chips) 
Seat 8: hammerwife ($100 in chips) 
Seat 9: SkUhNi ($100 in chips) 
SkUhNi: posts small blind $0.50
23SmOkEr07: posts big blind $1
*** HOLE CARDS ***
Dealt to matiko09 [9s Td]
blackw0lf_03: folds 
mavin80: folds 
mi$$I$Elena: folds 
Mattulh: folds 
ruslik_by: folds 
matiko09: folds 
hammerwife: raises $1 to $2
SkUhNi: folds 
23SmOkEr07: folds 
Uncalled bet ($1) returned to hammerwife
hammerwife collected $2.50 from pot
hammerwife: doesn't show hand 
*** SUMMARY ***
Total pot $2.50 | Rake $0 
Seat 1: 23SmOkEr07 (big blind) folded before Flop
Seat 2: blackw0lf_03 folded before Flop (didn't bet)
Seat 3: mavin80 folded before Flop (didn't bet)
Seat 4: mi$$I$Elena folded before Flop (didn't bet)
Seat 5: Mattulh folded before Flop (didn't bet)
Seat 6: ruslik_by folded before Flop (didn't bet)
Seat 7: matiko09 folded before Flop (didn't bet)
Seat 8: hammerwife (button) collected ($2.50)
Seat 9: SkUhNi (small blind) folded before Flop





PokerStars Hand #154969804116:  Hold'em No Limit (£0.25/£0.50 GBP) - 2016/06/20 12:12:38 CET [2016/06/20 6:12:38 ET]
Table 'Azalea' 6-max Seat #3 is the button
Seat 1: Rubleff85 (£23.64 in chips) 
Seat 2: matiko09 (£50 in chips) 
Seat 3: VahTang_89 (£52.72 in chips) 
Seat 5: mudders693 (£78.70 in chips) 
Seat 6: Bënedic10 (£50.75 in chips) 
mudders693: posts small blind £0.25
Bënedic10: posts big blind £0.50
*** HOLE CARDS ***
Dealt to matiko09 [3d 9h]
Rubleff85: calls £0.50
matiko09: folds 
VahTang_89: folds 
mudders693: folds 
Bënedic10: raises £1.50 to £2
Rubleff85: folds 
Uncalled bet (£1.50) returned to Bënedic10
Bënedic10 collected £1.25 from pot
Bënedic10: doesn't show hand 
*** SUMMARY ***
Total pot £1.25 | Rake £0 
Seat 1: Rubleff85 folded before Flop
Seat 2: matiko09 folded before Flop (didn't bet)
Seat 3: VahTang_89 (button) folded before Flop (didn't bet)
Seat 5: mudders693 (small blind) folded before Flop
Seat 6: Bënedic10 (big blind) collected (£1.25)





PokerStars Hand #154969804434:  Hold'em No Limit ($0.50/$1.00 USD) - 2016/06/20 12:12:39 CET [2016/06/20 6:12:39 ET]
Table 'Anhui' 9-max Seat #4 is the button
Seat 1: SkUhNi ($135.25 in chips) 
Seat 2: ruslik_by ($264.35 in chips) 
Seat 4: mavin80 ($39.86 in chips) 
Seat 5: mi$$I$Elena ($103.14 in chips) 
Seat 6: 23SmOkEr07 ($136.25 in chips) 
Seat 7: matiko09 ($100 in chips) 
Seat 8: nubpoker ($114.24 in chips) 
Seat 9: blackw0lf_03 ($104.80 in chips) 
mi$$I$Elena: posts small blind $0.50
23SmOkEr07: posts big blind $1
Filojoes: sits out 
*** HOLE CARDS ***
Dealt to matiko09 [3h 8d]
matiko09: folds 
nubpoker: folds 
blackw0lf_03: folds 
SkUhNi: folds 
ruslik_by: folds 
mavin80: folds 
mi$$I$Elena: raises $2 to $3
23SmOkEr07: folds 
Uncalled bet ($2) returned to mi$$I$Elena
mi$$I$Elena collected $2 from pot
mi$$I$Elena: doesn't show hand 
*** SUMMARY ***
Total pot $2 | Rake $0 
Seat 1: SkUhNi folded before Flop (didn't bet)
Seat 2: ruslik_by folded before Flop (didn't bet)
Seat 4: mavin80 (button) folded before Flop (didn't bet)
Seat 5: mi$$I$Elena (small blind) collected ($2)
Seat 6: 23SmOkEr07 (big blind) folded before Flop
Seat 7: matiko09 folded before Flop (didn't bet)
Seat 8: nubpoker folded before Flop (didn't bet)
Seat 9: blackw0lf_03 folded before Flop (didn't bet)





PokerStars Hand #154969809102:  Hold'em No Limit ($0.25/$0.50 USD) - 2016/06/20 12:12:51 CET [2016/06/20 6:12:51 ET]
Table 'Scheddi II' 9-max Seat #1 is the button
Seat 1: matiko09 ($50 in chips) 
Seat 3: St.LaCoste ($58.91 in chips) 
Seat 6: joker180785 ($60.55 in chips) 
Seat 8: nubpoker ($50 in chips) 
Seat 9: Infinitinium ($122.82 in chips) 
St.LaCoste: posts small blind $0.25
BlackHawk901: is sitting out 
joker180785: posts big blind $0.50
matiko09: posts the ante $0.10
St.LaCoste: posts the ante $0.10
joker180785: posts the ante $0.10
nubpoker: posts the ante $0.10
Infinitinium: posts the ante $0.10
*** HOLE CARDS ***
Dealt to matiko09 [Kc 8c]
BlackHawk901 leaves the table
nubpoker: raises $0.75 to $1.25
Infinitinium: calls $1.25
HopeMayBee joins the table at seat #7 
matiko09: folds 
St.LaCoste: folds 
joker180785: folds 
*** FLOP *** [5h 5d 6c]
nubpoker: checks 
Infinitinium: bets $1.78
funXmun was removed from the table for failing to post
nubpoker: folds 
Uncalled bet ($1.78) returned to Infinitinium
Infinitinium collected $3.56 from pot
Infinitinium: doesn't show hand 
*** SUMMARY ***
Total pot $3.75 | Rake $0.19 
Board [5h 5d 6c]
Seat 1: matiko09 (button) folded before Flop (didn't bet)
Seat 3: St.LaCoste (small blind) folded before Flop
Seat 6: joker180785 (big blind) folded before Flop
Seat 8: nubpoker folded on the Flop
Seat 9: Infinitinium collected ($3.56)





PokerStars Hand #154969812360:  Hold'em No Limit ($0.50/$1.00 USD) - 2016/06/20 12:13:00 CET [2016/06/20 6:13:00 ET]
Table 'Ambrosia II' 9-max Seat #9 is the button
Seat 1: 23SmOkEr07 ($113.45 in chips) 
Seat 3: mavin80 ($71.63 in chips) 
Seat 4: mi$$I$Elena ($136 in chips) 
Seat 5: Mattulh ($114.02 in chips) 
Seat 6: ruslik_by ($139.48 in chips) 
Seat 7: matiko09 ($100 in chips) 
Seat 8: hammerwife ($101.50 in chips) 
Seat 9: SkUhNi ($100 in chips) 
23SmOkEr07: posts small blind $0.50
blackw0lf_03: is sitting out 
mavin80: posts big blind $1
*** HOLE CARDS ***
Dealt to matiko09 [Ks 4h]
mi$$I$Elena: raises $1.38 to $2.38
Mattulh: folds 
ruslik_by: folds 
matiko09: folds 
hammerwife: folds 
SkUhNi: calls $2.38
23SmOkEr07: calls $1.88
mavin80: folds 
*** FLOP *** [6d Jd 9d]
23SmOkEr07: checks 
mi$$I$Elena: checks 
SkUhNi: bets $5.41
23SmOkEr07: folds 
mi$$I$Elena: folds 
Uncalled bet ($5.41) returned to SkUhNi
SkUhNi collected $7.73 from pot
SkUhNi: doesn't show hand 
*** SUMMARY ***
Total pot $8.14 | Rake $0.41 
Board [6d Jd 9d]
Seat 1: 23SmOkEr07 (small blind) folded on the Flop
Seat 3: mavin80 (big blind) folded before Flop
Seat 4: mi$$I$Elena folded on the Flop
Seat 5: Mattulh folded before Flop (didn't bet)
Seat 6: ruslik_by folded before Flop (didn't bet)
Seat 7: matiko09 folded before Flop (didn't bet)
Seat 8: hammerwife folded before Flop (didn't bet)
Seat 9: SkUhNi (button) collected ($7.73)





PokerStars Hand #154969813011:  Hold'em No Limit (£0.25/£0.50 GBP) - 2016/06/20 12:13:02 CET [2016/06/20 6:13:02 ET]
Table 'Ani' 6-max Seat #6 is the button
Seat 1: rewq99887788 (£52.49 in chips) 
Seat 2: joker180785 (£53.27 in chips) 
Seat 3: Doobes8555 (£73.71 in chips) 
Seat 4: matiko09 (£50 in chips) 
Seat 5: Wwwasian (£57.80 in chips) 
Seat 6: faceMyBallz_ (£55.42 in chips) 
rewq99887788: posts small blind £0.25
joker180785: posts big blind £0.50
*** HOLE CARDS ***
Dealt to matiko09 [2s 9d]
Doobes8555: raises £1 to £1.50
matiko09: folds 
Wwwasian: folds 
faceMyBallz_: folds 
rewq99887788: calls £1.25
joker180785: calls £1
*** FLOP *** [2d Kd 2c]
rewq99887788: checks 
joker180785: checks 
Doobes8555: checks 
*** TURN *** [2d Kd 2c] [6d]
rewq99887788: bets £2.50
joker180785: folds 
Doobes8555: folds 
Uncalled bet (£2.50) returned to rewq99887788
rewq99887788 collected £4.28 from pot
*** SUMMARY ***
Total pot £4.50 | Rake £0.22 
Board [2d Kd 2c 6d]
Seat 1: rewq99887788 (small blind) collected (£4.28)
Seat 2: joker180785 (big blind) folded on the Turn
Seat 3: Doobes8555 folded on the Turn
Seat 4: matiko09 folded before Flop (didn't bet)
Seat 5: Wwwasian folded before Flop (didn't bet)
Seat 6: faceMyBallz_ (button) folded before Flop (didn't bet)





PokerStars Hand #154969814705:  Hold'em No Limit (£0.25/£0.50 GBP) - 2016/06/20 12:13:07 CET [2016/06/20 6:13:07 ET]
Table 'Azalea' 6-max Seat #5 is the button
Seat 1: Rubleff85 (£23.14 in chips) 
Seat 2: matiko09 (£50 in chips) 
Seat 3: VahTang_89 (£52.72 in chips) 
Seat 5: mudders693 (£78.45 in chips) 
Seat 6: Bënedic10 (£51.50 in chips) 
Bënedic10: posts small blind £0.25
Rubleff85: posts big blind £0.50
*** HOLE CARDS ***
Dealt to matiko09 [9d 7d]
matiko09: raises £1 to £1.50
VahTang_89: folds 
mudders693: folds 
Bënedic10: folds 
Rubleff85: folds 
Uncalled bet (£1) returned to matiko09
matiko09 collected £1.25 from pot
matiko09: doesn't show hand 
*** SUMMARY ***
Total pot £1.25 | Rake £0 
Seat 1: Rubleff85 (big blind) folded before Flop
Seat 2: matiko09 collected (£1.25)
Seat 3: VahTang_89 folded before Flop (didn't bet)
Seat 5: mudders693 (button) folded before Flop (didn't bet)
Seat 6: Bënedic10 (small blind) folded before Flop





PokerStars Hand #154969821931:  Hold'em No Limit ($0.50/$1.00 USD) - 2016/06/20 12:13:26 CET [2016/06/20 6:13:26 ET]
Table 'Anhui' 9-max Seat #5 is the button
Seat 1: SkUhNi ($135.25 in chips) 
Seat 2: ruslik_by ($264.35 in chips) 
Seat 4: mavin80 ($39.86 in chips) 
Seat 5: mi$$I$Elena ($104.14 in chips) 
Seat 6: 23SmOkEr07 ($135.25 in chips) 
Seat 7: matiko09 ($100 in chips) 
Seat 8: nubpoker ($114.24 in chips) 
Seat 9: blackw0lf_03 ($104.80 in chips) 
23SmOkEr07: posts small blind $0.50
matiko09: posts big blind $1
Filojoes: sits out 
*** HOLE CARDS ***
Dealt to matiko09 [5s 2s]
nubpoker: raises $1.50 to $2.50
blackw0lf_03: folds 
SkUhNi: calls $2.50
ruslik_by: folds 
mavin80: calls $2.50
mi$$I$Elena: folds 
23SmOkEr07: folds 
matiko09: folds 
*** FLOP *** [2c 2d 5h]
nubpoker: checks 
SkUhNi: bets $6
mavin80: folds 
nubpoker: folds 
Uncalled bet ($6) returned to SkUhNi
SkUhNi collected $8.55 from pot
SkUhNi: doesn't show hand 
*** SUMMARY ***
Total pot $9 | Rake $0.45 
Board [2c 2d 5h]
Seat 1: SkUhNi collected ($8.55)
Seat 2: ruslik_by folded before Flop (didn't bet)
Seat 4: mavin80 folded on the Flop
Seat 5: mi$$I$Elena (button) folded before Flop (didn't bet)
Seat 6: 23SmOkEr07 (small blind) folded before Flop
Seat 7: matiko09 (big blind) folded before Flop
Seat 8: nubpoker folded on the Flop
Seat 9: blackw0lf_03 folded before Flop (didn't bet)





PokerStars Hand #154969822425:  Hold'em No Limit (£0.25/£0.50 GBP) - 2016/06/20 12:13:28 CET [2016/06/20 6:13:28 ET]
Table 'Azalea' 6-max Seat #6 is the button
Seat 1: Rubleff85 (£22.64 in chips) 
Seat 2: matiko09 (£50.75 in chips) 
Seat 3: VahTang_89 (£52.72 in chips) 
Seat 5: mudders693 (£78.45 in chips) 
Seat 6: Bënedic10 (£51.25 in chips) 
Rubleff85: posts small blind £0.25
matiko09: posts big blind £0.50
*** HOLE CARDS ***
Dealt to matiko09 [7c 9c]
VahTang_89: folds 
mudders693: raises £1 to £1.50
Bënedic10: folds 
Rubleff85: folds 
matiko09: folds 
Uncalled bet (£1) returned to mudders693
mudders693 collected £1.25 from pot
mudders693: doesn't show hand 
*** SUMMARY ***
Total pot £1.25 | Rake £0 
Seat 1: Rubleff85 (small blind) folded before Flop
Seat 2: matiko09 (big blind) folded before Flop
Seat 3: VahTang_89 folded before Flop (didn't bet)
Seat 5: mudders693 collected (£1.25)
Seat 6: Bënedic10 (button) folded before Flop (didn't bet)





PokerStars Hand #154969824055:  Hold'em No Limit ($0.50/$1.00 USD) - 2016/06/20 12:13:32 CET [2016/06/20 6:13:32 ET]
Table 'Pongola' 9-max Seat #2 is the button
Seat 1: matiko09 ($100 in chips) 
Seat 2: ruslik_by ($136 in chips) 
Seat 3: SkUhNi ($100 in chips) 
Seat 4: karllv ($117.74 in chips) 
Seat 5: joker180785 ($107.43 in chips) 
Seat 6: 23SmOkEr07 ($100 in chips) 
Seat 7: Prophet1906 ($100 in chips) 
Seat 8: phrantique ($131.42 in chips) 
Seat 9: blackw0lf_03 ($100 in chips) 
SkUhNi: posts small blind $0.50
karllv: posts big blind $1
*** HOLE CARDS ***
Dealt to matiko09 [6d 5s]
joker180785: folds 
23SmOkEr07: folds 
Prophet1906: folds 
phrantique: raises $2 to $3
blackw0lf_03: raises $6 to $9
matiko09: folds 
ruslik_by: folds 
SkUhNi: folds 
karllv: folds 
phrantique: calls $6
*** FLOP *** [4s 4h Ad]
phrantique: checks 
blackw0lf_03: checks 
*** TURN *** [4s 4h Ad] [9s]
phrantique: checks 
blackw0lf_03: checks 
*** RIVER *** [4s 4h Ad 9s] [8h]
phrantique: bets $5
blackw0lf_03: calls $5
*** SHOW DOWN ***
phrantique: shows [Qc Ah] (two pair, Aces and Fours)
blackw0lf_03: mucks hand 
phrantique collected $28.02 from pot
*** SUMMARY ***
Total pot $29.50 | Rake $1.48 
Board [4s 4h Ad 9s 8h]
Seat 1: matiko09 folded before Flop (didn't bet)
Seat 2: ruslik_by (button) folded before Flop (didn't bet)
Seat 3: SkUhNi (small blind) folded before Flop
Seat 4: karllv (big blind) folded before Flop
Seat 5: joker180785 folded before Flop (didn't bet)
Seat 6: 23SmOkEr07 folded before Flop (didn't bet)
Seat 7: Prophet1906 folded before Flop (didn't bet)
Seat 8: phrantique showed [Qc Ah] and won ($28.02) with two pair, Aces and Fours
Seat 9: blackw0lf_03 mucked [As Ts]





PokerStars Hand #154969825043:  Hold'em No Limit (£0.25/£0.50 GBP) - 2016/06/20 12:13:35 CET [2016/06/20 6:13:35 ET]
Table 'Ani' 6-max Seat #1 is the button
Seat 1: rewq99887788 (£55.27 in chips) 
Seat 2: joker180785 (£51.77 in chips) 
Seat 3: Doobes8555 (£72.21 in chips) 
Seat 4: matiko09 (£50 in chips) 
Seat 5: Wwwasian (£57.80 in chips) 
Seat 6: faceMyBallz_ (£55.42 in chips) 
joker180785: posts small blind £0.25
Doobes8555: posts big blind £0.50
*** HOLE CARDS ***
Dealt to matiko09 [Kc 3h]
matiko09: folds 
Wwwasian: folds 
faceMyBallz_: folds 
rewq99887788: folds 
joker180785: raises £0.75 to £1.25
Doobes8555 is disconnected 
Doobes8555 is connected 
Doobes8555: calls £0.75
*** FLOP *** [Qh 2d Qc]
joker180785: checks 
Doobes8555: checks 
*** TURN *** [Qh 2d Qc] [4c]
joker180785: checks 
Doobes8555: checks 
*** RIVER *** [Qh 2d Qc 4c] [4h]
joker180785: checks 
Doobes8555: bets £2.50
joker180785: folds 
Uncalled bet (£2.50) returned to Doobes8555
Doobes8555 collected £2.38 from pot
Doobes8555: doesn't show hand 
*** SUMMARY ***
Total pot £2.50 | Rake £0.12 
Board [Qh 2d Qc 4c 4h]
Seat 1: rewq99887788 (button) folded before Flop (didn't bet)
Seat 2: joker180785 (small blind) folded on the River
Seat 3: Doobes8555 (big blind) collected (£2.38)
Seat 4: matiko09 folded before Flop (didn't bet)
Seat 5: Wwwasian folded before Flop (didn't bet)
Seat 6: faceMyBallz_ folded before Flop (didn't bet)





PokerStars Hand #154969828789:  Hold'em No Limit (£0.25/£0.50 GBP) - 2016/06/20 12:13:45 CET [2016/06/20 6:13:45 ET]
Table 'Azalea' 6-max Seat #1 is the button
Seat 1: Rubleff85 (£22.39 in chips) 
Seat 2: matiko09 (£50.25 in chips) 
Seat 3: VahTang_89 (£52.72 in chips) 
Seat 5: mudders693 (£79.20 in chips) 
Seat 6: Bënedic10 (£51.25 in chips) 
matiko09: posts small blind £0.25
VahTang_89: posts big blind £0.50
*** HOLE CARDS ***
Dealt to matiko09 [Ad As]
mudders693: raises £1 to £1.50
Bënedic10: folds 
Rubleff85: calls £1.50
matiko09: raises £4 to £5.50
VahTang_89: folds 
mudders693: calls £4
Rubleff85: calls £4
*** FLOP *** [9d Qs Qh]
matiko09: bets £4.50
mudders693: raises £4.50 to £9
Rubleff85: folds 
matiko09: calls £4.50
*** TURN *** [9d Qs Qh] [4c]
matiko09: checks 
mudders693: bets £13
matiko09: calls £13
*** RIVER *** [9d Qs Qh 4c] [2d]
matiko09: checks 
mudders693: checks 
*** SHOW DOWN ***
matiko09: shows [Ad As] (two pair, Aces and Queens)
mudders693: mucks hand 
matiko09 collected £59.60 from pot
*** SUMMARY ***
Total pot £61 | Rake £1.40 
Board [9d Qs Qh 4c 2d]
Seat 1: Rubleff85 (button) folded on the Flop
Seat 2: matiko09 (small blind) showed [Ad As] and won (£59.60) with two pair, Aces and Queens
Seat 3: VahTang_89 (big blind) folded before Flop
Seat 5: mudders693 mucked [7s 9s]
Seat 6: Bënedic10 folded before Flop (didn't bet)





PokerStars Hand #154969830797:  Hold'em No Limit ($0.25/$0.50 USD) - 2016/06/20 12:13:51 CET [2016/06/20 6:13:51 ET]
Table 'Memoria II' 9-max Seat #8 is the button
Seat 2: matiko09 ($50 in chips) 
Seat 3: ljryviltj ($54.98 in chips) 
Seat 4: St.LaCoste ($60.02 in chips) 
Seat 5: kiev-city12 ($49.26 in chips) 
Seat 6: Kukuryzka ($49.75 in chips) 
Seat 7: Zeeshka ($50 in chips) 
Seat 8: mi$$I$Elena ($50 in chips) 
Seat 9: djammusic ($19.50 in chips) 
djammusic: posts small blind $0.25
matiko09: posts big blind $0.50
*** HOLE CARDS ***
Dealt to matiko09 [As 5c]
ljryviltj: folds 
St.LaCoste: folds 
kiev-city12: raises $1 to $1.50
Kukuryzka: folds 
Zeeshka: raises $3.50 to $5
mi$$I$Elena: folds 
djammusic: raises $14.25 to $19.25
matiko09: folds 
kiev-city12: folds 
Zeeshka: raises $14.25 to $33.50
djammusic: calls $0.25 and is all-in
Uncalled bet ($14) returned to Zeeshka
*** FIRST FLOP *** [2d Ah 8d]
*** FIRST TURN *** [2d Ah 8d] [3s]
*** FIRST RIVER *** [2d Ah 8d 3s] [8s]
*** SECOND FLOP *** [7s 6d Tc]
*** SECOND TURN *** [7s 6d Tc] [5h]
*** SECOND RIVER *** [7s 6d Tc 5h] [7d]
*** FIRST SHOW DOWN ***
djammusic: shows [Qc Qs] (two pair, Queens and Eights)
Zeeshka: shows [Ks Kh] (two pair, Kings and Eights)
Zeeshka collected $19.50 from pot
*** SECOND SHOW DOWN ***
djammusic: shows [Qc Qs] (two pair, Queens and Sevens)
Zeeshka: shows [Ks Kh] (two pair, Kings and Sevens)
Zeeshka collected $19.50 from pot
*** SUMMARY ***
Total pot $41 | Rake $2 
Hand was run twice
FIRST Board [2d Ah 8d 3s 8s]
SECOND Board [7s 6d Tc 5h 7d]
Seat 2: matiko09 (big blind) folded before Flop
Seat 3: ljryviltj folded before Flop (didn't bet)
Seat 4: St.LaCoste folded before Flop (didn't bet)
Seat 5: kiev-city12 folded before Flop
Seat 6: Kukuryzka folded before Flop (didn't bet)
Seat 7: Zeeshka showed [Ks Kh] and won ($19.50) with two pair, Kings and Eights, and won ($19.50) with two pair, Kings and Sevens
Seat 8: mi$$I$Elena (button) folded before Flop (didn't bet)
Seat 9: djammusic (small blind) showed [Qc Qs] and lost with two pair, Queens and Eights, and lost with two pair, Queens and Sevens





PokerStars Hand #154969833429:  Hold'em No Limit ($0.25/$0.50 USD) - 2016/06/20 12:13:58 CET [2016/06/20 6:13:58 ET]
Table 'Scheddi II' 9-max Seat #3 is the button
Seat 1: matiko09 ($50 in chips) 
Seat 3: St.LaCoste ($58.56 in chips) 
Seat 6: joker180785 ($59.95 in chips) 
Seat 7: HopeMayBee ($50 in chips) 
Seat 8: nubpoker ($50 in chips) 
Seat 9: Infinitinium ($125.03 in chips) 
joker180785: posts small blind $0.25
HopeMayBee: posts big blind $0.50
Yaaaazz: sits out 
matiko09: posts the ante $0.10
St.LaCoste: posts the ante $0.10
joker180785: posts the ante $0.10
HopeMayBee: posts the ante $0.10
nubpoker: posts the ante $0.10
Infinitinium: posts the ante $0.10
*** HOLE CARDS ***
Dealt to matiko09 [Qc 9c]
nubpoker: folds 
Infinitinium: calls $0.50
matiko09: raises $1.50 to $2
St.LaCoste: folds 
joker180785: folds 
HopeMayBee: calls $1.50
Infinitinium: calls $1.50
*** FLOP *** [Ts 8h 8s]
HopeMayBee: checks 
Infinitinium: checks 
matiko09: checks 
*** TURN *** [Ts 8h 8s] [Ks]
HopeMayBee: checks 
Infinitinium: bets $6.51
matiko09: folds 
HopeMayBee: calls $6.51
*** RIVER *** [Ts 8h 8s Ks] [6s]
No Money NW joins the table at seat #5 
HopeMayBee: bets $12
Infinitinium: folds 
Uncalled bet ($12) returned to HopeMayBee
HopeMayBee collected $18.88 from pot
HopeMayBee: doesn't show hand 
*** SUMMARY ***
Total pot $19.87 | Rake $0.99 
Board [Ts 8h 8s Ks 6s]
Seat 1: matiko09 folded on the Turn
Seat 3: St.LaCoste (button) folded before Flop (didn't bet)
Seat 6: joker180785 (small blind) folded before Flop
Seat 7: HopeMayBee (big blind) collected ($18.88)
Seat 8: nubpoker folded before Flop (didn't bet)
Seat 9: Infinitinium folded on the River





PokerStars Hand #154969840083:  Hold'em No Limit ($0.50/$1.00 USD) - 2016/06/20 12:14:16 CET [2016/06/20 6:14:16 ET]
Table 'Ambrosia II' 9-max Seat #1 is the button
Seat 1: 23SmOkEr07 ($111.07 in chips) 
Seat 3: mavin80 ($70.63 in chips) 
Seat 4: mi$$I$Elena ($133.62 in chips) 
Seat 5: Mattulh ($114.02 in chips) 
Seat 6: ruslik_by ($139.48 in chips) 
Seat 7: matiko09 ($100 in chips) 
Seat 8: hammerwife ($101.50 in chips) 
Seat 9: SkUhNi ($105.35 in chips) 
mavin80: posts small blind $0.50
mi$$I$Elena: posts big blind $1
*** HOLE CARDS ***
Dealt to matiko09 [5c 3c]
Mattulh: folds 
ruslik_by: folds 
matiko09: folds 
hammerwife: folds 
SkUhNi: folds 
23SmOkEr07: raises $1.50 to $2.50
blackw0lf_03 leaves the table
mavin80: raises $1.50 to $4
mi$$I$Elena: folds 
23SmOkEr07: calls $1.50
*** FLOP *** [Kc 5s 6h]
mavin80: checks 
23SmOkEr07: checks 
*** TURN *** [Kc 5s 6h] [Kd]
mavin80: bets $4
23SmOkEr07: folds 
Uncalled bet ($4) returned to mavin80
mavin80 collected $8.55 from pot
*** SUMMARY ***
Total pot $9 | Rake $0.45 
Board [Kc 5s 6h Kd]
Seat 1: 23SmOkEr07 (button) folded on the Turn
Seat 3: mavin80 (small blind) collected ($8.55)
Seat 4: mi$$I$Elena (big blind) folded before Flop
Seat 5: Mattulh folded before Flop (didn't bet)
Seat 6: ruslik_by folded before Flop (didn't bet)
Seat 7: matiko09 folded before Flop (didn't bet)
Seat 8: hammerwife folded before Flop (didn't bet)
Seat 9: SkUhNi folded before Flop (didn't bet)





PokerStars Hand #154969848493:  Hold'em No Limit ($0.25/$0.50 USD) - 2016/06/20 12:14:39 CET [2016/06/20 6:14:39 ET]
Table 'Memoria II' 9-max Seat #9 is the button
Seat 2: matiko09 ($50 in chips) 
Seat 3: ljryviltj ($54.98 in chips) 
Seat 4: St.LaCoste ($60.02 in chips) 
Seat 5: kiev-city12 ($47.76 in chips) 
Seat 6: Kukuryzka ($49.75 in chips) 
Seat 7: Zeeshka ($69.50 in chips) 
Seat 8: mi$$I$Elena ($50 in chips) 
Seat 9: djammusic ($20 in chips) 
matiko09: posts small blind $0.25
ljryviltj: posts big blind $0.50
*** HOLE CARDS ***
Dealt to matiko09 [9h Jc]
St.LaCoste: folds 
kiev-city12: raises $1 to $1.50
Kukuryzka: folds 
Zeeshka: folds 
mi$$I$Elena: folds 
djammusic: raises $2 to $3.50
matiko09: folds 
ljryviltj: folds 
kiev-city12: calls $2
*** FLOP *** [5h 7s 4c]
kiev-city12: checks 
djammusic: bets $4
kiev-city12: folds 
Uncalled bet ($4) returned to djammusic
djammusic collected $7.36 from pot
djammusic: doesn't show hand 
*** SUMMARY ***
Total pot $7.75 | Rake $0.39 
Board [5h 7s 4c]
Seat 2: matiko09 (small blind) folded before Flop
Seat 3: ljryviltj (big blind) folded before Flop
Seat 4: St.LaCoste folded before Flop (didn't bet)
Seat 5: kiev-city12 folded on the Flop
Seat 6: Kukuryzka folded before Flop (didn't bet)
Seat 7: Zeeshka folded before Flop (didn't bet)
Seat 8: mi$$I$Elena folded before Flop (didn't bet)
Seat 9: djammusic (button) collected ($7.36)





PokerStars Hand #154969850312:  Hold'em No Limit ($0.50/$1.00 USD) - 2016/06/20 12:14:44 CET [2016/06/20 6:14:44 ET]
Table 'Pongola' 9-max Seat #3 is the button
Seat 1: matiko09 ($100 in chips) 
Seat 2: ruslik_by ($136 in chips) 
Seat 3: SkUhNi ($100 in chips) 
Seat 4: karllv ($116.74 in chips) 
Seat 5: joker180785 ($107.43 in chips) 
Seat 6: 23SmOkEr07 ($100 in chips) 
Seat 7: Prophet1906 ($100 in chips) 
Seat 8: phrantique ($145.44 in chips) 
Seat 9: blackw0lf_03 ($100 in chips) 
karllv: posts small blind $0.50
joker180785: posts big blind $1
*** HOLE CARDS ***
Dealt to matiko09 [7d Qc]
23SmOkEr07: folds 
Prophet1906: folds 
phrantique: folds 
blackw0lf_03: folds 
matiko09: folds 
ruslik_by: folds 
SkUhNi: raises $1 to $2
karllv: calls $1.50
joker180785: folds 
*** FLOP *** [Td Ad 5s]
karllv: checks 
SkUhNi: bets $2
karllv: calls $2
*** TURN *** [Td Ad 5s] [4h]
karllv: checks 
SkUhNi: checks 
*** RIVER *** [Td Ad 5s 4h] [4d]
karllv: checks 
SkUhNi: checks 
*** SHOW DOWN ***
karllv: shows [Ts Jd] (two pair, Tens and Fours)
SkUhNi: mucks hand 
karllv collected $8.55 from pot
*** SUMMARY ***
Total pot $9 | Rake $0.45 
Board [Td Ad 5s 4h 4d]
Seat 1: matiko09 folded before Flop (didn't bet)
Seat 2: ruslik_by folded before Flop (didn't bet)
Seat 3: SkUhNi (button) mucked [3s Ks]
Seat 4: karllv (small blind) showed [Ts Jd] and won ($8.55) with two pair, Tens and Fours
Seat 5: joker180785 (big blind) folded before Flop
Seat 6: 23SmOkEr07 folded before Flop (didn't bet)
Seat 7: Prophet1906 folded before Flop (didn't bet)
Seat 8: phrantique folded before Flop (didn't bet)
Seat 9: blackw0lf_03 folded before Flop (didn't bet)





PokerStars Hand #154969852147:  Hold'em No Limit ($0.50/$1.00 USD) - 2016/06/20 12:14:49 CET [2016/06/20 6:14:49 ET]
Table 'Anhui' 9-max Seat #6 is the button
Seat 1: SkUhNi ($141.30 in chips) 
Seat 2: ruslik_by ($264.35 in chips) 
Seat 4: mavin80 ($37.36 in chips) 
Seat 5: mi$$I$Elena ($104.14 in chips) 
Seat 6: 23SmOkEr07 ($134.75 in chips) 
Seat 7: matiko09 ($100 in chips) 
matiko09: posts small blind $0.50
nubpoker: is sitting out 
nubpoker leaves the table
blackw0lf_03: is sitting out 
SkUhNi: posts big blind $1
Filojoes: sits out 
*** HOLE CARDS ***
Dealt to matiko09 [Ah 4c]
ruslik_by: folds 
blackw0lf_03 leaves the table
mavin80: folds 
mi$$I$Elena: raises $1.38 to $2.38
23SmOkEr07: folds 
matiko09: folds 
SkUhNi: calls $1.38
*** FLOP *** [Ts 2s 9s]
SkUhNi: checks 
mi$$I$Elena: bets $3
SkUhNi: calls $3
*** TURN *** [Ts 2s 9s] [2h]
SkUhNi: checks 
mi$$I$Elena: bets $7
SkUhNi: raises $14 to $21
mi$$I$Elena: folds 
Uncalled bet ($14) returned to SkUhNi
SkUhNi collected $24 from pot
SkUhNi: doesn't show hand 
*** SUMMARY ***
Total pot $25.26 | Rake $1.26 
Board [Ts 2s 9s 2h]
Seat 1: SkUhNi (big blind) collected ($24)
Seat 2: ruslik_by folded before Flop (didn't bet)
Seat 4: mavin80 folded before Flop (didn't bet)
Seat 5: mi$$I$Elena folded on the Turn
Seat 6: 23SmOkEr07 (button) folded before Flop (didn't bet)
Seat 7: matiko09 (small blind) folded before Flop





PokerStars Hand #154969863630:  Hold'em No Limit (£0.25/£0.50 GBP) - 2016/06/20 12:15:20 CET [2016/06/20 6:15:20 ET]
Table 'Ani' 6-max Seat #2 is the button
Seat 1: rewq99887788 (£55.27 in chips) 
Seat 2: joker180785 (£50.52 in chips) 
Seat 3: Doobes8555 (£73.34 in chips) 
Seat 4: matiko09 (£50 in chips) 
Seat 5: Wwwasian (£57.80 in chips) 
Seat 6: faceMyBallz_ (£55.42 in chips) 
Doobes8555: posts small blind £0.25
matiko09: posts big blind £0.50
*** HOLE CARDS ***
Dealt to matiko09 [2d Kc]
Wwwasian: folds 
faceMyBallz_: folds 
rewq99887788: folds 
joker180785: folds 
Doobes8555: calls £0.25
matiko09: checks 
*** FLOP *** [Kd Kh 4s]
Doobes8555: checks 
matiko09: checks 
*** TURN *** [Kd Kh 4s] [Ah]
Doobes8555: checks 
matiko09: bets £0.62
Doobes8555: folds 
Uncalled bet (£0.62) returned to matiko09
matiko09 collected £0.95 from pot
matiko09: doesn't show hand 
*** SUMMARY ***
Total pot £1 | Rake £0.05 
Board [Kd Kh 4s Ah]
Seat 1: rewq99887788 folded before Flop (didn't bet)
Seat 2: joker180785 (button) folded before Flop (didn't bet)
Seat 3: Doobes8555 (small blind) folded on the Turn
Seat 4: matiko09 (big blind) collected (£0.95)
Seat 5: Wwwasian folded before Flop (didn't bet)
Seat 6: faceMyBallz_ folded before Flop (didn't bet)





PokerStars Hand #154969863988:  Hold'em No Limit ($0.50/$1.00 USD) - 2016/06/20 12:15:21 CET [2016/06/20 6:15:21 ET]
Table 'Ambrosia II' 9-max Seat #3 is the button
Seat 1: 23SmOkEr07 ($107.07 in chips) 
Seat 3: mavin80 ($75.18 in chips) 
Seat 4: mi$$I$Elena ($132.62 in chips) 
Seat 5: Mattulh ($114.02 in chips) 
Seat 6: ruslik_by ($139.48 in chips) 
Seat 7: matiko09 ($100 in chips) 
Seat 8: hammerwife ($101.50 in chips) 
Seat 9: SkUhNi ($105.35 in chips) 
mi$$I$Elena: posts small blind $0.50
Mattulh: posts big blind $1
*** HOLE CARDS ***
Dealt to matiko09 [6s 4d]
ruslik_by: folds 
matiko09: folds 
hammerwife: folds 
SkUhNi: folds 
23SmOkEr07: folds 
mavin80: raises $1.50 to $2.50
mi$$I$Elena: folds 
Mattulh: folds 
Uncalled bet ($1.50) returned to mavin80
mavin80 collected $2.50 from pot
*** SUMMARY ***
Total pot $2.50 | Rake $0 
Seat 1: 23SmOkEr07 folded before Flop (didn't bet)
Seat 3: mavin80 (button) collected ($2.50)
Seat 4: mi$$I$Elena (small blind) folded before Flop
Seat 5: Mattulh (big blind) folded before Flop
Seat 6: ruslik_by folded before Flop (didn't bet)
Seat 7: matiko09 folded before Flop (didn't bet)
Seat 8: hammerwife folded before Flop (didn't bet)
Seat 9: SkUhNi folded before Flop (didn't bet)





PokerStars Hand #154969867193:  Hold'em No Limit ($0.50/$1.00 USD) - 2016/06/20 12:15:30 CET [2016/06/20 6:15:30 ET]
Table 'Pongola' 9-max Seat #4 is the button
Seat 1: matiko09 ($100 in chips) 
Seat 2: ruslik_by ($136 in chips) 
Seat 3: SkUhNi ($100 in chips) 
Seat 4: karllv ($121.29 in chips) 
Seat 5: joker180785 ($106.43 in chips) 
Seat 6: 23SmOkEr07 ($100 in chips) 
Seat 7: Prophet1906 ($100 in chips) 
Seat 8: phrantique ($145.44 in chips) 
Seat 9: blackw0lf_03 ($100 in chips) 
joker180785: posts small blind $0.50
23SmOkEr07: posts big blind $1
*** HOLE CARDS ***
Dealt to matiko09 [4h 4d]
Prophet1906: folds 
phrantique: raises $2 to $3
blackw0lf_03: raises $6 to $9
matiko09: folds 
ruslik_by: folds 
SkUhNi: folds 
karllv: folds 
joker180785: folds 
23SmOkEr07: folds 
phrantique: calls $6
*** FLOP *** [8d Jh As]
phrantique: checks 
blackw0lf_03: checks 
*** TURN *** [8d Jh As] [6s]
phrantique: checks 
blackw0lf_03: bets $6.30
phrantique: calls $6.30
*** RIVER *** [8d Jh As 6s] [6d]
phrantique: bets $12.17
blackw0lf_03: folds 
Uncalled bet ($12.17) returned to phrantique
phrantique collected $30.50 from pot
*** SUMMARY ***
Total pot $32.10 | Rake $1.60 
Board [8d Jh As 6s 6d]
Seat 1: matiko09 folded before Flop (didn't bet)
Seat 2: ruslik_by folded before Flop (didn't bet)
Seat 3: SkUhNi folded before Flop (didn't bet)
Seat 4: karllv (button) folded before Flop (didn't bet)
Seat 5: joker180785 (small blind) folded before Flop
Seat 6: 23SmOkEr07 (big blind) folded before Flop
Seat 7: Prophet1906 folded before Flop (didn't bet)
Seat 8: phrantique collected ($30.50)
Seat 9: blackw0lf_03 folded on the River





PokerStars Hand #154969867740:  Hold'em No Limit ($0.50/$1.00 USD) - 2016/06/20 12:15:31 CET [2016/06/20 6:15:31 ET]
Table 'Ernestina' 9-max Seat #9 is the button
Seat 1: diva3150 ($63.92 in chips) 
Seat 2: matiko09 ($100 in chips) 
Seat 3: blackw0lf_03 ($163.54 in chips) 
Seat 4: SkUhNi ($103.02 in chips) 
Seat 5: DomiVY ($40 in chips) 
Seat 6: arctur17 ($104.30 in chips) 
Seat 8: ruslik_by ($306.94 in chips) 
Seat 9: 23SmOkEr07 ($100 in chips) 
diva3150: posts small blind $0.50
matiko09: posts big blind $1
Filojoes: sits out 
*** HOLE CARDS ***
Dealt to matiko09 [4d 3d]
blackw0lf_03: folds 
SkUhNi: folds 
DomiVY: folds 
arctur17: folds 
ruslik_by: folds 
23SmOkEr07: folds 
diva3150: folds 
Uncalled bet ($0.50) returned to matiko09
matiko09 collected $1 from pot
matiko09: doesn't show hand 
*** SUMMARY ***
Total pot $1 | Rake $0 
Seat 1: diva3150 (small blind) folded before Flop
Seat 2: matiko09 (big blind) collected ($1)
Seat 3: blackw0lf_03 folded before Flop (didn't bet)
Seat 4: SkUhNi folded before Flop (didn't bet)
Seat 5: DomiVY folded before Flop (didn't bet)
Seat 6: arctur17 folded before Flop (didn't bet)
Seat 8: ruslik_by folded before Flop (didn't bet)
Seat 9: 23SmOkEr07 (button) folded before Flop (didn't bet)





PokerStars Hand #154969868044:  Hold'em No Limit ($0.25/$0.50 USD) - 2016/06/20 12:15:32 CET [2016/06/20 6:15:32 ET]
Table 'Memoria II' 9-max Seat #2 is the button
Seat 2: matiko09 ($50 in chips) 
Seat 3: ljryviltj ($54.48 in chips) 
Seat 4: St.LaCoste ($60.02 in chips) 
Seat 5: kiev-city12 ($44.26 in chips) 
Seat 6: Kukuryzka ($49.75 in chips) 
Seat 7: Zeeshka ($69.50 in chips) 
Seat 8: mi$$I$Elena ($50 in chips) 
Seat 9: djammusic ($23.86 in chips) 
ljryviltj: posts small blind $0.25
St.LaCoste: posts big blind $0.50
*** HOLE CARDS ***
Dealt to matiko09 [Js 8h]
kiev-city12: folds 
Kukuryzka: folds 
Zeeshka: folds 
mi$$I$Elena: folds 
djammusic: folds 
matiko09: raises $0.63 to $1.13
ljryviltj: folds 
St.LaCoste: folds 
Uncalled bet ($0.63) returned to matiko09
matiko09 collected $1.25 from pot
matiko09: doesn't show hand 
*** SUMMARY ***
Total pot $1.25 | Rake $0 
Seat 2: matiko09 (button) collected ($1.25)
Seat 3: ljryviltj (small blind) folded before Flop
Seat 4: St.LaCoste (big blind) folded before Flop
Seat 5: kiev-city12 folded before Flop (didn't bet)
Seat 6: Kukuryzka folded before Flop (didn't bet)
Seat 7: Zeeshka folded before Flop (didn't bet)
Seat 8: mi$$I$Elena folded before Flop (didn't bet)
Seat 9: djammusic folded before Flop (didn't bet)





PokerStars Hand #154969868216:  Hold'em No Limit (£0.25/£0.50 GBP) - 2016/06/20 12:15:33 CET [2016/06/20 6:15:33 ET]
Table 'Azalea' 6-max Seat #2 is the button
Seat 1: Rubleff85 (£16.89 in chips) 
Seat 2: matiko09 (£82.35 in chips) 
Seat 3: VahTang_89 (£52.22 in chips) 
Seat 5: mudders693 (£51.70 in chips) 
Seat 6: Bënedic10 (£51.25 in chips) 
VahTang_89: posts small blind £0.25
mudders693: posts big blind £0.50
*** HOLE CARDS ***
Dealt to matiko09 [Ac 4h]
Bënedic10: raises £0.75 to £1.25
Rubleff85: calls £1.25
matiko09: folds 
VahTang_89: folds 
mudders693: calls £0.75
*** FLOP *** [3h 4s 7d]
mudders693: bets £2.50
Bënedic10: folds 
Rubleff85: calls £2.50
*** TURN *** [3h 4s 7d] [Jc]
mudders693: checks 
Rubleff85: checks 
*** RIVER *** [3h 4s 7d Jc] [5h]
mudders693: checks 
Rubleff85: bets £6.25
mudders693: raises £8.75 to £15
Rubleff85: calls £6.89 and is all-in
Uncalled bet (£1.86) returned to mudders693
*** SHOW DOWN ***
mudders693: shows [6d 7s] (a straight, Three to Seven)
Rubleff85: shows [Ah 2h] (a straight, Ace to Five)
mudders693 collected £33.88 from pot
*** SUMMARY ***
Total pot £35.28 | Rake £1.40 
Board [3h 4s 7d Jc 5h]
Seat 1: Rubleff85 showed [Ah 2h] and lost with a straight, Ace to Five
Seat 2: matiko09 (button) folded before Flop (didn't bet)
Seat 3: VahTang_89 (small blind) folded before Flop
Seat 5: mudders693 (big blind) showed [6d 7s] and won (£33.88) with a straight, Three to Seven
Seat 6: Bënedic10 folded on the Flop





PokerStars Hand #154969871362:  Hold'em No Limit ($0.25/$0.50 USD) - 2016/06/20 12:15:41 CET [2016/06/20 6:15:41 ET]
Table 'Scheddi II' 9-max Seat #6 is the button
Seat 1: matiko09 ($50 in chips) 
Seat 3: St.LaCoste ($58.46 in chips) 
Seat 6: joker180785 ($59.60 in chips) 
Seat 7: HopeMayBee ($60.27 in chips) 
Seat 9: Infinitinium ($116.42 in chips) 
HopeMayBee: posts small blind $0.25
nubpoker: is sitting out 
nubpoker leaves the table
Infinitinium: posts big blind $0.50
Yaaaazz: sits out 
No Money NW: sits out 
matiko09: posts the ante $0.10
St.LaCoste: posts the ante $0.10
joker180785: posts the ante $0.10
HopeMayBee: posts the ante $0.10
Infinitinium: posts the ante $0.10
*** HOLE CARDS ***
Dealt to matiko09 [2h 6s]
matiko09: folds 
St.LaCoste: raises $1 to $1.50
joker180785: calls $1.50
HopeMayBee: folds 
Infinitinium: calls $1
*** FLOP *** [3c Ah Jh]
Infinitinium: checks 
St.LaCoste: checks 
joker180785: checks 
*** TURN *** [3c Ah Jh] [8h]
Infinitinium: bets $4.99
St.LaCoste: folds 
joker180785: folds 
Uncalled bet ($4.99) returned to Infinitinium
Infinitinium collected $4.99 from pot
Infinitinium: doesn't show hand 
*** SUMMARY ***
Total pot $5.25 | Rake $0.26 
Board [3c Ah Jh 8h]
Seat 1: matiko09 folded before Flop (didn't bet)
Seat 3: St.LaCoste folded on the Turn
Seat 6: joker180785 (button) folded on the Turn
Seat 7: HopeMayBee (small blind) folded before Flop
Seat 9: Infinitinium (big blind) collected ($4.99)





PokerStars Hand #154969876526:  Hold'em No Limit ($0.25/$0.50 USD) - 2016/06/20 12:15:55 CET [2016/06/20 6:15:55 ET]
Table 'Memoria II' 9-max Seat #3 is the button
Seat 2: matiko09 ($50.75 in chips) 
Seat 3: ljryviltj ($54.23 in chips) 
Seat 4: St.LaCoste ($59.52 in chips) 
Seat 5: kiev-city12 ($44.26 in chips) 
Seat 6: Kukuryzka ($49.75 in chips) 
Seat 7: Zeeshka ($69.50 in chips) 
Seat 8: mi$$I$Elena ($50 in chips) 
Seat 9: djammusic ($23.86 in chips) 
St.LaCoste: posts small blind $0.25
kiev-city12: posts big blind $0.50
*** HOLE CARDS ***
Dealt to matiko09 [Qc 5s]
Kukuryzka: folds 
Zeeshka: folds 
mi$$I$Elena: folds 
djammusic: folds 
matiko09: folds 
ljryviltj: folds 
St.LaCoste: raises $0.64 to $1.14
kiev-city12: calls $0.64
*** FLOP *** [3c Jd 9d]
St.LaCoste: checks 
kiev-city12: bets $2
St.LaCoste: calls $2
*** TURN *** [3c Jd 9d] [5c]
St.LaCoste: checks 
kiev-city12: bets $4
St.LaCoste: calls $4
*** RIVER *** [3c Jd 9d 5c] [2c]
St.LaCoste: checks 
kiev-city12: checks 
*** SHOW DOWN ***
St.LaCoste: shows [8c 9c] (a flush, Nine high)
kiev-city12: mucks hand 
St.LaCoste collected $13.57 from pot
*** SUMMARY ***
Total pot $14.28 | Rake $0.71 
Board [3c Jd 9d 5c 2c]
Seat 2: matiko09 folded before Flop (didn't bet)
Seat 3: ljryviltj (button) folded before Flop (didn't bet)
Seat 4: St.LaCoste (small blind) showed [8c 9c] and won ($13.57) with a flush, Nine high
Seat 5: kiev-city12 (big blind) mucked [6c 3s]
Seat 6: Kukuryzka folded before Flop (didn't bet)
Seat 7: Zeeshka folded before Flop (didn't bet)
Seat 8: mi$$I$Elena folded before Flop (didn't bet)
Seat 9: djammusic folded before Flop (didn't bet)





PokerStars Hand #154969877487:  Hold'em No Limit (£0.25/£0.50 GBP) - 2016/06/20 12:15:58 CET [2016/06/20 6:15:58 ET]
Table 'Ani' 6-max Seat #3 is the button
Seat 1: rewq99887788 (£55.27 in chips) 
Seat 2: joker180785 (£50.52 in chips) 
Seat 3: Doobes8555 (£72.84 in chips) 
Seat 4: matiko09 (£50.45 in chips) 
Seat 5: Wwwasian (£57.80 in chips) 
Seat 6: faceMyBallz_ (£55.42 in chips) 
matiko09: posts small blind £0.25
Wwwasian: posts big blind £0.50
*** HOLE CARDS ***
Dealt to matiko09 [3h 6h]
faceMyBallz_: folds 
rewq99887788: calls £0.50
joker180785: folds 
Doobes8555: folds 
matiko09: calls £0.25
Wwwasian: raises £0.90 to £1.40
rewq99887788: calls £0.90
matiko09: folds 
*** FLOP *** [Ah Jd As]
Doobes8555 is disconnected 
Wwwasian: checks 
rewq99887788: bets £2.50
Wwwasian: raises £2.50 to £5
rewq99887788: folds 
Uncalled bet (£2.50) returned to Wwwasian
Wwwasian collected £7.88 from pot
Wwwasian: doesn't show hand 
*** SUMMARY ***
Total pot £8.30 | Rake £0.42 
Board [Ah Jd As]
Seat 1: rewq99887788 folded on the Flop
Seat 2: joker180785 folded before Flop (didn't bet)
Seat 3: Doobes8555 (button) folded before Flop (didn't bet)
Seat 4: matiko09 (small blind) folded before Flop
Seat 5: Wwwasian (big blind) collected (£7.88)
Seat 6: faceMyBallz_ folded before Flop (didn't bet)





PokerStars Hand #154969878568:  Hold'em No Limit ($0.50/$1.00 USD) - 2016/06/20 12:16:01 CET [2016/06/20 6:16:01 ET]
Table 'Ernestina' 9-max Seat #1 is the button
Seat 1: diva3150 ($63.42 in chips) 
Seat 2: matiko09 ($100.50 in chips) 
Seat 4: SkUhNi ($103.02 in chips) 
Seat 5: DomiVY ($40 in chips) 
Seat 6: arctur17 ($104.30 in chips) 
Seat 8: ruslik_by ($306.94 in chips) 
Seat 9: 23SmOkEr07 ($100 in chips) 
matiko09: posts small blind $0.50
blackw0lf_03: is sitting out 
SkUhNi: posts big blind $1
Filojoes: sits out 
*** HOLE CARDS ***
Dealt to matiko09 [2s 6c]
DomiVY: folds 
arctur17: folds 
ruslik_by: folds 
23SmOkEr07: folds 
diva3150: raises $1 to $2
matiko09: folds 
SkUhNi: calls $1
*** FLOP *** [9c 7h Qh]
SkUhNi: checks 
diva3150: bets $3
SkUhNi: folds 
Uncalled bet ($3) returned to diva3150
diva3150 collected $4.28 from pot
diva3150: doesn't show hand 
*** SUMMARY ***
Total pot $4.50 | Rake $0.22 
Board [9c 7h Qh]
Seat 1: diva3150 (button) collected ($4.28)
Seat 2: matiko09 (small blind) folded before Flop
Seat 4: SkUhNi (big blind) folded on the Flop
Seat 5: DomiVY folded before Flop (didn't bet)
Seat 6: arctur17 folded before Flop (didn't bet)
Seat 8: ruslik_by folded before Flop (didn't bet)
Seat 9: 23SmOkEr07 folded before Flop (didn't bet)





PokerStars Hand #154969883926:  Hold'em No Limit ($0.50/$1.00 USD) - 2016/06/20 12:16:15 CET [2016/06/20 6:16:15 ET]
Table 'Ambrosia II' 9-max Seat #4 is the button
Seat 1: 23SmOkEr07 ($107.07 in chips) 
Seat 3: mavin80 ($76.68 in chips) 
Seat 4: mi$$I$Elena ($132.12 in chips) 
Seat 5: Mattulh ($113.02 in chips) 
Seat 6: ruslik_by ($139.48 in chips) 
Seat 7: matiko09 ($100 in chips) 
Seat 8: hammerwife ($101.50 in chips) 
Seat 9: SkUhNi ($105.35 in chips) 
Mattulh: posts small blind $0.50
ruslik_by: posts big blind $1
*** HOLE CARDS ***
Dealt to matiko09 [Js Td]
Eyeballz1307 joins the table at seat #2 
matiko09: folds 
hammerwife: folds 
SkUhNi: folds 
23SmOkEr07: folds 
mavin80: raises $1 to $2
mi$$I$Elena: folds 
Mattulh: folds 
ruslik_by: folds 
Uncalled bet ($1) returned to mavin80
mavin80 collected $2.50 from pot
*** SUMMARY ***
Total pot $2.50 | Rake $0 
Seat 1: 23SmOkEr07 folded before Flop (didn't bet)
Seat 3: mavin80 collected ($2.50)
Seat 4: mi$$I$Elena (button) folded before Flop (didn't bet)
Seat 5: Mattulh (small blind) folded before Flop
Seat 6: ruslik_by (big blind) folded before Flop
Seat 7: matiko09 folded before Flop (didn't bet)
Seat 8: hammerwife folded before Flop (didn't bet)
Seat 9: SkUhNi folded before Flop (didn't bet)





PokerStars Hand #154969888971:  Hold'em No Limit ($0.50/$1.00 USD) - 2016/06/20 12:16:29 CET [2016/06/20 6:16:29 ET]
Table 'Anhui' 9-max Seat #7 is the button
Seat 1: SkUhNi ($152.92 in chips) 
Seat 2: ruslik_by ($264.35 in chips) 
Seat 4: mavin80 ($37.36 in chips) 
Seat 5: mi$$I$Elena ($100 in chips) 
Seat 6: 23SmOkEr07 ($134.75 in chips) 
Seat 7: matiko09 ($100 in chips) 
SkUhNi: posts small blind $0.50
ruslik_by: posts big blind $1
Filojoes: sits out 
*** HOLE CARDS ***
Dealt to matiko09 [7c As]
mavin80: raises $1.50 to $2.50
mi$$I$Elena: folds 
23SmOkEr07: folds 
matiko09: folds 
SkUhNi: folds 
ruslik_by: folds 
Uncalled bet ($1.50) returned to mavin80
mavin80 collected $2.50 from pot
*** SUMMARY ***
Total pot $2.50 | Rake $0 
Seat 1: SkUhNi (small blind) folded before Flop
Seat 2: ruslik_by (big blind) folded before Flop
Seat 4: mavin80 collected ($2.50)
Seat 5: mi$$I$Elena folded before Flop (didn't bet)
Seat 6: 23SmOkEr07 folded before Flop (didn't bet)
Seat 7: matiko09 (button) folded before Flop (didn't bet)





PokerStars Hand #154969889739:  Hold'em No Limit ($0.25/$0.50 USD) - 2016/06/20 12:16:31 CET [2016/06/20 6:16:31 ET]
Table 'Scheddi II' 9-max Seat #7 is the button
Seat 1: matiko09 ($50 in chips) 
Seat 3: St.LaCoste ($56.86 in chips) 
Seat 6: joker180785 ($58 in chips) 
Seat 7: HopeMayBee ($59.92 in chips) 
Seat 9: Infinitinium ($119.81 in chips) 
Infinitinium: posts small blind $0.25
matiko09: posts big blind $0.50
Yaaaazz: sits out 
No Money NW: sits out 
matiko09: posts the ante $0.10
St.LaCoste: posts the ante $0.10
joker180785: posts the ante $0.10
HopeMayBee: posts the ante $0.10
Infinitinium: posts the ante $0.10
*** HOLE CARDS ***
Dealt to matiko09 [5h Tc]
St.LaCoste: folds 
joker180785: folds 
HopeMayBee: folds 
Infinitinium: raises $0.50 to $1
matiko09: folds 
Uncalled bet ($0.50) returned to Infinitinium
Infinitinium collected $1.50 from pot
Infinitinium: doesn't show hand 
*** SUMMARY ***
Total pot $1.50 | Rake $0 
Seat 1: matiko09 (big blind) folded before Flop
Seat 3: St.LaCoste folded before Flop (didn't bet)
Seat 6: joker180785 folded before Flop (didn't bet)
Seat 7: HopeMayBee (button) folded before Flop (didn't bet)
Seat 9: Infinitinium (small blind) collected ($1.50)





PokerStars Hand #154969891034:  Hold'em No Limit (£0.25/£0.50 GBP) - 2016/06/20 12:16:34 CET [2016/06/20 6:16:34 ET]
Table 'Azalea' 6-max Seat #3 is the button
Seat 2: matiko09 (£82.35 in chips) 
Seat 3: VahTang_89 (£51.97 in chips) 
Seat 5: mudders693 (£68.69 in chips) 
Seat 6: Bënedic10 (£50 in chips) 
mudders693: posts small blind £0.25
Bënedic10: posts big blind £0.50
*** HOLE CARDS ***
Dealt to matiko09 [5d Tc]
matiko09: folds 
VahTang_89: raises £1 to £1.50
Rubleff85 leaves the table
mudders693: raises £3.50 to £5
Bënedic10: folds 
mitsuVK joins the table at seat #1 
VahTang_89: folds 
Uncalled bet (£3.50) returned to mudders693
mudders693 collected £3.50 from pot
mudders693: doesn't show hand 
*** SUMMARY ***
Total pot £3.50 | Rake £0 
Seat 2: matiko09 folded before Flop (didn't bet)
Seat 3: VahTang_89 (button) folded before Flop
Seat 5: mudders693 (small blind) collected (£3.50)
Seat 6: Bënedic10 (big blind) folded before Flop





PokerStars Hand #154969894798:  Hold'em No Limit ($0.25/$0.50 USD) - 2016/06/20 12:16:44 CET [2016/06/20 6:16:44 ET]
Table 'Scheddi II' 9-max Seat #9 is the button
Seat 1: matiko09 ($50 in chips) 
Seat 2: Yaaaazz ($51.17 in chips) 
Seat 3: St.LaCoste ($56.76 in chips) 
Seat 6: joker180785 ($57.90 in chips) 
Seat 7: HopeMayBee ($59.82 in chips) 
Seat 9: Infinitinium ($120.71 in chips) 
matiko09: posts small blind $0.25
Yaaaazz: posts big blind $0.50
No Money NW: sits out 
matiko09: posts the ante $0.10
Yaaaazz: posts the ante $0.10
St.LaCoste: posts the ante $0.10
joker180785: posts the ante $0.10
HopeMayBee: posts the ante $0.10
Infinitinium: posts the ante $0.10
*** HOLE CARDS ***
Dealt to matiko09 [Ts Th]
St.LaCoste: folds 
joker180785: folds 
HopeMayBee: raises $0.75 to $1.25
Infinitinium: calls $1.25
matiko09: raises $4.75 to $6
Yaaaazz: folds 
HopeMayBee: folds 
Infinitinium: calls $4.75
*** FLOP *** [8s Jc 3d]
matiko09: bets $5.50
Infinitinium: calls $5.50
*** TURN *** [8s Jc 3d] [6s]
matiko09: checks 
Infinitinium: bets $7
matiko09: calls $7
*** RIVER *** [8s Jc 3d 6s] [5c]
matiko09: checks 
Infinitinium: checks 
*** SHOW DOWN ***
matiko09: shows [Ts Th] (a pair of Tens)
Infinitinium: shows [Jh 6h] (two pair, Jacks and Sixes)
Infinitinium collected $37.38 from pot
*** SUMMARY ***
Total pot $39.35 | Rake $1.97 
Board [8s Jc 3d 6s 5c]
Seat 1: matiko09 (small blind) showed [Ts Th] and lost with a pair of Tens
Seat 2: Yaaaazz (big blind) folded before Flop
Seat 3: St.LaCoste folded before Flop (didn't bet)
Seat 6: joker180785 folded before Flop (didn't bet)
Seat 7: HopeMayBee folded before Flop
Seat 9: Infinitinium (button) showed [Jh 6h] and won ($37.38) with two pair, Jacks and Sixes





PokerStars Hand #154969900676:  Hold'em No Limit ($0.50/$1.00 USD) - 2016/06/20 12:17:00 CET [2016/06/20 6:17:00 ET]
Table 'Anhui' 9-max Seat #1 is the button
Seat 1: SkUhNi ($152.42 in chips) 
Seat 2: ruslik_by ($263.35 in chips) 
Seat 3: Filojoes ($109 in chips) 
Seat 4: mavin80 ($38.86 in chips) 
Seat 5: mi$$I$Elena ($100 in chips) 
Seat 6: 23SmOkEr07 ($134.75 in chips) 
Seat 7: matiko09 ($100 in chips) 
ruslik_by: posts small blind $0.50
Filojoes: posts big blind $1
*** HOLE CARDS ***
Dealt to matiko09 [8d 8s]
mavin80: folds 
mi$$I$Elena: folds 
23SmOkEr07: folds 
matiko09: raises $1.50 to $2.50
blackmont111 joins the table at seat #8 
SkUhNi: folds 
ruslik_by: folds 
Filojoes: raises $6.50 to $9
matiko09: calls $6.50
*** FLOP *** [Ah 8c Qh]
Filojoes: bets $9
matiko09: calls $9
*** TURN *** [Ah 8c Qh] [5d]
TomBod1 joins the table at seat #9 
Filojoes: bets $20
matiko09: calls $20
*** RIVER *** [Ah 8c Qh 5d] [8h]
Filojoes: checks 
matiko09: bets $38
Filojoes: folds 
Uncalled bet ($38) returned to matiko09
matiko09 collected $74 from pot
matiko09: doesn't show hand 
*** SUMMARY ***
Total pot $76.50 | Rake $2.50 
Board [Ah 8c Qh 5d 8h]
Seat 1: SkUhNi (button) folded before Flop (didn't bet)
Seat 2: ruslik_by (small blind) folded before Flop
Seat 3: Filojoes (big blind) folded on the River
Seat 4: mavin80 folded before Flop (didn't bet)
Seat 5: mi$$I$Elena folded before Flop (didn't bet)
Seat 6: 23SmOkEr07 folded before Flop (didn't bet)
Seat 7: matiko09 collected ($74)





PokerStars Hand #154969901855:  Hold'em No Limit ($0.50/$1.00 USD) - 2016/06/20 12:17:03 CET [2016/06/20 6:17:03 ET]
Table 'Ernestina' 9-max Seat #2 is the button
Seat 1: diva3150 ($65.70 in chips) 
Seat 2: matiko09 ($100 in chips) 
Seat 4: SkUhNi ($101.02 in chips) 
Seat 5: DomiVY ($40 in chips) 
Seat 6: arctur17 ($104.30 in chips) 
Seat 8: ruslik_by ($306.94 in chips) 
Seat 9: 23SmOkEr07 ($100 in chips) 
SkUhNi: posts small blind $0.50
DomiVY: posts big blind $1
Filojoes: sits out 
*** HOLE CARDS ***
Dealt to matiko09 [6c 2s]
arctur17: folds 
ruslik_by: folds 
23SmOkEr07: folds 
diva3150: folds 
matiko09: folds 
SkUhNi: raises $1.50 to $2.50
DomiVY: folds 
Uncalled bet ($1.50) returned to SkUhNi
SkUhNi collected $2 from pot
SkUhNi: doesn't show hand 
*** SUMMARY ***
Total pot $2 | Rake $0 
Seat 1: diva3150 folded before Flop (didn't bet)
Seat 2: matiko09 (button) folded before Flop (didn't bet)
Seat 4: SkUhNi (small blind) collected ($2)
Seat 5: DomiVY (big blind) folded before Flop
Seat 6: arctur17 folded before Flop (didn't bet)
Seat 8: ruslik_by folded before Flop (didn't bet)
Seat 9: 23SmOkEr07 folded before Flop (didn't bet)





PokerStars Hand #154969905813:  Hold'em No Limit (£0.25/£0.50 GBP) - 2016/06/20 12:17:14 CET [2016/06/20 6:17:14 ET]
Table 'Azalea' 6-max Seat #5 is the button
Seat 1: mitsuVK (£50 in chips) 
Seat 2: matiko09 (£82.35 in chips) 
Seat 3: VahTang_89 (£50.47 in chips) 
Seat 5: mudders693 (£70.69 in chips) 
Seat 6: Bënedic10 (£50 in chips) 
Bënedic10: posts small blind £0.25
mitsuVK: posts big blind £0.50
*** HOLE CARDS ***
Dealt to matiko09 [5s Kc]
matiko09: folds 
VahTang_89: folds 
mudders693: raises £1 to £1.50
Bënedic10: folds 
mitsuVK: folds 
Uncalled bet (£1) returned to mudders693
mudders693 collected £1.25 from pot
mudders693: doesn't show hand 
*** SUMMARY ***
Total pot £1.25 | Rake £0 
Seat 1: mitsuVK (big blind) folded before Flop
Seat 2: matiko09 folded before Flop (didn't bet)
Seat 3: VahTang_89 folded before Flop (didn't bet)
Seat 5: mudders693 (button) collected (£1.25)
Seat 6: Bënedic10 (small blind) folded before Flop





PokerStars Hand #154969906035:  Hold'em No Limit (£0.25/£0.50 GBP) - 2016/06/20 12:17:14 CET [2016/06/20 6:17:14 ET]
Table 'Ani' 6-max Seat #4 is the button
Seat 1: rewq99887788 (£51.37 in chips) 
Seat 2: joker180785 (£50.52 in chips) 
Seat 3: Doobes8555 (£72.84 in chips) 
Seat 4: matiko09 (£50 in chips) 
Seat 5: Wwwasian (£61.78 in chips) 
Seat 6: faceMyBallz_ (£55.42 in chips) 
Wwwasian: posts small blind £0.25
faceMyBallz_: posts big blind £0.50
*** HOLE CARDS ***
Dealt to matiko09 [Qs 3s]
rewq99887788: calls £0.50
Doobes8555 is disconnected 
joker180785: raises £1.50 to £2
Doobes8555 is connected 
Doobes8555: folds 
matiko09: folds 
Wwwasian: folds 
faceMyBallz_: folds 
rewq99887788: folds 
Uncalled bet (£1.50) returned to joker180785
joker180785 collected £1.75 from pot
*** SUMMARY ***
Total pot £1.75 | Rake £0 
Seat 1: rewq99887788 folded before Flop
Seat 2: joker180785 collected (£1.75)
Seat 3: Doobes8555 folded before Flop (didn't bet)
Seat 4: matiko09 (button) folded before Flop (didn't bet)
Seat 5: Wwwasian (small blind) folded before Flop
Seat 6: faceMyBallz_ (big blind) folded before Flop





PokerStars Hand #154969906750:  Hold'em No Limit ($0.50/$1.00 USD) - 2016/06/20 12:17:16 CET [2016/06/20 6:17:16 ET]
Table 'Albiorix' 9-max Seat #1 is the button
Seat 1: arctur17 ($77.28 in chips) 
Seat 2: SkUhNi ($150.52 in chips) 
Seat 3: matiko09 ($100 in chips) 
Seat 4: 23SmOkEr07 ($100 in chips) 
Seat 5: ruslik_by ($101.50 in chips) 
Seat 6: joker180785 ($116.81 in chips) 
Seat 7: Pekyto ($38.50 in chips) 
Seat 8: smiley0221 ($137.23 in chips) 
Seat 9: Coolller ($102.97 in chips) 
SkUhNi: posts small blind $0.50
matiko09: posts big blind $1
*** HOLE CARDS ***
Dealt to matiko09 [Kd 6s]
23SmOkEr07: folds 
ruslik_by: folds 
joker180785: folds 
Pekyto: folds 
smiley0221: folds 
Coolller: folds 
arctur17: folds 
SkUhNi: raises $1.50 to $2.50
matiko09: folds 
Uncalled bet ($1.50) returned to SkUhNi
SkUhNi collected $2 from pot
SkUhNi: doesn't show hand 
*** SUMMARY ***
Total pot $2 | Rake $0 
Seat 1: arctur17 (button) folded before Flop (didn't bet)
Seat 2: SkUhNi (small blind) collected ($2)
Seat 3: matiko09 (big blind) folded before Flop
Seat 4: 23SmOkEr07 folded before Flop (didn't bet)
Seat 5: ruslik_by folded before Flop (didn't bet)
Seat 6: joker180785 folded before Flop (didn't bet)
Seat 7: Pekyto folded before Flop (didn't bet)
Seat 8: smiley0221 folded before Flop (didn't bet)
Seat 9: Coolller folded before Flop (didn't bet)





PokerStars Hand #154969910088:  Hold'em No Limit ($0.50/$1.00 USD) - 2016/06/20 12:17:25 CET [2016/06/20 6:17:25 ET]
Table 'Ambrosia II' 9-max Seat #5 is the button
Seat 1: 23SmOkEr07 ($107.07 in chips) 
Seat 2: Eyeballz1307 ($60 in chips) 
Seat 3: mavin80 ($78.18 in chips) 
Seat 4: mi$$I$Elena ($132.12 in chips) 
Seat 5: Mattulh ($112.52 in chips) 
Seat 6: ruslik_by ($138.48 in chips) 
Seat 7: matiko09 ($100 in chips) 
Seat 8: hammerwife ($101.50 in chips) 
Seat 9: SkUhNi ($105.35 in chips) 
ruslik_by: posts small blind $0.50
matiko09: posts big blind $1
Eyeballz1307: posts big blind $1
*** HOLE CARDS ***
Dealt to matiko09 [2c Kc]
hammerwife: folds 
SkUhNi: folds 
23SmOkEr07: raises $4 to $5
Eyeballz1307: folds 
mavin80: folds 
mi$$I$Elena: folds 
Mattulh: folds 
ruslik_by: folds 
matiko09: folds 
Uncalled bet ($4) returned to 23SmOkEr07
23SmOkEr07 collected $3.50 from pot
23SmOkEr07: doesn't show hand 
*** SUMMARY ***
Total pot $3.50 | Rake $0 
Seat 1: 23SmOkEr07 collected ($3.50)
Seat 2: Eyeballz1307 folded before Flop
Seat 3: mavin80 folded before Flop (didn't bet)
Seat 4: mi$$I$Elena folded before Flop (didn't bet)
Seat 5: Mattulh (button) folded before Flop (didn't bet)
Seat 6: ruslik_by (small blind) folded before Flop
Seat 7: matiko09 (big blind) folded before Flop
Seat 8: hammerwife folded before Flop (didn't bet)
Seat 9: SkUhNi folded before Flop (didn't bet)





PokerStars Hand #154969913341:  Hold'em No Limit ($0.50/$1.00 USD) - 2016/06/20 12:17:34 CET [2016/06/20 6:17:34 ET]
Table 'Ernestina' 9-max Seat #4 is the button
Seat 1: diva3150 ($65.70 in chips) 
Seat 2: matiko09 ($100 in chips) 
Seat 4: SkUhNi ($102.02 in chips) 
Seat 5: DomiVY ($40 in chips) 
Seat 6: arctur17 ($104.30 in chips) 
Seat 8: ruslik_by ($306.94 in chips) 
Seat 9: 23SmOkEr07 ($100 in chips) 
DomiVY: posts small blind $0.50
arctur17: posts big blind $1
Filojoes: sits out 
*** HOLE CARDS ***
Dealt to matiko09 [Js 3c]
ruslik_by: folds 
23SmOkEr07: folds 
diva3150: calls $1
matiko09: folds 
SkUhNi: folds 
DomiVY: folds 
arctur17: checks 
*** FLOP *** [Tc 4d Jh]
arctur17: checks 
diva3150: bets $2
arctur17: calls $2
*** TURN *** [Tc 4d Jh] [3h]
arctur17: checks 
diva3150: bets $2
blackw0lf_03 leaves the table
arctur17: calls $2
*** RIVER *** [Tc 4d Jh 3h] [9h]
arctur17: checks 
diva3150: bets $5
Pvsx. joins the table at seat #3 
arctur17: calls $5
*** SHOW DOWN ***
diva3150: shows [Td Qc] (a pair of Tens)
arctur17: mucks hand 
diva3150 collected $19.48 from pot
*** SUMMARY ***
Total pot $20.50 | Rake $1.02 
Board [Tc 4d Jh 3h 9h]
Seat 1: diva3150 showed [Td Qc] and won ($19.48) with a pair of Tens
Seat 2: matiko09 folded before Flop (didn't bet)
Seat 4: SkUhNi (button) folded before Flop (didn't bet)
Seat 5: DomiVY (small blind) folded before Flop
Seat 6: arctur17 (big blind) mucked [9c Qh]
Seat 8: ruslik_by folded before Flop (didn't bet)
Seat 9: 23SmOkEr07 folded before Flop (didn't bet)





PokerStars Hand #154969916418:  Hold'em No Limit ($0.25/$0.50 USD) - 2016/06/20 12:17:42 CET [2016/06/20 6:17:42 ET]
Table 'Memoria II' 9-max Seat #4 is the button
Seat 2: matiko09 ($50.75 in chips) 
Seat 3: ljryviltj ($54.23 in chips) 
Seat 4: St.LaCoste ($65.95 in chips) 
Seat 5: kiev-city12 ($37.12 in chips) 
Seat 6: Kukuryzka ($49.75 in chips) 
Seat 7: Zeeshka ($69.50 in chips) 
Seat 8: mi$$I$Elena ($50 in chips) 
Seat 9: djammusic ($23.86 in chips) 
kiev-city12: posts small blind $0.25
Kukuryzka: posts big blind $0.50
*** HOLE CARDS ***
Dealt to matiko09 [8h 7c]
Zeeshka: raises $1 to $1.50
mi$$I$Elena: folds 
djammusic: folds 
matiko09: folds 
ljryviltj: folds 
St.LaCoste: folds 
kiev-city12: folds 
Kukuryzka: folds 
Uncalled bet ($1) returned to Zeeshka
Zeeshka collected $1.25 from pot
Zeeshka: doesn't show hand 
*** SUMMARY ***
Total pot $1.25 | Rake $0 
Seat 2: matiko09 folded before Flop (didn't bet)
Seat 3: ljryviltj folded before Flop (didn't bet)
Seat 4: St.LaCoste (button) folded before Flop (didn't bet)
Seat 5: kiev-city12 (small blind) folded before Flop
Seat 6: Kukuryzka (big blind) folded before Flop
Seat 7: Zeeshka collected ($1.25)
Seat 8: mi$$I$Elena folded before Flop (didn't bet)
Seat 9: djammusic folded before Flop (didn't bet)





PokerStars Hand #154969917360:  Hold'em No Limit (£0.25/£0.50 GBP) - 2016/06/20 12:17:45 CET [2016/06/20 6:17:45 ET]
Table 'Azalea' 6-max Seat #6 is the button
Seat 1: mitsuVK (£50 in chips) 
Seat 2: matiko09 (£82.35 in chips) 
Seat 3: VahTang_89 (£50.47 in chips) 
Seat 5: mudders693 (£71.44 in chips) 
Seat 6: Bënedic10 (£50 in chips) 
mitsuVK: posts small blind £0.25
matiko09: posts big blind £0.50
*** HOLE CARDS ***
Dealt to matiko09 [8c 5d]
VahTang_89: folds 
mudders693: folds 
Bënedic10: raises £1 to £1.50
mitsuVK: calls £1.25
matiko09: folds 
*** FLOP *** [Td 9d Kc]
mitsuVK: checks 
Bënedic10: bets £1.50
mitsuVK: folds 
Uncalled bet (£1.50) returned to Bënedic10
Bënedic10 collected £3.32 from pot
Bënedic10: doesn't show hand 
*** SUMMARY ***
Total pot £3.50 | Rake £0.18 
Board [Td 9d Kc]
Seat 1: mitsuVK (small blind) folded on the Flop
Seat 2: matiko09 (big blind) folded before Flop
Seat 3: VahTang_89 folded before Flop (didn't bet)
Seat 5: mudders693 folded before Flop (didn't bet)
Seat 6: Bënedic10 (button) collected (£3.32)





PokerStars Hand #154969917867:  Hold'em No Limit (£0.25/£0.50 GBP) - 2016/06/20 12:17:46 CET [2016/06/20 6:17:46 ET]
Table 'Ani' 6-max Seat #5 is the button
Seat 1: rewq99887788 (£50.87 in chips) 
Seat 2: joker180785 (£51.77 in chips) 
Seat 3: Doobes8555 (£72.84 in chips) 
Seat 4: matiko09 (£50 in chips) 
Seat 5: Wwwasian (£61.53 in chips) 
Seat 6: faceMyBallz_ (£54.92 in chips) 
faceMyBallz_: posts small blind £0.25
rewq99887788: posts big blind £0.50
*** HOLE CARDS ***
Dealt to matiko09 [4h 8s]
joker180785: raises £1 to £1.50
Doobes8555: calls £1.50
matiko09: folds 
Wwwasian: folds 
faceMyBallz_: folds 
rewq99887788: folds 
*** FLOP *** [Ah Kh 4d]
joker180785: bets £1.88
Doobes8555: calls £1.88
*** TURN *** [Ah Kh 4d] [3c]
joker180785: checks 
Doobes8555: bets £3.50
joker180785: folds 
Uncalled bet (£3.50) returned to Doobes8555
Doobes8555 collected £7.13 from pot
Doobes8555: doesn't show hand 
*** SUMMARY ***
Total pot £7.51 | Rake £0.38 
Board [Ah Kh 4d 3c]
Seat 1: rewq99887788 (big blind) folded before Flop
Seat 2: joker180785 folded on the Turn
Seat 3: Doobes8555 collected (£7.13)
Seat 4: matiko09 folded before Flop (didn't bet)
Seat 5: Wwwasian (button) folded before Flop (didn't bet)
Seat 6: faceMyBallz_ (small blind) folded before Flop





PokerStars Hand #154969918557:  Hold'em No Limit ($0.50/$1.00 USD) - 2016/06/20 12:17:48 CET [2016/06/20 6:17:48 ET]
Table 'Pongola' 9-max Seat #5 is the button
Seat 1: matiko09 ($100 in chips) 
Seat 2: ruslik_by ($136 in chips) 
Seat 3: SkUhNi ($100 in chips) 
Seat 4: karllv ($121.29 in chips) 
Seat 5: joker180785 ($105.93 in chips) 
Seat 6: 23SmOkEr07 ($100 in chips) 
Seat 7: Prophet1906 ($100 in chips) 
Seat 8: phrantique ($160.64 in chips) 
Seat 9: blackw0lf_03 ($100 in chips) 
23SmOkEr07: posts small blind $0.50
Prophet1906: posts big blind $1
*** HOLE CARDS ***
Dealt to matiko09 [Qs 4h]
phrantique: raises $2 to $3
blackw0lf_03: folds 
matiko09: folds 
ruslik_by: folds 
SkUhNi: folds 
karllv: folds 
joker180785: folds 
23SmOkEr07: calls $2.50
Prophet1906: folds 
*** FLOP *** [Jd Th As]
23SmOkEr07: checks 
phrantique: checks 
*** TURN *** [Jd Th As] [Jc]
23SmOkEr07: checks 
phrantique: bets $3.32
23SmOkEr07: calls $3.32
*** RIVER *** [Jd Th As Jc] [2h]
23SmOkEr07: checks 
phrantique: checks 
*** SHOW DOWN ***
23SmOkEr07: shows [3d Ad] (two pair, Aces and Jacks)
phrantique: mucks hand 
23SmOkEr07 collected $12.96 from pot
*** SUMMARY ***
Total pot $13.64 | Rake $0.68 
Board [Jd Th As Jc 2h]
Seat 1: matiko09 folded before Flop (didn't bet)
Seat 2: ruslik_by folded before Flop (didn't bet)
Seat 3: SkUhNi folded before Flop (didn't bet)
Seat 4: karllv folded before Flop (didn't bet)
Seat 5: joker180785 (button) folded before Flop (didn't bet)
Seat 6: 23SmOkEr07 (small blind) showed [3d Ad] and won ($12.96) with two pair, Aces and Jacks
Seat 7: Prophet1906 (big blind) folded before Flop
Seat 8: phrantique mucked [Ks Kh]
Seat 9: blackw0lf_03 folded before Flop (didn't bet)





PokerStars Hand #154969918496:  Hold'em No Limit ($0.50/$1.00 USD) - 2016/06/20 12:17:48 CET [2016/06/20 6:17:48 ET]
Table 'Albiorix' 9-max Seat #2 is the button
Seat 1: arctur17 ($77.28 in chips) 
Seat 2: SkUhNi ($151.52 in chips) 
Seat 3: matiko09 ($100 in chips) 
Seat 4: 23SmOkEr07 ($100 in chips) 
Seat 5: ruslik_by ($101.50 in chips) 
Seat 6: joker180785 ($116.81 in chips) 
Seat 7: Pekyto ($38.50 in chips) 
Seat 8: smiley0221 ($137.23 in chips) 
Seat 9: Coolller ($102.97 in chips) 
matiko09: posts small blind $0.50
23SmOkEr07: posts big blind $1
*** HOLE CARDS ***
Dealt to matiko09 [Ah 7d]
ruslik_by: folds 
joker180785: folds 
Pekyto: folds 
smiley0221: folds 
Coolller: folds 
arctur17: folds 
SkUhNi: folds 
matiko09: raises $2 to $3
23SmOkEr07: folds 
Uncalled bet ($2) returned to matiko09
matiko09 collected $2 from pot
matiko09: doesn't show hand 
*** SUMMARY ***
Total pot $2 | Rake $0 
Seat 1: arctur17 folded before Flop (didn't bet)
Seat 2: SkUhNi (button) folded before Flop (didn't bet)
Seat 3: matiko09 (small blind) collected ($2)
Seat 4: 23SmOkEr07 (big blind) folded before Flop
Seat 5: ruslik_by folded before Flop (didn't bet)
Seat 6: joker180785 folded before Flop (didn't bet)
Seat 7: Pekyto folded before Flop (didn't bet)
Seat 8: smiley0221 folded before Flop (didn't bet)
Seat 9: Coolller folded before Flop (didn't bet)





PokerStars Hand #154969921374:  Hold'em No Limit ($0.25/$0.50 USD) - 2016/06/20 12:17:56 CET [2016/06/20 6:17:56 ET]
Table 'Scheddi II' 9-max Seat #1 is the button
Seat 1: matiko09 ($50 in chips) 
Seat 2: Yaaaazz ($50.57 in chips) 
Seat 5: No Money NW ($40 in chips) 
Seat 6: joker180785 ($57.80 in chips) 
Seat 7: HopeMayBee ($58.47 in chips) 
Seat 9: Infinitinium ($139.49 in chips) 
Yaaaazz: posts small blind $0.25
St.LaCoste: is sitting out 
No Money NW: posts big blind $0.50
matiko09: posts the ante $0.10
Yaaaazz: posts the ante $0.10
No Money NW: posts the ante $0.10
joker180785: posts the ante $0.10
HopeMayBee: posts the ante $0.10
Infinitinium: posts the ante $0.10
*** HOLE CARDS ***
Dealt to matiko09 [5h 6h]
St.LaCoste leaves the table
joker180785: raises $1.50 to $2
HopeMayBee: folds 
Infinitinium: folds 
matiko09: folds 
Yaaaazz: folds 
No Money NW: calls $1.50
*** FLOP *** [7s 3c 3d]
No Money NW: bets $2.50
joker180785: folds 
Uncalled bet ($2.50) returned to No Money NW
No Money NW collected $4.61 from pot
No Money NW: doesn't show hand 
*** SUMMARY ***
Total pot $4.85 | Rake $0.24 
Board [7s 3c 3d]
Seat 1: matiko09 (button) folded before Flop (didn't bet)
Seat 2: Yaaaazz (small blind) folded before Flop
Seat 5: No Money NW (big blind) collected ($4.61)
Seat 6: joker180785 folded on the Flop
Seat 7: HopeMayBee folded before Flop (didn't bet)
Seat 9: Infinitinium folded before Flop (didn't bet)





PokerStars Hand #154969924391:  Hold'em No Limit ($0.50/$1.00 USD) - 2016/06/20 12:18:04 CET [2016/06/20 6:18:04 ET]
Table 'Ambrosia II' 9-max Seat #6 is the button
Seat 1: 23SmOkEr07 ($109.57 in chips) 
Seat 2: Eyeballz1307 ($59 in chips) 
Seat 3: mavin80 ($78.18 in chips) 
Seat 4: mi$$I$Elena ($132.12 in chips) 
Seat 5: Mattulh ($112.52 in chips) 
Seat 6: ruslik_by ($137.98 in chips) 
Seat 7: matiko09 ($100 in chips) 
Seat 8: hammerwife ($101.50 in chips) 
Seat 9: SkUhNi ($105.35 in chips) 
matiko09: posts small blind $0.50
hammerwife: posts big blind $1
*** HOLE CARDS ***
Dealt to matiko09 [Kh Kd]
SkUhNi: folds 
23SmOkEr07: folds 
Eyeballz1307: calls $1
mavin80: folds 
mi$$I$Elena: raises $3 to $4
Mattulh: folds 
ruslik_by: folds 
matiko09: raises $9 to $13
hammerwife: folds 
Eyeballz1307: folds 
mi$$I$Elena: folds 
Uncalled bet ($9) returned to matiko09
matiko09 collected $10 from pot
matiko09: doesn't show hand 
*** SUMMARY ***
Total pot $10 | Rake $0 
Seat 1: 23SmOkEr07 folded before Flop (didn't bet)
Seat 2: Eyeballz1307 folded before Flop
Seat 3: mavin80 folded before Flop (didn't bet)
Seat 4: mi$$I$Elena folded before Flop
Seat 5: Mattulh folded before Flop (didn't bet)
Seat 6: ruslik_by (button) folded before Flop (didn't bet)
Seat 7: matiko09 (small blind) collected ($10)
Seat 8: hammerwife (big blind) folded before Flop
Seat 9: SkUhNi folded before Flop (didn't bet)





PokerStars Hand #154969926954:  Hold'em No Limit ($0.50/$1.00 USD) - 2016/06/20 12:18:11 CET [2016/06/20 6:18:11 ET]
Table 'Albiorix' 9-max Seat #3 is the button
Seat 1: arctur17 ($77.28 in chips) 
Seat 2: SkUhNi ($151.52 in chips) 
Seat 3: matiko09 ($101 in chips) 
Seat 4: 23SmOkEr07 ($100 in chips) 
Seat 5: ruslik_by ($101.50 in chips) 
Seat 6: joker180785 ($116.81 in chips) 
Seat 7: Pekyto ($38.50 in chips) 
Seat 8: smiley0221 ($137.23 in chips) 
Seat 9: Coolller ($102.97 in chips) 
23SmOkEr07: posts small blind $0.50
ruslik_by: posts big blind $1
*** HOLE CARDS ***
Dealt to matiko09 [3d 9h]
joker180785: folds 
Pekyto: folds 
smiley0221: folds 
Coolller: folds 
arctur17: folds 
SkUhNi: folds 
matiko09: folds 
23SmOkEr07: raises $1.50 to $2.50
ruslik_by: calls $1.50
*** FLOP *** [Tc 4c 2c]
23SmOkEr07: checks 
ruslik_by: checks 
*** TURN *** [Tc 4c 2c] [6d]
23SmOkEr07: checks 
ruslik_by: bets $1.61
23SmOkEr07: folds 
Uncalled bet ($1.61) returned to ruslik_by
ruslik_by collected $4.75 from pot
ruslik_by: doesn't show hand 
*** SUMMARY ***
Total pot $5 | Rake $0.25 
Board [Tc 4c 2c 6d]
Seat 1: arctur17 folded before Flop (didn't bet)
Seat 2: SkUhNi folded before Flop (didn't bet)
Seat 3: matiko09 (button) folded before Flop (didn't bet)
Seat 4: 23SmOkEr07 (small blind) folded on the Turn
Seat 5: ruslik_by (big blind) collected ($4.75)
Seat 6: joker180785 folded before Flop (didn't bet)
Seat 7: Pekyto folded before Flop (didn't bet)
Seat 8: smiley0221 folded before Flop (didn't bet)
Seat 9: Coolller folded before Flop (didn't bet)





PokerStars Hand #154969928744:  Hold'em No Limit (£0.25/£0.50 GBP) - 2016/06/20 12:18:16 CET [2016/06/20 6:18:16 ET]
Table 'Ani' 6-max Seat #6 is the button
Seat 1: rewq99887788 (£50.37 in chips) 
Seat 2: joker180785 (£50 in chips) 
Seat 3: Doobes8555 (£76.59 in chips) 
Seat 4: matiko09 (£50 in chips) 
Seat 5: Wwwasian (£61.53 in chips) 
Seat 6: faceMyBallz_ (£54.67 in chips) 
rewq99887788: posts small blind £0.25
joker180785: posts big blind £0.50
*** HOLE CARDS ***
Dealt to matiko09 [6d 4s]
Doobes8555: calls £0.50
matiko09: folds 
Wwwasian: folds 
faceMyBallz_: folds 
rewq99887788: folds 
joker180785: raises £2 to £2.50
Doobes8555: calls £2
*** FLOP *** [8h Qc Ks]
joker180785: checks 
Doobes8555: checks 
*** TURN *** [8h Qc Ks] [Jh]
joker180785: bets £4
Doobes8555: folds 
Uncalled bet (£4) returned to joker180785
joker180785 collected £4.99 from pot
*** SUMMARY ***
Total pot £5.25 | Rake £0.26 
Board [8h Qc Ks Jh]
Seat 1: rewq99887788 (small blind) folded before Flop
Seat 2: joker180785 (big blind) collected (£4.99)
Seat 3: Doobes8555 folded on the Turn
Seat 4: matiko09 folded before Flop (didn't bet)
Seat 5: Wwwasian folded before Flop (didn't bet)
Seat 6: faceMyBallz_ (button) folded before Flop (didn't bet)





PokerStars Hand #154969931371:  Hold'em No Limit ($0.25/$0.50 USD) - 2016/06/20 12:18:22 CET [2016/06/20 6:18:22 ET]
Table 'Juliana II' 9-max Seat #6 is the button
Seat 1: sno05 ($30.08 in chips) 
Seat 2: cjzm ($59.58 in chips) 
Seat 3: Dr.Mouse102 ($50 in chips) 
Seat 5: bigkahuna380 ($33.11 in chips) 
Seat 6: sophie2000 ($50 in chips) 
Seat 7: 23SmOkEr07 ($59.01 in chips) 
Seat 8: matiko09 ($50 in chips) 
Seat 9: tugboat2008 ($63.45 in chips) 
23SmOkEr07: posts small blind $0.25
matiko09: posts big blind $0.50
RICKA16: sits out 
*** HOLE CARDS ***
Dealt to matiko09 [6c Ts]
tugboat2008: folds 
sno05: raises $1 to $1.50
cjzm: folds 
Dr.Mouse102: folds 
bigkahuna380: folds 
sophie2000: folds 
23SmOkEr07: folds 
matiko09: folds 
Uncalled bet ($1) returned to sno05
sno05 collected $1.25 from pot
sno05: doesn't show hand 
*** SUMMARY ***
Total pot $1.25 | Rake $0 
Seat 1: sno05 collected ($1.25)
Seat 2: cjzm folded before Flop (didn't bet)
Seat 3: Dr.Mouse102 folded before Flop (didn't bet)
Seat 5: bigkahuna380 folded before Flop (didn't bet)
Seat 6: sophie2000 (button) folded before Flop (didn't bet)
Seat 7: 23SmOkEr07 (small blind) folded before Flop
Seat 8: matiko09 (big blind) folded before Flop
Seat 9: tugboat2008 folded before Flop (didn't bet)





PokerStars Hand #154969933146:  Hold'em No Limit ($0.25/$0.50 USD) - 2016/06/20 12:18:27 CET [2016/06/20 6:18:27 ET]
Table 'Memoria II' 9-max Seat #5 is the button
Seat 2: matiko09 ($50.75 in chips) 
Seat 3: ljryviltj ($54.23 in chips) 
Seat 4: St.LaCoste ($65.95 in chips) 
Seat 5: kiev-city12 ($36.87 in chips) 
Seat 6: Kukuryzka ($50 in chips) 
Seat 8: mi$$I$Elena ($50 in chips) 
Seat 9: djammusic ($23.86 in chips) 
Kukuryzka: posts small blind $0.25
Zeeshka: is sitting out 
mi$$I$Elena: posts big blind $0.50
*** HOLE CARDS ***
Dealt to matiko09 [3c Tc]
Zeeshka leaves the table
djammusic: folds 
mixer29 joins the table at seat #7 
matiko09: folds 
mixer29 leaves the table
ljryviltj: folds 
tallonn88 joins the table at seat #7 
St.LaCoste: raises $1 to $1.50
kiev-city12: calls $1.50
Kukuryzka: folds 
mi$$I$Elena: folds 
*** FLOP *** [8s 7d Jh]
St.LaCoste: bets $2.59
kiev-city12: calls $2.59
*** TURN *** [8s 7d Jh] [Jc]
St.LaCoste: checks 
kiev-city12: bets $4
St.LaCoste: calls $4
*** RIVER *** [8s 7d Jh Jc] [Ks]
St.LaCoste: checks 
kiev-city12: checks 
*** SHOW DOWN ***
St.LaCoste: shows [Ac As] (two pair, Aces and Jacks)
kiev-city12: mucks hand 
St.LaCoste collected $16.08 from pot
*** SUMMARY ***
Total pot $16.93 | Rake $0.85 
Board [8s 7d Jh Jc Ks]
Seat 2: matiko09 folded before Flop (didn't bet)
Seat 3: ljryviltj folded before Flop (didn't bet)
Seat 4: St.LaCoste showed [Ac As] and won ($16.08) with two pair, Aces and Jacks
Seat 5: kiev-city12 (button) mucked [6c 5c]
Seat 6: Kukuryzka (small blind) folded before Flop
Seat 8: mi$$I$Elena (big blind) folded before Flop
Seat 9: djammusic folded before Flop (didn't bet)





PokerStars Hand #154969938669:  Hold'em No Limit (£0.25/£0.50 GBP) - 2016/06/20 12:18:42 CET [2016/06/20 6:18:42 ET]
Table 'Azalea' 6-max Seat #1 is the button
Seat 1: mitsuVK (£50 in chips) 
Seat 2: matiko09 (£81.85 in chips) 
Seat 3: VahTang_89 (£50.47 in chips) 
Seat 5: mudders693 (£71.44 in chips) 
Seat 6: Bënedic10 (£51.82 in chips) 
matiko09: posts small blind £0.25
VahTang_89: posts big blind £0.50
*** HOLE CARDS ***
Dealt to matiko09 [2d 5d]
mudders693: raises £0.50 to £1
Bënedic10: calls £1
mitsuVK: folds 
matiko09: folds 
VahTang_89: folds 
*** FLOP *** [Th Ac 9c]
mudders693: checks 
Bënedic10: bets £2.50
mudders693: folds 
Uncalled bet (£2.50) returned to Bënedic10
Bënedic10 collected £2.61 from pot
Bënedic10: doesn't show hand 
*** SUMMARY ***
Total pot £2.75 | Rake £0.14 
Board [Th Ac 9c]
Seat 1: mitsuVK (button) folded before Flop (didn't bet)
Seat 2: matiko09 (small blind) folded before Flop
Seat 3: VahTang_89 (big blind) folded before Flop
Seat 5: mudders693 folded on the Flop
Seat 6: Bënedic10 collected (£2.61)





PokerStars Hand #154969942082:  Hold'em No Limit (£0.25/£0.50 GBP) - 2016/06/20 12:18:51 CET [2016/06/20 6:18:51 ET]
Table 'Ani' 6-max Seat #1 is the button
Seat 1: rewq99887788 (£50.12 in chips) 
Seat 2: joker180785 (£52.49 in chips) 
Seat 3: Doobes8555 (£74.09 in chips) 
Seat 4: matiko09 (£50 in chips) 
Seat 5: Wwwasian (£61.53 in chips) 
Seat 6: faceMyBallz_ (£54.67 in chips) 
joker180785: posts small blind £0.25
Doobes8555: posts big blind £0.50
*** HOLE CARDS ***
Dealt to matiko09 [Qh 9h]
matiko09: folds 
Wwwasian: folds 
faceMyBallz_: folds 
rewq99887788: folds 
joker180785: folds 
Uncalled bet (£0.25) returned to Doobes8555
Doobes8555 collected £0.50 from pot
Doobes8555: doesn't show hand 
*** SUMMARY ***
Total pot £0.50 | Rake £0 
Seat 1: rewq99887788 (button) folded before Flop (didn't bet)
Seat 2: joker180785 (small blind) folded before Flop
Seat 3: Doobes8555 (big blind) collected (£0.50)
Seat 4: matiko09 folded before Flop (didn't bet)
Seat 5: Wwwasian folded before Flop (didn't bet)
Seat 6: faceMyBallz_ folded before Flop (didn't bet)





PokerStars Hand #154969942617:  Hold'em No Limit ($0.50/$1.00 USD) - 2016/06/20 12:18:53 CET [2016/06/20 6:18:53 ET]
Table 'Ernestina' 9-max Seat #5 is the button
Seat 1: diva3150 ($75.18 in chips) 
Seat 2: matiko09 ($100 in chips) 
Seat 4: SkUhNi ($102.02 in chips) 
Seat 5: DomiVY ($40 in chips) 
Seat 6: arctur17 ($94.30 in chips) 
Seat 7: Filojoes ($119.91 in chips) 
Seat 8: ruslik_by ($306.94 in chips) 
Seat 9: 23SmOkEr07 ($100 in chips) 
arctur17: posts small blind $0.50
Filojoes: posts big blind $1
Pvsx.: sits out 
*** HOLE CARDS ***
Dealt to matiko09 [Ts 5s]
ruslik_by: folds 
23SmOkEr07: raises $1.50 to $2.50
diva3150: folds 
matiko09: folds 
SkUhNi: folds 
DomiVY: folds 
arctur17: folds 
Filojoes: folds 
Uncalled bet ($1.50) returned to 23SmOkEr07
23SmOkEr07 collected $2.50 from pot
23SmOkEr07: doesn't show hand 
*** SUMMARY ***
Total pot $2.50 | Rake $0 
Seat 1: diva3150 folded before Flop (didn't bet)
Seat 2: matiko09 folded before Flop (didn't bet)
Seat 4: SkUhNi folded before Flop (didn't bet)
Seat 5: DomiVY (button) folded before Flop (didn't bet)
Seat 6: arctur17 (small blind) folded before Flop
Seat 7: Filojoes (big blind) folded before Flop
Seat 8: ruslik_by folded before Flop (didn't bet)
Seat 9: 23SmOkEr07 collected ($2.50)





PokerStars Hand #154969943530:  Hold'em No Limit ($0.50/$1.00 USD) - 2016/06/20 12:18:55 CET [2016/06/20 6:18:55 ET]
Table 'Ambrosia II' 9-max Seat #7 is the button
Seat 1: 23SmOkEr07 ($109.57 in chips) 
Seat 2: Eyeballz1307 ($58 in chips) 
Seat 3: mavin80 ($78.18 in chips) 
Seat 4: mi$$I$Elena ($128.12 in chips) 
Seat 5: Mattulh ($112.52 in chips) 
Seat 6: ruslik_by ($137.98 in chips) 
Seat 7: matiko09 ($106 in chips) 
Seat 8: hammerwife ($100.50 in chips) 
Seat 9: SkUhNi ($105.35 in chips) 
hammerwife: posts small blind $0.50
SkUhNi: posts big blind $1
*** HOLE CARDS ***
Dealt to matiko09 [5h 3s]
23SmOkEr07: folds 
Eyeballz1307: calls $1
mavin80: calls $1
mi$$I$Elena: folds 
Mattulh: calls $1
ruslik_by: folds 
matiko09: folds 
hammerwife: folds 
SkUhNi: checks 
*** FLOP *** [As 2c 8c]
SkUhNi: checks 
Eyeballz1307: checks 
mavin80: checks 
Mattulh: bets $4
SkUhNi: calls $4
Eyeballz1307: calls $4
mavin80: folds 
*** TURN *** [As 2c 8c] [6c]
SkUhNi: checks 
Eyeballz1307: checks 
Mattulh: checks 
*** RIVER *** [As 2c 8c 6c] [Qh]
SkUhNi: checks 
Eyeballz1307: checks 
Mattulh: bets $10
SkUhNi: folds 
Eyeballz1307: raises $15 to $25
Mattulh: folds 
Uncalled bet ($15) returned to Eyeballz1307
Eyeballz1307 collected $34.68 from pot
Eyeballz1307: doesn't show hand 
*** SUMMARY ***
Total pot $36.50 | Rake $1.82 
Board [As 2c 8c 6c Qh]
Seat 1: 23SmOkEr07 folded before Flop (didn't bet)
Seat 2: Eyeballz1307 collected ($34.68)
Seat 3: mavin80 folded on the Flop
Seat 4: mi$$I$Elena folded before Flop (didn't bet)
Seat 5: Mattulh folded on the River
Seat 6: ruslik_by folded before Flop (didn't bet)
Seat 7: matiko09 (button) folded before Flop (didn't bet)
Seat 8: hammerwife (small blind) folded before Flop
Seat 9: SkUhNi (big blind) folded on the River





PokerStars Hand #154969945665:  Hold'em No Limit ($0.25/$0.50 USD) - 2016/06/20 12:19:01 CET [2016/06/20 6:19:01 ET]
Table 'Juliana II' 9-max Seat #7 is the button
Seat 1: sno05 ($30.83 in chips) 
Seat 2: cjzm ($59.58 in chips) 
Seat 3: Dr.Mouse102 ($50 in chips) 
Seat 5: bigkahuna380 ($33.11 in chips) 
Seat 6: sophie2000 ($50 in chips) 
Seat 7: 23SmOkEr07 ($58.76 in chips) 
Seat 8: matiko09 ($50 in chips) 
Seat 9: tugboat2008 ($63.45 in chips) 
matiko09: posts small blind $0.25
tugboat2008: posts big blind $0.50
RICKA16: sits out 
*** HOLE CARDS ***
Dealt to matiko09 [9h Qc]
sno05 has timed out
sno05: folds 
cjzm: raises $0.50 to $1
Dr.Mouse102: folds 
bigkahuna380: folds 
sophie2000: folds 
23SmOkEr07: folds 
matiko09: folds 
tugboat2008: calls $0.50
*** FLOP *** [7h 3d 2s]
tugboat2008: checks 
cjzm: bets $1.50
tugboat2008: calls $1.50
*** TURN *** [7h 3d 2s] [4c]
tugboat2008: checks 
cjzm: checks 
*** RIVER *** [7h 3d 2s 4c] [5d]
tugboat2008: bets $3.29
cjzm: calls $3.29
*** SHOW DOWN ***
tugboat2008: shows [6s 7c] (a straight, Three to Seven)
cjzm: mucks hand 
tugboat2008 collected $11.24 from pot
*** SUMMARY ***
Total pot $11.83 | Rake $0.59 
Board [7h 3d 2s 4c 5d]
Seat 1: sno05 folded before Flop (didn't bet)
Seat 2: cjzm mucked [8d 8c]
Seat 3: Dr.Mouse102 folded before Flop (didn't bet)
Seat 5: bigkahuna380 folded before Flop (didn't bet)
Seat 6: sophie2000 folded before Flop (didn't bet)
Seat 7: 23SmOkEr07 (button) folded before Flop (didn't bet)
Seat 8: matiko09 (small blind) folded before Flop
Seat 9: tugboat2008 (big blind) showed [6s 7c] and won ($11.24) with a straight, Three to Seven





PokerStars Hand #154969946616:  Hold'em No Limit ($0.25/$0.50 USD) - 2016/06/20 12:19:03 CET [2016/06/20 6:19:03 ET]
Table 'Scheddi II' 9-max Seat #2 is the button
Seat 1: matiko09 ($50 in chips) 
Seat 2: Yaaaazz ($50.22 in chips) 
Seat 5: No Money NW ($42.51 in chips) 
Seat 6: joker180785 ($55.70 in chips) 
Seat 7: HopeMayBee ($58.37 in chips) 
Seat 9: Infinitinium ($139.39 in chips) 
No Money NW: posts small blind $0.25
joker180785: posts big blind $0.50
matiko09: posts the ante $0.10
Yaaaazz: posts the ante $0.10
No Money NW: posts the ante $0.10
joker180785: posts the ante $0.10
HopeMayBee: posts the ante $0.10
Infinitinium: posts the ante $0.10
*** HOLE CARDS ***
Dealt to matiko09 [7h Jc]
HopeMayBee: raises $1 to $1.50
Infinitinium: folds 
matiko09: folds 
Yaaaazz: folds 
No Money NW: calls $1.25
joker180785: calls $1
*** FLOP *** [9d 8d 2h]
No Money NW: bets $2.50
joker180785: calls $2.50
HopeMayBee: folds 
*** TURN *** [9d 8d 2h] [2c]
No Money NW: checks 
joker180785: bets $6.50
No Money NW: calls $6.50
*** RIVER *** [9d 8d 2h 2c] [Qs]
No Money NW: checks 
joker180785: checks 
*** SHOW DOWN ***
No Money NW: shows [8c 7c] (two pair, Eights and Deuces)
joker180785: shows [Th 9h] (two pair, Nines and Deuces)
joker180785 collected $21.94 from pot
*** SUMMARY ***
Total pot $23.10 | Rake $1.16 
Board [9d 8d 2h 2c Qs]
Seat 1: matiko09 folded before Flop (didn't bet)
Seat 2: Yaaaazz (button) folded before Flop (didn't bet)
Seat 5: No Money NW (small blind) showed [8c 7c] and lost with two pair, Eights and Deuces
Seat 6: joker180785 (big blind) showed [Th 9h] and won ($21.94) with two pair, Nines and Deuces
Seat 7: HopeMayBee folded on the Flop
Seat 9: Infinitinium folded before Flop (didn't bet)





PokerStars Hand #154969946346:  Hold'em No Limit (£0.25/£0.50 GBP) - 2016/06/20 12:19:03 CET [2016/06/20 6:19:03 ET]
Table 'Ani' 6-max Seat #2 is the button
Seat 1: rewq99887788 (£50.12 in chips) 
Seat 2: joker180785 (£52.24 in chips) 
Seat 3: Doobes8555 (£74.34 in chips) 
Seat 4: matiko09 (£50 in chips) 
Seat 5: Wwwasian (£61.53 in chips) 
Seat 6: faceMyBallz_ (£54.67 in chips) 
Doobes8555: posts small blind £0.25
matiko09: posts big blind £0.50
*** HOLE CARDS ***
Dealt to matiko09 [7h Kh]
Wwwasian: folds 
faceMyBallz_: folds 
rewq99887788: folds 
joker180785: folds 
Doobes8555: calls £0.25
matiko09: raises £1.50 to £2
Doobes8555: folds 
Uncalled bet (£1.50) returned to matiko09
matiko09 collected £1 from pot
matiko09: doesn't show hand 
*** SUMMARY ***
Total pot £1 | Rake £0 
Seat 1: rewq99887788 folded before Flop (didn't bet)
Seat 2: joker180785 (button) folded before Flop (didn't bet)
Seat 3: Doobes8555 (small blind) folded before Flop
Seat 4: matiko09 (big blind) collected (£1)
Seat 5: Wwwasian folded before Flop (didn't bet)
Seat 6: faceMyBallz_ folded before Flop (didn't bet)





PokerStars Hand #154969947796:  Hold'em No Limit ($0.50/$1.00 USD) - 2016/06/20 12:19:06 CET [2016/06/20 6:19:06 ET]
Table 'Anhui' 9-max Seat #2 is the button
Seat 1: SkUhNi ($152.42 in chips) 
Seat 2: ruslik_by ($262.85 in chips) 
Seat 3: Filojoes ($100 in chips) 
Seat 4: mavin80 ($38.86 in chips) 
Seat 5: mi$$I$Elena ($100 in chips) 
Seat 6: 23SmOkEr07 ($134.75 in chips) 
Seat 7: matiko09 ($136 in chips) 
Seat 8: blackmont111 ($80 in chips) 
Filojoes: posts small blind $0.50
mavin80: posts big blind $1
blackmont111: posts big blind $1
TomBod1: sits out 
*** HOLE CARDS ***
Dealt to matiko09 [As 7d]
mi$$I$Elena: folds 
23SmOkEr07: folds 
matiko09: folds 
blackmont111: checks 
SkUhNi: folds 
ruslik_by: folds 
Filojoes: calls $0.50
mavin80: checks 
*** FLOP *** [Qd 5h Qh]
Filojoes: checks 
mavin80: bets $1.30
blackmont111: folds 
Filojoes: calls $1.30
*** TURN *** [Qd 5h Qh] [Qs]
Filojoes: checks 
mavin80: bets $3.40
Filojoes: folds 
Uncalled bet ($3.40) returned to mavin80
mavin80 collected $5.32 from pot
*** SUMMARY ***
Total pot $5.60 | Rake $0.28 
Board [Qd 5h Qh Qs]
Seat 1: SkUhNi folded before Flop (didn't bet)
Seat 2: ruslik_by (button) folded before Flop (didn't bet)
Seat 3: Filojoes (small blind) folded on the Turn
Seat 4: mavin80 (big blind) collected ($5.32)
Seat 5: mi$$I$Elena folded before Flop (didn't bet)
Seat 6: 23SmOkEr07 folded before Flop (didn't bet)
Seat 7: matiko09 folded before Flop (didn't bet)
Seat 8: blackmont111 folded on the Flop





PokerStars Hand #154969951373:  Hold'em No Limit ($0.50/$1.00 USD) - 2016/06/20 12:19:16 CET [2016/06/20 6:19:16 ET]
Table 'Pongola' 9-max Seat #6 is the button
Seat 1: matiko09 ($100 in chips) 
Seat 2: ruslik_by ($136 in chips) 
Seat 3: SkUhNi ($100 in chips) 
Seat 4: karllv ($121.29 in chips) 
Seat 5: joker180785 ($105.93 in chips) 
Seat 6: 23SmOkEr07 ($106.64 in chips) 
Seat 7: Prophet1906 ($100 in chips) 
Seat 8: phrantique ($154.32 in chips) 
Seat 9: blackw0lf_03 ($100 in chips) 
Prophet1906: posts small blind $0.50
phrantique: posts big blind $1
*** HOLE CARDS ***
Dealt to matiko09 [4c 6d]
blackw0lf_03: folds 
matiko09: folds 
ruslik_by: folds 
SkUhNi: folds 
karllv: folds 
joker180785: raises $1.50 to $2.50
23SmOkEr07: folds 
Prophet1906: folds 
phrantique: folds 
Uncalled bet ($1.50) returned to joker180785
joker180785 collected $2.50 from pot
*** SUMMARY ***
Total pot $2.50 | Rake $0 
Seat 1: matiko09 folded before Flop (didn't bet)
Seat 2: ruslik_by folded before Flop (didn't bet)
Seat 3: SkUhNi folded before Flop (didn't bet)
Seat 4: karllv folded before Flop (didn't bet)
Seat 5: joker180785 collected ($2.50)
Seat 6: 23SmOkEr07 (button) folded before Flop (didn't bet)
Seat 7: Prophet1906 (small blind) folded before Flop
Seat 8: phrantique (big blind) folded before Flop
Seat 9: blackw0lf_03 folded before Flop (didn't bet)





PokerStars Hand #154969952297:  Hold'em No Limit (£0.25/£0.50 GBP) - 2016/06/20 12:19:18 CET [2016/06/20 6:19:18 ET]
Table 'Ani' 6-max Seat #3 is the button
Seat 1: rewq99887788 (£50.12 in chips) 
Seat 2: joker180785 (£52.24 in chips) 
Seat 3: Doobes8555 (£73.84 in chips) 
Seat 4: matiko09 (£50.50 in chips) 
Seat 5: Wwwasian (£61.53 in chips) 
Seat 6: faceMyBallz_ (£54.67 in chips) 
matiko09: posts small blind £0.25
Wwwasian: posts big blind £0.50
*** HOLE CARDS ***
Dealt to matiko09 [2c Qs]
faceMyBallz_: folds 
rewq99887788: folds 
joker180785: raises £1 to £1.50
Doobes8555: folds 
matiko09: folds 
Wwwasian: calls £1
*** FLOP *** [9h 5c 8d]
Wwwasian: checks 
joker180785: bets £0.50
Wwwasian: raises £0.50 to £1
joker180785: calls £0.50
*** TURN *** [9h 5c 8d] [As]
Wwwasian: bets £4.44
joker180785: folds 
Uncalled bet (£4.44) returned to Wwwasian
Wwwasian collected £4.99 from pot
Wwwasian: doesn't show hand 
*** SUMMARY ***
Total pot £5.25 | Rake £0.26 
Board [9h 5c 8d As]
Seat 1: rewq99887788 folded before Flop (didn't bet)
Seat 2: joker180785 folded on the Turn
Seat 3: Doobes8555 (button) folded before Flop (didn't bet)
Seat 4: matiko09 (small blind) folded before Flop
Seat 5: Wwwasian (big blind) collected (£4.99)
Seat 6: faceMyBallz_ folded before Flop (didn't bet)





PokerStars Hand #154969954639:  Hold'em No Limit (£0.25/£0.50 GBP) - 2016/06/20 12:19:25 CET [2016/06/20 6:19:25 ET]
Table 'Azalea' 6-max Seat #2 is the button
Seat 1: mitsuVK (£50 in chips) 
Seat 2: matiko09 (£81.60 in chips) 
Seat 3: VahTang_89 (£50 in chips) 
Seat 5: mudders693 (£70.44 in chips) 
Seat 6: Bënedic10 (£53.43 in chips) 
VahTang_89: posts small blind £0.25
Wwwasian was removed from the table for failing to post
mudders693: posts big blind £0.50
*** HOLE CARDS ***
Dealt to matiko09 [Qh 3c]
VodkinFirst joins the table at seat #4 
VodkinFirst leaves the table
Bënedic10: raises £0.75 to £1.25
faceMyBallz_ joins the table at seat #4 
mitsuVK: folds 
matiko09: folds 
VahTang_89: folds 
mudders693: raises £2.75 to £4
Bënedic10: calls £2.75
*** FLOP *** [9d 5h 5s]
mudders693: checks 
Bënedic10: checks 
*** TURN *** [9d 5h 5s] [2c]
mudders693: checks 
Bënedic10: checks 
*** RIVER *** [9d 5h 5s 2c] [7h]
mudders693: checks 
Bënedic10: bets £11.83
mudders693: folds 
Uncalled bet (£11.83) returned to Bënedic10
Bënedic10 collected £7.84 from pot
Bënedic10: doesn't show hand 
*** SUMMARY ***
Total pot £8.25 | Rake £0.41 
Board [9d 5h 5s 2c 7h]
Seat 1: mitsuVK folded before Flop (didn't bet)
Seat 2: matiko09 (button) folded before Flop (didn't bet)
Seat 3: VahTang_89 (small blind) folded before Flop
Seat 5: mudders693 (big blind) folded on the River
Seat 6: Bënedic10 collected (£7.84)





PokerStars Hand #154969958529:  Hold'em No Limit ($0.50/$1.00 USD) - 2016/06/20 12:19:35 CET [2016/06/20 6:19:35 ET]
Table 'Albiorix' 9-max Seat #4 is the button
Seat 1: arctur17 ($77.28 in chips) 
Seat 2: SkUhNi ($151.52 in chips) 
Seat 3: matiko09 ($101 in chips) 
Seat 4: 23SmOkEr07 ($100 in chips) 
Seat 5: ruslik_by ($103.75 in chips) 
Seat 6: joker180785 ($116.81 in chips) 
Seat 7: Pekyto ($38.50 in chips) 
Seat 8: smiley0221 ($137.23 in chips) 
Seat 9: Coolller ($102.97 in chips) 
ruslik_by: posts small blind $0.50
joker180785: posts big blind $1
*** HOLE CARDS ***
Dealt to matiko09 [Th 9d]
Pekyto: raises $2 to $3
smiley0221: calls $3
Coolller: folds 
arctur17: folds 
SkUhNi: folds 
matiko09: folds 
23SmOkEr07: raises $10.50 to $13.50
ruslik_by: folds 
joker180785: calls $12.50
Pekyto: folds 
smiley0221: calls $10.50
*** FLOP *** [7h 4c 7s]
joker180785: bets $17
smiley0221: folds 
23SmOkEr07: raises $69.50 to $86.50 and is all-in
joker180785: folds 
Uncalled bet ($69.50) returned to 23SmOkEr07
23SmOkEr07 collected $75.50 from pot
23SmOkEr07: doesn't show hand 
*** SUMMARY ***
Total pot $78 | Rake $2.50 
Board [7h 4c 7s]
Seat 1: arctur17 folded before Flop (didn't bet)
Seat 2: SkUhNi folded before Flop (didn't bet)
Seat 3: matiko09 folded before Flop (didn't bet)
Seat 4: 23SmOkEr07 (button) collected ($75.50)
Seat 5: ruslik_by (small blind) folded before Flop
Seat 6: joker180785 (big blind) folded on the Flop
Seat 7: Pekyto folded before Flop
Seat 8: smiley0221 folded on the Flop
Seat 9: Coolller folded before Flop (didn't bet)





PokerStars Hand #154969959701:  Hold'em No Limit (€0.50/€1.00 EUR) - 2016/06/20 12:19:38 CET [2016/06/20 6:19:38 ET]
Table 'Austrasia II' 9-max Seat #2 is the button
Seat 1: Kukuryzka (€100 in chips) 
Seat 2: hammerwife (€100 in chips) 
Seat 3: Filojoes (€100 in chips) 
Seat 4: matiko09 (€100 in chips) 
Seat 9: stijner1986 (€109.25 in chips) 
Filojoes: posts small blind €0.50
matiko09: posts big blind €1
SkUhNi: sits out 
*** HOLE CARDS ***
Dealt to matiko09 [6s 8s]
stijner1986: folds 
Kukuryzka: folds 
hammerwife: folds 
Filojoes: raises €1.50 to €2.50
matiko09: raises €6.50 to €9
Filojoes: folds 
Uncalled bet (€6.50) returned to matiko09
matiko09 collected €5 from pot
matiko09: doesn't show hand 
*** SUMMARY ***
Total pot €5 | Rake €0 
Seat 1: Kukuryzka folded before Flop (didn't bet)
Seat 2: hammerwife (button) folded before Flop (didn't bet)
Seat 3: Filojoes (small blind) folded before Flop
Seat 4: matiko09 (big blind) collected (€5)
Seat 9: stijner1986 folded before Flop (didn't bet)





PokerStars Hand #154969963053:  Hold'em No Limit ($0.50/$1.00 USD) - 2016/06/20 12:19:47 CET [2016/06/20 6:19:47 ET]
Table 'Pongola' 9-max Seat #7 is the button
Seat 1: matiko09 ($100 in chips) 
Seat 2: ruslik_by ($136 in chips) 
Seat 3: SkUhNi ($100 in chips) 
Seat 4: karllv ($121.29 in chips) 
Seat 5: joker180785 ($107.43 in chips) 
Seat 6: 23SmOkEr07 ($106.64 in chips) 
Seat 7: Prophet1906 ($100 in chips) 
Seat 8: phrantique ($153.32 in chips) 
phrantique: posts small blind $0.50
blackw0lf_03: is sitting out 
matiko09: posts big blind $1
*** HOLE CARDS ***
Dealt to matiko09 [6s Td]
blackw0lf_03 leaves the table
Filojoes joins the table at seat #9 
ruslik_by: folds 
SkUhNi: folds 
karllv: folds 
joker180785: folds 
23SmOkEr07: folds 
Prophet1906: folds 
phrantique: raises $2 to $3
matiko09: folds 
Uncalled bet ($2) returned to phrantique
phrantique collected $2 from pot
*** SUMMARY ***
Total pot $2 | Rake $0 
Seat 1: matiko09 (big blind) folded before Flop
Seat 2: ruslik_by folded before Flop (didn't bet)
Seat 3: SkUhNi folded before Flop (didn't bet)
Seat 4: karllv folded before Flop (didn't bet)
Seat 5: joker180785 folded before Flop (didn't bet)
Seat 6: 23SmOkEr07 folded before Flop (didn't bet)
Seat 7: Prophet1906 (button) folded before Flop (didn't bet)
Seat 8: phrantique (small blind) collected ($2)





PokerStars Hand #154969963630:  Hold'em No Limit ($0.50/$1.00 USD) - 2016/06/20 12:19:49 CET [2016/06/20 6:19:49 ET]
Table 'Ernestina' 9-max Seat #6 is the button
Seat 1: diva3150 ($75.18 in chips) 
Seat 2: matiko09 ($100 in chips) 
Seat 4: SkUhNi ($102.02 in chips) 
Seat 5: DomiVY ($40 in chips) 
Seat 6: arctur17 ($93.80 in chips) 
Seat 7: Filojoes ($118.91 in chips) 
Seat 8: ruslik_by ($306.94 in chips) 
Seat 9: 23SmOkEr07 ($101.50 in chips) 
Filojoes: posts small blind $0.50
ruslik_by: posts big blind $1
Pvsx.: sits out 
*** HOLE CARDS ***
Dealt to matiko09 [4s 9d]
23SmOkEr07: folds 
diva3150: folds 
matiko09: folds 
SkUhNi: folds 
DomiVY: folds 
arctur17: folds 
Filojoes: folds 
Uncalled bet ($0.50) returned to ruslik_by
ruslik_by collected $1 from pot
ruslik_by: doesn't show hand 
*** SUMMARY ***
Total pot $1 | Rake $0 
Seat 1: diva3150 folded before Flop (didn't bet)
Seat 2: matiko09 folded before Flop (didn't bet)
Seat 4: SkUhNi folded before Flop (didn't bet)
Seat 5: DomiVY folded before Flop (didn't bet)
Seat 6: arctur17 (button) folded before Flop (didn't bet)
Seat 7: Filojoes (small blind) folded before Flop
Seat 8: ruslik_by (big blind) collected ($1)
Seat 9: 23SmOkEr07 folded before Flop (didn't bet)





PokerStars Hand #154969968439:  Hold'em No Limit ($0.25/$0.50 USD) - 2016/06/20 12:20:02 CET [2016/06/20 6:20:02 ET]
Table 'Scheddi II' 9-max Seat #5 is the button
Seat 1: matiko09 ($50 in chips) 
Seat 2: Yaaaazz ($50.12 in chips) 
Seat 5: No Money NW ($31.91 in chips) 
Seat 6: joker180785 ($67.04 in chips) 
Seat 7: HopeMayBee ($56.77 in chips) 
Seat 9: Infinitinium ($139.29 in chips) 
joker180785: posts small blind $0.25
HopeMayBee: posts big blind $0.50
matiko09: posts the ante $0.10
Yaaaazz: posts the ante $0.10
No Money NW: posts the ante $0.10
joker180785: posts the ante $0.10
HopeMayBee: posts the ante $0.10
Infinitinium: posts the ante $0.10
*** HOLE CARDS ***
Dealt to matiko09 [7s 8s]
Infinitinium: folds 
matiko09: raises $1 to $1.50
Yaaaazz: folds 
No Money NW: folds 
joker180785: calls $1.25
HopeMayBee: folds 
*** FLOP *** [5s Kh 9s]
joker180785: checks 
matiko09: bets $2.54
joker180785: folds 
Uncalled bet ($2.54) returned to matiko09
matiko09 collected $3.90 from pot
matiko09: doesn't show hand 
*** SUMMARY ***
Total pot $4.10 | Rake $0.20 
Board [5s Kh 9s]
Seat 1: matiko09 collected ($3.90)
Seat 2: Yaaaazz folded before Flop (didn't bet)
Seat 5: No Money NW (button) folded before Flop (didn't bet)
Seat 6: joker180785 (small blind) folded on the Flop
Seat 7: HopeMayBee (big blind) folded before Flop
Seat 9: Infinitinium folded before Flop (didn't bet)





PokerStars Hand #154969969807:  Hold'em No Limit ($0.25/$0.50 USD) - 2016/06/20 12:20:05 CET [2016/06/20 6:20:05 ET]
Table 'Memoria II' 9-max Seat #6 is the button
Seat 2: matiko09 ($50.75 in chips) 
Seat 3: ljryviltj ($54.23 in chips) 
Seat 4: St.LaCoste ($73.94 in chips) 
Seat 5: kiev-city12 ($28.78 in chips) 
Seat 6: Kukuryzka ($49.75 in chips) 
Seat 8: mi$$I$Elena ($50 in chips) 
Seat 9: djammusic ($23.86 in chips) 
tallonn88 will be allowed to play after the button
mi$$I$Elena: posts small blind $0.25
djammusic: posts big blind $0.50
*** HOLE CARDS ***
Dealt to matiko09 [Kd 6c]
matiko09: folds 
ljryviltj: folds 
St.LaCoste: folds 
kiev-city12: raises $0.50 to $1
Kukuryzka: folds 
mi$$I$Elena: folds 
djammusic: calls $0.50
*** FLOP *** [7s Qh Kh]
djammusic: checks 
kiev-city12: checks 
*** TURN *** [7s Qh Kh] [5d]
djammusic: checks 
kiev-city12: checks 
*** RIVER *** [7s Qh Kh 5d] [Qs]
djammusic: bets $1.82
kiev-city12: folds 
Uncalled bet ($1.82) returned to djammusic
djammusic collected $2.14 from pot
djammusic: doesn't show hand 
*** SUMMARY ***
Total pot $2.25 | Rake $0.11 
Board [7s Qh Kh 5d Qs]
Seat 2: matiko09 folded before Flop (didn't bet)
Seat 3: ljryviltj folded before Flop (didn't bet)
Seat 4: St.LaCoste folded before Flop (didn't bet)
Seat 5: kiev-city12 folded on the River
Seat 6: Kukuryzka (button) folded before Flop (didn't bet)
Seat 8: mi$$I$Elena (small blind) folded before Flop
Seat 9: djammusic (big blind) collected ($2.14)





PokerStars Hand #154969970541:  Hold'em No Limit (£0.25/£0.50 GBP) - 2016/06/20 12:20:07 CET [2016/06/20 6:20:07 ET]
Table 'Ani' 6-max Seat #4 is the button
Seat 1: rewq99887788 (£50.12 in chips) 
Seat 2: joker180785 (£50 in chips) 
Seat 3: Doobes8555 (£73.84 in chips) 
Seat 4: matiko09 (£50.25 in chips) 
Seat 5: Wwwasian (£64.02 in chips) 
Seat 6: faceMyBallz_ (£54.67 in chips) 
Wwwasian: posts small blind £0.25
faceMyBallz_: posts big blind £0.50
*** HOLE CARDS ***
Dealt to matiko09 [Ks 2h]
rewq99887788: folds 
joker180785: folds 
Doobes8555: calls £0.50
matiko09: folds 
Wwwasian: folds 
faceMyBallz_: checks 
*** FLOP *** [7h Ah 2s]
faceMyBallz_: checks 
Doobes8555: checks 
*** TURN *** [7h Ah 2s] [6c]
faceMyBallz_: bets £0.50
Doobes8555: folds 
Uncalled bet (£0.50) returned to faceMyBallz_
faceMyBallz_ collected £1.19 from pot
faceMyBallz_: doesn't show hand 
*** SUMMARY ***
Total pot £1.25 | Rake £0.06 
Board [7h Ah 2s 6c]
Seat 1: rewq99887788 folded before Flop (didn't bet)
Seat 2: joker180785 folded before Flop (didn't bet)
Seat 3: Doobes8555 folded on the Turn
Seat 4: matiko09 (button) folded before Flop (didn't bet)
Seat 5: Wwwasian (small blind) folded before Flop
Seat 6: faceMyBallz_ (big blind) collected (£1.19)





PokerStars Hand #154969972476:  Hold'em No Limit ($0.50/$1.00 USD) - 2016/06/20 12:20:13 CET [2016/06/20 6:20:13 ET]
Table 'Anhui' 9-max Seat #3 is the button
Seat 1: SkUhNi ($152.42 in chips) 
Seat 2: ruslik_by ($262.85 in chips) 
Seat 3: Filojoes ($100 in chips) 
Seat 4: mavin80 ($41.88 in chips) 
Seat 5: mi$$I$Elena ($100 in chips) 
Seat 6: 23SmOkEr07 ($134.75 in chips) 
Seat 7: matiko09 ($136 in chips) 
Seat 8: blackmont111 ($79 in chips) 
mavin80: posts small blind $0.50
mi$$I$Elena: posts big blind $1
TomBod1: sits out 
*** HOLE CARDS ***
Dealt to matiko09 [3d 9h]
23SmOkEr07: folds 
matiko09: folds 
blackmont111: folds 
SkUhNi: raises $2 to $3
ruslik_by: folds 
Filojoes: folds 
mavin80: folds 
mi$$I$Elena: folds 
Uncalled bet ($2) returned to SkUhNi
SkUhNi collected $2.50 from pot
SkUhNi: doesn't show hand 
*** SUMMARY ***
Total pot $2.50 | Rake $0 
Seat 1: SkUhNi collected ($2.50)
Seat 2: ruslik_by folded before Flop (didn't bet)
Seat 3: Filojoes (button) folded before Flop (didn't bet)
Seat 4: mavin80 (small blind) folded before Flop
Seat 5: mi$$I$Elena (big blind) folded before Flop
Seat 6: 23SmOkEr07 folded before Flop (didn't bet)
Seat 7: matiko09 folded before Flop (didn't bet)
Seat 8: blackmont111 folded before Flop (didn't bet)





PokerStars Hand #154969972864:  Hold'em No Limit ($0.50/$1.00 USD) - 2016/06/20 12:20:14 CET [2016/06/20 6:20:14 ET]
Table 'Ernestina' 9-max Seat #7 is the button
Seat 1: diva3150 ($75.18 in chips) 
Seat 2: matiko09 ($100 in chips) 
Seat 4: SkUhNi ($102.02 in chips) 
Seat 5: DomiVY ($40 in chips) 
Seat 6: arctur17 ($93.80 in chips) 
Seat 7: Filojoes ($118.41 in chips) 
Seat 8: ruslik_by ($307.44 in chips) 
Seat 9: 23SmOkEr07 ($101.50 in chips) 
ruslik_by: posts small blind $0.50
23SmOkEr07: posts big blind $1
Pvsx.: sits out 
*** HOLE CARDS ***
Dealt to matiko09 [3d 7d]
diva3150: folds 
matiko09: folds 
SkUhNi: folds 
DomiVY: folds 
arctur17: raises $1 to $2
Filojoes: folds 
ruslik_by: folds 
23SmOkEr07: folds 
Uncalled bet ($1) returned to arctur17
arctur17 collected $2.50 from pot
arctur17: doesn't show hand 
*** SUMMARY ***
Total pot $2.50 | Rake $0 
Seat 1: diva3150 folded before Flop (didn't bet)
Seat 2: matiko09 folded before Flop (didn't bet)
Seat 4: SkUhNi folded before Flop (didn't bet)
Seat 5: DomiVY folded before Flop (didn't bet)
Seat 6: arctur17 collected ($2.50)
Seat 7: Filojoes (button) folded before Flop (didn't bet)
Seat 8: ruslik_by (small blind) folded before Flop
Seat 9: 23SmOkEr07 (big blind) folded before Flop





PokerStars Hand #154969974903:  Hold'em No Limit (£0.25/£0.50 GBP) - 2016/06/20 12:20:19 CET [2016/06/20 6:20:19 ET]
Table 'Azalea' 6-max Seat #3 is the button
Seat 1: mitsuVK (£50 in chips) 
Seat 2: matiko09 (£81.60 in chips) 
Seat 3: VahTang_89 (£50 in chips) 
Seat 5: mudders693 (£66.44 in chips) 
Seat 6: Bënedic10 (£57.27 in chips) 
faceMyBallz_ will be allowed to play after the button
mudders693: posts small blind £0.25
Bënedic10: posts big blind £0.50
*** HOLE CARDS ***
Dealt to matiko09 [4s 5s]
mitsuVK: raises £1 to £1.50
matiko09: folds 
VahTang_89: calls £1.50
mudders693: folds 
Bënedic10: raises £4.75 to £6.25
mitsuVK: raises £7.25 to £13.50
VahTang_89: folds 
Bënedic10: raises £43.77 to £57.27 and is all-in
mitsuVK: calls £36.50 and is all-in
Uncalled bet (£7.27) returned to Bënedic10
*** FLOP *** [9h 2h 5c]
*** TURN *** [9h 2h 5c] [8d]
*** RIVER *** [9h 2h 5c 8d] [Jc]
*** SHOW DOWN ***
Bënedic10: shows [Td Th] (a pair of Tens)
mitsuVK: shows [Kh Kc] (a pair of Kings)
mitsuVK collected £100.35 from pot
*** SUMMARY ***
Total pot £101.75 | Rake £1.40 
Board [9h 2h 5c 8d Jc]
Seat 1: mitsuVK showed [Kh Kc] and won (£100.35) with a pair of Kings
Seat 2: matiko09 folded before Flop (didn't bet)
Seat 3: VahTang_89 (button) folded before Flop
Seat 5: mudders693 (small blind) folded before Flop
Seat 6: Bënedic10 (big blind) showed [Td Th] and lost with a pair of Tens





PokerStars Hand #154969977342:  Hold'em No Limit ($0.50/$1.00 USD) - 2016/06/20 12:20:26 CET [2016/06/20 6:20:26 ET]
Table 'Pongola' 9-max Seat #8 is the button
Seat 1: matiko09 ($100 in chips) 
Seat 2: ruslik_by ($136 in chips) 
Seat 3: SkUhNi ($100 in chips) 
Seat 4: karllv ($121.29 in chips) 
Seat 5: joker180785 ($107.43 in chips) 
Seat 6: 23SmOkEr07 ($106.64 in chips) 
Seat 7: Prophet1906 ($100 in chips) 
Seat 8: phrantique ($154.32 in chips) 
Filojoes will be allowed to play after the button
matiko09: posts small blind $0.50
ruslik_by: posts big blind $1
*** HOLE CARDS ***
Dealt to matiko09 [Kc Th]
SkUhNi: folds 
karllv: folds 
joker180785: raises $2 to $3
23SmOkEr07: folds 
Prophet1906: folds 
phrantique: folds 
matiko09: folds 
ruslik_by: folds 
Uncalled bet ($2) returned to joker180785
joker180785 collected $2.50 from pot
*** SUMMARY ***
Total pot $2.50 | Rake $0 
Seat 1: matiko09 (small blind) folded before Flop
Seat 2: ruslik_by (big blind) folded before Flop
Seat 3: SkUhNi folded before Flop (didn't bet)
Seat 4: karllv folded before Flop (didn't bet)
Seat 5: joker180785 collected ($2.50)
Seat 6: 23SmOkEr07 folded before Flop (didn't bet)
Seat 7: Prophet1906 folded before Flop (didn't bet)
Seat 8: phrantique (button) folded before Flop (didn't bet)





PokerStars Hand #154969978259:  Hold'em No Limit ($0.25/$0.50 USD) - 2016/06/20 12:20:28 CET [2016/06/20 6:20:28 ET]
Table 'Juliana II' 9-max Seat #8 is the button
Seat 1: sno05 ($30.83 in chips) 
Seat 2: cjzm ($53.79 in chips) 
Seat 3: Dr.Mouse102 ($50 in chips) 
Seat 5: bigkahuna380 ($33.11 in chips) 
Seat 6: sophie2000 ($50 in chips) 
Seat 7: 23SmOkEr07 ($58.76 in chips) 
Seat 8: matiko09 ($50 in chips) 
Seat 9: tugboat2008 ($68.90 in chips) 
tugboat2008: posts small blind $0.25
sno05: posts big blind $0.50
RICKA16: sits out 
*** HOLE CARDS ***
Dealt to matiko09 [Qh 5d]
cjzm: raises $0.50 to $1
Dr.Mouse102: folds 
bigkahuna380: folds 
sophie2000: folds 
23SmOkEr07: raises $0.50 to $1.50
matiko09: folds 
tugboat2008: folds 
sno05: folds 
cjzm: calls $0.50
*** FLOP *** [Kd 7d Qs]
cjzm: checks 
23SmOkEr07: checks 
*** TURN *** [Kd 7d Qs] [3d]
cjzm: checks 
23SmOkEr07: checks 
*** RIVER *** [Kd 7d Qs 3d] [Js]
cjzm: checks 
23SmOkEr07: bets $1.99
cjzm: calls $1.99
*** SHOW DOWN ***
23SmOkEr07: shows [Ts Ac] (a straight, Ten to Ace)
cjzm: mucks hand 
23SmOkEr07 collected $7.34 from pot
*** SUMMARY ***
Total pot $7.73 | Rake $0.39 
Board [Kd 7d Qs 3d Js]
Seat 1: sno05 (big blind) folded before Flop
Seat 2: cjzm mucked [Jc As]
Seat 3: Dr.Mouse102 folded before Flop (didn't bet)
Seat 5: bigkahuna380 folded before Flop (didn't bet)
Seat 6: sophie2000 folded before Flop (didn't bet)
Seat 7: 23SmOkEr07 showed [Ts Ac] and won ($7.34) with a straight, Ten to Ace
Seat 8: matiko09 (button) folded before Flop (didn't bet)
Seat 9: tugboat2008 (small blind) folded before Flop





PokerStars Hand #154969978890:  Hold'em No Limit (€0.50/€1.00 EUR) - 2016/06/20 12:20:30 CET [2016/06/20 6:20:30 ET]
Table 'Austrasia II' 9-max Seat #3 is the button
Seat 1: Kukuryzka (€100 in chips) 
Seat 2: hammerwife (€100 in chips) 
Seat 3: Filojoes (€100 in chips) 
Seat 4: matiko09 (€102.50 in chips) 
Seat 8: SkUhNi (€100 in chips) 
Seat 9: stijner1986 (€109.25 in chips) 
matiko09: posts small blind €0.50
SkUhNi: posts big blind €1
*** HOLE CARDS ***
Dealt to matiko09 [5s 2s]
stijner1986: calls €1
Kukuryzka: folds 
hammerwife: raises €3 to €4
Filojoes: folds 
matiko09: folds 
SkUhNi: folds 
stijner1986: folds 
Uncalled bet (€3) returned to hammerwife
hammerwife collected €3.50 from pot
hammerwife: doesn't show hand 
*** SUMMARY ***
Total pot €3.50 | Rake €0 
Seat 1: Kukuryzka folded before Flop (didn't bet)
Seat 2: hammerwife collected (€3.50)
Seat 3: Filojoes (button) folded before Flop (didn't bet)
Seat 4: matiko09 (small blind) folded before Flop
Seat 8: SkUhNi (big blind) folded before Flop
Seat 9: stijner1986 folded before Flop





PokerStars Hand #154969978983:  Hold'em No Limit ($0.25/$0.50 USD) - 2016/06/20 12:20:30 CET [2016/06/20 6:20:30 ET]
Table 'Scheddi II' 9-max Seat #6 is the button
Seat 1: matiko09 ($52.30 in chips) 
Seat 2: Yaaaazz ($50.02 in chips) 
Seat 5: No Money NW ($31.81 in chips) 
Seat 6: joker180785 ($65.44 in chips) 
Seat 7: HopeMayBee ($56.17 in chips) 
Seat 9: Infinitinium ($139.19 in chips) 
HopeMayBee: posts small blind $0.25
Infinitinium: posts big blind $0.50
matiko09: posts the ante $0.10
Yaaaazz: posts the ante $0.10
No Money NW: posts the ante $0.10
joker180785: posts the ante $0.10
HopeMayBee: posts the ante $0.10
Infinitinium: posts the ante $0.10
*** HOLE CARDS ***
Dealt to matiko09 [9d Jc]
matiko09: folds 
Yaaaazz: raises $1.50 to $2
No Money NW: folds 
joker180785: folds 
HopeMayBee: calls $1.75
Infinitinium: calls $1.50
*** FLOP *** [6s Js 9c]
HopeMayBee: checks 
Infinitinium: checks 
Yaaaazz: bets $5
HopeMayBee: calls $5
Infinitinium: calls $5
*** TURN *** [6s Js 9c] [Kc]
HopeMayBee: checks 
Infinitinium: checks 
Yaaaazz: bets $27.25
mi$$I$Elena joins the table at seat #3 
HopeMayBee: folds 
Infinitinium: folds 
Uncalled bet ($27.25) returned to Yaaaazz
Yaaaazz collected $20.52 from pot
*** SUMMARY ***
Total pot $21.60 | Rake $1.08 
Board [6s Js 9c Kc]
Seat 1: matiko09 folded before Flop (didn't bet)
Seat 2: Yaaaazz collected ($20.52)
Seat 5: No Money NW folded before Flop (didn't bet)
Seat 6: joker180785 (button) folded before Flop (didn't bet)
Seat 7: HopeMayBee (small blind) folded on the Turn
Seat 9: Infinitinium (big blind) folded on the Turn





PokerStars Hand #154969986256:  Hold'em No Limit (£0.25/£0.50 GBP) - 2016/06/20 12:20:50 CET [2016/06/20 6:20:50 ET]
Table 'Ani' 6-max Seat #5 is the button
Seat 1: rewq99887788 (£50.12 in chips) 
Seat 2: joker180785 (£50 in chips) 
Seat 3: Doobes8555 (£73.34 in chips) 
Seat 4: matiko09 (£50.25 in chips) 
Seat 5: Wwwasian (£63.77 in chips) 
Seat 6: faceMyBallz_ (£55.36 in chips) 
faceMyBallz_: posts small blind £0.25
rewq99887788: posts big blind £0.50
*** HOLE CARDS ***
Dealt to matiko09 [Kc Td]
joker180785: folds 
Doobes8555: calls £0.50
matiko09: raises £1.50 to £2
Wwwasian: folds 
faceMyBallz_: folds 
rewq99887788: folds 
Doobes8555: calls £1.50
*** FLOP *** [Jh 7h Kd]
Doobes8555: checks 
matiko09: bets £2.93
Doobes8555: folds 
Uncalled bet (£2.93) returned to matiko09
matiko09 collected £4.51 from pot
matiko09: doesn't show hand 
*** SUMMARY ***
Total pot £4.75 | Rake £0.24 
Board [Jh 7h Kd]
Seat 1: rewq99887788 (big blind) folded before Flop
Seat 2: joker180785 folded before Flop (didn't bet)
Seat 3: Doobes8555 folded on the Flop
Seat 4: matiko09 collected (£4.51)
Seat 5: Wwwasian (button) folded before Flop (didn't bet)
Seat 6: faceMyBallz_ (small blind) folded before Flop





PokerStars Hand #154969986580:  Hold'em No Limit ($0.50/$1.00 USD) - 2016/06/20 12:20:50 CET [2016/06/20 6:20:50 ET]
Table 'Ambrosia II' 9-max Seat #8 is the button
Seat 1: 23SmOkEr07 ($109.57 in chips) 
Seat 2: Eyeballz1307 ($77.68 in chips) 
Seat 3: mavin80 ($77.18 in chips) 
Seat 4: mi$$I$Elena ($128.12 in chips) 
Seat 5: Mattulh ($100 in chips) 
Seat 6: ruslik_by ($137.98 in chips) 
Seat 7: matiko09 ($106 in chips) 
Seat 8: hammerwife ($100 in chips) 
Seat 9: SkUhNi ($100.35 in chips) 
SkUhNi: posts small blind $0.50
23SmOkEr07: posts big blind $1
*** HOLE CARDS ***
Dealt to matiko09 [6c 9c]
Eyeballz1307: folds 
mavin80: folds 
mi$$I$Elena: folds 
Mattulh: folds 
ruslik_by: folds 
matiko09: folds 
hammerwife: raises $1 to $2
SkUhNi: folds 
23SmOkEr07: folds 
Uncalled bet ($1) returned to hammerwife
hammerwife collected $2.50 from pot
hammerwife: doesn't show hand 
*** SUMMARY ***
Total pot $2.50 | Rake $0 
Seat 1: 23SmOkEr07 (big blind) folded before Flop
Seat 2: Eyeballz1307 folded before Flop (didn't bet)
Seat 3: mavin80 folded before Flop (didn't bet)
Seat 4: mi$$I$Elena folded before Flop (didn't bet)
Seat 5: Mattulh folded before Flop (didn't bet)
Seat 6: ruslik_by folded before Flop (didn't bet)
Seat 7: matiko09 folded before Flop (didn't bet)
Seat 8: hammerwife (button) collected ($2.50)
Seat 9: SkUhNi (small blind) folded before Flop





PokerStars Hand #154969986376:  Hold'em No Limit (€0.50/€1.00 EUR) - 2016/06/20 12:20:50 CET [2016/06/20 6:20:50 ET]
Table 'Austrasia II' 9-max Seat #4 is the button
Seat 1: Kukuryzka (€100 in chips) 
Seat 2: hammerwife (€102.50 in chips) 
Seat 3: Filojoes (€100 in chips) 
Seat 4: matiko09 (€102 in chips) 
Seat 8: SkUhNi (€100 in chips) 
Seat 9: stijner1986 (€108.25 in chips) 
SkUhNi: posts small blind €0.50
stijner1986: posts big blind €1
*** HOLE CARDS ***
Dealt to matiko09 [2h Tc]
Kukuryzka: folds 
hammerwife: folds 
Filojoes: raises €1.50 to €2.50
matiko09: folds 
SkUhNi: folds 
stijner1986: folds 
Uncalled bet (€1.50) returned to Filojoes
Filojoes collected €2.50 from pot
Filojoes: doesn't show hand 
*** SUMMARY ***
Total pot €2.50 | Rake €0 
Seat 1: Kukuryzka folded before Flop (didn't bet)
Seat 2: hammerwife folded before Flop (didn't bet)
Seat 3: Filojoes collected (€2.50)
Seat 4: matiko09 (button) folded before Flop (didn't bet)
Seat 8: SkUhNi (small blind) folded before Flop
Seat 9: stijner1986 (big blind) folded before Flop





PokerStars Hand #154969986968:  Hold'em No Limit ($0.50/$1.00 USD) - 2016/06/20 12:20:52 CET [2016/06/20 6:20:52 ET]
Table 'Ernestina' 9-max Seat #8 is the button
Seat 1: diva3150 ($75.18 in chips) 
Seat 2: matiko09 ($100 in chips) 
Seat 4: SkUhNi ($102.02 in chips) 
Seat 5: DomiVY ($40 in chips) 
Seat 6: arctur17 ($95.30 in chips) 
Seat 7: Filojoes ($118.41 in chips) 
Seat 8: ruslik_by ($306.94 in chips) 
Seat 9: 23SmOkEr07 ($100.50 in chips) 
23SmOkEr07: posts small blind $0.50
diva3150: posts big blind $1
Pvsx.: sits out 
*** HOLE CARDS ***
Dealt to matiko09 [7c 9h]
matiko09: folds 
SkUhNi: folds 
DomiVY: raises $2 to $3
arctur17: folds 
Filojoes: calls $3
ruslik_by: folds 
23SmOkEr07: folds 
diva3150: folds 
*** FLOP *** [Tc 2h 6c]
DomiVY: checks 
Filojoes: checks 
*** TURN *** [Tc 2h 6c] [Ks]
DomiVY: checks 
Filojoes: checks 
*** RIVER *** [Tc 2h 6c Ks] [3d]
DomiVY: checks 
Filojoes: bets $4.27
DomiVY: folds 
Uncalled bet ($4.27) returned to Filojoes
Filojoes collected $7.12 from pot
Filojoes: doesn't show hand 
*** SUMMARY ***
Total pot $7.50 | Rake $0.38 
Board [Tc 2h 6c Ks 3d]
Seat 1: diva3150 (big blind) folded before Flop
Seat 2: matiko09 folded before Flop (didn't bet)
Seat 4: SkUhNi folded before Flop (didn't bet)
Seat 5: DomiVY folded on the River
Seat 6: arctur17 folded before Flop (didn't bet)
Seat 7: Filojoes collected ($7.12)
Seat 8: ruslik_by (button) folded before Flop (didn't bet)
Seat 9: 23SmOkEr07 (small blind) folded before Flop





PokerStars Hand #154969988239:  Hold'em No Limit ($0.50/$1.00 USD) - 2016/06/20 12:20:55 CET [2016/06/20 6:20:55 ET]
Table 'Pongola' 9-max Seat #1 is the button
Seat 1: matiko09 ($100 in chips) 
Seat 2: ruslik_by ($135 in chips) 
Seat 3: SkUhNi ($100 in chips) 
Seat 4: karllv ($121.29 in chips) 
Seat 5: joker180785 ($108.93 in chips) 
Seat 6: 23SmOkEr07 ($106.64 in chips) 
Seat 7: Prophet1906 ($100 in chips) 
Seat 8: phrantique ($154.32 in chips) 
ruslik_by: posts small blind $0.50
SkUhNi: posts big blind $1
Filojoes: sits out 
*** HOLE CARDS ***
Dealt to matiko09 [6h 9h]
karllv: folds 
joker180785: folds 
23SmOkEr07: folds 
Prophet1906: folds 
phrantique: folds 
matiko09: raises $1.27 to $2.27
ruslik_by: raises $6.73 to $9
SkUhNi: folds 
matiko09: folds 
Uncalled bet ($6.73) returned to ruslik_by
ruslik_by collected $5.54 from pot
ruslik_by: doesn't show hand 
*** SUMMARY ***
Total pot $5.54 | Rake $0 
Seat 1: matiko09 (button) folded before Flop
Seat 2: ruslik_by (small blind) collected ($5.54)
Seat 3: SkUhNi (big blind) folded before Flop
Seat 4: karllv folded before Flop (didn't bet)
Seat 5: joker180785 folded before Flop (didn't bet)
Seat 6: 23SmOkEr07 folded before Flop (didn't bet)
Seat 7: Prophet1906 folded before Flop (didn't bet)
Seat 8: phrantique folded before Flop (didn't bet)





PokerStars Hand #154969989840:  Hold'em No Limit ($0.50/$1.00 USD) - 2016/06/20 12:20:59 CET [2016/06/20 6:20:59 ET]
Table 'Anhui' 9-max Seat #4 is the button
Seat 1: SkUhNi ($153.92 in chips) 
Seat 2: ruslik_by ($262.85 in chips) 
Seat 3: Filojoes ($100 in chips) 
Seat 4: mavin80 ($41.38 in chips) 
Seat 5: mi$$I$Elena ($100 in chips) 
Seat 6: 23SmOkEr07 ($134.75 in chips) 
Seat 7: matiko09 ($136 in chips) 
Seat 8: blackmont111 ($79 in chips) 
mi$$I$Elena: posts small blind $0.50
23SmOkEr07: posts big blind $1
TomBod1: sits out 
*** HOLE CARDS ***
Dealt to matiko09 [Qs Kc]
matiko09: folds 
blackmont111: folds 
SkUhNi: folds 
ruslik_by: folds 
Filojoes: folds 
mavin80: folds 
mi$$I$Elena: raises $2 to $3
23SmOkEr07: folds 
Uncalled bet ($2) returned to mi$$I$Elena
mi$$I$Elena collected $2 from pot
mi$$I$Elena: doesn't show hand 
*** SUMMARY ***
Total pot $2 | Rake $0 
Seat 1: SkUhNi folded before Flop (didn't bet)
Seat 2: ruslik_by folded before Flop (didn't bet)
Seat 3: Filojoes folded before Flop (didn't bet)
Seat 4: mavin80 (button) folded before Flop (didn't bet)
Seat 5: mi$$I$Elena (small blind) collected ($2)
Seat 6: 23SmOkEr07 (big blind) folded before Flop
Seat 7: matiko09 folded before Flop (didn't bet)
Seat 8: blackmont111 folded before Flop (didn't bet)





PokerStars Hand #154969991997:  Hold'em No Limit (€0.50/€1.00 EUR) - 2016/06/20 12:21:05 CET [2016/06/20 6:21:05 ET]
Table 'Austrasia II' 9-max Seat #8 is the button
Seat 1: Kukuryzka (€100 in chips) 
Seat 2: hammerwife (€102.50 in chips) 
Seat 3: Filojoes (€101.50 in chips) 
Seat 4: matiko09 (€102 in chips) 
Seat 8: SkUhNi (€100 in chips) 
Seat 9: stijner1986 (€107.25 in chips) 
stijner1986: posts small blind €0.50
Kukuryzka: posts big blind €1
*** HOLE CARDS ***
Dealt to matiko09 [2s 3d]
hammerwife: raises €1.50 to €2.50
Avtovo joins the table at seat #5 
Dickyxxx joins the table at seat #6 
Filojoes: folds 
matiko09: folds 
SkUhNi: folds 
stijner1986: calls €2
Kukuryzka: folds 
*** FLOP *** [7c 8d Ks]
stijner1986: checks 
hammerwife: checks 
*** TURN *** [7c 8d Ks] [4c]
stijner1986: checks 
hammerwife: checks 
*** RIVER *** [7c 8d Ks 4c] [Th]
stijner1986: checks 
hammerwife: checks 
*** SHOW DOWN ***
stijner1986: shows [4s Qs] (a pair of Fours)
hammerwife: mucks hand 
stijner1986 collected €5.70 from pot
*** SUMMARY ***
Total pot €6 | Rake €0.30 
Board [7c 8d Ks 4c Th]
Seat 1: Kukuryzka (big blind) folded before Flop
Seat 2: hammerwife mucked [Js Ah]
Seat 3: Filojoes folded before Flop (didn't bet)
Seat 4: matiko09 folded before Flop (didn't bet)
Seat 8: SkUhNi (button) folded before Flop (didn't bet)
Seat 9: stijner1986 (small blind) showed [4s Qs] and won (€5.70) with a pair of Fours





PokerStars Hand #154969995018:  Hold'em No Limit ($0.50/$1.00 USD) - 2016/06/20 12:21:13 CET [2016/06/20 6:21:13 ET]
Table 'Ambrosia II' 9-max Seat #9 is the button
Seat 1: 23SmOkEr07 ($108.57 in chips) 
Seat 2: Eyeballz1307 ($77.68 in chips) 
Seat 3: mavin80 ($77.18 in chips) 
Seat 4: mi$$I$Elena ($128.12 in chips) 
Seat 5: Mattulh ($100 in chips) 
Seat 6: ruslik_by ($137.98 in chips) 
Seat 7: matiko09 ($106 in chips) 
Seat 8: hammerwife ($101.50 in chips) 
Seat 9: SkUhNi ($100 in chips) 
23SmOkEr07: posts small blind $0.50
Eyeballz1307: posts big blind $1
*** HOLE CARDS ***
Dealt to matiko09 [6s Jh]
mavin80: folds 
mi$$I$Elena: folds 
Mattulh: raises $2 to $3
ruslik_by: folds 
matiko09: folds 
hammerwife: folds 
SkUhNi: folds 
23SmOkEr07: raises $8.50 to $11.50
Eyeballz1307: folds 
Mattulh: folds 
Uncalled bet ($8.50) returned to 23SmOkEr07
23SmOkEr07 collected $7 from pot
23SmOkEr07: doesn't show hand 
*** SUMMARY ***
Total pot $7 | Rake $0 
Seat 1: 23SmOkEr07 (small blind) collected ($7)
Seat 2: Eyeballz1307 (big blind) folded before Flop
Seat 3: mavin80 folded before Flop (didn't bet)
Seat 4: mi$$I$Elena folded before Flop (didn't bet)
Seat 5: Mattulh folded before Flop
Seat 6: ruslik_by folded before Flop (didn't bet)
Seat 7: matiko09 folded before Flop (didn't bet)
Seat 8: hammerwife folded before Flop (didn't bet)
Seat 9: SkUhNi (button) folded before Flop (didn't bet)





PokerStars Hand #154969995153:  Hold'em No Limit (£0.25/£0.50 GBP) - 2016/06/20 12:21:13 CET [2016/06/20 6:21:13 ET]
Table 'Ani' 6-max Seat #6 is the button
Seat 1: rewq99887788 (£49.62 in chips) 
Seat 2: joker180785 (£50 in chips) 
Seat 3: Doobes8555 (£71.34 in chips) 
Seat 4: matiko09 (£52.76 in chips) 
Seat 5: Wwwasian (£63.77 in chips) 
Seat 6: faceMyBallz_ (£55.11 in chips) 
rewq99887788: posts small blind £0.25
joker180785: posts big blind £0.50
*** HOLE CARDS ***
Dealt to matiko09 [Ah Kc]
Doobes8555: folds 
matiko09: raises £1 to £1.50
Wwwasian: folds 
faceMyBallz_: folds 
rewq99887788: folds 
joker180785: folds 
Uncalled bet (£1) returned to matiko09
matiko09 collected £1.25 from pot
matiko09: doesn't show hand 
*** SUMMARY ***
Total pot £1.25 | Rake £0 
Seat 1: rewq99887788 (small blind) folded before Flop
Seat 2: joker180785 (big blind) folded before Flop
Seat 3: Doobes8555 folded before Flop (didn't bet)
Seat 4: matiko09 collected (£1.25)
Seat 5: Wwwasian folded before Flop (didn't bet)
Seat 6: faceMyBallz_ (button) folded before Flop (didn't bet)





PokerStars Hand #154969996208:  Hold'em No Limit (£0.25/£0.50 GBP) - 2016/06/20 12:21:16 CET [2016/06/20 6:21:16 ET]
Table 'Azalea' 6-max Seat #5 is the button
Seat 1: mitsuVK (£100.35 in chips) 
Seat 2: matiko09 (£81.60 in chips) 
Seat 3: VahTang_89 (£50 in chips) 
Seat 5: mudders693 (£66.19 in chips) 
Seat 6: Bënedic10 (£50 in chips) 
Bënedic10: posts small blind £0.25
mitsuVK: posts big blind £0.50
faceMyBallz_: sits out 
*** HOLE CARDS ***
Dealt to matiko09 [6c Kc]
matiko09: folds 
VahTang_89: folds 
mudders693: calls £0.50
Bënedic10: folds 
mitsuVK: raises £1.50 to £2
mudders693: folds 
Uncalled bet (£1.50) returned to mitsuVK
mitsuVK collected £1.25 from pot
mitsuVK: doesn't show hand 
*** SUMMARY ***
Total pot £1.25 | Rake £0 
Seat 1: mitsuVK (big blind) collected (£1.25)
Seat 2: matiko09 folded before Flop (didn't bet)
Seat 3: VahTang_89 folded before Flop (didn't bet)
Seat 5: mudders693 (button) folded before Flop
Seat 6: Bënedic10 (small blind) folded before Flop





PokerStars Hand #154969998560:  Hold'em No Limit ($0.25/$0.50 USD) - 2016/06/20 12:21:23 CET [2016/06/20 6:21:23 ET]
Table 'Juliana II' 9-max Seat #9 is the button
Seat 1: sno05 ($30.33 in chips) 
Seat 2: cjzm ($50.30 in chips) 
Seat 3: Dr.Mouse102 ($50 in chips) 
Seat 5: bigkahuna380 ($33.11 in chips) 
Seat 6: sophie2000 ($50 in chips) 
Seat 7: 23SmOkEr07 ($62.61 in chips) 
Seat 8: matiko09 ($50 in chips) 
Seat 9: tugboat2008 ($68.65 in chips) 
sno05: posts small blind $0.25
cjzm: posts big blind $0.50
RICKA16: sits out 
*** HOLE CARDS ***
Dealt to matiko09 [Ac 3d]
Dr.Mouse102: folds 
bigkahuna380: folds 
sophie2000: raises $1 to $1.50
23SmOkEr07: folds 
matiko09: folds 
tugboat2008: folds 
sno05: folds 
cjzm: folds 
Uncalled bet ($1) returned to sophie2000
sophie2000 collected $1.25 from pot
sophie2000: doesn't show hand 
*** SUMMARY ***
Total pot $1.25 | Rake $0 
Seat 1: sno05 (small blind) folded before Flop
Seat 2: cjzm (big blind) folded before Flop
Seat 3: Dr.Mouse102 folded before Flop (didn't bet)
Seat 5: bigkahuna380 folded before Flop (didn't bet)
Seat 6: sophie2000 collected ($1.25)
Seat 7: 23SmOkEr07 folded before Flop (didn't bet)
Seat 8: matiko09 folded before Flop (didn't bet)
Seat 9: tugboat2008 (button) folded before Flop (didn't bet)





PokerStars Hand #154970002211:  Hold'em No Limit (£0.25/£0.50 GBP) - 2016/06/20 12:21:33 CET [2016/06/20 6:21:33 ET]
Table 'Ani' 6-max Seat #1 is the button
Seat 1: rewq99887788 (£49.37 in chips) 
Seat 2: joker180785 (£50 in chips) 
Seat 3: Doobes8555 (£71.34 in chips) 
Seat 4: matiko09 (£53.51 in chips) 
Seat 5: Wwwasian (£63.77 in chips) 
Seat 6: faceMyBallz_ (£55.11 in chips) 
joker180785: posts small blind £0.25
Doobes8555: posts big blind £0.50
*** HOLE CARDS ***
Dealt to matiko09 [As 5d]
matiko09: folds 
Wwwasian: folds 
faceMyBallz_: folds 
rewq99887788: raises £0.50 to £1
joker180785: calls £0.75
Doobes8555: calls £0.50
*** FLOP *** [Ts 5c Qh]
joker180785: checks 
Doobes8555: checks 
rewq99887788: bets £1.50
joker180785: folds 
Doobes8555: calls £1.50
*** TURN *** [Ts 5c Qh] [8h]
Doobes8555: checks 
rewq99887788: bets £3.50
Doobes8555: folds 
Uncalled bet (£3.50) returned to rewq99887788
rewq99887788 collected £5.70 from pot
*** SUMMARY ***
Total pot £6 | Rake £0.30 
Board [Ts 5c Qh 8h]
Seat 1: rewq99887788 (button) collected (£5.70)
Seat 2: joker180785 (small blind) folded on the Flop
Seat 3: Doobes8555 (big blind) folded on the Turn
Seat 4: matiko09 folded before Flop (didn't bet)
Seat 5: Wwwasian folded before Flop (didn't bet)
Seat 6: faceMyBallz_ folded before Flop (didn't bet)





PokerStars Hand #154970003902:  Hold'em No Limit ($0.50/$1.00 USD) - 2016/06/20 12:21:37 CET [2016/06/20 6:21:37 ET]
Table 'Anhui' 9-max Seat #5 is the button
Seat 1: SkUhNi ($153.92 in chips) 
Seat 2: ruslik_by ($262.85 in chips) 
Seat 3: Filojoes ($100 in chips) 
Seat 4: mavin80 ($41.38 in chips) 
Seat 5: mi$$I$Elena ($101 in chips) 
Seat 6: 23SmOkEr07 ($133.75 in chips) 
Seat 7: matiko09 ($136 in chips) 
Seat 8: blackmont111 ($79 in chips) 
23SmOkEr07: posts small blind $0.50
matiko09: posts big blind $1
TomBod1: sits out 
*** HOLE CARDS ***
Dealt to matiko09 [4d 6c]
blackmont111: folds 
SkUhNi: folds 
ruslik_by: folds 
Filojoes: folds 
mavin80: folds 
mi$$I$Elena: raises $1 to $2
23SmOkEr07: folds 
matiko09: folds 
Uncalled bet ($1) returned to mi$$I$Elena
mi$$I$Elena collected $2.50 from pot
mi$$I$Elena: doesn't show hand 
*** SUMMARY ***
Total pot $2.50 | Rake $0 
Seat 1: SkUhNi folded before Flop (didn't bet)
Seat 2: ruslik_by folded before Flop (didn't bet)
Seat 3: Filojoes folded before Flop (didn't bet)
Seat 4: mavin80 folded before Flop (didn't bet)
Seat 5: mi$$I$Elena (button) collected ($2.50)
Seat 6: 23SmOkEr07 (small blind) folded before Flop
Seat 7: matiko09 (big blind) folded before Flop
Seat 8: blackmont111 folded before Flop (didn't bet)





PokerStars Hand #154970006317:  Hold'em No Limit ($0.50/$1.00 USD) - 2016/06/20 12:21:43 CET [2016/06/20 6:21:43 ET]
Table 'Pongola' 9-max Seat #2 is the button
Seat 1: matiko09 ($100 in chips) 
Seat 2: ruslik_by ($138.27 in chips) 
Seat 3: SkUhNi ($100 in chips) 
Seat 4: karllv ($121.29 in chips) 
Seat 5: joker180785 ($108.93 in chips) 
Seat 6: 23SmOkEr07 ($106.64 in chips) 
Seat 7: Prophet1906 ($100 in chips) 
Seat 8: phrantique ($154.32 in chips) 
SkUhNi: posts small blind $0.50
karllv: posts big blind $1
Filojoes: sits out 
*** HOLE CARDS ***
Dealt to matiko09 [6d Ad]
joker180785: folds 
23SmOkEr07: folds 
Prophet1906: folds 
phrantique: folds 
matiko09: raises $1.50 to $2.50
ruslik_by: folds 
SkUhNi: folds 
karllv: folds 
Uncalled bet ($1.50) returned to matiko09
matiko09 collected $2.50 from pot
matiko09: doesn't show hand 
*** SUMMARY ***
Total pot $2.50 | Rake $0 
Seat 1: matiko09 collected ($2.50)
Seat 2: ruslik_by (button) folded before Flop (didn't bet)
Seat 3: SkUhNi (small blind) folded before Flop
Seat 4: karllv (big blind) folded before Flop
Seat 5: joker180785 folded before Flop (didn't bet)
Seat 6: 23SmOkEr07 folded before Flop (didn't bet)
Seat 7: Prophet1906 folded before Flop (didn't bet)
Seat 8: phrantique folded before Flop (didn't bet)





PokerStars Hand #154970007946:  Hold'em No Limit (£0.25/£0.50 GBP) - 2016/06/20 12:21:48 CET [2016/06/20 6:21:48 ET]
Table 'Azalea' 6-max Seat #6 is the button
Seat 1: mitsuVK (£101.10 in chips) 
Seat 2: matiko09 (£81.60 in chips) 
Seat 3: VahTang_89 (£50 in chips) 
Seat 5: mudders693 (£65.69 in chips) 
Seat 6: Bënedic10 (£50 in chips) 
mitsuVK: posts small blind £0.25
matiko09: posts big blind £0.50
faceMyBallz_: sits out 
*** HOLE CARDS ***
Dealt to matiko09 [4d Kd]
VahTang_89: folds 
mudders693: raises £1 to £1.50
Bënedic10: folds 
mitsuVK: folds 
matiko09: folds 
Uncalled bet (£1) returned to mudders693
mudders693 collected £1.25 from pot
mudders693: doesn't show hand 
*** SUMMARY ***
Total pot £1.25 | Rake £0 
Seat 1: mitsuVK (small blind) folded before Flop
Seat 2: matiko09 (big blind) folded before Flop
Seat 3: VahTang_89 folded before Flop (didn't bet)
Seat 5: mudders693 collected (£1.25)
Seat 6: Bënedic10 (button) folded before Flop (didn't bet)





PokerStars Hand #154970011148:  Hold'em No Limit ($0.25/$0.50 USD) - 2016/06/20 12:21:56 CET [2016/06/20 6:21:56 ET]
Table 'Scheddi II' 9-max Seat #7 is the button
Seat 1: matiko09 ($52.20 in chips) 
Seat 2: Yaaaazz ($63.44 in chips) 
Seat 5: No Money NW ($31.71 in chips) 
Seat 6: joker180785 ($65.34 in chips) 
Seat 7: HopeMayBee ($49.07 in chips) 
Seat 9: Infinitinium ($132.09 in chips) 
Infinitinium: posts small blind $0.25
matiko09: posts big blind $0.50
mi$$I$Elena: sits out 
matiko09: posts the ante $0.10
Yaaaazz: posts the ante $0.10
No Money NW: posts the ante $0.10
joker180785: posts the ante $0.10
HopeMayBee: posts the ante $0.10
Infinitinium: posts the ante $0.10
*** HOLE CARDS ***
Dealt to matiko09 [Th 6c]
Yaaaazz: folds 
No Money NW: raises $0.50 to $1
joker180785: raises $2 to $3
HopeMayBee: folds 
Infinitinium: folds 
matiko09: folds 
No Money NW: raises $5 to $8
joker180785: folds 
Uncalled bet ($5) returned to No Money NW
No Money NW collected $7.35 from pot
No Money NW: doesn't show hand 
*** SUMMARY ***
Total pot $7.35 | Rake $0 
Seat 1: matiko09 (big blind) folded before Flop
Seat 2: Yaaaazz folded before Flop (didn't bet)
Seat 5: No Money NW collected ($7.35)
Seat 6: joker180785 folded before Flop
Seat 7: HopeMayBee (button) folded before Flop (didn't bet)
Seat 9: Infinitinium (small blind) folded before Flop





PokerStars Hand #154970012017:  Hold'em No Limit ($0.50/$1.00 USD) - 2016/06/20 12:21:59 CET [2016/06/20 6:21:59 ET]
Table 'Albiorix' 9-max Seat #5 is the button
Seat 1: arctur17 ($77.28 in chips) 
Seat 2: SkUhNi ($151.52 in chips) 
Seat 3: matiko09 ($101 in chips) 
Seat 4: 23SmOkEr07 ($145 in chips) 
Seat 5: ruslik_by ($103.25 in chips) 
Seat 6: joker180785 ($100 in chips) 
Seat 7: Pekyto ($35.50 in chips) 
Seat 8: smiley0221 ($123.73 in chips) 
Seat 9: Coolller ($102.97 in chips) 
joker180785: posts small blind $0.50
Pekyto: posts big blind $1
*** HOLE CARDS ***
Dealt to matiko09 [3s 7c]
smiley0221: folds 
Coolller has timed out
Coolller: folds 
arctur17: folds 
SkUhNi: folds 
matiko09: folds 
23SmOkEr07: folds 
ruslik_by: raises $1 to $2
joker180785: folds 
Pekyto: calls $1
*** FLOP *** [Qh 2d Jc]
Pekyto: checks 
ruslik_by: checks 
*** TURN *** [Qh 2d Jc] [Js]
Pekyto: bets $1
ruslik_by: calls $1
*** RIVER *** [Qh 2d Jc Js] [7h]
Pekyto: bets $3
ruslik_by: folds 
Uncalled bet ($3) returned to Pekyto
Pekyto collected $6.18 from pot
Pekyto: doesn't show hand 
*** SUMMARY ***
Total pot $6.50 | Rake $0.32 
Board [Qh 2d Jc Js 7h]
Seat 1: arctur17 folded before Flop (didn't bet)
Seat 2: SkUhNi folded before Flop (didn't bet)
Seat 3: matiko09 folded before Flop (didn't bet)
Seat 4: 23SmOkEr07 folded before Flop (didn't bet)
Seat 5: ruslik_by (button) folded on the River
Seat 6: joker180785 (small blind) folded before Flop
Seat 7: Pekyto (big blind) collected ($6.18)
Seat 8: smiley0221 folded before Flop (didn't bet)
Seat 9: Coolller folded before Flop (didn't bet)





PokerStars Hand #154970012893:  Hold'em No Limit ($0.50/$1.00 USD) - 2016/06/20 12:22:01 CET [2016/06/20 6:22:01 ET]
Table 'Ambrosia II' 9-max Seat #1 is the button
Seat 1: 23SmOkEr07 ($112.57 in chips) 
Seat 2: Eyeballz1307 ($76.68 in chips) 
Seat 3: mavin80 ($77.18 in chips) 
Seat 4: mi$$I$Elena ($128.12 in chips) 
Seat 5: Mattulh ($100 in chips) 
Seat 6: ruslik_by ($137.98 in chips) 
Seat 7: matiko09 ($106 in chips) 
Seat 8: hammerwife ($101.50 in chips) 
Seat 9: SkUhNi ($100 in chips) 
Eyeballz1307: posts small blind $0.50
mavin80: posts big blind $1
*** HOLE CARDS ***
Dealt to matiko09 [5c Jd]
mi$$I$Elena: raises $1 to $2
Mattulh: folds 
ruslik_by: folds 
matiko09: folds 
hammerwife: folds 
SkUhNi: folds 
23SmOkEr07: raises $7.50 to $9.50
Eyeballz1307: raises $67.18 to $76.68 and is all-in
mavin80: folds 
mi$$I$Elena: folds 
23SmOkEr07: calls $67.18
*** FLOP *** [8d Kh 8s]
*** TURN *** [8d Kh 8s] [Kc]
*** RIVER *** [8d Kh 8s Kc] [7c]
*** SHOW DOWN ***
Eyeballz1307: shows [Ks Ac] (a full house, Kings full of Eights)
23SmOkEr07: shows [Ah Kd] (a full house, Kings full of Eights)
Eyeballz1307 collected $76.93 from pot
23SmOkEr07 collected $76.93 from pot
*** SUMMARY ***
Total pot $156.36 | Rake $2.50 
Board [8d Kh 8s Kc 7c]
Seat 1: 23SmOkEr07 (button) showed [Ah Kd] and won ($76.93) with a full house, Kings full of Eights
Seat 2: Eyeballz1307 (small blind) showed [Ks Ac] and won ($76.93) with a full house, Kings full of Eights
Seat 3: mavin80 (big blind) folded before Flop
Seat 4: mi$$I$Elena folded before Flop
Seat 5: Mattulh folded before Flop (didn't bet)
Seat 6: ruslik_by folded before Flop (didn't bet)
Seat 7: matiko09 folded before Flop (didn't bet)
Seat 8: hammerwife folded before Flop (didn't bet)
Seat 9: SkUhNi folded before Flop (didn't bet)





PokerStars Hand #154970013480:  Hold'em No Limit (€0.50/€1.00 EUR) - 2016/06/20 12:22:02 CET [2016/06/20 6:22:02 ET]
Table 'Austrasia II' 9-max Seat #9 is the button
Seat 1: Kukuryzka (€99 in chips) 
Seat 2: hammerwife (€100 in chips) 
Seat 3: Filojoes (€101.50 in chips) 
Seat 4: matiko09 (€102 in chips) 
Seat 8: SkUhNi (€100 in chips) 
Seat 9: stijner1986 (€110.45 in chips) 
Kukuryzka: posts small blind €0.50
hammerwife: posts big blind €1
Avtovo: sits out 
Dickyxxx: sits out 
*** HOLE CARDS ***
Dealt to matiko09 [Qs 8h]
Filojoes: raises €2 to €3
azzad2007 joins the table at seat #7 
matiko09: folds 
SkUhNi: folds 
stijner1986: calls €3
Kukuryzka: folds 
hammerwife: folds 
*** FLOP *** [7c Ac Qd]
Filojoes: bets €4.27
stijner1986: calls €4.27
*** TURN *** [7c Ac Qd] [6s]
Filojoes: bets €9.14
stijner1986: calls €9.14
*** RIVER *** [7c Ac Qd 6s] [Kd]
Filojoes: bets €29.34
stijner1986: folds 
Uncalled bet (€29.34) returned to Filojoes
Filojoes collected €32.60 from pot
Filojoes: doesn't show hand 
*** SUMMARY ***
Total pot €34.32 | Rake €1.72 
Board [7c Ac Qd 6s Kd]
Seat 1: Kukuryzka (small blind) folded before Flop
Seat 2: hammerwife (big blind) folded before Flop
Seat 3: Filojoes collected (€32.60)
Seat 4: matiko09 folded before Flop (didn't bet)
Seat 8: SkUhNi folded before Flop (didn't bet)
Seat 9: stijner1986 (button) folded on the River





PokerStars Hand #154970014639:  Hold'em No Limit (£0.25/£0.50 GBP) - 2016/06/20 12:22:05 CET [2016/06/20 6:22:05 ET]
Table 'Azalea' 6-max Seat #1 is the button
Seat 1: mitsuVK (£100.85 in chips) 
Seat 2: matiko09 (£81.10 in chips) 
Seat 3: VahTang_89 (£50 in chips) 
Seat 5: mudders693 (£66.44 in chips) 
Seat 6: Bënedic10 (£50 in chips) 
matiko09: posts small blind £0.25
VahTang_89: posts big blind £0.50
faceMyBallz_: sits out 
*** HOLE CARDS ***
Dealt to matiko09 [Th 9h]
mudders693: raises £1.50 to £2
Bënedic10: folds 
mitsuVK: folds 
matiko09: folds 
VahTang_89: folds 
Uncalled bet (£1.50) returned to mudders693
mudders693 collected £1.25 from pot
mudders693: doesn't show hand 
*** SUMMARY ***
Total pot £1.25 | Rake £0 
Seat 1: mitsuVK (button) folded before Flop (didn't bet)
Seat 2: matiko09 (small blind) folded before Flop
Seat 3: VahTang_89 (big blind) folded before Flop
Seat 5: mudders693 collected (£1.25)
Seat 6: Bënedic10 folded before Flop (didn't bet)





PokerStars Hand #154970014551:  Hold'em No Limit ($0.25/$0.50 USD) - 2016/06/20 12:22:05 CET [2016/06/20 6:22:05 ET]
Table 'Juliana II' 9-max Seat #1 is the button
Seat 1: sno05 ($30.08 in chips) 
Seat 2: cjzm ($49.80 in chips) 
Seat 3: Dr.Mouse102 ($50 in chips) 
Seat 5: bigkahuna380 ($33.11 in chips) 
Seat 6: sophie2000 ($50.75 in chips) 
Seat 7: 23SmOkEr07 ($62.61 in chips) 
Seat 8: matiko09 ($50 in chips) 
Seat 9: tugboat2008 ($68.65 in chips) 
cjzm: posts small blind $0.25
Dr.Mouse102: posts big blind $0.50
RICKA16: sits out 
*** HOLE CARDS ***
Dealt to matiko09 [Ad 3h]
bigkahuna380: folds 
sophie2000: raises $1 to $1.50
23SmOkEr07: folds 
matiko09: folds 
tugboat2008: calls $1.50
sno05: folds 
cjzm: calls $1.25
Dr.Mouse102: folds 
*** FLOP *** [7s 7h 9h]
cjzm: checks 
sophie2000: bets $2.37
tugboat2008: calls $2.37
cjzm: folds 
*** TURN *** [7s 7h 9h] [Kh]
sophie2000: checks 
tugboat2008: bets $6.11
sophie2000: calls $6.11
*** RIVER *** [7s 7h 9h Kh] [2c]
sophie2000: checks 
tugboat2008: bets $14.50
sophie2000: calls $14.50
*** SHOW DOWN ***
tugboat2008: shows [9c 9s] (a full house, Nines full of Sevens)
sophie2000: mucks hand 
tugboat2008 collected $48.96 from pot
*** SUMMARY ***
Total pot $50.96 | Rake $2 
Board [7s 7h 9h Kh 2c]
Seat 1: sno05 (button) folded before Flop (didn't bet)
Seat 2: cjzm (small blind) folded on the Flop
Seat 3: Dr.Mouse102 (big blind) folded before Flop
Seat 5: bigkahuna380 folded before Flop (didn't bet)
Seat 6: sophie2000 mucked [Kd Jh]
Seat 7: 23SmOkEr07 folded before Flop (didn't bet)
Seat 8: matiko09 folded before Flop (didn't bet)
Seat 9: tugboat2008 showed [9c 9s] and won ($48.96) with a full house, Nines full of Sevens





PokerStars Hand #154970018307:  Hold'em No Limit ($0.50/$1.00 USD) - 2016/06/20 12:22:15 CET [2016/06/20 6:22:15 ET]
Table 'Anhui' 9-max Seat #6 is the button
Seat 1: SkUhNi ($153.92 in chips) 
Seat 2: ruslik_by ($262.85 in chips) 
Seat 3: Filojoes ($100 in chips) 
Seat 4: mavin80 ($41.38 in chips) 
Seat 5: mi$$I$Elena ($102.50 in chips) 
Seat 6: 23SmOkEr07 ($133.25 in chips) 
Seat 7: matiko09 ($135 in chips) 
Seat 8: blackmont111 ($79 in chips) 
matiko09: posts small blind $0.50
blackmont111: posts big blind $1
TomBod1: sits out 
*** HOLE CARDS ***
Dealt to matiko09 [Ac Qd]
SkUhNi: folds 
ruslik_by: folds 
Filojoes: folds 
mavin80: raises $1.50 to $2.50
mi$$I$Elena: folds 
23SmOkEr07: folds 
matiko09: raises $5.50 to $8
blackmont111: folds 
mavin80: calls $5.50
*** FLOP *** [6d Js 3h]
matiko09: checks 
mavin80: checks 
*** TURN *** [6d Js 3h] [9d]
matiko09: checks 
mavin80: checks 
*** RIVER *** [6d Js 3h 9d] [2s]
matiko09: checks 
mavin80: checks 
*** SHOW DOWN ***
matiko09: shows [Ac Qd] (high card Ace)
mavin80: mucks hand 
matiko09 collected $16.15 from pot
*** SUMMARY ***
Total pot $17 | Rake $0.85 
Board [6d Js 3h 9d 2s]
Seat 1: SkUhNi folded before Flop (didn't bet)
Seat 2: ruslik_by folded before Flop (didn't bet)
Seat 3: Filojoes folded before Flop (didn't bet)
Seat 4: mavin80 mucked [5d Ah]
Seat 5: mi$$I$Elena folded before Flop (didn't bet)
Seat 6: 23SmOkEr07 (button) folded before Flop (didn't bet)
Seat 7: matiko09 (small blind) showed [Ac Qd] and won ($16.15) with high card Ace
Seat 8: blackmont111 (big blind) folded before Flop





PokerStars Hand #154970018979:  Hold'em No Limit ($0.50/$1.00 USD) - 2016/06/20 12:22:17 CET [2016/06/20 6:22:17 ET]
Table 'Isonoe II' 9-max Seat #2 is the button
Seat 2: matiko09 ($100 in chips) 
Seat 3: azzad2007 ($100 in chips) 
Seat 7: SkUhNi ($100 in chips) 
Seat 8: lewyson ($60 in chips) 
Seat 9: djammusic ($40 in chips) 
azzad2007: posts small blind $0.50
SkUhNi: posts big blind $1
*** HOLE CARDS ***
Dealt to matiko09 [Qh Kh]
lewyson: folds 
djammusic: raises $1.25 to $2.25
matiko09: calls $2.25
Avtovo joins the table at seat #4 
azzad2007: folds 
SkUhNi: folds 
*** FLOP *** [Ks 2h 8d]
djammusic: bets $3.65
matiko09: calls $3.65
*** TURN *** [Ks 2h 8d] [Ts]
djammusic: bets $7.50
matiko09: calls $7.50
*** RIVER *** [Ks 2h 8d Ts] [8c]
djammusic: bets $26.60 and is all-in
matiko09: folds 
Uncalled bet ($26.60) returned to djammusic
djammusic collected $26.88 from pot
djammusic: doesn't show hand 
*** SUMMARY ***
Total pot $28.30 | Rake $1.42 
Board [Ks 2h 8d Ts 8c]
Seat 2: matiko09 (button) folded on the River
Seat 3: azzad2007 (small blind) folded before Flop
Seat 7: SkUhNi (big blind) folded before Flop
Seat 8: lewyson folded before Flop (didn't bet)
Seat 9: djammusic collected ($26.88)





PokerStars Hand #154970018909:  Hold'em No Limit ($0.50/$1.00 USD) - 2016/06/20 12:22:17 CET [2016/06/20 6:22:17 ET]
Table 'Pongola' 9-max Seat #3 is the button
Seat 1: matiko09 ($101.50 in chips) 
Seat 2: ruslik_by ($138.27 in chips) 
Seat 3: SkUhNi ($100 in chips) 
Seat 4: karllv ($120.29 in chips) 
Seat 5: joker180785 ($108.93 in chips) 
Seat 6: 23SmOkEr07 ($106.64 in chips) 
Seat 7: Prophet1906 ($100 in chips) 
Seat 8: phrantique ($154.32 in chips) 
karllv: posts small blind $0.50
joker180785: posts big blind $1
Filojoes: sits out 
*** HOLE CARDS ***
Dealt to matiko09 [6h 2d]
23SmOkEr07: raises $1.50 to $2.50
Prophet1906: calls $2.50
phrantique: folds 
matiko09: folds 
ruslik_by: calls $2.50
SkUhNi: folds 
karllv: folds 
joker180785: folds 
*** FLOP *** [7d 8d 8c]
23SmOkEr07: bets $5.50
Prophet1906: folds 
ruslik_by: folds 
Uncalled bet ($5.50) returned to 23SmOkEr07
23SmOkEr07 collected $8.55 from pot
23SmOkEr07: doesn't show hand 
*** SUMMARY ***
Total pot $9 | Rake $0.45 
Board [7d 8d 8c]
Seat 1: matiko09 folded before Flop (didn't bet)
Seat 2: ruslik_by folded on the Flop
Seat 3: SkUhNi (button) folded before Flop (didn't bet)
Seat 4: karllv (small blind) folded before Flop
Seat 5: joker180785 (big blind) folded before Flop
Seat 6: 23SmOkEr07 collected ($8.55)
Seat 7: Prophet1906 folded on the Flop
Seat 8: phrantique folded before Flop (didn't bet)





PokerStars Hand #154970021214:  Hold'em No Limit (£0.25/£0.50 GBP) - 2016/06/20 12:22:23 CET [2016/06/20 6:22:23 ET]
Table 'Azalea' 6-max Seat #2 is the button
Seat 1: mitsuVK (£100.85 in chips) 
Seat 2: matiko09 (£80.85 in chips) 
Seat 3: VahTang_89 (£50 in chips) 
Seat 4: faceMyBallz_ (£50 in chips) 
Seat 5: mudders693 (£67.19 in chips) 
Seat 6: Bënedic10 (£50 in chips) 
VahTang_89: posts small blind £0.25
faceMyBallz_: posts big blind £0.50
*** HOLE CARDS ***
Dealt to matiko09 [8h 5h]
mudders693: raises £1 to £1.50
Bënedic10: folds 
mitsuVK: folds 
matiko09: folds 
VahTang_89: folds 
faceMyBallz_: folds 
Uncalled bet (£1) returned to mudders693
mudders693 collected £1.25 from pot
mudders693: doesn't show hand 
*** SUMMARY ***
Total pot £1.25 | Rake £0 
Seat 1: mitsuVK folded before Flop (didn't bet)
Seat 2: matiko09 (button) folded before Flop (didn't bet)
Seat 3: VahTang_89 (small blind) folded before Flop
Seat 4: faceMyBallz_ (big blind) folded before Flop
Seat 5: mudders693 collected (£1.25)
Seat 6: Bënedic10 folded before Flop (didn't bet)





PokerStars Hand #154970024714:  Hold'em No Limit (£0.25/£0.50 GBP) - 2016/06/20 12:22:32 CET [2016/06/20 6:22:32 ET]
Table 'Ani' 6-max Seat #2 is the button
Seat 1: rewq99887788 (£52.57 in chips) 
Seat 2: joker180785 (£50 in chips) 
Seat 3: Doobes8555 (£68.84 in chips) 
Seat 4: matiko09 (£53.51 in chips) 
Seat 5: Wwwasian (£63.77 in chips) 
Seat 6: faceMyBallz_ (£55.11 in chips) 
Doobes8555: posts small blind £0.25
matiko09: posts big blind £0.50
*** HOLE CARDS ***
Dealt to matiko09 [6d 3c]
Wwwasian: folds 
faceMyBallz_: folds 
rewq99887788: folds 
joker180785: folds 
Doobes8555: raises £1 to £1.50
matiko09: folds 
Uncalled bet (£1) returned to Doobes8555
Doobes8555 collected £1 from pot
Doobes8555: doesn't show hand 
*** SUMMARY ***
Total pot £1 | Rake £0 
Seat 1: rewq99887788 folded before Flop (didn't bet)
Seat 2: joker180785 (button) folded before Flop (didn't bet)
Seat 3: Doobes8555 (small blind) collected (£1)
Seat 4: matiko09 (big blind) folded before Flop
Seat 5: Wwwasian folded before Flop (didn't bet)
Seat 6: faceMyBallz_ folded before Flop (didn't bet)





PokerStars Hand #154970027438:  Hold'em No Limit (€0.50/€1.00 EUR) - 2016/06/20 12:22:39 CET [2016/06/20 6:22:39 ET]
Table 'Austrasia II' 9-max Seat #1 is the button
Seat 1: Kukuryzka (€100 in chips) 
Seat 2: hammerwife (€100 in chips) 
Seat 4: matiko09 (€102 in chips) 
Seat 8: SkUhNi (€100 in chips) 
Seat 9: stijner1986 (€94.04 in chips) 
hammerwife: posts small blind €0.50
matiko09: posts big blind €1
Avtovo: sits out 
Dickyxxx: sits out 
azzad2007: sits out 
*** HOLE CARDS ***
Dealt to matiko09 [5s As]
SkUhNi: raises €2 to €3
stijner1986: raises €3 to €6
Kukuryzka: folds 
hammerwife: folds 
matiko09: folds 
SkUhNi: calls €3
*** FLOP *** [7d 8c Qh]
SkUhNi: checks 
stijner1986: bets €6
SkUhNi: calls €6
*** TURN *** [7d 8c Qh] [6c]
SkUhNi: checks 
stijner1986: bets €14
SkUhNi: calls €14
*** RIVER *** [7d 8c Qh 6c] [9d]
SkUhNi: bets €25
stijner1986: calls €25
*** SHOW DOWN ***
SkUhNi: shows [5d 6d] (a straight, Five to Nine)
stijner1986: mucks hand 
SkUhNi collected €101.25 from pot
*** SUMMARY ***
Total pot €103.50 | Rake €2.25 
Board [7d 8c Qh 6c 9d]
Seat 1: Kukuryzka (button) folded before Flop (didn't bet)
Seat 2: hammerwife (small blind) folded before Flop
Seat 4: matiko09 (big blind) folded before Flop
Seat 8: SkUhNi showed [5d 6d] and won (€101.25) with a straight, Five to Nine
Seat 9: stijner1986 mucked [8h 8d]





PokerStars Hand #154970027268:  Hold'em No Limit ($0.25/$0.50 USD) - 2016/06/20 12:22:39 CET [2016/06/20 6:22:39 ET]
Table 'Scheddi II' 9-max Seat #9 is the button
Seat 1: matiko09 ($51.60 in chips) 
Seat 2: Yaaaazz ($63.34 in chips) 
Seat 5: No Money NW ($35.96 in chips) 
Seat 6: joker180785 ($62.24 in chips) 
Seat 7: HopeMayBee ($48.97 in chips) 
Seat 9: Infinitinium ($131.74 in chips) 
matiko09: posts small blind $0.25
Yaaaazz: posts big blind $0.50
mi$$I$Elena: sits out 
matiko09: posts the ante $0.10
Yaaaazz: posts the ante $0.10
No Money NW: posts the ante $0.10
joker180785: posts the ante $0.10
HopeMayBee: posts the ante $0.10
Infinitinium: posts the ante $0.10
*** HOLE CARDS ***
Dealt to matiko09 [6c 5h]
No Money NW: calls $0.50
joker180785: folds 
HopeMayBee: folds 
Infinitinium: folds 
matiko09: folds 
Yaaaazz: raises $2 to $2.50
No Money NW: calls $2
*** FLOP *** [Ad 2s 8s]
Yaaaazz: bets $3
fullbook19 joins the table at seat #8 
No Money NW: raises $3 to $6
Yaaaazz: calls $3
*** TURN *** [Ad 2s 8s] [Kc]
Yaaaazz: checks 
fullbook19 leaves the table
No Money NW: bets $8.50
Yaaaazz: calls $8.50
*** RIVER *** [Ad 2s 8s Kc] [4s]
Yaaaazz: checks 
No Money NW: bets $18.86 and is all-in
Yaaaazz: calls $18.86
*** SHOW DOWN ***
No Money NW: shows [8d 9c] (a pair of Eights)
Yaaaazz: shows [Ac Js] (a pair of Aces)
Yaaaazz collected $70.57 from pot
*** SUMMARY ***
Total pot $72.57 | Rake $2 
Board [Ad 2s 8s Kc 4s]
Seat 1: matiko09 (small blind) folded before Flop
Seat 2: Yaaaazz (big blind) showed [Ac Js] and won ($70.57) with a pair of Aces
Seat 5: No Money NW showed [8d 9c] and lost with a pair of Eights
Seat 6: joker180785 folded before Flop (didn't bet)
Seat 7: HopeMayBee folded before Flop (didn't bet)
Seat 9: Infinitinium (button) folded before Flop (didn't bet)





PokerStars Hand #154970028875:  Hold'em No Limit ($0.50/$1.00 USD) - 2016/06/20 12:22:43 CET [2016/06/20 6:22:43 ET]
Table 'Ambrosia II' 9-max Seat #2 is the button
Seat 1: 23SmOkEr07 ($112.82 in chips) 
Seat 2: Eyeballz1307 ($76.93 in chips) 
Seat 3: mavin80 ($76.18 in chips) 
Seat 4: mi$$I$Elena ($126.12 in chips) 
Seat 5: Mattulh ($100 in chips) 
Seat 6: ruslik_by ($137.98 in chips) 
Seat 7: matiko09 ($106 in chips) 
Seat 8: hammerwife ($101.50 in chips) 
Seat 9: SkUhNi ($100 in chips) 
mavin80: posts small blind $0.50
mi$$I$Elena: posts big blind $1
*** HOLE CARDS ***
Dealt to matiko09 [4h 3c]
Mattulh: folds 
ruslik_by: raises $2 to $3
matiko09: folds 
hammerwife: folds 
SkUhNi: folds 
23SmOkEr07: folds 
Eyeballz1307: folds 
mavin80: raises $6 to $9
mi$$I$Elena: folds 
ruslik_by: folds 
Uncalled bet ($6) returned to mavin80
mavin80 collected $7 from pot
*** SUMMARY ***
Total pot $7 | Rake $0 
Seat 1: 23SmOkEr07 folded before Flop (didn't bet)
Seat 2: Eyeballz1307 (button) folded before Flop (didn't bet)
Seat 3: mavin80 (small blind) collected ($7)
Seat 4: mi$$I$Elena (big blind) folded before Flop
Seat 5: Mattulh folded before Flop (didn't bet)
Seat 6: ruslik_by folded before Flop
Seat 7: matiko09 folded before Flop (didn't bet)
Seat 8: hammerwife folded before Flop (didn't bet)
Seat 9: SkUhNi folded before Flop (didn't bet)





PokerStars Hand #154970029397:  Hold'em No Limit (£0.25/£0.50 GBP) - 2016/06/20 12:22:44 CET [2016/06/20 6:22:44 ET]
Table 'Azalea' 6-max Seat #3 is the button
Seat 1: mitsuVK (£100.85 in chips) 
Seat 2: matiko09 (£80.85 in chips) 
Seat 3: VahTang_89 (£50 in chips) 
Seat 4: faceMyBallz_ (£50 in chips) 
Seat 5: mudders693 (£67.94 in chips) 
Seat 6: Bënedic10 (£50 in chips) 
faceMyBallz_: posts small blind £0.25
mudders693: posts big blind £0.50
*** HOLE CARDS ***
Dealt to matiko09 [7s Th]
Bënedic10: folds 
mitsuVK: raises £1 to £1.50
matiko09: folds 
VahTang_89: folds 
faceMyBallz_: folds 
mudders693: folds 
Uncalled bet (£1) returned to mitsuVK
mitsuVK collected £1.25 from pot
mitsuVK: doesn't show hand 
*** SUMMARY ***
Total pot £1.25 | Rake £0 
Seat 1: mitsuVK collected (£1.25)
Seat 2: matiko09 folded before Flop (didn't bet)
Seat 3: VahTang_89 (button) folded before Flop (didn't bet)
Seat 4: faceMyBallz_ (small blind) folded before Flop
Seat 5: mudders693 (big blind) folded before Flop
Seat 6: Bënedic10 folded before Flop (didn't bet)





PokerStars Hand #154970033088:  Hold'em No Limit (£0.25/£0.50 GBP) - 2016/06/20 12:22:54 CET [2016/06/20 6:22:54 ET]
Table 'Ani' 6-max Seat #3 is the button
Seat 1: rewq99887788 (£52.57 in chips) 
Seat 2: joker180785 (£50 in chips) 
Seat 3: Doobes8555 (£69.34 in chips) 
Seat 4: matiko09 (£53.01 in chips) 
Seat 5: Wwwasian (£63.77 in chips) 
Seat 6: faceMyBallz_ (£55.11 in chips) 
matiko09: posts small blind £0.25
Wwwasian: posts big blind £0.50
*** HOLE CARDS ***
Dealt to matiko09 [9s 4c]
faceMyBallz_: raises £1 to £1.50
rewq99887788: folds 
joker180785: folds 
Doobes8555: folds 
matiko09: folds 
Wwwasian: folds 
Uncalled bet (£1) returned to faceMyBallz_
faceMyBallz_ collected £1.25 from pot
faceMyBallz_: doesn't show hand 
*** SUMMARY ***
Total pot £1.25 | Rake £0 
Seat 1: rewq99887788 folded before Flop (didn't bet)
Seat 2: joker180785 folded before Flop (didn't bet)
Seat 3: Doobes8555 (button) folded before Flop (didn't bet)
Seat 4: matiko09 (small blind) folded before Flop
Seat 5: Wwwasian (big blind) folded before Flop
Seat 6: faceMyBallz_ collected (£1.25)





PokerStars Hand #154970033947:  Hold'em No Limit (£0.25/£0.50 GBP) - 2016/06/20 12:22:57 CET [2016/06/20 6:22:57 ET]
Table 'Tesla' 6-max Seat #1 is the button
Seat 1: Rubleff85 (£40 in chips) 
Seat 2: matiko09 (£50 in chips) 
Rubleff85: posts small blind £0.25
matiko09: posts big blind £0.50
*** HOLE CARDS ***
Dealt to matiko09 [5h 3s]
Rubleff85: calls £0.25
matiko09: checks 
*** FLOP *** [Td 9h 4h]
matiko09: checks 
Rubleff85: bets £0.50
matiko09: folds 
Uncalled bet (£0.50) returned to Rubleff85
Rubleff85 collected £0.95 from pot
Rubleff85: doesn't show hand 
*** SUMMARY ***
Total pot £1 | Rake £0.05 
Board [Td 9h 4h]
Seat 1: Rubleff85 (button) (small blind) collected (£0.95)
Seat 2: matiko09 (big blind) folded on the Flop





PokerStars Hand #154970034866:  Hold'em No Limit ($0.50/$1.00 USD) - 2016/06/20 12:22:59 CET [2016/06/20 6:22:59 ET]
Table 'Ernestina' 9-max Seat #9 is the button
Seat 1: diva3150 ($74.18 in chips) 
Seat 2: matiko09 ($100 in chips) 
Seat 4: SkUhNi ($102.02 in chips) 
Seat 5: DomiVY ($40 in chips) 
Seat 6: arctur17 ($95.30 in chips) 
Seat 7: Filojoes ($122.53 in chips) 
Seat 8: ruslik_by ($306.94 in chips) 
Seat 9: 23SmOkEr07 ($100 in chips) 
diva3150: posts small blind $0.50
matiko09: posts big blind $1
Pvsx.: sits out 
*** HOLE CARDS ***
Dealt to matiko09 [2c 2h]
SkUhNi: raises $2 to $3
DomiVY: folds 
arctur17: folds 
Filojoes: folds 
ruslik_by: folds 
23SmOkEr07: folds 
diva3150: folds 
matiko09: folds 
Uncalled bet ($2) returned to SkUhNi
SkUhNi collected $2.50 from pot
SkUhNi: doesn't show hand 
*** SUMMARY ***
Total pot $2.50 | Rake $0 
Seat 1: diva3150 (small blind) folded before Flop
Seat 2: matiko09 (big blind) folded before Flop
Seat 4: SkUhNi collected ($2.50)
Seat 5: DomiVY folded before Flop (didn't bet)
Seat 6: arctur17 folded before Flop (didn't bet)
Seat 7: Filojoes folded before Flop (didn't bet)
Seat 8: ruslik_by folded before Flop (didn't bet)
Seat 9: 23SmOkEr07 (button) folded before Flop (didn't bet)





PokerStars Hand #154970039853:  Hold'em No Limit ($0.50/$1.00 USD) - 2016/06/20 12:23:12 CET [2016/06/20 6:23:12 ET]
Table 'Pongola' 9-max Seat #4 is the button
Seat 1: matiko09 ($101.50 in chips) 
Seat 2: ruslik_by ($135.77 in chips) 
Seat 3: SkUhNi ($100 in chips) 
Seat 4: karllv ($119.79 in chips) 
Seat 5: joker180785 ($107.93 in chips) 
Seat 6: 23SmOkEr07 ($112.69 in chips) 
Seat 7: Prophet1906 ($100 in chips) 
Seat 8: phrantique ($154.32 in chips) 
joker180785: posts small blind $0.50
23SmOkEr07: posts big blind $1
Filojoes: sits out 
*** HOLE CARDS ***
Dealt to matiko09 [5h 2d]
Prophet1906: folds 
phrantique: folds 
Prophet1906 leaves the table
matiko09: folds 
Dickyxxx joins the table at seat #7 
ruslik_by: raises $2 to $3
SkUhNi: folds 
karllv: folds 
joker180785: folds 
23SmOkEr07: raises $8.50 to $11.50
ruslik_by: calls $8.50
*** FLOP *** [9h 4h Tc]
23SmOkEr07: bets $15
ruslik_by: raises $109.27 to $124.27 and is all-in
23SmOkEr07: calls $86.19 and is all-in
Uncalled bet ($23.08) returned to ruslik_by
*** FIRST TURN *** [9h 4h Tc] [2h]
*** FIRST RIVER *** [9h 4h Tc 2h] [7s]
*** SECOND TURN *** [9h 4h Tc] [9d]
*** SECOND RIVER *** [9h 4h Tc 9d] [As]
*** FIRST SHOW DOWN ***
23SmOkEr07: shows [Ah Ac] (a pair of Aces)
ruslik_by: shows [Jh Th] (a flush, Jack high)
ruslik_by collected $111.69 from pot
*** SECOND SHOW DOWN ***
23SmOkEr07: shows [Ah Ac] (a full house, Aces full of Nines)
ruslik_by: shows [Jh Th] (two pair, Tens and Nines)
23SmOkEr07 collected $111.69 from pot
*** SUMMARY ***
Total pot $225.88 | Rake $2.50 
Hand was run twice
FIRST Board [9h 4h Tc 2h 7s]
SECOND Board [9h 4h Tc 9d As]
Seat 1: matiko09 folded before Flop (didn't bet)
Seat 2: ruslik_by showed [Jh Th] and won ($111.69) with a flush, Jack high, and lost with two pair, Tens and Nines
Seat 3: SkUhNi folded before Flop (didn't bet)
Seat 4: karllv (button) folded before Flop (didn't bet)
Seat 5: joker180785 (small blind) folded before Flop
Seat 6: 23SmOkEr07 (big blind) showed [Ah Ac] and lost with a pair of Aces, and won ($111.69) with a full house, Aces full of Nines
Seat 7: Prophet1906 folded before Flop (didn't bet)
Seat 8: phrantique folded before Flop (didn't bet)





PokerStars Hand #154970039718:  Hold'em No Limit (£0.25/£0.50 GBP) - 2016/06/20 12:23:12 CET [2016/06/20 6:23:12 ET]
Table 'Azalea' 6-max Seat #4 is the button
Seat 1: mitsuVK (£101.60 in chips) 
Seat 2: matiko09 (£80.85 in chips) 
Seat 3: VahTang_89 (£50 in chips) 
Seat 4: faceMyBallz_ (£50 in chips) 
Seat 5: mudders693 (£67.44 in chips) 
Seat 6: Bënedic10 (£50 in chips) 
mudders693: posts small blind £0.25
Bënedic10: posts big blind £0.50
*** HOLE CARDS ***
Dealt to matiko09 [9c Ts]
mitsuVK: folds 
matiko09: folds 
VahTang_89: folds 
faceMyBallz_: folds 
mudders693: raises £1 to £1.50
Bënedic10: folds 
Uncalled bet (£1) returned to mudders693
mudders693 collected £1 from pot
mudders693: doesn't show hand 
*** SUMMARY ***
Total pot £1 | Rake £0 
Seat 1: mitsuVK folded before Flop (didn't bet)
Seat 2: matiko09 folded before Flop (didn't bet)
Seat 3: VahTang_89 folded before Flop (didn't bet)
Seat 4: faceMyBallz_ (button) folded before Flop (didn't bet)
Seat 5: mudders693 (small blind) collected (£1)
Seat 6: Bënedic10 (big blind) folded before Flop





PokerStars Hand #154970041964:  Hold'em No Limit (£0.25/£0.50 GBP) - 2016/06/20 12:23:18 CET [2016/06/20 6:23:18 ET]
Table 'Ani' 6-max Seat #4 is the button
Seat 1: rewq99887788 (£52.57 in chips) 
Seat 2: joker180785 (£50 in chips) 
Seat 3: Doobes8555 (£69.34 in chips) 
Seat 4: matiko09 (£52.76 in chips) 
Seat 5: Wwwasian (£63.27 in chips) 
Seat 6: faceMyBallz_ (£55.86 in chips) 
Wwwasian: posts small blind £0.25
faceMyBallz_: posts big blind £0.50
*** HOLE CARDS ***
Dealt to matiko09 [3h 7s]
rewq99887788: raises £1 to £1.50
joker180785: folds 
Doobes8555: folds 
matiko09: folds 
Wwwasian: folds 
faceMyBallz_: folds 
Uncalled bet (£1) returned to rewq99887788
rewq99887788 collected £1.25 from pot
*** SUMMARY ***
Total pot £1.25 | Rake £0 
Seat 1: rewq99887788 collected (£1.25)
Seat 2: joker180785 folded before Flop (didn't bet)
Seat 3: Doobes8555 folded before Flop (didn't bet)
Seat 4: matiko09 (button) folded before Flop (didn't bet)
Seat 5: Wwwasian (small blind) folded before Flop
Seat 6: faceMyBallz_ (big blind) folded before Flop





PokerStars Hand #154970044907:  Hold'em No Limit ($0.50/$1.00 USD) - 2016/06/20 12:23:26 CET [2016/06/20 6:23:26 ET]
Table 'Albiorix' 9-max Seat #6 is the button
Seat 1: arctur17 ($77.28 in chips) 
Seat 2: SkUhNi ($151.52 in chips) 
Seat 3: matiko09 ($101 in chips) 
Seat 4: 23SmOkEr07 ($145 in chips) 
Seat 5: ruslik_by ($100.25 in chips) 
Seat 6: joker180785 ($100 in chips) 
Seat 7: Pekyto ($38.68 in chips) 
Seat 8: smiley0221 ($123.73 in chips) 
Seat 9: Coolller ($102.97 in chips) 
Pekyto: posts small blind $0.50
smiley0221: posts big blind $1
*** HOLE CARDS ***
Dealt to matiko09 [Jc Js]
Coolller: folds 
arctur17: folds 
SkUhNi: folds 
matiko09: raises $2 to $3
23SmOkEr07: folds 
ruslik_by: folds 
joker180785: raises $5 to $8
Pekyto: folds 
smiley0221: folds 
matiko09: calls $5
*** FLOP *** [9s Jd 2s]
matiko09: bets $8.64
joker180785: folds 
Uncalled bet ($8.64) returned to matiko09
matiko09 collected $16.62 from pot
matiko09: doesn't show hand 
*** SUMMARY ***
Total pot $17.50 | Rake $0.88 
Board [9s Jd 2s]
Seat 1: arctur17 folded before Flop (didn't bet)
Seat 2: SkUhNi folded before Flop (didn't bet)
Seat 3: matiko09 collected ($16.62)
Seat 4: 23SmOkEr07 folded before Flop (didn't bet)
Seat 5: ruslik_by folded before Flop (didn't bet)
Seat 6: joker180785 (button) folded on the Flop
Seat 7: Pekyto (small blind) folded before Flop
Seat 8: smiley0221 (big blind) folded before Flop
Seat 9: Coolller folded before Flop (didn't bet)





PokerStars Hand #154970045667:  Hold'em No Limit (£0.25/£0.50 GBP) - 2016/06/20 12:23:28 CET [2016/06/20 6:23:28 ET]
Table 'Tesla' 6-max Seat #2 is the button
Seat 1: Rubleff85 (£40.45 in chips) 
Seat 2: matiko09 (£50 in chips) 
matiko09: posts small blind £0.25
Rubleff85: posts big blind £0.50
*** HOLE CARDS ***
Dealt to matiko09 [Kd 8s]
matiko09: raises £0.63 to £1.13
Rubleff85: folds 
Uncalled bet (£0.63) returned to matiko09
matiko09 collected £1 from pot
matiko09: doesn't show hand 
*** SUMMARY ***
Total pot £1 | Rake £0 
Seat 1: Rubleff85 (big blind) folded before Flop
Seat 2: matiko09 (button) (small blind) collected (£1)





PokerStars Hand #154970045994:  Hold'em No Limit (£0.25/£0.50 GBP) - 2016/06/20 12:23:29 CET [2016/06/20 6:23:29 ET]
Table 'Azalea' 6-max Seat #5 is the button
Seat 1: mitsuVK (£101.60 in chips) 
Seat 2: matiko09 (£80.85 in chips) 
Seat 3: VahTang_89 (£50 in chips) 
Seat 4: faceMyBallz_ (£50 in chips) 
Seat 5: mudders693 (£67.94 in chips) 
Seat 6: Bënedic10 (£50 in chips) 
Bënedic10: posts small blind £0.25
mitsuVK: posts big blind £0.50
*** HOLE CARDS ***
Dealt to matiko09 [Kc 2d]
matiko09: folds 
VahTang_89: folds 
faceMyBallz_: folds 
mudders693: raises £1 to £1.50
Bënedic10: folds 
mitsuVK: folds 
Uncalled bet (£1) returned to mudders693
mudders693 collected £1.25 from pot
mudders693: doesn't show hand 
*** SUMMARY ***
Total pot £1.25 | Rake £0 
Seat 1: mitsuVK (big blind) folded before Flop
Seat 2: matiko09 folded before Flop (didn't bet)
Seat 3: VahTang_89 folded before Flop (didn't bet)
Seat 4: faceMyBallz_ folded before Flop (didn't bet)
Seat 5: mudders693 (button) collected (£1.25)
Seat 6: Bënedic10 (small blind) folded before Flop





PokerStars Hand #154970046250:  Hold'em No Limit ($0.25/$0.50 USD) - 2016/06/20 12:23:30 CET [2016/06/20 6:23:30 ET]
Table 'Juliana II' 9-max Seat #2 is the button
Seat 1: sno05 ($30.08 in chips) 
Seat 2: cjzm ($48.30 in chips) 
Seat 3: Dr.Mouse102 ($50 in chips) 
Seat 4: RICKA16 ($50 in chips) 
Seat 5: bigkahuna380 ($33.11 in chips) 
Seat 6: sophie2000 ($50 in chips) 
Seat 7: 23SmOkEr07 ($62.61 in chips) 
Seat 8: matiko09 ($50 in chips) 
Seat 9: tugboat2008 ($93.13 in chips) 
Dr.Mouse102: posts small blind $0.25
RICKA16: posts big blind $0.50
*** HOLE CARDS ***
Dealt to matiko09 [3c Qc]
bigkahuna380: calls $0.50
sophie2000: folds 
23SmOkEr07: folds 
matiko09: folds 
tugboat2008: raises $1 to $1.50
sno05: folds 
cjzm: folds 
Dr.Mouse102: folds 
RICKA16: folds 
bigkahuna380: calls $1
*** FLOP *** [Js Kd 3d]
bigkahuna380: checks 
tugboat2008: bets $2.35
bigkahuna380: folds 
Uncalled bet ($2.35) returned to tugboat2008
bigkahuna380 leaves the table
tugboat2008 collected $3.56 from pot
*** SUMMARY ***
Total pot $3.75 | Rake $0.19 
Board [Js Kd 3d]
Seat 1: sno05 folded before Flop (didn't bet)
Seat 2: cjzm (button) folded before Flop (didn't bet)
Seat 3: Dr.Mouse102 (small blind) folded before Flop
Seat 4: RICKA16 (big blind) folded before Flop
Seat 5: bigkahuna380 folded on the Flop
Seat 6: sophie2000 folded before Flop (didn't bet)
Seat 7: 23SmOkEr07 folded before Flop (didn't bet)
Seat 8: matiko09 folded before Flop (didn't bet)
Seat 9: tugboat2008 collected ($3.56)





PokerStars Hand #154970049840:  Hold'em No Limit (£0.25/£0.50 GBP) - 2016/06/20 12:23:39 CET [2016/06/20 6:23:39 ET]
Table 'Tesla' 6-max Seat #1 is the button
Seat 1: Rubleff85 (£39.95 in chips) 
Seat 2: matiko09 (£50.50 in chips) 
Rubleff85: posts small blind £0.25
matiko09: posts big blind £0.50
*** HOLE CARDS ***
Dealt to matiko09 [3d 5s]
Rubleff85: raises £0.50 to £1
matiko09: folds 
Uncalled bet (£0.50) returned to Rubleff85
Rubleff85 collected £1 from pot
Rubleff85: doesn't show hand 
*** SUMMARY ***
Total pot £1 | Rake £0 
Seat 1: Rubleff85 (button) (small blind) collected (£1)
Seat 2: matiko09 (big blind) folded before Flop





PokerStars Hand #154970050291:  Hold'em No Limit ($0.50/$1.00 USD) - 2016/06/20 12:23:40 CET [2016/06/20 6:23:40 ET]
Table 'Isonoe II' 9-max Seat #3 is the button
Seat 2: matiko09 ($100 in chips) 
Seat 3: azzad2007 ($100 in chips) 
Seat 7: SkUhNi ($100 in chips) 
Seat 8: lewyson ($60 in chips) 
Seat 9: djammusic ($53.48 in chips) 
Avtovo will be allowed to play after the button
SkUhNi: posts small blind $0.50
lewyson: posts big blind $1
hammerwife: sits out 
*** HOLE CARDS ***
Dealt to matiko09 [Jh 2s]
djammusic: raises $1.25 to $2.25
matiko09: folds 
azzad2007: folds 
SkUhNi: folds 
lewyson: calls $1.25
*** FLOP *** [5s Kd 6c]
lewyson: checks 
djammusic: bets $3.04
lewyson: folds 
Uncalled bet ($3.04) returned to djammusic
djammusic collected $4.75 from pot
djammusic: doesn't show hand 
*** SUMMARY ***
Total pot $5 | Rake $0.25 
Board [5s Kd 6c]
Seat 2: matiko09 folded before Flop (didn't bet)
Seat 3: azzad2007 (button) folded before Flop (didn't bet)
Seat 7: SkUhNi (small blind) folded before Flop
Seat 8: lewyson (big blind) folded on the Flop
Seat 9: djammusic collected ($4.75)





PokerStars Hand #154970051684:  Hold'em No Limit (£0.25/£0.50 GBP) - 2016/06/20 12:23:44 CET [2016/06/20 6:23:44 ET]
Table 'Ani' 6-max Seat #5 is the button
Seat 1: rewq99887788 (£53.32 in chips) 
Seat 2: joker180785 (£50 in chips) 
Seat 3: Doobes8555 (£69.34 in chips) 
Seat 4: matiko09 (£52.76 in chips) 
Seat 5: Wwwasian (£63.02 in chips) 
Seat 6: faceMyBallz_ (£55.36 in chips) 
faceMyBallz_: posts small blind £0.25
rewq99887788: posts big blind £0.50
*** HOLE CARDS ***
Dealt to matiko09 [6h Qh]
joker180785: folds 
Doobes8555: folds 
matiko09: folds 
Wwwasian: folds 
faceMyBallz_: raises £0.75 to £1.25
rewq99887788: folds 
Uncalled bet (£0.75) returned to faceMyBallz_
faceMyBallz_ collected £1 from pot
faceMyBallz_: doesn't show hand 
*** SUMMARY ***
Total pot £1 | Rake £0 
Seat 1: rewq99887788 (big blind) folded before Flop
Seat 2: joker180785 folded before Flop (didn't bet)
Seat 3: Doobes8555 folded before Flop (didn't bet)
Seat 4: matiko09 folded before Flop (didn't bet)
Seat 5: Wwwasian (button) folded before Flop (didn't bet)
Seat 6: faceMyBallz_ (small blind) collected (£1)





PokerStars Hand #154970053362:  Hold'em No Limit ($0.25/$0.50 USD) - 2016/06/20 12:23:48 CET [2016/06/20 6:23:48 ET]
Table 'Scheddi II' 9-max Seat #1 is the button
Seat 1: matiko09 ($51.25 in chips) 
Seat 2: Yaaaazz ($97.95 in chips) 
Seat 3: mi$$I$Elena ($50 in chips) 
Seat 6: joker180785 ($62.14 in chips) 
Seat 7: HopeMayBee ($48.87 in chips) 
Seat 9: Infinitinium ($131.64 in chips) 
Yaaaazz: posts small blind $0.25
mi$$I$Elena: posts big blind $0.50
matiko09: posts the ante $0.10
Yaaaazz: posts the ante $0.10
mi$$I$Elena: posts the ante $0.10
joker180785: posts the ante $0.10
HopeMayBee: posts the ante $0.10
Infinitinium: posts the ante $0.10
*** HOLE CARDS ***
Dealt to matiko09 [Kc 7c]
joker180785: folds 
HopeMayBee: raises $0.75 to $1.25
Infinitinium: folds 
orochimaturi joins the table at seat #8 
matiko09: folds 
Yaaaazz: folds 
mi$$I$Elena: folds 
Uncalled bet ($0.75) returned to HopeMayBee
HopeMayBee collected $1.85 from pot
HopeMayBee: doesn't show hand 
*** SUMMARY ***
Total pot $1.85 | Rake $0 
Seat 1: matiko09 (button) folded before Flop (didn't bet)
Seat 2: Yaaaazz (small blind) folded before Flop
Seat 3: mi$$I$Elena (big blind) folded before Flop
Seat 6: joker180785 folded before Flop (didn't bet)
Seat 7: HopeMayBee collected ($1.85)
Seat 9: Infinitinium folded before Flop (didn't bet)





PokerStars Hand #154970053364:  Hold'em No Limit (€0.50/€1.00 EUR) - 2016/06/20 12:23:48 CET [2016/06/20 6:23:48 ET]
Table 'Austrasia II' 9-max Seat #2 is the button
Seat 1: Kukuryzka (€100 in chips) 
Seat 2: hammerwife (€100 in chips) 
Seat 4: matiko09 (€101 in chips) 
Seat 5: Avtovo (€100 in chips) 
Seat 8: SkUhNi (€150.25 in chips) 
Seat 9: stijner1986 (€43.04 in chips) 
matiko09: posts small blind €0.50
Avtovo: posts big blind €1
Dickyxxx: sits out 
azzad2007: sits out 
*** HOLE CARDS ***
Dealt to matiko09 [Ah Qh]
SkUhNi: folds 
stijner1986: raises €42.04 to €43.04 and is all-in
Kukuryzka: folds 
hammerwife: folds 
matiko09: raises €57.96 to €101 and is all-in
Avtovo: folds 
Uncalled bet (€57.96) returned to matiko09
*** FLOP *** [5s As 4s]
*** TURN *** [5s As 4s] [9h]
*** RIVER *** [5s As 4s 9h] [7d]
*** SHOW DOWN ***
matiko09: shows [Ah Qh] (a pair of Aces)
stijner1986: shows [2d Ad] (a pair of Aces - lower kicker)
matiko09 collected €84.83 from pot
*** SUMMARY ***
Total pot €87.08 | Rake €2.25 
Board [5s As 4s 9h 7d]
Seat 1: Kukuryzka folded before Flop (didn't bet)
Seat 2: hammerwife (button) folded before Flop (didn't bet)
Seat 4: matiko09 (small blind) showed [Ah Qh] and won (€84.83) with a pair of Aces
Seat 5: Avtovo (big blind) folded before Flop
Seat 8: SkUhNi folded before Flop (didn't bet)
Seat 9: stijner1986 showed [2d Ad] and lost with a pair of Aces





PokerStars Hand #154970054679:  Hold'em No Limit (£0.25/£0.50 GBP) - 2016/06/20 12:23:52 CET [2016/06/20 6:23:52 ET]
Table 'Tesla' 6-max Seat #2 is the button
Seat 1: Rubleff85 (£40.45 in chips) 
Seat 2: matiko09 (£50 in chips) 
matiko09: posts small blind £0.25
Rubleff85: posts big blind £0.50
*** HOLE CARDS ***
Dealt to matiko09 [9d 8h]
matiko09: raises £0.63 to £1.13
Rubleff85: calls £0.63
*** FLOP *** [7h 4c 5h]
Rubleff85: bets £0.50
matiko09: calls £0.50
*** TURN *** [7h 4c 5h] [Qc]
Rubleff85: bets £2
matiko09: folds 
Uncalled bet (£2) returned to Rubleff85
Rubleff85 collected £3.10 from pot
Rubleff85: doesn't show hand 
*** SUMMARY ***
Total pot £3.26 | Rake £0.16 
Board [7h 4c 5h Qc]
Seat 1: Rubleff85 (big blind) collected (£3.10)
Seat 2: matiko09 (button) (small blind) folded on the Turn





PokerStars Hand #154970058833:  Hold'em No Limit (£0.25/£0.50 GBP) - 2016/06/20 12:24:03 CET [2016/06/20 6:24:03 ET]
Table 'Azalea' 6-max Seat #6 is the button
Seat 1: mitsuVK (£101.10 in chips) 
Seat 2: matiko09 (£80.85 in chips) 
Seat 3: VahTang_89 (£50 in chips) 
Seat 4: faceMyBallz_ (£50 in chips) 
Seat 5: mudders693 (£68.69 in chips) 
Seat 6: Bënedic10 (£50 in chips) 
mitsuVK: posts small blind £0.25
matiko09: posts big blind £0.50
*** HOLE CARDS ***
Dealt to matiko09 [Ah Kc]
VahTang_89: folds 
faceMyBallz_: folds 
mudders693: folds 
Bënedic10: raises £0.75 to £1.25
mitsuVK: folds 
matiko09: raises £3.25 to £4.50
Bënedic10: folds 
Uncalled bet (£3.25) returned to matiko09
matiko09 collected £2.75 from pot
matiko09: doesn't show hand 
*** SUMMARY ***
Total pot £2.75 | Rake £0 
Seat 1: mitsuVK (small blind) folded before Flop
Seat 2: matiko09 (big blind) collected (£2.75)
Seat 3: VahTang_89 folded before Flop (didn't bet)
Seat 4: faceMyBallz_ folded before Flop (didn't bet)
Seat 5: mudders693 folded before Flop (didn't bet)
Seat 6: Bënedic10 (button) folded before Flop





PokerStars Hand #154970060477:  Hold'em No Limit ($0.50/$1.00 USD) - 2016/06/20 12:24:07 CET [2016/06/20 6:24:07 ET]
Table 'Isonoe II' 9-max Seat #7 is the button
Seat 2: matiko09 ($100 in chips) 
Seat 3: azzad2007 ($100 in chips) 
Seat 7: SkUhNi ($100 in chips) 
Seat 8: lewyson ($57.75 in chips) 
Seat 9: djammusic ($55.98 in chips) 
lewyson: posts small blind $0.50
djammusic: posts big blind $1
hammerwife: sits out 
Avtovo: sits out 
*** HOLE CARDS ***
Dealt to matiko09 [Ah Qd]
matiko09: raises $2 to $3
azzad2007: folds 
SkUhNi: calls $3
lewyson: folds 
djammusic: folds 
*** FLOP *** [2h 4c 5d]
matiko09: checks 
SkUhNi: bets $5
matiko09: folds 
Uncalled bet ($5) returned to SkUhNi
SkUhNi collected $7.12 from pot
SkUhNi: doesn't show hand 
*** SUMMARY ***
Total pot $7.50 | Rake $0.38 
Board [2h 4c 5d]
Seat 2: matiko09 folded on the Flop
Seat 3: azzad2007 folded before Flop (didn't bet)
Seat 7: SkUhNi (button) collected ($7.12)
Seat 8: lewyson (small blind) folded before Flop
Seat 9: djammusic (big blind) folded before Flop





PokerStars Hand #154970063500:  Hold'em No Limit ($0.50/$1.00 USD) - 2016/06/20 12:24:15 CET [2016/06/20 6:24:15 ET]
Table 'Anhui' 9-max Seat #7 is the button
Seat 1: SkUhNi ($153.92 in chips) 
Seat 2: ruslik_by ($262.85 in chips) 
Seat 3: Filojoes ($100 in chips) 
Seat 4: mavin80 ($33.38 in chips) 
Seat 5: mi$$I$Elena ($102.50 in chips) 
Seat 6: 23SmOkEr07 ($133.25 in chips) 
Seat 7: matiko09 ($143.15 in chips) 
Seat 8: blackmont111 ($78 in chips) 
Seat 9: TomBod1 ($100 in chips) 
blackmont111: posts small blind $0.50
TomBod1: posts big blind $1
*** HOLE CARDS ***
Dealt to matiko09 [8c Kd]
SkUhNi: folds 
ruslik_by: raises $2 to $3
Filojoes: folds 
mavin80: folds 
mi$$I$Elena: folds 
23SmOkEr07: folds 
matiko09: folds 
blackmont111: folds 
TomBod1: calls $2
*** FLOP *** [7d 4c 6d]
TomBod1: checks 
ruslik_by: bets $2.10
TomBod1: raises $4.10 to $6.20
ruslik_by: calls $4.10
*** TURN *** [7d 4c 6d] [As]
TomBod1: bets $9
ruslik_by: calls $9
*** RIVER *** [7d 4c 6d As] [6c]
TomBod1: checks 
ruslik_by: checks 
*** SHOW DOWN ***
TomBod1: shows [Qd Jd] (a pair of Sixes)
ruslik_by: shows [5d 5h] (two pair, Sixes and Fives)
ruslik_by collected $35.06 from pot
*** SUMMARY ***
Total pot $36.90 | Rake $1.84 
Board [7d 4c 6d As 6c]
Seat 1: SkUhNi folded before Flop (didn't bet)
Seat 2: ruslik_by showed [5d 5h] and won ($35.06) with two pair, Sixes and Fives
Seat 3: Filojoes folded before Flop (didn't bet)
Seat 4: mavin80 folded before Flop (didn't bet)
Seat 5: mi$$I$Elena folded before Flop (didn't bet)
Seat 6: 23SmOkEr07 folded before Flop (didn't bet)
Seat 7: matiko09 (button) folded before Flop (didn't bet)
Seat 8: blackmont111 (small blind) folded before Flop
Seat 9: TomBod1 (big blind) showed [Qd Jd] and lost with a pair of Sixes





PokerStars Hand #154970064211:  Hold'em No Limit ($0.50/$1.00 USD) - 2016/06/20 12:24:17 CET [2016/06/20 6:24:17 ET]
Table 'Ambrosia II' 9-max Seat #3 is the button
Seat 1: 23SmOkEr07 ($112.82 in chips) 
Seat 2: Eyeballz1307 ($76.93 in chips) 
Seat 3: mavin80 ($80.18 in chips) 
Seat 4: mi$$I$Elena ($125.12 in chips) 
Seat 5: Mattulh ($100 in chips) 
Seat 6: ruslik_by ($134.98 in chips) 
Seat 7: matiko09 ($106 in chips) 
Seat 8: hammerwife ($101.50 in chips) 
Seat 9: SkUhNi ($100 in chips) 
mi$$I$Elena: posts small blind $0.50
Mattulh: posts big blind $1
*** HOLE CARDS ***
Dealt to matiko09 [3s Js]
ruslik_by: folds 
matiko09: folds 
hammerwife: raises $2 to $3
SkUhNi: calls $3
23SmOkEr07: folds 
Eyeballz1307: folds 
mavin80: folds 
mi$$I$Elena: folds 
Mattulh: folds 
*** FLOP *** [7s 3h 4c]
hammerwife: checks 
SkUhNi: bets $5
hammerwife: calls $5
*** TURN *** [7s 3h 4c] [6h]
hammerwife: checks 
SkUhNi: checks 
*** RIVER *** [7s 3h 4c 6h] [Qs]
hammerwife: checks 
SkUhNi: checks 
*** SHOW DOWN ***
hammerwife: shows [Jd Jc] (a pair of Jacks)
SkUhNi: shows [3d 3c] (three of a kind, Threes)
SkUhNi collected $16.62 from pot
*** SUMMARY ***
Total pot $17.50 | Rake $0.88 
Board [7s 3h 4c 6h Qs]
Seat 1: 23SmOkEr07 folded before Flop (didn't bet)
Seat 2: Eyeballz1307 folded before Flop (didn't bet)
Seat 3: mavin80 (button) folded before Flop (didn't bet)
Seat 4: mi$$I$Elena (small blind) folded before Flop
Seat 5: Mattulh (big blind) folded before Flop
Seat 6: ruslik_by folded before Flop (didn't bet)
Seat 7: matiko09 folded before Flop (didn't bet)
Seat 8: hammerwife showed [Jd Jc] and lost with a pair of Jacks
Seat 9: SkUhNi showed [3d 3c] and won ($16.62) with three of a kind, Threes





PokerStars Hand #154970064455:  Hold'em No Limit (£0.25/£0.50 GBP) - 2016/06/20 12:24:18 CET [2016/06/20 6:24:18 ET]
Table 'Ani' 6-max Seat #6 is the button
Seat 1: rewq99887788 (£52.82 in chips) 
Seat 2: joker180785 (£50 in chips) 
Seat 3: Doobes8555 (£69.34 in chips) 
Seat 4: matiko09 (£52.76 in chips) 
Seat 5: Wwwasian (£63.02 in chips) 
Seat 6: faceMyBallz_ (£55.86 in chips) 
rewq99887788: posts small blind £0.25
joker180785: posts big blind £0.50
*** HOLE CARDS ***
Dealt to matiko09 [Qh 2h]
Doobes8555: calls £0.50
matiko09: folds 
Wwwasian has timed out
Wwwasian: folds 
faceMyBallz_: folds 
rewq99887788: folds 
joker180785: checks 
*** FLOP *** [5s 5h Kh]
joker180785: checks 
Doobes8555: checks 
*** TURN *** [5s 5h Kh] [Jh]
joker180785: checks 
Doobes8555: checks 
*** RIVER *** [5s 5h Kh Jh] [Kd]
joker180785: checks 
Doobes8555: checks 
*** SHOW DOWN ***
joker180785: shows [Ac 7d] (two pair, Kings and Fives)
Doobes8555: shows [7c As] (two pair, Kings and Fives)
joker180785 collected £0.60 from pot
Doobes8555 collected £0.59 from pot
*** SUMMARY ***
Total pot £1.25 | Rake £0.06 
Board [5s 5h Kh Jh Kd]
Seat 1: rewq99887788 (small blind) folded before Flop
Seat 2: joker180785 (big blind) showed [Ac 7d] and won (£0.60) with two pair, Kings and Fives
Seat 3: Doobes8555 showed [7c As] and won (£0.59) with two pair, Kings and Fives
Seat 4: matiko09 folded before Flop (didn't bet)
Seat 5: Wwwasian folded before Flop (didn't bet)
Seat 6: faceMyBallz_ (button) folded before Flop (didn't bet)





PokerStars Hand #154970066055:  Hold'em No Limit ($0.50/$1.00 USD) - 2016/06/20 12:24:22 CET [2016/06/20 6:24:22 ET]
Table 'Ernestina' 9-max Seat #1 is the button
Seat 1: diva3150 ($73.68 in chips) 
Seat 2: matiko09 ($100 in chips) 
Seat 3: Pvsx. ($136.04 in chips) 
Seat 4: SkUhNi ($103.52 in chips) 
Seat 5: DomiVY ($40 in chips) 
Seat 6: arctur17 ($95.30 in chips) 
Seat 7: Filojoes ($122.53 in chips) 
Seat 8: ruslik_by ($306.94 in chips) 
Seat 9: 23SmOkEr07 ($100 in chips) 
matiko09: posts small blind $0.50
Pvsx.: posts big blind $1
*** HOLE CARDS ***
Dealt to matiko09 [9d 4s]
SkUhNi: folds 
DomiVY: folds 
arctur17: folds 
Filojoes: folds 
ruslik_by: folds 
23SmOkEr07: folds 
diva3150: raises $2 to $3
matiko09: folds 
Pvsx.: folds 
Uncalled bet ($2) returned to diva3150
diva3150 collected $2.50 from pot
diva3150: doesn't show hand 
*** SUMMARY ***
Total pot $2.50 | Rake $0 
Seat 1: diva3150 (button) collected ($2.50)
Seat 2: matiko09 (small blind) folded before Flop
Seat 3: Pvsx. (big blind) folded before Flop
Seat 4: SkUhNi folded before Flop (didn't bet)
Seat 5: DomiVY folded before Flop (didn't bet)
Seat 6: arctur17 folded before Flop (didn't bet)
Seat 7: Filojoes folded before Flop (didn't bet)
Seat 8: ruslik_by folded before Flop (didn't bet)
Seat 9: 23SmOkEr07 folded before Flop (didn't bet)





PokerStars Hand #154970068549:  Hold'em No Limit (€0.50/€1.00 EUR) - 2016/06/20 12:24:29 CET [2016/06/20 6:24:29 ET]
Table 'Austrasia II' 9-max Seat #4 is the button
Seat 1: Kukuryzka (€100 in chips) 
Seat 2: hammerwife (€100 in chips) 
Seat 4: matiko09 (€142.79 in chips) 
Seat 5: Avtovo (€100 in chips) 
Seat 6: Dickyxxx (€100 in chips) 
Seat 8: SkUhNi (€150.25 in chips) 
Avtovo: posts small blind €0.50
Dickyxxx: posts big blind €1
azzad2007: sits out 
*** HOLE CARDS ***
Dealt to matiko09 [As Ks]
SkUhNi: folds 
Kukuryzka: folds 
hammerwife: folds 
stijner1986 leaves the table
matiko09: raises €1.27 to €2.27
Avtovo: folds 
Dickyxxx: folds 
Uncalled bet (€1.27) returned to matiko09
matiko09 collected €2.50 from pot
matiko09: doesn't show hand 
*** SUMMARY ***
Total pot €2.50 | Rake €0 
Seat 1: Kukuryzka folded before Flop (didn't bet)
Seat 2: hammerwife folded before Flop (didn't bet)
Seat 4: matiko09 (button) collected (€2.50)
Seat 5: Avtovo (small blind) folded before Flop
Seat 6: Dickyxxx (big blind) folded before Flop
Seat 8: SkUhNi folded before Flop (didn't bet)





PokerStars Hand #154970069424:  Hold'em No Limit ($0.25/$0.50 USD) - 2016/06/20 12:24:31 CET [2016/06/20 6:24:31 ET]
Table 'Scheddi II' 9-max Seat #2 is the button
Seat 1: matiko09 ($51.15 in chips) 
Seat 2: Yaaaazz ($97.60 in chips) 
Seat 3: mi$$I$Elena ($50 in chips) 
Seat 6: joker180785 ($62.04 in chips) 
Seat 7: HopeMayBee ($50.12 in chips) 
Seat 9: Infinitinium ($131.54 in chips) 
mi$$I$Elena: posts small blind $0.25
joker180785: posts big blind $0.50
orochimaturi: sits out 
matiko09: posts the ante $0.10
Yaaaazz: posts the ante $0.10
mi$$I$Elena: posts the ante $0.10
joker180785: posts the ante $0.10
HopeMayBee: posts the ante $0.10
Infinitinium: posts the ante $0.10
*** HOLE CARDS ***
Dealt to matiko09 [Kc 2c]
HopeMayBee: folds 
Infinitinium: calls $0.50
matiko09: raises $1.50 to $2
Yaaaazz: folds 
mi$$I$Elena: folds 
joker180785: folds 
Infinitinium: calls $1.50
*** FLOP *** [5d Jd As]
Infinitinium: bets $2.54
matiko09: folds 
Uncalled bet ($2.54) returned to Infinitinium
Infinitinium collected $5.08 from pot
Infinitinium: doesn't show hand 
*** SUMMARY ***
Total pot $5.35 | Rake $0.27 
Board [5d Jd As]
Seat 1: matiko09 folded on the Flop
Seat 2: Yaaaazz (button) folded before Flop (didn't bet)
Seat 3: mi$$I$Elena (small blind) folded before Flop
Seat 6: joker180785 (big blind) folded before Flop
Seat 7: HopeMayBee folded before Flop (didn't bet)
Seat 9: Infinitinium collected ($5.08)





PokerStars Hand #154970072717:  Hold'em No Limit ($0.25/$0.50 USD) - 2016/06/20 12:24:40 CET [2016/06/20 6:24:40 ET]
Table 'Juliana II' 9-max Seat #3 is the button
Seat 1: sno05 ($50 in chips) 
Seat 2: cjzm ($48.30 in chips) 
Seat 3: Dr.Mouse102 ($50 in chips) 
Seat 4: RICKA16 ($49.50 in chips) 
Seat 6: sophie2000 ($50 in chips) 
Seat 7: 23SmOkEr07 ($62.61 in chips) 
Seat 8: matiko09 ($50 in chips) 
Seat 9: tugboat2008 ($95.19 in chips) 
RICKA16: posts small blind $0.25
sophie2000: posts big blind $0.50
*** HOLE CARDS ***
Dealt to matiko09 [Td Qh]
23SmOkEr07: folds 
ljryviltj joins the table at seat #5 
matiko09: folds 
tugboat2008: folds 
sno05: raises $1 to $1.50
cjzm: calls $1.50
Dr.Mouse102: folds 
RICKA16: folds 
sophie2000: folds 
*** FLOP *** [Jd Kc 8s]
sno05: checks 
cjzm: checks 
*** TURN *** [Jd Kc 8s] [2s]
sno05: bets $2.50
cjzm: folds 
Uncalled bet ($2.50) returned to sno05
sno05 collected $3.56 from pot
sno05: doesn't show hand 
*** SUMMARY ***
Total pot $3.75 | Rake $0.19 
Board [Jd Kc 8s 2s]
Seat 1: sno05 collected ($3.56)
Seat 2: cjzm folded on the Turn
Seat 3: Dr.Mouse102 (button) folded before Flop (didn't bet)
Seat 4: RICKA16 (small blind) folded before Flop
Seat 6: sophie2000 (big blind) folded before Flop
Seat 7: 23SmOkEr07 folded before Flop (didn't bet)
Seat 8: matiko09 folded before Flop (didn't bet)
Seat 9: tugboat2008 folded before Flop (didn't bet)





PokerStars Hand #154970074769:  Hold'em No Limit ($0.50/$1.00 USD) - 2016/06/20 12:24:45 CET [2016/06/20 6:24:45 ET]
Table 'Albiorix' 9-max Seat #7 is the button
Seat 1: arctur17 ($77.28 in chips) 
Seat 2: SkUhNi ($151.52 in chips) 
Seat 3: matiko09 ($109.62 in chips) 
Seat 4: 23SmOkEr07 ($145 in chips) 
Seat 5: ruslik_by ($100.25 in chips) 
Seat 6: joker180785 ($100 in chips) 
Seat 7: Pekyto ($38.18 in chips) 
Seat 8: smiley0221 ($122.73 in chips) 
Seat 9: Coolller ($102.97 in chips) 
smiley0221: posts small blind $0.50
Coolller: posts big blind $1
*** HOLE CARDS ***
Dealt to matiko09 [9h 6h]
arctur17: folds 
SkUhNi: raises $2 to $3
matiko09: folds 
23SmOkEr07: folds 
ruslik_by: folds 
joker180785: folds 
Pekyto: folds 
smiley0221: calls $2.50
Coolller: calls $2
*** FLOP *** [3s 2s 3d]
smiley0221: checks 
Coolller: bets $5
SkUhNi: calls $5
smiley0221: calls $5
*** TURN *** [3s 2s 3d] [Ac]
smiley0221: checks 
Coolller: bets $10
SkUhNi: folds 
smiley0221: raises $15 to $25
Coolller: calls $15
*** RIVER *** [3s 2s 3d Ac] [6d]
smiley0221: bets $36
Coolller: calls $36
*** SHOW DOWN ***
smiley0221: shows [Jd 9d] (a pair of Threes)
Coolller: shows [As Ks] (two pair, Aces and Threes)
Coolller collected $143.50 from pot
*** SUMMARY ***
Total pot $146 | Rake $2.50 
Board [3s 2s 3d Ac 6d]
Seat 1: arctur17 folded before Flop (didn't bet)
Seat 2: SkUhNi folded on the Turn
Seat 3: matiko09 folded before Flop (didn't bet)
Seat 4: 23SmOkEr07 folded before Flop (didn't bet)
Seat 5: ruslik_by folded before Flop (didn't bet)
Seat 6: joker180785 folded before Flop (didn't bet)
Seat 7: Pekyto (button) folded before Flop (didn't bet)
Seat 8: smiley0221 (small blind) showed [Jd 9d] and lost with a pair of Threes
Seat 9: Coolller (big blind) showed [As Ks] and won ($143.50) with two pair, Aces and Threes





PokerStars Hand #154970075264:  Hold'em No Limit (£0.25/£0.50 GBP) - 2016/06/20 12:24:46 CET [2016/06/20 6:24:46 ET]
Table 'Azalea' 6-max Seat #1 is the button
Seat 1: mitsuVK (£100.85 in chips) 
Seat 2: matiko09 (£82.35 in chips) 
Seat 3: VahTang_89 (£50 in chips) 
Seat 4: faceMyBallz_ (£50 in chips) 
Seat 5: mudders693 (£68.69 in chips) 
Seat 6: Bënedic10 (£50 in chips) 
matiko09: posts small blind £0.25
VahTang_89: posts big blind £0.50
*** HOLE CARDS ***
Dealt to matiko09 [8h Tc]
faceMyBallz_: folds 
mudders693: raises £1 to £1.50
Bënedic10: folds 
mitsuVK: calls £1.50
matiko09: folds 
VahTang_89: calls £1
*** FLOP *** [6d 5h 3c]
VahTang_89: checks 
mudders693: checks 
mitsuVK: bets £2
VahTang_89: folds 
mudders693: folds 
Uncalled bet (£2) returned to mitsuVK
mitsuVK collected £4.51 from pot
mitsuVK: doesn't show hand 
*** SUMMARY ***
Total pot £4.75 | Rake £0.24 
Board [6d 5h 3c]
Seat 1: mitsuVK (button) collected (£4.51)
Seat 2: matiko09 (small blind) folded before Flop
Seat 3: VahTang_89 (big blind) folded on the Flop
Seat 4: faceMyBallz_ folded before Flop (didn't bet)
Seat 5: mudders693 folded on the Flop
Seat 6: Bënedic10 folded before Flop (didn't bet)





PokerStars Hand #154970075067:  Hold'em No Limit (€0.50/€1.00 EUR) - 2016/06/20 12:24:46 CET [2016/06/20 6:24:46 ET]
Table 'Austrasia II' 9-max Seat #5 is the button
Seat 1: Kukuryzka (€100 in chips) 
Seat 2: hammerwife (€100 in chips) 
Seat 4: matiko09 (€144.29 in chips) 
Seat 5: Avtovo (€100 in chips) 
Seat 6: Dickyxxx (€100 in chips) 
Seat 7: azzad2007 (€100 in chips) 
Seat 8: SkUhNi (€150.25 in chips) 
Dickyxxx: posts small blind €0.50
azzad2007: posts big blind €1
*** HOLE CARDS ***
Dealt to matiko09 [3d Ks]
SkUhNi: folds 
Kukuryzka: folds 
hammerwife: folds 
matiko09: folds 
Avtovo: raises €1.50 to €2.50
Dickyxxx: folds 
azzad2007: calls €1.50
*** FLOP *** [4h 5s 6c]
azzad2007: checks 
Avtovo: bets €3
azzad2007: calls €3
*** TURN *** [4h 5s 6c] [Qs]
azzad2007: checks 
Avtovo: bets €5.46
azzad2007: raises €14.55 to €20.01
Avtovo: calls €14.55
*** RIVER *** [4h 5s 6c Qs] [Ts]
azzad2007: bets €38.43
Avtovo: calls €38.43
*** SHOW DOWN ***
azzad2007: shows [As 3s] (a flush, Ace high)
Avtovo: mucks hand 
azzad2007 collected €126.13 from pot
*** SUMMARY ***
Total pot €128.38 | Rake €2.25 
Board [4h 5s 6c Qs Ts]
Seat 1: Kukuryzka folded before Flop (didn't bet)
Seat 2: hammerwife folded before Flop (didn't bet)
Seat 4: matiko09 folded before Flop (didn't bet)
Seat 5: Avtovo (button) mucked [5h 5c]
Seat 6: Dickyxxx (small blind) folded before Flop
Seat 7: azzad2007 (big blind) showed [As 3s] and won (€126.13) with a flush, Ace high
Seat 8: SkUhNi folded before Flop (didn't bet)





PokerStars Hand #154970077055:  Hold'em No Limit (£0.25/£0.50 GBP) - 2016/06/20 12:24:51 CET [2016/06/20 6:24:51 ET]
Table 'Tesla' 6-max Seat #1 is the button
Seat 1: Rubleff85 (£41.92 in chips) 
Seat 2: matiko09 (£50 in chips) 
Rubleff85: posts small blind £0.25
matiko09: posts big blind £0.50
*** HOLE CARDS ***
Dealt to matiko09 [3c As]
Rubleff85: raises £0.50 to £1
matiko09: calls £0.50
*** FLOP *** [Ac 2d 5s]
matiko09: checks 
Rubleff85: bets £0.50
matiko09: calls £0.50
*** TURN *** [Ac 2d 5s] [3s]
matiko09: checks 
Rubleff85: checks 
*** RIVER *** [Ac 2d 5s 3s] [Kh]
matiko09: bets £0.88
Rubleff85: calls £0.88
*** SHOW DOWN ***
matiko09: shows [3c As] (two pair, Aces and Threes)
Rubleff85: mucks hand 
matiko09 collected £4.52 from pot
*** SUMMARY ***
Total pot £4.76 | Rake £0.24 
Board [Ac 2d 5s 3s Kh]
Seat 1: Rubleff85 (button) (small blind) mucked [Th Kc]
Seat 2: matiko09 (big blind) showed [3c As] and won (£4.52) with two pair, Aces and Threes





PokerStars Hand #154970080861:  Hold'em No Limit ($0.50/$1.00 USD) - 2016/06/20 12:25:01 CET [2016/06/20 6:25:01 ET]
Table 'Ernestina' 9-max Seat #2 is the button
Seat 1: diva3150 ($75.18 in chips) 
Seat 2: matiko09 ($100 in chips) 
Seat 3: Pvsx. ($135.04 in chips) 
Seat 4: SkUhNi ($103.52 in chips) 
Seat 5: DomiVY ($40 in chips) 
Seat 6: arctur17 ($95.30 in chips) 
Seat 7: Filojoes ($122.53 in chips) 
Seat 8: ruslik_by ($306.94 in chips) 
Seat 9: 23SmOkEr07 ($100 in chips) 
Pvsx.: posts small blind $0.50
SkUhNi: posts big blind $1
*** HOLE CARDS ***
Dealt to matiko09 [4s 7d]
DomiVY: folds 
arctur17: folds 
Filojoes: folds 
ruslik_by: folds 
23SmOkEr07: raises $1.50 to $2.50
diva3150: folds 
matiko09: folds 
Pvsx.: folds 
SkUhNi: folds 
Uncalled bet ($1.50) returned to 23SmOkEr07
23SmOkEr07 collected $2.50 from pot
23SmOkEr07: doesn't show hand 
*** SUMMARY ***
Total pot $2.50 | Rake $0 
Seat 1: diva3150 folded before Flop (didn't bet)
Seat 2: matiko09 (button) folded before Flop (didn't bet)
Seat 3: Pvsx. (small blind) folded before Flop
Seat 4: SkUhNi (big blind) folded before Flop
Seat 5: DomiVY folded before Flop (didn't bet)
Seat 6: arctur17 folded before Flop (didn't bet)
Seat 7: Filojoes folded before Flop (didn't bet)
Seat 8: ruslik_by folded before Flop (didn't bet)
Seat 9: 23SmOkEr07 collected ($2.50)





PokerStars Hand #154970080689:  Hold'em No Limit (£0.25/£0.50 GBP) - 2016/06/20 12:25:01 CET [2016/06/20 6:25:01 ET]
Table 'Ani' 6-max Seat #1 is the button
Seat 1: rewq99887788 (£52.57 in chips) 
Seat 2: joker180785 (£50.10 in chips) 
Seat 3: Doobes8555 (£69.43 in chips) 
Seat 4: matiko09 (£52.76 in chips) 
Seat 5: Wwwasian (£63.02 in chips) 
Seat 6: faceMyBallz_ (£55.86 in chips) 
joker180785: posts small blind £0.25
Doobes8555: posts big blind £0.50
*** HOLE CARDS ***
Dealt to matiko09 [8s 8c]
matiko09: raises £1 to £1.50
Wwwasian: folds 
faceMyBallz_: folds 
rewq99887788: folds 
joker180785: folds 
Doobes8555: calls £1
*** FLOP *** [9h Qs 7d]
Doobes8555: checks 
matiko09: checks 
*** TURN *** [9h Qs 7d] [As]
Doobes8555: checks 
matiko09: checks 
*** RIVER *** [9h Qs 7d As] [Jh]
Doobes8555: checks 
matiko09: checks 
*** SHOW DOWN ***
Doobes8555: shows [9s Tc] (a pair of Nines)
matiko09: mucks hand 
Doobes8555 collected £3.09 from pot
*** SUMMARY ***
Total pot £3.25 | Rake £0.16 
Board [9h Qs 7d As Jh]
Seat 1: rewq99887788 (button) folded before Flop (didn't bet)
Seat 2: joker180785 (small blind) folded before Flop
Seat 3: Doobes8555 (big blind) showed [9s Tc] and won (£3.09) with a pair of Nines
Seat 4: matiko09 mucked [8s 8c]
Seat 5: Wwwasian folded before Flop (didn't bet)
Seat 6: faceMyBallz_ folded before Flop (didn't bet)





PokerStars Hand #154970083372:  Hold'em No Limit ($0.50/$1.00 USD) - 2016/06/20 12:25:08 CET [2016/06/20 6:25:08 ET]
Table 'Isonoe II' 9-max Seat #8 is the button
Seat 1: hammerwife ($100 in chips) 
Seat 2: matiko09 ($100 in chips) 
Seat 3: azzad2007 ($100 in chips) 
Seat 7: SkUhNi ($104.12 in chips) 
Seat 8: lewyson ($57.25 in chips) 
Seat 9: djammusic ($54.98 in chips) 
djammusic: posts small blind $0.50
hammerwife: posts big blind $1
Avtovo: sits out 
*** HOLE CARDS ***
Dealt to matiko09 [5c 3h]
matiko09: folds 
azzad2007: folds 
SkUhNi: folds 
lewyson: folds 
djammusic: raises $1.25 to $2.25
Filojoes joins the table at seat #5 
hammerwife: folds 
Uncalled bet ($1.25) returned to djammusic
djammusic collected $2 from pot
djammusic: doesn't show hand 
*** SUMMARY ***
Total pot $2 | Rake $0 
Seat 1: hammerwife (big blind) folded before Flop
Seat 2: matiko09 folded before Flop (didn't bet)
Seat 3: azzad2007 folded before Flop (didn't bet)
Seat 7: SkUhNi folded before Flop (didn't bet)
Seat 8: lewyson (button) folded before Flop (didn't bet)
Seat 9: djammusic (small blind) collected ($2)





PokerStars Hand #154970084128:  Hold'em No Limit ($0.50/$1.00 USD) - 2016/06/20 12:25:10 CET [2016/06/20 6:25:10 ET]
Table 'Pongola' 9-max Seat #5 is the button
Seat 1: matiko09 ($101.50 in chips) 
Seat 2: ruslik_by ($134.77 in chips) 
Seat 3: SkUhNi ($100 in chips) 
Seat 4: karllv ($119.79 in chips) 
Seat 5: joker180785 ($107.43 in chips) 
Seat 6: 23SmOkEr07 ($111.69 in chips) 
Seat 7: Dickyxxx ($100 in chips) 
Seat 8: phrantique ($154.32 in chips) 
23SmOkEr07: posts small blind $0.50
Dickyxxx: posts big blind $1
Filojoes: sits out 
*** HOLE CARDS ***
Dealt to matiko09 [5d Ah]
phrantique: folds 
matiko09: folds 
ruslik_by: raises $2 to $3
SkUhNi: folds 
karllv: folds 
joker180785: folds 
23SmOkEr07: folds 
Dickyxxx: folds 
Uncalled bet ($2) returned to ruslik_by
ruslik_by collected $2.50 from pot
ruslik_by: doesn't show hand 
*** SUMMARY ***
Total pot $2.50 | Rake $0 
Seat 1: matiko09 folded before Flop (didn't bet)
Seat 2: ruslik_by collected ($2.50)
Seat 3: SkUhNi folded before Flop (didn't bet)
Seat 4: karllv folded before Flop (didn't bet)
Seat 5: joker180785 (button) folded before Flop (didn't bet)
Seat 6: 23SmOkEr07 (small blind) folded before Flop
Seat 7: Dickyxxx (big blind) folded before Flop
Seat 8: phrantique folded before Flop (didn't bet)





PokerStars Hand #154970087327:  Hold'em No Limit ($0.25/$0.50 USD) - 2016/06/20 12:25:18 CET [2016/06/20 6:25:18 ET]
Table 'Scheddi II' 9-max Seat #3 is the button
Seat 1: matiko09 ($50 in chips) 
Seat 2: Yaaaazz ($97.50 in chips) 
Seat 3: mi$$I$Elena ($50 in chips) 
Seat 6: joker180785 ($61.44 in chips) 
Seat 7: HopeMayBee ($50.02 in chips) 
Seat 9: Infinitinium ($134.52 in chips) 
No Money NW will be allowed to play after the button
joker180785: posts small blind $0.25
HopeMayBee: posts big blind $0.50
orochimaturi: sits out 
matiko09: posts the ante $0.10
Yaaaazz: posts the ante $0.10
mi$$I$Elena: posts the ante $0.10
joker180785: posts the ante $0.10
HopeMayBee: posts the ante $0.10
Infinitinium: posts the ante $0.10
*** HOLE CARDS ***
Dealt to matiko09 [3c 8c]
Infinitinium: folds 
matiko09: folds 
Yaaaazz: raises $0.75 to $1.25
mi$$I$Elena: folds 
joker180785: folds 
HopeMayBee: calls $0.75
*** FLOP *** [7s 7c 5c]
HopeMayBee: checks 
Yaaaazz: checks 
*** TURN *** [7s 7c 5c] [5s]
GOOFA13 joins the table at seat #4 
HopeMayBee: checks 
Yaaaazz: checks 
*** RIVER *** [7s 7c 5c 5s] [Js]
HopeMayBee: checks 
Yaaaazz: checks 
*** SHOW DOWN ***
HopeMayBee: shows [Ah Qh] (two pair, Sevens and Fives)
Yaaaazz: mucks hand 
HopeMayBee collected $3.18 from pot
*** SUMMARY ***
Total pot $3.35 | Rake $0.17 
Board [7s 7c 5c 5s Js]
Seat 1: matiko09 folded before Flop (didn't bet)
Seat 2: Yaaaazz mucked [9h Qc]
Seat 3: mi$$I$Elena (button) folded before Flop (didn't bet)
Seat 6: joker180785 (small blind) folded before Flop
Seat 7: HopeMayBee (big blind) showed [Ah Qh] and won ($3.18) with two pair, Sevens and Fives
Seat 9: Infinitinium folded before Flop (didn't bet)





PokerStars Hand #154970090452:  Hold'em No Limit ($0.50/$1.00 USD) - 2016/06/20 12:25:27 CET [2016/06/20 6:25:27 ET]
Table 'Ernestina' 9-max Seat #3 is the button
Seat 1: diva3150 ($75.18 in chips) 
Seat 2: matiko09 ($100 in chips) 
Seat 3: Pvsx. ($134.54 in chips) 
Seat 4: SkUhNi ($102.52 in chips) 
Seat 6: arctur17 ($95.30 in chips) 
Seat 7: Filojoes ($122.53 in chips) 
Seat 8: ruslik_by ($306.94 in chips) 
Seat 9: 23SmOkEr07 ($101.50 in chips) 
SkUhNi: posts small blind $0.50
DomiVY: is sitting out 
arctur17: posts big blind $1
*** HOLE CARDS ***
Dealt to matiko09 [Ts 3s]
DomiVY leaves the table
Dickyxxx joins the table at seat #5 
Filojoes: folds 
Filojoes leaves the table
Avtovo joins the table at seat #7 
ruslik_by: raises $2 to $3
23SmOkEr07: folds 
diva3150: folds 
matiko09: folds 
Pvsx.: calls $3
SkUhNi: folds 
arctur17: folds 
*** FLOP *** [Ac 2c Th]
ruslik_by: bets $2.42
Pvsx.: calls $2.42
*** TURN *** [Ac 2c Th] [6c]
ruslik_by: bets $3.98
Pvsx.: raises $10.02 to $14
ruslik_by: folds 
Uncalled bet ($10.02) returned to Pvsx.
Pvsx. collected $19.28 from pot
Pvsx.: doesn't show hand 
*** SUMMARY ***
Total pot $20.30 | Rake $1.02 
Board [Ac 2c Th 6c]
Seat 1: diva3150 folded before Flop (didn't bet)
Seat 2: matiko09 folded before Flop (didn't bet)
Seat 3: Pvsx. (button) collected ($19.28)
Seat 4: SkUhNi (small blind) folded before Flop
Seat 6: arctur17 (big blind) folded before Flop
Seat 7: Filojoes folded before Flop (didn't bet)
Seat 8: ruslik_by folded on the Turn
Seat 9: 23SmOkEr07 folded before Flop (didn't bet)





PokerStars Hand #154970091331:  Hold'em No Limit ($0.50/$1.00 USD) - 2016/06/20 12:25:29 CET [2016/06/20 6:25:29 ET]
Table 'Isonoe II' 9-max Seat #9 is the button
Seat 1: hammerwife ($100 in chips) 
Seat 2: matiko09 ($100 in chips) 
Seat 3: azzad2007 ($100 in chips) 
Seat 7: SkUhNi ($104.12 in chips) 
Seat 8: lewyson ($57.25 in chips) 
Seat 9: djammusic ($55.98 in chips) 
hammerwife: posts small blind $0.50
matiko09: posts big blind $1
Avtovo: sits out 
Filojoes: sits out 
*** HOLE CARDS ***
Dealt to matiko09 [5d 4h]
azzad2007: folds 
SkUhNi: folds 
lewyson: folds 
djammusic: folds 
hammerwife: folds 
Uncalled bet ($0.50) returned to matiko09
matiko09 collected $1 from pot
matiko09: doesn't show hand 
*** SUMMARY ***
Total pot $1 | Rake $0 
Seat 1: hammerwife (small blind) folded before Flop
Seat 2: matiko09 (big blind) collected ($1)
Seat 3: azzad2007 folded before Flop (didn't bet)
Seat 7: SkUhNi folded before Flop (didn't bet)
Seat 8: lewyson folded before Flop (didn't bet)
Seat 9: djammusic (button) folded before Flop (didn't bet)





PokerStars Hand #154970091757:  Hold'em No Limit (£0.25/£0.50 GBP) - 2016/06/20 12:25:30 CET [2016/06/20 6:25:30 ET]
Table 'Tesla' 6-max Seat #2 is the button
Seat 1: Rubleff85 (£39.54 in chips) 
Seat 2: matiko09 (£52.14 in chips) 
matiko09: posts small blind £0.25
Rubleff85: posts big blind £0.50
*** HOLE CARDS ***
Dealt to matiko09 [7d 2c]
matiko09: folds 
Uncalled bet (£0.25) returned to Rubleff85
Rubleff85 collected £0.50 from pot
Rubleff85: doesn't show hand 
*** SUMMARY ***
Total pot £0.50 | Rake £0 
Seat 1: Rubleff85 (big blind) collected (£0.50)
Seat 2: matiko09 (button) (small blind) folded before Flop





PokerStars Hand #154970092338:  Hold'em No Limit (£0.25/£0.50 GBP) - 2016/06/20 12:25:32 CET [2016/06/20 6:25:32 ET]
Table 'Azalea' 6-max Seat #2 is the button
Seat 1: mitsuVK (£103.86 in chips) 
Seat 2: matiko09 (£82.10 in chips) 
Seat 3: VahTang_89 (£50 in chips) 
Seat 4: faceMyBallz_ (£50 in chips) 
Seat 5: mudders693 (£67.19 in chips) 
Seat 6: Bënedic10 (£50 in chips) 
VahTang_89: posts small blind £0.25
faceMyBallz_: posts big blind £0.50
*** HOLE CARDS ***
Dealt to matiko09 [Kh 8h]
mudders693: folds 
Bënedic10: folds 
mitsuVK: folds 
matiko09: raises £0.63 to £1.13
VahTang_89: folds 
faceMyBallz_: calls £0.63
*** FLOP *** [Qh 9h 6s]
faceMyBallz_: checks 
matiko09: bets £1.55
faceMyBallz_: folds 
Uncalled bet (£1.55) returned to matiko09
matiko09 collected £2.38 from pot
matiko09: doesn't show hand 
*** SUMMARY ***
Total pot £2.51 | Rake £0.13 
Board [Qh 9h 6s]
Seat 1: mitsuVK folded before Flop (didn't bet)
Seat 2: matiko09 (button) collected (£2.38)
Seat 3: VahTang_89 (small blind) folded before Flop
Seat 4: faceMyBallz_ (big blind) folded on the Flop
Seat 5: mudders693 folded before Flop (didn't bet)
Seat 6: Bënedic10 folded before Flop (didn't bet)





PokerStars Hand #154970092861:  Hold'em No Limit ($0.50/$1.00 USD) - 2016/06/20 12:25:33 CET [2016/06/20 6:25:33 ET]
Table 'Pongola' 9-max Seat #6 is the button
Seat 1: matiko09 ($101.50 in chips) 
Seat 2: ruslik_by ($136.27 in chips) 
Seat 3: SkUhNi ($100 in chips) 
Seat 4: karllv ($119.79 in chips) 
Seat 5: joker180785 ($107.43 in chips) 
Seat 6: 23SmOkEr07 ($111.19 in chips) 
Seat 7: Dickyxxx ($100 in chips) 
Seat 8: phrantique ($154.32 in chips) 
Dickyxxx: posts small blind $0.50
phrantique: posts big blind $1
Filojoes: sits out 
*** HOLE CARDS ***
Dealt to matiko09 [8s Kd]
matiko09: folds 
ruslik_by: folds 
SkUhNi: raises $2 to $3
karllv: folds 
joker180785: folds 
23SmOkEr07: calls $3
Dickyxxx: folds 
phrantique: calls $2
*** FLOP *** [Ad 2d Ks]
phrantique: checks 
SkUhNi: checks 
23SmOkEr07: checks 
*** TURN *** [Ad 2d Ks] [4d]
phrantique: checks 
SkUhNi: checks 
23SmOkEr07: checks 
*** RIVER *** [Ad 2d Ks 4d] [3d]
phrantique: checks 
SkUhNi: checks 
23SmOkEr07: bets $5.05
phrantique: folds 
SkUhNi: folds 
Uncalled bet ($5.05) returned to 23SmOkEr07
23SmOkEr07 collected $9.02 from pot
23SmOkEr07: doesn't show hand 
*** SUMMARY ***
Total pot $9.50 | Rake $0.48 
Board [Ad 2d Ks 4d 3d]
Seat 1: matiko09 folded before Flop (didn't bet)
Seat 2: ruslik_by folded before Flop (didn't bet)
Seat 3: SkUhNi folded on the River
Seat 4: karllv folded before Flop (didn't bet)
Seat 5: joker180785 folded before Flop (didn't bet)
Seat 6: 23SmOkEr07 (button) collected ($9.02)
Seat 7: Dickyxxx (small blind) folded before Flop
Seat 8: phrantique (big blind) folded on the River





PokerStars Hand #154970093967:  Hold'em No Limit (£0.25/£0.50 GBP) - 2016/06/20 12:25:36 CET [2016/06/20 6:25:36 ET]
Table 'Tesla' 6-max Seat #1 is the button
Seat 1: Rubleff85 (£39.79 in chips) 
Seat 2: matiko09 (£51.89 in chips) 
Rubleff85: posts small blind £0.25
matiko09: posts big blind £0.50
*** HOLE CARDS ***
Dealt to matiko09 [Ts Ac]
Rubleff85: folds 
Uncalled bet (£0.25) returned to matiko09
matiko09 collected £0.50 from pot
matiko09: doesn't show hand 
*** SUMMARY ***
Total pot £0.50 | Rake £0 
Seat 1: Rubleff85 (button) (small blind) folded before Flop
Seat 2: matiko09 (big blind) collected (£0.50)





PokerStars Hand #154970094420:  Hold'em No Limit ($0.25/$0.50 USD) - 2016/06/20 12:25:37 CET [2016/06/20 6:25:37 ET]
Table 'Juliana II' 9-max Seat #4 is the button
Seat 1: sno05 ($52.06 in chips) 
Seat 2: cjzm ($46.80 in chips) 
Seat 3: Dr.Mouse102 ($50 in chips) 
Seat 4: RICKA16 ($49.25 in chips) 
Seat 6: sophie2000 ($50 in chips) 
Seat 7: 23SmOkEr07 ($62.61 in chips) 
Seat 8: matiko09 ($50 in chips) 
Seat 9: tugboat2008 ($95.19 in chips) 
ljryviltj will be allowed to play after the button
sophie2000: posts small blind $0.25
23SmOkEr07: posts big blind $0.50
*** HOLE CARDS ***
Dealt to matiko09 [Kh 4s]
matiko09: folds 
tugboat2008: folds 
sno05: folds 
cjzm: folds 
Dr.Mouse102: folds 
RICKA16: raises $1 to $1.50
sophie2000: folds 
23SmOkEr07: folds 
Uncalled bet ($1) returned to RICKA16
RICKA16 collected $1.25 from pot
RICKA16: doesn't show hand 
*** SUMMARY ***
Total pot $1.25 | Rake $0 
Seat 1: sno05 folded before Flop (didn't bet)
Seat 2: cjzm folded before Flop (didn't bet)
Seat 3: Dr.Mouse102 folded before Flop (didn't bet)
Seat 4: RICKA16 (button) collected ($1.25)
Seat 6: sophie2000 (small blind) folded before Flop
Seat 7: 23SmOkEr07 (big blind) folded before Flop
Seat 8: matiko09 folded before Flop (didn't bet)
Seat 9: tugboat2008 folded before Flop (didn't bet)





PokerStars Hand #154970095617:  Hold'em No Limit (£0.25/£0.50 GBP) - 2016/06/20 12:25:40 CET [2016/06/20 6:25:40 ET]
Table 'Tesla' 6-max Seat #2 is the button
Seat 1: Rubleff85 (£39.54 in chips) 
Seat 2: matiko09 (£52.14 in chips) 
matiko09: posts small blind £0.25
Rubleff85: posts big blind £0.50
*** HOLE CARDS ***
Dealt to matiko09 [Kd 2d]
matiko09: raises £0.63 to £1.13
Rubleff85: calls £0.63
*** FLOP *** [9h 2s Qs]
Rubleff85: checks 
matiko09: checks 
*** TURN *** [9h 2s Qs] [4h]
Rubleff85: checks 
matiko09: bets £0.50
Rubleff85: folds 
Uncalled bet (£0.50) returned to matiko09
matiko09 collected £2.15 from pot
matiko09: doesn't show hand 
*** SUMMARY ***
Total pot £2.26 | Rake £0.11 
Board [9h 2s Qs 4h]
Seat 1: Rubleff85 (big blind) folded on the Turn
Seat 2: matiko09 (button) (small blind) collected (£2.15)





PokerStars Hand #154970095636:  Hold'em No Limit (£0.25/£0.50 GBP) - 2016/06/20 12:25:40 CET [2016/06/20 6:25:40 ET]
Table 'Ani' 6-max Seat #2 is the button
Seat 1: rewq99887788 (£52.57 in chips) 
Seat 2: joker180785 (£50 in chips) 
Seat 3: Doobes8555 (£71.02 in chips) 
Seat 4: matiko09 (£51.26 in chips) 
Seat 5: Wwwasian (£63.02 in chips) 
Seat 6: faceMyBallz_ (£55.86 in chips) 
Doobes8555: posts small blind £0.25
matiko09: posts big blind £0.50
*** HOLE CARDS ***
Dealt to matiko09 [4d 2c]
Wwwasian: folds 
faceMyBallz_: folds 
rewq99887788: calls £0.50
joker180785: raises £1.50 to £2
Doobes8555: folds 
matiko09: folds 
rewq99887788: calls £1.50
*** FLOP *** [7h Qd 3h]
rewq99887788: checks 
joker180785: bets £2.39
Wwwasian is disconnected 
rewq99887788: calls £2.39
*** TURN *** [7h Qd 3h] [8h]
rewq99887788: checks 
joker180785: bets £5.70
rewq99887788: calls £5.70
*** RIVER *** [7h Qd 3h 8h] [7s]
rewq99887788: checks 
joker180785: bets £14.30
rewq99887788: folds 
Uncalled bet (£14.30) returned to joker180785
joker180785 collected £19.88 from pot
*** SUMMARY ***
Total pot £20.93 | Rake £1.05 
Board [7h Qd 3h 8h 7s]
Seat 1: rewq99887788 folded on the River
Seat 2: joker180785 (button) collected (£19.88)
Seat 3: Doobes8555 (small blind) folded before Flop
Seat 4: matiko09 (big blind) folded before Flop
Seat 5: Wwwasian folded before Flop (didn't bet)
Seat 6: faceMyBallz_ folded before Flop (didn't bet)





PokerStars Hand #154970096970:  Hold'em No Limit ($0.50/$1.00 USD) - 2016/06/20 12:25:44 CET [2016/06/20 6:25:44 ET]
Table 'Isonoe II' 9-max Seat #1 is the button
Seat 1: hammerwife ($100 in chips) 
Seat 2: matiko09 ($100.50 in chips) 
Seat 3: azzad2007 ($100 in chips) 
Seat 7: SkUhNi ($104.12 in chips) 
Seat 8: lewyson ($57.25 in chips) 
Seat 9: djammusic ($55.98 in chips) 
matiko09: posts small blind $0.50
azzad2007: posts big blind $1
Avtovo: sits out 
Filojoes: sits out 
*** HOLE CARDS ***
Dealt to matiko09 [Ad 3h]
SkUhNi: folds 
lewyson: folds 
djammusic: folds 
hammerwife: raises $1.01 to $2.01
matiko09: folds 
azzad2007: calls $1.01
*** FLOP *** [Jh 9h Ac]
azzad2007: checks 
Prophet1906 joins the table at seat #6 
hammerwife: checks 
*** TURN *** [Jh 9h Ac] [Ts]
azzad2007: checks 
hammerwife: bets $3.50
azzad2007: folds 
Uncalled bet ($3.50) returned to hammerwife
azzad2007 leaves the table
hammerwife collected $4.29 from pot
hammerwife: doesn't show hand 
*** SUMMARY ***
Total pot $4.52 | Rake $0.23 
Board [Jh 9h Ac Ts]
Seat 1: hammerwife (button) collected ($4.29)
Seat 2: matiko09 (small blind) folded before Flop
Seat 3: azzad2007 (big blind) folded on the Turn
Seat 7: SkUhNi folded before Flop (didn't bet)
Seat 8: lewyson folded before Flop (didn't bet)
Seat 9: djammusic folded before Flop (didn't bet)





PokerStars Hand #154970101432:  Hold'em No Limit ($0.25/$0.50 USD) - 2016/06/20 12:25:56 CET [2016/06/20 6:25:56 ET]
Table 'Juliana II' 9-max Seat #6 is the button
Seat 1: sno05 ($52.06 in chips) 
Seat 2: cjzm ($46.80 in chips) 
Seat 3: Dr.Mouse102 ($50 in chips) 
Seat 4: RICKA16 ($50 in chips) 
Seat 6: sophie2000 ($50 in chips) 
Seat 7: 23SmOkEr07 ($62.11 in chips) 
Seat 8: matiko09 ($50 in chips) 
Seat 9: tugboat2008 ($95.19 in chips) 
23SmOkEr07: posts small blind $0.25
matiko09: posts big blind $0.50
ljryviltj: sits out 
*** HOLE CARDS ***
Dealt to matiko09 [3c Td]
tugboat2008: folds 
sno05: calls $0.50
cjzm: folds 
Dr.Mouse102: folds 
RICKA16: folds 
sophie2000: raises $1.75 to $2.25
23SmOkEr07: folds 
matiko09: folds 
sno05: folds 
Uncalled bet ($1.75) returned to sophie2000
sophie2000 collected $1.75 from pot
sophie2000: doesn't show hand 
*** SUMMARY ***
Total pot $1.75 | Rake $0 
Seat 1: sno05 folded before Flop
Seat 2: cjzm folded before Flop (didn't bet)
Seat 3: Dr.Mouse102 folded before Flop (didn't bet)
Seat 4: RICKA16 folded before Flop (didn't bet)
Seat 6: sophie2000 (button) collected ($1.75)
Seat 7: 23SmOkEr07 (small blind) folded before Flop
Seat 8: matiko09 (big blind) folded before Flop
Seat 9: tugboat2008 folded before Flop (didn't bet)





PokerStars Hand #154970104942:  Hold'em No Limit (£0.25/£0.50 GBP) - 2016/06/20 12:26:05 CET [2016/06/20 6:26:05 ET]
Table 'Tesla' 6-max Seat #1 is the button
Seat 1: Rubleff85 (£38.41 in chips) 
Seat 2: matiko09 (£53.16 in chips) 
Rubleff85: posts small blind £0.25
matiko09: posts big blind £0.50
*** HOLE CARDS ***
Dealt to matiko09 [2s 7s]
Rubleff85: folds 
Uncalled bet (£0.25) returned to matiko09
matiko09 collected £0.50 from pot
matiko09: doesn't show hand 
*** SUMMARY ***
Total pot £0.50 | Rake £0 
Seat 1: Rubleff85 (button) (small blind) folded before Flop
Seat 2: matiko09 (big blind) collected (£0.50)





PokerStars Hand #154970105850:  Hold'em No Limit (€0.50/€1.00 EUR) - 2016/06/20 12:26:07 CET [2016/06/20 6:26:07 ET]
Table 'Austrasia II' 9-max Seat #6 is the button
Seat 1: Kukuryzka (€100 in chips) 
Seat 2: hammerwife (€100 in chips) 
Seat 4: matiko09 (€144.29 in chips) 
Seat 5: Avtovo (€100 in chips) 
Seat 6: Dickyxxx (€100 in chips) 
Seat 7: azzad2007 (€162.19 in chips) 
Seat 8: SkUhNi (€150.25 in chips) 
azzad2007: posts small blind €0.50
SkUhNi: posts big blind €1
*** HOLE CARDS ***
Dealt to matiko09 [6d Qc]
Kukuryzka: folds 
hammerwife: raises €1.50 to €2.50
matiko09: folds 
Avtovo: folds 
Dickyxxx: folds 
azzad2007: folds 
SkUhNi: folds 
Uncalled bet (€1.50) returned to hammerwife
hammerwife collected €2.50 from pot
hammerwife: doesn't show hand 
*** SUMMARY ***
Total pot €2.50 | Rake €0 
Seat 1: Kukuryzka folded before Flop (didn't bet)
Seat 2: hammerwife collected (€2.50)
Seat 4: matiko09 folded before Flop (didn't bet)
Seat 5: Avtovo folded before Flop (didn't bet)
Seat 6: Dickyxxx (button) folded before Flop (didn't bet)
Seat 7: azzad2007 (small blind) folded before Flop
Seat 8: SkUhNi (big blind) folded before Flop





PokerStars Hand #154970109632:  Hold'em No Limit (£0.25/£0.50 GBP) - 2016/06/20 12:26:17 CET [2016/06/20 6:26:17 ET]
Table 'Tesla' 6-max Seat #2 is the button
Seat 1: Rubleff85 (£38.16 in chips) 
Seat 2: matiko09 (£53.41 in chips) 
matiko09: posts small blind £0.25
Rubleff85: posts big blind £0.50
*** HOLE CARDS ***
Dealt to matiko09 [Qs 6h]
matiko09: raises £0.63 to £1.13
Rubleff85: calls £0.63
*** FLOP *** [Qd 3c 2h]
Rubleff85: checks 
matiko09: bets £1.11
Rubleff85: folds 
Uncalled bet (£1.11) returned to matiko09
matiko09 collected £2.15 from pot
matiko09: doesn't show hand 
*** SUMMARY ***
Total pot £2.26 | Rake £0.11 
Board [Qd 3c 2h]
Seat 1: Rubleff85 (big blind) folded on the Flop
Seat 2: matiko09 (button) (small blind) collected (£2.15)





PokerStars Hand #154970110219:  Hold'em No Limit ($0.50/$1.00 USD) - 2016/06/20 12:26:19 CET [2016/06/20 6:26:19 ET]
Table 'Anhui' 9-max Seat #8 is the button
Seat 1: SkUhNi ($153.92 in chips) 
Seat 2: ruslik_by ($279.71 in chips) 
Seat 3: Filojoes ($100 in chips) 
Seat 4: mavin80 ($33.38 in chips) 
Seat 5: mi$$I$Elena ($102.50 in chips) 
Seat 6: 23SmOkEr07 ($133.25 in chips) 
Seat 7: matiko09 ($143.15 in chips) 
Seat 8: blackmont111 ($77.50 in chips) 
Seat 9: TomBod1 ($81.80 in chips) 
TomBod1: posts small blind $0.50
SkUhNi: posts big blind $1
*** HOLE CARDS ***
Dealt to matiko09 [6d 6h]
ruslik_by: folds 
Filojoes: folds 
mavin80: folds 
mi$$I$Elena: folds 
23SmOkEr07: folds 
matiko09: raises $1.50 to $2.50
blackmont111: folds 
TomBod1: folds 
SkUhNi: folds 
Uncalled bet ($1.50) returned to matiko09
matiko09 collected $2.50 from pot
matiko09: doesn't show hand 
*** SUMMARY ***
Total pot $2.50 | Rake $0 
Seat 1: SkUhNi (big blind) folded before Flop
Seat 2: ruslik_by folded before Flop (didn't bet)
Seat 3: Filojoes folded before Flop (didn't bet)
Seat 4: mavin80 folded before Flop (didn't bet)
Seat 5: mi$$I$Elena folded before Flop (didn't bet)
Seat 6: 23SmOkEr07 folded before Flop (didn't bet)
Seat 7: matiko09 collected ($2.50)
Seat 8: blackmont111 (button) folded before Flop (didn't bet)
Seat 9: TomBod1 (small blind) folded before Flop





PokerStars Hand #154970112041:  Hold'em No Limit (£0.25/£0.50 GBP) - 2016/06/20 12:26:24 CET [2016/06/20 6:26:24 ET]
Table 'Azalea' 6-max Seat #3 is the button
Seat 1: mitsuVK (£103.86 in chips) 
Seat 2: matiko09 (£83.35 in chips) 
Seat 3: VahTang_89 (£50 in chips) 
Seat 4: faceMyBallz_ (£50 in chips) 
Seat 5: mudders693 (£67.19 in chips) 
Seat 6: Bënedic10 (£50 in chips) 
faceMyBallz_: posts small blind £0.25
mudders693: posts big blind £0.50
*** HOLE CARDS ***
Dealt to matiko09 [7s 4s]
Bënedic10: raises £1 to £1.50
mitsuVK: folds 
matiko09: folds 
VahTang_89: calls £1.50
faceMyBallz_: folds 
mudders693: calls £1
*** FLOP *** [4d 3h 8d]
mudders693: bets £4.50
Bënedic10: folds 
VahTang_89: folds 
Uncalled bet (£4.50) returned to mudders693
mudders693 collected £4.51 from pot
mudders693: doesn't show hand 
*** SUMMARY ***
Total pot £4.75 | Rake £0.24 
Board [4d 3h 8d]
Seat 1: mitsuVK folded before Flop (didn't bet)
Seat 2: matiko09 folded before Flop (didn't bet)
Seat 3: VahTang_89 (button) folded on the Flop
Seat 4: faceMyBallz_ (small blind) folded before Flop
Seat 5: mudders693 (big blind) collected (£4.51)
Seat 6: Bënedic10 folded on the Flop





PokerStars Hand #154970112159:  Hold'em No Limit ($0.25/$0.50 USD) - 2016/06/20 12:26:24 CET [2016/06/20 6:26:24 ET]
Table 'Scheddi II' 9-max Seat #6 is the button
Seat 1: matiko09 ($50 in chips) 
Seat 2: Yaaaazz ($96.15 in chips) 
Seat 3: mi$$I$Elena ($50 in chips) 
Seat 4: GOOFA13 ($30 in chips) 
Seat 5: No Money NW ($50 in chips) 
Seat 6: joker180785 ($61.09 in chips) 
Seat 7: HopeMayBee ($51.85 in chips) 
Seat 8: orochimaturi ($40 in chips) 
Seat 9: Infinitinium ($134.42 in chips) 
HopeMayBee: posts small blind $0.25
orochimaturi: posts big blind $0.50
GOOFA13: posts big blind $0.50
No Money NW: posts small & big blinds $0.75
matiko09: posts the ante $0.10
Yaaaazz: posts the ante $0.10
mi$$I$Elena: posts the ante $0.10
GOOFA13: posts the ante $0.10
No Money NW: posts the ante $0.10
joker180785: posts the ante $0.10
HopeMayBee: posts the ante $0.10
orochimaturi: posts the ante $0.10
Infinitinium: posts the ante $0.10
*** HOLE CARDS ***
Dealt to matiko09 [3s 6s]
Infinitinium: folds 
matiko09: folds 
Yaaaazz: calls $0.50
mi$$I$Elena: raises $3.50 to $4
GOOFA13: folds 
No Money NW: folds 
joker180785: folds 
HopeMayBee: raises $8 to $12
orochimaturi: folds 
Yaaaazz: folds 
mi$$I$Elena: folds 
Uncalled bet ($8) returned to HopeMayBee
HopeMayBee collected $11.15 from pot
HopeMayBee: doesn't show hand 
*** SUMMARY ***
Total pot $11.15 | Rake $0 
Seat 1: matiko09 folded before Flop (didn't bet)
Seat 2: Yaaaazz folded before Flop
Seat 3: mi$$I$Elena folded before Flop
Seat 4: GOOFA13 folded before Flop
Seat 5: No Money NW folded before Flop
Seat 6: joker180785 (button) folded before Flop (didn't bet)
Seat 7: HopeMayBee (small blind) collected ($11.15)
Seat 8: orochimaturi (big blind) folded before Flop
Seat 9: Infinitinium folded before Flop (didn't bet)





PokerStars Hand #154970113614:  Hold'em No Limit ($0.50/$1.00 USD) - 2016/06/20 12:26:28 CET [2016/06/20 6:26:28 ET]
Table 'Ambrosia II' 9-max Seat #4 is the button
Seat 1: 23SmOkEr07 ($112.82 in chips) 
Seat 2: Eyeballz1307 ($76.93 in chips) 
Seat 3: mavin80 ($80.18 in chips) 
Seat 4: mi$$I$Elena ($124.62 in chips) 
Seat 5: Mattulh ($100 in chips) 
Seat 6: ruslik_by ($134.98 in chips) 
Seat 7: matiko09 ($106 in chips) 
Seat 8: hammerwife ($100 in chips) 
Seat 9: SkUhNi ($108.62 in chips) 
Mattulh: posts small blind $0.50
ruslik_by: posts big blind $1
*** HOLE CARDS ***
Dealt to matiko09 [8d Jh]
matiko09: folds 
hammerwife: folds 
SkUhNi: raises $2 to $3
23SmOkEr07: folds 
Eyeballz1307: folds 
mavin80: folds 
mi$$I$Elena: folds 
Mattulh: folds 
ruslik_by: raises $6.50 to $9.50
SkUhNi: calls $6.50
*** FLOP *** [4d 8c 3s]
ruslik_by: checks 
SkUhNi: bets $10.18
ruslik_by: calls $10.18
*** TURN *** [4d 8c 3s] [7h]
ruslik_by: checks 
SkUhNi: checks 
*** RIVER *** [4d 8c 3s 7h] [9c]
ruslik_by: checks 
SkUhNi: checks 
*** SHOW DOWN ***
ruslik_by: shows [Qd Ah] (high card Ace)
SkUhNi: shows [6d 6s] (a pair of Sixes)
SkUhNi collected $37.87 from pot
*** SUMMARY ***
Total pot $39.86 | Rake $1.99 
Board [4d 8c 3s 7h 9c]
Seat 1: 23SmOkEr07 folded before Flop (didn't bet)
Seat 2: Eyeballz1307 folded before Flop (didn't bet)
Seat 3: mavin80 folded before Flop (didn't bet)
Seat 4: mi$$I$Elena (button) folded before Flop (didn't bet)
Seat 5: Mattulh (small blind) folded before Flop
Seat 6: ruslik_by (big blind) showed [Qd Ah] and lost with high card Ace
Seat 7: matiko09 folded before Flop (didn't bet)
Seat 8: hammerwife folded before Flop (didn't bet)
Seat 9: SkUhNi showed [6d 6s] and won ($37.87) with a pair of Sixes





PokerStars Hand #154970114026:  Hold'em No Limit ($0.50/$1.00 USD) - 2016/06/20 12:26:29 CET [2016/06/20 6:26:29 ET]
Table 'Ernestina' 9-max Seat #4 is the button
Seat 1: diva3150 ($75.18 in chips) 
Seat 2: matiko09 ($100 in chips) 
Seat 3: Pvsx. ($144.42 in chips) 
Seat 4: SkUhNi ($102.02 in chips) 
Seat 6: arctur17 ($94.30 in chips) 
Seat 7: Avtovo ($100 in chips) 
Seat 8: ruslik_by ($297.54 in chips) 
Seat 9: 23SmOkEr07 ($101.50 in chips) 
Dickyxxx will be allowed to play after the button
arctur17: posts small blind $0.50
Avtovo: posts big blind $1
*** HOLE CARDS ***
Dealt to matiko09 [5s 6c]
ruslik_by: folds 
23SmOkEr07: folds 
diva3150: folds 
matiko09: folds 
Pvsx.: raises $1.50 to $2.50
SkUhNi: folds 
arctur17: folds 
Avtovo: folds 
Uncalled bet ($1.50) returned to Pvsx.
Pvsx. collected $2.50 from pot
Pvsx.: doesn't show hand 
*** SUMMARY ***
Total pot $2.50 | Rake $0 
Seat 1: diva3150 folded before Flop (didn't bet)
Seat 2: matiko09 folded before Flop (didn't bet)
Seat 3: Pvsx. collected ($2.50)
Seat 4: SkUhNi (button) folded before Flop (didn't bet)
Seat 6: arctur17 (small blind) folded before Flop
Seat 7: Avtovo (big blind) folded before Flop
Seat 8: ruslik_by folded before Flop (didn't bet)
Seat 9: 23SmOkEr07 folded before Flop (didn't bet)





PokerStars Hand #154970114839:  Hold'em No Limit ($0.50/$1.00 USD) - 2016/06/20 12:26:31 CET [2016/06/20 6:26:31 ET]
Table 'Albiorix' 9-max Seat #8 is the button
Seat 1: arctur17 ($77.28 in chips) 
Seat 2: SkUhNi ($143.52 in chips) 
Seat 3: matiko09 ($109.62 in chips) 
Seat 4: 23SmOkEr07 ($145 in chips) 
Seat 5: ruslik_by ($100.25 in chips) 
Seat 6: joker180785 ($100 in chips) 
Seat 7: Pekyto ($38.18 in chips) 
Seat 8: smiley0221 ($53.73 in chips) 
Seat 9: Coolller ($177.47 in chips) 
Coolller: posts small blind $0.50
arctur17: posts big blind $1
*** HOLE CARDS ***
Dealt to matiko09 [9d 9s]
SkUhNi: raises $2 to $3
matiko09: calls $3
23SmOkEr07: folds 
ruslik_by: folds 
joker180785: folds 
Pekyto: calls $3
smiley0221: calls $3
Coolller: folds 
arctur17: calls $2
*** FLOP *** [7c 5s 6h]
arctur17: checks 
SkUhNi: checks 
matiko09: bets $7.65
Pekyto: folds 
smiley0221: calls $7.65
arctur17: folds 
SkUhNi: folds 
*** TURN *** [7c 5s 6h] [Kh]
matiko09: checks 
smiley0221: checks 
*** RIVER *** [7c 5s 6h Kh] [Ad]
matiko09: checks 
smiley0221: checks 
*** SHOW DOWN ***
matiko09: shows [9d 9s] (a pair of Nines)
smiley0221: mucks hand 
matiko09 collected $29.26 from pot
*** SUMMARY ***
Total pot $30.80 | Rake $1.54 
Board [7c 5s 6h Kh Ad]
Seat 1: arctur17 (big blind) folded on the Flop
Seat 2: SkUhNi folded on the Flop
Seat 3: matiko09 showed [9d 9s] and won ($29.26) with a pair of Nines
Seat 4: 23SmOkEr07 folded before Flop (didn't bet)
Seat 5: ruslik_by folded before Flop (didn't bet)
Seat 6: joker180785 folded before Flop (didn't bet)
Seat 7: Pekyto folded on the Flop
Seat 8: smiley0221 (button) mucked [4s 4h]
Seat 9: Coolller (small blind) folded before Flop





PokerStars Hand #154970115636:  Hold'em No Limit (£0.25/£0.50 GBP) - 2016/06/20 12:26:33 CET [2016/06/20 6:26:33 ET]
Table 'Tesla' 6-max Seat #1 is the button
Seat 1: Rubleff85 (£37.03 in chips) 
Seat 2: matiko09 (£54.43 in chips) 
Rubleff85: posts small blind £0.25
matiko09: posts big blind £0.50
*** HOLE CARDS ***
Dealt to matiko09 [Kd 5s]
Rubleff85: raises £1 to £1.50
matiko09: folds 
Uncalled bet (£1) returned to Rubleff85
Rubleff85 collected £1 from pot
Rubleff85: doesn't show hand 
*** SUMMARY ***
Total pot £1 | Rake £0 
Seat 1: Rubleff85 (button) (small blind) collected (£1)
Seat 2: matiko09 (big blind) folded before Flop





PokerStars Hand #154970117756:  Hold'em No Limit ($0.25/$0.50 USD) - 2016/06/20 12:26:39 CET [2016/06/20 6:26:39 ET]
Table 'Juliana II' 9-max Seat #7 is the button
Seat 1: sno05 ($51.56 in chips) 
Seat 2: cjzm ($46.80 in chips) 
Seat 3: Dr.Mouse102 ($50 in chips) 
Seat 4: RICKA16 ($50 in chips) 
Seat 6: sophie2000 ($51.25 in chips) 
Seat 7: 23SmOkEr07 ($61.86 in chips) 
Seat 8: matiko09 ($50 in chips) 
Seat 9: tugboat2008 ($95.19 in chips) 
matiko09: posts small blind $0.25
tugboat2008: posts big blind $0.50
ljryviltj: sits out 
*** HOLE CARDS ***
Dealt to matiko09 [Ad Tc]
sno05: folds 
cjzm: folds 
Dr.Mouse102: folds 
RICKA16: folds 
sophie2000: folds 
23SmOkEr07: folds 
matiko09: raises $1 to $1.50
tugboat2008: folds 
Uncalled bet ($1) returned to matiko09
matiko09 collected $1 from pot
matiko09: doesn't show hand 
*** SUMMARY ***
Total pot $1 | Rake $0 
Seat 1: sno05 folded before Flop (didn't bet)
Seat 2: cjzm folded before Flop (didn't bet)
Seat 3: Dr.Mouse102 folded before Flop (didn't bet)
Seat 4: RICKA16 folded before Flop (didn't bet)
Seat 6: sophie2000 folded before Flop (didn't bet)
Seat 7: 23SmOkEr07 (button) folded before Flop (didn't bet)
Seat 8: matiko09 (small blind) collected ($1)
Seat 9: tugboat2008 (big blind) folded before Flop





PokerStars Hand #154970122390:  Hold'em No Limit ($0.50/$1.00 USD) - 2016/06/20 12:26:51 CET [2016/06/20 6:26:51 ET]
Table 'Pongola' 9-max Seat #7 is the button
Seat 1: matiko09 ($101.50 in chips) 
Seat 2: ruslik_by ($136.27 in chips) 
Seat 3: SkUhNi ($100 in chips) 
Seat 4: karllv ($119.79 in chips) 
Seat 5: joker180785 ($107.43 in chips) 
Seat 6: 23SmOkEr07 ($117.21 in chips) 
Seat 7: Dickyxxx ($100 in chips) 
Seat 8: phrantique ($151.32 in chips) 
Seat 9: Filojoes ($107.72 in chips) 
phrantique: posts small blind $0.50
Filojoes: posts big blind $1
*** HOLE CARDS ***
Dealt to matiko09 [2h Th]
matiko09: folds 
ruslik_by: folds 
SkUhNi: folds 
karllv: calls $1
joker180785: folds 
23SmOkEr07: folds 
Dickyxxx: raises $3 to $4
phrantique: calls $3.50
Filojoes: folds 
karllv: calls $3
*** FLOP *** [Qd 5c Tc]
phrantique: checks 
karllv: checks 
Dickyxxx: bets $6.42
phrantique: calls $6.42
karllv: folds 
*** TURN *** [Qd 5c Tc] [3c]
phrantique: checks 
Dickyxxx: bets $18.41
phrantique: calls $18.41
*** RIVER *** [Qd 5c Tc 3c] [5s]
phrantique: bets $23.79
Dickyxxx: raises $47.38 to $71.17 and is all-in
phrantique: folds 
Uncalled bet ($47.38) returned to Dickyxxx
Dickyxxx collected $107.74 from pot
Dickyxxx: doesn't show hand 
*** SUMMARY ***
Total pot $110.24 | Rake $2.50 
Board [Qd 5c Tc 3c 5s]
Seat 1: matiko09 folded before Flop (didn't bet)
Seat 2: ruslik_by folded before Flop (didn't bet)
Seat 3: SkUhNi folded before Flop (didn't bet)
Seat 4: karllv folded on the Flop
Seat 5: joker180785 folded before Flop (didn't bet)
Seat 6: 23SmOkEr07 folded before Flop (didn't bet)
Seat 7: Dickyxxx (button) collected ($107.74)
Seat 8: phrantique (small blind) folded on the River
Seat 9: Filojoes (big blind) folded before Flop





PokerStars Hand #154970122579:  Hold'em No Limit (£0.25/£0.50 GBP) - 2016/06/20 12:26:52 CET [2016/06/20 6:26:52 ET]
Table 'Tesla' 6-max Seat #2 is the button
Seat 1: Rubleff85 (£37.53 in chips) 
Seat 2: matiko09 (£53.93 in chips) 
matiko09: posts small blind £0.25
Rubleff85: posts big blind £0.50
*** HOLE CARDS ***
Dealt to matiko09 [7c Jh]
matiko09: raises £0.63 to £1.13
asmodej666 joins the table at seat #3 
Rubleff85: calls £0.63
*** FLOP *** [Qh Kd Kh]
Rubleff85: checks 
matiko09: bets £1
Rubleff85: folds 
Uncalled bet (£1) returned to matiko09
matiko09 collected £2.15 from pot
matiko09: doesn't show hand 
*** SUMMARY ***
Total pot £2.26 | Rake £0.11 
Board [Qh Kd Kh]
Seat 1: Rubleff85 (big blind) folded on the Flop
Seat 2: matiko09 (button) (small blind) collected (£2.15)





PokerStars Hand #154970122848:  Hold'em No Limit ($0.50/$1.00 USD) - 2016/06/20 12:26:52 CET [2016/06/20 6:26:52 ET]
Table 'Anhui' 9-max Seat #9 is the button
Seat 1: SkUhNi ($152.92 in chips) 
Seat 2: ruslik_by ($279.71 in chips) 
Seat 3: Filojoes ($100 in chips) 
Seat 4: mavin80 ($33.38 in chips) 
Seat 5: mi$$I$Elena ($102.50 in chips) 
Seat 6: 23SmOkEr07 ($133.25 in chips) 
Seat 7: matiko09 ($144.65 in chips) 
Seat 8: blackmont111 ($77.50 in chips) 
Seat 9: TomBod1 ($81.30 in chips) 
SkUhNi: posts small blind $0.50
ruslik_by: posts big blind $1
*** HOLE CARDS ***
Dealt to matiko09 [8c 6s]
Filojoes: folds 
mavin80: folds 
mi$$I$Elena: raises $1.38 to $2.38
23SmOkEr07: folds 
matiko09: folds 
blackmont111: folds 
TomBod1: folds 
SkUhNi: folds 
ruslik_by: calls $1.38
*** FLOP *** [Ac 5h Ad]
ruslik_by: checks 
mi$$I$Elena: bets $1.65
ruslik_by: calls $1.65
*** TURN *** [Ac 5h Ad] [Kh]
ruslik_by: checks 
mi$$I$Elena: bets $3
ruslik_by: calls $3
*** RIVER *** [Ac 5h Ad Kh] [7d]
ruslik_by: checks 
mi$$I$Elena: bets $5
ruslik_by: folds 
Uncalled bet ($5) returned to mi$$I$Elena
mi$$I$Elena collected $13.83 from pot
mi$$I$Elena: doesn't show hand 
*** SUMMARY ***
Total pot $14.56 | Rake $0.73 
Board [Ac 5h Ad Kh 7d]
Seat 1: SkUhNi (small blind) folded before Flop
Seat 2: ruslik_by (big blind) folded on the River
Seat 3: Filojoes folded before Flop (didn't bet)
Seat 4: mavin80 folded before Flop (didn't bet)
Seat 5: mi$$I$Elena collected ($13.83)
Seat 6: 23SmOkEr07 folded before Flop (didn't bet)
Seat 7: matiko09 folded before Flop (didn't bet)
Seat 8: blackmont111 folded before Flop (didn't bet)
Seat 9: TomBod1 (button) folded before Flop (didn't bet)





PokerStars Hand #154970123900:  Hold'em No Limit ($0.50/$1.00 USD) - 2016/06/20 12:26:55 CET [2016/06/20 6:26:55 ET]
Table 'Ernestina' 9-max Seat #6 is the button
Seat 1: diva3150 ($75.18 in chips) 
Seat 2: matiko09 ($100 in chips) 
Seat 3: Pvsx. ($145.92 in chips) 
Seat 4: SkUhNi ($102.02 in chips) 
Seat 6: arctur17 ($93.80 in chips) 
Seat 7: Avtovo ($100 in chips) 
Seat 8: ruslik_by ($297.54 in chips) 
Seat 9: 23SmOkEr07 ($101.50 in chips) 
Avtovo: posts small blind $0.50
ruslik_by: posts big blind $1
Dickyxxx: sits out 
*** HOLE CARDS ***
Dealt to matiko09 [Qh 7c]
23SmOkEr07: folds 
diva3150: folds 
matiko09: folds 
Pvsx.: raises $1.50 to $2.50
SkUhNi: folds 
arctur17: folds 
Avtovo: folds 
ruslik_by: folds 
Uncalled bet ($1.50) returned to Pvsx.
Pvsx. collected $2.50 from pot
Pvsx.: doesn't show hand 
*** SUMMARY ***
Total pot $2.50 | Rake $0 
Seat 1: diva3150 folded before Flop (didn't bet)
Seat 2: matiko09 folded before Flop (didn't bet)
Seat 3: Pvsx. collected ($2.50)
Seat 4: SkUhNi folded before Flop (didn't bet)
Seat 6: arctur17 (button) folded before Flop (didn't bet)
Seat 7: Avtovo (small blind) folded before Flop
Seat 8: ruslik_by (big blind) folded before Flop
Seat 9: 23SmOkEr07 folded before Flop (didn't bet)





PokerStars Hand #154970124654:  Hold'em No Limit (£0.25/£0.50 GBP) - 2016/06/20 12:26:57 CET [2016/06/20 6:26:57 ET]
Table 'Ani' 6-max Seat #3 is the button
Seat 1: rewq99887788 (£42.48 in chips) 
Seat 2: joker180785 (£59.79 in chips) 
Seat 3: Doobes8555 (£70.77 in chips) 
Seat 4: matiko09 (£50.76 in chips) 
Seat 5: Wwwasian (£63.02 in chips) 
Seat 6: faceMyBallz_ (£55.86 in chips) 
matiko09: posts small blind £0.25
Wwwasian: posts big blind £0.50
*** HOLE CARDS ***
Dealt to matiko09 [Ah Jd]
faceMyBallz_: folds 
rewq99887788: folds 
joker180785: folds 
Doobes8555: folds 
matiko09: raises £1 to £1.50
Wwwasian: folds 
Uncalled bet (£1) returned to matiko09
matiko09 collected £1 from pot
matiko09: doesn't show hand 
*** SUMMARY ***
Total pot £1 | Rake £0 
Seat 1: rewq99887788 folded before Flop (didn't bet)
Seat 2: joker180785 folded before Flop (didn't bet)
Seat 3: Doobes8555 (button) folded before Flop (didn't bet)
Seat 4: matiko09 (small blind) collected (£1)
Seat 5: Wwwasian (big blind) folded before Flop
Seat 6: faceMyBallz_ folded before Flop (didn't bet)





PokerStars Hand #154970128112:  Hold'em No Limit ($0.50/$1.00 USD) - 2016/06/20 12:27:07 CET [2016/06/20 6:27:07 ET]
Table 'Isonoe II' 9-max Seat #2 is the button
Seat 1: hammerwife ($102.28 in chips) 
Seat 2: matiko09 ($100 in chips) 
Seat 7: SkUhNi ($104.12 in chips) 
Seat 8: lewyson ($57.25 in chips) 
Seat 9: djammusic ($55.98 in chips) 
Avtovo will be allowed to play after the button
Filojoes will be allowed to play after the button
Prophet1906 will be allowed to play after the button
SkUhNi: posts small blind $0.50
lewyson: posts big blind $1
*** HOLE CARDS ***
Dealt to matiko09 [4h 7c]
djammusic: folds 
hammerwife: folds 
matiko09: folds 
SkUhNi: raises $1.50 to $2.50
lewyson: folds 
Uncalled bet ($1.50) returned to SkUhNi
SkUhNi collected $2 from pot
SkUhNi: doesn't show hand 
*** SUMMARY ***
Total pot $2 | Rake $0 
Seat 1: hammerwife folded before Flop (didn't bet)
Seat 2: matiko09 (button) folded before Flop (didn't bet)
Seat 7: SkUhNi (small blind) collected ($2)
Seat 8: lewyson (big blind) folded before Flop
Seat 9: djammusic folded before Flop (didn't bet)





PokerStars Hand #154970129330:  Hold'em No Limit (£0.25/£0.50 GBP) - 2016/06/20 12:27:10 CET [2016/06/20 6:27:10 ET]
Table 'Azalea' 6-max Seat #4 is the button
Seat 1: mitsuVK (£103.86 in chips) 
Seat 2: matiko09 (£83.35 in chips) 
Seat 3: VahTang_89 (£50 in chips) 
Seat 4: faceMyBallz_ (£50 in chips) 
Seat 5: mudders693 (£70.20 in chips) 
Seat 6: Bënedic10 (£50 in chips) 
mudders693: posts small blind £0.25
Bënedic10: posts big blind £0.50
*** HOLE CARDS ***
Dealt to matiko09 [4h 6s]
mitsuVK: raises £1 to £1.50
matiko09: folds 
VahTang_89: folds 
faceMyBallz_: folds 
mudders693: raises £4 to £5.50
Bënedic10: folds 
mitsuVK: folds 
Uncalled bet (£4) returned to mudders693
mudders693 collected £3.50 from pot
mudders693: doesn't show hand 
*** SUMMARY ***
Total pot £3.50 | Rake £0 
Seat 1: mitsuVK folded before Flop
Seat 2: matiko09 folded before Flop (didn't bet)
Seat 3: VahTang_89 folded before Flop (didn't bet)
Seat 4: faceMyBallz_ (button) folded before Flop (didn't bet)
Seat 5: mudders693 (small blind) collected (£3.50)
Seat 6: Bënedic10 (big blind) folded before Flop





PokerStars Hand #154970131476:  Hold'em No Limit (£0.25/£0.50 GBP) - 2016/06/20 12:27:15 CET [2016/06/20 6:27:15 ET]
Table 'Tesla' 6-max Seat #1 is the button
Seat 1: Rubleff85 (£36.40 in chips) 
Seat 2: matiko09 (£54.95 in chips) 
Rubleff85: posts small blind £0.25
matiko09: posts big blind £0.50
*** HOLE CARDS ***
Dealt to matiko09 [Ad 6d]
Rubleff85: calls £0.25
matiko09: raises £2 to £2.50
Rubleff85: folds 
Uncalled bet (£2) returned to matiko09
matiko09 collected £1 from pot
matiko09: doesn't show hand 
*** SUMMARY ***
Total pot £1 | Rake £0 
Seat 1: Rubleff85 (button) (small blind) folded before Flop
Seat 2: matiko09 (big blind) collected (£1)





PokerStars Hand #154970132218:  Hold'em No Limit ($0.50/$1.00 USD) - 2016/06/20 12:27:17 CET [2016/06/20 6:27:17 ET]
Table 'Ernestina' 9-max Seat #7 is the button
Seat 1: diva3150 ($75.18 in chips) 
Seat 2: matiko09 ($100 in chips) 
Seat 3: Pvsx. ($147.42 in chips) 
Seat 4: SkUhNi ($102.02 in chips) 
Seat 6: arctur17 ($93.80 in chips) 
Seat 7: Avtovo ($100 in chips) 
Seat 8: ruslik_by ($296.54 in chips) 
Seat 9: 23SmOkEr07 ($101.50 in chips) 
ruslik_by: posts small blind $0.50
23SmOkEr07: posts big blind $1
Dickyxxx: sits out 
*** HOLE CARDS ***
Dealt to matiko09 [2h Ts]
diva3150: folds 
matiko09: folds 
Pvsx.: folds 
SkUhNi: folds 
arctur17: folds 
Avtovo: folds 
ruslik_by: raises $2 to $3
23SmOkEr07: calls $2
*** FLOP *** [Jd Qd 8s]
ruslik_by: bets $1.93
23SmOkEr07: folds 
Uncalled bet ($1.93) returned to ruslik_by
ruslik_by collected $5.70 from pot
ruslik_by: doesn't show hand 
*** SUMMARY ***
Total pot $6 | Rake $0.30 
Board [Jd Qd 8s]
Seat 1: diva3150 folded before Flop (didn't bet)
Seat 2: matiko09 folded before Flop (didn't bet)
Seat 3: Pvsx. folded before Flop (didn't bet)
Seat 4: SkUhNi folded before Flop (didn't bet)
Seat 6: arctur17 folded before Flop (didn't bet)
Seat 7: Avtovo (button) folded before Flop (didn't bet)
Seat 8: ruslik_by (small blind) collected ($5.70)
Seat 9: 23SmOkEr07 (big blind) folded on the Flop





PokerStars Hand #154970132783:  Hold'em No Limit (£0.25/£0.50 GBP) - 2016/06/20 12:27:19 CET [2016/06/20 6:27:19 ET]
Table 'Ani' 6-max Seat #4 is the button
Seat 1: rewq99887788 (£42.48 in chips) 
Seat 2: joker180785 (£59.79 in chips) 
Seat 3: Doobes8555 (£70.77 in chips) 
Seat 4: matiko09 (£51.26 in chips) 
Seat 5: Wwwasian (£62.52 in chips) 
Seat 6: faceMyBallz_ (£55.86 in chips) 
Wwwasian: posts small blind £0.25
faceMyBallz_: posts big blind £0.50
*** HOLE CARDS ***
Dealt to matiko09 [Tc 4h]
rewq99887788: folds 
joker180785: folds 
Doobes8555: raises £1 to £1.50
matiko09: folds 
Wwwasian is disconnected 
Wwwasian has timed out while disconnected
Wwwasian: folds 
faceMyBallz_: folds 
Uncalled bet (£1) returned to Doobes8555
Doobes8555 collected £1.25 from pot
Doobes8555: doesn't show hand 
*** SUMMARY ***
Total pot £1.25 | Rake £0 
Seat 1: rewq99887788 folded before Flop (didn't bet)
Seat 2: joker180785 folded before Flop (didn't bet)
Seat 3: Doobes8555 collected (£1.25)
Seat 4: matiko09 (button) folded before Flop (didn't bet)
Seat 5: Wwwasian (small blind) folded before Flop
Seat 6: faceMyBallz_ (big blind) folded before Flop





PokerStars Hand #154970133108:  Hold'em No Limit ($0.25/$0.50 USD) - 2016/06/20 12:27:20 CET [2016/06/20 6:27:20 ET]
Table 'Juliana II' 9-max Seat #8 is the button
Seat 1: sno05 ($51.56 in chips) 
Seat 2: cjzm ($46.80 in chips) 
Seat 3: Dr.Mouse102 ($50 in chips) 
Seat 4: RICKA16 ($50 in chips) 
Seat 6: sophie2000 ($51.25 in chips) 
Seat 7: 23SmOkEr07 ($61.86 in chips) 
Seat 8: matiko09 ($50.50 in chips) 
Seat 9: tugboat2008 ($94.69 in chips) 
tugboat2008: posts small blind $0.25
sno05: posts big blind $0.50
ljryviltj: sits out 
*** HOLE CARDS ***
Dealt to matiko09 [6d 9s]
cjzm: folds 
Dr.Mouse102: folds 
RICKA16: folds 
sophie2000: raises $1 to $1.50
23SmOkEr07: folds 
matiko09: folds 
tugboat2008: folds 
sno05: calls $1
*** FLOP *** [Ts Jd As]
sno05: bets $1.50
sophie2000: calls $1.50
*** TURN *** [Ts Jd As] [Kd]
sno05: bets $1.50
sophie2000: calls $1.50
*** RIVER *** [Ts Jd As Kd] [5h]
sno05: bets $2.50
sophie2000: calls $2.50
*** SHOW DOWN ***
sno05: shows [Ad Tc] (two pair, Aces and Tens)
sophie2000: mucks hand 
sno05 collected $13.54 from pot
*** SUMMARY ***
Total pot $14.25 | Rake $0.71 
Board [Ts Jd As Kd 5h]
Seat 1: sno05 (big blind) showed [Ad Tc] and won ($13.54) with two pair, Aces and Tens
Seat 2: cjzm folded before Flop (didn't bet)
Seat 3: Dr.Mouse102 folded before Flop (didn't bet)
Seat 4: RICKA16 folded before Flop (didn't bet)
Seat 6: sophie2000 mucked [5c Ac]
Seat 7: 23SmOkEr07 folded before Flop (didn't bet)
Seat 8: matiko09 (button) folded before Flop (didn't bet)
Seat 9: tugboat2008 (small blind) folded before Flop





PokerStars Hand #154970135162:  Hold'em No Limit ($0.50/$1.00 USD) - 2016/06/20 12:27:25 CET [2016/06/20 6:27:25 ET]
Table 'Isonoe II' 9-max Seat #7 is the button
Seat 1: hammerwife ($102.28 in chips) 
Seat 2: matiko09 ($100 in chips) 
Seat 7: SkUhNi ($105.12 in chips) 
Seat 8: lewyson ($56.25 in chips) 
Seat 9: djammusic ($55.98 in chips) 
lewyson: posts small blind $0.50
djammusic: posts big blind $1
Avtovo: sits out 
Filojoes: sits out 
Prophet1906: sits out 
*** HOLE CARDS ***
Dealt to matiko09 [8c Qh]
hammerwife: raises $1.50 to $2.50
Prophet1906 leaves the table
matiko09: folds 
SkUhNi: calls $2.50
lewyson: folds 
djammusic: folds 
*** FLOP *** [Qs 3h 8d]
GOOFA13 joins the table at seat #6 
hammerwife: bets $3.50
SkUhNi: calls $3.50
*** TURN *** [Qs 3h 8d] [Td]
Kukuryzka joins the table at seat #3 
hammerwife: bets $12.50
SkUhNi: calls $12.50
*** RIVER *** [Qs 3h 8d Td] [6d]
Kukuryzka leaves the table
hammerwife: bets $40.50
SkUhNi: folds 
Uncalled bet ($40.50) returned to hammerwife
hammerwife collected $36.58 from pot
hammerwife: doesn't show hand 
*** SUMMARY ***
Total pot $38.50 | Rake $1.92 
Board [Qs 3h 8d Td 6d]
Seat 1: hammerwife collected ($36.58)
Seat 2: matiko09 folded before Flop (didn't bet)
Seat 7: SkUhNi (button) folded on the River
Seat 8: lewyson (small blind) folded before Flop
Seat 9: djammusic (big blind) folded before Flop





PokerStars Hand #154970136694:  Hold'em No Limit (£0.25/£0.50 GBP) - 2016/06/20 12:27:29 CET [2016/06/20 6:27:29 ET]
Table 'Tesla' 6-max Seat #1 is the button
Seat 1: Rubleff85 (£35.90 in chips) 
Seat 2: matiko09 (£55.45 in chips) 
Seat 3: asmodej666 (£50 in chips) 
matiko09: posts small blind £0.25
asmodej666: posts big blind £0.50
*** HOLE CARDS ***
Dealt to matiko09 [Ah Jh]
Rubleff85: folds 
matiko09: raises £1 to £1.50
asmodej666: folds 
Uncalled bet (£1) returned to matiko09
matiko09 collected £1 from pot
matiko09: doesn't show hand 
*** SUMMARY ***
Total pot £1 | Rake £0 
Seat 1: Rubleff85 (button) folded before Flop (didn't bet)
Seat 2: matiko09 (small blind) collected (£1)
Seat 3: asmodej666 (big blind) folded before Flop





PokerStars Hand #154970138547:  Hold'em No Limit ($0.25/$0.50 USD) - 2016/06/20 12:27:34 CET [2016/06/20 6:27:34 ET]
Table 'Scheddi II' 9-max Seat #7 is the button
Seat 1: matiko09 ($50 in chips) 
Seat 2: Yaaaazz ($95.55 in chips) 
Seat 3: mi$$I$Elena ($50 in chips) 
Seat 4: GOOFA13 ($29.40 in chips) 
Seat 5: No Money NW ($49.15 in chips) 
Seat 6: joker180785 ($60.99 in chips) 
Seat 7: HopeMayBee ($58.90 in chips) 
Seat 8: orochimaturi ($39.40 in chips) 
Seat 9: Infinitinium ($134.32 in chips) 
orochimaturi: posts small blind $0.25
Infinitinium: posts big blind $0.50
matiko09: posts the ante $0.10
Yaaaazz: posts the ante $0.10
mi$$I$Elena: posts the ante $0.10
GOOFA13: posts the ante $0.10
No Money NW: posts the ante $0.10
joker180785: posts the ante $0.10
HopeMayBee: posts the ante $0.10
orochimaturi: posts the ante $0.10
Infinitinium: posts the ante $0.10
*** HOLE CARDS ***
Dealt to matiko09 [9h Kh]
matiko09: folds 
Yaaaazz: folds 
mi$$I$Elena: folds 
GOOFA13: folds 
No Money NW: folds 
joker180785: raises $1 to $1.50
HopeMayBee: folds 
orochimaturi: folds 
Infinitinium: calls $1
*** FLOP *** [Qh Ah Js]
Infinitinium: bets $0.50
joker180785: raises $4 to $4.50
Infinitinium: folds 
Uncalled bet ($4) returned to joker180785
joker180785 collected $4.89 from pot
*** SUMMARY ***
Total pot $5.15 | Rake $0.26 
Board [Qh Ah Js]
Seat 1: matiko09 folded before Flop (didn't bet)
Seat 2: Yaaaazz folded before Flop (didn't bet)
Seat 3: mi$$I$Elena folded before Flop (didn't bet)
Seat 4: GOOFA13 folded before Flop (didn't bet)
Seat 5: No Money NW folded before Flop (didn't bet)
Seat 6: joker180785 collected ($4.89)
Seat 7: HopeMayBee (button) folded before Flop (didn't bet)
Seat 8: orochimaturi (small blind) folded before Flop
Seat 9: Infinitinium (big blind) folded on the Flop





PokerStars Hand #154970143165:  Hold'em No Limit (£0.25/£0.50 GBP) - 2016/06/20 12:27:46 CET [2016/06/20 6:27:46 ET]
Table 'Tesla' 6-max Seat #2 is the button
Seat 1: Rubleff85 (£35.90 in chips) 
Seat 2: matiko09 (£55.95 in chips) 
Seat 3: asmodej666 (£50 in chips) 
asmodej666: posts small blind £0.25
Rubleff85: posts big blind £0.50
*** HOLE CARDS ***
Dealt to matiko09 [Jc 2d]
matiko09: folds 
asmodej666: raises £1 to £1.50
Rubleff85: folds 
Uncalled bet (£1) returned to asmodej666
asmodej666 collected £1 from pot
asmodej666: doesn't show hand 
*** SUMMARY ***
Total pot £1 | Rake £0 
Seat 1: Rubleff85 (big blind) folded before Flop
Seat 2: matiko09 (button) folded before Flop (didn't bet)
Seat 3: asmodej666 (small blind) collected (£1)





PokerStars Hand #154970143218:  Hold'em No Limit (£0.25/£0.50 GBP) - 2016/06/20 12:27:46 CET [2016/06/20 6:27:46 ET]
Table 'Azalea' 6-max Seat #5 is the button
Seat 1: mitsuVK (£102.36 in chips) 
Seat 2: matiko09 (£83.35 in chips) 
Seat 3: VahTang_89 (£50 in chips) 
Seat 4: faceMyBallz_ (£50 in chips) 
Seat 5: mudders693 (£72.20 in chips) 
Seat 6: Bënedic10 (£50 in chips) 
Bënedic10: posts small blind £0.25
mitsuVK: posts big blind £0.50
*** HOLE CARDS ***
Dealt to matiko09 [Qs 4d]
matiko09: folds 
VahTang_89: folds 
faceMyBallz_: folds 
mudders693: raises £1 to £1.50
Bënedic10: folds 
mitsuVK: folds 
Uncalled bet (£1) returned to mudders693
mudders693 collected £1.25 from pot
mudders693: doesn't show hand 
*** SUMMARY ***
Total pot £1.25 | Rake £0 
Seat 1: mitsuVK (big blind) folded before Flop
Seat 2: matiko09 folded before Flop (didn't bet)
Seat 3: VahTang_89 folded before Flop (didn't bet)
Seat 4: faceMyBallz_ folded before Flop (didn't bet)
Seat 5: mudders693 (button) collected (£1.25)
Seat 6: Bënedic10 (small blind) folded before Flop





PokerStars Hand #154970146338:  Hold'em No Limit ($0.50/$1.00 USD) - 2016/06/20 12:27:55 CET [2016/06/20 6:27:55 ET]
Table 'Ambrosia II' 9-max Seat #5 is the button
Seat 1: 23SmOkEr07 ($112.82 in chips) 
Seat 2: Eyeballz1307 ($76.93 in chips) 
Seat 3: mavin80 ($80.18 in chips) 
Seat 4: mi$$I$Elena ($124.62 in chips) 
Seat 5: Mattulh ($100 in chips) 
Seat 6: ruslik_by ($115.30 in chips) 
Seat 7: matiko09 ($106 in chips) 
Seat 8: hammerwife ($100 in chips) 
Seat 9: SkUhNi ($126.81 in chips) 
ruslik_by: posts small blind $0.50
matiko09: posts big blind $1
*** HOLE CARDS ***
Dealt to matiko09 [7c As]
hammerwife: folds 
SkUhNi: folds 
23SmOkEr07: folds 
Eyeballz1307: folds 
mavin80: folds 
mi$$I$Elena: raises $1.38 to $2.38
Mattulh: folds 
ruslik_by: folds 
matiko09: folds 
Uncalled bet ($1.38) returned to mi$$I$Elena
mi$$I$Elena collected $2.50 from pot
mi$$I$Elena: doesn't show hand 
*** SUMMARY ***
Total pot $2.50 | Rake $0 
Seat 1: 23SmOkEr07 folded before Flop (didn't bet)
Seat 2: Eyeballz1307 folded before Flop (didn't bet)
Seat 3: mavin80 folded before Flop (didn't bet)
Seat 4: mi$$I$Elena collected ($2.50)
Seat 5: Mattulh (button) folded before Flop (didn't bet)
Seat 6: ruslik_by (small blind) folded before Flop
Seat 7: matiko09 (big blind) folded before Flop
Seat 8: hammerwife folded before Flop (didn't bet)
Seat 9: SkUhNi folded before Flop (didn't bet)





PokerStars Hand #154970147073:  Hold'em No Limit (£0.25/£0.50 GBP) - 2016/06/20 12:27:57 CET [2016/06/20 6:27:57 ET]
Table 'Ani' 6-max Seat #6 is the button
Seat 1: rewq99887788 (£42.48 in chips) 
Seat 2: joker180785 (£59.79 in chips) 
Seat 3: Doobes8555 (£71.52 in chips) 
Seat 4: matiko09 (£51.26 in chips) 
Seat 6: faceMyBallz_ (£55.36 in chips) 
rewq99887788: posts small blind £0.25
joker180785: posts big blind £0.50
*** HOLE CARDS ***
Dealt to matiko09 [2c Ks]
Doobes8555: folds 
matiko09: folds 
faceMyBallz_: folds 
rewq99887788: calls £0.25
joker180785: checks 
*** FLOP *** [3h Qc Ac]
rewq99887788: bets £1
joker180785: folds 
Uncalled bet (£1) returned to rewq99887788
rewq99887788 collected £0.95 from pot
*** SUMMARY ***
Total pot £1 | Rake £0.05 
Board [3h Qc Ac]
Seat 1: rewq99887788 (small blind) collected (£0.95)
Seat 2: joker180785 (big blind) folded on the Flop
Seat 3: Doobes8555 folded before Flop (didn't bet)
Seat 4: matiko09 folded before Flop (didn't bet)
Seat 6: faceMyBallz_ (button) folded before Flop (didn't bet)





PokerStars Hand #154970147438:  Hold'em No Limit (£0.25/£0.50 GBP) - 2016/06/20 12:27:58 CET [2016/06/20 6:27:58 ET]
Table 'Tesla' 6-max Seat #3 is the button
Seat 1: Rubleff85 (£35.40 in chips) 
Seat 2: matiko09 (£55.95 in chips) 
Seat 3: asmodej666 (£50.50 in chips) 
Rubleff85: posts small blind £0.25
matiko09: posts big blind £0.50
*** HOLE CARDS ***
Dealt to matiko09 [Ks 7c]
asmodej666: folds 
Rubleff85: raises £1 to £1.50
matiko09: folds 
Uncalled bet (£1) returned to Rubleff85
Rubleff85 collected £1 from pot
Rubleff85: doesn't show hand 
*** SUMMARY ***
Total pot £1 | Rake £0 
Seat 1: Rubleff85 (small blind) collected (£1)
Seat 2: matiko09 (big blind) folded before Flop
Seat 3: asmodej666 (button) folded before Flop (didn't bet)





PokerStars Hand #154970150508:  Hold'em No Limit (£0.25/£0.50 GBP) - 2016/06/20 12:28:05 CET [2016/06/20 6:28:05 ET]
Table 'Azalea' 6-max Seat #6 is the button
Seat 1: mitsuVK (£101.86 in chips) 
Seat 2: matiko09 (£83.35 in chips) 
Seat 3: VahTang_89 (£50 in chips) 
Seat 4: faceMyBallz_ (£50 in chips) 
Seat 5: mudders693 (£72.95 in chips) 
Seat 6: Bënedic10 (£50 in chips) 
mitsuVK: posts small blind £0.25
matiko09: posts big blind £0.50
*** HOLE CARDS ***
Dealt to matiko09 [7s 9h]
VahTang_89: folds 
faceMyBallz_: folds 
mudders693: raises £0.50 to £1
Bënedic10: folds 
mitsuVK: folds 
matiko09: folds 
Uncalled bet (£0.50) returned to mudders693
mudders693 collected £1.25 from pot
mudders693: doesn't show hand 
*** SUMMARY ***
Total pot £1.25 | Rake £0 
Seat 1: mitsuVK (small blind) folded before Flop
Seat 2: matiko09 (big blind) folded before Flop
Seat 3: VahTang_89 folded before Flop (didn't bet)
Seat 4: faceMyBallz_ folded before Flop (didn't bet)
Seat 5: mudders693 collected (£1.25)
Seat 6: Bënedic10 (button) folded before Flop (didn't bet)





PokerStars Hand #154970152219:  Hold'em No Limit ($0.50/$1.00 USD) - 2016/06/20 12:28:10 CET [2016/06/20 6:28:10 ET]
Table 'Ernestina' 9-max Seat #8 is the button
Seat 1: diva3150 ($75.18 in chips) 
Seat 2: matiko09 ($100 in chips) 
Seat 3: Pvsx. ($147.42 in chips) 
Seat 4: SkUhNi ($102.02 in chips) 
Seat 6: arctur17 ($93.80 in chips) 
Seat 7: Avtovo ($100 in chips) 
Seat 8: ruslik_by ($299.24 in chips) 
Seat 9: 23SmOkEr07 ($100 in chips) 
23SmOkEr07: posts small blind $0.50
diva3150: posts big blind $1
Dickyxxx: sits out 
*** HOLE CARDS ***
Dealt to matiko09 [Kd Jd]
matiko09: raises $2 to $3
Pvsx.: folds 
SkUhNi: folds 
arctur17: folds 
Avtovo: folds 
ruslik_by: folds 
23SmOkEr07: folds 
diva3150: folds 
Uncalled bet ($2) returned to matiko09
matiko09 collected $2.50 from pot
matiko09: doesn't show hand 
*** SUMMARY ***
Total pot $2.50 | Rake $0 
Seat 1: diva3150 (big blind) folded before Flop
Seat 2: matiko09 collected ($2.50)
Seat 3: Pvsx. folded before Flop (didn't bet)
Seat 4: SkUhNi folded before Flop (didn't bet)
Seat 6: arctur17 folded before Flop (didn't bet)
Seat 7: Avtovo folded before Flop (didn't bet)
Seat 8: ruslik_by (button) folded before Flop (didn't bet)
Seat 9: 23SmOkEr07 (small blind) folded before Flop





PokerStars Hand #154970153310:  Hold'em No Limit (£0.25/£0.50 GBP) - 2016/06/20 12:28:13 CET [2016/06/20 6:28:13 ET]
Table 'Tesla' 6-max Seat #1 is the button
Seat 1: Rubleff85 (£35.90 in chips) 
Seat 2: matiko09 (£55.45 in chips) 
Seat 3: asmodej666 (£50.50 in chips) 
matiko09: posts small blind £0.25
asmodej666: posts big blind £0.50
*** HOLE CARDS ***
Dealt to matiko09 [6d Ac]
Rubleff85: folds 
matiko09: raises £1 to £1.50
asmodej666: raises £3 to £4.50
matiko09: folds 
Uncalled bet (£3) returned to asmodej666
asmodej666 collected £3 from pot
asmodej666: doesn't show hand 
*** SUMMARY ***
Total pot £3 | Rake £0 
Seat 1: Rubleff85 (button) folded before Flop (didn't bet)
Seat 2: matiko09 (small blind) folded before Flop
Seat 3: asmodej666 (big blind) collected (£3)





PokerStars Hand #154970157239:  Hold'em No Limit (£0.25/£0.50 GBP) - 2016/06/20 12:28:23 CET [2016/06/20 6:28:23 ET]
Table 'Azalea' 6-max Seat #1 is the button
Seat 1: mitsuVK (£101.61 in chips) 
Seat 2: matiko09 (£82.85 in chips) 
Seat 3: VahTang_89 (£50 in chips) 
Seat 4: faceMyBallz_ (£50 in chips) 
Seat 5: mudders693 (£73.70 in chips) 
Seat 6: Bënedic10 (£50 in chips) 
matiko09: posts small blind £0.25
VahTang_89: posts big blind £0.50
*** HOLE CARDS ***
Dealt to matiko09 [8s Qd]
faceMyBallz_: folds 
mudders693: folds 
Bënedic10: raises £0.75 to £1.25
mitsuVK: calls £1.25
matiko09: folds 
VahTang_89: folds 
*** FLOP *** [2s 6s 6h]
Bënedic10: checks 
mitsuVK: checks 
*** TURN *** [2s 6s 6h] [9d]
Bënedic10: checks 
mitsuVK: bets £1.25
Bënedic10: folds 
Uncalled bet (£1.25) returned to mitsuVK
mitsuVK collected £3.09 from pot
mitsuVK: doesn't show hand 
*** SUMMARY ***
Total pot £3.25 | Rake £0.16 
Board [2s 6s 6h 9d]
Seat 1: mitsuVK (button) collected (£3.09)
Seat 2: matiko09 (small blind) folded before Flop
Seat 3: VahTang_89 (big blind) folded before Flop
Seat 4: faceMyBallz_ folded before Flop (didn't bet)
Seat 5: mudders693 folded before Flop (didn't bet)
Seat 6: Bënedic10 folded on the Turn





PokerStars Hand #154970157258:  Hold'em No Limit (£0.25/£0.50 GBP) - 2016/06/20 12:28:23 CET [2016/06/20 6:28:23 ET]
Table 'Ani' 6-max Seat #1 is the button
Seat 1: rewq99887788 (£42.93 in chips) 
Seat 2: joker180785 (£59.29 in chips) 
Seat 3: Doobes8555 (£71.52 in chips) 
Seat 4: matiko09 (£51.26 in chips) 
Seat 6: faceMyBallz_ (£55.36 in chips) 
joker180785: posts small blind £0.25
Doobes8555: posts big blind £0.50
*** HOLE CARDS ***
Dealt to matiko09 [Ac Ks]
matiko09: raises £1 to £1.50
faceMyBallz_: folds 
rewq99887788: raises £3 to £4.50
joker180785: folds 
Doobes8555: folds 
matiko09: calls £3
*** FLOP *** [Js 7c 5d]
matiko09: checks 
rewq99887788: checks 
*** TURN *** [Js 7c 5d] [7d]
matiko09: checks 
rewq99887788: bets £6.50
matiko09: calls £6.50
*** RIVER *** [Js 7c 5d 7d] [3c]
matiko09: checks 
rewq99887788: checks 
*** SHOW DOWN ***
matiko09: shows [Ac Ks] (a pair of Sevens)
rewq99887788: shows [Kd Ad] (a pair of Sevens)
matiko09 collected £10.81 from pot
rewq99887788 collected £10.80 from pot
*** SUMMARY ***
Total pot £22.75 | Rake £1.14 
Board [Js 7c 5d 7d 3c]
Seat 1: rewq99887788 (button) showed [Kd Ad] and won (£10.80) with a pair of Sevens
Seat 2: joker180785 (small blind) folded before Flop
Seat 3: Doobes8555 (big blind) folded before Flop
Seat 4: matiko09 showed [Ac Ks] and won (£10.81) with a pair of Sevens
Seat 6: faceMyBallz_ folded before Flop (didn't bet)





PokerStars Hand #154970160499:  Hold'em No Limit ($0.25/$0.50 USD) - 2016/06/20 12:28:32 CET [2016/06/20 6:28:32 ET]
Table 'Scheddi II' 9-max Seat #8 is the button
Seat 1: matiko09 ($50 in chips) 
Seat 2: Yaaaazz ($95.45 in chips) 
Seat 3: mi$$I$Elena ($50 in chips) 
Seat 4: GOOFA13 ($29.30 in chips) 
Seat 5: No Money NW ($49.05 in chips) 
Seat 6: joker180785 ($63.78 in chips) 
Seat 7: HopeMayBee ($58.80 in chips) 
Seat 8: orochimaturi ($39.05 in chips) 
Seat 9: Infinitinium ($132.22 in chips) 
Infinitinium: posts small blind $0.25
matiko09: posts big blind $0.50
matiko09: posts the ante $0.10
Yaaaazz: posts the ante $0.10
mi$$I$Elena: posts the ante $0.10
GOOFA13: posts the ante $0.10
No Money NW: posts the ante $0.10
joker180785: posts the ante $0.10
HopeMayBee: posts the ante $0.10
orochimaturi: posts the ante $0.10
Infinitinium: posts the ante $0.10
*** HOLE CARDS ***
Dealt to matiko09 [9d 2s]
Yaaaazz: folds 
mi$$I$Elena: folds 
GOOFA13: raises $2 to $2.50
No Money NW: raises $3.50 to $6
joker180785: folds 
HopeMayBee: folds 
orochimaturi: folds 
Infinitinium: folds 
matiko09: folds 
GOOFA13: folds 
Uncalled bet ($3.50) returned to No Money NW
No Money NW collected $6.65 from pot
No Money NW: doesn't show hand 
*** SUMMARY ***
Total pot $6.65 | Rake $0 
Seat 1: matiko09 (big blind) folded before Flop
Seat 2: Yaaaazz folded before Flop (didn't bet)
Seat 3: mi$$I$Elena folded before Flop (didn't bet)
Seat 4: GOOFA13 folded before Flop
Seat 5: No Money NW collected ($6.65)
Seat 6: joker180785 folded before Flop (didn't bet)
Seat 7: HopeMayBee folded before Flop (didn't bet)
Seat 8: orochimaturi (button) folded before Flop (didn't bet)
Seat 9: Infinitinium (small blind) folded before Flop





PokerStars Hand #154970161666:  Hold'em No Limit (£0.25/£0.50 GBP) - 2016/06/20 12:28:35 CET [2016/06/20 6:28:35 ET]
Table 'Tesla' 6-max Seat #2 is the button
Seat 1: Rubleff85 (£35.90 in chips) 
Seat 2: matiko09 (£53.95 in chips) 
Seat 3: asmodej666 (£52 in chips) 
asmodej666: posts small blind £0.25
Rubleff85: posts big blind £0.50
*** HOLE CARDS ***
Dealt to matiko09 [9h Qs]
matiko09: raises £0.63 to £1.13
asmodej666: folds 
Rubleff85: calls £0.63
*** FLOP *** [5d Jc 6c]
Rubleff85: checks 
matiko09: checks 
*** TURN *** [5d Jc 6c] [3c]
Rubleff85: bets £1.19
matiko09: folds 
Uncalled bet (£1.19) returned to Rubleff85
Rubleff85 collected £2.38 from pot
Rubleff85: doesn't show hand 
*** SUMMARY ***
Total pot £2.51 | Rake £0.13 
Board [5d Jc 6c 3c]
Seat 1: Rubleff85 (big blind) collected (£2.38)
Seat 2: matiko09 (button) folded on the Turn
Seat 3: asmodej666 (small blind) folded before Flop





PokerStars Hand #154970162411:  Hold'em No Limit ($0.50/$1.00 USD) - 2016/06/20 12:28:37 CET [2016/06/20 6:28:37 ET]
Table 'Ambrosia II' 9-max Seat #6 is the button
Seat 1: 23SmOkEr07 ($112.82 in chips) 
Seat 2: Eyeballz1307 ($76.93 in chips) 
Seat 3: mavin80 ($80.18 in chips) 
Seat 4: mi$$I$Elena ($126.12 in chips) 
Seat 5: Mattulh ($100 in chips) 
Seat 6: ruslik_by ($114.80 in chips) 
Seat 7: matiko09 ($105 in chips) 
Seat 8: hammerwife ($100 in chips) 
Seat 9: SkUhNi ($126.81 in chips) 
matiko09: posts small blind $0.50
hammerwife: posts big blind $1
*** HOLE CARDS ***
Dealt to matiko09 [3h 8c]
SkUhNi: folds 
23SmOkEr07: folds 
Eyeballz1307: folds 
mavin80: folds 
mi$$I$Elena: folds 
Mattulh: folds 
ruslik_by: folds 
matiko09: folds 
Uncalled bet ($0.50) returned to hammerwife
hammerwife collected $1 from pot
hammerwife: doesn't show hand 
*** SUMMARY ***
Total pot $1 | Rake $0 
Seat 1: 23SmOkEr07 folded before Flop (didn't bet)
Seat 2: Eyeballz1307 folded before Flop (didn't bet)
Seat 3: mavin80 folded before Flop (didn't bet)
Seat 4: mi$$I$Elena folded before Flop (didn't bet)
Seat 5: Mattulh folded before Flop (didn't bet)
Seat 6: ruslik_by (button) folded before Flop (didn't bet)
Seat 7: matiko09 (small blind) folded before Flop
Seat 8: hammerwife (big blind) collected ($1)
Seat 9: SkUhNi folded before Flop (didn't bet)





PokerStars Hand #154970162546:  Hold'em No Limit ($0.50/$1.00 USD) - 2016/06/20 12:28:37 CET [2016/06/20 6:28:37 ET]
Table 'Ernestina' 9-max Seat #9 is the button
Seat 1: diva3150 ($74.18 in chips) 
Seat 2: matiko09 ($101.50 in chips) 
Seat 3: Pvsx. ($147.42 in chips) 
Seat 4: SkUhNi ($102.02 in chips) 
Seat 6: arctur17 ($93.80 in chips) 
Seat 7: Avtovo ($100 in chips) 
Seat 8: ruslik_by ($299.24 in chips) 
Seat 9: 23SmOkEr07 ($100 in chips) 
diva3150: posts small blind $0.50
matiko09: posts big blind $1
Dickyxxx: sits out 
*** HOLE CARDS ***
Dealt to matiko09 [3h 6d]
Pvsx.: folds 
SkUhNi: folds 
arctur17: folds 
Avtovo: raises $1.50 to $2.50
ruslik_by: raises $6 to $8.50
23SmOkEr07: folds 
diva3150: folds 
matiko09: folds 
Avtovo: raises $14 to $22.50
ruslik_by: folds 
Uncalled bet ($14) returned to Avtovo
Avtovo collected $18.50 from pot
Avtovo: doesn't show hand 
*** SUMMARY ***
Total pot $18.50 | Rake $0 
Seat 1: diva3150 (small blind) folded before Flop
Seat 2: matiko09 (big blind) folded before Flop
Seat 3: Pvsx. folded before Flop (didn't bet)
Seat 4: SkUhNi folded before Flop (didn't bet)
Seat 6: arctur17 folded before Flop (didn't bet)
Seat 7: Avtovo collected ($18.50)
Seat 8: ruslik_by folded before Flop
Seat 9: 23SmOkEr07 (button) folded before Flop (didn't bet)





PokerStars Hand #154970162473:  Hold'em No Limit ($0.50/$1.00 USD) - 2016/06/20 12:28:37 CET [2016/06/20 6:28:37 ET]
Table 'Albiorix' 9-max Seat #9 is the button
Seat 1: arctur17 ($74.28 in chips) 
Seat 2: SkUhNi ($140.52 in chips) 
Seat 3: matiko09 ($128.23 in chips) 
Seat 4: 23SmOkEr07 ($145 in chips) 
Seat 5: ruslik_by ($100.25 in chips) 
Seat 6: joker180785 ($100 in chips) 
Seat 7: Pekyto ($35.18 in chips) 
Seat 8: smiley0221 ($43.08 in chips) 
Seat 9: Coolller ($176.97 in chips) 
arctur17: posts small blind $0.50
SkUhNi: posts big blind $1
*** HOLE CARDS ***
Dealt to matiko09 [4h 5h]
matiko09: folds 
23SmOkEr07: folds 
ruslik_by: folds 
joker180785: raises $2 to $3
Pekyto: folds 
smiley0221: folds 
Coolller: calls $3
arctur17: folds 
SkUhNi: raises $10 to $13
joker180785: folds 
Coolller: calls $10
*** FLOP *** [Jc 3d Ah]
SkUhNi: checks 
Coolller: checks 
*** TURN *** [Jc 3d Ah] [As]
SkUhNi: bets $12
Coolller: raises $12 to $24
SkUhNi: folds 
Uncalled bet ($12) returned to Coolller
Coolller collected $51 from pot
Coolller: doesn't show hand 
*** SUMMARY ***
Total pot $53.50 | Rake $2.50 
Board [Jc 3d Ah As]
Seat 1: arctur17 (small blind) folded before Flop
Seat 2: SkUhNi (big blind) folded on the Turn
Seat 3: matiko09 folded before Flop (didn't bet)
Seat 4: 23SmOkEr07 folded before Flop (didn't bet)
Seat 5: ruslik_by folded before Flop (didn't bet)
Seat 6: joker180785 folded before Flop
Seat 7: Pekyto folded before Flop (didn't bet)
Seat 8: smiley0221 folded before Flop (didn't bet)
Seat 9: Coolller (button) collected ($51)





PokerStars Hand #154970165277:  Hold'em No Limit ($0.25/$0.50 USD) - 2016/06/20 12:28:44 CET [2016/06/20 6:28:44 ET]
Table 'Juliana II' 9-max Seat #9 is the button
Seat 1: sno05 ($58.10 in chips) 
Seat 2: cjzm ($46.80 in chips) 
Seat 3: Dr.Mouse102 ($50 in chips) 
Seat 4: RICKA16 ($50 in chips) 
Seat 6: sophie2000 ($50 in chips) 
Seat 7: 23SmOkEr07 ($61.86 in chips) 
Seat 8: matiko09 ($50.50 in chips) 
Seat 9: tugboat2008 ($94.44 in chips) 
sno05: posts small blind $0.25
cjzm: posts big blind $0.50
ljryviltj: sits out 
*** HOLE CARDS ***
Dealt to matiko09 [2s 3c]
Dr.Mouse102: folds 
RICKA16: folds 
sophie2000: folds 
23SmOkEr07: folds 
matiko09: folds 
tugboat2008: raises $0.50 to $1
sno05 is connected 
sno05: folds 
cjzm: folds 
Uncalled bet ($0.50) returned to tugboat2008
tugboat2008 collected $1.25 from pot
*** SUMMARY ***
Total pot $1.25 | Rake $0 
Seat 1: sno05 (small blind) folded before Flop
Seat 2: cjzm (big blind) folded before Flop
Seat 3: Dr.Mouse102 folded before Flop (didn't bet)
Seat 4: RICKA16 folded before Flop (didn't bet)
Seat 6: sophie2000 folded before Flop (didn't bet)
Seat 7: 23SmOkEr07 folded before Flop (didn't bet)
Seat 8: matiko09 folded before Flop (didn't bet)
Seat 9: tugboat2008 (button) collected ($1.25)





PokerStars Hand #154970169407:  Hold'em No Limit ($0.50/$1.00 USD) - 2016/06/20 12:28:55 CET [2016/06/20 6:28:55 ET]
Table 'Anhui' 9-max Seat #1 is the button
Seat 1: SkUhNi ($152.42 in chips) 
Seat 2: ruslik_by ($272.68 in chips) 
Seat 4: mavin80 ($33.38 in chips) 
Seat 5: mi$$I$Elena ($109.30 in chips) 
Seat 6: 23SmOkEr07 ($133.25 in chips) 
Seat 7: matiko09 ($144.65 in chips) 
Seat 8: blackmont111 ($77.50 in chips) 
Seat 9: TomBod1 ($81.30 in chips) 
ruslik_by: posts small blind $0.50
Filojoes: is sitting out 
Filojoes leaves the table
mavin80: posts big blind $1
*** HOLE CARDS ***
Dealt to matiko09 [8c Td]
mi$$I$Elena: folds 
23SmOkEr07: folds 
matiko09: folds 
blackmont111: folds 
TomBod1: folds 
hammerwife joins the table at seat #3 
SkUhNi: raises $1 to $2
ruslik_by: raises $6.50 to $8.50
mavin80: folds 
SkUhNi: folds 
Uncalled bet ($6.50) returned to ruslik_by
ruslik_by collected $5 from pot
ruslik_by: doesn't show hand 
*** SUMMARY ***
Total pot $5 | Rake $0 
Seat 1: SkUhNi (button) folded before Flop
Seat 2: ruslik_by (small blind) collected ($5)
Seat 4: mavin80 (big blind) folded before Flop
Seat 5: mi$$I$Elena folded before Flop (didn't bet)
Seat 6: 23SmOkEr07 folded before Flop (didn't bet)
Seat 7: matiko09 folded before Flop (didn't bet)
Seat 8: blackmont111 folded before Flop (didn't bet)
Seat 9: TomBod1 folded before Flop (didn't bet)





PokerStars Hand #154970172901:  Hold'em No Limit ($0.50/$1.00 USD) - 2016/06/20 12:29:04 CET [2016/06/20 6:29:04 ET]
Table 'Ambrosia II' 9-max Seat #7 is the button
Seat 1: 23SmOkEr07 ($112.82 in chips) 
Seat 2: Eyeballz1307 ($76.93 in chips) 
Seat 3: mavin80 ($80.18 in chips) 
Seat 4: mi$$I$Elena ($126.12 in chips) 
Seat 5: Mattulh ($100 in chips) 
Seat 6: ruslik_by ($114.80 in chips) 
Seat 7: matiko09 ($104.50 in chips) 
Seat 8: hammerwife ($100.50 in chips) 
Seat 9: SkUhNi ($126.81 in chips) 
hammerwife: posts small blind $0.50
SkUhNi: posts big blind $1
*** HOLE CARDS ***
Dealt to matiko09 [Ad Kh]
23SmOkEr07: folds 
Eyeballz1307: folds 
mavin80: folds 
mi$$I$Elena: folds 
Mattulh: raises $1.50 to $2.50
ruslik_by: folds 
matiko09: raises $6.50 to $9
hammerwife: folds 
SkUhNi: folds 
Mattulh: folds 
Uncalled bet ($6.50) returned to matiko09
matiko09 collected $6.50 from pot
matiko09: doesn't show hand 
*** SUMMARY ***
Total pot $6.50 | Rake $0 
Seat 1: 23SmOkEr07 folded before Flop (didn't bet)
Seat 2: Eyeballz1307 folded before Flop (didn't bet)
Seat 3: mavin80 folded before Flop (didn't bet)
Seat 4: mi$$I$Elena folded before Flop (didn't bet)
Seat 5: Mattulh folded before Flop
Seat 6: ruslik_by folded before Flop (didn't bet)
Seat 7: matiko09 (button) collected ($6.50)
Seat 8: hammerwife (small blind) folded before Flop
Seat 9: SkUhNi (big blind) folded before Flop





PokerStars Hand #154970173395:  Hold'em No Limit (£0.25/£0.50 GBP) - 2016/06/20 12:29:05 CET [2016/06/20 6:29:05 ET]
Table 'Tesla' 6-max Seat #3 is the button
Seat 1: Rubleff85 (£37.15 in chips) 
Seat 2: matiko09 (£52.82 in chips) 
Seat 3: asmodej666 (£51.75 in chips) 
Rubleff85: posts small blind £0.25
matiko09: posts big blind £0.50
*** HOLE CARDS ***
Dealt to matiko09 [6h 3c]
asmodej666: raises £0.62 to £1.12
Rubleff85: calls £0.87
matiko09: folds 
*** FLOP *** [7s Tc Jh]
Rubleff85: bets £0.50
asmodej666: raises £1.75 to £2.25
Rubleff85: calls £1.75
*** TURN *** [7s Tc Jh] [Qs]
Rubleff85: checks 
asmodej666: checks 
*** RIVER *** [7s Tc Jh Qs] [6s]
Rubleff85: bets £4.44
asmodej666: calls £4.44
*** SHOW DOWN ***
Rubleff85: shows [5s Ts] (a flush, Queen high)
asmodej666: mucks hand 
Rubleff85 collected £15.62 from pot
*** SUMMARY ***
Total pot £16.12 | Rake £0.50 
Board [7s Tc Jh Qs 6s]
Seat 1: Rubleff85 (small blind) showed [5s Ts] and won (£15.62) with a flush, Queen high
Seat 2: matiko09 (big blind) folded before Flop
Seat 3: asmodej666 (button) mucked [9s Jd]





PokerStars Hand #154970174353:  Hold'em No Limit (£0.25/£0.50 GBP) - 2016/06/20 12:29:08 CET [2016/06/20 6:29:08 ET]
Table 'Azalea' 6-max Seat #2 is the button
Seat 1: mitsuVK (£103.45 in chips) 
Seat 2: matiko09 (£82.60 in chips) 
Seat 3: VahTang_89 (£50 in chips) 
Seat 4: faceMyBallz_ (£50 in chips) 
Seat 5: mudders693 (£73.70 in chips) 
Seat 6: Bënedic10 (£50 in chips) 
VahTang_89: posts small blind £0.25
faceMyBallz_: posts big blind £0.50
*** HOLE CARDS ***
Dealt to matiko09 [9c Ts]
mudders693: folds 
Bënedic10: raises £1 to £1.50
mitsuVK: folds 
matiko09: folds 
VahTang_89: folds 
faceMyBallz_: folds 
Uncalled bet (£1) returned to Bënedic10
Bënedic10 collected £1.25 from pot
Bënedic10: doesn't show hand 
*** SUMMARY ***
Total pot £1.25 | Rake £0 
Seat 1: mitsuVK folded before Flop (didn't bet)
Seat 2: matiko09 (button) folded before Flop (didn't bet)
Seat 3: VahTang_89 (small blind) folded before Flop
Seat 4: faceMyBallz_ (big blind) folded before Flop
Seat 5: mudders693 folded before Flop (didn't bet)
Seat 6: Bënedic10 collected (£1.25)





PokerStars Hand #154970174810:  Hold'em No Limit ($0.50/$1.00 USD) - 2016/06/20 12:29:09 CET [2016/06/20 6:29:09 ET]
Table 'Isonoe II' 9-max Seat #8 is the button
Seat 1: hammerwife ($120.36 in chips) 
Seat 2: matiko09 ($100 in chips) 
Seat 6: GOOFA13 ($40 in chips) 
Seat 7: SkUhNi ($100 in chips) 
Seat 8: lewyson ($55.75 in chips) 
Seat 9: djammusic ($54.98 in chips) 
djammusic: posts small blind $0.50
hammerwife: posts big blind $1
Avtovo: sits out 
Filojoes: sits out 
GOOFA13: posts big blind $1
*** HOLE CARDS ***
Dealt to matiko09 [9d 7d]
matiko09: folds 
GOOFA13: checks 
SkUhNi: folds 
lewyson: folds 
djammusic: folds 
hammerwife: checks 
*** FLOP *** [9s 8d 3d]
hammerwife: checks 
GOOFA13: checks 
*** TURN *** [9s 8d 3d] [8h]
hammerwife: checks 
GOOFA13: checks 
*** RIVER *** [9s 8d 3d 8h] [Jh]
Kukuryzka joins the table at seat #3 
hammerwife: checks 
GOOFA13: bets $2.38
hammerwife: folds 
Uncalled bet ($2.38) returned to GOOFA13
GOOFA13 collected $2.38 from pot
GOOFA13: doesn't show hand 
*** SUMMARY ***
Total pot $2.50 | Rake $0.12 
Board [9s 8d 3d 8h Jh]
Seat 1: hammerwife (big blind) folded on the River
Seat 2: matiko09 folded before Flop (didn't bet)
Seat 6: GOOFA13 collected ($2.38)
Seat 7: SkUhNi folded before Flop (didn't bet)
Seat 8: lewyson (button) folded before Flop (didn't bet)
Seat 9: djammusic (small blind) folded before Flop





PokerStars Hand #154970179264:  Hold'em No Limit ($0.25/$0.50 USD) - 2016/06/20 12:29:21 CET [2016/06/20 6:29:21 ET]
Table 'Scheddi II' 9-max Seat #9 is the button
Seat 1: matiko09 ($50 in chips) 
Seat 2: Yaaaazz ($95.35 in chips) 
Seat 3: mi$$I$Elena ($50 in chips) 
Seat 4: GOOFA13 ($26.70 in chips) 
Seat 5: No Money NW ($53.10 in chips) 
Seat 6: joker180785 ($63.68 in chips) 
Seat 7: HopeMayBee ($58.70 in chips) 
Seat 8: orochimaturi ($38.95 in chips) 
Seat 9: Infinitinium ($131.87 in chips) 
matiko09: posts small blind $0.25
Yaaaazz: posts big blind $0.50
matiko09: posts the ante $0.10
Yaaaazz: posts the ante $0.10
mi$$I$Elena: posts the ante $0.10
GOOFA13: posts the ante $0.10
No Money NW: posts the ante $0.10
joker180785: posts the ante $0.10
HopeMayBee: posts the ante $0.10
orochimaturi: posts the ante $0.10
Infinitinium: posts the ante $0.10
*** HOLE CARDS ***
Dealt to matiko09 [7s 9d]
mi$$I$Elena: raises $0.69 to $1.19
GOOFA13: folds 
No Money NW: raises $1.69 to $2.88
joker180785: folds 
HopeMayBee: folds 
orochimaturi: folds 
Infinitinium: folds 
matiko09: folds 
Yaaaazz: folds 
mi$$I$Elena: calls $1.69
*** FLOP *** [8c 2c 3s]
mi$$I$Elena: checks 
No Money NW: bets $7
mi$$I$Elena: calls $7
*** TURN *** [8c 2c 3s] [Td]
mi$$I$Elena: checks 
No Money NW: bets $20.50
mi$$I$Elena: raises $19.52 to $40.02 and is all-in
No Money NW: calls $19.52
*** RIVER *** [8c 2c 3s Td] [Ks]
*** SHOW DOWN ***
mi$$I$Elena: shows [9s 9c] (a pair of Nines)
No Money NW: shows [Ad Jc] (high card Ace)
mi$$I$Elena collected $99.45 from pot
*** SUMMARY ***
Total pot $101.45 | Rake $2 
Board [8c 2c 3s Td Ks]
Seat 1: matiko09 (small blind) folded before Flop
Seat 2: Yaaaazz (big blind) folded before Flop
Seat 3: mi$$I$Elena showed [9s 9c] and won ($99.45) with a pair of Nines
Seat 4: GOOFA13 folded before Flop (didn't bet)
Seat 5: No Money NW showed [Ad Jc] and lost with high card Ace
Seat 6: joker180785 folded before Flop (didn't bet)
Seat 7: HopeMayBee folded before Flop (didn't bet)
Seat 8: orochimaturi folded before Flop (didn't bet)
Seat 9: Infinitinium (button) folded before Flop (didn't bet)





PokerStars Hand #154970179674:  Hold'em No Limit ($0.25/$0.50 USD) - 2016/06/20 12:29:22 CET [2016/06/20 6:29:22 ET]
Table 'Juliana II' 9-max Seat #1 is the button
Seat 1: sno05 ($57.85 in chips) 
Seat 2: cjzm ($46.30 in chips) 
Seat 3: Dr.Mouse102 ($50 in chips) 
Seat 4: RICKA16 ($50 in chips) 
Seat 6: sophie2000 ($50 in chips) 
Seat 7: 23SmOkEr07 ($61.86 in chips) 
Seat 8: matiko09 ($50.50 in chips) 
Seat 9: tugboat2008 ($95.19 in chips) 
cjzm: posts small blind $0.25
Dr.Mouse102: posts big blind $0.50
ljryviltj: sits out 
*** HOLE CARDS ***
Dealt to matiko09 [Tc 3h]
RICKA16: folds 
sophie2000: folds 
23SmOkEr07: folds 
RICKA16 leaves the table
matiko09: folds 
zarplatka joins the table at seat #4 
tugboat2008: folds 
Dr.Mouse102 is disconnected 
sno05: raises $0.50 to $1
cjzm: raises $2 to $3
Dr.Mouse102 is connected 
Dr.Mouse102: folds 
sno05: calls $2
*** FLOP *** [5c 5h 9c]
cjzm: bets $3
sno05: folds 
Uncalled bet ($3) returned to cjzm
cjzm collected $6.18 from pot
cjzm: doesn't show hand 
*** SUMMARY ***
Total pot $6.50 | Rake $0.32 
Board [5c 5h 9c]
Seat 1: sno05 (button) folded on the Flop
Seat 2: cjzm (small blind) collected ($6.18)
Seat 3: Dr.Mouse102 (big blind) folded before Flop
Seat 4: RICKA16 folded before Flop (didn't bet)
Seat 6: sophie2000 folded before Flop (didn't bet)
Seat 7: 23SmOkEr07 folded before Flop (didn't bet)
Seat 8: matiko09 folded before Flop (didn't bet)
Seat 9: tugboat2008 folded before Flop (didn't bet)





PokerStars Hand #154970180852:  Hold'em No Limit ($0.50/$1.00 USD) - 2016/06/20 12:29:25 CET [2016/06/20 6:29:25 ET]
Table 'Ernestina' 9-max Seat #1 is the button
Seat 1: diva3150 ($73.68 in chips) 
Seat 2: matiko09 ($100.50 in chips) 
Seat 3: Pvsx. ($147.42 in chips) 
Seat 4: SkUhNi ($102.02 in chips) 
Seat 6: arctur17 ($93.80 in chips) 
Seat 7: Avtovo ($110 in chips) 
Seat 8: ruslik_by ($290.74 in chips) 
Seat 9: 23SmOkEr07 ($100 in chips) 
matiko09: posts small blind $0.50
Pvsx.: posts big blind $1
Dickyxxx: sits out 
*** HOLE CARDS ***
Dealt to matiko09 [Qs Ts]
SkUhNi: raises $2 to $3
arctur17: folds 
Avtovo: folds 
ruslik_by: folds 
23SmOkEr07: folds 
diva3150: folds 
matiko09: folds 
Pvsx.: folds 
Uncalled bet ($2) returned to SkUhNi
SkUhNi collected $2.50 from pot
SkUhNi: doesn't show hand 
*** SUMMARY ***
Total pot $2.50 | Rake $0 
Seat 1: diva3150 (button) folded before Flop (didn't bet)
Seat 2: matiko09 (small blind) folded before Flop
Seat 3: Pvsx. (big blind) folded before Flop
Seat 4: SkUhNi collected ($2.50)
Seat 6: arctur17 folded before Flop (didn't bet)
Seat 7: Avtovo folded before Flop (didn't bet)
Seat 8: ruslik_by folded before Flop (didn't bet)
Seat 9: 23SmOkEr07 folded before Flop (didn't bet)





PokerStars Hand #154970181930:  Hold'em No Limit (£0.25/£0.50 GBP) - 2016/06/20 12:29:28 CET [2016/06/20 6:29:28 ET]
Table 'Azalea' 6-max Seat #3 is the button
Seat 1: mitsuVK (£103.45 in chips) 
Seat 2: matiko09 (£82.60 in chips) 
Seat 3: VahTang_89 (£50 in chips) 
Seat 4: faceMyBallz_ (£50 in chips) 
Seat 5: mudders693 (£73.70 in chips) 
Seat 6: Bënedic10 (£50.75 in chips) 
faceMyBallz_: posts small blind £0.25
mudders693: posts big blind £0.50
*** HOLE CARDS ***
Dealt to matiko09 [8d Jc]
Bënedic10: folds 
mitsuVK: folds 
matiko09: folds 
VahTang_89: raises £1 to £1.50
faceMyBallz_: folds 
mudders693: folds 
Uncalled bet (£1) returned to VahTang_89
VahTang_89 collected £1.25 from pot
VahTang_89: doesn't show hand 
*** SUMMARY ***
Total pot £1.25 | Rake £0 
Seat 1: mitsuVK folded before Flop (didn't bet)
Seat 2: matiko09 folded before Flop (didn't bet)
Seat 3: VahTang_89 (button) collected (£1.25)
Seat 4: faceMyBallz_ (small blind) folded before Flop
Seat 5: mudders693 (big blind) folded before Flop
Seat 6: Bënedic10 folded before Flop (didn't bet)





PokerStars Hand #154970187348:  Hold'em No Limit ($0.50/$1.00 USD) - 2016/06/20 12:29:42 CET [2016/06/20 6:29:42 ET]
Table 'Anhui' 9-max Seat #2 is the button
Seat 1: SkUhNi ($150.42 in chips) 
Seat 2: ruslik_by ($275.68 in chips) 
Seat 4: mavin80 ($32.38 in chips) 
Seat 5: mi$$I$Elena ($109.30 in chips) 
Seat 6: 23SmOkEr07 ($133.25 in chips) 
Seat 7: matiko09 ($144.65 in chips) 
Seat 8: blackmont111 ($77.50 in chips) 
Seat 9: TomBod1 ($81.30 in chips) 
mavin80: posts small blind $0.50
mi$$I$Elena: posts big blind $1
*** HOLE CARDS ***
Dealt to matiko09 [9h 4s]
23SmOkEr07: folds 
matiko09: folds 
blackmont111: folds 
TomBod1: folds 
SkUhNi: folds 
ruslik_by: folds 
mavin80: folds 
Uncalled bet ($0.50) returned to mi$$I$Elena
mi$$I$Elena collected $1 from pot
mi$$I$Elena: doesn't show hand 
*** SUMMARY ***
Total pot $1 | Rake $0 
Seat 1: SkUhNi folded before Flop (didn't bet)
Seat 2: ruslik_by (button) folded before Flop (didn't bet)
Seat 4: mavin80 (small blind) folded before Flop
Seat 5: mi$$I$Elena (big blind) collected ($1)
Seat 6: 23SmOkEr07 folded before Flop (didn't bet)
Seat 7: matiko09 folded before Flop (didn't bet)
Seat 8: blackmont111 folded before Flop (didn't bet)
Seat 9: TomBod1 folded before Flop (didn't bet)





PokerStars Hand #154970188775:  Hold'em No Limit (£0.25/£0.50 GBP) - 2016/06/20 12:29:45 CET [2016/06/20 6:29:45 ET]
Table 'Ani' 6-max Seat #2 is the button
Seat 1: rewq99887788 (£42.73 in chips) 
Seat 2: joker180785 (£59.04 in chips) 
Seat 3: Doobes8555 (£71.02 in chips) 
Seat 4: matiko09 (£51.07 in chips) 
Seat 5: Wwwasian (£62.27 in chips) 
Seat 6: faceMyBallz_ (£55.36 in chips) 
Doobes8555: posts small blind £0.25
matiko09: posts big blind £0.50
*** HOLE CARDS ***
Dealt to matiko09 [Jd 6d]
Wwwasian: folds 
faceMyBallz_: folds 
rewq99887788: raises £0.50 to £1
joker180785: calls £1
Doobes8555: calls £0.75
matiko09: calls £0.50
*** FLOP *** [9c Jh 3h]
Doobes8555: checks 
matiko09: checks 
rewq99887788: checks 
joker180785: checks 
*** TURN *** [9c Jh 3h] [Kh]
Doobes8555: checks 
matiko09: checks 
rewq99887788: checks 
joker180785: checks 
*** RIVER *** [9c Jh 3h Kh] [2d]
Doobes8555: checks 
matiko09: checks 
rewq99887788: bets £1.50
joker180785: folds 
Doobes8555: folds 
matiko09: calls £1.50
*** SHOW DOWN ***
rewq99887788: shows [As 8d] (high card Ace)
matiko09: shows [Jd 6d] (a pair of Jacks)
matiko09 collected £6.65 from pot
*** SUMMARY ***
Total pot £7 | Rake £0.35 
Board [9c Jh 3h Kh 2d]
Seat 1: rewq99887788 showed [As 8d] and lost with high card Ace
Seat 2: joker180785 (button) folded on the River
Seat 3: Doobes8555 (small blind) folded on the River
Seat 4: matiko09 (big blind) showed [Jd 6d] and won (£6.65) with a pair of Jacks
Seat 5: Wwwasian folded before Flop (didn't bet)
Seat 6: faceMyBallz_ folded before Flop (didn't bet)





PokerStars Hand #154970190733:  Hold'em No Limit ($0.50/$1.00 USD) - 2016/06/20 12:29:50 CET [2016/06/20 6:29:50 ET]
Table 'Ernestina' 9-max Seat #2 is the button
Seat 1: diva3150 ($73.68 in chips) 
Seat 2: matiko09 ($100 in chips) 
Seat 3: Pvsx. ($146.42 in chips) 
Seat 4: SkUhNi ($103.52 in chips) 
Seat 6: arctur17 ($93.80 in chips) 
Seat 7: Avtovo ($110 in chips) 
Seat 8: ruslik_by ($290.74 in chips) 
Seat 9: 23SmOkEr07 ($100 in chips) 
Pvsx.: posts small blind $0.50
SkUhNi: posts big blind $1
Dickyxxx: sits out 
*** HOLE CARDS ***
Dealt to matiko09 [7c Tc]
arctur17: folds 
Avtovo: folds 
ruslik_by: raises $2 to $3
23SmOkEr07: folds 
diva3150: folds 
matiko09: folds 
Pvsx.: calls $2.50
SkUhNi: folds 
*** FLOP *** [Ac Ks 7s]
Pvsx.: checks 
ruslik_by: bets $2.26
Pvsx.: raises $5.74 to $8
ruslik_by: calls $5.74
*** TURN *** [Ac Ks 7s] [Th]
Pvsx.: bets $12
ruslik_by: calls $12
*** RIVER *** [Ac Ks 7s Th] [6d]
Pvsx.: checks 
ruslik_by: checks 
*** SHOW DOWN ***
Pvsx.: shows [Kd Ad] (two pair, Aces and Kings)
ruslik_by: mucks hand 
Pvsx. collected $44.65 from pot
*** SUMMARY ***
Total pot $47 | Rake $2.35 
Board [Ac Ks 7s Th 6d]
Seat 1: diva3150 folded before Flop (didn't bet)
Seat 2: matiko09 (button) folded before Flop (didn't bet)
Seat 3: Pvsx. (small blind) showed [Kd Ad] and won ($44.65) with two pair, Aces and Kings
Seat 4: SkUhNi (big blind) folded before Flop
Seat 6: arctur17 folded before Flop (didn't bet)
Seat 7: Avtovo folded before Flop (didn't bet)
Seat 8: ruslik_by mucked [Ts Qs]
Seat 9: 23SmOkEr07 folded before Flop (didn't bet)





PokerStars Hand #154970190406:  Hold'em No Limit ($0.50/$1.00 USD) - 2016/06/20 12:29:50 CET [2016/06/20 6:29:50 ET]
Table 'Pongola' 9-max Seat #8 is the button
Seat 1: matiko09 ($101.50 in chips) 
Seat 2: ruslik_by ($136.27 in chips) 
Seat 3: SkUhNi ($100 in chips) 
Seat 4: karllv ($115.79 in chips) 
Seat 5: joker180785 ($107.43 in chips) 
Seat 6: 23SmOkEr07 ($117.21 in chips) 
Seat 7: Dickyxxx ($155.12 in chips) 
Seat 8: phrantique ($98.70 in chips) 
Seat 9: Filojoes ($106.72 in chips) 
Filojoes: posts small blind $0.50
matiko09: posts big blind $1
*** HOLE CARDS ***
Dealt to matiko09 [3d 4c]
ruslik_by: folds 
SkUhNi: folds 
karllv: calls $1
joker180785: folds 
23SmOkEr07: folds 
Dickyxxx: raises $3 to $4
phrantique: folds 
Filojoes: folds 
matiko09: folds 
karllv: calls $3
*** FLOP *** [3c Th 8h]
karllv: checks 
Dickyxxx: checks 
*** TURN *** [3c Th 8h] [4d]
karllv: bets $4
Dickyxxx: folds 
Uncalled bet ($4) returned to karllv
karllv collected $9.02 from pot
*** SUMMARY ***
Total pot $9.50 | Rake $0.48 
Board [3c Th 8h 4d]
Seat 1: matiko09 (big blind) folded before Flop
Seat 2: ruslik_by folded before Flop (didn't bet)
Seat 3: SkUhNi folded before Flop (didn't bet)
Seat 4: karllv collected ($9.02)
Seat 5: joker180785 folded before Flop (didn't bet)
Seat 6: 23SmOkEr07 folded before Flop (didn't bet)
Seat 7: Dickyxxx folded on the Turn
Seat 8: phrantique (button) folded before Flop (didn't bet)
Seat 9: Filojoes (small blind) folded before Flop





PokerStars Hand #154970191908:  Hold'em No Limit ($0.50/$1.00 USD) - 2016/06/20 12:29:53 CET [2016/06/20 6:29:53 ET]
Table 'Ambrosia II' 9-max Seat #8 is the button
Seat 1: 23SmOkEr07 ($112.82 in chips) 
Seat 2: Eyeballz1307 ($76.93 in chips) 
Seat 3: mavin80 ($80.18 in chips) 
Seat 4: mi$$I$Elena ($126.12 in chips) 
Seat 5: Mattulh ($100 in chips) 
Seat 6: ruslik_by ($114.80 in chips) 
Seat 7: matiko09 ($108.50 in chips) 
Seat 8: hammerwife ($100 in chips) 
Seat 9: SkUhNi ($125.81 in chips) 
SkUhNi: posts small blind $0.50
23SmOkEr07: posts big blind $1
*** HOLE CARDS ***
Dealt to matiko09 [Jd 6d]
Eyeballz1307: folds 
mavin80: folds 
mi$$I$Elena: folds 
Mattulh: folds 
ruslik_by: raises $2 to $3
matiko09: folds 
hammerwife: folds 
SkUhNi: folds 
23SmOkEr07: folds 
Uncalled bet ($2) returned to ruslik_by
ruslik_by collected $2.50 from pot
ruslik_by: doesn't show hand 
*** SUMMARY ***
Total pot $2.50 | Rake $0 
Seat 1: 23SmOkEr07 (big blind) folded before Flop
Seat 2: Eyeballz1307 folded before Flop (didn't bet)
Seat 3: mavin80 folded before Flop (didn't bet)
Seat 4: mi$$I$Elena folded before Flop (didn't bet)
Seat 5: Mattulh folded before Flop (didn't bet)
Seat 6: ruslik_by collected ($2.50)
Seat 7: matiko09 folded before Flop (didn't bet)
Seat 8: hammerwife (button) folded before Flop (didn't bet)
Seat 9: SkUhNi (small blind) folded before Flop





PokerStars Hand #154970197595:  Hold'em No Limit (£0.25/£0.50 GBP) - 2016/06/20 12:30:08 CET [2016/06/20 6:30:08 ET]
Table 'Azalea' 6-max Seat #4 is the button
Seat 1: mitsuVK (£103.45 in chips) 
Seat 2: matiko09 (£82.60 in chips) 
Seat 3: VahTang_89 (£50.75 in chips) 
Seat 4: faceMyBallz_ (£50 in chips) 
Seat 5: mudders693 (£73.20 in chips) 
Seat 6: Bënedic10 (£50.75 in chips) 
mudders693: posts small blind £0.25
Bënedic10: posts big blind £0.50
*** HOLE CARDS ***
Dealt to matiko09 [6h 9h]
mitsuVK: raises £1 to £1.50
matiko09: folds 
VahTang_89: folds 
faceMyBallz_: folds 
mudders693: folds 
Bënedic10: folds 
Uncalled bet (£1) returned to mitsuVK
mitsuVK collected £1.25 from pot
mitsuVK: doesn't show hand 
*** SUMMARY ***
Total pot £1.25 | Rake £0 
Seat 1: mitsuVK collected (£1.25)
Seat 2: matiko09 folded before Flop (didn't bet)
Seat 3: VahTang_89 folded before Flop (didn't bet)
Seat 4: faceMyBallz_ (button) folded before Flop (didn't bet)
Seat 5: mudders693 (small blind) folded before Flop
Seat 6: Bënedic10 (big blind) folded before Flop





PokerStars Hand #154970198589:  Hold'em No Limit (£0.25/£0.50 GBP) - 2016/06/20 12:30:11 CET [2016/06/20 6:30:11 ET]
Table 'Tesla' 6-max Seat #1 is the button
Seat 1: Rubleff85 (£44.96 in chips) 
Seat 2: matiko09 (£52.32 in chips) 
Seat 3: asmodej666 (£50 in chips) 
matiko09: posts small blind £0.25
asmodej666: posts big blind £0.50
*** HOLE CARDS ***
Dealt to matiko09 [6c 9s]
Rubleff85: folds 
matiko09: folds 
Uncalled bet (£0.25) returned to asmodej666
asmodej666 collected £0.50 from pot
asmodej666: doesn't show hand 
*** SUMMARY ***
Total pot £0.50 | Rake £0 
Seat 1: Rubleff85 (button) folded before Flop (didn't bet)
Seat 2: matiko09 (small blind) folded before Flop
Seat 3: asmodej666 (big blind) collected (£0.50)





PokerStars Hand #154970198540:  Hold'em No Limit ($0.50/$1.00 USD) - 2016/06/20 12:30:11 CET [2016/06/20 6:30:11 ET]
Table 'Anhui' 9-max Seat #4 is the button
Seat 1: SkUhNi ($150.42 in chips) 
Seat 2: ruslik_by ($275.68 in chips) 
Seat 4: mavin80 ($31.88 in chips) 
Seat 5: mi$$I$Elena ($109.80 in chips) 
Seat 6: 23SmOkEr07 ($133.25 in chips) 
Seat 7: matiko09 ($144.65 in chips) 
Seat 8: blackmont111 ($77.50 in chips) 
Seat 9: TomBod1 ($81.30 in chips) 
mi$$I$Elena: posts small blind $0.50
23SmOkEr07: posts big blind $1
*** HOLE CARDS ***
Dealt to matiko09 [9h Ts]
matiko09: folds 
blackmont111: folds 
TomBod1: folds 
SkUhNi: folds 
ruslik_by: folds 
mavin80: raises $1.50 to $2.50
mi$$I$Elena: raises $3.50 to $6
23SmOkEr07: folds 
mavin80: folds 
Uncalled bet ($3.50) returned to mi$$I$Elena
mi$$I$Elena collected $6 from pot
mi$$I$Elena: doesn't show hand 
*** SUMMARY ***
Total pot $6 | Rake $0 
Seat 1: SkUhNi folded before Flop (didn't bet)
Seat 2: ruslik_by folded before Flop (didn't bet)
Seat 4: mavin80 (button) folded before Flop
Seat 5: mi$$I$Elena (small blind) collected ($6)
Seat 6: 23SmOkEr07 (big blind) folded before Flop
Seat 7: matiko09 folded before Flop (didn't bet)
Seat 8: blackmont111 folded before Flop (didn't bet)
Seat 9: TomBod1 folded before Flop (didn't bet)





PokerStars Hand #154970202941:  Hold'em No Limit (£0.25/£0.50 GBP) - 2016/06/20 12:30:22 CET [2016/06/20 6:30:22 ET]
Table 'Tesla' 6-max Seat #2 is the button
Seat 1: Rubleff85 (£44.96 in chips) 
Seat 2: matiko09 (£52.07 in chips) 
Seat 3: asmodej666 (£50.25 in chips) 
asmodej666: posts small blind £0.25
Rubleff85: posts big blind £0.50
*** HOLE CARDS ***
Dealt to matiko09 [Ac 5s]
matiko09: raises £0.63 to £1.13
asmodej666: folds 
Rubleff85: folds 
Uncalled bet (£0.63) returned to matiko09
matiko09 collected £1.25 from pot
matiko09: doesn't show hand 
*** SUMMARY ***
Total pot £1.25 | Rake £0 
Seat 1: Rubleff85 (big blind) folded before Flop
Seat 2: matiko09 (button) collected (£1.25)
Seat 3: asmodej666 (small blind) folded before Flop





PokerStars Hand #154970204830:  Hold'em No Limit ($0.50/$1.00 USD) - 2016/06/20 12:30:27 CET [2016/06/20 6:30:27 ET]
Table 'Isonoe II' 9-max Seat #9 is the button
Seat 1: hammerwife ($119.36 in chips) 
Seat 2: matiko09 ($100 in chips) 
Seat 6: GOOFA13 ($41.38 in chips) 
Seat 7: SkUhNi ($100 in chips) 
Seat 8: lewyson ($55.75 in chips) 
Seat 9: djammusic ($54.48 in chips) 
hammerwife: posts small blind $0.50
matiko09: posts big blind $1
Kukuryzka: sits out 
Avtovo: sits out 
Filojoes: sits out 
*** HOLE CARDS ***
Dealt to matiko09 [3s 9d]
GOOFA13: folds 
SkUhNi: folds 
lewyson: folds 
djammusic: folds 
hammerwife: folds 
Uncalled bet ($0.50) returned to matiko09
matiko09 collected $1 from pot
matiko09: doesn't show hand 
*** SUMMARY ***
Total pot $1 | Rake $0 
Seat 1: hammerwife (small blind) folded before Flop
Seat 2: matiko09 (big blind) collected ($1)
Seat 6: GOOFA13 folded before Flop (didn't bet)
Seat 7: SkUhNi folded before Flop (didn't bet)
Seat 8: lewyson folded before Flop (didn't bet)
Seat 9: djammusic (button) folded before Flop (didn't bet)





PokerStars Hand #154970206510:  Hold'em No Limit (£0.25/£0.50 GBP) - 2016/06/20 12:30:31 CET [2016/06/20 6:30:31 ET]
Table 'Tesla' 6-max Seat #3 is the button
Seat 1: Rubleff85 (£44.46 in chips) 
Seat 2: matiko09 (£52.82 in chips) 
Seat 3: asmodej666 (£50 in chips) 
Rubleff85: posts small blind £0.25
matiko09: posts big blind £0.50
*** HOLE CARDS ***
Dealt to matiko09 [8d 6s]
asmodej666: raises £0.62 to £1.12
Rubleff85: folds 
matiko09: folds 
Uncalled bet (£0.62) returned to asmodej666
asmodej666 collected £1.25 from pot
asmodej666: doesn't show hand 
*** SUMMARY ***
Total pot £1.25 | Rake £0 
Seat 1: Rubleff85 (small blind) folded before Flop
Seat 2: matiko09 (big blind) folded before Flop
Seat 3: asmodej666 (button) collected (£1.25)





PokerStars Hand #154970208213:  Hold'em No Limit ($0.25/$0.50 USD) - 2016/06/20 12:30:36 CET [2016/06/20 6:30:36 ET]
Table 'Scheddi II' 9-max Seat #1 is the button
Seat 1: matiko09 ($50 in chips) 
Seat 2: Yaaaazz ($94.75 in chips) 
Seat 3: mi$$I$Elena ($99.45 in chips) 
Seat 4: GOOFA13 ($26.60 in chips) 
Seat 5: No Money NW ($3.10 in chips) 
Seat 6: joker180785 ($63.58 in chips) 
Seat 7: HopeMayBee ($58.60 in chips) 
Seat 8: orochimaturi ($38.85 in chips) 
Seat 9: Infinitinium ($131.77 in chips) 
Yaaaazz: posts small blind $0.25
mi$$I$Elena: posts big blind $0.50
matiko09: posts the ante $0.10
Yaaaazz: posts the ante $0.10
mi$$I$Elena: posts the ante $0.10
GOOFA13: posts the ante $0.10
No Money NW: posts the ante $0.10
joker180785: posts the ante $0.10
HopeMayBee: posts the ante $0.10
orochimaturi: posts the ante $0.10
Infinitinium: posts the ante $0.10
*** HOLE CARDS ***
Dealt to matiko09 [7c 4h]
GOOFA13: folds 
No Money NW: raises $2.50 to $3 and is all-in
joker180785: folds 
HopeMayBee: calls $3
orochimaturi: folds 
Infinitinium: folds 
matiko09: folds 
Yaaaazz: calls $2.75
mi$$I$Elena: folds 
*** FLOP *** [3s Td 5h]
Yaaaazz: checks 
HopeMayBee: checks 
*** TURN *** [3s Td 5h] [6s]
Yaaaazz: checks 
HopeMayBee: checks 
*** RIVER *** [3s Td 5h 6s] [3c]
Yaaaazz: checks 
HopeMayBee: checks 
*** SHOW DOWN ***
Yaaaazz: shows [Jh Kc] (a pair of Threes)
No Money NW: shows [As 4s] (a pair of Threes - Ace kicker)
HopeMayBee: shows [Ac Jd] (a pair of Threes - Ace+Jack kicker)
HopeMayBee collected $9.88 from pot
*** SUMMARY ***
Total pot $10.40 | Rake $0.52 
Board [3s Td 5h 6s 3c]
Seat 1: matiko09 (button) folded before Flop (didn't bet)
Seat 2: Yaaaazz (small blind) showed [Jh Kc] and lost with a pair of Threes
Seat 3: mi$$I$Elena (big blind) folded before Flop
Seat 4: GOOFA13 folded before Flop (didn't bet)
Seat 5: No Money NW showed [As 4s] and lost with a pair of Threes
Seat 6: joker180785 folded before Flop (didn't bet)
Seat 7: HopeMayBee showed [Ac Jd] and won ($9.88) with a pair of Threes
Seat 8: orochimaturi folded before Flop (didn't bet)
Seat 9: Infinitinium folded before Flop (didn't bet)





PokerStars Hand #154970209081:  Hold'em No Limit (£0.25/£0.50 GBP) - 2016/06/20 12:30:38 CET [2016/06/20 6:30:38 ET]
Table 'Azalea' 6-max Seat #5 is the button
Seat 1: mitsuVK (£104.20 in chips) 
Seat 2: matiko09 (£82.60 in chips) 
Seat 3: VahTang_89 (£50.75 in chips) 
Seat 4: faceMyBallz_ (£50 in chips) 
Seat 5: mudders693 (£72.95 in chips) 
Seat 6: Bënedic10 (£50.25 in chips) 
Bënedic10: posts small blind £0.25
mitsuVK: posts big blind £0.50
*** HOLE CARDS ***
Dealt to matiko09 [3c Ts]
matiko09: folds 
VahTang_89: folds 
faceMyBallz_: folds 
mudders693: raises £1 to £1.50
Bënedic10: folds 
mitsuVK: folds 
Uncalled bet (£1) returned to mudders693
mudders693 collected £1.25 from pot
mudders693: doesn't show hand 
*** SUMMARY ***
Total pot £1.25 | Rake £0 
Seat 1: mitsuVK (big blind) folded before Flop
Seat 2: matiko09 folded before Flop (didn't bet)
Seat 3: VahTang_89 folded before Flop (didn't bet)
Seat 4: faceMyBallz_ folded before Flop (didn't bet)
Seat 5: mudders693 (button) collected (£1.25)
Seat 6: Bënedic10 (small blind) folded before Flop





PokerStars Hand #154970209722:  Hold'em No Limit ($0.50/$1.00 USD) - 2016/06/20 12:30:40 CET [2016/06/20 6:30:40 ET]
Table 'Isonoe II' 9-max Seat #1 is the button
Seat 1: hammerwife ($118.86 in chips) 
Seat 2: matiko09 ($100.50 in chips) 
Seat 3: Kukuryzka ($100 in chips) 
Seat 6: GOOFA13 ($41.38 in chips) 
Seat 7: SkUhNi ($100 in chips) 
Seat 8: lewyson ($55.75 in chips) 
Seat 9: djammusic ($54.48 in chips) 
matiko09: posts small blind $0.50
Kukuryzka: posts big blind $1
Avtovo: sits out 
Filojoes: sits out 
*** HOLE CARDS ***
Dealt to matiko09 [Tc 2d]
GOOFA13: folds 
SkUhNi: folds 
lewyson: raises $2 to $3
djammusic: folds 
hammerwife: folds 
matiko09: folds 
Kukuryzka: raises $5 to $8
lewyson: calls $5
*** FLOP *** [Js 9s 6h]
Kukuryzka: bets $11.76
lewyson: calls $11.76
*** TURN *** [Js 9s 6h] [Qs]
Kukuryzka: checks 
lewyson: bets $35.99 and is all-in
Kukuryzka: folds 
Uncalled bet ($35.99) returned to lewyson
lewyson collected $38.02 from pot
*** SUMMARY ***
Total pot $40.02 | Rake $2 
Board [Js 9s 6h Qs]
Seat 1: hammerwife (button) folded before Flop (didn't bet)
Seat 2: matiko09 (small blind) folded before Flop
Seat 3: Kukuryzka (big blind) folded on the Turn
Seat 6: GOOFA13 folded before Flop (didn't bet)
Seat 7: SkUhNi folded before Flop (didn't bet)
Seat 8: lewyson collected ($38.02)
Seat 9: djammusic folded before Flop (didn't bet)





PokerStars Hand #154970210209:  Hold'em No Limit (£0.25/£0.50 GBP) - 2016/06/20 12:30:41 CET [2016/06/20 6:30:41 ET]
Table 'Tesla' 6-max Seat #1 is the button
Seat 1: Rubleff85 (£44.21 in chips) 
Seat 2: matiko09 (£52.32 in chips) 
Seat 3: asmodej666 (£50.75 in chips) 
matiko09: posts small blind £0.25
asmodej666: posts big blind £0.50
*** HOLE CARDS ***
Dealt to matiko09 [Kc 8s]
ILIUXa joins the table at seat #4 
Rubleff85 has timed out
Rubleff85: folds 
matiko09: raises £1 to £1.50
asmodej666: calls £1
*** FLOP *** [Qs Ts 3c]
matiko09: bets £1.85
asmodej666: folds 
Uncalled bet (£1.85) returned to matiko09
matiko09 collected £2.85 from pot
matiko09: doesn't show hand 
*** SUMMARY ***
Total pot £3 | Rake £0.15 
Board [Qs Ts 3c]
Seat 1: Rubleff85 (button) folded before Flop (didn't bet)
Seat 2: matiko09 (small blind) collected (£2.85)
Seat 3: asmodej666 (big blind) folded on the Flop





PokerStars Hand #154970211054:  Hold'em No Limit ($0.25/$0.50 USD) - 2016/06/20 12:30:43 CET [2016/06/20 6:30:43 ET]
Table 'Juliana II' 9-max Seat #2 is the button
Seat 1: sno05 ($54.85 in chips) 
Seat 2: cjzm ($49.48 in chips) 
Seat 3: Dr.Mouse102 ($50 in chips) 
Seat 4: zarplatka ($42.89 in chips) 
Seat 6: sophie2000 ($50 in chips) 
Seat 7: 23SmOkEr07 ($61.86 in chips) 
Seat 8: matiko09 ($50.50 in chips) 
Seat 9: tugboat2008 ($95.19 in chips) 
Dr.Mouse102: posts small blind $0.25
zarplatka: posts big blind $0.50
ljryviltj: sits out 
*** HOLE CARDS ***
Dealt to matiko09 [Kc Ts]
sophie2000: folds 
23SmOkEr07: folds 
matiko09: folds 
tugboat2008: folds 
sno05 has timed out
sno05: folds 
cjzm: folds 
Dr.Mouse102: raises $1 to $1.50
zarplatka: folds 
Uncalled bet ($1) returned to Dr.Mouse102
Dr.Mouse102 collected $1 from pot
*** SUMMARY ***
Total pot $1 | Rake $0 
Seat 1: sno05 folded before Flop (didn't bet)
Seat 2: cjzm (button) folded before Flop (didn't bet)
Seat 3: Dr.Mouse102 (small blind) collected ($1)
Seat 4: zarplatka (big blind) folded before Flop
Seat 6: sophie2000 folded before Flop (didn't bet)
Seat 7: 23SmOkEr07 folded before Flop (didn't bet)
Seat 8: matiko09 folded before Flop (didn't bet)
Seat 9: tugboat2008 folded before Flop (didn't bet)





PokerStars Hand #154970214878:  Hold'em No Limit ($0.50/$1.00 USD) - 2016/06/20 12:30:53 CET [2016/06/20 6:30:53 ET]
Table 'Ambrosia II' 9-max Seat #9 is the button
Seat 1: 23SmOkEr07 ($111.82 in chips) 
Seat 2: Eyeballz1307 ($76.93 in chips) 
Seat 3: mavin80 ($80.18 in chips) 
Seat 4: mi$$I$Elena ($126.12 in chips) 
Seat 5: Mattulh ($100 in chips) 
Seat 6: ruslik_by ($116.30 in chips) 
Seat 7: matiko09 ($108.50 in chips) 
Seat 8: hammerwife ($100 in chips) 
Seat 9: SkUhNi ($125.31 in chips) 
23SmOkEr07: posts small blind $0.50
Eyeballz1307: posts big blind $1
*** HOLE CARDS ***
Dealt to matiko09 [8h 4c]
mavin80: folds 
mi$$I$Elena: folds 
Mattulh: folds 
ruslik_by: folds 
matiko09: folds 
hammerwife: folds 
SkUhNi: folds 
23SmOkEr07: folds 
Uncalled bet ($0.50) returned to Eyeballz1307
Eyeballz1307 collected $1 from pot
Eyeballz1307: doesn't show hand 
*** SUMMARY ***
Total pot $1 | Rake $0 
Seat 1: 23SmOkEr07 (small blind) folded before Flop
Seat 2: Eyeballz1307 (big blind) collected ($1)
Seat 3: mavin80 folded before Flop (didn't bet)
Seat 4: mi$$I$Elena folded before Flop (didn't bet)
Seat 5: Mattulh folded before Flop (didn't bet)
Seat 6: ruslik_by folded before Flop (didn't bet)
Seat 7: matiko09 folded before Flop (didn't bet)
Seat 8: hammerwife folded before Flop (didn't bet)
Seat 9: SkUhNi (button) folded before Flop (didn't bet)





PokerStars Hand #154970216235:  Hold'em No Limit ($0.50/$1.00 USD) - 2016/06/20 12:30:56 CET [2016/06/20 6:30:56 ET]
Table 'Pongola' 9-max Seat #9 is the button
Seat 1: matiko09 ($100.50 in chips) 
Seat 2: ruslik_by ($136.27 in chips) 
Seat 3: SkUhNi ($100 in chips) 
Seat 4: karllv ($120.81 in chips) 
Seat 5: joker180785 ($107.43 in chips) 
Seat 6: 23SmOkEr07 ($117.21 in chips) 
Seat 7: Dickyxxx ($151.12 in chips) 
Seat 8: phrantique ($98.70 in chips) 
Seat 9: Filojoes ($106.22 in chips) 
matiko09: posts small blind $0.50
ruslik_by: posts big blind $1
*** HOLE CARDS ***
Dealt to matiko09 [7s 9c]
SkUhNi: folds 
karllv: folds 
joker180785: folds 
23SmOkEr07: folds 
Dickyxxx: folds 
phrantique: folds 
Filojoes: folds 
matiko09: folds 
Uncalled bet ($0.50) returned to ruslik_by
ruslik_by collected $1 from pot
ruslik_by: doesn't show hand 
*** SUMMARY ***
Total pot $1 | Rake $0 
Seat 1: matiko09 (small blind) folded before Flop
Seat 2: ruslik_by (big blind) collected ($1)
Seat 3: SkUhNi folded before Flop (didn't bet)
Seat 4: karllv folded before Flop (didn't bet)
Seat 5: joker180785 folded before Flop (didn't bet)
Seat 6: 23SmOkEr07 folded before Flop (didn't bet)
Seat 7: Dickyxxx folded before Flop (didn't bet)
Seat 8: phrantique folded before Flop (didn't bet)
Seat 9: Filojoes (button) folded before Flop (didn't bet)





PokerStars Hand #154970217460:  Hold'em No Limit (£0.25/£0.50 GBP) - 2016/06/20 12:30:59 CET [2016/06/20 6:30:59 ET]
Table 'Ani' 6-max Seat #3 is the button
Seat 1: rewq99887788 (£40.23 in chips) 
Seat 2: joker180785 (£58.04 in chips) 
Seat 3: Doobes8555 (£70.02 in chips) 
Seat 4: matiko09 (£55.22 in chips) 
Seat 5: Wwwasian (£62.27 in chips) 
Seat 6: faceMyBallz_ (£55.36 in chips) 
matiko09: posts small blind £0.25
Wwwasian: posts big blind £0.50
*** HOLE CARDS ***
Dealt to matiko09 [4d 6c]
faceMyBallz_: folds 
rewq99887788: raises £1 to £1.50
joker180785: folds 
Doobes8555: folds 
matiko09: folds 
Wwwasian: folds 
Uncalled bet (£1) returned to rewq99887788
rewq99887788 collected £1.25 from pot
*** SUMMARY ***
Total pot £1.25 | Rake £0 
Seat 1: rewq99887788 collected (£1.25)
Seat 2: joker180785 folded before Flop (didn't bet)
Seat 3: Doobes8555 (button) folded before Flop (didn't bet)
Seat 4: matiko09 (small blind) folded before Flop
Seat 5: Wwwasian (big blind) folded before Flop
Seat 6: faceMyBallz_ folded before Flop (didn't bet)





PokerStars Hand #154970218744:  Hold'em No Limit (£0.25/£0.50 GBP) - 2016/06/20 12:31:03 CET [2016/06/20 6:31:03 ET]
Table 'Azalea' 6-max Seat #6 is the button
Seat 1: mitsuVK (£103.70 in chips) 
Seat 2: matiko09 (£82.60 in chips) 
Seat 3: VahTang_89 (£50.75 in chips) 
Seat 4: faceMyBallz_ (£50 in chips) 
Seat 5: mudders693 (£73.70 in chips) 
Seat 6: Bënedic10 (£50 in chips) 
mitsuVK: posts small blind £0.25
matiko09: posts big blind £0.50
*** HOLE CARDS ***
Dealt to matiko09 [3c 5c]
VahTang_89: folds 
faceMyBallz_: folds 
mudders693: raises £1 to £1.50
Bënedic10: folds 
mitsuVK: folds 
matiko09: folds 
Uncalled bet (£1) returned to mudders693
mudders693 collected £1.25 from pot
mudders693: doesn't show hand 
*** SUMMARY ***
Total pot £1.25 | Rake £0 
Seat 1: mitsuVK (small blind) folded before Flop
Seat 2: matiko09 (big blind) folded before Flop
Seat 3: VahTang_89 folded before Flop (didn't bet)
Seat 4: faceMyBallz_ folded before Flop (didn't bet)
Seat 5: mudders693 collected (£1.25)
Seat 6: Bënedic10 (button) folded before Flop (didn't bet)





PokerStars Hand #154970221095:  Hold'em No Limit ($0.50/$1.00 USD) - 2016/06/20 12:31:09 CET [2016/06/20 6:31:09 ET]
Table 'Ernestina' 9-max Seat #3 is the button
Seat 1: diva3150 ($73.68 in chips) 
Seat 2: matiko09 ($100 in chips) 
Seat 3: Pvsx. ($168.07 in chips) 
Seat 4: SkUhNi ($102.52 in chips) 
Seat 5: Dickyxxx ($100 in chips) 
Seat 6: arctur17 ($93.80 in chips) 
Seat 7: Avtovo ($110 in chips) 
Seat 8: ruslik_by ($267.74 in chips) 
Seat 9: 23SmOkEr07 ($100 in chips) 
SkUhNi: posts small blind $0.50
Dickyxxx: posts big blind $1
*** HOLE CARDS ***
Dealt to matiko09 [7d Jd]
arctur17: folds 
Avtovo: folds 
ruslik_by: folds 
23SmOkEr07: folds 
diva3150: folds 
matiko09: folds 
Pvsx.: folds 
SkUhNi: raises $1.50 to $2.50
Dickyxxx: folds 
Uncalled bet ($1.50) returned to SkUhNi
SkUhNi collected $2 from pot
SkUhNi: doesn't show hand 
*** SUMMARY ***
Total pot $2 | Rake $0 
Seat 1: diva3150 folded before Flop (didn't bet)
Seat 2: matiko09 folded before Flop (didn't bet)
Seat 3: Pvsx. (button) folded before Flop (didn't bet)
Seat 4: SkUhNi (small blind) collected ($2)
Seat 5: Dickyxxx (big blind) folded before Flop
Seat 6: arctur17 folded before Flop (didn't bet)
Seat 7: Avtovo folded before Flop (didn't bet)
Seat 8: ruslik_by folded before Flop (didn't bet)
Seat 9: 23SmOkEr07 folded before Flop (didn't bet)





PokerStars Hand #154970223006:  Hold'em No Limit ($0.25/$0.50 USD) - 2016/06/20 12:31:14 CET [2016/06/20 6:31:14 ET]
Table 'Scheddi II' 9-max Seat #2 is the button
Seat 1: matiko09 ($50 in chips) 
Seat 2: Yaaaazz ($91.65 in chips) 
Seat 3: mi$$I$Elena ($98.85 in chips) 
Seat 4: GOOFA13 ($26.50 in chips) 
Seat 6: joker180785 ($63.48 in chips) 
Seat 7: HopeMayBee ($65.38 in chips) 
Seat 8: orochimaturi ($38.75 in chips) 
Seat 9: Infinitinium ($131.67 in chips) 
mi$$I$Elena: posts small blind $0.25
GOOFA13: posts big blind $0.50
matiko09: posts the ante $0.10
Yaaaazz: posts the ante $0.10
mi$$I$Elena: posts the ante $0.10
GOOFA13: posts the ante $0.10
joker180785: posts the ante $0.10
HopeMayBee: posts the ante $0.10
orochimaturi: posts the ante $0.10
Infinitinium: posts the ante $0.10
*** HOLE CARDS ***
Dealt to matiko09 [2s 4d]
No Money NW leaves the table
joker180785: folds 
HopeMayBee: folds 
orochimaturi: folds 
Infinitinium: folds 
matiko09: folds 
Yaaaazz: folds 
mi$$I$Elena: folds 
Uncalled bet ($0.25) returned to GOOFA13
GOOFA13 collected $1.30 from pot
GOOFA13: doesn't show hand 
*** SUMMARY ***
Total pot $1.30 | Rake $0 
Seat 1: matiko09 folded before Flop (didn't bet)
Seat 2: Yaaaazz (button) folded before Flop (didn't bet)
Seat 3: mi$$I$Elena (small blind) folded before Flop
Seat 4: GOOFA13 (big blind) collected ($1.30)
Seat 6: joker180785 folded before Flop (didn't bet)
Seat 7: HopeMayBee folded before Flop (didn't bet)
Seat 8: orochimaturi folded before Flop (didn't bet)
Seat 9: Infinitinium folded before Flop (didn't bet)





PokerStars Hand #154970224511:  Hold'em No Limit ($0.50/$1.00 USD) - 2016/06/20 12:31:18 CET [2016/06/20 6:31:18 ET]
Table 'Pongola' 9-max Seat #1 is the button
Seat 1: matiko09 ($100 in chips) 
Seat 2: ruslik_by ($136.77 in chips) 
Seat 3: SkUhNi ($100 in chips) 
Seat 4: karllv ($120.81 in chips) 
Seat 5: joker180785 ($107.43 in chips) 
Seat 6: 23SmOkEr07 ($117.21 in chips) 
Seat 7: Dickyxxx ($151.12 in chips) 
Seat 8: phrantique ($98.70 in chips) 
Seat 9: Filojoes ($106.22 in chips) 
ruslik_by: posts small blind $0.50
SkUhNi: posts big blind $1
*** HOLE CARDS ***
Dealt to matiko09 [6s 3h]
karllv: folds 
joker180785: folds 
23SmOkEr07: folds 
Dickyxxx: folds 
phrantique: raises $2 to $3
Filojoes: folds 
matiko09: folds 
ruslik_by: folds 
SkUhNi: folds 
Uncalled bet ($2) returned to phrantique
phrantique collected $2.50 from pot
*** SUMMARY ***
Total pot $2.50 | Rake $0 
Seat 1: matiko09 (button) folded before Flop (didn't bet)
Seat 2: ruslik_by (small blind) folded before Flop
Seat 3: SkUhNi (big blind) folded before Flop
Seat 4: karllv folded before Flop (didn't bet)
Seat 5: joker180785 folded before Flop (didn't bet)
Seat 6: 23SmOkEr07 folded before Flop (didn't bet)
Seat 7: Dickyxxx folded before Flop (didn't bet)
Seat 8: phrantique collected ($2.50)
Seat 9: Filojoes folded before Flop (didn't bet)





PokerStars Hand #154970226007:  Hold'em No Limit ($0.50/$1.00 USD) - 2016/06/20 12:31:22 CET [2016/06/20 6:31:22 ET]
Table 'Ambrosia II' 9-max Seat #1 is the button
Seat 1: 23SmOkEr07 ($111.32 in chips) 
Seat 2: Eyeballz1307 ($77.43 in chips) 
Seat 3: mavin80 ($80.18 in chips) 
Seat 4: mi$$I$Elena ($126.12 in chips) 
Seat 5: Mattulh ($100 in chips) 
Seat 6: ruslik_by ($116.30 in chips) 
Seat 7: matiko09 ($108.50 in chips) 
Seat 8: hammerwife ($100 in chips) 
Seat 9: SkUhNi ($125.31 in chips) 
Eyeballz1307: posts small blind $0.50
mavin80: posts big blind $1
*** HOLE CARDS ***
Dealt to matiko09 [Js As]
mi$$I$Elena: folds 
Mattulh: folds 
ruslik_by: folds 
matiko09: raises $2 to $3
hammerwife: folds 
SkUhNi: folds 
23SmOkEr07: folds 
Eyeballz1307: calls $2.50
mavin80: folds 
*** FLOP *** [Ah 6c Qh]
Eyeballz1307: checks 
matiko09: bets $4.32
Eyeballz1307: calls $4.32
*** TURN *** [Ah 6c Qh] [Qs]
Eyeballz1307: checks 
matiko09: checks 
*** RIVER *** [Ah 6c Qh Qs] [Kd]
Eyeballz1307: bets $7
matiko09: calls $7
*** SHOW DOWN ***
Eyeballz1307: shows [8h Ac] (two pair, Aces and Queens)
matiko09: shows [Js As] (two pair, Aces and Queens)
Eyeballz1307 collected $14.08 from pot
matiko09 collected $14.08 from pot
*** SUMMARY ***
Total pot $29.64 | Rake $1.48 
Board [Ah 6c Qh Qs Kd]
Seat 1: 23SmOkEr07 (button) folded before Flop (didn't bet)
Seat 2: Eyeballz1307 (small blind) showed [8h Ac] and won ($14.08) with two pair, Aces and Queens
Seat 3: mavin80 (big blind) folded before Flop
Seat 4: mi$$I$Elena folded before Flop (didn't bet)
Seat 5: Mattulh folded before Flop (didn't bet)
Seat 6: ruslik_by folded before Flop (didn't bet)
Seat 7: matiko09 showed [Js As] and won ($14.08) with two pair, Aces and Queens
Seat 8: hammerwife folded before Flop (didn't bet)
Seat 9: SkUhNi folded before Flop (didn't bet)





PokerStars Hand #154970226008:  Hold'em No Limit (£0.25/£0.50 GBP) - 2016/06/20 12:31:22 CET [2016/06/20 6:31:22 ET]
Table 'Ani' 6-max Seat #4 is the button
Seat 1: rewq99887788 (£40.98 in chips) 
Seat 2: joker180785 (£58.04 in chips) 
Seat 3: Doobes8555 (£70.02 in chips) 
Seat 4: matiko09 (£54.97 in chips) 
Seat 5: Wwwasian (£61.77 in chips) 
Seat 6: faceMyBallz_ (£55.36 in chips) 
Wwwasian: posts small blind £0.25
faceMyBallz_: posts big blind £0.50
*** HOLE CARDS ***
Dealt to matiko09 [8h 5d]
rewq99887788: calls £0.50
joker180785: folds 
Doobes8555: calls £0.50
matiko09: folds 
Wwwasian: folds 
faceMyBallz_: checks 
*** FLOP *** [7s 2s 3c]
faceMyBallz_: checks 
rewq99887788: bets £1
Doobes8555: calls £1
faceMyBallz_: folds 
*** TURN *** [7s 2s 3c] [Td]
rewq99887788: bets £2.50
Doobes8555: calls £2.50
*** RIVER *** [7s 2s 3c Td] [Jc]
rewq99887788: bets £3.50
Doobes8555: calls £3.50
*** SHOW DOWN ***
rewq99887788: shows [Ad 7d] (a pair of Sevens)
Doobes8555: shows [Js 5s] (a pair of Jacks)
Doobes8555 collected £14.96 from pot
*** SUMMARY ***
Total pot £15.75 | Rake £0.79 
Board [7s 2s 3c Td Jc]
Seat 1: rewq99887788 showed [Ad 7d] and lost with a pair of Sevens
Seat 2: joker180785 folded before Flop (didn't bet)
Seat 3: Doobes8555 showed [Js 5s] and won (£14.96) with a pair of Jacks
Seat 4: matiko09 (button) folded before Flop (didn't bet)
Seat 5: Wwwasian (small blind) folded before Flop
Seat 6: faceMyBallz_ (big blind) folded on the Flop





PokerStars Hand #154970226879:  Hold'em No Limit (£0.25/£0.50 GBP) - 2016/06/20 12:31:24 CET [2016/06/20 6:31:24 ET]
Table 'Tesla' 6-max Seat #2 is the button
Seat 1: Rubleff85 (£44.21 in chips) 
Seat 2: matiko09 (£53.67 in chips) 
Seat 3: asmodej666 (£50 in chips) 
Seat 4: ILIUXa (£50 in chips) 
asmodej666: posts small blind £0.25
ILIUXa: posts big blind £0.50
*** HOLE CARDS ***
Dealt to matiko09 [Jh Kh]
Rubleff85: raises £1.25 to £1.75
matiko09: raises £2.75 to £4.50
asmodej666: folds 
ILIUXa: folds 
Rubleff85: calls £2.75
*** FLOP *** [Tc Th 2d]
Rubleff85: checks 
matiko09: bets £3.50
Rubleff85: calls £3.50
*** TURN *** [Tc Th 2d] [6s]
Rubleff85: checks 
faceMyBallz_ joins the table at seat #6 
matiko09: checks 
*** RIVER *** [Tc Th 2d 6s] [7s]
Rubleff85: bets £10.75
matiko09: folds 
Uncalled bet (£10.75) returned to Rubleff85
Rubleff85 collected £16.25 from pot
Rubleff85: doesn't show hand 
*** SUMMARY ***
Total pot £16.75 | Rake £0.50 
Board [Tc Th 2d 6s 7s]
Seat 1: Rubleff85 collected (£16.25)
Seat 2: matiko09 (button) folded on the River
Seat 3: asmodej666 (small blind) folded before Flop
Seat 4: ILIUXa (big blind) folded before Flop





PokerStars Hand #154970228865:  Hold'em No Limit (£0.25/£0.50 GBP) - 2016/06/20 12:31:29 CET [2016/06/20 6:31:29 ET]
Table 'Azalea' 6-max Seat #1 is the button
Seat 1: mitsuVK (£103.45 in chips) 
Seat 2: matiko09 (£82.10 in chips) 
Seat 3: VahTang_89 (£50.75 in chips) 
Seat 4: faceMyBallz_ (£50 in chips) 
Seat 5: mudders693 (£74.45 in chips) 
Seat 6: Bënedic10 (£50 in chips) 
matiko09: posts small blind £0.25
VahTang_89: posts big blind £0.50
*** HOLE CARDS ***
Dealt to matiko09 [3s Qd]
faceMyBallz_: folds 
mudders693: folds 
Bënedic10: folds 
mitsuVK: raises £0.50 to £1
matiko09: folds 
VahTang_89: folds 
Uncalled bet (£0.50) returned to mitsuVK
mitsuVK collected £1.25 from pot
mitsuVK: doesn't show hand 
*** SUMMARY ***
Total pot £1.25 | Rake £0 
Seat 1: mitsuVK (button) collected (£1.25)
Seat 2: matiko09 (small blind) folded before Flop
Seat 3: VahTang_89 (big blind) folded before Flop
Seat 4: faceMyBallz_ folded before Flop (didn't bet)
Seat 5: mudders693 folded before Flop (didn't bet)
Seat 6: Bënedic10 folded before Flop (didn't bet)





PokerStars Hand #154970228801:  Hold'em No Limit ($0.25/$0.50 USD) - 2016/06/20 12:31:29 CET [2016/06/20 6:31:29 ET]
Table 'Juliana II' 9-max Seat #3 is the button
Seat 1: sno05 ($54.85 in chips) 
Seat 2: cjzm ($49.48 in chips) 
Seat 3: Dr.Mouse102 ($50.50 in chips) 
Seat 4: zarplatka ($42.39 in chips) 
Seat 5: ljryviltj ($72.80 in chips) 
Seat 6: sophie2000 ($50 in chips) 
Seat 7: 23SmOkEr07 ($61.86 in chips) 
Seat 8: matiko09 ($50.50 in chips) 
Seat 9: tugboat2008 ($95.19 in chips) 
zarplatka: posts small blind $0.25
ljryviltj: posts big blind $0.50
*** HOLE CARDS ***
Dealt to matiko09 [Qh 8d]
sophie2000: raises $1 to $1.50
23SmOkEr07: folds 
matiko09: folds 
tugboat2008: folds 
sno05: folds 
cjzm: folds 
Dr.Mouse102 is disconnected 
Dr.Mouse102 is connected 
Dr.Mouse102: raises $3 to $4.50
zarplatka: folds 
ljryviltj: folds 
sophie2000: calls $3
*** FLOP *** [9h 9c 8c]
sophie2000: checks 
Dr.Mouse102: bets $5
sophie2000: folds 
Uncalled bet ($5) returned to Dr.Mouse102
Dr.Mouse102 collected $9.26 from pot
*** SUMMARY ***
Total pot $9.75 | Rake $0.49 
Board [9h 9c 8c]
Seat 1: sno05 folded before Flop (didn't bet)
Seat 2: cjzm folded before Flop (didn't bet)
Seat 3: Dr.Mouse102 (button) collected ($9.26)
Seat 4: zarplatka (small blind) folded before Flop
Seat 5: ljryviltj (big blind) folded before Flop
Seat 6: sophie2000 folded on the Flop
Seat 7: 23SmOkEr07 folded before Flop (didn't bet)
Seat 8: matiko09 folded before Flop (didn't bet)
Seat 9: tugboat2008 folded before Flop (didn't bet)





PokerStars Hand #154970231230:  Hold'em No Limit ($0.50/$1.00 USD) - 2016/06/20 12:31:35 CET [2016/06/20 6:31:35 ET]
Table 'Ernestina' 9-max Seat #4 is the button
Seat 1: diva3150 ($73.68 in chips) 
Seat 2: matiko09 ($100 in chips) 
Seat 3: Pvsx. ($168.07 in chips) 
Seat 4: SkUhNi ($103.52 in chips) 
Seat 5: Dickyxxx ($100 in chips) 
Seat 6: arctur17 ($93.80 in chips) 
Seat 7: Avtovo ($110 in chips) 
Seat 8: ruslik_by ($267.74 in chips) 
Seat 9: 23SmOkEr07 ($100 in chips) 
Dickyxxx: posts small blind $0.50
arctur17: posts big blind $1
*** HOLE CARDS ***
Dealt to matiko09 [Js 6d]
Avtovo: folds 
ruslik_by: folds 
23SmOkEr07: folds 
diva3150: calls $1
matiko09: folds 
Pvsx.: raises $3.50 to $4.50
SkUhNi: folds 
Dickyxxx: folds 
arctur17: folds 
diva3150: folds 
Uncalled bet ($3.50) returned to Pvsx.
Pvsx. collected $3.50 from pot
Pvsx.: doesn't show hand 
*** SUMMARY ***
Total pot $3.50 | Rake $0 
Seat 1: diva3150 folded before Flop
Seat 2: matiko09 folded before Flop (didn't bet)
Seat 3: Pvsx. collected ($3.50)
Seat 4: SkUhNi (button) folded before Flop (didn't bet)
Seat 5: Dickyxxx (small blind) folded before Flop
Seat 6: arctur17 (big blind) folded before Flop
Seat 7: Avtovo folded before Flop (didn't bet)
Seat 8: ruslik_by folded before Flop (didn't bet)
Seat 9: 23SmOkEr07 folded before Flop (didn't bet)





PokerStars Hand #154970231115:  Hold'em No Limit ($0.50/$1.00 USD) - 2016/06/20 12:31:35 CET [2016/06/20 6:31:35 ET]
Table 'Anhui' 9-max Seat #5 is the button
Seat 1: SkUhNi ($150.42 in chips) 
Seat 2: ruslik_by ($275.68 in chips) 
Seat 4: mavin80 ($29.38 in chips) 
Seat 5: mi$$I$Elena ($113.30 in chips) 
Seat 6: 23SmOkEr07 ($132.25 in chips) 
Seat 7: matiko09 ($144.65 in chips) 
Seat 8: blackmont111 ($77.50 in chips) 
Seat 9: TomBod1 ($81.30 in chips) 
23SmOkEr07: posts small blind $0.50
matiko09: posts big blind $1
hammerwife: sits out 
*** HOLE CARDS ***
Dealt to matiko09 [Jc Qs]
blackmont111: folds 
TomBod1: folds 
SkUhNi: folds 
ruslik_by: folds 
mavin80: raises $1.50 to $2.50
mi$$I$Elena: folds 
23SmOkEr07: folds 
matiko09: folds 
Uncalled bet ($1.50) returned to mavin80
mavin80 collected $2.50 from pot
*** SUMMARY ***
Total pot $2.50 | Rake $0 
Seat 1: SkUhNi folded before Flop (didn't bet)
Seat 2: ruslik_by folded before Flop (didn't bet)
Seat 4: mavin80 collected ($2.50)
Seat 5: mi$$I$Elena (button) folded before Flop (didn't bet)
Seat 6: 23SmOkEr07 (small blind) folded before Flop
Seat 7: matiko09 (big blind) folded before Flop
Seat 8: blackmont111 folded before Flop (didn't bet)
Seat 9: TomBod1 folded before Flop (didn't bet)





PokerStars Hand #154970233976:  Hold'em No Limit (£0.25/£0.50 GBP) - 2016/06/20 12:31:42 CET [2016/06/20 6:31:42 ET]
Table 'Azalea' 6-max Seat #2 is the button
Seat 1: mitsuVK (£104.20 in chips) 
Seat 2: matiko09 (£81.85 in chips) 
Seat 3: VahTang_89 (£50.25 in chips) 
Seat 4: faceMyBallz_ (£50 in chips) 
Seat 5: mudders693 (£74.45 in chips) 
Seat 6: Bënedic10 (£50 in chips) 
VahTang_89: posts small blind £0.25
faceMyBallz_: posts big blind £0.50
*** HOLE CARDS ***
Dealt to matiko09 [Ks 5s]
mudders693: folds 
Bënedic10: folds 
mitsuVK: raises £0.75 to £1.25
matiko09: folds 
VahTang_89: folds 
faceMyBallz_: folds 
Uncalled bet (£0.75) returned to mitsuVK
mitsuVK collected £1.25 from pot
mitsuVK: doesn't show hand 
*** SUMMARY ***
Total pot £1.25 | Rake £0 
Seat 1: mitsuVK collected (£1.25)
Seat 2: matiko09 (button) folded before Flop (didn't bet)
Seat 3: VahTang_89 (small blind) folded before Flop
Seat 4: faceMyBallz_ (big blind) folded before Flop
Seat 5: mudders693 folded before Flop (didn't bet)
Seat 6: Bënedic10 folded before Flop (didn't bet)





PokerStars Hand #154970239751:  Hold'em No Limit ($0.25/$0.50 USD) - 2016/06/20 12:31:57 CET [2016/06/20 6:31:57 ET]
Table 'Scheddi II' 9-max Seat #3 is the button
Seat 1: matiko09 ($50 in chips) 
Seat 2: Yaaaazz ($91.55 in chips) 
Seat 3: mi$$I$Elena ($98.50 in chips) 
Seat 4: GOOFA13 ($27.45 in chips) 
Seat 6: joker180785 ($63.38 in chips) 
Seat 7: HopeMayBee ($65.28 in chips) 
Seat 8: orochimaturi ($38.65 in chips) 
Seat 9: Infinitinium ($131.57 in chips) 
GOOFA13: posts small blind $0.25
joker180785: posts big blind $0.50
matiko09: posts the ante $0.10
Yaaaazz: posts the ante $0.10
mi$$I$Elena: posts the ante $0.10
GOOFA13: posts the ante $0.10
joker180785: posts the ante $0.10
HopeMayBee: posts the ante $0.10
orochimaturi: posts the ante $0.10
Infinitinium: posts the ante $0.10
*** HOLE CARDS ***
Dealt to matiko09 [Jc Jh]
HopeMayBee: folds 
orochimaturi: raises $0.50 to $1
Infinitinium: calls $1
matiko09: raises $4 to $5
Yaaaazz: folds 
mi$$I$Elena: folds 
GOOFA13: folds 
joker180785: folds 
orochimaturi: folds 
Infinitinium: calls $4
*** FLOP *** [2s 3d Ks]
Infinitinium: checks 
matiko09: checks 
*** TURN *** [2s 3d Ks] [8c]
Infinitinium: bets $8.50
matiko09: calls $8.50
*** RIVER *** [2s 3d Ks 8c] [Ts]
Infinitinium: bets $28.07
matiko09: folds 
Uncalled bet ($28.07) returned to Infinitinium
Infinitinium collected $28.07 from pot
Infinitinium: doesn't show hand 
*** SUMMARY ***
Total pot $29.55 | Rake $1.48 
Board [2s 3d Ks 8c Ts]
Seat 1: matiko09 folded on the River
Seat 2: Yaaaazz folded before Flop (didn't bet)
Seat 3: mi$$I$Elena (button) folded before Flop (didn't bet)
Seat 4: GOOFA13 (small blind) folded before Flop
Seat 6: joker180785 (big blind) folded before Flop
Seat 7: HopeMayBee folded before Flop (didn't bet)
Seat 8: orochimaturi folded before Flop
Seat 9: Infinitinium collected ($28.07)





PokerStars Hand #154970240391:  Hold'em No Limit ($0.50/$1.00 USD) - 2016/06/20 12:31:59 CET [2016/06/20 6:31:59 ET]
Table 'Pongola' 9-max Seat #2 is the button
Seat 1: matiko09 ($100 in chips) 
Seat 2: ruslik_by ($136.27 in chips) 
Seat 3: SkUhNi ($100 in chips) 
Seat 4: karllv ($120.81 in chips) 
Seat 5: joker180785 ($107.43 in chips) 
Seat 6: 23SmOkEr07 ($117.21 in chips) 
Seat 7: Dickyxxx ($151.12 in chips) 
Seat 8: phrantique ($100.20 in chips) 
Seat 9: Filojoes ($106.22 in chips) 
SkUhNi: posts small blind $0.50
karllv: posts big blind $1
*** HOLE CARDS ***
Dealt to matiko09 [6d Ks]
joker180785: folds 
23SmOkEr07: folds 
Dickyxxx: folds 
phrantique: folds 
Filojoes: folds 
matiko09: folds 
ruslik_by: folds 
SkUhNi: folds 
Uncalled bet ($0.50) returned to karllv
karllv collected $1 from pot
*** SUMMARY ***
Total pot $1 | Rake $0 
Seat 1: matiko09 folded before Flop (didn't bet)
Seat 2: ruslik_by (button) folded before Flop (didn't bet)
Seat 3: SkUhNi (small blind) folded before Flop
Seat 4: karllv (big blind) collected ($1)
Seat 5: joker180785 folded before Flop (didn't bet)
Seat 6: 23SmOkEr07 folded before Flop (didn't bet)
Seat 7: Dickyxxx folded before Flop (didn't bet)
Seat 8: phrantique folded before Flop (didn't bet)
Seat 9: Filojoes folded before Flop (didn't bet)





PokerStars Hand #154970242686:  Hold'em No Limit ($0.50/$1.00 USD) - 2016/06/20 12:32:05 CET [2016/06/20 6:32:05 ET]
Table 'Ernestina' 9-max Seat #5 is the button
Seat 1: diva3150 ($72.68 in chips) 
Seat 2: matiko09 ($100 in chips) 
Seat 3: Pvsx. ($170.57 in chips) 
Seat 4: SkUhNi ($103.52 in chips) 
Seat 5: Dickyxxx ($100 in chips) 
Seat 6: arctur17 ($92.80 in chips) 
Seat 8: ruslik_by ($267.74 in chips) 
Seat 9: 23SmOkEr07 ($100 in chips) 
arctur17: posts small blind $0.50
Avtovo: is sitting out 
ruslik_by: posts big blind $1
*** HOLE CARDS ***
Dealt to matiko09 [2s Ad]
23SmOkEr07: folds 
diva3150: calls $1
Avtovo leaves the table
matiko09: folds 
mi$$I$Elena joins the table at seat #7 
Pvsx.: folds 
SkUhNi: folds 
Dickyxxx: folds 
arctur17: folds 
mi$$I$Elena leaves the table
djammusic joins the table at seat #7 
ruslik_by: checks 
*** FLOP *** [Ac 6d 3c]
ruslik_by: checks 
diva3150: bets $1
ruslik_by: folds 
Uncalled bet ($1) returned to diva3150
diva3150 collected $2.38 from pot
diva3150: doesn't show hand 
*** SUMMARY ***
Total pot $2.50 | Rake $0.12 
Board [Ac 6d 3c]
Seat 1: diva3150 collected ($2.38)
Seat 2: matiko09 folded before Flop (didn't bet)
Seat 3: Pvsx. folded before Flop (didn't bet)
Seat 4: SkUhNi folded before Flop (didn't bet)
Seat 5: Dickyxxx (button) folded before Flop (didn't bet)
Seat 6: arctur17 (small blind) folded before Flop
Seat 8: ruslik_by (big blind) folded on the Flop
Seat 9: 23SmOkEr07 folded before Flop (didn't bet)





PokerStars Hand #154970243650:  Hold'em No Limit (£0.25/£0.50 GBP) - 2016/06/20 12:32:07 CET [2016/06/20 6:32:07 ET]
Table 'Azalea' 6-max Seat #3 is the button
Seat 1: mitsuVK (£104.95 in chips) 
Seat 2: matiko09 (£81.85 in chips) 
Seat 3: VahTang_89 (£50 in chips) 
Seat 4: faceMyBallz_ (£50 in chips) 
Seat 5: mudders693 (£74.45 in chips) 
Seat 6: Bënedic10 (£50 in chips) 
faceMyBallz_: posts small blind £0.25
mudders693: posts big blind £0.50
*** HOLE CARDS ***
Dealt to matiko09 [6d 4s]
Bënedic10: raises £1 to £1.50
mitsuVK: folds 
matiko09: folds 
VahTang_89: folds 
faceMyBallz_: folds 
mudders693: raises £6.50 to £8
Bënedic10: folds 
Uncalled bet (£6.50) returned to mudders693
mudders693 collected £3.25 from pot
mudders693: doesn't show hand 
*** SUMMARY ***
Total pot £3.25 | Rake £0 
Seat 1: mitsuVK folded before Flop (didn't bet)
Seat 2: matiko09 folded before Flop (didn't bet)
Seat 3: VahTang_89 (button) folded before Flop (didn't bet)
Seat 4: faceMyBallz_ (small blind) folded before Flop
Seat 5: mudders693 (big blind) collected (£3.25)
Seat 6: Bënedic10 folded before Flop





PokerStars Hand #154970245279:  Hold'em No Limit ($0.50/$1.00 USD) - 2016/06/20 12:32:12 CET [2016/06/20 6:32:12 ET]
Table 'Isonoe II' 9-max Seat #2 is the button
Seat 1: hammerwife ($118.86 in chips) 
Seat 2: matiko09 ($100 in chips) 
Seat 3: Kukuryzka ($100 in chips) 
Seat 4: Avtovo ($100 in chips) 
Seat 6: GOOFA13 ($41.38 in chips) 
Seat 7: SkUhNi ($100 in chips) 
Seat 8: lewyson ($74.01 in chips) 
Seat 9: djammusic ($54.48 in chips) 
Kukuryzka: posts small blind $0.50
Avtovo: posts big blind $1
Filojoes: sits out 
*** HOLE CARDS ***
Dealt to matiko09 [Ah Kc]
GOOFA13: folds 
SkUhNi: folds 
lewyson: folds 
djammusic: folds 
hammerwife: raises $1.50 to $2.50
matiko09: raises $6.50 to $9
Kukuryzka: folds 
Avtovo: folds 
hammerwife: calls $6.50
*** FLOP *** [Ac Jd Qd]
hammerwife: checks 
matiko09: checks 
*** TURN *** [Ac Jd Qd] [Qs]
hammerwife: checks 
matiko09: checks 
*** RIVER *** [Ac Jd Qd Qs] [7s]
hammerwife: checks 
matiko09: checks 
*** SHOW DOWN ***
hammerwife: shows [9d 9s] (two pair, Queens and Nines)
matiko09: shows [Ah Kc] (two pair, Aces and Queens)
matiko09 collected $18.52 from pot
*** SUMMARY ***
Total pot $19.50 | Rake $0.98 
Board [Ac Jd Qd Qs 7s]
Seat 1: hammerwife showed [9d 9s] and lost with two pair, Queens and Nines
Seat 2: matiko09 (button) showed [Ah Kc] and won ($18.52) with two pair, Aces and Queens
Seat 3: Kukuryzka (small blind) folded before Flop
Seat 4: Avtovo (big blind) folded before Flop
Seat 6: GOOFA13 folded before Flop (didn't bet)
Seat 7: SkUhNi folded before Flop (didn't bet)
Seat 8: lewyson folded before Flop (didn't bet)
Seat 9: djammusic folded before Flop (didn't bet)





PokerStars Hand #154970248711:  Hold'em No Limit (£0.25/£0.50 GBP) - 2016/06/20 12:32:20 CET [2016/06/20 6:32:20 ET]
Table 'Ani' 6-max Seat #5 is the button
Seat 1: rewq99887788 (£33.48 in chips) 
Seat 2: joker180785 (£58.04 in chips) 
Seat 3: Doobes8555 (£77.48 in chips) 
Seat 4: matiko09 (£54.97 in chips) 
Seat 5: Wwwasian (£61.52 in chips) 
Seat 6: faceMyBallz_ (£54.86 in chips) 
faceMyBallz_: posts small blind £0.25
rewq99887788: posts big blind £0.50
*** HOLE CARDS ***
Dealt to matiko09 [Ks Ad]
joker180785: folds 
Doobes8555: folds 
matiko09: raises £1 to £1.50
Wwwasian: calls £1.50
faceMyBallz_: folds 
rewq99887788: raises £3 to £4.50
matiko09: raises £5.50 to £10
Wwwasian: folds 
rewq99887788: calls £5.50
*** FLOP *** [9h 3c 9c]
rewq99887788: checks 
matiko09: bets £7.50
rewq99887788: calls £7.50
*** TURN *** [9h 3c 9c] [5c]
rewq99887788: bets £15.98 and is all-in
matiko09: calls £15.98
*** RIVER *** [9h 3c 9c 5c] [8h]
*** SHOW DOWN ***
rewq99887788: shows [As Kh] (a pair of Nines)
matiko09: shows [Ks Ad] (a pair of Nines)
rewq99887788 collected £33.66 from pot
matiko09 collected £33.65 from pot
*** SUMMARY ***
Total pot £68.71 | Rake £1.40 
Board [9h 3c 9c 5c 8h]
Seat 1: rewq99887788 (big blind) showed [As Kh] and won (£33.66) with a pair of Nines
Seat 2: joker180785 folded before Flop (didn't bet)
Seat 3: Doobes8555 folded before Flop (didn't bet)
Seat 4: matiko09 showed [Ks Ad] and won (£33.65) with a pair of Nines
Seat 5: Wwwasian (button) folded before Flop
Seat 6: faceMyBallz_ (small blind) folded before Flop





PokerStars Hand #154970250146:  Hold'em No Limit ($0.50/$1.00 USD) - 2016/06/20 12:32:24 CET [2016/06/20 6:32:24 ET]
Table 'Ambrosia II' 9-max Seat #2 is the button
Seat 1: 23SmOkEr07 ($111.32 in chips) 
Seat 2: Eyeballz1307 ($77.19 in chips) 
Seat 3: mavin80 ($79.18 in chips) 
Seat 4: mi$$I$Elena ($126.12 in chips) 
Seat 5: Mattulh ($100 in chips) 
Seat 6: ruslik_by ($116.30 in chips) 
Seat 7: matiko09 ($108.26 in chips) 
Seat 8: hammerwife ($100 in chips) 
Seat 9: SkUhNi ($125.31 in chips) 
mavin80: posts small blind $0.50
mi$$I$Elena: posts big blind $1
*** HOLE CARDS ***
Dealt to matiko09 [7d 2c]
Mattulh: folds 
ruslik_by: folds 
matiko09: folds 
hammerwife: folds 
SkUhNi: folds 
23SmOkEr07: folds 
Eyeballz1307: raises $2 to $3
mavin80: calls $2.50
mi$$I$Elena: calls $2
*** FLOP *** [2s Qs Js]
mavin80: checks 
mi$$I$Elena: checks 
Eyeballz1307: bets $8
mavin80: calls $8
mi$$I$Elena: calls $8
*** TURN *** [2s Qs Js] [4h]
mavin80: bets $19
mi$$I$Elena: calls $19
Eyeballz1307: folds 
*** RIVER *** [2s Qs Js 4h] [2h]
mavin80: bets $29
mi$$I$Elena: raises $29 to $58
mavin80: calls $20.18 and is all-in
Uncalled bet ($8.82) returned to mi$$I$Elena
*** SHOW DOWN ***
mi$$I$Elena: shows [Qd 2d] (a full house, Deuces full of Queens)
mavin80: shows [6s 3s] (a flush, Queen high)
mi$$I$Elena collected $166.86 from pot
*** SUMMARY ***
Total pot $169.36 | Rake $2.50 
Board [2s Qs Js 4h 2h]
Seat 1: 23SmOkEr07 folded before Flop (didn't bet)
Seat 2: Eyeballz1307 (button) folded on the Turn
Seat 3: mavin80 (small blind) showed [6s 3s] and lost with a flush, Queen high
Seat 4: mi$$I$Elena (big blind) showed [Qd 2d] and won ($166.86) with a full house, Deuces full of Queens
Seat 5: Mattulh folded before Flop (didn't bet)
Seat 6: ruslik_by folded before Flop (didn't bet)
Seat 7: matiko09 folded before Flop (didn't bet)
Seat 8: hammerwife folded before Flop (didn't bet)
Seat 9: SkUhNi folded before Flop (didn't bet)





PokerStars Hand #154970254240:  Hold'em No Limit ($0.25/$0.50 USD) - 2016/06/20 12:32:35 CET [2016/06/20 6:32:35 ET]
Table 'Juliana II' 9-max Seat #4 is the button
Seat 1: sno05 ($54.85 in chips) 
Seat 2: cjzm ($49.48 in chips) 
Seat 3: Dr.Mouse102 ($55.26 in chips) 
Seat 4: zarplatka ($42.14 in chips) 
Seat 5: ljryviltj ($72.30 in chips) 
Seat 6: sophie2000 ($50 in chips) 
Seat 7: 23SmOkEr07 ($61.86 in chips) 
Seat 8: matiko09 ($50.50 in chips) 
Seat 9: tugboat2008 ($95.19 in chips) 
ljryviltj: posts small blind $0.25
sophie2000: posts big blind $0.50
*** HOLE CARDS ***
Dealt to matiko09 [8c 8d]
23SmOkEr07: folds 
matiko09: raises $1 to $1.50
tugboat2008: calls $1.50
sno05: calls $1.50
cjzm: folds 
Dr.Mouse102: folds 
zarplatka: folds 
ljryviltj: folds 
sophie2000: folds 
*** FLOP *** [Js Jh Qs]
Dr.Mouse102 is disconnected 
matiko09: checks 
tugboat2008: checks 
sno05: bets $2.22
matiko09: folds 
tugboat2008: folds 
Uncalled bet ($2.22) returned to sno05
sno05 collected $4.99 from pot
sno05: doesn't show hand 
*** SUMMARY ***
Total pot $5.25 | Rake $0.26 
Board [Js Jh Qs]
Seat 1: sno05 collected ($4.99)
Seat 2: cjzm folded before Flop (didn't bet)
Seat 3: Dr.Mouse102 folded before Flop (didn't bet)
Seat 4: zarplatka (button) folded before Flop (didn't bet)
Seat 5: ljryviltj (small blind) folded before Flop
Seat 6: sophie2000 (big blind) folded before Flop
Seat 7: 23SmOkEr07 folded before Flop (didn't bet)
Seat 8: matiko09 folded on the Flop
Seat 9: tugboat2008 folded on the Flop





PokerStars Hand #154970257269:  Hold'em No Limit (£0.25/£0.50 GBP) - 2016/06/20 12:32:43 CET [2016/06/20 6:32:43 ET]
Table 'Azalea' 6-max Seat #4 is the button
Seat 1: mitsuVK (£104.95 in chips) 
Seat 2: matiko09 (£81.85 in chips) 
Seat 3: VahTang_89 (£50 in chips) 
Seat 4: faceMyBallz_ (£50 in chips) 
Seat 5: mudders693 (£76.20 in chips) 
Seat 6: Bënedic10 (£50 in chips) 
mudders693: posts small blind £0.25
Bënedic10: posts big blind £0.50
*** HOLE CARDS ***
Dealt to matiko09 [8s 2h]
mitsuVK: folds 
matiko09: folds 
VahTang_89: folds 
faceMyBallz_: folds 
mudders693: raises £1 to £1.50
Bënedic10: folds 
Uncalled bet (£1) returned to mudders693
mudders693 collected £1 from pot
mudders693: doesn't show hand 
*** SUMMARY ***
Total pot £1 | Rake £0 
Seat 1: mitsuVK folded before Flop (didn't bet)
Seat 2: matiko09 folded before Flop (didn't bet)
Seat 3: VahTang_89 folded before Flop (didn't bet)
Seat 4: faceMyBallz_ (button) folded before Flop (didn't bet)
Seat 5: mudders693 (small blind) collected (£1)
Seat 6: Bënedic10 (big blind) folded before Flop





PokerStars Hand #154970257419:  Hold'em No Limit ($0.50/$1.00 USD) - 2016/06/20 12:32:43 CET [2016/06/20 6:32:43 ET]
Table 'Anhui' 9-max Seat #6 is the button
Seat 1: SkUhNi ($150.42 in chips) 
Seat 2: ruslik_by ($275.68 in chips) 
Seat 4: mavin80 ($30.88 in chips) 
Seat 5: mi$$I$Elena ($113.30 in chips) 
Seat 6: 23SmOkEr07 ($131.75 in chips) 
Seat 7: matiko09 ($143.65 in chips) 
Seat 8: blackmont111 ($77.50 in chips) 
Seat 9: TomBod1 ($81.30 in chips) 
matiko09: posts small blind $0.50
blackmont111: posts big blind $1
hammerwife: sits out 
*** HOLE CARDS ***
Dealt to matiko09 [2c Kd]
TomBod1: folds 
SkUhNi: folds 
ruslik_by: folds 
mavin80: folds 
mi$$I$Elena: raises $1.38 to $2.38
23SmOkEr07: folds 
matiko09: folds 
blackmont111: folds 
Uncalled bet ($1.38) returned to mi$$I$Elena
mi$$I$Elena collected $2.50 from pot
mi$$I$Elena: doesn't show hand 
*** SUMMARY ***
Total pot $2.50 | Rake $0 
Seat 1: SkUhNi folded before Flop (didn't bet)
Seat 2: ruslik_by folded before Flop (didn't bet)
Seat 4: mavin80 folded before Flop (didn't bet)
Seat 5: mi$$I$Elena collected ($2.50)
Seat 6: 23SmOkEr07 (button) folded before Flop (didn't bet)
Seat 7: matiko09 (small blind) folded before Flop
Seat 8: blackmont111 (big blind) folded before Flop
Seat 9: TomBod1 folded before Flop (didn't bet)





PokerStars Hand #154970258934:  Hold'em No Limit ($0.50/$1.00 USD) - 2016/06/20 12:32:47 CET [2016/06/20 6:32:47 ET]
Table 'Pongola' 9-max Seat #3 is the button
Seat 1: matiko09 ($100 in chips) 
Seat 2: ruslik_by ($136.27 in chips) 
Seat 3: SkUhNi ($100 in chips) 
Seat 4: karllv ($121.31 in chips) 
Seat 5: joker180785 ($107.43 in chips) 
Seat 6: 23SmOkEr07 ($117.21 in chips) 
Seat 7: Dickyxxx ($151.12 in chips) 
Seat 8: phrantique ($100.20 in chips) 
Seat 9: Filojoes ($106.22 in chips) 
karllv: posts small blind $0.50
joker180785: posts big blind $1
*** HOLE CARDS ***
Dealt to matiko09 [5c 2d]
23SmOkEr07: folds 
Dickyxxx: folds 
phrantique: folds 
Filojoes: raises $2 to $3
matiko09: folds 
ruslik_by: folds 
SkUhNi: folds 
karllv: folds 
joker180785: folds 
Uncalled bet ($2) returned to Filojoes
Filojoes collected $2.50 from pot
Filojoes: doesn't show hand 
*** SUMMARY ***
Total pot $2.50 | Rake $0 
Seat 1: matiko09 folded before Flop (didn't bet)
Seat 2: ruslik_by folded before Flop (didn't bet)
Seat 3: SkUhNi (button) folded before Flop (didn't bet)
Seat 4: karllv (small blind) folded before Flop
Seat 5: joker180785 (big blind) folded before Flop
Seat 6: 23SmOkEr07 folded before Flop (didn't bet)
Seat 7: Dickyxxx folded before Flop (didn't bet)
Seat 8: phrantique folded before Flop (didn't bet)
Seat 9: Filojoes collected ($2.50)





PokerStars Hand #154970262146:  Hold'em No Limit ($0.50/$1.00 USD) - 2016/06/20 12:32:56 CET [2016/06/20 6:32:56 ET]
Table 'Ernestina' 9-max Seat #6 is the button
Seat 1: diva3150 ($74.06 in chips) 
Seat 2: matiko09 ($100 in chips) 
Seat 3: Pvsx. ($170.57 in chips) 
Seat 4: SkUhNi ($103.52 in chips) 
Seat 5: Dickyxxx ($100 in chips) 
Seat 6: arctur17 ($92.30 in chips) 
Seat 8: ruslik_by ($266.74 in chips) 
Seat 9: 23SmOkEr07 ($100 in chips) 
djammusic will be allowed to play after the button
ruslik_by: posts small blind $0.50
23SmOkEr07: posts big blind $1
*** HOLE CARDS ***
Dealt to matiko09 [3h 4s]
diva3150: folds 
matiko09: folds 
Pvsx.: folds 
SkUhNi: folds 
Dickyxxx: raises $2 to $3
arctur17: calls $3
ruslik_by: folds 
23SmOkEr07: folds 
*** FLOP *** [7d 6d 5d]
Dickyxxx: bets $3.70
arctur17: calls $3.70
*** TURN *** [7d 6d 5d] [Ts]
Dickyxxx: bets $9.06
arctur17: calls $9.06
*** RIVER *** [7d 6d 5d Ts] [9s]
Dickyxxx: bets $23.52
arctur17: folds 
Uncalled bet ($23.52) returned to Dickyxxx
Dickyxxx collected $31.37 from pot
Dickyxxx: doesn't show hand 
*** SUMMARY ***
Total pot $33.02 | Rake $1.65 
Board [7d 6d 5d Ts 9s]
Seat 1: diva3150 folded before Flop (didn't bet)
Seat 2: matiko09 folded before Flop (didn't bet)
Seat 3: Pvsx. folded before Flop (didn't bet)
Seat 4: SkUhNi folded before Flop (didn't bet)
Seat 5: Dickyxxx collected ($31.37)
Seat 6: arctur17 (button) folded on the River
Seat 8: ruslik_by (small blind) folded before Flop
Seat 9: 23SmOkEr07 (big blind) folded before Flop





PokerStars Hand #154970262760:  Hold'em No Limit (£0.25/£0.50 GBP) - 2016/06/20 12:32:57 CET [2016/06/20 6:32:57 ET]
Table 'Azalea' 6-max Seat #5 is the button
Seat 1: mitsuVK (£104.95 in chips) 
Seat 2: matiko09 (£81.85 in chips) 
Seat 3: VahTang_89 (£50 in chips) 
Seat 4: faceMyBallz_ (£50 in chips) 
Seat 5: mudders693 (£76.70 in chips) 
Seat 6: Bënedic10 (£50 in chips) 
Bënedic10: posts small blind £0.25
mitsuVK: posts big blind £0.50
*** HOLE CARDS ***
Dealt to matiko09 [7c 4c]
matiko09: folds 
VahTang_89: raises £0.50 to £1
faceMyBallz_: folds 
mudders693: folds 
Bënedic10: calls £0.75
mitsuVK: folds 
*** FLOP *** [Ad 3h Kc]
Bënedic10: checks 
VahTang_89: checks 
*** TURN *** [Ad 3h Kc] [3d]
Bënedic10: checks 
VahTang_89: checks 
*** RIVER *** [Ad 3h Kc 3d] [Jh]
Bënedic10: checks 
VahTang_89: bets £1.19
Bënedic10: folds 
Uncalled bet (£1.19) returned to VahTang_89
VahTang_89 collected £2.38 from pot
VahTang_89: doesn't show hand 
*** SUMMARY ***
Total pot £2.50 | Rake £0.12 
Board [Ad 3h Kc 3d Jh]
Seat 1: mitsuVK (big blind) folded before Flop
Seat 2: matiko09 folded before Flop (didn't bet)
Seat 3: VahTang_89 collected (£2.38)
Seat 4: faceMyBallz_ folded before Flop (didn't bet)
Seat 5: mudders693 (button) folded before Flop (didn't bet)
Seat 6: Bënedic10 (small blind) folded on the River





PokerStars Hand #154970269086:  Hold'em No Limit ($0.25/$0.50 USD) - 2016/06/20 12:33:14 CET [2016/06/20 6:33:14 ET]
Table 'Scheddi II' 9-max Seat #4 is the button
Seat 1: matiko09 ($50 in chips) 
Seat 2: Yaaaazz ($91.45 in chips) 
Seat 3: mi$$I$Elena ($98.40 in chips) 
Seat 4: GOOFA13 ($27.10 in chips) 
Seat 6: joker180785 ($62.78 in chips) 
Seat 7: HopeMayBee ($65.18 in chips) 
Seat 8: orochimaturi ($37.55 in chips) 
Seat 9: Infinitinium ($146.04 in chips) 
joker180785: posts small blind $0.25
HopeMayBee: posts big blind $0.50
matiko09: posts the ante $0.10
Yaaaazz: posts the ante $0.10
mi$$I$Elena: posts the ante $0.10
GOOFA13: posts the ante $0.10
joker180785: posts the ante $0.10
HopeMayBee: posts the ante $0.10
orochimaturi: posts the ante $0.10
Infinitinium: posts the ante $0.10
*** HOLE CARDS ***
Dealt to matiko09 [9s 2h]
orochimaturi: folds 
Infinitinium: calls $0.50
matiko09: folds 
Yaaaazz: folds 
mi$$I$Elena: raises $1.50 to $2
GOOFA13: folds 
joker180785: folds 
HopeMayBee: calls $1.50
Infinitinium: calls $1.50
*** FLOP *** [3c Kh 5d]
HopeMayBee: checks 
Infinitinium: checks 
mi$$I$Elena: checks 
*** TURN *** [3c Kh 5d] [9h]
HopeMayBee: bets $5
Infinitinium: folds 
mi$$I$Elena: folds 
Uncalled bet ($5) returned to HopeMayBee
HopeMayBee collected $6.70 from pot
HopeMayBee: doesn't show hand 
*** SUMMARY ***
Total pot $7.05 | Rake $0.35 
Board [3c Kh 5d 9h]
Seat 1: matiko09 folded before Flop (didn't bet)
Seat 2: Yaaaazz folded before Flop (didn't bet)
Seat 3: mi$$I$Elena folded on the Turn
Seat 4: GOOFA13 (button) folded before Flop (didn't bet)
Seat 6: joker180785 (small blind) folded before Flop
Seat 7: HopeMayBee (big blind) collected ($6.70)
Seat 8: orochimaturi folded before Flop (didn't bet)
Seat 9: Infinitinium folded on the Turn





PokerStars Hand #154970273059:  Hold'em No Limit (£0.25/£0.50 GBP) - 2016/06/20 12:33:24 CET [2016/06/20 6:33:24 ET]
Table 'Tesla' 6-max Seat #3 is the button
Seat 1: Rubleff85 (£52.46 in chips) 
Seat 2: matiko09 (£50 in chips) 
Seat 3: asmodej666 (£50 in chips) 
Seat 4: ILIUXa (£50 in chips) 
Seat 6: faceMyBallz_ (£50 in chips) 
ILIUXa: posts small blind £0.25
faceMyBallz_: posts big blind £0.50
*** HOLE CARDS ***
Dealt to matiko09 [Qc Ac]
Rubleff85: calls £0.50
matiko09: raises £1.50 to £2
asmodej666: calls £2
ILIUXa: folds 
faceMyBallz_: folds 
Rubleff85: calls £1.50
*** FLOP *** [Kc 7h 2d]
Rubleff85: checks 
matiko09: bets £4
asmodej666: folds 
Rubleff85: folds 
Uncalled bet (£4) returned to matiko09
matiko09 collected £6.41 from pot
matiko09: doesn't show hand 
*** SUMMARY ***
Total pot £6.75 | Rake £0.34 
Board [Kc 7h 2d]
Seat 1: Rubleff85 folded on the Flop
Seat 2: matiko09 collected (£6.41)
Seat 3: asmodej666 (button) folded on the Flop
Seat 4: ILIUXa (small blind) folded before Flop
Seat 6: faceMyBallz_ (big blind) folded before Flop





PokerStars Hand #154970275180:  Hold'em No Limit ($0.50/$1.00 USD) - 2016/06/20 12:33:30 CET [2016/06/20 6:33:30 ET]
Table 'Anhui' 9-max Seat #7 is the button
Seat 1: SkUhNi ($150.42 in chips) 
Seat 2: ruslik_by ($275.68 in chips) 
Seat 4: mavin80 ($30.88 in chips) 
Seat 5: mi$$I$Elena ($114.80 in chips) 
Seat 6: 23SmOkEr07 ($131.75 in chips) 
Seat 7: matiko09 ($143.15 in chips) 
Seat 8: blackmont111 ($76.50 in chips) 
Seat 9: TomBod1 ($81.30 in chips) 
blackmont111: posts small blind $0.50
TomBod1: posts big blind $1
hammerwife: sits out 
*** HOLE CARDS ***
Dealt to matiko09 [Jc 8h]
SkUhNi: folds 
ruslik_by: folds 
mavin80: folds 
mi$$I$Elena: folds 
23SmOkEr07: folds 
matiko09: raises $1.27 to $2.27
blackmont111: folds 
TomBod1: raises $3.27 to $5.54
matiko09: folds 
Uncalled bet ($3.27) returned to TomBod1
TomBod1 collected $5.04 from pot
TomBod1: doesn't show hand 
*** SUMMARY ***
Total pot $5.04 | Rake $0 
Seat 1: SkUhNi folded before Flop (didn't bet)
Seat 2: ruslik_by folded before Flop (didn't bet)
Seat 4: mavin80 folded before Flop (didn't bet)
Seat 5: mi$$I$Elena folded before Flop (didn't bet)
Seat 6: 23SmOkEr07 folded before Flop (didn't bet)
Seat 7: matiko09 (button) folded before Flop
Seat 8: blackmont111 (small blind) folded before Flop
Seat 9: TomBod1 (big blind) collected ($5.04)





PokerStars Hand #154970277512:  Hold'em No Limit ($0.50/$1.00 USD) - 2016/06/20 12:33:36 CET [2016/06/20 6:33:36 ET]
Table 'Pongola' 9-max Seat #4 is the button
Seat 1: matiko09 ($100 in chips) 
Seat 2: ruslik_by ($136.27 in chips) 
Seat 3: SkUhNi ($100 in chips) 
Seat 4: karllv ($120.81 in chips) 
Seat 5: joker180785 ($106.43 in chips) 
Seat 6: 23SmOkEr07 ($117.21 in chips) 
Seat 7: Dickyxxx ($151.12 in chips) 
Seat 8: phrantique ($100.20 in chips) 
Seat 9: Filojoes ($107.72 in chips) 
joker180785: posts small blind $0.50
23SmOkEr07: posts big blind $1
*** HOLE CARDS ***
Dealt to matiko09 [Qd 4d]
Dickyxxx: folds 
phrantique: folds 
Filojoes: folds 
matiko09: folds 
ruslik_by: folds 
SkUhNi: folds 
karllv: folds 
joker180785: raises $1.50 to $2.50
23SmOkEr07: folds 
Uncalled bet ($1.50) returned to joker180785
joker180785 collected $2 from pot
*** SUMMARY ***
Total pot $2 | Rake $0 
Seat 1: matiko09 folded before Flop (didn't bet)
Seat 2: ruslik_by folded before Flop (didn't bet)
Seat 3: SkUhNi folded before Flop (didn't bet)
Seat 4: karllv (button) folded before Flop (didn't bet)
Seat 5: joker180785 (small blind) collected ($2)
Seat 6: 23SmOkEr07 (big blind) folded before Flop
Seat 7: Dickyxxx folded before Flop (didn't bet)
Seat 8: phrantique folded before Flop (didn't bet)
Seat 9: Filojoes folded before Flop (didn't bet)





PokerStars Hand #154970279378:  Hold'em No Limit ($0.50/$1.00 USD) - 2016/06/20 12:33:41 CET [2016/06/20 6:33:41 ET]
Table 'Annika' 9-max Seat #9 is the button
Seat 1: hammerwife ($137.77 in chips) 
Seat 2: matiko09 ($100 in chips) 
Seat 3: first_dnk ($87 in chips) 
Seat 4: Kukuryzka ($110 in chips) 
Seat 5: SkUhNi ($112.10 in chips) 
Seat 6: Pvsx. ($107.25 in chips) 
Seat 8: ruslik_by ($106.40 in chips) 
Seat 9: 23SmOkEr07 ($100 in chips) 
hammerwife: posts small blind $0.50
matiko09: posts big blind $1
jirka117: sits out 
*** HOLE CARDS ***
Dealt to matiko09 [4h 7s]
first_dnk: folds 
Kukuryzka: folds 
SkUhNi: raises $2 to $3
Pvsx.: folds 
ruslik_by: folds 
23SmOkEr07: folds 
hammerwife: folds 
matiko09: folds 
Uncalled bet ($2) returned to SkUhNi
SkUhNi collected $2.50 from pot
SkUhNi: doesn't show hand 
*** SUMMARY ***
Total pot $2.50 | Rake $0 
Seat 1: hammerwife (small blind) folded before Flop
Seat 2: matiko09 (big blind) folded before Flop
Seat 3: first_dnk folded before Flop (didn't bet)
Seat 4: Kukuryzka folded before Flop (didn't bet)
Seat 5: SkUhNi collected ($2.50)
Seat 6: Pvsx. folded before Flop (didn't bet)
Seat 8: ruslik_by folded before Flop (didn't bet)
Seat 9: 23SmOkEr07 (button) folded before Flop (didn't bet)





PokerStars Hand #154970281214:  Hold'em No Limit ($0.25/$0.50 USD) - 2016/06/20 12:33:46 CET [2016/06/20 6:33:46 ET]
Table 'Juliana II' 9-max Seat #5 is the button
Seat 1: sno05 ($58.34 in chips) 
Seat 2: cjzm ($49.48 in chips) 
Seat 3: Dr.Mouse102 ($55.26 in chips) 
Seat 4: zarplatka ($42.14 in chips) 
Seat 5: ljryviltj ($72.05 in chips) 
Seat 6: sophie2000 ($50 in chips) 
Seat 7: 23SmOkEr07 ($61.86 in chips) 
Seat 8: matiko09 ($50 in chips) 
Seat 9: tugboat2008 ($93.69 in chips) 
sophie2000: posts small blind $0.25
23SmOkEr07: posts big blind $0.50
*** HOLE CARDS ***
Dealt to matiko09 [8c 7c]
matiko09: raises $1 to $1.50
tugboat2008: folds 
sno05: calls $1.50
cjzm: folds 
Dr.Mouse102: calls $1.50
zarplatka: calls $1.50
ljryviltj: folds 
sophie2000: folds 
23SmOkEr07: folds 
*** FLOP *** [9s Ac Qs]
matiko09: checks 
sno05: bets $0.50
Dr.Mouse102: folds 
zarplatka: raises $3.25 to $3.75
matiko09: folds 
sno05: folds 
Uncalled bet ($3.25) returned to zarplatka
zarplatka collected $7.36 from pot
zarplatka: doesn't show hand 
*** SUMMARY ***
Total pot $7.75 | Rake $0.39 
Board [9s Ac Qs]
Seat 1: sno05 folded on the Flop
Seat 2: cjzm folded before Flop (didn't bet)
Seat 3: Dr.Mouse102 folded on the Flop
Seat 4: zarplatka collected ($7.36)
Seat 5: ljryviltj (button) folded before Flop (didn't bet)
Seat 6: sophie2000 (small blind) folded before Flop
Seat 7: 23SmOkEr07 (big blind) folded before Flop
Seat 8: matiko09 folded on the Flop
Seat 9: tugboat2008 folded before Flop (didn't bet)





PokerStars Hand #154970282631:  Hold'em No Limit ($0.50/$1.00 USD) - 2016/06/20 12:33:49 CET [2016/06/20 6:33:49 ET]
Table 'Isonoe II' 9-max Seat #3 is the button
Seat 1: hammerwife ($109.86 in chips) 
Seat 2: matiko09 ($109.52 in chips) 
Seat 3: Kukuryzka ($99.50 in chips) 
Seat 4: Avtovo ($100 in chips) 
Seat 5: Filojoes ($100 in chips) 
Seat 6: GOOFA13 ($41.38 in chips) 
Seat 7: SkUhNi ($100 in chips) 
Seat 8: lewyson ($74.01 in chips) 
Seat 9: djammusic ($54.48 in chips) 
Avtovo: posts small blind $0.50
Filojoes: posts big blind $1
*** HOLE CARDS ***
Dealt to matiko09 [7s Ad]
GOOFA13: folds 
SkUhNi: folds 
lewyson: folds 
djammusic: folds 
hammerwife: folds 
matiko09: folds 
Kukuryzka: folds 
Avtovo: folds 
Uncalled bet ($0.50) returned to Filojoes
Filojoes collected $1 from pot
Filojoes: doesn't show hand 
*** SUMMARY ***
Total pot $1 | Rake $0 
Seat 1: hammerwife folded before Flop (didn't bet)
Seat 2: matiko09 folded before Flop (didn't bet)
Seat 3: Kukuryzka (button) folded before Flop (didn't bet)
Seat 4: Avtovo (small blind) folded before Flop
Seat 5: Filojoes (big blind) collected ($1)
Seat 6: GOOFA13 folded before Flop (didn't bet)
Seat 7: SkUhNi folded before Flop (didn't bet)
Seat 8: lewyson folded before Flop (didn't bet)
Seat 9: djammusic folded before Flop (didn't bet)





PokerStars Hand #154970282363:  Hold'em No Limit (£0.25/£0.50 GBP) - 2016/06/20 12:33:49 CET [2016/06/20 6:33:49 ET]
Table 'Ani' 6-max Seat #6 is the button
Seat 1: rewq99887788 (£33.66 in chips) 
Seat 2: joker180785 (£58.04 in chips) 
Seat 3: Doobes8555 (£77.48 in chips) 
Seat 4: matiko09 (£55.14 in chips) 
Seat 5: Wwwasian (£60.02 in chips) 
Seat 6: faceMyBallz_ (£54.61 in chips) 
rewq99887788: posts small blind £0.25
joker180785: posts big blind £0.50
*** HOLE CARDS ***
Dealt to matiko09 [Qh Js]
Doobes8555: folds 
matiko09: folds 
Wwwasian: folds 
faceMyBallz_: raises £0.50 to £1
rewq99887788: folds 
joker180785: calls £0.50
*** FLOP *** [Jh Jc 5s]
joker180785: checks 
faceMyBallz_: checks 
*** TURN *** [Jh Jc 5s] [Jd]
joker180785: checks 
faceMyBallz_: checks 
*** RIVER *** [Jh Jc 5s Jd] [Qc]
joker180785: checks 
faceMyBallz_: checks 
*** SHOW DOWN ***
joker180785: shows [Ah 4h] (three of a kind, Jacks)
faceMyBallz_: shows [2h Ac] (three of a kind, Jacks)
joker180785 collected £1.07 from pot
faceMyBallz_ collected £1.07 from pot
*** SUMMARY ***
Total pot £2.25 | Rake £0.11 
Board [Jh Jc 5s Jd Qc]
Seat 1: rewq99887788 (small blind) folded before Flop
Seat 2: joker180785 (big blind) showed [Ah 4h] and won (£1.07) with three of a kind, Jacks
Seat 3: Doobes8555 folded before Flop (didn't bet)
Seat 4: matiko09 folded before Flop (didn't bet)
Seat 5: Wwwasian folded before Flop (didn't bet)
Seat 6: faceMyBallz_ (button) showed [2h Ac] and won (£1.07) with three of a kind, Jacks





PokerStars Hand #154970284450:  Hold'em No Limit ($0.50/$1.00 USD) - 2016/06/20 12:33:54 CET [2016/06/20 6:33:54 ET]
Table 'Pongola' 9-max Seat #5 is the button
Seat 1: matiko09 ($100 in chips) 
Seat 2: ruslik_by ($136.27 in chips) 
Seat 3: SkUhNi ($100 in chips) 
Seat 4: karllv ($120.81 in chips) 
Seat 5: joker180785 ($107.43 in chips) 
Seat 6: 23SmOkEr07 ($116.21 in chips) 
Seat 7: Dickyxxx ($151.12 in chips) 
Seat 8: phrantique ($100.20 in chips) 
Seat 9: Filojoes ($107.72 in chips) 
23SmOkEr07: posts small blind $0.50
Dickyxxx: posts big blind $1
*** HOLE CARDS ***
Dealt to matiko09 [9s 8d]
phrantique: raises $2 to $3
Filojoes: raises $6 to $9
matiko09: folds 
ruslik_by: folds 
SkUhNi: folds 
karllv: folds 
joker180785: folds 
23SmOkEr07: folds 
Dickyxxx: folds 
phrantique: calls $6
*** FLOP *** [3h 3s 5c]
phrantique: checks 
Filojoes: bets $10
phrantique: folds 
Uncalled bet ($10) returned to Filojoes
Filojoes collected $18.52 from pot
Filojoes: doesn't show hand 
*** SUMMARY ***
Total pot $19.50 | Rake $0.98 
Board [3h 3s 5c]
Seat 1: matiko09 folded before Flop (didn't bet)
Seat 2: ruslik_by folded before Flop (didn't bet)
Seat 3: SkUhNi folded before Flop (didn't bet)
Seat 4: karllv folded before Flop (didn't bet)
Seat 5: joker180785 (button) folded before Flop (didn't bet)
Seat 6: 23SmOkEr07 (small blind) folded before Flop
Seat 7: Dickyxxx (big blind) folded before Flop
Seat 8: phrantique folded on the Flop
Seat 9: Filojoes collected ($18.52)





PokerStars Hand #154970286598:  Hold'em No Limit (£0.25/£0.50 GBP) - 2016/06/20 12:34:00 CET [2016/06/20 6:34:00 ET]
Table 'Tesla' 6-max Seat #4 is the button
Seat 1: Rubleff85 (£50.46 in chips) 
Seat 2: matiko09 (£54.41 in chips) 
Seat 3: asmodej666 (£50 in chips) 
Seat 4: ILIUXa (£50 in chips) 
Seat 6: faceMyBallz_ (£50 in chips) 
faceMyBallz_: posts small blind £0.25
Rubleff85: posts big blind £0.50
*** HOLE CARDS ***
Dealt to matiko09 [Qd Td]
matiko09: raises £1 to £1.50
asmodej666: folds 
ILIUXa: folds 
faceMyBallz_: folds 
Rubleff85: calls £1
*** FLOP *** [Th Kh Ks]
Rubleff85: bets £0.50
matiko09: calls £0.50
*** TURN *** [Th Kh Ks] [9c]
Rubleff85: bets £3
matiko09: calls £3
*** RIVER *** [Th Kh Ks 9c] [Jc]
Rubleff85: checks 
matiko09: bets £3.50
Rubleff85: folds 
Uncalled bet (£3.50) returned to matiko09
matiko09 collected £9.74 from pot
matiko09: doesn't show hand 
*** SUMMARY ***
Total pot £10.25 | Rake £0.51 
Board [Th Kh Ks 9c Jc]
Seat 1: Rubleff85 (big blind) folded on the River
Seat 2: matiko09 collected (£9.74)
Seat 3: asmodej666 folded before Flop (didn't bet)
Seat 4: ILIUXa (button) folded before Flop (didn't bet)
Seat 6: faceMyBallz_ (small blind) folded before Flop





PokerStars Hand #154970286973:  Hold'em No Limit ($0.25/$0.50 USD) - 2016/06/20 12:34:01 CET [2016/06/20 6:34:01 ET]
Table 'Scheddi II' 9-max Seat #6 is the button
Seat 1: matiko09 ($50 in chips) 
Seat 2: Yaaaazz ($91.35 in chips) 
Seat 3: mi$$I$Elena ($96.30 in chips) 
Seat 4: GOOFA13 ($27 in chips) 
Seat 6: joker180785 ($62.43 in chips) 
Seat 7: HopeMayBee ($69.78 in chips) 
Seat 8: orochimaturi ($37.45 in chips) 
Seat 9: Infinitinium ($143.94 in chips) 
HopeMayBee: posts small blind $0.25
orochimaturi: posts big blind $0.50
matiko09: posts the ante $0.10
Yaaaazz: posts the ante $0.10
mi$$I$Elena: posts the ante $0.10
GOOFA13: posts the ante $0.10
joker180785: posts the ante $0.10
HopeMayBee: posts the ante $0.10
orochimaturi: posts the ante $0.10
Infinitinium: posts the ante $0.10
*** HOLE CARDS ***
Dealt to matiko09 [2s Qc]
Infinitinium: folds 
matiko09: folds 
Yaaaazz: folds 
mi$$I$Elena: folds 
GOOFA13: folds 
joker180785: raises $0.50 to $1
HopeMayBee: folds 
orochimaturi: calls $0.50
*** FLOP *** [Ks Ac 6c]
orochimaturi: checks 
joker180785: checks 
*** TURN *** [Ks Ac 6c] [Tc]
orochimaturi: checks 
joker180785: checks 
*** RIVER *** [Ks Ac 6c Tc] [9s]
orochimaturi: bets $1.50
joker180785: folds 
Uncalled bet ($1.50) returned to orochimaturi
orochimaturi collected $2.90 from pot
orochimaturi: doesn't show hand 
*** SUMMARY ***
Total pot $3.05 | Rake $0.15 
Board [Ks Ac 6c Tc 9s]
Seat 1: matiko09 folded before Flop (didn't bet)
Seat 2: Yaaaazz folded before Flop (didn't bet)
Seat 3: mi$$I$Elena folded before Flop (didn't bet)
Seat 4: GOOFA13 folded before Flop (didn't bet)
Seat 6: joker180785 (button) folded on the River
Seat 7: HopeMayBee (small blind) folded before Flop
Seat 8: orochimaturi (big blind) collected ($2.90)
Seat 9: Infinitinium folded before Flop (didn't bet)





PokerStars Hand #154970287857:  Hold'em No Limit ($0.50/$1.00 USD) - 2016/06/20 12:34:03 CET [2016/06/20 6:34:03 ET]
Table 'Annika' 9-max Seat #1 is the button
Seat 1: hammerwife ($137.27 in chips) 
Seat 2: matiko09 ($100 in chips) 
Seat 3: first_dnk ($87 in chips) 
Seat 4: Kukuryzka ($110 in chips) 
Seat 5: SkUhNi ($113.60 in chips) 
Seat 6: Pvsx. ($107.25 in chips) 
Seat 8: ruslik_by ($106.40 in chips) 
Seat 9: 23SmOkEr07 ($100 in chips) 
matiko09: posts small blind $0.50
first_dnk: posts big blind $1
jirka117: sits out 
*** HOLE CARDS ***
Dealt to matiko09 [As Qs]
Kukuryzka: folds 
SkUhNi: folds 
Pvsx.: raises $1.50 to $2.50
ruslik_by: folds 
23SmOkEr07: folds 
hammerwife: folds 
matiko09: calls $2
first_dnk: folds 
*** FLOP *** [7c Th 8h]
matiko09: checks 
Pvsx.: checks 
*** TURN *** [7c Th 8h] [Ah]
matiko09: bets $4
Pvsx.: calls $4
*** RIVER *** [7c Th 8h Ah] [Jh]
matiko09: checks 
Pvsx.: checks 
*** SHOW DOWN ***
matiko09: shows [As Qs] (a pair of Aces)
Pvsx.: shows [Jd Ad] (two pair, Aces and Jacks)
Pvsx. collected $13.30 from pot
*** SUMMARY ***
Total pot $14 | Rake $0.70 
Board [7c Th 8h Ah Jh]
Seat 1: hammerwife (button) folded before Flop (didn't bet)
Seat 2: matiko09 (small blind) showed [As Qs] and lost with a pair of Aces
Seat 3: first_dnk (big blind) folded before Flop
Seat 4: Kukuryzka folded before Flop (didn't bet)
Seat 5: SkUhNi folded before Flop (didn't bet)
Seat 6: Pvsx. showed [Jd Ad] and won ($13.30) with two pair, Aces and Jacks
Seat 8: ruslik_by folded before Flop (didn't bet)
Seat 9: 23SmOkEr07 folded before Flop (didn't bet)





PokerStars Hand #154970290052:  Hold'em No Limit ($0.50/$1.00 USD) - 2016/06/20 12:34:09 CET [2016/06/20 6:34:09 ET]
Table 'Isonoe II' 9-max Seat #4 is the button
Seat 1: hammerwife ($109.86 in chips) 
Seat 2: matiko09 ($109.52 in chips) 
Seat 3: Kukuryzka ($99.50 in chips) 
Seat 4: Avtovo ($100 in chips) 
Seat 5: Filojoes ($100.50 in chips) 
Seat 6: GOOFA13 ($41.38 in chips) 
Seat 7: SkUhNi ($100 in chips) 
Seat 8: lewyson ($74.01 in chips) 
Seat 9: djammusic ($54.48 in chips) 
Filojoes: posts small blind $0.50
GOOFA13: posts big blind $1
*** HOLE CARDS ***
Dealt to matiko09 [2h 9h]
SkUhNi: raises $2 to $3
lewyson: folds 
djammusic: folds 
hammerwife: folds 
matiko09: folds 
Kukuryzka: folds 
Avtovo: folds 
Filojoes: folds 
GOOFA13: folds 
Uncalled bet ($2) returned to SkUhNi
SkUhNi collected $2.50 from pot
SkUhNi: doesn't show hand 
*** SUMMARY ***
Total pot $2.50 | Rake $0 
Seat 1: hammerwife folded before Flop (didn't bet)
Seat 2: matiko09 folded before Flop (didn't bet)
Seat 3: Kukuryzka folded before Flop (didn't bet)
Seat 4: Avtovo (button) folded before Flop (didn't bet)
Seat 5: Filojoes (small blind) folded before Flop
Seat 6: GOOFA13 (big blind) folded before Flop
Seat 7: SkUhNi collected ($2.50)
Seat 8: lewyson folded before Flop (didn't bet)
Seat 9: djammusic folded before Flop (didn't bet)





PokerStars Hand #154970290896:  Hold'em No Limit ($0.50/$1.00 USD) - 2016/06/20 12:34:11 CET [2016/06/20 6:34:11 ET]
Table 'Anhui' 9-max Seat #8 is the button
Seat 1: SkUhNi ($150.42 in chips) 
Seat 2: ruslik_by ($275.68 in chips) 
Seat 4: mavin80 ($30.88 in chips) 
Seat 5: mi$$I$Elena ($114.80 in chips) 
Seat 6: 23SmOkEr07 ($131.75 in chips) 
Seat 7: matiko09 ($140.88 in chips) 
Seat 8: blackmont111 ($76 in chips) 
Seat 9: TomBod1 ($84.07 in chips) 
TomBod1: posts small blind $0.50
SkUhNi: posts big blind $1
hammerwife: sits out 
*** HOLE CARDS ***
Dealt to matiko09 [6s 5s]
ruslik_by: folds 
mavin80: raises $1.50 to $2.50
mi$$I$Elena: folds 
23SmOkEr07: folds 
matiko09: folds 
blackmont111: folds 
TomBod1: folds 
SkUhNi: folds 
Uncalled bet ($1.50) returned to mavin80
mavin80 collected $2.50 from pot
*** SUMMARY ***
Total pot $2.50 | Rake $0 
Seat 1: SkUhNi (big blind) folded before Flop
Seat 2: ruslik_by folded before Flop (didn't bet)
Seat 4: mavin80 collected ($2.50)
Seat 5: mi$$I$Elena folded before Flop (didn't bet)
Seat 6: 23SmOkEr07 folded before Flop (didn't bet)
Seat 7: matiko09 folded before Flop (didn't bet)
Seat 8: blackmont111 (button) folded before Flop (didn't bet)
Seat 9: TomBod1 (small blind) folded before Flop





PokerStars Hand #154970295220:  Hold'em No Limit (£0.25/£0.50 GBP) - 2016/06/20 12:34:22 CET [2016/06/20 6:34:22 ET]
Table 'Azalea' 6-max Seat #6 is the button
Seat 1: mitsuVK (£104.45 in chips) 
Seat 2: matiko09 (£81.85 in chips) 
Seat 3: VahTang_89 (£51.38 in chips) 
Seat 4: faceMyBallz_ (£50 in chips) 
Seat 5: mudders693 (£76.70 in chips) 
Seat 6: Bënedic10 (£50 in chips) 
mitsuVK: posts small blind £0.25
matiko09: posts big blind £0.50
*** HOLE CARDS ***
Dealt to matiko09 [Qc As]
VahTang_89: folds 
faceMyBallz_: folds 
mudders693: raises £1 to £1.50
Bënedic10: folds 
mitsuVK: folds 
matiko09: raises £4.50 to £6
mudders693: calls £4.50
*** FLOP *** [5s Kd Ad]
matiko09: bets £6.05
mudders693: folds 
Uncalled bet (£6.05) returned to matiko09
matiko09 collected £11.64 from pot
matiko09: doesn't show hand 
*** SUMMARY ***
Total pot £12.25 | Rake £0.61 
Board [5s Kd Ad]
Seat 1: mitsuVK (small blind) folded before Flop
Seat 2: matiko09 (big blind) collected (£11.64)
Seat 3: VahTang_89 folded before Flop (didn't bet)
Seat 4: faceMyBallz_ folded before Flop (didn't bet)
Seat 5: mudders693 folded on the Flop
Seat 6: Bënedic10 (button) folded before Flop (didn't bet)





PokerStars Hand #154970296055:  Hold'em No Limit ($0.50/$1.00 USD) - 2016/06/20 12:34:24 CET [2016/06/20 6:34:24 ET]
Table 'Ambrosia II' 9-max Seat #4 is the button
Seat 1: 23SmOkEr07 ($111.32 in chips) 
Seat 2: Eyeballz1307 ($66.19 in chips) 
Seat 4: mi$$I$Elena ($213.80 in chips) 
Seat 5: Mattulh ($100 in chips) 
Seat 6: ruslik_by ($116.30 in chips) 
Seat 7: matiko09 ($108.26 in chips) 
Seat 8: hammerwife ($100 in chips) 
Seat 9: SkUhNi ($125.31 in chips) 
Mattulh: posts small blind $0.50
ruslik_by: posts big blind $1
*** HOLE CARDS ***
Dealt to matiko09 [Ad 4s]
matiko09: folds 
hammerwife: folds 
SkUhNi: folds 
23SmOkEr07: folds 
Eyeballz1307: folds 
mavin80 said, "lucky idiot :))))"
mi$$I$Elena: folds 
Mattulh: raises $2 to $3
ruslik_by: calls $2
*** FLOP *** [3h Kc Qc]
Mattulh: checks 
ruslik_by: checks 
*** TURN *** [3h Kc Qc] [5c]
Mattulh: bets $3
ruslik_by: folds 
Uncalled bet ($3) returned to Mattulh
Mattulh collected $5.70 from pot
Mattulh: doesn't show hand 
*** SUMMARY ***
Total pot $6 | Rake $0.30 
Board [3h Kc Qc 5c]
Seat 1: 23SmOkEr07 folded before Flop (didn't bet)
Seat 2: Eyeballz1307 folded before Flop (didn't bet)
Seat 4: mi$$I$Elena (button) folded before Flop (didn't bet)
Seat 5: Mattulh (small blind) collected ($5.70)
Seat 6: ruslik_by (big blind) folded on the Turn
Seat 7: matiko09 folded before Flop (didn't bet)
Seat 8: hammerwife folded before Flop (didn't bet)
Seat 9: SkUhNi folded before Flop (didn't bet)





PokerStars Hand #154970296953:  Hold'em No Limit ($0.50/$1.00 USD) - 2016/06/20 12:34:27 CET [2016/06/20 6:34:27 ET]
Table 'Ernestina' 9-max Seat #8 is the button
Seat 1: diva3150 ($74.06 in chips) 
Seat 2: matiko09 ($100 in chips) 
Seat 3: Pvsx. ($170.57 in chips) 
Seat 4: SkUhNi ($103.52 in chips) 
Seat 5: Dickyxxx ($115.61 in chips) 
Seat 6: arctur17 ($76.54 in chips) 
Seat 8: ruslik_by ($266.24 in chips) 
Seat 9: 23SmOkEr07 ($100 in chips) 
23SmOkEr07: posts small blind $0.50
diva3150: posts big blind $1
djammusic: sits out 
*** HOLE CARDS ***
Dealt to matiko09 [8d 4d]
matiko09: folds 
Pvsx.: folds 
SkUhNi: folds 
Dickyxxx: folds 
arctur17: raises $1 to $2
ruslik_by: folds 
23SmOkEr07: calls $1.50
diva3150: folds 
*** FLOP *** [Ts 6s Kh]
23SmOkEr07: checks 
arctur17: checks 
*** TURN *** [Ts 6s Kh] [7d]
23SmOkEr07: checks 
arctur17: checks 
*** RIVER *** [Ts 6s Kh 7d] [Qs]
23SmOkEr07: checks 
arctur17: checks 
*** SHOW DOWN ***
23SmOkEr07: shows [4h Ah] (high card Ace)
arctur17: shows [9d 9c] (a pair of Nines)
arctur17 collected $4.75 from pot
*** SUMMARY ***
Total pot $5 | Rake $0.25 
Board [Ts 6s Kh 7d Qs]
Seat 1: diva3150 (big blind) folded before Flop
Seat 2: matiko09 folded before Flop (didn't bet)
Seat 3: Pvsx. folded before Flop (didn't bet)
Seat 4: SkUhNi folded before Flop (didn't bet)
Seat 5: Dickyxxx folded before Flop (didn't bet)
Seat 6: arctur17 showed [9d 9c] and won ($4.75) with a pair of Nines
Seat 8: ruslik_by (button) folded before Flop (didn't bet)
Seat 9: 23SmOkEr07 (small blind) showed [4h Ah] and lost with high card Ace





PokerStars Hand #154970301373:  Hold'em No Limit (£0.25/£0.50 GBP) - 2016/06/20 12:34:38 CET [2016/06/20 6:34:38 ET]
Table 'Ani' 6-max Seat #1 is the button
Seat 1: rewq99887788 (£33.41 in chips) 
Seat 2: joker180785 (£58.11 in chips) 
Seat 3: Doobes8555 (£77.48 in chips) 
Seat 4: matiko09 (£55.14 in chips) 
Seat 5: Wwwasian (£60.02 in chips) 
Seat 6: faceMyBallz_ (£54.68 in chips) 
joker180785: posts small blind £0.25
Doobes8555: posts big blind £0.50
*** HOLE CARDS ***
Dealt to matiko09 [Ah 5s]
matiko09: folds 
Wwwasian: folds 
faceMyBallz_: folds 
rewq99887788: raises £1 to £1.50
joker180785: folds 
Doobes8555: folds 
Uncalled bet (£1) returned to rewq99887788
rewq99887788 collected £1.25 from pot
*** SUMMARY ***
Total pot £1.25 | Rake £0 
Seat 1: rewq99887788 (button) collected (£1.25)
Seat 2: joker180785 (small blind) folded before Flop
Seat 3: Doobes8555 (big blind) folded before Flop
Seat 4: matiko09 folded before Flop (didn't bet)
Seat 5: Wwwasian folded before Flop (didn't bet)
Seat 6: faceMyBallz_ folded before Flop (didn't bet)





PokerStars Hand #154970302794:  Hold'em No Limit (£0.25/£0.50 GBP) - 2016/06/20 12:34:42 CET [2016/06/20 6:34:42 ET]
Table 'Tesla' 6-max Seat #6 is the button
Seat 1: Rubleff85 (£45.46 in chips) 
Seat 2: matiko09 (£59.15 in chips) 
Seat 3: asmodej666 (£50 in chips) 
Seat 4: ILIUXa (£50 in chips) 
Seat 6: faceMyBallz_ (£50 in chips) 
Rubleff85: posts small blind £0.25
matiko09: posts big blind £0.50
*** HOLE CARDS ***
Dealt to matiko09 [6d 4c]
asmodej666: folds 
ILIUXa: folds 
faceMyBallz_: folds 
Rubleff85: folds 
Uncalled bet (£0.25) returned to matiko09
matiko09 collected £0.50 from pot
matiko09: doesn't show hand 
*** SUMMARY ***
Total pot £0.50 | Rake £0 
Seat 1: Rubleff85 (small blind) folded before Flop
Seat 2: matiko09 (big blind) collected (£0.50)
Seat 3: asmodej666 folded before Flop (didn't bet)
Seat 4: ILIUXa folded before Flop (didn't bet)
Seat 6: faceMyBallz_ (button) folded before Flop (didn't bet)





PokerStars Hand #154970305546:  Hold'em No Limit ($0.50/$1.00 USD) - 2016/06/20 12:34:49 CET [2016/06/20 6:34:49 ET]
Table 'Pongola' 9-max Seat #6 is the button
Seat 1: matiko09 ($100 in chips) 
Seat 2: ruslik_by ($136.27 in chips) 
Seat 3: SkUhNi ($100 in chips) 
Seat 4: karllv ($120.81 in chips) 
Seat 5: joker180785 ($107.43 in chips) 
Seat 6: 23SmOkEr07 ($115.71 in chips) 
Seat 7: Dickyxxx ($150.12 in chips) 
Seat 8: phrantique ($91.20 in chips) 
Seat 9: Filojoes ($117.24 in chips) 
Dickyxxx: posts small blind $0.50
phrantique: posts big blind $1
*** HOLE CARDS ***
Dealt to matiko09 [5d As]
Filojoes: raises $2 to $3
matiko09: folds 
ruslik_by: folds 
SkUhNi: calls $3
karllv: calls $3
joker180785: folds 
23SmOkEr07: folds 
Dickyxxx: folds 
phrantique: calls $2
*** FLOP *** [6d 5h 8s]
phrantique: checks 
Filojoes: checks 
SkUhNi: bets $7
karllv: calls $7
phrantique: folds 
Filojoes: calls $7
*** TURN *** [6d 5h 8s] [2d]
Filojoes: checks 
SkUhNi: checks 
karllv: bets $15
Filojoes: calls $15
SkUhNi: folds 
*** RIVER *** [6d 5h 8s 2d] [8h]
Filojoes: checks 
karllv: bets $35
Filojoes: folds 
Uncalled bet ($35) returned to karllv
karllv collected $61 from pot
*** SUMMARY ***
Total pot $63.50 | Rake $2.50 
Board [6d 5h 8s 2d 8h]
Seat 1: matiko09 folded before Flop (didn't bet)
Seat 2: ruslik_by folded before Flop (didn't bet)
Seat 3: SkUhNi folded on the Turn
Seat 4: karllv collected ($61)
Seat 5: joker180785 folded before Flop (didn't bet)
Seat 6: 23SmOkEr07 (button) folded before Flop (didn't bet)
Seat 7: Dickyxxx (small blind) folded before Flop
Seat 8: phrantique (big blind) folded on the Flop
Seat 9: Filojoes folded on the River





PokerStars Hand #154970305457:  Hold'em No Limit ($0.50/$1.00 USD) - 2016/06/20 12:34:49 CET [2016/06/20 6:34:49 ET]
Table 'Isonoe II' 9-max Seat #5 is the button
Seat 1: hammerwife ($109.86 in chips) 
Seat 2: matiko09 ($109.52 in chips) 
Seat 3: Kukuryzka ($99.50 in chips) 
Seat 4: Avtovo ($100 in chips) 
Seat 5: Filojoes ($100 in chips) 
Seat 6: GOOFA13 ($40.38 in chips) 
Seat 7: SkUhNi ($101.50 in chips) 
Seat 8: lewyson ($74.01 in chips) 
Seat 9: djammusic ($54.48 in chips) 
GOOFA13: posts small blind $0.50
SkUhNi: posts big blind $1
*** HOLE CARDS ***
Dealt to matiko09 [3c 5s]
lewyson: folds 
djammusic: folds 
hammerwife: raises $2 to $3
matiko09: folds 
Kukuryzka: folds 
Avtovo: calls $3
Filojoes: folds 
GOOFA13: calls $2.50
SkUhNi: folds 
*** FLOP *** [2h 3s 9c]
GOOFA13: checks 
hammerwife: checks 
Avtovo: bets $5.50
GOOFA13: calls $5.50
hammerwife: calls $5.50
*** TURN *** [2h 3s 9c] [5d]
GOOFA13: bets $12.59
hammerwife: folds 
Avtovo: folds 
Uncalled bet ($12.59) returned to GOOFA13
GOOFA13 collected $25.18 from pot
GOOFA13: doesn't show hand 
*** SUMMARY ***
Total pot $26.50 | Rake $1.32 
Board [2h 3s 9c 5d]
Seat 1: hammerwife folded on the Turn
Seat 2: matiko09 folded before Flop (didn't bet)
Seat 3: Kukuryzka folded before Flop (didn't bet)
Seat 4: Avtovo folded on the Turn
Seat 5: Filojoes (button) folded before Flop (didn't bet)
Seat 6: GOOFA13 (small blind) collected ($25.18)
Seat 7: SkUhNi (big blind) folded before Flop
Seat 8: lewyson folded before Flop (didn't bet)
Seat 9: djammusic folded before Flop (didn't bet)





PokerStars Hand #154970306695:  Hold'em No Limit ($0.50/$1.00 USD) - 2016/06/20 12:34:52 CET [2016/06/20 6:34:52 ET]
Table 'Anhui' 9-max Seat #9 is the button
Seat 1: SkUhNi ($149.42 in chips) 
Seat 2: ruslik_by ($275.68 in chips) 
Seat 4: mavin80 ($32.38 in chips) 
Seat 5: mi$$I$Elena ($114.80 in chips) 
Seat 6: 23SmOkEr07 ($131.75 in chips) 
Seat 7: matiko09 ($140.88 in chips) 
Seat 8: blackmont111 ($76 in chips) 
Seat 9: TomBod1 ($83.57 in chips) 
SkUhNi: posts small blind $0.50
ruslik_by: posts big blind $1
hammerwife: sits out 
*** HOLE CARDS ***
Dealt to matiko09 [9d 9s]
mavin80: raises $1.50 to $2.50
mi$$I$Elena: folds 
23SmOkEr07: folds 
matiko09: calls $2.50
blackmont111: folds 
TomBod1: folds 
SkUhNi: folds 
ruslik_by: folds 
*** FLOP *** [Kc Tc Jd]
mavin80: checks 
matiko09: checks 
*** TURN *** [Kc Tc Jd] [As]
mavin80: bets $2
matiko09: folds 
Uncalled bet ($2) returned to mavin80
mavin80 collected $6.18 from pot
*** SUMMARY ***
Total pot $6.50 | Rake $0.32 
Board [Kc Tc Jd As]
Seat 1: SkUhNi (small blind) folded before Flop
Seat 2: ruslik_by (big blind) folded before Flop
Seat 4: mavin80 collected ($6.18)
Seat 5: mi$$I$Elena folded before Flop (didn't bet)
Seat 6: 23SmOkEr07 folded before Flop (didn't bet)
Seat 7: matiko09 folded on the Turn
Seat 8: blackmont111 folded before Flop (didn't bet)
Seat 9: TomBod1 (button) folded before Flop (didn't bet)





PokerStars Hand #154970309490:  Hold'em No Limit ($0.50/$1.00 USD) - 2016/06/20 12:34:59 CET [2016/06/20 6:34:59 ET]
Table 'Annika' 9-max Seat #2 is the button
Seat 1: hammerwife ($137.27 in chips) 
Seat 2: matiko09 ($100 in chips) 
Seat 3: first_dnk ($86 in chips) 
Seat 4: Kukuryzka ($110 in chips) 
Seat 5: SkUhNi ($113.60 in chips) 
Seat 6: Pvsx. ($114.05 in chips) 
Seat 8: ruslik_by ($106.40 in chips) 
Seat 9: 23SmOkEr07 ($100 in chips) 
first_dnk: posts small blind $0.50
Kukuryzka: posts big blind $1
jirka117: sits out 
*** HOLE CARDS ***
Dealt to matiko09 [4h Jc]
SkUhNi: raises $2 to $3
Pvsx.: folds 
ruslik_by: folds 
23SmOkEr07: folds 
hammerwife: folds 
matiko09: folds 
first_dnk: folds 
Kukuryzka: folds 
Uncalled bet ($2) returned to SkUhNi
SkUhNi collected $2.50 from pot
SkUhNi: doesn't show hand 
*** SUMMARY ***
Total pot $2.50 | Rake $0 
Seat 1: hammerwife folded before Flop (didn't bet)
Seat 2: matiko09 (button) folded before Flop (didn't bet)
Seat 3: first_dnk (small blind) folded before Flop
Seat 4: Kukuryzka (big blind) folded before Flop
Seat 5: SkUhNi collected ($2.50)
Seat 6: Pvsx. folded before Flop (didn't bet)
Seat 8: ruslik_by folded before Flop (didn't bet)
Seat 9: 23SmOkEr07 folded before Flop (didn't bet)





PokerStars Hand #154970309419:  Hold'em No Limit (£0.25/£0.50 GBP) - 2016/06/20 12:34:59 CET [2016/06/20 6:34:59 ET]
Table 'Ani' 6-max Seat #2 is the button
Seat 1: rewq99887788 (£34.16 in chips) 
Seat 2: joker180785 (£57.86 in chips) 
Seat 3: Doobes8555 (£76.98 in chips) 
Seat 4: matiko09 (£55.14 in chips) 
Seat 5: Wwwasian (£60.02 in chips) 
Seat 6: faceMyBallz_ (£54.68 in chips) 
Doobes8555: posts small blind £0.25
matiko09: posts big blind £0.50
*** HOLE CARDS ***
Dealt to matiko09 [9s 5s]
Wwwasian: folds 
faceMyBallz_: folds 
rewq99887788: folds 
joker180785: folds 
Doobes8555: folds 
Uncalled bet (£0.25) returned to matiko09
matiko09 collected £0.50 from pot
matiko09: doesn't show hand 
*** SUMMARY ***
Total pot £0.50 | Rake £0 
Seat 1: rewq99887788 folded before Flop (didn't bet)
Seat 2: joker180785 (button) folded before Flop (didn't bet)
Seat 3: Doobes8555 (small blind) folded before Flop
Seat 4: matiko09 (big blind) collected (£0.50)
Seat 5: Wwwasian folded before Flop (didn't bet)
Seat 6: faceMyBallz_ folded before Flop (didn't bet)





PokerStars Hand #154970311322:  Hold'em No Limit (£0.25/£0.50 GBP) - 2016/06/20 12:35:04 CET [2016/06/20 6:35:04 ET]
Table 'Azalea' 6-max Seat #1 is the button
Seat 1: mitsuVK (£104.20 in chips) 
Seat 2: matiko09 (£87.49 in chips) 
Seat 3: VahTang_89 (£51.38 in chips) 
Seat 4: faceMyBallz_ (£50 in chips) 
Seat 5: mudders693 (£70.70 in chips) 
Seat 6: Bënedic10 (£50 in chips) 
matiko09: posts small blind £0.25
VahTang_89: posts big blind £0.50
*** HOLE CARDS ***
Dealt to matiko09 [8d Js]
faceMyBallz_: raises £1 to £1.50
mudders693: calls £1.50
Bënedic10: folds 
mitsuVK: folds 
matiko09: folds 
VahTang_89: folds 
*** FLOP *** [Ts 2s 5s]
faceMyBallz_: checks 
mudders693: checks 
*** TURN *** [Ts 2s 5s] [7c]
faceMyBallz_: checks 
mudders693: checks 
*** RIVER *** [Ts 2s 5s 7c] [4c]
faceMyBallz_: checks 
mudders693: bets £4.50
faceMyBallz_: folds 
Uncalled bet (£4.50) returned to mudders693
mudders693 collected £3.56 from pot
mudders693: doesn't show hand 
*** SUMMARY ***
Total pot £3.75 | Rake £0.19 
Board [Ts 2s 5s 7c 4c]
Seat 1: mitsuVK (button) folded before Flop (didn't bet)
Seat 2: matiko09 (small blind) folded before Flop
Seat 3: VahTang_89 (big blind) folded before Flop
Seat 4: faceMyBallz_ folded on the River
Seat 5: mudders693 collected (£3.56)
Seat 6: Bënedic10 folded before Flop (didn't bet)





PokerStars Hand #154970311604:  Hold'em No Limit (£0.25/£0.50 GBP) - 2016/06/20 12:35:05 CET [2016/06/20 6:35:05 ET]
Table 'Tesla' 6-max Seat #1 is the button
Seat 1: Rubleff85 (£45.21 in chips) 
Seat 2: matiko09 (£59.40 in chips) 
Seat 3: asmodej666 (£50 in chips) 
Seat 4: ILIUXa (£50 in chips) 
Seat 6: faceMyBallz_ (£50 in chips) 
matiko09: posts small blind £0.25
asmodej666: posts big blind £0.50
*** HOLE CARDS ***
Dealt to matiko09 [7h Qd]
ILIUXa: folds 
sólyom333 joins the table at seat #5 
faceMyBallz_: folds 
Rubleff85: raises £0.50 to £1
matiko09: folds 
asmodej666: calls £0.50
*** FLOP *** [Ac 2c Ts]
asmodej666: checks 
Rubleff85: bets £1
sólyom333 leaves the table
asmodej666: folds 
Uncalled bet (£1) returned to Rubleff85
Rubleff85 collected £2.14 from pot
Rubleff85: doesn't show hand 
*** SUMMARY ***
Total pot £2.25 | Rake £0.11 
Board [Ac 2c Ts]
Seat 1: Rubleff85 (button) collected (£2.14)
Seat 2: matiko09 (small blind) folded before Flop
Seat 3: asmodej666 (big blind) folded on the Flop
Seat 4: ILIUXa folded before Flop (didn't bet)
Seat 6: faceMyBallz_ folded before Flop (didn't bet)





PokerStars Hand #154970313701:  Hold'em No Limit ($0.25/$0.50 USD) - 2016/06/20 12:35:10 CET [2016/06/20 6:35:10 ET]
Table 'Scheddi II' 9-max Seat #7 is the button
Seat 1: matiko09 ($50 in chips) 
Seat 2: Yaaaazz ($91.25 in chips) 
Seat 3: mi$$I$Elena ($96.20 in chips) 
Seat 4: GOOFA13 ($26.90 in chips) 
Seat 6: joker180785 ($61.33 in chips) 
Seat 7: HopeMayBee ($69.43 in chips) 
Seat 8: orochimaturi ($39.25 in chips) 
Seat 9: Infinitinium ($143.84 in chips) 
orochimaturi: posts small blind $0.25
Infinitinium: posts big blind $0.50
matiko09: posts the ante $0.10
Yaaaazz: posts the ante $0.10
mi$$I$Elena: posts the ante $0.10
GOOFA13: posts the ante $0.10
joker180785: posts the ante $0.10
HopeMayBee: posts the ante $0.10
orochimaturi: posts the ante $0.10
Infinitinium: posts the ante $0.10
*** HOLE CARDS ***
Dealt to matiko09 [Js Th]
matiko09: folds 
Yaaaazz: folds 
mi$$I$Elena: raises $1 to $1.50
GOOFA13: folds 
joker180785: folds 
HopeMayBee: calls $1.50
orochimaturi: raises $4.30 to $5.80
Infinitinium: calls $5.30
mi$$I$Elena: folds 
HopeMayBee: folds 
*** FLOP *** [7h 6d Jd]
orochimaturi: bets $8.50
Infinitinium: raises $27 to $35.50
orochimaturi: calls $24.85 and is all-in
Uncalled bet ($2.15) returned to Infinitinium
*** TURN *** [7h 6d Jd] [6h]
*** RIVER *** [7h 6d Jd 6h] [9d]
*** SHOW DOWN ***
orochimaturi: shows [Ks Kd] (two pair, Kings and Sixes)
Infinitinium: shows [Jc As] (two pair, Jacks and Sixes)
orochimaturi collected $80.10 from pot
*** SUMMARY ***
Total pot $82.10 | Rake $2 
Board [7h 6d Jd 6h 9d]
Seat 1: matiko09 folded before Flop (didn't bet)
Seat 2: Yaaaazz folded before Flop (didn't bet)
Seat 3: mi$$I$Elena folded before Flop
Seat 4: GOOFA13 folded before Flop (didn't bet)
Seat 6: joker180785 folded before Flop (didn't bet)
Seat 7: HopeMayBee (button) folded before Flop
Seat 8: orochimaturi (small blind) showed [Ks Kd] and won ($80.10) with two pair, Kings and Sixes
Seat 9: Infinitinium (big blind) showed [Jc As] and lost with two pair, Jacks and Sixes





PokerStars Hand #154970314124:  Hold'em No Limit ($0.50/$1.00 USD) - 2016/06/20 12:35:11 CET [2016/06/20 6:35:11 ET]
Table 'Ernestina' 9-max Seat #9 is the button
Seat 1: diva3150 ($73.06 in chips) 
Seat 2: matiko09 ($100 in chips) 
Seat 3: Pvsx. ($170.57 in chips) 
Seat 4: SkUhNi ($103.52 in chips) 
Seat 5: Dickyxxx ($115.61 in chips) 
Seat 6: arctur17 ($79.29 in chips) 
Seat 8: ruslik_by ($266.24 in chips) 
Seat 9: 23SmOkEr07 ($100 in chips) 
diva3150: posts small blind $0.50
matiko09: posts big blind $1
djammusic: sits out 
*** HOLE CARDS ***
Dealt to matiko09 [7s Kd]
Pvsx.: folds 
SkUhNi: folds 
Dickyxxx: folds 
arctur17: folds 
ruslik_by: folds 
23SmOkEr07: folds 
diva3150: raises $2 to $3
matiko09: folds 
Uncalled bet ($2) returned to diva3150
diva3150 collected $2 from pot
diva3150: doesn't show hand 
*** SUMMARY ***
Total pot $2 | Rake $0 
Seat 1: diva3150 (small blind) collected ($2)
Seat 2: matiko09 (big blind) folded before Flop
Seat 3: Pvsx. folded before Flop (didn't bet)
Seat 4: SkUhNi folded before Flop (didn't bet)
Seat 5: Dickyxxx folded before Flop (didn't bet)
Seat 6: arctur17 folded before Flop (didn't bet)
Seat 8: ruslik_by folded before Flop (didn't bet)
Seat 9: 23SmOkEr07 (button) folded before Flop (didn't bet)





PokerStars Hand #154970316863:  Hold'em No Limit (£0.25/£0.50 GBP) - 2016/06/20 12:35:19 CET [2016/06/20 6:35:19 ET]
Table 'Ani' 6-max Seat #3 is the button
Seat 1: rewq99887788 (£34.16 in chips) 
Seat 2: joker180785 (£57.86 in chips) 
Seat 3: Doobes8555 (£76.73 in chips) 
Seat 4: matiko09 (£55.39 in chips) 
Seat 5: Wwwasian (£60.02 in chips) 
Seat 6: faceMyBallz_ (£54.68 in chips) 
matiko09: posts small blind £0.25
Wwwasian: posts big blind £0.50
*** HOLE CARDS ***
Dealt to matiko09 [9s 2h]
faceMyBallz_: folds 
rewq99887788: folds 
joker180785: raises £0.75 to £1.25
Doobes8555: calls £1.25
matiko09: folds 
Wwwasian: folds 
*** FLOP *** [Td 2s 9h]
joker180785: checks 
Doobes8555: checks 
*** TURN *** [Td 2s 9h] [Ts]
joker180785: checks 
Doobes8555: checks 
*** RIVER *** [Td 2s 9h Ts] [Ad]
joker180785: checks 
Doobes8555: bets £3
joker180785: folds 
Uncalled bet (£3) returned to Doobes8555
Doobes8555 collected £3.09 from pot
Doobes8555: doesn't show hand 
*** SUMMARY ***
Total pot £3.25 | Rake £0.16 
Board [Td 2s 9h Ts Ad]
Seat 1: rewq99887788 folded before Flop (didn't bet)
Seat 2: joker180785 folded on the River
Seat 3: Doobes8555 (button) collected (£3.09)
Seat 4: matiko09 (small blind) folded before Flop
Seat 5: Wwwasian (big blind) folded before Flop
Seat 6: faceMyBallz_ folded before Flop (didn't bet)





PokerStars Hand #154970319406:  Hold'em No Limit ($0.50/$1.00 USD) - 2016/06/20 12:35:25 CET [2016/06/20 6:35:25 ET]
Table 'Ernestina' 9-max Seat #1 is the button
Seat 1: diva3150 ($74.06 in chips) 
Seat 2: matiko09 ($100 in chips) 
Seat 3: Pvsx. ($170.57 in chips) 
Seat 4: SkUhNi ($103.52 in chips) 
Seat 5: Dickyxxx ($115.61 in chips) 
Seat 6: arctur17 ($79.29 in chips) 
Seat 8: ruslik_by ($266.24 in chips) 
Seat 9: 23SmOkEr07 ($100 in chips) 
matiko09: posts small blind $0.50
Pvsx.: posts big blind $1
djammusic: sits out 
*** HOLE CARDS ***
Dealt to matiko09 [Ah 4h]
SkUhNi: folds 
Dickyxxx: folds 
arctur17: folds 
ruslik_by: folds 
23SmOkEr07: raises $1.50 to $2.50
diva3150: folds 
matiko09: folds 
Pvsx.: folds 
Uncalled bet ($1.50) returned to 23SmOkEr07
23SmOkEr07 collected $2.50 from pot
23SmOkEr07: doesn't show hand 
*** SUMMARY ***
Total pot $2.50 | Rake $0 
Seat 1: diva3150 (button) folded before Flop (didn't bet)
Seat 2: matiko09 (small blind) folded before Flop
Seat 3: Pvsx. (big blind) folded before Flop
Seat 4: SkUhNi folded before Flop (didn't bet)
Seat 5: Dickyxxx folded before Flop (didn't bet)
Seat 6: arctur17 folded before Flop (didn't bet)
Seat 8: ruslik_by folded before Flop (didn't bet)
Seat 9: 23SmOkEr07 collected ($2.50)





PokerStars Hand #154970320417:  Hold'em No Limit ($0.50/$1.00 USD) - 2016/06/20 12:35:28 CET [2016/06/20 6:35:28 ET]
Table 'Ambrosia II' 9-max Seat #5 is the button
Seat 1: 23SmOkEr07 ($111.32 in chips) 
Seat 2: Eyeballz1307 ($66.19 in chips) 
Seat 3: mavin80 ($100 in chips) 
Seat 4: mi$$I$Elena ($213.80 in chips) 
Seat 5: Mattulh ($102.70 in chips) 
Seat 6: ruslik_by ($113.30 in chips) 
Seat 7: matiko09 ($108.26 in chips) 
Seat 8: hammerwife ($100 in chips) 
Seat 9: SkUhNi ($125.31 in chips) 
ruslik_by: posts small blind $0.50
matiko09: posts big blind $1
*** HOLE CARDS ***
Dealt to matiko09 [Qs Ac]
hammerwife: folds 
SkUhNi: folds 
23SmOkEr07: raises $1.50 to $2.50
Eyeballz1307: calls $2.50
mavin80 said, "miss Elena u should pack up and ff off"
mavin80: folds 
mi$$I$Elena: folds 
Mattulh: folds 
ruslik_by: folds 
matiko09: calls $1.50
*** FLOP *** [4s 3s Ad]
matiko09: bets $4.94
23SmOkEr07: calls $4.94
Eyeballz1307: calls $4.94
*** TURN *** [4s 3s Ad] [Js]
matiko09: checks 
23SmOkEr07: bets $12.14
Eyeballz1307: calls $12.14
matiko09: calls $12.14
*** RIVER *** [4s 3s Ad Js] [7s]
matiko09: checks 
23SmOkEr07: bets $31.77
Eyeballz1307: calls $31.77
matiko09: folds 
*** SHOW DOWN ***
23SmOkEr07: shows [Qd As] (a flush, Ace high)
Eyeballz1307: mucks hand 
23SmOkEr07 collected $120.28 from pot
*** SUMMARY ***
Total pot $122.78 | Rake $2.50 
Board [4s 3s Ad Js 7s]
Seat 1: 23SmOkEr07 showed [Qd As] and won ($120.28) with a flush, Ace high
Seat 2: Eyeballz1307 mucked [7h Ah]
Seat 3: mavin80 folded before Flop (didn't bet)
Seat 4: mi$$I$Elena folded before Flop (didn't bet)
Seat 5: Mattulh (button) folded before Flop (didn't bet)
Seat 6: ruslik_by (small blind) folded before Flop
Seat 7: matiko09 (big blind) folded on the River
Seat 8: hammerwife folded before Flop (didn't bet)
Seat 9: SkUhNi folded before Flop (didn't bet)





PokerStars Hand #154970321109:  Hold'em No Limit ($0.50/$1.00 USD) - 2016/06/20 12:35:30 CET [2016/06/20 6:35:30 ET]
Table 'Annika' 9-max Seat #3 is the button
Seat 1: hammerwife ($137.27 in chips) 
Seat 2: matiko09 ($100 in chips) 
Seat 3: first_dnk ($85.50 in chips) 
Seat 4: Kukuryzka ($109 in chips) 
Seat 5: SkUhNi ($115.10 in chips) 
Seat 6: Pvsx. ($114.05 in chips) 
Seat 8: ruslik_by ($106.40 in chips) 
Seat 9: 23SmOkEr07 ($100 in chips) 
Kukuryzka: posts small blind $0.50
SkUhNi: posts big blind $1
jirka117: sits out 
*** HOLE CARDS ***
Dealt to matiko09 [Tc 3d]
Pvsx.: folds 
ruslik_by: folds 
23SmOkEr07: folds 
hammerwife: folds 
matiko09: folds 
first_dnk: folds 
Kukuryzka: folds 
Uncalled bet ($0.50) returned to SkUhNi
SkUhNi collected $1 from pot
SkUhNi: doesn't show hand 
*** SUMMARY ***
Total pot $1 | Rake $0 
Seat 1: hammerwife folded before Flop (didn't bet)
Seat 2: matiko09 folded before Flop (didn't bet)
Seat 3: first_dnk (button) folded before Flop (didn't bet)
Seat 4: Kukuryzka (small blind) folded before Flop
Seat 5: SkUhNi (big blind) collected ($1)
Seat 6: Pvsx. folded before Flop (didn't bet)
Seat 8: ruslik_by folded before Flop (didn't bet)
Seat 9: 23SmOkEr07 folded before Flop (didn't bet)





PokerStars Hand #154970323770:  Hold'em No Limit (£0.25/£0.50 GBP) - 2016/06/20 12:35:37 CET [2016/06/20 6:35:37 ET]
Table 'Tesla' 6-max Seat #2 is the button
Seat 1: Rubleff85 (£46.35 in chips) 
Seat 2: matiko09 (£59.15 in chips) 
Seat 3: asmodej666 (£50 in chips) 
Seat 4: ILIUXa (£50 in chips) 
Seat 6: faceMyBallz_ (£50 in chips) 
asmodej666: posts small blind £0.25
ILIUXa: posts big blind £0.50
*** HOLE CARDS ***
Dealt to matiko09 [Ts 9s]
faceMyBallz_: folds 
Rubleff85: calls £0.50
matiko09: raises £1.50 to £2
asmodej666: folds 
ILIUXa: folds 
Rubleff85: folds 
Uncalled bet (£1.50) returned to matiko09
matiko09 collected £1.75 from pot
matiko09: doesn't show hand 
*** SUMMARY ***
Total pot £1.75 | Rake £0 
Seat 1: Rubleff85 folded before Flop
Seat 2: matiko09 (button) collected (£1.75)
Seat 3: asmodej666 (small blind) folded before Flop
Seat 4: ILIUXa (big blind) folded before Flop
Seat 6: faceMyBallz_ folded before Flop (didn't bet)





PokerStars Hand #154970326202:  Hold'em No Limit ($0.50/$1.00 USD) - 2016/06/20 12:35:43 CET [2016/06/20 6:35:43 ET]
Table 'Anhui' 9-max Seat #1 is the button
Seat 1: SkUhNi ($148.92 in chips) 
Seat 2: ruslik_by ($274.68 in chips) 
Seat 3: hammerwife ($100 in chips) 
Seat 4: mavin80 ($36.06 in chips) 
Seat 5: mi$$I$Elena ($114.80 in chips) 
Seat 6: 23SmOkEr07 ($131.75 in chips) 
Seat 7: matiko09 ($138.38 in chips) 
Seat 8: blackmont111 ($76 in chips) 
Seat 9: TomBod1 ($83.57 in chips) 
ruslik_by: posts small blind $0.50
hammerwife: posts big blind $1
*** HOLE CARDS ***
Dealt to matiko09 [Qh 2d]
mavin80: folds 
mi$$I$Elena: folds 
23SmOkEr07: folds 
matiko09: folds 
blackmont111: folds 
TomBod1: folds 
SkUhNi: raises $1 to $2
ruslik_by: folds 
hammerwife: calls $1
*** FLOP *** [Qd Tc 4s]
hammerwife: checks 
SkUhNi: checks 
*** TURN *** [Qd Tc 4s] [5d]
hammerwife: bets $2.50
SkUhNi: folds 
Uncalled bet ($2.50) returned to hammerwife
hammerwife collected $4.28 from pot
hammerwife: doesn't show hand 
*** SUMMARY ***
Total pot $4.50 | Rake $0.22 
Board [Qd Tc 4s 5d]
Seat 1: SkUhNi (button) folded on the Turn
Seat 2: ruslik_by (small blind) folded before Flop
Seat 3: hammerwife (big blind) collected ($4.28)
Seat 4: mavin80 folded before Flop (didn't bet)
Seat 5: mi$$I$Elena folded before Flop (didn't bet)
Seat 6: 23SmOkEr07 folded before Flop (didn't bet)
Seat 7: matiko09 folded before Flop (didn't bet)
Seat 8: blackmont111 folded before Flop (didn't bet)
Seat 9: TomBod1 folded before Flop (didn't bet)





PokerStars Hand #154970331627:  Hold'em No Limit ($0.50/$1.00 USD) - 2016/06/20 12:35:57 CET [2016/06/20 6:35:57 ET]
Table 'Ernestina' 9-max Seat #2 is the button
Seat 1: diva3150 ($74.06 in chips) 
Seat 2: matiko09 ($100 in chips) 
Seat 3: Pvsx. ($169.57 in chips) 
Seat 4: SkUhNi ($103.52 in chips) 
Seat 5: Dickyxxx ($115.61 in chips) 
Seat 6: arctur17 ($79.29 in chips) 
Seat 8: ruslik_by ($266.24 in chips) 
Seat 9: 23SmOkEr07 ($101.50 in chips) 
Pvsx.: posts small blind $0.50
SkUhNi: posts big blind $1
djammusic: sits out 
*** HOLE CARDS ***
Dealt to matiko09 [Kh 4h]
Dickyxxx: folds 
arctur17: folds 
ruslik_by: folds 
23SmOkEr07: raises $1.50 to $2.50
diva3150: folds 
matiko09: folds 
Pvsx.: folds 
SkUhNi: folds 
Uncalled bet ($1.50) returned to 23SmOkEr07
23SmOkEr07 collected $2.50 from pot
23SmOkEr07: doesn't show hand 
*** SUMMARY ***
Total pot $2.50 | Rake $0 
Seat 1: diva3150 folded before Flop (didn't bet)
Seat 2: matiko09 (button) folded before Flop (didn't bet)
Seat 3: Pvsx. (small blind) folded before Flop
Seat 4: SkUhNi (big blind) folded before Flop
Seat 5: Dickyxxx folded before Flop (didn't bet)
Seat 6: arctur17 folded before Flop (didn't bet)
Seat 8: ruslik_by folded before Flop (didn't bet)
Seat 9: 23SmOkEr07 collected ($2.50)





PokerStars Hand #154970331951:  Hold'em No Limit ($0.50/$1.00 USD) - 2016/06/20 12:35:58 CET [2016/06/20 6:35:58 ET]
Table 'Annika' 9-max Seat #4 is the button
Seat 1: hammerwife ($137.27 in chips) 
Seat 2: matiko09 ($100 in chips) 
Seat 3: first_dnk ($85.50 in chips) 
Seat 4: Kukuryzka ($108.50 in chips) 
Seat 5: SkUhNi ($115.60 in chips) 
Seat 6: Pvsx. ($114.05 in chips) 
Seat 8: ruslik_by ($106.40 in chips) 
Seat 9: 23SmOkEr07 ($100 in chips) 
SkUhNi: posts small blind $0.50
Pvsx.: posts big blind $1
jirka117: sits out 
*** HOLE CARDS ***
Dealt to matiko09 [Ts Jc]
ruslik_by: raises $2 to $3
23SmOkEr07: folds 
hammerwife: folds 
matiko09: folds 
first_dnk: folds 
Kukuryzka: folds 
SkUhNi: folds 
Pvsx.: folds 
Uncalled bet ($2) returned to ruslik_by
ruslik_by collected $2.50 from pot
ruslik_by: doesn't show hand 
*** SUMMARY ***
Total pot $2.50 | Rake $0 
Seat 1: hammerwife folded before Flop (didn't bet)
Seat 2: matiko09 folded before Flop (didn't bet)
Seat 3: first_dnk folded before Flop (didn't bet)
Seat 4: Kukuryzka (button) folded before Flop (didn't bet)
Seat 5: SkUhNi (small blind) folded before Flop
Seat 6: Pvsx. (big blind) folded before Flop
Seat 8: ruslik_by collected ($2.50)
Seat 9: 23SmOkEr07 folded before Flop (didn't bet)





PokerStars Hand #154970335525:  Hold'em No Limit (£0.25/£0.50 GBP) - 2016/06/20 12:36:07 CET [2016/06/20 6:36:07 ET]
Table 'Tesla' 6-max Seat #3 is the button
Seat 1: Rubleff85 (£45.85 in chips) 
Seat 2: matiko09 (£60.40 in chips) 
Seat 3: asmodej666 (£50 in chips) 
Seat 4: ILIUXa (£50 in chips) 
Seat 6: faceMyBallz_ (£50 in chips) 
ILIUXa: posts small blind £0.25
faceMyBallz_: posts big blind £0.50
*** HOLE CARDS ***
Dealt to matiko09 [6c As]
Rubleff85: calls £0.50
matiko09: folds 
asmodej666: folds 
ILIUXa: folds 
faceMyBallz_: checks 
*** FLOP *** [4s 2h 8h]
faceMyBallz_: checks 
Rubleff85: bets £0.50
faceMyBallz_: calls £0.50
*** TURN *** [4s 2h 8h] [7s]
faceMyBallz_: checks 
Rubleff85: bets £1.75
faceMyBallz_: folds 
Uncalled bet (£1.75) returned to Rubleff85
Rubleff85 collected £2.14 from pot
Rubleff85: doesn't show hand 
*** SUMMARY ***
Total pot £2.25 | Rake £0.11 
Board [4s 2h 8h 7s]
Seat 1: Rubleff85 collected (£2.14)
Seat 2: matiko09 folded before Flop (didn't bet)
Seat 3: asmodej666 (button) folded before Flop (didn't bet)
Seat 4: ILIUXa (small blind) folded before Flop
Seat 6: faceMyBallz_ (big blind) folded on the Turn





PokerStars Hand #154970337203:  Hold'em No Limit (£0.25/£0.50 GBP) - 2016/06/20 12:36:12 CET [2016/06/20 6:36:12 ET]
Table 'Ani' 6-max Seat #4 is the button
Seat 1: rewq99887788 (£34.16 in chips) 
Seat 2: joker180785 (£56.61 in chips) 
Seat 3: Doobes8555 (£78.57 in chips) 
Seat 4: matiko09 (£55.14 in chips) 
Seat 5: Wwwasian (£59.52 in chips) 
Seat 6: faceMyBallz_ (£54.68 in chips) 
Wwwasian: posts small blind £0.25
faceMyBallz_: posts big blind £0.50
*** HOLE CARDS ***
Dealt to matiko09 [7s Tc]
rewq99887788: folds 
joker180785: folds 
Doobes8555: calls £0.50
matiko09: folds 
Wwwasian: folds 
faceMyBallz_: checks 
*** FLOP *** [Js Th Ts]
faceMyBallz_: checks 
Doobes8555: checks 
*** TURN *** [Js Th Ts] [Qh]
faceMyBallz_: checks 
Doobes8555: checks 
*** RIVER *** [Js Th Ts Qh] [7d]
faceMyBallz_: checks 
Doobes8555: checks 
*** SHOW DOWN ***
faceMyBallz_: shows [2h 2c] (two pair, Tens and Deuces)
Doobes8555: shows [8c 7c] (two pair, Tens and Sevens)
Doobes8555 collected £1.19 from pot
*** SUMMARY ***
Total pot £1.25 | Rake £0.06 
Board [Js Th Ts Qh 7d]
Seat 1: rewq99887788 folded before Flop (didn't bet)
Seat 2: joker180785 folded before Flop (didn't bet)
Seat 3: Doobes8555 showed [8c 7c] and won (£1.19) with two pair, Tens and Sevens
Seat 4: matiko09 (button) folded before Flop (didn't bet)
Seat 5: Wwwasian (small blind) folded before Flop
Seat 6: faceMyBallz_ (big blind) showed [2h 2c] and lost with two pair, Tens and Deuces





PokerStars Hand #154970341467:  Hold'em No Limit ($0.50/$1.00 USD) - 2016/06/20 12:36:23 CET [2016/06/20 6:36:23 ET]
Table 'Ernestina' 9-max Seat #3 is the button
Seat 1: diva3150 ($74.06 in chips) 
Seat 2: matiko09 ($100 in chips) 
Seat 3: Pvsx. ($169.07 in chips) 
Seat 4: SkUhNi ($102.52 in chips) 
Seat 5: Dickyxxx ($115.61 in chips) 
Seat 6: arctur17 ($79.29 in chips) 
Seat 8: ruslik_by ($266.24 in chips) 
Seat 9: 23SmOkEr07 ($103 in chips) 
SkUhNi: posts small blind $0.50
Dickyxxx: posts big blind $1
djammusic: sits out 
*** HOLE CARDS ***
Dealt to matiko09 [9d 9h]
arctur17: folds 
ruslik_by: folds 
23SmOkEr07: folds 
diva3150: raises $1 to $2
matiko09: raises $5 to $7
Pvsx.: folds 
SkUhNi: folds 
Dickyxxx: folds 
diva3150: calls $5
*** FLOP *** [8c 9c 3h]
diva3150: checks 
matiko09: bets $5
diva3150: raises $5 to $10
matiko09: calls $5
*** TURN *** [8c 9c 3h] [Tc]
diva3150: bets $14
matiko09: raises $69 to $83 and is all-in
diva3150: calls $43.06 and is all-in
Uncalled bet ($25.94) returned to matiko09
*** RIVER *** [8c 9c 3h Tc] [2d]
*** SHOW DOWN ***
diva3150: shows [Th Td] (three of a kind, Tens)
matiko09: shows [9d 9h] (three of a kind, Nines)
diva3150 collected $147.12 from pot
*** SUMMARY ***
Total pot $149.62 | Rake $2.50 
Board [8c 9c 3h Tc 2d]
Seat 1: diva3150 showed [Th Td] and won ($147.12) with three of a kind, Tens
Seat 2: matiko09 showed [9d 9h] and lost with three of a kind, Nines
Seat 3: Pvsx. (button) folded before Flop (didn't bet)
Seat 4: SkUhNi (small blind) folded before Flop
Seat 5: Dickyxxx (big blind) folded before Flop
Seat 6: arctur17 folded before Flop (didn't bet)
Seat 8: ruslik_by folded before Flop (didn't bet)
Seat 9: 23SmOkEr07 folded before Flop (didn't bet)





PokerStars Hand #154970342146:  Hold'em No Limit (£0.25/£0.50 GBP) - 2016/06/20 12:36:24 CET [2016/06/20 6:36:24 ET]
Table 'Azalea' 6-max Seat #2 is the button
Seat 1: mitsuVK (£104.20 in chips) 
Seat 2: matiko09 (£87.24 in chips) 
Seat 3: VahTang_89 (£50.88 in chips) 
Seat 4: faceMyBallz_ (£50 in chips) 
Seat 5: mudders693 (£72.76 in chips) 
Seat 6: Bënedic10 (£50 in chips) 
VahTang_89: posts small blind £0.25
faceMyBallz_: posts big blind £0.50
*** HOLE CARDS ***
Dealt to matiko09 [Ac Qc]
mudders693: folds 
Bënedic10: folds 
mitsuVK: folds 
matiko09: raises £0.63 to £1.13
VahTang_89: folds 
faceMyBallz_: folds 
Uncalled bet (£0.63) returned to matiko09
matiko09 collected £1.25 from pot
matiko09: doesn't show hand 
*** SUMMARY ***
Total pot £1.25 | Rake £0 
Seat 1: mitsuVK folded before Flop (didn't bet)
Seat 2: matiko09 (button) collected (£1.25)
Seat 3: VahTang_89 (small blind) folded before Flop
Seat 4: faceMyBallz_ (big blind) folded before Flop
Seat 5: mudders693 folded before Flop (didn't bet)
Seat 6: Bënedic10 folded before Flop (didn't bet)





PokerStars Hand #154970344466:  Hold'em No Limit ($0.50/$1.00 USD) - 2016/06/20 12:36:31 CET [2016/06/20 6:36:31 ET]
Table 'Isonoe II' 9-max Seat #6 is the button
Seat 1: hammerwife ($101.36 in chips) 
Seat 2: matiko09 ($109.52 in chips) 
Seat 3: Kukuryzka ($99.50 in chips) 
Seat 4: Avtovo ($100 in chips) 
Seat 5: Filojoes ($100 in chips) 
Seat 6: GOOFA13 ($57.06 in chips) 
Seat 7: SkUhNi ($100.50 in chips) 
Seat 8: lewyson ($74.01 in chips) 
Seat 9: djammusic ($54.48 in chips) 
SkUhNi: posts small blind $0.50
lewyson: posts big blind $1
*** HOLE CARDS ***
Dealt to matiko09 [4s Jd]
djammusic: folds 
hammerwife: folds 
matiko09: folds 
Kukuryzka: folds 
Avtovo: folds 
Filojoes: folds 
GOOFA13: raises $1 to $2
SkUhNi: calls $1.50
lewyson: calls $1
*** FLOP *** [Ad Kd 7h]
SkUhNi: checks 
lewyson: bets $4
GOOFA13: calls $4
SkUhNi: calls $4
*** TURN *** [Ad Kd 7h] [3s]
SkUhNi: checks 
lewyson: checks 
GOOFA13: bets $7
SkUhNi: calls $7
lewyson: folds 
*** RIVER *** [Ad Kd 7h 3s] [2c]
SkUhNi: checks 
GOOFA13: bets $15.20
SkUhNi: folds 
Uncalled bet ($15.20) returned to GOOFA13
GOOFA13 collected $30.40 from pot
GOOFA13: doesn't show hand 
*** SUMMARY ***
Total pot $32 | Rake $1.60 
Board [Ad Kd 7h 3s 2c]
Seat 1: hammerwife folded before Flop (didn't bet)
Seat 2: matiko09 folded before Flop (didn't bet)
Seat 3: Kukuryzka folded before Flop (didn't bet)
Seat 4: Avtovo folded before Flop (didn't bet)
Seat 5: Filojoes folded before Flop (didn't bet)
Seat 6: GOOFA13 (button) collected ($30.40)
Seat 7: SkUhNi (small blind) folded on the River
Seat 8: lewyson (big blind) folded on the Turn
Seat 9: djammusic folded before Flop (didn't bet)





PokerStars Hand #154970345400:  Hold'em No Limit ($0.25/$0.50 USD) - 2016/06/20 12:36:33 CET [2016/06/20 6:36:33 ET]
Table 'Scheddi II' 9-max Seat #8 is the button
Seat 1: matiko09 ($50 in chips) 
Seat 2: Yaaaazz ($91.15 in chips) 
Seat 3: mi$$I$Elena ($94.60 in chips) 
Seat 4: GOOFA13 ($26.80 in chips) 
Seat 6: joker180785 ($61.23 in chips) 
Seat 7: HopeMayBee ($67.83 in chips) 
Seat 8: orochimaturi ($80.10 in chips) 
Seat 9: Infinitinium ($104.59 in chips) 
Infinitinium: posts small blind $0.25
matiko09: posts big blind $0.50
matiko09: posts the ante $0.10
Yaaaazz: posts the ante $0.10
mi$$I$Elena: posts the ante $0.10
GOOFA13: posts the ante $0.10
joker180785: posts the ante $0.10
HopeMayBee: posts the ante $0.10
orochimaturi: posts the ante $0.10
Infinitinium: posts the ante $0.10
*** HOLE CARDS ***
Dealt to matiko09 [Ks 2s]
Yaaaazz: folds 
mi$$I$Elena: folds 
GOOFA13: raises $0.50 to $1
joker180785: folds 
HopeMayBee: folds 
orochimaturi: folds 
Infinitinium: calls $0.75
matiko09: calls $0.50
*** FLOP *** [7s Jc 7h]
Infinitinium: checks 
matiko09: checks 
GOOFA13: bets $1.50
Infinitinium: calls $1.50
matiko09: folds 
*** TURN *** [7s Jc 7h] [Qc]
Infinitinium: bets $3.23
GOOFA13: calls $3.23
*** RIVER *** [7s Jc 7h Qc] [4c]
Infinitinium: checks 
GOOFA13: checks 
*** SHOW DOWN ***
Infinitinium: shows [Jd 3s] (two pair, Jacks and Sevens)
GOOFA13: shows [Js 5s] (two pair, Jacks and Sevens)
Infinitinium collected $6.30 from pot
GOOFA13 collected $6.30 from pot
*** SUMMARY ***
Total pot $13.26 | Rake $0.66 
Board [7s Jc 7h Qc 4c]
Seat 1: matiko09 (big blind) folded on the Flop
Seat 2: Yaaaazz folded before Flop (didn't bet)
Seat 3: mi$$I$Elena folded before Flop (didn't bet)
Seat 4: GOOFA13 showed [Js 5s] and won ($6.30) with two pair, Jacks and Sevens
Seat 6: joker180785 folded before Flop (didn't bet)
Seat 7: HopeMayBee folded before Flop (didn't bet)
Seat 8: orochimaturi (button) folded before Flop (didn't bet)
Seat 9: Infinitinium (small blind) showed [Jd 3s] and won ($6.30) with two pair, Jacks and Sevens





PokerStars Hand #154970348523:  Hold'em No Limit (£0.25/£0.50 GBP) - 2016/06/20 12:36:41 CET [2016/06/20 6:36:41 ET]
Table 'Ani' 6-max Seat #5 is the button
Seat 1: rewq99887788 (£34.16 in chips) 
Seat 2: joker180785 (£56.61 in chips) 
Seat 3: Doobes8555 (£79.26 in chips) 
Seat 4: matiko09 (£55.14 in chips) 
Seat 5: Wwwasian (£59.27 in chips) 
Seat 6: faceMyBallz_ (£54.18 in chips) 
faceMyBallz_: posts small blind £0.25
rewq99887788: posts big blind £0.50
*** HOLE CARDS ***
Dealt to matiko09 [As 9h]
joker180785: folds 
Doobes8555: calls £0.50
matiko09: raises £1.50 to £2
Wwwasian: folds 
faceMyBallz_: raises £4 to £6
rewq99887788: folds 
Doobes8555: folds 
matiko09: folds 
Uncalled bet (£4) returned to faceMyBallz_
faceMyBallz_ collected £5 from pot
faceMyBallz_: doesn't show hand 
*** SUMMARY ***
Total pot £5 | Rake £0 
Seat 1: rewq99887788 (big blind) folded before Flop
Seat 2: joker180785 folded before Flop (didn't bet)
Seat 3: Doobes8555 folded before Flop
Seat 4: matiko09 folded before Flop
Seat 5: Wwwasian (button) folded before Flop (didn't bet)
Seat 6: faceMyBallz_ (small blind) collected (£5)





PokerStars Hand #154970350106:  Hold'em No Limit (£0.25/£0.50 GBP) - 2016/06/20 12:36:45 CET [2016/06/20 6:36:45 ET]
Table 'Azalea' 6-max Seat #3 is the button
Seat 1: mitsuVK (£104.20 in chips) 
Seat 2: matiko09 (£87.99 in chips) 
Seat 3: VahTang_89 (£50.63 in chips) 
Seat 4: faceMyBallz_ (£50 in chips) 
Seat 5: mudders693 (£72.76 in chips) 
Seat 6: Bënedic10 (£50 in chips) 
faceMyBallz_: posts small blind £0.25
mudders693: posts big blind £0.50
*** HOLE CARDS ***
Dealt to matiko09 [Ad 5s]
Bënedic10: folds 
mitsuVK: raises £1 to £1.50
matiko09: folds 
VahTang_89: folds 
faceMyBallz_: folds 
mudders693: raises £2 to £3.50
mitsuVK: calls £2
*** FLOP *** [8c 6c 7h]
mudders693: bets £6.50
mitsuVK: folds 
Uncalled bet (£6.50) returned to mudders693
mudders693 collected £6.89 from pot
mudders693: doesn't show hand 
*** SUMMARY ***
Total pot £7.25 | Rake £0.36 
Board [8c 6c 7h]
Seat 1: mitsuVK folded on the Flop
Seat 2: matiko09 folded before Flop (didn't bet)
Seat 3: VahTang_89 (button) folded before Flop (didn't bet)
Seat 4: faceMyBallz_ (small blind) folded before Flop
Seat 5: mudders693 (big blind) collected (£6.89)
Seat 6: Bënedic10 folded before Flop (didn't bet)





PokerStars Hand #154970351283:  Hold'em No Limit ($0.50/$1.00 USD) - 2016/06/20 12:36:48 CET [2016/06/20 6:36:48 ET]
Table 'Pongola' 9-max Seat #7 is the button
Seat 1: matiko09 ($100 in chips) 
Seat 2: ruslik_by ($136.27 in chips) 
Seat 3: SkUhNi ($100 in chips) 
Seat 4: karllv ($156.81 in chips) 
Seat 5: joker180785 ($107.43 in chips) 
Seat 6: 23SmOkEr07 ($115.71 in chips) 
Seat 7: Dickyxxx ($149.62 in chips) 
Seat 8: phrantique ($88.20 in chips) 
Seat 9: Filojoes ($100 in chips) 
phrantique: posts small blind $0.50
Filojoes: posts big blind $1
*** HOLE CARDS ***
Dealt to matiko09 [8d Qc]
matiko09: folds 
ruslik_by: folds 
SkUhNi: folds 
karllv: folds 
joker180785: folds 
23SmOkEr07: folds 
Dickyxxx: folds 
phrantique: folds 
Uncalled bet ($0.50) returned to Filojoes
Filojoes collected $1 from pot
Filojoes: doesn't show hand 
*** SUMMARY ***
Total pot $1 | Rake $0 
Seat 1: matiko09 folded before Flop (didn't bet)
Seat 2: ruslik_by folded before Flop (didn't bet)
Seat 3: SkUhNi folded before Flop (didn't bet)
Seat 4: karllv folded before Flop (didn't bet)
Seat 5: joker180785 folded before Flop (didn't bet)
Seat 6: 23SmOkEr07 folded before Flop (didn't bet)
Seat 7: Dickyxxx (button) folded before Flop (didn't bet)
Seat 8: phrantique (small blind) folded before Flop
Seat 9: Filojoes (big blind) collected ($1)





PokerStars Hand #154970351416:  Hold'em No Limit ($0.50/$1.00 USD) - 2016/06/20 12:36:49 CET [2016/06/20 6:36:49 ET]
Table 'Annika' 9-max Seat #5 is the button
Seat 1: hammerwife ($137.27 in chips) 
Seat 2: matiko09 ($100 in chips) 
Seat 3: first_dnk ($85.50 in chips) 
Seat 4: Kukuryzka ($108.50 in chips) 
Seat 5: SkUhNi ($115.10 in chips) 
Seat 6: Pvsx. ($113.05 in chips) 
Seat 7: jirka117 ($51.36 in chips) 
Seat 8: ruslik_by ($107.90 in chips) 
Seat 9: 23SmOkEr07 ($100 in chips) 
Pvsx.: posts small blind $0.50
jirka117: posts big blind $1
*** HOLE CARDS ***
Dealt to matiko09 [Ks 4s]
ruslik_by: folds 
23SmOkEr07: folds 
hammerwife: raises $2 to $3
matiko09: folds 
first_dnk: folds 
Kukuryzka: folds 
SkUhNi: folds 
Pvsx.: folds 
jirka117: calls $2
*** FLOP *** [Ts Jc As]
jirka117: checks 
hammerwife: checks 
*** TURN *** [Ts Jc As] [8s]
jirka117: checks 
hammerwife: checks 
*** RIVER *** [Ts Jc As 8s] [2s]
jirka117: checks 
hammerwife: checks 
*** SHOW DOWN ***
jirka117: shows [6s 8d] (a flush, Ace high)
hammerwife: mucks hand 
jirka117 collected $6.18 from pot
*** SUMMARY ***
Total pot $6.50 | Rake $0.32 
Board [Ts Jc As 8s 2s]
Seat 1: hammerwife mucked [9d 9h]
Seat 2: matiko09 folded before Flop (didn't bet)
Seat 3: first_dnk folded before Flop (didn't bet)
Seat 4: Kukuryzka folded before Flop (didn't bet)
Seat 5: SkUhNi (button) folded before Flop (didn't bet)
Seat 6: Pvsx. (small blind) folded before Flop
Seat 7: jirka117 (big blind) showed [6s 8d] and won ($6.18) with a flush, Ace high
Seat 8: ruslik_by folded before Flop (didn't bet)
Seat 9: 23SmOkEr07 folded before Flop (didn't bet)





PokerStars Hand #154970353881:  Hold'em No Limit ($0.50/$1.00 USD) - 2016/06/20 12:36:55 CET [2016/06/20 6:36:55 ET]
Table 'Anhui' 9-max Seat #2 is the button
Seat 1: SkUhNi ($146.92 in chips) 
Seat 2: ruslik_by ($274.18 in chips) 
Seat 3: hammerwife ($102.28 in chips) 
Seat 4: mavin80 ($36.06 in chips) 
Seat 5: mi$$I$Elena ($114.80 in chips) 
Seat 6: 23SmOkEr07 ($131.75 in chips) 
Seat 7: matiko09 ($138.38 in chips) 
Seat 8: blackmont111 ($76 in chips) 
Seat 9: TomBod1 ($83.57 in chips) 
hammerwife: posts small blind $0.50
mavin80: posts big blind $1
*** HOLE CARDS ***
Dealt to matiko09 [5s 9s]
mi$$I$Elena: folds 
23SmOkEr07: folds 
matiko09: folds 
blackmont111: folds 
TomBod1: raises $1 to $2
SkUhNi: raises $4 to $6
ruslik_by: folds 
hammerwife: folds 
mavin80: folds 
TomBod1: folds 
Uncalled bet ($4) returned to SkUhNi
SkUhNi collected $5.50 from pot
SkUhNi: doesn't show hand 
*** SUMMARY ***
Total pot $5.50 | Rake $0 
Seat 1: SkUhNi collected ($5.50)
Seat 2: ruslik_by (button) folded before Flop (didn't bet)
Seat 3: hammerwife (small blind) folded before Flop
Seat 4: mavin80 (big blind) folded before Flop
Seat 5: mi$$I$Elena folded before Flop (didn't bet)
Seat 6: 23SmOkEr07 folded before Flop (didn't bet)
Seat 7: matiko09 folded before Flop (didn't bet)
Seat 8: blackmont111 folded before Flop (didn't bet)
Seat 9: TomBod1 folded before Flop





PokerStars Hand #154970357049:  Hold'em No Limit (£0.25/£0.50 GBP) - 2016/06/20 12:37:03 CET [2016/06/20 6:37:03 ET]
Table 'Tesla' 6-max Seat #4 is the button
Seat 1: Rubleff85 (£46.99 in chips) 
Seat 2: matiko09 (£60.40 in chips) 
Seat 3: asmodej666 (£50 in chips) 
Seat 4: ILIUXa (£50 in chips) 
Seat 6: faceMyBallz_ (£50 in chips) 
faceMyBallz_: posts small blind £0.25
Rubleff85: posts big blind £0.50
*** HOLE CARDS ***
Dealt to matiko09 [Kc 4d]
matiko09: folds 
asmodej666: folds 
ILIUXa: raises £0.60 to £1.10
faceMyBallz_: raises £3.15 to £4.25
Rubleff85: folds 
ILIUXa: folds 
Uncalled bet (£3.15) returned to faceMyBallz_
faceMyBallz_ collected £2.70 from pot
faceMyBallz_: doesn't show hand 
Nego Razu joins the table at seat #5 
*** SUMMARY ***
Total pot £2.70 | Rake £0 
Seat 1: Rubleff85 (big blind) folded before Flop
Seat 2: matiko09 folded before Flop (didn't bet)
Seat 3: asmodej666 folded before Flop (didn't bet)
Seat 4: ILIUXa (button) folded before Flop
Seat 6: faceMyBallz_ (small blind) collected (£2.70)





PokerStars Hand #154970358123:  Hold'em No Limit (£0.25/£0.50 GBP) - 2016/06/20 12:37:06 CET [2016/06/20 6:37:06 ET]
Table 'Ani' 6-max Seat #6 is the button
Seat 1: rewq99887788 (£33.66 in chips) 
Seat 2: joker180785 (£56.61 in chips) 
Seat 3: Doobes8555 (£78.76 in chips) 
Seat 4: matiko09 (£53.14 in chips) 
Seat 5: Wwwasian (£59.27 in chips) 
Seat 6: faceMyBallz_ (£57.18 in chips) 
rewq99887788: posts small blind £0.25
joker180785: posts big blind £0.50
*** HOLE CARDS ***
Dealt to matiko09 [5d Ks]
Doobes8555: calls £0.50
matiko09: folds 
Wwwasian: folds 
faceMyBallz_: calls £0.50
rewq99887788: calls £0.25
joker180785: checks 
*** FLOP *** [6h Ad 3d]
rewq99887788: checks 
joker180785: checks 
Doobes8555: checks 
faceMyBallz_: checks 
*** TURN *** [6h Ad 3d] [8s]
rewq99887788: checks 
joker180785: checks 
Doobes8555: checks 
faceMyBallz_: checks 
*** RIVER *** [6h Ad 3d 8s] [6s]
rewq99887788: checks 
joker180785: checks 
Doobes8555: checks 
faceMyBallz_: checks 
*** SHOW DOWN ***
rewq99887788: shows [7s Kh] (a pair of Sixes)
joker180785: mucks hand 
Doobes8555: mucks hand 
faceMyBallz_: mucks hand 
rewq99887788 collected £1.90 from pot
*** SUMMARY ***
Total pot £2 | Rake £0.10 
Board [6h Ad 3d 8s 6s]
Seat 1: rewq99887788 (small blind) showed [7s Kh] and won (£1.90) with a pair of Sixes
Seat 2: joker180785 (big blind) mucked [4s 7d]
Seat 3: Doobes8555 mucked [Ts 9c]
Seat 4: matiko09 folded before Flop (didn't bet)
Seat 5: Wwwasian folded before Flop (didn't bet)
Seat 6: faceMyBallz_ (button) mucked [5h Qh]





PokerStars Hand #154970359690:  Hold'em No Limit ($0.50/$1.00 USD) - 2016/06/20 12:37:10 CET [2016/06/20 6:37:10 ET]
Table 'Ambrosia II' 9-max Seat #6 is the button
Seat 1: 23SmOkEr07 ($180.25 in chips) 
Seat 2: Eyeballz1307 ($14.84 in chips) 
Seat 3: mavin80 ($100 in chips) 
Seat 4: mi$$I$Elena ($213.80 in chips) 
Seat 5: Mattulh ($102.70 in chips) 
Seat 6: ruslik_by ($112.80 in chips) 
Seat 7: matiko09 ($100 in chips) 
Seat 8: hammerwife ($100 in chips) 
Seat 9: SkUhNi ($125.31 in chips) 
matiko09: posts small blind $0.50
hammerwife: posts big blind $1
*** HOLE CARDS ***
Dealt to matiko09 [5s 9h]
SkUhNi: raises $2 to $3
23SmOkEr07: folds 
Eyeballz1307: folds 
mavin80: calls $3
mi$$I$Elena: folds 
Mattulh: folds 
ruslik_by: folds 
matiko09: folds 
hammerwife: folds 
*** FLOP *** [As 7h 3s]
SkUhNi: bets $6
mavin80: folds 
Uncalled bet ($6) returned to SkUhNi
SkUhNi collected $7.12 from pot
SkUhNi: doesn't show hand 
*** SUMMARY ***
Total pot $7.50 | Rake $0.38 
Board [As 7h 3s]
Seat 1: 23SmOkEr07 folded before Flop (didn't bet)
Seat 2: Eyeballz1307 folded before Flop (didn't bet)
Seat 3: mavin80 folded on the Flop
Seat 4: mi$$I$Elena folded before Flop (didn't bet)
Seat 5: Mattulh folded before Flop (didn't bet)
Seat 6: ruslik_by (button) folded before Flop (didn't bet)
Seat 7: matiko09 (small blind) folded before Flop
Seat 8: hammerwife (big blind) folded before Flop
Seat 9: SkUhNi collected ($7.12)





PokerStars Hand #154970361454:  Hold'em No Limit (£0.25/£0.50 GBP) - 2016/06/20 12:37:15 CET [2016/06/20 6:37:15 ET]
Table 'Azalea' 6-max Seat #4 is the button
Seat 1: mitsuVK (£100.70 in chips) 
Seat 2: matiko09 (£87.99 in chips) 
Seat 3: VahTang_89 (£50.63 in chips) 
Seat 4: faceMyBallz_ (£50 in chips) 
Seat 5: mudders693 (£76.15 in chips) 
Seat 6: Bënedic10 (£50 in chips) 
mudders693: posts small blind £0.25
Bënedic10: posts big blind £0.50
*** HOLE CARDS ***
Dealt to matiko09 [7s 4s]
mitsuVK: folds 
matiko09: folds 
VahTang_89: folds 
faceMyBallz_: folds 
mudders693: calls £0.25
Bënedic10: checks 
*** FLOP *** [4c Kc 9h]
mudders693: checks 
Bënedic10: bets £0.50
mudders693: folds 
Uncalled bet (£0.50) returned to Bënedic10
Bënedic10 collected £0.95 from pot
Bënedic10: doesn't show hand 
*** SUMMARY ***
Total pot £1 | Rake £0.05 
Board [4c Kc 9h]
Seat 1: mitsuVK folded before Flop (didn't bet)
Seat 2: matiko09 folded before Flop (didn't bet)
Seat 3: VahTang_89 folded before Flop (didn't bet)
Seat 4: faceMyBallz_ (button) folded before Flop (didn't bet)
Seat 5: mudders693 (small blind) folded on the Flop
Seat 6: Bënedic10 (big blind) collected (£0.95)





PokerStars Hand #154970369582:  Hold'em No Limit ($0.25/$0.50 USD) - 2016/06/20 12:37:36 CET [2016/06/20 6:37:36 ET]
Table 'Scheddi II' 9-max Seat #9 is the button
Seat 1: matiko09 ($50 in chips) 
Seat 3: mi$$I$Elena ($94.50 in chips) 
Seat 4: GOOFA13 ($27.27 in chips) 
Seat 6: joker180785 ($61.13 in chips) 
Seat 7: HopeMayBee ($67.73 in chips) 
Seat 8: orochimaturi ($80 in chips) 
Seat 9: Infinitinium ($105.06 in chips) 
matiko09: posts small blind $0.25
Yaaaazz: is sitting out 
mi$$I$Elena: posts big blind $0.50
matiko09: posts the ante $0.10
mi$$I$Elena: posts the ante $0.10
GOOFA13: posts the ante $0.10
joker180785: posts the ante $0.10
HopeMayBee: posts the ante $0.10
orochimaturi: posts the ante $0.10
Infinitinium: posts the ante $0.10
*** HOLE CARDS ***
Dealt to matiko09 [As 7s]
GOOFA13: raises $0.50 to $1
joker180785: calls $1
HopeMayBee: calls $1
orochimaturi: folds 
Infinitinium: folds 
matiko09: folds 
mi$$I$Elena: folds 
*** FLOP *** [7d Ah 3h]
GOOFA13: checks 
joker180785: checks 
HopeMayBee: bets $3.50
GOOFA13: folds 
joker180785: folds 
Uncalled bet ($3.50) returned to HopeMayBee
HopeMayBee collected $4.23 from pot
HopeMayBee: doesn't show hand 
*** SUMMARY ***
Total pot $4.45 | Rake $0.22 
Board [7d Ah 3h]
Seat 1: matiko09 (small blind) folded before Flop
Seat 3: mi$$I$Elena (big blind) folded before Flop
Seat 4: GOOFA13 folded on the Flop
Seat 6: joker180785 folded on the Flop
Seat 7: HopeMayBee collected ($4.23)
Seat 8: orochimaturi folded before Flop (didn't bet)
Seat 9: Infinitinium (button) folded before Flop (didn't bet)





PokerStars Hand #154970369580:  Hold'em No Limit ($0.50/$1.00 USD) - 2016/06/20 12:37:36 CET [2016/06/20 6:37:36 ET]
Table 'Pongola' 9-max Seat #8 is the button
Seat 1: matiko09 ($100 in chips) 
Seat 2: ruslik_by ($136.27 in chips) 
Seat 3: SkUhNi ($100 in chips) 
Seat 4: karllv ($156.81 in chips) 
Seat 5: joker180785 ($107.43 in chips) 
Seat 6: 23SmOkEr07 ($115.71 in chips) 
Seat 7: Dickyxxx ($149.62 in chips) 
Seat 8: phrantique ($87.70 in chips) 
Seat 9: Filojoes ($100.50 in chips) 
Filojoes: posts small blind $0.50
matiko09: posts big blind $1
*** HOLE CARDS ***
Dealt to matiko09 [3d Qh]
ruslik_by: raises $2 to $3
SkUhNi: folds 
karllv: folds 
joker180785: folds 
23SmOkEr07: folds 
Dickyxxx: folds 
phrantique: folds 
Filojoes: folds 
matiko09: folds 
Uncalled bet ($2) returned to ruslik_by
ruslik_by collected $2.50 from pot
ruslik_by: doesn't show hand 
*** SUMMARY ***
Total pot $2.50 | Rake $0 
Seat 1: matiko09 (big blind) folded before Flop
Seat 2: ruslik_by collected ($2.50)
Seat 3: SkUhNi folded before Flop (didn't bet)
Seat 4: karllv folded before Flop (didn't bet)
Seat 5: joker180785 folded before Flop (didn't bet)
Seat 6: 23SmOkEr07 folded before Flop (didn't bet)
Seat 7: Dickyxxx folded before Flop (didn't bet)
Seat 8: phrantique (button) folded before Flop (didn't bet)
Seat 9: Filojoes (small blind) folded before Flop





PokerStars Hand #154970371733:  Hold'em No Limit (£0.25/£0.50 GBP) - 2016/06/20 12:37:41 CET [2016/06/20 6:37:41 ET]
Table 'Tesla' 6-max Seat #6 is the button
Seat 1: Rubleff85 (£46.49 in chips) 
Seat 2: matiko09 (£60.40 in chips) 
Seat 3: asmodej666 (£50 in chips) 
Seat 4: ILIUXa (£50 in chips) 
Seat 6: faceMyBallz_ (£51.60 in chips) 
Rubleff85: posts small blind £0.25
matiko09: posts big blind £0.50
Nego Razu: sits out 
*** HOLE CARDS ***
Dealt to matiko09 [9d 2d]
asmodej666: folds 
ILIUXa: folds 
faceMyBallz_: raises £0.50 to £1
Rubleff85: calls £0.75
matiko09: folds 
*** FLOP *** [Jh 3s 2c]
Rubleff85: checks 
faceMyBallz_: bets £1.25
Rubleff85: calls £1.25
*** TURN *** [Jh 3s 2c] [3h]
Rubleff85: checks 
faceMyBallz_: checks 
*** RIVER *** [Jh 3s 2c 3h] [Ah]
Rubleff85: bets £2.25
faceMyBallz_: calls £2.25
*** SHOW DOWN ***
Rubleff85: shows [4c Ad] (two pair, Aces and Threes)
faceMyBallz_: mucks hand 
Rubleff85 collected £9.02 from pot
*** SUMMARY ***
Total pot £9.50 | Rake £0.48 
Board [Jh 3s 2c 3h Ah]
Seat 1: Rubleff85 (small blind) showed [4c Ad] and won (£9.02) with two pair, Aces and Threes
Seat 2: matiko09 (big blind) folded before Flop
Seat 3: asmodej666 folded before Flop (didn't bet)
Seat 4: ILIUXa folded before Flop (didn't bet)
Seat 6: faceMyBallz_ (button) mucked [Kc Td]





PokerStars Hand #154970374122:  Hold'em No Limit ($0.50/$1.00 USD) - 2016/06/20 12:37:47 CET [2016/06/20 6:37:47 ET]
Table 'Isonoe II' 9-max Seat #7 is the button
Seat 1: hammerwife ($101.36 in chips) 
Seat 2: matiko09 ($109.52 in chips) 
Seat 3: Kukuryzka ($99.50 in chips) 
Seat 4: Avtovo ($100 in chips) 
Seat 5: Filojoes ($100 in chips) 
Seat 6: GOOFA13 ($74.46 in chips) 
Seat 7: SkUhNi ($100 in chips) 
Seat 8: lewyson ($68.01 in chips) 
Seat 9: djammusic ($54.48 in chips) 
lewyson: posts small blind $0.50
djammusic: posts big blind $1
*** HOLE CARDS ***
Dealt to matiko09 [4s 6h]
hammerwife: folds 
matiko09: folds 
Kukuryzka: folds 
Avtovo: folds 
Filojoes: folds 
GOOFA13: folds 
SkUhNi: folds 
lewyson: calls $0.50
djammusic: raises $3 to $4
lewyson: calls $3
*** FLOP *** [Ad Tc As]
lewyson: checks 
djammusic: bets $4.86
lewyson: calls $4.86
*** TURN *** [Ad Tc As] [Ac]
lewyson: checks 
djammusic: checks 
*** RIVER *** [Ad Tc As Ac] [2s]
lewyson: checks 
djammusic: checks 
*** SHOW DOWN ***
lewyson: shows [Qc Jd] (three of a kind, Aces)
djammusic: shows [9c 2c] (a full house, Aces full of Deuces)
djammusic collected $16.83 from pot
*** SUMMARY ***
Total pot $17.72 | Rake $0.89 
Board [Ad Tc As Ac 2s]
Seat 1: hammerwife folded before Flop (didn't bet)
Seat 2: matiko09 folded before Flop (didn't bet)
Seat 3: Kukuryzka folded before Flop (didn't bet)
Seat 4: Avtovo folded before Flop (didn't bet)
Seat 5: Filojoes folded before Flop (didn't bet)
Seat 6: GOOFA13 folded before Flop (didn't bet)
Seat 7: SkUhNi (button) folded before Flop (didn't bet)
Seat 8: lewyson (small blind) showed [Qc Jd] and lost with three of a kind, Aces
Seat 9: djammusic (big blind) showed [9c 2c] and won ($16.83) with a full house, Aces full of Deuces





PokerStars Hand #154970374784:  Hold'em No Limit (£0.25/£0.50 GBP) - 2016/06/20 12:37:49 CET [2016/06/20 6:37:49 ET]
Table 'Azalea' 6-max Seat #5 is the button
Seat 1: mitsuVK (£100.70 in chips) 
Seat 2: matiko09 (£87.99 in chips) 
Seat 3: VahTang_89 (£50.63 in chips) 
Seat 4: faceMyBallz_ (£50 in chips) 
Seat 5: mudders693 (£75.65 in chips) 
Seat 6: Bënedic10 (£50.45 in chips) 
Bënedic10: posts small blind £0.25
mitsuVK: posts big blind £0.50
*** HOLE CARDS ***
Dealt to matiko09 [Ac Kd]
matiko09: raises £1 to £1.50
VahTang_89: folds 
faceMyBallz_: folds 
mudders693: calls £1.50
Bënedic10: folds 
mitsuVK: folds 
*** FLOP *** [9d 3d 3c]
matiko09: checks 
mudders693: checks 
*** TURN *** [9d 3d 3c] [Qc]
matiko09: checks 
mudders693: bets £3.50
matiko09: folds 
Uncalled bet (£3.50) returned to mudders693
mudders693 collected £3.56 from pot
mudders693: doesn't show hand 
*** SUMMARY ***
Total pot £3.75 | Rake £0.19 
Board [9d 3d 3c Qc]
Seat 1: mitsuVK (big blind) folded before Flop
Seat 2: matiko09 folded on the Turn
Seat 3: VahTang_89 folded before Flop (didn't bet)
Seat 4: faceMyBallz_ folded before Flop (didn't bet)
Seat 5: mudders693 (button) collected (£3.56)
Seat 6: Bënedic10 (small blind) folded before Flop





PokerStars Hand #154970380252:  Hold'em No Limit ($0.50/$1.00 USD) - 2016/06/20 12:38:03 CET [2016/06/20 6:38:03 ET]
Table 'Pongola' 9-max Seat #9 is the button
Seat 1: matiko09 ($100 in chips) 
Seat 2: ruslik_by ($137.77 in chips) 
Seat 3: SkUhNi ($100 in chips) 
Seat 4: karllv ($156.81 in chips) 
Seat 5: joker180785 ($107.43 in chips) 
Seat 6: 23SmOkEr07 ($115.71 in chips) 
Seat 7: Dickyxxx ($149.62 in chips) 
Seat 8: phrantique ($87.70 in chips) 
Seat 9: Filojoes ($100 in chips) 
matiko09: posts small blind $0.50
ruslik_by: posts big blind $1
*** HOLE CARDS ***
Dealt to matiko09 [9h Ac]
SkUhNi: raises $2 to $3
karllv: folds 
joker180785: folds 
23SmOkEr07: calls $3
Dickyxxx: folds 
phrantique: calls $3
Filojoes: calls $3
matiko09: folds 
ruslik_by: calls $2
*** FLOP *** [Qd Tc 9c]
ruslik_by: checks 
SkUhNi: checks 
23SmOkEr07: checks 
phrantique: checks 
Filojoes: checks 
*** TURN *** [Qd Tc 9c] [Kd]
ruslik_by: bets $5
SkUhNi: raises $25 to $30
23SmOkEr07: folds 
phrantique: folds 
Filojoes: folds 
ruslik_by: folds 
Uncalled bet ($25) returned to SkUhNi
SkUhNi collected $24.22 from pot
SkUhNi: doesn't show hand 
*** SUMMARY ***
Total pot $25.50 | Rake $1.28 
Board [Qd Tc 9c Kd]
Seat 1: matiko09 (small blind) folded before Flop
Seat 2: ruslik_by (big blind) folded on the Turn
Seat 3: SkUhNi collected ($24.22)
Seat 4: karllv folded before Flop (didn't bet)
Seat 5: joker180785 folded before Flop (didn't bet)
Seat 6: 23SmOkEr07 folded on the Turn
Seat 7: Dickyxxx folded before Flop (didn't bet)
Seat 8: phrantique folded on the Turn
Seat 9: Filojoes (button) folded on the Turn





PokerStars Hand #154970383007:  Hold'em No Limit ($0.50/$1.00 USD) - 2016/06/20 12:38:11 CET [2016/06/20 6:38:11 ET]
Table 'Ernestina' 9-max Seat #4 is the button
Seat 1: diva3150 ($147.12 in chips) 
Seat 2: matiko09 ($100 in chips) 
Seat 3: Pvsx. ($169.07 in chips) 
Seat 4: SkUhNi ($102.02 in chips) 
Seat 5: Dickyxxx ($114.61 in chips) 
Seat 6: arctur17 ($79.29 in chips) 
Seat 8: ruslik_by ($266.24 in chips) 
Seat 9: 23SmOkEr07 ($103 in chips) 
Dickyxxx: posts small blind $0.50
arctur17: posts big blind $1
djammusic: sits out 
*** HOLE CARDS ***
Dealt to matiko09 [5s Ac]
ruslik_by: folds 
23SmOkEr07: folds 
diva3150: folds 
matiko09: folds 
Pvsx.: folds 
SkUhNi: folds 
Dickyxxx: raises $2 to $3
arctur17: folds 
Uncalled bet ($2) returned to Dickyxxx
Dickyxxx collected $2 from pot
Dickyxxx: doesn't show hand 
*** SUMMARY ***
Total pot $2 | Rake $0 
Seat 1: diva3150 folded before Flop (didn't bet)
Seat 2: matiko09 folded before Flop (didn't bet)
Seat 3: Pvsx. folded before Flop (didn't bet)
Seat 4: SkUhNi (button) folded before Flop (didn't bet)
Seat 5: Dickyxxx (small blind) collected ($2)
Seat 6: arctur17 (big blind) folded before Flop
Seat 8: ruslik_by folded before Flop (didn't bet)
Seat 9: 23SmOkEr07 folded before Flop (didn't bet)





PokerStars Hand #154970383204:  Hold'em No Limit ($0.50/$1.00 USD) - 2016/06/20 12:38:11 CET [2016/06/20 6:38:11 ET]
Table 'Anhui' 9-max Seat #3 is the button
Seat 1: SkUhNi ($150.42 in chips) 
Seat 2: ruslik_by ($274.18 in chips) 
Seat 3: hammerwife ($101.78 in chips) 
Seat 4: mavin80 ($35.06 in chips) 
Seat 5: mi$$I$Elena ($114.80 in chips) 
Seat 6: 23SmOkEr07 ($131.75 in chips) 
Seat 7: matiko09 ($138.38 in chips) 
Seat 8: blackmont111 ($76 in chips) 
Seat 9: TomBod1 ($81.57 in chips) 
mavin80: posts small blind $0.50
mi$$I$Elena: posts big blind $1
*** HOLE CARDS ***
Dealt to matiko09 [6s 9c]
23SmOkEr07: folds 
matiko09: folds 
blackmont111: folds 
TomBod1: calls $1
SkUhNi: raises $3 to $4
ruslik_by: folds 
hammerwife: folds 
mavin80: calls $3.50
mi$$I$Elena: folds 
TomBod1: folds 
*** FLOP *** [2s Jc 2h]
mavin80: checks 
SkUhNi: bets $6
mavin80: folds 
Uncalled bet ($6) returned to SkUhNi
SkUhNi collected $9.50 from pot
SkUhNi: doesn't show hand 
*** SUMMARY ***
Total pot $10 | Rake $0.50 
Board [2s Jc 2h]
Seat 1: SkUhNi collected ($9.50)
Seat 2: ruslik_by folded before Flop (didn't bet)
Seat 3: hammerwife (button) folded before Flop (didn't bet)
Seat 4: mavin80 (small blind) folded on the Flop
Seat 5: mi$$I$Elena (big blind) folded before Flop
Seat 6: 23SmOkEr07 folded before Flop (didn't bet)
Seat 7: matiko09 folded before Flop (didn't bet)
Seat 8: blackmont111 folded before Flop (didn't bet)
Seat 9: TomBod1 folded before Flop





PokerStars Hand #154970383987:  Hold'em No Limit ($0.50/$1.00 USD) - 2016/06/20 12:38:13 CET [2016/06/20 6:38:13 ET]
Table 'Ambrosia II' 9-max Seat #7 is the button
Seat 1: 23SmOkEr07 ($180.25 in chips) 
Seat 2: Eyeballz1307 ($14.84 in chips) 
Seat 3: mavin80 ($97 in chips) 
Seat 4: mi$$I$Elena ($213.80 in chips) 
Seat 5: Mattulh ($102.70 in chips) 
Seat 6: ruslik_by ($112.80 in chips) 
Seat 7: matiko09 ($100 in chips) 
Seat 8: hammerwife ($100 in chips) 
Seat 9: SkUhNi ($129.43 in chips) 
hammerwife: posts small blind $0.50
SkUhNi: posts big blind $1
*** HOLE CARDS ***
Dealt to matiko09 [Jc 2s]
23SmOkEr07: folds 
Eyeballz1307: raises $13.84 to $14.84 and is all-in
mavin80: folds 
mi$$I$Elena: folds 
Mattulh: folds 
ruslik_by: folds 
matiko09: folds 
hammerwife: folds 
SkUhNi: folds 
Uncalled bet ($13.84) returned to Eyeballz1307
Eyeballz1307 collected $2.50 from pot
Eyeballz1307: doesn't show hand 
*** SUMMARY ***
Total pot $2.50 | Rake $0 
Seat 1: 23SmOkEr07 folded before Flop (didn't bet)
Seat 2: Eyeballz1307 collected ($2.50)
Seat 3: mavin80 folded before Flop (didn't bet)
Seat 4: mi$$I$Elena folded before Flop (didn't bet)
Seat 5: Mattulh folded before Flop (didn't bet)
Seat 6: ruslik_by folded before Flop (didn't bet)
Seat 7: matiko09 (button) folded before Flop (didn't bet)
Seat 8: hammerwife (small blind) folded before Flop
Seat 9: SkUhNi (big blind) folded before Flop





PokerStars Hand #154970386842:  Hold'em No Limit (£0.25/£0.50 GBP) - 2016/06/20 12:38:20 CET [2016/06/20 6:38:20 ET]
Table 'Ani' 6-max Seat #1 is the button
Seat 1: rewq99887788 (£35.06 in chips) 
Seat 2: joker180785 (£56.11 in chips) 
Seat 3: Doobes8555 (£78.26 in chips) 
Seat 4: matiko09 (£53.14 in chips) 
Seat 5: Wwwasian (£59.27 in chips) 
Seat 6: faceMyBallz_ (£56.68 in chips) 
joker180785: posts small blind £0.25
Doobes8555: posts big blind £0.50
*** HOLE CARDS ***
Dealt to matiko09 [8h 2c]
matiko09: folds 
Wwwasian: folds 
faceMyBallz_: raises £0.50 to £1
rewq99887788: calls £1
joker180785: raises £4 to £5
Doobes8555: folds 
faceMyBallz_: folds 
rewq99887788: folds 
Uncalled bet (£4) returned to joker180785
joker180785 collected £3.50 from pot
*** SUMMARY ***
Total pot £3.50 | Rake £0 
Seat 1: rewq99887788 (button) folded before Flop
Seat 2: joker180785 (small blind) collected (£3.50)
Seat 3: Doobes8555 (big blind) folded before Flop
Seat 4: matiko09 folded before Flop (didn't bet)
Seat 5: Wwwasian folded before Flop (didn't bet)
Seat 6: faceMyBallz_ folded before Flop





PokerStars Hand #154970387905:  Hold'em No Limit ($0.50/$1.00 USD) - 2016/06/20 12:38:23 CET [2016/06/20 6:38:23 ET]
Table 'Ernestina' 9-max Seat #5 is the button
Seat 1: diva3150 ($147.12 in chips) 
Seat 2: matiko09 ($100 in chips) 
Seat 3: Pvsx. ($169.07 in chips) 
Seat 4: SkUhNi ($102.02 in chips) 
Seat 5: Dickyxxx ($115.61 in chips) 
Seat 6: arctur17 ($78.29 in chips) 
Seat 7: djammusic ($40 in chips) 
Seat 8: ruslik_by ($266.24 in chips) 
Seat 9: 23SmOkEr07 ($103 in chips) 
arctur17: posts small blind $0.50
djammusic: posts big blind $1
*** HOLE CARDS ***
Dealt to matiko09 [9h Jh]
ruslik_by: folds 
23SmOkEr07: folds 
diva3150: folds 
matiko09: folds 
Pvsx.: folds 
SkUhNi: folds 
Dickyxxx: folds 
arctur17: folds 
Uncalled bet ($0.50) returned to djammusic
djammusic collected $1 from pot
djammusic: doesn't show hand 
*** SUMMARY ***
Total pot $1 | Rake $0 
Seat 1: diva3150 folded before Flop (didn't bet)
Seat 2: matiko09 folded before Flop (didn't bet)
Seat 3: Pvsx. folded before Flop (didn't bet)
Seat 4: SkUhNi folded before Flop (didn't bet)
Seat 5: Dickyxxx (button) folded before Flop (didn't bet)
Seat 6: arctur17 (small blind) folded before Flop
Seat 7: djammusic (big blind) collected ($1)
Seat 8: ruslik_by folded before Flop (didn't bet)
Seat 9: 23SmOkEr07 folded before Flop (didn't bet)





PokerStars Hand #154970387793:  Hold'em No Limit ($0.50/$1.00 USD) - 2016/06/20 12:38:23 CET [2016/06/20 6:38:23 ET]
Table 'Annika' 9-max Seat #6 is the button
Seat 1: hammerwife ($134.27 in chips) 
Seat 2: matiko09 ($100 in chips) 
Seat 3: first_dnk ($85.50 in chips) 
Seat 4: Kukuryzka ($108.50 in chips) 
Seat 5: SkUhNi ($115.10 in chips) 
Seat 6: Pvsx. ($112.55 in chips) 
Seat 7: jirka117 ($54.54 in chips) 
Seat 8: ruslik_by ($107.90 in chips) 
Seat 9: 23SmOkEr07 ($100 in chips) 
jirka117: posts small blind $0.50
ruslik_by: posts big blind $1
*** HOLE CARDS ***
Dealt to matiko09 [Kc Qc]
23SmOkEr07: raises $1.50 to $2.50
hammerwife: folds 
matiko09: calls $2.50
first_dnk: folds 
Kukuryzka: folds 
SkUhNi: raises $8.50 to $11
Pvsx.: folds 
jirka117: folds 
ruslik_by: folds 
23SmOkEr07: folds 
matiko09: folds 
Uncalled bet ($8.50) returned to SkUhNi
SkUhNi collected $9 from pot
SkUhNi: doesn't show hand 
*** SUMMARY ***
Total pot $9 | Rake $0 
Seat 1: hammerwife folded before Flop (didn't bet)
Seat 2: matiko09 folded before Flop
Seat 3: first_dnk folded before Flop (didn't bet)
Seat 4: Kukuryzka folded before Flop (didn't bet)
Seat 5: SkUhNi collected ($9)
Seat 6: Pvsx. (button) folded before Flop (didn't bet)
Seat 7: jirka117 (small blind) folded before Flop
Seat 8: ruslik_by (big blind) folded before Flop
Seat 9: 23SmOkEr07 folded before Flop





PokerStars Hand #154970390909:  Hold'em No Limit (£0.25/£0.50 GBP) - 2016/06/20 12:38:30 CET [2016/06/20 6:38:30 ET]
Table 'Azalea' 6-max Seat #6 is the button
Seat 1: mitsuVK (£100.20 in chips) 
Seat 2: matiko09 (£86.49 in chips) 
Seat 3: VahTang_89 (£50.63 in chips) 
Seat 4: faceMyBallz_ (£50 in chips) 
Seat 5: mudders693 (£77.71 in chips) 
Seat 6: Bënedic10 (£50.20 in chips) 
mitsuVK: posts small blind £0.25
matiko09: posts big blind £0.50
*** HOLE CARDS ***
Dealt to matiko09 [8d Jc]
VahTang_89: raises £0.50 to £1
faceMyBallz_: folds 
mudders693: raises £0.50 to £1.50
Bënedic10: folds 
mitsuVK: folds 
matiko09: folds 
VahTang_89: calls £0.50
*** FLOP *** [3d 6c 9c]
VahTang_89: checks 
mudders693: checks 
*** TURN *** [3d 6c 9c] [8c]
VahTang_89: bets £2.03
mudders693: calls £2.03
*** RIVER *** [3d 6c 9c 8c] [6d]
VahTang_89: bets £3.71
mudders693: folds 
Uncalled bet (£3.71) returned to VahTang_89
VahTang_89 collected £7.42 from pot
VahTang_89: doesn't show hand 
*** SUMMARY ***
Total pot £7.81 | Rake £0.39 
Board [3d 6c 9c 8c 6d]
Seat 1: mitsuVK (small blind) folded before Flop
Seat 2: matiko09 (big blind) folded before Flop
Seat 3: VahTang_89 collected (£7.42)
Seat 4: faceMyBallz_ folded before Flop (didn't bet)
Seat 5: mudders693 folded on the River
Seat 6: Bënedic10 (button) folded before Flop (didn't bet)





PokerStars Hand #154970392108:  Hold'em No Limit ($0.25/$0.50 USD) - 2016/06/20 12:38:33 CET [2016/06/20 6:38:33 ET]
Table 'Scheddi II' 9-max Seat #1 is the button
Seat 1: matiko09 ($50 in chips) 
Seat 3: mi$$I$Elena ($93.90 in chips) 
Seat 4: GOOFA13 ($26.17 in chips) 
Seat 6: joker180785 ($60.03 in chips) 
Seat 7: HopeMayBee ($70.86 in chips) 
Seat 8: orochimaturi ($79.90 in chips) 
Seat 9: Infinitinium ($104.96 in chips) 
mi$$I$Elena: posts small blind $0.25
GOOFA13: posts big blind $0.50
matiko09: posts the ante $0.10
mi$$I$Elena: posts the ante $0.10
GOOFA13: posts the ante $0.10
joker180785: posts the ante $0.10
HopeMayBee: posts the ante $0.10
orochimaturi: posts the ante $0.10
Infinitinium: posts the ante $0.10
*** HOLE CARDS ***
Dealt to matiko09 [Tc 2h]
joker180785: raises $1 to $1.50
HopeMayBee: calls $1.50
orochimaturi: folds 
Infinitinium: folds 
matiko09: folds 
mi$$I$Elena: folds 
GOOFA13: calls $1
*** FLOP *** [Qd 3c 4d]
GOOFA13: checks 
joker180785: checks 
HopeMayBee: checks 
*** TURN *** [Qd 3c 4d] [6d]
zarplatka joins the table at seat #5 
GOOFA13: bets $2.50
joker180785: raises $7.83 to $10.33
HopeMayBee: folds 
GOOFA13: calls $7.83
*** RIVER *** [Qd 3c 4d 6d] [Ad]
GOOFA13: bets $14.24 and is all-in
joker180785: folds 
Uncalled bet ($14.24) returned to GOOFA13
GOOFA13 collected $24.80 from pot
GOOFA13: doesn't show hand 
*** SUMMARY ***
Total pot $26.11 | Rake $1.31 
Board [Qd 3c 4d 6d Ad]
Seat 1: matiko09 (button) folded before Flop (didn't bet)
Seat 3: mi$$I$Elena (small blind) folded before Flop
Seat 4: GOOFA13 (big blind) collected ($24.80)
Seat 6: joker180785 folded on the River
Seat 7: HopeMayBee folded on the Turn
Seat 8: orochimaturi folded before Flop (didn't bet)
Seat 9: Infinitinium folded before Flop (didn't bet)





PokerStars Hand #154970392785:  Hold'em No Limit ($0.50/$1.00 USD) - 2016/06/20 12:38:35 CET [2016/06/20 6:38:35 ET]
Table 'Ernestina' 9-max Seat #6 is the button
Seat 1: diva3150 ($147.12 in chips) 
Seat 2: matiko09 ($100 in chips) 
Seat 3: Pvsx. ($169.07 in chips) 
Seat 4: SkUhNi ($102.02 in chips) 
Seat 5: Dickyxxx ($115.61 in chips) 
Seat 6: arctur17 ($77.79 in chips) 
Seat 7: djammusic ($40.50 in chips) 
Seat 8: ruslik_by ($266.24 in chips) 
Seat 9: 23SmOkEr07 ($103 in chips) 
djammusic: posts small blind $0.50
ruslik_by: posts big blind $1
*** HOLE CARDS ***
Dealt to matiko09 [6d 4h]
23SmOkEr07: folds 
diva3150: folds 
matiko09: folds 
Pvsx.: folds 
SkUhNi: folds 
Dickyxxx: folds 
arctur17: folds 
djammusic: folds 
Uncalled bet ($0.50) returned to ruslik_by
ruslik_by collected $1 from pot
ruslik_by: doesn't show hand 
*** SUMMARY ***
Total pot $1 | Rake $0 
Seat 1: diva3150 folded before Flop (didn't bet)
Seat 2: matiko09 folded before Flop (didn't bet)
Seat 3: Pvsx. folded before Flop (didn't bet)
Seat 4: SkUhNi folded before Flop (didn't bet)
Seat 5: Dickyxxx folded before Flop (didn't bet)
Seat 6: arctur17 (button) folded before Flop (didn't bet)
Seat 7: djammusic (small blind) folded before Flop
Seat 8: ruslik_by (big blind) collected ($1)
Seat 9: 23SmOkEr07 folded before Flop (didn't bet)





PokerStars Hand #154970394863:  Hold'em No Limit (£0.25/£0.50 GBP) - 2016/06/20 12:38:40 CET [2016/06/20 6:38:40 ET]
Table 'Tesla' 6-max Seat #1 is the button
Seat 1: Rubleff85 (£51.01 in chips) 
Seat 2: matiko09 (£59.90 in chips) 
Seat 3: asmodej666 (£50 in chips) 
Seat 4: ILIUXa (£50 in chips) 
Seat 6: faceMyBallz_ (£50 in chips) 
matiko09: posts small blind £0.25
asmodej666: posts big blind £0.50
Nego Razu: sits out 
*** HOLE CARDS ***
Dealt to matiko09 [7s 3s]
ILIUXa: folds 
faceMyBallz_: folds 
Rubleff85: folds 
matiko09: folds 
Uncalled bet (£0.25) returned to asmodej666
asmodej666 collected £0.50 from pot
asmodej666: doesn't show hand 
*** SUMMARY ***
Total pot £0.50 | Rake £0 
Seat 1: Rubleff85 (button) folded before Flop (didn't bet)
Seat 2: matiko09 (small blind) folded before Flop
Seat 3: asmodej666 (big blind) collected (£0.50)
Seat 4: ILIUXa folded before Flop (didn't bet)
Seat 6: faceMyBallz_ folded before Flop (didn't bet)





PokerStars Hand #154970395247:  Hold'em No Limit ($0.50/$1.00 USD) - 2016/06/20 12:38:41 CET [2016/06/20 6:38:41 ET]
Table 'Isonoe II' 9-max Seat #8 is the button
Seat 1: hammerwife ($101.36 in chips) 
Seat 2: matiko09 ($109.52 in chips) 
Seat 3: Kukuryzka ($99.50 in chips) 
Seat 4: Avtovo ($100 in chips) 
Seat 5: Filojoes ($100 in chips) 
Seat 6: GOOFA13 ($74.46 in chips) 
Seat 7: SkUhNi ($100 in chips) 
Seat 8: lewyson ($59.15 in chips) 
Seat 9: djammusic ($62.45 in chips) 
djammusic: posts small blind $0.50
hammerwife: posts big blind $1
*** HOLE CARDS ***
Dealt to matiko09 [5c Qd]
matiko09: folds 
Kukuryzka: folds 
Avtovo: raises $1.50 to $2.50
Filojoes: folds 
GOOFA13: calls $2.50
SkUhNi: folds 
lewyson: folds 
djammusic: folds 
hammerwife: raises $10.50 to $13
Avtovo: folds 
GOOFA13: folds 
Uncalled bet ($10.50) returned to hammerwife
hammerwife collected $8 from pot
hammerwife: doesn't show hand 
*** SUMMARY ***
Total pot $8 | Rake $0 
Seat 1: hammerwife (big blind) collected ($8)
Seat 2: matiko09 folded before Flop (didn't bet)
Seat 3: Kukuryzka folded before Flop (didn't bet)
Seat 4: Avtovo folded before Flop
Seat 5: Filojoes folded before Flop (didn't bet)
Seat 6: GOOFA13 folded before Flop
Seat 7: SkUhNi folded before Flop (didn't bet)
Seat 8: lewyson (button) folded before Flop (didn't bet)
Seat 9: djammusic (small blind) folded before Flop





PokerStars Hand #154970395111:  Hold'em No Limit ($0.50/$1.00 USD) - 2016/06/20 12:38:41 CET [2016/06/20 6:38:41 ET]
Table 'Ambrosia II' 9-max Seat #8 is the button
Seat 1: 23SmOkEr07 ($180.25 in chips) 
Seat 2: Eyeballz1307 ($16.34 in chips) 
Seat 3: mavin80 ($97 in chips) 
Seat 4: mi$$I$Elena ($213.80 in chips) 
Seat 5: Mattulh ($102.70 in chips) 
Seat 6: ruslik_by ($112.80 in chips) 
Seat 7: matiko09 ($100 in chips) 
Seat 8: hammerwife ($100 in chips) 
Seat 9: SkUhNi ($128.43 in chips) 
SkUhNi: posts small blind $0.50
23SmOkEr07: posts big blind $1
*** HOLE CARDS ***
Dealt to matiko09 [3d Ah]
Eyeballz1307: folds 
mavin80: raises $1.50 to $2.50
mi$$I$Elena: folds 
Mattulh: folds 
ruslik_by: folds 
matiko09: folds 
hammerwife: folds 
SkUhNi: folds 
23SmOkEr07: folds 
Uncalled bet ($1.50) returned to mavin80
mavin80 collected $2.50 from pot
*** SUMMARY ***
Total pot $2.50 | Rake $0 
Seat 1: 23SmOkEr07 (big blind) folded before Flop
Seat 2: Eyeballz1307 folded before Flop (didn't bet)
Seat 3: mavin80 collected ($2.50)
Seat 4: mi$$I$Elena folded before Flop (didn't bet)
Seat 5: Mattulh folded before Flop (didn't bet)
Seat 6: ruslik_by folded before Flop (didn't bet)
Seat 7: matiko09 folded before Flop (didn't bet)
Seat 8: hammerwife (button) folded before Flop (didn't bet)
Seat 9: SkUhNi (small blind) folded before Flop





PokerStars Hand #154970400052:  Hold'em No Limit ($0.50/$1.00 USD) - 2016/06/20 12:38:54 CET [2016/06/20 6:38:54 ET]
Table 'Ernestina' 9-max Seat #7 is the button
Seat 1: diva3150 ($147.12 in chips) 
Seat 2: matiko09 ($100 in chips) 
Seat 3: Pvsx. ($169.07 in chips) 
Seat 4: SkUhNi ($102.02 in chips) 
Seat 5: Dickyxxx ($115.61 in chips) 
Seat 6: arctur17 ($77.79 in chips) 
Seat 7: djammusic ($40 in chips) 
Seat 8: ruslik_by ($266.74 in chips) 
Seat 9: 23SmOkEr07 ($103 in chips) 
ruslik_by: posts small blind $0.50
23SmOkEr07: posts big blind $1
*** HOLE CARDS ***
Dealt to matiko09 [7d 3h]
diva3150: folds 
matiko09: folds 
Pvsx.: folds 
SkUhNi: folds 
Dickyxxx: folds 
arctur17: folds 
djammusic: folds 
ruslik_by: folds 
Uncalled bet ($0.50) returned to 23SmOkEr07
23SmOkEr07 collected $1 from pot
23SmOkEr07: doesn't show hand 
*** SUMMARY ***
Total pot $1 | Rake $0 
Seat 1: diva3150 folded before Flop (didn't bet)
Seat 2: matiko09 folded before Flop (didn't bet)
Seat 3: Pvsx. folded before Flop (didn't bet)
Seat 4: SkUhNi folded before Flop (didn't bet)
Seat 5: Dickyxxx folded before Flop (didn't bet)
Seat 6: arctur17 folded before Flop (didn't bet)
Seat 7: djammusic (button) folded before Flop (didn't bet)
Seat 8: ruslik_by (small blind) folded before Flop
Seat 9: 23SmOkEr07 (big blind) collected ($1)





PokerStars Hand #154970400514:  Hold'em No Limit (£0.25/£0.50 GBP) - 2016/06/20 12:38:55 CET [2016/06/20 6:38:55 ET]
Table 'Tesla' 6-max Seat #2 is the button
Seat 1: Rubleff85 (£51.01 in chips) 
Seat 2: matiko09 (£59.65 in chips) 
Seat 3: asmodej666 (£50.25 in chips) 
Seat 4: ILIUXa (£50 in chips) 
Seat 6: faceMyBallz_ (£50 in chips) 
asmodej666: posts small blind £0.25
ILIUXa: posts big blind £0.50
Nego Razu: sits out 
*** HOLE CARDS ***
Dealt to matiko09 [4c 2d]
faceMyBallz_: folds 
Rubleff85: folds 
matiko09: folds 
asmodej666: raises £1 to £1.50
ILIUXa: calls £1
*** FLOP *** [4s 9c 8h]
asmodej666: bets £2
ILIUXa: calls £2
*** TURN *** [4s 9c 8h] [8c]
asmodej666: checks 
ILIUXa: bets £4.66
asmodej666: folds 
Uncalled bet (£4.66) returned to ILIUXa
ILIUXa collected £6.65 from pot
ILIUXa: doesn't show hand 
*** SUMMARY ***
Total pot £7 | Rake £0.35 
Board [4s 9c 8h 8c]
Seat 1: Rubleff85 folded before Flop (didn't bet)
Seat 2: matiko09 (button) folded before Flop (didn't bet)
Seat 3: asmodej666 (small blind) folded on the Turn
Seat 4: ILIUXa (big blind) collected (£6.65)
Seat 6: faceMyBallz_ folded before Flop (didn't bet)





PokerStars Hand #154970404528:  Hold'em No Limit ($0.50/$1.00 USD) - 2016/06/20 12:39:05 CET [2016/06/20 6:39:05 ET]
Table 'Annika' 9-max Seat #7 is the button
Seat 1: hammerwife ($134.27 in chips) 
Seat 2: matiko09 ($100 in chips) 
Seat 3: first_dnk ($85.50 in chips) 
Seat 4: Kukuryzka ($108.50 in chips) 
Seat 5: SkUhNi ($121.60 in chips) 
Seat 6: Pvsx. ($112.55 in chips) 
Seat 7: jirka117 ($54.04 in chips) 
Seat 8: ruslik_by ($106.90 in chips) 
Seat 9: 23SmOkEr07 ($100 in chips) 
ruslik_by: posts small blind $0.50
23SmOkEr07: posts big blind $1
*** HOLE CARDS ***
Dealt to matiko09 [3s Jd]
hammerwife: folds 
matiko09: folds 
first_dnk: folds 
Kukuryzka: folds 
SkUhNi: raises $2 to $3
Pvsx.: folds 
jirka117: calls $3
ruslik_by: folds 
23SmOkEr07: folds 
*** FLOP *** [4h 9h Kh]
SkUhNi: checks 
jirka117: checks 
*** TURN *** [4h 9h Kh] [Th]
SkUhNi: checks 
jirka117: checks 
*** RIVER *** [4h 9h Kh Th] [8h]
SkUhNi: bets $3
jirka117: calls $3
*** SHOW DOWN ***
SkUhNi: shows [Ad Qd] (a flush, King high)
jirka117: shows [Qc 6c] (a flush, King high)
SkUhNi collected $6.41 from pot
jirka117 collected $6.41 from pot
*** SUMMARY ***
Total pot $13.50 | Rake $0.68 
Board [4h 9h Kh Th 8h]
Seat 1: hammerwife folded before Flop (didn't bet)
Seat 2: matiko09 folded before Flop (didn't bet)
Seat 3: first_dnk folded before Flop (didn't bet)
Seat 4: Kukuryzka folded before Flop (didn't bet)
Seat 5: SkUhNi showed [Ad Qd] and won ($6.41) with a flush, King high
Seat 6: Pvsx. folded before Flop (didn't bet)
Seat 7: jirka117 (button) showed [Qc 6c] and won ($6.41) with a flush, King high
Seat 8: ruslik_by (small blind) folded before Flop
Seat 9: 23SmOkEr07 (big blind) folded before Flop





PokerStars Hand #154970404623:  Hold'em No Limit (£0.25/£0.50 GBP) - 2016/06/20 12:39:05 CET [2016/06/20 6:39:05 ET]
Table 'Ani' 6-max Seat #2 is the button
Seat 1: rewq99887788 (£34.06 in chips) 
Seat 2: joker180785 (£58.61 in chips) 
Seat 3: Doobes8555 (£77.76 in chips) 
Seat 4: matiko09 (£53.14 in chips) 
Seat 5: Wwwasian (£59.27 in chips) 
Seat 6: faceMyBallz_ (£55.68 in chips) 
Doobes8555: posts small blind £0.25
matiko09: posts big blind £0.50
*** HOLE CARDS ***
Dealt to matiko09 [3d 6d]
Wwwasian: folds 
faceMyBallz_: folds 
rewq99887788: folds 
joker180785: folds 
Doobes8555: folds 
Uncalled bet (£0.25) returned to matiko09
matiko09 collected £0.50 from pot
matiko09: doesn't show hand 
*** SUMMARY ***
Total pot £0.50 | Rake £0 
Seat 1: rewq99887788 folded before Flop (didn't bet)
Seat 2: joker180785 (button) folded before Flop (didn't bet)
Seat 3: Doobes8555 (small blind) folded before Flop
Seat 4: matiko09 (big blind) collected (£0.50)
Seat 5: Wwwasian folded before Flop (didn't bet)
Seat 6: faceMyBallz_ folded before Flop (didn't bet)





PokerStars Hand #154970405947:  Hold'em No Limit ($0.50/$1.00 USD) - 2016/06/20 12:39:09 CET [2016/06/20 6:39:09 ET]
Table 'Ambrosia II' 9-max Seat #9 is the button
Seat 1: 23SmOkEr07 ($179.25 in chips) 
Seat 2: Eyeballz1307 ($16.34 in chips) 
Seat 3: mavin80 ($98.50 in chips) 
Seat 4: mi$$I$Elena ($213.80 in chips) 
Seat 5: Mattulh ($102.70 in chips) 
Seat 6: ruslik_by ($112.80 in chips) 
Seat 7: matiko09 ($100 in chips) 
Seat 8: hammerwife ($100 in chips) 
Seat 9: SkUhNi ($127.93 in chips) 
23SmOkEr07: posts small blind $0.50
Eyeballz1307: posts big blind $1
*** HOLE CARDS ***
Dealt to matiko09 [5s Jh]
mavin80: folds 
mi$$I$Elena: folds 
Mattulh: folds 
ruslik_by: folds 
matiko09: folds 
hammerwife: folds 
SkUhNi: raises $1 to $2
23SmOkEr07: calls $1.50
Eyeballz1307: raises $14.34 to $16.34 and is all-in
SkUhNi: folds 
23SmOkEr07: folds 
Uncalled bet ($14.34) returned to Eyeballz1307
Eyeballz1307 collected $6 from pot
Eyeballz1307: doesn't show hand 
*** SUMMARY ***
Total pot $6 | Rake $0 
Seat 1: 23SmOkEr07 (small blind) folded before Flop
Seat 2: Eyeballz1307 (big blind) collected ($6)
Seat 3: mavin80 folded before Flop (didn't bet)
Seat 4: mi$$I$Elena folded before Flop (didn't bet)
Seat 5: Mattulh folded before Flop (didn't bet)
Seat 6: ruslik_by folded before Flop (didn't bet)
Seat 7: matiko09 folded before Flop (didn't bet)
Seat 8: hammerwife folded before Flop (didn't bet)
Seat 9: SkUhNi (button) folded before Flop





PokerStars Hand #154970408461:  Hold'em No Limit ($0.50/$1.00 USD) - 2016/06/20 12:39:15 CET [2016/06/20 6:39:15 ET]
Table 'Ernestina' 9-max Seat #8 is the button
Seat 1: diva3150 ($147.12 in chips) 
Seat 2: matiko09 ($100 in chips) 
Seat 3: Pvsx. ($169.07 in chips) 
Seat 4: SkUhNi ($102.02 in chips) 
Seat 5: Dickyxxx ($115.61 in chips) 
Seat 6: arctur17 ($77.79 in chips) 
Seat 7: djammusic ($40 in chips) 
Seat 8: ruslik_by ($266.24 in chips) 
Seat 9: 23SmOkEr07 ($103.50 in chips) 
23SmOkEr07: posts small blind $0.50
diva3150: posts big blind $1
*** HOLE CARDS ***
Dealt to matiko09 [Ks Kc]
matiko09: raises $2 to $3
Pvsx.: folds 
SkUhNi: calls $3
Dickyxxx: folds 
arctur17: folds 
djammusic: folds 
ruslik_by: folds 
23SmOkEr07: folds 
diva3150: calls $2
*** FLOP *** [Qc Qs Js]
diva3150: checks 
matiko09: bets $5
SkUhNi: folds 
diva3150: folds 
Uncalled bet ($5) returned to matiko09
matiko09 collected $9.02 from pot
matiko09: doesn't show hand 
*** SUMMARY ***
Total pot $9.50 | Rake $0.48 
Board [Qc Qs Js]
Seat 1: diva3150 (big blind) folded on the Flop
Seat 2: matiko09 collected ($9.02)
Seat 3: Pvsx. folded before Flop (didn't bet)
Seat 4: SkUhNi folded on the Flop
Seat 5: Dickyxxx folded before Flop (didn't bet)
Seat 6: arctur17 folded before Flop (didn't bet)
Seat 7: djammusic folded before Flop (didn't bet)
Seat 8: ruslik_by (button) folded before Flop (didn't bet)
Seat 9: 23SmOkEr07 (small blind) folded before Flop





PokerStars Hand #154970408957:  Hold'em No Limit (£0.25/£0.50 GBP) - 2016/06/20 12:39:16 CET [2016/06/20 6:39:16 ET]
Table 'Ani' 6-max Seat #3 is the button
Seat 1: rewq99887788 (£34.06 in chips) 
Seat 2: joker180785 (£58.61 in chips) 
Seat 3: Doobes8555 (£77.51 in chips) 
Seat 4: matiko09 (£53.39 in chips) 
Seat 5: Wwwasian (£59.27 in chips) 
Seat 6: faceMyBallz_ (£55.68 in chips) 
matiko09: posts small blind £0.25
Wwwasian: posts big blind £0.50
*** HOLE CARDS ***
Dealt to matiko09 [3d 7c]
faceMyBallz_: raises £0.50 to £1
rewq99887788: folds 
joker180785: calls £1
Doobes8555: folds 
matiko09: folds 
Wwwasian: folds 
*** FLOP *** [9d Ac 8s]
faceMyBallz_: bets £1.30
joker180785: folds 
Uncalled bet (£1.30) returned to faceMyBallz_
faceMyBallz_ collected £2.61 from pot
faceMyBallz_: doesn't show hand 
*** SUMMARY ***
Total pot £2.75 | Rake £0.14 
Board [9d Ac 8s]
Seat 1: rewq99887788 folded before Flop (didn't bet)
Seat 2: joker180785 folded on the Flop
Seat 3: Doobes8555 (button) folded before Flop (didn't bet)
Seat 4: matiko09 (small blind) folded before Flop
Seat 5: Wwwasian (big blind) folded before Flop
Seat 6: faceMyBallz_ collected (£2.61)





PokerStars Hand #154970408767:  Hold'em No Limit (£0.25/£0.50 GBP) - 2016/06/20 12:39:16 CET [2016/06/20 6:39:16 ET]
Table 'Azalea' 6-max Seat #1 is the button
Seat 1: mitsuVK (£99.95 in chips) 
Seat 2: matiko09 (£85.99 in chips) 
Seat 3: VahTang_89 (£54.52 in chips) 
Seat 4: faceMyBallz_ (£50 in chips) 
Seat 5: mudders693 (£74.18 in chips) 
Seat 6: Bënedic10 (£50.20 in chips) 
matiko09: posts small blind £0.25
VahTang_89: posts big blind £0.50
*** HOLE CARDS ***
Dealt to matiko09 [Ts 3h]
faceMyBallz_: folds 
mudders693: raises £1 to £1.50
Bënedic10: raises £3 to £4.50
mitsuVK: folds 
matiko09: folds 
VahTang_89: folds 
mudders693: calls £3
*** FLOP *** [9c Th Ad]
mudders693: bets £4.50
Bënedic10: calls £4.50
*** TURN *** [9c Th Ad] [9d]
mudders693: checks 
Bënedic10: checks 
*** RIVER *** [9c Th Ad 9d] [5c]
mudders693: bets £5
Bënedic10: calls £5
*** SHOW DOWN ***
mudders693: shows [6d Ac] (two pair, Aces and Nines)
Bënedic10: shows [Ah 8h] (two pair, Aces and Nines)
mudders693 collected £13.68 from pot
Bënedic10 collected £13.67 from pot
*** SUMMARY ***
Total pot £28.75 | Rake £1.40 
Board [9c Th Ad 9d 5c]
Seat 1: mitsuVK (button) folded before Flop (didn't bet)
Seat 2: matiko09 (small blind) folded before Flop
Seat 3: VahTang_89 (big blind) folded before Flop
Seat 4: faceMyBallz_ folded before Flop (didn't bet)
Seat 5: mudders693 showed [6d Ac] and won (£13.68) with two pair, Aces and Nines
Seat 6: Bënedic10 showed [Ah 8h] and won (£13.67) with two pair, Aces and Nines





PokerStars Hand #154970410684:  Hold'em No Limit ($0.50/$1.00 USD) - 2016/06/20 12:39:21 CET [2016/06/20 6:39:21 ET]
Table 'Anhui' 9-max Seat #4 is the button
Seat 1: SkUhNi ($155.92 in chips) 
Seat 2: ruslik_by ($274.18 in chips) 
Seat 3: hammerwife ($101.78 in chips) 
Seat 4: mavin80 ($31.06 in chips) 
Seat 5: mi$$I$Elena ($113.80 in chips) 
Seat 6: 23SmOkEr07 ($131.75 in chips) 
Seat 7: matiko09 ($138.38 in chips) 
Seat 8: blackmont111 ($76 in chips) 
Seat 9: TomBod1 ($80.57 in chips) 
mi$$I$Elena: posts small blind $0.50
23SmOkEr07: posts big blind $1
*** HOLE CARDS ***
Dealt to matiko09 [7s 7h]
matiko09: raises $2 to $3
blackmont111: folds 
TomBod1: calls $3
SkUhNi: folds 
ruslik_by: folds 
hammerwife: folds 
mavin80: folds 
mi$$I$Elena: folds 
23SmOkEr07: folds 
*** FLOP *** [5h Td 8s]
matiko09: bets $3.70
TomBod1: raises $3.70 to $7.40
matiko09: folds 
Uncalled bet ($3.70) returned to TomBod1
TomBod1 collected $14.16 from pot
TomBod1: doesn't show hand 
*** SUMMARY ***
Total pot $14.90 | Rake $0.74 
Board [5h Td 8s]
Seat 1: SkUhNi folded before Flop (didn't bet)
Seat 2: ruslik_by folded before Flop (didn't bet)
Seat 3: hammerwife folded before Flop (didn't bet)
Seat 4: mavin80 (button) folded before Flop (didn't bet)
Seat 5: mi$$I$Elena (small blind) folded before Flop
Seat 6: 23SmOkEr07 (big blind) folded before Flop
Seat 7: matiko09 folded on the Flop
Seat 8: blackmont111 folded before Flop (didn't bet)
Seat 9: TomBod1 collected ($14.16)





PokerStars Hand #154970414927:  Hold'em No Limit ($0.50/$1.00 USD) - 2016/06/20 12:39:31 CET [2016/06/20 6:39:31 ET]
Table 'Pongola' 9-max Seat #1 is the button
Seat 1: matiko09 ($100 in chips) 
Seat 2: ruslik_by ($129.77 in chips) 
Seat 3: SkUhNi ($116.22 in chips) 
Seat 4: karllv ($156.81 in chips) 
Seat 5: joker180785 ($107.43 in chips) 
Seat 6: 23SmOkEr07 ($112.71 in chips) 
Seat 7: Dickyxxx ($149.62 in chips) 
Seat 8: phrantique ($84.70 in chips) 
Seat 9: Filojoes ($100 in chips) 
ruslik_by: posts small blind $0.50
SkUhNi: posts big blind $1
*** HOLE CARDS ***
Dealt to matiko09 [Th 9h]
karllv: folds 
joker180785: folds 
23SmOkEr07: folds 
Dickyxxx: folds 
phrantique: raises $2 to $3
Filojoes: folds 
matiko09: calls $3
ruslik_by: folds 
SkUhNi: folds 
*** FLOP *** [7c 4d Ts]
phrantique: bets $3
matiko09: calls $3
*** TURN *** [7c 4d Ts] [Qs]
phrantique: bets $6.41
matiko09: calls $6.41
*** RIVER *** [7c 4d Ts Qs] [Jc]
phrantique: bets $11.71
matiko09: folds 
Uncalled bet ($11.71) returned to phrantique
phrantique collected $25 from pot
*** SUMMARY ***
Total pot $26.32 | Rake $1.32 
Board [7c 4d Ts Qs Jc]
Seat 1: matiko09 (button) folded on the River
Seat 2: ruslik_by (small blind) folded before Flop
Seat 3: SkUhNi (big blind) folded before Flop
Seat 4: karllv folded before Flop (didn't bet)
Seat 5: joker180785 folded before Flop (didn't bet)
Seat 6: 23SmOkEr07 folded before Flop (didn't bet)
Seat 7: Dickyxxx folded before Flop (didn't bet)
Seat 8: phrantique collected ($25)
Seat 9: Filojoes folded before Flop (didn't bet)





PokerStars Hand #154970416449:  Hold'em No Limit ($0.50/$1.00 USD) - 2016/06/20 12:39:35 CET [2016/06/20 6:39:35 ET]
Table 'Isonoe II' 9-max Seat #9 is the button
Seat 1: hammerwife ($106.86 in chips) 
Seat 2: matiko09 ($109.52 in chips) 
Seat 3: Kukuryzka ($99.50 in chips) 
Seat 4: Avtovo ($100 in chips) 
Seat 5: Filojoes ($100 in chips) 
Seat 6: GOOFA13 ($71.96 in chips) 
Seat 7: SkUhNi ($100 in chips) 
Seat 8: lewyson ($59.15 in chips) 
Seat 9: djammusic ($61.95 in chips) 
hammerwife: posts small blind $0.50
matiko09: posts big blind $1
*** HOLE CARDS ***
Dealt to matiko09 [Td 8d]
Kukuryzka: raises $2 to $3
Avtovo: folds 
Filojoes: folds 
GOOFA13: folds 
SkUhNi: folds 
lewyson: calls $3
djammusic: folds 
hammerwife: folds 
matiko09: folds 
*** FLOP *** [4s 4d 8s]
Kukuryzka: checks 
lewyson: bets $7.12
Kukuryzka: folds 
Uncalled bet ($7.12) returned to lewyson
lewyson collected $7.12 from pot
*** SUMMARY ***
Total pot $7.50 | Rake $0.38 
Board [4s 4d 8s]
Seat 1: hammerwife (small blind) folded before Flop
Seat 2: matiko09 (big blind) folded before Flop
Seat 3: Kukuryzka folded on the Flop
Seat 4: Avtovo folded before Flop (didn't bet)
Seat 5: Filojoes folded before Flop (didn't bet)
Seat 6: GOOFA13 folded before Flop (didn't bet)
Seat 7: SkUhNi folded before Flop (didn't bet)
Seat 8: lewyson collected ($7.12)
Seat 9: djammusic (button) folded before Flop (didn't bet)





PokerStars Hand #154970425191:  Hold'em No Limit (£0.25/£0.50 GBP) - 2016/06/20 12:39:57 CET [2016/06/20 6:39:57 ET]
Table 'Ani' 6-max Seat #4 is the button
Seat 1: rewq99887788 (£34.06 in chips) 
Seat 2: joker180785 (£57.61 in chips) 
Seat 3: Doobes8555 (£77.51 in chips) 
Seat 4: matiko09 (£53.14 in chips) 
Seat 5: Wwwasian (£58.77 in chips) 
Seat 6: faceMyBallz_ (£57.29 in chips) 
Wwwasian: posts small blind £0.25
faceMyBallz_: posts big blind £0.50
*** HOLE CARDS ***
Dealt to matiko09 [9d 4c]
rewq99887788: folds 
joker180785: folds 
Doobes8555: raises £1 to £1.50
matiko09: folds 
Wwwasian: folds 
faceMyBallz_: calls £1
*** FLOP *** [Ks 8h 9h]
faceMyBallz_: checks 
Doobes8555: bets £1.50
faceMyBallz_: folds 
Uncalled bet (£1.50) returned to Doobes8555
Doobes8555 collected £3.09 from pot
Doobes8555: doesn't show hand 
*** SUMMARY ***
Total pot £3.25 | Rake £0.16 
Board [Ks 8h 9h]
Seat 1: rewq99887788 folded before Flop (didn't bet)
Seat 2: joker180785 folded before Flop (didn't bet)
Seat 3: Doobes8555 collected (£3.09)
Seat 4: matiko09 (button) folded before Flop (didn't bet)
Seat 5: Wwwasian (small blind) folded before Flop
Seat 6: faceMyBallz_ (big blind) folded on the Flop





PokerStars Hand #154970428736:  Hold'em No Limit ($0.50/$1.00 USD) - 2016/06/20 12:40:06 CET [2016/06/20 6:40:06 ET]
Table 'Ambrosia II' 9-max Seat #1 is the button
Seat 1: 23SmOkEr07 ($177.25 in chips) 
Seat 2: Eyeballz1307 ($20.34 in chips) 
Seat 3: mavin80 ($98.50 in chips) 
Seat 4: mi$$I$Elena ($213.80 in chips) 
Seat 5: Mattulh ($102.70 in chips) 
Seat 6: ruslik_by ($112.80 in chips) 
Seat 7: matiko09 ($100 in chips) 
Seat 8: hammerwife ($100 in chips) 
Seat 9: SkUhNi ($125.93 in chips) 
Eyeballz1307: posts small blind $0.50
mavin80: posts big blind $1
*** HOLE CARDS ***
Dealt to matiko09 [Ah Jc]
mi$$I$Elena: raises $1.38 to $2.38
Mattulh: calls $2.38
ruslik_by: folds 
matiko09: folds 
hammerwife: folds 
SkUhNi: calls $2.38
23SmOkEr07: folds 
Eyeballz1307: folds 
mavin80: folds 
*** FLOP *** [9d 3d Kc]
mi$$I$Elena: checks 
Mattulh: checks 
SkUhNi: bets $5.74
mi$$I$Elena: folds 
Mattulh: folds 
Uncalled bet ($5.74) returned to SkUhNi
SkUhNi collected $8.21 from pot
SkUhNi: doesn't show hand 
*** SUMMARY ***
Total pot $8.64 | Rake $0.43 
Board [9d 3d Kc]
Seat 1: 23SmOkEr07 (button) folded before Flop (didn't bet)
Seat 2: Eyeballz1307 (small blind) folded before Flop
Seat 3: mavin80 (big blind) folded before Flop
Seat 4: mi$$I$Elena folded on the Flop
Seat 5: Mattulh folded on the Flop
Seat 6: ruslik_by folded before Flop (didn't bet)
Seat 7: matiko09 folded before Flop (didn't bet)
Seat 8: hammerwife folded before Flop (didn't bet)
Seat 9: SkUhNi collected ($8.21)





PokerStars Hand #154970429263:  Hold'em No Limit (£0.25/£0.50 GBP) - 2016/06/20 12:40:08 CET [2016/06/20 6:40:08 ET]
Table 'Azalea' 6-max Seat #2 is the button
Seat 1: mitsuVK (£99.95 in chips) 
Seat 2: matiko09 (£85.74 in chips) 
Seat 3: VahTang_89 (£54.02 in chips) 
Seat 4: faceMyBallz_ (£50 in chips) 
Seat 5: mudders693 (£73.86 in chips) 
Seat 6: Bënedic10 (£50 in chips) 
VahTang_89: posts small blind £0.25
faceMyBallz_: posts big blind £0.50
*** HOLE CARDS ***
Dealt to matiko09 [5d 7s]
mudders693: folds 
Bënedic10: folds 
mitsuVK: folds 
matiko09: folds 
VahTang_89: folds 
Uncalled bet (£0.25) returned to faceMyBallz_
faceMyBallz_ collected £0.50 from pot
faceMyBallz_: doesn't show hand 
*** SUMMARY ***
Total pot £0.50 | Rake £0 
Seat 1: mitsuVK folded before Flop (didn't bet)
Seat 2: matiko09 (button) folded before Flop (didn't bet)
Seat 3: VahTang_89 (small blind) folded before Flop
Seat 4: faceMyBallz_ (big blind) collected (£0.50)
Seat 5: mudders693 folded before Flop (didn't bet)
Seat 6: Bënedic10 folded before Flop (didn't bet)





PokerStars Hand #154970431065:  Hold'em No Limit (£0.25/£0.50 GBP) - 2016/06/20 12:40:12 CET [2016/06/20 6:40:12 ET]
Table 'Tesla' 6-max Seat #3 is the button
Seat 1: Rubleff85 (£51.01 in chips) 
Seat 2: matiko09 (£59.65 in chips) 
Seat 3: asmodej666 (£50 in chips) 
Seat 4: ILIUXa (£53.15 in chips) 
Seat 5: Nego Razu (£50 in chips) 
Seat 6: faceMyBallz_ (£50 in chips) 
ILIUXa: posts small blind £0.25
Nego Razu: posts big blind £0.50
*** HOLE CARDS ***
Dealt to matiko09 [Ts 4h]
faceMyBallz_ has timed out
faceMyBallz_: folds 
Rubleff85: raises £0.81 to £1.31
matiko09: folds 
asmodej666: folds 
ILIUXa: folds 
Nego Razu: folds 
Uncalled bet (£0.81) returned to Rubleff85
Rubleff85 collected £1.25 from pot
Rubleff85: doesn't show hand 
*** SUMMARY ***
Total pot £1.25 | Rake £0 
Seat 1: Rubleff85 collected (£1.25)
Seat 2: matiko09 folded before Flop (didn't bet)
Seat 3: asmodej666 (button) folded before Flop (didn't bet)
Seat 4: ILIUXa (small blind) folded before Flop
Seat 5: Nego Razu (big blind) folded before Flop
Seat 6: faceMyBallz_ folded before Flop (didn't bet)





PokerStars Hand #154970432376:  Hold'em No Limit ($0.25/$0.50 USD) - 2016/06/20 12:40:16 CET [2016/06/20 6:40:16 ET]
Table 'Scheddi II' 9-max Seat #3 is the button
Seat 1: matiko09 ($50 in chips) 
Seat 3: mi$$I$Elena ($93.55 in chips) 
Seat 4: GOOFA13 ($39.04 in chips) 
Seat 5: zarplatka ($40 in chips) 
Seat 6: joker180785 ($50 in chips) 
Seat 7: HopeMayBee ($69.26 in chips) 
Seat 8: orochimaturi ($79.80 in chips) 
Seat 9: Infinitinium ($104.86 in chips) 
GOOFA13: posts small blind $0.25
zarplatka: posts big blind $0.50
Yaaaazz: sits out 
matiko09: posts the ante $0.10
mi$$I$Elena: posts the ante $0.10
GOOFA13: posts the ante $0.10
zarplatka: posts the ante $0.10
joker180785: posts the ante $0.10
HopeMayBee: posts the ante $0.10
orochimaturi: posts the ante $0.10
Infinitinium: posts the ante $0.10
*** HOLE CARDS ***
Dealt to matiko09 [Ad Ah]
joker180785: folds 
HopeMayBee: folds 
orochimaturi: raises $1.55 to $2.05
Infinitinium: folds 
matiko09: raises $3.95 to $6
mi$$I$Elena: folds 
GOOFA13: folds 
zarplatka: folds 
orochimaturi: calls $3.95
*** FLOP *** [Tc 8c 2d]
orochimaturi: checks 
matiko09: bets $8.37
orochimaturi: calls $8.37
*** TURN *** [Tc 8c 2d] [5d]
orochimaturi: checks 
matiko09: bets $16.50
orochimaturi: raises $16.50 to $33
matiko09: raises $2.53 to $35.53 and is all-in
orochimaturi: calls $2.53
*** RIVER *** [Tc 8c 2d 5d] [6s]
*** SHOW DOWN ***
orochimaturi: shows [Js Jc] (a pair of Jacks)
matiko09: shows [Ad Ah] (a pair of Aces)
matiko09 collected $99.35 from pot
*** SUMMARY ***
Total pot $101.35 | Rake $2 
Board [Tc 8c 2d 5d 6s]
Seat 1: matiko09 showed [Ad Ah] and won ($99.35) with a pair of Aces
Seat 3: mi$$I$Elena (button) folded before Flop (didn't bet)
Seat 4: GOOFA13 (small blind) folded before Flop
Seat 5: zarplatka (big blind) folded before Flop
Seat 6: joker180785 folded before Flop (didn't bet)
Seat 7: HopeMayBee folded before Flop (didn't bet)
Seat 8: orochimaturi showed [Js Jc] and lost with a pair of Jacks
Seat 9: Infinitinium folded before Flop (didn't bet)





PokerStars Hand #154970432953:  Hold'em No Limit ($0.50/$1.00 USD) - 2016/06/20 12:40:17 CET [2016/06/20 6:40:17 ET]
Table 'Anhui' 9-max Seat #5 is the button
Seat 1: SkUhNi ($155.92 in chips) 
Seat 2: ruslik_by ($274.18 in chips) 
Seat 3: hammerwife ($101.78 in chips) 
Seat 4: mavin80 ($31.06 in chips) 
Seat 5: mi$$I$Elena ($113.30 in chips) 
Seat 6: 23SmOkEr07 ($130.75 in chips) 
Seat 7: matiko09 ($131.68 in chips) 
Seat 8: blackmont111 ($76 in chips) 
Seat 9: TomBod1 ($88.03 in chips) 
23SmOkEr07: posts small blind $0.50
matiko09: posts big blind $1
*** HOLE CARDS ***
Dealt to matiko09 [4h 5d]
blackmont111: raises $2 to $3
TomBod1: folds 
SkUhNi: folds 
ruslik_by: folds 
hammerwife: folds 
mavin80: calls $3
mi$$I$Elena: calls $3
23SmOkEr07: folds 
matiko09: folds 
*** FLOP *** [Kd 3h Ks]
blackmont111: checks 
mavin80: checks 
mi$$I$Elena: checks 
*** TURN *** [Kd 3h Ks] [8d]
blackmont111: checks 
mavin80: bets $2
mi$$I$Elena: folds 
blackmont111: calls $2
*** RIVER *** [Kd 3h Ks 8d] [Kc]
blackmont111: checks 
mavin80: bets $5
blackmont111: folds 
Uncalled bet ($5) returned to mavin80
mavin80 collected $13.78 from pot
*** SUMMARY ***
Total pot $14.50 | Rake $0.72 
Board [Kd 3h Ks 8d Kc]
Seat 1: SkUhNi folded before Flop (didn't bet)
Seat 2: ruslik_by folded before Flop (didn't bet)
Seat 3: hammerwife folded before Flop (didn't bet)
Seat 4: mavin80 collected ($13.78)
Seat 5: mi$$I$Elena (button) folded on the Turn
Seat 6: 23SmOkEr07 (small blind) folded before Flop
Seat 7: matiko09 (big blind) folded before Flop
Seat 8: blackmont111 folded on the River
Seat 9: TomBod1 folded before Flop (didn't bet)





PokerStars Hand #154970433027:  Hold'em No Limit ($0.50/$1.00 USD) - 2016/06/20 12:40:17 CET [2016/06/20 6:40:17 ET]
Table 'Isonoe II' 9-max Seat #1 is the button
Seat 1: hammerwife ($106.36 in chips) 
Seat 2: matiko09 ($108.52 in chips) 
Seat 3: Kukuryzka ($100 in chips) 
Seat 4: Avtovo ($100 in chips) 
Seat 5: Filojoes ($100 in chips) 
Seat 6: GOOFA13 ($71.96 in chips) 
Seat 7: SkUhNi ($100 in chips) 
Seat 8: lewyson ($63.27 in chips) 
Seat 9: djammusic ($61.95 in chips) 
matiko09: posts small blind $0.50
Kukuryzka: posts big blind $1
*** HOLE CARDS ***
Dealt to matiko09 [2s 5d]
Avtovo: folds 
Filojoes: folds 
GOOFA13: folds 
SkUhNi: raises $2 to $3
lewyson: calls $3
djammusic: folds 
hammerwife: folds 
matiko09: folds 
Kukuryzka: folds 
*** FLOP *** [4d 2d 3c]
SkUhNi: bets $5
lewyson: calls $5
*** TURN *** [4d 2d 3c] [Qs]
SkUhNi: checks 
lewyson: bets $8
SkUhNi: calls $8
*** RIVER *** [4d 2d 3c Qs] [2c]
SkUhNi: checks 
lewyson: checks 
*** SHOW DOWN ***
SkUhNi: shows [7s 7d] (two pair, Sevens and Deuces)
lewyson: mucks hand 
SkUhNi collected $31.82 from pot
*** SUMMARY ***
Total pot $33.50 | Rake $1.68 
Board [4d 2d 3c Qs 2c]
Seat 1: hammerwife (button) folded before Flop (didn't bet)
Seat 2: matiko09 (small blind) folded before Flop
Seat 3: Kukuryzka (big blind) folded before Flop
Seat 4: Avtovo folded before Flop (didn't bet)
Seat 5: Filojoes folded before Flop (didn't bet)
Seat 6: GOOFA13 folded before Flop (didn't bet)
Seat 7: SkUhNi showed [7s 7d] and won ($31.82) with two pair, Sevens and Deuces
Seat 8: lewyson mucked [8h Ah]
Seat 9: djammusic folded before Flop (didn't bet)





PokerStars Hand #154970432751:  Hold'em No Limit ($0.50/$1.00 USD) - 2016/06/20 12:40:17 CET [2016/06/20 6:40:17 ET]
Table 'Ernestina' 9-max Seat #9 is the button
Seat 1: diva3150 ($144.12 in chips) 
Seat 2: matiko09 ($106.02 in chips) 
Seat 3: Pvsx. ($169.07 in chips) 
Seat 4: SkUhNi ($100 in chips) 
Seat 5: Dickyxxx ($115.61 in chips) 
Seat 6: arctur17 ($77.79 in chips) 
Seat 7: djammusic ($40 in chips) 
Seat 8: ruslik_by ($266.24 in chips) 
Seat 9: 23SmOkEr07 ($103 in chips) 
diva3150: posts small blind $0.50
matiko09: posts big blind $1
*** HOLE CARDS ***
Dealt to matiko09 [5s Jh]
Pvsx.: folds 
SkUhNi: raises $2 to $3
Dickyxxx: folds 
arctur17: folds 
djammusic: folds 
ruslik_by: folds 
23SmOkEr07: folds 
diva3150: folds 
matiko09: folds 
Uncalled bet ($2) returned to SkUhNi
SkUhNi collected $2.50 from pot
SkUhNi: doesn't show hand 
*** SUMMARY ***
Total pot $2.50 | Rake $0 
Seat 1: diva3150 (small blind) folded before Flop
Seat 2: matiko09 (big blind) folded before Flop
Seat 3: Pvsx. folded before Flop (didn't bet)
Seat 4: SkUhNi collected ($2.50)
Seat 5: Dickyxxx folded before Flop (didn't bet)
Seat 6: arctur17 folded before Flop (didn't bet)
Seat 7: djammusic folded before Flop (didn't bet)
Seat 8: ruslik_by folded before Flop (didn't bet)
Seat 9: 23SmOkEr07 (button) folded before Flop (didn't bet)





PokerStars Hand #154970436298:  Hold'em No Limit ($0.50/$1.00 USD) - 2016/06/20 12:40:25 CET [2016/06/20 6:40:25 ET]
Table 'Annika' 9-max Seat #8 is the button
Seat 1: hammerwife ($134.27 in chips) 
Seat 2: matiko09 ($100 in chips) 
Seat 3: first_dnk ($85.50 in chips) 
Seat 4: Kukuryzka ($108.50 in chips) 
Seat 5: SkUhNi ($122.01 in chips) 
Seat 6: Pvsx. ($112.55 in chips) 
Seat 7: jirka117 ($54.45 in chips) 
Seat 8: ruslik_by ($106.40 in chips) 
Seat 9: 23SmOkEr07 ($100 in chips) 
23SmOkEr07: posts small blind $0.50
hammerwife: posts big blind $1
*** HOLE CARDS ***
Dealt to matiko09 [Tc 4h]
matiko09: folds 
first_dnk: folds 
Kukuryzka: folds 
SkUhNi: raises $2 to $3
Pvsx.: folds 
jirka117: calls $3
ruslik_by: folds 
23SmOkEr07: folds 
hammerwife: folds 
*** FLOP *** [Ks Th Js]
SkUhNi: bets $4
jirka117: folds 
Uncalled bet ($4) returned to SkUhNi
SkUhNi collected $7.12 from pot
SkUhNi: doesn't show hand 
*** SUMMARY ***
Total pot $7.50 | Rake $0.38 
Board [Ks Th Js]
Seat 1: hammerwife (big blind) folded before Flop
Seat 2: matiko09 folded before Flop (didn't bet)
Seat 3: first_dnk folded before Flop (didn't bet)
Seat 4: Kukuryzka folded before Flop (didn't bet)
Seat 5: SkUhNi collected ($7.12)
Seat 6: Pvsx. folded before Flop (didn't bet)
Seat 7: jirka117 folded on the Flop
Seat 8: ruslik_by (button) folded before Flop (didn't bet)
Seat 9: 23SmOkEr07 (small blind) folded before Flop





PokerStars Hand #154970439329:  Hold'em No Limit (£0.25/£0.50 GBP) - 2016/06/20 12:40:33 CET [2016/06/20 6:40:33 ET]
Table 'Azalea' 6-max Seat #3 is the button
Seat 1: mitsuVK (£99.95 in chips) 
Seat 2: matiko09 (£85.74 in chips) 
Seat 3: VahTang_89 (£53.77 in chips) 
Seat 4: faceMyBallz_ (£50.25 in chips) 
Seat 5: mudders693 (£73.86 in chips) 
Seat 6: Bënedic10 (£50 in chips) 
faceMyBallz_: posts small blind £0.25
mudders693: posts big blind £0.50
*** HOLE CARDS ***
Dealt to matiko09 [7c 2s]
Bënedic10: folds 
mitsuVK: folds 
matiko09: folds 
VahTang_89: folds 
faceMyBallz_: folds 
Uncalled bet (£0.25) returned to mudders693
mudders693 collected £0.50 from pot
mudders693: doesn't show hand 
*** SUMMARY ***
Total pot £0.50 | Rake £0 
Seat 1: mitsuVK folded before Flop (didn't bet)
Seat 2: matiko09 folded before Flop (didn't bet)
Seat 3: VahTang_89 (button) folded before Flop (didn't bet)
Seat 4: faceMyBallz_ (small blind) folded before Flop
Seat 5: mudders693 (big blind) collected (£0.50)
Seat 6: Bënedic10 folded before Flop (didn't bet)





PokerStars Hand #154970443827:  Hold'em No Limit (£0.25/£0.50 GBP) - 2016/06/20 12:40:45 CET [2016/06/20 6:40:45 ET]
Table 'Azalea' 6-max Seat #4 is the button
Seat 1: mitsuVK (£99.95 in chips) 
Seat 2: matiko09 (£85.74 in chips) 
Seat 3: VahTang_89 (£53.77 in chips) 
Seat 4: faceMyBallz_ (£50 in chips) 
Seat 5: mudders693 (£74.11 in chips) 
Seat 6: Bënedic10 (£50 in chips) 
mudders693: posts small blind £0.25
Bënedic10: posts big blind £0.50
*** HOLE CARDS ***
Dealt to matiko09 [6s Th]
mitsuVK: raises £1 to £1.50
matiko09: folds 
VahTang_89: folds 
faceMyBallz_: folds 
mudders693: calls £1.25
Bënedic10: calls £1
*** FLOP *** [7s 7d Ts]
mudders693: checks 
Bënedic10: checks 
mitsuVK: bets £2.25
mudders693: folds 
Bënedic10: folds 
Uncalled bet (£2.25) returned to mitsuVK
mitsuVK collected £4.28 from pot
mitsuVK: doesn't show hand 
*** SUMMARY ***
Total pot £4.50 | Rake £0.22 
Board [7s 7d Ts]
Seat 1: mitsuVK collected (£4.28)
Seat 2: matiko09 folded before Flop (didn't bet)
Seat 3: VahTang_89 folded before Flop (didn't bet)
Seat 4: faceMyBallz_ (button) folded before Flop (didn't bet)
Seat 5: mudders693 (small blind) folded on the Flop
Seat 6: Bënedic10 (big blind) folded on the Flop





PokerStars Hand #154970443937:  Hold'em No Limit ($0.50/$1.00 USD) - 2016/06/20 12:40:45 CET [2016/06/20 6:40:45 ET]
Table 'Ernestina' 9-max Seat #1 is the button
Seat 1: diva3150 ($143.62 in chips) 
Seat 2: matiko09 ($105.02 in chips) 
Seat 3: Pvsx. ($169.07 in chips) 
Seat 4: SkUhNi ($101.50 in chips) 
Seat 5: Dickyxxx ($115.61 in chips) 
Seat 6: arctur17 ($77.79 in chips) 
Seat 7: djammusic ($40 in chips) 
Seat 8: ruslik_by ($266.24 in chips) 
Seat 9: 23SmOkEr07 ($103 in chips) 
matiko09: posts small blind $0.50
Pvsx.: posts big blind $1
*** HOLE CARDS ***
Dealt to matiko09 [7c 7d]
SkUhNi: folds 
Dickyxxx: folds 
arctur17: folds 
djammusic: folds 
ruslik_by: folds 
23SmOkEr07: folds 
diva3150: folds 
matiko09: raises $2 to $3
Pvsx.: raises $6 to $9
matiko09: calls $6
*** FLOP *** [2s Jc 8s]
matiko09: checks 
Pvsx.: bets $9
matiko09: calls $9
*** TURN *** [2s Jc 8s] [2d]
matiko09: checks 
Pvsx.: bets $17.10
matiko09: folds 
Uncalled bet ($17.10) returned to Pvsx.
Pvsx. collected $34.20 from pot
Pvsx.: doesn't show hand 
*** SUMMARY ***
Total pot $36 | Rake $1.80 
Board [2s Jc 8s 2d]
Seat 1: diva3150 (button) folded before Flop (didn't bet)
Seat 2: matiko09 (small blind) folded on the Turn
Seat 3: Pvsx. (big blind) collected ($34.20)
Seat 4: SkUhNi folded before Flop (didn't bet)
Seat 5: Dickyxxx folded before Flop (didn't bet)
Seat 6: arctur17 folded before Flop (didn't bet)
Seat 7: djammusic folded before Flop (didn't bet)
Seat 8: ruslik_by folded before Flop (didn't bet)
Seat 9: 23SmOkEr07 folded before Flop (didn't bet)





PokerStars Hand #154970445820:  Hold'em No Limit ($0.50/$1.00 USD) - 2016/06/20 12:40:50 CET [2016/06/20 6:40:50 ET]
Table 'Pongola' 9-max Seat #2 is the button
Seat 1: matiko09 ($100 in chips) 
Seat 2: ruslik_by ($129.27 in chips) 
Seat 3: SkUhNi ($115.22 in chips) 
Seat 4: karllv ($156.81 in chips) 
Seat 5: joker180785 ($107.43 in chips) 
Seat 6: 23SmOkEr07 ($112.71 in chips) 
Seat 7: Dickyxxx ($149.62 in chips) 
Seat 8: phrantique ($97.29 in chips) 
Seat 9: Filojoes ($100 in chips) 
SkUhNi: posts small blind $0.50
karllv: posts big blind $1
*** HOLE CARDS ***
Dealt to matiko09 [7h 5c]
joker180785: folds 
23SmOkEr07: raises $1.50 to $2.50
Dickyxxx: folds 
phrantique: folds 
Filojoes: folds 
matiko09: folds 
ruslik_by: folds 
SkUhNi: folds 
karllv: folds 
Uncalled bet ($1.50) returned to 23SmOkEr07
23SmOkEr07 collected $2.50 from pot
23SmOkEr07: doesn't show hand 
*** SUMMARY ***
Total pot $2.50 | Rake $0 
Seat 1: matiko09 folded before Flop (didn't bet)
Seat 2: ruslik_by (button) folded before Flop (didn't bet)
Seat 3: SkUhNi (small blind) folded before Flop
Seat 4: karllv (big blind) folded before Flop
Seat 5: joker180785 folded before Flop (didn't bet)
Seat 6: 23SmOkEr07 collected ($2.50)
Seat 7: Dickyxxx folded before Flop (didn't bet)
Seat 8: phrantique folded before Flop (didn't bet)
Seat 9: Filojoes folded before Flop (didn't bet)





PokerStars Hand #154970446088:  Hold'em No Limit (£0.25/£0.50 GBP) - 2016/06/20 12:40:50 CET [2016/06/20 6:40:50 ET]
Table 'Tesla' 6-max Seat #4 is the button
Seat 1: Rubleff85 (£51.76 in chips) 
Seat 2: matiko09 (£59.65 in chips) 
Seat 3: asmodej666 (£50 in chips) 
Seat 4: ILIUXa (£52.90 in chips) 
Seat 5: Nego Razu (£50 in chips) 
Seat 6: faceMyBallz_ (£50 in chips) 
Nego Razu: posts small blind £0.25
faceMyBallz_: posts big blind £0.50
*** HOLE CARDS ***
Dealt to matiko09 [Qs 9c]
Rubleff85: folds 
matiko09: folds 
asmodej666: folds 
ILIUXa: folds 
Nego Razu: raises £0.77 to £1.27
faceMyBallz_: calls £0.77
*** FLOP *** [6h 4c Th]
Nego Razu: checks 
faceMyBallz_: bets £2
Nego Razu: calls £2
*** TURN *** [6h 4c Th] [8c]
Nego Razu: checks 
faceMyBallz_: checks 
*** RIVER *** [6h 4c Th 8c] [5s]
Nego Razu: bets £3.04
faceMyBallz_: calls £3.04
*** SHOW DOWN ***
Nego Razu: shows [Kd 4h] (a pair of Fours)
faceMyBallz_: shows [2s Ts] (a pair of Tens)
faceMyBallz_ collected £11.99 from pot
*** SUMMARY ***
Total pot £12.62 | Rake £0.63 
Board [6h 4c Th 8c 5s]
Seat 1: Rubleff85 folded before Flop (didn't bet)
Seat 2: matiko09 folded before Flop (didn't bet)
Seat 3: asmodej666 folded before Flop (didn't bet)
Seat 4: ILIUXa (button) folded before Flop (didn't bet)
Seat 5: Nego Razu (small blind) showed [Kd 4h] and lost with a pair of Fours
Seat 6: faceMyBallz_ (big blind) showed [2s Ts] and won (£11.99) with a pair of Tens





PokerStars Hand #154970446435:  Hold'em No Limit (£0.25/£0.50 GBP) - 2016/06/20 12:40:51 CET [2016/06/20 6:40:51 ET]
Table 'Ani' 6-max Seat #5 is the button
Seat 1: rewq99887788 (£34.06 in chips) 
Seat 2: joker180785 (£57.61 in chips) 
Seat 3: Doobes8555 (£79.10 in chips) 
Seat 4: matiko09 (£53.14 in chips) 
Seat 5: Wwwasian (£58.52 in chips) 
Seat 6: faceMyBallz_ (£55.79 in chips) 
faceMyBallz_: posts small blind £0.25
rewq99887788: posts big blind £0.50
*** HOLE CARDS ***
Dealt to matiko09 [6h 7d]
joker180785: folds 
Doobes8555: folds 
matiko09: folds 
Wwwasian: raises £0.75 to £1.25
faceMyBallz_: folds 
rewq99887788: calls £0.75
*** FLOP *** [4c Ks Qd]
rewq99887788: checks 
Wwwasian: bets £1
rewq99887788: calls £1
*** TURN *** [4c Ks Qd] [4h]
rewq99887788: checks 
Wwwasian: checks 
*** RIVER *** [4c Ks Qd 4h] [8c]
rewq99887788: bets £3.50
Wwwasian: folds 
Uncalled bet (£3.50) returned to rewq99887788
rewq99887788 collected £4.51 from pot
*** SUMMARY ***
Total pot £4.75 | Rake £0.24 
Board [4c Ks Qd 4h 8c]
Seat 1: rewq99887788 (big blind) collected (£4.51)
Seat 2: joker180785 folded before Flop (didn't bet)
Seat 3: Doobes8555 folded before Flop (didn't bet)
Seat 4: matiko09 folded before Flop (didn't bet)
Seat 5: Wwwasian (button) folded on the River
Seat 6: faceMyBallz_ (small blind) folded before Flop





PokerStars Hand #154970452287:  Hold'em No Limit ($0.50/$1.00 USD) - 2016/06/20 12:41:06 CET [2016/06/20 6:41:06 ET]
Table 'Annika' 9-max Seat #9 is the button
Seat 1: hammerwife ($133.27 in chips) 
Seat 2: matiko09 ($100 in chips) 
Seat 3: first_dnk ($85.50 in chips) 
Seat 4: Kukuryzka ($108.50 in chips) 
Seat 5: SkUhNi ($126.13 in chips) 
Seat 6: Pvsx. ($112.55 in chips) 
Seat 7: jirka117 ($51.45 in chips) 
Seat 8: ruslik_by ($106.40 in chips) 
Seat 9: 23SmOkEr07 ($100 in chips) 
hammerwife: posts small blind $0.50
matiko09: posts big blind $1
*** HOLE CARDS ***
Dealt to matiko09 [As Jc]
first_dnk: folds 
Kukuryzka: folds 
SkUhNi: folds 
Pvsx.: folds 
jirka117: folds 
ruslik_by: folds 
23SmOkEr07: raises $1.50 to $2.50
hammerwife: folds 
matiko09: calls $1.50
*** FLOP *** [Qh Ts 8c]
matiko09: checks 
23SmOkEr07: checks 
*** TURN *** [Qh Ts 8c] [Ad]
matiko09: checks 
23SmOkEr07: checks 
*** RIVER *** [Qh Ts 8c Ad] [3c]
matiko09: bets $3.39
23SmOkEr07: folds 
Uncalled bet ($3.39) returned to matiko09
matiko09 collected $5.22 from pot
matiko09: doesn't show hand 
*** SUMMARY ***
Total pot $5.50 | Rake $0.28 
Board [Qh Ts 8c Ad 3c]
Seat 1: hammerwife (small blind) folded before Flop
Seat 2: matiko09 (big blind) collected ($5.22)
Seat 3: first_dnk folded before Flop (didn't bet)
Seat 4: Kukuryzka folded before Flop (didn't bet)
Seat 5: SkUhNi folded before Flop (didn't bet)
Seat 6: Pvsx. folded before Flop (didn't bet)
Seat 7: jirka117 folded before Flop (didn't bet)
Seat 8: ruslik_by folded before Flop (didn't bet)
Seat 9: 23SmOkEr07 (button) folded on the River





PokerStars Hand #154970458109:  Hold'em No Limit ($0.50/$1.00 USD) - 2016/06/20 12:41:21 CET [2016/06/20 6:41:21 ET]
Table 'Pongola' 9-max Seat #3 is the button
Seat 1: matiko09 ($100 in chips) 
Seat 2: ruslik_by ($129.27 in chips) 
Seat 3: SkUhNi ($114.72 in chips) 
Seat 4: karllv ($155.81 in chips) 
Seat 5: joker180785 ($107.43 in chips) 
Seat 6: 23SmOkEr07 ($114.21 in chips) 
Seat 7: Dickyxxx ($149.62 in chips) 
Seat 8: phrantique ($97.29 in chips) 
Seat 9: Filojoes ($100 in chips) 
karllv: posts small blind $0.50
joker180785: posts big blind $1
*** HOLE CARDS ***
Dealt to matiko09 [Qc Kh]
23SmOkEr07: folds 
Dickyxxx: folds 
phrantique: folds 
Filojoes: raises $2 to $3
matiko09: raises $7 to $10
ruslik_by: folds 
SkUhNi: folds 
karllv: folds 
joker180785: folds 
Filojoes: folds 
Uncalled bet ($7) returned to matiko09
matiko09 collected $7.50 from pot
matiko09: doesn't show hand 
*** SUMMARY ***
Total pot $7.50 | Rake $0 
Seat 1: matiko09 collected ($7.50)
Seat 2: ruslik_by folded before Flop (didn't bet)
Seat 3: SkUhNi (button) folded before Flop (didn't bet)
Seat 4: karllv (small blind) folded before Flop
Seat 5: joker180785 (big blind) folded before Flop
Seat 6: 23SmOkEr07 folded before Flop (didn't bet)
Seat 7: Dickyxxx folded before Flop (didn't bet)
Seat 8: phrantique folded before Flop (didn't bet)
Seat 9: Filojoes folded before Flop





PokerStars Hand #154970459923:  Hold'em No Limit ($0.25/$0.50 USD) - 2016/06/20 12:41:26 CET [2016/06/20 6:41:26 ET]
Table 'Scheddi II' 9-max Seat #4 is the button
Seat 1: matiko09 ($99.35 in chips) 
Seat 3: mi$$I$Elena ($93.45 in chips) 
Seat 4: GOOFA13 ($38.69 in chips) 
Seat 5: zarplatka ($40 in chips) 
Seat 6: joker180785 ($50 in chips) 
Seat 7: HopeMayBee ($69.16 in chips) 
Seat 8: orochimaturi ($29.80 in chips) 
Seat 9: Infinitinium ($104.76 in chips) 
zarplatka: posts small blind $0.25
joker180785: posts big blind $0.50
Yaaaazz: sits out 
matiko09: posts the ante $0.10
mi$$I$Elena: posts the ante $0.10
GOOFA13: posts the ante $0.10
zarplatka: posts the ante $0.10
joker180785: posts the ante $0.10
HopeMayBee: posts the ante $0.10
orochimaturi: posts the ante $0.10
Infinitinium: posts the ante $0.10
*** HOLE CARDS ***
Dealt to matiko09 [As Th]
HopeMayBee: folds 
orochimaturi: folds 
Infinitinium: folds 
matiko09: raises $1 to $1.50
mi$$I$Elena: raises $3 to $4.50
GOOFA13: folds 
zarplatka: folds 
joker180785: folds 
matiko09: folds 
Uncalled bet ($3) returned to mi$$I$Elena
mi$$I$Elena collected $4.55 from pot
mi$$I$Elena: doesn't show hand 
*** SUMMARY ***
Total pot $4.55 | Rake $0 
Seat 1: matiko09 folded before Flop
Seat 3: mi$$I$Elena collected ($4.55)
Seat 4: GOOFA13 (button) folded before Flop (didn't bet)
Seat 5: zarplatka (small blind) folded before Flop
Seat 6: joker180785 (big blind) folded before Flop
Seat 7: HopeMayBee folded before Flop (didn't bet)
Seat 8: orochimaturi folded before Flop (didn't bet)
Seat 9: Infinitinium folded before Flop (didn't bet)





PokerStars Hand #154970460507:  Hold'em No Limit ($0.50/$1.00 USD) - 2016/06/20 12:41:27 CET [2016/06/20 6:41:27 ET]
Table 'Isonoe II' 9-max Seat #2 is the button
Seat 1: hammerwife ($106.36 in chips) 
Seat 2: matiko09 ($108.02 in chips) 
Seat 3: Kukuryzka ($99 in chips) 
Seat 4: Avtovo ($100 in chips) 
Seat 5: Filojoes ($100 in chips) 
Seat 6: GOOFA13 ($71.96 in chips) 
Seat 7: SkUhNi ($115.82 in chips) 
Seat 8: lewyson ($47.27 in chips) 
Seat 9: djammusic ($61.95 in chips) 
Kukuryzka: posts small blind $0.50
Avtovo: posts big blind $1
*** HOLE CARDS ***
Dealt to matiko09 [6h Ts]
Filojoes: folds 
GOOFA13: folds 
SkUhNi: folds 
lewyson: raises $1 to $2
djammusic: folds 
hammerwife: folds 
matiko09: folds 
Kukuryzka: folds 
Avtovo: calls $1
*** FLOP *** [3s 9h Ac]
Avtovo: checks 
lewyson: bets $4.28
Avtovo: calls $4.28
*** TURN *** [3s 9h Ac] [5d]
Avtovo: checks 
lewyson: bets $10
Avtovo: folds 
Uncalled bet ($10) returned to lewyson
lewyson collected $12.41 from pot
*** SUMMARY ***
Total pot $13.06 | Rake $0.65 
Board [3s 9h Ac 5d]
Seat 1: hammerwife folded before Flop (didn't bet)
Seat 2: matiko09 (button) folded before Flop (didn't bet)
Seat 3: Kukuryzka (small blind) folded before Flop
Seat 4: Avtovo (big blind) folded on the Turn
Seat 5: Filojoes folded before Flop (didn't bet)
Seat 6: GOOFA13 folded before Flop (didn't bet)
Seat 7: SkUhNi folded before Flop (didn't bet)
Seat 8: lewyson collected ($12.41)
Seat 9: djammusic folded before Flop (didn't bet)





PokerStars Hand #154970464683:  Hold'em No Limit (£0.25/£0.50 GBP) - 2016/06/20 12:41:38 CET [2016/06/20 6:41:38 ET]
Table 'Azalea' 6-max Seat #5 is the button
Seat 1: mitsuVK (£102.73 in chips) 
Seat 2: matiko09 (£85.74 in chips) 
Seat 3: VahTang_89 (£53.77 in chips) 
Seat 4: faceMyBallz_ (£50 in chips) 
Seat 5: mudders693 (£72.61 in chips) 
Seat 6: Bënedic10 (£50 in chips) 
Bënedic10: posts small blind £0.25
mitsuVK: posts big blind £0.50
*** HOLE CARDS ***
Dealt to matiko09 [7s 8h]
matiko09: folds 
VahTang_89: raises £0.50 to £1
faceMyBallz_: raises £2.50 to £3.50
mudders693: folds 
Bënedic10: folds 
mitsuVK: folds 
VahTang_89: raises £4 to £7.50
faceMyBallz_: calls £4
*** FLOP *** [Ad 7h Qs]
VahTang_89: checks 
faceMyBallz_: bets £5
VahTang_89: calls £5
*** TURN *** [Ad 7h Qs] [8d]
VahTang_89: checks 
faceMyBallz_: bets £8.75
VahTang_89: calls £8.75
*** RIVER *** [Ad 7h Qs 8d] [5c]
VahTang_89: checks 
faceMyBallz_: checks 
*** SHOW DOWN ***
VahTang_89: shows [As Ks] (a pair of Aces)
faceMyBallz_: mucks hand 
VahTang_89 collected £41.85 from pot
*** SUMMARY ***
Total pot £43.25 | Rake £1.40 
Board [Ad 7h Qs 8d 5c]
Seat 1: mitsuVK (big blind) folded before Flop
Seat 2: matiko09 folded before Flop (didn't bet)
Seat 3: VahTang_89 showed [As Ks] and won (£41.85) with a pair of Aces
Seat 4: faceMyBallz_ mucked [Th Kh]
Seat 5: mudders693 (button) folded before Flop (didn't bet)
Seat 6: Bënedic10 (small blind) folded before Flop





PokerStars Hand #154970469201:  Hold'em No Limit (£0.25/£0.50 GBP) - 2016/06/20 12:41:49 CET [2016/06/20 6:41:49 ET]
Table 'Tesla' 6-max Seat #5 is the button
Seat 1: Rubleff85 (£51.76 in chips) 
Seat 2: matiko09 (£59.65 in chips) 
Seat 3: asmodej666 (£50 in chips) 
Seat 4: ILIUXa (£52.90 in chips) 
Seat 5: Nego Razu (£50 in chips) 
Seat 6: faceMyBallz_ (£55.68 in chips) 
faceMyBallz_: posts small blind £0.25
Rubleff85: posts big blind £0.50
*** HOLE CARDS ***
Dealt to matiko09 [4c 5d]
matiko09: folds 
asmodej666: folds 
ILIUXa: folds 
Nego Razu: raises £0.50 to £1
faceMyBallz_: raises £3 to £4
Rubleff85: folds 
Nego Razu: folds 
Uncalled bet (£3) returned to faceMyBallz_
faceMyBallz_ collected £2.50 from pot
faceMyBallz_: doesn't show hand 
*** SUMMARY ***
Total pot £2.50 | Rake £0 
Seat 1: Rubleff85 (big blind) folded before Flop
Seat 2: matiko09 folded before Flop (didn't bet)
Seat 3: asmodej666 folded before Flop (didn't bet)
Seat 4: ILIUXa folded before Flop (didn't bet)
Seat 5: Nego Razu (button) folded before Flop
Seat 6: faceMyBallz_ (small blind) collected (£2.50)





PokerStars Hand #154970469741:  Hold'em No Limit ($0.50/$1.00 USD) - 2016/06/20 12:41:50 CET [2016/06/20 6:41:50 ET]
Table 'Ernestina' 9-max Seat #2 is the button
Seat 1: diva3150 ($143.62 in chips) 
Seat 2: matiko09 ($100 in chips) 
Seat 3: Pvsx. ($185.27 in chips) 
Seat 4: SkUhNi ($101.50 in chips) 
Seat 5: Dickyxxx ($115.61 in chips) 
Seat 6: arctur17 ($77.79 in chips) 
Seat 7: djammusic ($40 in chips) 
Seat 8: ruslik_by ($266.24 in chips) 
Seat 9: 23SmOkEr07 ($103 in chips) 
Pvsx.: posts small blind $0.50
SkUhNi: posts big blind $1
*** HOLE CARDS ***
Dealt to matiko09 [Ad Jh]
Dickyxxx: folds 
arctur17: folds 
djammusic: raises $1.25 to $2.25
ruslik_by: folds 
23SmOkEr07: folds 
diva3150: folds 
matiko09: raises $5.25 to $7.50
Pvsx.: folds 
SkUhNi: folds 
djammusic: folds 
Uncalled bet ($5.25) returned to matiko09
matiko09 collected $6 from pot
matiko09: doesn't show hand 
*** SUMMARY ***
Total pot $6 | Rake $0 
Seat 1: diva3150 folded before Flop (didn't bet)
Seat 2: matiko09 (button) collected ($6)
Seat 3: Pvsx. (small blind) folded before Flop
Seat 4: SkUhNi (big blind) folded before Flop
Seat 5: Dickyxxx folded before Flop (didn't bet)
Seat 6: arctur17 folded before Flop (didn't bet)
Seat 7: djammusic folded before Flop
Seat 8: ruslik_by folded before Flop (didn't bet)
Seat 9: 23SmOkEr07 folded before Flop (didn't bet)





PokerStars Hand #154970469781:  Hold'em No Limit (£0.25/£0.50 GBP) - 2016/06/20 12:41:51 CET [2016/06/20 6:41:51 ET]
Table 'Ani' 6-max Seat #6 is the button
Seat 1: rewq99887788 (£36.32 in chips) 
Seat 3: Doobes8555 (£79.10 in chips) 
Seat 4: matiko09 (£53.14 in chips) 
Seat 5: Wwwasian (£56.27 in chips) 
Seat 6: faceMyBallz_ (£55.54 in chips) 
rewq99887788: posts small blind £0.25
joker180785: is sitting out 
Doobes8555: posts big blind £0.50
*** HOLE CARDS ***
Dealt to matiko09 [Js 9h]
joker180785 leaves the table
mitsuVK joins the table at seat #2 
matiko09: folds 
Wwwasian: folds 
faceMyBallz_: folds 
rewq99887788: folds 
Uncalled bet (£0.25) returned to Doobes8555
Doobes8555 collected £0.50 from pot
Doobes8555: doesn't show hand 
*** SUMMARY ***
Total pot £0.50 | Rake £0 
Seat 1: rewq99887788 (small blind) folded before Flop
Seat 3: Doobes8555 (big blind) collected (£0.50)
Seat 4: matiko09 folded before Flop (didn't bet)
Seat 5: Wwwasian folded before Flop (didn't bet)
Seat 6: faceMyBallz_ (button) folded before Flop (didn't bet)





PokerStars Hand #154970471773:  Hold'em No Limit ($0.50/$1.00 USD) - 2016/06/20 12:41:56 CET [2016/06/20 6:41:56 ET]
Table 'Ambrosia II' 9-max Seat #2 is the button
Seat 1: 23SmOkEr07 ($177.25 in chips) 
Seat 2: Eyeballz1307 ($19.84 in chips) 
Seat 3: mavin80 ($97.50 in chips) 
Seat 4: mi$$I$Elena ($211.42 in chips) 
Seat 5: Mattulh ($100.32 in chips) 
Seat 6: ruslik_by ($112.80 in chips) 
Seat 7: matiko09 ($100 in chips) 
Seat 8: hammerwife ($100 in chips) 
Seat 9: SkUhNi ($131.76 in chips) 
mavin80: posts small blind $0.50
mi$$I$Elena: posts big blind $1
*** HOLE CARDS ***
Dealt to matiko09 [Jh Kh]
Mattulh: folds 
ruslik_by: raises $2 to $3
matiko09: folds 
hammerwife: folds 
SkUhNi: folds 
23SmOkEr07: folds 
Eyeballz1307: folds 
mavin80: calls $2.50
mi$$I$Elena: folds 
*** FLOP *** [7s Th Td]
mavin80: bets $2
ruslik_by: calls $2
*** TURN *** [7s Th Td] [9h]
mavin80: bets $5
ruslik_by: folds 
Uncalled bet ($5) returned to mavin80
mavin80 collected $10.45 from pot
*** SUMMARY ***
Total pot $11 | Rake $0.55 
Board [7s Th Td 9h]
Seat 1: 23SmOkEr07 folded before Flop (didn't bet)
Seat 2: Eyeballz1307 (button) folded before Flop (didn't bet)
Seat 3: mavin80 (small blind) collected ($10.45)
Seat 4: mi$$I$Elena (big blind) folded before Flop
Seat 5: Mattulh folded before Flop (didn't bet)
Seat 6: ruslik_by folded on the Turn
Seat 7: matiko09 folded before Flop (didn't bet)
Seat 8: hammerwife folded before Flop (didn't bet)
Seat 9: SkUhNi folded before Flop (didn't bet)





PokerStars Hand #154970475425:  Hold'em No Limit ($0.25/$0.50 USD) - 2016/06/20 12:42:05 CET [2016/06/20 6:42:05 ET]
Table 'Scheddi II' 9-max Seat #5 is the button
Seat 1: matiko09 ($97.75 in chips) 
Seat 3: mi$$I$Elena ($96.40 in chips) 
Seat 4: GOOFA13 ($38.59 in chips) 
Seat 5: zarplatka ($40 in chips) 
Seat 6: joker180785 ($50 in chips) 
Seat 7: HopeMayBee ($69.06 in chips) 
Seat 8: orochimaturi ($29.70 in chips) 
Seat 9: Infinitinium ($104.66 in chips) 
joker180785: posts small blind $0.25
HopeMayBee: posts big blind $0.50
Yaaaazz: sits out 
matiko09: posts the ante $0.10
mi$$I$Elena: posts the ante $0.10
GOOFA13: posts the ante $0.10
zarplatka: posts the ante $0.10
joker180785: posts the ante $0.10
HopeMayBee: posts the ante $0.10
orochimaturi: posts the ante $0.10
Infinitinium: posts the ante $0.10
*** HOLE CARDS ***
Dealt to matiko09 [3h 5c]
orochimaturi: folds 
Infinitinium: calls $0.50
matiko09: folds 
mi$$I$Elena: folds 
GOOFA13: raises $2.50 to $3
zarplatka: folds 
joker180785: calls $2.75
HopeMayBee: folds 
Infinitinium: calls $2.50
*** FLOP *** [Ks 3d 7s]
joker180785: checks 
Infinitinium: checks 
GOOFA13: bets $4.50
joker180785: folds 
Infinitinium: calls $4.50
*** TURN *** [Ks 3d 7s] [8d]
Infinitinium: checks 
GOOFA13: bets $11
Infinitinium: calls $11
*** RIVER *** [Ks 3d 7s 8d] [9h]
Infinitinium: checks 
GOOFA13: bets $19.65
Infinitinium: folds 
Uncalled bet ($19.65) returned to GOOFA13
GOOFA13 collected $39.30 from pot
GOOFA13: doesn't show hand 
*** SUMMARY ***
Total pot $41.30 | Rake $2 
Board [Ks 3d 7s 8d 9h]
Seat 1: matiko09 folded before Flop (didn't bet)
Seat 3: mi$$I$Elena folded before Flop (didn't bet)
Seat 4: GOOFA13 collected ($39.30)
Seat 5: zarplatka (button) folded before Flop (didn't bet)
Seat 6: joker180785 (small blind) folded on the Flop
Seat 7: HopeMayBee (big blind) folded before Flop
Seat 8: orochimaturi folded before Flop (didn't bet)
Seat 9: Infinitinium folded on the River





PokerStars Hand #154970476731:  Hold'em No Limit ($0.50/$1.00 USD) - 2016/06/20 12:42:08 CET [2016/06/20 6:42:08 ET]
Table 'Anhui' 9-max Seat #6 is the button
Seat 1: SkUhNi ($155.92 in chips) 
Seat 2: ruslik_by ($274.18 in chips) 
Seat 3: hammerwife ($101.78 in chips) 
Seat 4: mavin80 ($39.84 in chips) 
Seat 5: mi$$I$Elena ($110.30 in chips) 
Seat 6: 23SmOkEr07 ($130.25 in chips) 
Seat 7: matiko09 ($130.68 in chips) 
Seat 8: blackmont111 ($71 in chips) 
Seat 9: TomBod1 ($88.03 in chips) 
matiko09: posts small blind $0.50
blackmont111: posts big blind $1
*** HOLE CARDS ***
Dealt to matiko09 [3d 2c]
TomBod1: folds 
SkUhNi: folds 
ruslik_by: folds 
hammerwife: folds 
mavin80: raises $1.50 to $2.50
mi$$I$Elena: raises $3 to $5.50
23SmOkEr07: calls $5.50
matiko09: folds 
blackmont111: folds 
mavin80: calls $3
*** FLOP *** [3h 5d Td]
mavin80: checks 
mi$$I$Elena: checks 
23SmOkEr07: bets $9.57
mavin80: calls $9.57
mi$$I$Elena: folds 
*** TURN *** [3h 5d Td] [6s]
mavin80: bets $23
23SmOkEr07: folds 
Uncalled bet ($23) returned to mavin80
mavin80 collected $35.28 from pot
*** SUMMARY ***
Total pot $37.14 | Rake $1.86 
Board [3h 5d Td 6s]
Seat 1: SkUhNi folded before Flop (didn't bet)
Seat 2: ruslik_by folded before Flop (didn't bet)
Seat 3: hammerwife folded before Flop (didn't bet)
Seat 4: mavin80 collected ($35.28)
Seat 5: mi$$I$Elena folded on the Flop
Seat 6: 23SmOkEr07 (button) folded on the Turn
Seat 7: matiko09 (small blind) folded before Flop
Seat 8: blackmont111 (big blind) folded before Flop
Seat 9: TomBod1 folded before Flop (didn't bet)





PokerStars Hand #154970477171:  Hold'em No Limit (£0.25/£0.50 GBP) - 2016/06/20 12:42:09 CET [2016/06/20 6:42:09 ET]
Table 'Ani' 6-max Seat #1 is the button
Seat 1: rewq99887788 (£36.07 in chips) 
Seat 3: Doobes8555 (£79.35 in chips) 
Seat 4: matiko09 (£53.14 in chips) 
Seat 5: Wwwasian (£56.27 in chips) 
Seat 6: faceMyBallz_ (£55.54 in chips) 
mitsuVK will be allowed to play after the button
Doobes8555: posts small blind £0.25
matiko09: posts big blind £0.50
*** HOLE CARDS ***
Dealt to matiko09 [5d 5s]
Wwwasian: folds 
faceMyBallz_: raises £0.75 to £1.25
rewq99887788: folds 
Doobes8555: calls £1
matiko09: calls £0.75
*** FLOP *** [9c Th Qs]
Doobes8555: checks 
matiko09: checks 
faceMyBallz_: checks 
*** TURN *** [9c Th Qs] [4h]
Doobes8555: bets £2
matiko09: folds 
faceMyBallz_: folds 
Uncalled bet (£2) returned to Doobes8555
Doobes8555 collected £3.56 from pot
Doobes8555: doesn't show hand 
*** SUMMARY ***
Total pot £3.75 | Rake £0.19 
Board [9c Th Qs 4h]
Seat 1: rewq99887788 (button) folded before Flop (didn't bet)
Seat 3: Doobes8555 (small blind) collected (£3.56)
Seat 4: matiko09 (big blind) folded on the Turn
Seat 5: Wwwasian folded before Flop (didn't bet)
Seat 6: faceMyBallz_ folded on the Turn





PokerStars Hand #154970477063:  Hold'em No Limit ($0.50/$1.00 USD) - 2016/06/20 12:42:09 CET [2016/06/20 6:42:09 ET]
Table 'Pongola' 9-max Seat #4 is the button
Seat 1: matiko09 ($104.50 in chips) 
Seat 2: ruslik_by ($129.27 in chips) 
Seat 3: SkUhNi ($114.72 in chips) 
Seat 4: karllv ($155.31 in chips) 
Seat 5: joker180785 ($106.43 in chips) 
Seat 6: 23SmOkEr07 ($114.21 in chips) 
Seat 7: Dickyxxx ($149.62 in chips) 
Seat 8: phrantique ($97.29 in chips) 
Seat 9: Filojoes ($100 in chips) 
joker180785: posts small blind $0.50
23SmOkEr07: posts big blind $1
*** HOLE CARDS ***
Dealt to matiko09 [As Ts]
Dickyxxx: folds 
phrantique: folds 
Filojoes: raises $2 to $3
matiko09: folds 
ruslik_by: folds 
SkUhNi: folds 
karllv: folds 
joker180785: folds 
23SmOkEr07: folds 
Uncalled bet ($2) returned to Filojoes
Filojoes collected $2.50 from pot
Filojoes: doesn't show hand 
*** SUMMARY ***
Total pot $2.50 | Rake $0 
Seat 1: matiko09 folded before Flop (didn't bet)
Seat 2: ruslik_by folded before Flop (didn't bet)
Seat 3: SkUhNi folded before Flop (didn't bet)
Seat 4: karllv (button) folded before Flop (didn't bet)
Seat 5: joker180785 (small blind) folded before Flop
Seat 6: 23SmOkEr07 (big blind) folded before Flop
Seat 7: Dickyxxx folded before Flop (didn't bet)
Seat 8: phrantique folded before Flop (didn't bet)
Seat 9: Filojoes collected ($2.50)





PokerStars Hand #154970481913:  Hold'em No Limit (£0.25/£0.50 GBP) - 2016/06/20 12:42:21 CET [2016/06/20 6:42:21 ET]
Table 'Tesla' 6-max Seat #6 is the button
Seat 1: Rubleff85 (£51.26 in chips) 
Seat 2: matiko09 (£59.65 in chips) 
Seat 3: asmodej666 (£50 in chips) 
Seat 4: ILIUXa (£52.90 in chips) 
Seat 5: Nego Razu (£50 in chips) 
Seat 6: faceMyBallz_ (£57.18 in chips) 
Rubleff85: posts small blind £0.25
matiko09: posts big blind £0.50
*** HOLE CARDS ***
Dealt to matiko09 [3s 5s]
asmodej666: folds 
ILIUXa: folds 
Nego Razu: folds 
faceMyBallz_: raises £0.50 to £1
Rubleff85: raises £1.50 to £2.50
matiko09: folds 
faceMyBallz_: calls £1.50
*** FLOP *** [9c 7s 5d]
Rubleff85: checks 
faceMyBallz_: checks 
*** TURN *** [9c 7s 5d] [9h]
Rubleff85: bets £2.75
faceMyBallz_: folds 
Uncalled bet (£2.75) returned to Rubleff85
Rubleff85 collected £5.22 from pot
Rubleff85: doesn't show hand 
*** SUMMARY ***
Total pot £5.50 | Rake £0.28 
Board [9c 7s 5d 9h]
Seat 1: Rubleff85 (small blind) collected (£5.22)
Seat 2: matiko09 (big blind) folded before Flop
Seat 3: asmodej666 folded before Flop (didn't bet)
Seat 4: ILIUXa folded before Flop (didn't bet)
Seat 5: Nego Razu folded before Flop (didn't bet)
Seat 6: faceMyBallz_ (button) folded on the Turn





PokerStars Hand #154970482004:  Hold'em No Limit ($0.50/$1.00 USD) - 2016/06/20 12:42:22 CET [2016/06/20 6:42:22 ET]
Table 'Ernestina' 9-max Seat #3 is the button
Seat 1: diva3150 ($143.62 in chips) 
Seat 2: matiko09 ($103.75 in chips) 
Seat 3: Pvsx. ($184.77 in chips) 
Seat 4: SkUhNi ($100.50 in chips) 
Seat 5: Dickyxxx ($115.61 in chips) 
Seat 6: arctur17 ($77.79 in chips) 
Seat 7: djammusic ($37.75 in chips) 
Seat 8: ruslik_by ($266.24 in chips) 
Seat 9: 23SmOkEr07 ($103 in chips) 
SkUhNi: posts small blind $0.50
Dickyxxx: posts big blind $1
*** HOLE CARDS ***
Dealt to matiko09 [Jd 7c]
arctur17: folds 
djammusic: folds 
ruslik_by: folds 
23SmOkEr07: folds 
diva3150: folds 
matiko09: folds 
Pvsx.: raises $1.50 to $2.50
SkUhNi: folds 
Dickyxxx: folds 
Uncalled bet ($1.50) returned to Pvsx.
Pvsx. collected $2.50 from pot
Pvsx.: doesn't show hand 
*** SUMMARY ***
Total pot $2.50 | Rake $0 
Seat 1: diva3150 folded before Flop (didn't bet)
Seat 2: matiko09 folded before Flop (didn't bet)
Seat 3: Pvsx. (button) collected ($2.50)
Seat 4: SkUhNi (small blind) folded before Flop
Seat 5: Dickyxxx (big blind) folded before Flop
Seat 6: arctur17 folded before Flop (didn't bet)
Seat 7: djammusic folded before Flop (didn't bet)
Seat 8: ruslik_by folded before Flop (didn't bet)
Seat 9: 23SmOkEr07 folded before Flop (didn't bet)





PokerStars Hand #154970482415:  Hold'em No Limit ($0.50/$1.00 USD) - 2016/06/20 12:42:23 CET [2016/06/20 6:42:23 ET]
Table 'Annika' 9-max Seat #1 is the button
Seat 1: hammerwife ($132.77 in chips) 
Seat 2: matiko09 ($102.72 in chips) 
Seat 3: first_dnk ($85.50 in chips) 
Seat 4: Kukuryzka ($108.50 in chips) 
Seat 5: SkUhNi ($126.13 in chips) 
Seat 6: Pvsx. ($112.55 in chips) 
Seat 7: jirka117 ($51.45 in chips) 
Seat 8: ruslik_by ($106.40 in chips) 
Seat 9: 23SmOkEr07 ($100 in chips) 
matiko09: posts small blind $0.50
first_dnk: posts big blind $1
*** HOLE CARDS ***
Dealt to matiko09 [3s Ts]
Kukuryzka: folds 
SkUhNi: folds 
Pvsx.: raises $1.50 to $2.50
jirka117: calls $2.50
ruslik_by: folds 
23SmOkEr07: calls $2.50
hammerwife: folds 
matiko09: folds 
first_dnk: folds 
*** FLOP *** [8s 9d 7s]
Pvsx.: bets $6
jirka117: calls $6
23SmOkEr07: calls $6
*** TURN *** [8s 9d 7s] [Qs]
Pvsx.: checks 
jirka117: checks 
23SmOkEr07: checks 
*** RIVER *** [8s 9d 7s Qs] [2s]
Pvsx.: checks 
jirka117: checks 
23SmOkEr07: bets $14.36
Pvsx.: folds 
jirka117: folds 
Uncalled bet ($14.36) returned to 23SmOkEr07
23SmOkEr07 collected $25.65 from pot
23SmOkEr07: doesn't show hand 
*** SUMMARY ***
Total pot $27 | Rake $1.35 
Board [8s 9d 7s Qs 2s]
Seat 1: hammerwife (button) folded before Flop (didn't bet)
Seat 2: matiko09 (small blind) folded before Flop
Seat 3: first_dnk (big blind) folded before Flop
Seat 4: Kukuryzka folded before Flop (didn't bet)
Seat 5: SkUhNi folded before Flop (didn't bet)
Seat 6: Pvsx. folded on the River
Seat 7: jirka117 folded on the River
Seat 8: ruslik_by folded before Flop (didn't bet)
Seat 9: 23SmOkEr07 collected ($25.65)





PokerStars Hand #154970484364:  Hold'em No Limit ($0.50/$1.00 USD) - 2016/06/20 12:42:28 CET [2016/06/20 6:42:28 ET]
Table 'Isonoe II' 9-max Seat #3 is the button
Seat 1: hammerwife ($106.36 in chips) 
Seat 2: matiko09 ($108.02 in chips) 
Seat 3: Kukuryzka ($100 in chips) 
Seat 4: Avtovo ($100 in chips) 
Seat 5: Filojoes ($100 in chips) 
Seat 6: GOOFA13 ($71.96 in chips) 
Seat 7: SkUhNi ($115.82 in chips) 
Seat 8: lewyson ($53.40 in chips) 
Seat 9: djammusic ($61.95 in chips) 
Avtovo: posts small blind $0.50
Filojoes: posts big blind $1
*** HOLE CARDS ***
Dealt to matiko09 [5c Kc]
GOOFA13: folds 
SkUhNi: folds 
lewyson: raises $2 to $3
djammusic: folds 
hammerwife: folds 
matiko09: folds 
Kukuryzka: folds 
Avtovo: folds 
Filojoes: calls $2
*** FLOP *** [8d 9d Kd]
Filojoes: checks 
lewyson: bets $6
Filojoes: folds 
Uncalled bet ($6) returned to lewyson
lewyson collected $6.18 from pot
*** SUMMARY ***
Total pot $6.50 | Rake $0.32 
Board [8d 9d Kd]
Seat 1: hammerwife folded before Flop (didn't bet)
Seat 2: matiko09 folded before Flop (didn't bet)
Seat 3: Kukuryzka (button) folded before Flop (didn't bet)
Seat 4: Avtovo (small blind) folded before Flop
Seat 5: Filojoes (big blind) folded on the Flop
Seat 6: GOOFA13 folded before Flop (didn't bet)
Seat 7: SkUhNi folded before Flop (didn't bet)
Seat 8: lewyson collected ($6.18)
Seat 9: djammusic folded before Flop (didn't bet)





PokerStars Hand #154970491871:  Hold'em No Limit ($0.50/$1.00 USD) - 2016/06/20 12:42:47 CET [2016/06/20 6:42:47 ET]
Table 'Pongola' 9-max Seat #5 is the button
Seat 1: matiko09 ($104.50 in chips) 
Seat 2: ruslik_by ($129.27 in chips) 
Seat 3: SkUhNi ($114.72 in chips) 
Seat 4: karllv ($155.31 in chips) 
Seat 5: joker180785 ($105.93 in chips) 
Seat 6: 23SmOkEr07 ($113.21 in chips) 
Seat 7: Dickyxxx ($149.62 in chips) 
Seat 8: phrantique ($97.29 in chips) 
Seat 9: Filojoes ($101.50 in chips) 
23SmOkEr07: posts small blind $0.50
Dickyxxx: posts big blind $1
*** HOLE CARDS ***
Dealt to matiko09 [Tc Qh]
phrantique: raises $1.80 to $2.80
Filojoes: folds 
matiko09: folds 
ruslik_by: folds 
SkUhNi: folds 
karllv: folds 
joker180785: raises $5.20 to $8
23SmOkEr07: folds 
Dickyxxx: folds 
phrantique: calls $5.20
*** FLOP *** [8c 2d 7d]
phrantique: checks 
joker180785: bets $10.47
phrantique: calls $10.47
*** TURN *** [8c 2d 7d] [Jd]
phrantique: checks 
joker180785: bets $22
phrantique: raises $25 to $47
joker180785: raises $40.46 to $87.46 and is all-in
phrantique: folds 
Uncalled bet ($40.46) returned to joker180785
joker180785 collected $129.94 from pot
*** SUMMARY ***
Total pot $132.44 | Rake $2.50 
Board [8c 2d 7d Jd]
Seat 1: matiko09 folded before Flop (didn't bet)
Seat 2: ruslik_by folded before Flop (didn't bet)
Seat 3: SkUhNi folded before Flop (didn't bet)
Seat 4: karllv folded before Flop (didn't bet)
Seat 5: joker180785 (button) collected ($129.94)
Seat 6: 23SmOkEr07 (small blind) folded before Flop
Seat 7: Dickyxxx (big blind) folded before Flop
Seat 8: phrantique folded on the Turn
Seat 9: Filojoes folded before Flop (didn't bet)





PokerStars Hand #154970493057:  Hold'em No Limit (£0.25/£0.50 GBP) - 2016/06/20 12:42:50 CET [2016/06/20 6:42:50 ET]
Table 'Azalea' 6-max Seat #6 is the button
Seat 1: mitsuVK (£102.23 in chips) 
Seat 2: matiko09 (£85.74 in chips) 
Seat 3: VahTang_89 (£74.37 in chips) 
Seat 4: faceMyBallz_ (£50 in chips) 
Seat 5: mudders693 (£72.61 in chips) 
Seat 6: Bënedic10 (£50 in chips) 
mitsuVK: posts small blind £0.25
matiko09: posts big blind £0.50
*** HOLE CARDS ***
Dealt to matiko09 [2h 3d]
VahTang_89: folds 
faceMyBallz_: raises £1 to £1.50
mudders693: folds 
Bënedic10: folds 
mitsuVK: raises £3.50 to £5
matiko09: folds 
faceMyBallz_: calls £3.50
*** FLOP *** [7c 8s Ah]
mitsuVK: checks 
faceMyBallz_: bets £4
mitsuVK: calls £4
*** TURN *** [7c 8s Ah] [6c]
mitsuVK: checks 
faceMyBallz_: bets £8
mitsuVK: calls £8
*** RIVER *** [7c 8s Ah 6c] [7s]
mitsuVK: checks 
faceMyBallz_: bets £33 and is all-in
mitsuVK: calls £33
*** SHOW DOWN ***
faceMyBallz_: shows [Td 9d] (a straight, Six to Ten)
mitsuVK: shows [Ac Kd] (two pair, Aces and Sevens)
faceMyBallz_ collected £99.10 from pot
*** SUMMARY ***
Total pot £100.50 | Rake £1.40 
Board [7c 8s Ah 6c 7s]
Seat 1: mitsuVK (small blind) showed [Ac Kd] and lost with two pair, Aces and Sevens
Seat 2: matiko09 (big blind) folded before Flop
Seat 3: VahTang_89 folded before Flop (didn't bet)
Seat 4: faceMyBallz_ showed [Td 9d] and won (£99.10) with a straight, Six to Ten
Seat 5: mudders693 folded before Flop (didn't bet)
Seat 6: Bënedic10 (button) folded before Flop (didn't bet)





PokerStars Hand #154970495759:  Hold'em No Limit ($0.50/$1.00 USD) - 2016/06/20 12:42:57 CET [2016/06/20 6:42:57 ET]
Table 'Ernestina' 9-max Seat #4 is the button
Seat 1: diva3150 ($143.62 in chips) 
Seat 2: matiko09 ($103.75 in chips) 
Seat 3: Pvsx. ($186.27 in chips) 
Seat 4: SkUhNi ($100 in chips) 
Seat 5: Dickyxxx ($114.61 in chips) 
Seat 8: ruslik_by ($266.24 in chips) 
Seat 9: 23SmOkEr07 ($103 in chips) 
Dickyxxx: posts small blind $0.50
djammusic: is sitting out 
ruslik_by: posts big blind $1
*** HOLE CARDS ***
Dealt to matiko09 [Qs 8c]
23SmOkEr07: folds 
diva3150: folds 
matiko09: folds 
Pvsx.: folds 
SkUhNi: raises $1 to $2
Dickyxxx: folds 
ruslik_by: calls $1
*** FLOP *** [Qc 9d 9s]
ruslik_by: checks 
SkUhNi: bets $3
ruslik_by: folds 
Uncalled bet ($3) returned to SkUhNi
SkUhNi collected $4.28 from pot
SkUhNi: doesn't show hand 
*** SUMMARY ***
Total pot $4.50 | Rake $0.22 
Board [Qc 9d 9s]
Seat 1: diva3150 folded before Flop (didn't bet)
Seat 2: matiko09 folded before Flop (didn't bet)
Seat 3: Pvsx. folded before Flop (didn't bet)
Seat 4: SkUhNi (button) collected ($4.28)
Seat 5: Dickyxxx (small blind) folded before Flop
Seat 8: ruslik_by (big blind) folded on the Flop
Seat 9: 23SmOkEr07 folded before Flop (didn't bet)





PokerStars Hand #154970496262:  Hold'em No Limit (£0.25/£0.50 GBP) - 2016/06/20 12:42:58 CET [2016/06/20 6:42:58 ET]
Table 'Ani' 6-max Seat #3 is the button
Seat 1: rewq99887788 (£36.07 in chips) 
Seat 3: Doobes8555 (£81.66 in chips) 
Seat 4: matiko09 (£51.89 in chips) 
Seat 5: Wwwasian (£56.27 in chips) 
Seat 6: faceMyBallz_ (£54.29 in chips) 
matiko09: posts small blind £0.25
Wwwasian: posts big blind £0.50
mitsuVK: sits out 
*** HOLE CARDS ***
Dealt to matiko09 [4h Jd]
faceMyBallz_: folds 
rewq99887788: folds 
Doobes8555: folds 
matiko09: folds 
Uncalled bet (£0.25) returned to Wwwasian
Wwwasian collected £0.50 from pot
Wwwasian: doesn't show hand 
*** SUMMARY ***
Total pot £0.50 | Rake £0 
Seat 1: rewq99887788 folded before Flop (didn't bet)
Seat 3: Doobes8555 (button) folded before Flop (didn't bet)
Seat 4: matiko09 (small blind) folded before Flop
Seat 5: Wwwasian (big blind) collected (£0.50)
Seat 6: faceMyBallz_ folded before Flop (didn't bet)





PokerStars Hand #154970498605:  Hold'em No Limit ($0.50/$1.00 USD) - 2016/06/20 12:43:04 CET [2016/06/20 6:43:04 ET]
Table 'Isonoe II' 9-max Seat #4 is the button
Seat 1: hammerwife ($106.36 in chips) 
Seat 2: matiko09 ($108.02 in chips) 
Seat 3: Kukuryzka ($100 in chips) 
Seat 4: Avtovo ($100 in chips) 
Seat 5: Filojoes ($100 in chips) 
Seat 6: GOOFA13 ($71.96 in chips) 
Seat 7: SkUhNi ($115.82 in chips) 
Seat 8: lewyson ($56.58 in chips) 
Seat 9: djammusic ($61.95 in chips) 
Filojoes: posts small blind $0.50
GOOFA13: posts big blind $1
*** HOLE CARDS ***
Dealt to matiko09 [3d Jc]
SkUhNi: folds 
lewyson: folds 
djammusic: folds 
hammerwife: folds 
matiko09: folds 
Kukuryzka: folds 
Avtovo: folds 
Filojoes: raises $1.50 to $2.50
GOOFA13: folds 
Uncalled bet ($1.50) returned to Filojoes
Filojoes collected $2 from pot
Filojoes: doesn't show hand 
*** SUMMARY ***
Total pot $2 | Rake $0 
Seat 1: hammerwife folded before Flop (didn't bet)
Seat 2: matiko09 folded before Flop (didn't bet)
Seat 3: Kukuryzka folded before Flop (didn't bet)
Seat 4: Avtovo (button) folded before Flop (didn't bet)
Seat 5: Filojoes (small blind) collected ($2)
Seat 6: GOOFA13 (big blind) folded before Flop
Seat 7: SkUhNi folded before Flop (didn't bet)
Seat 8: lewyson folded before Flop (didn't bet)
Seat 9: djammusic folded before Flop (didn't bet)





PokerStars Hand #154970502954:  Hold'em No Limit (£0.25/£0.50 GBP) - 2016/06/20 12:43:15 CET [2016/06/20 6:43:15 ET]
Table 'Ani' 6-max Seat #4 is the button
Seat 1: rewq99887788 (£36.07 in chips) 
Seat 3: Doobes8555 (£81.66 in chips) 
Seat 4: matiko09 (£51.64 in chips) 
Seat 5: Wwwasian (£56.52 in chips) 
Seat 6: faceMyBallz_ (£54.29 in chips) 
Wwwasian: posts small blind £0.25
faceMyBallz_: posts big blind £0.50
mitsuVK: sits out 
*** HOLE CARDS ***
Dealt to matiko09 [9c 2d]
rewq99887788: folds 
Doobes8555: folds 
matiko09: folds 
Wwwasian: folds 
Uncalled bet (£0.25) returned to faceMyBallz_
faceMyBallz_ collected £0.50 from pot
faceMyBallz_: doesn't show hand 
*** SUMMARY ***
Total pot £0.50 | Rake £0 
Seat 1: rewq99887788 folded before Flop (didn't bet)
Seat 3: Doobes8555 folded before Flop (didn't bet)
Seat 4: matiko09 (button) folded before Flop (didn't bet)
Seat 5: Wwwasian (small blind) folded before Flop
Seat 6: faceMyBallz_ (big blind) collected (£0.50)





PokerStars Hand #154970503106:  Hold'em No Limit ($0.50/$1.00 USD) - 2016/06/20 12:43:15 CET [2016/06/20 6:43:15 ET]
Table 'Ambrosia II' 9-max Seat #3 is the button
Seat 1: 23SmOkEr07 ($177.25 in chips) 
Seat 2: Eyeballz1307 ($19.84 in chips) 
Seat 3: mavin80 ($102.95 in chips) 
Seat 4: mi$$I$Elena ($210.42 in chips) 
Seat 5: Mattulh ($100.32 in chips) 
Seat 6: ruslik_by ($107.80 in chips) 
Seat 7: matiko09 ($100 in chips) 
Seat 8: hammerwife ($100 in chips) 
Seat 9: SkUhNi ($131.76 in chips) 
mi$$I$Elena: posts small blind $0.50
Mattulh: posts big blind $1
*** HOLE CARDS ***
Dealt to matiko09 [3h 8c]
ruslik_by: folds 
matiko09: folds 
hammerwife: folds 
SkUhNi: folds 
23SmOkEr07: folds 
Eyeballz1307: folds 
mavin80: folds 
mi$$I$Elena: raises $2 to $3
Mattulh: calls $2
*** FLOP *** [4d 5h 3s]
mi$$I$Elena: checks 
Mattulh: checks 
*** TURN *** [4d 5h 3s] [Js]
mi$$I$Elena: bets $3.50
Mattulh: calls $3.50
*** RIVER *** [4d 5h 3s Js] [Kc]
mi$$I$Elena: bets $7.50
Mattulh: folds 
Uncalled bet ($7.50) returned to mi$$I$Elena
mi$$I$Elena collected $12.35 from pot
mi$$I$Elena: doesn't show hand 
*** SUMMARY ***
Total pot $13 | Rake $0.65 
Board [4d 5h 3s Js Kc]
Seat 1: 23SmOkEr07 folded before Flop (didn't bet)
Seat 2: Eyeballz1307 folded before Flop (didn't bet)
Seat 3: mavin80 (button) folded before Flop (didn't bet)
Seat 4: mi$$I$Elena (small blind) collected ($12.35)
Seat 5: Mattulh (big blind) folded on the River
Seat 6: ruslik_by folded before Flop (didn't bet)
Seat 7: matiko09 folded before Flop (didn't bet)
Seat 8: hammerwife folded before Flop (didn't bet)
Seat 9: SkUhNi folded before Flop (didn't bet)





PokerStars Hand #154970505194:  Hold'em No Limit (£0.25/£0.50 GBP) - 2016/06/20 12:43:21 CET [2016/06/20 6:43:21 ET]
Table 'Tesla' 6-max Seat #1 is the button
Seat 1: Rubleff85 (£53.98 in chips) 
Seat 2: matiko09 (£59.15 in chips) 
Seat 3: asmodej666 (£50 in chips) 
Seat 4: ILIUXa (£52.90 in chips) 
Seat 5: Nego Razu (£50 in chips) 
Seat 6: faceMyBallz_ (£54.68 in chips) 
matiko09: posts small blind £0.25
asmodej666: posts big blind £0.50
*** HOLE CARDS ***
Dealt to matiko09 [7d 6h]
ILIUXa: folds 
Nego Razu: raises £0.77 to £1.27
faceMyBallz_: calls £1.27
Rubleff85: calls £1.27
matiko09: folds 
asmodej666: raises £5.33 to £6.60
Nego Razu: folds 
faceMyBallz_: calls £5.33
Rubleff85: folds 
*** FLOP *** [Kd 9s Ks]
asmodej666: bets £7
faceMyBallz_: folds 
Uncalled bet (£7) returned to asmodej666
asmodej666 collected £15.19 from pot
asmodej666: doesn't show hand 
*** SUMMARY ***
Total pot £15.99 | Rake £0.80 
Board [Kd 9s Ks]
Seat 1: Rubleff85 (button) folded before Flop
Seat 2: matiko09 (small blind) folded before Flop
Seat 3: asmodej666 (big blind) collected (£15.19)
Seat 4: ILIUXa folded before Flop (didn't bet)
Seat 5: Nego Razu folded before Flop
Seat 6: faceMyBallz_ folded on the Flop





PokerStars Hand #154970509581:  Hold'em No Limit (£0.25/£0.50 GBP) - 2016/06/20 12:43:32 CET [2016/06/20 6:43:32 ET]
Table 'Ani' 6-max Seat #5 is the button
Seat 1: rewq99887788 (£36.07 in chips) 
Seat 3: Doobes8555 (£81.66 in chips) 
Seat 4: matiko09 (£51.64 in chips) 
Seat 5: Wwwasian (£56.27 in chips) 
Seat 6: faceMyBallz_ (£54.54 in chips) 
faceMyBallz_: posts small blind £0.25
rewq99887788: posts big blind £0.50
mitsuVK: sits out 
*** HOLE CARDS ***
Dealt to matiko09 [5c Ah]
Doobes8555: calls £0.50
matiko09: folds 
Wwwasian: folds 
faceMyBallz_: folds 
rewq99887788: raises £2 to £2.50
Doobes8555: calls £2
*** FLOP *** [7d Qd Ac]
rewq99887788: bets £2.50
Doobes8555: calls £2.50
*** TURN *** [7d Qd Ac] [3c]
rewq99887788: checks 
Doobes8555: checks 
*** RIVER *** [7d Qd Ac 3c] [8d]
rewq99887788: bets £6.50
Doobes8555: folds 
Uncalled bet (£6.50) returned to rewq99887788
rewq99887788 collected £9.74 from pot
*** SUMMARY ***
Total pot £10.25 | Rake £0.51 
Board [7d Qd Ac 3c 8d]
Seat 1: rewq99887788 (big blind) collected (£9.74)
Seat 3: Doobes8555 folded on the River
Seat 4: matiko09 folded before Flop (didn't bet)
Seat 5: Wwwasian (button) folded before Flop (didn't bet)
Seat 6: faceMyBallz_ (small blind) folded before Flop





PokerStars Hand #154970510051:  Hold'em No Limit ($0.50/$1.00 USD) - 2016/06/20 12:43:33 CET [2016/06/20 6:43:33 ET]
Table 'Ernestina' 9-max Seat #5 is the button
Seat 1: diva3150 ($143.62 in chips) 
Seat 2: matiko09 ($103.75 in chips) 
Seat 3: Pvsx. ($186.27 in chips) 
Seat 4: SkUhNi ($102.28 in chips) 
Seat 5: Dickyxxx ($114.11 in chips) 
Seat 8: ruslik_by ($264.24 in chips) 
Seat 9: 23SmOkEr07 ($103 in chips) 
ruslik_by: posts small blind $0.50
23SmOkEr07: posts big blind $1
*** HOLE CARDS ***
Dealt to matiko09 [Kd Jh]
diva3150: folds 
matiko09: folds 
Pvsx.: raises $1.50 to $2.50
SkUhNi: folds 
Dickyxxx: folds 
ruslik_by: folds 
23SmOkEr07: calls $1.50
*** FLOP *** [9s 2c Js]
23SmOkEr07: checks 
Pvsx.: bets $3
23SmOkEr07: folds 
Uncalled bet ($3) returned to Pvsx.
Pvsx. collected $5.22 from pot
Pvsx.: doesn't show hand 
*** SUMMARY ***
Total pot $5.50 | Rake $0.28 
Board [9s 2c Js]
Seat 1: diva3150 folded before Flop (didn't bet)
Seat 2: matiko09 folded before Flop (didn't bet)
Seat 3: Pvsx. collected ($5.22)
Seat 4: SkUhNi folded before Flop (didn't bet)
Seat 5: Dickyxxx (button) folded before Flop (didn't bet)
Seat 8: ruslik_by (small blind) folded before Flop
Seat 9: 23SmOkEr07 (big blind) folded on the Flop





PokerStars Hand #154970511220:  Hold'em No Limit ($0.50/$1.00 USD) - 2016/06/20 12:43:36 CET [2016/06/20 6:43:36 ET]
Table 'Garumna II' 9-max Seat #5 is the button
Seat 5: rura53 ($79.50 in chips) 
Seat 7: Avtovo ($100.50 in chips) 
Seat 8: matiko09 ($100 in chips) 
SexyAngeline will be allowed to play after the button
Avtovo: posts small blind $0.50
matiko09: posts big blind $1
SkUhNi: sits out 
*** HOLE CARDS ***
Dealt to matiko09 [7s Kd]
rura53: folds 
Avtovo: folds 
Uncalled bet ($0.50) returned to matiko09
matiko09 collected $1 from pot
matiko09: doesn't show hand 
*** SUMMARY ***
Total pot $1 | Rake $0 
Seat 5: rura53 (button) folded before Flop (didn't bet)
Seat 7: Avtovo (small blind) folded before Flop
Seat 8: matiko09 (big blind) collected ($1)





PokerStars Hand #154970511155:  Hold'em No Limit ($0.50/$1.00 USD) - 2016/06/20 12:43:36 CET [2016/06/20 6:43:36 ET]
Table 'Annika' 9-max Seat #2 is the button
Seat 1: hammerwife ($132.77 in chips) 
Seat 2: matiko09 ($102.22 in chips) 
Seat 3: first_dnk ($84.50 in chips) 
Seat 4: Kukuryzka ($108.50 in chips) 
Seat 5: SkUhNi ($126.13 in chips) 
Seat 6: Pvsx. ($104.05 in chips) 
Seat 7: jirka117 ($42.95 in chips) 
Seat 8: ruslik_by ($106.40 in chips) 
Seat 9: 23SmOkEr07 ($117.15 in chips) 
first_dnk: posts small blind $0.50
Kukuryzka: posts big blind $1
*** HOLE CARDS ***
Dealt to matiko09 [5s 5d]
SkUhNi: folds 
Pvsx.: folds 
jirka117: calls $1
ruslik_by: folds 
23SmOkEr07: folds 
hammerwife: folds 
matiko09: raises $2.50 to $3.50
first_dnk: folds 
Kukuryzka: folds 
jirka117: calls $2.50
*** FLOP *** [4s Ts 8s]
jirka117: checks 
matiko09: checks 
*** TURN *** [4s Ts 8s] [8d]
jirka117: checks 
matiko09: bets $4
jirka117: folds 
Uncalled bet ($4) returned to matiko09
matiko09 collected $8.08 from pot
matiko09: doesn't show hand 
*** SUMMARY ***
Total pot $8.50 | Rake $0.42 
Board [4s Ts 8s 8d]
Seat 1: hammerwife folded before Flop (didn't bet)
Seat 2: matiko09 (button) collected ($8.08)
Seat 3: first_dnk (small blind) folded before Flop
Seat 4: Kukuryzka (big blind) folded before Flop
Seat 5: SkUhNi folded before Flop (didn't bet)
Seat 6: Pvsx. folded before Flop (didn't bet)
Seat 7: jirka117 folded on the Turn
Seat 8: ruslik_by folded before Flop (didn't bet)
Seat 9: 23SmOkEr07 folded before Flop (didn't bet)





PokerStars Hand #154970511864:  Hold'em No Limit ($0.25/$0.50 USD) - 2016/06/20 12:43:38 CET [2016/06/20 6:43:38 ET]
Table 'Scheddi II' 9-max Seat #6 is the button
Seat 1: matiko09 ($97.65 in chips) 
Seat 3: mi$$I$Elena ($96.30 in chips) 
Seat 4: GOOFA13 ($59.29 in chips) 
Seat 5: zarplatka ($40 in chips) 
Seat 6: joker180785 ($50 in chips) 
Seat 7: HopeMayBee ($68.46 in chips) 
Seat 8: orochimaturi ($29.60 in chips) 
Seat 9: Infinitinium ($86.06 in chips) 
HopeMayBee: posts small blind $0.25
orochimaturi: posts big blind $0.50
Yaaaazz: sits out 
matiko09: posts the ante $0.10
mi$$I$Elena: posts the ante $0.10
GOOFA13: posts the ante $0.10
zarplatka: posts the ante $0.10
joker180785: posts the ante $0.10
HopeMayBee: posts the ante $0.10
orochimaturi: posts the ante $0.10
Infinitinium: posts the ante $0.10
*** HOLE CARDS ***
Dealt to matiko09 [7h 5s]
Infinitinium: folds 
matiko09: folds 
mi$$I$Elena: folds 
GOOFA13: folds 
zarplatka: folds 
joker180785: folds 
HopeMayBee: raises $0.75 to $1.25
orochimaturi: calls $0.75
*** FLOP *** [4d Js 3c]
HopeMayBee: bets $2
orochimaturi: folds 
Uncalled bet ($2) returned to HopeMayBee
HopeMayBee collected $3.14 from pot
HopeMayBee: doesn't show hand 
*** SUMMARY ***
Total pot $3.30 | Rake $0.16 
Board [4d Js 3c]
Seat 1: matiko09 folded before Flop (didn't bet)
Seat 3: mi$$I$Elena folded before Flop (didn't bet)
Seat 4: GOOFA13 folded before Flop (didn't bet)
Seat 5: zarplatka folded before Flop (didn't bet)
Seat 6: joker180785 (button) folded before Flop (didn't bet)
Seat 7: HopeMayBee (small blind) collected ($3.14)
Seat 8: orochimaturi (big blind) folded on the Flop
Seat 9: Infinitinium folded before Flop (didn't bet)





PokerStars Hand #154970514420:  Hold'em No Limit ($0.50/$1.00 USD) - 2016/06/20 12:43:44 CET [2016/06/20 6:43:44 ET]
Table 'Garumna II' 9-max Seat #7 is the button
Seat 5: rura53 ($79.50 in chips) 
Seat 7: Avtovo ($100 in chips) 
Seat 8: matiko09 ($100.50 in chips) 
Seat 9: SkUhNi ($100 in chips) 
matiko09: posts small blind $0.50
SkUhNi: posts big blind $1
SexyAngeline: sits out 
*** HOLE CARDS ***
Dealt to matiko09 [Qd Qh]
rura53: folds 
Avtovo: folds 
matiko09: raises $2 to $3
SkUhNi: calls $2
*** FLOP *** [8c 7h 6d]
matiko09: checks 
SkUhNi: bets $4
matiko09: calls $4
*** TURN *** [8c 7h 6d] [7s]
matiko09: checks 
SkUhNi: checks 
*** RIVER *** [8c 7h 6d 7s] [Tc]
matiko09: checks 
SkUhNi: bets $7
ki11u joins the table at seat #1 
matiko09: folds 
Uncalled bet ($7) returned to SkUhNi
SkUhNi collected $13.30 from pot
SkUhNi: doesn't show hand 
*** SUMMARY ***
Total pot $14 | Rake $0.70 
Board [8c 7h 6d 7s Tc]
Seat 5: rura53 folded before Flop (didn't bet)
Seat 7: Avtovo (button) folded before Flop (didn't bet)
Seat 8: matiko09 (small blind) folded on the River
Seat 9: SkUhNi (big blind) collected ($13.30)





PokerStars Hand #154970518898:  Hold'em No Limit ($0.50/$1.00 USD) - 2016/06/20 12:43:55 CET [2016/06/20 6:43:55 ET]
Table 'Isonoe II' 9-max Seat #5 is the button
Seat 1: hammerwife ($106.36 in chips) 
Seat 2: matiko09 ($108.02 in chips) 
Seat 3: Kukuryzka ($100 in chips) 
Seat 4: Avtovo ($100 in chips) 
Seat 5: Filojoes ($101 in chips) 
Seat 6: GOOFA13 ($70.96 in chips) 
Seat 7: SkUhNi ($115.82 in chips) 
Seat 8: lewyson ($56.58 in chips) 
Seat 9: djammusic ($61.95 in chips) 
GOOFA13: posts small blind $0.50
SkUhNi: posts big blind $1
*** HOLE CARDS ***
Dealt to matiko09 [4s As]
lewyson: folds 
djammusic: folds 
hammerwife: folds 
matiko09: folds 
Kukuryzka: folds 
Avtovo: folds 
Filojoes: folds 
GOOFA13: folds 
Uncalled bet ($0.50) returned to SkUhNi
SkUhNi collected $1 from pot
SkUhNi: doesn't show hand 
*** SUMMARY ***
Total pot $1 | Rake $0 
Seat 1: hammerwife folded before Flop (didn't bet)
Seat 2: matiko09 folded before Flop (didn't bet)
Seat 3: Kukuryzka folded before Flop (didn't bet)
Seat 4: Avtovo folded before Flop (didn't bet)
Seat 5: Filojoes (button) folded before Flop (didn't bet)
Seat 6: GOOFA13 (small blind) folded before Flop
Seat 7: SkUhNi (big blind) collected ($1)
Seat 8: lewyson folded before Flop (didn't bet)
Seat 9: djammusic folded before Flop (didn't bet)





PokerStars Hand #154970523149:  Hold'em No Limit (£0.25/£0.50 GBP) - 2016/06/20 12:44:06 CET [2016/06/20 6:44:06 ET]
Table 'Azalea' 6-max Seat #1 is the button
Seat 1: mitsuVK (£52.23 in chips) 
Seat 2: matiko09 (£85.24 in chips) 
Seat 4: faceMyBallz_ (£99.10 in chips) 
Seat 5: mudders693 (£72.61 in chips) 
Seat 6: Bënedic10 (£50 in chips) 
matiko09: posts small blind £0.25
VahTang_89: is sitting out 
faceMyBallz_: posts big blind £0.50
*** HOLE CARDS ***
Dealt to matiko09 [8h 6h]
VahTang_89 leaves the table
tyoma_knp joins the table at seat #3 
mudders693: raises £1 to £1.50
Bënedic10: folds 
mitsuVK: folds 
matiko09: folds 
faceMyBallz_: folds 
Uncalled bet (£1) returned to mudders693
mudders693 collected £1.25 from pot
mudders693: doesn't show hand 
*** SUMMARY ***
Total pot £1.25 | Rake £0 
Seat 1: mitsuVK (button) folded before Flop (didn't bet)
Seat 2: matiko09 (small blind) folded before Flop
Seat 4: faceMyBallz_ (big blind) folded before Flop
Seat 5: mudders693 collected (£1.25)
Seat 6: Bënedic10 folded before Flop (didn't bet)





PokerStars Hand #154970524488:  Hold'em No Limit ($0.25/$0.50 USD) - 2016/06/20 12:44:09 CET [2016/06/20 6:44:09 ET]
Table 'Scheddi II' 9-max Seat #7 is the button
Seat 1: matiko09 ($97.55 in chips) 
Seat 3: mi$$I$Elena ($96.20 in chips) 
Seat 4: GOOFA13 ($59.19 in chips) 
Seat 5: zarplatka ($40 in chips) 
Seat 6: joker180785 ($50 in chips) 
Seat 7: HopeMayBee ($70.25 in chips) 
Seat 8: orochimaturi ($28.25 in chips) 
Seat 9: Infinitinium ($85.96 in chips) 
orochimaturi: posts small blind $0.25
Infinitinium: posts big blind $0.50
Yaaaazz: sits out 
matiko09: posts the ante $0.10
mi$$I$Elena: posts the ante $0.10
GOOFA13: posts the ante $0.10
zarplatka: posts the ante $0.10
joker180785: posts the ante $0.10
HopeMayBee: posts the ante $0.10
orochimaturi: posts the ante $0.10
Infinitinium: posts the ante $0.10
*** HOLE CARDS ***
Dealt to matiko09 [9s Td]
matiko09: folds 
mi$$I$Elena: folds 
GOOFA13: folds 
zarplatka: folds 
joker180785: raises $0.75 to $1.25
HopeMayBee: calls $1.25
orochimaturi: calls $1
Infinitinium: calls $0.75
*** FLOP *** [Ad 9c 2c]
orochimaturi: checks 
Infinitinium: checks 
joker180785: checks 
HopeMayBee: checks 
*** TURN *** [Ad 9c 2c] [7s]
orochimaturi: bets $2.50
Infinitinium: calls $2.50
joker180785: folds 
HopeMayBee: calls $2.50
*** RIVER *** [Ad 9c 2c 7s] [Th]
orochimaturi: checks 
Infinitinium: bets $12.64
HopeMayBee: calls $12.64
orochimaturi: folds 
*** SHOW DOWN ***
Infinitinium: shows [4h 9h] (a pair of Nines)
HopeMayBee: shows [8c Tc] (a pair of Tens)
HopeMayBee collected $36.65 from pot
*** SUMMARY ***
Total pot $38.58 | Rake $1.93 
Board [Ad 9c 2c 7s Th]
Seat 1: matiko09 folded before Flop (didn't bet)
Seat 3: mi$$I$Elena folded before Flop (didn't bet)
Seat 4: GOOFA13 folded before Flop (didn't bet)
Seat 5: zarplatka folded before Flop (didn't bet)
Seat 6: joker180785 folded on the Turn
Seat 7: HopeMayBee (button) showed [8c Tc] and won ($36.65) with a pair of Tens
Seat 8: orochimaturi (small blind) folded on the River
Seat 9: Infinitinium (big blind) showed [4h 9h] and lost with a pair of Nines





PokerStars Hand #154970527411:  Hold'em No Limit ($0.50/$1.00 USD) - 2016/06/20 12:44:17 CET [2016/06/20 6:44:17 ET]
Table 'Anhui' 9-max Seat #7 is the button
Seat 1: SkUhNi ($155.92 in chips) 
Seat 2: ruslik_by ($274.18 in chips) 
Seat 3: hammerwife ($101.78 in chips) 
Seat 4: mavin80 ($60.05 in chips) 
Seat 5: mi$$I$Elena ($104.80 in chips) 
Seat 6: 23SmOkEr07 ($115.18 in chips) 
Seat 7: matiko09 ($130.18 in chips) 
Seat 8: blackmont111 ($70 in chips) 
Seat 9: TomBod1 ($88.03 in chips) 
blackmont111: posts small blind $0.50
TomBod1: posts big blind $1
*** HOLE CARDS ***
Dealt to matiko09 [5d Jd]
SkUhNi: folds 
ruslik_by: folds 
hammerwife: folds 
mavin80: folds 
mi$$I$Elena: folds 
23SmOkEr07: raises $1.50 to $2.50
matiko09: folds 
blackmont111: folds 
TomBod1: raises $3.50 to $6
23SmOkEr07: raises $13.50 to $19.50
TomBod1: folds 
Uncalled bet ($13.50) returned to 23SmOkEr07
23SmOkEr07 collected $12.50 from pot
23SmOkEr07: doesn't show hand 
*** SUMMARY ***
Total pot $12.50 | Rake $0 
Seat 1: SkUhNi folded before Flop (didn't bet)
Seat 2: ruslik_by folded before Flop (didn't bet)
Seat 3: hammerwife folded before Flop (didn't bet)
Seat 4: mavin80 folded before Flop (didn't bet)
Seat 5: mi$$I$Elena folded before Flop (didn't bet)
Seat 6: 23SmOkEr07 collected ($12.50)
Seat 7: matiko09 (button) folded before Flop (didn't bet)
Seat 8: blackmont111 (small blind) folded before Flop
Seat 9: TomBod1 (big blind) folded before Flop





PokerStars Hand #154970529008:  Hold'em No Limit (£0.25/£0.50 GBP) - 2016/06/20 12:44:21 CET [2016/06/20 6:44:21 ET]
Table 'Tesla' 6-max Seat #2 is the button
Seat 1: Rubleff85 (£52.71 in chips) 
Seat 2: matiko09 (£58.90 in chips) 
Seat 3: asmodej666 (£58.59 in chips) 
Seat 4: ILIUXa (£52.90 in chips) 
Seat 5: Nego Razu (£50 in chips) 
Seat 6: faceMyBallz_ (£50 in chips) 
asmodej666: posts small blind £0.25
ILIUXa: posts big blind £0.50
*** HOLE CARDS ***
Dealt to matiko09 [9c 5d]
Nego Razu: folds 
faceMyBallz_: folds 
Rubleff85: raises £1 to £1.50
matiko09: folds 
asmodej666: folds 
ILIUXa: folds 
Uncalled bet (£1) returned to Rubleff85
Rubleff85 collected £1.25 from pot
Rubleff85: doesn't show hand 
*** SUMMARY ***
Total pot £1.25 | Rake £0 
Seat 1: Rubleff85 collected (£1.25)
Seat 2: matiko09 (button) folded before Flop (didn't bet)
Seat 3: asmodej666 (small blind) folded before Flop
Seat 4: ILIUXa (big blind) folded before Flop
Seat 5: Nego Razu folded before Flop (didn't bet)
Seat 6: faceMyBallz_ folded before Flop (didn't bet)





PokerStars Hand #154970529562:  Hold'em No Limit ($0.50/$1.00 USD) - 2016/06/20 12:44:22 CET [2016/06/20 6:44:22 ET]
Table 'Ernestina' 9-max Seat #8 is the button
Seat 1: diva3150 ($143.62 in chips) 
Seat 2: matiko09 ($103.75 in chips) 
Seat 3: Pvsx. ($188.99 in chips) 
Seat 4: SkUhNi ($102.28 in chips) 
Seat 5: Dickyxxx ($114.11 in chips) 
Seat 8: ruslik_by ($263.74 in chips) 
Seat 9: 23SmOkEr07 ($100.50 in chips) 
23SmOkEr07: posts small blind $0.50
diva3150: posts big blind $1
*** HOLE CARDS ***
Dealt to matiko09 [9c Ac]
matiko09: folds 
Pvsx.: folds 
SkUhNi: raises $2 to $3
Dickyxxx: calls $3
ruslik_by: folds 
23SmOkEr07: calls $2.50
diva3150: folds 
*** FLOP *** [7c 3s 5c]
23SmOkEr07: bets $5.50
SkUhNi: folds 
Dickyxxx: calls $5.50
*** TURN *** [7c 3s 5c] [2d]
23SmOkEr07: bets $11.17
Dickyxxx: raises $12.83 to $24
23SmOkEr07: calls $12.83
*** RIVER *** [7c 3s 5c 2d] [8s]
23SmOkEr07: checks 
Dickyxxx: bets $68
23SmOkEr07: folds 
Uncalled bet ($68) returned to Dickyxxx
Dickyxxx collected $66.50 from pot
Dickyxxx: doesn't show hand 
*** SUMMARY ***
Total pot $69 | Rake $2.50 
Board [7c 3s 5c 2d 8s]
Seat 1: diva3150 (big blind) folded before Flop
Seat 2: matiko09 folded before Flop (didn't bet)
Seat 3: Pvsx. folded before Flop (didn't bet)
Seat 4: SkUhNi folded on the Flop
Seat 5: Dickyxxx collected ($66.50)
Seat 8: ruslik_by (button) folded before Flop (didn't bet)
Seat 9: 23SmOkEr07 (small blind) folded on the River





PokerStars Hand #154970530949:  Hold'em No Limit (£0.25/£0.50 GBP) - 2016/06/20 12:44:26 CET [2016/06/20 6:44:26 ET]
Table 'Azalea' 6-max Seat #2 is the button
Seat 1: mitsuVK (£52.23 in chips) 
Seat 2: matiko09 (£84.99 in chips) 
Seat 4: faceMyBallz_ (£98.60 in chips) 
Seat 5: mudders693 (£73.36 in chips) 
Seat 6: Bënedic10 (£50 in chips) 
faceMyBallz_: posts small blind £0.25
mudders693: posts big blind £0.50
*** HOLE CARDS ***
Dealt to matiko09 [2s Kc]
Bënedic10: raises £1 to £1.50
mitsuVK: folds 
matiko09: folds 
faceMyBallz_: folds 
mudders693: folds 
Uncalled bet (£1) returned to Bënedic10
Bënedic10 collected £1.25 from pot
Bënedic10: doesn't show hand 
*** SUMMARY ***
Total pot £1.25 | Rake £0 
Seat 1: mitsuVK folded before Flop (didn't bet)
Seat 2: matiko09 (button) folded before Flop (didn't bet)
Seat 4: faceMyBallz_ (small blind) folded before Flop
Seat 5: mudders693 (big blind) folded before Flop
Seat 6: Bënedic10 collected (£1.25)





PokerStars Hand #154970531744:  Hold'em No Limit ($0.50/$1.00 USD) - 2016/06/20 12:44:28 CET [2016/06/20 6:44:28 ET]
Table 'Isonoe II' 9-max Seat #6 is the button
Seat 1: hammerwife ($106.36 in chips) 
Seat 2: matiko09 ($108.02 in chips) 
Seat 3: Kukuryzka ($100 in chips) 
Seat 4: Avtovo ($100 in chips) 
Seat 5: Filojoes ($101 in chips) 
Seat 6: GOOFA13 ($70.46 in chips) 
Seat 7: SkUhNi ($116.32 in chips) 
Seat 8: lewyson ($56.58 in chips) 
Seat 9: djammusic ($61.95 in chips) 
SkUhNi: posts small blind $0.50
lewyson: posts big blind $1
*** HOLE CARDS ***
Dealt to matiko09 [5d 5h]
djammusic: folds 
hammerwife: folds 
matiko09: raises $2 to $3
Kukuryzka: folds 
Avtovo: folds 
Filojoes: calls $3
GOOFA13: folds 
SkUhNi: folds 
lewyson: folds 
*** FLOP *** [Jh 2s 5c]
matiko09: bets $4.63
Filojoes: calls $4.63
*** TURN *** [Jh 2s 5c] [Qd]
matiko09: bets $8.27
Filojoes: calls $8.27
*** RIVER *** [Jh 2s 5c Qd] [Jd]
matiko09: bets $16.45
Filojoes: folds 
Uncalled bet ($16.45) returned to matiko09
matiko09 collected $31.64 from pot
matiko09: doesn't show hand 
*** SUMMARY ***
Total pot $33.30 | Rake $1.66 
Board [Jh 2s 5c Qd Jd]
Seat 1: hammerwife folded before Flop (didn't bet)
Seat 2: matiko09 collected ($31.64)
Seat 3: Kukuryzka folded before Flop (didn't bet)
Seat 4: Avtovo folded before Flop (didn't bet)
Seat 5: Filojoes folded on the River
Seat 6: GOOFA13 (button) folded before Flop (didn't bet)
Seat 7: SkUhNi (small blind) folded before Flop
Seat 8: lewyson (big blind) folded before Flop
Seat 9: djammusic folded before Flop (didn't bet)





PokerStars Hand #154970537368:  Hold'em No Limit (£0.25/£0.50 GBP) - 2016/06/20 12:44:42 CET [2016/06/20 6:44:42 ET]
Table 'Azalea' 6-max Seat #4 is the button
Seat 1: mitsuVK (£52.23 in chips) 
Seat 2: matiko09 (£84.99 in chips) 
Seat 4: faceMyBallz_ (£98.35 in chips) 
Seat 5: mudders693 (£72.86 in chips) 
Seat 6: Bënedic10 (£50.75 in chips) 
mudders693: posts small blind £0.25
Bënedic10: posts big blind £0.50
*** HOLE CARDS ***
Dealt to matiko09 [Kc 5s]
mitsuVK: folds 
matiko09: folds 
faceMyBallz_: raises £0.50 to £1
mudders693: calls £0.75
Bënedic10: calls £0.50
*** FLOP *** [2h 5d Ts]
mudders693: checks 
Bënedic10: checks 
faceMyBallz_: bets £1.42
mudders693: calls £1.42
Bënedic10: calls £1.42
*** TURN *** [2h 5d Ts] [Td]
mudders693: checks 
Bënedic10: checks 
faceMyBallz_: checks 
*** RIVER *** [2h 5d Ts Td] [Qh]
mudders693: checks 
Bënedic10: checks 
faceMyBallz_: checks 
*** SHOW DOWN ***
mudders693: shows [Kh Jc] (a pair of Tens)
Bënedic10: shows [5h 6s] (two pair, Tens and Fives)
faceMyBallz_: mucks hand 
Bënedic10 collected £6.90 from pot
*** SUMMARY ***
Total pot £7.26 | Rake £0.36 
Board [2h 5d Ts Td Qh]
Seat 1: mitsuVK folded before Flop (didn't bet)
Seat 2: matiko09 folded before Flop (didn't bet)
Seat 4: faceMyBallz_ (button) mucked [Ad 7d]
Seat 5: mudders693 (small blind) showed [Kh Jc] and lost with a pair of Tens
Seat 6: Bënedic10 (big blind) showed [5h 6s] and won (£6.90) with two pair, Tens and Fives





PokerStars Hand #154970538423:  Hold'em No Limit (£0.25/£0.50 GBP) - 2016/06/20 12:44:45 CET [2016/06/20 6:44:45 ET]
Table 'Ani' 6-max Seat #6 is the button
Seat 1: rewq99887788 (£40.81 in chips) 
Seat 2: mitsuVK (£50 in chips) 
Seat 3: Doobes8555 (£76.66 in chips) 
Seat 4: matiko09 (£51.64 in chips) 
Seat 5: Wwwasian (£56.27 in chips) 
Seat 6: faceMyBallz_ (£54.29 in chips) 
rewq99887788: posts small blind £0.25
mitsuVK: posts big blind £0.50
*** HOLE CARDS ***
Dealt to matiko09 [3s 4h]
Doobes8555: folds 
matiko09: folds 
Wwwasian: raises £0.90 to £1.40
faceMyBallz_: folds 
rewq99887788: folds 
mitsuVK: raises £3.35 to £4.75
Wwwasian: folds 
Uncalled bet (£3.35) returned to mitsuVK
mitsuVK collected £3.05 from pot
mitsuVK: doesn't show hand 
*** SUMMARY ***
Total pot £3.05 | Rake £0 
Seat 1: rewq99887788 (small blind) folded before Flop
Seat 2: mitsuVK (big blind) collected (£3.05)
Seat 3: Doobes8555 folded before Flop (didn't bet)
Seat 4: matiko09 folded before Flop (didn't bet)
Seat 5: Wwwasian folded before Flop
Seat 6: faceMyBallz_ (button) folded before Flop (didn't bet)





PokerStars Hand #154970541569:  Hold'em No Limit (£0.25/£0.50 GBP) - 2016/06/20 12:44:53 CET [2016/06/20 6:44:53 ET]
Table 'Tesla' 6-max Seat #3 is the button
Seat 1: Rubleff85 (£53.46 in chips) 
Seat 2: matiko09 (£58.90 in chips) 
Seat 3: asmodej666 (£58.34 in chips) 
Seat 4: ILIUXa (£52.40 in chips) 
Seat 5: Nego Razu (£50 in chips) 
Seat 6: faceMyBallz_ (£50 in chips) 
ILIUXa: posts small blind £0.25
Nego Razu: posts big blind £0.50
*** HOLE CARDS ***
Dealt to matiko09 [6c 7c]
faceMyBallz_: folds 
Rubleff85: raises £0.50 to £1
matiko09: raises £2 to £3
asmodej666: folds 
ILIUXa: folds 
Nego Razu: folds 
Rubleff85: folds 
Uncalled bet (£2) returned to matiko09
matiko09 collected £2.75 from pot
matiko09: doesn't show hand 
*** SUMMARY ***
Total pot £2.75 | Rake £0 
Seat 1: Rubleff85 folded before Flop
Seat 2: matiko09 collected (£2.75)
Seat 3: asmodej666 (button) folded before Flop (didn't bet)
Seat 4: ILIUXa (small blind) folded before Flop
Seat 5: Nego Razu (big blind) folded before Flop
Seat 6: faceMyBallz_ folded before Flop (didn't bet)





PokerStars Hand #154970541890:  Hold'em No Limit ($0.50/$1.00 USD) - 2016/06/20 12:44:54 CET [2016/06/20 6:44:54 ET]
Table 'Albiorix' 9-max Seat #9 is the button
Seat 2: SkUhNi ($112.02 in chips) 
Seat 3: matiko09 ($128.23 in chips) 
Seat 4: 23SmOkEr07 ($135 in chips) 
Seat 5: ruslik_by ($100 in chips) 
Seat 6: joker180785 ($190.50 in chips) 
Seat 7: Pekyto ($50.65 in chips) 
Seat 8: smiley0221 ($58.88 in chips) 
Seat 9: Coolller ($197.47 in chips) 
SkUhNi: posts small blind $0.50
matiko09: posts big blind $1
*** HOLE CARDS ***
Dealt to matiko09 [9d 4h]
23SmOkEr07: folds 
ruslik_by: folds 
joker180785: folds 
Pekyto: folds 
smiley0221: folds 
Coolller: raises $2 to $3
SkUhNi: folds 
matiko09: folds 
Uncalled bet ($2) returned to Coolller
Coolller collected $2.50 from pot
Coolller: doesn't show hand 
*** SUMMARY ***
Total pot $2.50 | Rake $0 
Seat 2: SkUhNi (small blind) folded before Flop
Seat 3: matiko09 (big blind) folded before Flop
Seat 4: 23SmOkEr07 folded before Flop (didn't bet)
Seat 5: ruslik_by folded before Flop (didn't bet)
Seat 6: joker180785 folded before Flop (didn't bet)
Seat 7: Pekyto folded before Flop (didn't bet)
Seat 8: smiley0221 folded before Flop (didn't bet)
Seat 9: Coolller (button) collected ($2.50)





PokerStars Hand #154970542673:  Hold'em No Limit ($0.50/$1.00 USD) - 2016/06/20 12:44:56 CET [2016/06/20 6:44:56 ET]
Table 'Garumna II' 9-max Seat #8 is the button
Seat 1: ki11u ($100 in chips) 
Seat 5: rura53 ($79.50 in chips) 
Seat 7: Avtovo ($100 in chips) 
Seat 8: matiko09 ($100 in chips) 
Seat 9: SkUhNi ($106.30 in chips) 
SkUhNi: posts small blind $0.50
ki11u: posts big blind $1
SexyAngeline: sits out 
*** HOLE CARDS ***
Dealt to matiko09 [4c 4h]
rura53: folds 
Avtovo: folds 
matiko09: raises $1.27 to $2.27
SkUhNi: folds 
ki11u: folds 
Uncalled bet ($1.27) returned to matiko09
matiko09 collected $2.50 from pot
matiko09: doesn't show hand 
*** SUMMARY ***
Total pot $2.50 | Rake $0 
Seat 1: ki11u (big blind) folded before Flop
Seat 5: rura53 folded before Flop (didn't bet)
Seat 7: Avtovo folded before Flop (didn't bet)
Seat 8: matiko09 (button) collected ($2.50)
Seat 9: SkUhNi (small blind) folded before Flop





PokerStars Hand #154970543543:  Hold'em No Limit ($0.50/$1.00 USD) - 2016/06/20 12:44:58 CET [2016/06/20 6:44:58 ET]
Table 'Pongola' 9-max Seat #6 is the button
Seat 1: matiko09 ($104.50 in chips) 
Seat 2: ruslik_by ($129.27 in chips) 
Seat 3: SkUhNi ($114.72 in chips) 
Seat 4: karllv ($155.31 in chips) 
Seat 5: joker180785 ($170.40 in chips) 
Seat 6: 23SmOkEr07 ($112.71 in chips) 
Seat 7: Dickyxxx ($148.62 in chips) 
Seat 8: phrantique ($31.82 in chips) 
Seat 9: Filojoes ($101.50 in chips) 
Dickyxxx: posts small blind $0.50
phrantique: posts big blind $1
*** HOLE CARDS ***
Dealt to matiko09 [5s 9s]
Filojoes: folds 
matiko09: folds 
ruslik_by: folds 
SkUhNi: folds 
karllv: folds 
joker180785: folds 
23SmOkEr07: raises $1.50 to $2.50
Dickyxxx: folds 
phrantique: folds 
Uncalled bet ($1.50) returned to 23SmOkEr07
23SmOkEr07 collected $2.50 from pot
23SmOkEr07: doesn't show hand 
*** SUMMARY ***
Total pot $2.50 | Rake $0 
Seat 1: matiko09 folded before Flop (didn't bet)
Seat 2: ruslik_by folded before Flop (didn't bet)
Seat 3: SkUhNi folded before Flop (didn't bet)
Seat 4: karllv folded before Flop (didn't bet)
Seat 5: joker180785 folded before Flop (didn't bet)
Seat 6: 23SmOkEr07 (button) collected ($2.50)
Seat 7: Dickyxxx (small blind) folded before Flop
Seat 8: phrantique (big blind) folded before Flop
Seat 9: Filojoes folded before Flop (didn't bet)





PokerStars Hand #154970544056:  Hold'em No Limit ($0.50/$1.00 USD) - 2016/06/20 12:44:59 CET [2016/06/20 6:44:59 ET]
Table 'Annika' 9-max Seat #3 is the button
Seat 1: hammerwife ($132.77 in chips) 
Seat 2: matiko09 ($106.80 in chips) 
Seat 3: first_dnk ($84 in chips) 
Seat 4: Kukuryzka ($107.50 in chips) 
Seat 5: SkUhNi ($126.13 in chips) 
Seat 6: Pvsx. ($104.05 in chips) 
Seat 7: jirka117 ($39.45 in chips) 
Seat 8: ruslik_by ($106.40 in chips) 
Seat 9: 23SmOkEr07 ($117.15 in chips) 
Kukuryzka: posts small blind $0.50
SkUhNi: posts big blind $1
*** HOLE CARDS ***
Dealt to matiko09 [2s 7c]
Pvsx.: folds 
jirka117: folds 
ruslik_by: folds 
23SmOkEr07: folds 
hammerwife: folds 
matiko09: folds 
first_dnk: raises $1 to $2
Kukuryzka: folds 
SkUhNi: calls $1
*** FLOP *** [2h Qh 6c]
SkUhNi: checks 
first_dnk: bets $1.51
SkUhNi: folds 
Uncalled bet ($1.51) returned to first_dnk
first_dnk collected $4.28 from pot
first_dnk: doesn't show hand 
*** SUMMARY ***
Total pot $4.50 | Rake $0.22 
Board [2h Qh 6c]
Seat 1: hammerwife folded before Flop (didn't bet)
Seat 2: matiko09 folded before Flop (didn't bet)
Seat 3: first_dnk (button) collected ($4.28)
Seat 4: Kukuryzka (small blind) folded before Flop
Seat 5: SkUhNi (big blind) folded on the Flop
Seat 6: Pvsx. folded before Flop (didn't bet)
Seat 7: jirka117 folded before Flop (didn't bet)
Seat 8: ruslik_by folded before Flop (didn't bet)
Seat 9: 23SmOkEr07 folded before Flop (didn't bet)





PokerStars Hand #154970548401:  Hold'em No Limit ($0.50/$1.00 USD) - 2016/06/20 12:45:10 CET [2016/06/20 6:45:10 ET]
Table 'Garumna II' 9-max Seat #9 is the button
Seat 1: ki11u ($100 in chips) 
Seat 5: rura53 ($79.50 in chips) 
Seat 7: Avtovo ($100 in chips) 
Seat 8: matiko09 ($101.50 in chips) 
Seat 9: SkUhNi ($105.80 in chips) 
ki11u: posts small blind $0.50
rura53: posts big blind $1
SexyAngeline: sits out 
*** HOLE CARDS ***
Dealt to matiko09 [Qs 5c]
Avtovo: folds 
matiko09: folds 
SkUhNi: raises $1 to $2
ki11u: raises $6 to $8
rura53: folds 
Ndundun Gipe joins the table at seat #4 
SkUhNi: folds 
Uncalled bet ($6) returned to ki11u
ki11u collected $5 from pot
ki11u: doesn't show hand 
*** SUMMARY ***
Total pot $5 | Rake $0 
Seat 1: ki11u (small blind) collected ($5)
Seat 5: rura53 (big blind) folded before Flop
Seat 7: Avtovo folded before Flop (didn't bet)
Seat 8: matiko09 folded before Flop (didn't bet)
Seat 9: SkUhNi (button) folded before Flop





PokerStars Hand #154970548612:  Hold'em No Limit ($0.50/$1.00 USD) - 2016/06/20 12:45:11 CET [2016/06/20 6:45:11 ET]
Table 'Ambrosia II' 9-max Seat #4 is the button
Seat 1: 23SmOkEr07 ($177.25 in chips) 
Seat 2: Eyeballz1307 ($19.84 in chips) 
Seat 3: mavin80 ($102.95 in chips) 
Seat 4: mi$$I$Elena ($216.27 in chips) 
Seat 5: Mattulh ($100 in chips) 
Seat 6: ruslik_by ($107.80 in chips) 
Seat 7: matiko09 ($100 in chips) 
Seat 8: hammerwife ($100 in chips) 
Seat 9: SkUhNi ($131.76 in chips) 
Mattulh: posts small blind $0.50
ruslik_by: posts big blind $1
*** HOLE CARDS ***
Dealt to matiko09 [4c 4d]
matiko09: folds 
hammerwife: folds 
SkUhNi: folds 
23SmOkEr07: folds 
Eyeballz1307: folds 
mavin80: raises $1.50 to $2.50
mi$$I$Elena: folds 
Mattulh: folds 
ruslik_by: folds 
Uncalled bet ($1.50) returned to mavin80
mavin80 collected $2.50 from pot
*** SUMMARY ***
Total pot $2.50 | Rake $0 
Seat 1: 23SmOkEr07 folded before Flop (didn't bet)
Seat 2: Eyeballz1307 folded before Flop (didn't bet)
Seat 3: mavin80 collected ($2.50)
Seat 4: mi$$I$Elena (button) folded before Flop (didn't bet)
Seat 5: Mattulh (small blind) folded before Flop
Seat 6: ruslik_by (big blind) folded before Flop
Seat 7: matiko09 folded before Flop (didn't bet)
Seat 8: hammerwife folded before Flop (didn't bet)
Seat 9: SkUhNi folded before Flop (didn't bet)





PokerStars Hand #154970551503:  Hold'em No Limit (£0.25/£0.50 GBP) - 2016/06/20 12:45:18 CET [2016/06/20 6:45:18 ET]
Table 'Ani' 6-max Seat #1 is the button
Seat 1: rewq99887788 (£40.56 in chips) 
Seat 2: mitsuVK (£51.65 in chips) 
Seat 3: Doobes8555 (£76.66 in chips) 
Seat 4: matiko09 (£51.64 in chips) 
Seat 5: Wwwasian (£54.87 in chips) 
Seat 6: faceMyBallz_ (£54.29 in chips) 
mitsuVK: posts small blind £0.25
Doobes8555: posts big blind £0.50
*** HOLE CARDS ***
Dealt to matiko09 [3c Kd]
matiko09: folds 
Wwwasian: folds 
faceMyBallz_: raises £1 to £1.50
rewq99887788: folds 
mitsuVK: folds 
Doobes8555: folds 
Uncalled bet (£1) returned to faceMyBallz_
faceMyBallz_ collected £1.25 from pot
faceMyBallz_: doesn't show hand 
*** SUMMARY ***
Total pot £1.25 | Rake £0 
Seat 1: rewq99887788 (button) folded before Flop (didn't bet)
Seat 2: mitsuVK (small blind) folded before Flop
Seat 3: Doobes8555 (big blind) folded before Flop
Seat 4: matiko09 folded before Flop (didn't bet)
Seat 5: Wwwasian folded before Flop (didn't bet)
Seat 6: faceMyBallz_ collected (£1.25)





PokerStars Hand #154970551778:  Hold'em No Limit (£0.25/£0.50 GBP) - 2016/06/20 12:45:19 CET [2016/06/20 6:45:19 ET]
Table 'Tesla' 6-max Seat #4 is the button
Seat 1: Rubleff85 (£52.46 in chips) 
Seat 2: matiko09 (£60.65 in chips) 
Seat 3: asmodej666 (£58.34 in chips) 
Seat 4: ILIUXa (£52.15 in chips) 
Seat 5: Nego Razu (£50 in chips) 
Seat 6: faceMyBallz_ (£50 in chips) 
Nego Razu: posts small blind £0.25
faceMyBallz_: posts big blind £0.50
*** HOLE CARDS ***
Dealt to matiko09 [Kd 8s]
Rubleff85: folds 
matiko09: folds 
asmodej666: folds 
ILIUXa: raises £0.60 to £1.10
Nego Razu: folds 
faceMyBallz_: calls £0.60
*** FLOP *** [8c 8d Ah]
faceMyBallz_: checks 
ILIUXa: bets £1.63
faceMyBallz_: calls £1.63
*** TURN *** [8c 8d Ah] [3c]
faceMyBallz_: checks 
ILIUXa: bets £3.79
faceMyBallz_: calls £3.79
*** RIVER *** [8c 8d Ah 3c] [Jh]
faceMyBallz_: checks 
ILIUXa: checks 
*** SHOW DOWN ***
faceMyBallz_: shows [Tc As] (two pair, Aces and Eights)
ILIUXa: mucks hand 
faceMyBallz_ collected £12.63 from pot
*** SUMMARY ***
Total pot £13.29 | Rake £0.66 
Board [8c 8d Ah 3c Jh]
Seat 1: Rubleff85 folded before Flop (didn't bet)
Seat 2: matiko09 folded before Flop (didn't bet)
Seat 3: asmodej666 folded before Flop (didn't bet)
Seat 4: ILIUXa (button) mucked [Jc Qc]
Seat 5: Nego Razu (small blind) folded before Flop
Seat 6: faceMyBallz_ (big blind) showed [Tc As] and won (£12.63) with two pair, Aces and Eights





PokerStars Hand #154970553730:  Hold'em No Limit ($0.25/$0.50 USD) - 2016/06/20 12:45:24 CET [2016/06/20 6:45:24 ET]
Table 'Scheddi II' 9-max Seat #8 is the button
Seat 1: matiko09 ($97.45 in chips) 
Seat 3: mi$$I$Elena ($96.10 in chips) 
Seat 4: GOOFA13 ($59.09 in chips) 
Seat 5: zarplatka ($40 in chips) 
Seat 6: joker180785 ($50 in chips) 
Seat 7: HopeMayBee ($90.41 in chips) 
Seat 8: orochimaturi ($24.40 in chips) 
Seat 9: Infinitinium ($69.47 in chips) 
Infinitinium: posts small blind $0.25
matiko09: posts big blind $0.50
Yaaaazz: sits out 
matiko09: posts the ante $0.10
mi$$I$Elena: posts the ante $0.10
GOOFA13: posts the ante $0.10
zarplatka: posts the ante $0.10
joker180785: posts the ante $0.10
HopeMayBee: posts the ante $0.10
orochimaturi: posts the ante $0.10
Infinitinium: posts the ante $0.10
*** HOLE CARDS ***
Dealt to matiko09 [3c Ks]
mi$$I$Elena: folds 
GOOFA13: raises $2 to $2.50
zarplatka: folds 
joker180785: folds 
HopeMayBee: folds 
orochimaturi: calls $2.50
Infinitinium: folds 
matiko09: folds 
*** FLOP *** [6c Ts Td]
GOOFA13: checks 
orochimaturi: checks 
*** TURN *** [6c Ts Td] [5d]
GOOFA13: bets $2
orochimaturi: folds 
Uncalled bet ($2) returned to GOOFA13
GOOFA13 collected $6.22 from pot
GOOFA13: doesn't show hand 
*** SUMMARY ***
Total pot $6.55 | Rake $0.33 
Board [6c Ts Td 5d]
Seat 1: matiko09 (big blind) folded before Flop
Seat 3: mi$$I$Elena folded before Flop (didn't bet)
Seat 4: GOOFA13 collected ($6.22)
Seat 5: zarplatka folded before Flop (didn't bet)
Seat 6: joker180785 folded before Flop (didn't bet)
Seat 7: HopeMayBee folded before Flop (didn't bet)
Seat 8: orochimaturi (button) folded on the Turn
Seat 9: Infinitinium (small blind) folded before Flop





PokerStars Hand #154970556936:  Hold'em No Limit ($0.50/$1.00 USD) - 2016/06/20 12:45:32 CET [2016/06/20 6:45:32 ET]
Table 'Albiorix' 9-max Seat #2 is the button
Seat 2: SkUhNi ($111.52 in chips) 
Seat 3: matiko09 ($127.23 in chips) 
Seat 4: 23SmOkEr07 ($135 in chips) 
Seat 5: ruslik_by ($100 in chips) 
Seat 6: joker180785 ($190.50 in chips) 
Seat 7: Pekyto ($50.65 in chips) 
Seat 8: smiley0221 ($58.88 in chips) 
Seat 9: Coolller ($198.97 in chips) 
matiko09: posts small blind $0.50
23SmOkEr07: posts big blind $1
*** HOLE CARDS ***
Dealt to matiko09 [3c Ks]
ruslik_by: folds 
joker180785: raises $2 to $3
Pekyto: folds 
smiley0221: folds 
Coolller: calls $3
SkUhNi: folds 
matiko09: folds 
23SmOkEr07: calls $2
*** FLOP *** [Kc 6d 9s]
23SmOkEr07: checks 
joker180785: checks 
Coolller: checks 
*** TURN *** [Kc 6d 9s] [Qd]
23SmOkEr07: checks 
joker180785: bets $5.68
Coolller: calls $5.68
23SmOkEr07: folds 
*** RIVER *** [Kc 6d 9s Qd] [2c]
joker180785: bets $12.48
Coolller: folds 
Uncalled bet ($12.48) returned to joker180785
joker180785 collected $19.82 from pot
*** SUMMARY ***
Total pot $20.86 | Rake $1.04 
Board [Kc 6d 9s Qd 2c]
Seat 2: SkUhNi (button) folded before Flop (didn't bet)
Seat 3: matiko09 (small blind) folded before Flop
Seat 4: 23SmOkEr07 (big blind) folded on the Turn
Seat 5: ruslik_by folded before Flop (didn't bet)
Seat 6: joker180785 collected ($19.82)
Seat 7: Pekyto folded before Flop (didn't bet)
Seat 8: smiley0221 folded before Flop (didn't bet)
Seat 9: Coolller folded on the River





PokerStars Hand #154970559327:  Hold'em No Limit ($0.50/$1.00 USD) - 2016/06/20 12:45:38 CET [2016/06/20 6:45:38 ET]
Table 'Pongola' 9-max Seat #7 is the button
Seat 1: matiko09 ($104.50 in chips) 
Seat 2: ruslik_by ($129.27 in chips) 
Seat 3: SkUhNi ($114.72 in chips) 
Seat 4: karllv ($155.31 in chips) 
Seat 5: joker180785 ($170.40 in chips) 
Seat 6: 23SmOkEr07 ($114.21 in chips) 
Seat 7: Dickyxxx ($148.12 in chips) 
Seat 8: phrantique ($30.82 in chips) 
Seat 9: Filojoes ($101.50 in chips) 
phrantique: posts small blind $0.50
Filojoes: posts big blind $1
*** HOLE CARDS ***
Dealt to matiko09 [2h 4h]
matiko09: folds 
ruslik_by: raises $2 to $3
SkUhNi: folds 
karllv: folds 
joker180785: folds 
23SmOkEr07: folds 
Dickyxxx: folds 
phrantique: folds 
Filojoes: folds 
Uncalled bet ($2) returned to ruslik_by
ruslik_by collected $2.50 from pot
ruslik_by: doesn't show hand 
*** SUMMARY ***
Total pot $2.50 | Rake $0 
Seat 1: matiko09 folded before Flop (didn't bet)
Seat 2: ruslik_by collected ($2.50)
Seat 3: SkUhNi folded before Flop (didn't bet)
Seat 4: karllv folded before Flop (didn't bet)
Seat 5: joker180785 folded before Flop (didn't bet)
Seat 6: 23SmOkEr07 folded before Flop (didn't bet)
Seat 7: Dickyxxx (button) folded before Flop (didn't bet)
Seat 8: phrantique (small blind) folded before Flop
Seat 9: Filojoes (big blind) folded before Flop





PokerStars Hand #154970559442:  Hold'em No Limit (£0.25/£0.50 GBP) - 2016/06/20 12:45:39 CET [2016/06/20 6:45:39 ET]
Table 'Ani' 6-max Seat #2 is the button
Seat 1: rewq99887788 (£40.56 in chips) 
Seat 2: mitsuVK (£51.40 in chips) 
Seat 3: Doobes8555 (£76.16 in chips) 
Seat 4: matiko09 (£51.64 in chips) 
Seat 5: Wwwasian (£54.87 in chips) 
Seat 6: faceMyBallz_ (£55.04 in chips) 
Doobes8555: posts small blind £0.25
matiko09: posts big blind £0.50
*** HOLE CARDS ***
Dealt to matiko09 [Th Tc]
Wwwasian: folds 
faceMyBallz_: folds 
rewq99887788: folds 
mitsuVK: folds 
Doobes8555: calls £0.25
matiko09: raises £1.50 to £2
Doobes8555: calls £1.50
*** FLOP *** [2c 9h Ac]
Doobes8555: checks 
matiko09: bets £1.97
Doobes8555: folds 
Uncalled bet (£1.97) returned to matiko09
matiko09 collected £3.80 from pot
matiko09: doesn't show hand 
*** SUMMARY ***
Total pot £4 | Rake £0.20 
Board [2c 9h Ac]
Seat 1: rewq99887788 folded before Flop (didn't bet)
Seat 2: mitsuVK (button) folded before Flop (didn't bet)
Seat 3: Doobes8555 (small blind) folded on the Flop
Seat 4: matiko09 (big blind) collected (£3.80)
Seat 5: Wwwasian folded before Flop (didn't bet)
Seat 6: faceMyBallz_ folded before Flop (didn't bet)





PokerStars Hand #154970559559:  Hold'em No Limit ($0.50/$1.00 USD) - 2016/06/20 12:45:39 CET [2016/06/20 6:45:39 ET]
Table 'Garumna II' 9-max Seat #1 is the button
Seat 1: ki11u ($103 in chips) 
Seat 5: rura53 ($78.50 in chips) 
Seat 6: SexyAngeline ($41.55 in chips) 
Seat 7: Avtovo ($100 in chips) 
Seat 8: matiko09 ($101.50 in chips) 
Seat 9: SkUhNi ($103.80 in chips) 
Ndundun Gipe will be allowed to play after the button
rura53: posts small blind $0.50
SexyAngeline: posts big blind $1
*** HOLE CARDS ***
Dealt to matiko09 [3h 7s]
Avtovo: raises $1.50 to $2.50
matiko09: folds 
SkUhNi: folds 
ki11u: folds 
rura53: folds 
SexyAngeline: folds 
Uncalled bet ($1.50) returned to Avtovo
Avtovo collected $2.50 from pot
Avtovo: doesn't show hand 
*** SUMMARY ***
Total pot $2.50 | Rake $0 
Seat 1: ki11u (button) folded before Flop (didn't bet)
Seat 5: rura53 (small blind) folded before Flop
Seat 6: SexyAngeline (big blind) folded before Flop
Seat 7: Avtovo collected ($2.50)
Seat 8: matiko09 folded before Flop (didn't bet)
Seat 9: SkUhNi folded before Flop (didn't bet)





PokerStars Hand #154970560775:  Hold'em No Limit ($0.50/$1.00 USD) - 2016/06/20 12:45:42 CET [2016/06/20 6:45:42 ET]
Table 'Annika' 9-max Seat #4 is the button
Seat 1: hammerwife ($132.77 in chips) 
Seat 2: matiko09 ($106.80 in chips) 
Seat 3: first_dnk ($86.28 in chips) 
Seat 4: Kukuryzka ($107 in chips) 
Seat 5: SkUhNi ($124.13 in chips) 
Seat 6: Pvsx. ($104.05 in chips) 
Seat 8: ruslik_by ($106.40 in chips) 
Seat 9: 23SmOkEr07 ($117.15 in chips) 
SkUhNi: posts small blind $0.50
Pvsx.: posts big blind $1
*** HOLE CARDS ***
Dealt to matiko09 [7c 4h]
ruslik_by: folds 
23SmOkEr07: folds 
hammerwife: folds 
matiko09: folds 
first_dnk: raises $1.25 to $2.25
Kukuryzka: folds 
SkUhNi: folds 
Pvsx.: folds 
Uncalled bet ($1.25) returned to first_dnk
first_dnk collected $2.50 from pot
first_dnk: doesn't show hand 
*** SUMMARY ***
Total pot $2.50 | Rake $0 
Seat 1: hammerwife folded before Flop (didn't bet)
Seat 2: matiko09 folded before Flop (didn't bet)
Seat 3: first_dnk collected ($2.50)
Seat 4: Kukuryzka (button) folded before Flop (didn't bet)
Seat 5: SkUhNi (small blind) folded before Flop
Seat 6: Pvsx. (big blind) folded before Flop
Seat 8: ruslik_by folded before Flop (didn't bet)
Seat 9: 23SmOkEr07 folded before Flop (didn't bet)





PokerStars Hand #154970562051:  Hold'em No Limit ($0.50/$1.00 USD) - 2016/06/20 12:45:45 CET [2016/06/20 6:45:45 ET]
Table 'Anhui' 9-max Seat #8 is the button
Seat 1: SkUhNi ($155.92 in chips) 
Seat 2: ruslik_by ($274.18 in chips) 
Seat 3: hammerwife ($101.78 in chips) 
Seat 4: mavin80 ($60.05 in chips) 
Seat 5: mi$$I$Elena ($104.80 in chips) 
Seat 6: 23SmOkEr07 ($121.68 in chips) 
Seat 7: matiko09 ($130.18 in chips) 
Seat 8: blackmont111 ($69.50 in chips) 
Seat 9: TomBod1 ($82.03 in chips) 
TomBod1: posts small blind $0.50
SkUhNi: posts big blind $1
*** HOLE CARDS ***
Dealt to matiko09 [6h 9s]
ruslik_by: folds 
hammerwife: folds 
mavin80: raises $1.50 to $2.50
mi$$I$Elena: folds 
23SmOkEr07: folds 
matiko09: folds 
blackmont111: folds 
TomBod1: calls $2
SkUhNi: folds 
*** FLOP *** [Ac Td 2s]
TomBod1: bets $3
mavin80: calls $3
*** TURN *** [Ac Td 2s] [8s]
TomBod1: checks 
mavin80: bets $5
TomBod1: folds 
Uncalled bet ($5) returned to mavin80
mavin80 collected $11.40 from pot
*** SUMMARY ***
Total pot $12 | Rake $0.60 
Board [Ac Td 2s 8s]
Seat 1: SkUhNi (big blind) folded before Flop
Seat 2: ruslik_by folded before Flop (didn't bet)
Seat 3: hammerwife folded before Flop (didn't bet)
Seat 4: mavin80 collected ($11.40)
Seat 5: mi$$I$Elena folded before Flop (didn't bet)
Seat 6: 23SmOkEr07 folded before Flop (didn't bet)
Seat 7: matiko09 folded before Flop (didn't bet)
Seat 8: blackmont111 (button) folded before Flop (didn't bet)
Seat 9: TomBod1 (small blind) folded on the Turn





PokerStars Hand #154970564848:  Hold'em No Limit ($0.50/$1.00 USD) - 2016/06/20 12:45:52 CET [2016/06/20 6:45:52 ET]
Table 'Isonoe II' 9-max Seat #7 is the button
Seat 1: hammerwife ($106.36 in chips) 
Seat 2: matiko09 ($123.76 in chips) 
Seat 3: Kukuryzka ($100 in chips) 
Seat 4: Avtovo ($100 in chips) 
Seat 5: Filojoes ($100 in chips) 
Seat 6: GOOFA13 ($70.46 in chips) 
Seat 7: SkUhNi ($115.82 in chips) 
Seat 8: lewyson ($55.58 in chips) 
Seat 9: djammusic ($61.95 in chips) 
lewyson: posts small blind $0.50
djammusic: posts big blind $1
*** HOLE CARDS ***
Dealt to matiko09 [6d As]
hammerwife: folds 
matiko09: folds 
Kukuryzka: folds 
Avtovo: folds 
Filojoes: folds 
GOOFA13: folds 
SkUhNi: raises $1 to $2
lewyson: folds 
djammusic: raises $5.50 to $7.50
SkUhNi: folds 
Uncalled bet ($5.50) returned to djammusic
djammusic collected $4.50 from pot
djammusic: doesn't show hand 
*** SUMMARY ***
Total pot $4.50 | Rake $0 
Seat 1: hammerwife folded before Flop (didn't bet)
Seat 2: matiko09 folded before Flop (didn't bet)
Seat 3: Kukuryzka folded before Flop (didn't bet)
Seat 4: Avtovo folded before Flop (didn't bet)
Seat 5: Filojoes folded before Flop (didn't bet)
Seat 6: GOOFA13 folded before Flop (didn't bet)
Seat 7: SkUhNi (button) folded before Flop
Seat 8: lewyson (small blind) folded before Flop
Seat 9: djammusic (big blind) collected ($4.50)





PokerStars Hand #154970564743:  Hold'em No Limit ($0.50/$1.00 USD) - 2016/06/20 12:45:52 CET [2016/06/20 6:45:52 ET]
Table 'Ambrosia II' 9-max Seat #5 is the button
Seat 1: 23SmOkEr07 ($177.25 in chips) 
Seat 2: Eyeballz1307 ($19.84 in chips) 
Seat 3: mavin80 ($104.45 in chips) 
Seat 4: mi$$I$Elena ($216.27 in chips) 
Seat 5: Mattulh ($100 in chips) 
Seat 6: ruslik_by ($106.80 in chips) 
Seat 7: matiko09 ($100 in chips) 
Seat 8: hammerwife ($100 in chips) 
Seat 9: SkUhNi ($131.76 in chips) 
ruslik_by: posts small blind $0.50
matiko09: posts big blind $1
*** HOLE CARDS ***
Dealt to matiko09 [8s 6d]
hammerwife: folds 
SkUhNi: folds 
23SmOkEr07: folds 
Eyeballz1307: folds 
mavin80: raises $1.50 to $2.50
mi$$I$Elena: folds 
Mattulh: folds 
ruslik_by: folds 
matiko09: folds 
Uncalled bet ($1.50) returned to mavin80
mavin80 collected $2.50 from pot
*** SUMMARY ***
Total pot $2.50 | Rake $0 
Seat 1: 23SmOkEr07 folded before Flop (didn't bet)
Seat 2: Eyeballz1307 folded before Flop (didn't bet)
Seat 3: mavin80 collected ($2.50)
Seat 4: mi$$I$Elena folded before Flop (didn't bet)
Seat 5: Mattulh (button) folded before Flop (didn't bet)
Seat 6: ruslik_by (small blind) folded before Flop
Seat 7: matiko09 (big blind) folded before Flop
Seat 8: hammerwife folded before Flop (didn't bet)
Seat 9: SkUhNi folded before Flop (didn't bet)





PokerStars Hand #154970566011:  Hold'em No Limit (£0.25/£0.50 GBP) - 2016/06/20 12:45:55 CET [2016/06/20 6:45:55 ET]
Table 'Azalea' 6-max Seat #5 is the button
Seat 1: mitsuVK (£52.23 in chips) 
Seat 2: matiko09 (£84.99 in chips) 
Seat 4: faceMyBallz_ (£95.93 in chips) 
Seat 5: mudders693 (£70.44 in chips) 
Seat 6: Bënedic10 (£55.23 in chips) 
Bënedic10: posts small blind £0.25
mitsuVK: posts big blind £0.50
tyoma_knp: sits out 
*** HOLE CARDS ***
Dealt to matiko09 [Qs Kh]
matiko09: raises £1 to £1.50
faceMyBallz_: folds 
mudders693: calls £1.50
Bënedic10: calls £1.25
mitsuVK: folds 
*** FLOP *** [6c 2h 5d]
Bënedic10: checks 
matiko09: checks 
mudders693: bets £4.50
Bënedic10: folds 
matiko09: folds 
Uncalled bet (£4.50) returned to mudders693
mudders693 collected £4.75 from pot
mudders693: doesn't show hand 
*** SUMMARY ***
Total pot £5 | Rake £0.25 
Board [6c 2h 5d]
Seat 1: mitsuVK (big blind) folded before Flop
Seat 2: matiko09 folded on the Flop
Seat 4: faceMyBallz_ folded before Flop (didn't bet)
Seat 5: mudders693 (button) collected (£4.75)
Seat 6: Bënedic10 (small blind) folded on the Flop





PokerStars Hand #154970566165:  Hold'em No Limit ($0.50/$1.00 USD) - 2016/06/20 12:45:56 CET [2016/06/20 6:45:56 ET]
Table 'Garumna II' 9-max Seat #5 is the button
Seat 1: ki11u ($103 in chips) 
Seat 5: rura53 ($78 in chips) 
Seat 6: SexyAngeline ($40.55 in chips) 
Seat 7: Avtovo ($101.50 in chips) 
Seat 8: matiko09 ($101.50 in chips) 
Seat 9: SkUhNi ($103.80 in chips) 
SexyAngeline: posts small blind $0.50
Avtovo: posts big blind $1
Ndundun Gipe: sits out 
*** HOLE CARDS ***
Dealt to matiko09 [8h 6c]
matiko09: folds 
SkUhNi: folds 
ki11u: folds 
PopShoveIt13 leaves the table
rura53: folds 
SexyAngeline: raises $1.07 to $2.07
Avtovo: folds 
Uncalled bet ($1.07) returned to SexyAngeline
SexyAngeline collected $2 from pot
SexyAngeline: doesn't show hand 
*** SUMMARY ***
Total pot $2 | Rake $0 
Seat 1: ki11u folded before Flop (didn't bet)
Seat 5: rura53 (button) folded before Flop (didn't bet)
Seat 6: SexyAngeline (small blind) collected ($2)
Seat 7: Avtovo (big blind) folded before Flop
Seat 8: matiko09 folded before Flop (didn't bet)
Seat 9: SkUhNi folded before Flop (didn't bet)





PokerStars Hand #154970566951:  Hold'em No Limit ($0.50/$1.00 USD) - 2016/06/20 12:45:58 CET [2016/06/20 6:45:58 ET]
Table 'Normannia' 9-max Seat #5 is the button
Seat 1: hammerwife ($108.34 in chips) 
Seat 2: Pvsx. ($193.12 in chips) 
Seat 3: Avtovo ($100 in chips) 
Seat 5: Dickyxxx ($120.19 in chips) 
Seat 6: typename27 ($65.92 in chips) 
Seat 7: matiko09 ($100 in chips) 
Seat 8: SkUhNi ($132.81 in chips) 
Seat 9: ruslik_by ($147.69 in chips) 
typename27: posts small blind $0.50
matiko09: posts big blind $1
Filojoes: sits out 
*** HOLE CARDS ***
Dealt to matiko09 [8d Ks]
SkUhNi: folds 
ruslik_by: folds 
hammerwife: folds 
Pvsx.: raises $1.50 to $2.50
Avtovo: folds 
Dickyxxx: folds 
typename27: calls $2
matiko09: folds 
*** FLOP *** [Qc 9h 3s]
typename27: bets $2.85
Pvsx.: folds 
Uncalled bet ($2.85) returned to typename27
typename27 collected $5.70 from pot
typename27: doesn't show hand 
*** SUMMARY ***
Total pot $6 | Rake $0.30 
Board [Qc 9h 3s]
Seat 1: hammerwife folded before Flop (didn't bet)
Seat 2: Pvsx. folded on the Flop
Seat 3: Avtovo folded before Flop (didn't bet)
Seat 5: Dickyxxx (button) folded before Flop (didn't bet)
Seat 6: typename27 (small blind) collected ($5.70)
Seat 7: matiko09 (big blind) folded before Flop
Seat 8: SkUhNi folded before Flop (didn't bet)
Seat 9: ruslik_by folded before Flop (didn't bet)





PokerStars Hand #154970569928:  Hold'em No Limit ($0.50/$1.00 USD) - 2016/06/20 12:46:06 CET [2016/06/20 6:46:06 ET]
Table 'Pongola' 9-max Seat #8 is the button
Seat 1: matiko09 ($104.50 in chips) 
Seat 2: ruslik_by ($130.77 in chips) 
Seat 3: SkUhNi ($114.72 in chips) 
Seat 4: karllv ($155.31 in chips) 
Seat 5: joker180785 ($170.40 in chips) 
Seat 6: 23SmOkEr07 ($114.21 in chips) 
Seat 7: Dickyxxx ($148.12 in chips) 
Seat 8: phrantique ($100 in chips) 
Seat 9: Filojoes ($100.50 in chips) 
Filojoes: posts small blind $0.50
matiko09: posts big blind $1
*** HOLE CARDS ***
Dealt to matiko09 [Ks 9s]
ruslik_by: folds 
SkUhNi: folds 
karllv: folds 
joker180785: folds 
23SmOkEr07: folds 
Dickyxxx: folds 
phrantique: folds 
Filojoes: raises $1.50 to $2.50
matiko09: calls $1.50
*** FLOP *** [8c Kd 3d]
Filojoes: bets $2.85
matiko09: calls $2.85
*** TURN *** [8c Kd 3d] [4c]
Filojoes: bets $6.84
matiko09: calls $6.84
*** RIVER *** [8c Kd 3d 4c] [7s]
Filojoes: bets $13.89
matiko09: calls $13.89
*** SHOW DOWN ***
Filojoes: shows [Qs Kh] (a pair of Kings)
matiko09: mucks hand 
Filojoes collected $49.66 from pot
*** SUMMARY ***
Total pot $52.16 | Rake $2.50 
Board [8c Kd 3d 4c 7s]
Seat 1: matiko09 (big blind) mucked [Ks 9s]
Seat 2: ruslik_by folded before Flop (didn't bet)
Seat 3: SkUhNi folded before Flop (didn't bet)
Seat 4: karllv folded before Flop (didn't bet)
Seat 5: joker180785 folded before Flop (didn't bet)
Seat 6: 23SmOkEr07 folded before Flop (didn't bet)
Seat 7: Dickyxxx folded before Flop (didn't bet)
Seat 8: phrantique (button) folded before Flop (didn't bet)
Seat 9: Filojoes (small blind) showed [Qs Kh] and won ($49.66) with a pair of Kings





PokerStars Hand #154970570579:  Hold'em No Limit ($0.25/$0.50 USD) - 2016/06/20 12:46:07 CET [2016/06/20 6:46:07 ET]
Table 'Scheddi II' 9-max Seat #9 is the button
Seat 1: matiko09 ($96.85 in chips) 
Seat 2: Yaaaazz ($91.05 in chips) 
Seat 3: mi$$I$Elena ($96 in chips) 
Seat 4: GOOFA13 ($62.71 in chips) 
Seat 5: zarplatka ($40 in chips) 
Seat 6: joker180785 ($50 in chips) 
Seat 7: HopeMayBee ($90.31 in chips) 
Seat 8: orochimaturi ($21.80 in chips) 
Seat 9: Infinitinium ($69.12 in chips) 
matiko09: posts small blind $0.25
Yaaaazz: posts big blind $0.50
matiko09: posts the ante $0.10
Yaaaazz: posts the ante $0.10
mi$$I$Elena: posts the ante $0.10
GOOFA13: posts the ante $0.10
zarplatka: posts the ante $0.10
joker180785: posts the ante $0.10
HopeMayBee: posts the ante $0.10
orochimaturi: posts the ante $0.10
Infinitinium: posts the ante $0.10
*** HOLE CARDS ***
Dealt to matiko09 [7d 4h]
mi$$I$Elena: folds 
GOOFA13: folds 
zarplatka: folds 
joker180785: raises $1 to $1.50
HopeMayBee: folds 
orochimaturi: folds 
Infinitinium: calls $1.50
matiko09: folds 
Yaaaazz: folds 
*** FLOP *** [Qc Js 5s]
joker180785: bets $3.40
Infinitinium: calls $3.40
*** TURN *** [Qc Js 5s] [3c]
joker180785: bets $8.37
Infinitinium: calls $8.37
*** RIVER *** [Qc Js 5s 3c] [Qh]
joker180785: checks 
Infinitinium: checks 
*** SHOW DOWN ***
joker180785: shows [Kd Ks] (two pair, Kings and Queens)
Infinitinium: mucks hand 
joker180785 collected $26.78 from pot
*** SUMMARY ***
Total pot $28.19 | Rake $1.41 
Board [Qc Js 5s 3c Qh]
Seat 1: matiko09 (small blind) folded before Flop
Seat 2: Yaaaazz (big blind) folded before Flop
Seat 3: mi$$I$Elena folded before Flop (didn't bet)
Seat 4: GOOFA13 folded before Flop (didn't bet)
Seat 5: zarplatka folded before Flop (didn't bet)
Seat 6: joker180785 showed [Kd Ks] and won ($26.78) with two pair, Kings and Queens
Seat 7: HopeMayBee folded before Flop (didn't bet)
Seat 8: orochimaturi folded before Flop (didn't bet)
Seat 9: Infinitinium (button) mucked [Jc Ts]





PokerStars Hand #154970571412:  Hold'em No Limit (£0.25/£0.50 GBP) - 2016/06/20 12:46:09 CET [2016/06/20 6:46:09 ET]
Table 'Tesla' 6-max Seat #5 is the button
Seat 1: Rubleff85 (£52.46 in chips) 
Seat 2: matiko09 (£60.65 in chips) 
Seat 3: asmodej666 (£58.34 in chips) 
Seat 4: ILIUXa (£50 in chips) 
Seat 5: Nego Razu (£50 in chips) 
Seat 6: faceMyBallz_ (£56.11 in chips) 
faceMyBallz_: posts small blind £0.25
Rubleff85: posts big blind £0.50
*** HOLE CARDS ***
Dealt to matiko09 [Qs 4h]
matiko09: folds 
asmodej666: folds 
ILIUXa: folds 
Nego Razu: raises £0.77 to £1.27
faceMyBallz_: folds 
Rubleff85: raises £2.73 to £4
Nego Razu: folds 
Uncalled bet (£2.73) returned to Rubleff85
Rubleff85 collected £2.79 from pot
Rubleff85: doesn't show hand 
*** SUMMARY ***
Total pot £2.79 | Rake £0 
Seat 1: Rubleff85 (big blind) collected (£2.79)
Seat 2: matiko09 folded before Flop (didn't bet)
Seat 3: asmodej666 folded before Flop (didn't bet)
Seat 4: ILIUXa folded before Flop (didn't bet)
Seat 5: Nego Razu (button) folded before Flop
Seat 6: faceMyBallz_ (small blind) folded before Flop





PokerStars Hand #154970572733:  Hold'em No Limit ($0.50/$1.00 USD) - 2016/06/20 12:46:13 CET [2016/06/20 6:46:13 ET]
Table 'Garumna II' 9-max Seat #6 is the button
Seat 1: ki11u ($103 in chips) 
Seat 4: Ndundun Gipe ($40 in chips) 
Seat 5: rura53 ($78 in chips) 
Seat 6: SexyAngeline ($41.55 in chips) 
Seat 7: Avtovo ($100.50 in chips) 
Seat 8: matiko09 ($101.50 in chips) 
Seat 9: SkUhNi ($103.80 in chips) 
Avtovo: posts small blind $0.50
matiko09: posts big blind $1
Ndundun Gipe: posts big blind $1
*** HOLE CARDS ***
Dealt to matiko09 [3c 3s]
SkUhNi: folds 
ki11u: folds 
Ndundun Gipe: checks 
rura53: folds 
Racushniak joins the table at seat #2 
SexyAngeline: folds 
mooose100 joins the table at seat #3 
Avtovo: raises $4 to $5
matiko09: calls $4
Ndundun Gipe: calls $4
*** FLOP *** [9h 8h 8c]
Avtovo: bets $7.12
matiko09: folds 
Ndundun Gipe: calls $7.12
*** TURN *** [9h 8h 8c] [4c]
Avtovo: bets $28
Ndundun Gipe: calls $27.88 and is all-in
Uncalled bet ($0.12) returned to Avtovo
*** RIVER *** [9h 8h 8c 4c] [5s]
*** SHOW DOWN ***
Avtovo: shows [Ah Th] (a pair of Eights)
Ndundun Gipe: shows [Jh 4h] (two pair, Eights and Fours)
Ndundun Gipe collected $82.50 from pot
*** SUMMARY ***
Total pot $85 | Rake $2.50 
Board [9h 8h 8c 4c 5s]
Seat 1: ki11u folded before Flop (didn't bet)
Seat 4: Ndundun Gipe showed [Jh 4h] and won ($82.50) with two pair, Eights and Fours
Seat 5: rura53 folded before Flop (didn't bet)
Seat 6: SexyAngeline (button) folded before Flop (didn't bet)
Seat 7: Avtovo (small blind) showed [Ah Th] and lost with a pair of Eights
Seat 8: matiko09 (big blind) folded on the Flop
Seat 9: SkUhNi folded before Flop (didn't bet)





PokerStars Hand #154970573802:  Hold'em No Limit (£0.25/£0.50 GBP) - 2016/06/20 12:46:15 CET [2016/06/20 6:46:15 ET]
Table 'Ani' 6-max Seat #3 is the button
Seat 1: rewq99887788 (£40.56 in chips) 
Seat 2: mitsuVK (£51.40 in chips) 
Seat 3: Doobes8555 (£74.16 in chips) 
Seat 4: matiko09 (£53.44 in chips) 
Seat 5: Wwwasian (£54.87 in chips) 
Seat 6: faceMyBallz_ (£55.04 in chips) 
matiko09: posts small blind £0.25
Wwwasian: posts big blind £0.50
*** HOLE CARDS ***
Dealt to matiko09 [3d 9d]
faceMyBallz_: folds 
rewq99887788: calls £0.50
mitsuVK: folds 
Doobes8555: calls £0.50
matiko09: calls £0.25
Wwwasian: raises £0.90 to £1.40
rewq99887788: calls £0.90
Doobes8555: calls £0.90
matiko09: folds 
*** FLOP *** [8h Ac 8c]
Wwwasian: bets £1.50
rewq99887788: folds 
Doobes8555: folds 
Uncalled bet (£1.50) returned to Wwwasian
Wwwasian collected £4.46 from pot
Wwwasian: doesn't show hand 
*** SUMMARY ***
Total pot £4.70 | Rake £0.24 
Board [8h Ac 8c]
Seat 1: rewq99887788 folded on the Flop
Seat 2: mitsuVK folded before Flop (didn't bet)
Seat 3: Doobes8555 (button) folded on the Flop
Seat 4: matiko09 (small blind) folded before Flop
Seat 5: Wwwasian (big blind) collected (£4.46)
Seat 6: faceMyBallz_ folded before Flop (didn't bet)





PokerStars Hand #154970575166:  Hold'em No Limit ($0.50/$1.00 USD) - 2016/06/20 12:46:19 CET [2016/06/20 6:46:19 ET]
Table 'Ambrosia II' 9-max Seat #6 is the button
Seat 1: 23SmOkEr07 ($177.25 in chips) 
Seat 2: Eyeballz1307 ($19.84 in chips) 
Seat 3: mavin80 ($105.95 in chips) 
Seat 4: mi$$I$Elena ($216.27 in chips) 
Seat 5: Mattulh ($100 in chips) 
Seat 6: ruslik_by ($106.30 in chips) 
Seat 7: matiko09 ($100 in chips) 
Seat 8: hammerwife ($100 in chips) 
Seat 9: SkUhNi ($131.76 in chips) 
matiko09: posts small blind $0.50
hammerwife: posts big blind $1
*** HOLE CARDS ***
Dealt to matiko09 [Ks Ts]
SkUhNi: folds 
23SmOkEr07: raises $1.50 to $2.50
Eyeballz1307: folds 
mavin80: folds 
mi$$I$Elena: raises $5 to $7.50
Mattulh: folds 
ruslik_by: folds 
matiko09: folds 
hammerwife: raises $11.50 to $19
23SmOkEr07: folds 
mi$$I$Elena: calls $11.50
*** FLOP *** [9h Qd 2c]
hammerwife: bets $13.50
mi$$I$Elena: folds 
Uncalled bet ($13.50) returned to hammerwife
hammerwife collected $38.95 from pot
hammerwife: doesn't show hand 
*** SUMMARY ***
Total pot $41 | Rake $2.05 
Board [9h Qd 2c]
Seat 1: 23SmOkEr07 folded before Flop
Seat 2: Eyeballz1307 folded before Flop (didn't bet)
Seat 3: mavin80 folded before Flop (didn't bet)
Seat 4: mi$$I$Elena folded on the Flop
Seat 5: Mattulh folded before Flop (didn't bet)
Seat 6: ruslik_by (button) folded before Flop (didn't bet)
Seat 7: matiko09 (small blind) folded before Flop
Seat 8: hammerwife (big blind) collected ($38.95)
Seat 9: SkUhNi folded before Flop (didn't bet)





PokerStars Hand #154970576832:  Hold'em No Limit ($0.50/$1.00 USD) - 2016/06/20 12:46:23 CET [2016/06/20 6:46:23 ET]
Table 'Annika' 9-max Seat #5 is the button
Seat 1: hammerwife ($132.77 in chips) 
Seat 2: matiko09 ($106.80 in chips) 
Seat 3: first_dnk ($87.78 in chips) 
Seat 4: Kukuryzka ($107 in chips) 
Seat 5: SkUhNi ($123.63 in chips) 
Seat 6: Pvsx. ($103.05 in chips) 
Seat 8: ruslik_by ($106.40 in chips) 
Seat 9: 23SmOkEr07 ($117.15 in chips) 
Pvsx.: posts small blind $0.50
ruslik_by: posts big blind $1
*** HOLE CARDS ***
Dealt to matiko09 [7s Ac]
23SmOkEr07: folds 
hammerwife: raises $2 to $3
matiko09: folds 
first_dnk: folds 
Kukuryzka: folds 
SkUhNi: folds 
Pvsx.: folds 
ruslik_by: folds 
Uncalled bet ($2) returned to hammerwife
hammerwife collected $2.50 from pot
hammerwife: doesn't show hand 
*** SUMMARY ***
Total pot $2.50 | Rake $0 
Seat 1: hammerwife collected ($2.50)
Seat 2: matiko09 folded before Flop (didn't bet)
Seat 3: first_dnk folded before Flop (didn't bet)
Seat 4: Kukuryzka folded before Flop (didn't bet)
Seat 5: SkUhNi (button) folded before Flop (didn't bet)
Seat 6: Pvsx. (small blind) folded before Flop
Seat 8: ruslik_by (big blind) folded before Flop
Seat 9: 23SmOkEr07 folded before Flop (didn't bet)





PokerStars Hand #154970578221:  Hold'em No Limit ($0.50/$1.00 USD) - 2016/06/20 12:46:27 CET [2016/06/20 6:46:27 ET]
Table 'Isonoe II' 9-max Seat #8 is the button
Seat 1: hammerwife ($106.36 in chips) 
Seat 2: matiko09 ($123.76 in chips) 
Seat 3: Kukuryzka ($100 in chips) 
Seat 4: Avtovo ($100 in chips) 
Seat 5: Filojoes ($100 in chips) 
Seat 6: GOOFA13 ($70.46 in chips) 
Seat 7: SkUhNi ($113.82 in chips) 
Seat 8: lewyson ($55.08 in chips) 
Seat 9: djammusic ($64.45 in chips) 
djammusic: posts small blind $0.50
hammerwife: posts big blind $1
*** HOLE CARDS ***
Dealt to matiko09 [9h 8d]
matiko09: folds 
Kukuryzka: folds 
Avtovo: folds 
Filojoes: folds 
GOOFA13: folds 
SkUhNi: folds 
lewyson: raises $1 to $2
djammusic: folds 
hammerwife: folds 
Uncalled bet ($1) returned to lewyson
lewyson collected $2.50 from pot
*** SUMMARY ***
Total pot $2.50 | Rake $0 
Seat 1: hammerwife (big blind) folded before Flop
Seat 2: matiko09 folded before Flop (didn't bet)
Seat 3: Kukuryzka folded before Flop (didn't bet)
Seat 4: Avtovo folded before Flop (didn't bet)
Seat 5: Filojoes folded before Flop (didn't bet)
Seat 6: GOOFA13 folded before Flop (didn't bet)
Seat 7: SkUhNi folded before Flop (didn't bet)
Seat 8: lewyson (button) collected ($2.50)
Seat 9: djammusic (small blind) folded before Flop





PokerStars Hand #154970579875:  Hold'em No Limit ($0.50/$1.00 USD) - 2016/06/20 12:46:31 CET [2016/06/20 6:46:31 ET]
Table 'Ernestina' 9-max Seat #9 is the button
Seat 1: diva3150 ($142.62 in chips) 
Seat 2: matiko09 ($103.75 in chips) 
Seat 3: Pvsx. ($188.99 in chips) 
Seat 4: SkUhNi ($100 in chips) 
Seat 5: Dickyxxx ($148.11 in chips) 
Seat 8: ruslik_by ($263.74 in chips) 
Seat 9: 23SmOkEr07 ($100 in chips) 
diva3150: posts small blind $0.50
matiko09: posts big blind $1
*** HOLE CARDS ***
Dealt to matiko09 [Qs Kh]
Pvsx.: folds 
SkUhNi: folds 
Dickyxxx: folds 
ruslik_by: folds 
23SmOkEr07: raises $1.50 to $2.50
diva3150: folds 
matiko09: calls $1.50
*** FLOP *** [6s 7d 8h]
matiko09: checks 
23SmOkEr07: bets $2.92
matiko09: folds 
Uncalled bet ($2.92) returned to 23SmOkEr07
23SmOkEr07 collected $5.22 from pot
23SmOkEr07: doesn't show hand 
*** SUMMARY ***
Total pot $5.50 | Rake $0.28 
Board [6s 7d 8h]
Seat 1: diva3150 (small blind) folded before Flop
Seat 2: matiko09 (big blind) folded on the Flop
Seat 3: Pvsx. folded before Flop (didn't bet)
Seat 4: SkUhNi folded before Flop (didn't bet)
Seat 5: Dickyxxx folded before Flop (didn't bet)
Seat 8: ruslik_by folded before Flop (didn't bet)
Seat 9: 23SmOkEr07 (button) collected ($5.22)





PokerStars Hand #154970580064:  Hold'em No Limit (£0.25/£0.50 GBP) - 2016/06/20 12:46:31 CET [2016/06/20 6:46:31 ET]
Table 'Azalea' 6-max Seat #6 is the button
Seat 1: mitsuVK (£51.73 in chips) 
Seat 2: matiko09 (£83.49 in chips) 
Seat 4: faceMyBallz_ (£95.93 in chips) 
Seat 5: mudders693 (£73.69 in chips) 
Seat 6: Bënedic10 (£53.73 in chips) 
mitsuVK: posts small blind £0.25
matiko09: posts big blind £0.50
tyoma_knp: sits out 
*** HOLE CARDS ***
Dealt to matiko09 [Jc 3d]
faceMyBallz_: folds 
mudders693: calls £0.50
Bënedic10: raises £3 to £3.50
mitsuVK: folds 
matiko09: folds 
mudders693: folds 
Uncalled bet (£3) returned to Bënedic10
Bënedic10 collected £1.75 from pot
Bënedic10: doesn't show hand 
*** SUMMARY ***
Total pot £1.75 | Rake £0 
Seat 1: mitsuVK (small blind) folded before Flop
Seat 2: matiko09 (big blind) folded before Flop
Seat 4: faceMyBallz_ folded before Flop (didn't bet)
Seat 5: mudders693 folded before Flop
Seat 6: Bënedic10 (button) collected (£1.75)





PokerStars Hand #154970581486:  Hold'em No Limit ($0.50/$1.00 USD) - 2016/06/20 12:46:35 CET [2016/06/20 6:46:35 ET]
Table 'Albiorix' 9-max Seat #3 is the button
Seat 2: SkUhNi ($111.52 in chips) 
Seat 3: matiko09 ($126.73 in chips) 
Seat 4: 23SmOkEr07 ($132 in chips) 
Seat 5: ruslik_by ($100 in chips) 
Seat 6: joker180785 ($201.64 in chips) 
Seat 7: Pekyto ($50.65 in chips) 
Seat 8: smiley0221 ($58.88 in chips) 
Seat 9: Coolller ($190.29 in chips) 
23SmOkEr07: posts small blind $0.50
ruslik_by: posts big blind $1
*** HOLE CARDS ***
Dealt to matiko09 [Qc 8c]
joker180785: raises $2 to $3
Pekyto: folds 
smiley0221: folds 
Coolller: folds 
SkUhNi: folds 
matiko09: folds 
23SmOkEr07: folds 
ruslik_by: raises $6.50 to $9.50
joker180785: folds 
Uncalled bet ($6.50) returned to ruslik_by
ruslik_by collected $6.50 from pot
ruslik_by: doesn't show hand 
*** SUMMARY ***
Total pot $6.50 | Rake $0 
Seat 2: SkUhNi folded before Flop (didn't bet)
Seat 3: matiko09 (button) folded before Flop (didn't bet)
Seat 4: 23SmOkEr07 (small blind) folded before Flop
Seat 5: ruslik_by (big blind) collected ($6.50)
Seat 6: joker180785 folded before Flop
Seat 7: Pekyto folded before Flop (didn't bet)
Seat 8: smiley0221 folded before Flop (didn't bet)
Seat 9: Coolller folded before Flop (didn't bet)





PokerStars Hand #154970582225:  Hold'em No Limit ($0.25/$0.50 USD) - 2016/06/20 12:46:37 CET [2016/06/20 6:46:37 ET]
Table 'Scheddi II' 9-max Seat #1 is the button
Seat 1: matiko09 ($96.50 in chips) 
Seat 2: Yaaaazz ($90.45 in chips) 
Seat 3: mi$$I$Elena ($95.90 in chips) 
Seat 4: GOOFA13 ($62.61 in chips) 
Seat 5: zarplatka ($40 in chips) 
Seat 6: joker180785 ($63.41 in chips) 
Seat 7: HopeMayBee ($90.21 in chips) 
Seat 8: orochimaturi ($21.70 in chips) 
Seat 9: Infinitinium ($55.75 in chips) 
Yaaaazz: posts small blind $0.25
mi$$I$Elena: posts big blind $0.50
matiko09: posts the ante $0.10
Yaaaazz: posts the ante $0.10
mi$$I$Elena: posts the ante $0.10
GOOFA13: posts the ante $0.10
zarplatka: posts the ante $0.10
joker180785: posts the ante $0.10
HopeMayBee: posts the ante $0.10
orochimaturi: posts the ante $0.10
Infinitinium: posts the ante $0.10
*** HOLE CARDS ***
Dealt to matiko09 [7h 9d]
GOOFA13: raises $0.50 to $1
zarplatka: folds 
joker180785: calls $1
HopeMayBee: folds 
orochimaturi: calls $1
Infinitinium: raises $5.65 to $6.65
matiko09: folds 
Yaaaazz: folds 
mi$$I$Elena: folds 
GOOFA13: calls $5.65
joker180785: calls $5.65
orochimaturi: calls $5.65
*** FLOP *** [8h 6d Kd]
GOOFA13: checks 
joker180785: checks 
orochimaturi: checks 
Infinitinium: checks 
*** TURN *** [8h 6d Kd] [2s]
GOOFA13: checks 
joker180785: checks 
orochimaturi: bets $14.95 and is all-in
Infinitinium: calls $14.95
GOOFA13: calls $14.95
joker180785: calls $14.95
*** RIVER *** [8h 6d Kd 2s] [Ac]
GOOFA13: checks 
joker180785: checks 
Infinitinium: checks 
*** SHOW DOWN ***
GOOFA13: shows [7c 9c] (high card Ace)
joker180785: shows [Qd Td] (high card Ace - King+Queen kicker)
orochimaturi: shows [3s 3c] (a pair of Threes)
Infinitinium: shows [Qs Qc] (a pair of Queens)
Infinitinium collected $86.05 from pot
*** SUMMARY ***
Total pot $88.05 | Rake $2 
Board [8h 6d Kd 2s Ac]
Seat 1: matiko09 (button) folded before Flop (didn't bet)
Seat 2: Yaaaazz (small blind) folded before Flop
Seat 3: mi$$I$Elena (big blind) folded before Flop
Seat 4: GOOFA13 showed [7c 9c] and lost with high card Ace
Seat 5: zarplatka folded before Flop (didn't bet)
Seat 6: joker180785 showed [Qd Td] and lost with high card Ace
Seat 7: HopeMayBee folded before Flop (didn't bet)
Seat 8: orochimaturi showed [3s 3c] and lost with a pair of Threes
Seat 9: Infinitinium showed [Qs Qc] and won ($86.05) with a pair of Queens





PokerStars Hand #154970584725:  Hold'em No Limit ($0.50/$1.00 USD) - 2016/06/20 12:46:43 CET [2016/06/20 6:46:43 ET]
Table 'Normannia' 9-max Seat #6 is the button
Seat 1: hammerwife ($108.34 in chips) 
Seat 2: Pvsx. ($190.62 in chips) 
Seat 3: Avtovo ($100 in chips) 
Seat 5: Dickyxxx ($120.19 in chips) 
Seat 6: typename27 ($69.12 in chips) 
Seat 7: matiko09 ($100 in chips) 
Seat 8: SkUhNi ($132.81 in chips) 
Seat 9: ruslik_by ($147.69 in chips) 
matiko09: posts small blind $0.50
SkUhNi: posts big blind $1
Filojoes: sits out 
*** HOLE CARDS ***
Dealt to matiko09 [7s 2c]
ruslik_by: folds 
hammerwife: raises $2 to $3
Pvsx.: folds 
Avtovo: folds 
Dickyxxx: folds 
typename27: calls $3
matiko09: folds 
SkUhNi: calls $2
*** FLOP *** [4s Jd 2d]
SkUhNi: checks 
hammerwife: checks 
typename27: bets $4.51
SkUhNi: folds 
hammerwife: calls $4.51
*** TURN *** [4s Jd 2d] [8c]
hammerwife: checks 
typename27: bets $7
hammerwife: calls $7
*** RIVER *** [4s Jd 2d 8c] [7c]
hammerwife: checks 
typename27: checks 
*** SHOW DOWN ***
hammerwife: shows [7h 7d] (three of a kind, Sevens)
typename27: mucks hand 
hammerwife collected $30.89 from pot
*** SUMMARY ***
Total pot $32.52 | Rake $1.63 
Board [4s Jd 2d 8c 7c]
Seat 1: hammerwife showed [7h 7d] and won ($30.89) with three of a kind, Sevens
Seat 2: Pvsx. folded before Flop (didn't bet)
Seat 3: Avtovo folded before Flop (didn't bet)
Seat 5: Dickyxxx folded before Flop (didn't bet)
Seat 6: typename27 (button) mucked [Jc Qs]
Seat 7: matiko09 (small blind) folded before Flop
Seat 8: SkUhNi (big blind) folded on the Flop
Seat 9: ruslik_by folded before Flop (didn't bet)





PokerStars Hand #154970585499:  Hold'em No Limit ($0.50/$1.00 USD) - 2016/06/20 12:46:45 CET [2016/06/20 6:46:45 ET]
Table 'Anhui' 9-max Seat #9 is the button
Seat 1: SkUhNi ($154.92 in chips) 
Seat 2: ruslik_by ($274.18 in chips) 
Seat 3: hammerwife ($101.78 in chips) 
Seat 4: mavin80 ($65.95 in chips) 
Seat 5: mi$$I$Elena ($104.80 in chips) 
Seat 6: 23SmOkEr07 ($121.68 in chips) 
Seat 7: matiko09 ($130.18 in chips) 
Seat 8: blackmont111 ($69.50 in chips) 
Seat 9: TomBod1 ($76.53 in chips) 
SkUhNi: posts small blind $0.50
ruslik_by: posts big blind $1
*** HOLE CARDS ***
Dealt to matiko09 [4h 8c]
hammerwife: folds 
mavin80: folds 
mi$$I$Elena: folds 
23SmOkEr07: folds 
matiko09: folds 
blackmont111: folds 
TomBod1: raises $1.50 to $2.50
SkUhNi: folds 
ruslik_by: raises $6.50 to $9
TomBod1: raises $11.50 to $20.50
ruslik_by: folds 
Uncalled bet ($11.50) returned to TomBod1
TomBod1 collected $18.50 from pot
TomBod1: doesn't show hand 
*** SUMMARY ***
Total pot $18.50 | Rake $0 
Seat 1: SkUhNi (small blind) folded before Flop
Seat 2: ruslik_by (big blind) folded before Flop
Seat 3: hammerwife folded before Flop (didn't bet)
Seat 4: mavin80 folded before Flop (didn't bet)
Seat 5: mi$$I$Elena folded before Flop (didn't bet)
Seat 6: 23SmOkEr07 folded before Flop (didn't bet)
Seat 7: matiko09 folded before Flop (didn't bet)
Seat 8: blackmont111 folded before Flop (didn't bet)
Seat 9: TomBod1 (button) collected ($18.50)





PokerStars Hand #154970587416:  Hold'em No Limit (£0.25/£0.50 GBP) - 2016/06/20 12:46:50 CET [2016/06/20 6:46:50 ET]
Table 'Ani' 6-max Seat #4 is the button
Seat 1: rewq99887788 (£39.16 in chips) 
Seat 2: mitsuVK (£51.40 in chips) 
Seat 3: Doobes8555 (£72.76 in chips) 
Seat 4: matiko09 (£52.94 in chips) 
Seat 5: Wwwasian (£57.93 in chips) 
Seat 6: faceMyBallz_ (£55.04 in chips) 
Wwwasian: posts small blind £0.25
faceMyBallz_: posts big blind £0.50
*** HOLE CARDS ***
Dealt to matiko09 [9s 9h]
rewq99887788: folds 
mitsuVK: folds 
Doobes8555: raises £1 to £1.50
matiko09: raises £2.50 to £4
Wwwasian: folds 
faceMyBallz_: folds 
Doobes8555: calls £2.50
*** FLOP *** [9c 8d 7c]
Doobes8555: checks 
matiko09: bets £5.40
Doobes8555: calls £5.40
*** TURN *** [9c 8d 7c] [7h]
Doobes8555: checks 
matiko09: bets £7.50
Doobes8555: folds 
Uncalled bet (£7.50) returned to matiko09
matiko09 collected £18.57 from pot
matiko09: doesn't show hand 
*** SUMMARY ***
Total pot £19.55 | Rake £0.98 
Board [9c 8d 7c 7h]
Seat 1: rewq99887788 folded before Flop (didn't bet)
Seat 2: mitsuVK folded before Flop (didn't bet)
Seat 3: Doobes8555 folded on the Turn
Seat 4: matiko09 (button) collected (£18.57)
Seat 5: Wwwasian (small blind) folded before Flop
Seat 6: faceMyBallz_ (big blind) folded before Flop





PokerStars Hand #154970588451:  Hold'em No Limit (£0.25/£0.50 GBP) - 2016/06/20 12:46:53 CET [2016/06/20 6:46:53 ET]
Table 'Tesla' 6-max Seat #6 is the button
Seat 1: Rubleff85 (£53.98 in chips) 
Seat 2: matiko09 (£60.65 in chips) 
Seat 3: asmodej666 (£58.34 in chips) 
Seat 4: ILIUXa (£50 in chips) 
Seat 5: Nego Razu (£50 in chips) 
Seat 6: faceMyBallz_ (£55.86 in chips) 
Rubleff85: posts small blind £0.25
matiko09: posts big blind £0.50
*** HOLE CARDS ***
Dealt to matiko09 [Js Qh]
asmodej666: folds 
ILIUXa: folds 
Nego Razu: folds 
faceMyBallz_: raises £0.50 to £1
Rubleff85: calls £0.75
matiko09: calls £0.50
*** FLOP *** [4c Ks 7d]
Rubleff85: checks 
matiko09: checks 
faceMyBallz_: checks 
*** TURN *** [4c Ks 7d] [Jc]
Rubleff85: bets £1.50
matiko09: calls £1.50
faceMyBallz_: calls £1.50
*** RIVER *** [4c Ks 7d Jc] [3c]
Rubleff85: checks 
matiko09: checks 
faceMyBallz_: checks 
*** SHOW DOWN ***
Rubleff85: shows [8h 7s] (a pair of Sevens)
matiko09: shows [Js Qh] (a pair of Jacks)
faceMyBallz_: mucks hand 
matiko09 collected £7.12 from pot
*** SUMMARY ***
Total pot £7.50 | Rake £0.38 
Board [4c Ks 7d Jc 3c]
Seat 1: Rubleff85 (small blind) showed [8h 7s] and lost with a pair of Sevens
Seat 2: matiko09 (big blind) showed [Js Qh] and won (£7.12) with a pair of Jacks
Seat 3: asmodej666 folded before Flop (didn't bet)
Seat 4: ILIUXa folded before Flop (didn't bet)
Seat 5: Nego Razu folded before Flop (didn't bet)
Seat 6: faceMyBallz_ (button) mucked [Ah Ts]





PokerStars Hand #154970590006:  Hold'em No Limit (£0.25/£0.50 GBP) - 2016/06/20 12:46:57 CET [2016/06/20 6:46:57 ET]
Table 'Azalea' 6-max Seat #1 is the button
Seat 1: mitsuVK (£51.48 in chips) 
Seat 2: matiko09 (£82.99 in chips) 
Seat 3: tyoma_knp (£50 in chips) 
Seat 4: faceMyBallz_ (£95.93 in chips) 
Seat 5: mudders693 (£73.19 in chips) 
Seat 6: Bënedic10 (£54.98 in chips) 
matiko09: posts small blind £0.25
tyoma_knp: posts big blind £0.50
*** HOLE CARDS ***
Dealt to matiko09 [4d Kd]
faceMyBallz_: folds 
mudders693: raises £1 to £1.50
Bënedic10: folds 
mitsuVK: folds 
matiko09: folds 
tyoma_knp: raises £3.25 to £4.75
mudders693: folds 
Uncalled bet (£3.25) returned to tyoma_knp
tyoma_knp collected £3.25 from pot
*** SUMMARY ***
Total pot £3.25 | Rake £0 
Seat 1: mitsuVK (button) folded before Flop (didn't bet)
Seat 2: matiko09 (small blind) folded before Flop
Seat 3: tyoma_knp (big blind) collected (£3.25)
Seat 4: faceMyBallz_ folded before Flop (didn't bet)
Seat 5: mudders693 folded before Flop
Seat 6: Bënedic10 folded before Flop (didn't bet)





PokerStars Hand #154970591489:  Hold'em No Limit ($0.50/$1.00 USD) - 2016/06/20 12:47:01 CET [2016/06/20 6:47:01 ET]
Table 'Isonoe II' 9-max Seat #9 is the button
Seat 1: hammerwife ($105.36 in chips) 
Seat 2: matiko09 ($123.76 in chips) 
Seat 3: Kukuryzka ($100 in chips) 
Seat 4: Avtovo ($100 in chips) 
Seat 5: Filojoes ($100 in chips) 
Seat 6: GOOFA13 ($70.46 in chips) 
Seat 7: SkUhNi ($113.82 in chips) 
Seat 8: lewyson ($56.58 in chips) 
Seat 9: djammusic ($63.95 in chips) 
hammerwife: posts small blind $0.50
matiko09: posts big blind $1
*** HOLE CARDS ***
Dealt to matiko09 [9h 7c]
Kukuryzka: raises $2 to $3
Avtovo: folds 
Filojoes: folds 
GOOFA13: folds 
SkUhNi: folds 
lewyson: folds 
djammusic: raises $5 to $8
hammerwife: folds 
matiko09: folds 
Kukuryzka: folds 
Uncalled bet ($5) returned to djammusic
djammusic collected $7.50 from pot
djammusic: doesn't show hand 
*** SUMMARY ***
Total pot $7.50 | Rake $0 
Seat 1: hammerwife (small blind) folded before Flop
Seat 2: matiko09 (big blind) folded before Flop
Seat 3: Kukuryzka folded before Flop
Seat 4: Avtovo folded before Flop (didn't bet)
Seat 5: Filojoes folded before Flop (didn't bet)
Seat 6: GOOFA13 folded before Flop (didn't bet)
Seat 7: SkUhNi folded before Flop (didn't bet)
Seat 8: lewyson folded before Flop (didn't bet)
Seat 9: djammusic (button) collected ($7.50)





PokerStars Hand #154970592333:  Hold'em No Limit ($0.50/$1.00 USD) - 2016/06/20 12:47:03 CET [2016/06/20 6:47:03 ET]
Table 'Ernestina' 9-max Seat #1 is the button
Seat 1: diva3150 ($142.12 in chips) 
Seat 2: matiko09 ($101.25 in chips) 
Seat 3: Pvsx. ($188.99 in chips) 
Seat 4: SkUhNi ($100 in chips) 
Seat 5: Dickyxxx ($148.11 in chips) 
Seat 8: ruslik_by ($263.74 in chips) 
Seat 9: 23SmOkEr07 ($102.72 in chips) 
matiko09: posts small blind $0.50
Pvsx.: posts big blind $1
*** HOLE CARDS ***
Dealt to matiko09 [7c Kh]
SkUhNi: folds 
Dickyxxx: folds 
ruslik_by: folds 
23SmOkEr07: raises $1.50 to $2.50
diva3150: calls $2.50
matiko09: folds 
Pvsx.: folds 
*** FLOP *** [4c Ac Td]
23SmOkEr07: bets $3.46
diva3150: folds 
Uncalled bet ($3.46) returned to 23SmOkEr07
23SmOkEr07 collected $6.18 from pot
23SmOkEr07: doesn't show hand 
*** SUMMARY ***
Total pot $6.50 | Rake $0.32 
Board [4c Ac Td]
Seat 1: diva3150 (button) folded on the Flop
Seat 2: matiko09 (small blind) folded before Flop
Seat 3: Pvsx. (big blind) folded before Flop
Seat 4: SkUhNi folded before Flop (didn't bet)
Seat 5: Dickyxxx folded before Flop (didn't bet)
Seat 8: ruslik_by folded before Flop (didn't bet)
Seat 9: 23SmOkEr07 collected ($6.18)





PokerStars Hand #154970601794:  Hold'em No Limit ($0.50/$1.00 USD) - 2016/06/20 12:47:27 CET [2016/06/20 6:47:27 ET]
Table 'Annika' 9-max Seat #6 is the button
Seat 1: hammerwife ($134.27 in chips) 
Seat 2: matiko09 ($106.80 in chips) 
Seat 3: first_dnk ($87.78 in chips) 
Seat 4: Kukuryzka ($107 in chips) 
Seat 5: SkUhNi ($123.63 in chips) 
Seat 6: Pvsx. ($102.55 in chips) 
Seat 8: ruslik_by ($105.40 in chips) 
Seat 9: 23SmOkEr07 ($117.15 in chips) 
ruslik_by: posts small blind $0.50
23SmOkEr07: posts big blind $1
*** HOLE CARDS ***
Dealt to matiko09 [8h 6h]
hammerwife: folds 
matiko09: folds 
first_dnk: folds 
Kukuryzka: folds 
SkUhNi: folds 
Pvsx.: folds 
ruslik_by: folds 
Uncalled bet ($0.50) returned to 23SmOkEr07
23SmOkEr07 collected $1 from pot
23SmOkEr07: doesn't show hand 
*** SUMMARY ***
Total pot $1 | Rake $0 
Seat 1: hammerwife folded before Flop (didn't bet)
Seat 2: matiko09 folded before Flop (didn't bet)
Seat 3: first_dnk folded before Flop (didn't bet)
Seat 4: Kukuryzka folded before Flop (didn't bet)
Seat 5: SkUhNi folded before Flop (didn't bet)
Seat 6: Pvsx. (button) folded before Flop (didn't bet)
Seat 8: ruslik_by (small blind) folded before Flop
Seat 9: 23SmOkEr07 (big blind) collected ($1)





PokerStars Hand #154970602141:  Hold'em No Limit ($0.50/$1.00 USD) - 2016/06/20 12:47:28 CET [2016/06/20 6:47:28 ET]
Table 'Pongola' 9-max Seat #9 is the button
Seat 1: matiko09 ($100 in chips) 
Seat 2: ruslik_by ($130.77 in chips) 
Seat 3: SkUhNi ($114.72 in chips) 
Seat 4: karllv ($155.31 in chips) 
Seat 5: joker180785 ($170.40 in chips) 
Seat 6: 23SmOkEr07 ($114.21 in chips) 
Seat 7: Dickyxxx ($148.12 in chips) 
Seat 8: phrantique ($100 in chips) 
Seat 9: Filojoes ($124.08 in chips) 
matiko09: posts small blind $0.50
ruslik_by: posts big blind $1
*** HOLE CARDS ***
Dealt to matiko09 [7s 9h]
SkUhNi: folds 
karllv: folds 
joker180785: folds 
23SmOkEr07: folds 
Dickyxxx: raises $2 to $3
phrantique: folds 
Filojoes: folds 
joker180785 leaves the table
Avtovo joins the table at seat #5 
matiko09: folds 
ruslik_by: folds 
Uncalled bet ($2) returned to Dickyxxx
Dickyxxx collected $2.50 from pot
Dickyxxx: doesn't show hand 
*** SUMMARY ***
Total pot $2.50 | Rake $0 
Seat 1: matiko09 (small blind) folded before Flop
Seat 2: ruslik_by (big blind) folded before Flop
Seat 3: SkUhNi folded before Flop (didn't bet)
Seat 4: karllv folded before Flop (didn't bet)
Seat 5: joker180785 folded before Flop (didn't bet)
Seat 6: 23SmOkEr07 folded before Flop (didn't bet)
Seat 7: Dickyxxx collected ($2.50)
Seat 8: phrantique folded before Flop (didn't bet)
Seat 9: Filojoes (button) folded before Flop (didn't bet)





PokerStars Hand #154970602732:  Hold'em No Limit ($0.50/$1.00 USD) - 2016/06/20 12:47:30 CET [2016/06/20 6:47:30 ET]
Table 'Garumna II' 9-max Seat #7 is the button
Seat 1: ki11u ($103 in chips) 
Seat 3: mooose100 ($80 in chips) 
Seat 4: Ndundun Gipe ($82.50 in chips) 
Seat 5: rura53 ($78 in chips) 
Seat 6: SexyAngeline ($41.55 in chips) 
Seat 7: Avtovo ($100 in chips) 
Seat 8: matiko09 ($100 in chips) 
Seat 9: SkUhNi ($103.80 in chips) 
matiko09: posts small blind $0.50
SkUhNi: posts big blind $1
Racushniak: sits out 
mooose100: posts big blind $1
*** HOLE CARDS ***
Dealt to matiko09 [5s 6h]
ki11u: folds 
mooose100: checks 
Ndundun Gipe: folds 
rura53: folds 
SexyAngeline: folds 
Avtovo: folds 
matiko09: folds 
SkUhNi: checks 
*** FLOP *** [Kc 2s 6c]
SkUhNi: checks 
mooose100: bets $1
SkUhNi: folds 
Uncalled bet ($1) returned to mooose100
mooose100 collected $2.38 from pot
mooose100: doesn't show hand 
*** SUMMARY ***
Total pot $2.50 | Rake $0.12 
Board [Kc 2s 6c]
Seat 1: ki11u folded before Flop (didn't bet)
Seat 3: mooose100 collected ($2.38)
Seat 4: Ndundun Gipe folded before Flop (didn't bet)
Seat 5: rura53 folded before Flop (didn't bet)
Seat 6: SexyAngeline folded before Flop (didn't bet)
Seat 7: Avtovo (button) folded before Flop (didn't bet)
Seat 8: matiko09 (small blind) folded before Flop
Seat 9: SkUhNi (big blind) folded on the Flop





PokerStars Hand #154970602986:  Hold'em No Limit ($0.50/$1.00 USD) - 2016/06/20 12:47:30 CET [2016/06/20 6:47:30 ET]
Table 'Albiorix' 9-max Seat #4 is the button
Seat 2: SkUhNi ($111.52 in chips) 
Seat 3: matiko09 ($126.73 in chips) 
Seat 4: 23SmOkEr07 ($131.50 in chips) 
Seat 5: ruslik_by ($103.50 in chips) 
Seat 7: Pekyto ($50.65 in chips) 
Seat 8: smiley0221 ($58.88 in chips) 
Seat 9: Coolller ($190.29 in chips) 
ruslik_by: posts small blind $0.50
joker180785: is sitting out 
joker180785 leaves the table
Pekyto: posts big blind $1
*** HOLE CARDS ***
Dealt to matiko09 [8h 3h]
Filojoes joins the table at seat #6 
smiley0221: folds 
Coolller: folds 
SkUhNi: raises $2 to $3
matiko09: folds 
23SmOkEr07: calls $3
ruslik_by: folds 
Pekyto: folds 
*** FLOP *** [4d Ah 4h]
SkUhNi: bets $5
23SmOkEr07: folds 
Uncalled bet ($5) returned to SkUhNi
SkUhNi collected $7.12 from pot
*** SUMMARY ***
Total pot $7.50 | Rake $0.38 
Board [4d Ah 4h]
Seat 2: SkUhNi collected ($7.12)
Seat 3: matiko09 folded before Flop (didn't bet)
Seat 4: 23SmOkEr07 (button) folded on the Flop
Seat 5: ruslik_by (small blind) folded before Flop
Seat 7: Pekyto (big blind) folded before Flop
Seat 8: smiley0221 folded before Flop (didn't bet)
Seat 9: Coolller folded before Flop (didn't bet)





PokerStars Hand #154970603054:  Hold'em No Limit ($0.50/$1.00 USD) - 2016/06/20 12:47:30 CET [2016/06/20 6:47:30 ET]
Table 'Ernestina' 9-max Seat #2 is the button
Seat 1: diva3150 ($139.62 in chips) 
Seat 2: matiko09 ($100.75 in chips) 
Seat 3: Pvsx. ($187.99 in chips) 
Seat 4: SkUhNi ($100 in chips) 
Seat 5: Dickyxxx ($148.11 in chips) 
Seat 8: ruslik_by ($263.74 in chips) 
Seat 9: 23SmOkEr07 ($106.40 in chips) 
Pvsx.: posts small blind $0.50
SkUhNi: posts big blind $1
*** HOLE CARDS ***
Dealt to matiko09 [3h 3c]
Dickyxxx: folds 
ruslik_by: folds 
23SmOkEr07: folds 
diva3150: folds 
matiko09: raises $1.27 to $2.27
Pvsx.: folds 
SkUhNi: calls $1.27
*** FLOP *** [Ts 5d 8h]
SkUhNi: checks 
matiko09: checks 
*** TURN *** [Ts 5d 8h] [8s]
SkUhNi: checks 
matiko09: bets $2.49
SkUhNi: folds 
Uncalled bet ($2.49) returned to matiko09
matiko09 collected $4.79 from pot
matiko09: doesn't show hand 
*** SUMMARY ***
Total pot $5.04 | Rake $0.25 
Board [Ts 5d 8h 8s]
Seat 1: diva3150 folded before Flop (didn't bet)
Seat 2: matiko09 (button) collected ($4.79)
Seat 3: Pvsx. (small blind) folded before Flop
Seat 4: SkUhNi (big blind) folded on the Turn
Seat 5: Dickyxxx folded before Flop (didn't bet)
Seat 8: ruslik_by folded before Flop (didn't bet)
Seat 9: 23SmOkEr07 folded before Flop (didn't bet)





PokerStars Hand #154970604644:  Hold'em No Limit (£0.25/£0.50 GBP) - 2016/06/20 12:47:34 CET [2016/06/20 6:47:34 ET]
Table 'Azalea' 6-max Seat #2 is the button
Seat 1: mitsuVK (£51.48 in chips) 
Seat 2: matiko09 (£82.74 in chips) 
Seat 3: tyoma_knp (£51.75 in chips) 
Seat 4: faceMyBallz_ (£95.93 in chips) 
Seat 5: mudders693 (£71.69 in chips) 
Seat 6: Bënedic10 (£54.98 in chips) 
tyoma_knp: posts small blind £0.25
faceMyBallz_: posts big blind £0.50
*** HOLE CARDS ***
Dealt to matiko09 [9s Kd]
mudders693: folds 
Bënedic10: folds 
mitsuVK: folds 
matiko09: raises £1 to £1.50
tyoma_knp: raises £3.25 to £4.75
faceMyBallz_: raises £5.25 to £10
matiko09: folds 
tyoma_knp: folds 
Uncalled bet (£5.25) returned to faceMyBallz_
faceMyBallz_ collected £11 from pot
faceMyBallz_: doesn't show hand 
*** SUMMARY ***
Total pot £11 | Rake £0 
Seat 1: mitsuVK folded before Flop (didn't bet)
Seat 2: matiko09 (button) folded before Flop
Seat 3: tyoma_knp (small blind) folded before Flop
Seat 4: faceMyBallz_ (big blind) collected (£11)
Seat 5: mudders693 folded before Flop (didn't bet)
Seat 6: Bënedic10 folded before Flop (didn't bet)





PokerStars Hand #154970608828:  Hold'em No Limit ($0.50/$1.00 USD) - 2016/06/20 12:47:45 CET [2016/06/20 6:47:45 ET]
Table 'Ambrosia II' 9-max Seat #7 is the button
Seat 1: 23SmOkEr07 ($174.75 in chips) 
Seat 2: Eyeballz1307 ($19.84 in chips) 
Seat 3: mavin80 ($105.95 in chips) 
Seat 4: mi$$I$Elena ($197.27 in chips) 
Seat 5: Mattulh ($100 in chips) 
Seat 6: ruslik_by ($106.30 in chips) 
Seat 7: matiko09 ($100 in chips) 
Seat 8: hammerwife ($119.95 in chips) 
Seat 9: SkUhNi ($131.76 in chips) 
hammerwife: posts small blind $0.50
SkUhNi: posts big blind $1
*** HOLE CARDS ***
Dealt to matiko09 [5d 8h]
23SmOkEr07: folds 
Eyeballz1307: folds 
mavin80: raises $1.50 to $2.50
mi$$I$Elena: folds 
Mattulh: raises $5.50 to $8
ruslik_by: folds 
matiko09: folds 
hammerwife: folds 
SkUhNi: folds 
mavin80: raises $11 to $19
Mattulh: folds 
Uncalled bet ($11) returned to mavin80
mavin80 collected $17.50 from pot
*** SUMMARY ***
Total pot $17.50 | Rake $0 
Seat 1: 23SmOkEr07 folded before Flop (didn't bet)
Seat 2: Eyeballz1307 folded before Flop (didn't bet)
Seat 3: mavin80 collected ($17.50)
Seat 4: mi$$I$Elena folded before Flop (didn't bet)
Seat 5: Mattulh folded before Flop
Seat 6: ruslik_by folded before Flop (didn't bet)
Seat 7: matiko09 (button) folded before Flop (didn't bet)
Seat 8: hammerwife (small blind) folded before Flop
Seat 9: SkUhNi (big blind) folded before Flop





PokerStars Hand #154970609858:  Hold'em No Limit ($0.25/$0.50 USD) - 2016/06/20 12:47:48 CET [2016/06/20 6:47:48 ET]
Table 'Scheddi II' 9-max Seat #2 is the button
Seat 1: matiko09 ($96.40 in chips) 
Seat 2: Yaaaazz ($90.10 in chips) 
Seat 3: mi$$I$Elena ($95.30 in chips) 
Seat 4: GOOFA13 ($40.91 in chips) 
Seat 5: zarplatka ($40 in chips) 
Seat 6: joker180785 ($50 in chips) 
Seat 7: HopeMayBee ($90.11 in chips) 
Seat 9: Infinitinium ($120.10 in chips) 
mi$$I$Elena: posts small blind $0.25
GOOFA13: posts big blind $0.50
matiko09: posts the ante $0.10
Yaaaazz: posts the ante $0.10
mi$$I$Elena: posts the ante $0.10
GOOFA13: posts the ante $0.10
zarplatka: posts the ante $0.10
joker180785: posts the ante $0.10
HopeMayBee: posts the ante $0.10
Infinitinium: posts the ante $0.10
*** HOLE CARDS ***
Dealt to matiko09 [6h 7c]
zarplatka: folds 
joker180785: folds 
HopeMayBee: folds 
orochimaturi leaves the table
joker180785 leaves the table
Infinitinium: calls $0.50
matiko09: folds 
Yaaaazz: folds 
mi$$I$Elena: folds 
GOOFA13: checks 
*** FLOP *** [Qc Ks Qh]
GOOFA13: checks 
Infinitinium: bets $0.50
GOOFA13: folds 
Uncalled bet ($0.50) returned to Infinitinium
Infinitinium collected $1.95 from pot
Infinitinium: doesn't show hand 
*** SUMMARY ***
Total pot $2.05 | Rake $0.10 
Board [Qc Ks Qh]
Seat 1: matiko09 folded before Flop (didn't bet)
Seat 2: Yaaaazz (button) folded before Flop (didn't bet)
Seat 3: mi$$I$Elena (small blind) folded before Flop
Seat 4: GOOFA13 (big blind) folded on the Flop
Seat 5: zarplatka folded before Flop (didn't bet)
Seat 6: joker180785 folded before Flop (didn't bet)
Seat 7: HopeMayBee folded before Flop (didn't bet)
Seat 9: Infinitinium collected ($1.95)





PokerStars Hand #154970611524:  Hold'em No Limit (£0.25/£0.50 GBP) - 2016/06/20 12:47:52 CET [2016/06/20 6:47:52 ET]
Table 'Ani' 6-max Seat #5 is the button
Seat 1: rewq99887788 (£39.16 in chips) 
Seat 2: mitsuVK (£51.40 in chips) 
Seat 3: Doobes8555 (£63.36 in chips) 
Seat 4: matiko09 (£62.11 in chips) 
Seat 5: Wwwasian (£57.68 in chips) 
Seat 6: faceMyBallz_ (£54.54 in chips) 
faceMyBallz_: posts small blind £0.25
rewq99887788: posts big blind £0.50
*** HOLE CARDS ***
Dealt to matiko09 [7h 3h]
mitsuVK: raises £1 to £1.50
Doobes8555: folds 
matiko09: folds 
Wwwasian: folds 
faceMyBallz_: folds 
rewq99887788: folds 
Uncalled bet (£1) returned to mitsuVK
mitsuVK collected £1.25 from pot
mitsuVK: doesn't show hand 
*** SUMMARY ***
Total pot £1.25 | Rake £0 
Seat 1: rewq99887788 (big blind) folded before Flop
Seat 2: mitsuVK collected (£1.25)
Seat 3: Doobes8555 folded before Flop (didn't bet)
Seat 4: matiko09 folded before Flop (didn't bet)
Seat 5: Wwwasian (button) folded before Flop (didn't bet)
Seat 6: faceMyBallz_ (small blind) folded before Flop





PokerStars Hand #154970613379:  Hold'em No Limit ($0.50/$1.00 USD) - 2016/06/20 12:47:57 CET [2016/06/20 6:47:57 ET]
Table 'Isonoe II' 9-max Seat #1 is the button
Seat 1: hammerwife ($104.86 in chips) 
Seat 2: matiko09 ($122.76 in chips) 
Seat 3: Kukuryzka ($100 in chips) 
Seat 4: Avtovo ($100 in chips) 
Seat 5: Filojoes ($100 in chips) 
Seat 6: GOOFA13 ($70.46 in chips) 
Seat 7: SkUhNi ($113.82 in chips) 
Seat 8: lewyson ($56.58 in chips) 
Seat 9: djammusic ($68.45 in chips) 
matiko09: posts small blind $0.50
Kukuryzka: posts big blind $1
*** HOLE CARDS ***
Dealt to matiko09 [5h 2s]
Avtovo: folds 
Filojoes: folds 
GOOFA13: folds 
SkUhNi: folds 
lewyson: raises $1 to $2
djammusic: folds 
hammerwife: folds 
matiko09: folds 
Kukuryzka: calls $1
*** FLOP *** [6d 3s 4c]
Kukuryzka: checks 
lewyson: bets $3
Kukuryzka: folds 
Uncalled bet ($3) returned to lewyson
lewyson collected $4.28 from pot
*** SUMMARY ***
Total pot $4.50 | Rake $0.22 
Board [6d 3s 4c]
Seat 1: hammerwife (button) folded before Flop (didn't bet)
Seat 2: matiko09 (small blind) folded before Flop
Seat 3: Kukuryzka (big blind) folded on the Flop
Seat 4: Avtovo folded before Flop (didn't bet)
Seat 5: Filojoes folded before Flop (didn't bet)
Seat 6: GOOFA13 folded before Flop (didn't bet)
Seat 7: SkUhNi folded before Flop (didn't bet)
Seat 8: lewyson collected ($4.28)
Seat 9: djammusic folded before Flop (didn't bet)





PokerStars Hand #154970613897:  Hold'em No Limit (£0.25/£0.50 GBP) - 2016/06/20 12:47:58 CET [2016/06/20 6:47:58 ET]
Table 'Tesla' 6-max Seat #1 is the button
Seat 1: Rubleff85 (£51.48 in chips) 
Seat 2: matiko09 (£65.27 in chips) 
Seat 3: asmodej666 (£58.34 in chips) 
Seat 4: ILIUXa (£50 in chips) 
Seat 5: Nego Razu (£50 in chips) 
Seat 6: faceMyBallz_ (£53.36 in chips) 
matiko09: posts small blind £0.25
asmodej666: posts big blind £0.50
*** HOLE CARDS ***
Dealt to matiko09 [7s 7c]
ILIUXa: folds 
Nego Razu: folds 
faceMyBallz_: folds 
Rubleff85: folds 
matiko09: raises £1 to £1.50
asmodej666: raises £3 to £4.50
matiko09: calls £3
*** FLOP *** [6h 4h Qs]
matiko09: checks 
asmodej666: bets £4.50
matiko09: calls £4.50
*** TURN *** [6h 4h Qs] [7h]
matiko09: checks 
asmodej666: checks 
*** RIVER *** [6h 4h Qs 7h] [Qd]
matiko09: bets £8.89
asmodej666: folds 
Uncalled bet (£8.89) returned to matiko09
matiko09 collected £17.10 from pot
matiko09: doesn't show hand 
*** SUMMARY ***
Total pot £18 | Rake £0.90 
Board [6h 4h Qs 7h Qd]
Seat 1: Rubleff85 (button) folded before Flop (didn't bet)
Seat 2: matiko09 (small blind) collected (£17.10)
Seat 3: asmodej666 (big blind) folded on the River
Seat 4: ILIUXa folded before Flop (didn't bet)
Seat 5: Nego Razu folded before Flop (didn't bet)
Seat 6: faceMyBallz_ folded before Flop (didn't bet)





PokerStars Hand #154970614106:  Hold'em No Limit ($0.50/$1.00 USD) - 2016/06/20 12:47:59 CET [2016/06/20 6:47:59 ET]
Table 'Anhui' 9-max Seat #1 is the button
Seat 1: SkUhNi ($154.42 in chips) 
Seat 2: ruslik_by ($265.18 in chips) 
Seat 3: hammerwife ($101.78 in chips) 
Seat 4: mavin80 ($65.95 in chips) 
Seat 5: mi$$I$Elena ($104.80 in chips) 
Seat 6: 23SmOkEr07 ($121.68 in chips) 
Seat 7: matiko09 ($130.18 in chips) 
Seat 8: blackmont111 ($69.50 in chips) 
Seat 9: TomBod1 ($86.03 in chips) 
ruslik_by: posts small blind $0.50
hammerwife: posts big blind $1
*** HOLE CARDS ***
Dealt to matiko09 [Th 9h]
mavin80: raises $1.50 to $2.50
mi$$I$Elena: folds 
23SmOkEr07: folds 
matiko09: folds 
blackmont111: folds 
TomBod1: folds 
SkUhNi: folds 
ruslik_by: folds 
hammerwife: calls $1.50
*** FLOP *** [2s 8c 5s]
hammerwife: checks 
mavin80: bets $2
hammerwife: raises $8 to $10
mavin80: raises $15 to $25
hammerwife: raises $74.28 to $99.28 and is all-in
mavin80: calls $38.45 and is all-in
Uncalled bet ($35.83) returned to hammerwife
*** TURN *** [2s 8c 5s] [3s]
*** RIVER *** [2s 8c 5s 3s] [As]
*** SHOW DOWN ***
hammerwife: shows [6s 7s] (a flush, Ace high)
mavin80: shows [Qd Qc] (a pair of Queens)
hammerwife collected $129.90 from pot
*** SUMMARY ***
Total pot $132.40 | Rake $2.50 
Board [2s 8c 5s 3s As]
Seat 1: SkUhNi (button) folded before Flop (didn't bet)
Seat 2: ruslik_by (small blind) folded before Flop
Seat 3: hammerwife (big blind) showed [6s 7s] and won ($129.90) with a flush, Ace high
Seat 4: mavin80 showed [Qd Qc] and lost with a pair of Queens
Seat 5: mi$$I$Elena folded before Flop (didn't bet)
Seat 6: 23SmOkEr07 folded before Flop (didn't bet)
Seat 7: matiko09 folded before Flop (didn't bet)
Seat 8: blackmont111 folded before Flop (didn't bet)
Seat 9: TomBod1 folded before Flop (didn't bet)





PokerStars Hand #154970616700:  Hold'em No Limit ($0.50/$1.00 USD) - 2016/06/20 12:48:05 CET [2016/06/20 6:48:05 ET]
Table 'Pongola' 9-max Seat #1 is the button
Seat 1: matiko09 ($100 in chips) 
Seat 2: ruslik_by ($129.77 in chips) 
Seat 3: SkUhNi ($114.72 in chips) 
Seat 4: karllv ($155.31 in chips) 
Seat 6: 23SmOkEr07 ($114.21 in chips) 
Seat 7: Dickyxxx ($149.62 in chips) 
Seat 8: phrantique ($100 in chips) 
Seat 9: Filojoes ($124.08 in chips) 
ruslik_by: posts small blind $0.50
SkUhNi: posts big blind $1
Avtovo: sits out 
*** HOLE CARDS ***
Dealt to matiko09 [5c 9h]
karllv: folds 
23SmOkEr07: folds 
Dickyxxx: folds 
phrantique: raises $2 to $3
Filojoes: folds 
matiko09: folds 
ruslik_by: folds 
SkUhNi: folds 
Uncalled bet ($2) returned to phrantique
phrantique collected $2.50 from pot
*** SUMMARY ***
Total pot $2.50 | Rake $0 
Seat 1: matiko09 (button) folded before Flop (didn't bet)
Seat 2: ruslik_by (small blind) folded before Flop
Seat 3: SkUhNi (big blind) folded before Flop
Seat 4: karllv folded before Flop (didn't bet)
Seat 6: 23SmOkEr07 folded before Flop (didn't bet)
Seat 7: Dickyxxx folded before Flop (didn't bet)
Seat 8: phrantique collected ($2.50)
Seat 9: Filojoes folded before Flop (didn't bet)





PokerStars Hand #154970617490:  Hold'em No Limit ($0.50/$1.00 USD) - 2016/06/20 12:48:07 CET [2016/06/20 6:48:07 ET]
Table 'Albiorix' 9-max Seat #5 is the button
Seat 2: SkUhNi ($115.64 in chips) 
Seat 3: matiko09 ($126.73 in chips) 
Seat 4: 23SmOkEr07 ($128.50 in chips) 
Seat 5: ruslik_by ($103 in chips) 
Seat 7: Pekyto ($49.65 in chips) 
Seat 8: smiley0221 ($58.88 in chips) 
Seat 9: Coolller ($190.29 in chips) 
Filojoes will be allowed to play after the button
Pekyto: posts small blind $0.50
smiley0221: posts big blind $1
*** HOLE CARDS ***
Dealt to matiko09 [Kd 9s]
Coolller: folds 
Coolller leaves the table
SkUhNi: raises $2 to $3
DomiVY joins the table at seat #9 
matiko09: folds 
23SmOkEr07: raises $6.50 to $9.50
ruslik_by: folds 
Pekyto: folds 
smiley0221: folds 
SkUhNi: calls $6.50
*** FLOP *** [Qs 7d 6c]
SkUhNi: checks 
23SmOkEr07: checks 
*** TURN *** [Qs 7d 6c] [4s]
SkUhNi: checks 
23SmOkEr07: checks 
*** RIVER *** [Qs 7d 6c 4s] [Ac]
SkUhNi: checks 
23SmOkEr07: checks 
*** SHOW DOWN ***
SkUhNi: shows [6d 6h] (three of a kind, Sixes)
23SmOkEr07: mucks hand 
SkUhNi collected $19.48 from pot
*** SUMMARY ***
Total pot $20.50 | Rake $1.02 
Board [Qs 7d 6c 4s Ac]
Seat 2: SkUhNi showed [6d 6h] and won ($19.48) with three of a kind, Sixes
Seat 3: matiko09 folded before Flop (didn't bet)
Seat 4: 23SmOkEr07 mucked [Td Ts]
Seat 5: ruslik_by (button) folded before Flop (didn't bet)
Seat 7: Pekyto (small blind) folded before Flop
Seat 8: smiley0221 (big blind) folded before Flop
Seat 9: Coolller folded before Flop (didn't bet)





PokerStars Hand #154970618126:  Hold'em No Limit (£0.25/£0.50 GBP) - 2016/06/20 12:48:09 CET [2016/06/20 6:48:09 ET]
Table 'Azalea' 6-max Seat #3 is the button
Seat 1: mitsuVK (£51.48 in chips) 
Seat 2: matiko09 (£81.24 in chips) 
Seat 3: tyoma_knp (£50 in chips) 
Seat 4: faceMyBallz_ (£102.18 in chips) 
Seat 5: mudders693 (£71.69 in chips) 
Seat 6: Bënedic10 (£54.98 in chips) 
faceMyBallz_: posts small blind £0.25
mudders693: posts big blind £0.50
*** HOLE CARDS ***
Dealt to matiko09 [7d 8h]
Bënedic10: folds 
mitsuVK: folds 
matiko09: folds 
tyoma_knp: raises £0.62 to £1.12
faceMyBallz_: raises £2.88 to £4
mudders693: calls £3.50
tyoma_knp: folds 
*** FLOP *** [3h 3c Kc]
faceMyBallz_: bets £4.33
mudders693: folds 
Uncalled bet (£4.33) returned to faceMyBallz_
faceMyBallz_ collected £8.66 from pot
faceMyBallz_: doesn't show hand 
*** SUMMARY ***
Total pot £9.12 | Rake £0.46 
Board [3h 3c Kc]
Seat 1: mitsuVK folded before Flop (didn't bet)
Seat 2: matiko09 folded before Flop (didn't bet)
Seat 3: tyoma_knp (button) folded before Flop
Seat 4: faceMyBallz_ (small blind) collected (£8.66)
Seat 5: mudders693 (big blind) folded on the Flop
Seat 6: Bënedic10 folded before Flop (didn't bet)





PokerStars Hand #154970619269:  Hold'em No Limit (£0.25/£0.50 GBP) - 2016/06/20 12:48:12 CET [2016/06/20 6:48:12 ET]
Table 'Ani' 6-max Seat #6 is the button
Seat 1: rewq99887788 (£38.66 in chips) 
Seat 2: mitsuVK (£52.15 in chips) 
Seat 3: Doobes8555 (£63.36 in chips) 
Seat 4: matiko09 (£62.11 in chips) 
Seat 5: Wwwasian (£57.68 in chips) 
Seat 6: faceMyBallz_ (£54.29 in chips) 
rewq99887788: posts small blind £0.25
mitsuVK: posts big blind £0.50
*** HOLE CARDS ***
Dealt to matiko09 [4h 6d]
Doobes8555: folds 
matiko09: folds 
Wwwasian: folds 
faceMyBallz_: folds 
rewq99887788: raises £0.50 to £1
mitsuVK: folds 
Uncalled bet (£0.50) returned to rewq99887788
rewq99887788 collected £1 from pot
*** SUMMARY ***
Total pot £1 | Rake £0 
Seat 1: rewq99887788 (small blind) collected (£1)
Seat 2: mitsuVK (big blind) folded before Flop
Seat 3: Doobes8555 folded before Flop (didn't bet)
Seat 4: matiko09 folded before Flop (didn't bet)
Seat 5: Wwwasian folded before Flop (didn't bet)
Seat 6: faceMyBallz_ (button) folded before Flop (didn't bet)





PokerStars Hand #154970619728:  Hold'em No Limit ($0.25/$0.50 USD) - 2016/06/20 12:48:13 CET [2016/06/20 6:48:13 ET]
Table 'Scheddi II' 9-max Seat #3 is the button
Seat 1: matiko09 ($96.30 in chips) 
Seat 2: Yaaaazz ($90 in chips) 
Seat 3: mi$$I$Elena ($94.95 in chips) 
Seat 4: GOOFA13 ($40.31 in chips) 
Seat 5: zarplatka ($40 in chips) 
Seat 7: HopeMayBee ($90.01 in chips) 
Seat 9: Infinitinium ($121.45 in chips) 
GOOFA13: posts small blind $0.25
zarplatka: posts big blind $0.50
matiko09: posts the ante $0.10
Yaaaazz: posts the ante $0.10
mi$$I$Elena: posts the ante $0.10
GOOFA13: posts the ante $0.10
zarplatka: posts the ante $0.10
HopeMayBee: posts the ante $0.10
Infinitinium: posts the ante $0.10
*** HOLE CARDS ***
Dealt to matiko09 [Qd 8s]
HopeMayBee: folds 
Infinitinium: folds 
orochimaturi joins the table at seat #6 
matiko09: folds 
Yaaaazz: folds 
mi$$I$Elena: raises $0.50 to $1
GOOFA13: folds 
zarplatka: folds 
Uncalled bet ($0.50) returned to mi$$I$Elena
mi$$I$Elena collected $1.95 from pot
mi$$I$Elena: doesn't show hand 
*** SUMMARY ***
Total pot $1.95 | Rake $0 
Seat 1: matiko09 folded before Flop (didn't bet)
Seat 2: Yaaaazz folded before Flop (didn't bet)
Seat 3: mi$$I$Elena (button) collected ($1.95)
Seat 4: GOOFA13 (small blind) folded before Flop
Seat 5: zarplatka (big blind) folded before Flop
Seat 7: HopeMayBee folded before Flop (didn't bet)
Seat 9: Infinitinium folded before Flop (didn't bet)





PokerStars Hand #154970620105:  Hold'em No Limit ($0.50/$1.00 USD) - 2016/06/20 12:48:14 CET [2016/06/20 6:48:14 ET]
Table 'Annika' 9-max Seat #8 is the button
Seat 1: hammerwife ($134.27 in chips) 
Seat 2: matiko09 ($106.80 in chips) 
Seat 3: first_dnk ($87.78 in chips) 
Seat 4: Kukuryzka ($107 in chips) 
Seat 5: SkUhNi ($123.63 in chips) 
Seat 6: Pvsx. ($102.55 in chips) 
Seat 8: ruslik_by ($104.90 in chips) 
Seat 9: 23SmOkEr07 ($117.65 in chips) 
23SmOkEr07: posts small blind $0.50
hammerwife: posts big blind $1
*** HOLE CARDS ***
Dealt to matiko09 [5c 7c]
matiko09: folds 
first_dnk: raises $1.40 to $2.40
Kukuryzka: folds 
SkUhNi: folds 
Pvsx.: folds 
ruslik_by: folds 
23SmOkEr07: folds 
hammerwife: folds 
Uncalled bet ($1.40) returned to first_dnk
first_dnk collected $2.50 from pot
first_dnk: doesn't show hand 
*** SUMMARY ***
Total pot $2.50 | Rake $0 
Seat 1: hammerwife (big blind) folded before Flop
Seat 2: matiko09 folded before Flop (didn't bet)
Seat 3: first_dnk collected ($2.50)
Seat 4: Kukuryzka folded before Flop (didn't bet)
Seat 5: SkUhNi folded before Flop (didn't bet)
Seat 6: Pvsx. folded before Flop (didn't bet)
Seat 8: ruslik_by (button) folded before Flop (didn't bet)
Seat 9: 23SmOkEr07 (small blind) folded before Flop





PokerStars Hand #154970623938:  Hold'em No Limit ($0.50/$1.00 USD) - 2016/06/20 12:48:24 CET [2016/06/20 6:48:24 ET]
Table 'Garumna II' 9-max Seat #8 is the button
Seat 1: ki11u ($103 in chips) 
Seat 3: mooose100 ($81.38 in chips) 
Seat 4: Ndundun Gipe ($82.50 in chips) 
Seat 5: rura53 ($78 in chips) 
Seat 6: SexyAngeline ($41.55 in chips) 
Seat 7: Avtovo ($100 in chips) 
Seat 8: matiko09 ($100 in chips) 
Seat 9: SkUhNi ($102.80 in chips) 
SkUhNi: posts small blind $0.50
ki11u: posts big blind $1
Racushniak: sits out 
*** HOLE CARDS ***
Dealt to matiko09 [4d 9s]
mooose100: folds 
Ndundun Gipe: folds 
rura53: folds 
SexyAngeline: raises $1.07 to $2.07
Avtovo: folds 
matiko09: folds 
SkUhNi: folds 
ki11u: calls $1.07
*** FLOP *** [8h 6s 4s]
ki11u: checks 
SexyAngeline: bets $2.95
ki11u: calls $2.95
*** TURN *** [8h 6s 4s] [Qs]
ki11u: checks 
SexyAngeline: bets $6.70
ki11u: calls $6.70
*** RIVER *** [8h 6s 4s Qs] [7s]
ki11u: checks 
SexyAngeline: bets $10.68
ki11u: folds 
Uncalled bet ($10.68) returned to SexyAngeline
SexyAngeline collected $22.74 from pot
SexyAngeline: doesn't show hand 
*** SUMMARY ***
Total pot $23.94 | Rake $1.20 
Board [8h 6s 4s Qs 7s]
Seat 1: ki11u (big blind) folded on the River
Seat 3: mooose100 folded before Flop (didn't bet)
Seat 4: Ndundun Gipe folded before Flop (didn't bet)
Seat 5: rura53 folded before Flop (didn't bet)
Seat 6: SexyAngeline collected ($22.74)
Seat 7: Avtovo folded before Flop (didn't bet)
Seat 8: matiko09 (button) folded before Flop (didn't bet)
Seat 9: SkUhNi (small blind) folded before Flop





PokerStars Hand #154970627954:  Hold'em No Limit ($0.50/$1.00 USD) - 2016/06/20 12:48:34 CET [2016/06/20 6:48:34 ET]
Table 'Ernestina' 9-max Seat #3 is the button
Seat 1: diva3150 ($139.62 in chips) 
Seat 2: matiko09 ($103.27 in chips) 
Seat 3: Pvsx. ($187.49 in chips) 
Seat 4: SkUhNi ($100 in chips) 
Seat 5: Dickyxxx ($148.11 in chips) 
Seat 8: ruslik_by ($263.74 in chips) 
Seat 9: 23SmOkEr07 ($106.40 in chips) 
SkUhNi: posts small blind $0.50
Dickyxxx: posts big blind $1
*** HOLE CARDS ***
Dealt to matiko09 [Jc 9d]
ruslik_by: folds 
23SmOkEr07: folds 
diva3150: folds 
matiko09: folds 
Pvsx.: folds 
SkUhNi: raises $1.50 to $2.50
Dickyxxx: raises $6.50 to $9
SkUhNi: folds 
Uncalled bet ($6.50) returned to Dickyxxx
Dickyxxx collected $5 from pot
Dickyxxx: doesn't show hand 
*** SUMMARY ***
Total pot $5 | Rake $0 
Seat 1: diva3150 folded before Flop (didn't bet)
Seat 2: matiko09 folded before Flop (didn't bet)
Seat 3: Pvsx. (button) folded before Flop (didn't bet)
Seat 4: SkUhNi (small blind) folded before Flop
Seat 5: Dickyxxx (big blind) collected ($5)
Seat 8: ruslik_by folded before Flop (didn't bet)
Seat 9: 23SmOkEr07 folded before Flop (didn't bet)





PokerStars Hand #154970629167:  Hold'em No Limit ($0.50/$1.00 USD) - 2016/06/20 12:48:37 CET [2016/06/20 6:48:37 ET]
Table 'Pongola' 9-max Seat #2 is the button
Seat 1: matiko09 ($100 in chips) 
Seat 2: ruslik_by ($129.27 in chips) 
Seat 3: SkUhNi ($113.72 in chips) 
Seat 4: karllv ($155.31 in chips) 
Seat 6: 23SmOkEr07 ($114.21 in chips) 
Seat 7: Dickyxxx ($149.62 in chips) 
Seat 8: phrantique ($101.50 in chips) 
Seat 9: Filojoes ($124.08 in chips) 
SkUhNi: posts small blind $0.50
karllv: posts big blind $1
Avtovo: sits out 
*** HOLE CARDS ***
Dealt to matiko09 [Ah 7s]
23SmOkEr07: folds 
Dickyxxx: folds 
phrantique: folds 
Filojoes: raises $2 to $3
matiko09: folds 
ruslik_by: folds 
SkUhNi: folds 
karllv: calls $2
*** FLOP *** [Qs Ts Jd]
karllv: checks 
Filojoes: bets $3.71
karllv: calls $3.71
*** TURN *** [Qs Ts Jd] [6c]
karllv: checks 
Filojoes: bets $7.93
karllv: folds 
Uncalled bet ($7.93) returned to Filojoes
Filojoes collected $13.22 from pot
Filojoes: doesn't show hand 
*** SUMMARY ***
Total pot $13.92 | Rake $0.70 
Board [Qs Ts Jd 6c]
Seat 1: matiko09 folded before Flop (didn't bet)
Seat 2: ruslik_by (button) folded before Flop (didn't bet)
Seat 3: SkUhNi (small blind) folded before Flop
Seat 4: karllv (big blind) folded on the Turn
Seat 6: 23SmOkEr07 folded before Flop (didn't bet)
Seat 7: Dickyxxx folded before Flop (didn't bet)
Seat 8: phrantique folded before Flop (didn't bet)
Seat 9: Filojoes collected ($13.22)





PokerStars Hand #154970630365:  Hold'em No Limit ($0.50/$1.00 USD) - 2016/06/20 12:48:40 CET [2016/06/20 6:48:40 ET]
Table 'Normannia' 9-max Seat #7 is the button
Seat 1: hammerwife ($124.72 in chips) 
Seat 2: Pvsx. ($190.62 in chips) 
Seat 3: Avtovo ($100 in chips) 
Seat 5: Dickyxxx ($120.19 in chips) 
Seat 6: typename27 ($54.61 in chips) 
Seat 7: matiko09 ($100 in chips) 
Seat 8: SkUhNi ($129.81 in chips) 
Seat 9: ruslik_by ($147.69 in chips) 
SkUhNi: posts small blind $0.50
ruslik_by: posts big blind $1
Filojoes: sits out 
*** HOLE CARDS ***
Dealt to matiko09 [3s 5h]
hammerwife: folds 
Pvsx.: folds 
Avtovo: folds 
Dickyxxx: raises $2 to $3
typename27: raises $5 to $8
matiko09: folds 
SkUhNi: folds 
ruslik_by: folds 
Dickyxxx: folds 
Uncalled bet ($5) returned to typename27
typename27 collected $7.50 from pot
*** SUMMARY ***
Total pot $7.50 | Rake $0 
Seat 1: hammerwife folded before Flop (didn't bet)
Seat 2: Pvsx. folded before Flop (didn't bet)
Seat 3: Avtovo folded before Flop (didn't bet)
Seat 5: Dickyxxx folded before Flop
Seat 6: typename27 collected ($7.50)
Seat 7: matiko09 (button) folded before Flop (didn't bet)
Seat 8: SkUhNi (small blind) folded before Flop
Seat 9: ruslik_by (big blind) folded before Flop





PokerStars Hand #154970631797:  Hold'em No Limit (£0.25/£0.50 GBP) - 2016/06/20 12:48:44 CET [2016/06/20 6:48:44 ET]
Table 'Ani' 6-max Seat #1 is the button
Seat 1: rewq99887788 (£39.16 in chips) 
Seat 2: mitsuVK (£51.65 in chips) 
Seat 3: Doobes8555 (£63.36 in chips) 
Seat 4: matiko09 (£62.11 in chips) 
Seat 5: Wwwasian (£57.68 in chips) 
Seat 6: faceMyBallz_ (£54.29 in chips) 
mitsuVK: posts small blind £0.25
Doobes8555: posts big blind £0.50
*** HOLE CARDS ***
Dealt to matiko09 [6s 6c]
matiko09: raises £1 to £1.50
Wwwasian: folds 
faceMyBallz_: folds 
rewq99887788: folds 
mitsuVK: calls £1.25
Doobes8555: calls £1
*** FLOP *** [7s 9h 7c]
mitsuVK: checks 
Doobes8555: bets £2
matiko09: folds 
mitsuVK: folds 
Uncalled bet (£2) returned to Doobes8555
Doobes8555 collected £4.28 from pot
Doobes8555: doesn't show hand 
*** SUMMARY ***
Total pot £4.50 | Rake £0.22 
Board [7s 9h 7c]
Seat 1: rewq99887788 (button) folded before Flop (didn't bet)
Seat 2: mitsuVK (small blind) folded on the Flop
Seat 3: Doobes8555 (big blind) collected (£4.28)
Seat 4: matiko09 folded on the Flop
Seat 5: Wwwasian folded before Flop (didn't bet)
Seat 6: faceMyBallz_ folded before Flop (didn't bet)





PokerStars Hand #154970633187:  Hold'em No Limit (£0.25/£0.50 GBP) - 2016/06/20 12:48:47 CET [2016/06/20 6:48:47 ET]
Table 'Azalea' 6-max Seat #4 is the button
Seat 1: mitsuVK (£51.48 in chips) 
Seat 2: matiko09 (£81.24 in chips) 
Seat 3: tyoma_knp (£50 in chips) 
Seat 4: faceMyBallz_ (£106.84 in chips) 
Seat 5: mudders693 (£67.69 in chips) 
Seat 6: Bënedic10 (£54.98 in chips) 
mudders693: posts small blind £0.25
Bënedic10: posts big blind £0.50
*** HOLE CARDS ***
Dealt to matiko09 [As 5h]
mitsuVK: folds 
matiko09: folds 
tyoma_knp: folds 
faceMyBallz_: raises £0.50 to £1
mudders693: calls £0.75
Bënedic10: calls £0.50
*** FLOP *** [8d Js Jc]
mudders693: bets £2.50
Bënedic10: calls £2.50
faceMyBallz_: folds 
*** TURN *** [8d Js Jc] [Td]
mudders693: bets £5
Bënedic10: calls £5
*** RIVER *** [8d Js Jc Td] [5d]
mudders693: bets £8
Bënedic10: calls £8
*** SHOW DOWN ***
mudders693: shows [Tc 9d] (two pair, Jacks and Tens)
Bënedic10: shows [Jd 9s] (three of a kind, Jacks)
Bënedic10 collected £32.60 from pot
*** SUMMARY ***
Total pot £34 | Rake £1.40 
Board [8d Js Jc Td 5d]
Seat 1: mitsuVK folded before Flop (didn't bet)
Seat 2: matiko09 folded before Flop (didn't bet)
Seat 3: tyoma_knp folded before Flop (didn't bet)
Seat 4: faceMyBallz_ (button) folded on the Flop
Seat 5: mudders693 (small blind) showed [Tc 9d] and lost with two pair, Jacks and Tens
Seat 6: Bënedic10 (big blind) showed [Jd 9s] and won (£32.60) with three of a kind, Jacks





PokerStars Hand #154970634393:  Hold'em No Limit ($0.25/$0.50 USD) - 2016/06/20 12:48:50 CET [2016/06/20 6:48:50 ET]
Table 'Scheddi II' 9-max Seat #4 is the button
Seat 1: matiko09 ($96.20 in chips) 
Seat 2: Yaaaazz ($89.90 in chips) 
Seat 3: mi$$I$Elena ($96.30 in chips) 
Seat 4: GOOFA13 ($39.96 in chips) 
Seat 5: zarplatka ($40 in chips) 
Seat 6: orochimaturi ($40 in chips) 
Seat 7: HopeMayBee ($89.91 in chips) 
Seat 9: Infinitinium ($121.35 in chips) 
zarplatka: posts small blind $0.25
orochimaturi: posts big blind $0.50
matiko09: posts the ante $0.10
Yaaaazz: posts the ante $0.10
mi$$I$Elena: posts the ante $0.10
GOOFA13: posts the ante $0.10
zarplatka: posts the ante $0.10
orochimaturi: posts the ante $0.10
HopeMayBee: posts the ante $0.10
Infinitinium: posts the ante $0.10
*** HOLE CARDS ***
Dealt to matiko09 [8h 4d]
HopeMayBee: raises $0.75 to $1.25
Infinitinium: calls $1.25
matiko09: folds 
Yaaaazz: folds 
mi$$I$Elena: folds 
GOOFA13: folds 
zarplatka: folds 
orochimaturi: calls $0.75
*** FLOP *** [9d 5d 5c]
orochimaturi: checks 
HopeMayBee: checks 
Infinitinium: checks 
*** TURN *** [9d 5d 5c] [8c]
orochimaturi: checks 
HopeMayBee: checks 
Infinitinium: checks 
*** RIVER *** [9d 5d 5c 8c] [Jd]
orochimaturi: checks 
HopeMayBee: checks 
Infinitinium: bets $4.56
orochimaturi: folds 
HopeMayBee: folds 
Uncalled bet ($4.56) returned to Infinitinium
Infinitinium collected $4.56 from pot
Infinitinium: doesn't show hand 
*** SUMMARY ***
Total pot $4.80 | Rake $0.24 
Board [9d 5d 5c 8c Jd]
Seat 1: matiko09 folded before Flop (didn't bet)
Seat 2: Yaaaazz folded before Flop (didn't bet)
Seat 3: mi$$I$Elena folded before Flop (didn't bet)
Seat 4: GOOFA13 (button) folded before Flop (didn't bet)
Seat 5: zarplatka (small blind) folded before Flop
Seat 6: orochimaturi (big blind) folded on the River
Seat 7: HopeMayBee folded on the River
Seat 9: Infinitinium collected ($4.56)





PokerStars Hand #154970636449:  Hold'em No Limit ($0.50/$1.00 USD) - 2016/06/20 12:48:55 CET [2016/06/20 6:48:55 ET]
Table 'Ernestina' 9-max Seat #4 is the button
Seat 1: diva3150 ($139.62 in chips) 
Seat 2: matiko09 ($103.27 in chips) 
Seat 3: Pvsx. ($187.49 in chips) 
Seat 4: SkUhNi ($100 in chips) 
Seat 5: Dickyxxx ($150.61 in chips) 
Seat 8: ruslik_by ($263.74 in chips) 
Seat 9: 23SmOkEr07 ($106.40 in chips) 
Dickyxxx: posts small blind $0.50
ruslik_by: posts big blind $1
*** HOLE CARDS ***
Dealt to matiko09 [9h Ah]
23SmOkEr07: folds 
diva3150: folds 
matiko09: raises $2 to $3
Pvsx.: folds 
SkUhNi: folds 
Dickyxxx: folds 
ruslik_by: calls $2
*** FLOP *** [9d 5d 4c]
ruslik_by: checks 
matiko09: bets $4.02
ruslik_by: raises $7.11 to $11.13
matiko09: calls $7.11
*** TURN *** [9d 5d 4c] [4h]
ruslik_by: bets $9.28
matiko09: calls $9.28
*** RIVER *** [9d 5d 4c 4h] [2s]
ruslik_by: checks 
matiko09: checks 
*** SHOW DOWN ***
ruslik_by: shows [Ad Th] (a pair of Fours)
matiko09: shows [9h Ah] (two pair, Nines and Fours)
matiko09 collected $44.95 from pot
*** SUMMARY ***
Total pot $47.32 | Rake $2.37 
Board [9d 5d 4c 4h 2s]
Seat 1: diva3150 folded before Flop (didn't bet)
Seat 2: matiko09 showed [9h Ah] and won ($44.95) with two pair, Nines and Fours
Seat 3: Pvsx. folded before Flop (didn't bet)
Seat 4: SkUhNi (button) folded before Flop (didn't bet)
Seat 5: Dickyxxx (small blind) folded before Flop
Seat 8: ruslik_by (big blind) showed [Ad Th] and lost with a pair of Fours
Seat 9: 23SmOkEr07 folded before Flop (didn't bet)





PokerStars Hand #154970637615:  Hold'em No Limit ($0.50/$1.00 USD) - 2016/06/20 12:48:59 CET [2016/06/20 6:48:59 ET]
Table 'Isonoe II' 9-max Seat #2 is the button
Seat 1: hammerwife ($104.86 in chips) 
Seat 2: matiko09 ($122.26 in chips) 
Seat 3: Kukuryzka ($100 in chips) 
Seat 4: Avtovo ($100 in chips) 
Seat 5: Filojoes ($100 in chips) 
Seat 6: GOOFA13 ($70.46 in chips) 
Seat 7: SkUhNi ($113.82 in chips) 
Seat 8: lewyson ($58.86 in chips) 
Seat 9: djammusic ($68.45 in chips) 
Kukuryzka: posts small blind $0.50
Avtovo: posts big blind $1
*** HOLE CARDS ***
Dealt to matiko09 [Qc 3h]
Filojoes: folds 
GOOFA13: folds 
SkUhNi: folds 
lewyson: folds 
djammusic: folds 
hammerwife: folds 
matiko09: folds 
Kukuryzka: folds 
Uncalled bet ($0.50) returned to Avtovo
Avtovo collected $1 from pot
Avtovo: doesn't show hand 
*** SUMMARY ***
Total pot $1 | Rake $0 
Seat 1: hammerwife folded before Flop (didn't bet)
Seat 2: matiko09 (button) folded before Flop (didn't bet)
Seat 3: Kukuryzka (small blind) folded before Flop
Seat 4: Avtovo (big blind) collected ($1)
Seat 5: Filojoes folded before Flop (didn't bet)
Seat 6: GOOFA13 folded before Flop (didn't bet)
Seat 7: SkUhNi folded before Flop (didn't bet)
Seat 8: lewyson folded before Flop (didn't bet)
Seat 9: djammusic folded before Flop (didn't bet)





PokerStars Hand #154970638393:  Hold'em No Limit ($0.50/$1.00 USD) - 2016/06/20 12:49:00 CET [2016/06/20 6:49:00 ET]
Table 'Annika' 9-max Seat #9 is the button
Seat 1: hammerwife ($133.27 in chips) 
Seat 2: matiko09 ($106.80 in chips) 
Seat 3: first_dnk ($89.28 in chips) 
Seat 4: Kukuryzka ($107 in chips) 
Seat 5: SkUhNi ($123.63 in chips) 
Seat 6: Pvsx. ($102.55 in chips) 
Seat 8: ruslik_by ($104.90 in chips) 
Seat 9: 23SmOkEr07 ($117.15 in chips) 
hammerwife: posts small blind $0.50
matiko09: posts big blind $1
*** HOLE CARDS ***
Dealt to matiko09 [7c Kc]
first_dnk: folds 
Kukuryzka: folds 
SkUhNi: folds 
Pvsx.: folds 
ruslik_by: folds 
23SmOkEr07: raises $1.50 to $2.50
hammerwife: raises $6 to $8.50
matiko09: folds 
23SmOkEr07: calls $6
*** FLOP *** [5d 3h 8c]
hammerwife: bets $6.50
23SmOkEr07: calls $6.50
*** TURN *** [5d 3h 8c] [2s]
hammerwife: checks 
23SmOkEr07: bets $12.50
hammerwife: calls $12.50
*** RIVER *** [5d 3h 8c 2s] [8s]
hammerwife: checks 
23SmOkEr07: bets $53.50
hammerwife: folds 
Uncalled bet ($53.50) returned to 23SmOkEr07
23SmOkEr07 collected $53.50 from pot
23SmOkEr07: doesn't show hand 
*** SUMMARY ***
Total pot $56 | Rake $2.50 
Board [5d 3h 8c 2s 8s]
Seat 1: hammerwife (small blind) folded on the River
Seat 2: matiko09 (big blind) folded before Flop
Seat 3: first_dnk folded before Flop (didn't bet)
Seat 4: Kukuryzka folded before Flop (didn't bet)
Seat 5: SkUhNi folded before Flop (didn't bet)
Seat 6: Pvsx. folded before Flop (didn't bet)
Seat 8: ruslik_by folded before Flop (didn't bet)
Seat 9: 23SmOkEr07 (button) collected ($53.50)





PokerStars Hand #154970643586:  Hold'em No Limit ($0.50/$1.00 USD) - 2016/06/20 12:49:14 CET [2016/06/20 6:49:14 ET]
Table 'Ambrosia II' 9-max Seat #8 is the button
Seat 1: 23SmOkEr07 ($174.75 in chips) 
Seat 2: Eyeballz1307 ($19.84 in chips) 
Seat 3: mavin80 ($115.45 in chips) 
Seat 4: mi$$I$Elena ($197.27 in chips) 
Seat 5: Mattulh ($100 in chips) 
Seat 6: ruslik_by ($106.30 in chips) 
Seat 7: matiko09 ($100 in chips) 
Seat 8: hammerwife ($119.45 in chips) 
Seat 9: SkUhNi ($130.76 in chips) 
SkUhNi: posts small blind $0.50
23SmOkEr07: posts big blind $1
*** HOLE CARDS ***
Dealt to matiko09 [7h 4c]
Eyeballz1307: raises $3 to $4
mavin80: folds 
mi$$I$Elena: folds 
Mattulh: folds 
ruslik_by: folds 
matiko09: folds 
hammerwife: folds 
SkUhNi: folds 
23SmOkEr07: calls $3
*** FLOP *** [3c 7s Qc]
23SmOkEr07: checks 
Eyeballz1307: bets $2
23SmOkEr07: folds 
Uncalled bet ($2) returned to Eyeballz1307
Eyeballz1307 collected $8.08 from pot
Eyeballz1307: doesn't show hand 
*** SUMMARY ***
Total pot $8.50 | Rake $0.42 
Board [3c 7s Qc]
Seat 1: 23SmOkEr07 (big blind) folded on the Flop
Seat 2: Eyeballz1307 collected ($8.08)
Seat 3: mavin80 folded before Flop (didn't bet)
Seat 4: mi$$I$Elena folded before Flop (didn't bet)
Seat 5: Mattulh folded before Flop (didn't bet)
Seat 6: ruslik_by folded before Flop (didn't bet)
Seat 7: matiko09 folded before Flop (didn't bet)
Seat 8: hammerwife (button) folded before Flop (didn't bet)
Seat 9: SkUhNi (small blind) folded before Flop





PokerStars Hand #154970646638:  Hold'em No Limit (£0.25/£0.50 GBP) - 2016/06/20 12:49:21 CET [2016/06/20 6:49:21 ET]
Table 'Ani' 6-max Seat #2 is the button
Seat 1: rewq99887788 (£39.16 in chips) 
Seat 2: mitsuVK (£50.15 in chips) 
Seat 3: Doobes8555 (£66.14 in chips) 
Seat 4: matiko09 (£60.61 in chips) 
Seat 5: Wwwasian (£57.68 in chips) 
Seat 6: faceMyBallz_ (£54.29 in chips) 
Doobes8555: posts small blind £0.25
matiko09: posts big blind £0.50
*** HOLE CARDS ***
Dealt to matiko09 [7h Ad]
Wwwasian: folds 
faceMyBallz_: folds 
rewq99887788: raises £1 to £1.50
mitsuVK: calls £1.50
Doobes8555: folds 
matiko09: folds 
*** FLOP *** [9c 2s Jh]
rewq99887788: bets £1.50
mitsuVK: calls £1.50
*** TURN *** [9c 2s Jh] [5h]
rewq99887788: bets £3.50
mitsuVK: calls £3.50
*** RIVER *** [9c 2s Jh 5h] [Ts]
rewq99887788: bets £2.50
mitsuVK: raises £8.50 to £11
rewq99887788: calls £8.50
*** SHOW DOWN ***
mitsuVK: shows [2d 2c] (three of a kind, Deuces)
rewq99887788: mucks hand 
mitsuVK collected £34.35 from pot
*** SUMMARY ***
Total pot £35.75 | Rake £1.40 
Board [9c 2s Jh 5h Ts]
Seat 1: rewq99887788 mucked [Jd As]
Seat 2: mitsuVK (button) showed [2d 2c] and won (£34.35) with three of a kind, Deuces
Seat 3: Doobes8555 (small blind) folded before Flop
Seat 4: matiko09 (big blind) folded before Flop
Seat 5: Wwwasian folded before Flop (didn't bet)
Seat 6: faceMyBallz_ folded before Flop (didn't bet)





PokerStars Hand #154970649583:  Hold'em No Limit ($0.50/$1.00 USD) - 2016/06/20 12:49:29 CET [2016/06/20 6:49:29 ET]
Table 'Albiorix' 9-max Seat #7 is the button
Seat 2: SkUhNi ($125.62 in chips) 
Seat 3: matiko09 ($126.73 in chips) 
Seat 4: 23SmOkEr07 ($119 in chips) 
Seat 5: ruslik_by ($103 in chips) 
Seat 7: Pekyto ($49.15 in chips) 
Seat 8: smiley0221 ($57.88 in chips) 
Seat 9: DomiVY ($40 in chips) 
smiley0221: posts small blind $0.50
DomiVY: posts big blind $1
Filojoes: sits out 
*** HOLE CARDS ***
Dealt to matiko09 [8c Ts]
SkUhNi: raises $2 to $3
matiko09: folds 
23SmOkEr07: folds 
ruslik_by: folds 
Pekyto: folds 
smiley0221: calls $2.50
DomiVY: folds 
*** FLOP *** [5s 7s Tc]
smiley0221: bets $4
SkUhNi: calls $4
*** TURN *** [5s 7s Tc] [3s]
smiley0221: bets $8
SkUhNi: folds 
Uncalled bet ($8) returned to smiley0221
smiley0221 collected $14.25 from pot
smiley0221: doesn't show hand 
*** SUMMARY ***
Total pot $15 | Rake $0.75 
Board [5s 7s Tc 3s]
Seat 2: SkUhNi folded on the Turn
Seat 3: matiko09 folded before Flop (didn't bet)
Seat 4: 23SmOkEr07 folded before Flop (didn't bet)
Seat 5: ruslik_by folded before Flop (didn't bet)
Seat 7: Pekyto (button) folded before Flop (didn't bet)
Seat 8: smiley0221 (small blind) collected ($14.25)
Seat 9: DomiVY (big blind) folded before Flop





PokerStars Hand #154970651035:  Hold'em No Limit ($0.50/$1.00 USD) - 2016/06/20 12:49:33 CET [2016/06/20 6:49:33 ET]
Table 'Isonoe II' 9-max Seat #3 is the button
Seat 1: hammerwife ($104.86 in chips) 
Seat 2: matiko09 ($122.26 in chips) 
Seat 3: Kukuryzka ($99.50 in chips) 
Seat 4: Avtovo ($100.50 in chips) 
Seat 5: Filojoes ($100 in chips) 
Seat 6: GOOFA13 ($70.46 in chips) 
Seat 7: SkUhNi ($113.82 in chips) 
Seat 8: lewyson ($58.86 in chips) 
Seat 9: djammusic ($68.45 in chips) 
Avtovo: posts small blind $0.50
Filojoes: posts big blind $1
*** HOLE CARDS ***
Dealt to matiko09 [6c 9c]
GOOFA13: folds 
SkUhNi: folds 
lewyson: folds 
djammusic: folds 
hammerwife: folds 
matiko09: folds 
Kukuryzka: raises $1 to $2
Avtovo: raises $6 to $8
Filojoes: folds 
Kukuryzka: folds 
Uncalled bet ($6) returned to Avtovo
Avtovo collected $5 from pot
Avtovo: doesn't show hand 
*** SUMMARY ***
Total pot $5 | Rake $0 
Seat 1: hammerwife folded before Flop (didn't bet)
Seat 2: matiko09 folded before Flop (didn't bet)
Seat 3: Kukuryzka (button) folded before Flop
Seat 4: Avtovo (small blind) collected ($5)
Seat 5: Filojoes (big blind) folded before Flop
Seat 6: GOOFA13 folded before Flop (didn't bet)
Seat 7: SkUhNi folded before Flop (didn't bet)
Seat 8: lewyson folded before Flop (didn't bet)
Seat 9: djammusic folded before Flop (didn't bet)





PokerStars Hand #154970652904:  Hold'em No Limit (£0.25/£0.50 GBP) - 2016/06/20 12:49:37 CET [2016/06/20 6:49:37 ET]
Table 'Tesla' 6-max Seat #2 is the button
Seat 1: Rubleff85 (£51.48 in chips) 
Seat 2: matiko09 (£73.37 in chips) 
Seat 3: asmodej666 (£50 in chips) 
Seat 5: Nego Razu (£50 in chips) 
Seat 6: faceMyBallz_ (£53.36 in chips) 
asmodej666: posts small blind £0.25
ILIUXa: is sitting out 
ILIUXa leaves the table
Nego Razu: posts big blind £0.50
*** HOLE CARDS ***
Dealt to matiko09 [Jd 5c]
faceMyBallz_: folds 
Rubleff85: calls £0.50
VahTang_89 joins the table at seat #4 
matiko09: folds 
asmodej666: calls £0.25
Nego Razu: checks 
*** FLOP *** [5h 7h 7d]
asmodej666: checks 
Nego Razu: checks 
Rubleff85: bets £0.50
asmodej666: folds 
Nego Razu: folds 
Uncalled bet (£0.50) returned to Rubleff85
Rubleff85 collected £1.42 from pot
Rubleff85: doesn't show hand 
*** SUMMARY ***
Total pot £1.50 | Rake £0.08 
Board [5h 7h 7d]
Seat 1: Rubleff85 collected (£1.42)
Seat 2: matiko09 (button) folded before Flop (didn't bet)
Seat 3: asmodej666 (small blind) folded on the Flop
Seat 5: Nego Razu (big blind) folded on the Flop
Seat 6: faceMyBallz_ folded before Flop (didn't bet)





PokerStars Hand #154970653383:  Hold'em No Limit ($0.50/$1.00 USD) - 2016/06/20 12:49:38 CET [2016/06/20 6:49:38 ET]
Table 'Garumna II' 9-max Seat #9 is the button
Seat 1: ki11u ($100 in chips) 
Seat 2: Racushniak ($100 in chips) 
Seat 3: mooose100 ($81.38 in chips) 
Seat 4: Ndundun Gipe ($82.50 in chips) 
Seat 5: rura53 ($78 in chips) 
Seat 6: SexyAngeline ($52.57 in chips) 
Seat 7: Avtovo ($100 in chips) 
Seat 8: matiko09 ($100 in chips) 
Seat 9: SkUhNi ($102.30 in chips) 
ki11u: posts small blind $0.50
Racushniak: posts big blind $1
*** HOLE CARDS ***
Dealt to matiko09 [Ad 7h]
mooose100: folds 
Ndundun Gipe: calls $1
rura53: folds 
SexyAngeline: folds 
Avtovo: folds 
matiko09: raises $3 to $4
SkUhNi: folds 
ki11u: folds 
Racushniak: folds 
Ndundun Gipe: calls $3
*** FLOP *** [Kc 8s 2h]
Ndundun Gipe: checks 
matiko09: checks 
*** TURN *** [Kc 8s 2h] [4h]
Ndundun Gipe: bets $1
matiko09: calls $1
*** RIVER *** [Kc 8s 2h 4h] [Ac]
Ndundun Gipe: checks 
matiko09: bets $4
Ndundun Gipe: calls $4
*** SHOW DOWN ***
matiko09: shows [Ad 7h] (a pair of Aces)
Ndundun Gipe: mucks hand 
matiko09 collected $18.52 from pot
*** SUMMARY ***
Total pot $19.50 | Rake $0.98 
Board [Kc 8s 2h 4h Ac]
Seat 1: ki11u (small blind) folded before Flop
Seat 2: Racushniak (big blind) folded before Flop
Seat 3: mooose100 folded before Flop (didn't bet)
Seat 4: Ndundun Gipe mucked [3s Kh]
Seat 5: rura53 folded before Flop (didn't bet)
Seat 6: SexyAngeline folded before Flop (didn't bet)
Seat 7: Avtovo folded before Flop (didn't bet)
Seat 8: matiko09 showed [Ad 7h] and won ($18.52) with a pair of Aces
Seat 9: SkUhNi (button) folded before Flop (didn't bet)





PokerStars Hand #154970654186:  Hold'em No Limit ($0.25/$0.50 USD) - 2016/06/20 12:49:40 CET [2016/06/20 6:49:40 ET]
Table 'Scheddi II' 9-max Seat #5 is the button
Seat 1: matiko09 ($96.10 in chips) 
Seat 2: Yaaaazz ($89.80 in chips) 
Seat 3: mi$$I$Elena ($96.20 in chips) 
Seat 4: GOOFA13 ($39.86 in chips) 
Seat 5: zarplatka ($40 in chips) 
Seat 6: orochimaturi ($38.65 in chips) 
Seat 7: HopeMayBee ($88.56 in chips) 
Seat 9: Infinitinium ($124.56 in chips) 
orochimaturi: posts small blind $0.25
HopeMayBee: posts big blind $0.50
matiko09: posts the ante $0.10
Yaaaazz: posts the ante $0.10
mi$$I$Elena: posts the ante $0.10
GOOFA13: posts the ante $0.10
zarplatka: posts the ante $0.10
orochimaturi: posts the ante $0.10
HopeMayBee: posts the ante $0.10
Infinitinium: posts the ante $0.10
*** HOLE CARDS ***
Dealt to matiko09 [6s 6d]
Infinitinium: folds 
matiko09: raises $1 to $1.50
Yaaaazz: folds 
mi$$I$Elena: folds 
GOOFA13: calls $1.50
zarplatka: folds 
orochimaturi: raises $2.50 to $4
HopeMayBee: folds 
matiko09: folds 
GOOFA13: calls $2.50
*** FLOP *** [Qh 5s 7s]
orochimaturi: bets $5
GOOFA13: raises $30.76 to $35.76 and is all-in
Danil27 joins the table at seat #8 
orochimaturi has timed out
orochimaturi: folds 
Uncalled bet ($30.76) returned to GOOFA13
GOOFA13 collected $19.76 from pot
GOOFA13: doesn't show hand 
*** SUMMARY ***
Total pot $20.80 | Rake $1.04 
Board [Qh 5s 7s]
Seat 1: matiko09 folded before Flop
Seat 2: Yaaaazz folded before Flop (didn't bet)
Seat 3: mi$$I$Elena folded before Flop (didn't bet)
Seat 4: GOOFA13 collected ($19.76)
Seat 5: zarplatka (button) folded before Flop (didn't bet)
Seat 6: orochimaturi (small blind) folded on the Flop
Seat 7: HopeMayBee (big blind) folded before Flop
Seat 9: Infinitinium folded before Flop (didn't bet)





PokerStars Hand #154970654420:  Hold'em No Limit (£0.25/£0.50 GBP) - 2016/06/20 12:49:41 CET [2016/06/20 6:49:41 ET]
Table 'Azalea' 6-max Seat #5 is the button
Seat 1: mitsuVK (£51.48 in chips) 
Seat 2: matiko09 (£81.24 in chips) 
Seat 3: tyoma_knp (£50 in chips) 
Seat 4: faceMyBallz_ (£105.84 in chips) 
Seat 5: mudders693 (£51.19 in chips) 
Seat 6: Bënedic10 (£71.08 in chips) 
Bënedic10: posts small blind £0.25
mitsuVK: posts big blind £0.50
*** HOLE CARDS ***
Dealt to matiko09 [7d 6s]
matiko09: folds 
tyoma_knp: folds 
faceMyBallz_: folds 
mudders693: raises £1 to £1.50
Bënedic10: folds 
mitsuVK: folds 
Uncalled bet (£1) returned to mudders693
mudders693 collected £1.25 from pot
mudders693: doesn't show hand 
*** SUMMARY ***
Total pot £1.25 | Rake £0 
Seat 1: mitsuVK (big blind) folded before Flop
Seat 2: matiko09 folded before Flop (didn't bet)
Seat 3: tyoma_knp folded before Flop (didn't bet)
Seat 4: faceMyBallz_ folded before Flop (didn't bet)
Seat 5: mudders693 (button) collected (£1.25)
Seat 6: Bënedic10 (small blind) folded before Flop





PokerStars Hand #154970654208:  Hold'em No Limit ($0.50/$1.00 USD) - 2016/06/20 12:49:41 CET [2016/06/20 6:49:41 ET]
Table 'Pongola' 9-max Seat #3 is the button
Seat 1: matiko09 ($100 in chips) 
Seat 2: ruslik_by ($129.27 in chips) 
Seat 3: SkUhNi ($113.22 in chips) 
Seat 4: karllv ($148.60 in chips) 
Seat 5: Avtovo ($100 in chips) 
Seat 6: 23SmOkEr07 ($114.21 in chips) 
Seat 7: Dickyxxx ($149.62 in chips) 
Seat 8: phrantique ($101.50 in chips) 
Seat 9: Filojoes ($130.59 in chips) 
karllv: posts small blind $0.50
Avtovo: posts big blind $1
*** HOLE CARDS ***
Dealt to matiko09 [7h Kc]
23SmOkEr07: raises $1.50 to $2.50
Dickyxxx: folds 
phrantique: folds 
Filojoes: folds 
matiko09: folds 
ruslik_by: folds 
SkUhNi: folds 
karllv: calls $2
Avtovo: folds 
*** FLOP *** [Js Ah Jc]
karllv: checks 
23SmOkEr07: bets $3.19
karllv: calls $3.19
*** TURN *** [Js Ah Jc] [Tc]
karllv: checks 
23SmOkEr07: checks 
*** RIVER *** [Js Ah Jc Tc] [Kd]
karllv: checks 
23SmOkEr07: bets $6.58
karllv: calls $6.58
*** SHOW DOWN ***
23SmOkEr07: shows [Ac Ks] (two pair, Aces and Kings)
karllv: mucks hand 
23SmOkEr07 collected $24.26 from pot
*** SUMMARY ***
Total pot $25.54 | Rake $1.28 
Board [Js Ah Jc Tc Kd]
Seat 1: matiko09 folded before Flop (didn't bet)
Seat 2: ruslik_by folded before Flop (didn't bet)
Seat 3: SkUhNi (button) folded before Flop (didn't bet)
Seat 4: karllv (small blind) mucked [5s As]
Seat 5: Avtovo (big blind) folded before Flop
Seat 6: 23SmOkEr07 showed [Ac Ks] and won ($24.26) with two pair, Aces and Kings
Seat 7: Dickyxxx folded before Flop (didn't bet)
Seat 8: phrantique folded before Flop (didn't bet)
Seat 9: Filojoes folded before Flop (didn't bet)





PokerStars Hand #154970655995:  Hold'em No Limit ($0.50/$1.00 USD) - 2016/06/20 12:49:45 CET [2016/06/20 6:49:45 ET]
Table 'Normannia' 9-max Seat #8 is the button
Seat 1: hammerwife ($124.72 in chips) 
Seat 2: Pvsx. ($190.62 in chips) 
Seat 3: Avtovo ($100 in chips) 
Seat 5: Dickyxxx ($117.19 in chips) 
Seat 6: typename27 ($59.11 in chips) 
Seat 7: matiko09 ($100 in chips) 
Seat 8: SkUhNi ($129.31 in chips) 
Seat 9: ruslik_by ($146.69 in chips) 
ruslik_by: posts small blind $0.50
hammerwife: posts big blind $1
Filojoes: sits out 
*** HOLE CARDS ***
Dealt to matiko09 [8h Ts]
Pvsx.: folds 
Avtovo: folds 
Dickyxxx: folds 
typename27: raises $4 to $5
matiko09: folds 
SkUhNi: folds 
ruslik_by: folds 
hammerwife: folds 
Uncalled bet ($4) returned to typename27
typename27 collected $2.50 from pot
typename27: doesn't show hand 
*** SUMMARY ***
Total pot $2.50 | Rake $0 
Seat 1: hammerwife (big blind) folded before Flop
Seat 2: Pvsx. folded before Flop (didn't bet)
Seat 3: Avtovo folded before Flop (didn't bet)
Seat 5: Dickyxxx folded before Flop (didn't bet)
Seat 6: typename27 collected ($2.50)
Seat 7: matiko09 folded before Flop (didn't bet)
Seat 8: SkUhNi (button) folded before Flop (didn't bet)
Seat 9: ruslik_by (small blind) folded before Flop





PokerStars Hand #154970658873:  Hold'em No Limit ($0.50/$1.00 USD) - 2016/06/20 12:49:52 CET [2016/06/20 6:49:52 ET]
Table 'Anhui' 9-max Seat #2 is the button
Seat 1: SkUhNi ($154.42 in chips) 
Seat 2: ruslik_by ($264.68 in chips) 
Seat 3: hammerwife ($165.73 in chips) 
Seat 5: mi$$I$Elena ($104.80 in chips) 
Seat 6: 23SmOkEr07 ($121.68 in chips) 
Seat 7: matiko09 ($130.18 in chips) 
Seat 8: blackmont111 ($69.50 in chips) 
Seat 9: TomBod1 ($86.03 in chips) 
hammerwife: posts small blind $0.50
mi$$I$Elena: posts big blind $1
*** HOLE CARDS ***
Dealt to matiko09 [9d 9h]
23SmOkEr07: folds 
matiko09: raises $2 to $3
blackmont111: folds 
TomBod1: folds 
SkUhNi: calls $3
ruslik_by: folds 
hammerwife: folds 
mi$$I$Elena: folds 
*** FLOP *** [3d As 4d]
matiko09: bets $3.70
SkUhNi: calls $3.70
*** TURN *** [3d As 4d] [6s]
matiko09: checks 
SkUhNi: bets $5
matiko09: folds 
Uncalled bet ($5) returned to SkUhNi
SkUhNi collected $14.16 from pot
SkUhNi: doesn't show hand 
*** SUMMARY ***
Total pot $14.90 | Rake $0.74 
Board [3d As 4d 6s]
Seat 1: SkUhNi collected ($14.16)
Seat 2: ruslik_by (button) folded before Flop (didn't bet)
Seat 3: hammerwife (small blind) folded before Flop
Seat 5: mi$$I$Elena (big blind) folded before Flop
Seat 6: 23SmOkEr07 folded before Flop (didn't bet)
Seat 7: matiko09 folded on the Turn
Seat 8: blackmont111 folded before Flop (didn't bet)
Seat 9: TomBod1 folded before Flop (didn't bet)





PokerStars Hand #154970661885:  Hold'em No Limit ($0.50/$1.00 USD) - 2016/06/20 12:50:00 CET [2016/06/20 6:50:00 ET]
Table 'Ambrosia II' 9-max Seat #9 is the button
Seat 1: 23SmOkEr07 ($170.75 in chips) 
Seat 2: Eyeballz1307 ($23.92 in chips) 
Seat 3: mavin80 ($115.45 in chips) 
Seat 4: mi$$I$Elena ($197.27 in chips) 
Seat 5: Mattulh ($100 in chips) 
Seat 6: ruslik_by ($106.30 in chips) 
Seat 7: matiko09 ($100 in chips) 
Seat 8: hammerwife ($119.45 in chips) 
Seat 9: SkUhNi ($130.26 in chips) 
23SmOkEr07: posts small blind $0.50
Eyeballz1307: posts big blind $1
*** HOLE CARDS ***
Dealt to matiko09 [5c 9d]
mavin80: raises $1.50 to $2.50
mi$$I$Elena: folds 
Mattulh: calls $2.50
ruslik_by: folds 
matiko09: folds 
hammerwife: folds 
SkUhNi: raises $8.50 to $11
23SmOkEr07: folds 
Eyeballz1307: folds 
mavin80: folds 
Mattulh: folds 
Uncalled bet ($8.50) returned to SkUhNi
SkUhNi collected $9 from pot
SkUhNi: doesn't show hand 
*** SUMMARY ***
Total pot $9 | Rake $0 
Seat 1: 23SmOkEr07 (small blind) folded before Flop
Seat 2: Eyeballz1307 (big blind) folded before Flop
Seat 3: mavin80 folded before Flop
Seat 4: mi$$I$Elena folded before Flop (didn't bet)
Seat 5: Mattulh folded before Flop
Seat 6: ruslik_by folded before Flop (didn't bet)
Seat 7: matiko09 folded before Flop (didn't bet)
Seat 8: hammerwife folded before Flop (didn't bet)
Seat 9: SkUhNi (button) collected ($9)





PokerStars Hand #154970662396:  Hold'em No Limit ($0.50/$1.00 USD) - 2016/06/20 12:50:02 CET [2016/06/20 6:50:02 ET]
Table 'Ernestina' 9-max Seat #5 is the button
Seat 1: diva3150 ($139.62 in chips) 
Seat 2: matiko09 ($124.81 in chips) 
Seat 3: Pvsx. ($187.49 in chips) 
Seat 4: SkUhNi ($100 in chips) 
Seat 5: Dickyxxx ($150.11 in chips) 
Seat 8: ruslik_by ($240.33 in chips) 
Seat 9: 23SmOkEr07 ($106.40 in chips) 
ruslik_by: posts small blind $0.50
23SmOkEr07: posts big blind $1
*** HOLE CARDS ***
Dealt to matiko09 [Qd Jh]
diva3150: folds 
matiko09: folds 
Pvsx.: folds 
SkUhNi: folds 
Dickyxxx: folds 
ruslik_by: raises $2 to $3
23SmOkEr07: calls $2
*** FLOP *** [4c Th 6h]
ruslik_by: bets $1.93
23SmOkEr07: folds 
Uncalled bet ($1.93) returned to ruslik_by
ruslik_by collected $5.70 from pot
ruslik_by: doesn't show hand 
*** SUMMARY ***
Total pot $6 | Rake $0.30 
Board [4c Th 6h]
Seat 1: diva3150 folded before Flop (didn't bet)
Seat 2: matiko09 folded before Flop (didn't bet)
Seat 3: Pvsx. folded before Flop (didn't bet)
Seat 4: SkUhNi folded before Flop (didn't bet)
Seat 5: Dickyxxx (button) folded before Flop (didn't bet)
Seat 8: ruslik_by (small blind) collected ($5.70)
Seat 9: 23SmOkEr07 (big blind) folded on the Flop





PokerStars Hand #154970666371:  Hold'em No Limit (£0.25/£0.50 GBP) - 2016/06/20 12:50:12 CET [2016/06/20 6:50:12 ET]
Table 'Tesla' 6-max Seat #3 is the button
Seat 1: Rubleff85 (£52.40 in chips) 
Seat 2: matiko09 (£73.37 in chips) 
Seat 3: asmodej666 (£50 in chips) 
Seat 5: Nego Razu (£50 in chips) 
Seat 6: faceMyBallz_ (£53.36 in chips) 
VahTang_89 will be allowed to play after the button
Nego Razu: posts small blind £0.25
faceMyBallz_: posts big blind £0.50
*** HOLE CARDS ***
Dealt to matiko09 [9c Qh]
Rubleff85: folds 
matiko09: folds 
asmodej666: raises £0.62 to £1.12
Nego Razu: folds 
faceMyBallz_: folds 
Uncalled bet (£0.62) returned to asmodej666
asmodej666 collected £1.25 from pot
asmodej666: doesn't show hand 
*** SUMMARY ***
Total pot £1.25 | Rake £0 
Seat 1: Rubleff85 folded before Flop (didn't bet)
Seat 2: matiko09 folded before Flop (didn't bet)
Seat 3: asmodej666 (button) collected (£1.25)
Seat 5: Nego Razu (small blind) folded before Flop
Seat 6: faceMyBallz_ (big blind) folded before Flop





PokerStars Hand #154970668992:  Hold'em No Limit ($0.50/$1.00 USD) - 2016/06/20 12:50:18 CET [2016/06/20 6:50:18 ET]
Table 'Isonoe II' 9-max Seat #4 is the button
Seat 1: hammerwife ($104.86 in chips) 
Seat 2: matiko09 ($122.26 in chips) 
Seat 3: Kukuryzka ($100 in chips) 
Seat 4: Avtovo ($103.50 in chips) 
Seat 5: Filojoes ($100 in chips) 
Seat 6: GOOFA13 ($70.46 in chips) 
Seat 7: SkUhNi ($113.82 in chips) 
Seat 8: lewyson ($58.86 in chips) 
Seat 9: djammusic ($68.45 in chips) 
Filojoes: posts small blind $0.50
GOOFA13: posts big blind $1
*** HOLE CARDS ***
Dealt to matiko09 [8c 7s]
SkUhNi: folds 
lewyson: folds 
djammusic: raises $1.50 to $2.50
hammerwife: raises $6 to $8.50
matiko09: folds 
Kukuryzka: folds 
Avtovo: folds 
Filojoes: raises $14.50 to $23
GOOFA13: folds 
djammusic: folds 
hammerwife: folds 
Uncalled bet ($14.50) returned to Filojoes
Filojoes collected $20.50 from pot
Filojoes: doesn't show hand 
*** SUMMARY ***
Total pot $20.50 | Rake $0 
Seat 1: hammerwife folded before Flop
Seat 2: matiko09 folded before Flop (didn't bet)
Seat 3: Kukuryzka folded before Flop (didn't bet)
Seat 4: Avtovo (button) folded before Flop (didn't bet)
Seat 5: Filojoes (small blind) collected ($20.50)
Seat 6: GOOFA13 (big blind) folded before Flop
Seat 7: SkUhNi folded before Flop (didn't bet)
Seat 8: lewyson folded before Flop (didn't bet)
Seat 9: djammusic folded before Flop





PokerStars Hand #154970669482:  Hold'em No Limit ($0.50/$1.00 USD) - 2016/06/20 12:50:19 CET [2016/06/20 6:50:19 ET]
Table 'Normannia' 9-max Seat #9 is the button
Seat 1: hammerwife ($123.72 in chips) 
Seat 2: Pvsx. ($190.62 in chips) 
Seat 3: Avtovo ($100 in chips) 
Seat 5: Dickyxxx ($117.19 in chips) 
Seat 6: typename27 ($60.61 in chips) 
Seat 7: matiko09 ($100 in chips) 
Seat 8: SkUhNi ($129.31 in chips) 
Seat 9: ruslik_by ($146.19 in chips) 
hammerwife: posts small blind $0.50
Pvsx.: posts big blind $1
Filojoes: sits out 
*** HOLE CARDS ***
Dealt to matiko09 [Qc As]
Avtovo: folds 
Dickyxxx: folds 
typename27: raises $3 to $4
matiko09: calls $4
SkUhNi: folds 
ruslik_by: folds 
hammerwife: folds 
Pvsx.: folds 
*** FLOP *** [Kd 7c Tc]
typename27: bets $4.51
matiko09: calls $4.51
*** TURN *** [Kd 7c Tc] [2c]
typename27: bets $6
matiko09: calls $6
*** RIVER *** [Kd 7c Tc 2c] [Td]
typename27: bets $9
matiko09: folds 
Uncalled bet ($9) returned to typename27
typename27 collected $28.99 from pot
typename27: doesn't show hand 
*** SUMMARY ***
Total pot $30.52 | Rake $1.53 
Board [Kd 7c Tc 2c Td]
Seat 1: hammerwife (small blind) folded before Flop
Seat 2: Pvsx. (big blind) folded before Flop
Seat 3: Avtovo folded before Flop (didn't bet)
Seat 5: Dickyxxx folded before Flop (didn't bet)
Seat 6: typename27 collected ($28.99)
Seat 7: matiko09 folded on the River
Seat 8: SkUhNi folded before Flop (didn't bet)
Seat 9: ruslik_by (button) folded before Flop (didn't bet)





PokerStars Hand #154970669156:  Hold'em No Limit (£0.25/£0.50 GBP) - 2016/06/20 12:50:19 CET [2016/06/20 6:50:19 ET]
Table 'Azalea' 6-max Seat #6 is the button
Seat 1: mitsuVK (£50.98 in chips) 
Seat 2: matiko09 (£81.24 in chips) 
Seat 3: tyoma_knp (£50 in chips) 
Seat 4: faceMyBallz_ (£105.84 in chips) 
Seat 5: mudders693 (£51.94 in chips) 
Seat 6: Bënedic10 (£70.83 in chips) 
mitsuVK: posts small blind £0.25
matiko09: posts big blind £0.50
*** HOLE CARDS ***
Dealt to matiko09 [Qh Ac]
tyoma_knp: folds 
faceMyBallz_: folds 
mudders693: raises £1 to £1.50
Bënedic10: folds 
mitsuVK: folds 
matiko09: raises £4.50 to £6
mudders693: calls £4.50
*** FLOP *** [4c 7s 3d]
matiko09: checks 
mudders693: bets £6
matiko09: folds 
Uncalled bet (£6) returned to mudders693
mudders693 collected £11.64 from pot
mudders693: doesn't show hand 
*** SUMMARY ***
Total pot £12.25 | Rake £0.61 
Board [4c 7s 3d]
Seat 1: mitsuVK (small blind) folded before Flop
Seat 2: matiko09 (big blind) folded on the Flop
Seat 3: tyoma_knp folded before Flop (didn't bet)
Seat 4: faceMyBallz_ folded before Flop (didn't bet)
Seat 5: mudders693 collected (£11.64)
Seat 6: Bënedic10 (button) folded before Flop (didn't bet)





PokerStars Hand #154970674850:  Hold'em No Limit ($0.50/$1.00 USD) - 2016/06/20 12:50:33 CET [2016/06/20 6:50:33 ET]
Table 'Albiorix' 9-max Seat #8 is the button
Seat 2: SkUhNi ($118.62 in chips) 
Seat 3: matiko09 ($126.73 in chips) 
Seat 4: 23SmOkEr07 ($119 in chips) 
Seat 5: ruslik_by ($103 in chips) 
Seat 7: Pekyto ($49.15 in chips) 
Seat 8: smiley0221 ($65.13 in chips) 
Seat 9: DomiVY ($40 in chips) 
DomiVY: posts small blind $0.50
SkUhNi: posts big blind $1
Filojoes: sits out 
*** HOLE CARDS ***
Dealt to matiko09 [Kh Qc]
matiko09: folds 
23SmOkEr07: folds 
ruslik_by: folds 
Pekyto: raises $2 to $3
smiley0221: folds 
DomiVY: folds 
SkUhNi: folds 
Uncalled bet ($2) returned to Pekyto
Pekyto collected $2.50 from pot
Pekyto: doesn't show hand 
*** SUMMARY ***
Total pot $2.50 | Rake $0 
Seat 2: SkUhNi (big blind) folded before Flop
Seat 3: matiko09 folded before Flop (didn't bet)
Seat 4: 23SmOkEr07 folded before Flop (didn't bet)
Seat 5: ruslik_by folded before Flop (didn't bet)
Seat 7: Pekyto collected ($2.50)
Seat 8: smiley0221 (button) folded before Flop (didn't bet)
Seat 9: DomiVY (small blind) folded before Flop





PokerStars Hand #154970674930:  Hold'em No Limit (£0.25/£0.50 GBP) - 2016/06/20 12:50:33 CET [2016/06/20 6:50:33 ET]
Table 'Tesla' 6-max Seat #5 is the button
Seat 1: Rubleff85 (£52.40 in chips) 
Seat 2: matiko09 (£73.37 in chips) 
Seat 3: asmodej666 (£50.75 in chips) 
Seat 5: Nego Razu (£50 in chips) 
Seat 6: faceMyBallz_ (£52.86 in chips) 
faceMyBallz_: posts small blind £0.25
Rubleff85: posts big blind £0.50
VahTang_89: sits out 
*** HOLE CARDS ***
Dealt to matiko09 [Qh Qd]
matiko09: raises £1 to £1.50
asmodej666: folds 
Nego Razu: folds 
faceMyBallz_: folds 
Rubleff85: calls £1
*** FLOP *** [6s Jh 6h]
Rubleff85: checks 
matiko09: bets £2
Rubleff85: calls £2
*** TURN *** [6s Jh 6h] [Qc]
Rubleff85: checks 
matiko09: checks 
*** RIVER *** [6s Jh 6h Qc] [9s]
Rubleff85: bets £4
matiko09: raises £11.50 to £15.50
Rubleff85: folds 
Uncalled bet (£11.50) returned to matiko09
matiko09 collected £14.49 from pot
matiko09: doesn't show hand 
*** SUMMARY ***
Total pot £15.25 | Rake £0.76 
Board [6s Jh 6h Qc 9s]
Seat 1: Rubleff85 (big blind) folded on the River
Seat 2: matiko09 collected (£14.49)
Seat 3: asmodej666 folded before Flop (didn't bet)
Seat 5: Nego Razu (button) folded before Flop (didn't bet)
Seat 6: faceMyBallz_ (small blind) folded before Flop





PokerStars Hand #154970676622:  Hold'em No Limit (£0.25/£0.50 GBP) - 2016/06/20 12:50:38 CET [2016/06/20 6:50:38 ET]
Table 'Ani' 6-max Seat #3 is the button
Seat 1: rewq99887788 (£21.66 in chips) 
Seat 2: mitsuVK (£67 in chips) 
Seat 3: Doobes8555 (£65.89 in chips) 
Seat 4: matiko09 (£60.11 in chips) 
Seat 5: Wwwasian (£57.68 in chips) 
Seat 6: faceMyBallz_ (£54.29 in chips) 
matiko09: posts small blind £0.25
Wwwasian: posts big blind £0.50
*** HOLE CARDS ***
Dealt to matiko09 [Th 5s]
faceMyBallz_: folds 
rewq99887788: folds 
mitsuVK: folds 
Doobes8555: folds 
rewq99887788 leaves the table
matiko09: folds 
Uncalled bet (£0.25) returned to Wwwasian
Wwwasian collected £0.50 from pot
Wwwasian: doesn't show hand 
*** SUMMARY ***
Total pot £0.50 | Rake £0 
Seat 1: rewq99887788 folded before Flop (didn't bet)
Seat 2: mitsuVK folded before Flop (didn't bet)
Seat 3: Doobes8555 (button) folded before Flop (didn't bet)
Seat 4: matiko09 (small blind) folded before Flop
Seat 5: Wwwasian (big blind) collected (£0.50)
Seat 6: faceMyBallz_ folded before Flop (didn't bet)





PokerStars Hand #154970678607:  Hold'em No Limit ($0.50/$1.00 USD) - 2016/06/20 12:50:43 CET [2016/06/20 6:50:43 ET]
Table 'Ambrosia II' 9-max Seat #1 is the button
Seat 1: 23SmOkEr07 ($170.25 in chips) 
Seat 2: Eyeballz1307 ($22.92 in chips) 
Seat 3: mavin80 ($112.95 in chips) 
Seat 4: mi$$I$Elena ($197.27 in chips) 
Seat 5: Mattulh ($100 in chips) 
Seat 6: ruslik_by ($106.30 in chips) 
Seat 7: matiko09 ($100 in chips) 
Seat 8: hammerwife ($119.45 in chips) 
Seat 9: SkUhNi ($136.76 in chips) 
Eyeballz1307: posts small blind $0.50
mavin80: posts big blind $1
*** HOLE CARDS ***
Dealt to matiko09 [Kc 8c]
mi$$I$Elena: folds 
Mattulh: folds 
ruslik_by: folds 
matiko09: folds 
hammerwife: folds 
SkUhNi: folds 
23SmOkEr07: folds 
Eyeballz1307: raises $3 to $4
mavin80: calls $3
*** FLOP *** [7d 5h Jc]
Eyeballz1307: bets $18.92 and is all-in
mavin80: calls $18.92
*** TURN *** [7d 5h Jc] [Ac]
*** RIVER *** [7d 5h Jc Ac] [3s]
*** SHOW DOWN ***
Eyeballz1307: shows [7h 4d] (a pair of Sevens)
mavin80: shows [8s 9c] (high card Ace)
Eyeballz1307 collected $43.55 from pot
*** SUMMARY ***
Total pot $45.84 | Rake $2.29 
Board [7d 5h Jc Ac 3s]
Seat 1: 23SmOkEr07 (button) folded before Flop (didn't bet)
Seat 2: Eyeballz1307 (small blind) showed [7h 4d] and won ($43.55) with a pair of Sevens
Seat 3: mavin80 (big blind) showed [8s 9c] and lost with high card Ace
Seat 4: mi$$I$Elena folded before Flop (didn't bet)
Seat 5: Mattulh folded before Flop (didn't bet)
Seat 6: ruslik_by folded before Flop (didn't bet)
Seat 7: matiko09 folded before Flop (didn't bet)
Seat 8: hammerwife folded before Flop (didn't bet)
Seat 9: SkUhNi folded before Flop (didn't bet)





PokerStars Hand #154970679717:  Hold'em No Limit ($0.50/$1.00 USD) - 2016/06/20 12:50:46 CET [2016/06/20 6:50:46 ET]
Table 'Ernestina' 9-max Seat #8 is the button
Seat 1: diva3150 ($139.62 in chips) 
Seat 2: matiko09 ($124.81 in chips) 
Seat 3: Pvsx. ($187.49 in chips) 
Seat 4: SkUhNi ($100 in chips) 
Seat 5: Dickyxxx ($150.11 in chips) 
Seat 8: ruslik_by ($243.03 in chips) 
Seat 9: 23SmOkEr07 ($103.40 in chips) 
23SmOkEr07: posts small blind $0.50
diva3150: posts big blind $1
*** HOLE CARDS ***
Dealt to matiko09 [9s 9h]
matiko09: raises $2 to $3
Pvsx.: folds 
SkUhNi: folds 
Dickyxxx: calls $3
ruslik_by: folds 
23SmOkEr07: folds 
diva3150: calls $2
*** FLOP *** [9d Ts 9c]
diva3150: checks 
matiko09: checks 
Dickyxxx: bets $5.77
diva3150: calls $5.77
matiko09: calls $5.77
*** TURN *** [9d Ts 9c] [7c]
diva3150: checks 
matiko09: bets $13.24
Dickyxxx: calls $13.24
diva3150: folds 
*** RIVER *** [9d Ts 9c 7c] [Kd]
matiko09: bets $26
Dickyxxx: folds 
Uncalled bet ($26) returned to matiko09
matiko09 collected $50.79 from pot
matiko09: doesn't show hand 
*** SUMMARY ***
Total pot $53.29 | Rake $2.50 
Board [9d Ts 9c 7c Kd]
Seat 1: diva3150 (big blind) folded on the Turn
Seat 2: matiko09 collected ($50.79)
Seat 3: Pvsx. folded before Flop (didn't bet)
Seat 4: SkUhNi folded before Flop (didn't bet)
Seat 5: Dickyxxx folded on the River
Seat 8: ruslik_by (button) folded before Flop (didn't bet)
Seat 9: 23SmOkEr07 (small blind) folded before Flop





PokerStars Hand #154970682672:  Hold'em No Limit (£0.25/£0.50 GBP) - 2016/06/20 12:50:53 CET [2016/06/20 6:50:53 ET]
Table 'Ani' 6-max Seat #4 is the button
Seat 2: mitsuVK (£67 in chips) 
Seat 3: Doobes8555 (£65.89 in chips) 
Seat 4: matiko09 (£59.86 in chips) 
Seat 5: Wwwasian (£57.93 in chips) 
Seat 6: faceMyBallz_ (£54.29 in chips) 
Wwwasian: posts small blind £0.25
faceMyBallz_: posts big blind £0.50
*** HOLE CARDS ***
Dealt to matiko09 [5c Ad]
tyoma_knp joins the table at seat #1 
mitsuVK: folds 
tyoma_knp leaves the table
Doobes8555: calls £0.50
matiko09: raises £1.50 to £2
Wwwasian: folds 
faceMyBallz_: folds 
Doobes8555: calls £1.50
*** FLOP *** [Qs 6h Td]
Doobes8555: checks 
matiko09: checks 
*** TURN *** [Qs 6h Td] [Ks]
Doobes8555: bets £2
matiko09: folds 
Uncalled bet (£2) returned to Doobes8555
Doobes8555 collected £4.51 from pot
Doobes8555: doesn't show hand 
*** SUMMARY ***
Total pot £4.75 | Rake £0.24 
Board [Qs 6h Td Ks]
Seat 2: mitsuVK folded before Flop (didn't bet)
Seat 3: Doobes8555 collected (£4.51)
Seat 4: matiko09 (button) folded on the Turn
Seat 5: Wwwasian (small blind) folded before Flop
Seat 6: faceMyBallz_ (big blind) folded before Flop





PokerStars Hand #154970683767:  Hold'em No Limit ($0.50/$1.00 USD) - 2016/06/20 12:50:56 CET [2016/06/20 6:50:56 ET]
Table 'Pongola' 9-max Seat #4 is the button
Seat 1: matiko09 ($100 in chips) 
Seat 2: ruslik_by ($129.27 in chips) 
Seat 3: SkUhNi ($113.22 in chips) 
Seat 4: karllv ($136.33 in chips) 
Seat 5: Avtovo ($100 in chips) 
Seat 6: 23SmOkEr07 ($126.20 in chips) 
Seat 7: Dickyxxx ($149.62 in chips) 
Seat 8: phrantique ($101.50 in chips) 
Seat 9: Filojoes ($130.59 in chips) 
Avtovo: posts small blind $0.50
23SmOkEr07: posts big blind $1
*** HOLE CARDS ***
Dealt to matiko09 [6h Kd]
Dickyxxx: raises $2 to $3
phrantique: calls $3
Filojoes: folds 
matiko09: folds 
ruslik_by: folds 
SkUhNi: folds 
karllv: calls $3
Avtovo: folds 
23SmOkEr07: folds 
*** FLOP *** [4h 3h Tc]
Dickyxxx: bets $6.38
phrantique: folds 
karllv: folds 
Uncalled bet ($6.38) returned to Dickyxxx
Dickyxxx collected $9.98 from pot
Dickyxxx: doesn't show hand 
*** SUMMARY ***
Total pot $10.50 | Rake $0.52 
Board [4h 3h Tc]
Seat 1: matiko09 folded before Flop (didn't bet)
Seat 2: ruslik_by folded before Flop (didn't bet)
Seat 3: SkUhNi folded before Flop (didn't bet)
Seat 4: karllv (button) folded on the Flop
Seat 5: Avtovo (small blind) folded before Flop
Seat 6: 23SmOkEr07 (big blind) folded before Flop
Seat 7: Dickyxxx collected ($9.98)
Seat 8: phrantique folded on the Flop
Seat 9: Filojoes folded before Flop (didn't bet)





PokerStars Hand #154970684067:  Hold'em No Limit ($0.50/$1.00 USD) - 2016/06/20 12:50:57 CET [2016/06/20 6:50:57 ET]
Table 'Anhui' 9-max Seat #3 is the button
Seat 1: SkUhNi ($161.88 in chips) 
Seat 2: ruslik_by ($264.68 in chips) 
Seat 3: hammerwife ($165.23 in chips) 
Seat 5: mi$$I$Elena ($103.80 in chips) 
Seat 6: 23SmOkEr07 ($121.68 in chips) 
Seat 7: matiko09 ($123.48 in chips) 
Seat 8: blackmont111 ($69.50 in chips) 
Seat 9: TomBod1 ($86.03 in chips) 
mavin80 will be allowed to play after the button
mi$$I$Elena: posts small blind $0.50
23SmOkEr07: posts big blind $1
*** HOLE CARDS ***
Dealt to matiko09 [9c Qc]
matiko09: folds 
blackmont111: folds 
TomBod1: folds 
SkUhNi: folds 
ruslik_by: folds 
hammerwife: raises $1.01 to $2.01
mi$$I$Elena: folds 
23SmOkEr07: folds 
Uncalled bet ($1.01) returned to hammerwife
hammerwife collected $2.50 from pot
hammerwife: doesn't show hand 
*** SUMMARY ***
Total pot $2.50 | Rake $0 
Seat 1: SkUhNi folded before Flop (didn't bet)
Seat 2: ruslik_by folded before Flop (didn't bet)
Seat 3: hammerwife (button) collected ($2.50)
Seat 5: mi$$I$Elena (small blind) folded before Flop
Seat 6: 23SmOkEr07 (big blind) folded before Flop
Seat 7: matiko09 folded before Flop (didn't bet)
Seat 8: blackmont111 folded before Flop (didn't bet)
Seat 9: TomBod1 folded before Flop (didn't bet)





PokerStars Hand #154970688624:  Hold'em No Limit ($0.50/$1.00 USD) - 2016/06/20 12:51:08 CET [2016/06/20 6:51:08 ET]
Table 'Annika' 9-max Seat #1 is the button
Seat 1: hammerwife ($105.77 in chips) 
Seat 2: matiko09 ($105.80 in chips) 
Seat 3: first_dnk ($89.28 in chips) 
Seat 4: Kukuryzka ($107 in chips) 
Seat 5: SkUhNi ($123.63 in chips) 
Seat 6: Pvsx. ($102.55 in chips) 
Seat 8: ruslik_by ($104.90 in chips) 
Seat 9: 23SmOkEr07 ($143.15 in chips) 
matiko09: posts small blind $0.50
first_dnk: posts big blind $1
jirka117: sits out 
*** HOLE CARDS ***
Dealt to matiko09 [Th 4s]
Kukuryzka: raises $2 to $3
SkUhNi: folds 
Pvsx.: folds 
ruslik_by: raises $6 to $9
23SmOkEr07: folds 
hammerwife: folds 
matiko09: folds 
first_dnk: folds 
Kukuryzka: calls $6
*** FLOP *** [Jh 2d 6s]
Kukuryzka: checks 
ruslik_by: bets $6.29
Kukuryzka: calls $6.29
*** TURN *** [Jh 2d 6s] [8s]
Kukuryzka: checks 
ruslik_by: bets $10.36
Kukuryzka: calls $10.36
*** RIVER *** [Jh 2d 6s 8s] [9s]
Kukuryzka: checks 
ruslik_by: bets $79.25 and is all-in
Kukuryzka: folds 
Uncalled bet ($79.25) returned to ruslik_by
ruslik_by collected $50.30 from pot
ruslik_by: doesn't show hand 
*** SUMMARY ***
Total pot $52.80 | Rake $2.50 
Board [Jh 2d 6s 8s 9s]
Seat 1: hammerwife (button) folded before Flop (didn't bet)
Seat 2: matiko09 (small blind) folded before Flop
Seat 3: first_dnk (big blind) folded before Flop
Seat 4: Kukuryzka folded on the River
Seat 5: SkUhNi folded before Flop (didn't bet)
Seat 6: Pvsx. folded before Flop (didn't bet)
Seat 8: ruslik_by collected ($50.30)
Seat 9: 23SmOkEr07 folded before Flop (didn't bet)





PokerStars Hand #154970691025:  Hold'em No Limit (£0.25/£0.50 GBP) - 2016/06/20 12:51:14 CET [2016/06/20 6:51:14 ET]
Table 'Azalea' 6-max Seat #1 is the button
Seat 1: mitsuVK (£50.73 in chips) 
Seat 2: matiko09 (£75.24 in chips) 
Seat 3: tyoma_knp (£50 in chips) 
Seat 4: faceMyBallz_ (£105.84 in chips) 
Seat 5: mudders693 (£57.58 in chips) 
Seat 6: Bënedic10 (£70.83 in chips) 
matiko09: posts small blind £0.25
tyoma_knp: posts big blind £0.50
*** HOLE CARDS ***
Dealt to matiko09 [Jc 8c]
faceMyBallz_: folds 
mudders693: raises £1 to £1.50
Bënedic10: folds 
mitsuVK: folds 
matiko09: folds 
tyoma_knp: calls £1
*** FLOP *** [2h 8s 4c]
tyoma_knp: checks 
mudders693: bets £2
tyoma_knp: folds 
Uncalled bet (£2) returned to mudders693
mudders693 collected £3.09 from pot
mudders693: doesn't show hand 
*** SUMMARY ***
Total pot £3.25 | Rake £0.16 
Board [2h 8s 4c]
Seat 1: mitsuVK (button) folded before Flop (didn't bet)
Seat 2: matiko09 (small blind) folded before Flop
Seat 3: tyoma_knp (big blind) folded on the Flop
Seat 4: faceMyBallz_ folded before Flop (didn't bet)
Seat 5: mudders693 collected (£3.09)
Seat 6: Bënedic10 folded before Flop (didn't bet)





PokerStars Hand #154970691535:  Hold'em No Limit ($0.50/$1.00 USD) - 2016/06/20 12:51:16 CET [2016/06/20 6:51:16 ET]
Table 'Isonoe II' 9-max Seat #5 is the button
Seat 1: hammerwife ($100 in chips) 
Seat 2: matiko09 ($122.26 in chips) 
Seat 3: Kukuryzka ($100 in chips) 
Seat 4: Avtovo ($103.50 in chips) 
Seat 5: Filojoes ($112 in chips) 
Seat 6: GOOFA13 ($69.46 in chips) 
Seat 7: SkUhNi ($113.82 in chips) 
Seat 8: lewyson ($58.86 in chips) 
Seat 9: djammusic ($65.95 in chips) 
GOOFA13: posts small blind $0.50
SkUhNi: posts big blind $1
*** HOLE CARDS ***
Dealt to matiko09 [Kc 9d]
lewyson: raises $2 to $3
djammusic: folds 
hammerwife: folds 
matiko09: folds 
Kukuryzka: folds 
Avtovo: folds 
Filojoes: calls $3
GOOFA13: folds 
SkUhNi: folds 
*** FLOP *** [Ah 5h 7c]
lewyson: bets $7.12
Filojoes: folds 
Uncalled bet ($7.12) returned to lewyson
lewyson collected $7.12 from pot
*** SUMMARY ***
Total pot $7.50 | Rake $0.38 
Board [Ah 5h 7c]
Seat 1: hammerwife folded before Flop (didn't bet)
Seat 2: matiko09 folded before Flop (didn't bet)
Seat 3: Kukuryzka folded before Flop (didn't bet)
Seat 4: Avtovo folded before Flop (didn't bet)
Seat 5: Filojoes (button) folded on the Flop
Seat 6: GOOFA13 (small blind) folded before Flop
Seat 7: SkUhNi (big blind) folded before Flop
Seat 8: lewyson collected ($7.12)
Seat 9: djammusic folded before Flop (didn't bet)





PokerStars Hand #154970693735:  Hold'em No Limit ($0.50/$1.00 USD) - 2016/06/20 12:51:21 CET [2016/06/20 6:51:21 ET]
Table 'Albiorix' 9-max Seat #9 is the button
Seat 2: SkUhNi ($117.62 in chips) 
Seat 3: matiko09 ($126.73 in chips) 
Seat 4: 23SmOkEr07 ($119 in chips) 
Seat 5: ruslik_by ($103 in chips) 
Seat 7: Pekyto ($50.65 in chips) 
Seat 8: smiley0221 ($65.13 in chips) 
Seat 9: DomiVY ($40 in chips) 
SkUhNi: posts small blind $0.50
matiko09: posts big blind $1
Filojoes: sits out 
*** HOLE CARDS ***
Dealt to matiko09 [6c 4c]
23SmOkEr07: folds 
ruslik_by: folds 
Pekyto: folds 
smiley0221 has timed out
smiley0221: folds 
DomiVY: raises $1.10 to $2.10
SkUhNi: raises $4.90 to $7
matiko09: folds 
DomiVY: raises $33 to $40 and is all-in
SkUhNi: folds 
Uncalled bet ($33) returned to DomiVY
DomiVY collected $15 from pot
DomiVY: doesn't show hand 
*** SUMMARY ***
Total pot $15 | Rake $0 
Seat 2: SkUhNi (small blind) folded before Flop
Seat 3: matiko09 (big blind) folded before Flop
Seat 4: 23SmOkEr07 folded before Flop (didn't bet)
Seat 5: ruslik_by folded before Flop (didn't bet)
Seat 7: Pekyto folded before Flop (didn't bet)
Seat 8: smiley0221 folded before Flop (didn't bet)
Seat 9: DomiVY (button) collected ($15)





PokerStars Hand #154970695727:  Hold'em No Limit ($0.25/$0.50 USD) - 2016/06/20 12:51:26 CET [2016/06/20 6:51:26 ET]
Table 'Scheddi II' 9-max Seat #7 is the button
Seat 1: matiko09 ($94.50 in chips) 
Seat 2: Yaaaazz ($89.70 in chips) 
Seat 3: mi$$I$Elena ($96.10 in chips) 
Seat 4: GOOFA13 ($50.52 in chips) 
Seat 5: zarplatka ($40 in chips) 
Seat 7: HopeMayBee ($87.96 in chips) 
Seat 9: Infinitinium ($124.46 in chips) 
Danil27 will be allowed to play after the button
Infinitinium: posts small blind $0.25
matiko09: posts big blind $0.50
matiko09: posts the ante $0.10
Yaaaazz: posts the ante $0.10
mi$$I$Elena: posts the ante $0.10
GOOFA13: posts the ante $0.10
zarplatka: posts the ante $0.10
HopeMayBee: posts the ante $0.10
Infinitinium: posts the ante $0.10
*** HOLE CARDS ***
Dealt to matiko09 [6h 3c]
Yaaaazz: folds 
mi$$I$Elena: folds 
GOOFA13: raises $1.50 to $2
zarplatka: calls $2
HopeMayBee: folds 
Infinitinium: calls $1.75
matiko09: folds 
*** FLOP *** [9d As 4h]
Infinitinium: checks 
GOOFA13: bets $2.50
zarplatka: folds 
Infinitinium: calls $2.50
*** TURN *** [9d As 4h] [9s]
Infinitinium: bets $5.79
GOOFA13: calls $5.79
*** RIVER *** [9d As 4h 9s] [Th]
Infinitinium: checks 
GOOFA13: bets $11
Infinitinium: folds 
Uncalled bet ($11) returned to GOOFA13
GOOFA13 collected $22.59 from pot
GOOFA13: doesn't show hand 
*** SUMMARY ***
Total pot $23.78 | Rake $1.19 
Board [9d As 4h 9s Th]
Seat 1: matiko09 (big blind) folded before Flop
Seat 2: Yaaaazz folded before Flop (didn't bet)
Seat 3: mi$$I$Elena folded before Flop (didn't bet)
Seat 4: GOOFA13 collected ($22.59)
Seat 5: zarplatka folded on the Flop
Seat 7: HopeMayBee (button) folded before Flop (didn't bet)
Seat 9: Infinitinium (small blind) folded on the River





PokerStars Hand #154970695733:  Hold'em No Limit ($0.50/$1.00 USD) - 2016/06/20 12:51:27 CET [2016/06/20 6:51:27 ET]
Table 'Garumna II' 9-max Seat #1 is the button
Seat 1: ki11u ($100 in chips) 
Seat 2: Racushniak ($100 in chips) 
Seat 3: mooose100 ($81.38 in chips) 
Seat 4: Ndundun Gipe ($73.50 in chips) 
Seat 5: rura53 ($78 in chips) 
Seat 6: SexyAngeline ($52.57 in chips) 
Seat 7: Avtovo ($100 in chips) 
Seat 8: matiko09 ($109.52 in chips) 
Seat 9: SkUhNi ($102.30 in chips) 
Racushniak: posts small blind $0.50
mooose100: posts big blind $1
*** HOLE CARDS ***
Dealt to matiko09 [Ad 8h]
Ndundun Gipe: raises $1 to $2
rura53: folds 
SexyAngeline: folds 
Avtovo: folds 
matiko09: folds 
SkUhNi: folds 
ki11u: calls $2
Racushniak: folds 
mooose100: calls $1
*** FLOP *** [9c 4d 5d]
mooose100: checks 
Ndundun Gipe: bets $8
ki11u: calls $8
mooose100: folds 
*** TURN *** [9c 4d 5d] [5c]
Ndundun Gipe: bets $1
ki11u: calls $1
*** RIVER *** [9c 4d 5d 5c] [6h]
Ndundun Gipe: bets $5
ki11u: raises $24 to $29
Ndundun Gipe: calls $24
*** SHOW DOWN ***
ki11u: shows [8d 7d] (a straight, Five to Nine)
Ndundun Gipe: mucks hand 
ki11u collected $80 from pot
*** SUMMARY ***
Total pot $82.50 | Rake $2.50 
Board [9c 4d 5d 5c 6h]
Seat 1: ki11u (button) showed [8d 7d] and won ($80) with a straight, Five to Nine
Seat 2: Racushniak (small blind) folded before Flop
Seat 3: mooose100 (big blind) folded on the Flop
Seat 4: Ndundun Gipe mucked [Kh Kc]
Seat 5: rura53 folded before Flop (didn't bet)
Seat 6: SexyAngeline folded before Flop (didn't bet)
Seat 7: Avtovo folded before Flop (didn't bet)
Seat 8: matiko09 folded before Flop (didn't bet)
Seat 9: SkUhNi folded before Flop (didn't bet)





PokerStars Hand #154970697719:  Hold'em No Limit ($0.50/$1.00 USD) - 2016/06/20 12:51:32 CET [2016/06/20 6:51:32 ET]
Table 'Pongola' 9-max Seat #5 is the button
Seat 1: matiko09 ($100 in chips) 
Seat 2: ruslik_by ($129.27 in chips) 
Seat 3: SkUhNi ($113.22 in chips) 
Seat 4: karllv ($133.33 in chips) 
Seat 5: Avtovo ($100 in chips) 
Seat 6: 23SmOkEr07 ($125.20 in chips) 
Seat 7: Dickyxxx ($156.60 in chips) 
Seat 8: phrantique ($98.50 in chips) 
Seat 9: Filojoes ($130.59 in chips) 
23SmOkEr07: posts small blind $0.50
Dickyxxx: posts big blind $1
*** HOLE CARDS ***
Dealt to matiko09 [9d 3s]
phrantique: folds 
Filojoes: folds 
matiko09: folds 
ruslik_by: folds 
SkUhNi: folds 
karllv: folds 
Avtovo: raises $1.50 to $2.50
23SmOkEr07: folds 
Dickyxxx: calls $1.50
*** FLOP *** [4c Ad As]
Dickyxxx: checks 
Avtovo: bets $2.61
Dickyxxx: folds 
Uncalled bet ($2.61) returned to Avtovo
Avtovo collected $5.22 from pot
Avtovo: doesn't show hand 
*** SUMMARY ***
Total pot $5.50 | Rake $0.28 
Board [4c Ad As]
Seat 1: matiko09 folded before Flop (didn't bet)
Seat 2: ruslik_by folded before Flop (didn't bet)
Seat 3: SkUhNi folded before Flop (didn't bet)
Seat 4: karllv folded before Flop (didn't bet)
Seat 5: Avtovo (button) collected ($5.22)
Seat 6: 23SmOkEr07 (small blind) folded before Flop
Seat 7: Dickyxxx (big blind) folded on the Flop
Seat 8: phrantique folded before Flop (didn't bet)
Seat 9: Filojoes folded before Flop (didn't bet)





PokerStars Hand #154970700003:  Hold'em No Limit (£0.25/£0.50 GBP) - 2016/06/20 12:51:37 CET [2016/06/20 6:51:37 ET]
Table 'Ani' 6-max Seat #5 is the button
Seat 2: mitsuVK (£67 in chips) 
Seat 3: Doobes8555 (£68.40 in chips) 
Seat 4: matiko09 (£57.86 in chips) 
Seat 5: Wwwasian (£57.68 in chips) 
Seat 6: faceMyBallz_ (£53.79 in chips) 
faceMyBallz_: posts small blind £0.25
mitsuVK: posts big blind £0.50
*** HOLE CARDS ***
Dealt to matiko09 [Ac Ts]
Doobes8555: calls £0.50
matiko09: raises £1.50 to £2
Wwwasian: folds 
faceMyBallz_: raises £4 to £6
mitsuVK: folds 
Doobes8555: folds 
matiko09: folds 
Uncalled bet (£4) returned to faceMyBallz_
faceMyBallz_ collected £5 from pot
faceMyBallz_: doesn't show hand 
*** SUMMARY ***
Total pot £5 | Rake £0 
Seat 2: mitsuVK (big blind) folded before Flop
Seat 3: Doobes8555 folded before Flop
Seat 4: matiko09 folded before Flop
Seat 5: Wwwasian (button) folded before Flop (didn't bet)
Seat 6: faceMyBallz_ (small blind) collected (£5)





PokerStars Hand #154970699993:  Hold'em No Limit ($0.50/$1.00 USD) - 2016/06/20 12:51:37 CET [2016/06/20 6:51:37 ET]
Table 'Anhui' 9-max Seat #5 is the button
Seat 1: SkUhNi ($161.88 in chips) 
Seat 2: ruslik_by ($264.68 in chips) 
Seat 3: hammerwife ($166.73 in chips) 
Seat 4: mavin80 ($100 in chips) 
Seat 5: mi$$I$Elena ($103.30 in chips) 
Seat 6: 23SmOkEr07 ($120.68 in chips) 
Seat 7: matiko09 ($123.48 in chips) 
Seat 8: blackmont111 ($69.50 in chips) 
Seat 9: TomBod1 ($86.03 in chips) 
23SmOkEr07: posts small blind $0.50
matiko09: posts big blind $1
mavin80: posts small & big blinds $1.50
*** HOLE CARDS ***
Dealt to matiko09 [Jd 4s]
blackmont111: folds 
TomBod1: raises $2 to $3
SkUhNi: folds 
ruslik_by: folds 
hammerwife: folds 
mavin80: folds 
mi$$I$Elena: folds 
23SmOkEr07: folds 
matiko09: folds 
Uncalled bet ($2) returned to TomBod1
TomBod1 collected $4 from pot
TomBod1: doesn't show hand 
*** SUMMARY ***
Total pot $4 | Rake $0 
Seat 1: SkUhNi folded before Flop (didn't bet)
Seat 2: ruslik_by folded before Flop (didn't bet)
Seat 3: hammerwife folded before Flop (didn't bet)
Seat 4: mavin80 folded before Flop
Seat 5: mi$$I$Elena (button) folded before Flop (didn't bet)
Seat 6: 23SmOkEr07 (small blind) folded before Flop
Seat 7: matiko09 (big blind) folded before Flop
Seat 8: blackmont111 folded before Flop (didn't bet)
Seat 9: TomBod1 collected ($4)





PokerStars Hand #154970701806:  Hold'em No Limit ($0.50/$1.00 USD) - 2016/06/20 12:51:42 CET [2016/06/20 6:51:42 ET]
Table 'Ambrosia II' 9-max Seat #2 is the button
Seat 1: 23SmOkEr07 ($170.25 in chips) 
Seat 2: Eyeballz1307 ($43.55 in chips) 
Seat 3: mavin80 ($90.03 in chips) 
Seat 4: mi$$I$Elena ($197.27 in chips) 
Seat 5: Mattulh ($100 in chips) 
Seat 6: ruslik_by ($106.30 in chips) 
Seat 7: matiko09 ($100 in chips) 
Seat 8: hammerwife ($119.45 in chips) 
Seat 9: SkUhNi ($136.76 in chips) 
mavin80: posts small blind $0.50
mi$$I$Elena: posts big blind $1
*** HOLE CARDS ***
Dealt to matiko09 [Td 6d]
Mattulh: folds 
ruslik_by: raises $2 to $3
matiko09: folds 
hammerwife: folds 
SkUhNi: folds 
23SmOkEr07: folds 
Eyeballz1307: folds 
mavin80: folds 
mi$$I$Elena: folds 
Uncalled bet ($2) returned to ruslik_by
ruslik_by collected $2.50 from pot
ruslik_by: doesn't show hand 
*** SUMMARY ***
Total pot $2.50 | Rake $0 
Seat 1: 23SmOkEr07 folded before Flop (didn't bet)
Seat 2: Eyeballz1307 (button) folded before Flop (didn't bet)
Seat 3: mavin80 (small blind) folded before Flop
Seat 4: mi$$I$Elena (big blind) folded before Flop
Seat 5: Mattulh folded before Flop (didn't bet)
Seat 6: ruslik_by collected ($2.50)
Seat 7: matiko09 folded before Flop (didn't bet)
Seat 8: hammerwife folded before Flop (didn't bet)
Seat 9: SkUhNi folded before Flop (didn't bet)





PokerStars Hand #154970706364:  Hold'em No Limit (£0.25/£0.50 GBP) - 2016/06/20 12:51:53 CET [2016/06/20 6:51:53 ET]
Table 'Azalea' 6-max Seat #2 is the button
Seat 1: mitsuVK (£50.73 in chips) 
Seat 2: matiko09 (£74.99 in chips) 
Seat 3: tyoma_knp (£50 in chips) 
Seat 4: faceMyBallz_ (£105.84 in chips) 
Seat 5: mudders693 (£59.17 in chips) 
Seat 6: Bënedic10 (£70.83 in chips) 
tyoma_knp: posts small blind £0.25
faceMyBallz_: posts big blind £0.50
*** HOLE CARDS ***
Dealt to matiko09 [Ac 6h]
mudders693: folds 
Bënedic10: folds 
mitsuVK: folds 
matiko09: raises £0.63 to £1.13
tyoma_knp: folds 
faceMyBallz_: raises £3.87 to £5
matiko09: folds 
Uncalled bet (£3.87) returned to faceMyBallz_
faceMyBallz_ collected £2.51 from pot
faceMyBallz_: doesn't show hand 
*** SUMMARY ***
Total pot £2.51 | Rake £0 
Seat 1: mitsuVK folded before Flop (didn't bet)
Seat 2: matiko09 (button) folded before Flop
Seat 3: tyoma_knp (small blind) folded before Flop
Seat 4: faceMyBallz_ (big blind) collected (£2.51)
Seat 5: mudders693 folded before Flop (didn't bet)
Seat 6: Bënedic10 folded before Flop (didn't bet)





PokerStars Hand #154970711855:  Hold'em No Limit (£0.25/£0.50 GBP) - 2016/06/20 12:52:07 CET [2016/06/20 6:52:07 ET]
Table 'Ani' 6-max Seat #6 is the button
Seat 2: mitsuVK (£66.50 in chips) 
Seat 3: Doobes8555 (£67.90 in chips) 
Seat 4: matiko09 (£55.86 in chips) 
Seat 5: Wwwasian (£57.68 in chips) 
Seat 6: faceMyBallz_ (£56.79 in chips) 
asmodej666 joins the table at seat #1 
mitsuVK: posts small blind £0.25
Doobes8555: posts big blind £0.50
*** HOLE CARDS ***
Dealt to matiko09 [5c 2c]
matiko09: folds 
Wwwasian: folds 
faceMyBallz_: folds 
mitsuVK: folds 
Uncalled bet (£0.25) returned to Doobes8555
Doobes8555 collected £0.50 from pot
Doobes8555: doesn't show hand 
*** SUMMARY ***
Total pot £0.50 | Rake £0 
Seat 2: mitsuVK (small blind) folded before Flop
Seat 3: Doobes8555 (big blind) collected (£0.50)
Seat 4: matiko09 folded before Flop (didn't bet)
Seat 5: Wwwasian folded before Flop (didn't bet)
Seat 6: faceMyBallz_ (button) folded before Flop (didn't bet)





PokerStars Hand #154970714451:  Hold'em No Limit ($0.50/$1.00 USD) - 2016/06/20 12:52:14 CET [2016/06/20 6:52:14 ET]
Table 'Isonoe II' 9-max Seat #6 is the button
Seat 1: hammerwife ($100 in chips) 
Seat 2: matiko09 ($122.26 in chips) 
Seat 3: Kukuryzka ($100 in chips) 
Seat 4: Avtovo ($103.50 in chips) 
Seat 5: Filojoes ($109 in chips) 
Seat 6: GOOFA13 ($68.96 in chips) 
Seat 7: SkUhNi ($112.82 in chips) 
Seat 8: lewyson ($62.98 in chips) 
Seat 9: djammusic ($65.95 in chips) 
SkUhNi: posts small blind $0.50
lewyson: posts big blind $1
*** HOLE CARDS ***
Dealt to matiko09 [4d 2c]
djammusic: folds 
hammerwife: folds 
matiko09: folds 
Kukuryzka: raises $2 to $3
Avtovo: folds 
Filojoes: folds 
GOOFA13: calls $3
SkUhNi: folds 
lewyson: raises $4 to $7
Kukuryzka: calls $4
GOOFA13: calls $4
*** FLOP *** [8c Ac Qh]
lewyson: bets $20.42
Kukuryzka: folds 
GOOFA13: folds 
Uncalled bet ($20.42) returned to lewyson
lewyson collected $20.42 from pot
*** SUMMARY ***
Total pot $21.50 | Rake $1.08 
Board [8c Ac Qh]
Seat 1: hammerwife folded before Flop (didn't bet)
Seat 2: matiko09 folded before Flop (didn't bet)
Seat 3: Kukuryzka folded on the Flop
Seat 4: Avtovo folded before Flop (didn't bet)
Seat 5: Filojoes folded before Flop (didn't bet)
Seat 6: GOOFA13 (button) folded on the Flop
Seat 7: SkUhNi (small blind) folded before Flop
Seat 8: lewyson (big blind) collected ($20.42)
Seat 9: djammusic folded before Flop (didn't bet)





PokerStars Hand #154970715967:  Hold'em No Limit ($0.50/$1.00 USD) - 2016/06/20 12:52:18 CET [2016/06/20 6:52:18 ET]
Table 'Normannia' 9-max Seat #1 is the button
Seat 1: hammerwife ($123.22 in chips) 
Seat 2: Pvsx. ($189.62 in chips) 
Seat 3: Avtovo ($100 in chips) 
Seat 5: Dickyxxx ($117.19 in chips) 
Seat 6: typename27 ($75.09 in chips) 
Seat 7: matiko09 ($100 in chips) 
Seat 8: SkUhNi ($129.31 in chips) 
Seat 9: ruslik_by ($146.19 in chips) 
Pvsx.: posts small blind $0.50
Avtovo: posts big blind $1
Filojoes: sits out 
*** HOLE CARDS ***
Dealt to matiko09 [Qs 8s]
Dickyxxx: folds 
typename27: folds 
matiko09: folds 
SkUhNi: raises $2 to $3
ruslik_by: folds 
hammerwife: folds 
Pvsx.: calls $2.50
Avtovo: calls $2
*** FLOP *** [8d Qh 3c]
Pvsx.: checks 
Avtovo: checks 
SkUhNi: bets $5.98
Pvsx.: folds 
Avtovo: calls $5.98
*** TURN *** [8d Qh 3c] [Jh]
Avtovo: checks 
SkUhNi: checks 
*** RIVER *** [8d Qh 3c Jh] [9d]
Avtovo: checks 
SkUhNi: bets $10.95
Avtovo: folds 
Uncalled bet ($10.95) returned to SkUhNi
SkUhNi collected $19.91 from pot
SkUhNi: doesn't show hand 
*** SUMMARY ***
Total pot $20.96 | Rake $1.05 
Board [8d Qh 3c Jh 9d]
Seat 1: hammerwife (button) folded before Flop (didn't bet)
Seat 2: Pvsx. (small blind) folded on the Flop
Seat 3: Avtovo (big blind) folded on the River
Seat 5: Dickyxxx folded before Flop (didn't bet)
Seat 6: typename27 folded before Flop (didn't bet)
Seat 7: matiko09 folded before Flop (didn't bet)
Seat 8: SkUhNi collected ($19.91)
Seat 9: ruslik_by folded before Flop (didn't bet)





PokerStars Hand #154970716117:  Hold'em No Limit (£0.25/£0.50 GBP) - 2016/06/20 12:52:18 CET [2016/06/20 6:52:18 ET]
Table 'Tesla' 6-max Seat #6 is the button
Seat 1: Rubleff85 (£44.90 in chips) 
Seat 2: matiko09 (£80.36 in chips) 
Seat 3: asmodej666 (£50.75 in chips) 
Seat 5: Nego Razu (£50 in chips) 
Seat 6: faceMyBallz_ (£52.61 in chips) 
Rubleff85: posts small blind £0.25
matiko09: posts big blind £0.50
VahTang_89: sits out 
*** HOLE CARDS ***
Dealt to matiko09 [Ts 4d]
asmodej666: folds 
Nego Razu: folds 
faceMyBallz_: folds 
Rubleff85: raises £1 to £1.50
matiko09: folds 
Uncalled bet (£1) returned to Rubleff85
Rubleff85 collected £1 from pot
Rubleff85: doesn't show hand 
*** SUMMARY ***
Total pot £1 | Rake £0 
Seat 1: Rubleff85 (small blind) collected (£1)
Seat 2: matiko09 (big blind) folded before Flop
Seat 3: asmodej666 folded before Flop (didn't bet)
Seat 5: Nego Razu folded before Flop (didn't bet)
Seat 6: faceMyBallz_ (button) folded before Flop (didn't bet)





PokerStars Hand #154970716490:  Hold'em No Limit ($0.50/$1.00 USD) - 2016/06/20 12:52:19 CET [2016/06/20 6:52:19 ET]
Table 'Anhui' 9-max Seat #6 is the button
Seat 1: SkUhNi ($161.88 in chips) 
Seat 2: ruslik_by ($264.68 in chips) 
Seat 3: hammerwife ($166.73 in chips) 
Seat 4: mavin80 ($98.50 in chips) 
Seat 5: mi$$I$Elena ($103.30 in chips) 
Seat 6: 23SmOkEr07 ($120.18 in chips) 
Seat 7: matiko09 ($122.48 in chips) 
Seat 8: blackmont111 ($69.50 in chips) 
Seat 9: TomBod1 ($89.03 in chips) 
matiko09: posts small blind $0.50
blackmont111: posts big blind $1
*** HOLE CARDS ***
Dealt to matiko09 [6c Kd]
TomBod1: folds 
SkUhNi: folds 
ruslik_by: folds 
hammerwife: folds 
mavin80: raises $1.50 to $2.50
mi$$I$Elena: folds 
23SmOkEr07: calls $2.50
matiko09: folds 
blackmont111: calls $1.50
*** FLOP *** [Qh 4h Ad]
blackmont111: checks 
mavin80: bets $4
23SmOkEr07: folds 
blackmont111: calls $4
*** TURN *** [Qh 4h Ad] [4d]
blackmont111: checks 
mavin80: checks 
*** RIVER *** [Qh 4h Ad 4d] [Th]
blackmont111: checks 
mavin80: checks 
*** SHOW DOWN ***
blackmont111: shows [2c 3c] (a pair of Fours)
mavin80: shows [9c As] (two pair, Aces and Fours)
mavin80 collected $15.20 from pot
*** SUMMARY ***
Total pot $16 | Rake $0.80 
Board [Qh 4h Ad 4d Th]
Seat 1: SkUhNi folded before Flop (didn't bet)
Seat 2: ruslik_by folded before Flop (didn't bet)
Seat 3: hammerwife folded before Flop (didn't bet)
Seat 4: mavin80 showed [9c As] and won ($15.20) with two pair, Aces and Fours
Seat 5: mi$$I$Elena folded before Flop (didn't bet)
Seat 6: 23SmOkEr07 (button) folded on the Flop
Seat 7: matiko09 (small blind) folded before Flop
Seat 8: blackmont111 (big blind) showed [2c 3c] and lost with a pair of Fours
Seat 9: TomBod1 folded before Flop (didn't bet)





PokerStars Hand #154970718414:  Hold'em No Limit (£0.25/£0.50 GBP) - 2016/06/20 12:52:24 CET [2016/06/20 6:52:24 ET]
Table 'Ani' 6-max Seat #2 is the button
Seat 2: mitsuVK (£66.25 in chips) 
Seat 3: Doobes8555 (£68.15 in chips) 
Seat 4: matiko09 (£55.86 in chips) 
Seat 5: Wwwasian (£57.68 in chips) 
Seat 6: faceMyBallz_ (£56.79 in chips) 
Doobes8555: posts small blind £0.25
matiko09: posts big blind £0.50
asmodej666: sits out 
*** HOLE CARDS ***
Dealt to matiko09 [Ts 2d]
Wwwasian: folds 
faceMyBallz_: raises £0.75 to £1.25
mitsuVK: folds 
Doobes8555: folds 
matiko09: folds 
Uncalled bet (£0.75) returned to faceMyBallz_
faceMyBallz_ collected £1.25 from pot
faceMyBallz_: doesn't show hand 
*** SUMMARY ***
Total pot £1.25 | Rake £0 
Seat 2: mitsuVK (button) folded before Flop (didn't bet)
Seat 3: Doobes8555 (small blind) folded before Flop
Seat 4: matiko09 (big blind) folded before Flop
Seat 5: Wwwasian folded before Flop (didn't bet)
Seat 6: faceMyBallz_ collected (£1.25)





PokerStars Hand #154970719255:  Hold'em No Limit ($0.50/$1.00 USD) - 2016/06/20 12:52:26 CET [2016/06/20 6:52:26 ET]
Table 'Pongola' 9-max Seat #6 is the button
Seat 1: matiko09 ($100 in chips) 
Seat 2: ruslik_by ($129.27 in chips) 
Seat 3: SkUhNi ($113.22 in chips) 
Seat 4: karllv ($133.33 in chips) 
Seat 5: Avtovo ($102.72 in chips) 
Seat 6: 23SmOkEr07 ($124.70 in chips) 
Seat 7: Dickyxxx ($154.10 in chips) 
Seat 8: phrantique ($98.50 in chips) 
Seat 9: Filojoes ($130.59 in chips) 
Dickyxxx: posts small blind $0.50
phrantique: posts big blind $1
*** HOLE CARDS ***
Dealt to matiko09 [7h 6d]
Filojoes: folds 
matiko09: folds 
ruslik_by: raises $2 to $3
SkUhNi: folds 
karllv: folds 
Avtovo: folds 
23SmOkEr07: folds 
Dickyxxx: calls $2.50
phrantique: calls $2
*** FLOP *** [Jh Qs 7s]
Dickyxxx: checks 
phrantique: checks 
ruslik_by: checks 
*** TURN *** [Jh Qs 7s] [2s]
Dickyxxx: checks 
phrantique: checks 
ruslik_by: checks 
*** RIVER *** [Jh Qs 7s 2s] [As]
Dickyxxx: checks 
phrantique: checks 
ruslik_by: checks 
*** SHOW DOWN ***
Dickyxxx: shows [Ts Td] (a flush, Ace high)
phrantique: mucks hand 
ruslik_by: mucks hand 
Dickyxxx collected $8.55 from pot
*** SUMMARY ***
Total pot $9 | Rake $0.45 
Board [Jh Qs 7s 2s As]
Seat 1: matiko09 folded before Flop (didn't bet)
Seat 2: ruslik_by mucked [6c 5c]
Seat 3: SkUhNi folded before Flop (didn't bet)
Seat 4: karllv folded before Flop (didn't bet)
Seat 5: Avtovo folded before Flop (didn't bet)
Seat 6: 23SmOkEr07 (button) folded before Flop (didn't bet)
Seat 7: Dickyxxx (small blind) showed [Ts Td] and won ($8.55) with a flush, Ace high
Seat 8: phrantique (big blind) mucked [Qd Kd]
Seat 9: Filojoes folded before Flop (didn't bet)





PokerStars Hand #154970722265:  Hold'em No Limit (£0.25/£0.50 GBP) - 2016/06/20 12:52:34 CET [2016/06/20 6:52:34 ET]
Table 'Tesla' 6-max Seat #1 is the button
Seat 1: Rubleff85 (£45.40 in chips) 
Seat 2: matiko09 (£79.86 in chips) 
Seat 3: asmodej666 (£50.75 in chips) 
Seat 5: Nego Razu (£50 in chips) 
Seat 6: faceMyBallz_ (£52.61 in chips) 
matiko09: posts small blind £0.25
asmodej666: posts big blind £0.50
VahTang_89: sits out 
*** HOLE CARDS ***
Dealt to matiko09 [6d 5s]
Nego Razu: folds 
faceMyBallz_: folds 
Rubleff85: calls £0.50
matiko09: folds 
asmodej666: checks 
*** FLOP *** [Ac 2s Qd]
asmodej666: checks 
Rubleff85: bets £0.50
asmodej666: folds 
Uncalled bet (£0.50) returned to Rubleff85
Rubleff85 collected £1.19 from pot
Rubleff85: doesn't show hand 
*** SUMMARY ***
Total pot £1.25 | Rake £0.06 
Board [Ac 2s Qd]
Seat 1: Rubleff85 (button) collected (£1.19)
Seat 2: matiko09 (small blind) folded before Flop
Seat 3: asmodej666 (big blind) folded on the Flop
Seat 5: Nego Razu folded before Flop (didn't bet)
Seat 6: faceMyBallz_ folded before Flop (didn't bet)





PokerStars Hand #154970722787:  Hold'em No Limit ($0.50/$1.00 USD) - 2016/06/20 12:52:35 CET [2016/06/20 6:52:35 ET]
Table 'Ambrosia II' 9-max Seat #3 is the button
Seat 1: 23SmOkEr07 ($170.25 in chips) 
Seat 2: Eyeballz1307 ($43.55 in chips) 
Seat 3: mavin80 ($89.53 in chips) 
Seat 4: mi$$I$Elena ($196.27 in chips) 
Seat 5: Mattulh ($100 in chips) 
Seat 6: ruslik_by ($107.80 in chips) 
Seat 7: matiko09 ($100 in chips) 
Seat 8: hammerwife ($119.45 in chips) 
Seat 9: SkUhNi ($136.76 in chips) 
mi$$I$Elena: posts small blind $0.50
Mattulh: posts big blind $1
*** HOLE CARDS ***
Dealt to matiko09 [Kd 9h]
ruslik_by: folds 
matiko09: folds 
hammerwife: folds 
SkUhNi: folds 
23SmOkEr07: folds 
Eyeballz1307: folds 
mavin80: folds 
mi$$I$Elena: folds 
Uncalled bet ($0.50) returned to Mattulh
Mattulh collected $1 from pot
Mattulh: doesn't show hand 
*** SUMMARY ***
Total pot $1 | Rake $0 
Seat 1: 23SmOkEr07 folded before Flop (didn't bet)
Seat 2: Eyeballz1307 folded before Flop (didn't bet)
Seat 3: mavin80 (button) folded before Flop (didn't bet)
Seat 4: mi$$I$Elena (small blind) folded before Flop
Seat 5: Mattulh (big blind) collected ($1)
Seat 6: ruslik_by folded before Flop (didn't bet)
Seat 7: matiko09 folded before Flop (didn't bet)
Seat 8: hammerwife folded before Flop (didn't bet)
Seat 9: SkUhNi folded before Flop (didn't bet)





PokerStars Hand #154970723298:  Hold'em No Limit ($0.50/$1.00 USD) - 2016/06/20 12:52:37 CET [2016/06/20 6:52:37 ET]
Table 'Annika' 9-max Seat #2 is the button
Seat 1: hammerwife ($105.77 in chips) 
Seat 2: matiko09 ($105.30 in chips) 
Seat 3: first_dnk ($88.28 in chips) 
Seat 4: Kukuryzka ($100 in chips) 
Seat 5: SkUhNi ($123.63 in chips) 
Seat 6: Pvsx. ($102.55 in chips) 
Seat 8: ruslik_by ($129.55 in chips) 
Seat 9: 23SmOkEr07 ($143.15 in chips) 
first_dnk: posts small blind $0.50
Kukuryzka: posts big blind $1
jirka117: sits out 
*** HOLE CARDS ***
Dealt to matiko09 [7d 2c]
SkUhNi: folds 
Pvsx.: folds 
ruslik_by: folds 
23SmOkEr07: folds 
hammerwife: folds 
matiko09: folds 
first_dnk: raises $1.50 to $2.50
Kukuryzka: folds 
Uncalled bet ($1.50) returned to first_dnk
first_dnk collected $2 from pot
first_dnk: doesn't show hand 
*** SUMMARY ***
Total pot $2 | Rake $0 
Seat 1: hammerwife folded before Flop (didn't bet)
Seat 2: matiko09 (button) folded before Flop (didn't bet)
Seat 3: first_dnk (small blind) collected ($2)
Seat 4: Kukuryzka (big blind) folded before Flop
Seat 5: SkUhNi folded before Flop (didn't bet)
Seat 6: Pvsx. folded before Flop (didn't bet)
Seat 8: ruslik_by folded before Flop (didn't bet)
Seat 9: 23SmOkEr07 folded before Flop (didn't bet)





PokerStars Hand #154970724087:  Hold'em No Limit (£0.25/£0.50 GBP) - 2016/06/20 12:52:39 CET [2016/06/20 6:52:39 ET]
Table 'Azalea' 6-max Seat #3 is the button
Seat 1: mitsuVK (£50.73 in chips) 
Seat 2: matiko09 (£73.86 in chips) 
Seat 3: tyoma_knp (£50 in chips) 
Seat 4: faceMyBallz_ (£107.22 in chips) 
Seat 5: mudders693 (£59.17 in chips) 
Seat 6: Bënedic10 (£70.83 in chips) 
faceMyBallz_: posts small blind £0.25
mudders693: posts big blind £0.50
*** HOLE CARDS ***
Dealt to matiko09 [Kh 8c]
Bënedic10: folds 
mitsuVK: raises £1 to £1.50
matiko09: folds 
tyoma_knp: folds 
faceMyBallz_: calls £1.25
mudders693: folds 
*** FLOP *** [7h 4h 4d]
faceMyBallz_: checks 
mitsuVK: checks 
*** TURN *** [7h 4h 4d] [Qc]
faceMyBallz_: bets £2.50
mitsuVK: calls £2.50
*** RIVER *** [7h 4h 4d Qc] [Qs]
faceMyBallz_: bets £4.50
mitsuVK: raises £42.23 to £46.73 and is all-in
faceMyBallz_: folds 
Uncalled bet (£42.23) returned to mitsuVK
mitsuVK collected £16.62 from pot
mitsuVK: doesn't show hand 
*** SUMMARY ***
Total pot £17.50 | Rake £0.88 
Board [7h 4h 4d Qc Qs]
Seat 1: mitsuVK collected (£16.62)
Seat 2: matiko09 folded before Flop (didn't bet)
Seat 3: tyoma_knp (button) folded before Flop (didn't bet)
Seat 4: faceMyBallz_ (small blind) folded on the River
Seat 5: mudders693 (big blind) folded before Flop
Seat 6: Bënedic10 folded before Flop (didn't bet)





PokerStars Hand #154970725493:  Hold'em No Limit (£0.25/£0.50 GBP) - 2016/06/20 12:52:42 CET [2016/06/20 6:52:42 ET]
Table 'Ani' 6-max Seat #3 is the button
Seat 2: mitsuVK (£66.25 in chips) 
Seat 3: Doobes8555 (£67.90 in chips) 
Seat 4: matiko09 (£55.36 in chips) 
Seat 5: Wwwasian (£57.68 in chips) 
Seat 6: faceMyBallz_ (£57.54 in chips) 
matiko09: posts small blind £0.25
Wwwasian: posts big blind £0.50
asmodej666: sits out 
*** HOLE CARDS ***
Dealt to matiko09 [2s Js]
faceMyBallz_: folds 
mitsuVK: folds 
Doobes8555: raises £1 to £1.50
matiko09: folds 
Wwwasian: folds 
Uncalled bet (£1) returned to Doobes8555
Doobes8555 collected £1.25 from pot
Doobes8555: doesn't show hand 
*** SUMMARY ***
Total pot £1.25 | Rake £0 
Seat 2: mitsuVK folded before Flop (didn't bet)
Seat 3: Doobes8555 (button) collected (£1.25)
Seat 4: matiko09 (small blind) folded before Flop
Seat 5: Wwwasian (big blind) folded before Flop
Seat 6: faceMyBallz_ folded before Flop (didn't bet)





PokerStars Hand #154970726487:  Hold'em No Limit ($0.25/$0.50 USD) - 2016/06/20 12:52:45 CET [2016/06/20 6:52:45 ET]
Table 'Scheddi II' 9-max Seat #9 is the button
Seat 1: matiko09 ($93.90 in chips) 
Seat 2: Yaaaazz ($89.60 in chips) 
Seat 3: mi$$I$Elena ($96 in chips) 
Seat 4: GOOFA13 ($62.72 in chips) 
Seat 5: zarplatka ($40 in chips) 
Seat 6: orochimaturi ($29.55 in chips) 
Seat 7: HopeMayBee ($87.86 in chips) 
Seat 9: Infinitinium ($114.07 in chips) 
matiko09: posts small blind $0.25
Yaaaazz: posts big blind $0.50
Danil27: sits out 
matiko09: posts the ante $0.10
Yaaaazz: posts the ante $0.10
mi$$I$Elena: posts the ante $0.10
GOOFA13: posts the ante $0.10
zarplatka: posts the ante $0.10
orochimaturi: posts the ante $0.10
HopeMayBee: posts the ante $0.10
Infinitinium: posts the ante $0.10
*** HOLE CARDS ***
Dealt to matiko09 [Jd 4d]
mi$$I$Elena: raises $0.69 to $1.19
GOOFA13: calls $1.19
zarplatka: folds 
orochimaturi: folds 
HopeMayBee: folds 
Infinitinium: folds 
matiko09: folds 
Yaaaazz: calls $0.69
*** FLOP *** [6d 3c 9c]
Yaaaazz: checks 
mi$$I$Elena: checks 
GOOFA13: bets $2.50
Yaaaazz: folds 
mi$$I$Elena: calls $2.50
*** TURN *** [6d 3c 9c] [Th]
mi$$I$Elena: checks 
GOOFA13: bets $6.50
mi$$I$Elena: calls $6.50
*** RIVER *** [6d 3c 9c Th] [Jh]
mi$$I$Elena: checks 
GOOFA13: checks 
*** SHOW DOWN ***
mi$$I$Elena: shows [8d 9d] (a pair of Nines)
GOOFA13: shows [Ad 9s] (a pair of Nines - Ace kicker)
GOOFA13 collected $21.49 from pot
*** SUMMARY ***
Total pot $22.62 | Rake $1.13 
Board [6d 3c 9c Th Jh]
Seat 1: matiko09 (small blind) folded before Flop
Seat 2: Yaaaazz (big blind) folded on the Flop
Seat 3: mi$$I$Elena showed [8d 9d] and lost with a pair of Nines
Seat 4: GOOFA13 showed [Ad 9s] and won ($21.49) with a pair of Nines
Seat 5: zarplatka folded before Flop (didn't bet)
Seat 6: orochimaturi folded before Flop (didn't bet)
Seat 7: HopeMayBee folded before Flop (didn't bet)
Seat 9: Infinitinium (button) folded before Flop (didn't bet)





PokerStars Hand #154970728156:  Hold'em No Limit ($0.50/$1.00 USD) - 2016/06/20 12:52:49 CET [2016/06/20 6:52:49 ET]
Table 'Albiorix' 9-max Seat #2 is the button
Seat 2: SkUhNi ($110.62 in chips) 
Seat 3: matiko09 ($125.73 in chips) 
Seat 4: 23SmOkEr07 ($119 in chips) 
Seat 5: ruslik_by ($103 in chips) 
Seat 7: Pekyto ($50.65 in chips) 
Seat 8: smiley0221 ($65.13 in chips) 
Seat 9: DomiVY ($48 in chips) 
matiko09: posts small blind $0.50
23SmOkEr07: posts big blind $1
Filojoes: sits out 
*** HOLE CARDS ***
Dealt to matiko09 [7h Ks]
ruslik_by: folds 
Pekyto: folds 
smiley0221: raises $2 to $3
DomiVY: folds 
SkUhNi: folds 
matiko09: folds 
23SmOkEr07: calls $2
*** FLOP *** [8c 5h Ts]
23SmOkEr07: checks 
smiley0221: checks 
*** TURN *** [8c 5h Ts] [As]
23SmOkEr07: checks 
smiley0221: bets $3
23SmOkEr07: calls $3
*** RIVER *** [8c 5h Ts As] [Jc]
23SmOkEr07: bets $6.65
smiley0221: raises $15.65 to $22.30
23SmOkEr07: calls $15.65
*** SHOW DOWN ***
smiley0221: shows [Kd 7d] (high card Ace)
23SmOkEr07: shows [Ad Jd] (two pair, Aces and Jacks)
23SmOkEr07 collected $54.60 from pot
*** SUMMARY ***
Total pot $57.10 | Rake $2.50 
Board [8c 5h Ts As Jc]
Seat 2: SkUhNi (button) folded before Flop (didn't bet)
Seat 3: matiko09 (small blind) folded before Flop
Seat 4: 23SmOkEr07 (big blind) showed [Ad Jd] and won ($54.60) with two pair, Aces and Jacks
Seat 5: ruslik_by folded before Flop (didn't bet)
Seat 7: Pekyto folded before Flop (didn't bet)
Seat 8: smiley0221 showed [Kd 7d] and lost with high card Ace
Seat 9: DomiVY folded before Flop (didn't bet)





PokerStars Hand #154970729868:  Hold'em No Limit ($0.50/$1.00 USD) - 2016/06/20 12:52:53 CET [2016/06/20 6:52:53 ET]
Table 'Ernestina' 9-max Seat #9 is the button
Seat 1: diva3150 ($130.85 in chips) 
Seat 2: matiko09 ($153.59 in chips) 
Seat 3: Pvsx. ($187.49 in chips) 
Seat 4: SkUhNi ($100 in chips) 
Seat 5: Dickyxxx ($128.10 in chips) 
Seat 8: ruslik_by ($243.03 in chips) 
Seat 9: 23SmOkEr07 ($102.90 in chips) 
diva3150: posts small blind $0.50
matiko09: posts big blind $1
*** HOLE CARDS ***
Dealt to matiko09 [Th Qc]
Pvsx.: folds 
SkUhNi: folds 
Dickyxxx: folds 
ruslik_by: folds 
23SmOkEr07: folds 
diva3150: raises $2 to $3
matiko09: calls $2
*** FLOP *** [4c Kc Ac]
diva3150: bets $5.70
matiko09: calls $5.70
*** TURN *** [4c Kc Ac] [8c]
diva3150: checks 
matiko09: bets $8.59
diva3150: folds 
Uncalled bet ($8.59) returned to matiko09
matiko09 collected $16.53 from pot
matiko09: doesn't show hand 
*** SUMMARY ***
Total pot $17.40 | Rake $0.87 
Board [4c Kc Ac 8c]
Seat 1: diva3150 (small blind) folded on the Turn
Seat 2: matiko09 (big blind) collected ($16.53)
Seat 3: Pvsx. folded before Flop (didn't bet)
Seat 4: SkUhNi folded before Flop (didn't bet)
Seat 5: Dickyxxx folded before Flop (didn't bet)
Seat 8: ruslik_by folded before Flop (didn't bet)
Seat 9: 23SmOkEr07 (button) folded before Flop (didn't bet)





PokerStars Hand #154970730663:  Hold'em No Limit ($0.50/$1.00 USD) - 2016/06/20 12:52:55 CET [2016/06/20 6:52:55 ET]
Table 'Ambrosia II' 9-max Seat #4 is the button
Seat 1: 23SmOkEr07 ($170.25 in chips) 
Seat 2: Eyeballz1307 ($43.55 in chips) 
Seat 3: mavin80 ($89.53 in chips) 
Seat 4: mi$$I$Elena ($195.77 in chips) 
Seat 5: Mattulh ($100.50 in chips) 
Seat 6: ruslik_by ($107.80 in chips) 
Seat 7: matiko09 ($100 in chips) 
Seat 8: hammerwife ($119.45 in chips) 
Seat 9: SkUhNi ($136.76 in chips) 
Mattulh: posts small blind $0.50
ruslik_by: posts big blind $1
*** HOLE CARDS ***
Dealt to matiko09 [6h Js]
matiko09: folds 
hammerwife: folds 
SkUhNi: folds 
23SmOkEr07: folds 
Eyeballz1307: folds 
mavin80: raises $1.50 to $2.50
mi$$I$Elena: folds 
Mattulh: folds 
ruslik_by: calls $1.50
*** FLOP *** [Qh 9c 3c]
ruslik_by: checks 
mavin80: checks 
*** TURN *** [Qh 9c 3c] [Th]
ruslik_by: bets $1.77
mavin80: calls $1.77
*** RIVER *** [Qh 9c 3c Th] [5d]
ruslik_by: checks 
mavin80: checks 
*** SHOW DOWN ***
ruslik_by: shows [Ac 9h] (a pair of Nines)
mavin80: mucks hand 
ruslik_by collected $8.59 from pot
*** SUMMARY ***
Total pot $9.04 | Rake $0.45 
Board [Qh 9c 3c Th 5d]
Seat 1: 23SmOkEr07 folded before Flop (didn't bet)
Seat 2: Eyeballz1307 folded before Flop (didn't bet)
Seat 3: mavin80 mucked [7d 6s]
Seat 4: mi$$I$Elena (button) folded before Flop (didn't bet)
Seat 5: Mattulh (small blind) folded before Flop
Seat 6: ruslik_by (big blind) showed [Ac 9h] and won ($8.59) with a pair of Nines
Seat 7: matiko09 folded before Flop (didn't bet)
Seat 8: hammerwife folded before Flop (didn't bet)
Seat 9: SkUhNi folded before Flop (didn't bet)





PokerStars Hand #154970732978:  Hold'em No Limit (£0.25/£0.50 GBP) - 2016/06/20 12:53:01 CET [2016/06/20 6:53:01 ET]
Table 'Tesla' 6-max Seat #2 is the button
Seat 1: Rubleff85 (£46.09 in chips) 
Seat 2: matiko09 (£79.61 in chips) 
Seat 3: asmodej666 (£50.25 in chips) 
Seat 4: VahTang_89 (£50 in chips) 
Seat 5: Nego Razu (£50 in chips) 
Seat 6: faceMyBallz_ (£52.61 in chips) 
asmodej666: posts small blind £0.25
VahTang_89: posts big blind £0.50
*** HOLE CARDS ***
Dealt to matiko09 [Kh 9c]
Nego Razu: folds 
faceMyBallz_: raises £1 to £1.50
Rubleff85: calls £1.50
matiko09: folds 
asmodej666: folds 
VahTang_89: folds 
*** FLOP *** [Th 2d 9h]
faceMyBallz_: bets £2
Rubleff85: raises £2 to £4
faceMyBallz_: calls £2
*** TURN *** [Th 2d 9h] [Qc]
faceMyBallz_: checks 
Rubleff85: bets £6
faceMyBallz_: calls £6
*** RIVER *** [Th 2d 9h Qc] [4d]
faceMyBallz_: checks 
Rubleff85: bets £13.44
faceMyBallz_: folds 
Uncalled bet (£13.44) returned to Rubleff85
Rubleff85 collected £22.56 from pot
Rubleff85: doesn't show hand 
*** SUMMARY ***
Total pot £23.75 | Rake £1.19 
Board [Th 2d 9h Qc 4d]
Seat 1: Rubleff85 collected (£22.56)
Seat 2: matiko09 (button) folded before Flop (didn't bet)
Seat 3: asmodej666 (small blind) folded before Flop
Seat 4: VahTang_89 (big blind) folded before Flop
Seat 5: Nego Razu folded before Flop (didn't bet)
Seat 6: faceMyBallz_ folded on the River





PokerStars Hand #154970734000:  Hold'em No Limit (£0.25/£0.50 GBP) - 2016/06/20 12:53:04 CET [2016/06/20 6:53:04 ET]
Table 'Ani' 6-max Seat #4 is the button
Seat 2: mitsuVK (£66.25 in chips) 
Seat 3: Doobes8555 (£68.65 in chips) 
Seat 4: matiko09 (£55.11 in chips) 
Seat 5: Wwwasian (£57.18 in chips) 
Seat 6: faceMyBallz_ (£57.54 in chips) 
Wwwasian: posts small blind £0.25
faceMyBallz_: posts big blind £0.50
asmodej666: sits out 
*** HOLE CARDS ***
Dealt to matiko09 [9d Kh]
mitsuVK: folds 
Doobes8555: folds 
matiko09: raises £0.63 to £1.13
Wwwasian: folds 
faceMyBallz_: calls £0.63
*** FLOP *** [6s 5s Kd]
faceMyBallz_: checks 
matiko09: checks 
*** TURN *** [6s 5s Kd] [3c]
faceMyBallz_: checks 
matiko09: bets £1.23
faceMyBallz_: folds 
Uncalled bet (£1.23) returned to matiko09
matiko09 collected £2.38 from pot
matiko09: doesn't show hand 
*** SUMMARY ***
Total pot £2.51 | Rake £0.13 
Board [6s 5s Kd 3c]
Seat 2: mitsuVK folded before Flop (didn't bet)
Seat 3: Doobes8555 folded before Flop (didn't bet)
Seat 4: matiko09 (button) collected (£2.38)
Seat 5: Wwwasian (small blind) folded before Flop
Seat 6: faceMyBallz_ (big blind) folded on the Turn





PokerStars Hand #154970735987:  Hold'em No Limit ($0.50/$1.00 USD) - 2016/06/20 12:53:09 CET [2016/06/20 6:53:09 ET]
Table 'Annika' 9-max Seat #3 is the button
Seat 1: hammerwife ($105.77 in chips) 
Seat 2: matiko09 ($105.30 in chips) 
Seat 3: first_dnk ($89.28 in chips) 
Seat 4: Kukuryzka ($99 in chips) 
Seat 5: SkUhNi ($123.63 in chips) 
Seat 6: Pvsx. ($102.55 in chips) 
Seat 8: ruslik_by ($129.55 in chips) 
Seat 9: 23SmOkEr07 ($143.15 in chips) 
Kukuryzka: posts small blind $0.50
SkUhNi: posts big blind $1
jirka117: sits out 
*** HOLE CARDS ***
Dealt to matiko09 [6c Qs]
Pvsx.: folds 
ruslik_by: folds 
23SmOkEr07: folds 
hammerwife: folds 
matiko09: folds 
first_dnk: folds 
Kukuryzka: raises $1.50 to $2.50
SkUhNi: folds 
Uncalled bet ($1.50) returned to Kukuryzka
Kukuryzka collected $2 from pot
Kukuryzka: doesn't show hand 
*** SUMMARY ***
Total pot $2 | Rake $0 
Seat 1: hammerwife folded before Flop (didn't bet)
Seat 2: matiko09 folded before Flop (didn't bet)
Seat 3: first_dnk (button) folded before Flop (didn't bet)
Seat 4: Kukuryzka (small blind) collected ($2)
Seat 5: SkUhNi (big blind) folded before Flop
Seat 6: Pvsx. folded before Flop (didn't bet)
Seat 8: ruslik_by folded before Flop (didn't bet)
Seat 9: 23SmOkEr07 folded before Flop (didn't bet)





PokerStars Hand #154970736836:  Hold'em No Limit ($0.50/$1.00 USD) - 2016/06/20 12:53:11 CET [2016/06/20 6:53:11 ET]
Table 'Isonoe II' 9-max Seat #7 is the button
Seat 1: hammerwife ($100 in chips) 
Seat 2: matiko09 ($122.26 in chips) 
Seat 3: Kukuryzka ($100 in chips) 
Seat 4: Avtovo ($103.50 in chips) 
Seat 5: Filojoes ($109 in chips) 
Seat 6: GOOFA13 ($61.96 in chips) 
Seat 7: SkUhNi ($112.32 in chips) 
Seat 8: lewyson ($76.40 in chips) 
Seat 9: djammusic ($65.95 in chips) 
lewyson: posts small blind $0.50
djammusic: posts big blind $1
*** HOLE CARDS ***
Dealt to matiko09 [9c Ad]
hammerwife: folds 
matiko09: folds 
Kukuryzka: folds 
Avtovo: folds 
Filojoes: raises $2 to $3
GOOFA13: folds 
SkUhNi: folds 
lewyson: calls $2.50
djammusic: folds 
*** FLOP *** [6c Ks 6s]
lewyson: bets $4
Filojoes: calls $4
*** TURN *** [6c Ks 6s] [5d]
lewyson: checks 
Filojoes: checks 
*** RIVER *** [6c Ks 6s 5d] [4s]
lewyson: bets $6
Filojoes: folds 
Uncalled bet ($6) returned to lewyson
lewyson collected $14.25 from pot
*** SUMMARY ***
Total pot $15 | Rake $0.75 
Board [6c Ks 6s 5d 4s]
Seat 1: hammerwife folded before Flop (didn't bet)
Seat 2: matiko09 folded before Flop (didn't bet)
Seat 3: Kukuryzka folded before Flop (didn't bet)
Seat 4: Avtovo folded before Flop (didn't bet)
Seat 5: Filojoes folded on the River
Seat 6: GOOFA13 folded before Flop (didn't bet)
Seat 7: SkUhNi (button) folded before Flop (didn't bet)
Seat 8: lewyson (small blind) collected ($14.25)
Seat 9: djammusic (big blind) folded before Flop





PokerStars Hand #154970738572:  Hold'em No Limit (€0.25/€0.50 EUR) - 2016/06/20 12:53:16 CET [2016/06/20 6:53:16 ET]
Table 'Bechuana' 6-max Seat #5 is the button
Seat 1: zitagirl (€48.60 in chips) 
Seat 2: matiko09 (€50 in chips) 
Seat 3: Aju!ntje (€67.10 in chips) 
Seat 4: Wwwasian (€54.08 in chips) 
Seat 5: fanmtZ (€31.82 in chips) 
SlayersGBG will be allowed to play after the button
zitagirl: posts small blind €0.25
matiko09: posts big blind €0.50
*** HOLE CARDS ***
Dealt to matiko09 [9s 5c]
Aju!ntje: folds 
Wwwasian: folds 
fanmtZ: raises €0.79 to €1.29
zitagirl: calls €1.04
matiko09: folds 
*** FLOP *** [Qc Kd 9c]
zitagirl: checks 
fanmtZ: checks 
*** TURN *** [Qc Kd 9c] [Jh]
zitagirl: checks 
fanmtZ: bets €2
zitagirl: folds 
Uncalled bet (€2) returned to fanmtZ
fanmtZ collected €2.93 from pot
fanmtZ: doesn't show hand 
*** SUMMARY ***
Total pot €3.08 | Rake €0.15 
Board [Qc Kd 9c Jh]
Seat 1: zitagirl (small blind) folded on the Turn
Seat 2: matiko09 (big blind) folded before Flop
Seat 3: Aju!ntje folded before Flop (didn't bet)
Seat 4: Wwwasian folded before Flop (didn't bet)
Seat 5: fanmtZ (button) collected (€2.93)





PokerStars Hand #154970747833:  Hold'em No Limit ($0.50/$1.00 USD) - 2016/06/20 12:53:39 CET [2016/06/20 6:53:39 ET]
Table 'Ernestina' 9-max Seat #1 is the button
Seat 1: diva3150 ($122.15 in chips) 
Seat 2: matiko09 ($161.42 in chips) 
Seat 3: Pvsx. ($187.49 in chips) 
Seat 4: SkUhNi ($100 in chips) 
Seat 5: Dickyxxx ($128.10 in chips) 
Seat 8: ruslik_by ($243.03 in chips) 
Seat 9: 23SmOkEr07 ($102.90 in chips) 
matiko09: posts small blind $0.50
Pvsx.: posts big blind $1
*** HOLE CARDS ***
Dealt to matiko09 [4d Ks]
SkUhNi: raises $2 to $3
Dickyxxx: calls $3
ruslik_by: folds 
23SmOkEr07: calls $3
diva3150: folds 
matiko09: folds 
Pvsx.: folds 
*** FLOP *** [8c 9d 7c]
SkUhNi: checks 
Dickyxxx: bets $6.38
23SmOkEr07: folds 
SkUhNi: folds 
Uncalled bet ($6.38) returned to Dickyxxx
Dickyxxx collected $9.98 from pot
Dickyxxx: doesn't show hand 
*** SUMMARY ***
Total pot $10.50 | Rake $0.52 
Board [8c 9d 7c]
Seat 1: diva3150 (button) folded before Flop (didn't bet)
Seat 2: matiko09 (small blind) folded before Flop
Seat 3: Pvsx. (big blind) folded before Flop
Seat 4: SkUhNi folded on the Flop
Seat 5: Dickyxxx collected ($9.98)
Seat 8: ruslik_by folded before Flop (didn't bet)
Seat 9: 23SmOkEr07 folded on the Flop





PokerStars Hand #154970750665:  Hold'em No Limit ($0.50/$1.00 USD) - 2016/06/20 12:53:46 CET [2016/06/20 6:53:46 ET]
Table 'Annika' 9-max Seat #4 is the button
Seat 1: hammerwife ($105.77 in chips) 
Seat 2: matiko09 ($105.30 in chips) 
Seat 3: first_dnk ($89.28 in chips) 
Seat 4: Kukuryzka ($100 in chips) 
Seat 5: SkUhNi ($122.63 in chips) 
Seat 6: Pvsx. ($102.55 in chips) 
Seat 8: ruslik_by ($129.55 in chips) 
Seat 9: 23SmOkEr07 ($143.15 in chips) 
SkUhNi: posts small blind $0.50
Pvsx.: posts big blind $1
jirka117: sits out 
*** HOLE CARDS ***
Dealt to matiko09 [6h 7s]
ruslik_by: folds 
23SmOkEr07: folds 
hammerwife: folds 
matiko09: folds 
first_dnk: folds 
Kukuryzka: raises $1 to $2
SkUhNi: folds 
Pvsx.: folds 
Uncalled bet ($1) returned to Kukuryzka
Kukuryzka collected $2.50 from pot
Kukuryzka: doesn't show hand 
*** SUMMARY ***
Total pot $2.50 | Rake $0 
Seat 1: hammerwife folded before Flop (didn't bet)
Seat 2: matiko09 folded before Flop (didn't bet)
Seat 3: first_dnk folded before Flop (didn't bet)
Seat 4: Kukuryzka (button) collected ($2.50)
Seat 5: SkUhNi (small blind) folded before Flop
Seat 6: Pvsx. (big blind) folded before Flop
Seat 8: ruslik_by folded before Flop (didn't bet)
Seat 9: 23SmOkEr07 folded before Flop (didn't bet)





PokerStars Hand #154970755038:  Hold'em No Limit ($0.50/$1.00 USD) - 2016/06/20 12:53:57 CET [2016/06/20 6:53:57 ET]
Table 'Albiorix' 9-max Seat #3 is the button
Seat 2: SkUhNi ($110.62 in chips) 
Seat 3: matiko09 ($125.23 in chips) 
Seat 4: 23SmOkEr07 ($145.30 in chips) 
Seat 5: ruslik_by ($103 in chips) 
Seat 7: Pekyto ($50.65 in chips) 
Seat 8: smiley0221 ($36.83 in chips) 
Seat 9: DomiVY ($48 in chips) 
23SmOkEr07: posts small blind $0.50
ruslik_by: posts big blind $1
Filojoes: sits out 
*** HOLE CARDS ***
Dealt to matiko09 [2s 4d]
Pekyto: folds 
smiley0221: folds 
DomiVY: folds 
SkUhNi: folds 
matiko09: folds 
23SmOkEr07: raises $1.50 to $2.50
ruslik_by: raises $6 to $8.50
23SmOkEr07: folds 
Uncalled bet ($6) returned to ruslik_by
ruslik_by collected $5 from pot
ruslik_by: doesn't show hand 
*** SUMMARY ***
Total pot $5 | Rake $0 
Seat 2: SkUhNi folded before Flop (didn't bet)
Seat 3: matiko09 (button) folded before Flop (didn't bet)
Seat 4: 23SmOkEr07 (small blind) folded before Flop
Seat 5: ruslik_by (big blind) collected ($5)
Seat 7: Pekyto folded before Flop (didn't bet)
Seat 8: smiley0221 folded before Flop (didn't bet)
Seat 9: DomiVY folded before Flop (didn't bet)





PokerStars Hand #154970756095:  Hold'em No Limit ($0.50/$1.00 USD) - 2016/06/20 12:54:00 CET [2016/06/20 6:54:00 ET]
Table 'Anhui' 9-max Seat #7 is the button
Seat 1: SkUhNi ($161.88 in chips) 
Seat 2: ruslik_by ($264.68 in chips) 
Seat 3: hammerwife ($166.73 in chips) 
Seat 4: mavin80 ($107.20 in chips) 
Seat 5: mi$$I$Elena ($103.30 in chips) 
Seat 6: 23SmOkEr07 ($117.68 in chips) 
Seat 7: matiko09 ($121.98 in chips) 
Seat 8: blackmont111 ($63 in chips) 
Seat 9: TomBod1 ($89.03 in chips) 
blackmont111: posts small blind $0.50
TomBod1: posts big blind $1
*** HOLE CARDS ***
Dealt to matiko09 [Js Th]
SkUhNi: folds 
ruslik_by: folds 
hammerwife: folds 
mavin80: folds 
mi$$I$Elena: folds 
23SmOkEr07: raises $1.50 to $2.50
matiko09: folds 
blackmont111: folds 
mavin80 leaves the table
TomBod1: folds 
Uncalled bet ($1.50) returned to 23SmOkEr07
Yaaaazz joins the table at seat #4 
23SmOkEr07 collected $2.50 from pot
23SmOkEr07: doesn't show hand 
*** SUMMARY ***
Total pot $2.50 | Rake $0 
Seat 1: SkUhNi folded before Flop (didn't bet)
Seat 2: ruslik_by folded before Flop (didn't bet)
Seat 3: hammerwife folded before Flop (didn't bet)
Seat 4: mavin80 folded before Flop (didn't bet)
Seat 5: mi$$I$Elena folded before Flop (didn't bet)
Seat 6: 23SmOkEr07 collected ($2.50)
Seat 7: matiko09 (button) folded before Flop (didn't bet)
Seat 8: blackmont111 (small blind) folded before Flop
Seat 9: TomBod1 (big blind) folded before Flop





PokerStars Hand #154970756972:  Hold'em No Limit ($0.50/$1.00 USD) - 2016/06/20 12:54:02 CET [2016/06/20 6:54:02 ET]
Table 'Garumna II' 9-max Seat #2 is the button
Seat 1: ki11u ($140 in chips) 
Seat 2: Racushniak ($100 in chips) 
Seat 3: mooose100 ($79.38 in chips) 
Seat 4: Ndundun Gipe ($33.50 in chips) 
Seat 5: rura53 ($78 in chips) 
Seat 6: SexyAngeline ($52.57 in chips) 
Seat 7: Avtovo ($100 in chips) 
Seat 8: matiko09 ($109.52 in chips) 
Seat 9: SkUhNi ($102.30 in chips) 
mooose100: posts small blind $0.50
Ndundun Gipe: posts big blind $1
*** HOLE CARDS ***
Dealt to matiko09 [6d 8c]
rura53: folds 
SexyAngeline: folds 
Avtovo: folds 
matiko09: folds 
SkUhNi: folds 
ki11u: raises $1.55 to $2.55
Racushniak: folds 
mooose100: folds 
Ndundun Gipe: folds 
Uncalled bet ($1.55) returned to ki11u
ki11u collected $2.50 from pot
ki11u: doesn't show hand 
*** SUMMARY ***
Total pot $2.50 | Rake $0 
Seat 1: ki11u collected ($2.50)
Seat 2: Racushniak (button) folded before Flop (didn't bet)
Seat 3: mooose100 (small blind) folded before Flop
Seat 4: Ndundun Gipe (big blind) folded before Flop
Seat 5: rura53 folded before Flop (didn't bet)
Seat 6: SexyAngeline folded before Flop (didn't bet)
Seat 7: Avtovo folded before Flop (didn't bet)
Seat 8: matiko09 folded before Flop (didn't bet)
Seat 9: SkUhNi folded before Flop (didn't bet)





PokerStars Hand #154970757129:  Hold'em No Limit ($0.50/$1.00 USD) - 2016/06/20 12:54:02 CET [2016/06/20 6:54:02 ET]
Table 'Normannia' 9-max Seat #2 is the button
Seat 1: hammerwife ($123.22 in chips) 
Seat 2: Pvsx. ($186.62 in chips) 
Seat 3: Avtovo ($100 in chips) 
Seat 4: Filojoes ($108.39 in chips) 
Seat 5: Dickyxxx ($117.19 in chips) 
Seat 6: typename27 ($75.09 in chips) 
Seat 7: matiko09 ($100 in chips) 
Seat 8: SkUhNi ($140.24 in chips) 
Seat 9: ruslik_by ($146.19 in chips) 
Avtovo: posts small blind $0.50
Filojoes: posts big blind $1
*** HOLE CARDS ***
Dealt to matiko09 [7h As]
Dickyxxx: folds 
typename27 has timed out
typename27: folds 
matiko09: folds 
SkUhNi: folds 
ruslik_by: folds 
hammerwife: folds 
Pvsx.: raises $1.50 to $2.50
Avtovo: folds 
Filojoes: calls $1.50
*** FLOP *** [Qh 9d 8d]
Filojoes: checks 
Pvsx.: bets $3
Filojoes: folds 
Uncalled bet ($3) returned to Pvsx.
Pvsx. collected $5.22 from pot
Pvsx.: doesn't show hand 
*** SUMMARY ***
Total pot $5.50 | Rake $0.28 
Board [Qh 9d 8d]
Seat 1: hammerwife folded before Flop (didn't bet)
Seat 2: Pvsx. (button) collected ($5.22)
Seat 3: Avtovo (small blind) folded before Flop
Seat 4: Filojoes (big blind) folded on the Flop
Seat 5: Dickyxxx folded before Flop (didn't bet)
Seat 6: typename27 folded before Flop (didn't bet)
Seat 7: matiko09 folded before Flop (didn't bet)
Seat 8: SkUhNi folded before Flop (didn't bet)
Seat 9: ruslik_by folded before Flop (didn't bet)





PokerStars Hand #154970759030:  Hold'em No Limit (£0.25/£0.50 GBP) - 2016/06/20 12:54:07 CET [2016/06/20 6:54:07 ET]
Table 'Ani' 6-max Seat #5 is the button
Seat 1: asmodej666 (£50 in chips) 
Seat 2: mitsuVK (£66.25 in chips) 
Seat 3: Doobes8555 (£68.65 in chips) 
Seat 4: matiko09 (£56.36 in chips) 
Seat 5: Wwwasian (£56.93 in chips) 
Seat 6: faceMyBallz_ (£56.41 in chips) 
faceMyBallz_: posts small blind £0.25
asmodej666: posts big blind £0.50
*** HOLE CARDS ***
Dealt to matiko09 [As Js]
mitsuVK: raises £1 to £1.50
Doobes8555: folds 
matiko09: calls £1.50
Wwwasian: folds 
faceMyBallz_: folds 
asmodej666: folds 
*** FLOP *** [Ah 2d 7s]
mitsuVK: bets £1.50
matiko09: calls £1.50
*** TURN *** [Ah 2d 7s] [7d]
mitsuVK: checks 
matiko09: checks 
*** RIVER *** [Ah 2d 7s 7d] [Ts]
mitsuVK: checks 
matiko09: bets £2.50
mitsuVK: folds 
Uncalled bet (£2.50) returned to matiko09
matiko09 collected £6.41 from pot
matiko09: doesn't show hand 
*** SUMMARY ***
Total pot £6.75 | Rake £0.34 
Board [Ah 2d 7s 7d Ts]
Seat 1: asmodej666 (big blind) folded before Flop
Seat 2: mitsuVK folded on the River
Seat 3: Doobes8555 folded before Flop (didn't bet)
Seat 4: matiko09 collected (£6.41)
Seat 5: Wwwasian (button) folded before Flop (didn't bet)
Seat 6: faceMyBallz_ (small blind) folded before Flop





PokerStars Hand #154970759698:  Hold'em No Limit ($0.50/$1.00 USD) - 2016/06/20 12:54:09 CET [2016/06/20 6:54:09 ET]
Table 'Pongola' 9-max Seat #7 is the button
Seat 1: matiko09 ($100 in chips) 
Seat 2: ruslik_by ($126.27 in chips) 
Seat 3: SkUhNi ($113.22 in chips) 
Seat 4: karllv ($133.33 in chips) 
Seat 5: Avtovo ($102.72 in chips) 
Seat 6: 23SmOkEr07 ($124.70 in chips) 
Seat 7: Dickyxxx ($159.65 in chips) 
Seat 8: phrantique ($95.50 in chips) 
Seat 9: Filojoes ($130.59 in chips) 
phrantique: posts small blind $0.50
Filojoes: posts big blind $1
*** HOLE CARDS ***
Dealt to matiko09 [3h 8h]
matiko09: folds 
ruslik_by: raises $2 to $3
SkUhNi: folds 
karllv: folds 
Avtovo: folds 
23SmOkEr07: folds 
Dickyxxx: folds 
phrantique: folds 
Filojoes: folds 
Uncalled bet ($2) returned to ruslik_by
ruslik_by collected $2.50 from pot
ruslik_by: doesn't show hand 
*** SUMMARY ***
Total pot $2.50 | Rake $0 
Seat 1: matiko09 folded before Flop (didn't bet)
Seat 2: ruslik_by collected ($2.50)
Seat 3: SkUhNi folded before Flop (didn't bet)
Seat 4: karllv folded before Flop (didn't bet)
Seat 5: Avtovo folded before Flop (didn't bet)
Seat 6: 23SmOkEr07 folded before Flop (didn't bet)
Seat 7: Dickyxxx (button) folded before Flop (didn't bet)
Seat 8: phrantique (small blind) folded before Flop
Seat 9: Filojoes (big blind) folded before Flop





PokerStars Hand #154970759832:  Hold'em No Limit ($0.50/$1.00 USD) - 2016/06/20 12:54:09 CET [2016/06/20 6:54:09 ET]
Table 'Isonoe II' 9-max Seat #8 is the button
Seat 1: hammerwife ($100 in chips) 
Seat 2: matiko09 ($122.26 in chips) 
Seat 3: Kukuryzka ($100 in chips) 
Seat 4: Avtovo ($103.50 in chips) 
Seat 5: Filojoes ($102 in chips) 
Seat 6: GOOFA13 ($61.96 in chips) 
Seat 7: SkUhNi ($112.32 in chips) 
Seat 8: lewyson ($83.65 in chips) 
Seat 9: djammusic ($64.95 in chips) 
djammusic: posts small blind $0.50
hammerwife: posts big blind $1
*** HOLE CARDS ***
Dealt to matiko09 [Js 9s]
matiko09: folds 
Kukuryzka: folds 
Avtovo: folds 
Filojoes: folds 
GOOFA13: folds 
SkUhNi: raises $1.50 to $2.50
lewyson: folds 
djammusic: folds 
hammerwife: folds 
Uncalled bet ($1.50) returned to SkUhNi
SkUhNi collected $2.50 from pot
SkUhNi: doesn't show hand 
*** SUMMARY ***
Total pot $2.50 | Rake $0 
Seat 1: hammerwife (big blind) folded before Flop
Seat 2: matiko09 folded before Flop (didn't bet)
Seat 3: Kukuryzka folded before Flop (didn't bet)
Seat 4: Avtovo folded before Flop (didn't bet)
Seat 5: Filojoes folded before Flop (didn't bet)
Seat 6: GOOFA13 folded before Flop (didn't bet)
Seat 7: SkUhNi collected ($2.50)
Seat 8: lewyson (button) folded before Flop (didn't bet)
Seat 9: djammusic (small blind) folded before Flop





PokerStars Hand #154970760950:  Hold'em No Limit ($0.50/$1.00 USD) - 2016/06/20 12:54:12 CET [2016/06/20 6:54:12 ET]
Table 'Annika' 9-max Seat #5 is the button
Seat 1: hammerwife ($105.77 in chips) 
Seat 2: matiko09 ($105.30 in chips) 
Seat 3: first_dnk ($89.28 in chips) 
Seat 4: Kukuryzka ($101.50 in chips) 
Seat 5: SkUhNi ($122.13 in chips) 
Seat 6: Pvsx. ($101.55 in chips) 
Seat 7: jirka117 ($39.45 in chips) 
Seat 8: ruslik_by ($129.55 in chips) 
Seat 9: 23SmOkEr07 ($143.15 in chips) 
Pvsx.: posts small blind $0.50
jirka117: posts big blind $1
*** HOLE CARDS ***
Dealt to matiko09 [Ad 2d]
ruslik_by: raises $2 to $3
23SmOkEr07: folds 
hammerwife: folds 
matiko09: folds 
first_dnk: folds 
Kukuryzka: folds 
SkUhNi: calls $3
Pvsx.: folds 
jirka117: calls $2
*** FLOP *** [9s Td 9c]
jirka117: checks 
ruslik_by: bets $3.06
SkUhNi: folds 
jirka117: calls $3.06
*** TURN *** [9s Td 9c] [3c]
jirka117: checks 
ruslik_by: checks 
*** RIVER *** [9s Td 9c 3c] [8c]
jirka117: bets $7.42
ruslik_by: folds 
Uncalled bet ($7.42) returned to jirka117
jirka117 collected $14.84 from pot
*** SUMMARY ***
Total pot $15.62 | Rake $0.78 
Board [9s Td 9c 3c 8c]
Seat 1: hammerwife folded before Flop (didn't bet)
Seat 2: matiko09 folded before Flop (didn't bet)
Seat 3: first_dnk folded before Flop (didn't bet)
Seat 4: Kukuryzka folded before Flop (didn't bet)
Seat 5: SkUhNi (button) folded on the Flop
Seat 6: Pvsx. (small blind) folded before Flop
Seat 7: jirka117 (big blind) collected ($14.84)
Seat 8: ruslik_by folded on the River
Seat 9: 23SmOkEr07 folded before Flop (didn't bet)





PokerStars Hand #154970764729:  Hold'em No Limit (£0.25/£0.50 GBP) - 2016/06/20 12:54:22 CET [2016/06/20 6:54:22 ET]
Table 'Azalea' 6-max Seat #4 is the button
Seat 1: mitsuVK (£58.85 in chips) 
Seat 2: matiko09 (£73.86 in chips) 
Seat 3: tyoma_knp (£50 in chips) 
Seat 4: faceMyBallz_ (£98.72 in chips) 
Seat 5: mudders693 (£58.67 in chips) 
Seat 6: Bënedic10 (£70.83 in chips) 
mudders693: posts small blind £0.25
Bënedic10: posts big blind £0.50
*** HOLE CARDS ***
Dealt to matiko09 [6d 3s]
mitsuVK: raises £1 to £1.50
matiko09: folds 
tyoma_knp: folds 
faceMyBallz_: folds 
mudders693: raises £3 to £4.50
Bënedic10: folds 
mitsuVK: calls £3
*** FLOP *** [4d Ad As]
mudders693: bets £6
mitsuVK: folds 
Uncalled bet (£6) returned to mudders693
mudders693 collected £9.02 from pot
mudders693: doesn't show hand 
*** SUMMARY ***
Total pot £9.50 | Rake £0.48 
Board [4d Ad As]
Seat 1: mitsuVK folded on the Flop
Seat 2: matiko09 folded before Flop (didn't bet)
Seat 3: tyoma_knp folded before Flop (didn't bet)
Seat 4: faceMyBallz_ (button) folded before Flop (didn't bet)
Seat 5: mudders693 (small blind) collected (£9.02)
Seat 6: Bënedic10 (big blind) folded before Flop





PokerStars Hand #154970765851:  Hold'em No Limit (£0.25/£0.50 GBP) - 2016/06/20 12:54:25 CET [2016/06/20 6:54:25 ET]
Table 'Tesla' 6-max Seat #3 is the button
Seat 1: Rubleff85 (£57.15 in chips) 
Seat 2: matiko09 (£79.61 in chips) 
Seat 3: asmodej666 (£50 in chips) 
Seat 4: VahTang_89 (£50 in chips) 
Seat 5: Nego Razu (£50 in chips) 
Seat 6: faceMyBallz_ (£50 in chips) 
VahTang_89: posts small blind £0.25
Nego Razu: posts big blind £0.50
*** HOLE CARDS ***
Dealt to matiko09 [Jh 8c]
faceMyBallz_: folds 
Rubleff85: folds 
matiko09: folds 
asmodej666: raises £0.62 to £1.12
VahTang_89: raises £3.13 to £4.25
Nego Razu: folds 
asmodej666: folds 
Uncalled bet (£3.13) returned to VahTang_89
VahTang_89 collected £2.74 from pot
VahTang_89: doesn't show hand 
*** SUMMARY ***
Total pot £2.74 | Rake £0 
Seat 1: Rubleff85 folded before Flop (didn't bet)
Seat 2: matiko09 folded before Flop (didn't bet)
Seat 3: asmodej666 (button) folded before Flop
Seat 4: VahTang_89 (small blind) collected (£2.74)
Seat 5: Nego Razu (big blind) folded before Flop
Seat 6: faceMyBallz_ folded before Flop (didn't bet)





PokerStars Hand #154970768364:  Hold'em No Limit ($0.50/$1.00 USD) - 2016/06/20 12:54:31 CET [2016/06/20 6:54:31 ET]
Table 'Ernestina' 9-max Seat #2 is the button
Seat 1: diva3150 ($122.15 in chips) 
Seat 2: matiko09 ($160.92 in chips) 
Seat 3: Pvsx. ($186.49 in chips) 
Seat 4: SkUhNi ($100 in chips) 
Seat 5: Dickyxxx ($135.08 in chips) 
Seat 8: ruslik_by ($243.03 in chips) 
Seat 9: 23SmOkEr07 ($100 in chips) 
Pvsx.: posts small blind $0.50
SkUhNi: posts big blind $1
*** HOLE CARDS ***
Dealt to matiko09 [As 2h]
Dickyxxx: raises $2 to $3
ruslik_by: folds 
23SmOkEr07: folds 
diva3150: calls $3
matiko09: folds 
Pvsx.: folds 
SkUhNi: folds 
*** FLOP *** [6h Qd 5c]
Dickyxxx: bets $3.70
diva3150: folds 
Uncalled bet ($3.70) returned to Dickyxxx
Dickyxxx collected $7.12 from pot
Dickyxxx: doesn't show hand 
*** SUMMARY ***
Total pot $7.50 | Rake $0.38 
Board [6h Qd 5c]
Seat 1: diva3150 folded on the Flop
Seat 2: matiko09 (button) folded before Flop (didn't bet)
Seat 3: Pvsx. (small blind) folded before Flop
Seat 4: SkUhNi (big blind) folded before Flop
Seat 5: Dickyxxx collected ($7.12)
Seat 8: ruslik_by folded before Flop (didn't bet)
Seat 9: 23SmOkEr07 folded before Flop (didn't bet)





PokerStars Hand #154970768791:  Hold'em No Limit ($0.50/$1.00 USD) - 2016/06/20 12:54:32 CET [2016/06/20 6:54:32 ET]
Table 'Ambrosia II' 9-max Seat #5 is the button
Seat 1: 23SmOkEr07 ($170.25 in chips) 
Seat 2: Eyeballz1307 ($43.55 in chips) 
Seat 3: mavin80 ($85.26 in chips) 
Seat 4: mi$$I$Elena ($195.77 in chips) 
Seat 5: Mattulh ($100 in chips) 
Seat 6: ruslik_by ($112.12 in chips) 
Seat 7: matiko09 ($100 in chips) 
Seat 8: hammerwife ($119.45 in chips) 
Seat 9: SkUhNi ($136.76 in chips) 
ruslik_by: posts small blind $0.50
matiko09: posts big blind $1
*** HOLE CARDS ***
Dealt to matiko09 [8s 4h]
hammerwife: folds 
SkUhNi: folds 
23SmOkEr07: folds 
Eyeballz1307: folds 
mavin80: folds 
mavin80 leaves the table
Filojoes joins the table at seat #3 
mi$$I$Elena: folds 
Mattulh: folds 
ruslik_by: folds 
Uncalled bet ($0.50) returned to matiko09
matiko09 collected $1 from pot
matiko09: doesn't show hand 
*** SUMMARY ***
Total pot $1 | Rake $0 
Seat 1: 23SmOkEr07 folded before Flop (didn't bet)
Seat 2: Eyeballz1307 folded before Flop (didn't bet)
Seat 3: mavin80 folded before Flop (didn't bet)
Seat 4: mi$$I$Elena folded before Flop (didn't bet)
Seat 5: Mattulh (button) folded before Flop (didn't bet)
Seat 6: ruslik_by (small blind) folded before Flop
Seat 7: matiko09 (big blind) collected ($1)
Seat 8: hammerwife folded before Flop (didn't bet)
Seat 9: SkUhNi folded before Flop (didn't bet)





PokerStars Hand #154970770449:  Hold'em No Limit (€0.25/€0.50 EUR) - 2016/06/20 12:54:36 CET [2016/06/20 6:54:36 ET]
Table 'Bechuana' 6-max Seat #1 is the button
Seat 1: zitagirl (€47.31 in chips) 
Seat 2: matiko09 (€50 in chips) 
Seat 3: Aju!ntje (€67.10 in chips) 
Seat 4: Wwwasian (€54.08 in chips) 
Seat 5: fanmtZ (€33.46 in chips) 
matiko09: posts small blind €0.25
Aju!ntje: posts big blind €0.50
SlayersGBG: sits out 
*** HOLE CARDS ***
Dealt to matiko09 [6c Ac]
Wwwasian: folds 
fanmtZ: raises €0.69 to €1.19
zitagirl: raises €3.13 to €4.32
matiko09: folds 
Aju!ntje: folds 
fanmtZ: calls €3.13
*** FLOP *** [Jd As 9s]
fanmtZ: checks 
zitagirl: bets €0.50
fanmtZ: raises €9.42 to €9.92
zitagirl: calls €9.42
*** TURN *** [Jd As 9s] [7s]
fanmtZ: bets €19.22 and is all-in
zitagirl: folds 
Uncalled bet (€19.22) returned to fanmtZ
fanmtZ collected €27.77 from pot
fanmtZ: doesn't show hand 
*** SUMMARY ***
Total pot €29.23 | Rake €1.46 
Board [Jd As 9s 7s]
Seat 1: zitagirl (button) folded on the Turn
Seat 2: matiko09 (small blind) folded before Flop
Seat 3: Aju!ntje (big blind) folded before Flop
Seat 4: Wwwasian folded before Flop (didn't bet)
Seat 5: fanmtZ collected (€27.77)





PokerStars Hand #154970771163:  Hold'em No Limit ($0.50/$1.00 USD) - 2016/06/20 12:54:38 CET [2016/06/20 6:54:38 ET]
Table 'Albiorix' 9-max Seat #4 is the button
Seat 2: SkUhNi ($110.62 in chips) 
Seat 3: matiko09 ($125.23 in chips) 
Seat 4: 23SmOkEr07 ($142.80 in chips) 
Seat 5: ruslik_by ($105.50 in chips) 
Seat 6: Filojoes ($100 in chips) 
Seat 7: Pekyto ($50.65 in chips) 
Seat 8: smiley0221 ($36.83 in chips) 
Seat 9: DomiVY ($48 in chips) 
ruslik_by: posts small blind $0.50
Filojoes: posts big blind $1
*** HOLE CARDS ***
Dealt to matiko09 [9c Td]
Pekyto: folds 
smiley0221: folds 
DomiVY: raises $2 to $3
SkUhNi: folds 
matiko09: folds 
23SmOkEr07: folds 
ruslik_by: folds 
Filojoes: folds 
Uncalled bet ($2) returned to DomiVY
DomiVY collected $2.50 from pot
DomiVY: doesn't show hand 
*** SUMMARY ***
Total pot $2.50 | Rake $0 
Seat 2: SkUhNi folded before Flop (didn't bet)
Seat 3: matiko09 folded before Flop (didn't bet)
Seat 4: 23SmOkEr07 (button) folded before Flop (didn't bet)
Seat 5: ruslik_by (small blind) folded before Flop
Seat 6: Filojoes (big blind) folded before Flop
Seat 7: Pekyto folded before Flop (didn't bet)
Seat 8: smiley0221 folded before Flop (didn't bet)
Seat 9: DomiVY collected ($2.50)





PokerStars Hand #154970771164:  Hold'em No Limit ($0.50/$1.00 USD) - 2016/06/20 12:54:38 CET [2016/06/20 6:54:38 ET]
Table 'Pongola' 9-max Seat #8 is the button
Seat 1: matiko09 ($100 in chips) 
Seat 2: ruslik_by ($127.77 in chips) 
Seat 3: SkUhNi ($113.22 in chips) 
Seat 4: karllv ($133.33 in chips) 
Seat 5: Avtovo ($102.72 in chips) 
Seat 6: 23SmOkEr07 ($124.70 in chips) 
Seat 7: Dickyxxx ($159.65 in chips) 
Seat 8: phrantique ($95 in chips) 
Seat 9: Filojoes ($129.59 in chips) 
Filojoes: posts small blind $0.50
matiko09: posts big blind $1
*** HOLE CARDS ***
Dealt to matiko09 [Jh Ad]
ruslik_by: folds 
SkUhNi: folds 
karllv: folds 
Avtovo: folds 
23SmOkEr07: folds 
Dickyxxx: folds 
phrantique: raises $2 to $3
Filojoes: folds 
matiko09: raises $7 to $10
phrantique: calls $7
*** FLOP *** [9h Qs Ac]
matiko09: checks 
phrantique: checks 
*** TURN *** [9h Qs Ac] [Ts]
matiko09: bets $10
phrantique: calls $10
*** RIVER *** [9h Qs Ac Ts] [Td]
matiko09: checks 
phrantique: bets $14.19
matiko09: calls $14.19
*** SHOW DOWN ***
phrantique: shows [Th Kh] (three of a kind, Tens)
matiko09: mucks hand 
phrantique collected $66.38 from pot
*** SUMMARY ***
Total pot $68.88 | Rake $2.50 
Board [9h Qs Ac Ts Td]
Seat 1: matiko09 (big blind) mucked [Jh Ad]
Seat 2: ruslik_by folded before Flop (didn't bet)
Seat 3: SkUhNi folded before Flop (didn't bet)
Seat 4: karllv folded before Flop (didn't bet)
Seat 5: Avtovo folded before Flop (didn't bet)
Seat 6: 23SmOkEr07 folded before Flop (didn't bet)
Seat 7: Dickyxxx folded before Flop (didn't bet)
Seat 8: phrantique (button) showed [Th Kh] and won ($66.38) with three of a kind, Tens
Seat 9: Filojoes (small blind) folded before Flop





PokerStars Hand #154970771824:  Hold'em No Limit ($0.50/$1.00 USD) - 2016/06/20 12:54:40 CET [2016/06/20 6:54:40 ET]
Table 'Garumna II' 9-max Seat #3 is the button
Seat 1: ki11u ($141.50 in chips) 
Seat 2: Racushniak ($100 in chips) 
Seat 3: mooose100 ($78.88 in chips) 
Seat 4: Ndundun Gipe ($32.50 in chips) 
Seat 5: rura53 ($78 in chips) 
Seat 6: SexyAngeline ($52.57 in chips) 
Seat 7: Avtovo ($100 in chips) 
Seat 8: matiko09 ($109.52 in chips) 
Seat 9: SkUhNi ($102.30 in chips) 
Ndundun Gipe: posts small blind $0.50
rura53: posts big blind $1
*** HOLE CARDS ***
Dealt to matiko09 [Td 2s]
SexyAngeline: folds 
Avtovo: folds 
matiko09: folds 
SkUhNi: folds 
ki11u: raises $1.50 to $2.50
Racushniak: folds 
mooose100: calls $2.50
Ndundun Gipe: calls $2
rura53: folds 
*** FLOP *** [2d 6c 8c]
Ndundun Gipe: bets $1
ki11u: calls $1
mooose100: folds 
*** TURN *** [2d 6c 8c] [Qh]
Ndundun Gipe: checks 
ki11u: checks 
*** RIVER *** [2d 6c 8c Qh] [Ts]
Ndundun Gipe: checks 
ki11u: checks 
*** SHOW DOWN ***
Ndundun Gipe: shows [8s 5c] (a pair of Eights)
ki11u: mucks hand 
Ndundun Gipe collected $9.98 from pot
*** SUMMARY ***
Total pot $10.50 | Rake $0.52 
Board [2d 6c 8c Qh Ts]
Seat 1: ki11u mucked [Ks Jd]
Seat 2: Racushniak folded before Flop (didn't bet)
Seat 3: mooose100 (button) folded on the Flop
Seat 4: Ndundun Gipe (small blind) showed [8s 5c] and won ($9.98) with a pair of Eights
Seat 5: rura53 (big blind) folded before Flop
Seat 6: SexyAngeline folded before Flop (didn't bet)
Seat 7: Avtovo folded before Flop (didn't bet)
Seat 8: matiko09 folded before Flop (didn't bet)
Seat 9: SkUhNi folded before Flop (didn't bet)





PokerStars Hand #154970772740:  Hold'em No Limit ($0.50/$1.00 USD) - 2016/06/20 12:54:42 CET [2016/06/20 6:54:42 ET]
Table 'Isonoe II' 9-max Seat #9 is the button
Seat 1: hammerwife ($100 in chips) 
Seat 2: matiko09 ($122.26 in chips) 
Seat 3: Kukuryzka ($100 in chips) 
Seat 4: Avtovo ($103.50 in chips) 
Seat 5: Filojoes ($102 in chips) 
Seat 6: GOOFA13 ($61.96 in chips) 
Seat 7: SkUhNi ($113.82 in chips) 
Seat 8: lewyson ($83.65 in chips) 
Seat 9: djammusic ($64.45 in chips) 
hammerwife: posts small blind $0.50
matiko09: posts big blind $1
*** HOLE CARDS ***
Dealt to matiko09 [3s 3c]
Kukuryzka: folds 
Avtovo: folds 
Filojoes: folds 
GOOFA13: folds 
SkUhNi: folds 
lewyson: folds 
djammusic: folds 
hammerwife: raises $1.60 to $2.60
matiko09: calls $1.60
*** FLOP *** [4d 5c 2s]
hammerwife: bets $2.47
matiko09: calls $2.47
*** TURN *** [4d 5c 2s] [Jh]
hammerwife has timed out
hammerwife: checks 
matiko09: checks 
*** RIVER *** [4d 5c 2s Jh] [Ad]
hammerwife: checks 
matiko09: bets $5
hammerwife: folds 
Uncalled bet ($5) returned to matiko09
matiko09 collected $9.63 from pot
matiko09: doesn't show hand 
*** SUMMARY ***
Total pot $10.14 | Rake $0.51 
Board [4d 5c 2s Jh Ad]
Seat 1: hammerwife (small blind) folded on the River
Seat 2: matiko09 (big blind) collected ($9.63)
Seat 3: Kukuryzka folded before Flop (didn't bet)
Seat 4: Avtovo folded before Flop (didn't bet)
Seat 5: Filojoes folded before Flop (didn't bet)
Seat 6: GOOFA13 folded before Flop (didn't bet)
Seat 7: SkUhNi folded before Flop (didn't bet)
Seat 8: lewyson folded before Flop (didn't bet)
Seat 9: djammusic (button) folded before Flop (didn't bet)





PokerStars Hand #154970774890:  Hold'em No Limit ($0.50/$1.00 USD) - 2016/06/20 12:54:47 CET [2016/06/20 6:54:47 ET]
Table 'Anhui' 9-max Seat #8 is the button
Seat 1: SkUhNi ($161.88 in chips) 
Seat 2: ruslik_by ($264.68 in chips) 
Seat 3: hammerwife ($166.73 in chips) 
Seat 5: mi$$I$Elena ($103.30 in chips) 
Seat 6: 23SmOkEr07 ($119.18 in chips) 
Seat 7: matiko09 ($121.98 in chips) 
Seat 8: blackmont111 ($62.50 in chips) 
Seat 9: TomBod1 ($88.03 in chips) 
TomBod1: posts small blind $0.50
SkUhNi: posts big blind $1
Yaaaazz: sits out 
*** HOLE CARDS ***
Dealt to matiko09 [2d 9s]
ruslik_by: folds 
hammerwife: folds 
mi$$I$Elena: folds 
23SmOkEr07: folds 
matiko09: folds 
blackmont111: raises $1 to $2
TomBod1: raises $4 to $6
SkUhNi: folds 
blackmont111: calls $4
*** FLOP *** [Ts 8h Ah]
TomBod1: bets $5
blackmont111: calls $5
*** TURN *** [Ts 8h Ah] [7s]
Yaaaazz leaves the table
djammusic joins the table at seat #4 
TomBod1: bets $10
blackmont111: calls $10
*** RIVER *** [Ts 8h Ah 7s] [As]
TomBod1: checks 
blackmont111: bets $10
TomBod1: folds 
Uncalled bet ($10) returned to blackmont111
blackmont111 collected $40.85 from pot
blackmont111: doesn't show hand 
*** SUMMARY ***
Total pot $43 | Rake $2.15 
Board [Ts 8h Ah 7s As]
Seat 1: SkUhNi (big blind) folded before Flop
Seat 2: ruslik_by folded before Flop (didn't bet)
Seat 3: hammerwife folded before Flop (didn't bet)
Seat 5: mi$$I$Elena folded before Flop (didn't bet)
Seat 6: 23SmOkEr07 folded before Flop (didn't bet)
Seat 7: matiko09 folded before Flop (didn't bet)
Seat 8: blackmont111 (button) collected ($40.85)
Seat 9: TomBod1 (small blind) folded on the River





PokerStars Hand #154970775173:  Hold'em No Limit (£0.25/£0.50 GBP) - 2016/06/20 12:54:48 CET [2016/06/20 6:54:48 ET]
Table 'Tesla' 6-max Seat #4 is the button
Seat 1: Rubleff85 (£57.15 in chips) 
Seat 2: matiko09 (£79.61 in chips) 
Seat 3: asmodej666 (£50 in chips) 
Seat 4: VahTang_89 (£51.62 in chips) 
Seat 5: Nego Razu (£50 in chips) 
Seat 6: faceMyBallz_ (£50 in chips) 
Nego Razu: posts small blind £0.25
faceMyBallz_: posts big blind £0.50
*** HOLE CARDS ***
Dealt to matiko09 [3c 2h]
Rubleff85: folds 
matiko09: folds 
asmodej666: folds 
VahTang_89: folds 
Nego Razu: raises £1 to £1.50
faceMyBallz_: calls £1
*** FLOP *** [Ah 5s Th]
Nego Razu: bets £1.39
faceMyBallz_: folds 
Uncalled bet (£1.39) returned to Nego Razu
Nego Razu collected £2.85 from pot
Nego Razu: doesn't show hand 
*** SUMMARY ***
Total pot £3 | Rake £0.15 
Board [Ah 5s Th]
Seat 1: Rubleff85 folded before Flop (didn't bet)
Seat 2: matiko09 folded before Flop (didn't bet)
Seat 3: asmodej666 folded before Flop (didn't bet)
Seat 4: VahTang_89 (button) folded before Flop (didn't bet)
Seat 5: Nego Razu (small blind) collected (£2.85)
Seat 6: faceMyBallz_ (big blind) folded on the Flop





PokerStars Hand #154970778168:  Hold'em No Limit (£0.25/£0.50 GBP) - 2016/06/20 12:54:56 CET [2016/06/20 6:54:56 ET]
Table 'Ani' 6-max Seat #6 is the button
Seat 1: asmodej666 (£50 in chips) 
Seat 2: mitsuVK (£63.25 in chips) 
Seat 3: Doobes8555 (£68.65 in chips) 
Seat 4: matiko09 (£59.77 in chips) 
Seat 5: Wwwasian (£56.93 in chips) 
Seat 6: faceMyBallz_ (£56.16 in chips) 
asmodej666: posts small blind £0.25
mitsuVK: posts big blind £0.50
*** HOLE CARDS ***
Dealt to matiko09 [7c 8c]
Doobes8555: raises £1 to £1.50
matiko09: raises £3 to £4.50
Wwwasian: folds 
faceMyBallz_: folds 
asmodej666: folds 
mitsuVK: folds 
Doobes8555: folds 
Uncalled bet (£3) returned to matiko09
matiko09 collected £3.75 from pot
matiko09: doesn't show hand 
*** SUMMARY ***
Total pot £3.75 | Rake £0 
Seat 1: asmodej666 (small blind) folded before Flop
Seat 2: mitsuVK (big blind) folded before Flop
Seat 3: Doobes8555 folded before Flop
Seat 4: matiko09 collected (£3.75)
Seat 5: Wwwasian folded before Flop (didn't bet)
Seat 6: faceMyBallz_ (button) folded before Flop (didn't bet)





PokerStars Hand #154970779571:  Hold'em No Limit ($0.25/$0.50 USD) - 2016/06/20 12:54:59 CET [2016/06/20 6:54:59 ET]
Table 'Scheddi II' 9-max Seat #1 is the button
Seat 1: matiko09 ($93.55 in chips) 
Seat 2: Yaaaazz ($88.31 in chips) 
Seat 3: mi$$I$Elena ($85.71 in chips) 
Seat 4: GOOFA13 ($73.92 in chips) 
Seat 5: zarplatka ($40 in chips) 
Seat 6: orochimaturi ($29.45 in chips) 
Seat 7: HopeMayBee ($87.76 in chips) 
Seat 9: Infinitinium ($113.97 in chips) 
Yaaaazz: posts small blind $0.25
mi$$I$Elena: posts big blind $0.50
Danil27: sits out 
matiko09: posts the ante $0.10
Yaaaazz: posts the ante $0.10
mi$$I$Elena: posts the ante $0.10
GOOFA13: posts the ante $0.10
zarplatka: posts the ante $0.10
orochimaturi: posts the ante $0.10
HopeMayBee: posts the ante $0.10
Infinitinium: posts the ante $0.10
*** HOLE CARDS ***
Dealt to matiko09 [Qh 3s]
GOOFA13: raises $2 to $2.50
zarplatka: folds 
orochimaturi has timed out
orochimaturi: folds 
HopeMayBee: folds 
Infinitinium: calls $2.50
matiko09: folds 
Yaaaazz: folds 
mi$$I$Elena: calls $2
*** FLOP *** [7h Ts As]
mi$$I$Elena: checks 
GOOFA13: checks 
Infinitinium: bets $4.06
mi$$I$Elena: folds 
GOOFA13: calls $4.06
*** TURN *** [7h Ts As] [5s]
GOOFA13: checks 
Infinitinium: checks 
*** RIVER *** [7h Ts As 5s] [Jc]
GOOFA13: bets $10
Infinitinium: folds 
Uncalled bet ($10) returned to GOOFA13
GOOFA13 collected $15.84 from pot
GOOFA13: doesn't show hand 
*** SUMMARY ***
Total pot $16.67 | Rake $0.83 
Board [7h Ts As 5s Jc]
Seat 1: matiko09 (button) folded before Flop (didn't bet)
Seat 2: Yaaaazz (small blind) folded before Flop
Seat 3: mi$$I$Elena (big blind) folded on the Flop
Seat 4: GOOFA13 collected ($15.84)
Seat 5: zarplatka folded before Flop (didn't bet)
Seat 6: orochimaturi folded before Flop (didn't bet)
Seat 7: HopeMayBee folded before Flop (didn't bet)
Seat 9: Infinitinium folded on the River





PokerStars Hand #154970780630:  Hold'em No Limit ($0.50/$1.00 USD) - 2016/06/20 12:55:02 CET [2016/06/20 6:55:02 ET]
Table 'Normannia' 9-max Seat #3 is the button
Seat 1: hammerwife ($123.22 in chips) 
Seat 2: Pvsx. ($189.34 in chips) 
Seat 3: Avtovo ($100 in chips) 
Seat 4: Filojoes ($105.89 in chips) 
Seat 5: Dickyxxx ($117.19 in chips) 
Seat 7: matiko09 ($100 in chips) 
Seat 8: SkUhNi ($140.24 in chips) 
Seat 9: ruslik_by ($146.19 in chips) 
Filojoes: posts small blind $0.50
Dickyxxx: posts big blind $1
*** HOLE CARDS ***
Dealt to matiko09 [3d Kc]
matiko09: folds 
SkUhNi: raises $2 to $3
ruslik_by: folds 
hammerwife: folds 
Pvsx.: folds 
Avtovo: folds 
Filojoes: calls $2.50
Dickyxxx: calls $2
*** FLOP *** [5d 9s Kh]
Filojoes: checks 
Dickyxxx: checks 
SkUhNi: checks 
*** TURN *** [5d 9s Kh] [9c]
Filojoes: checks 
Dickyxxx: bets $4.44
SkUhNi: calls $4.44
Filojoes: folds 
*** RIVER *** [5d 9s Kh 9c] [9h]
Dickyxxx: bets $8.83
SkUhNi: folds 
Uncalled bet ($8.83) returned to Dickyxxx
Dickyxxx collected $16.99 from pot
Dickyxxx: doesn't show hand 
*** SUMMARY ***
Total pot $17.88 | Rake $0.89 
Board [5d 9s Kh 9c 9h]
Seat 1: hammerwife folded before Flop (didn't bet)
Seat 2: Pvsx. folded before Flop (didn't bet)
Seat 3: Avtovo (button) folded before Flop (didn't bet)
Seat 4: Filojoes (small blind) folded on the Turn
Seat 5: Dickyxxx (big blind) collected ($16.99)
Seat 7: matiko09 folded before Flop (didn't bet)
Seat 8: SkUhNi folded on the River
Seat 9: ruslik_by folded before Flop (didn't bet)





PokerStars Hand #154970782381:  Hold'em No Limit ($0.50/$1.00 USD) - 2016/06/20 12:55:06 CET [2016/06/20 6:55:06 ET]
Table 'Ernestina' 9-max Seat #3 is the button
Seat 1: diva3150 ($119.15 in chips) 
Seat 2: matiko09 ($160.92 in chips) 
Seat 3: Pvsx. ($185.99 in chips) 
Seat 4: SkUhNi ($100 in chips) 
Seat 5: Dickyxxx ($139.20 in chips) 
Seat 8: ruslik_by ($243.03 in chips) 
Seat 9: 23SmOkEr07 ($100 in chips) 
SkUhNi: posts small blind $0.50
Dickyxxx: posts big blind $1
*** HOLE CARDS ***
Dealt to matiko09 [6h 6d]
ruslik_by: folds 
23SmOkEr07: raises $1.50 to $2.50
diva3150: folds 
matiko09: calls $2.50
Pvsx.: folds 
SkUhNi: folds 
Dickyxxx: folds 
*** FLOP *** [7h Kc Jd]
23SmOkEr07: checks 
matiko09: checks 
*** TURN *** [7h Kc Jd] [8c]
23SmOkEr07: checks 
matiko09: checks 
*** RIVER *** [7h Kc Jd 8c] [8d]
23SmOkEr07: checks 
matiko09: checks 
*** SHOW DOWN ***
23SmOkEr07: shows [As 2s] (a pair of Eights)
matiko09: shows [6h 6d] (two pair, Eights and Sixes)
matiko09 collected $6.18 from pot
*** SUMMARY ***
Total pot $6.50 | Rake $0.32 
Board [7h Kc Jd 8c 8d]
Seat 1: diva3150 folded before Flop (didn't bet)
Seat 2: matiko09 showed [6h 6d] and won ($6.18) with two pair, Eights and Sixes
Seat 3: Pvsx. (button) folded before Flop (didn't bet)
Seat 4: SkUhNi (small blind) folded before Flop
Seat 5: Dickyxxx (big blind) folded before Flop
Seat 8: ruslik_by folded before Flop (didn't bet)
Seat 9: 23SmOkEr07 showed [As 2s] and lost with a pair of Eights





PokerStars Hand #154970785553:  Hold'em No Limit (£0.25/£0.50 GBP) - 2016/06/20 12:55:15 CET [2016/06/20 6:55:15 ET]
Table 'Azalea' 6-max Seat #5 is the button
Seat 1: mitsuVK (£54.35 in chips) 
Seat 2: matiko09 (£73.86 in chips) 
Seat 3: tyoma_knp (£50 in chips) 
Seat 4: faceMyBallz_ (£98.72 in chips) 
Seat 5: mudders693 (£63.19 in chips) 
Seat 6: Bënedic10 (£70.33 in chips) 
Bënedic10: posts small blind £0.25
mitsuVK: posts big blind £0.50
*** HOLE CARDS ***
Dealt to matiko09 [Ad 2s]
matiko09: folds 
tyoma_knp: raises £1 to £1.50
faceMyBallz_: folds 
mudders693: calls £1.50
Bënedic10: folds 
mitsuVK: folds 
*** FLOP *** [6h 8s As]
tyoma_knp: checks 
mudders693: checks 
*** TURN *** [6h 8s As] [Qd]
tyoma_knp: checks 
mudders693: checks 
*** RIVER *** [6h 8s As Qd] [Td]
tyoma_knp: bets £3.56
mudders693: calls £3.56
*** SHOW DOWN ***
tyoma_knp: shows [Ac 4c] (a pair of Aces)
mudders693: mucks hand 
tyoma_knp collected £10.33 from pot
*** SUMMARY ***
Total pot £10.87 | Rake £0.54 
Board [6h 8s As Qd Td]
Seat 1: mitsuVK (big blind) folded before Flop
Seat 2: matiko09 folded before Flop (didn't bet)
Seat 3: tyoma_knp showed [Ac 4c] and won (£10.33) with a pair of Aces
Seat 4: faceMyBallz_ folded before Flop (didn't bet)
Seat 5: mudders693 (button) mucked [Tc 7c]
Seat 6: Bënedic10 (small blind) folded before Flop





PokerStars Hand #154970785792:  Hold'em No Limit ($0.50/$1.00 USD) - 2016/06/20 12:55:16 CET [2016/06/20 6:55:16 ET]
Table 'Albiorix' 9-max Seat #5 is the button
Seat 2: SkUhNi ($110.62 in chips) 
Seat 3: matiko09 ($125.23 in chips) 
Seat 4: 23SmOkEr07 ($142.80 in chips) 
Seat 5: ruslik_by ($105 in chips) 
Seat 6: Filojoes ($100 in chips) 
Seat 7: Pekyto ($50.65 in chips) 
Seat 8: smiley0221 ($36.83 in chips) 
Seat 9: DomiVY ($49.50 in chips) 
Filojoes: posts small blind $0.50
Pekyto: posts big blind $1
*** HOLE CARDS ***
Dealt to matiko09 [Kd 6s]
smiley0221: folds 
DomiVY: folds 
SkUhNi: folds 
matiko09: folds 
23SmOkEr07: folds 
ruslik_by: raises $1 to $2
Filojoes: folds 
Pekyto: folds 
Uncalled bet ($1) returned to ruslik_by
ruslik_by collected $2.50 from pot
ruslik_by: doesn't show hand 
*** SUMMARY ***
Total pot $2.50 | Rake $0 
Seat 2: SkUhNi folded before Flop (didn't bet)
Seat 3: matiko09 folded before Flop (didn't bet)
Seat 4: 23SmOkEr07 folded before Flop (didn't bet)
Seat 5: ruslik_by (button) collected ($2.50)
Seat 6: Filojoes (small blind) folded before Flop
Seat 7: Pekyto (big blind) folded before Flop
Seat 8: smiley0221 folded before Flop (didn't bet)
Seat 9: DomiVY folded before Flop (didn't bet)





PokerStars Hand #154970788473:  Hold'em No Limit ($0.50/$1.00 USD) - 2016/06/20 12:55:23 CET [2016/06/20 6:55:23 ET]
Table 'Ambrosia II' 9-max Seat #6 is the button
Seat 1: 23SmOkEr07 ($170.25 in chips) 
Seat 2: Eyeballz1307 ($43.55 in chips) 
Seat 4: mi$$I$Elena ($195.77 in chips) 
Seat 5: Mattulh ($100 in chips) 
Seat 6: ruslik_by ($111.62 in chips) 
Seat 7: matiko09 ($100.50 in chips) 
Seat 8: hammerwife ($119.45 in chips) 
Seat 9: SkUhNi ($136.76 in chips) 
matiko09: posts small blind $0.50
hammerwife: posts big blind $1
Filojoes: sits out 
*** HOLE CARDS ***
Dealt to matiko09 [Js 8d]
SkUhNi: folds 
23SmOkEr07: folds 
Eyeballz1307: folds 
mi$$I$Elena: raises $1.38 to $2.38
Mattulh: raises $5.62 to $8
ruslik_by: folds 
matiko09: folds 
hammerwife: folds 
mi$$I$Elena: folds 
Uncalled bet ($5.62) returned to Mattulh
Mattulh collected $6.26 from pot
Mattulh: doesn't show hand 
*** SUMMARY ***
Total pot $6.26 | Rake $0 
Seat 1: 23SmOkEr07 folded before Flop (didn't bet)
Seat 2: Eyeballz1307 folded before Flop (didn't bet)
Seat 4: mi$$I$Elena folded before Flop
Seat 5: Mattulh collected ($6.26)
Seat 6: ruslik_by (button) folded before Flop (didn't bet)
Seat 7: matiko09 (small blind) folded before Flop
Seat 8: hammerwife (big blind) folded before Flop
Seat 9: SkUhNi folded before Flop (didn't bet)





PokerStars Hand #154970789529:  Hold'em No Limit ($0.50/$1.00 USD) - 2016/06/20 12:55:26 CET [2016/06/20 6:55:26 ET]
Table 'Annika' 9-max Seat #6 is the button
Seat 1: hammerwife ($105.77 in chips) 
Seat 2: matiko09 ($105.30 in chips) 
Seat 3: first_dnk ($89.28 in chips) 
Seat 4: Kukuryzka ($101.50 in chips) 
Seat 5: SkUhNi ($119.13 in chips) 
Seat 6: Pvsx. ($101.05 in chips) 
Seat 7: jirka117 ($48.23 in chips) 
Seat 8: ruslik_by ($123.49 in chips) 
Seat 9: 23SmOkEr07 ($143.15 in chips) 
jirka117: posts small blind $0.50
ruslik_by: posts big blind $1
*** HOLE CARDS ***
Dealt to matiko09 [Qd 3s]
23SmOkEr07: folds 
hammerwife: folds 
matiko09: folds 
first_dnk: folds 
Kukuryzka: folds 
SkUhNi: folds 
Pvsx.: folds 
jirka117: calls $0.50
ruslik_by: checks 
*** FLOP *** [7s 5d 6d]
jirka117: checks 
ruslik_by: bets $1
jirka117: calls $1
*** TURN *** [7s 5d 6d] [Ks]
jirka117: checks 
ruslik_by: bets $1.29
jirka117: calls $1.29
*** RIVER *** [7s 5d 6d Ks] [Js]
jirka117: checks 
ruslik_by: checks 
*** SHOW DOWN ***
jirka117: shows [Qh Kd] (a pair of Kings)
ruslik_by: mucks hand 
jirka117 collected $6.25 from pot
*** SUMMARY ***
Total pot $6.58 | Rake $0.33 
Board [7s 5d 6d Ks Js]
Seat 1: hammerwife folded before Flop (didn't bet)
Seat 2: matiko09 folded before Flop (didn't bet)
Seat 3: first_dnk folded before Flop (didn't bet)
Seat 4: Kukuryzka folded before Flop (didn't bet)
Seat 5: SkUhNi folded before Flop (didn't bet)
Seat 6: Pvsx. (button) folded before Flop (didn't bet)
Seat 7: jirka117 (small blind) showed [Qh Kd] and won ($6.25) with a pair of Kings
Seat 8: ruslik_by (big blind) mucked [8c Td]
Seat 9: 23SmOkEr07 folded before Flop (didn't bet)





PokerStars Hand #154970789964:  Hold'em No Limit (£0.25/£0.50 GBP) - 2016/06/20 12:55:27 CET [2016/06/20 6:55:27 ET]
Table 'Ani' 6-max Seat #1 is the button
Seat 1: asmodej666 (£50 in chips) 
Seat 2: mitsuVK (£62.75 in chips) 
Seat 3: Doobes8555 (£67.15 in chips) 
Seat 4: matiko09 (£62.02 in chips) 
Seat 5: Wwwasian (£56.93 in chips) 
Seat 6: faceMyBallz_ (£56.16 in chips) 
mitsuVK: posts small blind £0.25
Doobes8555: posts big blind £0.50
*** HOLE CARDS ***
Dealt to matiko09 [Td 5s]
matiko09: folds 
Wwwasian: folds 
faceMyBallz_: folds 
asmodej666: raises £0.62 to £1.12
mitsuVK: folds 
Doobes8555: calls £0.62
*** FLOP *** [9s Th Ah]
Doobes8555: folds 
asmodej666 collected £2.37 from pot
asmodej666: doesn't show hand 
*** SUMMARY ***
Total pot £2.49 | Rake £0.12 
Board [9s Th Ah]
Seat 1: asmodej666 (button) collected (£2.37)
Seat 2: mitsuVK (small blind) folded before Flop
Seat 3: Doobes8555 (big blind) folded on the Flop
Seat 4: matiko09 folded before Flop (didn't bet)
Seat 5: Wwwasian folded before Flop (didn't bet)
Seat 6: faceMyBallz_ folded before Flop (didn't bet)





PokerStars Hand #154970792203:  Hold'em No Limit (£0.25/£0.50 GBP) - 2016/06/20 12:55:33 CET [2016/06/20 6:55:33 ET]
Table 'Tesla' 6-max Seat #5 is the button
Seat 1: Rubleff85 (£57.15 in chips) 
Seat 2: matiko09 (£79.61 in chips) 
Seat 3: asmodej666 (£50 in chips) 
Seat 4: VahTang_89 (£51.62 in chips) 
Seat 5: Nego Razu (£51.35 in chips) 
Seat 6: faceMyBallz_ (£50 in chips) 
faceMyBallz_: posts small blind £0.25
Rubleff85: posts big blind £0.50
*** HOLE CARDS ***
Dealt to matiko09 [3h Ah]
matiko09: raises £1 to £1.50
asmodej666: folds 
VahTang_89: folds 
Nego Razu: folds 
faceMyBallz_: folds 
Rubleff85: calls £1
*** FLOP *** [5h 6h Qh]
Rubleff85: checks 
matiko09: bets £2
Rubleff85: folds 
Uncalled bet (£2) returned to matiko09
matiko09 collected £3.09 from pot
matiko09: doesn't show hand 
*** SUMMARY ***
Total pot £3.25 | Rake £0.16 
Board [5h 6h Qh]
Seat 1: Rubleff85 (big blind) folded on the Flop
Seat 2: matiko09 collected (£3.09)
Seat 3: asmodej666 folded before Flop (didn't bet)
Seat 4: VahTang_89 folded before Flop (didn't bet)
Seat 5: Nego Razu (button) folded before Flop (didn't bet)
Seat 6: faceMyBallz_ (small blind) folded before Flop





PokerStars Hand #154970796689:  Hold'em No Limit ($0.50/$1.00 USD) - 2016/06/20 12:55:46 CET [2016/06/20 6:55:46 ET]
Table 'Pongola' 9-max Seat #9 is the button
Seat 1: matiko09 ($100 in chips) 
Seat 2: ruslik_by ($127.77 in chips) 
Seat 3: SkUhNi ($113.22 in chips) 
Seat 4: karllv ($133.33 in chips) 
Seat 5: Avtovo ($102.72 in chips) 
Seat 6: 23SmOkEr07 ($124.70 in chips) 
Seat 7: Dickyxxx ($159.65 in chips) 
Seat 8: phrantique ($127.19 in chips) 
Seat 9: Filojoes ($129.09 in chips) 
matiko09: posts small blind $0.50
ruslik_by: posts big blind $1
*** HOLE CARDS ***
Dealt to matiko09 [Jc Jh]
SkUhNi: raises $2 to $3
karllv: folds 
Avtovo: folds 
23SmOkEr07: folds 
Dickyxxx: calls $3
phrantique: calls $3
Filojoes: folds 
matiko09: raises $12 to $15
ruslik_by: folds 
SkUhNi: folds 
Dickyxxx: folds 
phrantique: folds 
Uncalled bet ($12) returned to matiko09
matiko09 collected $13 from pot
matiko09: doesn't show hand 
*** SUMMARY ***
Total pot $13 | Rake $0 
Seat 1: matiko09 (small blind) collected ($13)
Seat 2: ruslik_by (big blind) folded before Flop
Seat 3: SkUhNi folded before Flop
Seat 4: karllv folded before Flop (didn't bet)
Seat 5: Avtovo folded before Flop (didn't bet)
Seat 6: 23SmOkEr07 folded before Flop (didn't bet)
Seat 7: Dickyxxx folded before Flop
Seat 8: phrantique folded before Flop
Seat 9: Filojoes (button) folded before Flop (didn't bet)





PokerStars Hand #154970798387:  Hold'em No Limit ($0.50/$1.00 USD) - 2016/06/20 12:55:51 CET [2016/06/20 6:55:51 ET]
Table 'Ernestina' 9-max Seat #4 is the button
Seat 1: diva3150 ($119.15 in chips) 
Seat 2: matiko09 ($164.60 in chips) 
Seat 3: Pvsx. ($185.99 in chips) 
Seat 4: SkUhNi ($100 in chips) 
Seat 5: Dickyxxx ($138.20 in chips) 
Seat 8: ruslik_by ($243.03 in chips) 
Seat 9: 23SmOkEr07 ($100 in chips) 
Dickyxxx: posts small blind $0.50
ruslik_by: posts big blind $1
*** HOLE CARDS ***
Dealt to matiko09 [Th 6s]
23SmOkEr07: folds 
diva3150: folds 
matiko09: folds 
Pvsx.: folds 
SkUhNi: folds 
Dickyxxx: raises $2 to $3
ruslik_by: folds 
Uncalled bet ($2) returned to Dickyxxx
Dickyxxx collected $2 from pot
Dickyxxx: doesn't show hand 
*** SUMMARY ***
Total pot $2 | Rake $0 
Seat 1: diva3150 folded before Flop (didn't bet)
Seat 2: matiko09 folded before Flop (didn't bet)
Seat 3: Pvsx. folded before Flop (didn't bet)
Seat 4: SkUhNi (button) folded before Flop (didn't bet)
Seat 5: Dickyxxx (small blind) collected ($2)
Seat 8: ruslik_by (big blind) folded before Flop
Seat 9: 23SmOkEr07 folded before Flop (didn't bet)





PokerStars Hand #154970799265:  Hold'em No Limit (£0.25/£0.50 GBP) - 2016/06/20 12:55:53 CET [2016/06/20 6:55:53 ET]
Table 'Ani' 6-max Seat #2 is the button
Seat 1: asmodej666 (£51.25 in chips) 
Seat 2: mitsuVK (£62.50 in chips) 
Seat 3: Doobes8555 (£66.03 in chips) 
Seat 4: matiko09 (£62.02 in chips) 
Seat 5: Wwwasian (£56.93 in chips) 
Seat 6: faceMyBallz_ (£56.16 in chips) 
Doobes8555: posts small blind £0.25
matiko09: posts big blind £0.50
*** HOLE CARDS ***
Dealt to matiko09 [Qs 4d]
Wwwasian: folds 
faceMyBallz_: folds 
asmodej666: folds 
mitsuVK: raises £0.50 to £1
Doobes8555: raises £0.50 to £1.50
matiko09: folds 
mitsuVK: calls £0.50
*** FLOP *** [3h 5s Ah]
Doobes8555: checks 
mitsuVK: bets £1.50
Doobes8555: calls £1.50
*** TURN *** [3h 5s Ah] [Ts]
Doobes8555: checks 
mitsuVK: checks 
*** RIVER *** [3h 5s Ah Ts] [8h]
Doobes8555: checks 
mitsuVK: checks 
*** SHOW DOWN ***
Doobes8555: shows [9c 9h] (a pair of Nines)
mitsuVK: mucks hand 
Doobes8555 collected £6.18 from pot
*** SUMMARY ***
Total pot £6.50 | Rake £0.32 
Board [3h 5s Ah Ts 8h]
Seat 1: asmodej666 folded before Flop (didn't bet)
Seat 2: mitsuVK (button) mucked [6c 3c]
Seat 3: Doobes8555 (small blind) showed [9c 9h] and won (£6.18) with a pair of Nines
Seat 4: matiko09 (big blind) folded before Flop
Seat 5: Wwwasian folded before Flop (didn't bet)
Seat 6: faceMyBallz_ folded before Flop (didn't bet)





PokerStars Hand #154970799148:  Hold'em No Limit ($0.50/$1.00 USD) - 2016/06/20 12:55:53 CET [2016/06/20 6:55:53 ET]
Table 'Albiorix' 9-max Seat #6 is the button
Seat 2: SkUhNi ($110.62 in chips) 
Seat 3: matiko09 ($125.23 in chips) 
Seat 4: 23SmOkEr07 ($142.80 in chips) 
Seat 5: ruslik_by ($106.50 in chips) 
Seat 6: Filojoes ($100 in chips) 
Seat 7: Pekyto ($49.65 in chips) 
Seat 8: smiley0221 ($36.83 in chips) 
Seat 9: DomiVY ($49.50 in chips) 
Pekyto: posts small blind $0.50
smiley0221: posts big blind $1
*** HOLE CARDS ***
Dealt to matiko09 [Js 3c]
DomiVY: folds 
DomiVY leaves the table
SkUhNi: raises $2 to $3
matiko09: folds 
23SmOkEr07: folds 
djammusic joins the table at seat #9 
ruslik_by: folds 
Filojoes: folds 
Pekyto: folds 
smiley0221: folds 
Uncalled bet ($2) returned to SkUhNi
SkUhNi collected $2.50 from pot
SkUhNi: doesn't show hand 
*** SUMMARY ***
Total pot $2.50 | Rake $0 
Seat 2: SkUhNi collected ($2.50)
Seat 3: matiko09 folded before Flop (didn't bet)
Seat 4: 23SmOkEr07 folded before Flop (didn't bet)
Seat 5: ruslik_by folded before Flop (didn't bet)
Seat 6: Filojoes (button) folded before Flop (didn't bet)
Seat 7: Pekyto (small blind) folded before Flop
Seat 8: smiley0221 (big blind) folded before Flop
Seat 9: DomiVY folded before Flop (didn't bet)





PokerStars Hand #154970802993:  Hold'em No Limit (£0.25/£0.50 GBP) - 2016/06/20 12:56:04 CET [2016/06/20 6:56:04 ET]
Table 'Tesla' 6-max Seat #6 is the button
Seat 1: Rubleff85 (£55.65 in chips) 
Seat 2: matiko09 (£81.20 in chips) 
Seat 3: asmodej666 (£50 in chips) 
Seat 4: VahTang_89 (£51.62 in chips) 
Seat 5: Nego Razu (£51.35 in chips) 
Seat 6: faceMyBallz_ (£50 in chips) 
Rubleff85: posts small blind £0.25
matiko09: posts big blind £0.50
*** HOLE CARDS ***
Dealt to matiko09 [6h 5d]
asmodej666: folds 
VahTang_89: folds 
Nego Razu: raises £0.77 to £1.27
faceMyBallz_: folds 
Rubleff85: folds 
matiko09: folds 
Uncalled bet (£0.77) returned to Nego Razu
Nego Razu collected £1.25 from pot
Nego Razu: doesn't show hand 
*** SUMMARY ***
Total pot £1.25 | Rake £0 
Seat 1: Rubleff85 (small blind) folded before Flop
Seat 2: matiko09 (big blind) folded before Flop
Seat 3: asmodej666 folded before Flop (didn't bet)
Seat 4: VahTang_89 folded before Flop (didn't bet)
Seat 5: Nego Razu collected (£1.25)
Seat 6: faceMyBallz_ (button) folded before Flop (didn't bet)





PokerStars Hand #154970805814:  Hold'em No Limit (£0.25/£0.50 GBP) - 2016/06/20 12:56:12 CET [2016/06/20 6:56:12 ET]
Table 'Azalea' 6-max Seat #6 is the button
Seat 1: mitsuVK (£53.85 in chips) 
Seat 2: matiko09 (£73.86 in chips) 
Seat 3: tyoma_knp (£55.27 in chips) 
Seat 4: faceMyBallz_ (£98.72 in chips) 
Seat 5: mudders693 (£58.13 in chips) 
Seat 6: Bënedic10 (£70.08 in chips) 
mitsuVK: posts small blind £0.25
matiko09: posts big blind £0.50
*** HOLE CARDS ***
Dealt to matiko09 [Td 8d]
tyoma_knp: folds 
faceMyBallz_: folds 
mudders693: raises £1 to £1.50
Bënedic10: folds 
mitsuVK: folds 
matiko09: folds 
Uncalled bet (£1) returned to mudders693
mudders693 collected £1.25 from pot
mudders693: doesn't show hand 
*** SUMMARY ***
Total pot £1.25 | Rake £0 
Seat 1: mitsuVK (small blind) folded before Flop
Seat 2: matiko09 (big blind) folded before Flop
Seat 3: tyoma_knp folded before Flop (didn't bet)
Seat 4: faceMyBallz_ folded before Flop (didn't bet)
Seat 5: mudders693 collected (£1.25)
Seat 6: Bënedic10 (button) folded before Flop (didn't bet)





PokerStars Hand #154970806909:  Hold'em No Limit ($0.50/$1.00 USD) - 2016/06/20 12:56:15 CET [2016/06/20 6:56:15 ET]
Table 'Anhui' 9-max Seat #9 is the button
Seat 1: SkUhNi ($160.88 in chips) 
Seat 2: ruslik_by ($264.68 in chips) 
Seat 3: hammerwife ($166.73 in chips) 
Seat 5: mi$$I$Elena ($103.30 in chips) 
Seat 6: 23SmOkEr07 ($119.18 in chips) 
Seat 7: matiko09 ($121.98 in chips) 
Seat 8: blackmont111 ($82.35 in chips) 
Seat 9: TomBod1 ($67.03 in chips) 
SkUhNi: posts small blind $0.50
ruslik_by: posts big blind $1
djammusic: sits out 
*** HOLE CARDS ***
Dealt to matiko09 [7h 3d]
hammerwife: folds 
mi$$I$Elena: folds 
23SmOkEr07: folds 
matiko09: folds 
blackmont111: folds 
TomBod1: folds 
TomBod1 leaves the table
mi$$I$Elena leaves the table
Dickyxxx joins the table at seat #5 
SkUhNi: raises $1.50 to $2.50
ruslik_by: raises $6 to $8.50
SkUhNi: folds 
Uncalled bet ($6) returned to ruslik_by
ruslik_by collected $5 from pot
ruslik_by: doesn't show hand 
*** SUMMARY ***
Total pot $5 | Rake $0 
Seat 1: SkUhNi (small blind) folded before Flop
Seat 2: ruslik_by (big blind) collected ($5)
Seat 3: hammerwife folded before Flop (didn't bet)
Seat 5: mi$$I$Elena folded before Flop (didn't bet)
Seat 6: 23SmOkEr07 folded before Flop (didn't bet)
Seat 7: matiko09 folded before Flop (didn't bet)
Seat 8: blackmont111 folded before Flop (didn't bet)
Seat 9: TomBod1 (button) folded before Flop (didn't bet)





PokerStars Hand #154970807250:  Hold'em No Limit (£0.25/£0.50 GBP) - 2016/06/20 12:56:16 CET [2016/06/20 6:56:16 ET]
Table 'Tesla' 6-max Seat #1 is the button
Seat 1: Rubleff85 (£55.40 in chips) 
Seat 2: matiko09 (£80.70 in chips) 
Seat 3: asmodej666 (£50 in chips) 
Seat 4: VahTang_89 (£51.62 in chips) 
Seat 5: Nego Razu (£52.10 in chips) 
Seat 6: faceMyBallz_ (£50 in chips) 
matiko09: posts small blind £0.25
asmodej666: posts big blind £0.50
*** HOLE CARDS ***
Dealt to matiko09 [9c Qs]
VahTang_89: raises £0.50 to £1
Nego Razu: folds 
faceMyBallz_: folds 
Rubleff85: raises £2 to £3
matiko09: folds 
asmodej666: folds 
VahTang_89: calls £2
*** FLOP *** [Tc 7d 2s]
VahTang_89: checks 
Rubleff85: checks 
*** TURN *** [Tc 7d 2s] [4c]
VahTang_89: bets £3.20
Rubleff85: calls £3.20
*** RIVER *** [Tc 7d 2s 4c] [6c]
VahTang_89: bets £8.62
Rubleff85: raises £9.38 to £18
VahTang_89: calls £9.38
*** SHOW DOWN ***
Rubleff85: shows [6d 6s] (three of a kind, Sixes)
VahTang_89: shows [9d 8d] (a straight, Six to Ten)
VahTang_89 collected £47.75 from pot
*** SUMMARY ***
Total pot £49.15 | Rake £1.40 
Board [Tc 7d 2s 4c 6c]
Seat 1: Rubleff85 (button) showed [6d 6s] and lost with three of a kind, Sixes
Seat 2: matiko09 (small blind) folded before Flop
Seat 3: asmodej666 (big blind) folded before Flop
Seat 4: VahTang_89 showed [9d 8d] and won (£47.75) with a straight, Six to Ten
Seat 5: Nego Razu folded before Flop (didn't bet)
Seat 6: faceMyBallz_ folded before Flop (didn't bet)





PokerStars Hand #154970808664:  Hold'em No Limit ($0.50/$1.00 USD) - 2016/06/20 12:56:20 CET [2016/06/20 6:56:20 ET]
Table 'Ambrosia II' 9-max Seat #7 is the button
Seat 1: 23SmOkEr07 ($170.25 in chips) 
Seat 2: Eyeballz1307 ($43.55 in chips) 
Seat 4: mi$$I$Elena ($193.39 in chips) 
Seat 5: Mattulh ($103.88 in chips) 
Seat 6: ruslik_by ($111.62 in chips) 
Seat 7: matiko09 ($100 in chips) 
Seat 8: hammerwife ($118.45 in chips) 
Seat 9: SkUhNi ($136.76 in chips) 
hammerwife: posts small blind $0.50
SkUhNi: posts big blind $1
Filojoes: sits out 
*** HOLE CARDS ***
Dealt to matiko09 [6c 7h]
23SmOkEr07: folds 
Eyeballz1307: folds 
mi$$I$Elena: folds 
Mattulh: raises $1.50 to $2.50
ruslik_by: folds 
matiko09: folds 
hammerwife: folds 
SkUhNi: folds 
Uncalled bet ($1.50) returned to Mattulh
Mattulh collected $2.50 from pot
Mattulh: doesn't show hand 
*** SUMMARY ***
Total pot $2.50 | Rake $0 
Seat 1: 23SmOkEr07 folded before Flop (didn't bet)
Seat 2: Eyeballz1307 folded before Flop (didn't bet)
Seat 4: mi$$I$Elena folded before Flop (didn't bet)
Seat 5: Mattulh collected ($2.50)
Seat 6: ruslik_by folded before Flop (didn't bet)
Seat 7: matiko09 (button) folded before Flop (didn't bet)
Seat 8: hammerwife (small blind) folded before Flop
Seat 9: SkUhNi (big blind) folded before Flop





PokerStars Hand #154970810037:  Hold'em No Limit ($0.50/$1.00 USD) - 2016/06/20 12:56:24 CET [2016/06/20 6:56:24 ET]
Table 'Garumna II' 9-max Seat #4 is the button
Seat 1: ki11u ($138 in chips) 
Seat 2: Racushniak ($100 in chips) 
Seat 3: mooose100 ($100 in chips) 
Seat 4: Ndundun Gipe ($38.98 in chips) 
Seat 5: rura53 ($77 in chips) 
Seat 6: SexyAngeline ($52.57 in chips) 
Seat 7: Avtovo ($100 in chips) 
Seat 8: matiko09 ($109.52 in chips) 
Seat 9: SkUhNi ($102.30 in chips) 
rura53: posts small blind $0.50
SexyAngeline: posts big blind $1
*** HOLE CARDS ***
Dealt to matiko09 [Ts 8s]
Avtovo: raises $1.50 to $2.50
matiko09: folds 
SkUhNi: calls $2.50
ki11u: folds 
Racushniak: folds 
mooose100: folds 
Ndundun Gipe: folds 
rura53: folds 
SexyAngeline: folds 
*** FLOP *** [As 6d 9s]
Avtovo: checks 
SkUhNi: bets $3
Avtovo: calls $3
*** TURN *** [As 6d 9s] [9h]
Avtovo: checks 
SkUhNi: bets $5
Avtovo: calls $5
*** RIVER *** [As 6d 9s 9h] [8h]
Avtovo: checks 
SkUhNi: checks 
*** SHOW DOWN ***
Avtovo: shows [8c Ac] (two pair, Aces and Nines)
SkUhNi: mucks hand 
Avtovo collected $21.38 from pot
*** SUMMARY ***
Total pot $22.50 | Rake $1.12 
Board [As 6d 9s 9h 8h]
Seat 1: ki11u folded before Flop (didn't bet)
Seat 2: Racushniak folded before Flop (didn't bet)
Seat 3: mooose100 folded before Flop (didn't bet)
Seat 4: Ndundun Gipe (button) folded before Flop (didn't bet)
Seat 5: rura53 (small blind) folded before Flop
Seat 6: SexyAngeline (big blind) folded before Flop
Seat 7: Avtovo showed [8c Ac] and won ($21.38) with two pair, Aces and Nines
Seat 8: matiko09 folded before Flop (didn't bet)
Seat 9: SkUhNi mucked [Qd Qc]





PokerStars Hand #154970810198:  Hold'em No Limit ($0.50/$1.00 USD) - 2016/06/20 12:56:24 CET [2016/06/20 6:56:24 ET]
Table 'Ernestina' 9-max Seat #5 is the button
Seat 1: diva3150 ($119.15 in chips) 
Seat 2: matiko09 ($164.60 in chips) 
Seat 3: Pvsx. ($185.99 in chips) 
Seat 4: SkUhNi ($100 in chips) 
Seat 5: Dickyxxx ($139.20 in chips) 
Seat 8: ruslik_by ($242.03 in chips) 
Seat 9: 23SmOkEr07 ($100 in chips) 
ruslik_by: posts small blind $0.50
23SmOkEr07: posts big blind $1
*** HOLE CARDS ***
Dealt to matiko09 [5d 9s]
diva3150: folds 
matiko09: folds 
Pvsx.: folds 
SkUhNi: folds 
Dickyxxx: folds 
ruslik_by: raises $2 to $3
23SmOkEr07: folds 
Uncalled bet ($2) returned to ruslik_by
ruslik_by collected $2 from pot
ruslik_by: doesn't show hand 
*** SUMMARY ***
Total pot $2 | Rake $0 
Seat 1: diva3150 folded before Flop (didn't bet)
Seat 2: matiko09 folded before Flop (didn't bet)
Seat 3: Pvsx. folded before Flop (didn't bet)
Seat 4: SkUhNi folded before Flop (didn't bet)
Seat 5: Dickyxxx (button) folded before Flop (didn't bet)
Seat 8: ruslik_by (small blind) collected ($2)
Seat 9: 23SmOkEr07 (big blind) folded before Flop





PokerStars Hand #154970810808:  Hold'em No Limit (£0.25/£0.50 GBP) - 2016/06/20 12:56:26 CET [2016/06/20 6:56:26 ET]
Table 'Azalea' 6-max Seat #1 is the button
Seat 1: mitsuVK (£53.60 in chips) 
Seat 2: matiko09 (£73.36 in chips) 
Seat 3: tyoma_knp (£55.27 in chips) 
Seat 4: faceMyBallz_ (£98.72 in chips) 
Seat 5: mudders693 (£58.88 in chips) 
Seat 6: Bënedic10 (£70.08 in chips) 
matiko09: posts small blind £0.25
tyoma_knp: posts big blind £0.50
*** HOLE CARDS ***
Dealt to matiko09 [Ks 6s]
faceMyBallz_: folds 
mudders693: raises £1 to £1.50
Bënedic10: folds 
mitsuVK: folds 
matiko09: folds 
tyoma_knp: folds 
Uncalled bet (£1) returned to mudders693
mudders693 collected £1.25 from pot
mudders693: doesn't show hand 
*** SUMMARY ***
Total pot £1.25 | Rake £0 
Seat 1: mitsuVK (button) folded before Flop (didn't bet)
Seat 2: matiko09 (small blind) folded before Flop
Seat 3: tyoma_knp (big blind) folded before Flop
Seat 4: faceMyBallz_ folded before Flop (didn't bet)
Seat 5: mudders693 collected (£1.25)
Seat 6: Bënedic10 folded before Flop (didn't bet)





PokerStars Hand #154970814077:  Hold'em No Limit ($0.50/$1.00 USD) - 2016/06/20 12:56:35 CET [2016/06/20 6:56:35 ET]
Table 'Annika' 9-max Seat #7 is the button
Seat 1: hammerwife ($105.77 in chips) 
Seat 2: matiko09 ($105.30 in chips) 
Seat 3: first_dnk ($89.28 in chips) 
Seat 4: Kukuryzka ($101.50 in chips) 
Seat 5: SkUhNi ($119.13 in chips) 
Seat 6: Pvsx. ($101.05 in chips) 
Seat 7: jirka117 ($51.19 in chips) 
Seat 8: ruslik_by ($120.20 in chips) 
Seat 9: 23SmOkEr07 ($143.15 in chips) 
ruslik_by: posts small blind $0.50
23SmOkEr07: posts big blind $1
*** HOLE CARDS ***
Dealt to matiko09 [9s 4d]
hammerwife: folds 
matiko09: folds 
first_dnk: folds 
Kukuryzka: folds 
SkUhNi: raises $2 to $3
Pvsx.: folds 
jirka117: calls $3
ruslik_by: folds 
23SmOkEr07: calls $2
*** FLOP *** [6d 3c Kc]
23SmOkEr07: checks 
SkUhNi: bets $6.31
jirka117: folds 
23SmOkEr07: calls $6.31
*** TURN *** [6d 3c Kc] [2d]
23SmOkEr07: checks 
SkUhNi: checks 
*** RIVER *** [6d 3c Kc 2d] [Ts]
23SmOkEr07: checks 
SkUhNi: checks 
*** SHOW DOWN ***
23SmOkEr07: shows [9d Kd] (a pair of Kings)
SkUhNi: mucks hand 
23SmOkEr07 collected $21.01 from pot
*** SUMMARY ***
Total pot $22.12 | Rake $1.11 
Board [6d 3c Kc 2d Ts]
Seat 1: hammerwife folded before Flop (didn't bet)
Seat 2: matiko09 folded before Flop (didn't bet)
Seat 3: first_dnk folded before Flop (didn't bet)
Seat 4: Kukuryzka folded before Flop (didn't bet)
Seat 5: SkUhNi mucked [Qh Qc]
Seat 6: Pvsx. folded before Flop (didn't bet)
Seat 7: jirka117 (button) folded on the Flop
Seat 8: ruslik_by (small blind) folded before Flop
Seat 9: 23SmOkEr07 (big blind) showed [9d Kd] and won ($21.01) with a pair of Kings





PokerStars Hand #154970814263:  Hold'em No Limit ($0.50/$1.00 USD) - 2016/06/20 12:56:36 CET [2016/06/20 6:56:36 ET]
Table 'Normannia' 9-max Seat #4 is the button
Seat 1: hammerwife ($123.22 in chips) 
Seat 2: Pvsx. ($189.34 in chips) 
Seat 3: Avtovo ($100 in chips) 
Seat 4: Filojoes ($102.89 in chips) 
Seat 5: Dickyxxx ($126.74 in chips) 
Seat 6: typename27 ($75.09 in chips) 
Seat 7: matiko09 ($100 in chips) 
Seat 8: SkUhNi ($132.80 in chips) 
Seat 9: ruslik_by ($146.19 in chips) 
Dickyxxx: posts small blind $0.50
typename27: posts big blind $1
*** HOLE CARDS ***
Dealt to matiko09 [Th Ks]
matiko09: folds 
SkUhNi: folds 
ruslik_by: folds 
hammerwife: folds 
Pvsx.: folds 
Avtovo: folds 
Filojoes: folds 
Dickyxxx: folds 
Uncalled bet ($0.50) returned to typename27
typename27 collected $1 from pot
typename27: doesn't show hand 
*** SUMMARY ***
Total pot $1 | Rake $0 
Seat 1: hammerwife folded before Flop (didn't bet)
Seat 2: Pvsx. folded before Flop (didn't bet)
Seat 3: Avtovo folded before Flop (didn't bet)
Seat 4: Filojoes (button) folded before Flop (didn't bet)
Seat 5: Dickyxxx (small blind) folded before Flop
Seat 6: typename27 (big blind) collected ($1)
Seat 7: matiko09 folded before Flop (didn't bet)
Seat 8: SkUhNi folded before Flop (didn't bet)
Seat 9: ruslik_by folded before Flop (didn't bet)





PokerStars Hand #154970815852:  Hold'em No Limit ($0.50/$1.00 USD) - 2016/06/20 12:56:40 CET [2016/06/20 6:56:40 ET]
Table 'Albiorix' 9-max Seat #7 is the button
Seat 2: SkUhNi ($112.12 in chips) 
Seat 3: matiko09 ($125.23 in chips) 
Seat 4: 23SmOkEr07 ($142.80 in chips) 
Seat 5: ruslik_by ($106.50 in chips) 
Seat 6: Filojoes ($100 in chips) 
Seat 7: Pekyto ($49.15 in chips) 
Seat 8: smiley0221 ($35.83 in chips) 
Seat 9: djammusic ($40 in chips) 
smiley0221: posts small blind $0.50
djammusic: posts big blind $1
*** HOLE CARDS ***
Dealt to matiko09 [Jh 2h]
SkUhNi: folds 
matiko09: folds 
23SmOkEr07: folds 
ruslik_by: folds 
Filojoes: folds 
Pekyto: folds 
smiley0221: folds 
Uncalled bet ($0.50) returned to djammusic
djammusic collected $1 from pot
djammusic: doesn't show hand 
*** SUMMARY ***
Total pot $1 | Rake $0 
Seat 2: SkUhNi folded before Flop (didn't bet)
Seat 3: matiko09 folded before Flop (didn't bet)
Seat 4: 23SmOkEr07 folded before Flop (didn't bet)
Seat 5: ruslik_by folded before Flop (didn't bet)
Seat 6: Filojoes folded before Flop (didn't bet)
Seat 7: Pekyto (button) folded before Flop (didn't bet)
Seat 8: smiley0221 (small blind) folded before Flop
Seat 9: djammusic (big blind) collected ($1)





PokerStars Hand #154970816649:  Hold'em No Limit (£0.25/£0.50 GBP) - 2016/06/20 12:56:42 CET [2016/06/20 6:56:42 ET]
Table 'Azalea' 6-max Seat #2 is the button
Seat 1: mitsuVK (£53.60 in chips) 
Seat 2: matiko09 (£73.11 in chips) 
Seat 3: tyoma_knp (£54.77 in chips) 
Seat 4: faceMyBallz_ (£98.72 in chips) 
Seat 5: mudders693 (£59.63 in chips) 
Seat 6: Bënedic10 (£70.08 in chips) 
tyoma_knp: posts small blind £0.25
faceMyBallz_: posts big blind £0.50
*** HOLE CARDS ***
Dealt to matiko09 [Kc Tc]
mudders693: raises £1 to £1.50
Bënedic10: folds 
mitsuVK: folds 
matiko09: raises £2.50 to £4
tyoma_knp: folds 
faceMyBallz_: folds 
mudders693: calls £2.50
*** FLOP *** [7d 6h 5h]
mudders693: checks 
matiko09: checks 
*** TURN *** [7d 6h 5h] [Ah]
mudders693: checks 
matiko09: checks 
*** RIVER *** [7d 6h 5h Ah] [6s]
mudders693: folds 
matiko09 collected £8.31 from pot
matiko09: doesn't show hand 
*** SUMMARY ***
Total pot £8.75 | Rake £0.44 
Board [7d 6h 5h Ah 6s]
Seat 1: mitsuVK folded before Flop (didn't bet)
Seat 2: matiko09 (button) collected (£8.31)
Seat 3: tyoma_knp (small blind) folded before Flop
Seat 4: faceMyBallz_ (big blind) folded before Flop
Seat 5: mudders693 folded on the River
Seat 6: Bënedic10 folded before Flop (didn't bet)





PokerStars Hand #154970817263:  Hold'em No Limit (€0.25/€0.50 EUR) - 2016/06/20 12:56:44 CET [2016/06/20 6:56:44 ET]
Table 'Bechuana' 6-max Seat #2 is the button
Seat 1: zitagirl (€33.07 in chips) 
Seat 2: matiko09 (€50 in chips) 
Seat 3: Aju!ntje (€66.60 in chips) 
Seat 4: Wwwasian (€54.08 in chips) 
Seat 5: fanmtZ (€46.99 in chips) 
Aju!ntje: posts small blind €0.25
Wwwasian: posts big blind €0.50
SlayersGBG: sits out 
*** HOLE CARDS ***
Dealt to matiko09 [5h Ah]
fanmtZ: folds 
zitagirl: folds 
matiko09: raises €0.63 to €1.13
Aju!ntje: folds 
Wwwasian: folds 
Uncalled bet (€0.63) returned to matiko09
matiko09 collected €1.25 from pot
matiko09: doesn't show hand 
*** SUMMARY ***
Total pot €1.25 | Rake €0 
Seat 1: zitagirl folded before Flop (didn't bet)
Seat 2: matiko09 (button) collected (€1.25)
Seat 3: Aju!ntje (small blind) folded before Flop
Seat 4: Wwwasian (big blind) folded before Flop
Seat 5: fanmtZ folded before Flop (didn't bet)





PokerStars Hand #154970817700:  Hold'em No Limit ($0.50/$1.00 USD) - 2016/06/20 12:56:45 CET [2016/06/20 6:56:45 ET]
Table 'Isonoe II' 9-max Seat #1 is the button
Seat 1: hammerwife ($100 in chips) 
Seat 2: matiko09 ($126.82 in chips) 
Seat 3: Kukuryzka ($100 in chips) 
Seat 4: Avtovo ($103.50 in chips) 
Seat 5: Filojoes ($102 in chips) 
Seat 6: GOOFA13 ($61.96 in chips) 
Seat 7: SkUhNi ($113.82 in chips) 
Seat 8: lewyson ($83.65 in chips) 
Seat 9: djammusic ($64.45 in chips) 
matiko09: posts small blind $0.50
Kukuryzka: posts big blind $1
*** HOLE CARDS ***
Dealt to matiko09 [8h 5s]
Avtovo: folds 
Filojoes: folds 
GOOFA13: folds 
SkUhNi: folds 
lewyson: folds 
djammusic: folds 
hammerwife: folds 
matiko09: folds 
Uncalled bet ($0.50) returned to Kukuryzka
Kukuryzka collected $1 from pot
Kukuryzka: doesn't show hand 
*** SUMMARY ***
Total pot $1 | Rake $0 
Seat 1: hammerwife (button) folded before Flop (didn't bet)
Seat 2: matiko09 (small blind) folded before Flop
Seat 3: Kukuryzka (big blind) collected ($1)
Seat 4: Avtovo folded before Flop (didn't bet)
Seat 5: Filojoes folded before Flop (didn't bet)
Seat 6: GOOFA13 folded before Flop (didn't bet)
Seat 7: SkUhNi folded before Flop (didn't bet)
Seat 8: lewyson folded before Flop (didn't bet)
Seat 9: djammusic folded before Flop (didn't bet)





PokerStars Hand #154970818291:  Hold'em No Limit (£0.25/£0.50 GBP) - 2016/06/20 12:56:47 CET [2016/06/20 6:56:47 ET]
Table 'Ani' 6-max Seat #3 is the button
Seat 1: asmodej666 (£51.25 in chips) 
Seat 2: mitsuVK (£59.50 in chips) 
Seat 3: Doobes8555 (£69.21 in chips) 
Seat 4: matiko09 (£61.52 in chips) 
Seat 5: Wwwasian (£56.93 in chips) 
Seat 6: faceMyBallz_ (£56.16 in chips) 
matiko09: posts small blind £0.25
Wwwasian: posts big blind £0.50
*** HOLE CARDS ***
Dealt to matiko09 [Qc 6d]
faceMyBallz_: folds 
asmodej666: folds 
mitsuVK: folds 
Doobes8555: folds 
matiko09: folds 
Uncalled bet (£0.25) returned to Wwwasian
Wwwasian collected £0.50 from pot
Wwwasian: doesn't show hand 
*** SUMMARY ***
Total pot £0.50 | Rake £0 
Seat 1: asmodej666 folded before Flop (didn't bet)
Seat 2: mitsuVK folded before Flop (didn't bet)
Seat 3: Doobes8555 (button) folded before Flop (didn't bet)
Seat 4: matiko09 (small blind) folded before Flop
Seat 5: Wwwasian (big blind) collected (£0.50)
Seat 6: faceMyBallz_ folded before Flop (didn't bet)





PokerStars Hand #154970818820:  Hold'em No Limit ($0.25/$0.50 USD) - 2016/06/20 12:56:49 CET [2016/06/20 6:56:49 ET]
Table 'Scheddi II' 9-max Seat #2 is the button
Seat 1: matiko09 ($93.45 in chips) 
Seat 2: Yaaaazz ($87.96 in chips) 
Seat 3: mi$$I$Elena ($83.11 in chips) 
Seat 4: GOOFA13 ($83.10 in chips) 
Seat 5: zarplatka ($40 in chips) 
Seat 6: orochimaturi ($29.35 in chips) 
Seat 7: HopeMayBee ($87.66 in chips) 
Seat 9: Infinitinium ($107.31 in chips) 
mi$$I$Elena: posts small blind $0.25
GOOFA13: posts big blind $0.50
Danil27: sits out 
matiko09: posts the ante $0.10
Yaaaazz: posts the ante $0.10
mi$$I$Elena: posts the ante $0.10
GOOFA13: posts the ante $0.10
zarplatka: posts the ante $0.10
orochimaturi: posts the ante $0.10
HopeMayBee: posts the ante $0.10
Infinitinium: posts the ante $0.10
*** HOLE CARDS ***
Dealt to matiko09 [2s 3s]
zarplatka: folds 
orochimaturi: folds 
HopeMayBee: raises $1 to $1.50
Infinitinium: folds 
matiko09: folds 
Yaaaazz: raises $5.25 to $6.75
mi$$I$Elena: folds 
GOOFA13: folds 
HopeMayBee: calls $5.25
*** FLOP *** [4h 2h Ac]
HopeMayBee: checks 
Yaaaazz: bets $8.25
HopeMayBee: calls $8.25
*** TURN *** [4h 2h Ac] [Qs]
HopeMayBee: checks 
Yaaaazz: bets $13
HopeMayBee: calls $13
*** RIVER *** [4h 2h Ac Qs] [Qh]
HopeMayBee: checks 
Yaaaazz: checks 
*** SHOW DOWN ***
HopeMayBee: shows [Ah Ad] (a full house, Aces full of Queens)
Yaaaazz: mucks hand 
HopeMayBee collected $55.55 from pot
*** SUMMARY ***
Total pot $57.55 | Rake $2 
Board [4h 2h Ac Qs Qh]
Seat 1: matiko09 folded before Flop (didn't bet)
Seat 2: Yaaaazz (button) mucked [Kd As]
Seat 3: mi$$I$Elena (small blind) folded before Flop
Seat 4: GOOFA13 (big blind) folded before Flop
Seat 5: zarplatka folded before Flop (didn't bet)
Seat 6: orochimaturi folded before Flop (didn't bet)
Seat 7: HopeMayBee showed [Ah Ad] and won ($55.55) with a full house, Aces full of Queens
Seat 9: Infinitinium folded before Flop (didn't bet)





PokerStars Hand #154970821543:  Hold'em No Limit ($0.50/$1.00 USD) - 2016/06/20 12:56:56 CET [2016/06/20 6:56:56 ET]
Table 'Ernestina' 9-max Seat #8 is the button
Seat 1: diva3150 ($119.15 in chips) 
Seat 2: matiko09 ($164.60 in chips) 
Seat 3: Pvsx. ($185.99 in chips) 
Seat 4: SkUhNi ($100 in chips) 
Seat 5: Dickyxxx ($139.20 in chips) 
Seat 8: ruslik_by ($243.03 in chips) 
Seat 9: 23SmOkEr07 ($100 in chips) 
23SmOkEr07: posts small blind $0.50
diva3150: posts big blind $1
arctur17: sits out 
*** HOLE CARDS ***
Dealt to matiko09 [Qs 8s]
matiko09: folds 
Pvsx.: folds 
SkUhNi: folds 
Dickyxxx: raises $2 to $3
ruslik_by: folds 
23SmOkEr07: folds 
diva3150: calls $2
*** FLOP *** [5h As 6h]
diva3150: checks 
Dickyxxx: bets $3.21
diva3150: folds 
Uncalled bet ($3.21) returned to Dickyxxx
Dickyxxx collected $6.18 from pot
Dickyxxx: doesn't show hand 
*** SUMMARY ***
Total pot $6.50 | Rake $0.32 
Board [5h As 6h]
Seat 1: diva3150 (big blind) folded on the Flop
Seat 2: matiko09 folded before Flop (didn't bet)
Seat 3: Pvsx. folded before Flop (didn't bet)
Seat 4: SkUhNi folded before Flop (didn't bet)
Seat 5: Dickyxxx collected ($6.18)
Seat 8: ruslik_by (button) folded before Flop (didn't bet)
Seat 9: 23SmOkEr07 (small blind) folded before Flop





PokerStars Hand #154970822974:  Hold'em No Limit (£0.25/£0.50 GBP) - 2016/06/20 12:57:00 CET [2016/06/20 6:57:00 ET]
Table 'Ani' 6-max Seat #4 is the button
Seat 1: asmodej666 (£51.25 in chips) 
Seat 2: mitsuVK (£59.50 in chips) 
Seat 3: Doobes8555 (£69.21 in chips) 
Seat 4: matiko09 (£61.27 in chips) 
Seat 5: Wwwasian (£57.18 in chips) 
Seat 6: faceMyBallz_ (£56.16 in chips) 
Wwwasian: posts small blind £0.25
faceMyBallz_: posts big blind £0.50
*** HOLE CARDS ***
Dealt to matiko09 [Ac 2c]
asmodej666: folds 
mitsuVK: folds 
Doobes8555: calls £0.50
matiko09: raises £1.50 to £2
Wwwasian: folds 
faceMyBallz_: folds 
Doobes8555: calls £1.50
*** FLOP *** [7c 5d 5s]
Doobes8555: checks 
matiko09: bets £2
Doobes8555: calls £2
*** TURN *** [7c 5d 5s] [Qc]
Doobes8555: checks 
matiko09: bets £5
Doobes8555: folds 
Uncalled bet (£5) returned to matiko09
matiko09 collected £8.31 from pot
matiko09: doesn't show hand 
*** SUMMARY ***
Total pot £8.75 | Rake £0.44 
Board [7c 5d 5s Qc]
Seat 1: asmodej666 folded before Flop (didn't bet)
Seat 2: mitsuVK folded before Flop (didn't bet)
Seat 3: Doobes8555 folded on the Turn
Seat 4: matiko09 (button) collected (£8.31)
Seat 5: Wwwasian (small blind) folded before Flop
Seat 6: faceMyBallz_ (big blind) folded before Flop





PokerStars Hand #154970824250:  Hold'em No Limit (€0.25/€0.50 EUR) - 2016/06/20 12:57:04 CET [2016/06/20 6:57:04 ET]
Table 'Bechuana' 6-max Seat #3 is the button
Seat 1: zitagirl (€33.07 in chips) 
Seat 2: matiko09 (€50.75 in chips) 
Seat 3: Aju!ntje (€66.35 in chips) 
Seat 4: Wwwasian (€53.58 in chips) 
Seat 5: fanmtZ (€46.99 in chips) 
Wwwasian: posts small blind €0.25
fanmtZ: posts big blind €0.50
SlayersGBG: sits out 
*** HOLE CARDS ***
Dealt to matiko09 [Ad 2s]
zitagirl: calls €0.50
matiko09: folds 
Aju!ntje: folds 
Wwwasian: raises €0.90 to €1.40
fanmtZ: folds 
zitagirl: calls €0.90
*** FLOP *** [3h 5d 2c]
Wwwasian: bets €1.50
zitagirl: folds 
Uncalled bet (€1.50) returned to Wwwasian
Wwwasian collected €3.14 from pot
Wwwasian: doesn't show hand 
*** SUMMARY ***
Total pot €3.30 | Rake €0.16 
Board [3h 5d 2c]
Seat 1: zitagirl folded on the Flop
Seat 2: matiko09 folded before Flop (didn't bet)
Seat 3: Aju!ntje (button) folded before Flop (didn't bet)
Seat 4: Wwwasian (small blind) collected (€3.14)
Seat 5: fanmtZ (big blind) folded before Flop





PokerStars Hand #154970825084:  Hold'em No Limit ($0.50/$1.00 USD) - 2016/06/20 12:57:06 CET [2016/06/20 6:57:06 ET]
Table 'Garumna II' 9-max Seat #5 is the button
Seat 1: ki11u ($138 in chips) 
Seat 2: Racushniak ($100 in chips) 
Seat 3: mooose100 ($100 in chips) 
Seat 4: Ndundun Gipe ($38.98 in chips) 
Seat 5: rura53 ($76.50 in chips) 
Seat 6: SexyAngeline ($51.57 in chips) 
Seat 7: Avtovo ($110.88 in chips) 
Seat 8: matiko09 ($109.52 in chips) 
Seat 9: SkUhNi ($100 in chips) 
SexyAngeline: posts small blind $0.50
Avtovo: posts big blind $1
*** HOLE CARDS ***
Dealt to matiko09 [4h Kc]
matiko09: folds 
SkUhNi: folds 
ki11u: raises $1.50 to $2.50
Racushniak: folds 
mooose100: folds 
Ndundun Gipe: folds 
rura53: folds 
SexyAngeline: folds 
Avtovo: folds 
Uncalled bet ($1.50) returned to ki11u
ki11u collected $2.50 from pot
ki11u: doesn't show hand 
*** SUMMARY ***
Total pot $2.50 | Rake $0 
Seat 1: ki11u collected ($2.50)
Seat 2: Racushniak folded before Flop (didn't bet)
Seat 3: mooose100 folded before Flop (didn't bet)
Seat 4: Ndundun Gipe folded before Flop (didn't bet)
Seat 5: rura53 (button) folded before Flop (didn't bet)
Seat 6: SexyAngeline (small blind) folded before Flop
Seat 7: Avtovo (big blind) folded before Flop
Seat 8: matiko09 folded before Flop (didn't bet)
Seat 9: SkUhNi folded before Flop (didn't bet)





PokerStars Hand #154970824958:  Hold'em No Limit ($0.50/$1.00 USD) - 2016/06/20 12:57:06 CET [2016/06/20 6:57:06 ET]
Table 'Anhui' 9-max Seat #1 is the button
Seat 1: SkUhNi ($158.38 in chips) 
Seat 2: ruslik_by ($267.18 in chips) 
Seat 3: hammerwife ($166.73 in chips) 
Seat 6: 23SmOkEr07 ($119.18 in chips) 
Seat 7: matiko09 ($121.98 in chips) 
Seat 8: blackmont111 ($82.35 in chips) 
ruslik_by: posts small blind $0.50
hammerwife: posts big blind $1
djammusic: sits out 
Dickyxxx: sits out 
*** HOLE CARDS ***
Dealt to matiko09 [8c Kd]
23SmOkEr07: folds 
matiko09: folds 
blackmont111: folds 
SkUhNi: folds 
ruslik_by: raises $2 to $3
hammerwife: calls $2
*** FLOP *** [Kh 9h 4c]
ruslik_by: bets $1.93
SexyAngeline joins the table at seat #9 
hammerwife: calls $1.93
*** TURN *** [Kh 9h 4c] [6d]
djammusic leaves the table
Racushniak joins the table at seat #4 
ruslik_by: bets $3.18
hammerwife: calls $3.18
*** RIVER *** [Kh 9h 4c 6d] [Td]
ruslik_by: bets $5.23
hammerwife: calls $5.23
*** SHOW DOWN ***
ruslik_by: shows [Kc Ah] (a pair of Kings)
hammerwife: mucks hand 
ruslik_by collected $25.35 from pot
*** SUMMARY ***
Total pot $26.68 | Rake $1.33 
Board [Kh 9h 4c 6d Td]
Seat 1: SkUhNi (button) folded before Flop (didn't bet)
Seat 2: ruslik_by (small blind) showed [Kc Ah] and won ($25.35) with a pair of Kings
Seat 3: hammerwife (big blind) mucked [Jd Ts]
Seat 6: 23SmOkEr07 folded before Flop (didn't bet)
Seat 7: matiko09 folded before Flop (didn't bet)
Seat 8: blackmont111 folded before Flop (didn't bet)





PokerStars Hand #154970825296:  Hold'em No Limit ($0.50/$1.00 USD) - 2016/06/20 12:57:07 CET [2016/06/20 6:57:07 ET]
Table 'Pongola' 9-max Seat #1 is the button
Seat 1: matiko09 ($110 in chips) 
Seat 2: ruslik_by ($126.77 in chips) 
Seat 3: SkUhNi ($110.22 in chips) 
Seat 4: karllv ($133.33 in chips) 
Seat 5: Avtovo ($102.72 in chips) 
Seat 6: 23SmOkEr07 ($124.70 in chips) 
Seat 7: Dickyxxx ($156.65 in chips) 
Seat 8: phrantique ($124.19 in chips) 
Seat 9: Filojoes ($129.09 in chips) 
ruslik_by: posts small blind $0.50
SkUhNi: posts big blind $1
*** HOLE CARDS ***
Dealt to matiko09 [2c Ad]
karllv: folds 
Avtovo: raises $1.50 to $2.50
23SmOkEr07: folds 
Dickyxxx: folds 
phrantique: folds 
karllv leaves the table
Filojoes: calls $2.50
matiko09: folds 
ruslik_by: folds 
SkUhNi: folds 
*** FLOP *** [3c 8s 5d]
SexyAngeline joins the table at seat #4 
Avtovo: bets $3.09
Filojoes: raises $5.91 to $9
Avtovo: calls $5.91
*** TURN *** [3c 8s 5d] [8d]
Avtovo: checks 
Filojoes: bets $13
Avtovo: calls $13
*** RIVER *** [3c 8s 5d 8d] [7h]
Avtovo: checks 
Filojoes: bets $27
Avtovo: folds 
Uncalled bet ($27) returned to Filojoes
Filojoes collected $48 from pot
Filojoes: doesn't show hand 
*** SUMMARY ***
Total pot $50.50 | Rake $2.50 
Board [3c 8s 5d 8d 7h]
Seat 1: matiko09 (button) folded before Flop (didn't bet)
Seat 2: ruslik_by (small blind) folded before Flop
Seat 3: SkUhNi (big blind) folded before Flop
Seat 4: karllv folded before Flop (didn't bet)
Seat 5: Avtovo folded on the River
Seat 6: 23SmOkEr07 folded before Flop (didn't bet)
Seat 7: Dickyxxx folded before Flop (didn't bet)
Seat 8: phrantique folded before Flop (didn't bet)
Seat 9: Filojoes collected ($48)





PokerStars Hand #154970825334:  Hold'em No Limit ($0.50/$1.00 USD) - 2016/06/20 12:57:07 CET [2016/06/20 6:57:07 ET]
Table 'Ambrosia II' 9-max Seat #8 is the button
Seat 1: 23SmOkEr07 ($170.25 in chips) 
Seat 2: Eyeballz1307 ($43.55 in chips) 
Seat 4: mi$$I$Elena ($193.39 in chips) 
Seat 5: Mattulh ($105.38 in chips) 
Seat 6: ruslik_by ($111.62 in chips) 
Seat 7: matiko09 ($100 in chips) 
Seat 8: hammerwife ($117.95 in chips) 
Seat 9: SkUhNi ($135.76 in chips) 
SkUhNi: posts small blind $0.50
23SmOkEr07: posts big blind $1
Filojoes: sits out 
*** HOLE CARDS ***
Dealt to matiko09 [3s 6d]
Eyeballz1307: raises $4 to $5
mi$$I$Elena: folds 
Mattulh: folds 
ruslik_by: folds 
matiko09: folds 
hammerwife: folds 
SkUhNi: folds 
23SmOkEr07: raises $165.25 to $170.25 and is all-in
Eyeballz1307: calls $38.55 and is all-in
Uncalled bet ($126.70) returned to 23SmOkEr07
*** FLOP *** [7d 4s Qh]
*** TURN *** [7d 4s Qh] [Ac]
*** RIVER *** [7d 4s Qh Ac] [Jd]
*** SHOW DOWN ***
23SmOkEr07: shows [As Ts] (a pair of Aces)
Eyeballz1307: shows [6h 6c] (a pair of Sixes)
23SmOkEr07 collected $85.10 from pot
*** SUMMARY ***
Total pot $87.60 | Rake $2.50 
Board [7d 4s Qh Ac Jd]
Seat 1: 23SmOkEr07 (big blind) showed [As Ts] and won ($85.10) with a pair of Aces
Seat 2: Eyeballz1307 showed [6h 6c] and lost with a pair of Sixes
Seat 4: mi$$I$Elena folded before Flop (didn't bet)
Seat 5: Mattulh folded before Flop (didn't bet)
Seat 6: ruslik_by folded before Flop (didn't bet)
Seat 7: matiko09 folded before Flop (didn't bet)
Seat 8: hammerwife (button) folded before Flop (didn't bet)
Seat 9: SkUhNi (small blind) folded before Flop





PokerStars Hand #154970826023:  Hold'em No Limit ($0.50/$1.00 USD) - 2016/06/20 12:57:09 CET [2016/06/20 6:57:09 ET]
Table 'Normannia' 9-max Seat #5 is the button
Seat 1: hammerwife ($123.22 in chips) 
Seat 2: Pvsx. ($189.34 in chips) 
Seat 3: Avtovo ($100 in chips) 
Seat 4: Filojoes ($102.89 in chips) 
Seat 5: Dickyxxx ($126.24 in chips) 
Seat 6: typename27 ($75.59 in chips) 
Seat 7: matiko09 ($100 in chips) 
Seat 8: SkUhNi ($132.80 in chips) 
Seat 9: ruslik_by ($146.19 in chips) 
typename27: posts small blind $0.50
matiko09: posts big blind $1
*** HOLE CARDS ***
Dealt to matiko09 [Ad 9s]
SkUhNi: folds 
ruslik_by: folds 
hammerwife: folds 
Pvsx.: folds 
Avtovo: folds 
Filojoes: folds 
Dickyxxx: raises $2 to $3
typename27 has timed out
typename27: folds 
matiko09: calls $2
*** FLOP *** [2d Ks Jd]
matiko09: checks 
Dickyxxx: checks 
*** TURN *** [2d Ks Jd] [7c]
matiko09: bets $4.02
Dickyxxx: calls $4.02
*** RIVER *** [2d Ks Jd 7c] [Tc]
matiko09: bets $11
Dickyxxx: folds 
Uncalled bet ($11) returned to matiko09
matiko09 collected $13.81 from pot
matiko09: doesn't show hand 
*** SUMMARY ***
Total pot $14.54 | Rake $0.73 
Board [2d Ks Jd 7c Tc]
Seat 1: hammerwife folded before Flop (didn't bet)
Seat 2: Pvsx. folded before Flop (didn't bet)
Seat 3: Avtovo folded before Flop (didn't bet)
Seat 4: Filojoes folded before Flop (didn't bet)
Seat 5: Dickyxxx (button) folded on the River
Seat 6: typename27 (small blind) folded before Flop
Seat 7: matiko09 (big blind) collected ($13.81)
Seat 8: SkUhNi folded before Flop (didn't bet)
Seat 9: ruslik_by folded before Flop (didn't bet)





PokerStars Hand #154970827856:  Hold'em No Limit ($0.50/$1.00 USD) - 2016/06/20 12:57:14 CET [2016/06/20 6:57:14 ET]
Table 'Albiorix' 9-max Seat #8 is the button
Seat 1: arctur17 ($71.28 in chips) 
Seat 2: SkUhNi ($112.12 in chips) 
Seat 3: matiko09 ($125.23 in chips) 
Seat 4: 23SmOkEr07 ($142.80 in chips) 
Seat 5: ruslik_by ($106.50 in chips) 
Seat 6: Filojoes ($100 in chips) 
Seat 7: Pekyto ($49.15 in chips) 
Seat 8: smiley0221 ($35.33 in chips) 
Seat 9: djammusic ($40.50 in chips) 
djammusic: posts small blind $0.50
arctur17: posts big blind $1
*** HOLE CARDS ***
Dealt to matiko09 [7c Jh]
SkUhNi: folds 
matiko09: folds 
23SmOkEr07: folds 
ruslik_by: folds 
Filojoes: folds 
Pekyto: folds 
smiley0221: raises $34.33 to $35.33 and is all-in
djammusic: folds 
arctur17: folds 
Uncalled bet ($34.33) returned to smiley0221
smiley0221 collected $2.50 from pot
smiley0221: doesn't show hand 
*** SUMMARY ***
Total pot $2.50 | Rake $0 
Seat 1: arctur17 (big blind) folded before Flop
Seat 2: SkUhNi folded before Flop (didn't bet)
Seat 3: matiko09 folded before Flop (didn't bet)
Seat 4: 23SmOkEr07 folded before Flop (didn't bet)
Seat 5: ruslik_by folded before Flop (didn't bet)
Seat 6: Filojoes folded before Flop (didn't bet)
Seat 7: Pekyto folded before Flop (didn't bet)
Seat 8: smiley0221 (button) collected ($2.50)
Seat 9: djammusic (small blind) folded before Flop





PokerStars Hand #154970833982:  Hold'em No Limit (£0.25/£0.50 GBP) - 2016/06/20 12:57:31 CET [2016/06/20 6:57:31 ET]
Table 'Azalea' 6-max Seat #3 is the button
Seat 1: mitsuVK (£53.60 in chips) 
Seat 2: matiko09 (£77.42 in chips) 
Seat 3: tyoma_knp (£54.52 in chips) 
Seat 4: faceMyBallz_ (£98.22 in chips) 
Seat 5: mudders693 (£55.63 in chips) 
Seat 6: Bënedic10 (£70.08 in chips) 
faceMyBallz_: posts small blind £0.25
mudders693: posts big blind £0.50
*** HOLE CARDS ***
Dealt to matiko09 [Ts Jh]
Bënedic10: folds 
mitsuVK: folds 
matiko09: raises £1 to £1.50
tyoma_knp: calls £1.50
faceMyBallz_: folds 
mudders693: calls £1
*** FLOP *** [4s 3s 6c]
mudders693: checks 
matiko09: checks 
tyoma_knp: bets £2.75
mudders693: folds 
matiko09: folds 
Uncalled bet (£2.75) returned to tyoma_knp
tyoma_knp collected £4.51 from pot
*** SUMMARY ***
Total pot £4.75 | Rake £0.24 
Board [4s 3s 6c]
Seat 1: mitsuVK folded before Flop (didn't bet)
Seat 2: matiko09 folded on the Flop
Seat 3: tyoma_knp (button) collected (£4.51)
Seat 4: faceMyBallz_ (small blind) folded before Flop
Seat 5: mudders693 (big blind) folded on the Flop
Seat 6: Bënedic10 folded before Flop (didn't bet)





PokerStars Hand #154970834257:  Hold'em No Limit ($0.50/$1.00 USD) - 2016/06/20 12:57:32 CET [2016/06/20 6:57:32 ET]
Table 'Isonoe II' 9-max Seat #2 is the button
Seat 1: hammerwife ($100 in chips) 
Seat 2: matiko09 ($126.32 in chips) 
Seat 3: Kukuryzka ($100.50 in chips) 
Seat 4: Avtovo ($103.50 in chips) 
Seat 5: Filojoes ($102 in chips) 
Seat 6: GOOFA13 ($61.96 in chips) 
Seat 7: SkUhNi ($113.82 in chips) 
Seat 8: lewyson ($83.65 in chips) 
Seat 9: djammusic ($64.45 in chips) 
Kukuryzka: posts small blind $0.50
Avtovo: posts big blind $1
*** HOLE CARDS ***
Dealt to matiko09 [6h 2h]
Filojoes: raises $2 to $3
GOOFA13: calls $3
SkUhNi: folds 
lewyson: folds 
djammusic: folds 
hammerwife: folds 
matiko09: folds 
Kukuryzka: folds 
Avtovo: folds 
*** FLOP *** [Qc 9h 3c]
Filojoes: checks 
GOOFA13: bets $5
Filojoes: raises $15 to $20
GOOFA13: folds 
Uncalled bet ($15) returned to Filojoes
Filojoes collected $16.62 from pot
Filojoes: doesn't show hand 
*** SUMMARY ***
Total pot $17.50 | Rake $0.88 
Board [Qc 9h 3c]
Seat 1: hammerwife folded before Flop (didn't bet)
Seat 2: matiko09 (button) folded before Flop (didn't bet)
Seat 3: Kukuryzka (small blind) folded before Flop
Seat 4: Avtovo (big blind) folded before Flop
Seat 5: Filojoes collected ($16.62)
Seat 6: GOOFA13 folded on the Flop
Seat 7: SkUhNi folded before Flop (didn't bet)
Seat 8: lewyson folded before Flop (didn't bet)
Seat 9: djammusic folded before Flop (didn't bet)





PokerStars Hand #154970835000:  Hold'em No Limit ($0.50/$1.00 USD) - 2016/06/20 12:57:34 CET [2016/06/20 6:57:34 ET]
Table 'Ernestina' 9-max Seat #9 is the button
Seat 1: diva3150 ($116.15 in chips) 
Seat 2: matiko09 ($164.60 in chips) 
Seat 3: Pvsx. ($185.99 in chips) 
Seat 4: SkUhNi ($100 in chips) 
Seat 5: Dickyxxx ($142.38 in chips) 
Seat 8: ruslik_by ($243.03 in chips) 
Seat 9: 23SmOkEr07 ($100 in chips) 
diva3150: posts small blind $0.50
matiko09: posts big blind $1
arctur17: sits out 
*** HOLE CARDS ***
Dealt to matiko09 [9d 3h]
Pvsx.: folds 
SkUhNi: raises $2 to $3
Dickyxxx: folds 
ruslik_by: folds 
23SmOkEr07: folds 
diva3150: calls $2.50
matiko09: folds 
*** FLOP *** [7h 8h 8d]
diva3150: checks 
SkUhNi: bets $4.65
diva3150: folds 
Uncalled bet ($4.65) returned to SkUhNi
SkUhNi collected $6.65 from pot
SkUhNi: doesn't show hand 
*** SUMMARY ***
Total pot $7 | Rake $0.35 
Board [7h 8h 8d]
Seat 1: diva3150 (small blind) folded on the Flop
Seat 2: matiko09 (big blind) folded before Flop
Seat 3: Pvsx. folded before Flop (didn't bet)
Seat 4: SkUhNi collected ($6.65)
Seat 5: Dickyxxx folded before Flop (didn't bet)
Seat 8: ruslik_by folded before Flop (didn't bet)
Seat 9: 23SmOkEr07 (button) folded before Flop (didn't bet)





PokerStars Hand #154970834873:  Hold'em No Limit (£0.25/£0.50 GBP) - 2016/06/20 12:57:34 CET [2016/06/20 6:57:34 ET]
Table 'Tesla' 6-max Seat #2 is the button
Seat 1: Rubleff85 (£31.20 in chips) 
Seat 2: matiko09 (£80.45 in chips) 
Seat 3: asmodej666 (£50 in chips) 
Seat 4: VahTang_89 (£75.17 in chips) 
Seat 5: Nego Razu (£52.10 in chips) 
Seat 6: faceMyBallz_ (£50 in chips) 
asmodej666: posts small blind £0.25
VahTang_89: posts big blind £0.50
*** HOLE CARDS ***
Dealt to matiko09 [2s Jd]
Nego Razu: folds 
faceMyBallz_: folds 
Rubleff85: folds 
matiko09: folds 
asmodej666: folds 
Uncalled bet (£0.25) returned to VahTang_89
VahTang_89 collected £0.50 from pot
VahTang_89: doesn't show hand 
*** SUMMARY ***
Total pot £0.50 | Rake £0 
Seat 1: Rubleff85 folded before Flop (didn't bet)
Seat 2: matiko09 (button) folded before Flop (didn't bet)
Seat 3: asmodej666 (small blind) folded before Flop
Seat 4: VahTang_89 (big blind) collected (£0.50)
Seat 5: Nego Razu folded before Flop (didn't bet)
Seat 6: faceMyBallz_ folded before Flop (didn't bet)





PokerStars Hand #154970836982:  Hold'em No Limit (£0.25/£0.50 GBP) - 2016/06/20 12:57:39 CET [2016/06/20 6:57:39 ET]
Table 'Ani' 6-max Seat #5 is the button
Seat 1: asmodej666 (£51.25 in chips) 
Seat 2: mitsuVK (£59.50 in chips) 
Seat 3: Doobes8555 (£65.21 in chips) 
Seat 4: matiko09 (£65.58 in chips) 
Seat 5: Wwwasian (£56.93 in chips) 
Seat 6: faceMyBallz_ (£55.66 in chips) 
faceMyBallz_: posts small blind £0.25
asmodej666: posts big blind £0.50
*** HOLE CARDS ***
Dealt to matiko09 [9c 4h]
mitsuVK: folds 
Doobes8555: calls £0.50
matiko09: folds 
Wwwasian: folds 
faceMyBallz_: folds 
asmodej666: checks 
*** FLOP *** [Tc 2h Ah]
asmodej666: checks 
Doobes8555: bets £1
asmodej666: calls £1
*** TURN *** [Tc 2h Ah] [6c]
asmodej666: checks 
Doobes8555: checks 
*** RIVER *** [Tc 2h Ah 6c] [9s]
asmodej666: bets £3
Doobes8555: folds 
Uncalled bet (£3) returned to asmodej666
asmodej666 collected £3.09 from pot
asmodej666: doesn't show hand 
*** SUMMARY ***
Total pot £3.25 | Rake £0.16 
Board [Tc 2h Ah 6c 9s]
Seat 1: asmodej666 (big blind) collected (£3.09)
Seat 2: mitsuVK folded before Flop (didn't bet)
Seat 3: Doobes8555 folded on the River
Seat 4: matiko09 folded before Flop (didn't bet)
Seat 5: Wwwasian (button) folded before Flop (didn't bet)
Seat 6: faceMyBallz_ (small blind) folded before Flop





PokerStars Hand #154970839592:  Hold'em No Limit ($0.50/$1.00 USD) - 2016/06/20 12:57:47 CET [2016/06/20 6:57:47 ET]
Table 'Annika' 9-max Seat #8 is the button
Seat 1: hammerwife ($105.77 in chips) 
Seat 2: matiko09 ($105.30 in chips) 
Seat 3: first_dnk ($89.28 in chips) 
Seat 4: Kukuryzka ($101.50 in chips) 
Seat 5: SkUhNi ($109.82 in chips) 
Seat 6: Pvsx. ($101.05 in chips) 
Seat 7: jirka117 ($48.19 in chips) 
Seat 8: ruslik_by ($119.70 in chips) 
Seat 9: 23SmOkEr07 ($154.85 in chips) 
23SmOkEr07: posts small blind $0.50
hammerwife: posts big blind $1
*** HOLE CARDS ***
Dealt to matiko09 [3d 8h]
matiko09: folds 
first_dnk: folds 
Kukuryzka: folds 
SkUhNi: folds 
Pvsx.: folds 
jirka117: folds 
ruslik_by: folds 
23SmOkEr07: folds 
Uncalled bet ($0.50) returned to hammerwife
hammerwife collected $1 from pot
hammerwife: doesn't show hand 
*** SUMMARY ***
Total pot $1 | Rake $0 
Seat 1: hammerwife (big blind) collected ($1)
Seat 2: matiko09 folded before Flop (didn't bet)
Seat 3: first_dnk folded before Flop (didn't bet)
Seat 4: Kukuryzka folded before Flop (didn't bet)
Seat 5: SkUhNi folded before Flop (didn't bet)
Seat 6: Pvsx. folded before Flop (didn't bet)
Seat 7: jirka117 folded before Flop (didn't bet)
Seat 8: ruslik_by (button) folded before Flop (didn't bet)
Seat 9: 23SmOkEr07 (small blind) folded before Flop





PokerStars Hand #154970840828:  Hold'em No Limit (£0.25/£0.50 GBP) - 2016/06/20 12:57:50 CET [2016/06/20 6:57:50 ET]
Table 'Tesla' 6-max Seat #3 is the button
Seat 1: Rubleff85 (£31.20 in chips) 
Seat 2: matiko09 (£80.45 in chips) 
Seat 3: asmodej666 (£50 in chips) 
Seat 4: VahTang_89 (£75.42 in chips) 
Seat 5: Nego Razu (£52.10 in chips) 
Seat 6: faceMyBallz_ (£50 in chips) 
VahTang_89: posts small blind £0.25
Nego Razu: posts big blind £0.50
*** HOLE CARDS ***
Dealt to matiko09 [8c Ts]
faceMyBallz_: raises £1 to £1.50
Rubleff85: calls £1.50
matiko09: folds 
asmodej666: folds 
VahTang_89: folds 
Nego Razu: folds 
*** FLOP *** [6h 4d Qc]
faceMyBallz_: checks 
Rubleff85: bets £1.78
faceMyBallz_: calls £1.78
*** TURN *** [6h 4d Qc] [4h]
faceMyBallz_: checks 
Rubleff85: checks 
*** RIVER *** [6h 4d Qc 4h] [Js]
faceMyBallz_: bets £4
Rubleff85: calls £4
*** SHOW DOWN ***
faceMyBallz_: shows [Kd Qd] (two pair, Queens and Fours)
Rubleff85: mucks hand 
faceMyBallz_ collected £14.54 from pot
*** SUMMARY ***
Total pot £15.31 | Rake £0.77 
Board [6h 4d Qc 4h Js]
Seat 1: Rubleff85 mucked [Jd 8s]
Seat 2: matiko09 folded before Flop (didn't bet)
Seat 3: asmodej666 (button) folded before Flop (didn't bet)
Seat 4: VahTang_89 (small blind) folded before Flop
Seat 5: Nego Razu (big blind) folded before Flop
Seat 6: faceMyBallz_ showed [Kd Qd] and won (£14.54) with two pair, Queens and Fours





PokerStars Hand #154970841748:  Hold'em No Limit (€0.25/€0.50 EUR) - 2016/06/20 12:57:52 CET [2016/06/20 6:57:52 ET]
Table 'Bechuana' 6-max Seat #4 is the button
Seat 1: zitagirl (€31.67 in chips) 
Seat 2: matiko09 (€50.75 in chips) 
Seat 3: Aju!ntje (€66.35 in chips) 
Seat 4: Wwwasian (€55.32 in chips) 
fanmtZ has timed out
fanmtZ: is sitting out 
SlayersGBG will be allowed to play after the button
zitagirl: posts small blind €0.25
matiko09: posts big blind €0.50
*** HOLE CARDS ***
Dealt to matiko09 [7d 5d]
Aju!ntje: folds 
Wwwasian: folds 
zitagirl: folds 
Uncalled bet (€0.25) returned to matiko09
matiko09 collected €0.50 from pot
matiko09: doesn't show hand 
*** SUMMARY ***
Total pot €0.50 | Rake €0 
Seat 1: zitagirl (small blind) folded before Flop
Seat 2: matiko09 (big blind) collected (€0.50)
Seat 3: Aju!ntje folded before Flop (didn't bet)
Seat 4: Wwwasian (button) folded before Flop (didn't bet)





PokerStars Hand #154970843307:  Hold'em No Limit ($0.50/$1.00 USD) - 2016/06/20 12:57:57 CET [2016/06/20 6:57:57 ET]
Table 'Garumna II' 9-max Seat #6 is the button
Seat 1: ki11u ($139.50 in chips) 
Seat 2: Racushniak ($100 in chips) 
Seat 3: mooose100 ($100 in chips) 
Seat 4: Ndundun Gipe ($38.98 in chips) 
Seat 5: rura53 ($76.50 in chips) 
Seat 6: SexyAngeline ($51.07 in chips) 
Seat 7: Avtovo ($109.88 in chips) 
Seat 8: matiko09 ($109.52 in chips) 
Seat 9: SkUhNi ($100 in chips) 
Avtovo: posts small blind $0.50
matiko09: posts big blind $1
*** HOLE CARDS ***
Dealt to matiko09 [3c 8c]
SkUhNi: folds 
ki11u: folds 
Racushniak: folds 
mooose100: folds 
Ndundun Gipe: calls $1
rura53: folds 
SexyAngeline: raises $3 to $4
Avtovo: folds 
matiko09: folds 
Ndundun Gipe: calls $3
*** FLOP *** [7s 8d Ah]
Ndundun Gipe: checks 
SexyAngeline: checks 
*** TURN *** [7s 8d Ah] [Ad]
Ndundun Gipe: checks 
SexyAngeline: bets $6.04
Ndundun Gipe: calls $6.04
*** RIVER *** [7s 8d Ah Ad] [6d]
Ndundun Gipe: bets $28.94 and is all-in
SexyAngeline: folds 
Uncalled bet ($28.94) returned to Ndundun Gipe
Ndundun Gipe collected $20.50 from pot
Ndundun Gipe: doesn't show hand 
*** SUMMARY ***
Total pot $21.58 | Rake $1.08 
Board [7s 8d Ah Ad 6d]
Seat 1: ki11u folded before Flop (didn't bet)
Seat 2: Racushniak folded before Flop (didn't bet)
Seat 3: mooose100 folded before Flop (didn't bet)
Seat 4: Ndundun Gipe collected ($20.50)
Seat 5: rura53 folded before Flop (didn't bet)
Seat 6: SexyAngeline (button) folded on the River
Seat 7: Avtovo (small blind) folded before Flop
Seat 8: matiko09 (big blind) folded before Flop
Seat 9: SkUhNi folded before Flop (didn't bet)





PokerStars Hand #154970846478:  Hold'em No Limit ($0.50/$1.00 USD) - 2016/06/20 12:58:06 CET [2016/06/20 6:58:06 ET]
Table 'Annika' 9-max Seat #9 is the button
Seat 1: hammerwife ($106.27 in chips) 
Seat 2: matiko09 ($105.30 in chips) 
Seat 3: first_dnk ($89.28 in chips) 
Seat 4: Kukuryzka ($101.50 in chips) 
Seat 5: SkUhNi ($109.82 in chips) 
Seat 6: Pvsx. ($101.05 in chips) 
Seat 7: jirka117 ($48.19 in chips) 
Seat 8: ruslik_by ($119.70 in chips) 
Seat 9: 23SmOkEr07 ($154.35 in chips) 
hammerwife: posts small blind $0.50
matiko09: posts big blind $1
*** HOLE CARDS ***
Dealt to matiko09 [Jh 8h]
first_dnk: folds 
Kukuryzka: folds 
SkUhNi: folds 
Pvsx.: folds 
jirka117: calls $1
ruslik_by: raises $3 to $4
23SmOkEr07: folds 
hammerwife: raises $9 to $13
matiko09: folds 
jirka117: folds 
ruslik_by: folds 
Uncalled bet ($9) returned to hammerwife
hammerwife collected $10 from pot
hammerwife: doesn't show hand 
*** SUMMARY ***
Total pot $10 | Rake $0 
Seat 1: hammerwife (small blind) collected ($10)
Seat 2: matiko09 (big blind) folded before Flop
Seat 3: first_dnk folded before Flop (didn't bet)
Seat 4: Kukuryzka folded before Flop (didn't bet)
Seat 5: SkUhNi folded before Flop (didn't bet)
Seat 6: Pvsx. folded before Flop (didn't bet)
Seat 7: jirka117 folded before Flop
Seat 8: ruslik_by folded before Flop
Seat 9: 23SmOkEr07 (button) folded before Flop (didn't bet)





PokerStars Hand #154970846952:  Hold'em No Limit ($0.50/$1.00 USD) - 2016/06/20 12:58:07 CET [2016/06/20 6:58:07 ET]
Table 'Ernestina' 9-max Seat #1 is the button
Seat 1: diva3150 ($113.15 in chips) 
Seat 2: matiko09 ($163.60 in chips) 
Seat 3: Pvsx. ($185.99 in chips) 
Seat 4: SkUhNi ($103.65 in chips) 
Seat 5: Dickyxxx ($142.38 in chips) 
Seat 8: ruslik_by ($243.03 in chips) 
Seat 9: 23SmOkEr07 ($100 in chips) 
matiko09: posts small blind $0.50
Pvsx.: posts big blind $1
arctur17: sits out 
*** HOLE CARDS ***
Dealt to matiko09 [5d Jd]
SkUhNi: folds 
Dickyxxx: raises $2 to $3
ruslik_by: folds 
23SmOkEr07: folds 
diva3150: calls $3
matiko09: folds 
Pvsx.: folds 
*** FLOP *** [5h 8d 3s]
Dickyxxx: bets $4.55
diva3150: folds 
Uncalled bet ($4.55) returned to Dickyxxx
Dickyxxx collected $7.12 from pot
Dickyxxx: doesn't show hand 
*** SUMMARY ***
Total pot $7.50 | Rake $0.38 
Board [5h 8d 3s]
Seat 1: diva3150 (button) folded on the Flop
Seat 2: matiko09 (small blind) folded before Flop
Seat 3: Pvsx. (big blind) folded before Flop
Seat 4: SkUhNi folded before Flop (didn't bet)
Seat 5: Dickyxxx collected ($7.12)
Seat 8: ruslik_by folded before Flop (didn't bet)
Seat 9: 23SmOkEr07 folded before Flop (didn't bet)





PokerStars Hand #154970849585:  Hold'em No Limit ($0.50/$1.00 USD) - 2016/06/20 12:58:14 CET [2016/06/20 6:58:14 ET]
Table 'Ambrosia II' 9-max Seat #9 is the button
Seat 1: 23SmOkEr07 ($211.80 in chips) 
Seat 3: Filojoes ($100 in chips) 
Seat 4: mi$$I$Elena ($193.39 in chips) 
Seat 5: Mattulh ($105.38 in chips) 
Seat 6: ruslik_by ($111.62 in chips) 
Seat 7: matiko09 ($100 in chips) 
Seat 8: hammerwife ($117.95 in chips) 
Seat 9: SkUhNi ($135.26 in chips) 
23SmOkEr07: posts small blind $0.50
Filojoes: posts big blind $1
*** HOLE CARDS ***
Dealt to matiko09 [Qs 3h]
mi$$I$Elena: folds 
Eyeballz1307 leaves the table
Mattulh: folds 
ruslik_by: folds 
matiko09: folds 
hammerwife: folds 
SkUhNi: raises $1 to $2
23SmOkEr07: folds 
Filojoes: folds 
Uncalled bet ($1) returned to SkUhNi
SkUhNi collected $2.50 from pot
SkUhNi: doesn't show hand 
*** SUMMARY ***
Total pot $2.50 | Rake $0 
Seat 1: 23SmOkEr07 (small blind) folded before Flop
Seat 3: Filojoes (big blind) folded before Flop
Seat 4: mi$$I$Elena folded before Flop (didn't bet)
Seat 5: Mattulh folded before Flop (didn't bet)
Seat 6: ruslik_by folded before Flop (didn't bet)
Seat 7: matiko09 folded before Flop (didn't bet)
Seat 8: hammerwife folded before Flop (didn't bet)
Seat 9: SkUhNi (button) collected ($2.50)





PokerStars Hand #154970850700:  Hold'em No Limit (£0.25/£0.50 GBP) - 2016/06/20 12:58:17 CET [2016/06/20 6:58:17 ET]
Table 'Azalea' 6-max Seat #4 is the button
Seat 1: mitsuVK (£53.60 in chips) 
Seat 2: matiko09 (£75.92 in chips) 
Seat 3: tyoma_knp (£57.53 in chips) 
Seat 4: faceMyBallz_ (£97.97 in chips) 
Seat 5: mudders693 (£54.13 in chips) 
Seat 6: Bënedic10 (£70.08 in chips) 
mudders693: posts small blind £0.25
Bënedic10: posts big blind £0.50
*** HOLE CARDS ***
Dealt to matiko09 [8s 5s]
mitsuVK: folds 
matiko09: folds 
tyoma_knp: folds 
faceMyBallz_: folds 
mudders693: raises £1 to £1.50
Bënedic10: folds 
Uncalled bet (£1) returned to mudders693
mudders693 collected £1 from pot
mudders693: doesn't show hand 
*** SUMMARY ***
Total pot £1 | Rake £0 
Seat 1: mitsuVK folded before Flop (didn't bet)
Seat 2: matiko09 folded before Flop (didn't bet)
Seat 3: tyoma_knp folded before Flop (didn't bet)
Seat 4: faceMyBallz_ (button) folded before Flop (didn't bet)
Seat 5: mudders693 (small blind) collected (£1)
Seat 6: Bënedic10 (big blind) folded before Flop





PokerStars Hand #154970852151:  Hold'em No Limit (£0.25/£0.50 GBP) - 2016/06/20 12:58:21 CET [2016/06/20 6:58:21 ET]
Table 'Tesla' 6-max Seat #4 is the button
Seat 1: Rubleff85 (£23.92 in chips) 
Seat 2: matiko09 (£80.45 in chips) 
Seat 3: asmodej666 (£50 in chips) 
Seat 4: VahTang_89 (£75.17 in chips) 
Seat 5: Nego Razu (£51.60 in chips) 
Seat 6: faceMyBallz_ (£57.26 in chips) 
Nego Razu: posts small blind £0.25
faceMyBallz_: posts big blind £0.50
*** HOLE CARDS ***
Dealt to matiko09 [Qd 2s]
Rubleff85: raises £0.50 to £1
matiko09: folds 
asmodej666: folds 
VahTang_89: folds 
Nego Razu: folds 
faceMyBallz_: folds 
Uncalled bet (£0.50) returned to Rubleff85
Rubleff85 collected £1.25 from pot
Rubleff85: doesn't show hand 
*** SUMMARY ***
Total pot £1.25 | Rake £0 
Seat 1: Rubleff85 collected (£1.25)
Seat 2: matiko09 folded before Flop (didn't bet)
Seat 3: asmodej666 folded before Flop (didn't bet)
Seat 4: VahTang_89 (button) folded before Flop (didn't bet)
Seat 5: Nego Razu (small blind) folded before Flop
Seat 6: faceMyBallz_ (big blind) folded before Flop





PokerStars Hand #154970852915:  Hold'em No Limit ($0.25/$0.50 USD) - 2016/06/20 12:58:23 CET [2016/06/20 6:58:23 ET]
Table 'Scheddi II' 9-max Seat #3 is the button
Seat 1: matiko09 ($93.35 in chips) 
Seat 2: Yaaaazz ($59.86 in chips) 
Seat 3: mi$$I$Elena ($82.76 in chips) 
Seat 4: GOOFA13 ($82.50 in chips) 
Seat 5: zarplatka ($40 in chips) 
Seat 6: orochimaturi ($50 in chips) 
Seat 7: HopeMayBee ($115.11 in chips) 
Seat 9: Infinitinium ($107.21 in chips) 
GOOFA13: posts small blind $0.25
zarplatka: posts big blind $0.50
Danil27: sits out 
matiko09: posts the ante $0.10
Yaaaazz: posts the ante $0.10
mi$$I$Elena: posts the ante $0.10
GOOFA13: posts the ante $0.10
zarplatka: posts the ante $0.10
orochimaturi: posts the ante $0.10
HopeMayBee: posts the ante $0.10
Infinitinium: posts the ante $0.10
*** HOLE CARDS ***
Dealt to matiko09 [Jh 5c]
orochimaturi: folds 
HopeMayBee: folds 
Infinitinium: calls $0.50
matiko09: folds 
Yaaaazz: folds 
mi$$I$Elena: folds 
GOOFA13: raises $2 to $2.50
zarplatka: folds 
Infinitinium: calls $2
*** FLOP *** [6s 9s Kh]
GOOFA13: bets $3.50
Infinitinium: calls $3.50
*** TURN *** [6s 9s Kh] [4c]
GOOFA13: checks 
Infinitinium: bets $2
GOOFA13: calls $2
*** RIVER *** [6s 9s Kh 4c] [8d]
GOOFA13: checks 
Infinitinium: bets $8.22
GOOFA13: folds 
Uncalled bet ($8.22) returned to Infinitinium
Infinitinium collected $16.44 from pot
Infinitinium: doesn't show hand 
*** SUMMARY ***
Total pot $17.30 | Rake $0.86 
Board [6s 9s Kh 4c 8d]
Seat 1: matiko09 folded before Flop (didn't bet)
Seat 2: Yaaaazz folded before Flop (didn't bet)
Seat 3: mi$$I$Elena (button) folded before Flop (didn't bet)
Seat 4: GOOFA13 (small blind) folded on the River
Seat 5: zarplatka (big blind) folded before Flop
Seat 6: orochimaturi folded before Flop (didn't bet)
Seat 7: HopeMayBee folded before Flop (didn't bet)
Seat 9: Infinitinium collected ($16.44)





PokerStars Hand #154970852790:  Hold'em No Limit (£0.25/£0.50 GBP) - 2016/06/20 12:58:23 CET [2016/06/20 6:58:23 ET]
Table 'Ani' 6-max Seat #6 is the button
Seat 1: asmodej666 (£52.84 in chips) 
Seat 2: mitsuVK (£59.50 in chips) 
Seat 3: Doobes8555 (£63.71 in chips) 
Seat 4: matiko09 (£65.58 in chips) 
Seat 5: Wwwasian (£56.93 in chips) 
Seat 6: faceMyBallz_ (£55.41 in chips) 
asmodej666: posts small blind £0.25
mitsuVK: posts big blind £0.50
*** HOLE CARDS ***
Dealt to matiko09 [4d 6d]
Doobes8555: folds 
matiko09: folds 
Wwwasian: folds 
faceMyBallz_: folds 
asmodej666: folds 
Uncalled bet (£0.25) returned to mitsuVK
mitsuVK collected £0.50 from pot
mitsuVK: doesn't show hand 
*** SUMMARY ***
Total pot £0.50 | Rake £0 
Seat 1: asmodej666 (small blind) folded before Flop
Seat 2: mitsuVK (big blind) collected (£0.50)
Seat 3: Doobes8555 folded before Flop (didn't bet)
Seat 4: matiko09 folded before Flop (didn't bet)
Seat 5: Wwwasian folded before Flop (didn't bet)
Seat 6: faceMyBallz_ (button) folded before Flop (didn't bet)





PokerStars Hand #154970853558:  Hold'em No Limit ($0.50/$1.00 USD) - 2016/06/20 12:58:25 CET [2016/06/20 6:58:25 ET]
Table 'Anhui' 9-max Seat #2 is the button
Seat 1: SkUhNi ($158.38 in chips) 
Seat 2: ruslik_by ($279.19 in chips) 
Seat 3: hammerwife ($153.39 in chips) 
Seat 4: Racushniak ($100 in chips) 
Seat 6: 23SmOkEr07 ($119.18 in chips) 
Seat 7: matiko09 ($121.98 in chips) 
Seat 8: blackmont111 ($82.35 in chips) 
hammerwife: posts small blind $0.50
Racushniak: posts big blind $1
Dickyxxx: sits out 
SexyAngeline: sits out 
*** HOLE CARDS ***
Dealt to matiko09 [3d 6s]
23SmOkEr07: folds 
matiko09: folds 
blackmont111: folds 
SkUhNi: folds 
ruslik_by: raises $1 to $2
hammerwife: folds 
Racushniak: calls $1
*** FLOP *** [6c 5s Jc]
Racushniak: checks 
ruslik_by: bets $1.45
Racushniak: raises $2.55 to $4
ruslik_by: calls $2.55
*** TURN *** [6c 5s Jc] [Qc]
Racushniak: bets $3.92
ruslik_by: calls $3.92
*** RIVER *** [6c 5s Jc Qc] [7h]
Racushniak: bets $17.38
ruslik_by: folds 
Uncalled bet ($17.38) returned to Racushniak
Racushniak collected $19.32 from pot
Racushniak: doesn't show hand 
*** SUMMARY ***
Total pot $20.34 | Rake $1.02 
Board [6c 5s Jc Qc 7h]
Seat 1: SkUhNi folded before Flop (didn't bet)
Seat 2: ruslik_by (button) folded on the River
Seat 3: hammerwife (small blind) folded before Flop
Seat 4: Racushniak (big blind) collected ($19.32)
Seat 6: 23SmOkEr07 folded before Flop (didn't bet)
Seat 7: matiko09 folded before Flop (didn't bet)
Seat 8: blackmont111 folded before Flop (didn't bet)





PokerStars Hand #154970855654:  Hold'em No Limit (€0.25/€0.50 EUR) - 2016/06/20 12:58:31 CET [2016/06/20 6:58:31 ET]
Table 'Bechuana' 6-max Seat #1 is the button
Seat 1: zitagirl (€31.42 in chips) 
Seat 2: matiko09 (€51 in chips) 
Seat 3: Aju!ntje (€66.35 in chips) 
Seat 4: Wwwasian (€55.32 in chips) 
matiko09: posts small blind €0.25
Aju!ntje: posts big blind €0.50
SlayersGBG: sits out 
*** HOLE CARDS ***
Dealt to matiko09 [Tc Jd]
Wwwasian: folds 
zitagirl has timed out
zitagirl: folds 
matiko09: raises €1 to €1.50
Aju!ntje: folds 
Uncalled bet (€1) returned to matiko09
matiko09 collected €1 from pot
matiko09: doesn't show hand 
*** SUMMARY ***
Total pot €1 | Rake €0 
Seat 1: zitagirl (button) folded before Flop (didn't bet)
Seat 2: matiko09 (small blind) collected (€1)
Seat 3: Aju!ntje (big blind) folded before Flop
Seat 4: Wwwasian folded before Flop (didn't bet)





PokerStars Hand #154970857383:  Hold'em No Limit (£0.25/£0.50 GBP) - 2016/06/20 12:58:35 CET [2016/06/20 6:58:35 ET]
Table 'Azalea' 6-max Seat #5 is the button
Seat 1: mitsuVK (£53.60 in chips) 
Seat 2: matiko09 (£75.92 in chips) 
Seat 3: tyoma_knp (£57.53 in chips) 
Seat 4: faceMyBallz_ (£97.97 in chips) 
Seat 5: mudders693 (£54.63 in chips) 
Seat 6: Bënedic10 (£69.58 in chips) 
Bënedic10: posts small blind £0.25
mitsuVK: posts big blind £0.50
*** HOLE CARDS ***
Dealt to matiko09 [As Qd]
matiko09: raises £1 to £1.50
tyoma_knp: folds 
faceMyBallz_: folds 
mudders693: raises £2.50 to £4
Bënedic10: folds 
mitsuVK: folds 
matiko09: calls £2.50
*** FLOP *** [Td 8s Kc]
matiko09: checks 
mudders693: bets £4.50
matiko09: folds 
Uncalled bet (£4.50) returned to mudders693
mudders693 collected £8.31 from pot
mudders693: doesn't show hand 
*** SUMMARY ***
Total pot £8.75 | Rake £0.44 
Board [Td 8s Kc]
Seat 1: mitsuVK (big blind) folded before Flop
Seat 2: matiko09 folded on the Flop
Seat 3: tyoma_knp folded before Flop (didn't bet)
Seat 4: faceMyBallz_ folded before Flop (didn't bet)
Seat 5: mudders693 (button) collected (£8.31)
Seat 6: Bënedic10 (small blind) folded before Flop





PokerStars Hand #154970857250:  Hold'em No Limit ($0.50/$1.00 USD) - 2016/06/20 12:58:35 CET [2016/06/20 6:58:35 ET]
Table 'Ernestina' 9-max Seat #2 is the button
Seat 1: diva3150 ($110.15 in chips) 
Seat 2: matiko09 ($163.10 in chips) 
Seat 3: Pvsx. ($184.99 in chips) 
Seat 4: SkUhNi ($103.65 in chips) 
Seat 5: Dickyxxx ($146.50 in chips) 
Seat 8: ruslik_by ($243.03 in chips) 
Seat 9: 23SmOkEr07 ($100 in chips) 
Pvsx.: posts small blind $0.50
SkUhNi: posts big blind $1
arctur17: sits out 
*** HOLE CARDS ***
Dealt to matiko09 [9d Qc]
Dickyxxx: raises $2 to $3
ruslik_by: folds 
23SmOkEr07: folds 
diva3150: raises $3 to $6
matiko09: folds 
Pvsx.: folds 
SkUhNi: folds 
Dickyxxx: raises $12 to $18
diva3150: calls $12
*** FLOP *** [Ad 4s 5h]
Dickyxxx: bets $15
diva3150: raises $65.62 to $80.62
Dickyxxx: folds 
Uncalled bet ($65.62) returned to diva3150
diva3150 collected $65 from pot
diva3150: doesn't show hand 
*** SUMMARY ***
Total pot $67.50 | Rake $2.50 
Board [Ad 4s 5h]
Seat 1: diva3150 collected ($65)
Seat 2: matiko09 (button) folded before Flop (didn't bet)
Seat 3: Pvsx. (small blind) folded before Flop
Seat 4: SkUhNi (big blind) folded before Flop
Seat 5: Dickyxxx folded on the Flop
Seat 8: ruslik_by folded before Flop (didn't bet)
Seat 9: 23SmOkEr07 folded before Flop (didn't bet)





PokerStars Hand #154970857136:  Hold'em No Limit (£0.25/£0.50 GBP) - 2016/06/20 12:58:35 CET [2016/06/20 6:58:35 ET]
Table 'Tesla' 6-max Seat #5 is the button
Seat 1: Rubleff85 (£24.67 in chips) 
Seat 2: matiko09 (£80.45 in chips) 
Seat 3: asmodej666 (£50 in chips) 
Seat 4: VahTang_89 (£75.17 in chips) 
Seat 5: Nego Razu (£51.35 in chips) 
Seat 6: faceMyBallz_ (£56.76 in chips) 
faceMyBallz_: posts small blind £0.25
Rubleff85: posts big blind £0.50
*** HOLE CARDS ***
Dealt to matiko09 [Ts 9c]
matiko09: folds 
asmodej666: folds 
VahTang_89: folds 
Nego Razu: folds 
faceMyBallz_: calls £0.25
Rubleff85: raises £0.50 to £1
faceMyBallz_: calls £0.50
*** FLOP *** [3d 7h 3h]
faceMyBallz_: checks 
Rubleff85: bets £0.95
faceMyBallz_: folds 
Uncalled bet (£0.95) returned to Rubleff85
Rubleff85 collected £1.90 from pot
Rubleff85: doesn't show hand 
*** SUMMARY ***
Total pot £2 | Rake £0.10 
Board [3d 7h 3h]
Seat 1: Rubleff85 (big blind) collected (£1.90)
Seat 2: matiko09 folded before Flop (didn't bet)
Seat 3: asmodej666 folded before Flop (didn't bet)
Seat 4: VahTang_89 folded before Flop (didn't bet)
Seat 5: Nego Razu (button) folded before Flop (didn't bet)
Seat 6: faceMyBallz_ (small blind) folded on the Flop





PokerStars Hand #154970858190:  Hold'em No Limit (£0.25/£0.50 GBP) - 2016/06/20 12:58:38 CET [2016/06/20 6:58:38 ET]
Table 'Ani' 6-max Seat #1 is the button
Seat 1: asmodej666 (£52.59 in chips) 
Seat 2: mitsuVK (£59.75 in chips) 
Seat 3: Doobes8555 (£63.71 in chips) 
Seat 4: matiko09 (£65.58 in chips) 
Seat 5: Wwwasian (£56.93 in chips) 
Seat 6: faceMyBallz_ (£55.41 in chips) 
mitsuVK: posts small blind £0.25
Doobes8555: posts big blind £0.50
*** HOLE CARDS ***
Dealt to matiko09 [2c Jh]
matiko09: folds 
Wwwasian: folds 
faceMyBallz_: folds 
asmodej666: raises £0.62 to £1.12
mitsuVK: folds 
Doobes8555: calls £0.62
*** FLOP *** [Js Kd 2s]
Doobes8555: checks 
asmodej666: checks 
*** TURN *** [Js Kd 2s] [4c]
Doobes8555: bets £2.50
asmodej666: folds 
Uncalled bet (£2.50) returned to Doobes8555
Doobes8555 collected £2.37 from pot
Doobes8555: doesn't show hand 
*** SUMMARY ***
Total pot £2.49 | Rake £0.12 
Board [Js Kd 2s 4c]
Seat 1: asmodej666 (button) folded on the Turn
Seat 2: mitsuVK (small blind) folded before Flop
Seat 3: Doobes8555 (big blind) collected (£2.37)
Seat 4: matiko09 folded before Flop (didn't bet)
Seat 5: Wwwasian folded before Flop (didn't bet)
Seat 6: faceMyBallz_ folded before Flop (didn't bet)





PokerStars Hand #154970862364:  Hold'em No Limit ($0.50/$1.00 USD) - 2016/06/20 12:58:49 CET [2016/06/20 6:58:49 ET]
Table 'Ambrosia II' 9-max Seat #1 is the button
Seat 1: 23SmOkEr07 ($211.30 in chips) 
Seat 3: Filojoes ($100 in chips) 
Seat 5: Mattulh ($105.38 in chips) 
Seat 6: ruslik_by ($111.62 in chips) 
Seat 7: matiko09 ($100 in chips) 
Seat 8: hammerwife ($117.95 in chips) 
Seat 9: SkUhNi ($136.76 in chips) 
Filojoes: posts small blind $0.50
mi$$I$Elena: is sitting out 
Mattulh: posts big blind $1
*** HOLE CARDS ***
Dealt to matiko09 [8s Ah]
mi$$I$Elena leaves the table
Dickyxxx joins the table at seat #2 
ruslik_by: folds 
matiko09: folds 
Avtovo joins the table at seat #4 
hammerwife: raises $1.50 to $2.50
SkUhNi: folds 
23SmOkEr07: folds 
Filojoes: folds 
Mattulh: folds 
Uncalled bet ($1.50) returned to hammerwife
hammerwife collected $2.50 from pot
hammerwife: doesn't show hand 
*** SUMMARY ***
Total pot $2.50 | Rake $0 
Seat 1: 23SmOkEr07 (button) folded before Flop (didn't bet)
Seat 3: Filojoes (small blind) folded before Flop
Seat 5: Mattulh (big blind) folded before Flop
Seat 6: ruslik_by folded before Flop (didn't bet)
Seat 7: matiko09 folded before Flop (didn't bet)
Seat 8: hammerwife collected ($2.50)
Seat 9: SkUhNi folded before Flop (didn't bet)





PokerStars Hand #154970865184:  Hold'em No Limit (£0.25/£0.50 GBP) - 2016/06/20 12:58:57 CET [2016/06/20 6:58:57 ET]
Table 'Tesla' 6-max Seat #6 is the button
Seat 1: Rubleff85 (£25.57 in chips) 
Seat 2: matiko09 (£80.45 in chips) 
Seat 3: asmodej666 (£50 in chips) 
Seat 4: VahTang_89 (£75.17 in chips) 
Seat 5: Nego Razu (£51.35 in chips) 
Seat 6: faceMyBallz_ (£55.76 in chips) 
Rubleff85: posts small blind £0.25
matiko09: posts big blind £0.50
*** HOLE CARDS ***
Dealt to matiko09 [3c 8s]
asmodej666: folds 
VahTang_89: raises £0.50 to £1
Nego Razu: folds 
faceMyBallz_: folds 
Rubleff85: calls £0.75
matiko09: folds 
*** FLOP *** [3s 3d Ah]
Rubleff85: checks 
VahTang_89: checks 
*** TURN *** [3s 3d Ah] [6d]
Rubleff85: bets £2
VahTang_89: calls £2
*** RIVER *** [3s 3d Ah 6d] [Tc]
Rubleff85: checks 
VahTang_89: bets £3.09
Rubleff85: folds 
Uncalled bet (£3.09) returned to VahTang_89
VahTang_89 collected £6.18 from pot
VahTang_89: doesn't show hand 
*** SUMMARY ***
Total pot £6.50 | Rake £0.32 
Board [3s 3d Ah 6d Tc]
Seat 1: Rubleff85 (small blind) folded on the River
Seat 2: matiko09 (big blind) folded before Flop
Seat 3: asmodej666 folded before Flop (didn't bet)
Seat 4: VahTang_89 collected (£6.18)
Seat 5: Nego Razu folded before Flop (didn't bet)
Seat 6: faceMyBallz_ (button) folded before Flop (didn't bet)





PokerStars Hand #154970865208:  Hold'em No Limit ($0.50/$1.00 USD) - 2016/06/20 12:58:57 CET [2016/06/20 6:58:57 ET]
Table 'Isonoe II' 9-max Seat #3 is the button
Seat 1: hammerwife ($100 in chips) 
Seat 2: matiko09 ($126.32 in chips) 
Seat 3: Kukuryzka ($100 in chips) 
Seat 4: Avtovo ($102.50 in chips) 
Seat 5: Filojoes ($110.62 in chips) 
Seat 6: GOOFA13 ($53.96 in chips) 
Seat 7: SkUhNi ($113.82 in chips) 
Seat 8: lewyson ($83.65 in chips) 
Seat 9: djammusic ($64.45 in chips) 
Avtovo: posts small blind $0.50
Filojoes: posts big blind $1
*** HOLE CARDS ***
Dealt to matiko09 [Qd 2d]
GOOFA13: raises $2 to $3
SkUhNi: calls $3
lewyson: calls $3
djammusic: folds 
hammerwife: folds 
matiko09: folds 
Kukuryzka: folds 
Avtovo: folds 
Filojoes: calls $2
*** FLOP *** [8s 3s 3h]
Filojoes: checks 
GOOFA13: checks 
SkUhNi: checks 
lewyson: checks 
*** TURN *** [8s 3s 3h] [5c]
Filojoes: checks 
GOOFA13: checks 
SkUhNi: bets $7
lewyson: folds 
Filojoes: folds 
GOOFA13: folds 
Uncalled bet ($7) returned to SkUhNi
SkUhNi collected $11.88 from pot
SkUhNi: doesn't show hand 
*** SUMMARY ***
Total pot $12.50 | Rake $0.62 
Board [8s 3s 3h 5c]
Seat 1: hammerwife folded before Flop (didn't bet)
Seat 2: matiko09 folded before Flop (didn't bet)
Seat 3: Kukuryzka (button) folded before Flop (didn't bet)
Seat 4: Avtovo (small blind) folded before Flop
Seat 5: Filojoes (big blind) folded on the Turn
Seat 6: GOOFA13 folded on the Turn
Seat 7: SkUhNi collected ($11.88)
Seat 8: lewyson folded on the Turn
Seat 9: djammusic folded before Flop (didn't bet)





PokerStars Hand #154970866515:  Hold'em No Limit (€0.25/€0.50 EUR) - 2016/06/20 12:59:01 CET [2016/06/20 6:59:01 ET]
Table 'Bechuana' 6-max Seat #2 is the button
Seat 2: matiko09 (€51.50 in chips) 
Seat 3: Aju!ntje (€65.85 in chips) 
Seat 4: Wwwasian (€55.32 in chips) 
Aju!ntje: posts small blind €0.25
Wwwasian: posts big blind €0.50
SlayersGBG: sits out 
*** HOLE CARDS ***
Dealt to matiko09 [8s 2s]
matiko09: folds 
Aju!ntje: raises €1 to €1.50
Wwwasian: calls €1
*** FLOP *** [As Kh 9d]
Aju!ntje: bets €2.05
Wwwasian: calls €2.05
*** TURN *** [As Kh 9d] [4h]
Aju!ntje: bets €4.85
Wwwasian: raises €4.85 to €9.70
Aju!ntje: calls €4.85
*** RIVER *** [As Kh 9d 4h] [Qc]
Aju!ntje: checks 
Wwwasian: checks 
*** SHOW DOWN ***
Aju!ntje: shows [Kc Ad] (two pair, Aces and Kings)
Wwwasian: mucks hand 
Aju!ntje collected €25.80 from pot
*** SUMMARY ***
Total pot €26.50 | Rake €0.70 
Board [As Kh 9d 4h Qc]
Seat 2: matiko09 (button) folded before Flop (didn't bet)
Seat 3: Aju!ntje (small blind) showed [Kc Ad] and won (€25.80) with two pair, Aces and Kings
Seat 4: Wwwasian (big blind) mucked [Ah Jd]





PokerStars Hand #154970867721:  Hold'em No Limit ($0.50/$1.00 USD) - 2016/06/20 12:59:04 CET [2016/06/20 6:59:04 ET]
Table 'Annika' 9-max Seat #1 is the button
Seat 1: hammerwife ($112.27 in chips) 
Seat 2: matiko09 ($104.30 in chips) 
Seat 3: first_dnk ($89.28 in chips) 
Seat 4: Kukuryzka ($101.50 in chips) 
Seat 5: SkUhNi ($109.82 in chips) 
Seat 6: Pvsx. ($101.05 in chips) 
Seat 7: jirka117 ($47.19 in chips) 
Seat 8: ruslik_by ($115.70 in chips) 
Seat 9: 23SmOkEr07 ($154.35 in chips) 
matiko09: posts small blind $0.50
first_dnk: posts big blind $1
*** HOLE CARDS ***
Dealt to matiko09 [Qd Ts]
Kukuryzka: raises $2 to $3
SkUhNi: folds 
Pvsx.: folds 
jirka117: folds 
ruslik_by: folds 
23SmOkEr07: calls $3
hammerwife: folds 
matiko09: folds 
first_dnk: folds 
*** FLOP *** [3d Th Kd]
Kukuryzka: bets $5.50
23SmOkEr07: folds 
Uncalled bet ($5.50) returned to Kukuryzka
Kukuryzka collected $7.12 from pot
Kukuryzka: doesn't show hand 
*** SUMMARY ***
Total pot $7.50 | Rake $0.38 
Board [3d Th Kd]
Seat 1: hammerwife (button) folded before Flop (didn't bet)
Seat 2: matiko09 (small blind) folded before Flop
Seat 3: first_dnk (big blind) folded before Flop
Seat 4: Kukuryzka collected ($7.12)
Seat 5: SkUhNi folded before Flop (didn't bet)
Seat 6: Pvsx. folded before Flop (didn't bet)
Seat 7: jirka117 folded before Flop (didn't bet)
Seat 8: ruslik_by folded before Flop (didn't bet)
Seat 9: 23SmOkEr07 folded on the Flop





PokerStars Hand #154970869014:  Hold'em No Limit (£0.25/£0.50 GBP) - 2016/06/20 12:59:08 CET [2016/06/20 6:59:08 ET]
Table 'Azalea' 6-max Seat #6 is the button
Seat 1: mitsuVK (£53.10 in chips) 
Seat 2: matiko09 (£71.92 in chips) 
Seat 3: tyoma_knp (£57.53 in chips) 
Seat 4: faceMyBallz_ (£97.97 in chips) 
Seat 5: mudders693 (£58.94 in chips) 
Seat 6: Bënedic10 (£69.33 in chips) 
mitsuVK: posts small blind £0.25
matiko09: posts big blind £0.50
*** HOLE CARDS ***
Dealt to matiko09 [5d Kc]
tyoma_knp: folds 
faceMyBallz_: folds 
mudders693: raises £1 to £1.50
Bënedic10: folds 
mitsuVK: folds 
matiko09: folds 
Uncalled bet (£1) returned to mudders693
mudders693 collected £1.25 from pot
mudders693: doesn't show hand 
*** SUMMARY ***
Total pot £1.25 | Rake £0 
Seat 1: mitsuVK (small blind) folded before Flop
Seat 2: matiko09 (big blind) folded before Flop
Seat 3: tyoma_knp folded before Flop (didn't bet)
Seat 4: faceMyBallz_ folded before Flop (didn't bet)
Seat 5: mudders693 collected (£1.25)
Seat 6: Bënedic10 (button) folded before Flop (didn't bet)





PokerStars Hand #154970871110:  Hold'em No Limit ($0.50/$1.00 USD) - 2016/06/20 12:59:14 CET [2016/06/20 6:59:14 ET]
Table 'Garumna II' 9-max Seat #7 is the button
Seat 1: ki11u ($139.50 in chips) 
Seat 2: Racushniak ($100 in chips) 
Seat 3: mooose100 ($100 in chips) 
Seat 4: Ndundun Gipe ($49.44 in chips) 
Seat 5: rura53 ($76.50 in chips) 
Seat 6: SexyAngeline ($41.03 in chips) 
Seat 7: Avtovo ($109.38 in chips) 
Seat 8: matiko09 ($108.52 in chips) 
Seat 9: SkUhNi ($100 in chips) 
matiko09: posts small blind $0.50
SkUhNi: posts big blind $1
*** HOLE CARDS ***
Dealt to matiko09 [6d 2h]
ki11u: folds 
Racushniak: folds 
mooose100: folds 
Ndundun Gipe: calls $1
rura53: folds 
SexyAngeline: folds 
Avtovo: folds 
matiko09: folds 
SkUhNi: checks 
*** FLOP *** [Qs 6s Qc]
SkUhNi: checks 
Ndundun Gipe: bets $3
SkUhNi: folds 
Uncalled bet ($3) returned to Ndundun Gipe
Ndundun Gipe collected $2.38 from pot
Ndundun Gipe: doesn't show hand 
*** SUMMARY ***
Total pot $2.50 | Rake $0.12 
Board [Qs 6s Qc]
Seat 1: ki11u folded before Flop (didn't bet)
Seat 2: Racushniak folded before Flop (didn't bet)
Seat 3: mooose100 folded before Flop (didn't bet)
Seat 4: Ndundun Gipe collected ($2.38)
Seat 5: rura53 folded before Flop (didn't bet)
Seat 6: SexyAngeline folded before Flop (didn't bet)
Seat 7: Avtovo (button) folded before Flop (didn't bet)
Seat 8: matiko09 (small blind) folded before Flop
Seat 9: SkUhNi (big blind) folded on the Flop





PokerStars Hand #154970873923:  Hold'em No Limit (£0.25/£0.50 GBP) - 2016/06/20 12:59:22 CET [2016/06/20 6:59:22 ET]
Table 'Azalea' 6-max Seat #1 is the button
Seat 1: mitsuVK (£52.85 in chips) 
Seat 2: matiko09 (£71.42 in chips) 
Seat 3: tyoma_knp (£57.53 in chips) 
Seat 4: faceMyBallz_ (£97.97 in chips) 
Seat 5: mudders693 (£59.69 in chips) 
Seat 6: Bënedic10 (£69.33 in chips) 
matiko09: posts small blind £0.25
tyoma_knp: posts big blind £0.50
*** HOLE CARDS ***
Dealt to matiko09 [Qs 9h]
faceMyBallz_: folds 
mudders693: folds 
Bënedic10: folds 
mitsuVK: raises £0.50 to £1
matiko09: folds 
tyoma_knp: folds 
Uncalled bet (£0.50) returned to mitsuVK
mitsuVK collected £1.25 from pot
mitsuVK: doesn't show hand 
*** SUMMARY ***
Total pot £1.25 | Rake £0 
Seat 1: mitsuVK (button) collected (£1.25)
Seat 2: matiko09 (small blind) folded before Flop
Seat 3: tyoma_knp (big blind) folded before Flop
Seat 4: faceMyBallz_ folded before Flop (didn't bet)
Seat 5: mudders693 folded before Flop (didn't bet)
Seat 6: Bënedic10 folded before Flop (didn't bet)





PokerStars Hand #154970874186:  Hold'em No Limit ($0.50/$1.00 USD) - 2016/06/20 12:59:23 CET [2016/06/20 6:59:23 ET]
Table 'Pongola' 9-max Seat #2 is the button
Seat 1: matiko09 ($110 in chips) 
Seat 2: ruslik_by ($126.27 in chips) 
Seat 3: SkUhNi ($109.22 in chips) 
Seat 4: SexyAngeline ($78.71 in chips) 
Seat 5: Avtovo ($100 in chips) 
Seat 6: 23SmOkEr07 ($124.70 in chips) 
Seat 7: Dickyxxx ($156.65 in chips) 
Seat 8: phrantique ($124.19 in chips) 
Seat 9: Filojoes ($152.59 in chips) 
SkUhNi: posts small blind $0.50
SexyAngeline: posts big blind $1
*** HOLE CARDS ***
Dealt to matiko09 [5s Ts]
Avtovo: folds 
23SmOkEr07: folds 
Dickyxxx: raises $2 to $3
phrantique: folds 
Filojoes: folds 
Avtovo leaves the table
matiko09: folds 
ruslik_by: folds 
SkUhNi: folds 
Coolller joins the table at seat #5 
SexyAngeline: folds 
Uncalled bet ($2) returned to Dickyxxx
Dickyxxx collected $2.50 from pot
Dickyxxx: doesn't show hand 
*** SUMMARY ***
Total pot $2.50 | Rake $0 
Seat 1: matiko09 folded before Flop (didn't bet)
Seat 2: ruslik_by (button) folded before Flop (didn't bet)
Seat 3: SkUhNi (small blind) folded before Flop
Seat 4: SexyAngeline (big blind) folded before Flop
Seat 5: Avtovo folded before Flop (didn't bet)
Seat 6: 23SmOkEr07 folded before Flop (didn't bet)
Seat 7: Dickyxxx collected ($2.50)
Seat 8: phrantique folded before Flop (didn't bet)
Seat 9: Filojoes folded before Flop (didn't bet)





PokerStars Hand #154970874148:  Hold'em No Limit ($0.50/$1.00 USD) - 2016/06/20 12:59:23 CET [2016/06/20 6:59:23 ET]
Table 'Normannia' 9-max Seat #7 is the button
Seat 1: hammerwife ($123.22 in chips) 
Seat 2: Pvsx. ($189.34 in chips) 
Seat 3: Avtovo ($100 in chips) 
Seat 4: Filojoes ($102.89 in chips) 
Seat 5: Dickyxxx ($119.22 in chips) 
Seat 7: matiko09 ($106.79 in chips) 
Seat 8: SkUhNi ($132.80 in chips) 
Seat 9: ruslik_by ($146.19 in chips) 
SkUhNi: posts small blind $0.50
ruslik_by: posts big blind $1
*** HOLE CARDS ***
Dealt to matiko09 [5d 9c]
hammerwife: folds 
Pvsx.: folds 
Avtovo: raises $1.50 to $2.50
Filojoes: folds 
Dickyxxx: folds 
matiko09: folds 
SkUhNi: folds 
ruslik_by: folds 
Uncalled bet ($1.50) returned to Avtovo
Avtovo collected $2.50 from pot
Avtovo: doesn't show hand 
*** SUMMARY ***
Total pot $2.50 | Rake $0 
Seat 1: hammerwife folded before Flop (didn't bet)
Seat 2: Pvsx. folded before Flop (didn't bet)
Seat 3: Avtovo collected ($2.50)
Seat 4: Filojoes folded before Flop (didn't bet)
Seat 5: Dickyxxx folded before Flop (didn't bet)
Seat 7: matiko09 (button) folded before Flop (didn't bet)
Seat 8: SkUhNi (small blind) folded before Flop
Seat 9: ruslik_by (big blind) folded before Flop





PokerStars Hand #154970876312:  Hold'em No Limit (£0.25/£0.50 GBP) - 2016/06/20 12:59:29 CET [2016/06/20 6:59:29 ET]
Table 'Ani' 6-max Seat #2 is the button
Seat 1: asmodej666 (£51.47 in chips) 
Seat 2: mitsuVK (£59.50 in chips) 
Seat 3: Doobes8555 (£64.96 in chips) 
Seat 4: matiko09 (£65.58 in chips) 
Seat 5: Wwwasian (£56.93 in chips) 
Seat 6: faceMyBallz_ (£55.41 in chips) 
Doobes8555: posts small blind £0.25
matiko09: posts big blind £0.50
*** HOLE CARDS ***
Dealt to matiko09 [7h 3h]
Wwwasian: folds 
faceMyBallz_: raises £1.25 to £1.75
asmodej666: folds 
mitsuVK: folds 
Doobes8555: folds 
matiko09: folds 
Uncalled bet (£1.25) returned to faceMyBallz_
faceMyBallz_ collected £1.25 from pot
faceMyBallz_: doesn't show hand 
*** SUMMARY ***
Total pot £1.25 | Rake £0 
Seat 1: asmodej666 folded before Flop (didn't bet)
Seat 2: mitsuVK (button) folded before Flop (didn't bet)
Seat 3: Doobes8555 (small blind) folded before Flop
Seat 4: matiko09 (big blind) folded before Flop
Seat 5: Wwwasian folded before Flop (didn't bet)
Seat 6: faceMyBallz_ collected (£1.25)





PokerStars Hand #154970876783:  Hold'em No Limit ($0.50/$1.00 USD) - 2016/06/20 12:59:30 CET [2016/06/20 6:59:30 ET]
Table 'Ernestina' 9-max Seat #3 is the button
Seat 1: diva3150 ($142.15 in chips) 
Seat 2: matiko09 ($163.10 in chips) 
Seat 3: Pvsx. ($184.49 in chips) 
Seat 4: SkUhNi ($102.65 in chips) 
Seat 5: Dickyxxx ($113.50 in chips) 
Seat 8: ruslik_by ($243.03 in chips) 
Seat 9: 23SmOkEr07 ($100 in chips) 
SkUhNi: posts small blind $0.50
Dickyxxx: posts big blind $1
arctur17: sits out 
*** HOLE CARDS ***
Dealt to matiko09 [Js Jh]
ruslik_by: folds 
23SmOkEr07: folds 
diva3150: calls $1
matiko09: raises $3 to $4
Pvsx.: folds 
SkUhNi: folds 
Dickyxxx: folds 
diva3150: calls $3
*** FLOP *** [7d 6h 3c]
diva3150: bets $9.02
matiko09: calls $9.02
*** TURN *** [7d 6h 3c] [2s]
diva3150: checks 
matiko09: bets $17
diva3150: calls $17
*** RIVER *** [7d 6h 3c 2s] [3s]
diva3150: checks 
matiko09: bets $36
diva3150: folds 
Uncalled bet ($36) returned to matiko09
matiko09 collected $59.04 from pot
matiko09: doesn't show hand 
*** SUMMARY ***
Total pot $61.54 | Rake $2.50 
Board [7d 6h 3c 2s 3s]
Seat 1: diva3150 folded on the River
Seat 2: matiko09 collected ($59.04)
Seat 3: Pvsx. (button) folded before Flop (didn't bet)
Seat 4: SkUhNi (small blind) folded before Flop
Seat 5: Dickyxxx (big blind) folded before Flop
Seat 8: ruslik_by folded before Flop (didn't bet)
Seat 9: 23SmOkEr07 folded before Flop (didn't bet)





PokerStars Hand #154970877542:  Hold'em No Limit ($0.25/$0.50 USD) - 2016/06/20 12:59:32 CET [2016/06/20 6:59:32 ET]
Table 'Scheddi II' 9-max Seat #4 is the button
Seat 1: matiko09 ($93.25 in chips) 
Seat 2: Yaaaazz ($59.76 in chips) 
Seat 3: mi$$I$Elena ($82.66 in chips) 
Seat 4: GOOFA13 ($74.40 in chips) 
Seat 5: zarplatka ($40 in chips) 
Seat 6: orochimaturi ($49.90 in chips) 
Seat 7: HopeMayBee ($115.01 in chips) 
Seat 9: Infinitinium ($115.55 in chips) 
zarplatka: posts small blind $0.25
orochimaturi: posts big blind $0.50
Danil27: sits out 
matiko09: posts the ante $0.10
Yaaaazz: posts the ante $0.10
mi$$I$Elena: posts the ante $0.10
GOOFA13: posts the ante $0.10
zarplatka: posts the ante $0.10
orochimaturi: posts the ante $0.10
HopeMayBee: posts the ante $0.10
Infinitinium: posts the ante $0.10
*** HOLE CARDS ***
Dealt to matiko09 [Qs 3s]
HopeMayBee: folds 
Infinitinium: calls $0.50
matiko09: folds 
Yaaaazz: folds 
mi$$I$Elena: folds 
GOOFA13: folds 
zarplatka: folds 
orochimaturi: checks 
*** FLOP *** [7s 6d 8h]
orochimaturi: bets $0.50
Infinitinium: folds 
Uncalled bet ($0.50) returned to orochimaturi
orochimaturi collected $1.95 from pot
orochimaturi: doesn't show hand 
*** SUMMARY ***
Total pot $2.05 | Rake $0.10 
Board [7s 6d 8h]
Seat 1: matiko09 folded before Flop (didn't bet)
Seat 2: Yaaaazz folded before Flop (didn't bet)
Seat 3: mi$$I$Elena folded before Flop (didn't bet)
Seat 4: GOOFA13 (button) folded before Flop (didn't bet)
Seat 5: zarplatka (small blind) folded before Flop
Seat 6: orochimaturi (big blind) collected ($1.95)
Seat 7: HopeMayBee folded before Flop (didn't bet)
Seat 9: Infinitinium folded on the Flop





PokerStars Hand #154970878973:  Hold'em No Limit (£0.25/£0.50 GBP) - 2016/06/20 12:59:36 CET [2016/06/20 6:59:36 ET]
Table 'Azalea' 6-max Seat #2 is the button
Seat 1: mitsuVK (£53.60 in chips) 
Seat 2: matiko09 (£71.17 in chips) 
Seat 3: tyoma_knp (£57.03 in chips) 
Seat 4: faceMyBallz_ (£97.97 in chips) 
Seat 5: mudders693 (£59.69 in chips) 
Seat 6: Bënedic10 (£69.33 in chips) 
tyoma_knp: posts small blind £0.25
faceMyBallz_: posts big blind £0.50
*** HOLE CARDS ***
Dealt to matiko09 [3d 5s]
mudders693: folds 
Bënedic10: raises £1 to £1.50
mitsuVK: folds 
matiko09: folds 
tyoma_knp: folds 
faceMyBallz_: folds 
Uncalled bet (£1) returned to Bënedic10
Bënedic10 collected £1.25 from pot
Bënedic10: doesn't show hand 
*** SUMMARY ***
Total pot £1.25 | Rake £0 
Seat 1: mitsuVK folded before Flop (didn't bet)
Seat 2: matiko09 (button) folded before Flop (didn't bet)
Seat 3: tyoma_knp (small blind) folded before Flop
Seat 4: faceMyBallz_ (big blind) folded before Flop
Seat 5: mudders693 folded before Flop (didn't bet)
Seat 6: Bënedic10 collected (£1.25)





PokerStars Hand #154970883774:  Hold'em No Limit (£0.25/£0.50 GBP) - 2016/06/20 12:59:49 CET [2016/06/20 6:59:49 ET]
Table 'Ani' 6-max Seat #3 is the button
Seat 1: asmodej666 (£51.47 in chips) 
Seat 2: mitsuVK (£59.50 in chips) 
Seat 3: Doobes8555 (£64.71 in chips) 
Seat 4: matiko09 (£65.08 in chips) 
Seat 5: Wwwasian (£56.93 in chips) 
Seat 6: faceMyBallz_ (£56.16 in chips) 
matiko09: posts small blind £0.25
Wwwasian: posts big blind £0.50
*** HOLE CARDS ***
Dealt to matiko09 [7h 2s]
faceMyBallz_: folds 
asmodej666: raises £1 to £1.50
mitsuVK: folds 
Doobes8555: calls £1.50
matiko09: folds 
Wwwasian: folds 
*** FLOP *** [Jd Kh Td]
asmodej666: checks 
Doobes8555: checks 
*** TURN *** [Jd Kh Td] [As]
asmodej666: checks 
Doobes8555: checks 
*** RIVER *** [Jd Kh Td As] [Ks]
asmodej666: checks 
Doobes8555: bets £3.50
asmodej666: folds 
Uncalled bet (£3.50) returned to Doobes8555
Doobes8555 collected £3.56 from pot
Doobes8555: doesn't show hand 
*** SUMMARY ***
Total pot £3.75 | Rake £0.19 
Board [Jd Kh Td As Ks]
Seat 1: asmodej666 folded on the River
Seat 2: mitsuVK folded before Flop (didn't bet)
Seat 3: Doobes8555 (button) collected (£3.56)
Seat 4: matiko09 (small blind) folded before Flop
Seat 5: Wwwasian (big blind) folded before Flop
Seat 6: faceMyBallz_ folded before Flop (didn't bet)





PokerStars Hand #154970883692:  Hold'em No Limit (£0.25/£0.50 GBP) - 2016/06/20 12:59:49 CET [2016/06/20 6:59:49 ET]
Table 'Tesla' 6-max Seat #1 is the button
Seat 1: Rubleff85 (£22.57 in chips) 
Seat 2: matiko09 (£79.95 in chips) 
Seat 3: asmodej666 (£50 in chips) 
Seat 4: VahTang_89 (£78.35 in chips) 
Seat 5: Nego Razu (£51.35 in chips) 
Seat 6: faceMyBallz_ (£55.76 in chips) 
matiko09: posts small blind £0.25
asmodej666: posts big blind £0.50
*** HOLE CARDS ***
Dealt to matiko09 [5h 5d]
VahTang_89: raises £0.50 to £1
Nego Razu: folds 
faceMyBallz_: folds 
Rubleff85: folds 
matiko09: folds 
asmodej666: calls £0.50
*** FLOP *** [4c 4s Qd]
asmodej666: checks 
VahTang_89: bets £0.74
asmodej666: calls £0.74
*** TURN *** [4c 4s Qd] [9s]
asmodej666: checks 
VahTang_89: bets £1.77
asmodej666: folds 
Uncalled bet (£1.77) returned to VahTang_89
VahTang_89 collected £3.54 from pot
VahTang_89: doesn't show hand 
*** SUMMARY ***
Total pot £3.73 | Rake £0.19 
Board [4c 4s Qd 9s]
Seat 1: Rubleff85 (button) folded before Flop (didn't bet)
Seat 2: matiko09 (small blind) folded before Flop
Seat 3: asmodej666 (big blind) folded on the Turn
Seat 4: VahTang_89 collected (£3.54)
Seat 5: Nego Razu folded before Flop (didn't bet)
Seat 6: faceMyBallz_ folded before Flop (didn't bet)





PokerStars Hand #154970885061:  Hold'em No Limit ($0.50/$1.00 USD) - 2016/06/20 12:59:53 CET [2016/06/20 6:59:53 ET]
Table 'Pongola' 9-max Seat #3 is the button
Seat 1: matiko09 ($110 in chips) 
Seat 2: ruslik_by ($126.27 in chips) 
Seat 3: SkUhNi ($108.72 in chips) 
Seat 4: SexyAngeline ($77.71 in chips) 
Seat 5: Coolller ($100 in chips) 
Seat 6: 23SmOkEr07 ($124.70 in chips) 
Seat 7: Dickyxxx ($158.15 in chips) 
Seat 8: phrantique ($124.19 in chips) 
Seat 9: Filojoes ($152.59 in chips) 
SexyAngeline: posts small blind $0.50
Coolller: posts big blind $1
*** HOLE CARDS ***
Dealt to matiko09 [3s 5d]
23SmOkEr07: raises $1.50 to $2.50
Dickyxxx: folds 
phrantique: folds 
Filojoes: folds 
matiko09: folds 
ruslik_by: folds 
SkUhNi: folds 
SexyAngeline: folds 
Coolller: folds 
Uncalled bet ($1.50) returned to 23SmOkEr07
23SmOkEr07 collected $2.50 from pot
23SmOkEr07: doesn't show hand 
*** SUMMARY ***
Total pot $2.50 | Rake $0 
Seat 1: matiko09 folded before Flop (didn't bet)
Seat 2: ruslik_by folded before Flop (didn't bet)
Seat 3: SkUhNi (button) folded before Flop (didn't bet)
Seat 4: SexyAngeline (small blind) folded before Flop
Seat 5: Coolller (big blind) folded before Flop
Seat 6: 23SmOkEr07 collected ($2.50)
Seat 7: Dickyxxx folded before Flop (didn't bet)
Seat 8: phrantique folded before Flop (didn't bet)
Seat 9: Filojoes folded before Flop (didn't bet)





PokerStars Hand #154970885916:  Hold'em No Limit ($0.50/$1.00 USD) - 2016/06/20 12:59:55 CET [2016/06/20 6:59:55 ET]
Table 'Garumna II' 9-max Seat #8 is the button
Seat 1: ki11u ($139.50 in chips) 
Seat 2: Racushniak ($100 in chips) 
Seat 3: mooose100 ($100 in chips) 
Seat 4: Ndundun Gipe ($50.82 in chips) 
Seat 5: rura53 ($76.50 in chips) 
Seat 6: SexyAngeline ($41.03 in chips) 
Seat 7: Avtovo ($109.38 in chips) 
Seat 8: matiko09 ($108.02 in chips) 
Seat 9: SkUhNi ($100 in chips) 
SkUhNi: posts small blind $0.50
ki11u: posts big blind $1
*** HOLE CARDS ***
Dealt to matiko09 [Ad 3h]
Racushniak: folds 
mooose100: folds 
Ndundun Gipe: calls $1
rura53: folds 
SexyAngeline: folds 
Avtovo: folds 
matiko09: raises $3 to $4
SkUhNi: folds 
ki11u: folds 
Ndundun Gipe: calls $3
*** FLOP *** [3s 4s Tc]
Ndundun Gipe: checks 
matiko09: checks 
*** TURN *** [3s 4s Tc] [7s]
Ndundun Gipe: bets $1
matiko09: folds 
Uncalled bet ($1) returned to Ndundun Gipe
Ndundun Gipe collected $9.02 from pot
Ndundun Gipe: doesn't show hand 
*** SUMMARY ***
Total pot $9.50 | Rake $0.48 
Board [3s 4s Tc 7s]
Seat 1: ki11u (big blind) folded before Flop
Seat 2: Racushniak folded before Flop (didn't bet)
Seat 3: mooose100 folded before Flop (didn't bet)
Seat 4: Ndundun Gipe collected ($9.02)
Seat 5: rura53 folded before Flop (didn't bet)
Seat 6: SexyAngeline folded before Flop (didn't bet)
Seat 7: Avtovo folded before Flop (didn't bet)
Seat 8: matiko09 (button) folded on the Turn
Seat 9: SkUhNi (small blind) folded before Flop





PokerStars Hand #154970887676:  Hold'em No Limit (€0.25/€0.50 EUR) - 2016/06/20 13:00:00 CET [2016/06/20 7:00:00 ET]
Table 'Bechuana' 6-max Seat #3 is the button
Seat 2: matiko09 (€51.50 in chips) 
Seat 3: Aju!ntje (€78.40 in chips) 
Seat 4: Wwwasian (€50 in chips) 
Seat 5: fanmtZ (€46.49 in chips) 
Wwwasian: posts small blind €0.25
fanmtZ: posts big blind €0.50
SlayersGBG: sits out 
*** HOLE CARDS ***
Dealt to matiko09 [8s Tc]
matiko09: folds 
Aju!ntje: folds 
Wwwasian: folds 
Uncalled bet (€0.25) returned to fanmtZ
fanmtZ collected €0.50 from pot
fanmtZ: doesn't show hand 
*** SUMMARY ***
Total pot €0.50 | Rake €0 
Seat 2: matiko09 folded before Flop (didn't bet)
Seat 3: Aju!ntje (button) folded before Flop (didn't bet)
Seat 4: Wwwasian (small blind) folded before Flop
Seat 5: fanmtZ (big blind) collected (€0.50)





PokerStars Hand #154970888212:  Hold'em No Limit (£0.25/£0.50 GBP) - 2016/06/20 13:00:02 CET [2016/06/20 7:00:02 ET]
Table 'Azalea' 6-max Seat #3 is the button
Seat 1: mitsuVK (£53.60 in chips) 
Seat 2: matiko09 (£71.17 in chips) 
Seat 3: tyoma_knp (£56.78 in chips) 
Seat 4: faceMyBallz_ (£97.47 in chips) 
Seat 5: mudders693 (£59.69 in chips) 
Seat 6: Bënedic10 (£70.08 in chips) 
faceMyBallz_: posts small blind £0.25
mudders693: posts big blind £0.50
*** HOLE CARDS ***
Dealt to matiko09 [7s 3d]
Bënedic10: raises £1 to £1.50
mitsuVK: folds 
matiko09: folds 
tyoma_knp: folds 
faceMyBallz_: folds 
mudders693: folds 
Uncalled bet (£1) returned to Bënedic10
Bënedic10 collected £1.25 from pot
Bënedic10: doesn't show hand 
*** SUMMARY ***
Total pot £1.25 | Rake £0 
Seat 1: mitsuVK folded before Flop (didn't bet)
Seat 2: matiko09 folded before Flop (didn't bet)
Seat 3: tyoma_knp (button) folded before Flop (didn't bet)
Seat 4: faceMyBallz_ (small blind) folded before Flop
Seat 5: mudders693 (big blind) folded before Flop
Seat 6: Bënedic10 collected (£1.25)





PokerStars Hand #154970888521:  Hold'em No Limit ($0.50/$1.00 USD) - 2016/06/20 13:00:03 CET [2016/06/20 7:00:03 ET]
Table 'Annika' 9-max Seat #2 is the button
Seat 1: hammerwife ($112.27 in chips) 
Seat 2: matiko09 ($103.80 in chips) 
Seat 3: first_dnk ($88.28 in chips) 
Seat 4: Kukuryzka ($105.62 in chips) 
Seat 5: SkUhNi ($109.82 in chips) 
Seat 6: Pvsx. ($101.05 in chips) 
Seat 7: jirka117 ($47.19 in chips) 
Seat 8: ruslik_by ($115.70 in chips) 
Seat 9: 23SmOkEr07 ($151.35 in chips) 
first_dnk: posts small blind $0.50
Kukuryzka: posts big blind $1
*** HOLE CARDS ***
Dealt to matiko09 [2d 6c]
SkUhNi: folds 
Pvsx.: folds 
jirka117: calls $1
ruslik_by: raises $3 to $4
23SmOkEr07: calls $4
hammerwife: folds 
matiko09: folds 
first_dnk: folds 
Kukuryzka: folds 
jirka117: calls $3
*** FLOP *** [2s 5h 9h]
jirka117: checks 
ruslik_by: bets $4.35
23SmOkEr07: raises $7.65 to $12
jirka117: folds 
ruslik_by: calls $7.65
*** TURN *** [2s 5h 9h] [Ac]
ruslik_by: checks 
23SmOkEr07: bets $19.94
ruslik_by: folds 
Uncalled bet ($19.94) returned to 23SmOkEr07
23SmOkEr07 collected $35.62 from pot
23SmOkEr07: doesn't show hand 
*** SUMMARY ***
Total pot $37.50 | Rake $1.88 
Board [2s 5h 9h Ac]
Seat 1: hammerwife folded before Flop (didn't bet)
Seat 2: matiko09 (button) folded before Flop (didn't bet)
Seat 3: first_dnk (small blind) folded before Flop
Seat 4: Kukuryzka (big blind) folded before Flop
Seat 5: SkUhNi folded before Flop (didn't bet)
Seat 6: Pvsx. folded before Flop (didn't bet)
Seat 7: jirka117 folded on the Flop
Seat 8: ruslik_by folded on the Turn
Seat 9: 23SmOkEr07 collected ($35.62)





PokerStars Hand #154970891041:  Hold'em No Limit ($0.25/$0.50 USD) - 2016/06/20 13:00:10 CET [2016/06/20 7:00:10 ET]
Table 'Scheddi II' 9-max Seat #5 is the button
Seat 1: matiko09 ($93.15 in chips) 
Seat 2: Yaaaazz ($59.66 in chips) 
Seat 3: mi$$I$Elena ($82.56 in chips) 
Seat 4: GOOFA13 ($74.30 in chips) 
Seat 5: zarplatka ($40 in chips) 
Seat 6: orochimaturi ($51.25 in chips) 
Seat 7: HopeMayBee ($114.91 in chips) 
Seat 9: Infinitinium ($114.95 in chips) 
orochimaturi: posts small blind $0.25
HopeMayBee: posts big blind $0.50
Danil27: sits out 
matiko09: posts the ante $0.10
Yaaaazz: posts the ante $0.10
mi$$I$Elena: posts the ante $0.10
GOOFA13: posts the ante $0.10
zarplatka: posts the ante $0.10
orochimaturi: posts the ante $0.10
HopeMayBee: posts the ante $0.10
Infinitinium: posts the ante $0.10
*** HOLE CARDS ***
Dealt to matiko09 [2h Th]
Infinitinium: folds 
matiko09: folds 
Yaaaazz: folds 
mi$$I$Elena: folds 
GOOFA13: raises $1.50 to $2
zarplatka: calls $2
orochimaturi: folds 
HopeMayBee: raises $8 to $10
GOOFA13: folds 
zarplatka: folds 
Uncalled bet ($8) returned to HopeMayBee
HopeMayBee collected $7.05 from pot
HopeMayBee: doesn't show hand 
*** SUMMARY ***
Total pot $7.05 | Rake $0 
Seat 1: matiko09 folded before Flop (didn't bet)
Seat 2: Yaaaazz folded before Flop (didn't bet)
Seat 3: mi$$I$Elena folded before Flop (didn't bet)
Seat 4: GOOFA13 folded before Flop
Seat 5: zarplatka (button) folded before Flop
Seat 6: orochimaturi (small blind) folded before Flop
Seat 7: HopeMayBee (big blind) collected ($7.05)
Seat 9: Infinitinium folded before Flop (didn't bet)





PokerStars Hand #154970891547:  Hold'em No Limit ($0.50/$1.00 USD) - 2016/06/20 13:00:11 CET [2016/06/20 7:00:11 ET]
Table 'Anhui' 9-max Seat #3 is the button
Seat 1: SkUhNi ($158.38 in chips) 
Seat 2: ruslik_by ($269.27 in chips) 
Seat 3: hammerwife ($152.89 in chips) 
Seat 4: Racushniak ($109.40 in chips) 
Seat 5: Dickyxxx ($100 in chips) 
Seat 6: 23SmOkEr07 ($119.18 in chips) 
Seat 7: matiko09 ($121.98 in chips) 
Seat 8: blackmont111 ($82.35 in chips) 
Racushniak: posts small blind $0.50
Dickyxxx: posts big blind $1
SexyAngeline: sits out 
*** HOLE CARDS ***
Dealt to matiko09 [2d 6d]
23SmOkEr07: folds 
matiko09: folds 
blackmont111: folds 
SkUhNi: folds 
ruslik_by: folds 
hammerwife: raises $1.01 to $2.01
Racushniak: folds 
Dickyxxx: folds 
Uncalled bet ($1.01) returned to hammerwife
hammerwife collected $2.50 from pot
hammerwife: doesn't show hand 
*** SUMMARY ***
Total pot $2.50 | Rake $0 
Seat 1: SkUhNi folded before Flop (didn't bet)
Seat 2: ruslik_by folded before Flop (didn't bet)
Seat 3: hammerwife (button) collected ($2.50)
Seat 4: Racushniak (small blind) folded before Flop
Seat 5: Dickyxxx (big blind) folded before Flop
Seat 6: 23SmOkEr07 folded before Flop (didn't bet)
Seat 7: matiko09 folded before Flop (didn't bet)
Seat 8: blackmont111 folded before Flop (didn't bet)





PokerStars Hand #154970892370:  Hold'em No Limit ($0.50/$1.00 USD) - 2016/06/20 13:00:13 CET [2016/06/20 7:00:13 ET]
Table 'Normannia' 9-max Seat #8 is the button
Seat 2: Pvsx. ($189.34 in chips) 
Seat 3: Avtovo ($101.50 in chips) 
Seat 4: Filojoes ($102.89 in chips) 
Seat 5: Dickyxxx ($119.22 in chips) 
Seat 6: typename27 ($75.09 in chips) 
Seat 7: matiko09 ($106.79 in chips) 
Seat 8: SkUhNi ($132.30 in chips) 
Seat 9: ruslik_by ($145.19 in chips) 
ruslik_by: posts small blind $0.50
hammerwife: is sitting out 
Pvsx.: posts big blind $1
*** HOLE CARDS ***
Dealt to matiko09 [9c 6c]
Avtovo: folds 
Filojoes: raises $2 to $3
Dickyxxx: raises $6 to $9
typename27: folds 
matiko09: folds 
SkUhNi: folds 
ruslik_by: folds 
Pvsx.: folds 
Filojoes: calls $6
*** FLOP *** [6s Ad Ts]
Filojoes: checks 
Dickyxxx: bets $9.63
Filojoes: raises $84.26 to $93.89 and is all-in
Dickyxxx: calls $84.26
*** FIRST TURN *** [6s Ad Ts] [Qd]
*** FIRST RIVER *** [6s Ad Ts Qd] [7h]
*** SECOND TURN *** [6s Ad Ts] [7s]
*** SECOND RIVER *** [6s Ad Ts 7s] [Ac]
*** FIRST SHOW DOWN ***
Filojoes: shows [As Qs] (two pair, Aces and Queens)
Dickyxxx: shows [Qc Ah] (two pair, Aces and Queens)
Filojoes collected $51.20 from pot
Dickyxxx collected $51.19 from pot
*** SECOND SHOW DOWN ***
Filojoes: shows [As Qs] (a flush, Ace high)
Dickyxxx: shows [Qc Ah] (three of a kind, Aces)
Filojoes collected $102.39 from pot
*** SUMMARY ***
Total pot $207.28 | Rake $2.50 
Hand was run twice
FIRST Board [6s Ad Ts Qd 7h]
SECOND Board [6s Ad Ts 7s Ac]
Seat 2: Pvsx. (big blind) folded before Flop
Seat 3: Avtovo folded before Flop (didn't bet)
Seat 4: Filojoes showed [As Qs] and won ($51.20) with two pair, Aces and Queens, and won ($102.39) with a flush, Ace high
Seat 5: Dickyxxx showed [Qc Ah] and won ($51.19) with two pair, Aces and Queens, and lost with three of a kind, Aces
Seat 6: typename27 folded before Flop (didn't bet)
Seat 7: matiko09 folded before Flop (didn't bet)
Seat 8: SkUhNi (button) folded before Flop (didn't bet)
Seat 9: ruslik_by (small blind) folded before Flop





PokerStars Hand #154970893227:  Hold'em No Limit (€0.25/€0.50 EUR) - 2016/06/20 13:00:16 CET [2016/06/20 7:00:16 ET]
Table 'Bechuana' 6-max Seat #4 is the button
Seat 2: matiko09 (€51.50 in chips) 
Seat 3: Aju!ntje (€78.40 in chips) 
Seat 4: Wwwasian (€50 in chips) 
Seat 5: fanmtZ (€46.74 in chips) 
Seat 6: SlayersGBG (€50 in chips) 
fanmtZ: posts small blind €0.25
SlayersGBG: posts big blind €0.50
*** HOLE CARDS ***
Dealt to matiko09 [9d Jd]
matiko09: raises €1 to €1.50
Aju!ntje: folds 
Wwwasian: folds 
fanmtZ: folds 
SlayersGBG: folds 
Uncalled bet (€1) returned to matiko09
matiko09 collected €1.25 from pot
matiko09: doesn't show hand 
*** SUMMARY ***
Total pot €1.25 | Rake €0 
Seat 2: matiko09 collected (€1.25)
Seat 3: Aju!ntje folded before Flop (didn't bet)
Seat 4: Wwwasian (button) folded before Flop (didn't bet)
Seat 5: fanmtZ (small blind) folded before Flop
Seat 6: SlayersGBG (big blind) folded before Flop





PokerStars Hand #154970895726:  Hold'em No Limit (£0.25/£0.50 GBP) - 2016/06/20 13:00:23 CET [2016/06/20 7:00:23 ET]
Table 'Azalea' 6-max Seat #4 is the button
Seat 1: mitsuVK (£53.60 in chips) 
Seat 2: matiko09 (£71.17 in chips) 
Seat 3: tyoma_knp (£56.78 in chips) 
Seat 4: faceMyBallz_ (£97.22 in chips) 
Seat 5: mudders693 (£59.19 in chips) 
Seat 6: Bënedic10 (£70.83 in chips) 
mudders693: posts small blind £0.25
Bënedic10: posts big blind £0.50
*** HOLE CARDS ***
Dealt to matiko09 [Td 9d]
mitsuVK: folds 
matiko09: raises £1 to £1.50
tyoma_knp: folds 
faceMyBallz_: folds 
mudders693: calls £1.25
Bënedic10: folds 
*** FLOP *** [Qc 8c Ts]
mudders693: checks 
matiko09: checks 
*** TURN *** [Qc 8c Ts] [Jh]
mudders693: checks 
matiko09: bets £2.16
mudders693: calls £2.16
*** RIVER *** [Qc 8c Ts Jh] [Kc]
mudders693: checks 
matiko09: checks 
*** SHOW DOWN ***
mudders693: shows [4h Kh] (a pair of Kings)
matiko09: shows [Td 9d] (a straight, Nine to King)
matiko09 collected £7.43 from pot
*** SUMMARY ***
Total pot £7.82 | Rake £0.39 
Board [Qc 8c Ts Jh Kc]
Seat 1: mitsuVK folded before Flop (didn't bet)
Seat 2: matiko09 showed [Td 9d] and won (£7.43) with a straight, Nine to King
Seat 3: tyoma_knp folded before Flop (didn't bet)
Seat 4: faceMyBallz_ (button) folded before Flop (didn't bet)
Seat 5: mudders693 (small blind) showed [4h Kh] and lost with a pair of Kings
Seat 6: Bënedic10 (big blind) folded before Flop





PokerStars Hand #154970898455:  Hold'em No Limit ($0.50/$1.00 USD) - 2016/06/20 13:00:30 CET [2016/06/20 7:00:30 ET]
Table 'Pongola' 9-max Seat #4 is the button
Seat 1: matiko09 ($110 in chips) 
Seat 2: ruslik_by ($126.27 in chips) 
Seat 3: SkUhNi ($108.72 in chips) 
Seat 4: SexyAngeline ($77.21 in chips) 
Seat 5: Coolller ($99 in chips) 
Seat 7: Dickyxxx ($158.15 in chips) 
Seat 8: phrantique ($124.19 in chips) 
Seat 9: Filojoes ($152.59 in chips) 
Coolller: posts small blind $0.50
23SmOkEr07: is sitting out 
Dickyxxx: posts big blind $1
*** HOLE CARDS ***
Dealt to matiko09 [Ts Js]
23SmOkEr07 leaves the table
phrantique: folds 
Filojoes: folds 
matiko09: raises $2 to $3
Racushniak joins the table at seat #6 
ruslik_by: folds 
SkUhNi: folds 
SexyAngeline: folds 
Coolller: folds 
Dickyxxx: calls $2
*** FLOP *** [8h Jc Qs]
Dickyxxx: checks 
matiko09: checks 
*** TURN *** [8h Jc Qs] [Jh]
Dickyxxx: checks 
matiko09: bets $3.21
Dickyxxx: folds 
Uncalled bet ($3.21) returned to matiko09
matiko09 collected $6.18 from pot
matiko09: doesn't show hand 
*** SUMMARY ***
Total pot $6.50 | Rake $0.32 
Board [8h Jc Qs Jh]
Seat 1: matiko09 collected ($6.18)
Seat 2: ruslik_by folded before Flop (didn't bet)
Seat 3: SkUhNi folded before Flop (didn't bet)
Seat 4: SexyAngeline (button) folded before Flop (didn't bet)
Seat 5: Coolller (small blind) folded before Flop
Seat 7: Dickyxxx (big blind) folded on the Turn
Seat 8: phrantique folded before Flop (didn't bet)
Seat 9: Filojoes folded before Flop (didn't bet)





PokerStars Hand #154970901863:  Hold'em No Limit (€0.25/€0.50 EUR) - 2016/06/20 13:00:39 CET [2016/06/20 7:00:39 ET]
Table 'Bechuana' 6-max Seat #5 is the button
Seat 2: matiko09 (€52.25 in chips) 
Seat 3: Aju!ntje (€78.40 in chips) 
Seat 4: Wwwasian (€50 in chips) 
Seat 5: fanmtZ (€46.49 in chips) 
Seat 6: SlayersGBG (€50 in chips) 
SlayersGBG: posts small blind €0.25
matiko09: posts big blind €0.50
*** HOLE CARDS ***
Dealt to matiko09 [9d 9h]
Aju!ntje: folds 
Wwwasian: folds 
fanmtZ: folds 
SlayersGBG: raises €0.75 to €1.25
matiko09: calls €0.75
*** FLOP *** [5h 4d 9s]
SlayersGBG: checks 
matiko09: checks 
*** TURN *** [5h 4d 9s] [6s]
SlayersGBG: checks 
matiko09: bets €1.23
SlayersGBG: raises €3.77 to €5
matiko09: calls €3.77
*** RIVER *** [5h 4d 9s 6s] [Ah]
SlayersGBG: bets €8.50
matiko09: calls €8.50
*** SHOW DOWN ***
SlayersGBG: shows [5c 9c] (two pair, Nines and Fives)
matiko09: shows [9d 9h] (three of a kind, Nines)
matiko09 collected €28.02 from pot
*** SUMMARY ***
Total pot €29.50 | Rake €1.48 
Board [5h 4d 9s 6s Ah]
Seat 2: matiko09 (big blind) showed [9d 9h] and won (€28.02) with three of a kind, Nines
Seat 3: Aju!ntje folded before Flop (didn't bet)
Seat 4: Wwwasian folded before Flop (didn't bet)
Seat 5: fanmtZ (button) folded before Flop (didn't bet)
Seat 6: SlayersGBG (small blind) showed [5c 9c] and lost with two pair, Nines and Fives





PokerStars Hand #154970903716:  Hold'em No Limit (£0.25/£0.50 GBP) - 2016/06/20 13:00:44 CET [2016/06/20 7:00:44 ET]
Table 'Ani' 6-max Seat #4 is the button
Seat 1: asmodej666 (£50 in chips) 
Seat 2: mitsuVK (£59.50 in chips) 
Seat 3: Doobes8555 (£66.77 in chips) 
Seat 4: matiko09 (£64.83 in chips) 
Seat 5: Wwwasian (£56.43 in chips) 
Seat 6: faceMyBallz_ (£56.16 in chips) 
Wwwasian: posts small blind £0.25
faceMyBallz_: posts big blind £0.50
*** HOLE CARDS ***
Dealt to matiko09 [2s Ac]
asmodej666: raises £1 to £1.50
mitsuVK: folds 
Doobes8555: folds 
matiko09: folds 
Wwwasian: folds 
faceMyBallz_: folds 
Uncalled bet (£1) returned to asmodej666
asmodej666 collected £1.25 from pot
asmodej666: doesn't show hand 
*** SUMMARY ***
Total pot £1.25 | Rake £0 
Seat 1: asmodej666 collected (£1.25)
Seat 2: mitsuVK folded before Flop (didn't bet)
Seat 3: Doobes8555 folded before Flop (didn't bet)
Seat 4: matiko09 (button) folded before Flop (didn't bet)
Seat 5: Wwwasian (small blind) folded before Flop
Seat 6: faceMyBallz_ (big blind) folded before Flop





PokerStars Hand #154970904572:  Hold'em No Limit (£0.25/£0.50 GBP) - 2016/06/20 13:00:47 CET [2016/06/20 7:00:47 ET]
Table 'Tesla' 6-max Seat #2 is the button
Seat 1: Rubleff85 (£22.57 in chips) 
Seat 2: matiko09 (£79.70 in chips) 
Seat 3: asmodej666 (£50 in chips) 
Seat 4: VahTang_89 (£80.15 in chips) 
Seat 5: Nego Razu (£51.35 in chips) 
Seat 6: faceMyBallz_ (£55.76 in chips) 
asmodej666: posts small blind £0.25
VahTang_89: posts big blind £0.50
*** HOLE CARDS ***
Dealt to matiko09 [2d 8c]
Nego Razu: folds 
faceMyBallz_: raises £1 to £1.50
Rubleff85: folds 
matiko09: folds 
asmodej666: folds 
VahTang_89: folds 
Uncalled bet (£1) returned to faceMyBallz_
faceMyBallz_ collected £1.25 from pot
faceMyBallz_: doesn't show hand 
*** SUMMARY ***
Total pot £1.25 | Rake £0 
Seat 1: Rubleff85 folded before Flop (didn't bet)
Seat 2: matiko09 (button) folded before Flop (didn't bet)
Seat 3: asmodej666 (small blind) folded before Flop
Seat 4: VahTang_89 (big blind) folded before Flop
Seat 5: Nego Razu folded before Flop (didn't bet)
Seat 6: faceMyBallz_ collected (£1.25)





PokerStars Hand #154970907965:  Hold'em No Limit ($0.50/$1.00 USD) - 2016/06/20 13:00:56 CET [2016/06/20 7:00:56 ET]
Table 'Garumna II' 9-max Seat #9 is the button
Seat 1: ki11u ($138.50 in chips) 
Seat 2: Racushniak ($100 in chips) 
Seat 3: mooose100 ($100 in chips) 
Seat 4: Ndundun Gipe ($55.84 in chips) 
Seat 5: rura53 ($76.50 in chips) 
Seat 6: SexyAngeline ($41.03 in chips) 
Seat 7: Avtovo ($109.38 in chips) 
Seat 8: matiko09 ($104.02 in chips) 
Seat 9: SkUhNi ($100 in chips) 
ki11u: posts small blind $0.50
Racushniak: posts big blind $1
*** HOLE CARDS ***
Dealt to matiko09 [6s Kh]
mooose100: calls $1
Ndundun Gipe: folds 
rura53: folds 
SexyAngeline: folds 
Avtovo: folds 
matiko09: folds 
SkUhNi: folds 
ki11u: raises $3.50 to $4.50
Racushniak: folds 
mooose100: calls $3.50
*** FLOP *** [Ks 3c Ad]
ki11u: checks 
mooose100: checks 
*** TURN *** [Ks 3c Ad] [Jh]
ki11u: bets $6
mooose100: folds 
Uncalled bet ($6) returned to ki11u
ki11u collected $9.50 from pot
ki11u: doesn't show hand 
*** SUMMARY ***
Total pot $10 | Rake $0.50 
Board [Ks 3c Ad Jh]
Seat 1: ki11u (small blind) collected ($9.50)
Seat 2: Racushniak (big blind) folded before Flop
Seat 3: mooose100 folded on the Turn
Seat 4: Ndundun Gipe folded before Flop (didn't bet)
Seat 5: rura53 folded before Flop (didn't bet)
Seat 6: SexyAngeline folded before Flop (didn't bet)
Seat 7: Avtovo folded before Flop (didn't bet)
Seat 8: matiko09 folded before Flop (didn't bet)
Seat 9: SkUhNi (button) folded before Flop (didn't bet)





PokerStars Hand #154970908802:  Hold'em No Limit ($0.50/$1.00 USD) - 2016/06/20 13:00:58 CET [2016/06/20 7:00:58 ET]
Table 'Isonoe II' 9-max Seat #4 is the button
Seat 1: hammerwife ($100 in chips) 
Seat 2: matiko09 ($126.32 in chips) 
Seat 3: Kukuryzka ($100 in chips) 
Seat 4: Avtovo ($102 in chips) 
Seat 5: Filojoes ($107.62 in chips) 
Seat 6: GOOFA13 ($50.96 in chips) 
Seat 7: SkUhNi ($122.70 in chips) 
Seat 8: lewyson ($80.65 in chips) 
Seat 9: djammusic ($64.45 in chips) 
Filojoes: posts small blind $0.50
GOOFA13: posts big blind $1
*** HOLE CARDS ***
Dealt to matiko09 [8h 4d]
SkUhNi: folds 
lewyson: folds 
djammusic: raises $1.50 to $2.50
hammerwife: folds 
matiko09: folds 
Kukuryzka: folds 
Avtovo: folds 
Filojoes: folds 
GOOFA13: folds 
Uncalled bet ($1.50) returned to djammusic
djammusic collected $2.50 from pot
djammusic: doesn't show hand 
*** SUMMARY ***
Total pot $2.50 | Rake $0 
Seat 1: hammerwife folded before Flop (didn't bet)
Seat 2: matiko09 folded before Flop (didn't bet)
Seat 3: Kukuryzka folded before Flop (didn't bet)
Seat 4: Avtovo (button) folded before Flop (didn't bet)
Seat 5: Filojoes (small blind) folded before Flop
Seat 6: GOOFA13 (big blind) folded before Flop
Seat 7: SkUhNi folded before Flop (didn't bet)
Seat 8: lewyson folded before Flop (didn't bet)
Seat 9: djammusic collected ($2.50)





PokerStars Hand #154970910148:  Hold'em No Limit (£0.25/£0.50 GBP) - 2016/06/20 13:01:01 CET [2016/06/20 7:01:01 ET]
Table 'Ani' 6-max Seat #5 is the button
Seat 1: asmodej666 (£50.75 in chips) 
Seat 2: mitsuVK (£59.50 in chips) 
Seat 3: Doobes8555 (£66.77 in chips) 
Seat 4: matiko09 (£64.83 in chips) 
Seat 5: Wwwasian (£56.18 in chips) 
Seat 6: faceMyBallz_ (£55.66 in chips) 
faceMyBallz_: posts small blind £0.25
asmodej666: posts big blind £0.50
*** HOLE CARDS ***
Dealt to matiko09 [2d Qc]
mitsuVK: folds 
Doobes8555: folds 
matiko09: folds 
Wwwasian: raises £0.75 to £1.25
faceMyBallz_: folds 
asmodej666: folds 
Uncalled bet (£0.75) returned to Wwwasian
Wwwasian collected £1.25 from pot
Wwwasian: doesn't show hand 
*** SUMMARY ***
Total pot £1.25 | Rake £0 
Seat 1: asmodej666 (big blind) folded before Flop
Seat 2: mitsuVK folded before Flop (didn't bet)
Seat 3: Doobes8555 folded before Flop (didn't bet)
Seat 4: matiko09 folded before Flop (didn't bet)
Seat 5: Wwwasian (button) collected (£1.25)
Seat 6: faceMyBallz_ (small blind) folded before Flop





PokerStars Hand #154970911537:  Hold'em No Limit (£0.25/£0.50 GBP) - 2016/06/20 13:01:05 CET [2016/06/20 7:01:05 ET]
Table 'Azalea' 6-max Seat #5 is the button
Seat 1: mitsuVK (£53.60 in chips) 
Seat 2: matiko09 (£74.94 in chips) 
Seat 3: tyoma_knp (£56.78 in chips) 
Seat 4: faceMyBallz_ (£97.22 in chips) 
Seat 5: mudders693 (£55.53 in chips) 
Seat 6: Bënedic10 (£70.33 in chips) 
Bënedic10: posts small blind £0.25
mitsuVK: posts big blind £0.50
*** HOLE CARDS ***
Dealt to matiko09 [2s 2c]
matiko09: raises £1 to £1.50
tyoma_knp: calls £1.50
faceMyBallz_: raises £4.50 to £6
mudders693: folds 
Bënedic10: folds 
mitsuVK: folds 
matiko09: folds 
tyoma_knp: folds 
Uncalled bet (£4.50) returned to faceMyBallz_
faceMyBallz_ collected £5.25 from pot
faceMyBallz_: doesn't show hand 
*** SUMMARY ***
Total pot £5.25 | Rake £0 
Seat 1: mitsuVK (big blind) folded before Flop
Seat 2: matiko09 folded before Flop
Seat 3: tyoma_knp folded before Flop
Seat 4: faceMyBallz_ collected (£5.25)
Seat 5: mudders693 (button) folded before Flop (didn't bet)
Seat 6: Bënedic10 (small blind) folded before Flop





PokerStars Hand #154970912211:  Hold'em No Limit (£0.25/£0.50 GBP) - 2016/06/20 13:01:07 CET [2016/06/20 7:01:07 ET]
Table 'Tesla' 6-max Seat #3 is the button
Seat 1: Rubleff85 (£22.57 in chips) 
Seat 2: matiko09 (£79.70 in chips) 
Seat 3: asmodej666 (£50 in chips) 
Seat 4: VahTang_89 (£79.65 in chips) 
Seat 5: Nego Razu (£51.35 in chips) 
Seat 6: faceMyBallz_ (£56.51 in chips) 
VahTang_89: posts small blind £0.25
Nego Razu: posts big blind £0.50
*** HOLE CARDS ***
Dealt to matiko09 [Jh Js]
faceMyBallz_: folds 
Rubleff85: raises £0.50 to £1
matiko09: raises £2 to £3
asmodej666: folds 
VahTang_89: folds 
Nego Razu: folds 
Rubleff85: calls £2
*** FLOP *** [5h Qc 7c]
Rubleff85: checks 
matiko09: checks 
*** TURN *** [5h Qc 7c] [2c]
Rubleff85: bets £5
matiko09: calls £5
*** RIVER *** [5h Qc 7c 2c] [Ac]
Rubleff85: bets £14.57 and is all-in
matiko09: folds 
Uncalled bet (£14.57) returned to Rubleff85
Rubleff85 collected £15.91 from pot
Rubleff85: doesn't show hand 
*** SUMMARY ***
Total pot £16.75 | Rake £0.84 
Board [5h Qc 7c 2c Ac]
Seat 1: Rubleff85 collected (£15.91)
Seat 2: matiko09 folded on the River
Seat 3: asmodej666 (button) folded before Flop (didn't bet)
Seat 4: VahTang_89 (small blind) folded before Flop
Seat 5: Nego Razu (big blind) folded before Flop
Seat 6: faceMyBallz_ folded before Flop (didn't bet)





PokerStars Hand #154970914804:  Hold'em No Limit ($0.50/$1.00 USD) - 2016/06/20 13:01:13 CET [2016/06/20 7:01:13 ET]
Table 'Ernestina' 9-max Seat #4 is the button
Seat 1: diva3150 ($112.13 in chips) 
Seat 2: matiko09 ($192.12 in chips) 
Seat 3: Pvsx. ($184.49 in chips) 
Seat 4: SkUhNi ($102.15 in chips) 
Seat 5: Dickyxxx ($112.50 in chips) 
Seat 6: arctur17 ($77.79 in chips) 
Seat 8: ruslik_by ($243.03 in chips) 
Seat 9: 23SmOkEr07 ($100 in chips) 
Dickyxxx: posts small blind $0.50
arctur17: posts big blind $1
*** HOLE CARDS ***
Dealt to matiko09 [Qs 9c]
ruslik_by: folds 
23SmOkEr07: folds 
diva3150: raises $2 to $3
matiko09: folds 
Pvsx.: folds 
SkUhNi: folds 
Dickyxxx: folds 
arctur17: folds 
Uncalled bet ($2) returned to diva3150
diva3150 collected $2.50 from pot
diva3150: doesn't show hand 
*** SUMMARY ***
Total pot $2.50 | Rake $0 
Seat 1: diva3150 collected ($2.50)
Seat 2: matiko09 folded before Flop (didn't bet)
Seat 3: Pvsx. folded before Flop (didn't bet)
Seat 4: SkUhNi (button) folded before Flop (didn't bet)
Seat 5: Dickyxxx (small blind) folded before Flop
Seat 6: arctur17 (big blind) folded before Flop
Seat 8: ruslik_by folded before Flop (didn't bet)
Seat 9: 23SmOkEr07 folded before Flop (didn't bet)





PokerStars Hand #154970916633:  Hold'em No Limit (£0.25/£0.50 GBP) - 2016/06/20 13:01:18 CET [2016/06/20 7:01:18 ET]
Table 'Ani' 6-max Seat #6 is the button
Seat 1: asmodej666 (£50.25 in chips) 
Seat 2: mitsuVK (£59.50 in chips) 
Seat 3: Doobes8555 (£66.77 in chips) 
Seat 4: matiko09 (£64.83 in chips) 
Seat 5: Wwwasian (£56.93 in chips) 
Seat 6: faceMyBallz_ (£55.41 in chips) 
asmodej666: posts small blind £0.25
mitsuVK: posts big blind £0.50
*** HOLE CARDS ***
Dealt to matiko09 [6s As]
Doobes8555: folds 
matiko09: raises £1 to £1.50
Wwwasian: folds 
faceMyBallz_: folds 
asmodej666: folds 
mitsuVK: calls £1
*** FLOP *** [Ac Ad 9d]
mitsuVK: checks 
matiko09: bets £1.60
mitsuVK: folds 
Uncalled bet (£1.60) returned to matiko09
matiko09 collected £3.09 from pot
matiko09: doesn't show hand 
*** SUMMARY ***
Total pot £3.25 | Rake £0.16 
Board [Ac Ad 9d]
Seat 1: asmodej666 (small blind) folded before Flop
Seat 2: mitsuVK (big blind) folded on the Flop
Seat 3: Doobes8555 folded before Flop (didn't bet)
Seat 4: matiko09 collected (£3.09)
Seat 5: Wwwasian folded before Flop (didn't bet)
Seat 6: faceMyBallz_ (button) folded before Flop (didn't bet)





PokerStars Hand #154970922339:  Hold'em No Limit ($0.50/$1.00 USD) - 2016/06/20 13:01:33 CET [2016/06/20 7:01:33 ET]
Table 'Pongola' 9-max Seat #5 is the button
Seat 1: matiko09 ($113.18 in chips) 
Seat 2: ruslik_by ($126.27 in chips) 
Seat 3: SkUhNi ($108.72 in chips) 
Seat 4: SexyAngeline ($77.21 in chips) 
Seat 5: Coolller ($98.50 in chips) 
Seat 7: Dickyxxx ($155.15 in chips) 
Seat 8: phrantique ($124.19 in chips) 
Seat 9: Filojoes ($152.59 in chips) 
Racushniak will be allowed to play after the button
Dickyxxx: posts small blind $0.50
phrantique: posts big blind $1
*** HOLE CARDS ***
Dealt to matiko09 [5h 5c]
Filojoes: folds 
matiko09: raises $2 to $3
ruslik_by: folds 
SkUhNi: folds 
SexyAngeline: folds 
Coolller: folds 
Dickyxxx: folds 
phrantique: folds 
Uncalled bet ($2) returned to matiko09
matiko09 collected $2.50 from pot
matiko09: doesn't show hand 
*** SUMMARY ***
Total pot $2.50 | Rake $0 
Seat 1: matiko09 collected ($2.50)
Seat 2: ruslik_by folded before Flop (didn't bet)
Seat 3: SkUhNi folded before Flop (didn't bet)
Seat 4: SexyAngeline folded before Flop (didn't bet)
Seat 5: Coolller (button) folded before Flop (didn't bet)
Seat 7: Dickyxxx (small blind) folded before Flop
Seat 8: phrantique (big blind) folded before Flop
Seat 9: Filojoes folded before Flop (didn't bet)





PokerStars Hand #154970925558:  Hold'em No Limit ($0.25/$0.50 USD) - 2016/06/20 13:01:41 CET [2016/06/20 7:01:41 ET]
Table 'Scheddi II' 9-max Seat #6 is the button
Seat 1: matiko09 ($93.05 in chips) 
Seat 2: Yaaaazz ($59.56 in chips) 
Seat 3: mi$$I$Elena ($82.46 in chips) 
Seat 4: GOOFA13 ($72.20 in chips) 
Seat 5: zarplatka ($40 in chips) 
Seat 6: orochimaturi ($50.90 in chips) 
Seat 7: HopeMayBee ($119.86 in chips) 
Seat 8: Danil27 ($50 in chips) 
Seat 9: Infinitinium ($114.85 in chips) 
HopeMayBee: posts small blind $0.25
Danil27: posts big blind $0.50
matiko09: posts the ante $0.10
Yaaaazz: posts the ante $0.10
mi$$I$Elena: posts the ante $0.10
GOOFA13: posts the ante $0.10
zarplatka: posts the ante $0.10
orochimaturi: posts the ante $0.10
HopeMayBee: posts the ante $0.10
Danil27: posts the ante $0.10
Infinitinium: posts the ante $0.10
*** HOLE CARDS ***
Dealt to matiko09 [5d 8c]
Infinitinium: folds 
matiko09: folds 
Yaaaazz: folds 
mi$$I$Elena: folds 
GOOFA13: folds 
zarplatka: folds 
orochimaturi: folds 
HopeMayBee: folds 
Uncalled bet ($0.25) returned to Danil27
Danil27 collected $1.40 from pot
Danil27: doesn't show hand 
*** SUMMARY ***
Total pot $1.40 | Rake $0 
Seat 1: matiko09 folded before Flop (didn't bet)
Seat 2: Yaaaazz folded before Flop (didn't bet)
Seat 3: mi$$I$Elena folded before Flop (didn't bet)
Seat 4: GOOFA13 folded before Flop (didn't bet)
Seat 5: zarplatka folded before Flop (didn't bet)
Seat 6: orochimaturi (button) folded before Flop (didn't bet)
Seat 7: HopeMayBee (small blind) folded before Flop
Seat 8: Danil27 (big blind) collected ($1.40)
Seat 9: Infinitinium folded before Flop (didn't bet)





PokerStars Hand #154970925524:  Hold'em No Limit (£0.25/£0.50 GBP) - 2016/06/20 13:01:41 CET [2016/06/20 7:01:41 ET]
Table 'Azalea' 6-max Seat #6 is the button
Seat 1: mitsuVK (£53.10 in chips) 
Seat 2: matiko09 (£73.44 in chips) 
Seat 3: tyoma_knp (£55.28 in chips) 
Seat 4: faceMyBallz_ (£100.97 in chips) 
Seat 5: mudders693 (£55.53 in chips) 
Seat 6: Bënedic10 (£70.08 in chips) 
mitsuVK: posts small blind £0.25
matiko09: posts big blind £0.50
*** HOLE CARDS ***
Dealt to matiko09 [Kc 8d]
tyoma_knp: raises £1 to £1.50
faceMyBallz_: folds 
mudders693: calls £1.50
Bënedic10: folds 
mitsuVK: folds 
matiko09: folds 
*** FLOP *** [4s 5h 4c]
tyoma_knp: bets £1.78
mudders693: raises £4.28 to £6.06
tyoma_knp: folds 
Uncalled bet (£4.28) returned to mudders693
mudders693 collected £6.94 from pot
mudders693: doesn't show hand 
*** SUMMARY ***
Total pot £7.31 | Rake £0.37 
Board [4s 5h 4c]
Seat 1: mitsuVK (small blind) folded before Flop
Seat 2: matiko09 (big blind) folded before Flop
Seat 3: tyoma_knp folded on the Flop
Seat 4: faceMyBallz_ folded before Flop (didn't bet)
Seat 5: mudders693 collected (£6.94)
Seat 6: Bënedic10 (button) folded before Flop (didn't bet)





PokerStars Hand #154970926688:  Hold'em No Limit ($0.50/$1.00 USD) - 2016/06/20 13:01:44 CET [2016/06/20 7:01:44 ET]
Table 'Annika' 9-max Seat #3 is the button
Seat 1: hammerwife ($112.27 in chips) 
Seat 2: matiko09 ($103.80 in chips) 
Seat 3: first_dnk ($87.78 in chips) 
Seat 4: Kukuryzka ($104.62 in chips) 
Seat 5: SkUhNi ($109.82 in chips) 
Seat 6: Pvsx. ($101.05 in chips) 
Seat 7: jirka117 ($43.19 in chips) 
Seat 8: ruslik_by ($100 in chips) 
Seat 9: 23SmOkEr07 ($170.97 in chips) 
Kukuryzka: posts small blind $0.50
SkUhNi: posts big blind $1
*** HOLE CARDS ***
Dealt to matiko09 [8d Js]
Pvsx.: raises $1.50 to $2.50
jirka117: folds 
ruslik_by: folds 
23SmOkEr07: folds 
hammerwife: folds 
matiko09: folds 
first_dnk: folds 
Kukuryzka: folds 
SkUhNi: folds 
Uncalled bet ($1.50) returned to Pvsx.
Pvsx. collected $2.50 from pot
Pvsx.: doesn't show hand 
*** SUMMARY ***
Total pot $2.50 | Rake $0 
Seat 1: hammerwife folded before Flop (didn't bet)
Seat 2: matiko09 folded before Flop (didn't bet)
Seat 3: first_dnk (button) folded before Flop (didn't bet)
Seat 4: Kukuryzka (small blind) folded before Flop
Seat 5: SkUhNi (big blind) folded before Flop
Seat 6: Pvsx. collected ($2.50)
Seat 7: jirka117 folded before Flop (didn't bet)
Seat 8: ruslik_by folded before Flop (didn't bet)
Seat 9: 23SmOkEr07 folded before Flop (didn't bet)





PokerStars Hand #154970927226:  Hold'em No Limit ($0.50/$1.00 USD) - 2016/06/20 13:01:45 CET [2016/06/20 7:01:45 ET]
Table 'Isonoe II' 9-max Seat #5 is the button
Seat 1: hammerwife ($100 in chips) 
Seat 2: matiko09 ($126.32 in chips) 
Seat 3: Kukuryzka ($100 in chips) 
Seat 4: Avtovo ($102 in chips) 
Seat 5: Filojoes ($107.12 in chips) 
Seat 6: GOOFA13 ($49.96 in chips) 
Seat 7: SkUhNi ($122.70 in chips) 
Seat 8: lewyson ($80.65 in chips) 
Seat 9: djammusic ($65.95 in chips) 
GOOFA13: posts small blind $0.50
SkUhNi: posts big blind $1
*** HOLE CARDS ***
Dealt to matiko09 [9h 5s]
lewyson: raises $1 to $2
djammusic: folds 
hammerwife: raises $6.50 to $8.50
matiko09: folds 
Kukuryzka: folds 
Avtovo: folds 
Filojoes: folds 
GOOFA13: folds 
SkUhNi: folds 
lewyson: calls $6.50
*** FLOP *** [4c 5d Tc]
lewyson: checks 
hammerwife: bets $8
lewyson: calls $8
*** TURN *** [4c 5d Tc] [Jh]
lewyson: checks 
hammerwife: bets $23
lewyson: raises $23 to $46
hammerwife: raises $37.50 to $83.50 and is all-in
lewyson: folds 
Uncalled bet ($37.50) returned to hammerwife
hammerwife collected $124 from pot
hammerwife: doesn't show hand 
*** SUMMARY ***
Total pot $126.50 | Rake $2.50 
Board [4c 5d Tc Jh]
Seat 1: hammerwife collected ($124)
Seat 2: matiko09 folded before Flop (didn't bet)
Seat 3: Kukuryzka folded before Flop (didn't bet)
Seat 4: Avtovo folded before Flop (didn't bet)
Seat 5: Filojoes (button) folded before Flop (didn't bet)
Seat 6: GOOFA13 (small blind) folded before Flop
Seat 7: SkUhNi (big blind) folded before Flop
Seat 8: lewyson folded on the Turn
Seat 9: djammusic folded before Flop (didn't bet)





PokerStars Hand #154970927582:  Hold'em No Limit ($0.50/$1.00 USD) - 2016/06/20 13:01:46 CET [2016/06/20 7:01:46 ET]
Table 'Ernestina' 9-max Seat #5 is the button
Seat 1: diva3150 ($113.63 in chips) 
Seat 2: matiko09 ($192.12 in chips) 
Seat 3: Pvsx. ($184.49 in chips) 
Seat 4: SkUhNi ($102.15 in chips) 
Seat 5: Dickyxxx ($112 in chips) 
Seat 6: arctur17 ($76.79 in chips) 
Seat 8: ruslik_by ($243.03 in chips) 
Seat 9: 23SmOkEr07 ($100 in chips) 
arctur17: posts small blind $0.50
ruslik_by: posts big blind $1
*** HOLE CARDS ***
Dealt to matiko09 [8d 5d]
23SmOkEr07: folds 
diva3150: raises $2 to $3
matiko09: folds 
Pvsx.: folds 
SkUhNi: calls $3
Dickyxxx: calls $3
arctur17: folds 
ruslik_by: calls $2
*** FLOP *** [6s As 5s]
ruslik_by: checks 
diva3150: checks 
SkUhNi: checks 
Dickyxxx: checks 
*** TURN *** [6s As 5s] [Ad]
ruslik_by: checks 
diva3150: bets $6
SkUhNi: folds 
Dickyxxx: folds 
ruslik_by: folds 
Uncalled bet ($6) returned to diva3150
diva3150 collected $11.88 from pot
diva3150: doesn't show hand 
*** SUMMARY ***
Total pot $12.50 | Rake $0.62 
Board [6s As 5s Ad]
Seat 1: diva3150 collected ($11.88)
Seat 2: matiko09 folded before Flop (didn't bet)
Seat 3: Pvsx. folded before Flop (didn't bet)
Seat 4: SkUhNi folded on the Turn
Seat 5: Dickyxxx (button) folded on the Turn
Seat 6: arctur17 (small blind) folded before Flop
Seat 8: ruslik_by (big blind) folded on the Turn
Seat 9: 23SmOkEr07 folded before Flop (didn't bet)





PokerStars Hand #154970934573:  Hold'em No Limit (£0.25/£0.50 GBP) - 2016/06/20 13:02:04 CET [2016/06/20 7:02:04 ET]
Table 'Ani' 6-max Seat #1 is the button
Seat 1: asmodej666 (£50 in chips) 
Seat 2: mitsuVK (£58 in chips) 
Seat 3: Doobes8555 (£66.77 in chips) 
Seat 4: matiko09 (£66.42 in chips) 
Seat 5: Wwwasian (£56.93 in chips) 
Seat 6: faceMyBallz_ (£55.41 in chips) 
mitsuVK: posts small blind £0.25
Doobes8555: posts big blind £0.50
*** HOLE CARDS ***
Dealt to matiko09 [9c 2d]
matiko09: folds 
Wwwasian: folds 
faceMyBallz_: folds 
asmodej666: folds 
mitsuVK: folds 
Uncalled bet (£0.25) returned to Doobes8555
Doobes8555 collected £0.50 from pot
Doobes8555: doesn't show hand 
*** SUMMARY ***
Total pot £0.50 | Rake £0 
Seat 1: asmodej666 (button) folded before Flop (didn't bet)
Seat 2: mitsuVK (small blind) folded before Flop
Seat 3: Doobes8555 (big blind) collected (£0.50)
Seat 4: matiko09 folded before Flop (didn't bet)
Seat 5: Wwwasian folded before Flop (didn't bet)
Seat 6: faceMyBallz_ folded before Flop (didn't bet)





PokerStars Hand #154970935661:  Hold'em No Limit ($0.50/$1.00 USD) - 2016/06/20 13:02:07 CET [2016/06/20 7:02:07 ET]
Table 'Garumna II' 9-max Seat #1 is the button
Seat 1: ki11u ($143.50 in chips) 
Seat 2: Racushniak ($100 in chips) 
Seat 3: mooose100 ($95.50 in chips) 
Seat 4: Ndundun Gipe ($55.84 in chips) 
Seat 5: rura53 ($76.50 in chips) 
Seat 6: SexyAngeline ($41.03 in chips) 
Seat 7: Avtovo ($109.38 in chips) 
Seat 8: matiko09 ($104.02 in chips) 
Seat 9: SkUhNi ($100 in chips) 
Racushniak: posts small blind $0.50
mooose100: posts big blind $1
*** HOLE CARDS ***
Dealt to matiko09 [9c 8h]
Ndundun Gipe: folds 
rura53: raises $2 to $3
SexyAngeline: folds 
Avtovo: calls $3
matiko09: folds 
SkUhNi: folds 
ki11u: folds 
Racushniak: folds 
mooose100: folds 
*** FLOP *** [Kd 3h 2d]
rura53: bets $3
Avtovo: folds 
Uncalled bet ($3) returned to rura53
rura53 collected $7.12 from pot
rura53: doesn't show hand 
*** SUMMARY ***
Total pot $7.50 | Rake $0.38 
Board [Kd 3h 2d]
Seat 1: ki11u (button) folded before Flop (didn't bet)
Seat 2: Racushniak (small blind) folded before Flop
Seat 3: mooose100 (big blind) folded before Flop
Seat 4: Ndundun Gipe folded before Flop (didn't bet)
Seat 5: rura53 collected ($7.12)
Seat 6: SexyAngeline folded before Flop (didn't bet)
Seat 7: Avtovo folded on the Flop
Seat 8: matiko09 folded before Flop (didn't bet)
Seat 9: SkUhNi folded before Flop (didn't bet)





PokerStars Hand #154970936045:  Hold'em No Limit (£0.25/£0.50 GBP) - 2016/06/20 13:02:08 CET [2016/06/20 7:02:08 ET]
Table 'Tesla' 6-max Seat #4 is the button
Seat 1: Rubleff85 (£30.48 in chips) 
Seat 2: matiko09 (£71.70 in chips) 
Seat 3: asmodej666 (£50 in chips) 
Seat 4: VahTang_89 (£79.40 in chips) 
Seat 5: Nego Razu (£50.85 in chips) 
Seat 6: faceMyBallz_ (£56.51 in chips) 
Nego Razu: posts small blind £0.25
faceMyBallz_: posts big blind £0.50
*** HOLE CARDS ***
Dealt to matiko09 [Ac 2s]
Rubleff85: calls £0.50
matiko09: folds 
asmodej666: folds 
VahTang_89: raises £1.50 to £2
Nego Razu: calls £1.75
faceMyBallz_: folds 
Rubleff85: calls £1.50
*** FLOP *** [8d 4s Ks]
Nego Razu: checks 
Rubleff85: bets £3.09
VahTang_89: folds 
Nego Razu: folds 
Uncalled bet (£3.09) returned to Rubleff85
Rubleff85 collected £6.18 from pot
Rubleff85: doesn't show hand 
*** SUMMARY ***
Total pot £6.50 | Rake £0.32 
Board [8d 4s Ks]
Seat 1: Rubleff85 collected (£6.18)
Seat 2: matiko09 folded before Flop (didn't bet)
Seat 3: asmodej666 folded before Flop (didn't bet)
Seat 4: VahTang_89 (button) folded on the Flop
Seat 5: Nego Razu (small blind) folded on the Flop
Seat 6: faceMyBallz_ (big blind) folded before Flop





PokerStars Hand #154970937457:  Hold'em No Limit ($0.25/$0.50 USD) - 2016/06/20 13:02:11 CET [2016/06/20 7:02:11 ET]
Table 'Scheddi II' 9-max Seat #7 is the button
Seat 1: matiko09 ($92.95 in chips) 
Seat 2: Yaaaazz ($59.46 in chips) 
Seat 3: mi$$I$Elena ($82.36 in chips) 
Seat 5: zarplatka ($40 in chips) 
Seat 6: orochimaturi ($50.80 in chips) 
Seat 7: HopeMayBee ($119.51 in chips) 
Seat 8: Danil27 ($51.05 in chips) 
Seat 9: Infinitinium ($114.75 in chips) 
Danil27: posts small blind $0.25
Infinitinium: posts big blind $0.50
matiko09: posts the ante $0.10
Yaaaazz: posts the ante $0.10
mi$$I$Elena: posts the ante $0.10
zarplatka: posts the ante $0.10
orochimaturi: posts the ante $0.10
HopeMayBee: posts the ante $0.10
Danil27: posts the ante $0.10
Infinitinium: posts the ante $0.10
*** HOLE CARDS ***
Dealt to matiko09 [3s 4s]
matiko09: folds 
Yaaaazz: folds 
mi$$I$Elena: folds 
zarplatka: folds 
orochimaturi: raises $1 to $1.50
HopeMayBee: calls $1.50
Danil27: calls $1.25
Infinitinium: calls $1
*** FLOP *** [6h 9s Jd]
Danil27: checks 
Infinitinium: checks 
orochimaturi: bets $3
HopeMayBee: calls $3
Danil27: folds 
Infinitinium: calls $3
*** TURN *** [6h 9s Jd] [Td]
Infinitinium: checks 
orochimaturi: checks 
HopeMayBee: checks 
*** RIVER *** [6h 9s Jd Td] [7s]
Infinitinium: bets $5
orochimaturi: calls $5
HopeMayBee: calls $5
*** SHOW DOWN ***
Infinitinium: shows [As 8s] (a straight, Seven to Jack)
orochimaturi: mucks hand 
HopeMayBee: mucks hand 
Infinitinium collected $29.26 from pot
*** SUMMARY ***
Total pot $30.80 | Rake $1.54 
Board [6h 9s Jd Td 7s]
Seat 1: matiko09 folded before Flop (didn't bet)
Seat 2: Yaaaazz folded before Flop (didn't bet)
Seat 3: mi$$I$Elena folded before Flop (didn't bet)
Seat 5: zarplatka folded before Flop (didn't bet)
Seat 6: orochimaturi mucked [9h Jc]
Seat 7: HopeMayBee (button) mucked [Jh Qh]
Seat 8: Danil27 (small blind) folded on the Flop
Seat 9: Infinitinium (big blind) showed [As 8s] and won ($29.26) with a straight, Seven to Jack





PokerStars Hand #154970938070:  Hold'em No Limit (€0.25/€0.50 EUR) - 2016/06/20 13:02:13 CET [2016/06/20 7:02:13 ET]
Table 'Bechuana' 6-max Seat #6 is the button
Seat 2: matiko09 (€65.52 in chips) 
Seat 3: Aju!ntje (€78.40 in chips) 
Seat 4: Wwwasian (€50 in chips) 
Seat 5: fanmtZ (€46.49 in chips) 
Seat 6: SlayersGBG (€50 in chips) 
zitagirl will be allowed to play after the button
matiko09: posts small blind €0.25
Aju!ntje: posts big blind €0.50
*** HOLE CARDS ***
Dealt to matiko09 [6c Qd]
Wwwasian: raises €0.90 to €1.40
fanmtZ: folds 
SlayersGBG: folds 
matiko09: folds 
Aju!ntje: folds 
Uncalled bet (€0.90) returned to Wwwasian
Wwwasian collected €1.25 from pot
Wwwasian: doesn't show hand 
*** SUMMARY ***
Total pot €1.25 | Rake €0 
Seat 2: matiko09 (small blind) folded before Flop
Seat 3: Aju!ntje (big blind) folded before Flop
Seat 4: Wwwasian collected (€1.25)
Seat 5: fanmtZ folded before Flop (didn't bet)
Seat 6: SlayersGBG (button) folded before Flop (didn't bet)





PokerStars Hand #154970939432:  Hold'em No Limit ($0.50/$1.00 USD) - 2016/06/20 13:02:16 CET [2016/06/20 7:02:16 ET]
Table 'Pongola' 9-max Seat #7 is the button
Seat 1: matiko09 ($114.68 in chips) 
Seat 2: ruslik_by ($126.27 in chips) 
Seat 3: SkUhNi ($108.72 in chips) 
Seat 4: SexyAngeline ($77.21 in chips) 
Seat 5: Coolller ($98.50 in chips) 
Seat 7: Dickyxxx ($154.65 in chips) 
Seat 8: phrantique ($123.19 in chips) 
Seat 9: Filojoes ($152.59 in chips) 
phrantique: posts small blind $0.50
Filojoes: posts big blind $1
Racushniak: sits out 
*** HOLE CARDS ***
Dealt to matiko09 [4s 6h]
matiko09: folds 
ruslik_by: folds 
SkUhNi: folds 
SexyAngeline: raises $1.07 to $2.07
Coolller: folds 
Dickyxxx: folds 
phrantique: calls $1.57
Filojoes: calls $1.07
*** FLOP *** [4d Qs 5h]
phrantique: checks 
Filojoes: checks 
SexyAngeline: checks 
*** TURN *** [4d Qs 5h] [5d]
phrantique: checks 
Filojoes: bets $3.54
SexyAngeline: folds 
phrantique: folds 
Uncalled bet ($3.54) returned to Filojoes
Filojoes collected $5.90 from pot
Filojoes: doesn't show hand 
*** SUMMARY ***
Total pot $6.21 | Rake $0.31 
Board [4d Qs 5h 5d]
Seat 1: matiko09 folded before Flop (didn't bet)
Seat 2: ruslik_by folded before Flop (didn't bet)
Seat 3: SkUhNi folded before Flop (didn't bet)
Seat 4: SexyAngeline folded on the Turn
Seat 5: Coolller folded before Flop (didn't bet)
Seat 7: Dickyxxx (button) folded before Flop (didn't bet)
Seat 8: phrantique (small blind) folded on the Turn
Seat 9: Filojoes (big blind) collected ($5.90)





PokerStars Hand #154970941203:  Hold'em No Limit (£0.25/£0.50 GBP) - 2016/06/20 13:02:21 CET [2016/06/20 7:02:21 ET]
Table 'Ani' 6-max Seat #2 is the button
Seat 1: asmodej666 (£50 in chips) 
Seat 2: mitsuVK (£57.75 in chips) 
Seat 3: Doobes8555 (£67.02 in chips) 
Seat 4: matiko09 (£66.42 in chips) 
Seat 5: Wwwasian (£56.93 in chips) 
Seat 6: faceMyBallz_ (£55.41 in chips) 
Doobes8555: posts small blind £0.25
matiko09: posts big blind £0.50
*** HOLE CARDS ***
Dealt to matiko09 [3h Ac]
Wwwasian: raises £0.90 to £1.40
faceMyBallz_: folds 
asmodej666: folds 
mitsuVK: calls £1.40
Doobes8555: folds 
matiko09: folds 
*** FLOP *** [6s 5c 2h]
Wwwasian: bets £1.50
mitsuVK: calls £1.50
*** TURN *** [6s 5c 2h] [Ah]
Wwwasian: bets £3
mitsuVK: folds 
Uncalled bet (£3) returned to Wwwasian
Wwwasian collected £6.22 from pot
Wwwasian: doesn't show hand 
*** SUMMARY ***
Total pot £6.55 | Rake £0.33 
Board [6s 5c 2h Ah]
Seat 1: asmodej666 folded before Flop (didn't bet)
Seat 2: mitsuVK (button) folded on the Turn
Seat 3: Doobes8555 (small blind) folded before Flop
Seat 4: matiko09 (big blind) folded before Flop
Seat 5: Wwwasian collected (£6.22)
Seat 6: faceMyBallz_ folded before Flop (didn't bet)





PokerStars Hand #154970943006:  Hold'em No Limit ($0.50/$1.00 USD) - 2016/06/20 13:02:25 CET [2016/06/20 7:02:25 ET]
Table 'Annika' 9-max Seat #4 is the button
Seat 1: hammerwife ($112.27 in chips) 
Seat 2: matiko09 ($103.80 in chips) 
Seat 3: first_dnk ($87.78 in chips) 
Seat 4: Kukuryzka ($104.12 in chips) 
Seat 5: SkUhNi ($108.82 in chips) 
Seat 6: Pvsx. ($102.55 in chips) 
Seat 7: jirka117 ($43.19 in chips) 
Seat 8: ruslik_by ($100 in chips) 
Seat 9: 23SmOkEr07 ($170.97 in chips) 
SkUhNi: posts small blind $0.50
Pvsx.: posts big blind $1
*** HOLE CARDS ***
Dealt to matiko09 [Kh 8d]
jirka117: folds 
ruslik_by: raises $2 to $3
23SmOkEr07: folds 
hammerwife: folds 
matiko09: folds 
first_dnk: folds 
Kukuryzka: folds 
SkUhNi: folds 
Pvsx.: calls $2
*** FLOP *** [6h 3s 5s]
Pvsx.: checks 
ruslik_by: bets $2.10
Pvsx.: raises $5.90 to $8
ruslik_by: calls $5.90
*** TURN *** [6h 3s 5s] [2s]
Pvsx.: bets $12
ruslik_by: folds 
Uncalled bet ($12) returned to Pvsx.
Pvsx. collected $21.38 from pot
Pvsx.: doesn't show hand 
*** SUMMARY ***
Total pot $22.50 | Rake $1.12 
Board [6h 3s 5s 2s]
Seat 1: hammerwife folded before Flop (didn't bet)
Seat 2: matiko09 folded before Flop (didn't bet)
Seat 3: first_dnk folded before Flop (didn't bet)
Seat 4: Kukuryzka (button) folded before Flop (didn't bet)
Seat 5: SkUhNi (small blind) folded before Flop
Seat 6: Pvsx. (big blind) collected ($21.38)
Seat 7: jirka117 folded before Flop (didn't bet)
Seat 8: ruslik_by folded on the Turn
Seat 9: 23SmOkEr07 folded before Flop (didn't bet)





PokerStars Hand #154970947605:  Hold'em No Limit (€0.25/€0.50 EUR) - 2016/06/20 13:02:37 CET [2016/06/20 7:02:37 ET]
Table 'Bechuana' 6-max Seat #2 is the button
Seat 2: matiko09 (€65.27 in chips) 
Seat 3: Aju!ntje (€77.90 in chips) 
Seat 4: Wwwasian (€50.75 in chips) 
Seat 5: fanmtZ (€46.49 in chips) 
Seat 6: SlayersGBG (€50 in chips) 
Aju!ntje: posts small blind €0.25
Wwwasian: posts big blind €0.50
zitagirl: sits out 
*** HOLE CARDS ***
Dealt to matiko09 [9s 4d]
fanmtZ: folds 
SlayersGBG: raises €0.75 to €1.25
matiko09: folds 
Aju!ntje: calls €1
Wwwasian: folds 
*** FLOP *** [2c 4s Kd]
Aju!ntje: bets €1.93
SlayersGBG: folds 
Uncalled bet (€1.93) returned to Aju!ntje
Aju!ntje collected €2.85 from pot
Aju!ntje: doesn't show hand 
*** SUMMARY ***
Total pot €3 | Rake €0.15 
Board [2c 4s Kd]
Seat 2: matiko09 (button) folded before Flop (didn't bet)
Seat 3: Aju!ntje (small blind) collected (€2.85)
Seat 4: Wwwasian (big blind) folded before Flop
Seat 5: fanmtZ folded before Flop (didn't bet)
Seat 6: SlayersGBG folded on the Flop





PokerStars Hand #154970947746:  Hold'em No Limit (£0.25/£0.50 GBP) - 2016/06/20 13:02:37 CET [2016/06/20 7:02:37 ET]
Table 'Azalea' 6-max Seat #1 is the button
Seat 1: mitsuVK (£52.85 in chips) 
Seat 2: matiko09 (£72.94 in chips) 
Seat 3: tyoma_knp (£52 in chips) 
Seat 4: faceMyBallz_ (£100.97 in chips) 
Seat 5: mudders693 (£59.19 in chips) 
Seat 6: Bënedic10 (£70.08 in chips) 
matiko09: posts small blind £0.25
tyoma_knp: posts big blind £0.50
*** HOLE CARDS ***
Dealt to matiko09 [Ts 3s]
faceMyBallz_: folds 
mudders693: raises £1 to £1.50
Bënedic10: folds 
mitsuVK: calls £1.50
matiko09: folds 
tyoma_knp: folds 
*** FLOP *** [2d Kd Kc]
mudders693: bets £3.50
mitsuVK: calls £3.50
*** TURN *** [2d Kd Kc] [4s]
mudders693: bets £6
mitsuVK: calls £6
*** RIVER *** [2d Kd Kc 4s] [Qd]
mudders693: checks 
mitsuVK: bets £21.50
mudders693: folds 
Uncalled bet (£21.50) returned to mitsuVK
mitsuVK collected £21.61 from pot
mitsuVK: doesn't show hand 
*** SUMMARY ***
Total pot £22.75 | Rake £1.14 
Board [2d Kd Kc 4s Qd]
Seat 1: mitsuVK (button) collected (£21.61)
Seat 2: matiko09 (small blind) folded before Flop
Seat 3: tyoma_knp (big blind) folded before Flop
Seat 4: faceMyBallz_ folded before Flop (didn't bet)
Seat 5: mudders693 folded on the River
Seat 6: Bënedic10 folded before Flop (didn't bet)





PokerStars Hand #154970952607:  Hold'em No Limit ($0.50/$1.00 USD) - 2016/06/20 13:02:50 CET [2016/06/20 7:02:50 ET]
Table 'Normannia' 9-max Seat #9 is the button
Seat 2: Pvsx. ($188.34 in chips) 
Seat 3: Avtovo ($101.50 in chips) 
Seat 4: Filojoes ($153.59 in chips) 
Seat 5: Dickyxxx ($100 in chips) 
Seat 6: typename27 ($75.09 in chips) 
Seat 7: matiko09 ($106.79 in chips) 
Seat 8: SkUhNi ($132.30 in chips) 
Seat 9: ruslik_by ($144.69 in chips) 
Pvsx.: posts small blind $0.50
Avtovo: posts big blind $1
*** HOLE CARDS ***
Dealt to matiko09 [Tc Js]
Filojoes: folds 
Filojoes leaves the table
Dickyxxx: folds 
typename27: folds 
matiko09: folds 
SkUhNi: folds 
mi$$I$Elena joins the table at seat #4 
mi$$I$Elena leaves the table
SexyAngeline joins the table at seat #4 
ruslik_by: raises $1 to $2
Pvsx.: folds 
Avtovo: folds 
Uncalled bet ($1) returned to ruslik_by
ruslik_by collected $2.50 from pot
ruslik_by: doesn't show hand 
*** SUMMARY ***
Total pot $2.50 | Rake $0 
Seat 2: Pvsx. (small blind) folded before Flop
Seat 3: Avtovo (big blind) folded before Flop
Seat 4: Filojoes folded before Flop (didn't bet)
Seat 5: Dickyxxx folded before Flop (didn't bet)
Seat 6: typename27 folded before Flop (didn't bet)
Seat 7: matiko09 folded before Flop (didn't bet)
Seat 8: SkUhNi folded before Flop (didn't bet)
Seat 9: ruslik_by (button) collected ($2.50)





PokerStars Hand #154970953048:  Hold'em No Limit ($0.50/$1.00 USD) - 2016/06/20 13:02:51 CET [2016/06/20 7:02:51 ET]
Table 'Garumna II' 9-max Seat #2 is the button
Seat 1: ki11u ($143.50 in chips) 
Seat 2: Racushniak ($100 in chips) 
Seat 3: mooose100 ($94.50 in chips) 
Seat 4: Ndundun Gipe ($55.84 in chips) 
Seat 5: rura53 ($80.62 in chips) 
Seat 6: SexyAngeline ($41.03 in chips) 
Seat 7: Avtovo ($106.38 in chips) 
Seat 8: matiko09 ($104.02 in chips) 
Seat 9: SkUhNi ($100 in chips) 
mooose100: posts small blind $0.50
Ndundun Gipe: posts big blind $1
*** HOLE CARDS ***
Dealt to matiko09 [Ad Td]
rura53: folds 
SexyAngeline: folds 
Avtovo: raises $1.50 to $2.50
matiko09: raises $6.50 to $9
SkUhNi: folds 
ki11u: folds 
Racushniak: folds 
mooose100: folds 
Ndundun Gipe: folds 
Avtovo: folds 
Uncalled bet ($6.50) returned to matiko09
matiko09 collected $6.50 from pot
matiko09: doesn't show hand 
*** SUMMARY ***
Total pot $6.50 | Rake $0 
Seat 1: ki11u folded before Flop (didn't bet)
Seat 2: Racushniak (button) folded before Flop (didn't bet)
Seat 3: mooose100 (small blind) folded before Flop
Seat 4: Ndundun Gipe (big blind) folded before Flop
Seat 5: rura53 folded before Flop (didn't bet)
Seat 6: SexyAngeline folded before Flop (didn't bet)
Seat 7: Avtovo folded before Flop
Seat 8: matiko09 collected ($6.50)
Seat 9: SkUhNi folded before Flop (didn't bet)





PokerStars Hand #154970955246:  Hold'em No Limit (£0.25/£0.50 GBP) - 2016/06/20 13:02:57 CET [2016/06/20 7:02:57 ET]
Table 'Tesla' 6-max Seat #5 is the button
Seat 1: Rubleff85 (£34.66 in chips) 
Seat 2: matiko09 (£71.70 in chips) 
Seat 3: asmodej666 (£50 in chips) 
Seat 4: VahTang_89 (£77.40 in chips) 
Seat 5: Nego Razu (£50 in chips) 
Seat 6: faceMyBallz_ (£56.01 in chips) 
faceMyBallz_: posts small blind £0.25
Rubleff85: posts big blind £0.50
*** HOLE CARDS ***
Dealt to matiko09 [9s Kh]
matiko09: folds 
asmodej666: folds 
VahTang_89: folds 
Nego Razu: raises £0.77 to £1.27
faceMyBallz_: folds 
Rubleff85: folds 
Uncalled bet (£0.77) returned to Nego Razu
Nego Razu collected £1.25 from pot
Nego Razu: doesn't show hand 
*** SUMMARY ***
Total pot £1.25 | Rake £0 
Seat 1: Rubleff85 (big blind) folded before Flop
Seat 2: matiko09 folded before Flop (didn't bet)
Seat 3: asmodej666 folded before Flop (didn't bet)
Seat 4: VahTang_89 folded before Flop (didn't bet)
Seat 5: Nego Razu (button) collected (£1.25)
Seat 6: faceMyBallz_ (small blind) folded before Flop





PokerStars Hand #154970959406:  Hold'em No Limit (£0.25/£0.50 GBP) - 2016/06/20 13:03:07 CET [2016/06/20 7:03:07 ET]
Table 'Ani' 6-max Seat #3 is the button
Seat 1: asmodej666 (£50 in chips) 
Seat 2: mitsuVK (£54.85 in chips) 
Seat 3: Doobes8555 (£66.77 in chips) 
Seat 4: matiko09 (£65.92 in chips) 
Seat 5: Wwwasian (£60.25 in chips) 
Seat 6: faceMyBallz_ (£55.41 in chips) 
matiko09: posts small blind £0.25
Wwwasian: posts big blind £0.50
*** HOLE CARDS ***
Dealt to matiko09 [5c 4d]
faceMyBallz_: folds 
asmodej666: folds 
mitsuVK: folds 
Doobes8555: folds 
matiko09: folds 
Uncalled bet (£0.25) returned to Wwwasian
Wwwasian collected £0.50 from pot
Wwwasian: doesn't show hand 
*** SUMMARY ***
Total pot £0.50 | Rake £0 
Seat 1: asmodej666 folded before Flop (didn't bet)
Seat 2: mitsuVK folded before Flop (didn't bet)
Seat 3: Doobes8555 (button) folded before Flop (didn't bet)
Seat 4: matiko09 (small blind) folded before Flop
Seat 5: Wwwasian (big blind) collected (£0.50)
Seat 6: faceMyBallz_ folded before Flop (didn't bet)





PokerStars Hand #154970961177:  Hold'em No Limit (£0.25/£0.50 GBP) - 2016/06/20 13:03:12 CET [2016/06/20 7:03:12 ET]
Table 'Tesla' 6-max Seat #6 is the button
Seat 1: Rubleff85 (£34.16 in chips) 
Seat 2: matiko09 (£71.70 in chips) 
Seat 3: asmodej666 (£50 in chips) 
Seat 4: VahTang_89 (£77.40 in chips) 
Seat 5: Nego Razu (£50.75 in chips) 
Seat 6: faceMyBallz_ (£55.76 in chips) 
Rubleff85: posts small blind £0.25
matiko09: posts big blind £0.50
*** HOLE CARDS ***
Dealt to matiko09 [Ah 4s]
asmodej666: folds 
VahTang_89: raises £0.50 to £1
Nego Razu: folds 
faceMyBallz_: folds 
Rubleff85: calls £0.75
matiko09: folds 
*** FLOP *** [8c Ks Kc]
Rubleff85: bets £0.50
VahTang_89: folds 
Uncalled bet (£0.50) returned to Rubleff85
Rubleff85 collected £2.38 from pot
Rubleff85: doesn't show hand 
*** SUMMARY ***
Total pot £2.50 | Rake £0.12 
Board [8c Ks Kc]
Seat 1: Rubleff85 (small blind) collected (£2.38)
Seat 2: matiko09 (big blind) folded before Flop
Seat 3: asmodej666 folded before Flop (didn't bet)
Seat 4: VahTang_89 folded on the Flop
Seat 5: Nego Razu folded before Flop (didn't bet)
Seat 6: faceMyBallz_ (button) folded before Flop (didn't bet)





PokerStars Hand #154970965210:  Hold'em No Limit ($0.50/$1.00 USD) - 2016/06/20 13:03:22 CET [2016/06/20 7:03:22 ET]
Table 'Ernestina' 9-max Seat #6 is the button
Seat 1: diva3150 ($122.51 in chips) 
Seat 2: matiko09 ($192.12 in chips) 
Seat 3: Pvsx. ($184.49 in chips) 
Seat 4: SkUhNi ($100 in chips) 
Seat 5: Dickyxxx ($109 in chips) 
Seat 6: arctur17 ($76.29 in chips) 
Seat 8: ruslik_by ($240.03 in chips) 
ruslik_by: posts small blind $0.50
23SmOkEr07: is sitting out 
23SmOkEr07 leaves the table
diva3150: posts big blind $1
*** HOLE CARDS ***
Dealt to matiko09 [Js Jh]
Filojoes joins the table at seat #9 
matiko09: raises $2 to $3
Pvsx.: folds 
SkUhNi: folds 
Dickyxxx: calls $3
arctur17: folds 
ruslik_by: folds 
diva3150: folds 
*** FLOP *** [4h 6c 2s]
matiko09: bets $4.50
Dickyxxx: calls $4.50
*** TURN *** [4h 6c 2s] [8d]
matiko09: bets $8.15
Dickyxxx: folds 
Uncalled bet ($8.15) returned to matiko09
matiko09 collected $15.68 from pot
matiko09: doesn't show hand 
*** SUMMARY ***
Total pot $16.50 | Rake $0.82 
Board [4h 6c 2s 8d]
Seat 1: diva3150 (big blind) folded before Flop
Seat 2: matiko09 collected ($15.68)
Seat 3: Pvsx. folded before Flop (didn't bet)
Seat 4: SkUhNi folded before Flop (didn't bet)
Seat 5: Dickyxxx folded on the Turn
Seat 6: arctur17 (button) folded before Flop (didn't bet)
Seat 8: ruslik_by (small blind) folded before Flop





PokerStars Hand #154970967566:  Hold'em No Limit ($0.50/$1.00 USD) - 2016/06/20 13:03:28 CET [2016/06/20 7:03:28 ET]
Table 'Pongola' 9-max Seat #8 is the button
Seat 1: matiko09 ($114.68 in chips) 
Seat 2: ruslik_by ($126.27 in chips) 
Seat 3: SkUhNi ($108.72 in chips) 
Seat 4: SexyAngeline ($75.14 in chips) 
Seat 5: Coolller ($98.50 in chips) 
Seat 7: Dickyxxx ($154.65 in chips) 
Seat 8: phrantique ($121.12 in chips) 
Seat 9: Filojoes ($156.42 in chips) 
Filojoes: posts small blind $0.50
matiko09: posts big blind $1
Racushniak: sits out 
*** HOLE CARDS ***
Dealt to matiko09 [Jd 9s]
ruslik_by: folds 
SkUhNi: folds 
SexyAngeline: folds 
Coolller: raises $2 to $3
Dickyxxx: folds 
phrantique: folds 
Filojoes: folds 
matiko09: folds 
Uncalled bet ($2) returned to Coolller
Coolller collected $2.50 from pot
Coolller: doesn't show hand 
*** SUMMARY ***
Total pot $2.50 | Rake $0 
Seat 1: matiko09 (big blind) folded before Flop
Seat 2: ruslik_by folded before Flop (didn't bet)
Seat 3: SkUhNi folded before Flop (didn't bet)
Seat 4: SexyAngeline folded before Flop (didn't bet)
Seat 5: Coolller collected ($2.50)
Seat 7: Dickyxxx folded before Flop (didn't bet)
Seat 8: phrantique (button) folded before Flop (didn't bet)
Seat 9: Filojoes (small blind) folded before Flop





PokerStars Hand #154970967779:  Hold'em No Limit (£0.25/£0.50 GBP) - 2016/06/20 13:03:29 CET [2016/06/20 7:03:29 ET]
Table 'Ani' 6-max Seat #4 is the button
Seat 1: asmodej666 (£50 in chips) 
Seat 2: mitsuVK (£54.85 in chips) 
Seat 3: Doobes8555 (£66.77 in chips) 
Seat 4: matiko09 (£65.67 in chips) 
Seat 5: Wwwasian (£60.50 in chips) 
Seat 6: faceMyBallz_ (£55.41 in chips) 
Wwwasian: posts small blind £0.25
faceMyBallz_: posts big blind £0.50
*** HOLE CARDS ***
Dealt to matiko09 [4s 5h]
asmodej666: folds 
mitsuVK: folds 
Doobes8555: folds 
matiko09: folds 
Wwwasian: folds 
Uncalled bet (£0.25) returned to faceMyBallz_
faceMyBallz_ collected £0.50 from pot
faceMyBallz_: doesn't show hand 
*** SUMMARY ***
Total pot £0.50 | Rake £0 
Seat 1: asmodej666 folded before Flop (didn't bet)
Seat 2: mitsuVK folded before Flop (didn't bet)
Seat 3: Doobes8555 folded before Flop (didn't bet)
Seat 4: matiko09 (button) folded before Flop (didn't bet)
Seat 5: Wwwasian (small blind) folded before Flop
Seat 6: faceMyBallz_ (big blind) collected (£0.50)





PokerStars Hand #154970968724:  Hold'em No Limit (€0.25/€0.50 EUR) - 2016/06/20 13:03:31 CET [2016/06/20 7:03:31 ET]
Table 'Bechuana' 6-max Seat #3 is the button
Seat 2: matiko09 (€65.27 in chips) 
Seat 3: Aju!ntje (€79.50 in chips) 
Seat 4: Wwwasian (€50.25 in chips) 
Seat 5: fanmtZ (€46.49 in chips) 
Seat 6: SlayersGBG (€50 in chips) 
Wwwasian: posts small blind €0.25
fanmtZ: posts big blind €0.50
zitagirl: sits out 
*** HOLE CARDS ***
Dealt to matiko09 [5h Js]
SlayersGBG: raises €1 to €1.50
matiko09: folds 
Aju!ntje: calls €1.50
Wwwasian: folds 
fanmtZ: folds 
*** FLOP *** [5c 3d 3s]
SlayersGBG: checks 
Aju!ntje: bets €2.42
SlayersGBG: folds 
Uncalled bet (€2.42) returned to Aju!ntje
Aju!ntje collected €3.56 from pot
Aju!ntje: doesn't show hand 
*** SUMMARY ***
Total pot €3.75 | Rake €0.19 
Board [5c 3d 3s]
Seat 2: matiko09 folded before Flop (didn't bet)
Seat 3: Aju!ntje (button) collected (€3.56)
Seat 4: Wwwasian (small blind) folded before Flop
Seat 5: fanmtZ (big blind) folded before Flop
Seat 6: SlayersGBG folded on the Flop





PokerStars Hand #154970971618:  Hold'em No Limit (£0.25/£0.50 GBP) - 2016/06/20 13:03:38 CET [2016/06/20 7:03:38 ET]
Table 'Tesla' 6-max Seat #1 is the button
Seat 1: Rubleff85 (£35.54 in chips) 
Seat 2: matiko09 (£71.20 in chips) 
Seat 3: asmodej666 (£50 in chips) 
Seat 4: VahTang_89 (£76.40 in chips) 
Seat 5: Nego Razu (£50.75 in chips) 
Seat 6: faceMyBallz_ (£55.76 in chips) 
matiko09: posts small blind £0.25
asmodej666: posts big blind £0.50
*** HOLE CARDS ***
Dealt to matiko09 [7c 4d]
VahTang_89: folds 
Nego Razu: folds 
faceMyBallz_: folds 
Rubleff85: raises £1 to £1.50
matiko09: folds 
asmodej666: folds 
Uncalled bet (£1) returned to Rubleff85
Rubleff85 collected £1.25 from pot
Rubleff85: doesn't show hand 
*** SUMMARY ***
Total pot £1.25 | Rake £0 
Seat 1: Rubleff85 (button) collected (£1.25)
Seat 2: matiko09 (small blind) folded before Flop
Seat 3: asmodej666 (big blind) folded before Flop
Seat 4: VahTang_89 folded before Flop (didn't bet)
Seat 5: Nego Razu folded before Flop (didn't bet)
Seat 6: faceMyBallz_ folded before Flop (didn't bet)





PokerStars Hand #154970975276:  Hold'em No Limit ($0.50/$1.00 USD) - 2016/06/20 13:03:48 CET [2016/06/20 7:03:48 ET]
Table 'Garumna II' 9-max Seat #3 is the button
Seat 1: ki11u ($143.50 in chips) 
Seat 2: Racushniak ($100 in chips) 
Seat 3: mooose100 ($94 in chips) 
Seat 4: Ndundun Gipe ($54.84 in chips) 
Seat 5: rura53 ($80.62 in chips) 
Seat 6: SexyAngeline ($41.03 in chips) 
Seat 7: Avtovo ($103.88 in chips) 
Seat 8: matiko09 ($108.02 in chips) 
Seat 9: SkUhNi ($100 in chips) 
Ndundun Gipe: posts small blind $0.50
rura53: posts big blind $1
*** HOLE CARDS ***
Dealt to matiko09 [Jd Ts]
SexyAngeline: folds 
Avtovo: folds 
matiko09: folds 
SkUhNi: folds 
ki11u: folds 
Racushniak: folds 
mooose100: raises $2 to $3
Ndundun Gipe: calls $2.50
rura53: folds 
*** FLOP *** [5c Ac 8c]
Ndundun Gipe: checks 
mooose100: bets $6.65
Ndundun Gipe: folds 
Uncalled bet ($6.65) returned to mooose100
mooose100 collected $6.65 from pot
mooose100: doesn't show hand 
*** SUMMARY ***
Total pot $7 | Rake $0.35 
Board [5c Ac 8c]
Seat 1: ki11u folded before Flop (didn't bet)
Seat 2: Racushniak folded before Flop (didn't bet)
Seat 3: mooose100 (button) collected ($6.65)
Seat 4: Ndundun Gipe (small blind) folded on the Flop
Seat 5: rura53 (big blind) folded before Flop
Seat 6: SexyAngeline folded before Flop (didn't bet)
Seat 7: Avtovo folded before Flop (didn't bet)
Seat 8: matiko09 folded before Flop (didn't bet)
Seat 9: SkUhNi folded before Flop (didn't bet)





PokerStars Hand #154970976343:  Hold'em No Limit (£0.25/£0.50 GBP) - 2016/06/20 13:03:50 CET [2016/06/20 7:03:50 ET]
Table 'Tesla' 6-max Seat #2 is the button
Seat 1: Rubleff85 (£36.29 in chips) 
Seat 2: matiko09 (£70.95 in chips) 
Seat 3: asmodej666 (£50 in chips) 
Seat 4: VahTang_89 (£76.40 in chips) 
Seat 5: Nego Razu (£50.75 in chips) 
Seat 6: faceMyBallz_ (£55.76 in chips) 
asmodej666: posts small blind £0.25
VahTang_89: posts big blind £0.50
*** HOLE CARDS ***
Dealt to matiko09 [Ah Td]
Nego Razu: folds 
faceMyBallz_: folds 
Rubleff85: folds 
matiko09: raises £0.63 to £1.13
asmodej666: folds 
VahTang_89: calls £0.63
*** FLOP *** [Ac 7d 5d]
VahTang_89: checks 
matiko09: bets £1.55
VahTang_89: calls £1.55
*** TURN *** [Ac 7d 5d] [2h]
VahTang_89: checks 
matiko09: bets £3.46
VahTang_89: raises £6.12 to £9.58
matiko09: folds 
Uncalled bet (£6.12) returned to VahTang_89
VahTang_89 collected £11.90 from pot
VahTang_89: doesn't show hand 
*** SUMMARY ***
Total pot £12.53 | Rake £0.63 
Board [Ac 7d 5d 2h]
Seat 1: Rubleff85 folded before Flop (didn't bet)
Seat 2: matiko09 (button) folded on the Turn
Seat 3: asmodej666 (small blind) folded before Flop
Seat 4: VahTang_89 (big blind) collected (£11.90)
Seat 5: Nego Razu folded before Flop (didn't bet)
Seat 6: faceMyBallz_ folded before Flop (didn't bet)





PokerStars Hand #154970979990:  Hold'em No Limit ($0.50/$1.00 USD) - 2016/06/20 13:03:59 CET [2016/06/20 7:03:59 ET]
Table 'Normannia' 9-max Seat #2 is the button
Seat 2: Pvsx. ($187.84 in chips) 
Seat 3: Avtovo ($100.50 in chips) 
Seat 4: SexyAngeline ($97.81 in chips) 
Seat 5: Dickyxxx ($100 in chips) 
Seat 6: typename27 ($75.09 in chips) 
Seat 7: matiko09 ($106.79 in chips) 
Seat 8: SkUhNi ($132.30 in chips) 
Seat 9: ruslik_by ($146.19 in chips) 
Avtovo: posts small blind $0.50
SexyAngeline: posts big blind $1
*** HOLE CARDS ***
Dealt to matiko09 [8c 9d]
Dickyxxx: folds 
typename27: folds 
matiko09: folds 
SkUhNi: folds 
ruslik_by: raises $1.50 to $2.50
Pvsx.: folds 
Avtovo: folds 
SexyAngeline: calls $1.50
*** FLOP *** [3h 5h Qs]
SexyAngeline: checks 
ruslik_by: bets $1.77
SexyAngeline: folds 
Uncalled bet ($1.77) returned to ruslik_by
ruslik_by collected $5.22 from pot
ruslik_by: doesn't show hand 
*** SUMMARY ***
Total pot $5.50 | Rake $0.28 
Board [3h 5h Qs]
Seat 2: Pvsx. (button) folded before Flop (didn't bet)
Seat 3: Avtovo (small blind) folded before Flop
Seat 4: SexyAngeline (big blind) folded on the Flop
Seat 5: Dickyxxx folded before Flop (didn't bet)
Seat 6: typename27 folded before Flop (didn't bet)
Seat 7: matiko09 folded before Flop (didn't bet)
Seat 8: SkUhNi folded before Flop (didn't bet)
Seat 9: ruslik_by collected ($5.22)





PokerStars Hand #154970981253:  Hold'em No Limit ($0.50/$1.00 USD) - 2016/06/20 13:04:03 CET [2016/06/20 7:04:03 ET]
Table 'Pongola' 9-max Seat #9 is the button
Seat 1: matiko09 ($113.68 in chips) 
Seat 2: ruslik_by ($126.27 in chips) 
Seat 3: SkUhNi ($108.72 in chips) 
Seat 4: SexyAngeline ($75.14 in chips) 
Seat 5: Coolller ($100 in chips) 
Seat 7: Dickyxxx ($154.65 in chips) 
Seat 8: phrantique ($121.12 in chips) 
Seat 9: Filojoes ($155.92 in chips) 
matiko09: posts small blind $0.50
ruslik_by: posts big blind $1
Racushniak: sits out 
*** HOLE CARDS ***
Dealt to matiko09 [Qd Tc]
SkUhNi: folds 
SexyAngeline: folds 
Coolller: folds 
Dickyxxx has timed out
Dickyxxx: folds 
phrantique: folds 
Filojoes: folds 
matiko09: raises $2 to $3
ruslik_by: calls $2
*** FLOP *** [Ac Jc Th]
matiko09: checks 
ruslik_by: bets $1.93
matiko09: calls $1.93
*** TURN *** [Ac Jc Th] [7c]
matiko09: checks 
ruslik_by: checks 
*** RIVER *** [Ac Jc Th 7c] [4h]
matiko09: bets $10
ruslik_by: folds 
Uncalled bet ($10) returned to matiko09
matiko09 collected $9.37 from pot
matiko09: doesn't show hand 
*** SUMMARY ***
Total pot $9.86 | Rake $0.49 
Board [Ac Jc Th 7c 4h]
Seat 1: matiko09 (small blind) collected ($9.37)
Seat 2: ruslik_by (big blind) folded on the River
Seat 3: SkUhNi folded before Flop (didn't bet)
Seat 4: SexyAngeline folded before Flop (didn't bet)
Seat 5: Coolller folded before Flop (didn't bet)
Seat 7: Dickyxxx folded before Flop (didn't bet)
Seat 8: phrantique folded before Flop (didn't bet)
Seat 9: Filojoes (button) folded before Flop (didn't bet)





PokerStars Hand #154970981398:  Hold'em No Limit (£0.25/£0.50 GBP) - 2016/06/20 13:04:03 CET [2016/06/20 7:04:03 ET]
Table 'Azalea' 6-max Seat #2 is the button
Seat 1: mitsuVK (£63.46 in chips) 
Seat 2: matiko09 (£72.69 in chips) 
Seat 3: tyoma_knp (£51.50 in chips) 
Seat 4: faceMyBallz_ (£100.97 in chips) 
Seat 5: mudders693 (£48.19 in chips) 
Seat 6: Bënedic10 (£70.08 in chips) 
tyoma_knp is connected 
tyoma_knp: posts small blind £0.25
faceMyBallz_: posts big blind £0.50
*** HOLE CARDS ***
Dealt to matiko09 [3d Qc]
mudders693: raises £1 to £1.50
Bënedic10: folds 
mitsuVK: folds 
matiko09: folds 
tyoma_knp: raises £2 to £3.50
faceMyBallz_: folds 
mudders693: calls £2
*** FLOP *** [Jc Kh 5h]
tyoma_knp: checks 
mudders693: checks 
*** TURN *** [Jc Kh 5h] [7d]
tyoma_knp: checks 
mudders693: bets £5
tyoma_knp: folds 
Uncalled bet (£5) returned to mudders693
mudders693 collected £7.12 from pot
mudders693: doesn't show hand 
*** SUMMARY ***
Total pot £7.50 | Rake £0.38 
Board [Jc Kh 5h 7d]
Seat 1: mitsuVK folded before Flop (didn't bet)
Seat 2: matiko09 (button) folded before Flop (didn't bet)
Seat 3: tyoma_knp (small blind) folded on the Turn
Seat 4: faceMyBallz_ (big blind) folded before Flop
Seat 5: mudders693 collected (£7.12)
Seat 6: Bënedic10 folded before Flop (didn't bet)





PokerStars Hand #154970982299:  Hold'em No Limit (£0.25/£0.50 GBP) - 2016/06/20 13:04:05 CET [2016/06/20 7:04:05 ET]
Table 'Ani' 6-max Seat #5 is the button
Seat 1: asmodej666 (£50 in chips) 
Seat 2: mitsuVK (£54.85 in chips) 
Seat 3: Doobes8555 (£66.77 in chips) 
Seat 4: matiko09 (£65.67 in chips) 
Seat 5: Wwwasian (£60.25 in chips) 
Seat 6: faceMyBallz_ (£55.66 in chips) 
faceMyBallz_: posts small blind £0.25
asmodej666: posts big blind £0.50
*** HOLE CARDS ***
Dealt to matiko09 [Tc Kh]
mitsuVK: folds 
Doobes8555: folds 
matiko09: raises £1 to £1.50
Wwwasian: folds 
faceMyBallz_: folds 
asmodej666: folds 
Uncalled bet (£1) returned to matiko09
matiko09 collected £1.25 from pot
matiko09: doesn't show hand 
*** SUMMARY ***
Total pot £1.25 | Rake £0 
Seat 1: asmodej666 (big blind) folded before Flop
Seat 2: mitsuVK folded before Flop (didn't bet)
Seat 3: Doobes8555 folded before Flop (didn't bet)
Seat 4: matiko09 collected (£1.25)
Seat 5: Wwwasian (button) folded before Flop (didn't bet)
Seat 6: faceMyBallz_ (small blind) folded before Flop





PokerStars Hand #154970985131:  Hold'em No Limit ($0.50/$1.00 USD) - 2016/06/20 13:04:12 CET [2016/06/20 7:04:12 ET]
Table 'Isonoe II' 9-max Seat #6 is the button
Seat 1: hammerwife ($161.50 in chips) 
Seat 2: matiko09 ($126.32 in chips) 
Seat 3: Kukuryzka ($100 in chips) 
Seat 4: Avtovo ($102 in chips) 
Seat 5: Filojoes ($107.12 in chips) 
Seat 6: GOOFA13 ($49.46 in chips) 
Seat 7: SkUhNi ($121.70 in chips) 
Seat 8: lewyson ($18.15 in chips) 
Seat 9: djammusic ($65.95 in chips) 
SkUhNi: posts small blind $0.50
lewyson: posts big blind $1
*** HOLE CARDS ***
Dealt to matiko09 [4d Th]
djammusic: raises $1.50 to $2.50
hammerwife: folds 
matiko09: folds 
Kukuryzka: folds 
Avtovo: folds 
Filojoes: calls $2.50
GOOFA13: folds 
SkUhNi: folds 
lewyson: folds 
*** FLOP *** [9h Jc 2s]
djammusic: checks 
Filojoes: bets $3.71
djammusic: calls $3.71
*** TURN *** [9h Jc 2s] [9d]
djammusic: checks 
Filojoes: bets $7.93
djammusic: folds 
Uncalled bet ($7.93) returned to Filojoes
Filojoes collected $13.22 from pot
Filojoes: doesn't show hand 
*** SUMMARY ***
Total pot $13.92 | Rake $0.70 
Board [9h Jc 2s 9d]
Seat 1: hammerwife folded before Flop (didn't bet)
Seat 2: matiko09 folded before Flop (didn't bet)
Seat 3: Kukuryzka folded before Flop (didn't bet)
Seat 4: Avtovo folded before Flop (didn't bet)
Seat 5: Filojoes collected ($13.22)
Seat 6: GOOFA13 (button) folded before Flop (didn't bet)
Seat 7: SkUhNi (small blind) folded before Flop
Seat 8: lewyson (big blind) folded before Flop
Seat 9: djammusic folded on the Turn





PokerStars Hand #154970987422:  Hold'em No Limit ($0.50/$1.00 USD) - 2016/06/20 13:04:18 CET [2016/06/20 7:04:18 ET]
Table 'Annika' 9-max Seat #5 is the button
Seat 1: hammerwife ($112.27 in chips) 
Seat 2: matiko09 ($103.80 in chips) 
Seat 3: first_dnk ($87.78 in chips) 
Seat 4: Kukuryzka ($104.12 in chips) 
Seat 5: SkUhNi ($108.32 in chips) 
Seat 6: Pvsx. ($112.93 in chips) 
Seat 7: jirka117 ($43.19 in chips) 
Seat 8: ruslik_by ($100 in chips) 
Seat 9: 23SmOkEr07 ($170.97 in chips) 
Pvsx.: posts small blind $0.50
jirka117: posts big blind $1
*** HOLE CARDS ***
Dealt to matiko09 [As 4c]
ruslik_by: folds 
23SmOkEr07: folds 
hammerwife: folds 
matiko09: folds 
first_dnk: folds 
Kukuryzka: folds 
SkUhNi: raises $1 to $2
Pvsx.: folds 
jirka117: calls $1
*** FLOP *** [Jh 4s Js]
jirka117: checks 
SkUhNi: bets $3
jirka117: calls $3
*** TURN *** [Jh 4s Js] [9h]
jirka117: checks 
SkUhNi: checks 
*** RIVER *** [Jh 4s Js 9h] [5c]
jirka117: bets $9.98
SkUhNi: folds 
Uncalled bet ($9.98) returned to jirka117
jirka117 collected $9.98 from pot
*** SUMMARY ***
Total pot $10.50 | Rake $0.52 
Board [Jh 4s Js 9h 5c]
Seat 1: hammerwife folded before Flop (didn't bet)
Seat 2: matiko09 folded before Flop (didn't bet)
Seat 3: first_dnk folded before Flop (didn't bet)
Seat 4: Kukuryzka folded before Flop (didn't bet)
Seat 5: SkUhNi (button) folded on the River
Seat 6: Pvsx. (small blind) folded before Flop
Seat 7: jirka117 (big blind) collected ($9.98)
Seat 8: ruslik_by folded before Flop (didn't bet)
Seat 9: 23SmOkEr07 folded before Flop (didn't bet)





PokerStars Hand #154970989105:  Hold'em No Limit (€0.25/€0.50 EUR) - 2016/06/20 13:04:22 CET [2016/06/20 7:04:22 ET]
Table 'Bechuana' 6-max Seat #4 is the button
Seat 2: matiko09 (€65.27 in chips) 
Seat 3: Aju!ntje (€81.56 in chips) 
Seat 4: Wwwasian (€50 in chips) 
Seat 5: fanmtZ (€45.99 in chips) 
Seat 6: SlayersGBG (€50 in chips) 
fanmtZ: posts small blind €0.25
SlayersGBG: posts big blind €0.50
zitagirl: sits out 
*** HOLE CARDS ***
Dealt to matiko09 [7h 7d]
matiko09: raises €1 to €1.50
Aju!ntje: calls €1.50
Wwwasian: folds 
fanmtZ: folds 
SlayersGBG: folds 
*** FLOP *** [Qc 6d 5c]
matiko09: bets €1.85
Aju!ntje: calls €1.85
*** TURN *** [Qc 6d 5c] [Td]
matiko09: checks 
Aju!ntje: bets €5.09
matiko09: folds 
Uncalled bet (€5.09) returned to Aju!ntje
Aju!ntje collected €7.08 from pot
Aju!ntje: doesn't show hand 
*** SUMMARY ***
Total pot €7.45 | Rake €0.37 
Board [Qc 6d 5c Td]
Seat 2: matiko09 folded on the Turn
Seat 3: Aju!ntje collected (€7.08)
Seat 4: Wwwasian (button) folded before Flop (didn't bet)
Seat 5: fanmtZ (small blind) folded before Flop
Seat 6: SlayersGBG (big blind) folded before Flop





PokerStars Hand #154970989174:  Hold'em No Limit ($0.25/$0.50 USD) - 2016/06/20 13:04:22 CET [2016/06/20 7:04:22 ET]
Table 'Scheddi II' 9-max Seat #8 is the button
Seat 1: matiko09 ($92.85 in chips) 
Seat 2: Yaaaazz ($59.36 in chips) 
Seat 3: mi$$I$Elena ($82.26 in chips) 
Seat 4: GOOFA13 ($72.10 in chips) 
Seat 5: zarplatka ($40 in chips) 
Seat 6: orochimaturi ($41.20 in chips) 
Seat 7: HopeMayBee ($109.91 in chips) 
Seat 8: Danil27 ($50 in chips) 
Seat 9: Infinitinium ($134.41 in chips) 
Infinitinium: posts small blind $0.25
matiko09: posts big blind $0.50
matiko09: posts the ante $0.10
Yaaaazz: posts the ante $0.10
mi$$I$Elena: posts the ante $0.10
GOOFA13: posts the ante $0.10
zarplatka: posts the ante $0.10
orochimaturi: posts the ante $0.10
HopeMayBee: posts the ante $0.10
Danil27: posts the ante $0.10
Infinitinium: posts the ante $0.10
*** HOLE CARDS ***
Dealt to matiko09 [As Ad]
Yaaaazz: folds 
mi$$I$Elena: folds 
GOOFA13: folds 
zarplatka: folds 
orochimaturi has timed out
orochimaturi: folds 
HopeMayBee: folds 
Danil27: folds 
Infinitinium: folds 
Uncalled bet ($0.25) returned to matiko09
matiko09 collected $1.40 from pot
matiko09: doesn't show hand 
*** SUMMARY ***
Total pot $1.40 | Rake $0 
Seat 1: matiko09 (big blind) collected ($1.40)
Seat 2: Yaaaazz folded before Flop (didn't bet)
Seat 3: mi$$I$Elena folded before Flop (didn't bet)
Seat 4: GOOFA13 folded before Flop (didn't bet)
Seat 5: zarplatka folded before Flop (didn't bet)
Seat 6: orochimaturi folded before Flop (didn't bet)
Seat 7: HopeMayBee folded before Flop (didn't bet)
Seat 8: Danil27 (button) folded before Flop (didn't bet)
Seat 9: Infinitinium (small blind) folded before Flop





PokerStars Hand #154970991495:  Hold'em No Limit ($0.50/$1.00 USD) - 2016/06/20 13:04:28 CET [2016/06/20 7:04:28 ET]
Table 'Ernestina' 9-max Seat #8 is the button
Seat 1: diva3150 ($121.51 in chips) 
Seat 2: matiko09 ($200.30 in chips) 
Seat 3: Pvsx. ($184.49 in chips) 
Seat 4: SkUhNi ($100 in chips) 
Seat 5: Dickyxxx ($101.50 in chips) 
Seat 6: arctur17 ($76.29 in chips) 
Seat 8: ruslik_by ($239.53 in chips) 
Filojoes will be allowed to play after the button
diva3150: posts small blind $0.50
matiko09: posts big blind $1
*** HOLE CARDS ***
Dealt to matiko09 [Qs 6c]
Pvsx.: raises $1.50 to $2.50
SkUhNi: folds 
Dickyxxx: folds 
arctur17: folds 
ruslik_by: folds 
diva3150: folds 
matiko09: folds 
Uncalled bet ($1.50) returned to Pvsx.
Pvsx. collected $2.50 from pot
Pvsx.: doesn't show hand 
*** SUMMARY ***
Total pot $2.50 | Rake $0 
Seat 1: diva3150 (small blind) folded before Flop
Seat 2: matiko09 (big blind) folded before Flop
Seat 3: Pvsx. collected ($2.50)
Seat 4: SkUhNi folded before Flop (didn't bet)
Seat 5: Dickyxxx folded before Flop (didn't bet)
Seat 6: arctur17 folded before Flop (didn't bet)
Seat 8: ruslik_by (button) folded before Flop (didn't bet)





PokerStars Hand #154970994355:  Hold'em No Limit (£0.25/£0.50 GBP) - 2016/06/20 13:04:35 CET [2016/06/20 7:04:35 ET]
Table 'Ani' 6-max Seat #6 is the button
Seat 1: asmodej666 (£50 in chips) 
Seat 2: mitsuVK (£54.85 in chips) 
Seat 3: Doobes8555 (£66.77 in chips) 
Seat 4: matiko09 (£66.42 in chips) 
Seat 5: Wwwasian (£60.25 in chips) 
Seat 6: faceMyBallz_ (£55.41 in chips) 
asmodej666: posts small blind £0.25
mitsuVK: posts big blind £0.50
*** HOLE CARDS ***
Dealt to matiko09 [9d Qc]
Doobes8555: calls £0.50
matiko09: folds 
Wwwasian: folds 
faceMyBallz_: raises £2 to £2.50
asmodej666: folds 
mitsuVK: folds 
Doobes8555: calls £2
*** FLOP *** [7c 3d 9s]
Doobes8555: checks 
faceMyBallz_: bets £2.73
Doobes8555: calls £2.73
*** TURN *** [7c 3d 9s] [6s]
Doobes8555: checks 
faceMyBallz_: checks 
*** RIVER *** [7c 3d 9s 6s] [6d]
Doobes8555: bets £10.50
faceMyBallz_: folds 
Uncalled bet (£10.50) returned to Doobes8555
Doobes8555 collected £10.65 from pot
Doobes8555: doesn't show hand 
*** SUMMARY ***
Total pot £11.21 | Rake £0.56 
Board [7c 3d 9s 6s 6d]
Seat 1: asmodej666 (small blind) folded before Flop
Seat 2: mitsuVK (big blind) folded before Flop
Seat 3: Doobes8555 collected (£10.65)
Seat 4: matiko09 folded before Flop (didn't bet)
Seat 5: Wwwasian folded before Flop (didn't bet)
Seat 6: faceMyBallz_ (button) folded on the River





PokerStars Hand #154970996739:  Hold'em No Limit ($0.50/$1.00 USD) - 2016/06/20 13:04:41 CET [2016/06/20 7:04:41 ET]
Table 'Normannia' 9-max Seat #3 is the button
Seat 2: Pvsx. ($187.84 in chips) 
Seat 3: Avtovo ($100 in chips) 
Seat 4: SexyAngeline ($95.31 in chips) 
Seat 5: Dickyxxx ($100 in chips) 
Seat 6: typename27 ($75.09 in chips) 
Seat 7: matiko09 ($106.79 in chips) 
Seat 8: SkUhNi ($132.30 in chips) 
Seat 9: ruslik_by ($148.91 in chips) 
SexyAngeline: posts small blind $0.50
Dickyxxx: posts big blind $1
*** HOLE CARDS ***
Dealt to matiko09 [Qd 7d]
typename27: raises $3 to $4
matiko09: folds 
SkUhNi: folds 
ruslik_by: folds 
Pvsx.: folds 
Avtovo: folds 
SexyAngeline: folds 
Dickyxxx: folds 
Uncalled bet ($3) returned to typename27
typename27 collected $2.50 from pot
typename27: doesn't show hand 
*** SUMMARY ***
Total pot $2.50 | Rake $0 
Seat 2: Pvsx. folded before Flop (didn't bet)
Seat 3: Avtovo (button) folded before Flop (didn't bet)
Seat 4: SexyAngeline (small blind) folded before Flop
Seat 5: Dickyxxx (big blind) folded before Flop
Seat 6: typename27 collected ($2.50)
Seat 7: matiko09 folded before Flop (didn't bet)
Seat 8: SkUhNi folded before Flop (didn't bet)
Seat 9: ruslik_by folded before Flop (didn't bet)





PokerStars Hand #154970998143:  Hold'em No Limit ($0.50/$1.00 USD) - 2016/06/20 13:04:45 CET [2016/06/20 7:04:45 ET]
Table 'Garumna II' 9-max Seat #4 is the button
Seat 1: ki11u ($143.50 in chips) 
Seat 2: Racushniak ($100 in chips) 
Seat 3: mooose100 ($97.65 in chips) 
Seat 4: Ndundun Gipe ($51.84 in chips) 
Seat 5: rura53 ($79.62 in chips) 
Seat 6: SexyAngeline ($41.03 in chips) 
Seat 7: Avtovo ($103.88 in chips) 
Seat 8: matiko09 ($108.02 in chips) 
Seat 9: SkUhNi ($100 in chips) 
rura53: posts small blind $0.50
SexyAngeline: posts big blind $1
*** HOLE CARDS ***
Dealt to matiko09 [Qh 4c]
Avtovo: folds 
matiko09: folds 
SkUhNi: folds 
ki11u: folds 
Racushniak: folds 
mooose100: folds 
Ndundun Gipe: calls $1
rura53: folds 
SexyAngeline: checks 
*** FLOP *** [2c Qd 3h]
SexyAngeline: checks 
Ndundun Gipe: checks 
*** TURN *** [2c Qd 3h] [4h]
SexyAngeline: bets $2
Ndundun Gipe: folds 
Uncalled bet ($2) returned to SexyAngeline
SexyAngeline collected $2.38 from pot
SexyAngeline: doesn't show hand 
*** SUMMARY ***
Total pot $2.50 | Rake $0.12 
Board [2c Qd 3h 4h]
Seat 1: ki11u folded before Flop (didn't bet)
Seat 2: Racushniak folded before Flop (didn't bet)
Seat 3: mooose100 folded before Flop (didn't bet)
Seat 4: Ndundun Gipe (button) folded on the Turn
Seat 5: rura53 (small blind) folded before Flop
Seat 6: SexyAngeline (big blind) collected ($2.38)
Seat 7: Avtovo folded before Flop (didn't bet)
Seat 8: matiko09 folded before Flop (didn't bet)
Seat 9: SkUhNi folded before Flop (didn't bet)





PokerStars Hand #154971005645:  Hold'em No Limit ($0.50/$1.00 USD) - 2016/06/20 13:05:04 CET [2016/06/20 7:05:04 ET]
Table 'Normannia' 9-max Seat #4 is the button
Seat 2: Pvsx. ($187.84 in chips) 
Seat 3: Avtovo ($100 in chips) 
Seat 4: SexyAngeline ($94.81 in chips) 
Seat 5: Dickyxxx ($100 in chips) 
Seat 6: typename27 ($76.59 in chips) 
Seat 7: matiko09 ($106.79 in chips) 
Seat 8: SkUhNi ($132.30 in chips) 
Seat 9: ruslik_by ($148.91 in chips) 
Dickyxxx: posts small blind $0.50
typename27: posts big blind $1
*** HOLE CARDS ***
Dealt to matiko09 [2d Ac]
matiko09: folds 
SkUhNi: folds 
ruslik_by: folds 
Pvsx.: folds 
Avtovo: raises $1.50 to $2.50
SexyAngeline: folds 
Dickyxxx: calls $2
typename27: raises $4.50 to $7
Avtovo: folds 
Dickyxxx: calls $4.50
*** FLOP *** [2c 8d 5h]
Dickyxxx: checks 
typename27: bets $8
Dickyxxx: folds 
Uncalled bet ($8) returned to typename27
typename27 collected $15.68 from pot
typename27: doesn't show hand 
*** SUMMARY ***
Total pot $16.50 | Rake $0.82 
Board [2c 8d 5h]
Seat 2: Pvsx. folded before Flop (didn't bet)
Seat 3: Avtovo folded before Flop
Seat 4: SexyAngeline (button) folded before Flop (didn't bet)
Seat 5: Dickyxxx (small blind) folded on the Flop
Seat 6: typename27 (big blind) collected ($15.68)
Seat 7: matiko09 folded before Flop (didn't bet)
Seat 8: SkUhNi folded before Flop (didn't bet)
Seat 9: ruslik_by folded before Flop (didn't bet)





PokerStars Hand #154971006623:  Hold'em No Limit ($0.25/$0.50 USD) - 2016/06/20 13:05:06 CET [2016/06/20 7:05:06 ET]
Table 'Scheddi II' 9-max Seat #9 is the button
Seat 1: matiko09 ($93.90 in chips) 
Seat 2: Yaaaazz ($59.26 in chips) 
Seat 3: mi$$I$Elena ($82.16 in chips) 
Seat 4: GOOFA13 ($72 in chips) 
Seat 5: zarplatka ($40 in chips) 
Seat 6: orochimaturi ($41.10 in chips) 
Seat 7: HopeMayBee ($109.81 in chips) 
Seat 8: Danil27 ($50 in chips) 
Seat 9: Infinitinium ($134.06 in chips) 
matiko09: posts small blind $0.25
Yaaaazz: posts big blind $0.50
matiko09: posts the ante $0.10
Yaaaazz: posts the ante $0.10
mi$$I$Elena: posts the ante $0.10
GOOFA13: posts the ante $0.10
zarplatka: posts the ante $0.10
orochimaturi: posts the ante $0.10
HopeMayBee: posts the ante $0.10
Danil27: posts the ante $0.10
Infinitinium: posts the ante $0.10
*** HOLE CARDS ***
Dealt to matiko09 [Ks 9d]
mi$$I$Elena: folds 
GOOFA13: raises $1.50 to $2
zarplatka: folds 
orochimaturi: folds 
HopeMayBee: folds 
Danil27: folds 
Infinitinium: folds 
matiko09: folds 
Yaaaazz: calls $1.50
*** FLOP *** [3h 5h 4d]
Yaaaazz: checks 
GOOFA13: bets $3
Yaaaazz: folds 
Uncalled bet ($3) returned to GOOFA13
GOOFA13 collected $4.89 from pot
GOOFA13: doesn't show hand 
*** SUMMARY ***
Total pot $5.15 | Rake $0.26 
Board [3h 5h 4d]
Seat 1: matiko09 (small blind) folded before Flop
Seat 2: Yaaaazz (big blind) folded on the Flop
Seat 3: mi$$I$Elena folded before Flop (didn't bet)
Seat 4: GOOFA13 collected ($4.89)
Seat 5: zarplatka folded before Flop (didn't bet)
Seat 6: orochimaturi folded before Flop (didn't bet)
Seat 7: HopeMayBee folded before Flop (didn't bet)
Seat 8: Danil27 folded before Flop (didn't bet)
Seat 9: Infinitinium (button) folded before Flop (didn't bet)





PokerStars Hand #154971011402:  Hold'em No Limit (£0.25/£0.50 GBP) - 2016/06/20 13:05:18 CET [2016/06/20 7:05:18 ET]
Table 'Tesla' 6-max Seat #3 is the button
Seat 1: Rubleff85 (£36.29 in chips) 
Seat 2: matiko09 (£64.81 in chips) 
Seat 3: asmodej666 (£50 in chips) 
Seat 4: VahTang_89 (£82.16 in chips) 
Seat 5: Nego Razu (£50.75 in chips) 
Seat 6: faceMyBallz_ (£55.76 in chips) 
VahTang_89: posts small blind £0.25
Nego Razu: posts big blind £0.50
*** HOLE CARDS ***
Dealt to matiko09 [Th Td]
faceMyBallz_: folds 
Rubleff85: folds 
matiko09: raises £1 to £1.50
asmodej666: folds 
VahTang_89: folds 
Nego Razu: folds 
Uncalled bet (£1) returned to matiko09
matiko09 collected £1.25 from pot
matiko09: doesn't show hand 
*** SUMMARY ***
Total pot £1.25 | Rake £0 
Seat 1: Rubleff85 folded before Flop (didn't bet)
Seat 2: matiko09 collected (£1.25)
Seat 3: asmodej666 (button) folded before Flop (didn't bet)
Seat 4: VahTang_89 (small blind) folded before Flop
Seat 5: Nego Razu (big blind) folded before Flop
Seat 6: faceMyBallz_ folded before Flop (didn't bet)





PokerStars Hand #154971011924:  Hold'em No Limit ($0.50/$1.00 USD) - 2016/06/20 13:05:20 CET [2016/06/20 7:05:20 ET]
Table 'Ernestina' 9-max Seat #1 is the button
Seat 1: diva3150 ($121.01 in chips) 
Seat 2: matiko09 ($199.30 in chips) 
Seat 4: SkUhNi ($100 in chips) 
Seat 5: Dickyxxx ($101.50 in chips) 
Seat 6: arctur17 ($76.29 in chips) 
Seat 8: ruslik_by ($239.53 in chips) 
matiko09: posts small blind $0.50
Pvsx.: is sitting out 
SkUhNi: posts big blind $1
Filojoes: sits out 
*** HOLE CARDS ***
Dealt to matiko09 [5d Kc]
Dickyxxx: folds 
Pvsx. leaves the table
arctur17: folds 
Avtovo joins the table at seat #3 
ruslik_by: folds 
diva3150: folds 
matiko09: folds 
Uncalled bet ($0.50) returned to SkUhNi
SkUhNi collected $1 from pot
SkUhNi: doesn't show hand 
*** SUMMARY ***
Total pot $1 | Rake $0 
Seat 1: diva3150 (button) folded before Flop (didn't bet)
Seat 2: matiko09 (small blind) folded before Flop
Seat 4: SkUhNi (big blind) collected ($1)
Seat 5: Dickyxxx folded before Flop (didn't bet)
Seat 6: arctur17 folded before Flop (didn't bet)
Seat 8: ruslik_by folded before Flop (didn't bet)





PokerStars Hand #154971014105:  Hold'em No Limit (£0.25/£0.50 GBP) - 2016/06/20 13:05:25 CET [2016/06/20 7:05:25 ET]
Table 'Azalea' 6-max Seat #3 is the button
Seat 1: mitsuVK (£63.46 in chips) 
Seat 2: matiko09 (£72.69 in chips) 
Seat 3: tyoma_knp (£50 in chips) 
Seat 4: faceMyBallz_ (£100.47 in chips) 
Seat 5: mudders693 (£51.81 in chips) 
Seat 6: Bënedic10 (£70.08 in chips) 
faceMyBallz_: posts small blind £0.25
mudders693: posts big blind £0.50
*** HOLE CARDS ***
Dealt to matiko09 [Qs 2h]
Bënedic10: folds 
mitsuVK: folds 
matiko09: folds 
tyoma_knp: raises £0.62 to £1.12
faceMyBallz_: folds 
mudders693: calls £0.62
*** FLOP *** [Kh 8c Th]
mudders693: checks 
tyoma_knp: checks 
*** TURN *** [Kh 8c Th] [Ks]
mudders693: checks 
tyoma_knp: checks 
*** RIVER *** [Kh 8c Th Ks] [As]
mudders693: bets £2.50
tyoma_knp: folds 
Uncalled bet (£2.50) returned to mudders693
mudders693 collected £2.37 from pot
mudders693: doesn't show hand 
*** SUMMARY ***
Total pot £2.49 | Rake £0.12 
Board [Kh 8c Th Ks As]
Seat 1: mitsuVK folded before Flop (didn't bet)
Seat 2: matiko09 folded before Flop (didn't bet)
Seat 3: tyoma_knp (button) folded on the River
Seat 4: faceMyBallz_ (small blind) folded before Flop
Seat 5: mudders693 (big blind) collected (£2.37)
Seat 6: Bënedic10 folded before Flop (didn't bet)





PokerStars Hand #154971018529:  Hold'em No Limit ($0.50/$1.00 USD) - 2016/06/20 13:05:36 CET [2016/06/20 7:05:36 ET]
Table 'Ernestina' 9-max Seat #2 is the button
Seat 1: diva3150 ($121.01 in chips) 
Seat 2: matiko09 ($198.80 in chips) 
Seat 4: SkUhNi ($100.50 in chips) 
Seat 5: Dickyxxx ($101.50 in chips) 
Seat 6: arctur17 ($76.29 in chips) 
Seat 8: ruslik_by ($239.53 in chips) 
Avtovo will be allowed to play after the button
SkUhNi: posts small blind $0.50
Dickyxxx: posts big blind $1
Filojoes: sits out 
*** HOLE CARDS ***
Dealt to matiko09 [6h Kd]
arctur17: folds 
Avtovo leaves the table
ruslik_by: folds 
diva3150: folds 
matiko09: folds 
SexyAngeline joins the table at seat #3 
SkUhNi: folds 
Uncalled bet ($0.50) returned to Dickyxxx
Dickyxxx collected $1 from pot
Dickyxxx: doesn't show hand 
*** SUMMARY ***
Total pot $1 | Rake $0 
Seat 1: diva3150 folded before Flop (didn't bet)
Seat 2: matiko09 (button) folded before Flop (didn't bet)
Seat 4: SkUhNi (small blind) folded before Flop
Seat 5: Dickyxxx (big blind) collected ($1)
Seat 6: arctur17 folded before Flop (didn't bet)
Seat 8: ruslik_by folded before Flop (didn't bet)





PokerStars Hand #154971018999:  Hold'em No Limit (€0.25/€0.50 EUR) - 2016/06/20 13:05:37 CET [2016/06/20 7:05:37 ET]
Table 'Bechuana' 6-max Seat #5 is the button
Seat 1: zitagirl (€31.42 in chips) 
Seat 2: matiko09 (€61.92 in chips) 
Seat 3: Aju!ntje (€85.29 in chips) 
Seat 4: Wwwasian (€50 in chips) 
Seat 5: fanmtZ (€45.74 in chips) 
Seat 6: SlayersGBG (€50 in chips) 
SlayersGBG: posts small blind €0.25
zitagirl: posts big blind €0.50
*** HOLE CARDS ***
Dealt to matiko09 [5d 4h]
matiko09: folds 
Aju!ntje: folds 
Wwwasian: raises €0.90 to €1.40
fanmtZ: folds 
SlayersGBG: calls €1.15
zitagirl has timed out
zitagirl: folds 
*** FLOP *** [6d 9c Td]
SlayersGBG: checks 
Wwwasian: bets €1.50
SlayersGBG: calls €1.50
*** TURN *** [6d 9c Td] [3h]
SlayersGBG: checks 
Wwwasian: checks 
*** RIVER *** [6d 9c Td 3h] [2s]
SlayersGBG: bets €5
Wwwasian: folds 
Uncalled bet (€5) returned to SlayersGBG
SlayersGBG collected €5.98 from pot
*** SUMMARY ***
Total pot €6.30 | Rake €0.32 
Board [6d 9c Td 3h 2s]
Seat 1: zitagirl (big blind) folded before Flop
Seat 2: matiko09 folded before Flop (didn't bet)
Seat 3: Aju!ntje folded before Flop (didn't bet)
Seat 4: Wwwasian folded on the River
Seat 5: fanmtZ (button) folded before Flop (didn't bet)
Seat 6: SlayersGBG (small blind) collected (€5.98)





PokerStars Hand #154971020492:  Hold'em No Limit ($0.50/$1.00 USD) - 2016/06/20 13:05:39 CET [2016/06/20 7:05:39 ET]
Table 'Pongola' 9-max Seat #1 is the button
Seat 1: matiko09 ($118.12 in chips) 
Seat 2: ruslik_by ($121.34 in chips) 
Seat 3: SkUhNi ($108.72 in chips) 
Seat 4: SexyAngeline ($75.14 in chips) 
Seat 5: Coolller ($100 in chips) 
Seat 7: Dickyxxx ($154.65 in chips) 
Seat 8: phrantique ($121.12 in chips) 
Seat 9: Filojoes ($155.92 in chips) 
ruslik_by: posts small blind $0.50
SkUhNi: posts big blind $1
Racushniak: sits out 
*** HOLE CARDS ***
Dealt to matiko09 [6s Ks]
SexyAngeline: folds 
Coolller: folds 
Dickyxxx: folds 
phrantique: folds 
Filojoes: folds 
matiko09: raises $1.27 to $2.27
ruslik_by: folds 
SkUhNi: folds 
Uncalled bet ($1.27) returned to matiko09
matiko09 collected $2.50 from pot
matiko09: doesn't show hand 
*** SUMMARY ***
Total pot $2.50 | Rake $0 
Seat 1: matiko09 (button) collected ($2.50)
Seat 2: ruslik_by (small blind) folded before Flop
Seat 3: SkUhNi (big blind) folded before Flop
Seat 4: SexyAngeline folded before Flop (didn't bet)
Seat 5: Coolller folded before Flop (didn't bet)
Seat 7: Dickyxxx folded before Flop (didn't bet)
Seat 8: phrantique folded before Flop (didn't bet)
Seat 9: Filojoes folded before Flop (didn't bet)





PokerStars Hand #154971021280:  Hold'em No Limit ($0.50/$1.00 USD) - 2016/06/20 13:05:41 CET [2016/06/20 7:05:41 ET]
Table 'Annika' 9-max Seat #6 is the button
Seat 1: hammerwife ($112.27 in chips) 
Seat 2: matiko09 ($103.80 in chips) 
Seat 3: first_dnk ($87.78 in chips) 
Seat 4: Kukuryzka ($104.12 in chips) 
Seat 5: SkUhNi ($103.32 in chips) 
Seat 6: Pvsx. ($112.43 in chips) 
Seat 7: jirka117 ($48.17 in chips) 
Seat 8: ruslik_by ($100 in chips) 
Seat 9: 23SmOkEr07 ($170.97 in chips) 
jirka117: posts small blind $0.50
ruslik_by: posts big blind $1
*** HOLE CARDS ***
Dealt to matiko09 [Jc 6c]
23SmOkEr07: folds 
hammerwife: folds 
matiko09: folds 
first_dnk: folds 
Kukuryzka: folds 
SkUhNi: raises $1.50 to $2.50
Pvsx.: raises $6.50 to $9
jirka117: folds 
ruslik_by: folds 
SkUhNi: calls $6.50
*** FLOP *** [3s 3d 4d]
SkUhNi: checks 
Pvsx.: bets $10
SkUhNi: calls $10
*** TURN *** [3s 3d 4d] [Td]
SkUhNi: checks 
23SmOkEr07 leaves the table
Pvsx.: checks 
*** RIVER *** [3s 3d 4d Td] [Qc]
Avtovo joins the table at seat #9 
SkUhNi: checks 
Pvsx.: bets $20
SkUhNi: folds 
Uncalled bet ($20) returned to Pvsx.
Pvsx. collected $37.52 from pot
Pvsx.: doesn't show hand 
*** SUMMARY ***
Total pot $39.50 | Rake $1.98 
Board [3s 3d 4d Td Qc]
Seat 1: hammerwife folded before Flop (didn't bet)
Seat 2: matiko09 folded before Flop (didn't bet)
Seat 3: first_dnk folded before Flop (didn't bet)
Seat 4: Kukuryzka folded before Flop (didn't bet)
Seat 5: SkUhNi folded on the River
Seat 6: Pvsx. (button) collected ($37.52)
Seat 7: jirka117 (small blind) folded before Flop
Seat 8: ruslik_by (big blind) folded before Flop
Seat 9: 23SmOkEr07 folded before Flop (didn't bet)





PokerStars Hand #154971025264:  Hold'em No Limit (£0.25/£0.50 GBP) - 2016/06/20 13:05:51 CET [2016/06/20 7:05:51 ET]
Table 'Ani' 6-max Seat #1 is the button
Seat 1: asmodej666 (£50 in chips) 
Seat 2: mitsuVK (£54.35 in chips) 
Seat 3: Doobes8555 (£72.19 in chips) 
Seat 4: matiko09 (£66.42 in chips) 
Seat 5: Wwwasian (£60.25 in chips) 
Seat 6: faceMyBallz_ (£50.18 in chips) 
mitsuVK: posts small blind £0.25
Doobes8555: posts big blind £0.50
*** HOLE CARDS ***
Dealt to matiko09 [Kc 9c]
matiko09: folds 
Wwwasian: folds 
faceMyBallz_: folds 
asmodej666: raises £0.50 to £1
mitsuVK: raises £2.50 to £3.50
Doobes8555: folds 
asmodej666: folds 
Uncalled bet (£2.50) returned to mitsuVK
mitsuVK collected £2.50 from pot
mitsuVK: doesn't show hand 
*** SUMMARY ***
Total pot £2.50 | Rake £0 
Seat 1: asmodej666 (button) folded before Flop
Seat 2: mitsuVK (small blind) collected (£2.50)
Seat 3: Doobes8555 (big blind) folded before Flop
Seat 4: matiko09 folded before Flop (didn't bet)
Seat 5: Wwwasian folded before Flop (didn't bet)
Seat 6: faceMyBallz_ folded before Flop (didn't bet)





PokerStars Hand #154971025265:  Hold'em No Limit ($0.50/$1.00 USD) - 2016/06/20 13:05:51 CET [2016/06/20 7:05:51 ET]
Table 'Ernestina' 9-max Seat #4 is the button
Seat 1: diva3150 ($121.01 in chips) 
Seat 2: matiko09 ($198.80 in chips) 
Seat 4: SkUhNi ($100 in chips) 
Seat 5: Dickyxxx ($102 in chips) 
Seat 6: arctur17 ($76.29 in chips) 
Seat 8: ruslik_by ($239.53 in chips) 
Dickyxxx: posts small blind $0.50
arctur17: posts big blind $1
Filojoes: sits out 
SexyAngeline: sits out 
*** HOLE CARDS ***
Dealt to matiko09 [6h Kh]
ruslik_by: folds 
diva3150: folds 
matiko09: raises $1.50 to $2.50
SkUhNi: calls $2.50
Dickyxxx: folds 
arctur17: folds 
*** FLOP *** [9h 2d 2c]
matiko09: bets $4
SkUhNi: calls $4
*** TURN *** [9h 2d 2c] [7c]
matiko09: checks 
SkUhNi: bets $4
matiko09: folds 
Uncalled bet ($4) returned to SkUhNi
SkUhNi collected $13.78 from pot
SkUhNi: doesn't show hand 
*** SUMMARY ***
Total pot $14.50 | Rake $0.72 
Board [9h 2d 2c 7c]
Seat 1: diva3150 folded before Flop (didn't bet)
Seat 2: matiko09 folded on the Turn
Seat 4: SkUhNi (button) collected ($13.78)
Seat 5: Dickyxxx (small blind) folded before Flop
Seat 6: arctur17 (big blind) folded before Flop
Seat 8: ruslik_by folded before Flop (didn't bet)





PokerStars Hand #154971026433:  Hold'em No Limit (£0.25/£0.50 GBP) - 2016/06/20 13:05:54 CET [2016/06/20 7:05:54 ET]
Table 'Tesla' 6-max Seat #4 is the button
Seat 1: Rubleff85 (£36.29 in chips) 
Seat 2: matiko09 (£65.56 in chips) 
Seat 3: asmodej666 (£50 in chips) 
Seat 4: VahTang_89 (£81.91 in chips) 
Seat 5: Nego Razu (£50.25 in chips) 
Seat 6: faceMyBallz_ (£55.76 in chips) 
Nego Razu: posts small blind £0.25
faceMyBallz_: posts big blind £0.50
*** HOLE CARDS ***
Dealt to matiko09 [5c 7c]
Rubleff85: calls £0.50
matiko09: folds 
asmodej666: folds 
VahTang_89: folds 
Nego Razu: calls £0.25
faceMyBallz_: checks 
*** FLOP *** [Tc 4h As]
Nego Razu: checks 
faceMyBallz_: checks 
Rubleff85: checks 
*** TURN *** [Tc 4h As] [7h]
Nego Razu: bets £0.69
faceMyBallz_: folds 
Rubleff85: calls £0.69
*** RIVER *** [Tc 4h As 7h] [9c]
Nego Razu: checks 
Rubleff85: bets £2.50
Nego Razu: calls £2.50
*** SHOW DOWN ***
Rubleff85: shows [8s Jh] (a straight, Seven to Jack)
Nego Razu: mucks hand 
Rubleff85 collected £7.49 from pot
*** SUMMARY ***
Total pot £7.88 | Rake £0.39 
Board [Tc 4h As 7h 9c]
Seat 1: Rubleff85 showed [8s Jh] and won (£7.49) with a straight, Seven to Jack
Seat 2: matiko09 folded before Flop (didn't bet)
Seat 3: asmodej666 folded before Flop (didn't bet)
Seat 4: VahTang_89 (button) folded before Flop (didn't bet)
Seat 5: Nego Razu (small blind) mucked [Js Ts]
Seat 6: faceMyBallz_ (big blind) folded on the Turn





PokerStars Hand #154971028365:  Hold'em No Limit ($0.50/$1.00 USD) - 2016/06/20 13:05:59 CET [2016/06/20 7:05:59 ET]
Table 'Normannia' 9-max Seat #5 is the button
Seat 2: Pvsx. ($187.84 in chips) 
Seat 3: Avtovo ($100 in chips) 
Seat 4: SexyAngeline ($94.81 in chips) 
Seat 5: Dickyxxx ($100 in chips) 
Seat 6: typename27 ($85.27 in chips) 
Seat 7: matiko09 ($106.79 in chips) 
Seat 8: SkUhNi ($132.30 in chips) 
Seat 9: ruslik_by ($148.91 in chips) 
typename27: posts small blind $0.50
matiko09: posts big blind $1
*** HOLE CARDS ***
Dealt to matiko09 [5d 9d]
SkUhNi: folds 
ruslik_by: folds 
Pvsx.: folds 
Avtovo: folds 
SexyAngeline: folds 
Dickyxxx: folds 
typename27: calls $0.50
matiko09: checks 
*** FLOP *** [Qc 9c 4c]
typename27: bets $4
matiko09: folds 
Uncalled bet ($4) returned to typename27
typename27 collected $1.90 from pot
typename27: doesn't show hand 
*** SUMMARY ***
Total pot $2 | Rake $0.10 
Board [Qc 9c 4c]
Seat 2: Pvsx. folded before Flop (didn't bet)
Seat 3: Avtovo folded before Flop (didn't bet)
Seat 4: SexyAngeline folded before Flop (didn't bet)
Seat 5: Dickyxxx (button) folded before Flop (didn't bet)
Seat 6: typename27 (small blind) collected ($1.90)
Seat 7: matiko09 (big blind) folded on the Flop
Seat 8: SkUhNi folded before Flop (didn't bet)
Seat 9: ruslik_by folded before Flop (didn't bet)





PokerStars Hand #154971030792:  Hold'em No Limit ($0.50/$1.00 USD) - 2016/06/20 13:06:04 CET [2016/06/20 7:06:04 ET]
Table 'Isonoe II' 9-max Seat #7 is the button
Seat 1: hammerwife ($161.50 in chips) 
Seat 2: matiko09 ($126.32 in chips) 
Seat 3: Kukuryzka ($100 in chips) 
Seat 4: Avtovo ($102 in chips) 
Seat 5: Filojoes ($114.13 in chips) 
Seat 6: GOOFA13 ($49.46 in chips) 
Seat 7: SkUhNi ($121.20 in chips) 
Seat 8: lewyson ($17.15 in chips) 
Seat 9: djammusic ($59.74 in chips) 
lewyson: posts small blind $0.50
djammusic: posts big blind $1
*** HOLE CARDS ***
Dealt to matiko09 [3s Jh]
hammerwife: folds 
matiko09: folds 
Kukuryzka: folds 
Avtovo: folds 
Filojoes: folds 
GOOFA13: folds 
SkUhNi: raises $1 to $2
lewyson: folds 
djammusic: calls $1
*** FLOP *** [4c 9h 4d]
djammusic: checks 
SkUhNi: checks 
*** TURN *** [4c 9h 4d] [Ad]
djammusic: checks 
SkUhNi: checks 
*** RIVER *** [4c 9h 4d Ad] [5c]
djammusic: checks 
SkUhNi: checks 
*** SHOW DOWN ***
djammusic: shows [6h 8h] (a pair of Fours)
SkUhNi: shows [Jd Qc] (a pair of Fours - Ace+Queen kicker)
SkUhNi collected $4.28 from pot
*** SUMMARY ***
Total pot $4.50 | Rake $0.22 
Board [4c 9h 4d Ad 5c]
Seat 1: hammerwife folded before Flop (didn't bet)
Seat 2: matiko09 folded before Flop (didn't bet)
Seat 3: Kukuryzka folded before Flop (didn't bet)
Seat 4: Avtovo folded before Flop (didn't bet)
Seat 5: Filojoes folded before Flop (didn't bet)
Seat 6: GOOFA13 folded before Flop (didn't bet)
Seat 7: SkUhNi (button) showed [Jd Qc] and won ($4.28) with a pair of Fours
Seat 8: lewyson (small blind) folded before Flop
Seat 9: djammusic (big blind) showed [6h 8h] and lost with a pair of Fours





PokerStars Hand #154971035266:  Hold'em No Limit ($0.50/$1.00 USD) - 2016/06/20 13:06:16 CET [2016/06/20 7:06:16 ET]
Table 'Garumna II' 9-max Seat #5 is the button
Seat 1: ki11u ($143.50 in chips) 
Seat 2: Racushniak ($100 in chips) 
Seat 3: mooose100 ($97.65 in chips) 
Seat 4: Ndundun Gipe ($50.84 in chips) 
Seat 5: rura53 ($79.12 in chips) 
Seat 6: SexyAngeline ($42.41 in chips) 
Seat 7: Avtovo ($103.88 in chips) 
Seat 8: matiko09 ($108.02 in chips) 
Seat 9: SkUhNi ($100 in chips) 
SexyAngeline: posts small blind $0.50
Avtovo: posts big blind $1
*** HOLE CARDS ***
Dealt to matiko09 [3c 9c]
matiko09: folds 
SkUhNi: folds 
ki11u: folds 
Racushniak: folds 
mooose100: folds 
Ndundun Gipe: calls $1
rura53: folds 
SexyAngeline: folds 
Avtovo: checks 
*** FLOP *** [5h 3s 2d]
Avtovo: checks 
Ndundun Gipe: bets $1
Avtovo: folds 
Uncalled bet ($1) returned to Ndundun Gipe
Ndundun Gipe collected $2.38 from pot
Ndundun Gipe: doesn't show hand 
*** SUMMARY ***
Total pot $2.50 | Rake $0.12 
Board [5h 3s 2d]
Seat 1: ki11u folded before Flop (didn't bet)
Seat 2: Racushniak folded before Flop (didn't bet)
Seat 3: mooose100 folded before Flop (didn't bet)
Seat 4: Ndundun Gipe collected ($2.38)
Seat 5: rura53 (button) folded before Flop (didn't bet)
Seat 6: SexyAngeline (small blind) folded before Flop
Seat 7: Avtovo (big blind) folded on the Flop
Seat 8: matiko09 folded before Flop (didn't bet)
Seat 9: SkUhNi folded before Flop (didn't bet)





PokerStars Hand #154971036617:  Hold'em No Limit ($0.25/$0.50 USD) - 2016/06/20 13:06:19 CET [2016/06/20 7:06:19 ET]
Table 'Scheddi II' 9-max Seat #1 is the button
Seat 1: matiko09 ($93.55 in chips) 
Seat 2: Yaaaazz ($57.16 in chips) 
Seat 3: mi$$I$Elena ($82.06 in chips) 
Seat 4: GOOFA13 ($74.79 in chips) 
Seat 5: zarplatka ($40 in chips) 
Seat 6: orochimaturi ($41 in chips) 
Seat 7: HopeMayBee ($109.71 in chips) 
Seat 8: Danil27 ($50 in chips) 
Seat 9: Infinitinium ($133.96 in chips) 
Yaaaazz: posts small blind $0.25
mi$$I$Elena: posts big blind $0.50
matiko09: posts the ante $0.10
Yaaaazz: posts the ante $0.10
mi$$I$Elena: posts the ante $0.10
GOOFA13: posts the ante $0.10
zarplatka: posts the ante $0.10
orochimaturi: posts the ante $0.10
HopeMayBee: posts the ante $0.10
Danil27: posts the ante $0.10
Infinitinium: posts the ante $0.10
*** HOLE CARDS ***
Dealt to matiko09 [Jd 3d]
GOOFA13: raises $1 to $1.50
zarplatka: folds 
orochimaturi: folds 
HopeMayBee: folds 
Danil27: folds 
Infinitinium: calls $1.50
matiko09: folds 
Yaaaazz: folds 
mi$$I$Elena: folds 
*** FLOP *** [Qs 7d 9h]
GOOFA13: bets $1.50
Infinitinium: raises $1.50 to $3
GOOFA13: calls $1.50
*** TURN *** [Qs 7d 9h] [9c]
GOOFA13: checks 
Infinitinium: bets $10.12
GOOFA13: folds 
Uncalled bet ($10.12) returned to Infinitinium
Infinitinium collected $10.12 from pot
Infinitinium: doesn't show hand 
*** SUMMARY ***
Total pot $10.65 | Rake $0.53 
Board [Qs 7d 9h 9c]
Seat 1: matiko09 (button) folded before Flop (didn't bet)
Seat 2: Yaaaazz (small blind) folded before Flop
Seat 3: mi$$I$Elena (big blind) folded before Flop
Seat 4: GOOFA13 folded on the Turn
Seat 5: zarplatka folded before Flop (didn't bet)
Seat 6: orochimaturi folded before Flop (didn't bet)
Seat 7: HopeMayBee folded before Flop (didn't bet)
Seat 8: Danil27 folded before Flop (didn't bet)
Seat 9: Infinitinium collected ($10.12)





PokerStars Hand #154971039093:  Hold'em No Limit (£0.25/£0.50 GBP) - 2016/06/20 13:06:25 CET [2016/06/20 7:06:25 ET]
Table 'Azalea' 6-max Seat #4 is the button
Seat 1: mitsuVK (£63.46 in chips) 
Seat 2: matiko09 (£72.69 in chips) 
Seat 3: tyoma_knp (£50 in chips) 
Seat 4: faceMyBallz_ (£100.22 in chips) 
Seat 5: mudders693 (£53.06 in chips) 
Seat 6: Bënedic10 (£70.08 in chips) 
mudders693: posts small blind £0.25
Bënedic10: posts big blind £0.50
*** HOLE CARDS ***
Dealt to matiko09 [5d Kh]
mitsuVK: folds 
matiko09: folds 
tyoma_knp: folds 
faceMyBallz_: folds 
mudders693: raises £1 to £1.50
Bënedic10: folds 
Uncalled bet (£1) returned to mudders693
mudders693 collected £1 from pot
mudders693: doesn't show hand 
*** SUMMARY ***
Total pot £1 | Rake £0 
Seat 1: mitsuVK folded before Flop (didn't bet)
Seat 2: matiko09 folded before Flop (didn't bet)
Seat 3: tyoma_knp folded before Flop (didn't bet)
Seat 4: faceMyBallz_ (button) folded before Flop (didn't bet)
Seat 5: mudders693 (small blind) collected (£1)
Seat 6: Bënedic10 (big blind) folded before Flop





PokerStars Hand #154971039808:  Hold'em No Limit ($0.50/$1.00 USD) - 2016/06/20 13:06:27 CET [2016/06/20 7:06:27 ET]
Table 'Pongola' 9-max Seat #2 is the button
Seat 1: matiko09 ($119.62 in chips) 
Seat 2: ruslik_by ($120.84 in chips) 
Seat 3: SkUhNi ($107.72 in chips) 
Seat 4: SexyAngeline ($75.14 in chips) 
Seat 5: Coolller ($100 in chips) 
Seat 7: Dickyxxx ($154.65 in chips) 
Seat 8: phrantique ($121.12 in chips) 
Seat 9: Filojoes ($155.92 in chips) 
SkUhNi: posts small blind $0.50
SexyAngeline: posts big blind $1
Racushniak: sits out 
*** HOLE CARDS ***
Dealt to matiko09 [Td Jd]
Coolller has timed out
Coolller: folds 
Dickyxxx: folds 
phrantique: folds 
Filojoes: folds 
matiko09: raises $1.50 to $2.50
ruslik_by: folds 
SkUhNi: folds 
SexyAngeline: folds 
Uncalled bet ($1.50) returned to matiko09
matiko09 collected $2.50 from pot
matiko09: doesn't show hand 
*** SUMMARY ***
Total pot $2.50 | Rake $0 
Seat 1: matiko09 collected ($2.50)
Seat 2: ruslik_by (button) folded before Flop (didn't bet)
Seat 3: SkUhNi (small blind) folded before Flop
Seat 4: SexyAngeline (big blind) folded before Flop
Seat 5: Coolller folded before Flop (didn't bet)
Seat 7: Dickyxxx folded before Flop (didn't bet)
Seat 8: phrantique folded before Flop (didn't bet)
Seat 9: Filojoes folded before Flop (didn't bet)





PokerStars Hand #154971046847:  Hold'em No Limit ($0.50/$1.00 USD) - 2016/06/20 13:06:44 CET [2016/06/20 7:06:44 ET]
Table 'Normannia' 9-max Seat #6 is the button
Seat 2: Pvsx. ($187.84 in chips) 
Seat 3: Avtovo ($100 in chips) 
Seat 4: SexyAngeline ($94.81 in chips) 
Seat 5: Dickyxxx ($100 in chips) 
Seat 6: typename27 ($86.17 in chips) 
Seat 7: matiko09 ($105.79 in chips) 
Seat 8: SkUhNi ($132.30 in chips) 
Seat 9: ruslik_by ($148.91 in chips) 
matiko09: posts small blind $0.50
SkUhNi: posts big blind $1
*** HOLE CARDS ***
Dealt to matiko09 [Qh 9h]
ruslik_by: folds 
Pvsx.: folds 
Avtovo: folds 
SexyAngeline: folds 
Dickyxxx: folds 
typename27: folds 
matiko09: raises $2 to $3
SkUhNi: calls $2
*** FLOP *** [Qc 2s 4h]
matiko09: bets $2.96
SkUhNi: calls $2.96
*** TURN *** [Qc 2s 4h] [8d]
matiko09: checks 
SkUhNi: checks 
*** RIVER *** [Qc 2s 4h 8d] [Jc]
matiko09: bets $5.88
SkUhNi: folds 
Uncalled bet ($5.88) returned to matiko09
matiko09 collected $11.32 from pot
matiko09: doesn't show hand 
*** SUMMARY ***
Total pot $11.92 | Rake $0.60 
Board [Qc 2s 4h 8d Jc]
Seat 2: Pvsx. folded before Flop (didn't bet)
Seat 3: Avtovo folded before Flop (didn't bet)
Seat 4: SexyAngeline folded before Flop (didn't bet)
Seat 5: Dickyxxx folded before Flop (didn't bet)
Seat 6: typename27 (button) folded before Flop (didn't bet)
Seat 7: matiko09 (small blind) collected ($11.32)
Seat 8: SkUhNi (big blind) folded on the River
Seat 9: ruslik_by folded before Flop (didn't bet)





PokerStars Hand #154971047635:  Hold'em No Limit (£0.25/£0.50 GBP) - 2016/06/20 13:06:47 CET [2016/06/20 7:06:47 ET]
Table 'Ani' 6-max Seat #2 is the button
Seat 1: asmodej666 (£50 in chips) 
Seat 2: mitsuVK (£55.85 in chips) 
Seat 3: Doobes8555 (£71.69 in chips) 
Seat 4: matiko09 (£66.42 in chips) 
Seat 5: Wwwasian (£60.25 in chips) 
Seat 6: faceMyBallz_ (£50.18 in chips) 
Doobes8555: posts small blind £0.25
matiko09: posts big blind £0.50
*** HOLE CARDS ***
Dealt to matiko09 [As Jh]
Wwwasian: raises £0.50 to £1
faceMyBallz_: folds 
asmodej666: folds 
mitsuVK: folds 
Doobes8555: folds 
matiko09: calls £0.50
*** FLOP *** [Ks 3h 8s]
matiko09: checks 
Wwwasian: bets £1
matiko09: calls £1
*** TURN *** [Ks 3h 8s] [Jd]
matiko09: checks 
Wwwasian: bets £4
matiko09: folds 
Uncalled bet (£4) returned to Wwwasian
Wwwasian collected £4.04 from pot
Wwwasian: doesn't show hand 
*** SUMMARY ***
Total pot £4.25 | Rake £0.21 
Board [Ks 3h 8s Jd]
Seat 1: asmodej666 folded before Flop (didn't bet)
Seat 2: mitsuVK (button) folded before Flop (didn't bet)
Seat 3: Doobes8555 (small blind) folded before Flop
Seat 4: matiko09 (big blind) folded on the Turn
Seat 5: Wwwasian collected (£4.04)
Seat 6: faceMyBallz_ folded before Flop (didn't bet)





PokerStars Hand #154971048148:  Hold'em No Limit (£0.25/£0.50 GBP) - 2016/06/20 13:06:48 CET [2016/06/20 7:06:48 ET]
Table 'Azalea' 6-max Seat #5 is the button
Seat 1: mitsuVK (£63.46 in chips) 
Seat 2: matiko09 (£72.69 in chips) 
Seat 3: tyoma_knp (£50 in chips) 
Seat 4: faceMyBallz_ (£100.22 in chips) 
Seat 5: mudders693 (£53.56 in chips) 
Seat 6: Bënedic10 (£69.58 in chips) 
Bënedic10: posts small blind £0.25
mitsuVK: posts big blind £0.50
*** HOLE CARDS ***
Dealt to matiko09 [7s 5h]
matiko09: folds 
tyoma_knp: folds 
faceMyBallz_: folds 
mudders693: raises £1 to £1.50
Bënedic10: calls £1.25
mitsuVK: folds 
*** FLOP *** [Ks 7c 4s]
Bënedic10: checks 
mudders693: checks 
*** TURN *** [Ks 7c 4s] [Ah]
Bënedic10: checks 
mudders693: bets £3
Bënedic10: folds 
Uncalled bet (£3) returned to mudders693
mudders693 collected £3.32 from pot
mudders693: doesn't show hand 
*** SUMMARY ***
Total pot £3.50 | Rake £0.18 
Board [Ks 7c 4s Ah]
Seat 1: mitsuVK (big blind) folded before Flop
Seat 2: matiko09 folded before Flop (didn't bet)
Seat 3: tyoma_knp folded before Flop (didn't bet)
Seat 4: faceMyBallz_ folded before Flop (didn't bet)
Seat 5: mudders693 (button) collected (£3.32)
Seat 6: Bënedic10 (small blind) folded on the Turn





PokerStars Hand #154971052535:  Hold'em No Limit ($0.50/$1.00 USD) - 2016/06/20 13:06:59 CET [2016/06/20 7:06:59 ET]
Table 'Ernestina' 9-max Seat #5 is the button
Seat 1: diva3150 ($121.01 in chips) 
Seat 2: matiko09 ($192.30 in chips) 
Seat 4: SkUhNi ($107.28 in chips) 
Seat 5: Dickyxxx ($101.50 in chips) 
Seat 6: arctur17 ($75.29 in chips) 
Seat 8: ruslik_by ($239.53 in chips) 
arctur17: posts small blind $0.50
djammusic was removed from the table for failing to post
ruslik_by: posts big blind $1
Filojoes: sits out 
SexyAngeline: sits out 
*** HOLE CARDS ***
Dealt to matiko09 [Js 3c]
ki11u joins the table at seat #7 
diva3150: calls $1
matiko09: folds 
SkUhNi: folds 
Dickyxxx: folds 
arctur17: folds 
ruslik_by: checks 
*** FLOP *** [Qh Kc 2c]
ruslik_by: checks 
diva3150: bets $1
ruslik_by: folds 
Uncalled bet ($1) returned to diva3150
diva3150 collected $2.38 from pot
diva3150: doesn't show hand 
*** SUMMARY ***
Total pot $2.50 | Rake $0.12 
Board [Qh Kc 2c]
Seat 1: diva3150 collected ($2.38)
Seat 2: matiko09 folded before Flop (didn't bet)
Seat 4: SkUhNi folded before Flop (didn't bet)
Seat 5: Dickyxxx (button) folded before Flop (didn't bet)
Seat 6: arctur17 (small blind) folded before Flop
Seat 8: ruslik_by (big blind) folded on the Flop





PokerStars Hand #154971053758:  Hold'em No Limit ($0.50/$1.00 USD) - 2016/06/20 13:07:02 CET [2016/06/20 7:07:02 ET]
Table 'Garumna II' 9-max Seat #6 is the button
Seat 1: ki11u ($143.50 in chips) 
Seat 2: Racushniak ($100 in chips) 
Seat 3: mooose100 ($97.65 in chips) 
Seat 4: Ndundun Gipe ($52.22 in chips) 
Seat 5: rura53 ($79.12 in chips) 
Seat 6: SexyAngeline ($41.91 in chips) 
Seat 7: Avtovo ($102.88 in chips) 
Seat 8: matiko09 ($108.02 in chips) 
Seat 9: SkUhNi ($100 in chips) 
Avtovo: posts small blind $0.50
matiko09: posts big blind $1
*** HOLE CARDS ***
Dealt to matiko09 [Ah 7s]
SkUhNi: raises $2 to $3
ki11u: folds 
Racushniak: folds 
mooose100: folds 
Ndundun Gipe: folds 
rura53: folds 
SexyAngeline: folds 
Avtovo: folds 
matiko09: folds 
Uncalled bet ($2) returned to SkUhNi
SkUhNi collected $2.50 from pot
SkUhNi: doesn't show hand 
*** SUMMARY ***
Total pot $2.50 | Rake $0 
Seat 1: ki11u folded before Flop (didn't bet)
Seat 2: Racushniak folded before Flop (didn't bet)
Seat 3: mooose100 folded before Flop (didn't bet)
Seat 4: Ndundun Gipe folded before Flop (didn't bet)
Seat 5: rura53 folded before Flop (didn't bet)
Seat 6: SexyAngeline (button) folded before Flop (didn't bet)
Seat 7: Avtovo (small blind) folded before Flop
Seat 8: matiko09 (big blind) folded before Flop
Seat 9: SkUhNi collected ($2.50)





PokerStars Hand #154971061305:  Hold'em No Limit ($0.50/$1.00 USD) - 2016/06/20 13:07:21 CET [2016/06/20 7:07:21 ET]
Table 'Pongola' 9-max Seat #3 is the button
Seat 1: matiko09 ($121.12 in chips) 
Seat 2: ruslik_by ($120.84 in chips) 
Seat 3: SkUhNi ($107.22 in chips) 
Seat 4: SexyAngeline ($74.14 in chips) 
Seat 5: Coolller ($100 in chips) 
Seat 7: Dickyxxx ($154.65 in chips) 
Seat 8: phrantique ($121.12 in chips) 
Seat 9: Filojoes ($155.92 in chips) 
SexyAngeline: posts small blind $0.50
Coolller: posts big blind $1
Racushniak: sits out 
*** HOLE CARDS ***
Dealt to matiko09 [2s Kc]
Dickyxxx: folds 
phrantique: folds 
Filojoes: folds 
matiko09: folds 
ruslik_by: raises $1.50 to $2.50
SkUhNi: raises $6.50 to $9
SexyAngeline: folds 
Coolller: folds 
ruslik_by: calls $6.50
*** FLOP *** [7c 6s Td]
ruslik_by: checks 
SkUhNi: bets $10.18
ruslik_by: calls $10.18
*** TURN *** [7c 6s Td] [9d]
ruslik_by: checks 
SkUhNi: bets $24
ruslik_by: folds 
Uncalled bet ($24) returned to SkUhNi
SkUhNi collected $37.87 from pot
SkUhNi: doesn't show hand 
*** SUMMARY ***
Total pot $39.86 | Rake $1.99 
Board [7c 6s Td 9d]
Seat 1: matiko09 folded before Flop (didn't bet)
Seat 2: ruslik_by folded on the Turn
Seat 3: SkUhNi (button) collected ($37.87)
Seat 4: SexyAngeline (small blind) folded before Flop
Seat 5: Coolller (big blind) folded before Flop
Seat 7: Dickyxxx folded before Flop (didn't bet)
Seat 8: phrantique folded before Flop (didn't bet)
Seat 9: Filojoes folded before Flop (didn't bet)





PokerStars Hand #154971061878:  Hold'em No Limit ($0.25/$0.50 USD) - 2016/06/20 13:07:22 CET [2016/06/20 7:07:22 ET]
Table 'Scheddi II' 9-max Seat #2 is the button
Seat 1: matiko09 ($93.45 in chips) 
Seat 2: Yaaaazz ($56.81 in chips) 
Seat 3: mi$$I$Elena ($81.46 in chips) 
Seat 4: GOOFA13 ($70.19 in chips) 
Seat 5: zarplatka ($40 in chips) 
Seat 6: orochimaturi ($40.90 in chips) 
Seat 7: HopeMayBee ($109.61 in chips) 
Seat 8: Danil27 ($50 in chips) 
Seat 9: Infinitinium ($139.48 in chips) 
mi$$I$Elena: posts small blind $0.25
GOOFA13: posts big blind $0.50
matiko09: posts the ante $0.10
Yaaaazz: posts the ante $0.10
mi$$I$Elena: posts the ante $0.10
GOOFA13: posts the ante $0.10
zarplatka: posts the ante $0.10
orochimaturi: posts the ante $0.10
HopeMayBee: posts the ante $0.10
Danil27: posts the ante $0.10
Infinitinium: posts the ante $0.10
*** HOLE CARDS ***
Dealt to matiko09 [Jd 8d]
zarplatka: folds 
orochimaturi: folds 
HopeMayBee: raises $0.75 to $1.25
Danil27: folds 
Infinitinium: calls $1.25
matiko09: folds 
Yaaaazz: folds 
mi$$I$Elena: folds 
GOOFA13: calls $0.75
*** FLOP *** [As 3c 2c]
GOOFA13: checks 
HopeMayBee: bets $3
Infinitinium: calls $3
GOOFA13: calls $3
*** TURN *** [As 3c 2c] [5h]
GOOFA13: checks 
HopeMayBee: checks 
Infinitinium: checks 
*** RIVER *** [As 3c 2c 5h] [Ah]
GOOFA13: checks 
HopeMayBee: bets $9
Infinitinium: folds 
GOOFA13: folds 
Uncalled bet ($9) returned to HopeMayBee
HopeMayBee collected $13.20 from pot
HopeMayBee: doesn't show hand 
*** SUMMARY ***
Total pot $13.90 | Rake $0.70 
Board [As 3c 2c 5h Ah]
Seat 1: matiko09 folded before Flop (didn't bet)
Seat 2: Yaaaazz (button) folded before Flop (didn't bet)
Seat 3: mi$$I$Elena (small blind) folded before Flop
Seat 4: GOOFA13 (big blind) folded on the River
Seat 5: zarplatka folded before Flop (didn't bet)
Seat 6: orochimaturi folded before Flop (didn't bet)
Seat 7: HopeMayBee collected ($13.20)
Seat 8: Danil27 folded before Flop (didn't bet)
Seat 9: Infinitinium folded on the River





PokerStars Hand #154971062623:  Hold'em No Limit ($0.50/$1.00 USD) - 2016/06/20 13:07:24 CET [2016/06/20 7:07:24 ET]
Table 'Annika' 9-max Seat #7 is the button
Seat 1: hammerwife ($112.27 in chips) 
Seat 2: matiko09 ($103.80 in chips) 
Seat 3: first_dnk ($87.78 in chips) 
Seat 4: Kukuryzka ($104.12 in chips) 
Seat 5: SkUhNi ($100 in chips) 
Seat 6: Pvsx. ($130.95 in chips) 
Seat 7: jirka117 ($47.67 in chips) 
Seat 8: ruslik_by ($100 in chips) 
Seat 9: Avtovo ($100 in chips) 
ruslik_by: posts small blind $0.50
Avtovo: posts big blind $1
*** HOLE CARDS ***
Dealt to matiko09 [8d Tc]
hammerwife: folds 
matiko09: folds 
first_dnk: folds 
Kukuryzka: folds 
SkUhNi: folds 
Pvsx.: folds 
jirka117: calls $1
ruslik_by: folds 
Avtovo: checks 
*** FLOP *** [3s 5d Qh]
Kukuryzka leaves the table
Filojoes joins the table at seat #4 
Avtovo: checks 
jirka117: bets $2.38
Avtovo: folds 
Uncalled bet ($2.38) returned to jirka117
jirka117 collected $2.38 from pot
*** SUMMARY ***
Total pot $2.50 | Rake $0.12 
Board [3s 5d Qh]
Seat 1: hammerwife folded before Flop (didn't bet)
Seat 2: matiko09 folded before Flop (didn't bet)
Seat 3: first_dnk folded before Flop (didn't bet)
Seat 4: Kukuryzka folded before Flop (didn't bet)
Seat 5: SkUhNi folded before Flop (didn't bet)
Seat 6: Pvsx. folded before Flop (didn't bet)
Seat 7: jirka117 (button) collected ($2.38)
Seat 8: ruslik_by (small blind) folded before Flop
Seat 9: Avtovo (big blind) folded on the Flop





PokerStars Hand #154971065299:  Hold'em No Limit ($0.50/$1.00 USD) - 2016/06/20 13:07:31 CET [2016/06/20 7:07:31 ET]
Table 'Isonoe II' 9-max Seat #8 is the button
Seat 2: matiko09 ($126.32 in chips) 
Seat 3: Kukuryzka ($100 in chips) 
Seat 4: Avtovo ($102 in chips) 
Seat 5: Filojoes ($114.13 in chips) 
Seat 6: GOOFA13 ($49.46 in chips) 
Seat 7: SkUhNi ($123.48 in chips) 
Seat 8: lewyson ($16.65 in chips) 
Seat 9: djammusic ($57.74 in chips) 
djammusic: posts small blind $0.50
matiko09: posts big blind $1
*** HOLE CARDS ***
Dealt to matiko09 [9s Jd]
Kukuryzka: folds 
Kukuryzka leaves the table
Avtovo: folds 
Filojoes: folds 
GOOFA13: folds 
SkUhNi: folds 
lewyson: folds 
djammusic: folds 
Uncalled bet ($0.50) returned to matiko09
matiko09 collected $1 from pot
matiko09: doesn't show hand 
*** SUMMARY ***
Total pot $1 | Rake $0 
Seat 2: matiko09 (big blind) collected ($1)
Seat 3: Kukuryzka folded before Flop (didn't bet)
Seat 4: Avtovo folded before Flop (didn't bet)
Seat 5: Filojoes folded before Flop (didn't bet)
Seat 6: GOOFA13 folded before Flop (didn't bet)
Seat 7: SkUhNi folded before Flop (didn't bet)
Seat 8: lewyson (button) folded before Flop (didn't bet)
Seat 9: djammusic (small blind) folded before Flop





PokerStars Hand #154971065730:  Hold'em No Limit (£0.25/£0.50 GBP) - 2016/06/20 13:07:32 CET [2016/06/20 7:07:32 ET]
Table 'Azalea' 6-max Seat #6 is the button
Seat 1: mitsuVK (£62.96 in chips) 
Seat 2: matiko09 (£72.69 in chips) 
Seat 3: tyoma_knp (£50 in chips) 
Seat 4: faceMyBallz_ (£100.22 in chips) 
Seat 5: mudders693 (£55.38 in chips) 
Seat 6: Bënedic10 (£68.08 in chips) 
mitsuVK: posts small blind £0.25
matiko09: posts big blind £0.50
*** HOLE CARDS ***
Dealt to matiko09 [5h 4s]
tyoma_knp: folds 
faceMyBallz_: folds 
mudders693: raises £1 to £1.50
Bënedic10: raises £4.50 to £6
mitsuVK: folds 
matiko09: folds 
mudders693: calls £4.50
*** FLOP *** [8s Jc 2c]
mudders693: bets £11
Bënedic10: raises £51.08 to £62.08 and is all-in
mudders693: folds 
Uncalled bet (£51.08) returned to Bënedic10
Bënedic10 collected £33.35 from pot
Bënedic10: doesn't show hand 
*** SUMMARY ***
Total pot £34.75 | Rake £1.40 
Board [8s Jc 2c]
Seat 1: mitsuVK (small blind) folded before Flop
Seat 2: matiko09 (big blind) folded before Flop
Seat 3: tyoma_knp folded before Flop (didn't bet)
Seat 4: faceMyBallz_ folded before Flop (didn't bet)
Seat 5: mudders693 folded on the Flop
Seat 6: Bënedic10 (button) collected (£33.35)





PokerStars Hand #154971068920:  Hold'em No Limit ($0.50/$1.00 USD) - 2016/06/20 13:07:39 CET [2016/06/20 7:07:39 ET]
Table 'Garumna II' 9-max Seat #7 is the button
Seat 1: ki11u ($143.50 in chips) 
Seat 2: Racushniak ($100 in chips) 
Seat 3: mooose100 ($97.65 in chips) 
Seat 4: Ndundun Gipe ($52.22 in chips) 
Seat 5: rura53 ($79.12 in chips) 
Seat 6: SexyAngeline ($41.91 in chips) 
Seat 7: Avtovo ($102.38 in chips) 
Seat 8: matiko09 ($107.02 in chips) 
Seat 9: SkUhNi ($101.50 in chips) 
matiko09: posts small blind $0.50
SkUhNi: posts big blind $1
*** HOLE CARDS ***
Dealt to matiko09 [6d Qc]
ki11u: folds 
Racushniak: folds 
mooose100: folds 
Ndundun Gipe: calls $1
rura53: folds 
SexyAngeline: folds 
Avtovo: raises $3.50 to $4.50
matiko09: folds 
SkUhNi: folds 
Ndundun Gipe: calls $3.50
*** FLOP *** [9h Jh 8h]
Ndundun Gipe: bets $1
Avtovo: calls $1
*** TURN *** [9h Jh 8h] [9d]
Ndundun Gipe: bets $1
Avtovo: raises $6.94 to $7.94
Ndundun Gipe: calls $6.94
*** RIVER *** [9h Jh 8h 9d] [7d]
Ndundun Gipe: checks 
Avtovo: checks 
*** SHOW DOWN ***
Ndundun Gipe: shows [Qs 3s] (a pair of Nines)
Avtovo: shows [9s Ad] (three of a kind, Nines)
Avtovo collected $26.96 from pot
*** SUMMARY ***
Total pot $28.38 | Rake $1.42 
Board [9h Jh 8h 9d 7d]
Seat 1: ki11u folded before Flop (didn't bet)
Seat 2: Racushniak folded before Flop (didn't bet)
Seat 3: mooose100 folded before Flop (didn't bet)
Seat 4: Ndundun Gipe showed [Qs 3s] and lost with a pair of Nines
Seat 5: rura53 folded before Flop (didn't bet)
Seat 6: SexyAngeline folded before Flop (didn't bet)
Seat 7: Avtovo (button) showed [9s Ad] and won ($26.96) with three of a kind, Nines
Seat 8: matiko09 (small blind) folded before Flop
Seat 9: SkUhNi (big blind) folded before Flop





PokerStars Hand #154971073444:  Hold'em No Limit ($0.50/$1.00 USD) - 2016/06/20 13:07:51 CET [2016/06/20 7:07:51 ET]
Table 'Ernestina' 9-max Seat #6 is the button
Seat 1: diva3150 ($122.39 in chips) 
Seat 2: matiko09 ($192.30 in chips) 
Seat 4: SkUhNi ($107.28 in chips) 
Seat 5: Dickyxxx ($101.50 in chips) 
Seat 6: arctur17 ($74.79 in chips) 
Seat 8: ruslik_by ($238.53 in chips) 
Seat 9: Filojoes ($122.53 in chips) 
ki11u will be allowed to play after the button
ruslik_by: posts small blind $0.50
Filojoes: posts big blind $1
SexyAngeline: sits out 
*** HOLE CARDS ***
Dealt to matiko09 [Qd Ks]
diva3150: folds 
matiko09: raises $2 to $3
SkUhNi: folds 
Dickyxxx: folds 
arctur17: calls $3
ruslik_by: folds 
Filojoes: folds 
*** FLOP *** [As Qc 6c]
matiko09: checks 
arctur17: bets $5
matiko09: calls $5
*** TURN *** [As Qc 6c] [8h]
matiko09: checks 
arctur17: checks 
*** RIVER *** [As Qc 6c 8h] [Ad]
matiko09: bets $4
arctur17: calls $4
*** SHOW DOWN ***
matiko09: shows [Qd Ks] (two pair, Aces and Queens)
arctur17: mucks hand 
matiko09 collected $24.22 from pot
*** SUMMARY ***
Total pot $25.50 | Rake $1.28 
Board [As Qc 6c 8h Ad]
Seat 1: diva3150 folded before Flop (didn't bet)
Seat 2: matiko09 showed [Qd Ks] and won ($24.22) with two pair, Aces and Queens
Seat 4: SkUhNi folded before Flop (didn't bet)
Seat 5: Dickyxxx folded before Flop (didn't bet)
Seat 6: arctur17 (button) mucked [Kd Td]
Seat 8: ruslik_by (small blind) folded before Flop
Seat 9: Filojoes (big blind) folded before Flop





PokerStars Hand #154971074621:  Hold'em No Limit (£0.25/£0.50 GBP) - 2016/06/20 13:07:54 CET [2016/06/20 7:07:54 ET]
Table 'Tesla' 6-max Seat #5 is the button
Seat 1: Rubleff85 (£40.09 in chips) 
Seat 2: matiko09 (£65.56 in chips) 
Seat 3: asmodej666 (£50 in chips) 
Seat 4: VahTang_89 (£81.91 in chips) 
Seat 5: Nego Razu (£50 in chips) 
Seat 6: faceMyBallz_ (£55.26 in chips) 
faceMyBallz_: posts small blind £0.25
Rubleff85: posts big blind £0.50
*** HOLE CARDS ***
Dealt to matiko09 [5d Th]
matiko09: folds 
asmodej666: folds 
VahTang_89: folds 
Nego Razu: raises £0.77 to £1.27
faceMyBallz_: folds 
Rubleff85: folds 
Uncalled bet (£0.77) returned to Nego Razu
Nego Razu collected £1.25 from pot
Nego Razu: doesn't show hand 
*** SUMMARY ***
Total pot £1.25 | Rake £0 
Seat 1: Rubleff85 (big blind) folded before Flop
Seat 2: matiko09 folded before Flop (didn't bet)
Seat 3: asmodej666 folded before Flop (didn't bet)
Seat 4: VahTang_89 folded before Flop (didn't bet)
Seat 5: Nego Razu (button) collected (£1.25)
Seat 6: faceMyBallz_ (small blind) folded before Flop





PokerStars Hand #154971077793:  Hold'em No Limit ($0.50/$1.00 USD) - 2016/06/20 13:08:02 CET [2016/06/20 7:08:02 ET]
Table 'Isonoe II' 9-max Seat #9 is the button
Seat 2: matiko09 ($126.82 in chips) 
Seat 5: Filojoes ($114.13 in chips) 
Seat 6: GOOFA13 ($49.46 in chips) 
Seat 7: SkUhNi ($123.48 in chips) 
Seat 8: lewyson ($16.65 in chips) 
Seat 9: djammusic ($57.24 in chips) 
matiko09: posts small blind $0.50
Avtovo: is sitting out 
Filojoes: posts big blind $1
*** HOLE CARDS ***
Dealt to matiko09 [8d Ah]
GOOFA13: folds 
SkUhNi: folds 
SexyAngeline joins the table at seat #3 
lewyson: raises $1 to $2
djammusic: folds 
matiko09: folds 
Filojoes: calls $1
*** FLOP *** [Tc 4d 2d]
Filojoes: checks 
lewyson: bets $4.28
Filojoes: raises $28.72 to $33
lewyson: calls $10.37 and is all-in
Uncalled bet ($18.35) returned to Filojoes
*** TURN *** [Tc 4d 2d] [Ts]
*** RIVER *** [Tc 4d 2d Ts] [4h]
*** SHOW DOWN ***
Filojoes: shows [2s Js] (two pair, Tens and Fours)
lewyson: shows [Qs Qh] (two pair, Queens and Tens)
lewyson collected $32.11 from pot
*** SUMMARY ***
Total pot $33.80 | Rake $1.69 
Board [Tc 4d 2d Ts 4h]
Seat 2: matiko09 (small blind) folded before Flop
Seat 5: Filojoes (big blind) showed [2s Js] and lost with two pair, Tens and Fours
Seat 6: GOOFA13 folded before Flop (didn't bet)
Seat 7: SkUhNi folded before Flop (didn't bet)
Seat 8: lewyson showed [Qs Qh] and won ($32.11) with two pair, Queens and Tens
Seat 9: djammusic (button) folded before Flop (didn't bet)





PokerStars Hand #154971083638:  Hold'em No Limit ($0.50/$1.00 USD) - 2016/06/20 13:08:16 CET [2016/06/20 7:08:16 ET]
Table 'Normannia' 9-max Seat #7 is the button
Seat 2: Pvsx. ($187.84 in chips) 
Seat 3: Avtovo ($100 in chips) 
Seat 4: SexyAngeline ($94.81 in chips) 
Seat 5: Dickyxxx ($100 in chips) 
Seat 6: typename27 ($86.17 in chips) 
Seat 7: matiko09 ($111.15 in chips) 
Seat 8: SkUhNi ($126.34 in chips) 
Seat 9: ruslik_by ($148.91 in chips) 
SkUhNi: posts small blind $0.50
ruslik_by: posts big blind $1
*** HOLE CARDS ***
Dealt to matiko09 [4h 5s]
Pvsx.: folds 
Avtovo: folds 
SexyAngeline: folds 
Dickyxxx: folds 
typename27: folds 
matiko09: folds 
SkUhNi: folds 
Uncalled bet ($0.50) returned to ruslik_by
ruslik_by collected $1 from pot
ruslik_by: doesn't show hand 
*** SUMMARY ***
Total pot $1 | Rake $0 
Seat 2: Pvsx. folded before Flop (didn't bet)
Seat 3: Avtovo folded before Flop (didn't bet)
Seat 4: SexyAngeline folded before Flop (didn't bet)
Seat 5: Dickyxxx folded before Flop (didn't bet)
Seat 6: typename27 folded before Flop (didn't bet)
Seat 7: matiko09 (button) folded before Flop (didn't bet)
Seat 8: SkUhNi (small blind) folded before Flop
Seat 9: ruslik_by (big blind) collected ($1)





PokerStars Hand #154971084786:  Hold'em No Limit (£0.25/£0.50 GBP) - 2016/06/20 13:08:19 CET [2016/06/20 7:08:19 ET]
Table 'Tesla' 6-max Seat #6 is the button
Seat 1: Rubleff85 (£39.59 in chips) 
Seat 2: matiko09 (£65.56 in chips) 
Seat 3: asmodej666 (£50 in chips) 
Seat 4: VahTang_89 (£81.91 in chips) 
Seat 5: Nego Razu (£50.75 in chips) 
Seat 6: faceMyBallz_ (£55.01 in chips) 
Rubleff85: posts small blind £0.25
matiko09: posts big blind £0.50
*** HOLE CARDS ***
Dealt to matiko09 [5d 4h]
asmodej666: raises £1 to £1.50
VahTang_89: folds 
Nego Razu: raises £3 to £4.50
faceMyBallz_: folds 
Rubleff85: folds 
matiko09: folds 
asmodej666: folds 
Uncalled bet (£3) returned to Nego Razu
Nego Razu collected £3.75 from pot
Nego Razu: doesn't show hand 
*** SUMMARY ***
Total pot £3.75 | Rake £0 
Seat 1: Rubleff85 (small blind) folded before Flop
Seat 2: matiko09 (big blind) folded before Flop
Seat 3: asmodej666 folded before Flop
Seat 4: VahTang_89 folded before Flop (didn't bet)
Seat 5: Nego Razu collected (£3.75)
Seat 6: faceMyBallz_ (button) folded before Flop (didn't bet)





PokerStars Hand #154971085724:  Hold'em No Limit (€0.25/€0.50 EUR) - 2016/06/20 13:08:21 CET [2016/06/20 7:08:21 ET]
Table 'Bechuana' 6-max Seat #6 is the button
Seat 1: zitagirl (€30.92 in chips) 
Seat 2: matiko09 (€61.92 in chips) 
Seat 3: Aju!ntje (€85.29 in chips) 
Seat 4: Wwwasian (€50 in chips) 
Seat 5: fanmtZ (€45.74 in chips) 
Seat 6: SlayersGBG (€53.08 in chips) 
zitagirl: posts small blind €0.25
matiko09: posts big blind €0.50
*** HOLE CARDS ***
Dealt to matiko09 [Tc Jd]
Aju!ntje: folds 
Wwwasian: folds 
fanmtZ: folds 
SlayersGBG: raises €0.75 to €1.25
zitagirl: folds 
matiko09: calls €0.75
*** FLOP *** [3s Ks 8c]
matiko09: checks 
SlayersGBG: bets €1.95
matiko09: folds 
Uncalled bet (€1.95) returned to SlayersGBG
SlayersGBG collected €2.61 from pot
*** SUMMARY ***
Total pot €2.75 | Rake €0.14 
Board [3s Ks 8c]
Seat 1: zitagirl (small blind) folded before Flop
Seat 2: matiko09 (big blind) folded on the Flop
Seat 3: Aju!ntje folded before Flop (didn't bet)
Seat 4: Wwwasian folded before Flop (didn't bet)
Seat 5: fanmtZ folded before Flop (didn't bet)
Seat 6: SlayersGBG (button) collected (€2.61)





PokerStars Hand #154971088911:  Hold'em No Limit (£0.25/£0.50 GBP) - 2016/06/20 13:08:29 CET [2016/06/20 7:08:29 ET]
Table 'Ani' 6-max Seat #3 is the button
Seat 1: asmodej666 (£50 in chips) 
Seat 2: mitsuVK (£55.85 in chips) 
Seat 3: Doobes8555 (£71.44 in chips) 
Seat 4: matiko09 (£64.42 in chips) 
Seat 5: Wwwasian (£62.29 in chips) 
Seat 6: faceMyBallz_ (£50.18 in chips) 
matiko09: posts small blind £0.25
Wwwasian: posts big blind £0.50
*** HOLE CARDS ***
Dealt to matiko09 [7d Qd]
faceMyBallz_: folds 
asmodej666: raises £1 to £1.50
mitsuVK: folds 
Doobes8555: folds 
matiko09: folds 
Wwwasian: folds 
Uncalled bet (£1) returned to asmodej666
asmodej666 collected £1.25 from pot
asmodej666: doesn't show hand 
*** SUMMARY ***
Total pot £1.25 | Rake £0 
Seat 1: asmodej666 collected (£1.25)
Seat 2: mitsuVK folded before Flop (didn't bet)
Seat 3: Doobes8555 (button) folded before Flop (didn't bet)
Seat 4: matiko09 (small blind) folded before Flop
Seat 5: Wwwasian (big blind) folded before Flop
Seat 6: faceMyBallz_ folded before Flop (didn't bet)





PokerStars Hand #154971090840:  Hold'em No Limit ($0.50/$1.00 USD) - 2016/06/20 13:08:34 CET [2016/06/20 7:08:34 ET]
Table 'Annika' 9-max Seat #8 is the button
Seat 2: matiko09 ($103.80 in chips) 
Seat 3: first_dnk ($87.78 in chips) 
Seat 5: SkUhNi ($100 in chips) 
Seat 6: Pvsx. ($130.95 in chips) 
Seat 7: jirka117 ($49.05 in chips) 
Seat 8: ruslik_by ($100 in chips) 
Seat 9: Avtovo ($100 in chips) 
Avtovo: posts small blind $0.50
hammerwife: is sitting out 
matiko09: posts big blind $1
Filojoes: sits out 
*** HOLE CARDS ***
Dealt to matiko09 [4d 6c]
first_dnk: folds 
SkUhNi: folds 
Pvsx.: folds 
jirka117: folds 
ruslik_by: raises $1 to $2
Avtovo: folds 
matiko09: folds 
Uncalled bet ($1) returned to ruslik_by
ruslik_by collected $2.50 from pot
ruslik_by: doesn't show hand 
*** SUMMARY ***
Total pot $2.50 | Rake $0 
Seat 2: matiko09 (big blind) folded before Flop
Seat 3: first_dnk folded before Flop (didn't bet)
Seat 5: SkUhNi folded before Flop (didn't bet)
Seat 6: Pvsx. folded before Flop (didn't bet)
Seat 7: jirka117 folded before Flop (didn't bet)
Seat 8: ruslik_by (button) collected ($2.50)
Seat 9: Avtovo (small blind) folded before Flop





PokerStars Hand #154971091550:  Hold'em No Limit ($0.50/$1.00 USD) - 2016/06/20 13:08:35 CET [2016/06/20 7:08:35 ET]
Table 'Normannia' 9-max Seat #8 is the button
Seat 3: Avtovo ($100 in chips) 
Seat 4: SexyAngeline ($94.81 in chips) 
Seat 5: Dickyxxx ($100 in chips) 
Seat 6: typename27 ($86.17 in chips) 
Seat 7: matiko09 ($111.15 in chips) 
Seat 8: SkUhNi ($125.84 in chips) 
Seat 9: ruslik_by ($149.41 in chips) 
ruslik_by: posts small blind $0.50
Pvsx.: is sitting out 
Avtovo: posts big blind $1
*** HOLE CARDS ***
Dealt to matiko09 [Jh Ts]
SexyAngeline: folds 
Pvsx. leaves the table
Dickyxxx: folds 
ki11u joins the table at seat #2 
typename27: raises $3 to $4
matiko09: folds 
SkUhNi: folds 
ruslik_by: folds 
Avtovo: folds 
Uncalled bet ($3) returned to typename27
typename27 collected $2.50 from pot
typename27: doesn't show hand 
*** SUMMARY ***
Total pot $2.50 | Rake $0 
Seat 3: Avtovo (big blind) folded before Flop
Seat 4: SexyAngeline folded before Flop (didn't bet)
Seat 5: Dickyxxx folded before Flop (didn't bet)
Seat 6: typename27 collected ($2.50)
Seat 7: matiko09 folded before Flop (didn't bet)
Seat 8: SkUhNi (button) folded before Flop (didn't bet)
Seat 9: ruslik_by (small blind) folded before Flop





PokerStars Hand #154971092417:  Hold'em No Limit (£0.25/£0.50 GBP) - 2016/06/20 13:08:38 CET [2016/06/20 7:08:38 ET]
Table 'Azalea' 6-max Seat #1 is the button
Seat 1: mitsuVK (£62.71 in chips) 
Seat 2: matiko09 (£72.19 in chips) 
Seat 4: faceMyBallz_ (£100.22 in chips) 
Seat 5: mudders693 (£38.38 in chips) 
Seat 6: Bënedic10 (£84.43 in chips) 
matiko09: posts small blind £0.25
tyoma_knp: is sitting out 
faceMyBallz_: posts big blind £0.50
*** HOLE CARDS ***
Dealt to matiko09 [6h 8c]
mudders693: folds 
Bënedic10: raises £0.75 to £1.25
mitsuVK: folds 
matiko09: folds 
faceMyBallz_: folds 
Uncalled bet (£0.75) returned to Bënedic10
Bënedic10 collected £1.25 from pot
Bënedic10: doesn't show hand 
*** SUMMARY ***
Total pot £1.25 | Rake £0 
Seat 1: mitsuVK (button) folded before Flop (didn't bet)
Seat 2: matiko09 (small blind) folded before Flop
Seat 4: faceMyBallz_ (big blind) folded before Flop
Seat 5: mudders693 folded before Flop (didn't bet)
Seat 6: Bënedic10 collected (£1.25)





PokerStars Hand #154971092414:  Hold'em No Limit ($0.25/$0.50 USD) - 2016/06/20 13:08:38 CET [2016/06/20 7:08:38 ET]
Table 'Scheddi II' 9-max Seat #3 is the button
Seat 1: matiko09 ($93.35 in chips) 
Seat 2: Yaaaazz ($56.71 in chips) 
Seat 3: mi$$I$Elena ($81.11 in chips) 
Seat 4: GOOFA13 ($65.84 in chips) 
Seat 5: zarplatka ($40 in chips) 
Seat 6: orochimaturi ($40.80 in chips) 
Seat 7: HopeMayBee ($118.46 in chips) 
Seat 8: Danil27 ($50 in chips) 
Seat 9: Infinitinium ($135.13 in chips) 
GOOFA13: posts small blind $0.25
zarplatka: posts big blind $0.50
matiko09: posts the ante $0.10
Yaaaazz: posts the ante $0.10
mi$$I$Elena: posts the ante $0.10
GOOFA13: posts the ante $0.10
zarplatka: posts the ante $0.10
orochimaturi: posts the ante $0.10
HopeMayBee: posts the ante $0.10
Danil27: posts the ante $0.10
Infinitinium: posts the ante $0.10
*** HOLE CARDS ***
Dealt to matiko09 [3h 6c]
orochimaturi: calls $0.50
HopeMayBee: raises $1.50 to $2
Danil27: folds 
Infinitinium: calls $2
matiko09: folds 
Yaaaazz: folds 
mi$$I$Elena: folds 
GOOFA13: folds 
zarplatka: folds 
orochimaturi: calls $1.50
*** FLOP *** [Qc Tc Kd]
orochimaturi: checks 
HopeMayBee: checks 
Infinitinium: checks 
*** TURN *** [Qc Tc Kd] [2h]
orochimaturi: checks 
HopeMayBee: checks 
Infinitinium: bets $3.63
orochimaturi: folds 
HopeMayBee: calls $3.63
*** RIVER *** [Qc Tc Kd 2h] [6s]
HopeMayBee: checks 
Infinitinium: checks 
*** SHOW DOWN ***
HopeMayBee: shows [Qs Ad] (a pair of Queens)
Infinitinium: shows [Ks 3s] (a pair of Kings)
Infinitinium collected $14.16 from pot
*** SUMMARY ***
Total pot $14.91 | Rake $0.75 
Board [Qc Tc Kd 2h 6s]
Seat 1: matiko09 folded before Flop (didn't bet)
Seat 2: Yaaaazz folded before Flop (didn't bet)
Seat 3: mi$$I$Elena (button) folded before Flop (didn't bet)
Seat 4: GOOFA13 (small blind) folded before Flop
Seat 5: zarplatka (big blind) folded before Flop
Seat 6: orochimaturi folded on the Turn
Seat 7: HopeMayBee showed [Qs Ad] and lost with a pair of Queens
Seat 8: Danil27 folded before Flop (didn't bet)
Seat 9: Infinitinium showed [Ks 3s] and won ($14.16) with a pair of Kings





PokerStars Hand #154971092640:  Hold'em No Limit (£0.25/£0.50 GBP) - 2016/06/20 13:08:38 CET [2016/06/20 7:08:38 ET]
Table 'Tesla' 6-max Seat #1 is the button
Seat 1: Rubleff85 (£39.34 in chips) 
Seat 2: matiko09 (£65.06 in chips) 
Seat 3: asmodej666 (£50 in chips) 
Seat 4: VahTang_89 (£81.91 in chips) 
Seat 5: Nego Razu (£53 in chips) 
Seat 6: faceMyBallz_ (£55.01 in chips) 
matiko09: posts small blind £0.25
asmodej666: posts big blind £0.50
*** HOLE CARDS ***
Dealt to matiko09 [Qc 2c]
VahTang_89: folds 
Nego Razu: folds 
faceMyBallz_: raises £0.75 to £1.25
Rubleff85: folds 
matiko09: folds 
asmodej666: folds 
Uncalled bet (£0.75) returned to faceMyBallz_
faceMyBallz_ collected £1.25 from pot
faceMyBallz_: doesn't show hand 
*** SUMMARY ***
Total pot £1.25 | Rake £0 
Seat 1: Rubleff85 (button) folded before Flop (didn't bet)
Seat 2: matiko09 (small blind) folded before Flop
Seat 3: asmodej666 (big blind) folded before Flop
Seat 4: VahTang_89 folded before Flop (didn't bet)
Seat 5: Nego Razu folded before Flop (didn't bet)
Seat 6: faceMyBallz_ collected (£1.25)





PokerStars Hand #154971097678:  Hold'em No Limit ($0.50/$1.00 USD) - 2016/06/20 13:08:51 CET [2016/06/20 7:08:51 ET]
Table 'Annika' 9-max Seat #9 is the button
Seat 2: matiko09 ($102.80 in chips) 
Seat 3: first_dnk ($87.78 in chips) 
Seat 5: SkUhNi ($100 in chips) 
Seat 6: Pvsx. ($130.95 in chips) 
Seat 7: jirka117 ($49.05 in chips) 
Seat 8: ruslik_by ($101.50 in chips) 
Seat 9: Avtovo ($100 in chips) 
matiko09: posts small blind $0.50
first_dnk: posts big blind $1
Filojoes: sits out 
*** HOLE CARDS ***
Dealt to matiko09 [Jd 3d]
SkUhNi: folds 
Pvsx.: folds 
jirka117 has timed out
jirka117: folds 
ruslik_by: raises $1.50 to $2.50
Avtovo: raises $6 to $8.50
matiko09: folds 
first_dnk: folds 
ruslik_by: folds 
Uncalled bet ($6) returned to Avtovo
Avtovo collected $6.50 from pot
Avtovo: doesn't show hand 
*** SUMMARY ***
Total pot $6.50 | Rake $0 
Seat 2: matiko09 (small blind) folded before Flop
Seat 3: first_dnk (big blind) folded before Flop
Seat 5: SkUhNi folded before Flop (didn't bet)
Seat 6: Pvsx. folded before Flop (didn't bet)
Seat 7: jirka117 folded before Flop (didn't bet)
Seat 8: ruslik_by folded before Flop
Seat 9: Avtovo (button) collected ($6.50)





PokerStars Hand #154971098961:  Hold'em No Limit (£0.25/£0.50 GBP) - 2016/06/20 13:08:54 CET [2016/06/20 7:08:54 ET]
Table 'Tesla' 6-max Seat #2 is the button
Seat 1: Rubleff85 (£39.34 in chips) 
Seat 2: matiko09 (£64.81 in chips) 
Seat 3: asmodej666 (£50 in chips) 
Seat 4: VahTang_89 (£81.91 in chips) 
Seat 5: Nego Razu (£53 in chips) 
Seat 6: faceMyBallz_ (£55.76 in chips) 
asmodej666: posts small blind £0.25
VahTang_89: posts big blind £0.50
*** HOLE CARDS ***
Dealt to matiko09 [9c Qh]
Nego Razu: folds 
faceMyBallz_: folds 
Rubleff85: folds 
matiko09: raises £0.63 to £1.13
asmodej666: folds 
VahTang_89: raises £3.37 to £4.50
matiko09: folds 
Uncalled bet (£3.37) returned to VahTang_89
VahTang_89 collected £2.51 from pot
VahTang_89: doesn't show hand 
*** SUMMARY ***
Total pot £2.51 | Rake £0 
Seat 1: Rubleff85 folded before Flop (didn't bet)
Seat 2: matiko09 (button) folded before Flop
Seat 3: asmodej666 (small blind) folded before Flop
Seat 4: VahTang_89 (big blind) collected (£2.51)
Seat 5: Nego Razu folded before Flop (didn't bet)
Seat 6: faceMyBallz_ folded before Flop (didn't bet)





PokerStars Hand #154971101127:  Hold'em No Limit (£0.25/£0.50 GBP) - 2016/06/20 13:08:59 CET [2016/06/20 7:08:59 ET]
Table 'Azalea' 6-max Seat #2 is the button
Seat 1: mitsuVK (£62.71 in chips) 
Seat 2: matiko09 (£71.94 in chips) 
Seat 4: faceMyBallz_ (£99.72 in chips) 
Seat 5: mudders693 (£38.38 in chips) 
Seat 6: Bënedic10 (£85.18 in chips) 
faceMyBallz_: posts small blind £0.25
mudders693: posts big blind £0.50
*** HOLE CARDS ***
Dealt to matiko09 [Kd 4h]
Bënedic10: raises £1 to £1.50
mitsuVK: folds 
matiko09: folds 
faceMyBallz_: folds 
mudders693: folds 
Uncalled bet (£1) returned to Bënedic10
Bënedic10 collected £1.25 from pot
Bënedic10: doesn't show hand 
*** SUMMARY ***
Total pot £1.25 | Rake £0 
Seat 1: mitsuVK folded before Flop (didn't bet)
Seat 2: matiko09 (button) folded before Flop (didn't bet)
Seat 4: faceMyBallz_ (small blind) folded before Flop
Seat 5: mudders693 (big blind) folded before Flop
Seat 6: Bënedic10 collected (£1.25)





PokerStars Hand #154971102672:  Hold'em No Limit ($0.50/$1.00 USD) - 2016/06/20 13:09:03 CET [2016/06/20 7:09:03 ET]
Table 'Garumna II' 9-max Seat #8 is the button
Seat 1: ki11u ($143.50 in chips) 
Seat 3: mooose100 ($97.65 in chips) 
Seat 4: Ndundun Gipe ($38.78 in chips) 
Seat 5: rura53 ($79.12 in chips) 
Seat 6: SexyAngeline ($41.91 in chips) 
Seat 7: Avtovo ($115.90 in chips) 
Seat 8: matiko09 ($106.52 in chips) 
Seat 9: SkUhNi ($100.50 in chips) 
SkUhNi: posts small blind $0.50
ki11u: posts big blind $1
*** HOLE CARDS ***
Dealt to matiko09 [Th 4s]
mooose100: folds 
Ndundun Gipe: calls $1
rura53: folds 
SexyAngeline: folds 
Avtovo: folds 
matiko09: folds 
SkUhNi: raises $3 to $4
ki11u: folds 
Ndundun Gipe: calls $3
*** FLOP *** [9h Ts Jd]
SkUhNi: checks 
Ndundun Gipe: checks 
*** TURN *** [9h Ts Jd] [5h]
SkUhNi: bets $6
Ndundun Gipe: calls $6
*** RIVER *** [9h Ts Jd 5h] [Ah]
SkUhNi: bets $30
Ndundun Gipe: calls $28.78 and is all-in
Uncalled bet ($1.22) returned to SkUhNi
*** SHOW DOWN ***
SkUhNi: shows [Qh Jh] (a flush, Ace high)
Ndundun Gipe: shows [Ad 7d] (a pair of Aces)
SkUhNi collected $76.06 from pot
*** SUMMARY ***
Total pot $78.56 | Rake $2.50 
Board [9h Ts Jd 5h Ah]
Seat 1: ki11u (big blind) folded before Flop
Seat 3: mooose100 folded before Flop (didn't bet)
Seat 4: Ndundun Gipe showed [Ad 7d] and lost with a pair of Aces
Seat 5: rura53 folded before Flop (didn't bet)
Seat 6: SexyAngeline folded before Flop (didn't bet)
Seat 7: Avtovo folded before Flop (didn't bet)
Seat 8: matiko09 (button) folded before Flop (didn't bet)
Seat 9: SkUhNi (small blind) showed [Qh Jh] and won ($76.06) with a flush, Ace high





PokerStars Hand #154971102483:  Hold'em No Limit ($0.50/$1.00 USD) - 2016/06/20 13:09:03 CET [2016/06/20 7:09:03 ET]
Table 'Pongola' 9-max Seat #4 is the button
Seat 1: matiko09 ($121.12 in chips) 
Seat 2: ruslik_by ($101.66 in chips) 
Seat 3: SkUhNi ($125.91 in chips) 
Seat 4: SexyAngeline ($73.64 in chips) 
Seat 5: Coolller ($99 in chips) 
Seat 7: Dickyxxx ($154.65 in chips) 
Seat 8: phrantique ($121.12 in chips) 
Seat 9: Filojoes ($155.92 in chips) 
Coolller: posts small blind $0.50
Dickyxxx: posts big blind $1
*** HOLE CARDS ***
Dealt to matiko09 [8c Qs]
phrantique: raises $2 to $3
Filojoes: folds 
matiko09: folds 
ruslik_by: folds 
SkUhNi: raises $7 to $10
SexyAngeline: folds 
Coolller: folds 
Dickyxxx: folds 
phrantique: calls $7
*** FLOP *** [6c 3h 4s]
phrantique: checks 
SkUhNi: bets $12
phrantique: folds 
Uncalled bet ($12) returned to SkUhNi
SkUhNi collected $20.42 from pot
SkUhNi: doesn't show hand 
*** SUMMARY ***
Total pot $21.50 | Rake $1.08 
Board [6c 3h 4s]
Seat 1: matiko09 folded before Flop (didn't bet)
Seat 2: ruslik_by folded before Flop (didn't bet)
Seat 3: SkUhNi collected ($20.42)
Seat 4: SexyAngeline (button) folded before Flop (didn't bet)
Seat 5: Coolller (small blind) folded before Flop
Seat 7: Dickyxxx (big blind) folded before Flop
Seat 8: phrantique folded on the Flop
Seat 9: Filojoes folded before Flop (didn't bet)





PokerStars Hand #154971103517:  Hold'em No Limit ($0.50/$1.00 USD) - 2016/06/20 13:09:05 CET [2016/06/20 7:09:05 ET]
Table 'Isonoe II' 9-max Seat #2 is the button
Seat 2: matiko09 ($126.32 in chips) 
Seat 5: Filojoes ($100 in chips) 
Seat 6: GOOFA13 ($49.46 in chips) 
Seat 7: SkUhNi ($123.48 in chips) 
Seat 8: lewyson ($32.11 in chips) 
Seat 9: djammusic ($57.24 in chips) 
SexyAngeline will be allowed to play after the button
Avtovo will be allowed to play after the button
Filojoes: posts small blind $0.50
GOOFA13: posts big blind $1
*** HOLE CARDS ***
Dealt to matiko09 [Kd Qc]
SkUhNi: folds 
lewyson: calls $1
djammusic: folds 
matiko09: raises $3 to $4
Filojoes: calls $3.50
GOOFA13: folds 
lewyson: calls $3
*** FLOP *** [9s Qh Td]
Filojoes: checks 
lewyson: checks 
matiko09: bets $8.02
Filojoes: folds 
lewyson: folds 
Uncalled bet ($8.02) returned to matiko09
matiko09 collected $12.35 from pot
matiko09: doesn't show hand 
*** SUMMARY ***
Total pot $13 | Rake $0.65 
Board [9s Qh Td]
Seat 2: matiko09 (button) collected ($12.35)
Seat 5: Filojoes (small blind) folded on the Flop
Seat 6: GOOFA13 (big blind) folded before Flop
Seat 7: SkUhNi folded before Flop (didn't bet)
Seat 8: lewyson folded on the Flop
Seat 9: djammusic folded before Flop (didn't bet)





PokerStars Hand #154971105397:  Hold'em No Limit (£0.25/£0.50 GBP) - 2016/06/20 13:09:10 CET [2016/06/20 7:09:10 ET]
Table 'Ani' 6-max Seat #4 is the button
Seat 1: asmodej666 (£50.75 in chips) 
Seat 2: mitsuVK (£55.85 in chips) 
Seat 3: Doobes8555 (£71.44 in chips) 
Seat 4: matiko09 (£64.17 in chips) 
Seat 5: Wwwasian (£61.79 in chips) 
Seat 6: faceMyBallz_ (£50.18 in chips) 
Wwwasian: posts small blind £0.25
faceMyBallz_: posts big blind £0.50
*** HOLE CARDS ***
Dealt to matiko09 [Kd 4s]
asmodej666: raises £1 to £1.50
mitsuVK: folds 
Doobes8555 is connected 
Doobes8555: calls £1.50
matiko09: folds 
Wwwasian: folds 
faceMyBallz_: folds 
*** FLOP *** [6h 2d 2c]
asmodej666: checks 
Doobes8555: checks 
*** TURN *** [6h 2d 2c] [9s]
asmodej666: checks 
Doobes8555: bets £3.50
asmodej666: folds 
Uncalled bet (£3.50) returned to Doobes8555
Doobes8555 collected £3.56 from pot
Doobes8555: doesn't show hand 
*** SUMMARY ***
Total pot £3.75 | Rake £0.19 
Board [6h 2d 2c 9s]
Seat 1: asmodej666 folded on the Turn
Seat 2: mitsuVK folded before Flop (didn't bet)
Seat 3: Doobes8555 collected (£3.56)
Seat 4: matiko09 (button) folded before Flop (didn't bet)
Seat 5: Wwwasian (small blind) folded before Flop
Seat 6: faceMyBallz_ (big blind) folded before Flop





PokerStars Hand #154971106138:  Hold'em No Limit (€0.25/€0.50 EUR) - 2016/06/20 13:09:12 CET [2016/06/20 7:09:12 ET]
Table 'Bechuana' 6-max Seat #1 is the button
Seat 1: zitagirl (€30.67 in chips) 
Seat 2: matiko09 (€60.67 in chips) 
Seat 3: Aju!ntje (€85.29 in chips) 
Seat 4: Wwwasian (€50 in chips) 
Seat 5: fanmtZ (€45.74 in chips) 
Seat 6: SlayersGBG (€54.44 in chips) 
matiko09: posts small blind €0.25
Aju!ntje: posts big blind €0.50
*** HOLE CARDS ***
Dealt to matiko09 [Qh 8s]
Wwwasian: folds 
fanmtZ: folds 
SlayersGBG: raises €0.75 to €1.25
zitagirl: calls €1.25
matiko09: folds 
Aju!ntje: folds 
*** FLOP *** [Jd 4h Ks]
SlayersGBG: bets €2.31
zitagirl: folds 
Uncalled bet (€2.31) returned to SlayersGBG
SlayersGBG collected €3.09 from pot
*** SUMMARY ***
Total pot €3.25 | Rake €0.16 
Board [Jd 4h Ks]
Seat 1: zitagirl (button) folded on the Flop
Seat 2: matiko09 (small blind) folded before Flop
Seat 3: Aju!ntje (big blind) folded before Flop
Seat 4: Wwwasian folded before Flop (didn't bet)
Seat 5: fanmtZ folded before Flop (didn't bet)
Seat 6: SlayersGBG collected (€3.09)





PokerStars Hand #154971106943:  Hold'em No Limit ($0.50/$1.00 USD) - 2016/06/20 13:09:14 CET [2016/06/20 7:09:14 ET]
Table 'Ernestina' 9-max Seat #8 is the button
Seat 1: diva3150 ($122.39 in chips) 
Seat 2: matiko09 ($204.52 in chips) 
Seat 4: SkUhNi ($107.28 in chips) 
Seat 5: Dickyxxx ($101.50 in chips) 
Seat 6: arctur17 ($62.79 in chips) 
Seat 8: ruslik_by ($238.03 in chips) 
Seat 9: Filojoes ($121.53 in chips) 
Filojoes: posts small blind $0.50
diva3150: posts big blind $1
SexyAngeline: sits out 
ki11u: sits out 
*** HOLE CARDS ***
Dealt to matiko09 [4s 8h]
matiko09: folds 
SkUhNi: folds 
Dickyxxx: folds 
arctur17: folds 
ruslik_by: folds 
Filojoes: folds 
Uncalled bet ($0.50) returned to diva3150
diva3150 collected $1 from pot
diva3150: doesn't show hand 
*** SUMMARY ***
Total pot $1 | Rake $0 
Seat 1: diva3150 (big blind) collected ($1)
Seat 2: matiko09 folded before Flop (didn't bet)
Seat 4: SkUhNi folded before Flop (didn't bet)
Seat 5: Dickyxxx folded before Flop (didn't bet)
Seat 6: arctur17 folded before Flop (didn't bet)
Seat 8: ruslik_by (button) folded before Flop (didn't bet)
Seat 9: Filojoes (small blind) folded before Flop





PokerStars Hand #154971108102:  Hold'em No Limit ($0.50/$1.00 USD) - 2016/06/20 13:09:16 CET [2016/06/20 7:09:16 ET]
Table 'Normannia' 9-max Seat #9 is the button
Seat 3: Avtovo ($100 in chips) 
Seat 4: SexyAngeline ($94.81 in chips) 
Seat 5: Dickyxxx ($100 in chips) 
Seat 6: typename27 ($87.67 in chips) 
Seat 7: matiko09 ($111.15 in chips) 
Seat 8: SkUhNi ($125.84 in chips) 
Seat 9: ruslik_by ($148.91 in chips) 
ki11u will be allowed to play after the button
Avtovo: posts small blind $0.50
SexyAngeline: posts big blind $1
*** HOLE CARDS ***
Dealt to matiko09 [2h Kc]
Dickyxxx: folds 
typename27: raises $3 to $4
matiko09: folds 
SkUhNi: folds 
ruslik_by: folds 
Avtovo: folds 
SexyAngeline: folds 
Uncalled bet ($3) returned to typename27
typename27 collected $2.50 from pot
typename27: doesn't show hand 
*** SUMMARY ***
Total pot $2.50 | Rake $0 
Seat 3: Avtovo (small blind) folded before Flop
Seat 4: SexyAngeline (big blind) folded before Flop
Seat 5: Dickyxxx folded before Flop (didn't bet)
Seat 6: typename27 collected ($2.50)
Seat 7: matiko09 folded before Flop (didn't bet)
Seat 8: SkUhNi folded before Flop (didn't bet)
Seat 9: ruslik_by (button) folded before Flop (didn't bet)





PokerStars Hand #154971110673:  Hold'em No Limit (£0.25/£0.50 GBP) - 2016/06/20 13:09:23 CET [2016/06/20 7:09:23 ET]
Table 'Azalea' 6-max Seat #4 is the button
Seat 1: mitsuVK (£62.71 in chips) 
Seat 2: matiko09 (£71.94 in chips) 
Seat 4: faceMyBallz_ (£99.47 in chips) 
Seat 5: mudders693 (£37.88 in chips) 
Seat 6: Bënedic10 (£85.93 in chips) 
mudders693: posts small blind £0.25
Bënedic10: posts big blind £0.50
*** HOLE CARDS ***
Dealt to matiko09 [2d Qs]
mitsuVK: folds 
matiko09: folds 
faceMyBallz_: folds 
mudders693: raises £1 to £1.50
Bënedic10: calls £1
*** FLOP *** [Ac 6h 8h]
mudders693: checks 
Bënedic10: checks 
*** TURN *** [Ac 6h 8h] [Jh]
mudders693: checks 
Bënedic10: checks 
*** RIVER *** [Ac 6h 8h Jh] [Kc]
mudders693: checks 
Bënedic10: checks 
*** SHOW DOWN ***
mudders693: shows [3d Ts] (high card Ace)
Bënedic10: shows [Js 9d] (a pair of Jacks)
Bënedic10 collected £2.85 from pot
*** SUMMARY ***
Total pot £3 | Rake £0.15 
Board [Ac 6h 8h Jh Kc]
Seat 1: mitsuVK folded before Flop (didn't bet)
Seat 2: matiko09 folded before Flop (didn't bet)
Seat 4: faceMyBallz_ (button) folded before Flop (didn't bet)
Seat 5: mudders693 (small blind) showed [3d Ts] and lost with high card Ace
Seat 6: Bënedic10 (big blind) showed [Js 9d] and won (£2.85) with a pair of Jacks





PokerStars Hand #154971114560:  Hold'em No Limit ($0.50/$1.00 USD) - 2016/06/20 13:09:33 CET [2016/06/20 7:09:33 ET]
Table 'Ernestina' 9-max Seat #9 is the button
Seat 1: diva3150 ($122.89 in chips) 
Seat 2: matiko09 ($204.52 in chips) 
Seat 4: SkUhNi ($107.28 in chips) 
Seat 5: Dickyxxx ($101.50 in chips) 
Seat 6: arctur17 ($62.79 in chips) 
Seat 8: ruslik_by ($238.03 in chips) 
Seat 9: Filojoes ($121.03 in chips) 
diva3150: posts small blind $0.50
matiko09: posts big blind $1
SexyAngeline: sits out 
ki11u: sits out 
*** HOLE CARDS ***
Dealt to matiko09 [Kc 8d]
SkUhNi: folds 
Dickyxxx: folds 
arctur17: folds 
ruslik_by: raises $1.50 to $2.50
Filojoes: folds 
diva3150: folds 
matiko09: folds 
Uncalled bet ($1.50) returned to ruslik_by
ruslik_by collected $2.50 from pot
ruslik_by: doesn't show hand 
*** SUMMARY ***
Total pot $2.50 | Rake $0 
Seat 1: diva3150 (small blind) folded before Flop
Seat 2: matiko09 (big blind) folded before Flop
Seat 4: SkUhNi folded before Flop (didn't bet)
Seat 5: Dickyxxx folded before Flop (didn't bet)
Seat 6: arctur17 folded before Flop (didn't bet)
Seat 8: ruslik_by collected ($2.50)
Seat 9: Filojoes (button) folded before Flop (didn't bet)





PokerStars Hand #154971115489:  Hold'em No Limit (£0.25/£0.50 GBP) - 2016/06/20 13:09:35 CET [2016/06/20 7:09:35 ET]
Table 'Tesla' 6-max Seat #3 is the button
Seat 1: Rubleff85 (£39.34 in chips) 
Seat 2: matiko09 (£63.68 in chips) 
Seat 3: asmodej666 (£50 in chips) 
Seat 4: VahTang_89 (£83.29 in chips) 
Seat 5: Nego Razu (£53 in chips) 
Seat 6: faceMyBallz_ (£55.76 in chips) 
VahTang_89: posts small blind £0.25
Nego Razu: posts big blind £0.50
*** HOLE CARDS ***
Dealt to matiko09 [Ks Js]
faceMyBallz_: raises £1 to £1.50
Rubleff85: folds 
matiko09: calls £1.50
asmodej666: folds 
VahTang_89: folds 
Nego Razu: folds 
*** FLOP *** [4c 5s 9c]
faceMyBallz_: checks 
matiko09: checks 
*** TURN *** [4c 5s 9c] [Qs]
faceMyBallz_: checks 
matiko09: bets £2.31
faceMyBallz_: folds 
Uncalled bet (£2.31) returned to matiko09
matiko09 collected £3.56 from pot
matiko09: doesn't show hand 
*** SUMMARY ***
Total pot £3.75 | Rake £0.19 
Board [4c 5s 9c Qs]
Seat 1: Rubleff85 folded before Flop (didn't bet)
Seat 2: matiko09 collected (£3.56)
Seat 3: asmodej666 (button) folded before Flop (didn't bet)
Seat 4: VahTang_89 (small blind) folded before Flop
Seat 5: Nego Razu (big blind) folded before Flop
Seat 6: faceMyBallz_ folded on the Turn





PokerStars Hand #154971116565:  Hold'em No Limit ($0.25/$0.50 USD) - 2016/06/20 13:09:38 CET [2016/06/20 7:09:38 ET]
Table 'Scheddi II' 9-max Seat #4 is the button
Seat 1: matiko09 ($93.25 in chips) 
Seat 2: Yaaaazz ($56.61 in chips) 
Seat 3: mi$$I$Elena ($81.01 in chips) 
Seat 4: GOOFA13 ($65.49 in chips) 
Seat 5: zarplatka ($40 in chips) 
Seat 6: orochimaturi ($38.70 in chips) 
Seat 7: HopeMayBee ($112.73 in chips) 
Seat 8: Danil27 ($50 in chips) 
Seat 9: Infinitinium ($143.56 in chips) 
zarplatka: posts small blind $0.25
orochimaturi: posts big blind $0.50
matiko09: posts the ante $0.10
Yaaaazz: posts the ante $0.10
mi$$I$Elena: posts the ante $0.10
GOOFA13: posts the ante $0.10
zarplatka: posts the ante $0.10
orochimaturi: posts the ante $0.10
HopeMayBee: posts the ante $0.10
Danil27: posts the ante $0.10
Infinitinium: posts the ante $0.10
*** HOLE CARDS ***
Dealt to matiko09 [4d As]
HopeMayBee: folds 
Danil27: folds 
Infinitinium: folds 
matiko09: folds 
Yaaaazz: folds 
mi$$I$Elena: raises $0.69 to $1.19
GOOFA13: folds 
zarplatka: folds 
orochimaturi: calls $0.69
*** FLOP *** [8s Qd 2s]
orochimaturi: checks 
mi$$I$Elena: checks 
*** TURN *** [8s Qd 2s] [5s]
orochimaturi: checks 
mi$$I$Elena: checks 
*** RIVER *** [8s Qd 2s 5s] [Tc]
orochimaturi: checks 
mi$$I$Elena: checks 
*** SHOW DOWN ***
orochimaturi: shows [Kd Td] (a pair of Tens)
mi$$I$Elena: mucks hand 
orochimaturi collected $3.35 from pot
*** SUMMARY ***
Total pot $3.53 | Rake $0.18 
Board [8s Qd 2s 5s Tc]
Seat 1: matiko09 folded before Flop (didn't bet)
Seat 2: Yaaaazz folded before Flop (didn't bet)
Seat 3: mi$$I$Elena mucked [Ah Jc]
Seat 4: GOOFA13 (button) folded before Flop (didn't bet)
Seat 5: zarplatka (small blind) folded before Flop
Seat 6: orochimaturi (big blind) showed [Kd Td] and won ($3.35) with a pair of Tens
Seat 7: HopeMayBee folded before Flop (didn't bet)
Seat 8: Danil27 folded before Flop (didn't bet)
Seat 9: Infinitinium folded before Flop (didn't bet)





PokerStars Hand #154971118547:  Hold'em No Limit ($0.50/$1.00 USD) - 2016/06/20 13:09:42 CET [2016/06/20 7:09:42 ET]
Table 'Pongola' 9-max Seat #5 is the button
Seat 1: matiko09 ($121.12 in chips) 
Seat 2: ruslik_by ($101.66 in chips) 
Seat 3: SkUhNi ($136.33 in chips) 
Seat 4: SexyAngeline ($73.64 in chips) 
Seat 5: Coolller ($98.50 in chips) 
Seat 7: Dickyxxx ($153.65 in chips) 
Seat 8: phrantique ($111.12 in chips) 
Seat 9: Filojoes ($155.92 in chips) 
Dickyxxx: posts small blind $0.50
phrantique: posts big blind $1
*** HOLE CARDS ***
Dealt to matiko09 [3d 9h]
Filojoes: folds 
matiko09: folds 
ruslik_by: folds 
SkUhNi: folds 
SexyAngeline: folds 
Coolller: folds 
Dickyxxx: raises $2 to $3
phrantique: folds 
Uncalled bet ($2) returned to Dickyxxx
Dickyxxx collected $2 from pot
Dickyxxx: doesn't show hand 
*** SUMMARY ***
Total pot $2 | Rake $0 
Seat 1: matiko09 folded before Flop (didn't bet)
Seat 2: ruslik_by folded before Flop (didn't bet)
Seat 3: SkUhNi folded before Flop (didn't bet)
Seat 4: SexyAngeline folded before Flop (didn't bet)
Seat 5: Coolller (button) folded before Flop (didn't bet)
Seat 7: Dickyxxx (small blind) collected ($2)
Seat 8: phrantique (big blind) folded before Flop
Seat 9: Filojoes folded before Flop (didn't bet)





PokerStars Hand #154971119394:  Hold'em No Limit ($0.50/$1.00 USD) - 2016/06/20 13:09:44 CET [2016/06/20 7:09:44 ET]
Table 'Normannia' 9-max Seat #3 is the button
Seat 3: Avtovo ($100 in chips) 
Seat 4: SexyAngeline ($93.81 in chips) 
Seat 5: Dickyxxx ($100 in chips) 
Seat 6: typename27 ($89.17 in chips) 
Seat 7: matiko09 ($111.15 in chips) 
Seat 8: SkUhNi ($125.84 in chips) 
Seat 9: ruslik_by ($148.91 in chips) 
SexyAngeline: posts small blind $0.50
Dickyxxx: posts big blind $1
ki11u: sits out 
*** HOLE CARDS ***
Dealt to matiko09 [2s Ac]
typename27: calls $1
matiko09: folds 
SkUhNi: folds 
ruslik_by: raises $3 to $4
Avtovo: folds 
SexyAngeline: folds 
Dickyxxx: folds 
typename27: calls $3
*** FLOP *** [6h 5s 3h]
typename27: checks 
ruslik_by: bets $3.06
typename27: calls $3.06
*** TURN *** [6h 5s 3h] [Qs]
typename27: checks 
ruslik_by: bets $5.04
typename27: folds 
Uncalled bet ($5.04) returned to ruslik_by
ruslik_by collected $14.84 from pot
ruslik_by: doesn't show hand 
*** SUMMARY ***
Total pot $15.62 | Rake $0.78 
Board [6h 5s 3h Qs]
Seat 3: Avtovo (button) folded before Flop (didn't bet)
Seat 4: SexyAngeline (small blind) folded before Flop
Seat 5: Dickyxxx (big blind) folded before Flop
Seat 6: typename27 folded on the Turn
Seat 7: matiko09 folded before Flop (didn't bet)
Seat 8: SkUhNi folded before Flop (didn't bet)
Seat 9: ruslik_by collected ($14.84)





PokerStars Hand #154971122496:  Hold'em No Limit ($0.50/$1.00 USD) - 2016/06/20 13:09:52 CET [2016/06/20 7:09:52 ET]
Table 'Isonoe II' 9-max Seat #5 is the button
Seat 2: matiko09 ($134.67 in chips) 
Seat 5: Filojoes ($100 in chips) 
Seat 6: GOOFA13 ($48.46 in chips) 
Seat 7: SkUhNi ($123.48 in chips) 
Seat 8: lewyson ($28.11 in chips) 
Seat 9: djammusic ($57.24 in chips) 
GOOFA13: posts small blind $0.50
SkUhNi: posts big blind $1
SexyAngeline: sits out 
Avtovo: sits out 
*** HOLE CARDS ***
Dealt to matiko09 [As Kh]
lewyson: folds 
djammusic: folds 
matiko09: raises $1.50 to $2.50
Filojoes: folds 
GOOFA13: folds 
SkUhNi: folds 
Uncalled bet ($1.50) returned to matiko09
matiko09 collected $2.50 from pot
matiko09: doesn't show hand 
*** SUMMARY ***
Total pot $2.50 | Rake $0 
Seat 2: matiko09 collected ($2.50)
Seat 5: Filojoes (button) folded before Flop (didn't bet)
Seat 6: GOOFA13 (small blind) folded before Flop
Seat 7: SkUhNi (big blind) folded before Flop
Seat 8: lewyson folded before Flop (didn't bet)
Seat 9: djammusic folded before Flop (didn't bet)





PokerStars Hand #154971122444:  Hold'em No Limit ($0.50/$1.00 USD) - 2016/06/20 13:09:52 CET [2016/06/20 7:09:52 ET]
Table 'Annika' 9-max Seat #2 is the button
Seat 2: matiko09 ($102.30 in chips) 
Seat 3: first_dnk ($86.78 in chips) 
Seat 4: Filojoes ($108.14 in chips) 
Seat 5: SkUhNi ($100 in chips) 
Seat 6: Pvsx. ($130.95 in chips) 
Seat 8: ruslik_by ($100 in chips) 
Seat 9: Avtovo ($104 in chips) 
first_dnk: posts small blind $0.50
Filojoes: posts big blind $1
*** HOLE CARDS ***
Dealt to matiko09 [9h Kd]
SkUhNi: folds 
Pvsx.: raises $1.50 to $2.50
ruslik_by: folds 
Avtovo: folds 
matiko09: folds 
first_dnk: folds 
Filojoes: folds 
Uncalled bet ($1.50) returned to Pvsx.
Pvsx. collected $2.50 from pot
Pvsx.: doesn't show hand 
*** SUMMARY ***
Total pot $2.50 | Rake $0 
Seat 2: matiko09 (button) folded before Flop (didn't bet)
Seat 3: first_dnk (small blind) folded before Flop
Seat 4: Filojoes (big blind) folded before Flop
Seat 5: SkUhNi folded before Flop (didn't bet)
Seat 6: Pvsx. collected ($2.50)
Seat 8: ruslik_by folded before Flop (didn't bet)
Seat 9: Avtovo folded before Flop (didn't bet)





PokerStars Hand #154971125025:  Hold'em No Limit (€0.25/€0.50 EUR) - 2016/06/20 13:09:58 CET [2016/06/20 7:09:58 ET]
Table 'Bechuana' 6-max Seat #2 is the button
Seat 1: zitagirl (€29.42 in chips) 
Seat 2: matiko09 (€60.42 in chips) 
Seat 3: Aju!ntje (€84.79 in chips) 
Seat 4: Wwwasian (€50 in chips) 
Seat 5: fanmtZ (€45.74 in chips) 
Seat 6: SlayersGBG (€56.28 in chips) 
Aju!ntje: posts small blind €0.25
Wwwasian: posts big blind €0.50
*** HOLE CARDS ***
Dealt to matiko09 [Qc 4c]
fanmtZ: folds 
SlayersGBG: raises €1 to €1.50
zitagirl: folds 
matiko09: folds 
Aju!ntje: calls €1.25
Wwwasian: calls €1
*** FLOP *** [9h 3d 9c]
Aju!ntje: checks 
Wwwasian: checks 
SlayersGBG: checks 
*** TURN *** [9h 3d 9c] [5d]
Aju!ntje: bets €2.91
Wwwasian: raises €6.09 to €9
SlayersGBG: folds 
Aju!ntje: folds 
Uncalled bet (€6.09) returned to Wwwasian
Wwwasian collected €9.80 from pot
Wwwasian: doesn't show hand 
*** SUMMARY ***
Total pot €10.32 | Rake €0.52 
Board [9h 3d 9c 5d]
Seat 1: zitagirl folded before Flop (didn't bet)
Seat 2: matiko09 (button) folded before Flop (didn't bet)
Seat 3: Aju!ntje (small blind) folded on the Turn
Seat 4: Wwwasian (big blind) collected (€9.80)
Seat 5: fanmtZ folded before Flop (didn't bet)
Seat 6: SlayersGBG folded on the Turn





PokerStars Hand #154971128626:  Hold'em No Limit ($0.50/$1.00 USD) - 2016/06/20 13:10:07 CET [2016/06/20 7:10:07 ET]
Table 'Ernestina' 9-max Seat #1 is the button
Seat 1: diva3150 ($122.39 in chips) 
Seat 2: matiko09 ($203.52 in chips) 
Seat 3: SexyAngeline ($100 in chips) 
Seat 4: SkUhNi ($107.28 in chips) 
Seat 5: Dickyxxx ($101.50 in chips) 
Seat 6: arctur17 ($62.79 in chips) 
Seat 8: ruslik_by ($239.53 in chips) 
Seat 9: Filojoes ($121.03 in chips) 
matiko09: posts small blind $0.50
SexyAngeline: posts big blind $1
ki11u: sits out 
*** HOLE CARDS ***
Dealt to matiko09 [9s 6d]
SkUhNi: folds 
Dickyxxx: folds 
arctur17: raises $1 to $2
ruslik_by: folds 
Filojoes: folds 
diva3150: calls $2
matiko09: folds 
SexyAngeline: folds 
*** FLOP *** [2s Tc 7s]
arctur17: bets $3
ki11u leaves the table
diva3150: calls $3
*** TURN *** [2s Tc 7s] [4d]
arctur17: bets $8
diva3150: calls $8
*** RIVER *** [2s Tc 7s 4d] [Qd]
arctur17: bets $16
diva3150: calls $16
*** SHOW DOWN ***
arctur17: shows [4h 4s] (three of a kind, Fours)
diva3150: mucks hand 
arctur17 collected $57 from pot
*** SUMMARY ***
Total pot $59.50 | Rake $2.50 
Board [2s Tc 7s 4d Qd]
Seat 1: diva3150 (button) mucked [Ah Jd]
Seat 2: matiko09 (small blind) folded before Flop
Seat 3: SexyAngeline (big blind) folded before Flop
Seat 4: SkUhNi folded before Flop (didn't bet)
Seat 5: Dickyxxx folded before Flop (didn't bet)
Seat 6: arctur17 showed [4h 4s] and won ($57) with three of a kind, Fours
Seat 8: ruslik_by folded before Flop (didn't bet)
Seat 9: Filojoes folded before Flop (didn't bet)





PokerStars Hand #154971129826:  Hold'em No Limit (£0.25/£0.50 GBP) - 2016/06/20 13:10:10 CET [2016/06/20 7:10:10 ET]
Table 'Azalea' 6-max Seat #5 is the button
Seat 1: mitsuVK (£62.71 in chips) 
Seat 2: matiko09 (£71.94 in chips) 
Seat 4: faceMyBallz_ (£99.47 in chips) 
Seat 5: mudders693 (£36.38 in chips) 
Seat 6: Bënedic10 (£87.28 in chips) 
Bënedic10: posts small blind £0.25
mitsuVK: posts big blind £0.50
*** HOLE CARDS ***
Dealt to matiko09 [Js 8s]
matiko09: folds 
faceMyBallz_: raises £0.75 to £1.25
mudders693: raises £2.75 to £4
Bënedic10: calls £3.75
mitsuVK: folds 
faceMyBallz_: calls £2.75
*** FLOP *** [5h 2h 7s]
Bënedic10: checks 
faceMyBallz_: checks 
mudders693: bets £7
Bënedic10: folds 
faceMyBallz_: folds 
Uncalled bet (£7) returned to mudders693
mudders693 collected £11.88 from pot
mudders693: doesn't show hand 
*** SUMMARY ***
Total pot £12.50 | Rake £0.62 
Board [5h 2h 7s]
Seat 1: mitsuVK (big blind) folded before Flop
Seat 2: matiko09 folded before Flop (didn't bet)
Seat 4: faceMyBallz_ folded on the Flop
Seat 5: mudders693 (button) collected (£11.88)
Seat 6: Bënedic10 (small blind) folded on the Flop





PokerStars Hand #154971131313:  Hold'em No Limit ($0.50/$1.00 USD) - 2016/06/20 13:10:14 CET [2016/06/20 7:10:14 ET]
Table 'Pongola' 9-max Seat #7 is the button
Seat 1: matiko09 ($121.12 in chips) 
Seat 2: ruslik_by ($101.66 in chips) 
Seat 3: SkUhNi ($136.33 in chips) 
Seat 4: SexyAngeline ($73.64 in chips) 
Seat 5: Coolller ($98.50 in chips) 
Seat 7: Dickyxxx ($154.65 in chips) 
Seat 8: phrantique ($110.12 in chips) 
Seat 9: Filojoes ($155.92 in chips) 
phrantique: posts small blind $0.50
Filojoes: posts big blind $1
*** HOLE CARDS ***
Dealt to matiko09 [Qh Ad]
matiko09: raises $2 to $3
ruslik_by: folds 
SkUhNi: folds 
SexyAngeline: folds 
Coolller: folds 
Dickyxxx: folds 
phrantique: folds 
Filojoes: folds 
Uncalled bet ($2) returned to matiko09
matiko09 collected $2.50 from pot
matiko09: doesn't show hand 
*** SUMMARY ***
Total pot $2.50 | Rake $0 
Seat 1: matiko09 collected ($2.50)
Seat 2: ruslik_by folded before Flop (didn't bet)
Seat 3: SkUhNi folded before Flop (didn't bet)
Seat 4: SexyAngeline folded before Flop (didn't bet)
Seat 5: Coolller folded before Flop (didn't bet)
Seat 7: Dickyxxx (button) folded before Flop (didn't bet)
Seat 8: phrantique (small blind) folded before Flop
Seat 9: Filojoes (big blind) folded before Flop





PokerStars Hand #154971132011:  Hold'em No Limit ($0.50/$1.00 USD) - 2016/06/20 13:10:16 CET [2016/06/20 7:10:16 ET]
Table 'Annika' 9-max Seat #3 is the button
Seat 2: matiko09 ($102.30 in chips) 
Seat 3: first_dnk ($86.28 in chips) 
Seat 4: Filojoes ($107.14 in chips) 
Seat 5: SkUhNi ($100 in chips) 
Seat 6: Pvsx. ($132.45 in chips) 
Seat 8: ruslik_by ($100 in chips) 
Seat 9: Avtovo ($104 in chips) 
Filojoes: posts small blind $0.50
SkUhNi: posts big blind $1
*** HOLE CARDS ***
Dealt to matiko09 [Jc As]
Pvsx.: folds 
Pvsx. leaves the table
ruslik_by: folds 
Avtovo: folds 
matiko09: raises $1.50 to $2.50
first_dnk: folds 
Filojoes: folds 
SkUhNi: folds 
Uncalled bet ($1.50) returned to matiko09
matiko09 collected $2.50 from pot
matiko09: doesn't show hand 
*** SUMMARY ***
Total pot $2.50 | Rake $0 
Seat 2: matiko09 collected ($2.50)
Seat 3: first_dnk (button) folded before Flop (didn't bet)
Seat 4: Filojoes (small blind) folded before Flop
Seat 5: SkUhNi (big blind) folded before Flop
Seat 6: Pvsx. folded before Flop (didn't bet)
Seat 8: ruslik_by folded before Flop (didn't bet)
Seat 9: Avtovo folded before Flop (didn't bet)





PokerStars Hand #154971133176:  Hold'em No Limit (£0.25/£0.50 GBP) - 2016/06/20 13:10:19 CET [2016/06/20 7:10:19 ET]
Table 'Ani' 6-max Seat #5 is the button
Seat 1: asmodej666 (£50 in chips) 
Seat 2: mitsuVK (£55.85 in chips) 
Seat 3: Doobes8555 (£73.50 in chips) 
Seat 4: matiko09 (£64.17 in chips) 
Seat 5: Wwwasian (£61.54 in chips) 
Seat 6: faceMyBallz_ (£50 in chips) 
faceMyBallz_: posts small blind £0.25
asmodej666: posts big blind £0.50
*** HOLE CARDS ***
Dealt to matiko09 [5s 3h]
mitsuVK: folds 
Doobes8555: raises £1.25 to £1.75
matiko09: folds 
Wwwasian: folds 
faceMyBallz_: calls £1.50
asmodej666: folds 
*** FLOP *** [8h Jh 3d]
faceMyBallz_: checks 
Doobes8555: checks 
*** TURN *** [8h Jh 3d] [6h]
faceMyBallz_: bets £2.50
Doobes8555: calls £2.50
*** RIVER *** [8h Jh 3d 6h] [Qc]
faceMyBallz_: checks 
Doobes8555: bets £8.50
faceMyBallz_: folds 
Uncalled bet (£8.50) returned to Doobes8555
Doobes8555 collected £8.55 from pot
Doobes8555: doesn't show hand 
*** SUMMARY ***
Total pot £9 | Rake £0.45 
Board [8h Jh 3d 6h Qc]
Seat 1: asmodej666 (big blind) folded before Flop
Seat 2: mitsuVK folded before Flop (didn't bet)
Seat 3: Doobes8555 collected (£8.55)
Seat 4: matiko09 folded before Flop (didn't bet)
Seat 5: Wwwasian (button) folded before Flop (didn't bet)
Seat 6: faceMyBallz_ (small blind) folded on the River





PokerStars Hand #154971134486:  Hold'em No Limit (£0.25/£0.50 GBP) - 2016/06/20 13:10:22 CET [2016/06/20 7:10:22 ET]
Table 'Tesla' 6-max Seat #4 is the button
Seat 1: Rubleff85 (£39.34 in chips) 
Seat 2: matiko09 (£65.74 in chips) 
Seat 3: asmodej666 (£50 in chips) 
Seat 4: VahTang_89 (£83.04 in chips) 
Seat 5: Nego Razu (£52.50 in chips) 
Seat 6: faceMyBallz_ (£54.26 in chips) 
Nego Razu: posts small blind £0.25
faceMyBallz_: posts big blind £0.50
*** HOLE CARDS ***
Dealt to matiko09 [5c Ac]
Rubleff85: folds 
matiko09: raises £1 to £1.50
asmodej666: raises £3 to £4.50
VahTang_89: folds 
Nego Razu: folds 
faceMyBallz_: folds 
matiko09: folds 
Uncalled bet (£3) returned to asmodej666
asmodej666 collected £3.75 from pot
asmodej666: doesn't show hand 
*** SUMMARY ***
Total pot £3.75 | Rake £0 
Seat 1: Rubleff85 folded before Flop (didn't bet)
Seat 2: matiko09 folded before Flop
Seat 3: asmodej666 collected (£3.75)
Seat 4: VahTang_89 (button) folded before Flop (didn't bet)
Seat 5: Nego Razu (small blind) folded before Flop
Seat 6: faceMyBallz_ (big blind) folded before Flop





PokerStars Hand #154971135532:  Hold'em No Limit ($0.50/$1.00 USD) - 2016/06/20 13:10:24 CET [2016/06/20 7:10:24 ET]
Table 'Isonoe II' 9-max Seat #6 is the button
Seat 2: matiko09 ($136.17 in chips) 
Seat 5: Filojoes ($100 in chips) 
Seat 6: GOOFA13 ($47.96 in chips) 
Seat 7: SkUhNi ($122.48 in chips) 
Seat 8: lewyson ($28.11 in chips) 
Seat 9: djammusic ($57.24 in chips) 
SkUhNi: posts small blind $0.50
lewyson: posts big blind $1
SexyAngeline: sits out 
Avtovo: sits out 
*** HOLE CARDS ***
Dealt to matiko09 [3s Qc]
djammusic: folds 
matiko09: folds 
Filojoes: raises $1.50 to $2.50
GOOFA13: folds 
SkUhNi: folds 
lewyson: calls $1.50
*** FLOP *** [Qs Jd Kc]
lewyson: bets $5.22
Filojoes: folds 
Uncalled bet ($5.22) returned to lewyson
lewyson collected $5.22 from pot
*** SUMMARY ***
Total pot $5.50 | Rake $0.28 
Board [Qs Jd Kc]
Seat 2: matiko09 folded before Flop (didn't bet)
Seat 5: Filojoes folded on the Flop
Seat 6: GOOFA13 (button) folded before Flop (didn't bet)
Seat 7: SkUhNi (small blind) folded before Flop
Seat 8: lewyson (big blind) collected ($5.22)
Seat 9: djammusic folded before Flop (didn't bet)





PokerStars Hand #154971136172:  Hold'em No Limit ($0.50/$1.00 USD) - 2016/06/20 13:10:26 CET [2016/06/20 7:10:26 ET]
Table 'Garumna II' 9-max Seat #9 is the button
Seat 1: ki11u ($142.50 in chips) 
Seat 3: mooose100 ($97.65 in chips) 
Seat 5: rura53 ($79.12 in chips) 
Seat 6: SexyAngeline ($41.91 in chips) 
Seat 7: Avtovo ($115.90 in chips) 
Seat 8: matiko09 ($106.52 in chips) 
Seat 9: SkUhNi ($137.78 in chips) 
ki11u: posts small blind $0.50
mooose100: posts big blind $1
*** HOLE CARDS ***
Dealt to matiko09 [5c 2s]
rura53: folds 
SexyAngeline: raises $1.07 to $2.07
Avtovo: folds 
matiko09: folds 
SkUhNi: folds 
ki11u: folds 
mooose100: folds 
Uncalled bet ($1.07) returned to SexyAngeline
SexyAngeline collected $2.50 from pot
SexyAngeline: doesn't show hand 
*** SUMMARY ***
Total pot $2.50 | Rake $0 
Seat 1: ki11u (small blind) folded before Flop
Seat 3: mooose100 (big blind) folded before Flop
Seat 5: rura53 folded before Flop (didn't bet)
Seat 6: SexyAngeline collected ($2.50)
Seat 7: Avtovo folded before Flop (didn't bet)
Seat 8: matiko09 folded before Flop (didn't bet)
Seat 9: SkUhNi (button) folded before Flop (didn't bet)





PokerStars Hand #154971143113:  Hold'em No Limit ($0.25/$0.50 USD) - 2016/06/20 13:10:43 CET [2016/06/20 7:10:43 ET]
Table 'Scheddi II' 9-max Seat #5 is the button
Seat 1: matiko09 ($93.15 in chips) 
Seat 2: Yaaaazz ($56.51 in chips) 
Seat 3: mi$$I$Elena ($79.72 in chips) 
Seat 4: GOOFA13 ($65.39 in chips) 
Seat 5: zarplatka ($40 in chips) 
Seat 6: orochimaturi ($40.76 in chips) 
Seat 7: HopeMayBee ($112.63 in chips) 
Seat 8: Danil27 ($50 in chips) 
Seat 9: Infinitinium ($143.46 in chips) 
orochimaturi: posts small blind $0.25
HopeMayBee: posts big blind $0.50
matiko09: posts the ante $0.10
Yaaaazz: posts the ante $0.10
mi$$I$Elena: posts the ante $0.10
GOOFA13: posts the ante $0.10
zarplatka: posts the ante $0.10
orochimaturi: posts the ante $0.10
HopeMayBee: posts the ante $0.10
Danil27: posts the ante $0.10
Infinitinium: posts the ante $0.10
*** HOLE CARDS ***
Dealt to matiko09 [4s 9d]
Danil27: folds 
Infinitinium: calls $0.50
matiko09: folds 
Yaaaazz: folds 
mi$$I$Elena: folds 
GOOFA13: folds 
zarplatka: folds 
orochimaturi: calls $0.25
HopeMayBee: checks 
*** FLOP *** [3s 5s Qd]
orochimaturi: checks 
HopeMayBee: checks 
Infinitinium: bets $0.50
orochimaturi: calls $0.50
HopeMayBee: calls $0.50
*** TURN *** [3s 5s Qd] [Jd]
orochimaturi: checks 
HopeMayBee: checks 
Infinitinium: bets $1.85
orochimaturi: folds 
HopeMayBee: calls $1.85
*** RIVER *** [3s 5s Qd Jd] [8h]
HopeMayBee: checks 
Infinitinium: bets $7.22
HopeMayBee: folds 
Uncalled bet ($7.22) returned to Infinitinium
Infinitinium collected $7.22 from pot
Infinitinium: doesn't show hand 
*** SUMMARY ***
Total pot $7.60 | Rake $0.38 
Board [3s 5s Qd Jd 8h]
Seat 1: matiko09 folded before Flop (didn't bet)
Seat 2: Yaaaazz folded before Flop (didn't bet)
Seat 3: mi$$I$Elena folded before Flop (didn't bet)
Seat 4: GOOFA13 folded before Flop (didn't bet)
Seat 5: zarplatka (button) folded before Flop (didn't bet)
Seat 6: orochimaturi (small blind) folded on the Turn
Seat 7: HopeMayBee (big blind) folded on the River
Seat 8: Danil27 folded before Flop (didn't bet)
Seat 9: Infinitinium collected ($7.22)





PokerStars Hand #154971143799:  Hold'em No Limit (£0.25/£0.50 GBP) - 2016/06/20 13:10:44 CET [2016/06/20 7:10:44 ET]
Table 'Tesla' 6-max Seat #5 is the button
Seat 1: Rubleff85 (£39.34 in chips) 
Seat 2: matiko09 (£64.24 in chips) 
Seat 3: asmodej666 (£52.25 in chips) 
Seat 4: VahTang_89 (£83.04 in chips) 
Seat 5: Nego Razu (£52.25 in chips) 
Seat 6: faceMyBallz_ (£53.76 in chips) 
faceMyBallz_: posts small blind £0.25
Rubleff85: posts big blind £0.50
*** HOLE CARDS ***
Dealt to matiko09 [7c 5c]
matiko09: folds 
asmodej666: folds 
VahTang_89: folds 
Nego Razu: raises £0.77 to £1.27
faceMyBallz_: folds 
Rubleff85: folds 
Uncalled bet (£0.77) returned to Nego Razu
Nego Razu collected £1.25 from pot
Nego Razu: doesn't show hand 
*** SUMMARY ***
Total pot £1.25 | Rake £0 
Seat 1: Rubleff85 (big blind) folded before Flop
Seat 2: matiko09 folded before Flop (didn't bet)
Seat 3: asmodej666 folded before Flop (didn't bet)
Seat 4: VahTang_89 folded before Flop (didn't bet)
Seat 5: Nego Razu (button) collected (£1.25)
Seat 6: faceMyBallz_ (small blind) folded before Flop





PokerStars Hand #154971145448:  Hold'em No Limit ($0.50/$1.00 USD) - 2016/06/20 13:10:48 CET [2016/06/20 7:10:48 ET]
Table 'Garumna II' 9-max Seat #1 is the button
Seat 1: ki11u ($142 in chips) 
Seat 3: mooose100 ($96.65 in chips) 
Seat 5: rura53 ($79.12 in chips) 
Seat 6: SexyAngeline ($43.41 in chips) 
Seat 7: Avtovo ($115.90 in chips) 
Seat 8: matiko09 ($106.52 in chips) 
Seat 9: SkUhNi ($137.78 in chips) 
mooose100: posts small blind $0.50
rura53: posts big blind $1
*** HOLE CARDS ***
Dealt to matiko09 [2c Ac]
SexyAngeline: folds 
Avtovo: folds 
matiko09: raises $2 to $3
SkUhNi: folds 
ki11u: folds 
mooose100: calls $2.50
rura53: calls $2
*** FLOP *** [3c Ad Td]
mooose100: checks 
rura53: checks 
matiko09: bets $5
mooose100: folds 
rura53: folds 
Uncalled bet ($5) returned to matiko09
matiko09 collected $8.55 from pot
matiko09: doesn't show hand 
*** SUMMARY ***
Total pot $9 | Rake $0.45 
Board [3c Ad Td]
Seat 1: ki11u (button) folded before Flop (didn't bet)
Seat 3: mooose100 (small blind) folded on the Flop
Seat 5: rura53 (big blind) folded on the Flop
Seat 6: SexyAngeline folded before Flop (didn't bet)
Seat 7: Avtovo folded before Flop (didn't bet)
Seat 8: matiko09 collected ($8.55)
Seat 9: SkUhNi folded before Flop (didn't bet)





PokerStars Hand #154971145438:  Hold'em No Limit (£0.25/£0.50 GBP) - 2016/06/20 13:10:48 CET [2016/06/20 7:10:48 ET]
Table 'Azalea' 6-max Seat #6 is the button
Seat 1: mitsuVK (£62.21 in chips) 
Seat 2: matiko09 (£71.94 in chips) 
Seat 4: faceMyBallz_ (£95.47 in chips) 
Seat 5: mudders693 (£44.26 in chips) 
Seat 6: Bënedic10 (£83.28 in chips) 
mitsuVK: posts small blind £0.25
matiko09: posts big blind £0.50
*** HOLE CARDS ***
Dealt to matiko09 [9s 6s]
faceMyBallz_: folds 
mudders693: raises £1 to £1.50
Bënedic10: folds 
mitsuVK: calls £1.25
matiko09: calls £1
*** FLOP *** [5h Kc 9c]
mitsuVK: checks 
matiko09: checks 
mudders693: checks 
*** TURN *** [5h Kc 9c] [7h]
mitsuVK: checks 
matiko09: checks 
mudders693: bets £4
mitsuVK: folds 
matiko09: calls £4
*** RIVER *** [5h Kc 9c 7h] [3c]
matiko09: checks 
mudders693: bets £4
matiko09: calls £4
*** SHOW DOWN ***
mudders693: shows [Th Jh] (high card King)
matiko09: shows [9s 6s] (a pair of Nines)
matiko09 collected £19.48 from pot
*** SUMMARY ***
Total pot £20.50 | Rake £1.02 
Board [5h Kc 9c 7h 3c]
Seat 1: mitsuVK (small blind) folded on the Turn
Seat 2: matiko09 (big blind) showed [9s 6s] and won (£19.48) with a pair of Nines
Seat 4: faceMyBallz_ folded before Flop (didn't bet)
Seat 5: mudders693 showed [Th Jh] and lost with high card King
Seat 6: Bënedic10 (button) folded before Flop (didn't bet)





PokerStars Hand #154971145843:  Hold'em No Limit ($0.50/$1.00 USD) - 2016/06/20 13:10:49 CET [2016/06/20 7:10:49 ET]
Table 'Annika' 9-max Seat #4 is the button
Seat 2: matiko09 ($103.80 in chips) 
Seat 3: first_dnk ($86.28 in chips) 
Seat 4: Filojoes ($106.64 in chips) 
Seat 5: SkUhNi ($100 in chips) 
Seat 8: ruslik_by ($100 in chips) 
Seat 9: Avtovo ($104 in chips) 
SkUhNi: posts small blind $0.50
ruslik_by: posts big blind $1
*** HOLE CARDS ***
Dealt to matiko09 [5s Jd]
Avtovo: folds 
Avtovo leaves the table
matiko09: folds 
mi$$I$Elena joins the table at seat #9 
first_dnk: folds 
Filojoes: folds 
SexyAngeline joins the table at seat #6 
SkUhNi: folds 
Uncalled bet ($0.50) returned to ruslik_by
ruslik_by collected $1 from pot
ruslik_by: doesn't show hand 
*** SUMMARY ***
Total pot $1 | Rake $0 
Seat 2: matiko09 folded before Flop (didn't bet)
Seat 3: first_dnk folded before Flop (didn't bet)
Seat 4: Filojoes (button) folded before Flop (didn't bet)
Seat 5: SkUhNi (small blind) folded before Flop
Seat 8: ruslik_by (big blind) collected ($1)
Seat 9: Avtovo folded before Flop (didn't bet)





PokerStars Hand #154971146220:  Hold'em No Limit ($0.50/$1.00 USD) - 2016/06/20 13:10:50 CET [2016/06/20 7:10:50 ET]
Table 'Normannia' 9-max Seat #4 is the button
Seat 3: Avtovo ($100 in chips) 
Seat 4: SexyAngeline ($93.31 in chips) 
Seat 5: Dickyxxx ($100 in chips) 
Seat 6: typename27 ($82.11 in chips) 
Seat 7: matiko09 ($111.15 in chips) 
Seat 8: SkUhNi ($125.84 in chips) 
Seat 9: ruslik_by ($156.69 in chips) 
Dickyxxx: posts small blind $0.50
typename27: posts big blind $1
ki11u: sits out 
*** HOLE CARDS ***
Dealt to matiko09 [Kh 4s]
matiko09: folds 
SkUhNi: folds 
ruslik_by: raises $2 to $3
Avtovo: folds 
SexyAngeline: folds 
Dickyxxx: folds 
typename27: folds 
Uncalled bet ($2) returned to ruslik_by
ruslik_by collected $2.50 from pot
ruslik_by: doesn't show hand 
*** SUMMARY ***
Total pot $2.50 | Rake $0 
Seat 3: Avtovo folded before Flop (didn't bet)
Seat 4: SexyAngeline (button) folded before Flop (didn't bet)
Seat 5: Dickyxxx (small blind) folded before Flop
Seat 6: typename27 (big blind) folded before Flop
Seat 7: matiko09 folded before Flop (didn't bet)
Seat 8: SkUhNi folded before Flop (didn't bet)
Seat 9: ruslik_by collected ($2.50)





PokerStars Hand #154971146703:  Hold'em No Limit ($0.50/$1.00 USD) - 2016/06/20 13:10:52 CET [2016/06/20 7:10:52 ET]
Table 'Isonoe II' 9-max Seat #7 is the button
Seat 2: matiko09 ($136.17 in chips) 
Seat 5: Filojoes ($100 in chips) 
Seat 6: GOOFA13 ($47.96 in chips) 
Seat 7: SkUhNi ($121.98 in chips) 
Seat 8: lewyson ($30.83 in chips) 
Seat 9: djammusic ($57.24 in chips) 
lewyson: posts small blind $0.50
djammusic: posts big blind $1
SexyAngeline: sits out 
Avtovo: sits out 
*** HOLE CARDS ***
Dealt to matiko09 [7s 7h]
matiko09: raises $2 to $3
Filojoes: folds 
GOOFA13: calls $3
SkUhNi: folds 
lewyson: folds 
djammusic: folds 
*** FLOP *** [7d 6h Jc]
matiko09: bets $4.63
GOOFA13: calls $4.63
*** TURN *** [7d 6h Jc] [8s]
matiko09: bets $11
GOOFA13: folds 
Uncalled bet ($11) returned to matiko09
matiko09 collected $15.92 from pot
matiko09: doesn't show hand 
*** SUMMARY ***
Total pot $16.76 | Rake $0.84 
Board [7d 6h Jc 8s]
Seat 2: matiko09 collected ($15.92)
Seat 5: Filojoes folded before Flop (didn't bet)
Seat 6: GOOFA13 folded on the Turn
Seat 7: SkUhNi (button) folded before Flop (didn't bet)
Seat 8: lewyson (small blind) folded before Flop
Seat 9: djammusic (big blind) folded before Flop





PokerStars Hand #154971149590:  Hold'em No Limit (£0.25/£0.50 GBP) - 2016/06/20 13:10:59 CET [2016/06/20 7:10:59 ET]
Table 'Tesla' 6-max Seat #6 is the button
Seat 1: Rubleff85 (£38.84 in chips) 
Seat 2: matiko09 (£64.24 in chips) 
Seat 3: asmodej666 (£52.25 in chips) 
Seat 4: VahTang_89 (£83.04 in chips) 
Seat 5: Nego Razu (£53 in chips) 
Seat 6: faceMyBallz_ (£53.51 in chips) 
Rubleff85: posts small blind £0.25
matiko09: posts big blind £0.50
*** HOLE CARDS ***
Dealt to matiko09 [2h 7h]
asmodej666: folds 
VahTang_89: folds 
Nego Razu: raises £0.77 to £1.27
faceMyBallz_: folds 
Rubleff85: calls £1.02
matiko09: folds 
*** FLOP *** [As Tc 2s]
Rubleff85: checks 
Nego Razu: bets £1.99
Rubleff85: calls £1.99
*** TURN *** [As Tc 2s] [4h]
Rubleff85: checks 
Nego Razu: checks 
*** RIVER *** [As Tc 2s 4h] [3h]
Rubleff85: bets £5.25
Nego Razu: folds 
Uncalled bet (£5.25) returned to Rubleff85
Rubleff85 collected £6.67 from pot
Rubleff85: doesn't show hand 
*** SUMMARY ***
Total pot £7.02 | Rake £0.35 
Board [As Tc 2s 4h 3h]
Seat 1: Rubleff85 (small blind) collected (£6.67)
Seat 2: matiko09 (big blind) folded before Flop
Seat 3: asmodej666 folded before Flop (didn't bet)
Seat 4: VahTang_89 folded before Flop (didn't bet)
Seat 5: Nego Razu folded on the River
Seat 6: faceMyBallz_ (button) folded before Flop (didn't bet)





PokerStars Hand #154971150183:  Hold'em No Limit ($0.50/$1.00 USD) - 2016/06/20 13:11:00 CET [2016/06/20 7:11:00 ET]
Table 'Pongola' 9-max Seat #8 is the button
Seat 1: matiko09 ($122.62 in chips) 
Seat 2: ruslik_by ($101.66 in chips) 
Seat 3: SkUhNi ($136.33 in chips) 
Seat 4: SexyAngeline ($73.64 in chips) 
Seat 5: Coolller ($98.50 in chips) 
Seat 7: Dickyxxx ($154.65 in chips) 
Seat 8: phrantique ($109.62 in chips) 
Seat 9: Filojoes ($154.92 in chips) 
Filojoes: posts small blind $0.50
matiko09: posts big blind $1
*** HOLE CARDS ***
Dealt to matiko09 [3h 4s]
ruslik_by: raises $2 to $3
SkUhNi: folds 
SexyAngeline: folds 
Coolller: folds 
Dickyxxx: folds 
phrantique: calls $3
Filojoes: folds 
matiko09: folds 
*** FLOP *** [5c 7h 8d]
ruslik_by: bets $2.42
phrantique: calls $2.42
*** TURN *** [5c 7h 8d] [5d]
ruslik_by: bets $3.98
phrantique: calls $3.98
*** RIVER *** [5c 7h 8d 5d] [3s]
ruslik_by: bets $6.55
phrantique: calls $6.55
*** SHOW DOWN ***
ruslik_by: shows [Js Jc] (two pair, Jacks and Fives)
phrantique: mucks hand 
ruslik_by collected $31.73 from pot
*** SUMMARY ***
Total pot $33.40 | Rake $1.67 
Board [5c 7h 8d 5d 3s]
Seat 1: matiko09 (big blind) folded before Flop
Seat 2: ruslik_by showed [Js Jc] and won ($31.73) with two pair, Jacks and Fives
Seat 3: SkUhNi folded before Flop (didn't bet)
Seat 4: SexyAngeline folded before Flop (didn't bet)
Seat 5: Coolller folded before Flop (didn't bet)
Seat 7: Dickyxxx folded before Flop (didn't bet)
Seat 8: phrantique (button) mucked [6d 7d]
Seat 9: Filojoes (small blind) folded before Flop





PokerStars Hand #154971152086:  Hold'em No Limit (£0.25/£0.50 GBP) - 2016/06/20 13:11:05 CET [2016/06/20 7:11:05 ET]
Table 'Ani' 6-max Seat #6 is the button
Seat 1: asmodej666 (£50 in chips) 
Seat 2: mitsuVK (£55.85 in chips) 
Seat 3: Doobes8555 (£77.80 in chips) 
Seat 4: matiko09 (£64.17 in chips) 
Seat 5: Wwwasian (£61.54 in chips) 
Seat 6: faceMyBallz_ (£50 in chips) 
asmodej666: posts small blind £0.25
mitsuVK: posts big blind £0.50
*** HOLE CARDS ***
Dealt to matiko09 [Ks Qh]
Doobes8555: folds 
matiko09: raises £1 to £1.50
Wwwasian: folds 
faceMyBallz_: folds 
asmodej666: folds 
mitsuVK: calls £1
*** FLOP *** [6s 5d 9c]
mitsuVK: checks 
matiko09: checks 
*** TURN *** [6s 5d 9c] [Jd]
mitsuVK: checks 
matiko09: bets £2
mitsuVK: folds 
Uncalled bet (£2) returned to matiko09
matiko09 collected £3.09 from pot
matiko09: doesn't show hand 
*** SUMMARY ***
Total pot £3.25 | Rake £0.16 
Board [6s 5d 9c Jd]
Seat 1: asmodej666 (small blind) folded before Flop
Seat 2: mitsuVK (big blind) folded on the Turn
Seat 3: Doobes8555 folded before Flop (didn't bet)
Seat 4: matiko09 collected (£3.09)
Seat 5: Wwwasian folded before Flop (didn't bet)
Seat 6: faceMyBallz_ (button) folded before Flop (didn't bet)





PokerStars Hand #154971157615:  Hold'em No Limit ($0.50/$1.00 USD) - 2016/06/20 13:11:18 CET [2016/06/20 7:11:18 ET]
Table 'Isonoe II' 9-max Seat #8 is the button
Seat 2: matiko09 ($144.46 in chips) 
Seat 5: Filojoes ($100 in chips) 
Seat 6: GOOFA13 ($40.33 in chips) 
Seat 7: SkUhNi ($121.98 in chips) 
Seat 8: lewyson ($30.33 in chips) 
Seat 9: djammusic ($56.24 in chips) 
djammusic: posts small blind $0.50
matiko09: posts big blind $1
SexyAngeline: sits out 
Avtovo: sits out 
*** HOLE CARDS ***
Dealt to matiko09 [9h 4s]
Filojoes: folds 
GOOFA13: raises $2 to $3
SkUhNi: folds 
lewyson is connected 
lewyson: folds 
djammusic: folds 
matiko09: folds 
Uncalled bet ($2) returned to GOOFA13
GOOFA13 collected $2.50 from pot
GOOFA13: doesn't show hand 
*** SUMMARY ***
Total pot $2.50 | Rake $0 
Seat 2: matiko09 (big blind) folded before Flop
Seat 5: Filojoes folded before Flop (didn't bet)
Seat 6: GOOFA13 collected ($2.50)
Seat 7: SkUhNi folded before Flop (didn't bet)
Seat 8: lewyson (button) folded before Flop (didn't bet)
Seat 9: djammusic (small blind) folded before Flop





PokerStars Hand #154971160335:  Hold'em No Limit ($0.50/$1.00 USD) - 2016/06/20 13:11:25 CET [2016/06/20 7:11:25 ET]
Table 'Normannia' 9-max Seat #5 is the button
Seat 3: Avtovo ($100 in chips) 
Seat 4: SexyAngeline ($93.31 in chips) 
Seat 5: Dickyxxx ($100 in chips) 
Seat 6: typename27 ($81.11 in chips) 
Seat 7: matiko09 ($111.15 in chips) 
Seat 8: SkUhNi ($125.84 in chips) 
Seat 9: ruslik_by ($158.19 in chips) 
typename27: posts small blind $0.50
matiko09: posts big blind $1
ki11u: sits out 
*** HOLE CARDS ***
Dealt to matiko09 [7d 3s]
SkUhNi: folds 
ruslik_by: folds 
Avtovo: raises $1.50 to $2.50
SexyAngeline: raises $5.07 to $7.57
Dickyxxx: calls $7.57
typename27: folds 
matiko09: folds 
Avtovo: calls $5.07
*** FLOP *** [4d 2s 4c]
Avtovo: checks 
SexyAngeline: bets $10.81
Dickyxxx: folds 
Avtovo: calls $10.81
*** TURN *** [4d 2s 4c] [8d]
Avtovo: checks 
SexyAngeline: bets $20.46
Avtovo: folds 
Uncalled bet ($20.46) returned to SexyAngeline
SexyAngeline collected $43.54 from pot
SexyAngeline: doesn't show hand 
*** SUMMARY ***
Total pot $45.83 | Rake $2.29 
Board [4d 2s 4c 8d]
Seat 3: Avtovo folded on the Turn
Seat 4: SexyAngeline collected ($43.54)
Seat 5: Dickyxxx (button) folded on the Flop
Seat 6: typename27 (small blind) folded before Flop
Seat 7: matiko09 (big blind) folded before Flop
Seat 8: SkUhNi folded before Flop (didn't bet)
Seat 9: ruslik_by folded before Flop (didn't bet)





PokerStars Hand #154971161704:  Hold'em No Limit ($0.50/$1.00 USD) - 2016/06/20 13:11:28 CET [2016/06/20 7:11:28 ET]
Table 'Annika' 9-max Seat #5 is the button
Seat 2: matiko09 ($103.80 in chips) 
Seat 3: first_dnk ($86.28 in chips) 
Seat 4: Filojoes ($106.64 in chips) 
Seat 5: SkUhNi ($100 in chips) 
Seat 8: ruslik_by ($100.50 in chips) 
SexyAngeline will be allowed to play after the button
ruslik_by: posts small blind $0.50
matiko09: posts big blind $1
*** HOLE CARDS ***
Dealt to matiko09 [6s Td]
first_dnk: folds 
Filojoes: folds 
SkUhNi: folds 
ruslik_by: folds 
Uncalled bet ($0.50) returned to matiko09
matiko09 collected $1 from pot
matiko09: doesn't show hand 
*** SUMMARY ***
Total pot $1 | Rake $0 
Seat 2: matiko09 (big blind) collected ($1)
Seat 3: first_dnk folded before Flop (didn't bet)
Seat 4: Filojoes folded before Flop (didn't bet)
Seat 5: SkUhNi (button) folded before Flop (didn't bet)
Seat 8: ruslik_by (small blind) folded before Flop





PokerStars Hand #154971165804:  Hold'em No Limit ($0.50/$1.00 USD) - 2016/06/20 13:11:38 CET [2016/06/20 7:11:38 ET]
Table 'Ernestina' 9-max Seat #2 is the button
Seat 1: diva3150 ($93.39 in chips) 
Seat 2: matiko09 ($203.02 in chips) 
Seat 3: SexyAngeline ($99 in chips) 
Seat 4: SkUhNi ($107.28 in chips) 
Seat 5: Dickyxxx ($101.50 in chips) 
Seat 6: arctur17 ($90.79 in chips) 
Seat 8: ruslik_by ($239.53 in chips) 
Seat 9: Filojoes ($121.03 in chips) 
SexyAngeline: posts small blind $0.50
SkUhNi: posts big blind $1
*** HOLE CARDS ***
Dealt to matiko09 [Ad 3s]
Dickyxxx: folds 
arctur17: folds 
ruslik_by: folds 
Filojoes: folds 
diva3150: folds 
diva3150 leaves the table
chenconhaste joins the table at seat #7 
aseban11 joins the table at seat #1 
chenconhaste leaves the table
aseban11 leaves the table
deadkiller1 joins the table at seat #7 
matiko09: raises $1.27 to $2.27
SexyAngeline: folds 
SkUhNi: calls $1.27
*** FLOP *** [Jc Js 9h]
SkUhNi: bets $3.35
matiko09: folds 
Uncalled bet ($3.35) returned to SkUhNi
SkUhNi collected $4.79 from pot
SkUhNi: doesn't show hand 
*** SUMMARY ***
Total pot $5.04 | Rake $0.25 
Board [Jc Js 9h]
Seat 1: diva3150 folded before Flop (didn't bet)
Seat 2: matiko09 (button) folded on the Flop
Seat 3: SexyAngeline (small blind) folded before Flop
Seat 4: SkUhNi (big blind) collected ($4.79)
Seat 5: Dickyxxx folded before Flop (didn't bet)
Seat 6: arctur17 folded before Flop (didn't bet)
Seat 8: ruslik_by folded before Flop (didn't bet)
Seat 9: Filojoes folded before Flop (didn't bet)





PokerStars Hand #154971168430:  Hold'em No Limit (£0.25/£0.50 GBP) - 2016/06/20 13:11:45 CET [2016/06/20 7:11:45 ET]
Table 'Tesla' 6-max Seat #1 is the button
Seat 1: Rubleff85 (£42.25 in chips) 
Seat 2: matiko09 (£63.74 in chips) 
Seat 3: asmodej666 (£52.25 in chips) 
Seat 4: VahTang_89 (£83.04 in chips) 
Seat 5: Nego Razu (£50 in chips) 
Seat 6: faceMyBallz_ (£53.51 in chips) 
matiko09: posts small blind £0.25
asmodej666: posts big blind £0.50
*** HOLE CARDS ***
Dealt to matiko09 [2s 5d]
VahTang_89: raises £0.50 to £1
Nego Razu: folds 
faceMyBallz_: folds 
Rubleff85: folds 
matiko09: folds 
asmodej666: folds 
Uncalled bet (£0.50) returned to VahTang_89
VahTang_89 collected £1.25 from pot
VahTang_89: doesn't show hand 
*** SUMMARY ***
Total pot £1.25 | Rake £0 
Seat 1: Rubleff85 (button) folded before Flop (didn't bet)
Seat 2: matiko09 (small blind) folded before Flop
Seat 3: asmodej666 (big blind) folded before Flop
Seat 4: VahTang_89 collected (£1.25)
Seat 5: Nego Razu folded before Flop (didn't bet)
Seat 6: faceMyBallz_ folded before Flop (didn't bet)





PokerStars Hand #154971169327:  Hold'em No Limit ($0.50/$1.00 USD) - 2016/06/20 13:11:47 CET [2016/06/20 7:11:47 ET]
Table 'Garumna II' 9-max Seat #3 is the button
Seat 1: ki11u ($142 in chips) 
Seat 3: mooose100 ($93.65 in chips) 
Seat 5: rura53 ($76.12 in chips) 
Seat 6: SexyAngeline ($43.41 in chips) 
Seat 7: Avtovo ($115.90 in chips) 
Seat 8: matiko09 ($112.07 in chips) 
Seat 9: SkUhNi ($137.78 in chips) 
rura53: posts small blind $0.50
SexyAngeline: posts big blind $1
*** HOLE CARDS ***
Dealt to matiko09 [4c Jc]
Avtovo: folds 
matiko09: folds 
SkUhNi: folds 
ki11u: folds 
mooose100: folds 
rura53: folds 
Uncalled bet ($0.50) returned to SexyAngeline
SexyAngeline collected $1 from pot
SexyAngeline: doesn't show hand 
*** SUMMARY ***
Total pot $1 | Rake $0 
Seat 1: ki11u folded before Flop (didn't bet)
Seat 3: mooose100 (button) folded before Flop (didn't bet)
Seat 5: rura53 (small blind) folded before Flop
Seat 6: SexyAngeline (big blind) collected ($1)
Seat 7: Avtovo folded before Flop (didn't bet)
Seat 8: matiko09 folded before Flop (didn't bet)
Seat 9: SkUhNi folded before Flop (didn't bet)





PokerStars Hand #154971170122:  Hold'em No Limit ($0.50/$1.00 USD) - 2016/06/20 13:11:49 CET [2016/06/20 7:11:49 ET]
Table 'Isonoe II' 9-max Seat #9 is the button
Seat 2: matiko09 ($143.46 in chips) 
Seat 3: SexyAngeline ($100 in chips) 
Seat 5: Filojoes ($100 in chips) 
Seat 6: GOOFA13 ($41.83 in chips) 
Seat 7: SkUhNi ($121.98 in chips) 
Seat 8: lewyson ($30.33 in chips) 
Seat 9: djammusic ($55.74 in chips) 
matiko09: posts small blind $0.50
SexyAngeline: posts big blind $1
Avtovo: sits out 
*** HOLE CARDS ***
Dealt to matiko09 [Th 5s]
Filojoes: folds 
GOOFA13: folds 
SkUhNi: folds 
lewyson: folds 
djammusic: folds 
matiko09: folds 
Uncalled bet ($0.50) returned to SexyAngeline
SexyAngeline collected $1 from pot
SexyAngeline: doesn't show hand 
*** SUMMARY ***
Total pot $1 | Rake $0 
Seat 2: matiko09 (small blind) folded before Flop
Seat 3: SexyAngeline (big blind) collected ($1)
Seat 5: Filojoes folded before Flop (didn't bet)
Seat 6: GOOFA13 folded before Flop (didn't bet)
Seat 7: SkUhNi folded before Flop (didn't bet)
Seat 8: lewyson folded before Flop (didn't bet)
Seat 9: djammusic (button) folded before Flop (didn't bet)





PokerStars Hand #154971171624:  Hold'em No Limit ($0.50/$1.00 USD) - 2016/06/20 13:11:53 CET [2016/06/20 7:11:53 ET]
Table 'Annika' 9-max Seat #8 is the button
Seat 2: matiko09 ($104.30 in chips) 
Seat 3: first_dnk ($86.28 in chips) 
Seat 4: Filojoes ($106.64 in chips) 
Seat 5: SkUhNi ($100 in chips) 
Seat 8: ruslik_by ($100 in chips) 
matiko09: posts small blind $0.50
first_dnk: posts big blind $1
SexyAngeline: sits out 
*** HOLE CARDS ***
Dealt to matiko09 [9d 3s]
Filojoes: folds 
SkUhNi: folds 
ruslik_by: raises $1 to $2
matiko09: folds 
first_dnk: folds 
Uncalled bet ($1) returned to ruslik_by
ruslik_by collected $2.50 from pot
ruslik_by: doesn't show hand 
*** SUMMARY ***
Total pot $2.50 | Rake $0 
Seat 2: matiko09 (small blind) folded before Flop
Seat 3: first_dnk (big blind) folded before Flop
Seat 4: Filojoes folded before Flop (didn't bet)
Seat 5: SkUhNi folded before Flop (didn't bet)
Seat 8: ruslik_by (button) collected ($2.50)





