PokerStars Hand #153500468942:  Hold'em No Limit ($0.50/$1.00 USD) - 2016/05/18 19:54:38 CET [2016/05/18 13:54:38 ET]
Table 'Saiph II' 9-max Seat #3 is the button
Seat 1: chris.99.741 ($34 in chips) 
Seat 2: matiko09 ($100 in chips) 
Seat 3: lydia12345 ($100 in chips) 
Seat 4: Bimaxa ($107.04 in chips) 
Seat 6: LadyMaCe86 ($103 in chips) 
Seat 8: sanr23 ($100 in chips) 
Seat 9: florrin92 ($101.50 in chips) 
Bimaxa: posts small blind $0.50
cobrik23: is sitting out 
cobrik23 leaves the table
LadyMaCe86: posts big blind $1
*** HOLE CARDS ***
Dealt to matiko09 [Td Jc]
ipashutapkom joins the table at seat #5 
sanr23: folds 
florrin92: folds 
chris.99.741: folds 
matiko09: raises $1.50 to $2.50
lydia12345: folds 
Bimaxa: folds 
LadyMaCe86: raises $6 to $8.50
matiko09: folds 
Uncalled bet ($6) returned to LadyMaCe86
LadyMaCe86 collected $5.50 from pot
LadyMaCe86: doesn't show hand 
*** SUMMARY ***
Total pot $5.50 | Rake $0 
Seat 1: chris.99.741 folded before Flop (didn't bet)
Seat 2: matiko09 folded before Flop
Seat 3: lydia12345 (button) folded before Flop (didn't bet)
Seat 4: Bimaxa (small blind) folded before Flop
Seat 6: LadyMaCe86 (big blind) collected ($5.50)
Seat 8: sanr23 folded before Flop (didn't bet)
Seat 9: florrin92 folded before Flop (didn't bet)





PokerStars Hand #153500474053:  Hold'em No Limit ($1/$2 USD) - 2016/05/18 19:54:45 CET [2016/05/18 13:54:45 ET]
Table 'Chlosinde' 9-max Seat #5 is the button
Seat 1: ersevi6 ($187.83 in chips) 
Seat 2: aseban11 ($200 in chips) 
Seat 3: matiko09 ($200 in chips) 
Seat 4: FREDY BULLIT ($200 in chips) 
Seat 5: tepi_guy ($652.69 in chips) 
Seat 6: slick_nickDH ($416.56 in chips) 
Seat 7: donald0404 ($200 in chips) 
Seat 8: sanducu_eu ($227.67 in chips) 
Seat 9: Tey113 ($418.44 in chips) 
slick_nickDH: posts small blind $1
donald0404: posts big blind $2
*** HOLE CARDS ***
Dealt to matiko09 [Js 8c]
sanducu_eu: folds 
Tey113: raises $3.54 to $5.54
ersevi6: calls $5.54
aseban11: calls $5.54
matiko09: folds 
FREDY BULLIT: folds 
tepi_guy: folds 
slick_nickDH: folds 
donald0404: folds 
*** FLOP *** [5h 3d Qc]
Tey113: bets $9.32
ersevi6: folds 
aseban11: folds 
Uncalled bet ($9.32) returned to Tey113
Tey113 collected $18.64 from pot
Tey113: doesn't show hand 
*** SUMMARY ***
Total pot $19.62 | Rake $0.98 
Board [5h 3d Qc]
Seat 1: ersevi6 folded on the Flop
Seat 2: aseban11 folded on the Flop
Seat 3: matiko09 folded before Flop (didn't bet)
Seat 4: FREDY BULLIT folded before Flop (didn't bet)
Seat 5: tepi_guy (button) folded before Flop (didn't bet)
Seat 6: slick_nickDH (small blind) folded before Flop
Seat 7: donald0404 (big blind) folded before Flop
Seat 8: sanducu_eu folded before Flop (didn't bet)
Seat 9: Tey113 collected ($18.64)





PokerStars Hand #153500499669:  Hold'em No Limit (€0.50/€1.00 EUR) - 2016/05/18 19:55:18 CET [2016/05/18 13:55:18 ET]
Table 'Pallas II' 9-max Seat #2 is the button
Seat 1: florrin92 (€100 in chips) 
Seat 2: matiko09 (€217.45 in chips) 
Seat 3: nickreason17 (€100 in chips) 
Seat 4: torkkdnm (€114.30 in chips) 
Seat 5: cobrik23 (€62.62 in chips) 
Seat 6: STrakDD (€100 in chips) 
Seat 8: lydia12345 (€100 in chips) 
Seat 9: stijner1986 (€86.11 in chips) 
nickreason17: posts small blind €0.50
torkkdnm: posts big blind €1
ipashutapkom: sits out 
*** HOLE CARDS ***
Dealt to matiko09 [7s 8h]
cobrik23: folds 
STrakDD: folds 
lydia12345: folds 
stijner1986: folds 
florrin92: folds 
matiko09: folds 
nickreason17: folds 
Uncalled bet (€0.50) returned to torkkdnm
torkkdnm collected €1 from pot
*** SUMMARY ***
Total pot €1 | Rake €0 
Seat 1: florrin92 folded before Flop (didn't bet)
Seat 2: matiko09 (button) folded before Flop (didn't bet)
Seat 3: nickreason17 (small blind) folded before Flop
Seat 4: torkkdnm (big blind) collected (€1)
Seat 5: cobrik23 folded before Flop (didn't bet)
Seat 6: STrakDD folded before Flop (didn't bet)
Seat 8: lydia12345 folded before Flop (didn't bet)
Seat 9: stijner1986 folded before Flop (didn't bet)





PokerStars Hand #153500503503:  Hold'em No Limit ($1/$2 USD) - 2016/05/18 19:55:24 CET [2016/05/18 13:55:24 ET]
Table 'Letaba' 9-max Seat #4 is the button
Seat 1: FREDY BULLIT ($200 in chips) 
Seat 2: staruk669 ($138.41 in chips) 
Seat 3: ersevi6 ($191.44 in chips) 
Seat 4: matiko09 ($211.20 in chips) 
Seat 5: aseban11 ($200 in chips) 
Seat 6: donald0404 ($200 in chips) 
Seat 7: moshmachine ($256.66 in chips) 
Seat 8: $-Twackle-$ ($219.88 in chips) 
Seat 9: tepi_guy ($234.20 in chips) 
aseban11: posts small blind $1
donald0404: posts big blind $2
*** HOLE CARDS ***
Dealt to matiko09 [Ad 2d]
moshmachine: folds 
$-Twackle-$: folds 
tepi_guy: folds 
FREDY BULLIT: folds 
staruk669: raises $2 to $4
ersevi6: folds 
matiko09: folds 
aseban11: folds 
donald0404: calls $2
*** FLOP *** [Kd Qh 4s]
donald0404: checks 
staruk669: bets $8
donald0404: folds 
Uncalled bet ($8) returned to staruk669
staruk669 collected $8.55 from pot
staruk669: doesn't show hand 
*** SUMMARY ***
Total pot $9 | Rake $0.45 
Board [Kd Qh 4s]
Seat 1: FREDY BULLIT folded before Flop (didn't bet)
Seat 2: staruk669 collected ($8.55)
Seat 3: ersevi6 folded before Flop (didn't bet)
Seat 4: matiko09 (button) folded before Flop (didn't bet)
Seat 5: aseban11 (small blind) folded before Flop
Seat 6: donald0404 (big blind) folded on the Flop
Seat 7: moshmachine folded before Flop (didn't bet)
Seat 8: $-Twackle-$ folded before Flop (didn't bet)
Seat 9: tepi_guy folded before Flop (didn't bet)





PokerStars Hand #153500517175:  Hold'em No Limit ($1/$2 USD) - 2016/05/18 19:55:45 CET [2016/05/18 13:55:45 ET]
Table 'Chlosinde' 9-max Seat #6 is the button
Seat 1: ersevi6 ($182.29 in chips) 
Seat 2: aseban11 ($200 in chips) 
Seat 3: matiko09 ($200 in chips) 
Seat 4: FREDY BULLIT ($200 in chips) 
Seat 5: tepi_guy ($652.69 in chips) 
Seat 6: slick_nickDH ($415.56 in chips) 
Seat 7: donald0404 ($200 in chips) 
Seat 8: sanducu_eu ($227.67 in chips) 
Seat 9: Tey113 ($431.54 in chips) 
donald0404: posts small blind $1
sanducu_eu: posts big blind $2
*** HOLE CARDS ***
Dealt to matiko09 [Qs 4d]
Tey113: folds 
ersevi6: folds 
aseban11: raises $4 to $6
matiko09: folds 
FREDY BULLIT: folds 
tepi_guy has timed out
tepi_guy: folds 
slick_nickDH: folds 
donald0404: folds 
sanducu_eu: folds 
Uncalled bet ($4) returned to aseban11
aseban11 collected $5 from pot
aseban11: doesn't show hand 
*** SUMMARY ***
Total pot $5 | Rake $0 
Seat 1: ersevi6 folded before Flop (didn't bet)
Seat 2: aseban11 collected ($5)
Seat 3: matiko09 folded before Flop (didn't bet)
Seat 4: FREDY BULLIT folded before Flop (didn't bet)
Seat 5: tepi_guy folded before Flop (didn't bet)
Seat 6: slick_nickDH (button) folded before Flop (didn't bet)
Seat 7: donald0404 (small blind) folded before Flop
Seat 8: sanducu_eu (big blind) folded before Flop
Seat 9: Tey113 folded before Flop (didn't bet)





PokerStars Hand #153500520015:  Hold'em No Limit ($0.50/$1.00 USD) - 2016/05/18 19:55:49 CET [2016/05/18 13:55:49 ET]
Table 'Abetti II' 9-max Seat #9 is the button
Seat 1: matiko09 ($100 in chips) 
Seat 2: Bimaxa ($131.89 in chips) 
Seat 3: cobrik23 ($255.87 in chips) 
Seat 4: aseban11 ($100 in chips) 
Seat 5: blufthenuts ($123.12 in chips) 
Seat 6: I The King I ($147.14 in chips) 
Seat 7: nickreason17 ($100.92 in chips) 
Seat 8: roadster683 ($111.91 in chips) 
Seat 9: florrin92 ($100 in chips) 
matiko09: posts small blind $0.50
Bimaxa: posts big blind $1
*** HOLE CARDS ***
Dealt to matiko09 [8s 3d]
cobrik23: folds 
aseban11: folds 
blufthenuts: folds 
I The King I: folds 
nickreason17: folds 
roadster683: folds 
florrin92: raises $1.50 to $2.50
matiko09: folds 
Bimaxa: folds 
Uncalled bet ($1.50) returned to florrin92
florrin92 collected $2.50 from pot
florrin92: doesn't show hand 
*** SUMMARY ***
Total pot $2.50 | Rake $0 
Seat 1: matiko09 (small blind) folded before Flop
Seat 2: Bimaxa (big blind) folded before Flop
Seat 3: cobrik23 folded before Flop (didn't bet)
Seat 4: aseban11 folded before Flop (didn't bet)
Seat 5: blufthenuts folded before Flop (didn't bet)
Seat 6: I The King I folded before Flop (didn't bet)
Seat 7: nickreason17 folded before Flop (didn't bet)
Seat 8: roadster683 folded before Flop (didn't bet)
Seat 9: florrin92 (button) collected ($2.50)





PokerStars Hand #153500521993:  Hold'em No Limit (€0.50/€1.00 EUR) - 2016/05/18 19:55:52 CET [2016/05/18 13:55:52 ET]
Table 'Pallas II' 9-max Seat #3 is the button
Seat 1: florrin92 (€100 in chips) 
Seat 2: matiko09 (€217.45 in chips) 
Seat 3: nickreason17 (€100 in chips) 
Seat 4: torkkdnm (€114.80 in chips) 
Seat 5: cobrik23 (€62.62 in chips) 
Seat 6: STrakDD (€100 in chips) 
Seat 8: lydia12345 (€100 in chips) 
Seat 9: stijner1986 (€86.11 in chips) 
torkkdnm: posts small blind €0.50
cobrik23: posts big blind €1
ipashutapkom: sits out 
*** HOLE CARDS ***
Dealt to matiko09 [As Ad]
STrakDD: folds 
lydia12345: folds 
stijner1986: folds 
florrin92: raises €2 to €3
matiko09: raises €6.50 to €9.50
nickreason17: folds 
torkkdnm: folds 
cobrik23: folds 
florrin92: folds 
Uncalled bet (€6.50) returned to matiko09
matiko09 collected €7.50 from pot
matiko09: doesn't show hand 
*** SUMMARY ***
Total pot €7.50 | Rake €0 
Seat 1: florrin92 folded before Flop
Seat 2: matiko09 collected (€7.50)
Seat 3: nickreason17 (button) folded before Flop (didn't bet)
Seat 4: torkkdnm (small blind) folded before Flop
Seat 5: cobrik23 (big blind) folded before Flop
Seat 6: STrakDD folded before Flop (didn't bet)
Seat 8: lydia12345 folded before Flop (didn't bet)
Seat 9: stijner1986 folded before Flop (didn't bet)





PokerStars Hand #153500524939:  Hold'em No Limit ($0.50/$1.00 USD) - 2016/05/18 19:55:57 CET [2016/05/18 13:55:57 ET]
Table 'Tatjana III' 9-max Seat #5 is the button
Seat 1: cobrik23 ($40 in chips) 
Seat 2: kirki000 ($129.72 in chips) 
Seat 3: matiko09 ($100 in chips) 
Seat 4: nuuaber ($160.94 in chips) 
Seat 5: sanr23 ($126.75 in chips) 
Seat 6: Bimaxa ($100 in chips) 
Seat 7: djammusic ($38.12 in chips) 
Seat 8: aseban11 ($100 in chips) 
Seat 9: florrin92 ($100 in chips) 
Bimaxa: posts small blind $0.50
djammusic: posts big blind $1
*** HOLE CARDS ***
Dealt to matiko09 [7d 3d]
aseban11: folds 
florrin92: folds 
cobrik23: raises $1 to $2
kirki000: calls $2
matiko09: folds 
nuuaber: folds 
sanr23: folds 
Bimaxa: folds 
djammusic: folds 
*** FLOP *** [Jh 7c 4d]
cobrik23: checks 
kirki000: checks 
*** TURN *** [Jh 7c 4d] [Qh]
cobrik23: checks 
kirki000: checks 
*** RIVER *** [Jh 7c 4d Qh] [8s]
cobrik23: checks 
kirki000: checks 
*** SHOW DOWN ***
cobrik23: shows [2s As] (high card Ace)
kirki000: mucks hand 
cobrik23 collected $5.22 from pot
*** SUMMARY ***
Total pot $5.50 | Rake $0.28 
Board [Jh 7c 4d Qh 8s]
Seat 1: cobrik23 showed [2s As] and won ($5.22) with high card Ace
Seat 2: kirki000 mucked [2h 3s]
Seat 3: matiko09 folded before Flop (didn't bet)
Seat 4: nuuaber folded before Flop (didn't bet)
Seat 5: sanr23 (button) folded before Flop (didn't bet)
Seat 6: Bimaxa (small blind) folded before Flop
Seat 7: djammusic (big blind) folded before Flop
Seat 8: aseban11 folded before Flop (didn't bet)
Seat 9: florrin92 folded before Flop (didn't bet)





PokerStars Hand #153500526845:  Hold'em No Limit ($0.50/$1.00 USD) - 2016/05/18 19:56:00 CET [2016/05/18 13:56:00 ET]
Table 'Saiph II' 9-max Seat #4 is the button
Seat 1: chris.99.741 ($34 in chips) 
Seat 2: matiko09 ($100 in chips) 
Seat 3: lydia12345 ($100 in chips) 
Seat 4: Bimaxa ($106.54 in chips) 
Seat 6: LadyMaCe86 ($106 in chips) 
Seat 8: sanr23 ($100 in chips) 
Seat 9: florrin92 ($101.50 in chips) 
ipashutapkom will be allowed to play after the button
LadyMaCe86: posts small blind $0.50
sanr23: posts big blind $1
*** HOLE CARDS ***
Dealt to matiko09 [Ac 7s]
florrin92: folds 
chris.99.741: raises $2 to $3
florrin92 leaves the table
matiko09: folds 
lydia12345: calls $3
Bimaxa: folds 
LadyMaCe86: folds 
ipashutapkom leaves the table
sanr23: folds 
*** FLOP *** [6c 8c Kc]
chris.99.741: checks 
lydia12345: bets $7.12
chris.99.741: folds 
Uncalled bet ($7.12) returned to lydia12345
lydia12345 collected $7.12 from pot
*** SUMMARY ***
Total pot $7.50 | Rake $0.38 
Board [6c 8c Kc]
Seat 1: chris.99.741 folded on the Flop
Seat 2: matiko09 folded before Flop (didn't bet)
Seat 3: lydia12345 collected ($7.12)
Seat 4: Bimaxa (button) folded before Flop (didn't bet)
Seat 6: LadyMaCe86 (small blind) folded before Flop
Seat 8: sanr23 (big blind) folded before Flop
Seat 9: florrin92 folded before Flop (didn't bet)





PokerStars Hand #153500538917:  Hold'em No Limit ($1/$2 USD) - 2016/05/18 19:56:19 CET [2016/05/18 13:56:19 ET]
Table 'Letaba' 9-max Seat #5 is the button
Seat 1: FREDY BULLIT ($200 in chips) 
Seat 2: staruk669 ($142.96 in chips) 
Seat 3: ersevi6 ($191.44 in chips) 
Seat 4: matiko09 ($211.20 in chips) 
Seat 5: aseban11 ($200 in chips) 
Seat 6: donald0404 ($200 in chips) 
Seat 7: moshmachine ($256.66 in chips) 
Seat 8: $-Twackle-$ ($219.88 in chips) 
Seat 9: tepi_guy ($234.20 in chips) 
donald0404: posts small blind $1
moshmachine: posts big blind $2
*** HOLE CARDS ***
Dealt to matiko09 [Kc 3h]
$-Twackle-$: folds 
tepi_guy: raises $3.40 to $5.40
FREDY BULLIT: folds 
staruk669: folds 
ersevi6: folds 
matiko09: folds 
aseban11: folds 
donald0404: folds 
moshmachine: folds 
Uncalled bet ($3.40) returned to tepi_guy
tepi_guy collected $5 from pot
tepi_guy: doesn't show hand 
*** SUMMARY ***
Total pot $5 | Rake $0 
Seat 1: FREDY BULLIT folded before Flop (didn't bet)
Seat 2: staruk669 folded before Flop (didn't bet)
Seat 3: ersevi6 folded before Flop (didn't bet)
Seat 4: matiko09 folded before Flop (didn't bet)
Seat 5: aseban11 (button) folded before Flop (didn't bet)
Seat 6: donald0404 (small blind) folded before Flop
Seat 7: moshmachine (big blind) folded before Flop
Seat 8: $-Twackle-$ folded before Flop (didn't bet)
Seat 9: tepi_guy collected ($5)





PokerStars Hand #153500541471:  Hold'em No Limit (€0.50/€1.00 EUR) - 2016/05/18 19:56:23 CET [2016/05/18 13:56:23 ET]
Table 'Pallas II' 9-max Seat #4 is the button
Seat 1: florrin92 (€100 in chips) 
Seat 2: matiko09 (€221.95 in chips) 
Seat 3: nickreason17 (€100 in chips) 
Seat 4: torkkdnm (€114.30 in chips) 
Seat 5: cobrik23 (€61.62 in chips) 
Seat 6: STrakDD (€100 in chips) 
Seat 8: lydia12345 (€100 in chips) 
Seat 9: stijner1986 (€86.11 in chips) 
cobrik23: posts small blind €0.50
STrakDD: posts big blind €1
ipashutapkom: sits out 
*** HOLE CARDS ***
Dealt to matiko09 [Js 2d]
lydia12345: folds 
stijner1986: folds 
florrin92: folds 
matiko09: folds 
nickreason17: folds 
torkkdnm: raises €1 to €2
cobrik23: folds 
STrakDD: folds 
Uncalled bet (€1) returned to torkkdnm
torkkdnm collected €2.50 from pot
*** SUMMARY ***
Total pot €2.50 | Rake €0 
Seat 1: florrin92 folded before Flop (didn't bet)
Seat 2: matiko09 folded before Flop (didn't bet)
Seat 3: nickreason17 folded before Flop (didn't bet)
Seat 4: torkkdnm (button) collected (€2.50)
Seat 5: cobrik23 (small blind) folded before Flop
Seat 6: STrakDD (big blind) folded before Flop
Seat 8: lydia12345 folded before Flop (didn't bet)
Seat 9: stijner1986 folded before Flop (didn't bet)





PokerStars Hand #153500546797:  Hold'em No Limit ($0.50/$1.00 USD) - 2016/05/18 19:56:31 CET [2016/05/18 13:56:31 ET]
Table 'Abetti II' 9-max Seat #1 is the button
Seat 1: matiko09 ($100 in chips) 
Seat 2: Bimaxa ($130.89 in chips) 
Seat 3: cobrik23 ($255.87 in chips) 
Seat 4: aseban11 ($100 in chips) 
Seat 5: blufthenuts ($123.12 in chips) 
Seat 6: I The King I ($147.14 in chips) 
Seat 7: nickreason17 ($100.92 in chips) 
Seat 8: roadster683 ($111.91 in chips) 
Seat 9: florrin92 ($101.50 in chips) 
Bimaxa: posts small blind $0.50
cobrik23: posts big blind $1
*** HOLE CARDS ***
Dealt to matiko09 [Kh 2c]
aseban11: folds 
blufthenuts: folds 
I The King I: folds 
nickreason17: folds 
roadster683 is disconnected 
roadster683 is connected 
roadster683: calls $1
florrin92: raises $4 to $5
matiko09: folds 
Bimaxa: folds 
cobrik23: folds 
roadster683: calls $4
*** FLOP *** [Jc Jd 2h]
roadster683: checks 
florrin92: bets $7
roadster683: calls $7
*** TURN *** [Jc Jd 2h] [5s]
roadster683: checks 
florrin92: bets $16
roadster683: calls $16
*** RIVER *** [Jc Jd 2h 5s] [5h]
roadster683: checks 
florrin92: checks 
*** SHOW DOWN ***
roadster683: shows [Jh 9h] (a full house, Jacks full of Fives)
florrin92: mucks hand 
roadster683 collected $55 from pot
*** SUMMARY ***
Total pot $57.50 | Rake $2.50 
Board [Jc Jd 2h 5s 5h]
Seat 1: matiko09 (button) folded before Flop (didn't bet)
Seat 2: Bimaxa (small blind) folded before Flop
Seat 3: cobrik23 (big blind) folded before Flop
Seat 4: aseban11 folded before Flop (didn't bet)
Seat 5: blufthenuts folded before Flop (didn't bet)
Seat 6: I The King I folded before Flop (didn't bet)
Seat 7: nickreason17 folded before Flop (didn't bet)
Seat 8: roadster683 showed [Jh 9h] and won ($55) with a full house, Jacks full of Fives
Seat 9: florrin92 mucked [8d 8h]





PokerStars Hand #153500548801:  Hold'em No Limit ($1/$2 USD) - 2016/05/18 19:56:34 CET [2016/05/18 13:56:34 ET]
Table 'Chlosinde' 9-max Seat #7 is the button
Seat 1: ersevi6 ($182.29 in chips) 
Seat 2: aseban11 ($203 in chips) 
Seat 3: matiko09 ($200 in chips) 
Seat 4: FREDY BULLIT ($200 in chips) 
Seat 5: tepi_guy ($652.69 in chips) 
Seat 6: slick_nickDH ($415.56 in chips) 
Seat 7: donald0404 ($200 in chips) 
Seat 8: sanducu_eu ($225.67 in chips) 
Seat 9: Tey113 ($431.54 in chips) 
sanducu_eu: posts small blind $1
Tey113: posts big blind $2
*** HOLE CARDS ***
Dealt to matiko09 [4h 5d]
ersevi6: folds 
aseban11: folds 
matiko09: folds 
FREDY BULLIT: folds 
tepi_guy has timed out
tepi_guy: folds 
slick_nickDH: folds 
donald0404: folds 
sanducu_eu: raises $4 to $6
Tey113: folds 
Uncalled bet ($4) returned to sanducu_eu
sanducu_eu collected $4 from pot
sanducu_eu: doesn't show hand 
*** SUMMARY ***
Total pot $4 | Rake $0 
Seat 1: ersevi6 folded before Flop (didn't bet)
Seat 2: aseban11 folded before Flop (didn't bet)
Seat 3: matiko09 folded before Flop (didn't bet)
Seat 4: FREDY BULLIT folded before Flop (didn't bet)
Seat 5: tepi_guy folded before Flop (didn't bet)
Seat 6: slick_nickDH folded before Flop (didn't bet)
Seat 7: donald0404 (button) folded before Flop (didn't bet)
Seat 8: sanducu_eu (small blind) collected ($4)
Seat 9: Tey113 (big blind) folded before Flop





PokerStars Hand #153500550761:  Hold'em No Limit ($0.50/$1.00 USD) - 2016/05/18 19:56:37 CET [2016/05/18 13:56:37 ET]
Table 'Tatjana III' 9-max Seat #6 is the button
Seat 1: cobrik23 ($43.22 in chips) 
Seat 2: kirki000 ($127.72 in chips) 
Seat 3: matiko09 ($100 in chips) 
Seat 4: nuuaber ($160.94 in chips) 
Seat 5: sanr23 ($126.75 in chips) 
Seat 6: Bimaxa ($100 in chips) 
Seat 7: djammusic ($37.12 in chips) 
Seat 8: aseban11 ($100 in chips) 
Seat 9: florrin92 ($100 in chips) 
djammusic: posts small blind $0.50
aseban11: posts big blind $1
*** HOLE CARDS ***
Dealt to matiko09 [3h 6c]
florrin92: folds 
cobrik23: folds 
kirki000: folds 
matiko09: folds 
nuuaber: folds 
sanr23: folds 
Bimaxa: folds 
djammusic: raises $1.25 to $2.25
aseban11: folds 
Uncalled bet ($1.25) returned to djammusic
djammusic collected $2 from pot
djammusic: doesn't show hand 
*** SUMMARY ***
Total pot $2 | Rake $0 
Seat 1: cobrik23 folded before Flop (didn't bet)
Seat 2: kirki000 folded before Flop (didn't bet)
Seat 3: matiko09 folded before Flop (didn't bet)
Seat 4: nuuaber folded before Flop (didn't bet)
Seat 5: sanr23 folded before Flop (didn't bet)
Seat 6: Bimaxa (button) folded before Flop (didn't bet)
Seat 7: djammusic (small blind) collected ($2)
Seat 8: aseban11 (big blind) folded before Flop
Seat 9: florrin92 folded before Flop (didn't bet)





PokerStars Hand #153500558437:  Hold'em No Limit ($0.50/$1.00 USD) - 2016/05/18 19:56:49 CET [2016/05/18 13:56:49 ET]
Table 'Saiph II' 9-max Seat #6 is the button
Seat 2: matiko09 ($100 in chips) 
Seat 3: lydia12345 ($104.12 in chips) 
Seat 4: Bimaxa ($106.54 in chips) 
Seat 6: LadyMaCe86 ($105.50 in chips) 
Seat 8: sanr23 ($100 in chips) 
sanr23: posts small blind $0.50
chris.99.741: is sitting out 
matiko09: posts big blind $1
*** HOLE CARDS ***
Dealt to matiko09 [Qh Ah]
lydia12345: folds 
lydia12345 leaves the table
chris.99.741 leaves the table
Bimaxa: raises $2 to $3
alesi007 joins the table at seat #9 
LadyMaCe86: folds 
sanr23: folds 
ipashutapkom joins the table at seat #1 
matiko09: raises $7 to $10
cobrik23 joins the table at seat #5 
Bimaxa: folds 
Uncalled bet ($7) returned to matiko09
matiko09 collected $6.50 from pot
matiko09: doesn't show hand 
*** SUMMARY ***
Total pot $6.50 | Rake $0 
Seat 2: matiko09 (big blind) collected ($6.50)
Seat 3: lydia12345 folded before Flop (didn't bet)
Seat 4: Bimaxa folded before Flop
Seat 6: LadyMaCe86 (button) folded before Flop (didn't bet)
Seat 8: sanr23 (small blind) folded before Flop





PokerStars Hand #153500560105:  Hold'em No Limit ($1/$2 USD) - 2016/05/18 19:56:52 CET [2016/05/18 13:56:52 ET]
Table 'Letaba' 9-max Seat #6 is the button
Seat 1: FREDY BULLIT ($200 in chips) 
Seat 2: staruk669 ($142.96 in chips) 
Seat 3: ersevi6 ($191.44 in chips) 
Seat 4: matiko09 ($211.20 in chips) 
Seat 5: aseban11 ($200 in chips) 
Seat 6: donald0404 ($200 in chips) 
Seat 7: moshmachine ($254.66 in chips) 
Seat 8: $-Twackle-$ ($219.88 in chips) 
Seat 9: tepi_guy ($237.20 in chips) 
moshmachine: posts small blind $1
$-Twackle-$: posts big blind $2
*** HOLE CARDS ***
Dealt to matiko09 [Th 9h]
tepi_guy: folds 
FREDY BULLIT: folds 
staruk669: calls $2
ersevi6: folds 
matiko09: raises $6 to $8
aseban11: folds 
donald0404: raises $14 to $22
moshmachine: folds 
$-Twackle-$: folds 
staruk669: raises $14 to $36
matiko09: folds 
donald0404: calls $14
*** FLOP *** [7h Ac Qh]
staruk669: checks 
donald0404: bets $68.21
staruk669: folds 
Uncalled bet ($68.21) returned to donald0404
donald0404 collected $80.25 from pot
donald0404: doesn't show hand 
*** SUMMARY ***
Total pot $83 | Rake $2.75 
Board [7h Ac Qh]
Seat 1: FREDY BULLIT folded before Flop (didn't bet)
Seat 2: staruk669 folded on the Flop
Seat 3: ersevi6 folded before Flop (didn't bet)
Seat 4: matiko09 folded before Flop
Seat 5: aseban11 folded before Flop (didn't bet)
Seat 6: donald0404 (button) collected ($80.25)
Seat 7: moshmachine (small blind) folded before Flop
Seat 8: $-Twackle-$ (big blind) folded before Flop
Seat 9: tepi_guy folded before Flop (didn't bet)





PokerStars Hand #153500561801:  Hold'em No Limit (€0.50/€1.00 EUR) - 2016/05/18 19:56:55 CET [2016/05/18 13:56:55 ET]
Table 'Pallas II' 9-max Seat #5 is the button
Seat 1: florrin92 (€100 in chips) 
Seat 2: matiko09 (€221.95 in chips) 
Seat 3: nickreason17 (€100 in chips) 
Seat 4: torkkdnm (€115.80 in chips) 
Seat 5: cobrik23 (€61.12 in chips) 
Seat 6: STrakDD (€100 in chips) 
Seat 7: ipashutapkom (€40 in chips) 
Seat 8: lydia12345 (€100 in chips) 
Seat 9: stijner1986 (€86.11 in chips) 
STrakDD: posts small blind €0.50
ipashutapkom: posts big blind €1
*** HOLE CARDS ***
Dealt to matiko09 [2d 6c]
lydia12345: folds 
stijner1986: raises €1 to €2
florrin92: folds 
matiko09: folds 
nickreason17: folds 
torkkdnm: folds 
cobrik23: folds 
STrakDD: folds 
ipashutapkom: calls €1
*** FLOP *** [3c 9c 3h]
ipashutapkom: checks 
stijner1986: checks 
*** TURN *** [3c 9c 3h] [8c]
ipashutapkom: bets €2.87
stijner1986: folds 
Uncalled bet (€2.87) returned to ipashutapkom
ipashutapkom collected €4.28 from pot
ipashutapkom: doesn't show hand 
*** SUMMARY ***
Total pot €4.50 | Rake €0.22 
Board [3c 9c 3h 8c]
Seat 1: florrin92 folded before Flop (didn't bet)
Seat 2: matiko09 folded before Flop (didn't bet)
Seat 3: nickreason17 folded before Flop (didn't bet)
Seat 4: torkkdnm folded before Flop (didn't bet)
Seat 5: cobrik23 (button) folded before Flop (didn't bet)
Seat 6: STrakDD (small blind) folded before Flop
Seat 7: ipashutapkom (big blind) collected (€4.28)
Seat 8: lydia12345 folded before Flop (didn't bet)
Seat 9: stijner1986 folded on the Turn





PokerStars Hand #153500578529:  Hold'em No Limit ($1/$2 USD) - 2016/05/18 19:57:21 CET [2016/05/18 13:57:21 ET]
Table 'Chlosinde' 9-max Seat #8 is the button
Seat 1: ersevi6 ($182.29 in chips) 
Seat 2: aseban11 ($203 in chips) 
Seat 3: matiko09 ($200 in chips) 
Seat 4: FREDY BULLIT ($200 in chips) 
Seat 5: tepi_guy ($652.69 in chips) 
Seat 6: slick_nickDH ($415.56 in chips) 
Seat 7: donald0404 ($200 in chips) 
Seat 8: sanducu_eu ($227.67 in chips) 
Seat 9: Tey113 ($429.54 in chips) 
Tey113: posts small blind $1
ersevi6: posts big blind $2
*** HOLE CARDS ***
Dealt to matiko09 [Ah 3c]
aseban11: raises $4 to $6
matiko09: folds 
FREDY BULLIT: folds 
tepi_guy: folds 
slick_nickDH: folds 
donald0404: folds 
sanducu_eu: folds 
Tey113: calls $5
ersevi6: calls $4
*** FLOP *** [Ts Qs 3h]
Tey113: checks 
ersevi6: checks 
aseban11: checks 
*** TURN *** [Ts Qs 3h] [8h]
Tey113: bets $4
ersevi6: calls $4
aseban11: folds 
*** RIVER *** [Ts Qs 3h 8h] [3s]
Tey113: checks 
ersevi6: checks 
*** SHOW DOWN ***
Tey113: shows [Qd 5d] (two pair, Queens and Threes)
ersevi6: mucks hand 
Tey113 collected $24.70 from pot
*** SUMMARY ***
Total pot $26 | Rake $1.30 
Board [Ts Qs 3h 8h 3s]
Seat 1: ersevi6 (big blind) mucked [8d 9d]
Seat 2: aseban11 folded on the Turn
Seat 3: matiko09 folded before Flop (didn't bet)
Seat 4: FREDY BULLIT folded before Flop (didn't bet)
Seat 5: tepi_guy folded before Flop (didn't bet)
Seat 6: slick_nickDH folded before Flop (didn't bet)
Seat 7: donald0404 folded before Flop (didn't bet)
Seat 8: sanducu_eu (button) folded before Flop (didn't bet)
Seat 9: Tey113 (small blind) showed [Qd 5d] and won ($24.70) with two pair, Queens and Threes





PokerStars Hand #153500581819:  Hold'em No Limit ($0.50/$1.00 USD) - 2016/05/18 19:57:26 CET [2016/05/18 13:57:26 ET]
Table 'Tatjana III' 9-max Seat #7 is the button
Seat 1: cobrik23 ($43.22 in chips) 
Seat 2: kirki000 ($127.72 in chips) 
Seat 3: matiko09 ($100 in chips) 
Seat 4: nuuaber ($160.94 in chips) 
Seat 5: sanr23 ($126.75 in chips) 
Seat 6: Bimaxa ($100 in chips) 
Seat 7: djammusic ($38.12 in chips) 
Seat 8: aseban11 ($100 in chips) 
Seat 9: florrin92 ($100 in chips) 
aseban11: posts small blind $0.50
florrin92: posts big blind $1
*** HOLE CARDS ***
Dealt to matiko09 [3h 3c]
cobrik23: folds 
kirki000: folds 
matiko09: raises $2 to $3
nuuaber: folds 
sanr23: folds 
Bimaxa: folds 
djammusic: folds 
aseban11: folds 
florrin92: folds 
Uncalled bet ($2) returned to matiko09
matiko09 collected $2.50 from pot
matiko09: doesn't show hand 
*** SUMMARY ***
Total pot $2.50 | Rake $0 
Seat 1: cobrik23 folded before Flop (didn't bet)
Seat 2: kirki000 folded before Flop (didn't bet)
Seat 3: matiko09 collected ($2.50)
Seat 4: nuuaber folded before Flop (didn't bet)
Seat 5: sanr23 folded before Flop (didn't bet)
Seat 6: Bimaxa folded before Flop (didn't bet)
Seat 7: djammusic (button) folded before Flop (didn't bet)
Seat 8: aseban11 (small blind) folded before Flop
Seat 9: florrin92 (big blind) folded before Flop





PokerStars Hand #153500591256:  Hold'em No Limit ($0.50/$1.00 USD) - 2016/05/18 19:57:41 CET [2016/05/18 13:57:41 ET]
Table 'Saiph II' 9-max Seat #8 is the button
Seat 2: matiko09 ($103.50 in chips) 
Seat 5: cobrik23 ($43 in chips) 
Seat 6: LadyMaCe86 ($105.50 in chips) 
Seat 8: sanr23 ($100 in chips) 
alesi007 will be allowed to play after the button
ipashutapkom will be allowed to play after the button
matiko09: posts small blind $0.50
Bimaxa: is sitting out 
cobrik23: posts big blind $1
*** HOLE CARDS ***
Dealt to matiko09 [Th 8c]
LadyMaCe86: folds 
Bimaxa leaves the table
sanr23: folds 
matiko09: folds 
Uncalled bet ($0.50) returned to cobrik23
cobrik23 collected $1 from pot
cobrik23: doesn't show hand 
*** SUMMARY ***
Total pot $1 | Rake $0 
Seat 2: matiko09 (small blind) folded before Flop
Seat 5: cobrik23 (big blind) collected ($1)
Seat 6: LadyMaCe86 folded before Flop (didn't bet)
Seat 8: sanr23 (button) folded before Flop (didn't bet)





PokerStars Hand #153500596290:  Hold'em No Limit ($0.50/$1.00 USD) - 2016/05/18 19:57:48 CET [2016/05/18 13:57:48 ET]
Table 'Abetti II' 9-max Seat #2 is the button
Seat 1: matiko09 ($100 in chips) 
Seat 2: Bimaxa ($130.39 in chips) 
Seat 3: cobrik23 ($254.87 in chips) 
Seat 4: aseban11 ($100 in chips) 
Seat 5: blufthenuts ($123.12 in chips) 
Seat 6: I The King I ($147.14 in chips) 
Seat 7: nickreason17 ($100.92 in chips) 
Seat 8: roadster683 ($138.91 in chips) 
Seat 9: florrin92 ($100 in chips) 
cobrik23: posts small blind $0.50
aseban11: posts big blind $1
*** HOLE CARDS ***
Dealt to matiko09 [Td Qh]
blufthenuts: folds 
I The King I: folds 
nickreason17: folds 
roadster683: calls $1
florrin92: folds 
matiko09: raises $3 to $4
Bimaxa: folds 
cobrik23: raises $7 to $11
aseban11: folds 
roadster683: folds 
matiko09: folds 
Uncalled bet ($7) returned to cobrik23
cobrik23 collected $10 from pot
cobrik23: doesn't show hand 
*** SUMMARY ***
Total pot $10 | Rake $0 
Seat 1: matiko09 folded before Flop
Seat 2: Bimaxa (button) folded before Flop (didn't bet)
Seat 3: cobrik23 (small blind) collected ($10)
Seat 4: aseban11 (big blind) folded before Flop
Seat 5: blufthenuts folded before Flop (didn't bet)
Seat 6: I The King I folded before Flop (didn't bet)
Seat 7: nickreason17 folded before Flop (didn't bet)
Seat 8: roadster683 folded before Flop
Seat 9: florrin92 folded before Flop (didn't bet)





PokerStars Hand #153500597905:  Hold'em No Limit ($0.50/$1.00 USD) - 2016/05/18 19:57:51 CET [2016/05/18 13:57:51 ET]
Table 'Saiph II' 9-max Seat #2 is the button
Seat 2: matiko09 ($103 in chips) 
Seat 5: cobrik23 ($43.50 in chips) 
Seat 9: alesi007 ($61.46 in chips) 
cobrik23: posts small blind $0.50
LadyMaCe86: is sitting out 
sanr23: is sitting out 
alesi007: posts big blind $1
ipashutapkom: sits out 
*** HOLE CARDS ***
Dealt to matiko09 [7c Tc]
matiko09: raises $1.27 to $2.27
cobrik23: folds 
lydia12345 joins the table at seat #3 
alesi007: raises $2.27 to $4.54
dr_mraz1 joins the table at seat #4 
matiko09: calls $2.27
*** FLOP *** [5c 4c 4d]
alesi007: bets $4
matiko09: calls $4
*** TURN *** [5c 4c 4d] [3c]
alesi007: bets $5
matiko09: raises $13.88 to $18.88
alesi007: calls $13.88
*** RIVER *** [5c 4c 4d 3c] [Js]
alesi007: checks 
matiko09: bets $35
alesi007: folds 
Uncalled bet ($35) returned to matiko09
matiko09 collected $54.34 from pot
matiko09: doesn't show hand 
*** SUMMARY ***
Total pot $55.34 | Rake $1 
Board [5c 4c 4d 3c Js]
Seat 2: matiko09 (button) collected ($54.34)
Seat 5: cobrik23 (small blind) folded before Flop
Seat 9: alesi007 (big blind) folded on the River





PokerStars Hand #153500599942:  Hold'em No Limit ($0.50/$1.00 USD) - 2016/05/18 19:57:54 CET [2016/05/18 13:57:54 ET]
Table 'Tatjana III' 9-max Seat #8 is the button
Seat 1: cobrik23 ($43.22 in chips) 
Seat 2: kirki000 ($127.72 in chips) 
Seat 3: matiko09 ($101.50 in chips) 
Seat 4: nuuaber ($160.94 in chips) 
Seat 5: sanr23 ($126.75 in chips) 
Seat 6: Bimaxa ($100 in chips) 
Seat 7: djammusic ($38.12 in chips) 
Seat 8: aseban11 ($100 in chips) 
Seat 9: florrin92 ($100 in chips) 
florrin92: posts small blind $0.50
cobrik23: posts big blind $1
*** HOLE CARDS ***
Dealt to matiko09 [5s 3c]
kirki000: folds 
matiko09: folds 
nuuaber: folds 
sanr23: folds 
Bimaxa: folds 
djammusic: folds 
aseban11: folds 
florrin92: folds 
Uncalled bet ($0.50) returned to cobrik23
cobrik23 collected $1 from pot
cobrik23: doesn't show hand 
*** SUMMARY ***
Total pot $1 | Rake $0 
Seat 1: cobrik23 (big blind) collected ($1)
Seat 2: kirki000 folded before Flop (didn't bet)
Seat 3: matiko09 folded before Flop (didn't bet)
Seat 4: nuuaber folded before Flop (didn't bet)
Seat 5: sanr23 folded before Flop (didn't bet)
Seat 6: Bimaxa folded before Flop (didn't bet)
Seat 7: djammusic folded before Flop (didn't bet)
Seat 8: aseban11 (button) folded before Flop (didn't bet)
Seat 9: florrin92 (small blind) folded before Flop





PokerStars Hand #153500601045:  Hold'em No Limit (€0.50/€1.00 EUR) - 2016/05/18 19:57:56 CET [2016/05/18 13:57:56 ET]
Table 'Pallas II' 9-max Seat #6 is the button
Seat 1: florrin92 (€100 in chips) 
Seat 2: matiko09 (€221.95 in chips) 
Seat 3: nickreason17 (€100 in chips) 
Seat 4: torkkdnm (€115.80 in chips) 
Seat 5: cobrik23 (€61.12 in chips) 
Seat 6: STrakDD (€100 in chips) 
Seat 7: ipashutapkom (€42.28 in chips) 
Seat 8: lydia12345 (€100 in chips) 
Seat 9: stijner1986 (€84.11 in chips) 
ipashutapkom: posts small blind €0.50
lydia12345: posts big blind €1
*** HOLE CARDS ***
Dealt to matiko09 [8d 7s]
stijner1986: folds 
florrin92: folds 
matiko09: folds 
nickreason17: folds 
torkkdnm: folds 
cobrik23: folds 
STrakDD: folds 
ipashutapkom: raises €1.73 to €2.73
lydia12345: raises €7.27 to €10
ipashutapkom: folds 
Uncalled bet (€7.27) returned to lydia12345
lydia12345 collected €5.46 from pot
*** SUMMARY ***
Total pot €5.46 | Rake €0 
Seat 1: florrin92 folded before Flop (didn't bet)
Seat 2: matiko09 folded before Flop (didn't bet)
Seat 3: nickreason17 folded before Flop (didn't bet)
Seat 4: torkkdnm folded before Flop (didn't bet)
Seat 5: cobrik23 folded before Flop (didn't bet)
Seat 6: STrakDD (button) folded before Flop (didn't bet)
Seat 7: ipashutapkom (small blind) folded before Flop
Seat 8: lydia12345 (big blind) collected (€5.46)
Seat 9: stijner1986 folded before Flop (didn't bet)





PokerStars Hand #153500615957:  Hold'em No Limit ($0.50/$1.00 USD) - 2016/05/18 19:58:18 CET [2016/05/18 13:58:18 ET]
Table 'Abetti II' 9-max Seat #3 is the button
Seat 1: matiko09 ($100 in chips) 
Seat 2: Bimaxa ($130.39 in chips) 
Seat 3: cobrik23 ($260.87 in chips) 
Seat 4: aseban11 ($100 in chips) 
Seat 5: blufthenuts ($123.12 in chips) 
Seat 6: I The King I ($147.14 in chips) 
Seat 7: nickreason17 ($100.92 in chips) 
Seat 8: roadster683 ($137.91 in chips) 
Seat 9: florrin92 ($100 in chips) 
aseban11: posts small blind $0.50
blufthenuts: posts big blind $1
*** HOLE CARDS ***
Dealt to matiko09 [5s Th]
I The King I: folds 
nickreason17: folds 
roadster683: calls $1
florrin92: folds 
matiko09: folds 
Bimaxa: folds 
cobrik23: folds 
aseban11: folds 
blufthenuts: checks 
*** FLOP *** [6c Qd 3c]
blufthenuts: checks 
roadster683: bets $2
blufthenuts: folds 
Uncalled bet ($2) returned to roadster683
roadster683 collected $2.38 from pot
roadster683: doesn't show hand 
*** SUMMARY ***
Total pot $2.50 | Rake $0.12 
Board [6c Qd 3c]
Seat 1: matiko09 folded before Flop (didn't bet)
Seat 2: Bimaxa folded before Flop (didn't bet)
Seat 3: cobrik23 (button) folded before Flop (didn't bet)
Seat 4: aseban11 (small blind) folded before Flop
Seat 5: blufthenuts (big blind) folded on the Flop
Seat 6: I The King I folded before Flop (didn't bet)
Seat 7: nickreason17 folded before Flop (didn't bet)
Seat 8: roadster683 collected ($2.38)
Seat 9: florrin92 folded before Flop (didn't bet)





PokerStars Hand #153500617292:  Hold'em No Limit ($0.50/$1.00 USD) - 2016/05/18 19:58:20 CET [2016/05/18 13:58:20 ET]
Table 'Tatjana III' 9-max Seat #9 is the button
Seat 1: cobrik23 ($43.72 in chips) 
Seat 2: kirki000 ($127.72 in chips) 
Seat 3: matiko09 ($101.50 in chips) 
Seat 4: nuuaber ($160.94 in chips) 
Seat 5: sanr23 ($126.75 in chips) 
Seat 6: Bimaxa ($100 in chips) 
Seat 7: djammusic ($38.12 in chips) 
Seat 8: aseban11 ($100 in chips) 
Seat 9: florrin92 ($100 in chips) 
cobrik23: posts small blind $0.50
kirki000: posts big blind $1
*** HOLE CARDS ***
Dealt to matiko09 [Kd Kc]
matiko09: raises $2 to $3
nuuaber: raises $3 to $6
sanr23: folds 
Bimaxa: folds 
djammusic: folds 
aseban11: folds 
florrin92: folds 
cobrik23: folds 
kirki000: folds 
matiko09: raises $11 to $17
nuuaber: calls $11
*** FLOP *** [Jh Jc 3s]
kirki000 leaves the table
HITYESCA joins the table at seat #2 
matiko09: bets $17.53
nuuaber: raises $25.47 to $43
matiko09: calls $25.47
*** TURN *** [Jh Jc 3s] [4c]
matiko09: checks 
nuuaber: bets $100.94 and is all-in
matiko09: calls $41.50 and is all-in
Uncalled bet ($59.44) returned to nuuaber
*** RIVER *** [Jh Jc 3s 4c] [2s]
*** SHOW DOWN ***
matiko09: shows [Kd Kc] (two pair, Kings and Jacks)
nuuaber: mucks hand 
matiko09 collected $202 from pot
*** SUMMARY ***
Total pot $204.50 | Rake $2.50 
Board [Jh Jc 3s 4c 2s]
Seat 1: cobrik23 (small blind) folded before Flop
Seat 2: kirki000 (big blind) folded before Flop
Seat 3: matiko09 showed [Kd Kc] and won ($202) with two pair, Kings and Jacks
Seat 4: nuuaber mucked [Tc Th]
Seat 5: sanr23 folded before Flop (didn't bet)
Seat 6: Bimaxa folded before Flop (didn't bet)
Seat 7: djammusic folded before Flop (didn't bet)
Seat 8: aseban11 folded before Flop (didn't bet)
Seat 9: florrin92 (button) folded before Flop (didn't bet)





PokerStars Hand #153500621039:  Hold'em No Limit ($1/$2 USD) - 2016/05/18 19:58:26 CET [2016/05/18 13:58:26 ET]
Table 'Chlosinde' 9-max Seat #9 is the button
Seat 1: ersevi6 ($172.29 in chips) 
Seat 2: aseban11 ($200 in chips) 
Seat 3: matiko09 ($200 in chips) 
Seat 4: FREDY BULLIT ($200 in chips) 
Seat 5: tepi_guy ($652.69 in chips) 
Seat 6: slick_nickDH ($415.56 in chips) 
Seat 7: donald0404 ($200 in chips) 
Seat 8: sanducu_eu ($227.67 in chips) 
Seat 9: Tey113 ($444.24 in chips) 
ersevi6: posts small blind $1
aseban11: posts big blind $2
*** HOLE CARDS ***
Dealt to matiko09 [9d Js]
matiko09: folds 
FREDY BULLIT: folds 
tepi_guy: folds 
slick_nickDH: folds 
donald0404: folds 
sanducu_eu: folds 
Tey113: folds 
ersevi6: raises $3 to $5
aseban11: calls $3
*** FLOP *** [Qc 4s 6d]
ersevi6: checks 
aseban11: checks 
*** TURN *** [Qc 4s 6d] [Jh]
ersevi6: checks 
aseban11: bets $4.75
ersevi6: folds 
Uncalled bet ($4.75) returned to aseban11
aseban11 collected $9.50 from pot
aseban11: doesn't show hand 
*** SUMMARY ***
Total pot $10 | Rake $0.50 
Board [Qc 4s 6d Jh]
Seat 1: ersevi6 (small blind) folded on the Turn
Seat 2: aseban11 (big blind) collected ($9.50)
Seat 3: matiko09 folded before Flop (didn't bet)
Seat 4: FREDY BULLIT folded before Flop (didn't bet)
Seat 5: tepi_guy folded before Flop (didn't bet)
Seat 6: slick_nickDH folded before Flop (didn't bet)
Seat 7: donald0404 folded before Flop (didn't bet)
Seat 8: sanducu_eu folded before Flop (didn't bet)
Seat 9: Tey113 (button) folded before Flop (didn't bet)





PokerStars Hand #153500627152:  Hold'em No Limit (€0.50/€1.00 EUR) - 2016/05/18 19:58:35 CET [2016/05/18 13:58:35 ET]
Table 'Pallas II' 9-max Seat #7 is the button
Seat 1: florrin92 (€100 in chips) 
Seat 2: matiko09 (€221.95 in chips) 
Seat 3: nickreason17 (€100 in chips) 
Seat 4: torkkdnm (€115.80 in chips) 
Seat 5: cobrik23 (€61.12 in chips) 
Seat 6: STrakDD (€100 in chips) 
Seat 7: ipashutapkom (€40 in chips) 
Seat 8: lydia12345 (€102.73 in chips) 
Seat 9: stijner1986 (€84.11 in chips) 
lydia12345: posts small blind €0.50
stijner1986: posts big blind €1
*** HOLE CARDS ***
Dealt to matiko09 [Ad 3h]
florrin92: raises €2 to €3
matiko09: folds 
nickreason17: folds 
torkkdnm: calls €3
cobrik23: folds 
STrakDD: folds 
ipashutapkom: folds 
lydia12345: folds 
stijner1986: folds 
*** FLOP *** [3c 4h Js]
florrin92: bets €4.50
torkkdnm: calls €4.50
*** TURN *** [3c 4h Js] [Th]
florrin92: bets €11
torkkdnm: raises €17 to €28
florrin92: folds 
Uncalled bet (€17) returned to torkkdnm
torkkdnm collected €36.58 from pot
*** SUMMARY ***
Total pot €38.50 | Rake €1.92 
Board [3c 4h Js Th]
Seat 1: florrin92 folded on the Turn
Seat 2: matiko09 folded before Flop (didn't bet)
Seat 3: nickreason17 folded before Flop (didn't bet)
Seat 4: torkkdnm collected (€36.58)
Seat 5: cobrik23 folded before Flop (didn't bet)
Seat 6: STrakDD folded before Flop (didn't bet)
Seat 7: ipashutapkom (button) folded before Flop (didn't bet)
Seat 8: lydia12345 (small blind) folded before Flop
Seat 9: stijner1986 (big blind) folded before Flop





PokerStars Hand #153500631420:  Hold'em No Limit ($0.50/$1.00 USD) - 2016/05/18 19:58:42 CET [2016/05/18 13:58:42 ET]
Table 'Abetti II' 9-max Seat #4 is the button
Seat 1: matiko09 ($100 in chips) 
Seat 2: Bimaxa ($130.39 in chips) 
Seat 3: cobrik23 ($260.87 in chips) 
Seat 4: aseban11 ($100 in chips) 
Seat 5: blufthenuts ($122.12 in chips) 
Seat 6: I The King I ($147.14 in chips) 
Seat 7: nickreason17 ($100.92 in chips) 
Seat 8: roadster683 ($139.29 in chips) 
Seat 9: florrin92 ($100 in chips) 
blufthenuts: posts small blind $0.50
I The King I: posts big blind $1
*** HOLE CARDS ***
Dealt to matiko09 [8s 9c]
nickreason17: folds 
roadster683: calls $1
florrin92: raises $3 to $4
matiko09: folds 
Bimaxa: folds 
cobrik23: folds 
aseban11: folds 
blufthenuts: folds 
I The King I: folds 
roadster683: calls $3
*** FLOP *** [7d Ks 3d]
roadster683: checks 
florrin92: checks 
*** TURN *** [7d Ks 3d] [8c]
roadster683: checks 
florrin92: bets $6.50
roadster683: folds 
Uncalled bet ($6.50) returned to florrin92
florrin92 collected $9.02 from pot
florrin92: doesn't show hand 
*** SUMMARY ***
Total pot $9.50 | Rake $0.48 
Board [7d Ks 3d 8c]
Seat 1: matiko09 folded before Flop (didn't bet)
Seat 2: Bimaxa folded before Flop (didn't bet)
Seat 3: cobrik23 folded before Flop (didn't bet)
Seat 4: aseban11 (button) folded before Flop (didn't bet)
Seat 5: blufthenuts (small blind) folded before Flop
Seat 6: I The King I (big blind) folded before Flop
Seat 7: nickreason17 folded before Flop (didn't bet)
Seat 8: roadster683 folded on the Turn
Seat 9: florrin92 collected ($9.02)





PokerStars Hand #153500634073:  Hold'em No Limit ($1/$2 USD) - 2016/05/18 19:58:46 CET [2016/05/18 13:58:46 ET]
Table 'Letaba' 9-max Seat #7 is the button
Seat 1: FREDY BULLIT ($200 in chips) 
Seat 2: staruk669 ($106.96 in chips) 
Seat 3: ersevi6 ($191.44 in chips) 
Seat 4: matiko09 ($203.20 in chips) 
Seat 5: aseban11 ($200 in chips) 
Seat 6: donald0404 ($244.25 in chips) 
Seat 7: moshmachine ($253.66 in chips) 
Seat 8: $-Twackle-$ ($217.88 in chips) 
Seat 9: tepi_guy ($237.20 in chips) 
$-Twackle-$: posts small blind $1
tepi_guy: posts big blind $2
*** HOLE CARDS ***
Dealt to matiko09 [Qh 8c]
FREDY BULLIT: folds 
staruk669: calls $2
ersevi6: raises $5 to $7
matiko09: folds 
aseban11: folds 
donald0404: folds 
moshmachine: folds 
$-Twackle-$: folds 
tepi_guy: folds 
staruk669: calls $5
*** FLOP *** [4c 4s 8h]
staruk669: checks 
ersevi6: bets $8.55
staruk669: folds 
Uncalled bet ($8.55) returned to ersevi6
ersevi6 collected $16.15 from pot
ersevi6: doesn't show hand 
*** SUMMARY ***
Total pot $17 | Rake $0.85 
Board [4c 4s 8h]
Seat 1: FREDY BULLIT folded before Flop (didn't bet)
Seat 2: staruk669 folded on the Flop
Seat 3: ersevi6 collected ($16.15)
Seat 4: matiko09 folded before Flop (didn't bet)
Seat 5: aseban11 folded before Flop (didn't bet)
Seat 6: donald0404 folded before Flop (didn't bet)
Seat 7: moshmachine (button) folded before Flop (didn't bet)
Seat 8: $-Twackle-$ (small blind) folded before Flop
Seat 9: tepi_guy (big blind) folded before Flop





PokerStars Hand #153500644191:  Hold'em No Limit ($0.50/$1.00 USD) - 2016/05/18 19:59:02 CET [2016/05/18 13:59:02 ET]
Table 'Saiph II' 9-max Seat #5 is the button
Seat 1: ipashutapkom ($40 in chips) 
Seat 2: matiko09 ($129.92 in chips) 
Seat 4: dr_mraz1 ($80 in chips) 
Seat 5: cobrik23 ($43 in chips) 
Seat 9: alesi007 ($34.04 in chips) 
nickreason17 will be allowed to play after the button
alesi007: posts small blind $0.50
ipashutapkom: posts big blind $1
lydia12345: sits out 
dr_mraz1: posts big blind $1
*** HOLE CARDS ***
Dealt to matiko09 [3d Jd]
matiko09: folds 
dr_mraz1: checks 
cobrik23: folds 
alesi007: folds 
ipashutapkom: checks 
*** FLOP *** [5h 4h Ah]
ipashutapkom: checks 
dr_mraz1: bets $1
ipashutapkom: raises $3.50 to $4.50
dr_mraz1: calls $3.50
*** TURN *** [5h 4h Ah] [2c]
ipashutapkom: bets $8.32
dr_mraz1: folds 
Uncalled bet ($8.32) returned to ipashutapkom
ipashutapkom collected $10.92 from pot
ipashutapkom: doesn't show hand 
*** SUMMARY ***
Total pot $11.50 | Rake $0.58 
Board [5h 4h Ah 2c]
Seat 1: ipashutapkom (big blind) collected ($10.92)
Seat 2: matiko09 folded before Flop (didn't bet)
Seat 4: dr_mraz1 folded on the Turn
Seat 5: cobrik23 (button) folded before Flop (didn't bet)
Seat 9: alesi007 (small blind) folded before Flop





PokerStars Hand #153500653760:  Hold'em No Limit ($1/$2 USD) - 2016/05/18 19:59:16 CET [2016/05/18 13:59:16 ET]
Table 'Chlosinde' 9-max Seat #1 is the button
Seat 1: ersevi6 ($167.29 in chips) 
Seat 2: aseban11 ($204.50 in chips) 
Seat 3: matiko09 ($200 in chips) 
Seat 4: FREDY BULLIT ($200 in chips) 
Seat 5: tepi_guy ($652.69 in chips) 
Seat 6: slick_nickDH ($415.56 in chips) 
Seat 7: donald0404 ($200 in chips) 
Seat 8: sanducu_eu ($227.67 in chips) 
Seat 9: Tey113 ($444.24 in chips) 
aseban11: posts small blind $1
matiko09: posts big blind $2
*** HOLE CARDS ***
Dealt to matiko09 [6c 9c]
FREDY BULLIT: raises $3.80 to $5.80
tepi_guy: folds 
slick_nickDH: folds 
donald0404: folds 
sanducu_eu: folds 
Tey113: folds 
ersevi6: folds 
aseban11: folds 
matiko09: folds 
Uncalled bet ($3.80) returned to FREDY BULLIT
FREDY BULLIT collected $5 from pot
FREDY BULLIT: doesn't show hand 
*** SUMMARY ***
Total pot $5 | Rake $0 
Seat 1: ersevi6 (button) folded before Flop (didn't bet)
Seat 2: aseban11 (small blind) folded before Flop
Seat 3: matiko09 (big blind) folded before Flop
Seat 4: FREDY BULLIT collected ($5)
Seat 5: tepi_guy folded before Flop (didn't bet)
Seat 6: slick_nickDH folded before Flop (didn't bet)
Seat 7: donald0404 folded before Flop (didn't bet)
Seat 8: sanducu_eu folded before Flop (didn't bet)
Seat 9: Tey113 folded before Flop (didn't bet)





PokerStars Hand #153500661771:  Hold'em No Limit ($1/$2 USD) - 2016/05/18 19:59:29 CET [2016/05/18 13:59:29 ET]
Table 'Letaba' 9-max Seat #8 is the button
Seat 1: FREDY BULLIT ($200 in chips) 
Seat 2: staruk669 ($99.96 in chips) 
Seat 3: ersevi6 ($200.59 in chips) 
Seat 4: matiko09 ($203.20 in chips) 
Seat 5: aseban11 ($200 in chips) 
Seat 6: donald0404 ($244.25 in chips) 
Seat 7: moshmachine ($253.66 in chips) 
Seat 8: $-Twackle-$ ($216.88 in chips) 
Seat 9: tepi_guy ($235.20 in chips) 
tepi_guy: posts small blind $1
FREDY BULLIT: posts big blind $2
*** HOLE CARDS ***
Dealt to matiko09 [3c 8c]
staruk669: calls $2
ersevi6: folds 
matiko09: folds 
aseban11: folds 
donald0404: folds 
moshmachine: folds 
$-Twackle-$: folds 
tepi_guy: raises $5.40 to $7.40
FREDY BULLIT: folds 
staruk669: calls $5.40
*** FLOP *** [7c Ac Tc]
tepi_guy: bets $9.21
staruk669: folds 
Uncalled bet ($9.21) returned to tepi_guy
tepi_guy collected $15.96 from pot
tepi_guy: doesn't show hand 
*** SUMMARY ***
Total pot $16.80 | Rake $0.84 
Board [7c Ac Tc]
Seat 1: FREDY BULLIT (big blind) folded before Flop
Seat 2: staruk669 folded on the Flop
Seat 3: ersevi6 folded before Flop (didn't bet)
Seat 4: matiko09 folded before Flop (didn't bet)
Seat 5: aseban11 folded before Flop (didn't bet)
Seat 6: donald0404 folded before Flop (didn't bet)
Seat 7: moshmachine folded before Flop (didn't bet)
Seat 8: $-Twackle-$ (button) folded before Flop (didn't bet)
Seat 9: tepi_guy (small blind) collected ($15.96)





PokerStars Hand #153500661991:  Hold'em No Limit ($0.50/$1.00 USD) - 2016/05/18 19:59:29 CET [2016/05/18 13:59:29 ET]
Table 'Saiph II' 9-max Seat #9 is the button
Seat 1: ipashutapkom ($45.42 in chips) 
Seat 2: matiko09 ($129.92 in chips) 
Seat 4: dr_mraz1 ($74.50 in chips) 
Seat 5: cobrik23 ($43 in chips) 
Seat 9: alesi007 ($33.54 in chips) 
ipashutapkom: posts small blind $0.50
matiko09: posts big blind $1
lydia12345: sits out 
nickreason17: sits out 
sanr23: sits out 
*** HOLE CARDS ***
Dealt to matiko09 [Ad Js]
dr_mraz1: calls $1
cobrik23: raises $3 to $4
alesi007: folds 
ipashutapkom: folds 
matiko09: folds 
dr_mraz1: raises $70.50 to $74.50 and is all-in
cobrik23: folds 
Uncalled bet ($70.50) returned to dr_mraz1
dr_mraz1 collected $9.50 from pot
dr_mraz1: doesn't show hand 
*** SUMMARY ***
Total pot $9.50 | Rake $0 
Seat 1: ipashutapkom (small blind) folded before Flop
Seat 2: matiko09 (big blind) folded before Flop
Seat 4: dr_mraz1 collected ($9.50)
Seat 5: cobrik23 folded before Flop
Seat 9: alesi007 (button) folded before Flop (didn't bet)





PokerStars Hand #153500662337:  Hold'em No Limit ($0.50/$1.00 USD) - 2016/05/18 19:59:30 CET [2016/05/18 13:59:30 ET]
Table 'Abetti II' 9-max Seat #5 is the button
Seat 1: matiko09 ($100 in chips) 
Seat 2: Bimaxa ($130.39 in chips) 
Seat 3: cobrik23 ($260.87 in chips) 
Seat 4: aseban11 ($100 in chips) 
Seat 5: blufthenuts ($121.62 in chips) 
Seat 6: I The King I ($146.14 in chips) 
Seat 7: nickreason17 ($100.92 in chips) 
Seat 8: roadster683 ($135.29 in chips) 
Seat 9: florrin92 ($105.02 in chips) 
I The King I: posts small blind $0.50
nickreason17: posts big blind $1
*** HOLE CARDS ***
Dealt to matiko09 [5h 9s]
roadster683: calls $1
florrin92: folds 
matiko09: folds 
Bimaxa: raises $3 to $4
cobrik23: folds 
aseban11: folds 
blufthenuts: calls $4
I The King I: folds 
nickreason17: folds 
roadster683: calls $3
*** FLOP *** [7h 8s 6h]
roadster683: checks 
Bimaxa: checks 
blufthenuts: checks 
*** TURN *** [7h 8s 6h] [Qd]
roadster683: checks 
Bimaxa: checks 
blufthenuts: bets $8.97
roadster683: calls $8.97
Bimaxa: folds 
*** RIVER *** [7h 8s 6h Qd] [Ac]
roadster683: checks 
blufthenuts: bets $21
roadster683: folds 
Uncalled bet ($21) returned to blufthenuts
blufthenuts collected $29.87 from pot
blufthenuts: doesn't show hand 
*** SUMMARY ***
Total pot $31.44 | Rake $1.57 
Board [7h 8s 6h Qd Ac]
Seat 1: matiko09 folded before Flop (didn't bet)
Seat 2: Bimaxa folded on the Turn
Seat 3: cobrik23 folded before Flop (didn't bet)
Seat 4: aseban11 folded before Flop (didn't bet)
Seat 5: blufthenuts (button) collected ($29.87)
Seat 6: I The King I (small blind) folded before Flop
Seat 7: nickreason17 (big blind) folded before Flop
Seat 8: roadster683 folded on the River
Seat 9: florrin92 folded before Flop (didn't bet)





PokerStars Hand #153500682405:  Hold'em No Limit ($0.50/$1.00 USD) - 2016/05/18 20:00:00 CET [2016/05/18 14:00:00 ET]
Table 'Saiph II' 9-max Seat #1 is the button
Seat 1: ipashutapkom ($44.92 in chips) 
Seat 2: matiko09 ($128.92 in chips) 
Seat 3: lydia12345 ($104.12 in chips) 
Seat 4: dr_mraz1 ($80 in chips) 
Seat 5: cobrik23 ($39 in chips) 
Seat 9: alesi007 ($33.54 in chips) 
matiko09: posts small blind $0.50
lydia12345: posts big blind $1
nickreason17: sits out 
sanr23: sits out 
*** HOLE CARDS ***
Dealt to matiko09 [4s Ac]
dr_mraz1: calls $1
cobrik23: folds 
alesi007: raises $2 to $3
ipashutapkom: folds 
matiko09: folds 
lydia12345: folds 
dr_mraz1 has timed out
dr_mraz1: folds 
Uncalled bet ($2) returned to alesi007
alesi007 collected $3.50 from pot
alesi007: doesn't show hand 
*** SUMMARY ***
Total pot $3.50 | Rake $0 
Seat 1: ipashutapkom (button) folded before Flop (didn't bet)
Seat 2: matiko09 (small blind) folded before Flop
Seat 3: lydia12345 (big blind) folded before Flop
Seat 4: dr_mraz1 folded before Flop
Seat 5: cobrik23 folded before Flop (didn't bet)
Seat 9: alesi007 collected ($3.50)





PokerStars Hand #153500682792:  Hold'em No Limit (€0.50/€1.00 EUR) - 2016/05/18 20:00:01 CET [2016/05/18 14:00:01 ET]
Table 'Pallas II' 9-max Seat #8 is the button
Seat 1: florrin92 (€100 in chips) 
Seat 2: matiko09 (€221.95 in chips) 
Seat 3: nickreason17 (€100 in chips) 
Seat 4: torkkdnm (€133.88 in chips) 
Seat 5: cobrik23 (€61.12 in chips) 
Seat 6: STrakDD (€100 in chips) 
Seat 7: ipashutapkom (€40 in chips) 
Seat 8: lydia12345 (€102.23 in chips) 
Seat 9: stijner1986 (€83.11 in chips) 
stijner1986: posts small blind €0.50
florrin92: posts big blind €1
*** HOLE CARDS ***
Dealt to matiko09 [3s Kd]
matiko09: folds 
nickreason17: raises €1.50 to €2.50
torkkdnm: raises €5.50 to €8
cobrik23: folds 
STrakDD: folds 
ipashutapkom: folds 
lydia12345: folds 
stijner1986: folds 
florrin92: folds 
nickreason17: folds 
Uncalled bet (€5.50) returned to torkkdnm
torkkdnm collected €6.50 from pot
*** SUMMARY ***
Total pot €6.50 | Rake €0 
Seat 1: florrin92 (big blind) folded before Flop
Seat 2: matiko09 folded before Flop (didn't bet)
Seat 3: nickreason17 folded before Flop
Seat 4: torkkdnm collected (€6.50)
Seat 5: cobrik23 folded before Flop (didn't bet)
Seat 6: STrakDD folded before Flop (didn't bet)
Seat 7: ipashutapkom folded before Flop (didn't bet)
Seat 8: lydia12345 (button) folded before Flop (didn't bet)
Seat 9: stijner1986 (small blind) folded before Flop





PokerStars Hand #153500688384:  Hold'em No Limit ($1/$2 USD) - 2016/05/18 20:00:08 CET [2016/05/18 14:00:08 ET]
Table 'Letaba' 9-max Seat #9 is the button
Seat 1: FREDY BULLIT ($200 in chips) 
Seat 2: staruk669 ($92.56 in chips) 
Seat 3: ersevi6 ($200.59 in chips) 
Seat 4: matiko09 ($203.20 in chips) 
Seat 5: aseban11 ($200 in chips) 
Seat 6: donald0404 ($244.25 in chips) 
Seat 7: moshmachine ($253.66 in chips) 
Seat 8: $-Twackle-$ ($216.88 in chips) 
Seat 9: tepi_guy ($243.76 in chips) 
FREDY BULLIT: posts small blind $1
staruk669: posts big blind $2
*** HOLE CARDS ***
Dealt to matiko09 [4d 5d]
ersevi6: folds 
matiko09: folds 
aseban11: folds 
donald0404: raises $3 to $5
moshmachine: folds 
$-Twackle-$: folds 
tepi_guy: folds 
FREDY BULLIT: folds 
staruk669: calls $3
*** FLOP *** [3h 3d 2c]
staruk669: checks 
donald0404: bets $5.23
staruk669: calls $5.23
*** TURN *** [3h 3d 2c] [Tc]
staruk669: checks 
donald0404: bets $10.60
staruk669: folds 
Uncalled bet ($10.60) returned to donald0404
donald0404 collected $20.39 from pot
*** SUMMARY ***
Total pot $21.46 | Rake $1.07 
Board [3h 3d 2c Tc]
Seat 1: FREDY BULLIT (small blind) folded before Flop
Seat 2: staruk669 (big blind) folded on the Turn
Seat 3: ersevi6 folded before Flop (didn't bet)
Seat 4: matiko09 folded before Flop (didn't bet)
Seat 5: aseban11 folded before Flop (didn't bet)
Seat 6: donald0404 collected ($20.39)
Seat 7: moshmachine folded before Flop (didn't bet)
Seat 8: $-Twackle-$ folded before Flop (didn't bet)
Seat 9: tepi_guy (button) folded before Flop (didn't bet)





PokerStars Hand #153500694232:  Hold'em No Limit ($1/$2 USD) - 2016/05/18 20:00:17 CET [2016/05/18 14:00:17 ET]
Table 'Chlosinde' 9-max Seat #2 is the button
Seat 1: ersevi6 ($167.29 in chips) 
Seat 2: aseban11 ($203.50 in chips) 
Seat 3: matiko09 ($200 in chips) 
Seat 4: FREDY BULLIT ($203 in chips) 
Seat 5: tepi_guy ($652.69 in chips) 
Seat 6: slick_nickDH ($415.56 in chips) 
Seat 7: donald0404 ($200 in chips) 
Seat 8: sanducu_eu ($227.67 in chips) 
Seat 9: Tey113 ($444.24 in chips) 
matiko09: posts small blind $1
FREDY BULLIT: posts big blind $2
*** HOLE CARDS ***
Dealt to matiko09 [Kd Qh]
tepi_guy: folds 
slick_nickDH: raises $4 to $6
donald0404: folds 
sanducu_eu: folds 
Tey113: folds 
ersevi6: folds 
aseban11: folds 
matiko09: folds 
FREDY BULLIT: raises $15 to $21
slick_nickDH: calls $15
*** FLOP *** [3c Td 5h]
FREDY BULLIT: bets $13.48
slick_nickDH: folds 
Uncalled bet ($13.48) returned to FREDY BULLIT
FREDY BULLIT collected $40.85 from pot
FREDY BULLIT: doesn't show hand 
*** SUMMARY ***
Total pot $43 | Rake $2.15 
Board [3c Td 5h]
Seat 1: ersevi6 folded before Flop (didn't bet)
Seat 2: aseban11 (button) folded before Flop (didn't bet)
Seat 3: matiko09 (small blind) folded before Flop
Seat 4: FREDY BULLIT (big blind) collected ($40.85)
Seat 5: tepi_guy folded before Flop (didn't bet)
Seat 6: slick_nickDH folded on the Flop
Seat 7: donald0404 folded before Flop (didn't bet)
Seat 8: sanducu_eu folded before Flop (didn't bet)
Seat 9: Tey113 folded before Flop (didn't bet)





PokerStars Hand #153500704034:  Hold'em No Limit ($0.50/$1.00 USD) - 2016/05/18 20:00:32 CET [2016/05/18 14:00:32 ET]
Table 'Tatjana III' 9-max Seat #1 is the button
Seat 1: cobrik23 ($43.22 in chips) 
Seat 3: matiko09 ($202 in chips) 
Seat 4: nuuaber ($59.44 in chips) 
Seat 5: sanr23 ($126.75 in chips) 
Seat 6: Bimaxa ($100 in chips) 
Seat 7: djammusic ($38.12 in chips) 
Seat 8: aseban11 ($100 in chips) 
Seat 9: florrin92 ($100 in chips) 
HITYESCA will be allowed to play after the button
matiko09: posts small blind $0.50
nuuaber: posts big blind $1
*** HOLE CARDS ***
Dealt to matiko09 [5d 9c]
sanr23: folds 
Bimaxa: folds 
djammusic: folds 
aseban11: folds 
florrin92: folds 
cobrik23: folds 
matiko09: folds 
Uncalled bet ($0.50) returned to nuuaber
nuuaber collected $1 from pot
nuuaber: doesn't show hand 
*** SUMMARY ***
Total pot $1 | Rake $0 
Seat 1: cobrik23 (button) folded before Flop (didn't bet)
Seat 3: matiko09 (small blind) folded before Flop
Seat 4: nuuaber (big blind) collected ($1)
Seat 5: sanr23 folded before Flop (didn't bet)
Seat 6: Bimaxa folded before Flop (didn't bet)
Seat 7: djammusic folded before Flop (didn't bet)
Seat 8: aseban11 folded before Flop (didn't bet)
Seat 9: florrin92 folded before Flop (didn't bet)





PokerStars Hand #153500707985:  Hold'em No Limit ($0.50/$1.00 USD) - 2016/05/18 20:00:38 CET [2016/05/18 14:00:38 ET]
Table 'Abetti II' 9-max Seat #6 is the button
Seat 1: matiko09 ($100 in chips) 
Seat 2: Bimaxa ($126.39 in chips) 
Seat 3: cobrik23 ($260.87 in chips) 
Seat 4: aseban11 ($100 in chips) 
Seat 5: blufthenuts ($138.52 in chips) 
Seat 6: I The King I ($145.64 in chips) 
Seat 7: nickreason17 ($100 in chips) 
Seat 8: roadster683 ($122.32 in chips) 
Seat 9: florrin92 ($105.02 in chips) 
nickreason17: posts small blind $0.50
roadster683: posts big blind $1
*** HOLE CARDS ***
Dealt to matiko09 [Qd 9s]
florrin92: folds 
matiko09: folds 
Bimaxa: folds 
cobrik23: folds 
aseban11: folds 
blufthenuts: folds 
I The King I: folds 
nickreason17: folds 
Uncalled bet ($0.50) returned to roadster683
roadster683 collected $1 from pot
roadster683: doesn't show hand 
*** SUMMARY ***
Total pot $1 | Rake $0 
Seat 1: matiko09 folded before Flop (didn't bet)
Seat 2: Bimaxa folded before Flop (didn't bet)
Seat 3: cobrik23 folded before Flop (didn't bet)
Seat 4: aseban11 folded before Flop (didn't bet)
Seat 5: blufthenuts folded before Flop (didn't bet)
Seat 6: I The King I (button) folded before Flop (didn't bet)
Seat 7: nickreason17 (small blind) folded before Flop
Seat 8: roadster683 (big blind) collected ($1)
Seat 9: florrin92 folded before Flop (didn't bet)





PokerStars Hand #153500712308:  Hold'em No Limit (€0.50/€1.00 EUR) - 2016/05/18 20:00:44 CET [2016/05/18 14:00:44 ET]
Table 'Pallas II' 9-max Seat #9 is the button
Seat 1: florrin92 (€100 in chips) 
Seat 2: matiko09 (€221.95 in chips) 
Seat 3: nickreason17 (€100 in chips) 
Seat 4: torkkdnm (€137.88 in chips) 
Seat 5: cobrik23 (€61.12 in chips) 
Seat 6: STrakDD (€100 in chips) 
Seat 7: ipashutapkom (€40 in chips) 
Seat 8: lydia12345 (€102.23 in chips) 
Seat 9: stijner1986 (€82.61 in chips) 
florrin92: posts small blind €0.50
matiko09: posts big blind €1
*** HOLE CARDS ***
Dealt to matiko09 [Js Jd]
nickreason17: raises €1.50 to €2.50
torkkdnm: folds 
cobrik23: folds 
STrakDD: raises €4.50 to €7
ipashutapkom: folds 
lydia12345: folds 
stijner1986: folds 
florrin92: folds 
matiko09: raises €10 to €17
nickreason17: folds 
STrakDD: calls €10
*** FLOP *** [Qh 3c 4h]
matiko09: checks 
STrakDD: bets €22.84
matiko09: folds 
Uncalled bet (€22.84) returned to STrakDD
STrakDD collected €35.15 from pot
STrakDD: doesn't show hand 
*** SUMMARY ***
Total pot €37 | Rake €1.85 
Board [Qh 3c 4h]
Seat 1: florrin92 (small blind) folded before Flop
Seat 2: matiko09 (big blind) folded on the Flop
Seat 3: nickreason17 folded before Flop
Seat 4: torkkdnm folded before Flop (didn't bet)
Seat 5: cobrik23 folded before Flop (didn't bet)
Seat 6: STrakDD collected (€35.15)
Seat 7: ipashutapkom folded before Flop (didn't bet)
Seat 8: lydia12345 folded before Flop (didn't bet)
Seat 9: stijner1986 (button) folded before Flop (didn't bet)





PokerStars Hand #153500725189:  Hold'em No Limit ($1/$2 USD) - 2016/05/18 20:01:01 CET [2016/05/18 14:01:01 ET]
Table 'Chlosinde' 9-max Seat #3 is the button
Seat 1: ersevi6 ($167.29 in chips) 
Seat 2: aseban11 ($203.50 in chips) 
Seat 3: matiko09 ($200 in chips) 
Seat 4: FREDY BULLIT ($222.85 in chips) 
Seat 5: tepi_guy ($652.69 in chips) 
Seat 6: slick_nickDH ($394.56 in chips) 
Seat 7: donald0404 ($200 in chips) 
Seat 8: sanducu_eu ($227.67 in chips) 
Seat 9: Tey113 ($444.24 in chips) 
FREDY BULLIT: posts small blind $1
tepi_guy: posts big blind $2
*** HOLE CARDS ***
Dealt to matiko09 [6d Jh]
slick_nickDH: folds 
donald0404: raises $4 to $6
sanducu_eu: folds 
Tey113: folds 
ersevi6: folds 
aseban11: folds 
matiko09: folds 
FREDY BULLIT: folds 
tepi_guy: folds 
Uncalled bet ($4) returned to donald0404
donald0404 collected $5 from pot
donald0404: doesn't show hand 
*** SUMMARY ***
Total pot $5 | Rake $0 
Seat 1: ersevi6 folded before Flop (didn't bet)
Seat 2: aseban11 folded before Flop (didn't bet)
Seat 3: matiko09 (button) folded before Flop (didn't bet)
Seat 4: FREDY BULLIT (small blind) folded before Flop
Seat 5: tepi_guy (big blind) folded before Flop
Seat 6: slick_nickDH folded before Flop (didn't bet)
Seat 7: donald0404 collected ($5)
Seat 8: sanducu_eu folded before Flop (didn't bet)
Seat 9: Tey113 folded before Flop (didn't bet)





PokerStars Hand #153500726518:  Hold'em No Limit ($0.50/$1.00 USD) - 2016/05/18 20:01:03 CET [2016/05/18 14:01:03 ET]
Table 'Tatjana III' 9-max Seat #3 is the button
Seat 1: cobrik23 ($43.22 in chips) 
Seat 3: matiko09 ($201.50 in chips) 
Seat 5: sanr23 ($126.75 in chips) 
Seat 6: Bimaxa ($100 in chips) 
Seat 7: djammusic ($38.12 in chips) 
Seat 8: aseban11 ($100 in chips) 
Seat 9: florrin92 ($100 in chips) 
sanr23: posts small blind $0.50
Bimaxa: posts big blind $1
HITYESCA: sits out 
*** HOLE CARDS ***
Dealt to matiko09 [3h 8d]
nuuaber leaves the table
djammusic: folds 
aseban11: folds 
florrin92: raises $2 to $3
cobrik23: folds 
djammusic leaves the table
matiko09: folds 
sanr23: raises $7 to $10
Bimaxa: folds 
florrin92: folds 
Uncalled bet ($7) returned to sanr23
sanr23 collected $7 from pot
sanr23: doesn't show hand 
rene1984tsv joins the table at seat #7 
*** SUMMARY ***
Total pot $7 | Rake $0 
Seat 1: cobrik23 folded before Flop (didn't bet)
Seat 3: matiko09 (button) folded before Flop (didn't bet)
Seat 5: sanr23 (small blind) collected ($7)
Seat 6: Bimaxa (big blind) folded before Flop
Seat 7: djammusic folded before Flop (didn't bet)
Seat 8: aseban11 folded before Flop (didn't bet)
Seat 9: florrin92 folded before Flop





PokerStars Hand #153500728333:  Hold'em No Limit ($0.50/$1.00 USD) - 2016/05/18 20:01:06 CET [2016/05/18 14:01:06 ET]
Table 'Abetti II' 9-max Seat #7 is the button
Seat 1: matiko09 ($100 in chips) 
Seat 2: Bimaxa ($126.39 in chips) 
Seat 3: cobrik23 ($260.87 in chips) 
Seat 4: aseban11 ($100 in chips) 
Seat 5: blufthenuts ($138.52 in chips) 
Seat 7: nickreason17 ($100 in chips) 
Seat 8: roadster683 ($122.82 in chips) 
Seat 9: florrin92 ($105.02 in chips) 
roadster683: posts small blind $0.50
florrin92: posts big blind $1
*** HOLE CARDS ***
Dealt to matiko09 [Qh 2s]
matiko09: folds 
Bimaxa: raises $2 to $3
cobrik23: folds 
aseban11: folds 
blufthenuts: folds 
nickreason17: calls $3
roadster683: calls $2.50
florrin92: folds 
*** FLOP *** [7c 3c Td]
roadster683: checks 
Bimaxa: checks 
nickreason17: bets $5
roadster683: calls $5
Bimaxa: folds 
*** TURN *** [7c 3c Td] [Ah]
roadster683: checks 
nickreason17: bets $13.38
roadster683: folds 
Uncalled bet ($13.38) returned to nickreason17
nickreason17 collected $19 from pot
*** SUMMARY ***
Total pot $20 | Rake $1 
Board [7c 3c Td Ah]
Seat 1: matiko09 folded before Flop (didn't bet)
Seat 2: Bimaxa folded on the Flop
Seat 3: cobrik23 folded before Flop (didn't bet)
Seat 4: aseban11 folded before Flop (didn't bet)
Seat 5: blufthenuts folded before Flop (didn't bet)
Seat 7: nickreason17 (button) collected ($19)
Seat 8: roadster683 (small blind) folded on the Turn
Seat 9: florrin92 (big blind) folded before Flop





PokerStars Hand #153500741348:  Hold'em No Limit ($1/$2 USD) - 2016/05/18 20:01:23 CET [2016/05/18 14:01:23 ET]
Table 'Letaba' 9-max Seat #1 is the button
Seat 1: FREDY BULLIT ($200 in chips) 
Seat 2: staruk669 ($82.33 in chips) 
Seat 3: ersevi6 ($200.59 in chips) 
Seat 4: matiko09 ($203.20 in chips) 
Seat 5: aseban11 ($200 in chips) 
Seat 6: donald0404 ($254.41 in chips) 
Seat 7: moshmachine ($253.66 in chips) 
Seat 8: $-Twackle-$ ($216.88 in chips) 
Seat 9: tepi_guy ($243.76 in chips) 
staruk669: posts small blind $1
ersevi6: posts big blind $2
*** HOLE CARDS ***
Dealt to matiko09 [9c Td]
matiko09: folds 
aseban11: folds 
donald0404: folds 
moshmachine: folds 
$-Twackle-$: folds 
tepi_guy: folds 
FREDY BULLIT: raises $3 to $5
staruk669: folds 
ersevi6: calls $3
*** FLOP *** [Qd 8h 2d]
ersevi6: checks 
FREDY BULLIT: checks 
*** TURN *** [Qd 8h 2d] [3s]
ersevi6: checks 
FREDY BULLIT: checks 
*** RIVER *** [Qd 8h 2d 3s] [4d]
ersevi6: checks 
FREDY BULLIT: checks 
*** SHOW DOWN ***
ersevi6: shows [3c Ad] (a pair of Threes)
FREDY BULLIT: mucks hand 
ersevi6 collected $10.45 from pot
*** SUMMARY ***
Total pot $11 | Rake $0.55 
Board [Qd 8h 2d 3s 4d]
Seat 1: FREDY BULLIT (button) mucked [Kh Ts]
Seat 2: staruk669 (small blind) folded before Flop
Seat 3: ersevi6 (big blind) showed [3c Ad] and won ($10.45) with a pair of Threes
Seat 4: matiko09 folded before Flop (didn't bet)
Seat 5: aseban11 folded before Flop (didn't bet)
Seat 6: donald0404 folded before Flop (didn't bet)
Seat 7: moshmachine folded before Flop (didn't bet)
Seat 8: $-Twackle-$ folded before Flop (didn't bet)
Seat 9: tepi_guy folded before Flop (didn't bet)





PokerStars Hand #153500743287:  Hold'em No Limit ($0.50/$1.00 USD) - 2016/05/18 20:01:25 CET [2016/05/18 14:01:25 ET]
Table 'Saiph II' 9-max Seat #2 is the button
Seat 1: ipashutapkom ($44.92 in chips) 
Seat 2: matiko09 ($128.42 in chips) 
Seat 3: lydia12345 ($103.12 in chips) 
Seat 5: cobrik23 ($39 in chips) 
Seat 9: alesi007 ($36.04 in chips) 
lydia12345: posts small blind $0.50
cobrik23: posts big blind $1
nickreason17: sits out 
sanr23: sits out 
*** HOLE CARDS ***
Dealt to matiko09 [5h 6h]
alesi007: folds 
ipashutapkom: raises $1.26 to $2.26
matiko09: folds 
lydia12345: folds 
cobrik23: folds 
Uncalled bet ($1.26) returned to ipashutapkom
ipashutapkom collected $2.50 from pot
ipashutapkom: doesn't show hand 
*** SUMMARY ***
Total pot $2.50 | Rake $0 
Seat 1: ipashutapkom collected ($2.50)
Seat 2: matiko09 (button) folded before Flop (didn't bet)
Seat 3: lydia12345 (small blind) folded before Flop
Seat 5: cobrik23 (big blind) folded before Flop
Seat 9: alesi007 folded before Flop (didn't bet)





PokerStars Hand #153500752991:  Hold'em No Limit ($1/$2 USD) - 2016/05/18 20:01:38 CET [2016/05/18 14:01:38 ET]
Table 'Chlosinde' 9-max Seat #4 is the button
Seat 1: ersevi6 ($167.29 in chips) 
Seat 2: aseban11 ($203.50 in chips) 
Seat 3: matiko09 ($200 in chips) 
Seat 4: FREDY BULLIT ($221.85 in chips) 
Seat 5: tepi_guy ($650.69 in chips) 
Seat 6: slick_nickDH ($394.56 in chips) 
Seat 7: donald0404 ($203 in chips) 
Seat 8: sanducu_eu ($227.67 in chips) 
Seat 9: Tey113 ($444.24 in chips) 
tepi_guy: posts small blind $1
slick_nickDH: posts big blind $2
*** HOLE CARDS ***
Dealt to matiko09 [2s Ah]
donald0404: folds 
sanducu_eu: folds 
Tey113: raises $3.54 to $5.54
ersevi6: raises $14.46 to $20
aseban11: folds 
matiko09: folds 
FREDY BULLIT: folds 
tepi_guy: folds 
slick_nickDH: folds 
Tey113: calls $14.46
*** FLOP *** [9s 3s 6h]
Tey113: bets $12
ersevi6: calls $12
*** TURN *** [9s 3s 6h] [5h]
Tey113: bets $48.98
ersevi6: calls $48.98
*** RIVER *** [9s 3s 6h 5h] [Kh]
Tey113: bets $363.26 and is all-in
ersevi6: calls $86.31 and is all-in
Uncalled bet ($276.95) returned to Tey113
*** SHOW DOWN ***
Tey113: shows [9c 9d] (three of a kind, Nines)
ersevi6: shows [Qs Qh] (a pair of Queens)
Tey113 collected $334.83 from pot
*** SUMMARY ***
Total pot $337.58 | Rake $2.75 
Board [9s 3s 6h 5h Kh]
Seat 1: ersevi6 showed [Qs Qh] and lost with a pair of Queens
Seat 2: aseban11 folded before Flop (didn't bet)
Seat 3: matiko09 folded before Flop (didn't bet)
Seat 4: FREDY BULLIT (button) folded before Flop (didn't bet)
Seat 5: tepi_guy (small blind) folded before Flop
Seat 6: slick_nickDH (big blind) folded before Flop
Seat 7: donald0404 folded before Flop (didn't bet)
Seat 8: sanducu_eu folded before Flop (didn't bet)
Seat 9: Tey113 showed [9c 9d] and won ($334.83) with three of a kind, Nines





PokerStars Hand #153500758080:  Hold'em No Limit ($0.50/$1.00 USD) - 2016/05/18 20:01:44 CET [2016/05/18 14:01:44 ET]
Table 'Saiph II' 9-max Seat #3 is the button
Seat 1: ipashutapkom ($46.42 in chips) 
Seat 2: matiko09 ($128.42 in chips) 
Seat 3: lydia12345 ($102.62 in chips) 
Seat 5: cobrik23 ($38 in chips) 
Seat 7: nickreason17 ($112.28 in chips) 
Seat 9: alesi007 ($36.04 in chips) 
cobrik23: posts small blind $0.50
nickreason17: posts big blind $1
sanr23: sits out 
*** HOLE CARDS ***
Dealt to matiko09 [4d 5s]
alesi007: folds 
ipashutapkom: raises $1.26 to $2.26
matiko09: folds 
lydia12345: folds 
cobrik23: calls $1.76
nickreason17: folds 
*** FLOP *** [6d 5c 4s]
cobrik23: checks 
ipashutapkom: bets $1.67
cobrik23: calls $1.67
*** TURN *** [6d 5c 4s] [9h]
cobrik23: checks 
ipashutapkom: checks 
*** RIVER *** [6d 5c 4s 9h] [2h]
cobrik23: checks 
ipashutapkom: checks 
*** SHOW DOWN ***
cobrik23: shows [Ad Js] (high card Ace)
ipashutapkom: mucks hand 
cobrik23 collected $8.42 from pot
*** SUMMARY ***
Total pot $8.86 | Rake $0.44 
Board [6d 5c 4s 9h 2h]
Seat 1: ipashutapkom mucked [Ks Jd]
Seat 2: matiko09 folded before Flop (didn't bet)
Seat 3: lydia12345 (button) folded before Flop (didn't bet)
Seat 5: cobrik23 (small blind) showed [Ad Js] and won ($8.42) with high card Ace
Seat 7: nickreason17 (big blind) folded before Flop
Seat 9: alesi007 folded before Flop (didn't bet)





PokerStars Hand #153500759982:  Hold'em No Limit ($0.50/$1.00 USD) - 2016/05/18 20:01:47 CET [2016/05/18 14:01:47 ET]
Table 'Tatjana III' 9-max Seat #5 is the button
Seat 1: cobrik23 ($43.22 in chips) 
Seat 3: matiko09 ($201.50 in chips) 
Seat 5: sanr23 ($130.75 in chips) 
Seat 6: Bimaxa ($100 in chips) 
Seat 7: rene1984tsv ($80 in chips) 
Seat 8: aseban11 ($100 in chips) 
Seat 9: florrin92 ($100 in chips) 
Bimaxa: posts small blind $0.50
rene1984tsv: posts big blind $1
HITYESCA: sits out 
*** HOLE CARDS ***
Dealt to matiko09 [9d Ad]
aseban11: folds 
lydia12345 joins the table at seat #4 
florrin92: raises $2 to $3
cobrik23: folds 
matiko09: raises $7 to $10
sanr23: folds 
Bimaxa: folds 
rene1984tsv: calls $9
florrin92: folds 
*** FLOP *** [4d 5s Qs]
rene1984tsv: checks 
matiko09: bets $11.60
rene1984tsv: calls $11.60
*** TURN *** [4d 5s Qs] [6h]
rene1984tsv: checks 
matiko09: checks 
*** RIVER *** [4d 5s Qs 6h] [Ks]
rene1984tsv: bets $4
matiko09: folds 
Uncalled bet ($4) returned to rene1984tsv
rene1984tsv collected $44.36 from pot
rene1984tsv: doesn't show hand 
*** SUMMARY ***
Total pot $46.70 | Rake $2.34 
Board [4d 5s Qs 6h Ks]
Seat 1: cobrik23 folded before Flop (didn't bet)
Seat 3: matiko09 folded on the River
Seat 5: sanr23 (button) folded before Flop (didn't bet)
Seat 6: Bimaxa (small blind) folded before Flop
Seat 7: rene1984tsv (big blind) collected ($44.36)
Seat 8: aseban11 folded before Flop (didn't bet)
Seat 9: florrin92 folded before Flop





PokerStars Hand #153500791563:  Hold'em No Limit ($1/$2 USD) - 2016/05/18 20:02:25 CET [2016/05/18 14:02:25 ET]
Table 'Letaba' 9-max Seat #2 is the button
Seat 1: FREDY BULLIT ($200 in chips) 
Seat 2: staruk669 ($81.33 in chips) 
Seat 3: ersevi6 ($206.04 in chips) 
Seat 4: matiko09 ($203.20 in chips) 
Seat 5: aseban11 ($200 in chips) 
Seat 6: donald0404 ($254.41 in chips) 
Seat 7: moshmachine ($253.66 in chips) 
Seat 8: $-Twackle-$ ($216.88 in chips) 
Seat 9: tepi_guy ($243.76 in chips) 
ersevi6: posts small blind $1
matiko09: posts big blind $2
*** HOLE CARDS ***
Dealt to matiko09 [Qc 2c]
aseban11: folds 
donald0404: raises $3 to $5
moshmachine: calls $5
$-Twackle-$: folds 
tepi_guy: folds 
FREDY BULLIT: folds 
staruk669: calls $5
ersevi6: folds 
matiko09: folds 
*** FLOP *** [Qd Tc Kc]
donald0404: bets $10.94
moshmachine: raises $25.72 to $36.66
staruk669: folds 
donald0404: calls $25.72
*** TURN *** [Qd Tc Kc] [Th]
donald0404: checks 
moshmachine: checks 
*** RIVER *** [Qd Tc Kc Th] [7c]
donald0404: checks 
moshmachine: checks 
*** SHOW DOWN ***
donald0404: shows [Ts Jd] (three of a kind, Tens)
moshmachine: shows [As Js] (a straight, Ten to Ace)
moshmachine collected $88.57 from pot
*** SUMMARY ***
Total pot $91.32 | Rake $2.75 
Board [Qd Tc Kc Th 7c]
Seat 1: FREDY BULLIT folded before Flop (didn't bet)
Seat 2: staruk669 (button) folded on the Flop
Seat 3: ersevi6 (small blind) folded before Flop
Seat 4: matiko09 (big blind) folded before Flop
Seat 5: aseban11 folded before Flop (didn't bet)
Seat 6: donald0404 showed [Ts Jd] and lost with three of a kind, Tens
Seat 7: moshmachine showed [As Js] and won ($88.57) with a straight, Ten to Ace
Seat 8: $-Twackle-$ folded before Flop (didn't bet)
Seat 9: tepi_guy folded before Flop (didn't bet)





PokerStars Hand #153500796830:  Hold'em No Limit ($0.50/$1.00 USD) - 2016/05/18 20:02:32 CET [2016/05/18 14:02:32 ET]
Table 'Abetti II' 9-max Seat #8 is the button
Seat 1: matiko09 ($100 in chips) 
Seat 2: Bimaxa ($123.39 in chips) 
Seat 3: cobrik23 ($260.87 in chips) 
Seat 4: aseban11 ($100 in chips) 
Seat 5: blufthenuts ($138.52 in chips) 
Seat 7: nickreason17 ($111 in chips) 
Seat 8: roadster683 ($114.82 in chips) 
Seat 9: florrin92 ($104.02 in chips) 
florrin92: posts small blind $0.50
matiko09: posts big blind $1
*** HOLE CARDS ***
Dealt to matiko09 [9d 6h]
Bimaxa: raises $2 to $3
cobrik23: folds 
aseban11: folds 
blufthenuts: folds 
nickreason17: folds 
roadster683: folds 
florrin92: raises $2 to $5
matiko09: folds 
Bimaxa: calls $2
*** FLOP *** [Qc 7h Jd]
florrin92: checks 
Bimaxa: checks 
*** TURN *** [Qc 7h Jd] [As]
florrin92: checks 
Bimaxa: bets $5.22
florrin92: folds 
Uncalled bet ($5.22) returned to Bimaxa
Bimaxa collected $10.45 from pot
Bimaxa: doesn't show hand 
*** SUMMARY ***
Total pot $11 | Rake $0.55 
Board [Qc 7h Jd As]
Seat 1: matiko09 (big blind) folded before Flop
Seat 2: Bimaxa collected ($10.45)
Seat 3: cobrik23 folded before Flop (didn't bet)
Seat 4: aseban11 folded before Flop (didn't bet)
Seat 5: blufthenuts folded before Flop (didn't bet)
Seat 7: nickreason17 folded before Flop (didn't bet)
Seat 8: roadster683 (button) folded before Flop (didn't bet)
Seat 9: florrin92 (small blind) folded on the Turn





PokerStars Hand #153500800841:  Hold'em No Limit (€0.50/€1.00 EUR) - 2016/05/18 20:02:37 CET [2016/05/18 14:02:37 ET]
Table 'Pallas II' 9-max Seat #1 is the button
Seat 1: florrin92 (€100 in chips) 
Seat 2: matiko09 (€204.95 in chips) 
Seat 3: nickreason17 (€100 in chips) 
Seat 4: torkkdnm (€137.88 in chips) 
Seat 5: cobrik23 (€61.12 in chips) 
Seat 6: STrakDD (€118.15 in chips) 
Seat 7: ipashutapkom (€40 in chips) 
Seat 8: lydia12345 (€102.23 in chips) 
Seat 9: stijner1986 (€82.61 in chips) 
matiko09: posts small blind €0.50
nickreason17: posts big blind €1
*** HOLE CARDS ***
Dealt to matiko09 [3d 9d]
torkkdnm: folds 
cobrik23: raises €2 to €3
STrakDD: folds 
ipashutapkom: folds 
lydia12345: folds 
stijner1986: folds 
florrin92: folds 
matiko09: folds 
nickreason17: folds 
Uncalled bet (€2) returned to cobrik23
cobrik23 collected €2.50 from pot
cobrik23: doesn't show hand 
*** SUMMARY ***
Total pot €2.50 | Rake €0 
Seat 1: florrin92 (button) folded before Flop (didn't bet)
Seat 2: matiko09 (small blind) folded before Flop
Seat 3: nickreason17 (big blind) folded before Flop
Seat 4: torkkdnm folded before Flop (didn't bet)
Seat 5: cobrik23 collected (€2.50)
Seat 6: STrakDD folded before Flop (didn't bet)
Seat 7: ipashutapkom folded before Flop (didn't bet)
Seat 8: lydia12345 folded before Flop (didn't bet)
Seat 9: stijner1986 folded before Flop (didn't bet)





PokerStars Hand #153500801191:  Hold'em No Limit ($0.50/$1.00 USD) - 2016/05/18 20:02:37 CET [2016/05/18 14:02:37 ET]
Table 'Saiph II' 9-max Seat #5 is the button
Seat 1: ipashutapkom ($42.49 in chips) 
Seat 2: matiko09 ($128.42 in chips) 
Seat 3: lydia12345 ($102.62 in chips) 
Seat 5: cobrik23 ($42.49 in chips) 
Seat 7: nickreason17 ($111.28 in chips) 
Seat 8: sanr23 ($100 in chips) 
Seat 9: alesi007 ($36.04 in chips) 
nickreason17: posts small blind $0.50
sanr23: posts big blind $1
*** HOLE CARDS ***
Dealt to matiko09 [Kc 2c]
alesi007: folds 
ipashutapkom: folds 
matiko09: folds 
lydia12345: folds 
cobrik23: folds 
nickreason17: folds 
Uncalled bet ($0.50) returned to sanr23
sanr23 collected $1 from pot
*** SUMMARY ***
Total pot $1 | Rake $0 
Seat 1: ipashutapkom folded before Flop (didn't bet)
Seat 2: matiko09 folded before Flop (didn't bet)
Seat 3: lydia12345 folded before Flop (didn't bet)
Seat 5: cobrik23 (button) folded before Flop (didn't bet)
Seat 7: nickreason17 (small blind) folded before Flop
Seat 8: sanr23 (big blind) collected ($1)
Seat 9: alesi007 folded before Flop (didn't bet)





PokerStars Hand #153500809141:  Hold'em No Limit ($0.50/$1.00 USD) - 2016/05/18 20:02:46 CET [2016/05/18 14:02:46 ET]
Table 'Tatjana III' 9-max Seat #6 is the button
Seat 1: cobrik23 ($43.22 in chips) 
Seat 3: matiko09 ($179.90 in chips) 
Seat 5: sanr23 ($130.75 in chips) 
Seat 6: Bimaxa ($100 in chips) 
Seat 7: rene1984tsv ($102.76 in chips) 
Seat 8: aseban11 ($100 in chips) 
Seat 9: florrin92 ($100 in chips) 
rene1984tsv: posts small blind $0.50
aseban11: posts big blind $1
HITYESCA: sits out 
lydia12345: sits out 
*** HOLE CARDS ***
Dealt to matiko09 [4c Qd]
florrin92: folds 
cobrik23: folds 
matiko09: folds 
sanr23: raises $1.50 to $2.50
Bimaxa: folds 
rene1984tsv: raises $6 to $8.50
aseban11: calls $7.50
sanr23: folds 
*** FLOP *** [Ks 2s Qs]
rene1984tsv: bets $15
aseban11: folds 
Uncalled bet ($15) returned to rene1984tsv
rene1984tsv collected $18.52 from pot
rene1984tsv: doesn't show hand 
*** SUMMARY ***
Total pot $19.50 | Rake $0.98 
Board [Ks 2s Qs]
Seat 1: cobrik23 folded before Flop (didn't bet)
Seat 3: matiko09 folded before Flop (didn't bet)
Seat 5: sanr23 folded before Flop
Seat 6: Bimaxa (button) folded before Flop (didn't bet)
Seat 7: rene1984tsv (small blind) collected ($18.52)
Seat 8: aseban11 (big blind) folded on the Flop
Seat 9: florrin92 folded before Flop (didn't bet)





PokerStars Hand #153500817249:  Hold'em No Limit ($0.50/$1.00 USD) - 2016/05/18 20:02:55 CET [2016/05/18 14:02:55 ET]
Table 'Saiph II' 9-max Seat #7 is the button
Seat 1: ipashutapkom ($42.49 in chips) 
Seat 2: matiko09 ($128.42 in chips) 
Seat 3: lydia12345 ($102.62 in chips) 
Seat 5: cobrik23 ($42.49 in chips) 
Seat 7: nickreason17 ($110.78 in chips) 
Seat 8: sanr23 ($100.50 in chips) 
Seat 9: alesi007 ($36.04 in chips) 
sanr23: posts small blind $0.50
alesi007: posts big blind $1
*** HOLE CARDS ***
Dealt to matiko09 [5d Qh]
ipashutapkom: folds 
matiko09: folds 
lydia12345: folds 
cobrik23: folds 
nickreason17: folds 
sanr23: calls $0.50
alesi007: checks 
*** FLOP *** [Ad Ks 2d]
sanr23: checks 
alesi007: checks 
*** TURN *** [Ad Ks 2d] [9d]
sanr23: checks 
alesi007: checks 
*** RIVER *** [Ad Ks 2d 9d] [6c]
sanr23: checks 
alesi007: checks 
*** SHOW DOWN ***
sanr23: shows [2h Jh] (a pair of Deuces)
alesi007: mucks hand 
sanr23 collected $1.90 from pot
*** SUMMARY ***
Total pot $2 | Rake $0.10 
Board [Ad Ks 2d 9d 6c]
Seat 1: ipashutapkom folded before Flop (didn't bet)
Seat 2: matiko09 folded before Flop (didn't bet)
Seat 3: lydia12345 folded before Flop (didn't bet)
Seat 5: cobrik23 folded before Flop (didn't bet)
Seat 7: nickreason17 (button) folded before Flop (didn't bet)
Seat 8: sanr23 (small blind) showed [2h Jh] and won ($1.90) with a pair of Deuces
Seat 9: alesi007 (big blind) mucked [Qd 5s]





PokerStars Hand #153500837093:  Hold'em No Limit (€0.50/€1.00 EUR) - 2016/05/18 20:03:18 CET [2016/05/18 14:03:18 ET]
Table 'Pallas II' 9-max Seat #2 is the button
Seat 1: florrin92 (€100 in chips) 
Seat 2: matiko09 (€204.45 in chips) 
Seat 3: nickreason17 (€100 in chips) 
Seat 4: torkkdnm (€137.88 in chips) 
Seat 5: cobrik23 (€62.62 in chips) 
Seat 7: ipashutapkom (€40 in chips) 
Seat 8: lydia12345 (€102.23 in chips) 
Seat 9: stijner1986 (€82.61 in chips) 
nickreason17: posts small blind €0.50
torkkdnm: posts big blind €1
*** HOLE CARDS ***
Dealt to matiko09 [Qh Ac]
cobrik23: folds 
ipashutapkom: folds 
lydia12345: folds 
stijner1986: folds 
florrin92: folds 
matiko09: raises €1.27 to €2.27
nickreason17: folds 
torkkdnm: calls €1.27
*** FLOP *** [Jc 5h 9h]
torkkdnm: checks 
matiko09: bets €3.11
torkkdnm: folds 
Uncalled bet (€3.11) returned to matiko09
matiko09 collected €4.79 from pot
matiko09: doesn't show hand 
*** SUMMARY ***
Total pot €5.04 | Rake €0.25 
Board [Jc 5h 9h]
Seat 1: florrin92 folded before Flop (didn't bet)
Seat 2: matiko09 (button) collected (€4.79)
Seat 3: nickreason17 (small blind) folded before Flop
Seat 4: torkkdnm (big blind) folded on the Flop
Seat 5: cobrik23 folded before Flop (didn't bet)
Seat 7: ipashutapkom folded before Flop (didn't bet)
Seat 8: lydia12345 folded before Flop (didn't bet)
Seat 9: stijner1986 folded before Flop (didn't bet)





PokerStars Hand #153500838731:  Hold'em No Limit ($0.50/$1.00 USD) - 2016/05/18 20:03:20 CET [2016/05/18 14:03:20 ET]
Table 'Abetti II' 9-max Seat #9 is the button
Seat 1: matiko09 ($100 in chips) 
Seat 2: Bimaxa ($128.84 in chips) 
Seat 3: cobrik23 ($260.87 in chips) 
Seat 4: aseban11 ($100 in chips) 
Seat 5: blufthenuts ($138.52 in chips) 
Seat 7: nickreason17 ($111 in chips) 
Seat 8: roadster683 ($114.82 in chips) 
Seat 9: florrin92 ($100 in chips) 
matiko09: posts small blind $0.50
Bimaxa: posts big blind $1
*** HOLE CARDS ***
Dealt to matiko09 [9h 2h]
cobrik23: folds 
aseban11: raises $2 to $3
blufthenuts: folds 
nickreason17: calls $3
roadster683: folds 
florrin92: folds 
matiko09: folds 
Bimaxa: folds 
*** FLOP *** [Ks Qs Ad]
aseban11: checks 
nickreason17: checks 
*** TURN *** [Ks Qs Ad] [Td]
aseban11: checks 
nickreason17: bets $3.75
aseban11: calls $3.75
*** RIVER *** [Ks Qs Ad Td] [4d]
aseban11: checks 
nickreason17: checks 
*** SHOW DOWN ***
aseban11: shows [Qc Jc] (a straight, Ten to Ace)
nickreason17: mucks hand 
aseban11 collected $14.25 from pot
*** SUMMARY ***
Total pot $15 | Rake $0.75 
Board [Ks Qs Ad Td 4d]
Seat 1: matiko09 (small blind) folded before Flop
Seat 2: Bimaxa (big blind) folded before Flop
Seat 3: cobrik23 folded before Flop (didn't bet)
Seat 4: aseban11 showed [Qc Jc] and won ($14.25) with a straight, Ten to Ace
Seat 5: blufthenuts folded before Flop (didn't bet)
Seat 7: nickreason17 mucked [5c 5d]
Seat 8: roadster683 folded before Flop (didn't bet)
Seat 9: florrin92 (button) folded before Flop (didn't bet)





PokerStars Hand #153500852090:  Hold'em No Limit ($0.50/$1.00 USD) - 2016/05/18 20:03:37 CET [2016/05/18 14:03:37 ET]
Table 'Tatjana III' 9-max Seat #7 is the button
Seat 1: cobrik23 ($43.22 in chips) 
Seat 3: matiko09 ($179.90 in chips) 
Seat 5: sanr23 ($128.25 in chips) 
Seat 6: Bimaxa ($100 in chips) 
Seat 7: rene1984tsv ($112.78 in chips) 
Seat 8: aseban11 ($100 in chips) 
aseban11: posts small blind $0.50
florrin92: is sitting out 
florrin92 leaves the table
cobrik23: posts big blind $1
HITYESCA: sits out 
lydia12345: sits out 
*** HOLE CARDS ***
Dealt to matiko09 [5s 3d]
matiko09: folds 
Moszes360 joins the table at seat #9 
sanr23: raises $2 to $3
Bimaxa: folds 
rene1984tsv: calls $3
aseban11: folds 
cobrik23: calls $2
*** FLOP *** [2c Jh 8s]
cobrik23: checks 
sanr23: bets $5.95
rene1984tsv: calls $5.95
cobrik23: folds 
*** TURN *** [2c Jh 8s] [Th]
sanr23: bets $13.42
rene1984tsv: folds 
Uncalled bet ($13.42) returned to sanr23
sanr23 collected $20.33 from pot
sanr23: doesn't show hand 
*** SUMMARY ***
Total pot $21.40 | Rake $1.07 
Board [2c Jh 8s Th]
Seat 1: cobrik23 (big blind) folded on the Flop
Seat 3: matiko09 folded before Flop (didn't bet)
Seat 5: sanr23 collected ($20.33)
Seat 6: Bimaxa folded before Flop (didn't bet)
Seat 7: rene1984tsv (button) folded on the Turn
Seat 8: aseban11 (small blind) folded before Flop





PokerStars Hand #153500861912:  Hold'em No Limit ($1/$2 USD) - 2016/05/18 20:03:48 CET [2016/05/18 14:03:48 ET]
Table 'Letaba' 9-max Seat #3 is the button
Seat 1: FREDY BULLIT ($200 in chips) 
Seat 2: staruk669 ($76.33 in chips) 
Seat 3: ersevi6 ($205.04 in chips) 
Seat 4: matiko09 ($201.20 in chips) 
Seat 5: aseban11 ($200 in chips) 
Seat 6: donald0404 ($212.75 in chips) 
Seat 7: moshmachine ($300.57 in chips) 
Seat 8: $-Twackle-$ ($216.88 in chips) 
Seat 9: tepi_guy ($243.76 in chips) 
matiko09: posts small blind $1
aseban11: posts big blind $2
*** HOLE CARDS ***
Dealt to matiko09 [Js 9s]
donald0404: raises $4 to $6
moshmachine: folds 
$-Twackle-$: folds 
tepi_guy: folds 
FREDY BULLIT: folds 
staruk669: calls $6
ersevi6: folds 
matiko09: folds 
aseban11: folds 
*** FLOP *** [8s Qd 4c]
donald0404: checks 
staruk669: bets $8
donald0404: folds 
Uncalled bet ($8) returned to staruk669
staruk669 collected $14.25 from pot
staruk669: doesn't show hand 
*** SUMMARY ***
Total pot $15 | Rake $0.75 
Board [8s Qd 4c]
Seat 1: FREDY BULLIT folded before Flop (didn't bet)
Seat 2: staruk669 collected ($14.25)
Seat 3: ersevi6 (button) folded before Flop (didn't bet)
Seat 4: matiko09 (small blind) folded before Flop
Seat 5: aseban11 (big blind) folded before Flop
Seat 6: donald0404 folded on the Flop
Seat 7: moshmachine folded before Flop (didn't bet)
Seat 8: $-Twackle-$ folded before Flop (didn't bet)
Seat 9: tepi_guy folded before Flop (didn't bet)





PokerStars Hand #153500871082:  Hold'em No Limit ($0.50/$1.00 USD) - 2016/05/18 20:03:58 CET [2016/05/18 14:03:58 ET]
Table 'Saiph II' 9-max Seat #8 is the button
Seat 2: matiko09 ($128.42 in chips) 
Seat 3: lydia12345 ($102.62 in chips) 
Seat 5: cobrik23 ($42.49 in chips) 
Seat 7: nickreason17 ($110.78 in chips) 
Seat 8: sanr23 ($101.40 in chips) 
Seat 9: alesi007 ($35.04 in chips) 
alesi007: posts small blind $0.50
ipashutapkom: is sitting out 
matiko09: posts big blind $1
*** HOLE CARDS ***
Dealt to matiko09 [Ks 5d]
ipashutapkom leaves the table
lydia12345: folds 
Moszes360 joins the table at seat #1 
cobrik23: folds 
nickreason17: raises $1.50 to $2.50
sanr23: folds 
alesi007: calls $2
matiko09: folds 
*** FLOP *** [3c Kc 9h]
alesi007: checks 
nickreason17: bets $3
alesi007: calls $3
*** TURN *** [3c Kc 9h] [Ac]
alesi007: checks 
nickreason17: bets $7.98
alesi007: raises $9.98 to $17.96
nickreason17: folds 
Uncalled bet ($9.98) returned to alesi007
alesi007 collected $26.56 from pot
alesi007: doesn't show hand 
*** SUMMARY ***
Total pot $27.96 | Rake $1.40 
Board [3c Kc 9h Ac]
Seat 2: matiko09 (big blind) folded before Flop
Seat 3: lydia12345 folded before Flop (didn't bet)
Seat 5: cobrik23 folded before Flop (didn't bet)
Seat 7: nickreason17 folded on the Turn
Seat 8: sanr23 (button) folded before Flop (didn't bet)
Seat 9: alesi007 (small blind) collected ($26.56)





PokerStars Hand #153500871181:  Hold'em No Limit ($1/$2 USD) - 2016/05/18 20:03:59 CET [2016/05/18 14:03:59 ET]
Table 'Chlosinde' 9-max Seat #5 is the button
Seat 1: ersevi6 ($80 in chips) 
Seat 2: aseban11 ($203.50 in chips) 
Seat 3: matiko09 ($200 in chips) 
Seat 4: FREDY BULLIT ($221.85 in chips) 
Seat 5: tepi_guy ($649.69 in chips) 
Seat 6: slick_nickDH ($392.56 in chips) 
Seat 7: donald0404 ($203 in chips) 
Seat 8: sanducu_eu ($227.67 in chips) 
Seat 9: Tey113 ($611.78 in chips) 
slick_nickDH: posts small blind $1
donald0404: posts big blind $2
*** HOLE CARDS ***
Dealt to matiko09 [Jh Kc]
sanducu_eu: folds 
Tey113: folds 
ersevi6: folds 
aseban11: raises $4 to $6
matiko09: folds 
FREDY BULLIT: raises $12 to $18
tepi_guy: folds 
slick_nickDH: folds 
donald0404: folds 
aseban11: folds 
Uncalled bet ($12) returned to FREDY BULLIT
FREDY BULLIT collected $15 from pot
FREDY BULLIT: doesn't show hand 
*** SUMMARY ***
Total pot $15 | Rake $0 
Seat 1: ersevi6 folded before Flop (didn't bet)
Seat 2: aseban11 folded before Flop
Seat 3: matiko09 folded before Flop (didn't bet)
Seat 4: FREDY BULLIT collected ($15)
Seat 5: tepi_guy (button) folded before Flop (didn't bet)
Seat 6: slick_nickDH (small blind) folded before Flop
Seat 7: donald0404 (big blind) folded before Flop
Seat 8: sanducu_eu folded before Flop (didn't bet)
Seat 9: Tey113 folded before Flop (didn't bet)





PokerStars Hand #153500872449:  Hold'em No Limit (€0.50/€1.00 EUR) - 2016/05/18 20:04:00 CET [2016/05/18 14:04:00 ET]
Table 'Pallas II' 9-max Seat #3 is the button
Seat 1: florrin92 (€100 in chips) 
Seat 2: matiko09 (€206.97 in chips) 
Seat 3: nickreason17 (€100 in chips) 
Seat 4: torkkdnm (€135.61 in chips) 
Seat 5: cobrik23 (€62.62 in chips) 
Seat 7: ipashutapkom (€40 in chips) 
Seat 8: lydia12345 (€102.23 in chips) 
Seat 9: stijner1986 (€82.61 in chips) 
torkkdnm: posts small blind €0.50
cobrik23: posts big blind €1
*** HOLE CARDS ***
Dealt to matiko09 [5d 9c]
ipashutapkom: raises €1.26 to €2.26
lydia12345: folds 
stijner1986: calls €2.26
florrin92: folds 
matiko09: folds 
nickreason17: folds 
torkkdnm: folds 
cobrik23: folds 
*** FLOP *** [Qh Ks 6h]
ipashutapkom: bets €4.33
STrakDD leaves the table
stijner1986: calls €4.33
*** TURN *** [Qh Ks 6h] [Jh]
ipashutapkom: bets €9.35
HITYESCA joins the table at seat #6 
stijner1986: calls €9.35
*** RIVER *** [Qh Ks 6h Jh] [7h]
ipashutapkom: checks 
stijner1986: bets €31.71
ipashutapkom: folds 
Uncalled bet (€31.71) returned to stijner1986
stijner1986 collected €31.71 from pot
stijner1986: doesn't show hand 
*** SUMMARY ***
Total pot €33.38 | Rake €1.67 
Board [Qh Ks 6h Jh 7h]
Seat 1: florrin92 folded before Flop (didn't bet)
Seat 2: matiko09 folded before Flop (didn't bet)
Seat 3: nickreason17 (button) folded before Flop (didn't bet)
Seat 4: torkkdnm (small blind) folded before Flop
Seat 5: cobrik23 (big blind) folded before Flop
Seat 7: ipashutapkom folded on the River
Seat 8: lydia12345 folded before Flop (didn't bet)
Seat 9: stijner1986 collected (€31.71)





PokerStars Hand #153500887398:  Hold'em No Limit ($0.50/$1.00 USD) - 2016/05/18 20:04:18 CET [2016/05/18 14:04:18 ET]
Table 'Abetti II' 9-max Seat #1 is the button
Seat 1: matiko09 ($100 in chips) 
Seat 2: Bimaxa ($127.84 in chips) 
Seat 3: cobrik23 ($260.87 in chips) 
Seat 4: aseban11 ($107.50 in chips) 
Seat 5: blufthenuts ($138.52 in chips) 
Seat 7: nickreason17 ($104.25 in chips) 
Seat 8: roadster683 ($114.82 in chips) 
Seat 9: florrin92 ($100 in chips) 
Bimaxa: posts small blind $0.50
cobrik23: posts big blind $1
*** HOLE CARDS ***
Dealt to matiko09 [8c Js]
aseban11: raises $2 to $3
blufthenuts: folds 
nickreason17: folds 
roadster683: folds 
florrin92: folds 
matiko09: folds 
Bimaxa: folds 
cobrik23: folds 
Uncalled bet ($2) returned to aseban11
aseban11 collected $2.50 from pot
aseban11: doesn't show hand 
*** SUMMARY ***
Total pot $2.50 | Rake $0 
Seat 1: matiko09 (button) folded before Flop (didn't bet)
Seat 2: Bimaxa (small blind) folded before Flop
Seat 3: cobrik23 (big blind) folded before Flop
Seat 4: aseban11 collected ($2.50)
Seat 5: blufthenuts folded before Flop (didn't bet)
Seat 7: nickreason17 folded before Flop (didn't bet)
Seat 8: roadster683 folded before Flop (didn't bet)
Seat 9: florrin92 folded before Flop (didn't bet)





PokerStars Hand #153500894563:  Hold'em No Limit ($1/$2 USD) - 2016/05/18 20:04:26 CET [2016/05/18 14:04:26 ET]
Table 'Letaba' 9-max Seat #4 is the button
Seat 1: FREDY BULLIT ($200 in chips) 
Seat 2: staruk669 ($84.58 in chips) 
Seat 3: ersevi6 ($205.04 in chips) 
Seat 4: matiko09 ($200.20 in chips) 
Seat 5: aseban11 ($200 in chips) 
Seat 6: donald0404 ($206.75 in chips) 
Seat 7: moshmachine ($300.57 in chips) 
Seat 8: $-Twackle-$ ($216.88 in chips) 
Seat 9: tepi_guy ($243.76 in chips) 
aseban11: posts small blind $1
donald0404: posts big blind $2
*** HOLE CARDS ***
Dealt to matiko09 [4s 4c]
moshmachine: folds 
$-Twackle-$: folds 
tepi_guy: folds 
FREDY BULLIT: raises $3.60 to $5.60
staruk669: calls $5.60
ersevi6: folds 
matiko09: calls $5.60
aseban11: folds 
donald0404: folds 
*** FLOP *** [Qc 7d 9d]
FREDY BULLIT: checks 
staruk669: checks 
matiko09: checks 
*** TURN *** [Qc 7d 9d] [5s]
FREDY BULLIT: checks 
staruk669: bets $10
matiko09: folds 
FREDY BULLIT: folds 
Uncalled bet ($10) returned to staruk669
staruk669 collected $18.81 from pot
staruk669: doesn't show hand 
*** SUMMARY ***
Total pot $19.80 | Rake $0.99 
Board [Qc 7d 9d 5s]
Seat 1: FREDY BULLIT folded on the Turn
Seat 2: staruk669 collected ($18.81)
Seat 3: ersevi6 folded before Flop (didn't bet)
Seat 4: matiko09 (button) folded on the Turn
Seat 5: aseban11 (small blind) folded before Flop
Seat 6: donald0404 (big blind) folded before Flop
Seat 7: moshmachine folded before Flop (didn't bet)
Seat 8: $-Twackle-$ folded before Flop (didn't bet)
Seat 9: tepi_guy folded before Flop (didn't bet)





PokerStars Hand #153500912287:  Hold'em No Limit ($1/$2 USD) - 2016/05/18 20:04:47 CET [2016/05/18 14:04:47 ET]
Table 'Chlosinde' 9-max Seat #6 is the button
Seat 1: ersevi6 ($160 in chips) 
Seat 2: aseban11 ($200 in chips) 
Seat 3: matiko09 ($200 in chips) 
Seat 4: FREDY BULLIT ($230.85 in chips) 
Seat 5: tepi_guy ($649.69 in chips) 
Seat 6: slick_nickDH ($391.56 in chips) 
Seat 7: donald0404 ($201 in chips) 
Seat 8: sanducu_eu ($227.67 in chips) 
Seat 9: Tey113 ($611.78 in chips) 
donald0404: posts small blind $1
sanducu_eu: posts big blind $2
*** HOLE CARDS ***
Dealt to matiko09 [Ac 2h]
Tey113: raises $2.45 to $4.45
ersevi6: folds 
aseban11: folds 
matiko09: folds 
FREDY BULLIT: folds 
tepi_guy has timed out
tepi_guy: folds 
slick_nickDH: folds 
donald0404: folds 
sanducu_eu: calls $2.45
*** FLOP *** [Ad 8s 7h]
sanducu_eu: checks 
Tey113: checks 
*** TURN *** [Ad 8s 7h] [8h]
sanducu_eu: checks 
Tey113: checks 
*** RIVER *** [Ad 8s 7h 8h] [5d]
sanducu_eu: checks 
Tey113: bets $4
sanducu_eu: folds 
Uncalled bet ($4) returned to Tey113
Tey113 collected $9.40 from pot
Tey113: doesn't show hand 
*** SUMMARY ***
Total pot $9.90 | Rake $0.50 
Board [Ad 8s 7h 8h 5d]
Seat 1: ersevi6 folded before Flop (didn't bet)
Seat 2: aseban11 folded before Flop (didn't bet)
Seat 3: matiko09 folded before Flop (didn't bet)
Seat 4: FREDY BULLIT folded before Flop (didn't bet)
Seat 5: tepi_guy folded before Flop (didn't bet)
Seat 6: slick_nickDH (button) folded before Flop (didn't bet)
Seat 7: donald0404 (small blind) folded before Flop
Seat 8: sanducu_eu (big blind) folded on the River
Seat 9: Tey113 collected ($9.40)





PokerStars Hand #153500920542:  Hold'em No Limit ($0.50/$1.00 USD) - 2016/05/18 20:04:56 CET [2016/05/18 14:04:56 ET]
Table 'Abetti II' 9-max Seat #2 is the button
Seat 1: matiko09 ($100 in chips) 
Seat 2: Bimaxa ($127.34 in chips) 
Seat 3: cobrik23 ($259.87 in chips) 
Seat 4: aseban11 ($109 in chips) 
Seat 5: blufthenuts ($138.52 in chips) 
Seat 7: nickreason17 ($104.25 in chips) 
Seat 8: roadster683 ($114.82 in chips) 
Seat 9: florrin92 ($100 in chips) 
cobrik23: posts small blind $0.50
aseban11: posts big blind $1
*** HOLE CARDS ***
Dealt to matiko09 [7c 9s]
blufthenuts: folds 
nickreason17: folds 
roadster683: folds 
florrin92: folds 
matiko09: folds 
Bimaxa: folds 
cobrik23: folds 
Uncalled bet ($0.50) returned to aseban11
aseban11 collected $1 from pot
aseban11: doesn't show hand 
*** SUMMARY ***
Total pot $1 | Rake $0 
Seat 1: matiko09 folded before Flop (didn't bet)
Seat 2: Bimaxa (button) folded before Flop (didn't bet)
Seat 3: cobrik23 (small blind) folded before Flop
Seat 4: aseban11 (big blind) collected ($1)
Seat 5: blufthenuts folded before Flop (didn't bet)
Seat 7: nickreason17 folded before Flop (didn't bet)
Seat 8: roadster683 folded before Flop (didn't bet)
Seat 9: florrin92 folded before Flop (didn't bet)





PokerStars Hand #153500936995:  Hold'em No Limit ($0.50/$1.00 USD) - 2016/05/18 20:05:15 CET [2016/05/18 14:05:15 ET]
Table 'Abetti II' 9-max Seat #3 is the button
Seat 1: matiko09 ($100 in chips) 
Seat 2: Bimaxa ($127.34 in chips) 
Seat 3: cobrik23 ($259.37 in chips) 
Seat 4: aseban11 ($109.50 in chips) 
Seat 5: blufthenuts ($138.52 in chips) 
Seat 7: nickreason17 ($104.25 in chips) 
Seat 8: roadster683 ($114.82 in chips) 
Seat 9: florrin92 ($100 in chips) 
aseban11: posts small blind $0.50
blufthenuts: posts big blind $1
*** HOLE CARDS ***
Dealt to matiko09 [2s Js]
nickreason17: folds 
roadster683: folds 
florrin92: folds 
matiko09: folds 
Bimaxa: raises $2 to $3
cobrik23: folds 
aseban11: folds 
blufthenuts: folds 
Uncalled bet ($2) returned to Bimaxa
Bimaxa collected $2.50 from pot
Bimaxa: doesn't show hand 
*** SUMMARY ***
Total pot $2.50 | Rake $0 
Seat 1: matiko09 folded before Flop (didn't bet)
Seat 2: Bimaxa collected ($2.50)
Seat 3: cobrik23 (button) folded before Flop (didn't bet)
Seat 4: aseban11 (small blind) folded before Flop
Seat 5: blufthenuts (big blind) folded before Flop
Seat 7: nickreason17 folded before Flop (didn't bet)
Seat 8: roadster683 folded before Flop (didn't bet)
Seat 9: florrin92 folded before Flop (didn't bet)





PokerStars Hand #153500943589:  Hold'em No Limit ($0.50/$1.00 USD) - 2016/05/18 20:05:23 CET [2016/05/18 14:05:23 ET]
Table 'Saiph II' 9-max Seat #9 is the button
Seat 2: matiko09 ($127.42 in chips) 
Seat 3: lydia12345 ($102.62 in chips) 
Seat 4: dr_mraz1 ($79 in chips) 
Seat 5: cobrik23 ($42.49 in chips) 
Seat 7: nickreason17 ($100 in chips) 
Seat 8: sanr23 ($101.40 in chips) 
Seat 9: alesi007 ($48.12 in chips) 
Moszes360 will be allowed to play after the button
matiko09: posts small blind $0.50
lydia12345: posts big blind $1
dr_mraz1: posts small & big blinds $1.50
*** HOLE CARDS ***
Dealt to matiko09 [Ad 4c]
dr_mraz1: checks 
cobrik23: folds 
nickreason17: folds 
sanr23: folds 
alesi007: folds 
matiko09: calls $0.50
lydia12345: raises $4 to $5
dr_mraz1: folds 
matiko09: folds 
Uncalled bet ($4) returned to lydia12345
lydia12345 collected $3.50 from pot
*** SUMMARY ***
Total pot $3.50 | Rake $0 
Seat 2: matiko09 (small blind) folded before Flop
Seat 3: lydia12345 (big blind) collected ($3.50)
Seat 4: dr_mraz1 folded before Flop
Seat 5: cobrik23 folded before Flop (didn't bet)
Seat 7: nickreason17 folded before Flop (didn't bet)
Seat 8: sanr23 folded before Flop (didn't bet)
Seat 9: alesi007 (button) folded before Flop (didn't bet)





PokerStars Hand #153500947138:  Hold'em No Limit ($0.50/$1.00 USD) - 2016/05/18 20:05:27 CET [2016/05/18 14:05:27 ET]
Table 'Tatjana III' 9-max Seat #8 is the button
Seat 1: cobrik23 ($40.22 in chips) 
Seat 2: HITYESCA ($100 in chips) 
Seat 3: matiko09 ($179.90 in chips) 
Seat 5: sanr23 ($139.63 in chips) 
Seat 6: Bimaxa ($100 in chips) 
Seat 7: rene1984tsv ($103.83 in chips) 
Seat 8: aseban11 ($100 in chips) 
Moszes360 will be allowed to play after the button
cobrik23: posts small blind $0.50
HITYESCA: posts big blind $1
lydia12345: sits out 
*** HOLE CARDS ***
Dealt to matiko09 [Jd Ah]
matiko09: folds 
sanr23: raises $2 to $3
Bimaxa: folds 
rene1984tsv: calls $3
aseban11: folds 
cobrik23: raises $10 to $13
HITYESCA: folds 
sanr23: folds 
rene1984tsv: calls $10
*** FLOP *** [Jh Th 3h]
cobrik23: checks 
rene1984tsv: checks 
*** TURN *** [Jh Th 3h] [9s]
cobrik23: checks 
rene1984tsv: bets $9
cobrik23: folds 
Uncalled bet ($9) returned to rene1984tsv
rene1984tsv collected $28.50 from pot
*** SUMMARY ***
Total pot $30 | Rake $1.50 
Board [Jh Th 3h 9s]
Seat 1: cobrik23 (small blind) folded on the Turn
Seat 2: HITYESCA (big blind) folded before Flop
Seat 3: matiko09 folded before Flop (didn't bet)
Seat 5: sanr23 folded before Flop
Seat 6: Bimaxa folded before Flop (didn't bet)
Seat 7: rene1984tsv collected ($28.50)
Seat 8: aseban11 (button) folded before Flop (didn't bet)





PokerStars Hand #153500951788:  Hold'em No Limit ($0.50/$1.00 USD) - 2016/05/18 20:05:32 CET [2016/05/18 14:05:32 ET]
Table 'Abetti II' 9-max Seat #4 is the button
Seat 1: matiko09 ($100 in chips) 
Seat 2: Bimaxa ($128.84 in chips) 
Seat 3: cobrik23 ($259.37 in chips) 
Seat 4: aseban11 ($109 in chips) 
Seat 5: blufthenuts ($137.52 in chips) 
Seat 7: nickreason17 ($104.25 in chips) 
Seat 8: roadster683 ($114.82 in chips) 
Seat 9: florrin92 ($100 in chips) 
blufthenuts: posts small blind $0.50
nickreason17: posts big blind $1
*** HOLE CARDS ***
Dealt to matiko09 [Td 3h]
roadster683: folds 
florrin92: folds 
matiko09: folds 
Bimaxa: folds 
cobrik23: folds 
aseban11: raises $1.50 to $2.50
blufthenuts: folds 
nickreason17: calls $1.50
*** FLOP *** [3c 4s 7s]
nickreason17: bets $3.65
aseban11: folds 
Uncalled bet ($3.65) returned to nickreason17
nickreason17 collected $5.22 from pot
*** SUMMARY ***
Total pot $5.50 | Rake $0.28 
Board [3c 4s 7s]
Seat 1: matiko09 folded before Flop (didn't bet)
Seat 2: Bimaxa folded before Flop (didn't bet)
Seat 3: cobrik23 folded before Flop (didn't bet)
Seat 4: aseban11 (button) folded on the Flop
Seat 5: blufthenuts (small blind) folded before Flop
Seat 7: nickreason17 (big blind) collected ($5.22)
Seat 8: roadster683 folded before Flop (didn't bet)
Seat 9: florrin92 folded before Flop (didn't bet)





PokerStars Hand #153500955340:  Hold'em No Limit (€0.50/€1.00 EUR) - 2016/05/18 20:05:37 CET [2016/05/18 14:05:37 ET]
Table 'Pallas II' 9-max Seat #4 is the button
Seat 1: florrin92 (€100 in chips) 
Seat 2: matiko09 (€206.97 in chips) 
Seat 3: nickreason17 (€100 in chips) 
Seat 4: torkkdnm (€135.11 in chips) 
Seat 5: cobrik23 (€61.62 in chips) 
Seat 6: HITYESCA (€100 in chips) 
Seat 7: ipashutapkom (€40 in chips) 
Seat 8: lydia12345 (€102.23 in chips) 
Seat 9: stijner1986 (€98.38 in chips) 
cobrik23: posts small blind €0.50
HITYESCA: posts big blind €1
*** HOLE CARDS ***
Dealt to matiko09 [Qd 9h]
ipashutapkom: folds 
lydia12345: folds 
stijner1986: calls €1
florrin92: folds 
matiko09: folds 
nickreason17: folds 
torkkdnm: folds 
cobrik23: folds 
HITYESCA: raises €5 to €6
stijner1986: folds 
Uncalled bet (€5) returned to HITYESCA
HITYESCA collected €2.50 from pot
HITYESCA: doesn't show hand 
*** SUMMARY ***
Total pot €2.50 | Rake €0 
Seat 1: florrin92 folded before Flop (didn't bet)
Seat 2: matiko09 folded before Flop (didn't bet)
Seat 3: nickreason17 folded before Flop (didn't bet)
Seat 4: torkkdnm (button) folded before Flop (didn't bet)
Seat 5: cobrik23 (small blind) folded before Flop
Seat 6: HITYESCA (big blind) collected (€2.50)
Seat 7: ipashutapkom folded before Flop (didn't bet)
Seat 8: lydia12345 folded before Flop (didn't bet)
Seat 9: stijner1986 folded before Flop





PokerStars Hand #153500958197:  Hold'em No Limit ($0.50/$1.00 USD) - 2016/05/18 20:05:40 CET [2016/05/18 14:05:40 ET]
Table 'Saiph II' 9-max Seat #2 is the button
Seat 2: matiko09 ($126.42 in chips) 
Seat 3: lydia12345 ($105.12 in chips) 
Seat 4: dr_mraz1 ($77.50 in chips) 
Seat 5: cobrik23 ($42.49 in chips) 
Seat 7: nickreason17 ($100 in chips) 
Seat 8: sanr23 ($101.40 in chips) 
Seat 9: alesi007 ($48.12 in chips) 
lydia12345: posts small blind $0.50
dr_mraz1: posts big blind $1
Moszes360: sits out 
*** HOLE CARDS ***
Dealt to matiko09 [As Ts]
cobrik23: folds 
nickreason17: folds 
sanr23: raises $2 to $3
alesi007: folds 
matiko09: calls $3
lydia12345: folds 
dr_mraz1: calls $2
*** FLOP *** [8s 2d 9s]
dr_mraz1: checks 
sanr23: checks 
matiko09: bets $7
dr_mraz1: folds 
sanr23: calls $7
*** TURN *** [8s 2d 9s] [Qs]
sanr23: checks 
matiko09: bets $11.60
sanr23: folds 
Uncalled bet ($11.60) returned to matiko09
matiko09 collected $22.32 from pot
matiko09: doesn't show hand 
*** SUMMARY ***
Total pot $23.50 | Rake $1.18 
Board [8s 2d 9s Qs]
Seat 2: matiko09 (button) collected ($22.32)
Seat 3: lydia12345 (small blind) folded before Flop
Seat 4: dr_mraz1 (big blind) folded on the Flop
Seat 5: cobrik23 folded before Flop (didn't bet)
Seat 7: nickreason17 folded before Flop (didn't bet)
Seat 8: sanr23 folded on the Turn
Seat 9: alesi007 folded before Flop (didn't bet)





PokerStars Hand #153500971936:  Hold'em No Limit ($1/$2 USD) - 2016/05/18 20:05:55 CET [2016/05/18 14:05:55 ET]
Table 'Letaba' 9-max Seat #5 is the button
Seat 1: FREDY BULLIT ($200 in chips) 
Seat 2: staruk669 ($97.79 in chips) 
Seat 3: ersevi6 ($205.04 in chips) 
Seat 4: matiko09 ($200 in chips) 
Seat 5: aseban11 ($200 in chips) 
Seat 6: donald0404 ($204.75 in chips) 
Seat 7: moshmachine ($300.57 in chips) 
Seat 8: $-Twackle-$ ($216.88 in chips) 
Seat 9: tepi_guy ($243.76 in chips) 
donald0404: posts small blind $1
moshmachine: posts big blind $2
*** HOLE CARDS ***
Dealt to matiko09 [5h 2s]
$-Twackle-$: folds 
tepi_guy: folds 
FREDY BULLIT: raises $3.60 to $5.60
staruk669: calls $5.60
ersevi6: folds 
matiko09: folds 
aseban11: folds 
donald0404: folds 
moshmachine: calls $3.60
*** FLOP *** [7d Ac 9h]
moshmachine: checks 
FREDY BULLIT: bets $5.58
staruk669: folds 
moshmachine: folds 
Uncalled bet ($5.58) returned to FREDY BULLIT
FREDY BULLIT collected $16.91 from pot
FREDY BULLIT: doesn't show hand 
*** SUMMARY ***
Total pot $17.80 | Rake $0.89 
Board [7d Ac 9h]
Seat 1: FREDY BULLIT collected ($16.91)
Seat 2: staruk669 folded on the Flop
Seat 3: ersevi6 folded before Flop (didn't bet)
Seat 4: matiko09 folded before Flop (didn't bet)
Seat 5: aseban11 (button) folded before Flop (didn't bet)
Seat 6: donald0404 (small blind) folded before Flop
Seat 7: moshmachine (big blind) folded on the Flop
Seat 8: $-Twackle-$ folded before Flop (didn't bet)
Seat 9: tepi_guy folded before Flop (didn't bet)





PokerStars Hand #153500991900:  Hold'em No Limit ($0.50/$1.00 USD) - 2016/05/18 20:06:18 CET [2016/05/18 14:06:18 ET]
Table 'Abetti II' 9-max Seat #5 is the button
Seat 1: matiko09 ($100 in chips) 
Seat 2: Bimaxa ($128.84 in chips) 
Seat 3: cobrik23 ($259.37 in chips) 
Seat 4: aseban11 ($106.50 in chips) 
Seat 5: blufthenuts ($137.02 in chips) 
Seat 7: nickreason17 ($106.97 in chips) 
Seat 8: roadster683 ($114.82 in chips) 
Seat 9: florrin92 ($100 in chips) 
nickreason17: posts small blind $0.50
roadster683: posts big blind $1
*** HOLE CARDS ***
Dealt to matiko09 [9d 3c]
florrin92: folds 
florrin92 leaves the table
matiko09: folds 
Bimaxa: folds 
cobrik23: folds 
lydia12345 joins the table at seat #9 
aseban11: folds 
blufthenuts: folds 
nickreason17: raises $1.50 to $2.50
roadster683: raises $3.50 to $6
nickreason17: folds 
Uncalled bet ($3.50) returned to roadster683
roadster683 collected $5 from pot
roadster683: doesn't show hand 
*** SUMMARY ***
Total pot $5 | Rake $0 
Seat 1: matiko09 folded before Flop (didn't bet)
Seat 2: Bimaxa folded before Flop (didn't bet)
Seat 3: cobrik23 folded before Flop (didn't bet)
Seat 4: aseban11 folded before Flop (didn't bet)
Seat 5: blufthenuts (button) folded before Flop (didn't bet)
Seat 7: nickreason17 (small blind) folded before Flop
Seat 8: roadster683 (big blind) collected ($5)
Seat 9: florrin92 folded before Flop (didn't bet)





PokerStars Hand #153501004776:  Hold'em No Limit (€0.50/€1.00 EUR) - 2016/05/18 20:06:33 CET [2016/05/18 14:06:33 ET]
Table 'Pallas II' 9-max Seat #5 is the button
Seat 1: florrin92 (€100 in chips) 
Seat 2: matiko09 (€206.97 in chips) 
Seat 3: nickreason17 (€100 in chips) 
Seat 4: torkkdnm (€135.11 in chips) 
Seat 5: cobrik23 (€61.12 in chips) 
Seat 6: HITYESCA (€101.50 in chips) 
Seat 7: ipashutapkom (€40 in chips) 
Seat 8: lydia12345 (€102.23 in chips) 
Seat 9: stijner1986 (€97.38 in chips) 
HITYESCA: posts small blind €0.50
ipashutapkom: posts big blind €1
*** HOLE CARDS ***
Dealt to matiko09 [9h Ah]
lydia12345: folds 
stijner1986: calls €1
florrin92: raises €3 to €4
matiko09: folds 
nickreason17: folds 
torkkdnm: calls €4
cobrik23: raises €10 to €14
HITYESCA: folds 
ipashutapkom: folds 
stijner1986: folds 
florrin92: folds 
torkkdnm: folds 
Uncalled bet (€10) returned to cobrik23
cobrik23 collected €14.50 from pot
cobrik23: doesn't show hand 
*** SUMMARY ***
Total pot €14.50 | Rake €0 
Seat 1: florrin92 folded before Flop
Seat 2: matiko09 folded before Flop (didn't bet)
Seat 3: nickreason17 folded before Flop (didn't bet)
Seat 4: torkkdnm folded before Flop
Seat 5: cobrik23 (button) collected (€14.50)
Seat 6: HITYESCA (small blind) folded before Flop
Seat 7: ipashutapkom (big blind) folded before Flop
Seat 8: lydia12345 folded before Flop (didn't bet)
Seat 9: stijner1986 folded before Flop





PokerStars Hand #153501011597:  Hold'em No Limit ($0.50/$1.00 USD) - 2016/05/18 20:06:41 CET [2016/05/18 14:06:41 ET]
Table 'Abetti II' 9-max Seat #7 is the button
Seat 1: matiko09 ($100 in chips) 
Seat 2: Bimaxa ($128.84 in chips) 
Seat 3: cobrik23 ($259.37 in chips) 
Seat 4: aseban11 ($106.50 in chips) 
Seat 5: blufthenuts ($137.02 in chips) 
Seat 7: nickreason17 ($104.47 in chips) 
Seat 8: roadster683 ($117.32 in chips) 
Seat 9: lydia12345 ($100 in chips) 
roadster683: posts small blind $0.50
lydia12345: posts big blind $1
*** HOLE CARDS ***
Dealt to matiko09 [5d 4c]
matiko09: folds 
Bimaxa: folds 
cobrik23: folds 
aseban11: folds 
blufthenuts: raises $2 to $3
nickreason17: folds 
roadster683: folds 
lydia12345: folds 
Uncalled bet ($2) returned to blufthenuts
blufthenuts collected $2.50 from pot
blufthenuts: doesn't show hand 
*** SUMMARY ***
Total pot $2.50 | Rake $0 
Seat 1: matiko09 folded before Flop (didn't bet)
Seat 2: Bimaxa folded before Flop (didn't bet)
Seat 3: cobrik23 folded before Flop (didn't bet)
Seat 4: aseban11 folded before Flop (didn't bet)
Seat 5: blufthenuts collected ($2.50)
Seat 7: nickreason17 (button) folded before Flop (didn't bet)
Seat 8: roadster683 (small blind) folded before Flop
Seat 9: lydia12345 (big blind) folded before Flop





PokerStars Hand #153501012437:  Hold'em No Limit ($1/$2 USD) - 2016/05/18 20:06:42 CET [2016/05/18 14:06:42 ET]
Table 'Chlosinde' 9-max Seat #7 is the button
Seat 1: ersevi6 ($160 in chips) 
Seat 2: aseban11 ($200 in chips) 
Seat 3: matiko09 ($200 in chips) 
Seat 4: FREDY BULLIT ($230.85 in chips) 
Seat 5: tepi_guy ($649.69 in chips) 
Seat 6: slick_nickDH ($391.56 in chips) 
Seat 7: donald0404 ($200 in chips) 
Seat 8: sanducu_eu ($223.22 in chips) 
Seat 9: Tey113 ($616.73 in chips) 
sanducu_eu: posts small blind $1
Tey113: posts big blind $2
*** HOLE CARDS ***
Dealt to matiko09 [9c 9h]
ersevi6: folds 
aseban11: folds 
matiko09: raises $3 to $5
FREDY BULLIT: folds 
tepi_guy: folds 
slick_nickDH: folds 
donald0404: folds 
sanducu_eu: folds 
Tey113: calls $3
*** FLOP *** [8c 6c 4h]
Tey113: checks 
matiko09: bets $8
Tey113: calls $8
*** TURN *** [8c 6c 4h] [Qd]
Tey113: checks 
matiko09: bets $14
Tey113: calls $14
*** RIVER *** [8c 6c 4h Qd] [7h]
Tey113: checks 
matiko09: checks 
*** SHOW DOWN ***
Tey113: shows [4d 9d] (a pair of Fours)
matiko09: shows [9c 9h] (a pair of Nines)
matiko09 collected $52.25 from pot
*** SUMMARY ***
Total pot $55 | Rake $2.75 
Board [8c 6c 4h Qd 7h]
Seat 1: ersevi6 folded before Flop (didn't bet)
Seat 2: aseban11 folded before Flop (didn't bet)
Seat 3: matiko09 showed [9c 9h] and won ($52.25) with a pair of Nines
Seat 4: FREDY BULLIT folded before Flop (didn't bet)
Seat 5: tepi_guy folded before Flop (didn't bet)
Seat 6: slick_nickDH folded before Flop (didn't bet)
Seat 7: donald0404 (button) folded before Flop (didn't bet)
Seat 8: sanducu_eu (small blind) folded before Flop
Seat 9: Tey113 (big blind) showed [4d 9d] and lost with a pair of Fours





PokerStars Hand #153501027660:  Hold'em No Limit ($0.50/$1.00 USD) - 2016/05/18 20:06:59 CET [2016/05/18 14:06:59 ET]
Table 'Tatjana III' 9-max Seat #1 is the button
Seat 1: cobrik23 ($40 in chips) 
Seat 2: HITYESCA ($100 in chips) 
Seat 3: matiko09 ($179.90 in chips) 
Seat 5: sanr23 ($136.63 in chips) 
Seat 6: Bimaxa ($100 in chips) 
Seat 7: rene1984tsv ($119.33 in chips) 
Seat 8: aseban11 ($100 in chips) 
HITYESCA: posts small blind $0.50
matiko09: posts big blind $1
lydia12345: sits out 
Moszes360: sits out 
*** HOLE CARDS ***
Dealt to matiko09 [Jc 7s]
sanr23: folds 
Bimaxa: folds 
rene1984tsv: raises $1 to $2
aseban11: folds 
cobrik23: raises $5.50 to $7.50
HITYESCA: folds 
matiko09: folds 
rene1984tsv: folds 
Uncalled bet ($5.50) returned to cobrik23
cobrik23 collected $5.50 from pot
cobrik23: doesn't show hand 
*** SUMMARY ***
Total pot $5.50 | Rake $0 
Seat 1: cobrik23 (button) collected ($5.50)
Seat 2: HITYESCA (small blind) folded before Flop
Seat 3: matiko09 (big blind) folded before Flop
Seat 5: sanr23 folded before Flop (didn't bet)
Seat 6: Bimaxa folded before Flop (didn't bet)
Seat 7: rene1984tsv folded before Flop
Seat 8: aseban11 folded before Flop (didn't bet)





PokerStars Hand #153501033210:  Hold'em No Limit ($1/$2 USD) - 2016/05/18 20:07:06 CET [2016/05/18 14:07:06 ET]
Table 'Letaba' 9-max Seat #6 is the button
Seat 1: FREDY BULLIT ($211.31 in chips) 
Seat 2: staruk669 ($92.19 in chips) 
Seat 3: ersevi6 ($205.04 in chips) 
Seat 4: matiko09 ($200 in chips) 
Seat 5: aseban11 ($200 in chips) 
Seat 6: donald0404 ($203.75 in chips) 
Seat 7: moshmachine ($294.97 in chips) 
Seat 8: $-Twackle-$ ($216.88 in chips) 
Seat 9: tepi_guy ($243.76 in chips) 
moshmachine: posts small blind $1
$-Twackle-$: posts big blind $2
*** HOLE CARDS ***
Dealt to matiko09 [9c 3s]
tepi_guy: folds 
FREDY BULLIT: folds 
staruk669: calls $2
ersevi6: folds 
matiko09: folds 
aseban11: raises $5 to $7
donald0404: folds 
moshmachine: folds 
$-Twackle-$: folds 
staruk669: calls $5
*** FLOP *** [3d Qh 5d]
staruk669: checks 
aseban11: bets $12.11
staruk669: calls $12.11
*** TURN *** [3d Qh 5d] [6s]
staruk669: checks 
aseban11: checks 
*** RIVER *** [3d Qh 5d 6s] [8h]
staruk669: bets $40
aseban11: folds 
Uncalled bet ($40) returned to staruk669
staruk669 collected $39.16 from pot
staruk669: doesn't show hand 
*** SUMMARY ***
Total pot $41.22 | Rake $2.06 
Board [3d Qh 5d 6s 8h]
Seat 1: FREDY BULLIT folded before Flop (didn't bet)
Seat 2: staruk669 collected ($39.16)
Seat 3: ersevi6 folded before Flop (didn't bet)
Seat 4: matiko09 folded before Flop (didn't bet)
Seat 5: aseban11 folded on the River
Seat 6: donald0404 (button) folded before Flop (didn't bet)
Seat 7: moshmachine (small blind) folded before Flop
Seat 8: $-Twackle-$ (big blind) folded before Flop
Seat 9: tepi_guy folded before Flop (didn't bet)





PokerStars Hand #153501032700:  Hold'em No Limit ($0.50/$1.00 USD) - 2016/05/18 20:07:06 CET [2016/05/18 14:07:06 ET]
Table 'Saiph II' 9-max Seat #3 is the button
Seat 2: matiko09 ($138.74 in chips) 
Seat 3: lydia12345 ($104.62 in chips) 
Seat 4: dr_mraz1 ($74.50 in chips) 
Seat 5: cobrik23 ($42.49 in chips) 
Seat 7: nickreason17 ($100 in chips) 
Seat 8: sanr23 ($100 in chips) 
Seat 9: alesi007 ($48.12 in chips) 
dr_mraz1: posts small blind $0.50
cobrik23: posts big blind $1
Moszes360: sits out 
*** HOLE CARDS ***
Dealt to matiko09 [6d 3s]
nickreason17: folds 
sanr23: folds 
alesi007: calls $1
matiko09: folds 
lydia12345: folds 
dr_mraz1: folds 
cobrik23: checks 
*** FLOP *** [Jc 6h Ts]
cobrik23: checks 
alesi007: bets $1
cobrik23: folds 
Uncalled bet ($1) returned to alesi007
alesi007 collected $2.38 from pot
alesi007: doesn't show hand 
*** SUMMARY ***
Total pot $2.50 | Rake $0.12 
Board [Jc 6h Ts]
Seat 2: matiko09 folded before Flop (didn't bet)
Seat 3: lydia12345 (button) folded before Flop (didn't bet)
Seat 4: dr_mraz1 (small blind) folded before Flop
Seat 5: cobrik23 (big blind) folded on the Flop
Seat 7: nickreason17 folded before Flop (didn't bet)
Seat 8: sanr23 folded before Flop (didn't bet)
Seat 9: alesi007 collected ($2.38)





PokerStars Hand #153501036096:  Hold'em No Limit ($0.50/$1.00 USD) - 2016/05/18 20:07:10 CET [2016/05/18 14:07:10 ET]
Table 'Abetti II' 9-max Seat #8 is the button
Seat 1: matiko09 ($100 in chips) 
Seat 2: Bimaxa ($128.84 in chips) 
Seat 3: cobrik23 ($259.37 in chips) 
Seat 4: aseban11 ($106.50 in chips) 
Seat 5: blufthenuts ($138.52 in chips) 
Seat 7: nickreason17 ($104.47 in chips) 
Seat 8: roadster683 ($116.82 in chips) 
Seat 9: lydia12345 ($100 in chips) 
lydia12345: posts small blind $0.50
matiko09: posts big blind $1
*** HOLE CARDS ***
Dealt to matiko09 [Tc 4c]
Bimaxa: folds 
cobrik23: folds 
aseban11: folds 
blufthenuts: folds 
nickreason17: folds 
roadster683: raises $1 to $2
lydia12345: calls $1.50
matiko09: calls $1
*** FLOP *** [9d 7s Th]
lydia12345: checks 
matiko09: checks 
roadster683: bets $3
lydia12345: folds 
matiko09: calls $3
*** TURN *** [9d 7s Th] [5d]
matiko09: checks 
roadster683: checks 
*** RIVER *** [9d 7s Th 5d] [Qc]
matiko09: checks 
roadster683: checks 
*** SHOW DOWN ***
matiko09: shows [Tc 4c] (a pair of Tens)
roadster683: mucks hand 
matiko09 collected $11.40 from pot
*** SUMMARY ***
Total pot $12 | Rake $0.60 
Board [9d 7s Th 5d Qc]
Seat 1: matiko09 (big blind) showed [Tc 4c] and won ($11.40) with a pair of Tens
Seat 2: Bimaxa folded before Flop (didn't bet)
Seat 3: cobrik23 folded before Flop (didn't bet)
Seat 4: aseban11 folded before Flop (didn't bet)
Seat 5: blufthenuts folded before Flop (didn't bet)
Seat 7: nickreason17 folded before Flop (didn't bet)
Seat 8: roadster683 (button) mucked [As Jc]
Seat 9: lydia12345 (small blind) folded on the Flop





PokerStars Hand #153501058434:  Hold'em No Limit ($0.50/$1.00 USD) - 2016/05/18 20:07:35 CET [2016/05/18 14:07:35 ET]
Table 'Saiph II' 9-max Seat #4 is the button
Seat 2: matiko09 ($138.74 in chips) 
Seat 3: lydia12345 ($104.62 in chips) 
Seat 4: dr_mraz1 ($74 in chips) 
Seat 5: cobrik23 ($41.49 in chips) 
Seat 6: LadyMaCe86 ($105.50 in chips) 
Seat 7: nickreason17 ($100 in chips) 
Seat 8: sanr23 ($100 in chips) 
Seat 9: alesi007 ($49.50 in chips) 
cobrik23: posts small blind $0.50
LadyMaCe86: posts big blind $1
Moszes360: sits out 
*** HOLE CARDS ***
Dealt to matiko09 [Kc 4s]
nickreason17: raises $1.50 to $2.50
sanr23: folds 
alesi007: folds 
alesi007 leaves the table
matiko09: folds 
lydia12345: folds 
dr_mraz1: folds 
HITYESCA joins the table at seat #9 
cobrik23: folds 
LadyMaCe86: folds 
Uncalled bet ($1.50) returned to nickreason17
HITYESCA leaves the table
nickreason17 collected $2.50 from pot
*** SUMMARY ***
Total pot $2.50 | Rake $0 
Seat 2: matiko09 folded before Flop (didn't bet)
Seat 3: lydia12345 folded before Flop (didn't bet)
Seat 4: dr_mraz1 (button) folded before Flop (didn't bet)
Seat 5: cobrik23 (small blind) folded before Flop
Seat 6: LadyMaCe86 (big blind) folded before Flop
Seat 7: nickreason17 collected ($2.50)
Seat 8: sanr23 folded before Flop (didn't bet)
Seat 9: alesi007 folded before Flop (didn't bet)





PokerStars Hand #153501062991:  Hold'em No Limit ($0.50/$1.00 USD) - 2016/05/18 20:07:41 CET [2016/05/18 14:07:41 ET]
Table 'Tatjana III' 9-max Seat #2 is the button
Seat 1: cobrik23 ($83.50 in chips) 
Seat 2: HITYESCA ($100 in chips) 
Seat 3: matiko09 ($178.90 in chips) 
Seat 4: lydia12345 ($100 in chips) 
Seat 5: sanr23 ($136.63 in chips) 
Seat 6: Bimaxa ($100 in chips) 
Seat 7: rene1984tsv ($117.33 in chips) 
Seat 8: aseban11 ($100 in chips) 
matiko09: posts small blind $0.50
lydia12345: posts big blind $1
Moszes360: sits out 
*** HOLE CARDS ***
Dealt to matiko09 [Ah 6s]
sanr23: folds 
Bimaxa: folds 
rene1984tsv: raises $1 to $2
aseban11: folds 
cobrik23: folds 
HITYESCA: folds 
matiko09: folds 
lydia12345: calls $1
*** FLOP *** [Qh Js Td]
lydia12345: checks 
rene1984tsv: bets $2.14
lydia12345: calls $2.14
*** TURN *** [Qh Js Td] [5c]
lydia12345: checks 
rene1984tsv: checks 
*** RIVER *** [Qh Js Td 5c] [6d]
lydia12345: checks 
rene1984tsv: checks 
*** SHOW DOWN ***
lydia12345: shows [Ts 9s] (a pair of Tens)
rene1984tsv: mucks hand 
lydia12345 collected $8.34 from pot
*** SUMMARY ***
Total pot $8.78 | Rake $0.44 
Board [Qh Js Td 5c 6d]
Seat 1: cobrik23 folded before Flop (didn't bet)
Seat 2: HITYESCA (button) folded before Flop (didn't bet)
Seat 3: matiko09 (small blind) folded before Flop
Seat 4: lydia12345 (big blind) showed [Ts 9s] and won ($8.34) with a pair of Tens
Seat 5: sanr23 folded before Flop (didn't bet)
Seat 6: Bimaxa folded before Flop (didn't bet)
Seat 7: rene1984tsv mucked [5d 2h]
Seat 8: aseban11 folded before Flop (didn't bet)





PokerStars Hand #153501069841:  Hold'em No Limit (€0.50/€1.00 EUR) - 2016/05/18 20:07:49 CET [2016/05/18 14:07:49 ET]
Table 'Pallas II' 9-max Seat #6 is the button
Seat 1: florrin92 (€100 in chips) 
Seat 2: matiko09 (€206.97 in chips) 
Seat 3: nickreason17 (€100 in chips) 
Seat 4: torkkdnm (€131.11 in chips) 
Seat 5: cobrik23 (€71.62 in chips) 
Seat 6: HITYESCA (€101 in chips) 
Seat 7: ipashutapkom (€40 in chips) 
Seat 8: lydia12345 (€102.23 in chips) 
Seat 9: stijner1986 (€96.38 in chips) 
ipashutapkom: posts small blind €0.50
lydia12345: posts big blind €1
*** HOLE CARDS ***
Dealt to matiko09 [8s 2h]
stijner1986: folds 
florrin92: folds 
matiko09: folds 
nickreason17: folds 
florrin92 leaves the table
torkkdnm: raises €1.50 to €2.50
cobrik23: calls €2.50
HITYESCA: calls €2.50
ipashutapkom: folds 
lydia12345: folds 
*** FLOP *** [Tc 7h Ad]
deadkiller1 joins the table at seat #1 
torkkdnm: checks 
cobrik23: checks 
HITYESCA: checks 
*** TURN *** [Tc 7h Ad] [5d]
torkkdnm: bets €6
cobrik23: folds 
HITYESCA: folds 
Uncalled bet (€6) returned to torkkdnm
torkkdnm collected €8.55 from pot
*** SUMMARY ***
Total pot €9 | Rake €0.45 
Board [Tc 7h Ad 5d]
Seat 1: florrin92 folded before Flop (didn't bet)
Seat 2: matiko09 folded before Flop (didn't bet)
Seat 3: nickreason17 folded before Flop (didn't bet)
Seat 4: torkkdnm collected (€8.55)
Seat 5: cobrik23 folded on the Turn
Seat 6: HITYESCA (button) folded on the Turn
Seat 7: ipashutapkom (small blind) folded before Flop
Seat 8: lydia12345 (big blind) folded before Flop
Seat 9: stijner1986 folded before Flop (didn't bet)





PokerStars Hand #153501074875:  Hold'em No Limit ($0.50/$1.00 USD) - 2016/05/18 20:07:54 CET [2016/05/18 14:07:54 ET]
Table 'Saiph II' 9-max Seat #5 is the button
Seat 2: matiko09 ($138.74 in chips) 
Seat 3: lydia12345 ($104.62 in chips) 
Seat 4: dr_mraz1 ($74 in chips) 
Seat 5: cobrik23 ($40.99 in chips) 
Seat 6: LadyMaCe86 ($104.50 in chips) 
Seat 7: nickreason17 ($101.50 in chips) 
Seat 8: sanr23 ($100 in chips) 
LadyMaCe86: posts small blind $0.50
nickreason17: posts big blind $1
Moszes360: sits out 
*** HOLE CARDS ***
Dealt to matiko09 [6h 9c]
sanr23: folds 
matiko09: folds 
lydia12345: raises $2 to $3
dr_mraz1: raises $2 to $5
Moszes360 leaves the table
cobrik23: folds 
LadyMaCe86: folds 
nickreason17: folds 
Bimaxa joins the table at seat #9 
lydia12345: raises $14 to $19
dr_mraz1: calls $14
*** FLOP *** [Kc Qs 4d]
Bimaxa leaves the table
HITYESCA joins the table at seat #9 
lydia12345: bets $12
dr_mraz1: raises $12 to $24
lydia12345: raises $56.23 to $80.23
dr_mraz1: calls $31 and is all-in
Uncalled bet ($25.23) returned to lydia12345
*** TURN *** [Kc Qs 4d] [Js]
*** RIVER *** [Kc Qs 4d Js] [4s]
*** SHOW DOWN ***
lydia12345: shows [As Ad] (two pair, Aces and Fours)
dr_mraz1: shows [Kh Qh] (two pair, Kings and Queens)
lydia12345 collected $147 from pot
*** SUMMARY ***
Total pot $149.50 | Rake $2.50 
Board [Kc Qs 4d Js 4s]
Seat 2: matiko09 folded before Flop (didn't bet)
Seat 3: lydia12345 showed [As Ad] and won ($147) with two pair, Aces and Fours
Seat 4: dr_mraz1 showed [Kh Qh] and lost with two pair, Kings and Queens
Seat 5: cobrik23 (button) folded before Flop (didn't bet)
Seat 6: LadyMaCe86 (small blind) folded before Flop
Seat 7: nickreason17 (big blind) folded before Flop
Seat 8: sanr23 folded before Flop (didn't bet)





PokerStars Hand #153501078736:  Hold'em No Limit ($1/$2 USD) - 2016/05/18 20:07:59 CET [2016/05/18 14:07:59 ET]
Table 'Chlosinde' 9-max Seat #8 is the button
Seat 1: ersevi6 ($160 in chips) 
Seat 2: aseban11 ($200 in chips) 
Seat 3: matiko09 ($225.25 in chips) 
Seat 4: FREDY BULLIT ($230.85 in chips) 
Seat 5: tepi_guy ($649.69 in chips) 
Seat 6: slick_nickDH ($391.56 in chips) 
Seat 7: donald0404 ($200 in chips) 
Seat 8: sanducu_eu ($222.22 in chips) 
Seat 9: Tey113 ($589.73 in chips) 
Tey113: posts small blind $1
ersevi6: posts big blind $2
*** HOLE CARDS ***
Dealt to matiko09 [3s 2s]
aseban11: folds 
matiko09: folds 
FREDY BULLIT: folds 
tepi_guy: raises $3.40 to $5.40
slick_nickDH: folds 
donald0404: folds 
sanducu_eu: raises $12.60 to $18
Tey113: folds 
ersevi6: folds 
tepi_guy: raises $24 to $42
sanducu_eu: calls $24
*** FLOP *** [7h Kc 9s]
tepi_guy: bets $32.01
sanducu_eu: calls $32.01
*** TURN *** [7h Kc 9s] [6s]
tepi_guy: bets $150.27
sanducu_eu: calls $148.21 and is all-in
Uncalled bet ($2.06) returned to tepi_guy
*** FIRST RIVER *** [7h Kc 9s 6s] [3d]
*** SECOND RIVER *** [7h Kc 9s 6s] [Jd]
*** FIRST SHOW DOWN ***
tepi_guy: shows [Ac Ah] (a pair of Aces)
sanducu_eu: shows [Kd As] (a pair of Kings)
tepi_guy collected $222.35 from pot
*** SECOND SHOW DOWN ***
tepi_guy: shows [Ac Ah] (a pair of Aces)
sanducu_eu: shows [Kd As] (a pair of Kings)
tepi_guy collected $222.34 from pot
*** SUMMARY ***
Total pot $447.44 | Rake $2.75 
Hand was run twice
FIRST Board [7h Kc 9s 6s 3d]
SECOND Board [7h Kc 9s 6s Jd]
Seat 1: ersevi6 (big blind) folded before Flop
Seat 2: aseban11 folded before Flop (didn't bet)
Seat 3: matiko09 folded before Flop (didn't bet)
Seat 4: FREDY BULLIT folded before Flop (didn't bet)
Seat 5: tepi_guy showed [Ac Ah] and won ($222.35) with a pair of Aces, and won ($222.34) with a pair of Aces
Seat 6: slick_nickDH folded before Flop (didn't bet)
Seat 7: donald0404 folded before Flop (didn't bet)
Seat 8: sanducu_eu (button) showed [Kd As] and lost with a pair of Kings, and lost with a pair of Kings
Seat 9: Tey113 (small blind) folded before Flop





PokerStars Hand #153501093273:  Hold'em No Limit ($0.50/$1.00 USD) - 2016/05/18 20:08:16 CET [2016/05/18 14:08:16 ET]
Table 'Abetti II' 9-max Seat #9 is the button
Seat 1: matiko09 ($106.40 in chips) 
Seat 2: Bimaxa ($128.84 in chips) 
Seat 3: cobrik23 ($259.37 in chips) 
Seat 4: aseban11 ($106.50 in chips) 
Seat 5: blufthenuts ($138.52 in chips) 
Seat 7: nickreason17 ($104.47 in chips) 
Seat 8: roadster683 ($111.82 in chips) 
Seat 9: lydia12345 ($100 in chips) 
matiko09: posts small blind $0.50
Bimaxa: posts big blind $1
*** HOLE CARDS ***
Dealt to matiko09 [Jh 6s]
cobrik23: folds 
aseban11: folds 
blufthenuts: folds 
nickreason17: folds 
roadster683: folds 
lydia12345: raises $2 to $3
matiko09: folds 
Bimaxa: folds 
Uncalled bet ($2) returned to lydia12345
lydia12345 collected $2.50 from pot
*** SUMMARY ***
Total pot $2.50 | Rake $0 
Seat 1: matiko09 (small blind) folded before Flop
Seat 2: Bimaxa (big blind) folded before Flop
Seat 3: cobrik23 folded before Flop (didn't bet)
Seat 4: aseban11 folded before Flop (didn't bet)
Seat 5: blufthenuts folded before Flop (didn't bet)
Seat 7: nickreason17 folded before Flop (didn't bet)
Seat 8: roadster683 folded before Flop (didn't bet)
Seat 9: lydia12345 (button) collected ($2.50)





PokerStars Hand #153501098309:  Hold'em No Limit ($1/$2 USD) - 2016/05/18 20:08:22 CET [2016/05/18 14:08:22 ET]
Table 'Letaba' 9-max Seat #7 is the button
Seat 1: FREDY BULLIT ($211.31 in chips) 
Seat 2: staruk669 ($112.24 in chips) 
Seat 3: ersevi6 ($205.04 in chips) 
Seat 4: matiko09 ($200 in chips) 
Seat 5: aseban11 ($200 in chips) 
Seat 6: donald0404 ($203.75 in chips) 
Seat 7: moshmachine ($293.97 in chips) 
Seat 8: $-Twackle-$ ($214.88 in chips) 
Seat 9: tepi_guy ($243.76 in chips) 
$-Twackle-$: posts small blind $1
tepi_guy: posts big blind $2
*** HOLE CARDS ***
Dealt to matiko09 [Kd 3d]
FREDY BULLIT: raises $3.80 to $5.80
staruk669: folds 
ersevi6: folds 
matiko09: folds 
aseban11: folds 
donald0404: calls $5.80
moshmachine: folds 
$-Twackle-$: folds 
tepi_guy: calls $3.80
*** FLOP *** [4s 5h 6h]
tepi_guy: checks 
FREDY BULLIT: checks 
donald0404: bets $11.18
tepi_guy: calls $11.18
FREDY BULLIT: folds 
*** TURN *** [4s 5h 6h] [7s]
tepi_guy: checks 
donald0404: bets $42
tepi_guy: folds 
Uncalled bet ($42) returned to donald0404
donald0404 collected $38.72 from pot
donald0404: doesn't show hand 
*** SUMMARY ***
Total pot $40.76 | Rake $2.04 
Board [4s 5h 6h 7s]
Seat 1: FREDY BULLIT folded on the Flop
Seat 2: staruk669 folded before Flop (didn't bet)
Seat 3: ersevi6 folded before Flop (didn't bet)
Seat 4: matiko09 folded before Flop (didn't bet)
Seat 5: aseban11 folded before Flop (didn't bet)
Seat 6: donald0404 collected ($38.72)
Seat 7: moshmachine (button) folded before Flop (didn't bet)
Seat 8: $-Twackle-$ (small blind) folded before Flop
Seat 9: tepi_guy (big blind) folded on the Turn





PokerStars Hand #153501101732:  Hold'em No Limit ($0.50/$1.00 USD) - 2016/05/18 20:08:25 CET [2016/05/18 14:08:25 ET]
Table 'Tatjana III' 9-max Seat #3 is the button
Seat 1: cobrik23 ($83.50 in chips) 
Seat 2: HITYESCA ($100 in chips) 
Seat 3: matiko09 ($178.40 in chips) 
Seat 4: lydia12345 ($104.20 in chips) 
Seat 7: rene1984tsv ($113.19 in chips) 
Seat 8: aseban11 ($100 in chips) 
lydia12345: posts small blind $0.50
sanr23: is sitting out 
Bimaxa: is sitting out 
rene1984tsv: posts big blind $1
Moszes360: sits out 
*** HOLE CARDS ***
Dealt to matiko09 [8c Kh]
aseban11: raises $2 to $3
cobrik23: folds 
Bimaxa leaves the table
sanr23 leaves the table
nickreason17 joins the table at seat #6 
HITYESCA: raises $6 to $9
matiko09: folds 
lydia12345: folds 
rene1984tsv: folds 
aseban11: raises $12 to $21
HITYESCA: calls $12
*** FLOP *** [5d 7c 6d]
deadkiller1 joins the table at seat #5 
aseban11: bets $18.50
HITYESCA: raises $60.50 to $79 and is all-in
aseban11: folds 
Uncalled bet ($60.50) returned to HITYESCA
HITYESCA collected $78 from pot
HITYESCA: doesn't show hand 
*** SUMMARY ***
Total pot $80.50 | Rake $2.50 
Board [5d 7c 6d]
Seat 1: cobrik23 folded before Flop (didn't bet)
Seat 2: HITYESCA collected ($78)
Seat 3: matiko09 (button) folded before Flop (didn't bet)
Seat 4: lydia12345 (small blind) folded before Flop
Seat 7: rene1984tsv (big blind) folded before Flop
Seat 8: aseban11 folded on the Flop





PokerStars Hand #153501117804:  Hold'em No Limit ($0.50/$1.00 USD) - 2016/05/18 20:08:44 CET [2016/05/18 14:08:44 ET]
Table 'Abetti II' 9-max Seat #1 is the button
Seat 1: matiko09 ($105.90 in chips) 
Seat 2: Bimaxa ($127.84 in chips) 
Seat 3: cobrik23 ($259.37 in chips) 
Seat 4: aseban11 ($106.50 in chips) 
Seat 5: blufthenuts ($138.52 in chips) 
Seat 7: nickreason17 ($104.47 in chips) 
Seat 8: roadster683 ($111.82 in chips) 
Seat 9: lydia12345 ($101.50 in chips) 
Bimaxa: posts small blind $0.50
cobrik23: posts big blind $1
*** HOLE CARDS ***
Dealt to matiko09 [Kh Ad]
aseban11: folds 
blufthenuts: folds 
nickreason17: folds 
roadster683: calls $1
lydia12345: calls $1
matiko09: raises $4 to $5
Bimaxa: folds 
cobrik23: folds 
roadster683: calls $4
lydia12345: calls $4
*** FLOP *** [9c Kc 2s]
roadster683: checks 
lydia12345: checks 
matiko09: bets $10
roadster683: folds 
lydia12345: calls $10
*** TURN *** [9c Kc 2s] [6s]
lydia12345: checks 
matiko09: checks 
*** RIVER *** [9c Kc 2s 6s] [8h]
lydia12345: checks 
matiko09: checks 
*** SHOW DOWN ***
lydia12345: shows [4c Ac] (high card Ace)
matiko09: shows [Kh Ad] (a pair of Kings)
matiko09 collected $34.68 from pot
*** SUMMARY ***
Total pot $36.50 | Rake $1.82 
Board [9c Kc 2s 6s 8h]
Seat 1: matiko09 (button) showed [Kh Ad] and won ($34.68) with a pair of Kings
Seat 2: Bimaxa (small blind) folded before Flop
Seat 3: cobrik23 (big blind) folded before Flop
Seat 4: aseban11 folded before Flop (didn't bet)
Seat 5: blufthenuts folded before Flop (didn't bet)
Seat 7: nickreason17 folded before Flop (didn't bet)
Seat 8: roadster683 folded on the Flop
Seat 9: lydia12345 showed [4c Ac] and lost with high card Ace





PokerStars Hand #153501123115:  Hold'em No Limit ($0.50/$1.00 USD) - 2016/05/18 20:08:50 CET [2016/05/18 14:08:50 ET]
Table 'Saiph II' 9-max Seat #6 is the button
Seat 2: matiko09 ($138.74 in chips) 
Seat 3: lydia12345 ($177.62 in chips) 
Seat 5: cobrik23 ($40.99 in chips) 
Seat 6: LadyMaCe86 ($104 in chips) 
Seat 7: nickreason17 ($100.50 in chips) 
Seat 8: sanr23 ($100 in chips) 
nickreason17: posts small blind $0.50
sanr23: posts big blind $1
HITYESCA: sits out 
*** HOLE CARDS ***
Dealt to matiko09 [Ah 3d]
matiko09: folds 
lydia12345: folds 
MAARKKKK joins the table at seat #1 
cobrik23: raises $1.50 to $2.50
LadyMaCe86: folds 
dr_mraz1 leaves the table
nickreason17: folds 
deadkiller1 joins the table at seat #4 
sanr23: calls $1.50
*** FLOP *** [Qh 5d 9h]
sanr23: checks 
cobrik23: bets $3
sanr23: raises $6 to $9
cobrik23: folds 
Uncalled bet ($6) returned to sanr23
sanr23 collected $10.92 from pot
sanr23: doesn't show hand 
*** SUMMARY ***
Total pot $11.50 | Rake $0.58 
Board [Qh 5d 9h]
Seat 2: matiko09 folded before Flop (didn't bet)
Seat 3: lydia12345 folded before Flop (didn't bet)
Seat 5: cobrik23 folded on the Flop
Seat 6: LadyMaCe86 (button) folded before Flop (didn't bet)
Seat 7: nickreason17 (small blind) folded before Flop
Seat 8: sanr23 (big blind) collected ($10.92)





PokerStars Hand #153501137733:  Hold'em No Limit (€0.50/€1.00 EUR) - 2016/05/18 20:09:07 CET [2016/05/18 14:09:07 ET]
Table 'Pallas II' 9-max Seat #7 is the button
Seat 2: matiko09 (€206.97 in chips) 
Seat 3: nickreason17 (€100 in chips) 
Seat 4: torkkdnm (€137.16 in chips) 
Seat 5: cobrik23 (€69.12 in chips) 
Seat 6: HITYESCA (€100 in chips) 
Seat 7: ipashutapkom (€40 in chips) 
Seat 8: lydia12345 (€101.23 in chips) 
Seat 9: stijner1986 (€96.38 in chips) 
lydia12345: posts small blind €0.50
stijner1986: posts big blind €1
deadkiller1: sits out 
*** HOLE CARDS ***
Dealt to matiko09 [6d Qc]
matiko09: folds 
nickreason17: folds 
torkkdnm: folds 
cobrik23: folds 
HITYESCA: raises €1.50 to €2.50
ipashutapkom: folds 
lydia12345: folds 
stijner1986: calls €1.50
*** FLOP *** [5h 4d 3d]
stijner1986: checks 
HITYESCA: bets €4
stijner1986: calls €4
*** TURN *** [5h 4d 3d] [Ac]
stijner1986: checks 
HITYESCA: checks 
*** RIVER *** [5h 4d 3d Ac] [Kc]
stijner1986: bets €17
HITYESCA: calls €17
*** SHOW DOWN ***
stijner1986: shows [Jd 5d] (a pair of Fives)
HITYESCA: shows [Kh Ad] (two pair, Aces and Kings)
HITYESCA collected €45.25 from pot
*** SUMMARY ***
Total pot €47.50 | Rake €2.25 
Board [5h 4d 3d Ac Kc]
Seat 2: matiko09 folded before Flop (didn't bet)
Seat 3: nickreason17 folded before Flop (didn't bet)
Seat 4: torkkdnm folded before Flop (didn't bet)
Seat 5: cobrik23 folded before Flop (didn't bet)
Seat 6: HITYESCA showed [Kh Ad] and won (€45.25) with two pair, Aces and Kings
Seat 7: ipashutapkom (button) folded before Flop (didn't bet)
Seat 8: lydia12345 (small blind) folded before Flop
Seat 9: stijner1986 (big blind) showed [Jd 5d] and lost with a pair of Fives





PokerStars Hand #153501169640:  Hold'em No Limit ($0.50/$1.00 USD) - 2016/05/18 20:09:44 CET [2016/05/18 14:09:44 ET]
Table 'Tatjana III' 9-max Seat #4 is the button
Seat 1: cobrik23 ($83.50 in chips) 
Seat 2: HITYESCA ($138.50 in chips) 
Seat 3: matiko09 ($178.40 in chips) 
Seat 4: lydia12345 ($103.70 in chips) 
Seat 7: rene1984tsv ($112.19 in chips) 
Seat 9: Moszes360 ($100 in chips) 
deadkiller1 will be allowed to play after the button
rene1984tsv: posts small blind $0.50
aseban11: is sitting out 
Moszes360: posts big blind $1
*** HOLE CARDS ***
Dealt to matiko09 [7h Kc]
aseban11 leaves the table
cobrik23: folds 
JACQUILF joins the table at seat #8 
HITYESCA: folds 
matiko09: folds 
lydia12345: raises $2 to $3
rene1984tsv: calls $2.50
Moszes360: folds 
*** FLOP *** [4c 6s Js]
rene1984tsv: checks 
lydia12345: bets $4.52
rene1984tsv: calls $4.52
*** TURN *** [4c 6s Js] [Qh]
rene1984tsv: checks 
lydia12345: bets $10.36
rene1984tsv: folds 
Uncalled bet ($10.36) returned to lydia12345
lydia12345 collected $15.24 from pot
*** SUMMARY ***
Total pot $16.04 | Rake $0.80 
Board [4c 6s Js Qh]
Seat 1: cobrik23 folded before Flop (didn't bet)
Seat 2: HITYESCA folded before Flop (didn't bet)
Seat 3: matiko09 folded before Flop (didn't bet)
Seat 4: lydia12345 (button) collected ($15.24)
Seat 7: rene1984tsv (small blind) folded on the Turn
Seat 9: Moszes360 (big blind) folded before Flop





PokerStars Hand #153501179170:  Hold'em No Limit ($1/$2 USD) - 2016/05/18 20:09:55 CET [2016/05/18 14:09:55 ET]
Table 'Chlosinde' 9-max Seat #9 is the button
Seat 1: ersevi6 ($158 in chips) 
Seat 3: matiko09 ($225.25 in chips) 
Seat 4: FREDY BULLIT ($230.85 in chips) 
Seat 5: tepi_guy ($872.16 in chips) 
Seat 6: slick_nickDH ($391.56 in chips) 
Seat 7: donald0404 ($200 in chips) 
Seat 8: sanducu_eu ($200 in chips) 
Seat 9: Tey113 ($588.73 in chips) 
ersevi6: posts small blind $1
aseban11: is sitting out 
matiko09: posts big blind $2
*** HOLE CARDS ***
Dealt to matiko09 [6d 4h]
aseban11 leaves the table
FREDY BULLIT: folds 
lydia12345 joins the table at seat #2 
tepi_guy has timed out
tepi_guy: folds 
slick_nickDH: raises $4 to $6
donald0404: folds 
sanducu_eu: folds 
Tey113: calls $6
ersevi6: folds 
matiko09: folds 
*** FLOP *** [3s Ks 5c]
slick_nickDH: bets $8
Tey113: folds 
Uncalled bet ($8) returned to slick_nickDH
slick_nickDH collected $14.25 from pot
slick_nickDH: doesn't show hand 
*** SUMMARY ***
Total pot $15 | Rake $0.75 
Board [3s Ks 5c]
Seat 1: ersevi6 (small blind) folded before Flop
Seat 3: matiko09 (big blind) folded before Flop
Seat 4: FREDY BULLIT folded before Flop (didn't bet)
Seat 5: tepi_guy folded before Flop (didn't bet)
Seat 6: slick_nickDH collected ($14.25)
Seat 7: donald0404 folded before Flop (didn't bet)
Seat 8: sanducu_eu folded before Flop (didn't bet)
Seat 9: Tey113 (button) folded on the Flop





PokerStars Hand #153501179701:  Hold'em No Limit ($0.50/$1.00 USD) - 2016/05/18 20:09:55 CET [2016/05/18 14:09:55 ET]
Table 'Saiph II' 9-max Seat #7 is the button
Seat 2: matiko09 ($138.74 in chips) 
Seat 3: lydia12345 ($177.62 in chips) 
Seat 5: cobrik23 ($35.49 in chips) 
Seat 6: LadyMaCe86 ($104 in chips) 
Seat 7: nickreason17 ($100 in chips) 
Seat 8: sanr23 ($105.42 in chips) 
Seat 9: HITYESCA ($100 in chips) 
sanr23: posts small blind $0.50
HITYESCA: posts big blind $1
MAARKKKK: sits out 
deadkiller1: sits out 
*** HOLE CARDS ***
Dealt to matiko09 [Kc 8d]
matiko09: folds 
lydia12345: folds 
cobrik23: raises $2 to $3
LadyMaCe86: folds 
nickreason17: folds 
sanr23: folds 
HITYESCA: folds 
Uncalled bet ($2) returned to cobrik23
cobrik23 collected $2.50 from pot
cobrik23: doesn't show hand 
*** SUMMARY ***
Total pot $2.50 | Rake $0 
Seat 2: matiko09 folded before Flop (didn't bet)
Seat 3: lydia12345 folded before Flop (didn't bet)
Seat 5: cobrik23 collected ($2.50)
Seat 6: LadyMaCe86 folded before Flop (didn't bet)
Seat 7: nickreason17 (button) folded before Flop (didn't bet)
Seat 8: sanr23 (small blind) folded before Flop
Seat 9: HITYESCA (big blind) folded before Flop





PokerStars Hand #153501186847:  Hold'em No Limit (€0.50/€1.00 EUR) - 2016/05/18 20:10:04 CET [2016/05/18 14:10:04 ET]
Table 'Pallas II' 9-max Seat #8 is the button
Seat 1: deadkiller1 (€100 in chips) 
Seat 2: matiko09 (€206.97 in chips) 
Seat 3: nickreason17 (€100 in chips) 
Seat 4: torkkdnm (€137.16 in chips) 
Seat 5: cobrik23 (€69.12 in chips) 
Seat 6: HITYESCA (€121.75 in chips) 
Seat 7: ipashutapkom (€40 in chips) 
Seat 8: lydia12345 (€100.73 in chips) 
Seat 9: stijner1986 (€72.88 in chips) 
stijner1986: posts small blind €0.50
deadkiller1: posts big blind €1
*** HOLE CARDS ***
Dealt to matiko09 [Jh 2d]
matiko09: folds 
nickreason17: folds 
torkkdnm: folds 
cobrik23: folds 
HITYESCA: raises €2 to €3
ipashutapkom: folds 
lydia12345: folds 
stijner1986: folds 
deadkiller1: folds 
Uncalled bet (€2) returned to HITYESCA
HITYESCA collected €2.50 from pot
HITYESCA: doesn't show hand 
*** SUMMARY ***
Total pot €2.50 | Rake €0 
Seat 1: deadkiller1 (big blind) folded before Flop
Seat 2: matiko09 folded before Flop (didn't bet)
Seat 3: nickreason17 folded before Flop (didn't bet)
Seat 4: torkkdnm folded before Flop (didn't bet)
Seat 5: cobrik23 folded before Flop (didn't bet)
Seat 6: HITYESCA collected (€2.50)
Seat 7: ipashutapkom folded before Flop (didn't bet)
Seat 8: lydia12345 (button) folded before Flop (didn't bet)
Seat 9: stijner1986 (small blind) folded before Flop





PokerStars Hand #153501208502:  Hold'em No Limit ($0.50/$1.00 USD) - 2016/05/18 20:10:30 CET [2016/05/18 14:10:30 ET]
Table 'Tatjana III' 9-max Seat #7 is the button
Seat 1: cobrik23 ($83.50 in chips) 
Seat 2: HITYESCA ($138.50 in chips) 
Seat 3: matiko09 ($178.40 in chips) 
Seat 4: lydia12345 ($111.42 in chips) 
Seat 7: rene1984tsv ($104.67 in chips) 
Seat 9: Moszes360 ($100 in chips) 
JACQUILF will be allowed to play after the button
Moszes360: posts small blind $0.50
cobrik23: posts big blind $1
deadkiller1: sits out 
*** HOLE CARDS ***
Dealt to matiko09 [Th Qh]
HITYESCA: folds 
matiko09: raises $2 to $3
lydia12345: folds 
rene1984tsv: calls $3
Moszes360: folds 
cobrik23: raises $10 to $13
matiko09: folds 
rene1984tsv: calls $10
*** FLOP *** [Td 8c 6h]
cobrik23: checks 
rene1984tsv: bets $16
cobrik23: calls $16
*** TURN *** [Td 8c 6h] [Jh]
cobrik23: bets $54.50 and is all-in
rene1984tsv: calls $54.50
*** RIVER *** [Td 8c 6h Jh] [6c]
*** SHOW DOWN ***
cobrik23: shows [As Qc] (a pair of Sixes)
rene1984tsv: shows [7h 9s] (a straight, Seven to Jack)
rene1984tsv collected $168 from pot
*** SUMMARY ***
Total pot $170.50 | Rake $2.50 
Board [Td 8c 6h Jh 6c]
Seat 1: cobrik23 (big blind) showed [As Qc] and lost with a pair of Sixes
Seat 2: HITYESCA folded before Flop (didn't bet)
Seat 3: matiko09 folded before Flop
Seat 4: lydia12345 folded before Flop (didn't bet)
Seat 7: rene1984tsv (button) showed [7h 9s] and won ($168) with a straight, Seven to Jack
Seat 9: Moszes360 (small blind) folded before Flop





PokerStars Hand #153501212964:  Hold'em No Limit ($1/$2 USD) - 2016/05/18 20:10:35 CET [2016/05/18 14:10:35 ET]
Table 'Letaba' 9-max Seat #8 is the button
Seat 1: FREDY BULLIT ($205.51 in chips) 
Seat 2: staruk669 ($112.24 in chips) 
Seat 3: ersevi6 ($205.04 in chips) 
Seat 4: matiko09 ($200 in chips) 
Seat 5: aseban11 ($200 in chips) 
Seat 6: donald0404 ($225.49 in chips) 
Seat 7: moshmachine ($293.97 in chips) 
Seat 8: $-Twackle-$ ($213.88 in chips) 
Seat 9: tepi_guy ($226.78 in chips) 
tepi_guy: posts small blind $1
FREDY BULLIT: posts big blind $2
*** HOLE CARDS ***
Dealt to matiko09 [8d 8s]
staruk669: folds 
ersevi6: folds 
matiko09: raises $3 to $5
aseban11: folds 
donald0404: folds 
moshmachine: folds 
$-Twackle-$: folds 
tepi_guy: calls $4
FREDY BULLIT: folds 
*** FLOP *** [7c 2s Jd]
tepi_guy: checks 
matiko09: checks 
*** TURN *** [7c 2s Jd] [Th]
tepi_guy: bets $7.30
matiko09: calls $7.30
*** RIVER *** [7c 2s Jd Th] [Ad]
tepi_guy: bets $16.17
matiko09: folds 
Uncalled bet ($16.17) returned to tepi_guy
tepi_guy collected $25.27 from pot
tepi_guy: doesn't show hand 
*** SUMMARY ***
Total pot $26.60 | Rake $1.33 
Board [7c 2s Jd Th Ad]
Seat 1: FREDY BULLIT (big blind) folded before Flop
Seat 2: staruk669 folded before Flop (didn't bet)
Seat 3: ersevi6 folded before Flop (didn't bet)
Seat 4: matiko09 folded on the River
Seat 5: aseban11 folded before Flop (didn't bet)
Seat 6: donald0404 folded before Flop (didn't bet)
Seat 7: moshmachine folded before Flop (didn't bet)
Seat 8: $-Twackle-$ (button) folded before Flop (didn't bet)
Seat 9: tepi_guy (small blind) collected ($25.27)





PokerStars Hand #153501214492:  Hold'em No Limit (€0.50/€1.00 EUR) - 2016/05/18 20:10:36 CET [2016/05/18 14:10:36 ET]
Table 'Pallas II' 9-max Seat #9 is the button
Seat 1: deadkiller1 (€100 in chips) 
Seat 2: matiko09 (€206.97 in chips) 
Seat 3: nickreason17 (€100 in chips) 
Seat 4: torkkdnm (€137.16 in chips) 
Seat 5: cobrik23 (€69.12 in chips) 
Seat 6: HITYESCA (€123.25 in chips) 
Seat 7: ipashutapkom (€40 in chips) 
Seat 8: lydia12345 (€100.73 in chips) 
Seat 9: stijner1986 (€72.38 in chips) 
deadkiller1: posts small blind €0.50
matiko09: posts big blind €1
*** HOLE CARDS ***
Dealt to matiko09 [7h 9c]
nickreason17: raises €1.50 to €2.50
torkkdnm: folds 
cobrik23: folds 
HITYESCA: folds 
ipashutapkom: calls €2.50
lydia12345: raises €11.50 to €14
stijner1986: raises €58.38 to €72.38 and is all-in
deadkiller1: folds 
matiko09: folds 
nickreason17: folds 
ipashutapkom: folds 
lydia12345: calls €58.38
*** FLOP *** [7d 9d Kc]
*** TURN *** [7d 9d Kc] [Tc]
*** RIVER *** [7d 9d Kc Tc] [2c]
*** SHOW DOWN ***
lydia12345: shows [As Ah] (a pair of Aces)
stijner1986: shows [Ks Kd] (three of a kind, Kings)
stijner1986 collected €149.01 from pot
*** SUMMARY ***
Total pot €151.26 | Rake €2.25 
Board [7d 9d Kc Tc 2c]
Seat 1: deadkiller1 (small blind) folded before Flop
Seat 2: matiko09 (big blind) folded before Flop
Seat 3: nickreason17 folded before Flop
Seat 4: torkkdnm folded before Flop (didn't bet)
Seat 5: cobrik23 folded before Flop (didn't bet)
Seat 6: HITYESCA folded before Flop (didn't bet)
Seat 7: ipashutapkom folded before Flop
Seat 8: lydia12345 showed [As Ah] and lost with a pair of Aces
Seat 9: stijner1986 (button) showed [Ks Kd] and won (€149.01) with three of a kind, Kings





PokerStars Hand #153501215147:  Hold'em No Limit ($0.50/$1.00 USD) - 2016/05/18 20:10:37 CET [2016/05/18 14:10:37 ET]
Table 'Saiph II' 9-max Seat #8 is the button
Seat 1: MAARKKKK ($59.42 in chips) 
Seat 2: matiko09 ($138.74 in chips) 
Seat 3: lydia12345 ($177.62 in chips) 
Seat 5: cobrik23 ($36.99 in chips) 
Seat 6: LadyMaCe86 ($104 in chips) 
Seat 7: nickreason17 ($100 in chips) 
Seat 8: sanr23 ($104.92 in chips) 
Seat 9: HITYESCA ($100 in chips) 
HITYESCA: posts small blind $0.50
MAARKKKK: posts big blind $1
deadkiller1: sits out 
*** HOLE CARDS ***
Dealt to matiko09 [4s 2s]
matiko09: folds 
lydia12345: folds 
cobrik23: folds 
LadyMaCe86: folds 
nickreason17: folds 
sanr23: raises $1 to $2
HITYESCA: folds 
MAARKKKK: calls $1
*** FLOP *** [6s 7d Jh]
MAARKKKK: bets $4.28
sanr23: folds 
Uncalled bet ($4.28) returned to MAARKKKK
MAARKKKK collected $4.28 from pot
MAARKKKK: doesn't show hand 
*** SUMMARY ***
Total pot $4.50 | Rake $0.22 
Board [6s 7d Jh]
Seat 1: MAARKKKK (big blind) collected ($4.28)
Seat 2: matiko09 folded before Flop (didn't bet)
Seat 3: lydia12345 folded before Flop (didn't bet)
Seat 5: cobrik23 folded before Flop (didn't bet)
Seat 6: LadyMaCe86 folded before Flop (didn't bet)
Seat 7: nickreason17 folded before Flop (didn't bet)
Seat 8: sanr23 (button) folded on the Flop
Seat 9: HITYESCA (small blind) folded before Flop





PokerStars Hand #153501235209:  Hold'em No Limit ($0.50/$1.00 USD) - 2016/05/18 20:11:00 CET [2016/05/18 14:11:00 ET]
Table 'Abetti II' 9-max Seat #2 is the button
Seat 1: matiko09 ($125.58 in chips) 
Seat 2: Bimaxa ($127.34 in chips) 
Seat 3: cobrik23 ($258.37 in chips) 
Seat 5: blufthenuts ($138.52 in chips) 
Seat 7: nickreason17 ($104.47 in chips) 
Seat 8: roadster683 ($106.82 in chips) 
Seat 9: lydia12345 ($100 in chips) 
cobrik23: posts small blind $0.50
aseban11: is sitting out 
blufthenuts: posts big blind $1
*** HOLE CARDS ***
Dealt to matiko09 [Qh 7d]
aseban11 leaves the table
nickreason17: folds 
roadster683: calls $1
lydia12345: folds 
matiko09: folds 
Bimaxa: folds 
cobrik23: folds 
blufthenuts: checks 
*** FLOP *** [9s 4h Kd]
blufthenuts: checks 
roadster683: bets $2
blufthenuts: folds 
Uncalled bet ($2) returned to roadster683
roadster683 collected $2.38 from pot
roadster683: doesn't show hand 
*** SUMMARY ***
Total pot $2.50 | Rake $0.12 
Board [9s 4h Kd]
Seat 1: matiko09 folded before Flop (didn't bet)
Seat 2: Bimaxa (button) folded before Flop (didn't bet)
Seat 3: cobrik23 (small blind) folded before Flop
Seat 5: blufthenuts (big blind) folded on the Flop
Seat 7: nickreason17 folded before Flop (didn't bet)
Seat 8: roadster683 collected ($2.38)
Seat 9: lydia12345 folded before Flop (didn't bet)





PokerStars Hand #153501238391:  Hold'em No Limit ($1/$2 USD) - 2016/05/18 20:11:04 CET [2016/05/18 14:11:04 ET]
Table 'Chlosinde' 9-max Seat #1 is the button
Seat 1: ersevi6 ($157 in chips) 
Seat 3: matiko09 ($223.25 in chips) 
Seat 4: FREDY BULLIT ($230.85 in chips) 
Seat 5: tepi_guy ($872.16 in chips) 
Seat 6: slick_nickDH ($399.81 in chips) 
Seat 7: donald0404 ($200 in chips) 
Seat 8: sanducu_eu ($200 in chips) 
Seat 9: Tey113 ($582.73 in chips) 
lydia12345 will be allowed to play after the button
matiko09: posts small blind $1
FREDY BULLIT: posts big blind $2
*** HOLE CARDS ***
Dealt to matiko09 [Ac Qs]
tepi_guy: folds 
slick_nickDH: folds 
donald0404: folds 
sanducu_eu: raises $4 to $6
Tey113: folds 
ersevi6: folds 
matiko09: raises $14 to $20
FREDY BULLIT: folds 
sanducu_eu: calls $14
*** FLOP *** [Ks 9d 7h]
matiko09: bets $24
sanducu_eu: calls $24
*** TURN *** [Ks 9d 7h] [8s]
matiko09: checks 
sanducu_eu: checks 
*** RIVER *** [Ks 9d 7h 8s] [5c]
matiko09: checks 
sanducu_eu: checks 
*** SHOW DOWN ***
matiko09: shows [Ac Qs] (high card Ace)
sanducu_eu: shows [Qc Qd] (a pair of Queens)
sanducu_eu collected $87.25 from pot
*** SUMMARY ***
Total pot $90 | Rake $2.75 
Board [Ks 9d 7h 8s 5c]
Seat 1: ersevi6 (button) folded before Flop (didn't bet)
Seat 3: matiko09 (small blind) showed [Ac Qs] and lost with high card Ace
Seat 4: FREDY BULLIT (big blind) folded before Flop
Seat 5: tepi_guy folded before Flop (didn't bet)
Seat 6: slick_nickDH folded before Flop (didn't bet)
Seat 7: donald0404 folded before Flop (didn't bet)
Seat 8: sanducu_eu showed [Qc Qd] and won ($87.25) with a pair of Queens
Seat 9: Tey113 folded before Flop (didn't bet)





PokerStars Hand #153501248786:  Hold'em No Limit ($0.50/$1.00 USD) - 2016/05/18 20:11:16 CET [2016/05/18 14:11:16 ET]
Table 'Saiph II' 9-max Seat #9 is the button
Seat 1: MAARKKKK ($61.70 in chips) 
Seat 2: matiko09 ($138.74 in chips) 
Seat 3: lydia12345 ($177.62 in chips) 
Seat 5: cobrik23 ($36.99 in chips) 
Seat 6: LadyMaCe86 ($104 in chips) 
Seat 7: nickreason17 ($100 in chips) 
Seat 8: sanr23 ($102.92 in chips) 
Seat 9: HITYESCA ($100 in chips) 
MAARKKKK: posts small blind $0.50
matiko09: posts big blind $1
deadkiller1: sits out 
*** HOLE CARDS ***
Dealt to matiko09 [8d Jh]
lydia12345: folds 
cobrik23: folds 
LadyMaCe86: folds 
nickreason17: folds 
sanr23: folds 
HITYESCA: raises $1.50 to $2.50
MAARKKKK: folds 
matiko09: folds 
Uncalled bet ($1.50) returned to HITYESCA
HITYESCA collected $2.50 from pot
HITYESCA: doesn't show hand 
*** SUMMARY ***
Total pot $2.50 | Rake $0 
Seat 1: MAARKKKK (small blind) folded before Flop
Seat 2: matiko09 (big blind) folded before Flop
Seat 3: lydia12345 folded before Flop (didn't bet)
Seat 5: cobrik23 folded before Flop (didn't bet)
Seat 6: LadyMaCe86 folded before Flop (didn't bet)
Seat 7: nickreason17 folded before Flop (didn't bet)
Seat 8: sanr23 folded before Flop (didn't bet)
Seat 9: HITYESCA (button) collected ($2.50)





PokerStars Hand #153501255810:  Hold'em No Limit (€0.50/€1.00 EUR) - 2016/05/18 20:11:24 CET [2016/05/18 14:11:24 ET]
Table 'Pallas II' 9-max Seat #1 is the button
Seat 1: deadkiller1 (€100 in chips) 
Seat 2: matiko09 (€205.97 in chips) 
Seat 4: torkkdnm (€137.16 in chips) 
Seat 5: cobrik23 (€69.12 in chips) 
Seat 6: HITYESCA (€123.25 in chips) 
Seat 7: ipashutapkom (€40 in chips) 
Seat 8: lydia12345 (€100 in chips) 
Seat 9: stijner1986 (€149.01 in chips) 
matiko09: posts small blind €0.50
nickreason17: is sitting out 
torkkdnm: posts big blind €1
*** HOLE CARDS ***
Dealt to matiko09 [Qc 3s]
cobrik23: raises €1 to €2
nickreason17 leaves the table
HITYESCA: folds 
ipashutapkom: folds 
lydia12345: folds 
JACQUILF joins the table at seat #3 
stijner1986: folds 
deadkiller1: folds 
matiko09: folds 
torkkdnm: folds 
Uncalled bet (€1) returned to cobrik23
cobrik23 collected €2.50 from pot
cobrik23: doesn't show hand 
*** SUMMARY ***
Total pot €2.50 | Rake €0 
Seat 1: deadkiller1 (button) folded before Flop (didn't bet)
Seat 2: matiko09 (small blind) folded before Flop
Seat 4: torkkdnm (big blind) folded before Flop
Seat 5: cobrik23 collected (€2.50)
Seat 6: HITYESCA folded before Flop (didn't bet)
Seat 7: ipashutapkom folded before Flop (didn't bet)
Seat 8: lydia12345 folded before Flop (didn't bet)
Seat 9: stijner1986 folded before Flop (didn't bet)





PokerStars Hand #153501257565:  Hold'em No Limit ($0.50/$1.00 USD) - 2016/05/18 20:11:26 CET [2016/05/18 14:11:26 ET]
Table 'Abetti II' 9-max Seat #3 is the button
Seat 1: matiko09 ($125.58 in chips) 
Seat 2: Bimaxa ($127.34 in chips) 
Seat 3: cobrik23 ($257.87 in chips) 
Seat 5: blufthenuts ($137.52 in chips) 
Seat 7: nickreason17 ($104.47 in chips) 
Seat 8: roadster683 ($108.20 in chips) 
Seat 9: lydia12345 ($100 in chips) 
blufthenuts: posts small blind $0.50
nickreason17: posts big blind $1
*** HOLE CARDS ***
Dealt to matiko09 [Ts As]
ipashutapkom joins the table at seat #4 
roadster683: folds 
lydia12345: folds 
matiko09: raises $2 to $3
Bimaxa: folds 
cobrik23: folds 
blufthenuts: folds 
nickreason17: folds 
Uncalled bet ($2) returned to matiko09
matiko09 collected $2.50 from pot
matiko09: doesn't show hand 
*** SUMMARY ***
Total pot $2.50 | Rake $0 
Seat 1: matiko09 collected ($2.50)
Seat 2: Bimaxa folded before Flop (didn't bet)
Seat 3: cobrik23 (button) folded before Flop (didn't bet)
Seat 5: blufthenuts (small blind) folded before Flop
Seat 7: nickreason17 (big blind) folded before Flop
Seat 8: roadster683 folded before Flop (didn't bet)
Seat 9: lydia12345 folded before Flop (didn't bet)





PokerStars Hand #153501267064:  Hold'em No Limit ($1/$2 USD) - 2016/05/18 20:11:37 CET [2016/05/18 14:11:37 ET]
Table 'Letaba' 9-max Seat #9 is the button
Seat 1: FREDY BULLIT ($203.51 in chips) 
Seat 2: staruk669 ($112.24 in chips) 
Seat 3: ersevi6 ($205.04 in chips) 
Seat 4: matiko09 ($200 in chips) 
Seat 5: aseban11 ($200 in chips) 
Seat 6: donald0404 ($225.49 in chips) 
Seat 7: moshmachine ($293.97 in chips) 
Seat 8: $-Twackle-$ ($213.88 in chips) 
Seat 9: tepi_guy ($239.75 in chips) 
FREDY BULLIT: posts small blind $1
staruk669: posts big blind $2
*** HOLE CARDS ***
Dealt to matiko09 [3h 8c]
ersevi6: folds 
matiko09: folds 
aseban11: folds 
donald0404: raises $3 to $5
moshmachine: folds 
$-Twackle-$: calls $5
tepi_guy: folds 
FREDY BULLIT: folds 
staruk669: calls $3
*** FLOP *** [Qs 6s 2c]
staruk669: checks 
donald0404: checks 
$-Twackle-$: checks 
*** TURN *** [Qs 6s 2c] [8s]
staruk669: checks 
donald0404: checks 
$-Twackle-$: checks 
*** RIVER *** [Qs 6s 2c 8s] [Ad]
staruk669: checks 
donald0404: checks 
$-Twackle-$: checks 
*** SHOW DOWN ***
staruk669: shows [4h Jd] (high card Ace)
donald0404: shows [Th Jh] (high card Ace - Queen+Jack+Ten kicker)
$-Twackle-$: shows [7d 7s] (a pair of Sevens)
$-Twackle-$ collected $15.20 from pot
*** SUMMARY ***
Total pot $16 | Rake $0.80 
Board [Qs 6s 2c 8s Ad]
Seat 1: FREDY BULLIT (small blind) folded before Flop
Seat 2: staruk669 (big blind) showed [4h Jd] and lost with high card Ace
Seat 3: ersevi6 folded before Flop (didn't bet)
Seat 4: matiko09 folded before Flop (didn't bet)
Seat 5: aseban11 folded before Flop (didn't bet)
Seat 6: donald0404 showed [Th Jh] and lost with high card Ace
Seat 7: moshmachine folded before Flop (didn't bet)
Seat 8: $-Twackle-$ showed [7d 7s] and won ($15.20) with a pair of Sevens
Seat 9: tepi_guy (button) folded before Flop (didn't bet)





PokerStars Hand #153501278938:  Hold'em No Limit ($0.50/$1.00 USD) - 2016/05/18 20:11:51 CET [2016/05/18 14:11:51 ET]
Table 'Abetti II' 9-max Seat #5 is the button
Seat 1: matiko09 ($127.08 in chips) 
Seat 2: Bimaxa ($127.34 in chips) 
Seat 3: cobrik23 ($257.87 in chips) 
Seat 5: blufthenuts ($137.02 in chips) 
Seat 7: nickreason17 ($103.47 in chips) 
Seat 8: roadster683 ($108.20 in chips) 
Seat 9: lydia12345 ($100 in chips) 
nickreason17: posts small blind $0.50
roadster683: posts big blind $1
ipashutapkom: sits out 
*** HOLE CARDS ***
Dealt to matiko09 [8s 6h]
lydia12345: folds 
matiko09: folds 
Bimaxa: folds 
cobrik23: folds 
blufthenuts: raises $2 to $3
nickreason17: folds 
roadster683: folds 
Uncalled bet ($2) returned to blufthenuts
blufthenuts collected $2.50 from pot
blufthenuts: doesn't show hand 
*** SUMMARY ***
Total pot $2.50 | Rake $0 
Seat 1: matiko09 folded before Flop (didn't bet)
Seat 2: Bimaxa folded before Flop (didn't bet)
Seat 3: cobrik23 folded before Flop (didn't bet)
Seat 5: blufthenuts (button) collected ($2.50)
Seat 7: nickreason17 (small blind) folded before Flop
Seat 8: roadster683 (big blind) folded before Flop
Seat 9: lydia12345 folded before Flop (didn't bet)





PokerStars Hand #153501297060:  Hold'em No Limit ($0.50/$1.00 USD) - 2016/05/18 20:12:12 CET [2016/05/18 14:12:12 ET]
Table 'Saiph II' 9-max Seat #1 is the button
Seat 1: MAARKKKK ($61.20 in chips) 
Seat 2: matiko09 ($137.74 in chips) 
Seat 3: lydia12345 ($177.62 in chips) 
Seat 5: cobrik23 ($36.99 in chips) 
Seat 6: LadyMaCe86 ($104 in chips) 
Seat 7: nickreason17 ($100 in chips) 
Seat 8: sanr23 ($102.92 in chips) 
Seat 9: HITYESCA ($101.50 in chips) 
matiko09: posts small blind $0.50
lydia12345: posts big blind $1
deadkiller1: sits out 
*** HOLE CARDS ***
Dealt to matiko09 [Js Ad]
cobrik23: raises $2 to $3
LadyMaCe86: folds 
nickreason17: folds 
sanr23: folds 
HITYESCA: calls $3
MAARKKKK: folds 
matiko09: folds 
lydia12345: folds 
*** FLOP *** [4c 7d 3c]
cobrik23: bets $4.74
HITYESCA: raises $93.76 to $98.50 and is all-in
cobrik23: calls $29.25 and is all-in
Uncalled bet ($64.51) returned to HITYESCA
*** TURN *** [4c 7d 3c] [5h]
*** RIVER *** [4c 7d 3c 5h] [8h]
*** SHOW DOWN ***
cobrik23: shows [8s 8d] (three of a kind, Eights)
HITYESCA: mucks hand 
cobrik23 collected $72.98 from pot
*** SUMMARY ***
Total pot $75.48 | Rake $2.50 
Board [4c 7d 3c 5h 8h]
Seat 1: MAARKKKK (button) folded before Flop (didn't bet)
Seat 2: matiko09 (small blind) folded before Flop
Seat 3: lydia12345 (big blind) folded before Flop
Seat 5: cobrik23 showed [8s 8d] and won ($72.98) with three of a kind, Eights
Seat 6: LadyMaCe86 folded before Flop (didn't bet)
Seat 7: nickreason17 folded before Flop (didn't bet)
Seat 8: sanr23 folded before Flop (didn't bet)
Seat 9: HITYESCA mucked [Jc Jd]





PokerStars Hand #153501298364:  Hold'em No Limit ($0.50/$1.00 USD) - 2016/05/18 20:12:14 CET [2016/05/18 14:12:14 ET]
Table 'Tatjana III' 9-max Seat #9 is the button
Seat 1: cobrik23 ($40 in chips) 
Seat 2: HITYESCA ($138.50 in chips) 
Seat 3: matiko09 ($175.40 in chips) 
Seat 4: lydia12345 ($111.42 in chips) 
Seat 7: rene1984tsv ($189.17 in chips) 
Seat 9: Moszes360 ($100 in chips) 
cobrik23: posts small blind $0.50
HITYESCA: posts big blind $1
deadkiller1: sits out 
JACQUILF: sits out 
*** HOLE CARDS ***
Dealt to matiko09 [2d Kd]
matiko09: folds 
lydia12345: raises $2 to $3
rene1984tsv: calls $3
Moszes360: folds 
cobrik23: folds 
HITYESCA: folds 
*** FLOP *** [6s Ac 4c]
lydia12345: bets $4.84
rene1984tsv: calls $4.84
*** TURN *** [6s Ac 4c] [3c]
lydia12345: checks 
rene1984tsv: checks 
*** RIVER *** [6s Ac 4c 3c] [7d]
lydia12345: bets $6
rene1984tsv: folds 
Uncalled bet ($6) returned to lydia12345
lydia12345 collected $16.32 from pot
*** SUMMARY ***
Total pot $17.18 | Rake $0.86 
Board [6s Ac 4c 3c 7d]
Seat 1: cobrik23 (small blind) folded before Flop
Seat 2: HITYESCA (big blind) folded before Flop
Seat 3: matiko09 folded before Flop (didn't bet)
Seat 4: lydia12345 collected ($16.32)
Seat 7: rene1984tsv folded on the River
Seat 9: Moszes360 (button) folded before Flop (didn't bet)





PokerStars Hand #153501304166:  Hold'em No Limit (€0.50/€1.00 EUR) - 2016/05/18 20:12:21 CET [2016/05/18 14:12:21 ET]
Table 'Pallas II' 9-max Seat #2 is the button
Seat 1: deadkiller1 (€100 in chips) 
Seat 2: matiko09 (€205.47 in chips) 
Seat 4: torkkdnm (€136.16 in chips) 
Seat 5: cobrik23 (€70.62 in chips) 
Seat 6: HITYESCA (€123.25 in chips) 
Seat 7: ipashutapkom (€40 in chips) 
Seat 8: lydia12345 (€100 in chips) 
Seat 9: stijner1986 (€149.01 in chips) 
JACQUILF will be allowed to play after the button
torkkdnm: posts small blind €0.50
cobrik23: posts big blind €1
*** HOLE CARDS ***
Dealt to matiko09 [Ks 6h]
HITYESCA: folds 
ipashutapkom: folds 
lydia12345: folds 
stijner1986: folds 
deadkiller1: folds 
matiko09: folds 
torkkdnm: raises €1 to €2
cobrik23: calls €1
*** FLOP *** [Th 5h 3h]
torkkdnm: checks 
cobrik23: checks 
*** TURN *** [Th 5h 3h] [7d]
torkkdnm: checks 
cobrik23: checks 
*** RIVER *** [Th 5h 3h 7d] [2d]
torkkdnm: checks 
cobrik23: checks 
*** SHOW DOWN ***
torkkdnm: shows [Ad 6c] (high card Ace)
cobrik23: mucks hand 
torkkdnm collected €3.80 from pot
*** SUMMARY ***
Total pot €4 | Rake €0.20 
Board [Th 5h 3h 7d 2d]
Seat 1: deadkiller1 folded before Flop (didn't bet)
Seat 2: matiko09 (button) folded before Flop (didn't bet)
Seat 4: torkkdnm (small blind) showed [Ad 6c] and won (€3.80) with high card Ace
Seat 5: cobrik23 (big blind) mucked [8d 9s]
Seat 6: HITYESCA folded before Flop (didn't bet)
Seat 7: ipashutapkom folded before Flop (didn't bet)
Seat 8: lydia12345 folded before Flop (didn't bet)
Seat 9: stijner1986 folded before Flop (didn't bet)





PokerStars Hand #153501314457:  Hold'em No Limit ($0.50/$1.00 USD) - 2016/05/18 20:12:33 CET [2016/05/18 14:12:33 ET]
Table 'Suevia' 9-max Seat #9 is the button
Seat 1: Bimaxa ($102.65 in chips) 
Seat 3: matiko09 ($100 in chips) 
Seat 4: HITYESCA ($105.32 in chips) 
Seat 5: bello1310 ($89.77 in chips) 
Seat 6: torkkdnm ($102.72 in chips) 
Seat 8: ama58 ($41.57 in chips) 
Seat 9: oscarleon ($111.64 in chips) 
Bimaxa: posts small blind $0.50
matiko09: posts big blind $1
sanr23: sits out 
*** HOLE CARDS ***
Dealt to matiko09 [Js Jd]
HITYESCA: folds 
sanr23 leaves the table
bello1310: folds 
cobrik23 joins the table at seat #7 
torkkdnm: folds 
ama58: folds 
oscarleon: folds 
Bimaxa: raises $1.50 to $2.50
matiko09: raises $6 to $8.50
Bimaxa: folds 
Uncalled bet ($6) returned to matiko09
matiko09 collected $5 from pot
matiko09: doesn't show hand 
*** SUMMARY ***
Total pot $5 | Rake $0 
Seat 1: Bimaxa (small blind) folded before Flop
Seat 3: matiko09 (big blind) collected ($5)
Seat 4: HITYESCA folded before Flop (didn't bet)
Seat 5: bello1310 folded before Flop (didn't bet)
Seat 6: torkkdnm folded before Flop (didn't bet)
Seat 8: ama58 folded before Flop (didn't bet)
Seat 9: oscarleon (button) folded before Flop (didn't bet)





PokerStars Hand #153501317158:  Hold'em No Limit ($0.50/$1.00 USD) - 2016/05/18 20:12:36 CET [2016/05/18 14:12:36 ET]
Table 'Pandora' 9-max Seat #6 is the button
Seat 1: deadkiller1 ($101.50 in chips) 
Seat 2: fack_vi ($69 in chips) 
Seat 4: mooose100 ($81.38 in chips) 
Seat 5: Mr Seelen ($83 in chips) 
Seat 6: Mulgraver25 ($64.63 in chips) 
Seat 7: lydia12345 ($100 in chips) 
Seat 8: matiko09 ($100 in chips) 
Seat 9: oscarleon ($116.98 in chips) 
lydia12345: posts small blind $0.50
matiko09: posts big blind $1
tipner: sits out 
*** HOLE CARDS ***
Dealt to matiko09 [7d 2h]
oscarleon: folds 
deadkiller1: folds 
fack_vi: folds 
mooose100: calls $1
Mr Seelen: folds 
Mulgraver25: folds 
lydia12345: folds 
matiko09: checks 
*** FLOP *** [Qh Qc Jd]
matiko09: checks 
mooose100: checks 
*** TURN *** [Qh Qc Jd] [3c]
matiko09: checks 
mooose100: checks 
*** RIVER *** [Qh Qc Jd 3c] [9h]
matiko09: checks 
mooose100: bets $1.19
matiko09: folds 
Uncalled bet ($1.19) returned to mooose100
mooose100 collected $2.38 from pot
mooose100: doesn't show hand 
*** SUMMARY ***
Total pot $2.50 | Rake $0.12 
Board [Qh Qc Jd 3c 9h]
Seat 1: deadkiller1 folded before Flop (didn't bet)
Seat 2: fack_vi folded before Flop (didn't bet)
Seat 4: mooose100 collected ($2.38)
Seat 5: Mr Seelen folded before Flop (didn't bet)
Seat 6: Mulgraver25 (button) folded before Flop (didn't bet)
Seat 7: lydia12345 (small blind) folded before Flop
Seat 8: matiko09 (big blind) folded on the River
Seat 9: oscarleon folded before Flop (didn't bet)





PokerStars Hand #153501324238:  Hold'em No Limit ($0.50/$1.00 USD) - 2016/05/18 20:12:44 CET [2016/05/18 14:12:44 ET]
Table 'Abetti II' 9-max Seat #7 is the button
Seat 1: matiko09 ($127.08 in chips) 
Seat 2: Bimaxa ($127.34 in chips) 
Seat 3: cobrik23 ($257.87 in chips) 
Seat 5: blufthenuts ($138.52 in chips) 
Seat 7: nickreason17 ($102.97 in chips) 
Seat 8: roadster683 ($107.20 in chips) 
Seat 9: lydia12345 ($100 in chips) 
roadster683: posts small blind $0.50
lydia12345: posts big blind $1
ipashutapkom: sits out 
I The King I: sits out 
*** HOLE CARDS ***
Dealt to matiko09 [8h 6h]
matiko09: folds 
Bimaxa: folds 
cobrik23: folds 
blufthenuts: folds 
nickreason17: raises $1 to $2
roadster683: calls $1.50
lydia12345: folds 
*** FLOP *** [2h Ah 4s]
roadster683: checks 
nickreason17: bets $3
roadster683: folds 
Uncalled bet ($3) returned to nickreason17
nickreason17 collected $4.75 from pot
*** SUMMARY ***
Total pot $5 | Rake $0.25 
Board [2h Ah 4s]
Seat 1: matiko09 folded before Flop (didn't bet)
Seat 2: Bimaxa folded before Flop (didn't bet)
Seat 3: cobrik23 folded before Flop (didn't bet)
Seat 5: blufthenuts folded before Flop (didn't bet)
Seat 7: nickreason17 (button) collected ($4.75)
Seat 8: roadster683 (small blind) folded on the Flop
Seat 9: lydia12345 (big blind) folded before Flop





PokerStars Hand #153501333217:  Hold'em No Limit ($1/$2 USD) - 2016/05/18 20:12:54 CET [2016/05/18 14:12:54 ET]
Table 'Chlosinde' 9-max Seat #3 is the button
Seat 1: ersevi6 ($157 in chips) 
Seat 3: matiko09 ($200 in chips) 
Seat 4: FREDY BULLIT ($228.85 in chips) 
Seat 5: tepi_guy ($872.16 in chips) 
Seat 6: slick_nickDH ($399.81 in chips) 
Seat 7: donald0404 ($200 in chips) 
Seat 8: sanducu_eu ($243.25 in chips) 
Seat 9: Tey113 ($582.73 in chips) 
FREDY BULLIT: posts small blind $1
tepi_guy: posts big blind $2
lydia12345: sits out 
*** HOLE CARDS ***
Dealt to matiko09 [2h 9d]
slick_nickDH: folds 
slick_nickDH leaves the table
I The King I joins the table at seat #6 
donald0404: folds 
sanducu_eu: folds 
I The King I leaves the table
Tey113: calls $2
ersevi6: folds 
matiko09: folds 
tipner joins the table at seat #6 
FREDY BULLIT: folds 
tepi_guy: checks 
*** FLOP *** [5d Td Tc]
tepi_guy: checks 
Tey113: bets $2
tepi_guy: folds 
Uncalled bet ($2) returned to Tey113
Tey113 collected $4.75 from pot
Tey113: doesn't show hand 
*** SUMMARY ***
Total pot $5 | Rake $0.25 
Board [5d Td Tc]
Seat 1: ersevi6 folded before Flop (didn't bet)
Seat 3: matiko09 (button) folded before Flop (didn't bet)
Seat 4: FREDY BULLIT (small blind) folded before Flop
Seat 5: tepi_guy (big blind) folded on the Flop
Seat 6: slick_nickDH folded before Flop (didn't bet)
Seat 7: donald0404 folded before Flop (didn't bet)
Seat 8: sanducu_eu folded before Flop (didn't bet)
Seat 9: Tey113 collected ($4.75)





PokerStars Hand #153501351214:  Hold'em No Limit ($0.50/$1.00 USD) - 2016/05/18 20:13:15 CET [2016/05/18 14:13:15 ET]
Table 'Abetti II' 9-max Seat #8 is the button
Seat 1: matiko09 ($127.08 in chips) 
Seat 2: Bimaxa ($127.34 in chips) 
Seat 3: cobrik23 ($257.87 in chips) 
Seat 5: blufthenuts ($138.52 in chips) 
Seat 7: nickreason17 ($105.72 in chips) 
Seat 8: roadster683 ($105.20 in chips) 
Seat 9: lydia12345 ($100 in chips) 
lydia12345: posts small blind $0.50
matiko09: posts big blind $1
ipashutapkom: sits out 
I The King I: sits out 
*** HOLE CARDS ***
Dealt to matiko09 [5h Qh]
Bimaxa: folds 
cobrik23: folds 
blufthenuts: folds 
nickreason17: raises $1.50 to $2.50
roadster683: calls $2.50
lydia12345: folds 
matiko09: folds 
*** FLOP *** [2h Ks 7s]
nickreason17: bets $3.50
roadster683: calls $3.50
*** TURN *** [2h Ks 7s] [4s]
nickreason17: bets $9
roadster683: calls $9
*** RIVER *** [2h Ks 7s 4s] [6c]
nickreason17: checks 
roadster683: bets $24
nickreason17: calls $24
*** SHOW DOWN ***
roadster683: shows [As 2d] (a pair of Deuces)
nickreason17: shows [Kc Kh] (three of a kind, Kings)
nickreason17 collected $77 from pot
*** SUMMARY ***
Total pot $79.50 | Rake $2.50 
Board [2h Ks 7s 4s 6c]
Seat 1: matiko09 (big blind) folded before Flop
Seat 2: Bimaxa folded before Flop (didn't bet)
Seat 3: cobrik23 folded before Flop (didn't bet)
Seat 5: blufthenuts folded before Flop (didn't bet)
Seat 7: nickreason17 showed [Kc Kh] and won ($77) with three of a kind, Kings
Seat 8: roadster683 (button) showed [As 2d] and lost with a pair of Deuces
Seat 9: lydia12345 (small blind) folded before Flop





PokerStars Hand #153501352861:  Hold'em No Limit ($1/$2 USD) - 2016/05/18 20:13:17 CET [2016/05/18 14:13:17 ET]
Table 'Letaba' 9-max Seat #1 is the button
Seat 1: FREDY BULLIT ($202.51 in chips) 
Seat 2: staruk669 ($107.24 in chips) 
Seat 3: ersevi6 ($205.04 in chips) 
Seat 4: matiko09 ($200 in chips) 
Seat 5: aseban11 ($200 in chips) 
Seat 6: donald0404 ($220.49 in chips) 
Seat 7: moshmachine ($293.97 in chips) 
Seat 8: $-Twackle-$ ($224.08 in chips) 
Seat 9: tepi_guy ($239.75 in chips) 
staruk669: posts small blind $1
ersevi6: posts big blind $2
*** HOLE CARDS ***
Dealt to matiko09 [3d 7h]
matiko09: folds 
aseban11: folds 
donald0404: folds 
moshmachine: folds 
$-Twackle-$: folds 
tepi_guy: folds 
FREDY BULLIT: raises $3 to $5
staruk669: calls $4
ersevi6: raises $18 to $23
FREDY BULLIT: folds 
staruk669: folds 
Uncalled bet ($18) returned to ersevi6
ersevi6 collected $15 from pot
ersevi6: doesn't show hand 
*** SUMMARY ***
Total pot $15 | Rake $0 
Seat 1: FREDY BULLIT (button) folded before Flop
Seat 2: staruk669 (small blind) folded before Flop
Seat 3: ersevi6 (big blind) collected ($15)
Seat 4: matiko09 folded before Flop (didn't bet)
Seat 5: aseban11 folded before Flop (didn't bet)
Seat 6: donald0404 folded before Flop (didn't bet)
Seat 7: moshmachine folded before Flop (didn't bet)
Seat 8: $-Twackle-$ folded before Flop (didn't bet)
Seat 9: tepi_guy folded before Flop (didn't bet)





PokerStars Hand #153501354047:  Hold'em No Limit ($0.50/$1.00 USD) - 2016/05/18 20:13:19 CET [2016/05/18 14:13:19 ET]
Table 'Tatjana III' 9-max Seat #1 is the button
Seat 1: cobrik23 ($40 in chips) 
Seat 2: HITYESCA ($137.50 in chips) 
Seat 3: matiko09 ($175.40 in chips) 
Seat 4: lydia12345 ($119.90 in chips) 
Seat 7: rene1984tsv ($181.33 in chips) 
Seat 9: Moszes360 ($100 in chips) 
HITYESCA: posts small blind $0.50
matiko09: posts big blind $1
deadkiller1: sits out 
JACQUILF: sits out 
*** HOLE CARDS ***
Dealt to matiko09 [5d Ts]
lydia12345: folds 
rene1984tsv: folds 
Moszes360: raises $1.10 to $2.10
cobrik23: folds 
HITYESCA: folds 
matiko09: folds 
Uncalled bet ($1.10) returned to Moszes360
Moszes360 collected $2.50 from pot
Moszes360: doesn't show hand 
*** SUMMARY ***
Total pot $2.50 | Rake $0 
Seat 1: cobrik23 (button) folded before Flop (didn't bet)
Seat 2: HITYESCA (small blind) folded before Flop
Seat 3: matiko09 (big blind) folded before Flop
Seat 4: lydia12345 folded before Flop (didn't bet)
Seat 7: rene1984tsv folded before Flop (didn't bet)
Seat 9: Moszes360 collected ($2.50)





PokerStars Hand #153501361330:  Hold'em No Limit ($0.50/$1.00 USD) - 2016/05/18 20:13:27 CET [2016/05/18 14:13:27 ET]
Table 'Saiph II' 9-max Seat #2 is the button
Seat 1: MAARKKKK ($61.20 in chips) 
Seat 2: matiko09 ($137.24 in chips) 
Seat 3: lydia12345 ($176.62 in chips) 
Seat 4: deadkiller1 ($100 in chips) 
Seat 5: cobrik23 ($72.98 in chips) 
Seat 6: LadyMaCe86 ($104 in chips) 
Seat 7: nickreason17 ($100 in chips) 
Seat 8: sanr23 ($102.92 in chips) 
Seat 9: HITYESCA ($100 in chips) 
lydia12345: posts small blind $0.50
deadkiller1: posts big blind $1
*** HOLE CARDS ***
Dealt to matiko09 [Kd 4s]
cobrik23: folds 
LadyMaCe86: folds 
nickreason17: folds 
sanr23: folds 
HITYESCA: raises $2 to $3
MAARKKKK: folds 
matiko09: folds 
lydia12345: folds 
deadkiller1: folds 
Uncalled bet ($2) returned to HITYESCA
HITYESCA collected $2.50 from pot
HITYESCA: doesn't show hand 
*** SUMMARY ***
Total pot $2.50 | Rake $0 
Seat 1: MAARKKKK folded before Flop (didn't bet)
Seat 2: matiko09 (button) folded before Flop (didn't bet)
Seat 3: lydia12345 (small blind) folded before Flop
Seat 4: deadkiller1 (big blind) folded before Flop
Seat 5: cobrik23 folded before Flop (didn't bet)
Seat 6: LadyMaCe86 folded before Flop (didn't bet)
Seat 7: nickreason17 folded before Flop (didn't bet)
Seat 8: sanr23 folded before Flop (didn't bet)
Seat 9: HITYESCA collected ($2.50)





PokerStars Hand #153501363750:  Hold'em No Limit ($0.50/$1.00 USD) - 2016/05/18 20:13:30 CET [2016/05/18 14:13:30 ET]
Table 'Suevia' 9-max Seat #1 is the button
Seat 1: Bimaxa ($100.15 in chips) 
Seat 3: matiko09 ($102.50 in chips) 
Seat 4: HITYESCA ($105.32 in chips) 
Seat 5: bello1310 ($89.77 in chips) 
Seat 6: torkkdnm ($102.72 in chips) 
Seat 8: ama58 ($41.57 in chips) 
Seat 9: oscarleon ($111.64 in chips) 
matiko09: posts small blind $0.50
HITYESCA: posts big blind $1
cobrik23: sits out 
*** HOLE CARDS ***
Dealt to matiko09 [3s 2h]
bello1310: folds 
torkkdnm: folds 
ama58: folds 
oscarleon: folds 
Bimaxa: folds 
matiko09: folds 
Uncalled bet ($0.50) returned to HITYESCA
HITYESCA collected $1 from pot
HITYESCA: doesn't show hand 
*** SUMMARY ***
Total pot $1 | Rake $0 
Seat 1: Bimaxa (button) folded before Flop (didn't bet)
Seat 3: matiko09 (small blind) folded before Flop
Seat 4: HITYESCA (big blind) collected ($1)
Seat 5: bello1310 folded before Flop (didn't bet)
Seat 6: torkkdnm folded before Flop (didn't bet)
Seat 8: ama58 folded before Flop (didn't bet)
Seat 9: oscarleon folded before Flop (didn't bet)





PokerStars Hand #153501368328:  Hold'em No Limit ($0.50/$1.00 USD) - 2016/05/18 20:13:35 CET [2016/05/18 14:13:35 ET]
Table 'Pandora' 9-max Seat #7 is the button
Seat 1: deadkiller1 ($101.50 in chips) 
Seat 2: fack_vi ($69 in chips) 
Seat 4: mooose100 ($82.76 in chips) 
Seat 5: Mr Seelen ($83 in chips) 
Seat 6: Mulgraver25 ($64.63 in chips) 
Seat 7: lydia12345 ($100 in chips) 
Seat 8: matiko09 ($100 in chips) 
Seat 9: oscarleon ($116.98 in chips) 
matiko09: posts small blind $0.50
oscarleon: posts big blind $1
tipner: sits out 
*** HOLE CARDS ***
Dealt to matiko09 [3s 2d]
deadkiller1: folds 
fack_vi: folds 
mooose100: calls $1
Mr Seelen: calls $1
Mulgraver25: folds 
lydia12345: raises $3 to $4
matiko09: folds 
oscarleon: folds 
mooose100: calls $3
Mr Seelen: calls $3
*** FLOP *** [4c 2c 9s]
mooose100: checks 
Mr Seelen: checks 
lydia12345: bets $8.72
mooose100: folds 
Mr Seelen: folds 
Uncalled bet ($8.72) returned to lydia12345
lydia12345 collected $12.82 from pot
*** SUMMARY ***
Total pot $13.50 | Rake $0.68 
Board [4c 2c 9s]
Seat 1: deadkiller1 folded before Flop (didn't bet)
Seat 2: fack_vi folded before Flop (didn't bet)
Seat 4: mooose100 folded on the Flop
Seat 5: Mr Seelen folded on the Flop
Seat 6: Mulgraver25 folded before Flop (didn't bet)
Seat 7: lydia12345 (button) collected ($12.82)
Seat 8: matiko09 (small blind) folded before Flop
Seat 9: oscarleon (big blind) folded before Flop





PokerStars Hand #153501368599:  Hold'em No Limit ($1/$2 USD) - 2016/05/18 20:13:36 CET [2016/05/18 14:13:36 ET]
Table 'Chlosinde' 9-max Seat #4 is the button
Seat 1: ersevi6 ($157 in chips) 
Seat 3: matiko09 ($200 in chips) 
Seat 4: FREDY BULLIT ($227.85 in chips) 
Seat 5: tepi_guy ($870.16 in chips) 
Seat 7: donald0404 ($200 in chips) 
Seat 8: sanducu_eu ($243.25 in chips) 
Seat 9: Tey113 ($585.48 in chips) 
tepi_guy: posts small blind $1
donald0404: posts big blind $2
lydia12345: sits out 
*** HOLE CARDS ***
Dealt to matiko09 [Ah 3c]
sanducu_eu: folds 
Tey113: folds 
ersevi6: folds 
matiko09: folds 
FREDY BULLIT: raises $3 to $5
tepi_guy has timed out
tepi_guy: folds 
donald0404: folds 
Uncalled bet ($3) returned to FREDY BULLIT
FREDY BULLIT collected $5 from pot
FREDY BULLIT: doesn't show hand 
*** SUMMARY ***
Total pot $5 | Rake $0 
Seat 1: ersevi6 folded before Flop (didn't bet)
Seat 3: matiko09 folded before Flop (didn't bet)
Seat 4: FREDY BULLIT (button) collected ($5)
Seat 5: tepi_guy (small blind) folded before Flop
Seat 7: donald0404 (big blind) folded before Flop
Seat 8: sanducu_eu folded before Flop (didn't bet)
Seat 9: Tey113 folded before Flop (didn't bet)





PokerStars Hand #153501376779:  Hold'em No Limit (€0.50/€1.00 EUR) - 2016/05/18 20:13:45 CET [2016/05/18 14:13:45 ET]
Table 'Pallas II' 9-max Seat #4 is the button
Seat 1: deadkiller1 (€100 in chips) 
Seat 2: matiko09 (€205.47 in chips) 
Seat 4: torkkdnm (€137.96 in chips) 
Seat 5: cobrik23 (€68.62 in chips) 
Seat 6: HITYESCA (€123.25 in chips) 
Seat 7: ipashutapkom (€40 in chips) 
Seat 8: lydia12345 (€100 in chips) 
Seat 9: stijner1986 (€149.01 in chips) 
cobrik23: posts small blind €0.50
HITYESCA: posts big blind €1
JACQUILF: sits out 
*** HOLE CARDS ***
Dealt to matiko09 [Th Tc]
ipashutapkom: folds 
lydia12345: folds 
stijner1986: folds 
deadkiller1: folds 
matiko09: raises €1.50 to €2.50
torkkdnm: raises €4.50 to €7
cobrik23: folds 
HITYESCA: folds 
matiko09: calls €4.50
*** FLOP *** [4d Kc Js]
matiko09: checks 
torkkdnm: bets €10
matiko09: folds 
Uncalled bet (€10) returned to torkkdnm
torkkdnm collected €14.72 from pot
*** SUMMARY ***
Total pot €15.50 | Rake €0.78 
Board [4d Kc Js]
Seat 1: deadkiller1 folded before Flop (didn't bet)
Seat 2: matiko09 folded on the Flop
Seat 4: torkkdnm (button) collected (€14.72)
Seat 5: cobrik23 (small blind) folded before Flop
Seat 6: HITYESCA (big blind) folded before Flop
Seat 7: ipashutapkom folded before Flop (didn't bet)
Seat 8: lydia12345 folded before Flop (didn't bet)
Seat 9: stijner1986 folded before Flop (didn't bet)





PokerStars Hand #153501380043:  Hold'em No Limit ($0.50/$1.00 USD) - 2016/05/18 20:13:49 CET [2016/05/18 14:13:49 ET]
Table 'Tatjana III' 9-max Seat #2 is the button
Seat 1: cobrik23 ($40 in chips) 
Seat 2: HITYESCA ($137 in chips) 
Seat 3: matiko09 ($174.40 in chips) 
Seat 4: lydia12345 ($119.90 in chips) 
Seat 7: rene1984tsv ($181.33 in chips) 
Seat 9: Moszes360 ($101.50 in chips) 
matiko09: posts small blind $0.50
lydia12345: posts big blind $1
deadkiller1: sits out 
JACQUILF: sits out 
*** HOLE CARDS ***
Dealt to matiko09 [8d Qc]
rene1984tsv: raises $1 to $2
Moszes360: folds 
cobrik23: folds 
HITYESCA: raises $4 to $6
matiko09: folds 
lydia12345: folds 
rene1984tsv: calls $4
*** FLOP *** [Kc 5c 4d]
rene1984tsv: checks 
HITYESCA: bets $7
rene1984tsv: folds 
Uncalled bet ($7) returned to HITYESCA
HITYESCA collected $12.82 from pot
HITYESCA: doesn't show hand 
*** SUMMARY ***
Total pot $13.50 | Rake $0.68 
Board [Kc 5c 4d]
Seat 1: cobrik23 folded before Flop (didn't bet)
Seat 2: HITYESCA (button) collected ($12.82)
Seat 3: matiko09 (small blind) folded before Flop
Seat 4: lydia12345 (big blind) folded before Flop
Seat 7: rene1984tsv folded on the Flop
Seat 9: Moszes360 folded before Flop (didn't bet)





PokerStars Hand #153501381302:  Hold'em No Limit ($0.50/$1.00 USD) - 2016/05/18 20:13:50 CET [2016/05/18 14:13:50 ET]
Table 'Saiph II' 9-max Seat #3 is the button
Seat 1: MAARKKKK ($61.20 in chips) 
Seat 2: matiko09 ($137.24 in chips) 
Seat 3: lydia12345 ($176.12 in chips) 
Seat 4: deadkiller1 ($100 in chips) 
Seat 5: cobrik23 ($72.98 in chips) 
Seat 6: LadyMaCe86 ($104 in chips) 
Seat 7: nickreason17 ($100 in chips) 
Seat 8: sanr23 ($102.92 in chips) 
Seat 9: HITYESCA ($101.50 in chips) 
deadkiller1: posts small blind $0.50
cobrik23: posts big blind $1
*** HOLE CARDS ***
Dealt to matiko09 [3c Th]
LadyMaCe86: folds 
nickreason17: folds 
sanr23: folds 
HITYESCA: raises $2 to $3
MAARKKKK: calls $3
matiko09: folds 
lydia12345: calls $3
deadkiller1: folds 
cobrik23: folds 
*** FLOP *** [6s 8h Jd]
HITYESCA: checks 
MAARKKKK: checks 
lydia12345: checks 
*** TURN *** [6s 8h Jd] [4c]
HITYESCA: checks 
MAARKKKK: bets $4.99
lydia12345: folds 
HITYESCA: folds 
Uncalled bet ($4.99) returned to MAARKKKK
MAARKKKK collected $9.98 from pot
MAARKKKK: doesn't show hand 
*** SUMMARY ***
Total pot $10.50 | Rake $0.52 
Board [6s 8h Jd 4c]
Seat 1: MAARKKKK collected ($9.98)
Seat 2: matiko09 folded before Flop (didn't bet)
Seat 3: lydia12345 (button) folded on the Turn
Seat 4: deadkiller1 (small blind) folded before Flop
Seat 5: cobrik23 (big blind) folded before Flop
Seat 6: LadyMaCe86 folded before Flop (didn't bet)
Seat 7: nickreason17 folded before Flop (didn't bet)
Seat 8: sanr23 folded before Flop (didn't bet)
Seat 9: HITYESCA folded on the Turn





PokerStars Hand #153501380726:  Hold'em No Limit ($0.50/$1.00 USD) - 2016/05/18 20:13:50 CET [2016/05/18 14:13:50 ET]
Table 'Suevia' 9-max Seat #3 is the button
Seat 1: Bimaxa ($100.15 in chips) 
Seat 3: matiko09 ($102 in chips) 
Seat 4: HITYESCA ($105.82 in chips) 
Seat 5: bello1310 ($89.77 in chips) 
Seat 6: torkkdnm ($102.72 in chips) 
Seat 8: ama58 ($41.57 in chips) 
Seat 9: oscarleon ($111.64 in chips) 
HITYESCA: posts small blind $0.50
bello1310: posts big blind $1
cobrik23: sits out 
*** HOLE CARDS ***
Dealt to matiko09 [Ad 3s]
torkkdnm: folds 
ama58: raises $2 to $3
oscarleon: folds 
Bimaxa: folds 
matiko09: folds 
HITYESCA: folds 
bello1310: calls $2
*** FLOP *** [As Ah 3h]
bello1310: checks 
ama58: bets $1
bello1310: folds 
Uncalled bet ($1) returned to ama58
ama58 collected $6.18 from pot
*** SUMMARY ***
Total pot $6.50 | Rake $0.32 
Board [As Ah 3h]
Seat 1: Bimaxa folded before Flop (didn't bet)
Seat 3: matiko09 (button) folded before Flop (didn't bet)
Seat 4: HITYESCA (small blind) folded before Flop
Seat 5: bello1310 (big blind) folded on the Flop
Seat 6: torkkdnm folded before Flop (didn't bet)
Seat 8: ama58 collected ($6.18)
Seat 9: oscarleon folded before Flop (didn't bet)





PokerStars Hand #153501384893:  Hold'em No Limit ($1/$2 USD) - 2016/05/18 20:13:55 CET [2016/05/18 14:13:55 ET]
Table 'Letaba' 9-max Seat #2 is the button
Seat 1: FREDY BULLIT ($200 in chips) 
Seat 2: staruk669 ($102.24 in chips) 
Seat 3: ersevi6 ($215.04 in chips) 
Seat 4: matiko09 ($200 in chips) 
Seat 5: aseban11 ($200 in chips) 
Seat 6: donald0404 ($220.49 in chips) 
Seat 7: moshmachine ($293.97 in chips) 
Seat 8: $-Twackle-$ ($224.08 in chips) 
Seat 9: tepi_guy ($239.75 in chips) 
ersevi6: posts small blind $1
matiko09: posts big blind $2
*** HOLE CARDS ***
Dealt to matiko09 [3d 4d]
aseban11: folds 
donald0404: folds 
moshmachine: folds 
$-Twackle-$: folds 
tepi_guy: folds 
FREDY BULLIT: folds 
staruk669: raises $4 to $6
ersevi6: folds 
matiko09: folds 
Uncalled bet ($4) returned to staruk669
staruk669 collected $5 from pot
staruk669: doesn't show hand 
*** SUMMARY ***
Total pot $5 | Rake $0 
Seat 1: FREDY BULLIT folded before Flop (didn't bet)
Seat 2: staruk669 (button) collected ($5)
Seat 3: ersevi6 (small blind) folded before Flop
Seat 4: matiko09 (big blind) folded before Flop
Seat 5: aseban11 folded before Flop (didn't bet)
Seat 6: donald0404 folded before Flop (didn't bet)
Seat 7: moshmachine folded before Flop (didn't bet)
Seat 8: $-Twackle-$ folded before Flop (didn't bet)
Seat 9: tepi_guy folded before Flop (didn't bet)





PokerStars Hand #153501405724:  Hold'em No Limit ($0.50/$1.00 USD) - 2016/05/18 20:14:19 CET [2016/05/18 14:14:19 ET]
Table 'Abetti II' 9-max Seat #9 is the button
Seat 1: matiko09 ($126.08 in chips) 
Seat 2: Bimaxa ($127.34 in chips) 
Seat 3: cobrik23 ($257.87 in chips) 
Seat 7: nickreason17 ($143.72 in chips) 
Seat 8: roadster683 ($66.20 in chips) 
Seat 9: lydia12345 ($100 in chips) 
matiko09: posts small blind $0.50
Bimaxa: posts big blind $1
ipashutapkom: sits out 
I The King I: sits out 
*** HOLE CARDS ***
Dealt to matiko09 [8h 4d]
cobrik23: folds 
nickreason17: folds 
roadster683: folds 
lydia12345: folds 
matiko09: folds 
Uncalled bet ($0.50) returned to Bimaxa
Bimaxa collected $1 from pot
Bimaxa: doesn't show hand 
*** SUMMARY ***
Total pot $1 | Rake $0 
Seat 1: matiko09 (small blind) folded before Flop
Seat 2: Bimaxa (big blind) collected ($1)
Seat 3: cobrik23 folded before Flop (didn't bet)
Seat 7: nickreason17 folded before Flop (didn't bet)
Seat 8: roadster683 folded before Flop (didn't bet)
Seat 9: lydia12345 (button) folded before Flop (didn't bet)





PokerStars Hand #153501411225:  Hold'em No Limit ($1/$2 USD) - 2016/05/18 20:14:25 CET [2016/05/18 14:14:25 ET]
Table 'Chlosinde' 9-max Seat #5 is the button
Seat 1: ersevi6 ($157 in chips) 
Seat 3: matiko09 ($200 in chips) 
Seat 4: FREDY BULLIT ($230.85 in chips) 
Seat 5: tepi_guy ($869.16 in chips) 
Seat 7: donald0404 ($200 in chips) 
Seat 8: sanducu_eu ($243.25 in chips) 
Seat 9: Tey113 ($585.48 in chips) 
donald0404: posts small blind $1
sanducu_eu: posts big blind $2
lydia12345: sits out 
*** HOLE CARDS ***
Dealt to matiko09 [6h Tc]
Tey113: folds 
ersevi6: raises $3 to $5
matiko09: folds 
FREDY BULLIT: folds 
tepi_guy: folds 
donald0404: folds 
sanducu_eu: folds 
Uncalled bet ($3) returned to ersevi6
ersevi6 collected $5 from pot
ersevi6: doesn't show hand 
*** SUMMARY ***
Total pot $5 | Rake $0 
Seat 1: ersevi6 collected ($5)
Seat 3: matiko09 folded before Flop (didn't bet)
Seat 4: FREDY BULLIT folded before Flop (didn't bet)
Seat 5: tepi_guy (button) folded before Flop (didn't bet)
Seat 7: donald0404 (small blind) folded before Flop
Seat 8: sanducu_eu (big blind) folded before Flop
Seat 9: Tey113 folded before Flop (didn't bet)





PokerStars Hand #153501417478:  Hold'em No Limit ($0.50/$1.00 USD) - 2016/05/18 20:14:33 CET [2016/05/18 14:14:33 ET]
Table 'Abetti II' 9-max Seat #1 is the button
Seat 1: matiko09 ($125.58 in chips) 
Seat 2: Bimaxa ($127.84 in chips) 
Seat 3: cobrik23 ($257.87 in chips) 
Seat 7: nickreason17 ($143.72 in chips) 
Seat 8: roadster683 ($66.20 in chips) 
Seat 9: lydia12345 ($100 in chips) 
Bimaxa: posts small blind $0.50
cobrik23: posts big blind $1
ipashutapkom: sits out 
I The King I: sits out 
*** HOLE CARDS ***
Dealt to matiko09 [2c Ac]
nickreason17: folds 
roadster683: raises $1 to $2
lydia12345: folds 
matiko09: folds 
Bimaxa: folds 
cobrik23: folds 
Uncalled bet ($1) returned to roadster683
roadster683 collected $2.50 from pot
roadster683: doesn't show hand 
*** SUMMARY ***
Total pot $2.50 | Rake $0 
Seat 1: matiko09 (button) folded before Flop (didn't bet)
Seat 2: Bimaxa (small blind) folded before Flop
Seat 3: cobrik23 (big blind) folded before Flop
Seat 7: nickreason17 folded before Flop (didn't bet)
Seat 8: roadster683 collected ($2.50)
Seat 9: lydia12345 folded before Flop (didn't bet)





PokerStars Hand #153501420645:  Hold'em No Limit ($0.50/$1.00 USD) - 2016/05/18 20:14:36 CET [2016/05/18 14:14:36 ET]
Table 'Tatjana III' 9-max Seat #3 is the button
Seat 1: cobrik23 ($40 in chips) 
Seat 2: HITYESCA ($143.82 in chips) 
Seat 3: matiko09 ($173.90 in chips) 
Seat 4: lydia12345 ($118.90 in chips) 
Seat 5: deadkiller1 ($100 in chips) 
Seat 7: rene1984tsv ($175.33 in chips) 
Seat 9: Moszes360 ($101.50 in chips) 
lydia12345: posts small blind $0.50
deadkiller1: posts big blind $1
JACQUILF: sits out 
*** HOLE CARDS ***
Dealt to matiko09 [3h Th]
rene1984tsv: raises $2 to $3
Moszes360: folds 
cobrik23: folds 
HITYESCA: folds 
matiko09: folds 
lydia12345: folds 
deadkiller1: raises $6 to $9
rene1984tsv: folds 
Uncalled bet ($6) returned to deadkiller1
deadkiller1 collected $6.50 from pot
deadkiller1: doesn't show hand 
*** SUMMARY ***
Total pot $6.50 | Rake $0 
Seat 1: cobrik23 folded before Flop (didn't bet)
Seat 2: HITYESCA folded before Flop (didn't bet)
Seat 3: matiko09 (button) folded before Flop (didn't bet)
Seat 4: lydia12345 (small blind) folded before Flop
Seat 5: deadkiller1 (big blind) collected ($6.50)
Seat 7: rene1984tsv folded before Flop
Seat 9: Moszes360 folded before Flop (didn't bet)





PokerStars Hand #153501426157:  Hold'em No Limit ($1/$2 USD) - 2016/05/18 20:14:43 CET [2016/05/18 14:14:43 ET]
Table 'Letaba' 9-max Seat #3 is the button
Seat 1: FREDY BULLIT ($200 in chips) 
Seat 2: staruk669 ($105.24 in chips) 
Seat 3: ersevi6 ($214.04 in chips) 
Seat 4: matiko09 ($200 in chips) 
Seat 6: donald0404 ($220.49 in chips) 
Seat 7: moshmachine ($293.97 in chips) 
Seat 8: $-Twackle-$ ($224.08 in chips) 
Seat 9: tepi_guy ($239.75 in chips) 
matiko09: posts small blind $1
aseban11: is sitting out 
aseban11 leaves the table
donald0404: posts big blind $2
*** HOLE CARDS ***
Dealt to matiko09 [Ts Kh]
moshmachine: folds 
I The King I joins the table at seat #5 
I The King I leaves the table
$-Twackle-$: folds 
tipner joins the table at seat #5 
tepi_guy: folds 
FREDY BULLIT: folds 
staruk669: calls $2
ersevi6: folds 
matiko09: raises $7 to $9
donald0404: folds 
staruk669: folds 
Uncalled bet ($7) returned to matiko09
matiko09 collected $6 from pot
matiko09: doesn't show hand 
*** SUMMARY ***
Total pot $6 | Rake $0 
Seat 1: FREDY BULLIT folded before Flop (didn't bet)
Seat 2: staruk669 folded before Flop
Seat 3: ersevi6 (button) folded before Flop (didn't bet)
Seat 4: matiko09 (small blind) collected ($6)
Seat 6: donald0404 (big blind) folded before Flop
Seat 7: moshmachine folded before Flop (didn't bet)
Seat 8: $-Twackle-$ folded before Flop (didn't bet)
Seat 9: tepi_guy folded before Flop (didn't bet)





PokerStars Hand #153501429517:  Hold'em No Limit ($0.50/$1.00 USD) - 2016/05/18 20:14:47 CET [2016/05/18 14:14:47 ET]
Table 'Suevia' 9-max Seat #4 is the button
Seat 1: Bimaxa ($100.15 in chips) 
Seat 3: matiko09 ($102 in chips) 
Seat 4: HITYESCA ($105.32 in chips) 
Seat 5: bello1310 ($86.77 in chips) 
Seat 6: torkkdnm ($102.72 in chips) 
Seat 8: ama58 ($44.75 in chips) 
Seat 9: oscarleon ($111.64 in chips) 
bello1310: posts small blind $0.50
torkkdnm: posts big blind $1
cobrik23: sits out 
*** HOLE CARDS ***
Dealt to matiko09 [Td Js]
ama58: calls $1
oscarleon: folds 
Bimaxa: folds 
matiko09: raises $3 to $4
HITYESCA: calls $4
bello1310: calls $3.50
torkkdnm: calls $3
ama58: calls $3
*** FLOP *** [8d 5d 3h]
bello1310: checks 
torkkdnm: checks 
ama58: checks 
matiko09: checks 
HITYESCA: bets $12
bello1310: calls $12
torkkdnm: raises $86.72 to $98.72 and is all-in
ama58: folds 
matiko09: folds 
HITYESCA: folds 
bello1310: folds 
Uncalled bet ($86.72) returned to torkkdnm
torkkdnm collected $53.50 from pot
*** SUMMARY ***
Total pot $56 | Rake $2.50 
Board [8d 5d 3h]
Seat 1: Bimaxa folded before Flop (didn't bet)
Seat 3: matiko09 folded on the Flop
Seat 4: HITYESCA (button) folded on the Flop
Seat 5: bello1310 (small blind) folded on the Flop
Seat 6: torkkdnm (big blind) collected ($53.50)
Seat 8: ama58 folded on the Flop
Seat 9: oscarleon folded before Flop (didn't bet)





PokerStars Hand #153501436092:  Hold'em No Limit (€0.50/€1.00 EUR) - 2016/05/18 20:14:54 CET [2016/05/18 14:14:54 ET]
Table 'Pallas II' 9-max Seat #5 is the button
Seat 1: deadkiller1 (€100 in chips) 
Seat 2: matiko09 (€198.47 in chips) 
Seat 4: torkkdnm (€145.68 in chips) 
Seat 5: cobrik23 (€68.12 in chips) 
Seat 6: HITYESCA (€122.25 in chips) 
Seat 8: lydia12345 (€100 in chips) 
Seat 9: stijner1986 (€149.01 in chips) 
HITYESCA: posts small blind €0.50
ipashutapkom: is sitting out 
lydia12345: posts big blind €1
ipashutapkom leaves the table
JACQUILF: sits out 
*** HOLE CARDS ***
Dealt to matiko09 [Jh 5s]
stijner1986: folds 
deadkiller1: folds 
matiko09: folds 
torkkdnm: folds 
cobrik23: folds 
HITYESCA: raises €1.50 to €2.50
lydia12345: folds 
Uncalled bet (€1.50) returned to HITYESCA
HITYESCA collected €2 from pot
HITYESCA: doesn't show hand 
*** SUMMARY ***
Total pot €2 | Rake €0 
Seat 1: deadkiller1 folded before Flop (didn't bet)
Seat 2: matiko09 folded before Flop (didn't bet)
Seat 4: torkkdnm folded before Flop (didn't bet)
Seat 5: cobrik23 (button) folded before Flop (didn't bet)
Seat 6: HITYESCA (small blind) collected (€2)
Seat 8: lydia12345 (big blind) folded before Flop
Seat 9: stijner1986 folded before Flop (didn't bet)





PokerStars Hand #153501444063:  Hold'em No Limit ($0.50/$1.00 USD) - 2016/05/18 20:15:04 CET [2016/05/18 14:15:04 ET]
Table 'Pandora' 9-max Seat #8 is the button
Seat 1: deadkiller1 ($101.50 in chips) 
Seat 2: fack_vi ($69 in chips) 
Seat 4: mooose100 ($78.76 in chips) 
Seat 5: Mr Seelen ($79 in chips) 
Seat 6: Mulgraver25 ($64.63 in chips) 
Seat 7: lydia12345 ($108.82 in chips) 
Seat 8: matiko09 ($100 in chips) 
Seat 9: oscarleon ($115.98 in chips) 
oscarleon: posts small blind $0.50
deadkiller1: posts big blind $1
tipner: sits out 
*** HOLE CARDS ***
Dealt to matiko09 [Qh Th]
fack_vi: folds 
mooose100: raises $2 to $3
Mr Seelen: folds 
Mulgraver25: folds 
lydia12345: folds 
matiko09: folds 
oscarleon: folds 
deadkiller1: calls $2
*** FLOP *** [8d 4d 2h]
deadkiller1: checks 
mooose100: bets $3.09
deadkiller1: raises $5.91 to $9
mooose100: calls $5.91
*** TURN *** [8d 4d 2h] [3h]
deadkiller1: checks 
mooose100: bets $23.28
deadkiller1: folds 
Uncalled bet ($23.28) returned to mooose100
mooose100 collected $23.28 from pot
mooose100: doesn't show hand 
*** SUMMARY ***
Total pot $24.50 | Rake $1.22 
Board [8d 4d 2h 3h]
Seat 1: deadkiller1 (big blind) folded on the Turn
Seat 2: fack_vi folded before Flop (didn't bet)
Seat 4: mooose100 collected ($23.28)
Seat 5: Mr Seelen folded before Flop (didn't bet)
Seat 6: Mulgraver25 folded before Flop (didn't bet)
Seat 7: lydia12345 folded before Flop (didn't bet)
Seat 8: matiko09 (button) folded before Flop (didn't bet)
Seat 9: oscarleon (small blind) folded before Flop





PokerStars Hand #153501446503:  Hold'em No Limit ($1/$2 USD) - 2016/05/18 20:15:07 CET [2016/05/18 14:15:07 ET]
Table 'Chlosinde' 9-max Seat #7 is the button
Seat 1: ersevi6 ($160 in chips) 
Seat 3: matiko09 ($200 in chips) 
Seat 4: FREDY BULLIT ($230.85 in chips) 
Seat 5: tepi_guy ($869.16 in chips) 
Seat 7: donald0404 ($200 in chips) 
Seat 8: sanducu_eu ($241.25 in chips) 
Seat 9: Tey113 ($585.48 in chips) 
sanducu_eu: posts small blind $1
Tey113: posts big blind $2
lydia12345: sits out 
tipner: sits out 
*** HOLE CARDS ***
Dealt to matiko09 [3h 9s]
ersevi6: folds 
matiko09: folds 
FREDY BULLIT: folds 
tepi_guy: folds 
donald0404: folds 
sanducu_eu: raises $4 to $6
Tey113: calls $4
*** FLOP *** [2s 6c 8h]
sanducu_eu: bets $6.15
Tey113: calls $6.15
*** TURN *** [2s 6c 8h] [Jd]
sanducu_eu: bets $17.07
Tey113: calls $17.07
*** RIVER *** [2s 6c 8h Jd] [8s]
sanducu_eu: checks 
Tey113: bets $27.84
sanducu_eu: folds 
Uncalled bet ($27.84) returned to Tey113
Tey113 collected $55.69 from pot
Tey113: doesn't show hand 
*** SUMMARY ***
Total pot $58.44 | Rake $2.75 
Board [2s 6c 8h Jd 8s]
Seat 1: ersevi6 folded before Flop (didn't bet)
Seat 3: matiko09 folded before Flop (didn't bet)
Seat 4: FREDY BULLIT folded before Flop (didn't bet)
Seat 5: tepi_guy folded before Flop (didn't bet)
Seat 7: donald0404 (button) folded before Flop (didn't bet)
Seat 8: sanducu_eu (small blind) folded on the River
Seat 9: Tey113 (big blind) collected ($55.69)





PokerStars Hand #153501448278:  Hold'em No Limit ($0.50/$1.00 USD) - 2016/05/18 20:15:09 CET [2016/05/18 14:15:09 ET]
Table 'Tatjana III' 9-max Seat #4 is the button
Seat 1: cobrik23 ($40 in chips) 
Seat 2: HITYESCA ($143.82 in chips) 
Seat 3: matiko09 ($173.90 in chips) 
Seat 4: lydia12345 ($118.40 in chips) 
Seat 5: deadkiller1 ($103.50 in chips) 
Seat 6: nickreason17 ($134.62 in chips) 
Seat 7: rene1984tsv ($172.33 in chips) 
Seat 9: Moszes360 ($101.50 in chips) 
deadkiller1: posts small blind $0.50
nickreason17: posts big blind $1
JACQUILF: sits out 
*** HOLE CARDS ***
Dealt to matiko09 [4c 6c]
rene1984tsv: folds 
Moszes360: folds 
cobrik23: raises $2 to $3
HITYESCA: calls $3
matiko09: folds 
lydia12345: folds 
deadkiller1: folds 
nickreason17: folds 
*** FLOP *** [Ah 8h 9s]
cobrik23: checks 
HITYESCA: bets $5
cobrik23: calls $5
*** TURN *** [Ah 8h 9s] [Kc]
cobrik23: checks 
HITYESCA: checks 
*** RIVER *** [Ah 8h 9s Kc] [Qd]
cobrik23: bets $12
HITYESCA: calls $12
*** SHOW DOWN ***
cobrik23: shows [Kd Ks] (three of a kind, Kings)
HITYESCA: mucks hand 
cobrik23 collected $39.42 from pot
*** SUMMARY ***
Total pot $41.50 | Rake $2.08 
Board [Ah 8h 9s Kc Qd]
Seat 1: cobrik23 showed [Kd Ks] and won ($39.42) with three of a kind, Kings
Seat 2: HITYESCA mucked [Qh Ac]
Seat 3: matiko09 folded before Flop (didn't bet)
Seat 4: lydia12345 (button) folded before Flop (didn't bet)
Seat 5: deadkiller1 (small blind) folded before Flop
Seat 6: nickreason17 (big blind) folded before Flop
Seat 7: rene1984tsv folded before Flop (didn't bet)
Seat 9: Moszes360 folded before Flop (didn't bet)





PokerStars Hand #153501449226:  Hold'em No Limit ($0.50/$1.00 USD) - 2016/05/18 20:15:10 CET [2016/05/18 14:15:10 ET]
Table 'Abetti II' 9-max Seat #2 is the button
Seat 1: matiko09 ($125.58 in chips) 
Seat 2: Bimaxa ($127.34 in chips) 
Seat 3: cobrik23 ($256.87 in chips) 
Seat 4: ipashutapkom ($40 in chips) 
Seat 7: nickreason17 ($143.72 in chips) 
Seat 8: roadster683 ($67.70 in chips) 
Seat 9: lydia12345 ($100 in chips) 
cobrik23: posts small blind $0.50
ipashutapkom: posts big blind $1
I The King I: sits out 
*** HOLE CARDS ***
Dealt to matiko09 [Jh Ad]
nickreason17: folds 
roadster683: folds 
lydia12345: folds 
matiko09: raises $1.50 to $2.50
Bimaxa: folds 
cobrik23: folds 
ipashutapkom: folds 
Uncalled bet ($1.50) returned to matiko09
matiko09 collected $2.50 from pot
matiko09: doesn't show hand 
*** SUMMARY ***
Total pot $2.50 | Rake $0 
Seat 1: matiko09 collected ($2.50)
Seat 2: Bimaxa (button) folded before Flop (didn't bet)
Seat 3: cobrik23 (small blind) folded before Flop
Seat 4: ipashutapkom (big blind) folded before Flop
Seat 7: nickreason17 folded before Flop (didn't bet)
Seat 8: roadster683 folded before Flop (didn't bet)
Seat 9: lydia12345 folded before Flop (didn't bet)





PokerStars Hand #153501459498:  Hold'em No Limit ($1/$2 USD) - 2016/05/18 20:15:23 CET [2016/05/18 14:15:23 ET]
Table 'Letaba' 9-max Seat #4 is the button
Seat 1: FREDY BULLIT ($200 in chips) 
Seat 2: staruk669 ($103.24 in chips) 
Seat 3: ersevi6 ($214.04 in chips) 
Seat 4: matiko09 ($204 in chips) 
Seat 6: donald0404 ($218.49 in chips) 
Seat 9: tepi_guy ($239.75 in chips) 
donald0404: posts small blind $1
moshmachine: is sitting out 
$-Twackle-$: is sitting out 
tepi_guy: posts big blind $2
*** HOLE CARDS ***
Dealt to matiko09 [Ad 2h]
$-Twackle-$ leaves the table
FREDY BULLIT: folds 
staruk669: calls $2
ersevi6: folds 
matiko09: raises $6 to $8
donald0404: folds 
tepi_guy: folds 
staruk669: calls $6
*** FLOP *** [9s Ks Kh]
staruk669: checks 
matiko09: checks 
*** TURN *** [9s Ks Kh] [5h]
staruk669: bets $10
matiko09: folds 
Uncalled bet ($10) returned to staruk669
staruk669 collected $18.05 from pot
*** SUMMARY ***
Total pot $19 | Rake $0.95 
Board [9s Ks Kh 5h]
Seat 1: FREDY BULLIT folded before Flop (didn't bet)
Seat 2: staruk669 collected ($18.05)
Seat 3: ersevi6 folded before Flop (didn't bet)
Seat 4: matiko09 (button) folded on the Turn
Seat 6: donald0404 (small blind) folded before Flop
Seat 9: tepi_guy (big blind) folded before Flop





PokerStars Hand #153501465153:  Hold'em No Limit ($0.50/$1.00 USD) - 2016/05/18 20:15:29 CET [2016/05/18 14:15:29 ET]
Table 'Abetti II' 9-max Seat #3 is the button
Seat 1: matiko09 ($127.08 in chips) 
Seat 2: Bimaxa ($127.34 in chips) 
Seat 3: cobrik23 ($256.37 in chips) 
Seat 4: ipashutapkom ($40 in chips) 
Seat 6: I The King I ($145.64 in chips) 
Seat 7: nickreason17 ($143.72 in chips) 
Seat 8: roadster683 ($67.70 in chips) 
Seat 9: lydia12345 ($100 in chips) 
ipashutapkom: posts small blind $0.50
I The King I: posts big blind $1
*** HOLE CARDS ***
Dealt to matiko09 [3d Jh]
nickreason17: folds 
roadster683: folds 
lydia12345: folds 
matiko09: folds 
Bimaxa: raises $2 to $3
cobrik23: folds 
ipashutapkom: folds 
I The King I: folds 
Uncalled bet ($2) returned to Bimaxa
Bimaxa collected $2.50 from pot
Bimaxa: doesn't show hand 
*** SUMMARY ***
Total pot $2.50 | Rake $0 
Seat 1: matiko09 folded before Flop (didn't bet)
Seat 2: Bimaxa collected ($2.50)
Seat 3: cobrik23 (button) folded before Flop (didn't bet)
Seat 4: ipashutapkom (small blind) folded before Flop
Seat 6: I The King I (big blind) folded before Flop
Seat 7: nickreason17 folded before Flop (didn't bet)
Seat 8: roadster683 folded before Flop (didn't bet)
Seat 9: lydia12345 folded before Flop (didn't bet)





PokerStars Hand #153501471524:  Hold'em No Limit (€0.50/€1.00 EUR) - 2016/05/18 20:15:37 CET [2016/05/18 14:15:37 ET]
Table 'Pallas II' 9-max Seat #6 is the button
Seat 1: deadkiller1 (€100 in chips) 
Seat 2: matiko09 (€198.47 in chips) 
Seat 4: torkkdnm (€145.68 in chips) 
Seat 5: cobrik23 (€68.12 in chips) 
Seat 6: HITYESCA (€123.25 in chips) 
Seat 8: lydia12345 (€100 in chips) 
Seat 9: stijner1986 (€149.01 in chips) 
lydia12345: posts small blind €0.50
stijner1986: posts big blind €1
JACQUILF: sits out 
*** HOLE CARDS ***
Dealt to matiko09 [6s 8s]
deadkiller1: folds 
matiko09: folds 
torkkdnm: folds 
cobrik23: folds 
HITYESCA: raises €1.50 to €2.50
lydia12345: folds 
stijner1986: folds 
Uncalled bet (€1.50) returned to HITYESCA
HITYESCA collected €2.50 from pot
*** SUMMARY ***
Total pot €2.50 | Rake €0 
Seat 1: deadkiller1 folded before Flop (didn't bet)
Seat 2: matiko09 folded before Flop (didn't bet)
Seat 4: torkkdnm folded before Flop (didn't bet)
Seat 5: cobrik23 folded before Flop (didn't bet)
Seat 6: HITYESCA (button) collected (€2.50)
Seat 8: lydia12345 (small blind) folded before Flop
Seat 9: stijner1986 (big blind) folded before Flop





PokerStars Hand #153501475321:  Hold'em No Limit ($0.50/$1.00 USD) - 2016/05/18 20:15:41 CET [2016/05/18 14:15:41 ET]
Table 'Saiph II' 9-max Seat #4 is the button
Seat 1: MAARKKKK ($68.18 in chips) 
Seat 2: matiko09 ($137.24 in chips) 
Seat 3: lydia12345 ($173.12 in chips) 
Seat 4: deadkiller1 ($100 in chips) 
Seat 5: cobrik23 ($71.98 in chips) 
Seat 6: LadyMaCe86 ($104 in chips) 
Seat 7: nickreason17 ($100 in chips) 
Seat 8: sanr23 ($102.92 in chips) 
Seat 9: HITYESCA ($100 in chips) 
cobrik23: posts small blind $0.50
LadyMaCe86: posts big blind $1
*** HOLE CARDS ***
Dealt to matiko09 [6h 2h]
nickreason17: raises $1.50 to $2.50
sanr23: folds 
HITYESCA: folds 
MAARKKKK: folds 
matiko09: folds 
lydia12345: folds 
deadkiller1: folds 
cobrik23: folds 
LadyMaCe86: calls $1.50
*** FLOP *** [6s Ks 7c]
LadyMaCe86: checks 
nickreason17: bets $2.75
LadyMaCe86: calls $2.75
*** TURN *** [6s Ks 7c] [4h]
LadyMaCe86: checks 
nickreason17: bets $7.83
LadyMaCe86: folds 
Uncalled bet ($7.83) returned to nickreason17
nickreason17 collected $10.45 from pot
*** SUMMARY ***
Total pot $11 | Rake $0.55 
Board [6s Ks 7c 4h]
Seat 1: MAARKKKK folded before Flop (didn't bet)
Seat 2: matiko09 folded before Flop (didn't bet)
Seat 3: lydia12345 folded before Flop (didn't bet)
Seat 4: deadkiller1 (button) folded before Flop (didn't bet)
Seat 5: cobrik23 (small blind) folded before Flop
Seat 6: LadyMaCe86 (big blind) folded on the Turn
Seat 7: nickreason17 collected ($10.45)
Seat 8: sanr23 folded before Flop (didn't bet)
Seat 9: HITYESCA folded before Flop (didn't bet)





PokerStars Hand #153501485340:  Hold'em No Limit ($0.50/$1.00 USD) - 2016/05/18 20:15:53 CET [2016/05/18 14:15:53 ET]
Table 'Abetti II' 9-max Seat #4 is the button
Seat 1: matiko09 ($127.08 in chips) 
Seat 2: Bimaxa ($128.84 in chips) 
Seat 3: cobrik23 ($256.37 in chips) 
Seat 4: ipashutapkom ($40 in chips) 
Seat 6: I The King I ($144.64 in chips) 
Seat 7: nickreason17 ($143.72 in chips) 
Seat 8: roadster683 ($67.70 in chips) 
Seat 9: lydia12345 ($100 in chips) 
I The King I: posts small blind $0.50
nickreason17: posts big blind $1
*** HOLE CARDS ***
Dealt to matiko09 [Ks 5h]
roadster683: calls $1
lydia12345: folds 
matiko09: folds 
Bimaxa: folds 
cobrik23: folds 
ipashutapkom: folds 
I The King I: raises $4 to $5
nickreason17: folds 
roadster683: calls $4
*** FLOP *** [8d Qs 6c]
I The King I: checks 
roadster683: checks 
*** TURN *** [8d Qs 6c] [Qc]
I The King I: bets $7
roadster683: calls $7
*** RIVER *** [8d Qs 6c Qc] [3h]
I The King I: bets $17
roadster683: folds 
Uncalled bet ($17) returned to I The King I
I The King I collected $23.75 from pot
I The King I: doesn't show hand 
*** SUMMARY ***
Total pot $25 | Rake $1.25 
Board [8d Qs 6c Qc 3h]
Seat 1: matiko09 folded before Flop (didn't bet)
Seat 2: Bimaxa folded before Flop (didn't bet)
Seat 3: cobrik23 folded before Flop (didn't bet)
Seat 4: ipashutapkom (button) folded before Flop (didn't bet)
Seat 6: I The King I (small blind) collected ($23.75)
Seat 7: nickreason17 (big blind) folded before Flop
Seat 8: roadster683 folded on the River
Seat 9: lydia12345 folded before Flop (didn't bet)





PokerStars Hand #153501494101:  Hold'em No Limit ($1/$2 USD) - 2016/05/18 20:16:03 CET [2016/05/18 14:16:03 ET]
Table 'Chlosinde' 9-max Seat #8 is the button
Seat 1: ersevi6 ($160 in chips) 
Seat 3: matiko09 ($200 in chips) 
Seat 4: FREDY BULLIT ($230.85 in chips) 
Seat 5: tepi_guy ($869.16 in chips) 
Seat 7: donald0404 ($200 in chips) 
Seat 8: sanducu_eu ($212.03 in chips) 
Seat 9: Tey113 ($611.95 in chips) 
Tey113: posts small blind $1
ersevi6: posts big blind $2
lydia12345: sits out 
tipner: sits out 
*** HOLE CARDS ***
Dealt to matiko09 [5h 5s]
matiko09: raises $3 to $5
FREDY BULLIT: folds 
tepi_guy: folds 
donald0404: folds 
sanducu_eu: folds 
Tey113: calls $4
ersevi6: folds 
*** FLOP *** [Th Tc 8c]
Tey113: checks 
matiko09: checks 
*** TURN *** [Th Tc 8c] [4d]
Tey113: checks 
matiko09: bets $5.92
Tey113: calls $5.92
*** RIVER *** [Th Tc 8c 4d] [2d]
Tey113: checks 
matiko09: checks 
*** SHOW DOWN ***
Tey113: shows [Ac 5d] (a pair of Tens)
matiko09: shows [5h 5s] (two pair, Tens and Fives)
matiko09 collected $22.65 from pot
*** SUMMARY ***
Total pot $23.84 | Rake $1.19 
Board [Th Tc 8c 4d 2d]
Seat 1: ersevi6 (big blind) folded before Flop
Seat 3: matiko09 showed [5h 5s] and won ($22.65) with two pair, Tens and Fives
Seat 4: FREDY BULLIT folded before Flop (didn't bet)
Seat 5: tepi_guy folded before Flop (didn't bet)
Seat 7: donald0404 folded before Flop (didn't bet)
Seat 8: sanducu_eu (button) folded before Flop (didn't bet)
Seat 9: Tey113 (small blind) showed [Ac 5d] and lost with a pair of Tens





PokerStars Hand #153501500510:  Hold'em No Limit (€0.50/€1.00 EUR) - 2016/05/18 20:16:10 CET [2016/05/18 14:16:10 ET]
Table 'Pallas II' 9-max Seat #8 is the button
Seat 1: deadkiller1 (€100 in chips) 
Seat 2: matiko09 (€198.47 in chips) 
Seat 4: torkkdnm (€145.68 in chips) 
Seat 5: cobrik23 (€68.12 in chips) 
Seat 6: HITYESCA (€124.75 in chips) 
Seat 8: lydia12345 (€100 in chips) 
Seat 9: stijner1986 (€148.01 in chips) 
stijner1986: posts small blind €0.50
deadkiller1: posts big blind €1
JACQUILF: sits out 
*** HOLE CARDS ***
Dealt to matiko09 [3d Kc]
matiko09: folds 
rate8 joins the table at seat #7 
torkkdnm: raises €2 to €3
cobrik23: calls €3
HITYESCA: folds 
lydia12345: folds 
stijner1986: folds 
deadkiller1: folds 
*** FLOP *** [Qc Tc 4d]
torkkdnm: checks 
cobrik23: bets €3.56
torkkdnm: folds 
Uncalled bet (€3.56) returned to cobrik23
cobrik23 collected €7.12 from pot
cobrik23: doesn't show hand 
*** SUMMARY ***
Total pot €7.50 | Rake €0.38 
Board [Qc Tc 4d]
Seat 1: deadkiller1 (big blind) folded before Flop
Seat 2: matiko09 folded before Flop (didn't bet)
Seat 4: torkkdnm folded on the Flop
Seat 5: cobrik23 collected (€7.12)
Seat 6: HITYESCA folded before Flop (didn't bet)
Seat 8: lydia12345 (button) folded before Flop (didn't bet)
Seat 9: stijner1986 (small blind) folded before Flop





PokerStars Hand #153501502125:  Hold'em No Limit ($1/$2 USD) - 2016/05/18 20:16:12 CET [2016/05/18 14:16:12 ET]
Table 'Letaba' 9-max Seat #6 is the button
Seat 1: FREDY BULLIT ($200 in chips) 
Seat 2: staruk669 ($113.29 in chips) 
Seat 3: ersevi6 ($214.04 in chips) 
Seat 4: matiko09 ($200 in chips) 
Seat 6: donald0404 ($217.49 in chips) 
Seat 9: tepi_guy ($237.75 in chips) 
tepi_guy: posts small blind $1
FREDY BULLIT: posts big blind $2
*** HOLE CARDS ***
Dealt to matiko09 [2c 3s]
staruk669: folds 
ersevi6: folds 
matiko09: folds 
donald0404: folds 
tepi_guy: folds 
Uncalled bet ($1) returned to FREDY BULLIT
FREDY BULLIT collected $2 from pot
FREDY BULLIT: doesn't show hand 
*** SUMMARY ***
Total pot $2 | Rake $0 
Seat 1: FREDY BULLIT (big blind) collected ($2)
Seat 2: staruk669 folded before Flop (didn't bet)
Seat 3: ersevi6 folded before Flop (didn't bet)
Seat 4: matiko09 folded before Flop (didn't bet)
Seat 6: donald0404 (button) folded before Flop (didn't bet)
Seat 9: tepi_guy (small blind) folded before Flop





PokerStars Hand #153501504424:  Hold'em No Limit ($0.50/$1.00 USD) - 2016/05/18 20:16:15 CET [2016/05/18 14:16:15 ET]
Table 'Tatjana III' 9-max Seat #5 is the button
Seat 1: cobrik23 ($59.42 in chips) 
Seat 2: HITYESCA ($123.82 in chips) 
Seat 3: matiko09 ($173.90 in chips) 
Seat 4: lydia12345 ($118.40 in chips) 
Seat 5: deadkiller1 ($103 in chips) 
Seat 6: nickreason17 ($133.62 in chips) 
Seat 7: rene1984tsv ($172.33 in chips) 
Seat 9: Moszes360 ($101.50 in chips) 
nickreason17: posts small blind $0.50
rene1984tsv: posts big blind $1
JACQUILF: sits out 
*** HOLE CARDS ***
Dealt to matiko09 [5d Kc]
Moszes360: folds 
cobrik23: folds 
HITYESCA: raises $2 to $3
matiko09: folds 
lydia12345: folds 
deadkiller1: folds 
nickreason17: folds 
rene1984tsv: folds 
Uncalled bet ($2) returned to HITYESCA
HITYESCA collected $2.50 from pot
HITYESCA: doesn't show hand 
*** SUMMARY ***
Total pot $2.50 | Rake $0 
Seat 1: cobrik23 folded before Flop (didn't bet)
Seat 2: HITYESCA collected ($2.50)
Seat 3: matiko09 folded before Flop (didn't bet)
Seat 4: lydia12345 folded before Flop (didn't bet)
Seat 5: deadkiller1 (button) folded before Flop (didn't bet)
Seat 6: nickreason17 (small blind) folded before Flop
Seat 7: rene1984tsv (big blind) folded before Flop
Seat 9: Moszes360 folded before Flop (didn't bet)





PokerStars Hand #153501514775:  Hold'em No Limit ($1/$2 USD) - 2016/05/18 20:16:27 CET [2016/05/18 14:16:27 ET]
Table 'Letaba' 9-max Seat #9 is the button
Seat 1: FREDY BULLIT ($201 in chips) 
Seat 2: staruk669 ($113.29 in chips) 
Seat 3: ersevi6 ($214.04 in chips) 
Seat 4: matiko09 ($200 in chips) 
Seat 6: donald0404 ($217.49 in chips) 
Seat 9: tepi_guy ($236.75 in chips) 
FREDY BULLIT: posts small blind $1
staruk669: posts big blind $2
tipner: sits out 
*** HOLE CARDS ***
Dealt to matiko09 [Ad 9h]
ersevi6: folds 
matiko09: raises $3 to $5
donald0404: folds 
tepi_guy: folds 
uonlylive1ce joins the table at seat #8 
FREDY BULLIT: calls $4
staruk669: calls $3
*** FLOP *** [6s Qh 3d]
FREDY BULLIT: checks 
staruk669: checks 
matiko09: checks 
*** TURN *** [6s Qh 3d] [Kh]
FREDY BULLIT: checks 
staruk669: checks 
matiko09: checks 
*** RIVER *** [6s Qh 3d Kh] [Kd]
FREDY BULLIT: checks 
staruk669: checks 
matiko09: checks 
*** SHOW DOWN ***
FREDY BULLIT: shows [Ts Td] (two pair, Kings and Tens)
staruk669: mucks hand 
matiko09: mucks hand 
FREDY BULLIT collected $14.25 from pot
*** SUMMARY ***
Total pot $15 | Rake $0.75 
Board [6s Qh 3d Kh Kd]
Seat 1: FREDY BULLIT (small blind) showed [Ts Td] and won ($14.25) with two pair, Kings and Tens
Seat 2: staruk669 (big blind) mucked [9d 2s]
Seat 3: ersevi6 folded before Flop (didn't bet)
Seat 4: matiko09 mucked [Ad 9h]
Seat 6: donald0404 folded before Flop (didn't bet)
Seat 9: tepi_guy (button) folded before Flop (didn't bet)





PokerStars Hand #153501515796:  Hold'em No Limit ($0.50/$1.00 USD) - 2016/05/18 20:16:28 CET [2016/05/18 14:16:28 ET]
Table 'Tatjana III' 9-max Seat #6 is the button
Seat 1: cobrik23 ($59.42 in chips) 
Seat 2: HITYESCA ($125.32 in chips) 
Seat 3: matiko09 ($173.90 in chips) 
Seat 4: lydia12345 ($118.40 in chips) 
Seat 5: deadkiller1 ($103 in chips) 
Seat 6: nickreason17 ($133.12 in chips) 
Seat 7: rene1984tsv ($171.33 in chips) 
Seat 8: JACQUILF ($100 in chips) 
Seat 9: Moszes360 ($101.50 in chips) 
rene1984tsv: posts small blind $0.50
JACQUILF: posts big blind $1
*** HOLE CARDS ***
Dealt to matiko09 [As 4c]
Moszes360: folds 
cobrik23: folds 
HITYESCA: folds 
matiko09: folds 
lydia12345: folds 
deadkiller1: folds 
nickreason17: folds 
rene1984tsv: raises $1 to $2
JACQUILF: folds 
Uncalled bet ($1) returned to rene1984tsv
rene1984tsv collected $2 from pot
*** SUMMARY ***
Total pot $2 | Rake $0 
Seat 1: cobrik23 folded before Flop (didn't bet)
Seat 2: HITYESCA folded before Flop (didn't bet)
Seat 3: matiko09 folded before Flop (didn't bet)
Seat 4: lydia12345 folded before Flop (didn't bet)
Seat 5: deadkiller1 folded before Flop (didn't bet)
Seat 6: nickreason17 (button) folded before Flop (didn't bet)
Seat 7: rene1984tsv (small blind) collected ($2)
Seat 8: JACQUILF (big blind) folded before Flop
Seat 9: Moszes360 folded before Flop (didn't bet)





PokerStars Hand #153501517878:  Hold'em No Limit ($0.50/$1.00 USD) - 2016/05/18 20:16:30 CET [2016/05/18 14:16:30 ET]
Table 'Pandora' 9-max Seat #9 is the button
Seat 1: deadkiller1 ($100 in chips) 
Seat 2: fack_vi ($69 in chips) 
Seat 4: mooose100 ($90.04 in chips) 
Seat 5: Mr Seelen ($79 in chips) 
Seat 6: Mulgraver25 ($64.63 in chips) 
Seat 7: lydia12345 ($108.82 in chips) 
Seat 8: matiko09 ($100 in chips) 
Seat 9: oscarleon ($115.48 in chips) 
deadkiller1: posts small blind $0.50
fack_vi: posts big blind $1
tipner: sits out 
*** HOLE CARDS ***
Dealt to matiko09 [7s 2s]
mooose100: folds 
Mr Seelen: calls $1
Mulgraver25: folds 
lydia12345: folds 
matiko09: folds 
oscarleon: folds 
deadkiller1: calls $0.50
fack_vi: raises $1.50 to $2.50
Mr Seelen: calls $1.50
deadkiller1: calls $1.50
*** FLOP *** [Kc Qd 5d]
deadkiller1: checks 
fack_vi: bets $4
Mr Seelen: folds 
deadkiller1: folds 
Uncalled bet ($4) returned to fack_vi
fack_vi collected $7.12 from pot
fack_vi: doesn't show hand 
*** SUMMARY ***
Total pot $7.50 | Rake $0.38 
Board [Kc Qd 5d]
Seat 1: deadkiller1 (small blind) folded on the Flop
Seat 2: fack_vi (big blind) collected ($7.12)
Seat 4: mooose100 folded before Flop (didn't bet)
Seat 5: Mr Seelen folded on the Flop
Seat 6: Mulgraver25 folded before Flop (didn't bet)
Seat 7: lydia12345 folded before Flop (didn't bet)
Seat 8: matiko09 folded before Flop (didn't bet)
Seat 9: oscarleon (button) folded before Flop (didn't bet)





PokerStars Hand #153501520301:  Hold'em No Limit ($0.50/$1.00 USD) - 2016/05/18 20:16:33 CET [2016/05/18 14:16:33 ET]
Table 'Suevia' 9-max Seat #5 is the button
Seat 1: Bimaxa ($100.15 in chips) 
Seat 3: matiko09 ($100 in chips) 
Seat 4: HITYESCA ($100 in chips) 
Seat 5: bello1310 ($70.77 in chips) 
Seat 6: torkkdnm ($140.22 in chips) 
Seat 7: cobrik23 ($76.80 in chips) 
Seat 8: ama58 ($40.75 in chips) 
Seat 9: oscarleon ($111.64 in chips) 
torkkdnm: posts small blind $0.50
cobrik23: posts big blind $1
*** HOLE CARDS ***
Dealt to matiko09 [3s 9h]
ama58: folds 
oscarleon: folds 
Bimaxa: folds 
matiko09: folds 
tipner leaves the table
HITYESCA: folds 
deadkiller1 joins the table at seat #2 
bello1310: raises $2.50 to $3.50
torkkdnm: folds 
cobrik23: folds 
Uncalled bet ($2.50) returned to bello1310
bello1310 collected $2.50 from pot
bello1310: doesn't show hand 
*** SUMMARY ***
Total pot $2.50 | Rake $0 
Seat 1: Bimaxa folded before Flop (didn't bet)
Seat 3: matiko09 folded before Flop (didn't bet)
Seat 4: HITYESCA folded before Flop (didn't bet)
Seat 5: bello1310 (button) collected ($2.50)
Seat 6: torkkdnm (small blind) folded before Flop
Seat 7: cobrik23 (big blind) folded before Flop
Seat 8: ama58 folded before Flop (didn't bet)
Seat 9: oscarleon folded before Flop (didn't bet)





PokerStars Hand #153501531235:  Hold'em No Limit ($0.50/$1.00 USD) - 2016/05/18 20:16:46 CET [2016/05/18 14:16:46 ET]
Table 'Abetti II' 9-max Seat #6 is the button
Seat 1: matiko09 ($127.08 in chips) 
Seat 2: Bimaxa ($128.84 in chips) 
Seat 3: cobrik23 ($256.37 in chips) 
Seat 4: ipashutapkom ($40 in chips) 
Seat 6: I The King I ($156.39 in chips) 
Seat 7: nickreason17 ($142.72 in chips) 
Seat 8: roadster683 ($55.70 in chips) 
Seat 9: lydia12345 ($100 in chips) 
nickreason17: posts small blind $0.50
roadster683: posts big blind $1
*** HOLE CARDS ***
Dealt to matiko09 [6h 7h]
lydia12345: folds 
matiko09: folds 
Bimaxa: folds 
cobrik23: raises $2 to $3
ipashutapkom: folds 
I The King I: folds 
nickreason17: folds 
roadster683: folds 
Uncalled bet ($2) returned to cobrik23
cobrik23 collected $2.50 from pot
cobrik23: doesn't show hand 
*** SUMMARY ***
Total pot $2.50 | Rake $0 
Seat 1: matiko09 folded before Flop (didn't bet)
Seat 2: Bimaxa folded before Flop (didn't bet)
Seat 3: cobrik23 collected ($2.50)
Seat 4: ipashutapkom folded before Flop (didn't bet)
Seat 6: I The King I (button) folded before Flop (didn't bet)
Seat 7: nickreason17 (small blind) folded before Flop
Seat 8: roadster683 (big blind) folded before Flop
Seat 9: lydia12345 folded before Flop (didn't bet)





PokerStars Hand #153501537575:  Hold'em No Limit ($0.50/$1.00 USD) - 2016/05/18 20:16:53 CET [2016/05/18 14:16:53 ET]
Table 'Tatjana III' 9-max Seat #7 is the button
Seat 1: cobrik23 ($59.42 in chips) 
Seat 2: HITYESCA ($125.32 in chips) 
Seat 3: matiko09 ($173.90 in chips) 
Seat 4: lydia12345 ($118.40 in chips) 
Seat 5: deadkiller1 ($103 in chips) 
Seat 6: nickreason17 ($133.12 in chips) 
Seat 7: rene1984tsv ($172.33 in chips) 
Seat 8: JACQUILF ($100 in chips) 
Seat 9: Moszes360 ($101.50 in chips) 
JACQUILF: posts small blind $0.50
Moszes360: posts big blind $1
*** HOLE CARDS ***
Dealt to matiko09 [Qs 8s]
cobrik23: folds 
HITYESCA: folds 
matiko09: folds 
lydia12345: folds 
deadkiller1: folds 
nickreason17: folds 
rene1984tsv: raises $2 to $3
JACQUILF: folds 
Moszes360: folds 
Uncalled bet ($2) returned to rene1984tsv
rene1984tsv collected $2.50 from pot
*** SUMMARY ***
Total pot $2.50 | Rake $0 
Seat 1: cobrik23 folded before Flop (didn't bet)
Seat 2: HITYESCA folded before Flop (didn't bet)
Seat 3: matiko09 folded before Flop (didn't bet)
Seat 4: lydia12345 folded before Flop (didn't bet)
Seat 5: deadkiller1 folded before Flop (didn't bet)
Seat 6: nickreason17 folded before Flop (didn't bet)
Seat 7: rene1984tsv (button) collected ($2.50)
Seat 8: JACQUILF (small blind) folded before Flop
Seat 9: Moszes360 (big blind) folded before Flop





PokerStars Hand #153501538730:  Hold'em No Limit ($0.50/$1.00 USD) - 2016/05/18 20:16:55 CET [2016/05/18 14:16:55 ET]
Table 'Saiph II' 9-max Seat #5 is the button
Seat 1: MAARKKKK ($68.18 in chips) 
Seat 2: matiko09 ($137.24 in chips) 
Seat 3: lydia12345 ($173.12 in chips) 
Seat 4: deadkiller1 ($100 in chips) 
Seat 5: cobrik23 ($71.48 in chips) 
Seat 6: LadyMaCe86 ($100 in chips) 
Seat 7: nickreason17 ($105.20 in chips) 
Seat 8: sanr23 ($102.92 in chips) 
Seat 9: HITYESCA ($100 in chips) 
LadyMaCe86: posts small blind $0.50
nickreason17: posts big blind $1
*** HOLE CARDS ***
Dealt to matiko09 [8s 4h]
sanr23: raises $2 to $3
HITYESCA: folds 
MAARKKKK: folds 
matiko09: folds 
lydia12345: folds 
deadkiller1: folds 
cobrik23: folds 
LadyMaCe86: folds 
nickreason17: folds 
Uncalled bet ($2) returned to sanr23
sanr23 collected $2.50 from pot
sanr23: doesn't show hand 
*** SUMMARY ***
Total pot $2.50 | Rake $0 
Seat 1: MAARKKKK folded before Flop (didn't bet)
Seat 2: matiko09 folded before Flop (didn't bet)
Seat 3: lydia12345 folded before Flop (didn't bet)
Seat 4: deadkiller1 folded before Flop (didn't bet)
Seat 5: cobrik23 (button) folded before Flop (didn't bet)
Seat 6: LadyMaCe86 (small blind) folded before Flop
Seat 7: nickreason17 (big blind) folded before Flop
Seat 8: sanr23 collected ($2.50)
Seat 9: HITYESCA folded before Flop (didn't bet)





PokerStars Hand #153501548898:  Hold'em No Limit ($0.50/$1.00 USD) - 2016/05/18 20:17:06 CET [2016/05/18 14:17:06 ET]
Table 'Suevia' 9-max Seat #6 is the button
Seat 1: Bimaxa ($100.15 in chips) 
Seat 3: matiko09 ($100 in chips) 
Seat 4: HITYESCA ($100 in chips) 
Seat 5: bello1310 ($72.27 in chips) 
Seat 6: torkkdnm ($139.72 in chips) 
Seat 7: cobrik23 ($75.80 in chips) 
Seat 8: ama58 ($40.75 in chips) 
Seat 9: oscarleon ($111.64 in chips) 
cobrik23: posts small blind $0.50
ama58: posts big blind $1
deadkiller1: sits out 
*** HOLE CARDS ***
Dealt to matiko09 [Jd 8d]
oscarleon: folds 
Bimaxa: folds 
matiko09: folds 
HITYESCA: folds 
bello1310: folds 
torkkdnm: folds 
cobrik23: raises $2 to $3
ama58: calls $2
*** FLOP *** [9c Kd 3d]
cobrik23: checks 
ama58: bets $3
cobrik23: folds 
Uncalled bet ($3) returned to ama58
ama58 collected $5.70 from pot
*** SUMMARY ***
Total pot $6 | Rake $0.30 
Board [9c Kd 3d]
Seat 1: Bimaxa folded before Flop (didn't bet)
Seat 3: matiko09 folded before Flop (didn't bet)
Seat 4: HITYESCA folded before Flop (didn't bet)
Seat 5: bello1310 folded before Flop (didn't bet)
Seat 6: torkkdnm (button) folded before Flop (didn't bet)
Seat 7: cobrik23 (small blind) folded on the Flop
Seat 8: ama58 (big blind) collected ($5.70)
Seat 9: oscarleon folded before Flop (didn't bet)





PokerStars Hand #153501550467:  Hold'em No Limit (€0.50/€1.00 EUR) - 2016/05/18 20:17:08 CET [2016/05/18 14:17:08 ET]
Table 'Pallas II' 9-max Seat #9 is the button
Seat 1: deadkiller1 (€100 in chips) 
Seat 2: matiko09 (€198.47 in chips) 
Seat 4: torkkdnm (€142.68 in chips) 
Seat 5: cobrik23 (€72.24 in chips) 
Seat 6: HITYESCA (€124.75 in chips) 
Seat 8: lydia12345 (€100 in chips) 
Seat 9: stijner1986 (€147.51 in chips) 
deadkiller1: posts small blind €0.50
matiko09: posts big blind €1
JACQUILF: sits out 
*** HOLE CARDS ***
Dealt to matiko09 [Td Ad]
torkkdnm: folds 
rate8 is disconnected 
cobrik23: raises €2 to €3
HITYESCA: folds 
lydia12345: folds 
stijner1986: calls €3
deadkiller1: folds 
matiko09: calls €2
*** FLOP *** [7c 6h 2d]
matiko09: checks 
cobrik23: checks 
stijner1986: checks 
*** TURN *** [7c 6h 2d] [8d]
matiko09: bets €7
cobrik23: folds 
stijner1986: folds 
Uncalled bet (€7) returned to matiko09
matiko09 collected €9.02 from pot
matiko09: doesn't show hand 
*** SUMMARY ***
Total pot €9.50 | Rake €0.48 
Board [7c 6h 2d 8d]
Seat 1: deadkiller1 (small blind) folded before Flop
Seat 2: matiko09 (big blind) collected (€9.02)
Seat 4: torkkdnm folded before Flop (didn't bet)
Seat 5: cobrik23 folded on the Turn
Seat 6: HITYESCA folded before Flop (didn't bet)
Seat 8: lydia12345 folded before Flop (didn't bet)
Seat 9: stijner1986 (button) folded on the Turn





PokerStars Hand #153501550284:  Hold'em No Limit ($0.50/$1.00 USD) - 2016/05/18 20:17:08 CET [2016/05/18 14:17:08 ET]
Table 'Erida II' 9-max Seat #5 is the button
Seat 2: cobrik23 ($100 in chips) 
Seat 3: Kelvin sai ($71.78 in chips) 
Seat 5: Moszes360 ($101 in chips) 
Seat 6: deadkiller1 ($134.42 in chips) 
Seat 7: matiko09 ($100 in chips) 
Seat 9: sanr23 ($102.40 in chips) 
deadkiller1: posts small blind $0.50
matiko09: posts big blind $1
t4ppz: sits out 
vanilica: sits out 
*** HOLE CARDS ***
Dealt to matiko09 [Tc 5h]
sanr23: raises $2 to $3
cobrik23: folds 
Kelvin sai: folds 
Moszes360: folds 
deadkiller1: folds 
matiko09: folds 
Uncalled bet ($2) returned to sanr23
sanr23 collected $2.50 from pot
sanr23: doesn't show hand 
*** SUMMARY ***
Total pot $2.50 | Rake $0 
Seat 2: cobrik23 folded before Flop (didn't bet)
Seat 3: Kelvin sai folded before Flop (didn't bet)
Seat 5: Moszes360 (button) folded before Flop (didn't bet)
Seat 6: deadkiller1 (small blind) folded before Flop
Seat 7: matiko09 (big blind) folded before Flop
Seat 9: sanr23 collected ($2.50)





PokerStars Hand #153501553274:  Hold'em No Limit ($0.50/$1.00 USD) - 2016/05/18 20:17:12 CET [2016/05/18 14:17:12 ET]
Table 'Abetti II' 9-max Seat #7 is the button
Seat 1: matiko09 ($127.08 in chips) 
Seat 2: Bimaxa ($128.84 in chips) 
Seat 3: cobrik23 ($257.87 in chips) 
Seat 4: ipashutapkom ($40 in chips) 
Seat 6: I The King I ($156.39 in chips) 
Seat 7: nickreason17 ($142.22 in chips) 
Seat 8: roadster683 ($54.70 in chips) 
Seat 9: lydia12345 ($100 in chips) 
roadster683: posts small blind $0.50
lydia12345: posts big blind $1
*** HOLE CARDS ***
Dealt to matiko09 [Jc 8c]
matiko09: folds 
Bimaxa: folds 
cobrik23: folds 
ipashutapkom: raises $1.26 to $2.26
I The King I: folds 
nickreason17: folds 
roadster683: calls $1.76
lydia12345: folds 
*** FLOP *** [As Qd 3s]
roadster683: checks 
ipashutapkom: bets $3.51
roadster683: folds 
Uncalled bet ($3.51) returned to ipashutapkom
ipashutapkom collected $5.24 from pot
ipashutapkom: doesn't show hand 
*** SUMMARY ***
Total pot $5.52 | Rake $0.28 
Board [As Qd 3s]
Seat 1: matiko09 folded before Flop (didn't bet)
Seat 2: Bimaxa folded before Flop (didn't bet)
Seat 3: cobrik23 folded before Flop (didn't bet)
Seat 4: ipashutapkom collected ($5.24)
Seat 6: I The King I folded before Flop (didn't bet)
Seat 7: nickreason17 (button) folded before Flop (didn't bet)
Seat 8: roadster683 (small blind) folded on the Flop
Seat 9: lydia12345 (big blind) folded before Flop





PokerStars Hand #153501558090:  Hold'em No Limit ($1/$2 USD) - 2016/05/18 20:17:17 CET [2016/05/18 14:17:17 ET]
Table 'Chlosinde' 9-max Seat #9 is the button
Seat 1: ersevi6 ($158 in chips) 
Seat 2: lydia12345 ($200 in chips) 
Seat 3: matiko09 ($211.73 in chips) 
Seat 4: FREDY BULLIT ($230.85 in chips) 
Seat 5: tepi_guy ($869.16 in chips) 
Seat 7: donald0404 ($200 in chips) 
Seat 8: sanducu_eu ($212.03 in chips) 
Seat 9: Tey113 ($601.03 in chips) 
ersevi6: posts small blind $1
lydia12345: posts big blind $2
tipner: sits out 
*** HOLE CARDS ***
Dealt to matiko09 [7d 7s]
matiko09: raises $3 to $5
FREDY BULLIT: folds 
tepi_guy: folds 
donald0404: folds 
sanducu_eu: folds 
Tey113: calls $5
ersevi6: calls $4
lydia12345: folds 
*** FLOP *** [6c Kd Ks]
ersevi6: checks 
matiko09: bets $8.39
Tey113: calls $8.39
ersevi6: folds 
*** TURN *** [6c Kd Ks] [5d]
matiko09: bets $16
Tey113: calls $16
*** RIVER *** [6c Kd Ks 5d] [6h]
matiko09: checks 
Tey113: checks 
*** SHOW DOWN ***
matiko09: shows [7d 7s] (two pair, Kings and Sevens)
Tey113: shows [Th Td] (two pair, Kings and Tens)
Tey113 collected $63.03 from pot
*** SUMMARY ***
Total pot $65.78 | Rake $2.75 
Board [6c Kd Ks 5d 6h]
Seat 1: ersevi6 (small blind) folded on the Flop
Seat 2: lydia12345 (big blind) folded before Flop
Seat 3: matiko09 showed [7d 7s] and lost with two pair, Kings and Sevens
Seat 4: FREDY BULLIT folded before Flop (didn't bet)
Seat 5: tepi_guy folded before Flop (didn't bet)
Seat 7: donald0404 folded before Flop (didn't bet)
Seat 8: sanducu_eu folded before Flop (didn't bet)
Seat 9: Tey113 (button) showed [Th Td] and won ($63.03) with two pair, Kings and Tens





PokerStars Hand #153501558371:  Hold'em No Limit ($0.50/$1.00 USD) - 2016/05/18 20:17:17 CET [2016/05/18 14:17:17 ET]
Table 'Saiph II' 9-max Seat #6 is the button
Seat 1: MAARKKKK ($68.18 in chips) 
Seat 2: matiko09 ($137.24 in chips) 
Seat 3: lydia12345 ($173.12 in chips) 
Seat 4: deadkiller1 ($100 in chips) 
Seat 5: cobrik23 ($71.48 in chips) 
Seat 6: LadyMaCe86 ($100 in chips) 
Seat 7: nickreason17 ($104.20 in chips) 
Seat 9: HITYESCA ($100 in chips) 
nickreason17: posts small blind $0.50
sanr23: is sitting out 
HITYESCA: posts big blind $1
*** HOLE CARDS ***
Dealt to matiko09 [Tc Ks]
MAARKKKK: folds 
matiko09: folds 
lydia12345: raises $2 to $3
deadkiller1: folds 
cobrik23: folds 
LadyMaCe86: folds 
nickreason17: folds 
sanr23 leaves the table
HITYESCA: calls $2
*** FLOP *** [2d Kc 3h]
HITYESCA: checks 
lydia12345: checks 
*** TURN *** [2d Kc 3h] [3c]
HITYESCA: checks 
lydia12345: bets $4.20
HITYESCA: folds 
Uncalled bet ($4.20) returned to lydia12345
lydia12345 collected $6.18 from pot
*** SUMMARY ***
Total pot $6.50 | Rake $0.32 
Board [2d Kc 3h 3c]
Seat 1: MAARKKKK folded before Flop (didn't bet)
Seat 2: matiko09 folded before Flop (didn't bet)
Seat 3: lydia12345 collected ($6.18)
Seat 4: deadkiller1 folded before Flop (didn't bet)
Seat 5: cobrik23 folded before Flop (didn't bet)
Seat 6: LadyMaCe86 (button) folded before Flop (didn't bet)
Seat 7: nickreason17 (small blind) folded before Flop
Seat 9: HITYESCA (big blind) folded on the Turn





PokerStars Hand #153501561338:  Hold'em No Limit ($0.50/$1.00 USD) - 2016/05/18 20:17:21 CET [2016/05/18 14:17:21 ET]
Table 'Erida II' 9-max Seat #6 is the button
Seat 2: cobrik23 ($100 in chips) 
Seat 3: Kelvin sai ($71.78 in chips) 
Seat 5: Moszes360 ($101 in chips) 
Seat 6: deadkiller1 ($133.92 in chips) 
Seat 7: matiko09 ($100 in chips) 
Seat 8: t4ppz ($80 in chips) 
Seat 9: sanr23 ($103.90 in chips) 
matiko09: posts small blind $0.50
t4ppz: posts big blind $1
vanilica: sits out 
*** HOLE CARDS ***
Dealt to matiko09 [Th 8s]
sanr23: folds 
cobrik23: folds 
Kelvin sai: raises $1 to $2
Moszes360: folds 
deadkiller1: folds 
matiko09: folds 
t4ppz: calls $1
*** FLOP *** [As Jd 4s]
t4ppz: checks 
Kelvin sai: bets $2.14
t4ppz: folds 
Uncalled bet ($2.14) returned to Kelvin sai
Kelvin sai collected $4.28 from pot
Kelvin sai: doesn't show hand 
*** SUMMARY ***
Total pot $4.50 | Rake $0.22 
Board [As Jd 4s]
Seat 2: cobrik23 folded before Flop (didn't bet)
Seat 3: Kelvin sai collected ($4.28)
Seat 5: Moszes360 folded before Flop (didn't bet)
Seat 6: deadkiller1 (button) folded before Flop (didn't bet)
Seat 7: matiko09 (small blind) folded before Flop
Seat 8: t4ppz (big blind) folded on the Flop
Seat 9: sanr23 folded before Flop (didn't bet)





PokerStars Hand #153501563522:  Hold'em No Limit ($0.50/$1.00 USD) - 2016/05/18 20:17:23 CET [2016/05/18 14:17:23 ET]
Table 'Kayala' 9-max Seat #1 is the button
Seat 1: deadkiller1 ($109.40 in chips) 
Seat 2: Oelie7 ($92.12 in chips) 
Seat 3: matiko09 ($100 in chips) 
Seat 4: HITYESCA ($100 in chips) 
Seat 5: tipner ($101.50 in chips) 
Seat 6: lydia12345 ($132.38 in chips) 
Seat 7: nickreason17 ($106.88 in chips) 
Seat 9: altunaelisa ($39.97 in chips) 
Oelie7: posts small blind $0.50
matiko09: posts big blind $1
cobrik23: sits out 
*** HOLE CARDS ***
Dealt to matiko09 [Ah 5d]
HITYESCA: raises $2 to $3
tipner: folds 
lydia12345: calls $3
nickreason17: folds 
altunaelisa: calls $3
deadkiller1: folds 
Oelie7: calls $2.50
matiko09: folds 
*** FLOP *** [2c Jc Ac]
Oelie7: checks 
HITYESCA: checks 
lydia12345: checks 
altunaelisa: checks 
*** TURN *** [2c Jc Ac] [Kd]
Oelie7: checks 
HITYESCA: checks 
lydia12345: checks 
altunaelisa: checks 
*** RIVER *** [2c Jc Ac Kd] [Ad]
Oelie7: checks 
HITYESCA: checks 
lydia12345: checks 
altunaelisa: checks 
*** SHOW DOWN ***
Oelie7: shows [Jd 9c] (two pair, Aces and Jacks)
HITYESCA: mucks hand 
lydia12345: mucks hand 
altunaelisa: shows [Jh 9d] (two pair, Aces and Jacks)
Oelie7 collected $6.18 from pot
altunaelisa collected $6.17 from pot
*** SUMMARY ***
Total pot $13 | Rake $0.65 
Board [2c Jc Ac Kd Ad]
Seat 1: deadkiller1 (button) folded before Flop (didn't bet)
Seat 2: Oelie7 (small blind) showed [Jd 9c] and won ($6.18) with two pair, Aces and Jacks
Seat 3: matiko09 (big blind) folded before Flop
Seat 4: HITYESCA mucked [8h 9h]
Seat 5: tipner folded before Flop (didn't bet)
Seat 6: lydia12345 mucked [Tc Th]
Seat 7: nickreason17 folded before Flop (didn't bet)
Seat 9: altunaelisa showed [Jh 9d] and won ($6.17) with two pair, Aces and Jacks





PokerStars Hand #153501563892:  Hold'em No Limit ($0.50/$1.00 USD) - 2016/05/18 20:17:24 CET [2016/05/18 14:17:24 ET]
Table 'Tatjana III' 9-max Seat #8 is the button
Seat 1: cobrik23 ($59.42 in chips) 
Seat 2: HITYESCA ($125.32 in chips) 
Seat 3: matiko09 ($173.90 in chips) 
Seat 4: lydia12345 ($118.40 in chips) 
Seat 5: deadkiller1 ($103 in chips) 
Seat 6: nickreason17 ($133.12 in chips) 
Seat 7: rene1984tsv ($173.83 in chips) 
Seat 8: JACQUILF ($100 in chips) 
Seat 9: Moszes360 ($100.50 in chips) 
Moszes360: posts small blind $0.50
cobrik23: posts big blind $1
*** HOLE CARDS ***
Dealt to matiko09 [2h 7h]
HITYESCA: folds 
matiko09: folds 
lydia12345: folds 
deadkiller1: folds 
nickreason17: raises $1.50 to $2.50
rene1984tsv: folds 
JACQUILF: folds 
Moszes360: calls $2
cobrik23: raises $8.50 to $11
nickreason17: folds 
Moszes360: raises $89.50 to $100.50 and is all-in
cobrik23: folds 
Uncalled bet ($89.50) returned to Moszes360
Moszes360 collected $24.50 from pot
Moszes360: doesn't show hand 
*** SUMMARY ***
Total pot $24.50 | Rake $0 
Seat 1: cobrik23 (big blind) folded before Flop
Seat 2: HITYESCA folded before Flop (didn't bet)
Seat 3: matiko09 folded before Flop (didn't bet)
Seat 4: lydia12345 folded before Flop (didn't bet)
Seat 5: deadkiller1 folded before Flop (didn't bet)
Seat 6: nickreason17 folded before Flop
Seat 7: rene1984tsv folded before Flop (didn't bet)
Seat 8: JACQUILF (button) folded before Flop (didn't bet)
Seat 9: Moszes360 (small blind) collected ($24.50)





PokerStars Hand #153501572219:  Hold'em No Limit ($0.50/$1.00 USD) - 2016/05/18 20:17:33 CET [2016/05/18 14:17:33 ET]
Table 'Pandora' 9-max Seat #1 is the button
Seat 1: deadkiller1 ($100 in chips) 
Seat 2: fack_vi ($73.62 in chips) 
Seat 3: tipner ($100 in chips) 
Seat 4: mooose100 ($90.04 in chips) 
Seat 5: Mr Seelen ($76.50 in chips) 
Seat 6: Mulgraver25 ($64.63 in chips) 
Seat 7: lydia12345 ($108.82 in chips) 
Seat 8: matiko09 ($100 in chips) 
Seat 9: oscarleon ($115.48 in chips) 
fack_vi: posts small blind $0.50
tipner: posts big blind $1
*** HOLE CARDS ***
Dealt to matiko09 [7d 9s]
mooose100: folds 
Mr Seelen: folds 
Mulgraver25: folds 
lydia12345: folds 
matiko09: folds 
oscarleon: folds 
deadkiller1: raises $1.50 to $2.50
fack_vi: raises $4 to $6.50
tipner: folds 
deadkiller1: folds 
Uncalled bet ($4) returned to fack_vi
fack_vi collected $6 from pot
fack_vi: doesn't show hand 
*** SUMMARY ***
Total pot $6 | Rake $0 
Seat 1: deadkiller1 (button) folded before Flop
Seat 2: fack_vi (small blind) collected ($6)
Seat 3: tipner (big blind) folded before Flop
Seat 4: mooose100 folded before Flop (didn't bet)
Seat 5: Mr Seelen folded before Flop (didn't bet)
Seat 6: Mulgraver25 folded before Flop (didn't bet)
Seat 7: lydia12345 folded before Flop (didn't bet)
Seat 8: matiko09 folded before Flop (didn't bet)
Seat 9: oscarleon folded before Flop (didn't bet)





PokerStars Hand #153501585403:  Hold'em No Limit ($1/$2 USD) - 2016/05/18 20:17:49 CET [2016/05/18 14:17:49 ET]
Table 'Letaba' 9-max Seat #1 is the button
Seat 1: FREDY BULLIT ($210.25 in chips) 
Seat 2: staruk669 ($108.29 in chips) 
Seat 3: ersevi6 ($214.04 in chips) 
Seat 4: matiko09 ($200 in chips) 
Seat 6: donald0404 ($217.49 in chips) 
Seat 9: tepi_guy ($236.75 in chips) 
staruk669: posts small blind $1
ersevi6: posts big blind $2
tipner: sits out 
uonlylive1ce: sits out 
*** HOLE CARDS ***
Dealt to matiko09 [Qh 9h]
uonlylive1ce leaves the table
matiko09: folds 
lydia12345 joins the table at seat #8 
donald0404: raises $3 to $5
tepi_guy: folds 
FREDY BULLIT: calls $5
staruk669: calls $4
ersevi6: folds 
*** FLOP *** [6c Kh Ah]
staruk669: checks 
donald0404: checks 
FREDY BULLIT: bets $5.33
staruk669: calls $5.33
donald0404: folds 
*** TURN *** [6c Kh Ah] [5s]
staruk669: checks 
FREDY BULLIT: bets $19.71
staruk669: folds 
Uncalled bet ($19.71) returned to FREDY BULLIT
FREDY BULLIT collected $26.28 from pot
FREDY BULLIT: doesn't show hand 
*** SUMMARY ***
Total pot $27.66 | Rake $1.38 
Board [6c Kh Ah 5s]
Seat 1: FREDY BULLIT (button) collected ($26.28)
Seat 2: staruk669 (small blind) folded on the Turn
Seat 3: ersevi6 (big blind) folded before Flop
Seat 4: matiko09 folded before Flop (didn't bet)
Seat 6: donald0404 folded on the Flop
Seat 9: tepi_guy folded before Flop (didn't bet)





PokerStars Hand #153501585692:  Hold'em No Limit ($0.50/$1.00 USD) - 2016/05/18 20:17:49 CET [2016/05/18 14:17:49 ET]
Table 'Abetti II' 9-max Seat #8 is the button
Seat 1: matiko09 ($127.08 in chips) 
Seat 2: Bimaxa ($128.84 in chips) 
Seat 3: cobrik23 ($257.87 in chips) 
Seat 4: ipashutapkom ($42.98 in chips) 
Seat 6: I The King I ($156.39 in chips) 
Seat 7: nickreason17 ($142.22 in chips) 
Seat 8: roadster683 ($52.44 in chips) 
Seat 9: lydia12345 ($100 in chips) 
lydia12345: posts small blind $0.50
matiko09: posts big blind $1
*** HOLE CARDS ***
Dealt to matiko09 [Ah Ad]
Bimaxa: folds 
cobrik23: raises $3 to $4
ipashutapkom: folds 
I The King I: folds 
nickreason17: folds 
roadster683 is disconnected 
roadster683 is connected 
roadster683: folds 
lydia12345: folds 
matiko09: raises $9 to $13
cobrik23 has timed out
cobrik23: folds 
Uncalled bet ($9) returned to matiko09
matiko09 collected $8.50 from pot
matiko09: doesn't show hand 
*** SUMMARY ***
Total pot $8.50 | Rake $0 
Seat 1: matiko09 (big blind) collected ($8.50)
Seat 2: Bimaxa folded before Flop (didn't bet)
Seat 3: cobrik23 folded before Flop
Seat 4: ipashutapkom folded before Flop (didn't bet)
Seat 6: I The King I folded before Flop (didn't bet)
Seat 7: nickreason17 folded before Flop (didn't bet)
Seat 8: roadster683 (button) folded before Flop (didn't bet)
Seat 9: lydia12345 (small blind) folded before Flop





PokerStars Hand #153501596790:  Hold'em No Limit ($0.50/$1.00 USD) - 2016/05/18 20:18:02 CET [2016/05/18 14:18:02 ET]
Table 'Erida II' 9-max Seat #7 is the button
Seat 2: cobrik23 ($100 in chips) 
Seat 3: Kelvin sai ($74.06 in chips) 
Seat 5: Moszes360 ($101 in chips) 
Seat 6: deadkiller1 ($133.92 in chips) 
Seat 7: matiko09 ($100 in chips) 
Seat 8: t4ppz ($78 in chips) 
Seat 9: sanr23 ($103.90 in chips) 
t4ppz: posts small blind $0.50
sanr23: posts big blind $1
vanilica: sits out 
*** HOLE CARDS ***
Dealt to matiko09 [2s Ad]
cobrik23: folds 
Kelvin sai: raises $1 to $2
Moszes360: folds 
deadkiller1: folds 
matiko09: folds 
t4ppz: folds 
sanr23: folds 
Uncalled bet ($1) returned to Kelvin sai
Kelvin sai collected $2.50 from pot
Kelvin sai: doesn't show hand 
*** SUMMARY ***
Total pot $2.50 | Rake $0 
Seat 2: cobrik23 folded before Flop (didn't bet)
Seat 3: Kelvin sai collected ($2.50)
Seat 5: Moszes360 folded before Flop (didn't bet)
Seat 6: deadkiller1 folded before Flop (didn't bet)
Seat 7: matiko09 (button) folded before Flop (didn't bet)
Seat 8: t4ppz (small blind) folded before Flop
Seat 9: sanr23 (big blind) folded before Flop





PokerStars Hand #153501607808:  Hold'em No Limit ($0.50/$1.00 USD) - 2016/05/18 20:18:14 CET [2016/05/18 14:18:14 ET]
Table 'Saiph II' 9-max Seat #7 is the button
Seat 1: MAARKKKK ($68.18 in chips) 
Seat 2: matiko09 ($137.24 in chips) 
Seat 3: lydia12345 ($176.30 in chips) 
Seat 4: deadkiller1 ($100 in chips) 
Seat 5: cobrik23 ($71.48 in chips) 
Seat 6: LadyMaCe86 ($100 in chips) 
Seat 7: nickreason17 ($103.70 in chips) 
Seat 9: HITYESCA ($100 in chips) 
HITYESCA: posts small blind $0.50
MAARKKKK: posts big blind $1
*** HOLE CARDS ***
Dealt to matiko09 [As Qh]
matiko09: raises $2 to $3
lydia12345: folds 
deadkiller1: folds 
vanilica joins the table at seat #8 
cobrik23 has timed out
cobrik23: folds 
LadyMaCe86: folds 
nickreason17: raises $6 to $9
HITYESCA: folds 
MAARKKKK: folds 
matiko09: raises $10 to $19
nickreason17: calls $10
*** FLOP *** [6d Tc Js]
matiko09: bets $20
nickreason17: raises $20 to $40
matiko09: folds 
Uncalled bet ($20) returned to nickreason17
nickreason17 collected $77 from pot
*** SUMMARY ***
Total pot $79.50 | Rake $2.50 
Board [6d Tc Js]
Seat 1: MAARKKKK (big blind) folded before Flop
Seat 2: matiko09 folded on the Flop
Seat 3: lydia12345 folded before Flop (didn't bet)
Seat 4: deadkiller1 folded before Flop (didn't bet)
Seat 5: cobrik23 folded before Flop (didn't bet)
Seat 6: LadyMaCe86 folded before Flop (didn't bet)
Seat 7: nickreason17 (button) collected ($77)
Seat 9: HITYESCA (small blind) folded before Flop





PokerStars Hand #153501614672:  Hold'em No Limit ($0.50/$1.00 USD) - 2016/05/18 20:18:22 CET [2016/05/18 14:18:22 ET]
Table 'Suevia' 9-max Seat #7 is the button
Seat 1: Bimaxa ($100.15 in chips) 
Seat 3: matiko09 ($100 in chips) 
Seat 4: HITYESCA ($100 in chips) 
Seat 5: bello1310 ($72.27 in chips) 
Seat 6: torkkdnm ($139.72 in chips) 
Seat 7: cobrik23 ($72.80 in chips) 
Seat 8: ama58 ($43.45 in chips) 
Seat 9: oscarleon ($111.64 in chips) 
ama58: posts small blind $0.50
oscarleon: posts big blind $1
deadkiller1: sits out 
*** HOLE CARDS ***
Dealt to matiko09 [Th Qd]
Bimaxa: folds 
matiko09: folds 
HITYESCA: folds 
bello1310: raises $2 to $3
torkkdnm: folds 
cobrik23: folds 
ama58: folds 
oscarleon: folds 
Uncalled bet ($2) returned to bello1310
bello1310 collected $2.50 from pot
bello1310: doesn't show hand 
*** SUMMARY ***
Total pot $2.50 | Rake $0 
Seat 1: Bimaxa folded before Flop (didn't bet)
Seat 3: matiko09 folded before Flop (didn't bet)
Seat 4: HITYESCA folded before Flop (didn't bet)
Seat 5: bello1310 collected ($2.50)
Seat 6: torkkdnm folded before Flop (didn't bet)
Seat 7: cobrik23 (button) folded before Flop (didn't bet)
Seat 8: ama58 (small blind) folded before Flop
Seat 9: oscarleon (big blind) folded before Flop





PokerStars Hand #153501615458:  Hold'em No Limit ($0.50/$1.00 USD) - 2016/05/18 20:18:23 CET [2016/05/18 14:18:23 ET]
Table 'Tatjana III' 9-max Seat #9 is the button
Seat 1: cobrik23 ($48.42 in chips) 
Seat 2: HITYESCA ($125.32 in chips) 
Seat 3: matiko09 ($173.90 in chips) 
Seat 4: lydia12345 ($118.40 in chips) 
Seat 5: deadkiller1 ($103 in chips) 
Seat 6: nickreason17 ($130.62 in chips) 
Seat 7: rene1984tsv ($173.83 in chips) 
Seat 8: JACQUILF ($100 in chips) 
Seat 9: Moszes360 ($114 in chips) 
cobrik23: posts small blind $0.50
HITYESCA: posts big blind $1
*** HOLE CARDS ***
Dealt to matiko09 [6c Ts]
matiko09: folds 
lydia12345: folds 
deadkiller1: folds 
nickreason17: folds 
rene1984tsv: folds 
JACQUILF: raises $1.50 to $2.50
Moszes360: folds 
cobrik23: raises $5.50 to $8
HITYESCA: folds 
JACQUILF: raises $8 to $16
cobrik23: folds 
Uncalled bet ($8) returned to JACQUILF
JACQUILF collected $17 from pot
JACQUILF: doesn't show hand 
*** SUMMARY ***
Total pot $17 | Rake $0 
Seat 1: cobrik23 (small blind) folded before Flop
Seat 2: HITYESCA (big blind) folded before Flop
Seat 3: matiko09 folded before Flop (didn't bet)
Seat 4: lydia12345 folded before Flop (didn't bet)
Seat 5: deadkiller1 folded before Flop (didn't bet)
Seat 6: nickreason17 folded before Flop (didn't bet)
Seat 7: rene1984tsv folded before Flop (didn't bet)
Seat 8: JACQUILF collected ($17)
Seat 9: Moszes360 (button) folded before Flop (didn't bet)





PokerStars Hand #153501622984:  Hold'em No Limit ($0.50/$1.00 USD) - 2016/05/18 20:18:32 CET [2016/05/18 14:18:32 ET]
Table 'Pandora' 9-max Seat #2 is the button
Seat 1: deadkiller1 ($100 in chips) 
Seat 2: fack_vi ($77.12 in chips) 
Seat 3: tipner ($100 in chips) 
Seat 4: mooose100 ($90.04 in chips) 
Seat 5: Mr Seelen ($76.50 in chips) 
Seat 6: Mulgraver25 ($64.63 in chips) 
Seat 7: lydia12345 ($108.82 in chips) 
Seat 8: matiko09 ($100 in chips) 
Seat 9: oscarleon ($115.48 in chips) 
tipner: posts small blind $0.50
mooose100: posts big blind $1
*** HOLE CARDS ***
Dealt to matiko09 [6h 3h]
Mr Seelen: calls $1
Mulgraver25: raises $5 to $6
lydia12345: folds 
matiko09: folds 
oscarleon: folds 
deadkiller1: folds 
fack_vi: folds 
tipner: folds 
mooose100: folds 
Mr Seelen: folds 
Uncalled bet ($5) returned to Mulgraver25
Mulgraver25 collected $3.50 from pot
Mulgraver25: doesn't show hand 
*** SUMMARY ***
Total pot $3.50 | Rake $0 
Seat 1: deadkiller1 folded before Flop (didn't bet)
Seat 2: fack_vi (button) folded before Flop (didn't bet)
Seat 3: tipner (small blind) folded before Flop
Seat 4: mooose100 (big blind) folded before Flop
Seat 5: Mr Seelen folded before Flop
Seat 6: Mulgraver25 collected ($3.50)
Seat 7: lydia12345 folded before Flop (didn't bet)
Seat 8: matiko09 folded before Flop (didn't bet)
Seat 9: oscarleon folded before Flop (didn't bet)





PokerStars Hand #153501624114:  Hold'em No Limit ($1/$2 USD) - 2016/05/18 20:18:33 CET [2016/05/18 14:18:33 ET]
Table 'Chlosinde' 9-max Seat #1 is the button
Seat 1: ersevi6 ($153 in chips) 
Seat 2: lydia12345 ($200 in chips) 
Seat 3: matiko09 ($200 in chips) 
Seat 4: FREDY BULLIT ($230.85 in chips) 
Seat 5: tepi_guy ($869.16 in chips) 
Seat 7: donald0404 ($200 in chips) 
Seat 8: sanducu_eu ($212.03 in chips) 
Seat 9: Tey113 ($634.67 in chips) 
lydia12345: posts small blind $1
matiko09: posts big blind $2
tipner: sits out 
*** HOLE CARDS ***
Dealt to matiko09 [Ac 8d]
FREDY BULLIT: folds 
tepi_guy has timed out
tepi_guy: folds 
donald0404: folds 
sanducu_eu: folds 
Tey113: folds 
ersevi6: folds 
lydia12345: raises $4 to $6
matiko09: calls $4
*** FLOP *** [Jc 2h Qc]
lydia12345: checks 
matiko09: checks 
*** TURN *** [Jc 2h Qc] [9h]
lydia12345: bets $7.75
matiko09: folds 
Uncalled bet ($7.75) returned to lydia12345
lydia12345 collected $11.40 from pot
*** SUMMARY ***
Total pot $12 | Rake $0.60 
Board [Jc 2h Qc 9h]
Seat 1: ersevi6 (button) folded before Flop (didn't bet)
Seat 2: lydia12345 (small blind) collected ($11.40)
Seat 3: matiko09 (big blind) folded on the Turn
Seat 4: FREDY BULLIT folded before Flop (didn't bet)
Seat 5: tepi_guy folded before Flop (didn't bet)
Seat 7: donald0404 folded before Flop (didn't bet)
Seat 8: sanducu_eu folded before Flop (didn't bet)
Seat 9: Tey113 folded before Flop (didn't bet)





PokerStars Hand #153501638615:  Hold'em No Limit (€0.50/€1.00 EUR) - 2016/05/18 20:18:50 CET [2016/05/18 14:18:50 ET]
Table 'Pallas II' 9-max Seat #1 is the button
Seat 1: deadkiller1 (€100 in chips) 
Seat 2: matiko09 (€204.49 in chips) 
Seat 3: JACQUILF (€100 in chips) 
Seat 4: torkkdnm (€142.68 in chips) 
Seat 5: cobrik23 (€69.24 in chips) 
Seat 6: HITYESCA (€124.75 in chips) 
Seat 8: lydia12345 (€100 in chips) 
Seat 9: stijner1986 (€144.51 in chips) 
matiko09: posts small blind €0.50
JACQUILF: posts big blind €1
*** HOLE CARDS ***
Dealt to matiko09 [4c 6s]
torkkdnm: folds 
cobrik23: folds 
HITYESCA: folds 
lydia12345: folds 
stijner1986: calls €1
deadkiller1: folds 
matiko09: folds 
JACQUILF: checks 
*** FLOP *** [5s Kd 9c]
JACQUILF: checks 
stijner1986: checks 
*** TURN *** [5s Kd 9c] [Ad]
JACQUILF: bets €1.42
stijner1986: folds 
Uncalled bet (€1.42) returned to JACQUILF
JACQUILF collected €2.38 from pot
JACQUILF: doesn't show hand 
*** SUMMARY ***
Total pot €2.50 | Rake €0.12 
Board [5s Kd 9c Ad]
Seat 1: deadkiller1 (button) folded before Flop (didn't bet)
Seat 2: matiko09 (small blind) folded before Flop
Seat 3: JACQUILF (big blind) collected (€2.38)
Seat 4: torkkdnm folded before Flop (didn't bet)
Seat 5: cobrik23 folded before Flop (didn't bet)
Seat 6: HITYESCA folded before Flop (didn't bet)
Seat 8: lydia12345 folded before Flop (didn't bet)
Seat 9: stijner1986 folded on the Turn





PokerStars Hand #153501639030:  Hold'em No Limit ($0.50/$1.00 USD) - 2016/05/18 20:18:50 CET [2016/05/18 14:18:50 ET]
Table 'Erida II' 9-max Seat #8 is the button
Seat 1: vanilica ($100 in chips) 
Seat 2: cobrik23 ($100 in chips) 
Seat 3: Kelvin sai ($75.56 in chips) 
Seat 5: Moszes360 ($101 in chips) 
Seat 6: deadkiller1 ($133.92 in chips) 
Seat 7: matiko09 ($100 in chips) 
Seat 8: t4ppz ($77.50 in chips) 
Seat 9: sanr23 ($102.90 in chips) 
sanr23: posts small blind $0.50
vanilica: posts big blind $1
*** HOLE CARDS ***
Dealt to matiko09 [Qc 4d]
cobrik23: folds 
Kelvin sai: raises $2 to $3
Moszes360: folds 
deadkiller1: folds 
matiko09: folds 
t4ppz: folds 
t4ppz leaves the table
sanr23: folds 
rate8 joins the table at seat #8 
vanilica: folds 
Uncalled bet ($2) returned to Kelvin sai
Kelvin sai collected $2.50 from pot
Kelvin sai: doesn't show hand 
*** SUMMARY ***
Total pot $2.50 | Rake $0 
Seat 1: vanilica (big blind) folded before Flop
Seat 2: cobrik23 folded before Flop (didn't bet)
Seat 3: Kelvin sai collected ($2.50)
Seat 5: Moszes360 folded before Flop (didn't bet)
Seat 6: deadkiller1 folded before Flop (didn't bet)
Seat 7: matiko09 folded before Flop (didn't bet)
Seat 8: t4ppz (button) folded before Flop (didn't bet)
Seat 9: sanr23 (small blind) folded before Flop





PokerStars Hand #153501643742:  Hold'em No Limit ($0.50/$1.00 USD) - 2016/05/18 20:18:56 CET [2016/05/18 14:18:56 ET]
Table 'Kayala' 9-max Seat #2 is the button
Seat 1: deadkiller1 ($109.40 in chips) 
Seat 2: Oelie7 ($95.30 in chips) 
Seat 3: matiko09 ($100 in chips) 
Seat 4: HITYESCA ($100 in chips) 
Seat 5: tipner ($101.50 in chips) 
Seat 6: lydia12345 ($129.38 in chips) 
Seat 7: nickreason17 ($106.88 in chips) 
Seat 9: altunaelisa ($43.14 in chips) 
matiko09: posts small blind $0.50
HITYESCA: posts big blind $1
cobrik23: sits out 
*** HOLE CARDS ***
Dealt to matiko09 [6c 8h]
tipner: folds 
lydia12345: raises $2 to $3
nickreason17: folds 
altunaelisa: calls $3
deadkiller1: folds 
Oelie7: folds 
matiko09: folds 
HITYESCA: folds 
*** FLOP *** [9s 2c 5c]
lydia12345: bets $4.84
altunaelisa: calls $4.84
*** TURN *** [9s 2c 5c] [3c]
lydia12345: bets $11.10
altunaelisa: folds 
Uncalled bet ($11.10) returned to lydia12345
lydia12345 collected $16.32 from pot
*** SUMMARY ***
Total pot $17.18 | Rake $0.86 
Board [9s 2c 5c 3c]
Seat 1: deadkiller1 folded before Flop (didn't bet)
Seat 2: Oelie7 (button) folded before Flop (didn't bet)
Seat 3: matiko09 (small blind) folded before Flop
Seat 4: HITYESCA (big blind) folded before Flop
Seat 5: tipner folded before Flop (didn't bet)
Seat 6: lydia12345 collected ($16.32)
Seat 7: nickreason17 folded before Flop (didn't bet)
Seat 9: altunaelisa folded on the Turn





PokerStars Hand #153501648724:  Hold'em No Limit ($1/$2 USD) - 2016/05/18 20:19:01 CET [2016/05/18 14:19:01 ET]
Table 'Letaba' 9-max Seat #2 is the button
Seat 1: FREDY BULLIT ($226.20 in chips) 
Seat 2: staruk669 ($97.96 in chips) 
Seat 3: ersevi6 ($212.04 in chips) 
Seat 4: matiko09 ($200 in chips) 
Seat 6: donald0404 ($212.49 in chips) 
Seat 9: tepi_guy ($236.75 in chips) 
ersevi6: posts small blind $1
matiko09: posts big blind $2
tipner: sits out 
lydia12345: sits out 
*** HOLE CARDS ***
Dealt to matiko09 [2s 4c]
donald0404: folds 
tepi_guy: folds 
FREDY BULLIT: raises $3 to $5
staruk669: calls $5
ersevi6: folds 
matiko09: folds 
*** FLOP *** [Kh Qc 7h]
FREDY BULLIT: bets $6.17
staruk669: calls $6.17
*** TURN *** [Kh Qc 7h] [4h]
FREDY BULLIT: checks 
staruk669: checks 
*** RIVER *** [Kh Qc 7h 4h] [8c]
FREDY BULLIT: checks 
staruk669: checks 
*** SHOW DOWN ***
FREDY BULLIT: shows [Ad Jd] (high card Ace)
staruk669: shows [6h 7d] (a pair of Sevens)
staruk669 collected $24.07 from pot
*** SUMMARY ***
Total pot $25.34 | Rake $1.27 
Board [Kh Qc 7h 4h 8c]
Seat 1: FREDY BULLIT showed [Ad Jd] and lost with high card Ace
Seat 2: staruk669 (button) showed [6h 7d] and won ($24.07) with a pair of Sevens
Seat 3: ersevi6 (small blind) folded before Flop
Seat 4: matiko09 (big blind) folded before Flop
Seat 6: donald0404 folded before Flop (didn't bet)
Seat 9: tepi_guy folded before Flop (didn't bet)





PokerStars Hand #153501654741:  Hold'em No Limit ($0.50/$1.00 USD) - 2016/05/18 20:19:08 CET [2016/05/18 14:19:08 ET]
Table 'Suevia' 9-max Seat #8 is the button
Seat 1: Bimaxa ($100.15 in chips) 
Seat 3: matiko09 ($100 in chips) 
Seat 4: HITYESCA ($100 in chips) 
Seat 5: bello1310 ($73.77 in chips) 
Seat 6: torkkdnm ($139.72 in chips) 
Seat 7: cobrik23 ($72.80 in chips) 
Seat 8: ama58 ($42.95 in chips) 
Seat 9: oscarleon ($110.64 in chips) 
oscarleon: posts small blind $0.50
Bimaxa: posts big blind $1
deadkiller1: sits out 
*** HOLE CARDS ***
Dealt to matiko09 [2h Jc]
matiko09: folds 
HITYESCA: folds 
bello1310: calls $1
torkkdnm: folds 
cobrik23: folds 
ama58: folds 
oscarleon: raises $3 to $4
Bimaxa: folds 
bello1310: calls $3
*** FLOP *** [Qs Kh Tc]
oscarleon: bets $6
bello1310: calls $6
*** TURN *** [Qs Kh Tc] [Qc]
oscarleon: bets $14
bello1310: calls $14
*** RIVER *** [Qs Kh Tc Qc] [2s]
oscarleon: bets $33
bello1310: folds 
Uncalled bet ($33) returned to oscarleon
oscarleon collected $46.55 from pot
oscarleon: doesn't show hand 
*** SUMMARY ***
Total pot $49 | Rake $2.45 
Board [Qs Kh Tc Qc 2s]
Seat 1: Bimaxa (big blind) folded before Flop
Seat 3: matiko09 folded before Flop (didn't bet)
Seat 4: HITYESCA folded before Flop (didn't bet)
Seat 5: bello1310 folded on the River
Seat 6: torkkdnm folded before Flop (didn't bet)
Seat 7: cobrik23 folded before Flop (didn't bet)
Seat 8: ama58 (button) folded before Flop (didn't bet)
Seat 9: oscarleon (small blind) collected ($46.55)





PokerStars Hand #153501659923:  Hold'em No Limit ($0.50/$1.00 USD) - 2016/05/18 20:19:14 CET [2016/05/18 14:19:14 ET]
Table 'Abetti II' 9-max Seat #9 is the button
Seat 1: matiko09 ($131.58 in chips) 
Seat 2: Bimaxa ($128.84 in chips) 
Seat 4: ipashutapkom ($42.98 in chips) 
Seat 6: I The King I ($156.39 in chips) 
Seat 7: nickreason17 ($142.22 in chips) 
Seat 8: roadster683 ($52.44 in chips) 
Seat 9: lydia12345 ($100 in chips) 
matiko09: posts small blind $0.50
Bimaxa: posts big blind $1
*** HOLE CARDS ***
Dealt to matiko09 [3d Kd]
ipashutapkom: raises $1.26 to $2.26
I The King I: folds 
nickreason17: folds 
roadster683: folds 
lydia12345: calls $2.26
matiko09: folds 
Bimaxa: folds 
*** FLOP *** [3c Jc 8c]
ipashutapkom: bets $1.83
lydia12345: calls $1.83
*** TURN *** [3c Jc 8c] [4c]
ipashutapkom: checks 
lydia12345: bets $6.26
ipashutapkom: calls $6.26
*** RIVER *** [3c Jc 8c 4c] [3s]
ipashutapkom: checks 
lydia12345: bets $34
ipashutapkom: folds 
Uncalled bet ($34) returned to lydia12345
lydia12345 collected $21.09 from pot
*** SUMMARY ***
Total pot $22.20 | Rake $1.11 
Board [3c Jc 8c 4c 3s]
Seat 1: matiko09 (small blind) folded before Flop
Seat 2: Bimaxa (big blind) folded before Flop
Seat 4: ipashutapkom folded on the River
Seat 6: I The King I folded before Flop (didn't bet)
Seat 7: nickreason17 folded before Flop (didn't bet)
Seat 8: roadster683 folded before Flop (didn't bet)
Seat 9: lydia12345 (button) collected ($21.09)





PokerStars Hand #153501671369:  Hold'em No Limit ($0.50/$1.00 USD) - 2016/05/18 20:19:28 CET [2016/05/18 14:19:28 ET]
Table 'Pandora' 9-max Seat #3 is the button
Seat 1: deadkiller1 ($100 in chips) 
Seat 2: fack_vi ($77.12 in chips) 
Seat 3: tipner ($100 in chips) 
Seat 4: mooose100 ($89.04 in chips) 
Seat 5: Mr Seelen ($75.50 in chips) 
Seat 6: Mulgraver25 ($67.13 in chips) 
Seat 7: lydia12345 ($108.82 in chips) 
Seat 8: matiko09 ($100 in chips) 
Seat 9: oscarleon ($115.48 in chips) 
mooose100: posts small blind $0.50
Mr Seelen: posts big blind $1
*** HOLE CARDS ***
Dealt to matiko09 [8s Ts]
Mulgraver25: folds 
lydia12345: folds 
matiko09: folds 
oscarleon: folds 
deadkiller1: folds 
fack_vi: folds 
tipner: folds 
mooose100: calls $0.50
Mr Seelen has timed out
Mr Seelen: checks 
*** FLOP *** [7d 9c Qs]
mooose100: checks 
Mr Seelen has timed out
Mr Seelen: checks 
*** TURN *** [7d 9c Qs] [Kc]
mooose100: bets $1.90
Mr Seelen has timed out
Mr Seelen: folds 
Uncalled bet ($1.90) returned to mooose100
mooose100 collected $1.90 from pot
mooose100: doesn't show hand 
*** SUMMARY ***
Total pot $2 | Rake $0.10 
Board [7d 9c Qs Kc]
Seat 1: deadkiller1 folded before Flop (didn't bet)
Seat 2: fack_vi folded before Flop (didn't bet)
Seat 3: tipner (button) folded before Flop (didn't bet)
Seat 4: mooose100 (small blind) collected ($1.90)
Seat 5: Mr Seelen (big blind) folded on the Turn
Seat 6: Mulgraver25 folded before Flop (didn't bet)
Seat 7: lydia12345 folded before Flop (didn't bet)
Seat 8: matiko09 folded before Flop (didn't bet)
Seat 9: oscarleon folded before Flop (didn't bet)





PokerStars Hand #153501682072:  Hold'em No Limit ($0.50/$1.00 USD) - 2016/05/18 20:19:40 CET [2016/05/18 14:19:40 ET]
Table 'Kayala' 9-max Seat #3 is the button
Seat 1: deadkiller1 ($109.40 in chips) 
Seat 2: Oelie7 ($95.30 in chips) 
Seat 3: matiko09 ($100 in chips) 
Seat 4: HITYESCA ($100 in chips) 
Seat 5: tipner ($101.50 in chips) 
Seat 6: lydia12345 ($137.86 in chips) 
Seat 7: nickreason17 ($106.88 in chips) 
Seat 9: altunaelisa ($35.30 in chips) 
HITYESCA: posts small blind $0.50
tipner: posts big blind $1
cobrik23: sits out 
*** HOLE CARDS ***
Dealt to matiko09 [8d Qd]
lydia12345: raises $2 to $3
nickreason17: folds 
altunaelisa: folds 
deadkiller1: folds 
Oelie7: raises $2 to $5
matiko09: folds 
HITYESCA: folds 
tipner: folds 
lydia12345: calls $2
*** FLOP *** [6s Tc 4c]
lydia12345: checks 
Oelie7: bets $10.92
lydia12345: calls $10.92
*** TURN *** [6s Tc 4c] [3s]
lydia12345: checks 
Oelie7: bets $31.67
lydia12345: folds 
Uncalled bet ($31.67) returned to Oelie7
Oelie7 collected $31.67 from pot
Oelie7: doesn't show hand 
*** SUMMARY ***
Total pot $33.34 | Rake $1.67 
Board [6s Tc 4c 3s]
Seat 1: deadkiller1 folded before Flop (didn't bet)
Seat 2: Oelie7 collected ($31.67)
Seat 3: matiko09 (button) folded before Flop (didn't bet)
Seat 4: HITYESCA (small blind) folded before Flop
Seat 5: tipner (big blind) folded before Flop
Seat 6: lydia12345 folded on the Turn
Seat 7: nickreason17 folded before Flop (didn't bet)
Seat 9: altunaelisa folded before Flop (didn't bet)





PokerStars Hand #153501698207:  Hold'em No Limit ($1/$2 USD) - 2016/05/18 20:19:58 CET [2016/05/18 14:19:58 ET]
Table 'Letaba' 9-max Seat #3 is the button
Seat 1: FREDY BULLIT ($215.03 in chips) 
Seat 2: staruk669 ($110.86 in chips) 
Seat 3: ersevi6 ($211.04 in chips) 
Seat 4: matiko09 ($200 in chips) 
Seat 5: tipner ($200 in chips) 
Seat 6: donald0404 ($212.49 in chips) 
Seat 9: tepi_guy ($236.75 in chips) 
matiko09: posts small blind $1
tipner: posts big blind $2
lydia12345: sits out 
*** HOLE CARDS ***
Dealt to matiko09 [Ts 4s]
donald0404: raises $4 to $6
tepi_guy: calls $6
FREDY BULLIT: folds 
staruk669: calls $6
ersevi6: folds 
matiko09: folds 
tipner: folds 
*** FLOP *** [Ac 2s 9d]
donald0404: checks 
tepi_guy: checks 
staruk669: checks 
*** TURN *** [Ac 2s 9d] [9c]
donald0404: checks 
tepi_guy: checks 
staruk669: bets $10
donald0404: calls $10
tepi_guy: folds 
*** RIVER *** [Ac 2s 9d 9c] [6c]
donald0404: checks 
staruk669: checks 
*** SHOW DOWN ***
donald0404: shows [Kd Ks] (two pair, Kings and Nines)
staruk669: mucks hand 
donald0404 collected $38.95 from pot
*** SUMMARY ***
Total pot $41 | Rake $2.05 
Board [Ac 2s 9d 9c 6c]
Seat 1: FREDY BULLIT folded before Flop (didn't bet)
Seat 2: staruk669 mucked [Jd Qs]
Seat 3: ersevi6 (button) folded before Flop (didn't bet)
Seat 4: matiko09 (small blind) folded before Flop
Seat 5: tipner (big blind) folded before Flop
Seat 6: donald0404 showed [Kd Ks] and won ($38.95) with two pair, Kings and Nines
Seat 9: tepi_guy folded on the Turn





PokerStars Hand #153501699026:  Hold'em No Limit (€0.50/€1.00 EUR) - 2016/05/18 20:19:59 CET [2016/05/18 14:19:59 ET]
Table 'Pallas II' 9-max Seat #2 is the button
Seat 1: deadkiller1 (€100 in chips) 
Seat 2: matiko09 (€203.99 in chips) 
Seat 3: JACQUILF (€101.38 in chips) 
Seat 4: torkkdnm (€142.68 in chips) 
Seat 5: cobrik23 (€69.24 in chips) 
Seat 6: HITYESCA (€124.75 in chips) 
Seat 8: lydia12345 (€100 in chips) 
Seat 9: stijner1986 (€143.51 in chips) 
JACQUILF: posts small blind €0.50
torkkdnm: posts big blind €1
*** HOLE CARDS ***
Dealt to matiko09 [Jh 7c]
cobrik23: folds 
HITYESCA: folds 
lydia12345: folds 
stijner1986: folds 
deadkiller1: folds 
matiko09: folds 
JACQUILF: folds 
Uncalled bet (€0.50) returned to torkkdnm
torkkdnm collected €1 from pot
*** SUMMARY ***
Total pot €1 | Rake €0 
Seat 1: deadkiller1 folded before Flop (didn't bet)
Seat 2: matiko09 (button) folded before Flop (didn't bet)
Seat 3: JACQUILF (small blind) folded before Flop
Seat 4: torkkdnm (big blind) collected (€1)
Seat 5: cobrik23 folded before Flop (didn't bet)
Seat 6: HITYESCA folded before Flop (didn't bet)
Seat 8: lydia12345 folded before Flop (didn't bet)
Seat 9: stijner1986 folded before Flop (didn't bet)





PokerStars Hand #153501703987:  Hold'em No Limit ($0.50/$1.00 USD) - 2016/05/18 20:20:05 CET [2016/05/18 14:20:05 ET]
Table 'Tatjana III' 9-max Seat #1 is the button
Seat 1: cobrik23 ($40.42 in chips) 
Seat 2: HITYESCA ($124.32 in chips) 
Seat 3: matiko09 ($173.90 in chips) 
Seat 4: lydia12345 ($118.40 in chips) 
Seat 5: deadkiller1 ($103 in chips) 
Seat 6: nickreason17 ($130.62 in chips) 
Seat 7: rene1984tsv ($173.83 in chips) 
Seat 8: JACQUILF ($109 in chips) 
Seat 9: Moszes360 ($114 in chips) 
HITYESCA: posts small blind $0.50
matiko09: posts big blind $1
*** HOLE CARDS ***
Dealt to matiko09 [Ac Ad]
lydia12345: folds 
deadkiller1: folds 
nickreason17: folds 
rene1984tsv: calls $1
JACQUILF: folds 
Moszes360: raises $3 to $4
cobrik23: folds 
HITYESCA: folds 
matiko09: raises $8 to $12
rene1984tsv: folds 
Moszes360: calls $8
*** FLOP *** [6c 6h 7h]
matiko09: bets $16
Moszes360: folds 
Uncalled bet ($16) returned to matiko09
matiko09 collected $24.22 from pot
matiko09: doesn't show hand 
*** SUMMARY ***
Total pot $25.50 | Rake $1.28 
Board [6c 6h 7h]
Seat 1: cobrik23 (button) folded before Flop (didn't bet)
Seat 2: HITYESCA (small blind) folded before Flop
Seat 3: matiko09 (big blind) collected ($24.22)
Seat 4: lydia12345 folded before Flop (didn't bet)
Seat 5: deadkiller1 folded before Flop (didn't bet)
Seat 6: nickreason17 folded before Flop (didn't bet)
Seat 7: rene1984tsv folded before Flop
Seat 8: JACQUILF folded before Flop (didn't bet)
Seat 9: Moszes360 folded on the Flop





PokerStars Hand #153501708206:  Hold'em No Limit ($1/$2 USD) - 2016/05/18 20:20:10 CET [2016/05/18 14:20:10 ET]
Table 'Chlosinde' 9-max Seat #2 is the button
Seat 1: ersevi6 ($153 in chips) 
Seat 2: lydia12345 ($205.40 in chips) 
Seat 3: matiko09 ($200 in chips) 
Seat 4: FREDY BULLIT ($230.85 in chips) 
Seat 5: tepi_guy ($869.16 in chips) 
Seat 7: donald0404 ($200 in chips) 
Seat 8: sanducu_eu ($212.03 in chips) 
Seat 9: Tey113 ($634.67 in chips) 
matiko09: posts small blind $1
FREDY BULLIT: posts big blind $2
tipner: sits out 
*** HOLE CARDS ***
Dealt to matiko09 [3h Ad]
tepi_guy: folds 
donald0404: folds 
sanducu_eu: folds 
Tey113: folds 
ersevi6: folds 
lydia12345: raises $2 to $4
matiko09: folds 
FREDY BULLIT: raises $14 to $18
lydia12345: folds 
Uncalled bet ($14) returned to FREDY BULLIT
FREDY BULLIT collected $9 from pot
FREDY BULLIT: doesn't show hand 
*** SUMMARY ***
Total pot $9 | Rake $0 
Seat 1: ersevi6 folded before Flop (didn't bet)
Seat 2: lydia12345 (button) folded before Flop
Seat 3: matiko09 (small blind) folded before Flop
Seat 4: FREDY BULLIT (big blind) collected ($9)
Seat 5: tepi_guy folded before Flop (didn't bet)
Seat 7: donald0404 folded before Flop (didn't bet)
Seat 8: sanducu_eu folded before Flop (didn't bet)
Seat 9: Tey113 folded before Flop (didn't bet)





PokerStars Hand #153501713014:  Hold'em No Limit ($0.50/$1.00 USD) - 2016/05/18 20:20:16 CET [2016/05/18 14:20:16 ET]
Table 'Erida II' 9-max Seat #9 is the button
Seat 1: vanilica ($100 in chips) 
Seat 2: cobrik23 ($100 in chips) 
Seat 3: Kelvin sai ($77.06 in chips) 
Seat 5: Moszes360 ($101 in chips) 
Seat 6: deadkiller1 ($133.92 in chips) 
Seat 7: matiko09 ($100 in chips) 
Seat 9: sanr23 ($102.40 in chips) 
vanilica: posts small blind $0.50
cobrik23: posts big blind $1
*** HOLE CARDS ***
Dealt to matiko09 [Ad 8d]
Kelvin sai: folds 
Moszes360: raises $2 to $3
deadkiller1: folds 
matiko09: raises $7 to $10
sanr23: folds 
vanilica: folds 
cobrik23: folds 
Moszes360: folds 
Uncalled bet ($7) returned to matiko09
matiko09 collected $7.50 from pot
matiko09: doesn't show hand 
*** SUMMARY ***
Total pot $7.50 | Rake $0 
Seat 1: vanilica (small blind) folded before Flop
Seat 2: cobrik23 (big blind) folded before Flop
Seat 3: Kelvin sai folded before Flop (didn't bet)
Seat 5: Moszes360 folded before Flop
Seat 6: deadkiller1 folded before Flop (didn't bet)
Seat 7: matiko09 collected ($7.50)
Seat 9: sanr23 (button) folded before Flop (didn't bet)





PokerStars Hand #153501720801:  Hold'em No Limit (€0.50/€1.00 EUR) - 2016/05/18 20:20:24 CET [2016/05/18 14:20:24 ET]
Table 'Pallas II' 9-max Seat #3 is the button
Seat 1: deadkiller1 (€100 in chips) 
Seat 2: matiko09 (€203.99 in chips) 
Seat 3: JACQUILF (€100.88 in chips) 
Seat 4: torkkdnm (€143.18 in chips) 
Seat 5: cobrik23 (€69.24 in chips) 
Seat 6: HITYESCA (€124.75 in chips) 
Seat 8: lydia12345 (€100 in chips) 
Seat 9: stijner1986 (€143.51 in chips) 
torkkdnm: posts small blind €0.50
cobrik23: posts big blind €1
*** HOLE CARDS ***
Dealt to matiko09 [5c 6h]
HITYESCA: folds 
lydia12345: folds 
stijner1986: calls €1
deadkiller1: folds 
matiko09: folds 
JACQUILF: folds 
torkkdnm: raises €4 to €5
cobrik23: folds 
stijner1986: folds 
Uncalled bet (€4) returned to torkkdnm
torkkdnm collected €3 from pot
*** SUMMARY ***
Total pot €3 | Rake €0 
Seat 1: deadkiller1 folded before Flop (didn't bet)
Seat 2: matiko09 folded before Flop (didn't bet)
Seat 3: JACQUILF (button) folded before Flop (didn't bet)
Seat 4: torkkdnm (small blind) collected (€3)
Seat 5: cobrik23 (big blind) folded before Flop
Seat 6: HITYESCA folded before Flop (didn't bet)
Seat 8: lydia12345 folded before Flop (didn't bet)
Seat 9: stijner1986 folded before Flop





PokerStars Hand #153501737583:  Hold'em No Limit ($0.50/$1.00 USD) - 2016/05/18 20:20:43 CET [2016/05/18 14:20:43 ET]
Table 'Abetti II' 9-max Seat #1 is the button
Seat 1: matiko09 ($131.08 in chips) 
Seat 2: Bimaxa ($127.84 in chips) 
Seat 3: cobrik23 ($253.87 in chips) 
Seat 4: ipashutapkom ($40 in chips) 
Seat 6: I The King I ($156.39 in chips) 
Seat 7: nickreason17 ($142.22 in chips) 
Seat 8: roadster683 ($52.44 in chips) 
Seat 9: lydia12345 ($110.74 in chips) 
Bimaxa: posts small blind $0.50
cobrik23: posts big blind $1
*** HOLE CARDS ***
Dealt to matiko09 [Td Kc]
ipashutapkom: raises $1.26 to $2.26
I The King I: folds 
nickreason17: folds 
roadster683: raises $5.26 to $7.52
lydia12345: folds 
matiko09: folds 
Bimaxa: folds 
cobrik23: folds 
ipashutapkom: folds 
Uncalled bet ($5.26) returned to roadster683
roadster683 collected $6.02 from pot
roadster683: doesn't show hand 
*** SUMMARY ***
Total pot $6.02 | Rake $0 
Seat 1: matiko09 (button) folded before Flop (didn't bet)
Seat 2: Bimaxa (small blind) folded before Flop
Seat 3: cobrik23 (big blind) folded before Flop
Seat 4: ipashutapkom folded before Flop
Seat 6: I The King I folded before Flop (didn't bet)
Seat 7: nickreason17 folded before Flop (didn't bet)
Seat 8: roadster683 collected ($6.02)
Seat 9: lydia12345 folded before Flop (didn't bet)





PokerStars Hand #153501739622:  Hold'em No Limit ($0.50/$1.00 USD) - 2016/05/18 20:20:46 CET [2016/05/18 14:20:46 ET]
Table 'Suevia' 9-max Seat #9 is the button
Seat 1: Bimaxa ($100 in chips) 
Seat 2: deadkiller1 ($100 in chips) 
Seat 3: matiko09 ($100 in chips) 
Seat 4: HITYESCA ($100 in chips) 
Seat 5: bello1310 ($49.77 in chips) 
Seat 6: torkkdnm ($139.72 in chips) 
Seat 7: cobrik23 ($72.80 in chips) 
Seat 8: ama58 ($42.95 in chips) 
Seat 9: oscarleon ($133.19 in chips) 
Bimaxa: posts small blind $0.50
deadkiller1: posts big blind $1
*** HOLE CARDS ***
Dealt to matiko09 [3c 6c]
matiko09: folds 
HITYESCA: folds 
bello1310: folds 
torkkdnm: folds 
cobrik23 has timed out
cobrik23: folds 
ama58: folds 
oscarleon: raises $2 to $3
Bimaxa: folds 
deadkiller1: calls $2
*** FLOP *** [Th Td 5c]
deadkiller1: checks 
oscarleon: bets $3.21
deadkiller1: folds 
Uncalled bet ($3.21) returned to oscarleon
oscarleon collected $6.18 from pot
oscarleon: doesn't show hand 
*** SUMMARY ***
Total pot $6.50 | Rake $0.32 
Board [Th Td 5c]
Seat 1: Bimaxa (small blind) folded before Flop
Seat 2: deadkiller1 (big blind) folded on the Flop
Seat 3: matiko09 folded before Flop (didn't bet)
Seat 4: HITYESCA folded before Flop (didn't bet)
Seat 5: bello1310 folded before Flop (didn't bet)
Seat 6: torkkdnm folded before Flop (didn't bet)
Seat 7: cobrik23 folded before Flop (didn't bet)
Seat 8: ama58 folded before Flop (didn't bet)
Seat 9: oscarleon (button) collected ($6.18)





PokerStars Hand #153501745235:  Hold'em No Limit ($0.50/$1.00 USD) - 2016/05/18 20:20:52 CET [2016/05/18 14:20:52 ET]
Table 'Erida II' 9-max Seat #1 is the button
Seat 1: vanilica ($100 in chips) 
Seat 2: cobrik23 ($99 in chips) 
Seat 3: Kelvin sai ($77.06 in chips) 
Seat 5: Moszes360 ($100 in chips) 
Seat 6: deadkiller1 ($133.92 in chips) 
Seat 7: matiko09 ($104.50 in chips) 
Seat 9: sanr23 ($102.40 in chips) 
cobrik23: posts small blind $0.50
Kelvin sai: posts big blind $1
*** HOLE CARDS ***
Dealt to matiko09 [4d 7h]
Moszes360: folds 
deadkiller1: folds 
matiko09: folds 
sanr23: folds 
vanilica: raises $1.50 to $2.50
nickreason17 leaves the table
cobrik23: folds 
Kelvin sai: calls $1.50
*** FLOP *** [Qd 9h 5d]
smolski15 joins the table at seat #4 
smolski15 leaves the table
Kelvin sai: bets $2
FLQHenrici joins the table at seat #4 
vanilica: calls $2
*** TURN *** [Qd 9h 5d] [3h]
Kelvin sai: bets $4
vanilica: calls $4
*** RIVER *** [Qd 9h 5d 3h] [Jh]
Kelvin sai: bets $14
vanilica: calls $14
*** SHOW DOWN ***
Kelvin sai: shows [Th Ah] (a flush, Ace high)
vanilica: mucks hand 
Kelvin sai collected $43.22 from pot
*** SUMMARY ***
Total pot $45.50 | Rake $2.28 
Board [Qd 9h 5d 3h Jh]
Seat 1: vanilica (button) mucked [9c Js]
Seat 2: cobrik23 (small blind) folded before Flop
Seat 3: Kelvin sai (big blind) showed [Th Ah] and won ($43.22) with a flush, Ace high
Seat 5: Moszes360 folded before Flop (didn't bet)
Seat 6: deadkiller1 folded before Flop (didn't bet)
Seat 7: matiko09 folded before Flop (didn't bet)
Seat 9: sanr23 folded before Flop (didn't bet)





PokerStars Hand #153501746452:  Hold'em No Limit ($1/$2 USD) - 2016/05/18 20:20:54 CET [2016/05/18 14:20:54 ET]
Table 'Letaba' 9-max Seat #4 is the button
Seat 1: FREDY BULLIT ($215.03 in chips) 
Seat 2: staruk669 ($94.86 in chips) 
Seat 3: ersevi6 ($211.04 in chips) 
Seat 4: matiko09 ($200 in chips) 
Seat 5: tipner ($200 in chips) 
Seat 6: donald0404 ($235.44 in chips) 
Seat 9: tepi_guy ($230.75 in chips) 
tipner: posts small blind $1
donald0404: posts big blind $2
lydia12345: sits out 
*** HOLE CARDS ***
Dealt to matiko09 [As Js]
tepi_guy: folds 
FREDY BULLIT: raises $3.60 to $5.60
staruk669: raises $3.60 to $9.20
ersevi6: folds 
matiko09: folds 
tipner: folds 
donald0404: folds 
FREDY BULLIT: calls $3.60
*** FLOP *** [3s Ah Ad]
FREDY BULLIT: checks 
staruk669: bets $10
FREDY BULLIT: folds 
Uncalled bet ($10) returned to staruk669
staruk669 collected $20.33 from pot
staruk669: doesn't show hand 
*** SUMMARY ***
Total pot $21.40 | Rake $1.07 
Board [3s Ah Ad]
Seat 1: FREDY BULLIT folded on the Flop
Seat 2: staruk669 collected ($20.33)
Seat 3: ersevi6 folded before Flop (didn't bet)
Seat 4: matiko09 (button) folded before Flop (didn't bet)
Seat 5: tipner (small blind) folded before Flop
Seat 6: donald0404 (big blind) folded before Flop
Seat 9: tepi_guy folded before Flop (didn't bet)





PokerStars Hand #153501747516:  Hold'em No Limit ($1/$2 USD) - 2016/05/18 20:20:55 CET [2016/05/18 14:20:55 ET]
Table 'Chlosinde' 9-max Seat #3 is the button
Seat 1: ersevi6 ($153 in chips) 
Seat 2: lydia12345 ($201.40 in chips) 
Seat 3: matiko09 ($200 in chips) 
Seat 4: FREDY BULLIT ($235.85 in chips) 
Seat 5: tepi_guy ($869.16 in chips) 
Seat 7: donald0404 ($200 in chips) 
Seat 8: sanducu_eu ($212.03 in chips) 
Seat 9: Tey113 ($634.67 in chips) 
FREDY BULLIT: posts small blind $1
tepi_guy: posts big blind $2
tipner: sits out 
*** HOLE CARDS ***
Dealt to matiko09 [9s Ad]
donald0404: folds 
sanducu_eu: folds 
Tey113: folds 
ersevi6: folds 
lydia12345: folds 
matiko09: raises $2.54 to $4.54
FREDY BULLIT: folds 
tepi_guy has timed out
tepi_guy: folds 
Uncalled bet ($2.54) returned to matiko09
matiko09 collected $5 from pot
matiko09: doesn't show hand 
*** SUMMARY ***
Total pot $5 | Rake $0 
Seat 1: ersevi6 folded before Flop (didn't bet)
Seat 2: lydia12345 folded before Flop (didn't bet)
Seat 3: matiko09 (button) collected ($5)
Seat 4: FREDY BULLIT (small blind) folded before Flop
Seat 5: tepi_guy (big blind) folded before Flop
Seat 7: donald0404 folded before Flop (didn't bet)
Seat 8: sanducu_eu folded before Flop (didn't bet)
Seat 9: Tey113 folded before Flop (didn't bet)





PokerStars Hand #153501752139:  Hold'em No Limit ($0.50/$1.00 USD) - 2016/05/18 20:21:00 CET [2016/05/18 14:21:00 ET]
Table 'Saiph II' 9-max Seat #9 is the button
Seat 1: MAARKKKK ($67.18 in chips) 
Seat 2: matiko09 ($100 in chips) 
Seat 3: lydia12345 ($176.30 in chips) 
Seat 4: deadkiller1 ($100 in chips) 
Seat 5: cobrik23 ($71.48 in chips) 
Seat 6: LadyMaCe86 ($100 in chips) 
Seat 7: nickreason17 ($141.70 in chips) 
Seat 9: HITYESCA ($100 in chips) 
MAARKKKK: posts small blind $0.50
matiko09: posts big blind $1
vanilica: sits out 
*** HOLE CARDS ***
Dealt to matiko09 [7d 4h]
lydia12345: folds 
deadkiller1: folds 
cobrik23: folds 
LadyMaCe86: raises $2 to $3
nickreason17: folds 
HITYESCA: calls $3
MAARKKKK: folds 
matiko09: folds 
*** FLOP *** [Jh 9h 8h]
LadyMaCe86: checks 
HITYESCA: checks 
*** TURN *** [Jh 9h 8h] [6d]
LadyMaCe86: checks 
HITYESCA: checks 
*** RIVER *** [Jh 9h 8h 6d] [4c]
LadyMaCe86: checks 
HITYESCA: checks 
*** SHOW DOWN ***
LadyMaCe86: shows [As 9s] (a pair of Nines)
HITYESCA: mucks hand 
LadyMaCe86 collected $7.12 from pot
*** SUMMARY ***
Total pot $7.50 | Rake $0.38 
Board [Jh 9h 8h 6d 4c]
Seat 1: MAARKKKK (small blind) folded before Flop
Seat 2: matiko09 (big blind) folded before Flop
Seat 3: lydia12345 folded before Flop (didn't bet)
Seat 4: deadkiller1 folded before Flop (didn't bet)
Seat 5: cobrik23 folded before Flop (didn't bet)
Seat 6: LadyMaCe86 showed [As 9s] and won ($7.12) with a pair of Nines
Seat 7: nickreason17 folded before Flop (didn't bet)
Seat 9: HITYESCA (button) mucked [5s 5h]





PokerStars Hand #153501763867:  Hold'em No Limit ($0.50/$1.00 USD) - 2016/05/18 20:21:14 CET [2016/05/18 14:21:14 ET]
Table 'Tatjana III' 9-max Seat #2 is the button
Seat 1: cobrik23 ($40.42 in chips) 
Seat 2: HITYESCA ($123.82 in chips) 
Seat 3: matiko09 ($186.12 in chips) 
Seat 4: lydia12345 ($118.40 in chips) 
Seat 5: deadkiller1 ($103 in chips) 
Seat 6: nickreason17 ($130.62 in chips) 
Seat 7: rene1984tsv ($172.83 in chips) 
Seat 8: JACQUILF ($109 in chips) 
Seat 9: Moszes360 ($102 in chips) 
matiko09: posts small blind $0.50
lydia12345: posts big blind $1
*** HOLE CARDS ***
Dealt to matiko09 [7d Qc]
deadkiller1: folds 
nickreason17: folds 
rene1984tsv: raises $1 to $2
JACQUILF: folds 
Moszes360: folds 
cobrik23: raises $5 to $7
HITYESCA: folds 
matiko09: folds 
lydia12345: folds 
rene1984tsv: calls $5
*** FLOP *** [Qs 7s 7c]
rene1984tsv: checks 
cobrik23: bets $7
rene1984tsv: folds 
Uncalled bet ($7) returned to cobrik23
cobrik23 collected $14.72 from pot
cobrik23: doesn't show hand 
*** SUMMARY ***
Total pot $15.50 | Rake $0.78 
Board [Qs 7s 7c]
Seat 1: cobrik23 collected ($14.72)
Seat 2: HITYESCA (button) folded before Flop (didn't bet)
Seat 3: matiko09 (small blind) folded before Flop
Seat 4: lydia12345 (big blind) folded before Flop
Seat 5: deadkiller1 folded before Flop (didn't bet)
Seat 6: nickreason17 folded before Flop (didn't bet)
Seat 7: rene1984tsv folded on the Flop
Seat 8: JACQUILF folded before Flop (didn't bet)
Seat 9: Moszes360 folded before Flop (didn't bet)





PokerStars Hand #153501765391:  Hold'em No Limit (€0.50/€1.00 EUR) - 2016/05/18 20:21:15 CET [2016/05/18 14:21:15 ET]
Table 'Pallas II' 9-max Seat #4 is the button
Seat 1: deadkiller1 (€100 in chips) 
Seat 2: matiko09 (€203.99 in chips) 
Seat 3: JACQUILF (€100.88 in chips) 
Seat 4: torkkdnm (€145.18 in chips) 
Seat 5: cobrik23 (€68.24 in chips) 
Seat 6: HITYESCA (€124.75 in chips) 
Seat 8: lydia12345 (€100 in chips) 
Seat 9: stijner1986 (€142.51 in chips) 
cobrik23: posts small blind €0.50
HITYESCA: posts big blind €1
*** HOLE CARDS ***
Dealt to matiko09 [3c 8s]
lydia12345: folds 
stijner1986: folds 
deadkiller1: folds 
matiko09: folds 
JACQUILF: raises €1.50 to €2.50
torkkdnm: folds 
cobrik23: folds 
HITYESCA: calls €1.50
*** FLOP *** [6h 6s 2c]
HITYESCA: checks 
JACQUILF: bets €3.13
HITYESCA: calls €3.13
*** TURN *** [6h 6s 2c] [3s]
HITYESCA: checks 
JACQUILF: checks 
*** RIVER *** [6h 6s 2c 3s] [6d]
HITYESCA: checks 
JACQUILF: bets €9
HITYESCA: calls €9
*** SHOW DOWN ***
JACQUILF: shows [7d 7h] (a full house, Sixes full of Sevens)
HITYESCA: mucks hand 
JACQUILF collected €28.27 from pot
*** SUMMARY ***
Total pot €29.76 | Rake €1.49 
Board [6h 6s 2c 3s 6d]
Seat 1: deadkiller1 folded before Flop (didn't bet)
Seat 2: matiko09 folded before Flop (didn't bet)
Seat 3: JACQUILF showed [7d 7h] and won (€28.27) with a full house, Sixes full of Sevens
Seat 4: torkkdnm (button) folded before Flop (didn't bet)
Seat 5: cobrik23 (small blind) folded before Flop
Seat 6: HITYESCA (big blind) mucked [5s Ac]
Seat 8: lydia12345 folded before Flop (didn't bet)
Seat 9: stijner1986 folded before Flop (didn't bet)





PokerStars Hand #153501782224:  Hold'em No Limit ($0.50/$1.00 USD) - 2016/05/18 20:21:35 CET [2016/05/18 14:21:35 ET]
Table 'Abetti II' 9-max Seat #2 is the button
Seat 1: matiko09 ($131.08 in chips) 
Seat 2: Bimaxa ($127.34 in chips) 
Seat 3: cobrik23 ($252.87 in chips) 
Seat 4: ipashutapkom ($40 in chips) 
Seat 6: I The King I ($156.39 in chips) 
Seat 7: nickreason17 ($142.22 in chips) 
Seat 8: roadster683 ($56.20 in chips) 
Seat 9: lydia12345 ($110.74 in chips) 
cobrik23: posts small blind $0.50
ipashutapkom: posts big blind $1
*** HOLE CARDS ***
Dealt to matiko09 [5s As]
I The King I: folds 
nickreason17: folds 
roadster683: raises $1 to $2
lydia12345: folds 
matiko09: folds 
Bimaxa: folds 
cobrik23: folds 
ipashutapkom: folds 
Uncalled bet ($1) returned to roadster683
roadster683 collected $2.50 from pot
roadster683: doesn't show hand 
*** SUMMARY ***
Total pot $2.50 | Rake $0 
Seat 1: matiko09 folded before Flop (didn't bet)
Seat 2: Bimaxa (button) folded before Flop (didn't bet)
Seat 3: cobrik23 (small blind) folded before Flop
Seat 4: ipashutapkom (big blind) folded before Flop
Seat 6: I The King I folded before Flop (didn't bet)
Seat 7: nickreason17 folded before Flop (didn't bet)
Seat 8: roadster683 collected ($2.50)
Seat 9: lydia12345 folded before Flop (didn't bet)





PokerStars Hand #153501787154:  Hold'em No Limit ($1/$2 USD) - 2016/05/18 20:21:40 CET [2016/05/18 14:21:40 ET]
Table 'Letaba' 9-max Seat #5 is the button
Seat 1: FREDY BULLIT ($205.83 in chips) 
Seat 2: staruk669 ($105.99 in chips) 
Seat 3: ersevi6 ($211.04 in chips) 
Seat 4: matiko09 ($200 in chips) 
Seat 5: tipner ($200 in chips) 
Seat 6: donald0404 ($233.44 in chips) 
Seat 8: lydia12345 ($200 in chips) 
Seat 9: tepi_guy ($230.75 in chips) 
donald0404: posts small blind $1
lydia12345: posts big blind $2
*** HOLE CARDS ***
Dealt to matiko09 [4d Qd]
tepi_guy: folds 
FREDY BULLIT: folds 
staruk669: calls $2
ersevi6: folds 
matiko09: folds 
tipner: raises $6 to $8
donald0404: calls $7
lydia12345: folds 
staruk669: calls $6
*** FLOP *** [Qc 9d 5d]
donald0404: checks 
staruk669: checks 
tipner: checks 
*** TURN *** [Qc 9d 5d] [3d]
donald0404: checks 
staruk669: checks 
tipner: checks 
*** RIVER *** [Qc 9d 5d 3d] [5c]
donald0404: checks 
staruk669: bets $12
tipner: folds 
donald0404: calls $12
*** SHOW DOWN ***
staruk669: shows [2c Ac] (a pair of Fives)
donald0404: shows [Jc Jd] (two pair, Jacks and Fives)
donald0404 collected $47.50 from pot
*** SUMMARY ***
Total pot $50 | Rake $2.50 
Board [Qc 9d 5d 3d 5c]
Seat 1: FREDY BULLIT folded before Flop (didn't bet)
Seat 2: staruk669 showed [2c Ac] and lost with a pair of Fives
Seat 3: ersevi6 folded before Flop (didn't bet)
Seat 4: matiko09 folded before Flop (didn't bet)
Seat 5: tipner (button) folded on the River
Seat 6: donald0404 (small blind) showed [Jc Jd] and won ($47.50) with two pair, Jacks and Fives
Seat 8: lydia12345 (big blind) folded before Flop
Seat 9: tepi_guy folded before Flop (didn't bet)





PokerStars Hand #153501787815:  Hold'em No Limit ($1/$2 USD) - 2016/05/18 20:21:41 CET [2016/05/18 14:21:41 ET]
Table 'Chlosinde' 9-max Seat #4 is the button
Seat 1: ersevi6 ($153 in chips) 
Seat 2: lydia12345 ($201.40 in chips) 
Seat 3: matiko09 ($203 in chips) 
Seat 4: FREDY BULLIT ($234.85 in chips) 
Seat 5: tepi_guy ($867.16 in chips) 
Seat 6: tipner ($200 in chips) 
Seat 7: donald0404 ($200 in chips) 
Seat 8: sanducu_eu ($212.03 in chips) 
Seat 9: Tey113 ($634.67 in chips) 
tepi_guy: posts small blind $1
tipner: posts big blind $2
*** HOLE CARDS ***
Dealt to matiko09 [Kh Qs]
donald0404: folds 
sanducu_eu: folds 
Tey113: folds 
ersevi6: folds 
lydia12345: folds 
matiko09: raises $3 to $5
FREDY BULLIT: folds 
tepi_guy: calls $4
tipner: folds 
*** FLOP *** [6c Ad 2s]
tepi_guy: checks 
matiko09: bets $7.41
tepi_guy: calls $7.41
*** TURN *** [6c Ad 2s] [8h]
tepi_guy: checks 
matiko09: bets $16.50
tepi_guy: calls $16.50
*** RIVER *** [6c Ad 2s 8h] [Jh]
tepi_guy: checks 
matiko09: bets $40
tepi_guy: folds 
Uncalled bet ($40) returned to matiko09
matiko09 collected $57.07 from pot
matiko09: doesn't show hand 
*** SUMMARY ***
Total pot $59.82 | Rake $2.75 
Board [6c Ad 2s 8h Jh]
Seat 1: ersevi6 folded before Flop (didn't bet)
Seat 2: lydia12345 folded before Flop (didn't bet)
Seat 3: matiko09 collected ($57.07)
Seat 4: FREDY BULLIT (button) folded before Flop (didn't bet)
Seat 5: tepi_guy (small blind) folded on the River
Seat 6: tipner (big blind) folded before Flop
Seat 7: donald0404 folded before Flop (didn't bet)
Seat 8: sanducu_eu folded before Flop (didn't bet)
Seat 9: Tey113 folded before Flop (didn't bet)





PokerStars Hand #153501789193:  Hold'em No Limit ($0.50/$1.00 USD) - 2016/05/18 20:21:43 CET [2016/05/18 14:21:43 ET]
Table 'Kayala' 9-max Seat #4 is the button
Seat 1: deadkiller1 ($109.40 in chips) 
Seat 2: Oelie7 ($111.05 in chips) 
Seat 3: matiko09 ($100 in chips) 
Seat 4: HITYESCA ($100 in chips) 
Seat 5: tipner ($100.50 in chips) 
Seat 6: lydia12345 ($121.94 in chips) 
Seat 7: nickreason17 ($106.88 in chips) 
Seat 9: altunaelisa ($35.30 in chips) 
tipner: posts small blind $0.50
lydia12345: posts big blind $1
cobrik23: sits out 
*** HOLE CARDS ***
Dealt to matiko09 [Kd 6s]
nickreason17: folds 
altunaelisa: folds 
deadkiller1: folds 
Oelie7: folds 
matiko09: folds 
HITYESCA: folds 
tipner: folds 
Uncalled bet ($0.50) returned to lydia12345
lydia12345 collected $1 from pot
*** SUMMARY ***
Total pot $1 | Rake $0 
Seat 1: deadkiller1 folded before Flop (didn't bet)
Seat 2: Oelie7 folded before Flop (didn't bet)
Seat 3: matiko09 folded before Flop (didn't bet)
Seat 4: HITYESCA (button) folded before Flop (didn't bet)
Seat 5: tipner (small blind) folded before Flop
Seat 6: lydia12345 (big blind) collected ($1)
Seat 7: nickreason17 folded before Flop (didn't bet)
Seat 9: altunaelisa folded before Flop (didn't bet)





PokerStars Hand #153501804110:  Hold'em No Limit ($0.50/$1.00 USD) - 2016/05/18 20:22:00 CET [2016/05/18 14:22:00 ET]
Table 'Abetti II' 9-max Seat #3 is the button
Seat 1: matiko09 ($131.08 in chips) 
Seat 2: Bimaxa ($127.34 in chips) 
Seat 3: cobrik23 ($252.37 in chips) 
Seat 4: ipashutapkom ($40 in chips) 
Seat 6: I The King I ($156.39 in chips) 
Seat 7: nickreason17 ($142.22 in chips) 
Seat 8: roadster683 ($57.70 in chips) 
Seat 9: lydia12345 ($110.74 in chips) 
ipashutapkom: posts small blind $0.50
I The King I: posts big blind $1
*** HOLE CARDS ***
Dealt to matiko09 [7h 4h]
nickreason17: folds 
roadster683: folds 
lydia12345: folds 
matiko09: folds 
Bimaxa: folds 
cobrik23: raises $2 to $3
ipashutapkom: folds 
I The King I: folds 
Uncalled bet ($2) returned to cobrik23
cobrik23 collected $2.50 from pot
cobrik23: doesn't show hand 
*** SUMMARY ***
Total pot $2.50 | Rake $0 
Seat 1: matiko09 folded before Flop (didn't bet)
Seat 2: Bimaxa folded before Flop (didn't bet)
Seat 3: cobrik23 (button) collected ($2.50)
Seat 4: ipashutapkom (small blind) folded before Flop
Seat 6: I The King I (big blind) folded before Flop
Seat 7: nickreason17 folded before Flop (didn't bet)
Seat 8: roadster683 folded before Flop (didn't bet)
Seat 9: lydia12345 folded before Flop (didn't bet)





PokerStars Hand #153501804869:  Hold'em No Limit ($0.50/$1.00 USD) - 2016/05/18 20:22:01 CET [2016/05/18 14:22:01 ET]
Table 'Suevia' 9-max Seat #1 is the button
Seat 1: Bimaxa ($100 in chips) 
Seat 2: deadkiller1 ($100 in chips) 
Seat 3: matiko09 ($100 in chips) 
Seat 4: HITYESCA ($100 in chips) 
Seat 6: torkkdnm ($139.72 in chips) 
Seat 7: cobrik23 ($72.80 in chips) 
Seat 8: ama58 ($42.95 in chips) 
Seat 9: oscarleon ($136.37 in chips) 
deadkiller1: posts small blind $0.50
matiko09: posts big blind $1
*** HOLE CARDS ***
Dealt to matiko09 [Jh 9h]
HITYESCA: folds 
torkkdnm: folds 
cobrik23 has timed out
cobrik23: folds 
ama58: folds 
oscarleon: raises $2 to $3
Bimaxa: folds 
deadkiller1: folds 
matiko09: folds 
Uncalled bet ($2) returned to oscarleon
oscarleon collected $2.50 from pot
oscarleon: doesn't show hand 
*** SUMMARY ***
Total pot $2.50 | Rake $0 
Seat 1: Bimaxa (button) folded before Flop (didn't bet)
Seat 2: deadkiller1 (small blind) folded before Flop
Seat 3: matiko09 (big blind) folded before Flop
Seat 4: HITYESCA folded before Flop (didn't bet)
Seat 6: torkkdnm folded before Flop (didn't bet)
Seat 7: cobrik23 folded before Flop (didn't bet)
Seat 8: ama58 folded before Flop (didn't bet)
Seat 9: oscarleon collected ($2.50)





PokerStars Hand #153501809061:  Hold'em No Limit ($0.50/$1.00 USD) - 2016/05/18 20:22:06 CET [2016/05/18 14:22:06 ET]
Table 'Kayala' 9-max Seat #5 is the button
Seat 1: deadkiller1 ($109.40 in chips) 
Seat 2: Oelie7 ($111.05 in chips) 
Seat 3: matiko09 ($100 in chips) 
Seat 4: HITYESCA ($100 in chips) 
Seat 5: tipner ($100 in chips) 
Seat 6: lydia12345 ($122.44 in chips) 
Seat 7: nickreason17 ($106.88 in chips) 
Seat 9: altunaelisa ($35.30 in chips) 
lydia12345: posts small blind $0.50
nickreason17: posts big blind $1
cobrik23: sits out 
*** HOLE CARDS ***
Dealt to matiko09 [3s 6c]
altunaelisa: folds 
deadkiller1: folds 
Oelie7: calls $1
matiko09: folds 
HITYESCA: folds 
tipner: folds 
lydia12345: folds 
nickreason17: checks 
*** FLOP *** [Td Ks Ac]
nickreason17: checks 
Oelie7: checks 
*** TURN *** [Td Ks Ac] [Jd]
nickreason17: bets $1.25
Oelie7: folds 
Uncalled bet ($1.25) returned to nickreason17
nickreason17 collected $2.38 from pot
*** SUMMARY ***
Total pot $2.50 | Rake $0.12 
Board [Td Ks Ac Jd]
Seat 1: deadkiller1 folded before Flop (didn't bet)
Seat 2: Oelie7 folded on the Turn
Seat 3: matiko09 folded before Flop (didn't bet)
Seat 4: HITYESCA folded before Flop (didn't bet)
Seat 5: tipner (button) folded before Flop (didn't bet)
Seat 6: lydia12345 (small blind) folded before Flop
Seat 7: nickreason17 (big blind) collected ($2.38)
Seat 9: altunaelisa folded before Flop (didn't bet)





PokerStars Hand #153501811820:  Hold'em No Limit ($0.50/$1.00 USD) - 2016/05/18 20:22:09 CET [2016/05/18 14:22:09 ET]
Table 'Tatjana III' 9-max Seat #3 is the button
Seat 1: cobrik23 ($48.14 in chips) 
Seat 2: HITYESCA ($123.82 in chips) 
Seat 3: matiko09 ($185.62 in chips) 
Seat 4: lydia12345 ($117.40 in chips) 
Seat 5: deadkiller1 ($103 in chips) 
Seat 6: nickreason17 ($130.62 in chips) 
Seat 7: rene1984tsv ($165.83 in chips) 
Seat 8: JACQUILF ($109 in chips) 
Seat 9: Moszes360 ($102 in chips) 
lydia12345: posts small blind $0.50
deadkiller1: posts big blind $1
*** HOLE CARDS ***
Dealt to matiko09 [6c Kh]
nickreason17: folds 
rene1984tsv: folds 
JACQUILF: folds 
Moszes360: folds 
cobrik23: folds 
HITYESCA: raises $1.50 to $2.50
matiko09: folds 
lydia12345: folds 
deadkiller1: folds 
Uncalled bet ($1.50) returned to HITYESCA
HITYESCA collected $2.50 from pot
HITYESCA: doesn't show hand 
*** SUMMARY ***
Total pot $2.50 | Rake $0 
Seat 1: cobrik23 folded before Flop (didn't bet)
Seat 2: HITYESCA collected ($2.50)
Seat 3: matiko09 (button) folded before Flop (didn't bet)
Seat 4: lydia12345 (small blind) folded before Flop
Seat 5: deadkiller1 (big blind) folded before Flop
Seat 6: nickreason17 folded before Flop (didn't bet)
Seat 7: rene1984tsv folded before Flop (didn't bet)
Seat 8: JACQUILF folded before Flop (didn't bet)
Seat 9: Moszes360 folded before Flop (didn't bet)





PokerStars Hand #153501817995:  Hold'em No Limit ($0.50/$1.00 USD) - 2016/05/18 20:22:16 CET [2016/05/18 14:22:16 ET]
Table 'Pandora' 9-max Seat #4 is the button
Seat 1: deadkiller1 ($100 in chips) 
Seat 2: fack_vi ($77.12 in chips) 
Seat 3: tipner ($100 in chips) 
Seat 4: mooose100 ($89.94 in chips) 
Seat 6: Mulgraver25 ($67.13 in chips) 
Seat 7: lydia12345 ($108.82 in chips) 
Seat 8: matiko09 ($100 in chips) 
Seat 9: oscarleon ($115.48 in chips) 
Mulgraver25: posts small blind $0.50
lydia12345: posts big blind $1
*** HOLE CARDS ***
Dealt to matiko09 [9d Tc]
matiko09: folds 
oscarleon: folds 
deadkiller1: raises $2 to $3
fack_vi: folds 
tipner: folds 
mooose100: folds 
Mulgraver25: calls $2.50
lydia12345: folds 
*** FLOP *** [6c Jh 4c]
Mulgraver25: checks 
deadkiller1: bets $4.38
Mulgraver25: calls $4.38
*** TURN *** [6c Jh 4c] [7d]
Mulgraver25: checks 
deadkiller1: bets $9.88
Mulgraver25: calls $9.88
*** RIVER *** [6c Jh 4c 7d] [5h]
Mulgraver25: checks 
deadkiller1: bets $22.26
Mulgraver25: calls $22.26
*** SHOW DOWN ***
deadkiller1: shows [Qc Qd] (a pair of Queens)
Mulgraver25: mucks hand 
deadkiller1 collected $77.54 from pot
*** SUMMARY ***
Total pot $80.04 | Rake $2.50 
Board [6c Jh 4c 7d 5h]
Seat 1: deadkiller1 showed [Qc Qd] and won ($77.54) with a pair of Queens
Seat 2: fack_vi folded before Flop (didn't bet)
Seat 3: tipner folded before Flop (didn't bet)
Seat 4: mooose100 (button) folded before Flop (didn't bet)
Seat 6: Mulgraver25 (small blind) mucked [Kd Js]
Seat 7: lydia12345 (big blind) folded before Flop
Seat 8: matiko09 folded before Flop (didn't bet)
Seat 9: oscarleon folded before Flop (didn't bet)





PokerStars Hand #153501819974:  Hold'em No Limit ($0.50/$1.00 USD) - 2016/05/18 20:22:19 CET [2016/05/18 14:22:19 ET]
Table 'Erida II' 9-max Seat #2 is the button
Seat 1: vanilica ($100 in chips) 
Seat 2: cobrik23 ($98.50 in chips) 
Seat 3: Kelvin sai ($97.78 in chips) 
Seat 4: FLQHenrici ($100 in chips) 
Seat 5: Moszes360 ($100 in chips) 
Seat 6: deadkiller1 ($133.92 in chips) 
Seat 7: matiko09 ($104.50 in chips) 
Seat 9: sanr23 ($102.40 in chips) 
Kelvin sai: posts small blind $0.50
FLQHenrici: posts big blind $1
*** HOLE CARDS ***
Dealt to matiko09 [4d 2c]
Moszes360: raises $2 to $3
deadkiller1: calls $3
matiko09: folds 
sanr23: folds 
vanilica: folds 
cobrik23: folds 
Kelvin sai: folds 
FLQHenrici: calls $2
*** FLOP *** [3s 2s Qc]
FLQHenrici: checks 
Moszes360: bets $4.96
deadkiller1: calls $4.96
FLQHenrici: folds 
*** TURN *** [3s 2s Qc] [6c]
Moszes360: bets $12.17
deadkiller1: raises $19.83 to $32
Moszes360: folds 
Uncalled bet ($19.83) returned to deadkiller1
deadkiller1 collected $41.57 from pot
deadkiller1: doesn't show hand 
*** SUMMARY ***
Total pot $43.76 | Rake $2.19 
Board [3s 2s Qc 6c]
Seat 1: vanilica folded before Flop (didn't bet)
Seat 2: cobrik23 (button) folded before Flop (didn't bet)
Seat 3: Kelvin sai (small blind) folded before Flop
Seat 4: FLQHenrici (big blind) folded on the Flop
Seat 5: Moszes360 folded on the Turn
Seat 6: deadkiller1 collected ($41.57)
Seat 7: matiko09 folded before Flop (didn't bet)
Seat 9: sanr23 folded before Flop (didn't bet)





PokerStars Hand #153501823120:  Hold'em No Limit ($0.50/$1.00 USD) - 2016/05/18 20:22:22 CET [2016/05/18 14:22:22 ET]
Table 'Saiph II' 9-max Seat #1 is the button
Seat 1: MAARKKKK ($66.68 in chips) 
Seat 2: matiko09 ($100 in chips) 
Seat 4: deadkiller1 ($100 in chips) 
Seat 5: cobrik23 ($71.48 in chips) 
Seat 6: LadyMaCe86 ($104.12 in chips) 
Seat 7: nickreason17 ($141.70 in chips) 
Seat 9: HITYESCA ($100 in chips) 
matiko09: posts small blind $0.50
lydia12345: is sitting out 
deadkiller1: posts big blind $1
vanilica: sits out 
*** HOLE CARDS ***
Dealt to matiko09 [4s Jd]
lydia12345 leaves the table
smolski15 joins the table at seat #3 
cobrik23: raises $2 to $3
LadyMaCe86: folds 
nickreason17: folds 
HITYESCA: folds 
MAARKKKK: folds 
smolski15 leaves the table
matiko09: folds 
deadkiller1: folds 
Uncalled bet ($2) returned to cobrik23
cobrik23 collected $2.50 from pot
cobrik23: doesn't show hand 
*** SUMMARY ***
Total pot $2.50 | Rake $0 
Seat 1: MAARKKKK (button) folded before Flop (didn't bet)
Seat 2: matiko09 (small blind) folded before Flop
Seat 4: deadkiller1 (big blind) folded before Flop
Seat 5: cobrik23 collected ($2.50)
Seat 6: LadyMaCe86 folded before Flop (didn't bet)
Seat 7: nickreason17 folded before Flop (didn't bet)
Seat 9: HITYESCA folded before Flop (didn't bet)





PokerStars Hand #153501826448:  Hold'em No Limit ($0.50/$1.00 USD) - 2016/05/18 20:22:26 CET [2016/05/18 14:22:26 ET]
Table 'Abetti II' 9-max Seat #4 is the button
Seat 1: matiko09 ($131.08 in chips) 
Seat 2: Bimaxa ($127.34 in chips) 
Seat 3: cobrik23 ($253.87 in chips) 
Seat 4: ipashutapkom ($40 in chips) 
Seat 6: I The King I ($155.39 in chips) 
Seat 7: nickreason17 ($142.22 in chips) 
Seat 8: roadster683 ($57.70 in chips) 
Seat 9: lydia12345 ($110.74 in chips) 
I The King I: posts small blind $0.50
nickreason17: posts big blind $1
*** HOLE CARDS ***
Dealt to matiko09 [Kc 5d]
roadster683: calls $1
lydia12345: folds 
matiko09: folds 
Bimaxa: folds 
cobrik23 has timed out
cobrik23: folds 
ipashutapkom: raises $3.26 to $4.26
I The King I: folds 
nickreason17: calls $3.26
roadster683: calls $3.26
*** FLOP *** [6c 5h 4c]
nickreason17: checks 
roadster683: checks 
ipashutapkom: checks 
*** TURN *** [6c 5h 4c] [7d]
nickreason17: checks 
roadster683: bets $6
ipashutapkom: calls $6
nickreason17: folds 
*** RIVER *** [6c 5h 4c 7d] [Js]
roadster683: bets $1
ipashutapkom: raises $28.74 to $29.74 and is all-in
roadster683: calls $28.74
*** SHOW DOWN ***
ipashutapkom: shows [9s Qh] (high card Queen)
roadster683: shows [2s 3s] (a straight, Three to Seven)
roadster683 collected $82.26 from pot
*** SUMMARY ***
Total pot $84.76 | Rake $2.50 
Board [6c 5h 4c 7d Js]
Seat 1: matiko09 folded before Flop (didn't bet)
Seat 2: Bimaxa folded before Flop (didn't bet)
Seat 3: cobrik23 folded before Flop (didn't bet)
Seat 4: ipashutapkom (button) showed [9s Qh] and lost with high card Queen
Seat 6: I The King I (small blind) folded before Flop
Seat 7: nickreason17 (big blind) folded on the Turn
Seat 8: roadster683 showed [2s 3s] and won ($82.26) with a straight, Three to Seven
Seat 9: lydia12345 folded before Flop (didn't bet)





PokerStars Hand #153501839193:  Hold'em No Limit ($0.50/$1.00 USD) - 2016/05/18 20:22:41 CET [2016/05/18 14:22:41 ET]
Table 'Kayala' 9-max Seat #6 is the button
Seat 1: deadkiller1 ($109.40 in chips) 
Seat 2: Oelie7 ($110.05 in chips) 
Seat 3: matiko09 ($100 in chips) 
Seat 4: HITYESCA ($100 in chips) 
Seat 5: tipner ($100 in chips) 
Seat 6: lydia12345 ($121.94 in chips) 
Seat 7: nickreason17 ($108.26 in chips) 
Seat 8: cobrik23 ($86.54 in chips) 
Seat 9: altunaelisa ($35.30 in chips) 
nickreason17: posts small blind $0.50
cobrik23: posts big blind $1
*** HOLE CARDS ***
Dealt to matiko09 [Qh 6h]
altunaelisa: folds 
deadkiller1: folds 
Oelie7: calls $1
matiko09: folds 
HITYESCA: folds 
tipner: folds 
lydia12345: folds 
nickreason17: calls $0.50
cobrik23: checks 
*** FLOP *** [Qs 7c Ad]
nickreason17: bets $1.50
cobrik23: folds 
Oelie7: folds 
Uncalled bet ($1.50) returned to nickreason17
nickreason17 collected $2.85 from pot
*** SUMMARY ***
Total pot $3 | Rake $0.15 
Board [Qs 7c Ad]
Seat 1: deadkiller1 folded before Flop (didn't bet)
Seat 2: Oelie7 folded on the Flop
Seat 3: matiko09 folded before Flop (didn't bet)
Seat 4: HITYESCA folded before Flop (didn't bet)
Seat 5: tipner folded before Flop (didn't bet)
Seat 6: lydia12345 (button) folded before Flop (didn't bet)
Seat 7: nickreason17 (small blind) collected ($2.85)
Seat 8: cobrik23 (big blind) folded on the Flop
Seat 9: altunaelisa folded before Flop (didn't bet)





PokerStars Hand #153501842187:  Hold'em No Limit (€0.50/€1.00 EUR) - 2016/05/18 20:22:44 CET [2016/05/18 14:22:44 ET]
Table 'Pallas II' 9-max Seat #5 is the button
Seat 1: deadkiller1 (€100 in chips) 
Seat 2: matiko09 (€203.99 in chips) 
Seat 3: JACQUILF (€114.52 in chips) 
Seat 4: torkkdnm (€145.18 in chips) 
Seat 5: cobrik23 (€67.74 in chips) 
Seat 6: HITYESCA (€110.12 in chips) 
Seat 8: lydia12345 (€100 in chips) 
Seat 9: stijner1986 (€142.51 in chips) 
HITYESCA: posts small blind €0.50
lydia12345: posts big blind €1
*** HOLE CARDS ***
Dealt to matiko09 [3c Js]
stijner1986: folds 
deadkiller1: folds 
matiko09: folds 
JACQUILF: folds 
torkkdnm: folds 
cobrik23: raises €2 to €3
HITYESCA: folds 
lydia12345: folds 
Uncalled bet (€2) returned to cobrik23
cobrik23 collected €2.50 from pot
cobrik23: doesn't show hand 
*** SUMMARY ***
Total pot €2.50 | Rake €0 
Seat 1: deadkiller1 folded before Flop (didn't bet)
Seat 2: matiko09 folded before Flop (didn't bet)
Seat 3: JACQUILF folded before Flop (didn't bet)
Seat 4: torkkdnm folded before Flop (didn't bet)
Seat 5: cobrik23 (button) collected (€2.50)
Seat 6: HITYESCA (small blind) folded before Flop
Seat 8: lydia12345 (big blind) folded before Flop
Seat 9: stijner1986 folded before Flop (didn't bet)





PokerStars Hand #153501846199:  Hold'em No Limit ($0.50/$1.00 USD) - 2016/05/18 20:22:49 CET [2016/05/18 14:22:49 ET]
Table 'Tatjana III' 9-max Seat #4 is the button
Seat 1: cobrik23 ($48.14 in chips) 
Seat 2: HITYESCA ($125.32 in chips) 
Seat 3: matiko09 ($185.62 in chips) 
Seat 4: lydia12345 ($116.90 in chips) 
Seat 5: deadkiller1 ($102 in chips) 
Seat 6: nickreason17 ($130.62 in chips) 
Seat 7: rene1984tsv ($165.83 in chips) 
Seat 8: JACQUILF ($109 in chips) 
Seat 9: Moszes360 ($102 in chips) 
deadkiller1: posts small blind $0.50
nickreason17: posts big blind $1
*** HOLE CARDS ***
Dealt to matiko09 [Qc Js]
rene1984tsv: folds 
JACQUILF: folds 
Moszes360: folds 
cobrik23: folds 
HITYESCA: folds 
matiko09: raises $1.50 to $2.50
lydia12345: folds 
deadkiller1: folds 
nickreason17: calls $1.50
*** FLOP *** [9d Qd 4s]
nickreason17: checks 
matiko09: bets $3.39
nickreason17: folds 
Uncalled bet ($3.39) returned to matiko09
matiko09 collected $5.22 from pot
matiko09: doesn't show hand 
*** SUMMARY ***
Total pot $5.50 | Rake $0.28 
Board [9d Qd 4s]
Seat 1: cobrik23 folded before Flop (didn't bet)
Seat 2: HITYESCA folded before Flop (didn't bet)
Seat 3: matiko09 collected ($5.22)
Seat 4: lydia12345 (button) folded before Flop (didn't bet)
Seat 5: deadkiller1 (small blind) folded before Flop
Seat 6: nickreason17 (big blind) folded on the Flop
Seat 7: rene1984tsv folded before Flop (didn't bet)
Seat 8: JACQUILF folded before Flop (didn't bet)
Seat 9: Moszes360 folded before Flop (didn't bet)





PokerStars Hand #153501853171:  Hold'em No Limit ($0.50/$1.00 USD) - 2016/05/18 20:22:57 CET [2016/05/18 14:22:57 ET]
Table 'Saiph II' 9-max Seat #2 is the button
Seat 1: MAARKKKK ($66.68 in chips) 
Seat 2: matiko09 ($100 in chips) 
Seat 4: deadkiller1 ($100 in chips) 
Seat 5: cobrik23 ($72.98 in chips) 
Seat 6: LadyMaCe86 ($104.12 in chips) 
Seat 7: nickreason17 ($141.70 in chips) 
Seat 9: HITYESCA ($100 in chips) 
deadkiller1: posts small blind $0.50
cobrik23: posts big blind $1
vanilica: sits out 
*** HOLE CARDS ***
Dealt to matiko09 [Jd Ks]
rate8 joins the table at seat #3 
LadyMaCe86: folds 
nickreason17: folds 
HITYESCA: folds 
MAARKKKK: folds 
matiko09: raises $1.27 to $2.27
deadkiller1: folds 
cobrik23: folds 
Uncalled bet ($1.27) returned to matiko09
matiko09 collected $2.50 from pot
matiko09: doesn't show hand 
*** SUMMARY ***
Total pot $2.50 | Rake $0 
Seat 1: MAARKKKK folded before Flop (didn't bet)
Seat 2: matiko09 (button) collected ($2.50)
Seat 4: deadkiller1 (small blind) folded before Flop
Seat 5: cobrik23 (big blind) folded before Flop
Seat 6: LadyMaCe86 folded before Flop (didn't bet)
Seat 7: nickreason17 folded before Flop (didn't bet)
Seat 9: HITYESCA folded before Flop (didn't bet)





PokerStars Hand #153501855151:  Hold'em No Limit ($1/$2 USD) - 2016/05/18 20:22:59 CET [2016/05/18 14:22:59 ET]
Table 'Letaba' 9-max Seat #6 is the button
Seat 1: FREDY BULLIT ($205.83 in chips) 
Seat 2: staruk669 ($85.99 in chips) 
Seat 3: ersevi6 ($211.04 in chips) 
Seat 4: matiko09 ($200 in chips) 
Seat 5: tipner ($200 in chips) 
Seat 6: donald0404 ($260.94 in chips) 
Seat 8: lydia12345 ($200 in chips) 
Seat 9: tepi_guy ($230.75 in chips) 
lydia12345: posts small blind $1
tepi_guy: posts big blind $2
*** HOLE CARDS ***
Dealt to matiko09 [Jh 4h]
FREDY BULLIT: folds 
staruk669: calls $2
ersevi6: folds 
matiko09: folds 
tipner: raises $6 to $8
donald0404: calls $8
lydia12345: folds 
tepi_guy: folds 
staruk669: calls $6
*** FLOP *** [5c 5d Td]
staruk669: checks 
tipner: bets $14
donald0404: calls $14
staruk669: folds 
*** TURN *** [5c 5d Td] [3h]
tipner: checks 
donald0404: bets $33
tipner: calls $33
*** RIVER *** [5c 5d Td 3h] [As]
tipner: checks 
donald0404: checks 
*** SHOW DOWN ***
tipner: shows [Jc Th] (two pair, Tens and Fives)
donald0404: shows [7d Ad] (two pair, Aces and Fives)
donald0404 collected $118.25 from pot
*** SUMMARY ***
Total pot $121 | Rake $2.75 
Board [5c 5d Td 3h As]
Seat 1: FREDY BULLIT folded before Flop (didn't bet)
Seat 2: staruk669 folded on the Flop
Seat 3: ersevi6 folded before Flop (didn't bet)
Seat 4: matiko09 folded before Flop (didn't bet)
Seat 5: tipner showed [Jc Th] and lost with two pair, Tens and Fives
Seat 6: donald0404 (button) showed [7d Ad] and won ($118.25) with two pair, Aces and Fives
Seat 8: lydia12345 (small blind) folded before Flop
Seat 9: tepi_guy (big blind) folded before Flop





PokerStars Hand #153501860880:  Hold'em No Limit ($1/$2 USD) - 2016/05/18 20:23:06 CET [2016/05/18 14:23:06 ET]
Table 'Chlosinde' 9-max Seat #5 is the button
Seat 1: ersevi6 ($153 in chips) 
Seat 2: lydia12345 ($201.40 in chips) 
Seat 3: matiko09 ($231.16 in chips) 
Seat 4: FREDY BULLIT ($234.85 in chips) 
Seat 5: tepi_guy ($838.25 in chips) 
Seat 6: tipner ($200 in chips) 
Seat 7: donald0404 ($200 in chips) 
Seat 8: sanducu_eu ($212.03 in chips) 
Seat 9: Tey113 ($634.67 in chips) 
tipner: posts small blind $1
donald0404: posts big blind $2
*** HOLE CARDS ***
Dealt to matiko09 [9s 3d]
sanducu_eu: folds 
Tey113: calls $2
ersevi6: folds 
lydia12345: folds 
matiko09: folds 
FREDY BULLIT: folds 
tepi_guy has timed out
tepi_guy: folds 
tipner: folds 
donald0404: checks 
*** FLOP *** [9c 3s Kh]
donald0404: checks 
Tey113: checks 
*** TURN *** [9c 3s Kh] [4c]
donald0404: bets $4.03
Tey113: calls $4.03
*** RIVER *** [9c 3s Kh 4c] [5d]
donald0404: bets $10.54
Tey113: folds 
Uncalled bet ($10.54) returned to donald0404
donald0404 collected $12.41 from pot
donald0404: doesn't show hand 
*** SUMMARY ***
Total pot $13.06 | Rake $0.65 
Board [9c 3s Kh 4c 5d]
Seat 1: ersevi6 folded before Flop (didn't bet)
Seat 2: lydia12345 folded before Flop (didn't bet)
Seat 3: matiko09 folded before Flop (didn't bet)
Seat 4: FREDY BULLIT folded before Flop (didn't bet)
Seat 5: tepi_guy (button) folded before Flop (didn't bet)
Seat 6: tipner (small blind) folded before Flop
Seat 7: donald0404 (big blind) collected ($12.41)
Seat 8: sanducu_eu folded before Flop (didn't bet)
Seat 9: Tey113 folded on the River





PokerStars Hand #153501866960:  Hold'em No Limit ($0.50/$1.00 USD) - 2016/05/18 20:23:13 CET [2016/05/18 14:23:13 ET]
Table 'Suevia' 9-max Seat #2 is the button
Seat 1: Bimaxa ($100 in chips) 
Seat 2: deadkiller1 ($100 in chips) 
Seat 3: matiko09 ($100 in chips) 
Seat 4: HITYESCA ($100 in chips) 
Seat 6: torkkdnm ($139.72 in chips) 
Seat 7: cobrik23 ($72.80 in chips) 
Seat 8: ama58 ($42.95 in chips) 
Seat 9: oscarleon ($137.87 in chips) 
matiko09: posts small blind $0.50
HITYESCA: posts big blind $1
*** HOLE CARDS ***
Dealt to matiko09 [Jd 8c]
torkkdnm: raises $2 to $3
cobrik23: folds 
ama58: calls $3
oscarleon: folds 
Bimaxa: folds 
deadkiller1: folds 
matiko09: folds 
HITYESCA: folds 
*** FLOP *** [Qh 4s 9d]
torkkdnm: checks 
ama58: bets $3.56
torkkdnm: calls $3.56
*** TURN *** [Qh 4s 9d] [3c]
torkkdnm: checks 
ama58: bets $6
torkkdnm: calls $6
*** RIVER *** [Qh 4s 9d 3c] [Tc]
torkkdnm: checks 
ama58: checks 
*** SHOW DOWN ***
torkkdnm: shows [Jh Js] (a pair of Jacks)
ama58: shows [Qc Ac] (a pair of Queens)
ama58 collected $25.29 from pot
*** SUMMARY ***
Total pot $26.62 | Rake $1.33 
Board [Qh 4s 9d 3c Tc]
Seat 1: Bimaxa folded before Flop (didn't bet)
Seat 2: deadkiller1 (button) folded before Flop (didn't bet)
Seat 3: matiko09 (small blind) folded before Flop
Seat 4: HITYESCA (big blind) folded before Flop
Seat 6: torkkdnm showed [Jh Js] and lost with a pair of Jacks
Seat 7: cobrik23 folded before Flop (didn't bet)
Seat 8: ama58 showed [Qc Ac] and won ($25.29) with a pair of Queens
Seat 9: oscarleon folded before Flop (didn't bet)





PokerStars Hand #153501877093:  Hold'em No Limit (€0.50/€1.00 EUR) - 2016/05/18 20:23:24 CET [2016/05/18 14:23:24 ET]
Table 'Pallas II' 9-max Seat #6 is the button
Seat 1: deadkiller1 (€100 in chips) 
Seat 2: matiko09 (€203.99 in chips) 
Seat 3: JACQUILF (€114.52 in chips) 
Seat 4: torkkdnm (€145.18 in chips) 
Seat 5: cobrik23 (€69.24 in chips) 
Seat 6: HITYESCA (€109.62 in chips) 
Seat 8: lydia12345 (€100 in chips) 
Seat 9: stijner1986 (€142.51 in chips) 
lydia12345: posts small blind €0.50
stijner1986: posts big blind €1
*** HOLE CARDS ***
Dealt to matiko09 [3d 5c]
deadkiller1: folds 
matiko09: folds 
JACQUILF: raises €2 to €3
torkkdnm: folds 
cobrik23: raises €6 to €9
HITYESCA: folds 
lydia12345: folds 
stijner1986: folds 
JACQUILF: folds 
Uncalled bet (€6) returned to cobrik23
cobrik23 collected €7.50 from pot
cobrik23: doesn't show hand 
*** SUMMARY ***
Total pot €7.50 | Rake €0 
Seat 1: deadkiller1 folded before Flop (didn't bet)
Seat 2: matiko09 folded before Flop (didn't bet)
Seat 3: JACQUILF folded before Flop
Seat 4: torkkdnm folded before Flop (didn't bet)
Seat 5: cobrik23 collected (€7.50)
Seat 6: HITYESCA (button) folded before Flop (didn't bet)
Seat 8: lydia12345 (small blind) folded before Flop
Seat 9: stijner1986 (big blind) folded before Flop





PokerStars Hand #153501884205:  Hold'em No Limit ($0.50/$1.00 USD) - 2016/05/18 20:23:32 CET [2016/05/18 14:23:32 ET]
Table 'Saiph II' 9-max Seat #4 is the button
Seat 1: MAARKKKK ($66.68 in chips) 
Seat 2: matiko09 ($101.50 in chips) 
Seat 4: deadkiller1 ($100 in chips) 
Seat 5: cobrik23 ($71.98 in chips) 
Seat 6: LadyMaCe86 ($104.12 in chips) 
Seat 7: nickreason17 ($141.70 in chips) 
Seat 9: HITYESCA ($100 in chips) 
cobrik23: posts small blind $0.50
LadyMaCe86: posts big blind $1
vanilica: sits out 
*** HOLE CARDS ***
Dealt to matiko09 [6h 5h]
nickreason17: folds 
HITYESCA: folds 
MAARKKKK: folds 
matiko09: raises $1.50 to $2.50
deadkiller1: folds 
cobrik23: folds 
LadyMaCe86: folds 
Uncalled bet ($1.50) returned to matiko09
matiko09 collected $2.50 from pot
matiko09: doesn't show hand 
*** SUMMARY ***
Total pot $2.50 | Rake $0 
Seat 1: MAARKKKK folded before Flop (didn't bet)
Seat 2: matiko09 collected ($2.50)
Seat 4: deadkiller1 (button) folded before Flop (didn't bet)
Seat 5: cobrik23 (small blind) folded before Flop
Seat 6: LadyMaCe86 (big blind) folded before Flop
Seat 7: nickreason17 folded before Flop (didn't bet)
Seat 9: HITYESCA folded before Flop (didn't bet)





PokerStars Hand #153501894001:  Hold'em No Limit ($0.50/$1.00 USD) - 2016/05/18 20:23:44 CET [2016/05/18 14:23:44 ET]
Table 'Kayala' 9-max Seat #7 is the button
Seat 1: deadkiller1 ($109.40 in chips) 
Seat 2: Oelie7 ($109.05 in chips) 
Seat 3: matiko09 ($100 in chips) 
Seat 4: HITYESCA ($100 in chips) 
Seat 5: tipner ($100 in chips) 
Seat 6: lydia12345 ($121.94 in chips) 
Seat 7: nickreason17 ($110.11 in chips) 
Seat 8: cobrik23 ($85.54 in chips) 
Seat 9: altunaelisa ($35.30 in chips) 
cobrik23: posts small blind $0.50
altunaelisa: posts big blind $1
*** HOLE CARDS ***
Dealt to matiko09 [9c Ac]
deadkiller1: folds 
Oelie7: folds 
matiko09: folds 
HITYESCA: folds 
tipner: folds 
lydia12345: raises $2 to $3
nickreason17: folds 
cobrik23: raises $7 to $10
altunaelisa: folds 
lydia12345: folds 
Uncalled bet ($7) returned to cobrik23
cobrik23 collected $7 from pot
cobrik23: doesn't show hand 
*** SUMMARY ***
Total pot $7 | Rake $0 
Seat 1: deadkiller1 folded before Flop (didn't bet)
Seat 2: Oelie7 folded before Flop (didn't bet)
Seat 3: matiko09 folded before Flop (didn't bet)
Seat 4: HITYESCA folded before Flop (didn't bet)
Seat 5: tipner folded before Flop (didn't bet)
Seat 6: lydia12345 folded before Flop
Seat 7: nickreason17 (button) folded before Flop (didn't bet)
Seat 8: cobrik23 (small blind) collected ($7)
Seat 9: altunaelisa (big blind) folded before Flop





PokerStars Hand #153501895429:  Hold'em No Limit ($0.50/$1.00 USD) - 2016/05/18 20:23:45 CET [2016/05/18 14:23:45 ET]
Table 'Pandora' 9-max Seat #6 is the button
Seat 1: deadkiller1 ($138.02 in chips) 
Seat 2: fack_vi ($77.12 in chips) 
Seat 3: tipner ($100 in chips) 
Seat 4: mooose100 ($89.94 in chips) 
Seat 6: Mulgraver25 ($27.61 in chips) 
Seat 7: lydia12345 ($107.82 in chips) 
Seat 8: matiko09 ($100 in chips) 
Seat 9: oscarleon ($115.48 in chips) 
lydia12345: posts small blind $0.50
matiko09: posts big blind $1
*** HOLE CARDS ***
Dealt to matiko09 [3d 4c]
oscarleon: folds 
deadkiller1: folds 
fack_vi: folds 
tipner: raises $2 to $3
mooose100: folds 
Mulgraver25: calls $3
lydia12345: folds 
matiko09: folds 
*** FLOP *** [7s 6h 2d]
tipner: bets $4
Mulgraver25: calls $4
*** TURN *** [7s 6h 2d] [Ac]
tipner: checks 
Mulgraver25: checks 
*** RIVER *** [7s 6h 2d Ac] [Jh]
tipner: checks 
Mulgraver25: bets $7
tipner: calls $7
*** SHOW DOWN ***
Mulgraver25: shows [3h 4h] (high card Ace)
tipner: shows [9h 9s] (a pair of Nines)
tipner collected $28.02 from pot
*** SUMMARY ***
Total pot $29.50 | Rake $1.48 
Board [7s 6h 2d Ac Jh]
Seat 1: deadkiller1 folded before Flop (didn't bet)
Seat 2: fack_vi folded before Flop (didn't bet)
Seat 3: tipner showed [9h 9s] and won ($28.02) with a pair of Nines
Seat 4: mooose100 folded before Flop (didn't bet)
Seat 6: Mulgraver25 (button) showed [3h 4h] and lost with high card Ace
Seat 7: lydia12345 (small blind) folded before Flop
Seat 8: matiko09 (big blind) folded before Flop
Seat 9: oscarleon folded before Flop (didn't bet)





PokerStars Hand #153501909834:  Hold'em No Limit ($0.50/$1.00 USD) - 2016/05/18 20:24:02 CET [2016/05/18 14:24:02 ET]
Table 'Tatjana III' 9-max Seat #5 is the button
Seat 1: cobrik23 ($48.14 in chips) 
Seat 2: HITYESCA ($125.32 in chips) 
Seat 3: matiko09 ($188.34 in chips) 
Seat 4: lydia12345 ($116.90 in chips) 
Seat 5: deadkiller1 ($101.50 in chips) 
Seat 6: nickreason17 ($128.12 in chips) 
Seat 7: rene1984tsv ($165.83 in chips) 
Seat 8: JACQUILF ($109 in chips) 
Seat 9: Moszes360 ($102 in chips) 
nickreason17: posts small blind $0.50
rene1984tsv: posts big blind $1
*** HOLE CARDS ***
Dealt to matiko09 [3c 8h]
JACQUILF: folds 
Moszes360: folds 
cobrik23: folds 
HITYESCA: folds 
matiko09: folds 
lydia12345: folds 
deadkiller1: raises $1.50 to $2.50
nickreason17: folds 
rene1984tsv: calls $1.50
*** FLOP *** [6h Kd 5s]
rene1984tsv: checks 
deadkiller1: bets $3.44
rene1984tsv: calls $3.44
*** TURN *** [6h Kd 5s] [Qh]
rene1984tsv: checks 
deadkiller1: checks 
*** RIVER *** [6h Kd 5s Qh] [Jh]
rene1984tsv: checks 
deadkiller1: checks 
*** SHOW DOWN ***
rene1984tsv: shows [6s 3s] (a pair of Sixes)
deadkiller1: mucks hand 
rene1984tsv collected $11.76 from pot
*** SUMMARY ***
Total pot $12.38 | Rake $0.62 
Board [6h Kd 5s Qh Jh]
Seat 1: cobrik23 folded before Flop (didn't bet)
Seat 2: HITYESCA folded before Flop (didn't bet)
Seat 3: matiko09 folded before Flop (didn't bet)
Seat 4: lydia12345 folded before Flop (didn't bet)
Seat 5: deadkiller1 (button) mucked [4s Ad]
Seat 6: nickreason17 (small blind) folded before Flop
Seat 7: rene1984tsv (big blind) showed [6s 3s] and won ($11.76) with a pair of Sixes
Seat 8: JACQUILF folded before Flop (didn't bet)
Seat 9: Moszes360 folded before Flop (didn't bet)





PokerStars Hand #153501913346:  Hold'em No Limit ($0.50/$1.00 USD) - 2016/05/18 20:24:06 CET [2016/05/18 14:24:06 ET]
Table 'Saiph II' 9-max Seat #5 is the button
Seat 1: MAARKKKK ($66.68 in chips) 
Seat 2: matiko09 ($103 in chips) 
Seat 4: deadkiller1 ($100 in chips) 
Seat 5: cobrik23 ($71.48 in chips) 
Seat 6: LadyMaCe86 ($103.12 in chips) 
Seat 7: nickreason17 ($141.70 in chips) 
Seat 9: HITYESCA ($100 in chips) 
LadyMaCe86: posts small blind $0.50
nickreason17: posts big blind $1
vanilica: sits out 
*** HOLE CARDS ***
Dealt to matiko09 [8s Qc]
HITYESCA: folds 
MAARKKKK: calls $1
matiko09: folds 
deadkiller1: folds 
cobrik23: folds 
LadyMaCe86: folds 
nickreason17: raises $3 to $4
MAARKKKK: calls $3
*** FLOP *** [7d Qh 3s]
nickreason17: bets $3.23
MAARKKKK: calls $3.23
*** TURN *** [7d Qh 3s] [8h]
nickreason17: checks 
MAARKKKK: checks 
*** RIVER *** [7d Qh 3s 8h] [Ah]
nickreason17: checks 
MAARKKKK: bets $7.10
nickreason17: folds 
Uncalled bet ($7.10) returned to MAARKKKK
MAARKKKK collected $14.21 from pot
MAARKKKK: doesn't show hand 
*** SUMMARY ***
Total pot $14.96 | Rake $0.75 
Board [7d Qh 3s 8h Ah]
Seat 1: MAARKKKK collected ($14.21)
Seat 2: matiko09 folded before Flop (didn't bet)
Seat 4: deadkiller1 folded before Flop (didn't bet)
Seat 5: cobrik23 (button) folded before Flop (didn't bet)
Seat 6: LadyMaCe86 (small blind) folded before Flop
Seat 7: nickreason17 (big blind) folded on the River
Seat 9: HITYESCA folded before Flop (didn't bet)





PokerStars Hand #153501918225:  Hold'em No Limit ($0.50/$1.00 USD) - 2016/05/18 20:24:11 CET [2016/05/18 14:24:11 ET]
Table 'Abetti II' 9-max Seat #6 is the button
Seat 1: matiko09 ($131.08 in chips) 
Seat 2: Bimaxa ($127.34 in chips) 
Seat 3: cobrik23 ($253.87 in chips) 
Seat 4: ipashutapkom ($40 in chips) 
Seat 6: I The King I ($154.89 in chips) 
Seat 7: nickreason17 ($137.96 in chips) 
Seat 8: roadster683 ($99.96 in chips) 
Seat 9: lydia12345 ($110.74 in chips) 
nickreason17: posts small blind $0.50
roadster683: posts big blind $1
*** HOLE CARDS ***
Dealt to matiko09 [Ts 2c]
lydia12345: calls $1
matiko09: folds 
Bimaxa: folds 
cobrik23: raises $3.50 to $4.50
ipashutapkom: folds 
I The King I: folds 
nickreason17: calls $4
roadster683: calls $3.50
lydia12345: calls $3.50
*** FLOP *** [5s 7h Qc]
nickreason17: checks 
roadster683: checks 
lydia12345: checks 
cobrik23: bets $10
nickreason17: folds 
roadster683: calls $10
lydia12345: raises $14 to $24
cobrik23: calls $14
roadster683: calls $14
*** TURN *** [5s 7h Qc] [6h]
roadster683: checks 
lydia12345: bets $82.24 and is all-in
cobrik23: calls $82.24
roadster683: folds 
*** RIVER *** [5s 7h Qc 6h] [7s]
*** SHOW DOWN ***
lydia12345: shows [5c 5h] (a full house, Fives full of Sevens)
cobrik23: mucks hand 
lydia12345 collected $251.98 from pot
*** SUMMARY ***
Total pot $254.48 | Rake $2.50 
Board [5s 7h Qc 6h 7s]
Seat 1: matiko09 folded before Flop (didn't bet)
Seat 2: Bimaxa folded before Flop (didn't bet)
Seat 3: cobrik23 mucked [As Qh]
Seat 4: ipashutapkom folded before Flop (didn't bet)
Seat 6: I The King I (button) folded before Flop (didn't bet)
Seat 7: nickreason17 (small blind) folded on the Flop
Seat 8: roadster683 (big blind) folded on the Turn
Seat 9: lydia12345 showed [5c 5h] and won ($251.98) with a full house, Fives full of Sevens





PokerStars Hand #153501934211:  Hold'em No Limit ($0.50/$1.00 USD) - 2016/05/18 20:24:30 CET [2016/05/18 14:24:30 ET]
Table 'Kayala' 9-max Seat #8 is the button
Seat 1: deadkiller1 ($109.40 in chips) 
Seat 2: Oelie7 ($109.05 in chips) 
Seat 3: matiko09 ($100 in chips) 
Seat 4: HITYESCA ($100 in chips) 
Seat 5: tipner ($100 in chips) 
Seat 6: lydia12345 ($118.94 in chips) 
Seat 7: nickreason17 ($110.11 in chips) 
Seat 8: cobrik23 ($89.54 in chips) 
Seat 9: altunaelisa ($34.30 in chips) 
altunaelisa: posts small blind $0.50
deadkiller1: posts big blind $1
*** HOLE CARDS ***
Dealt to matiko09 [4c Th]
Oelie7: calls $1
matiko09: folds 
HITYESCA: folds 
tipner: folds 
lydia12345: folds 
nickreason17: folds 
cobrik23: folds 
altunaelisa: folds 
deadkiller1: checks 
*** FLOP *** [6d 2c 9d]
deadkiller1: checks 
Oelie7: bets $2.38
deadkiller1: folds 
Uncalled bet ($2.38) returned to Oelie7
Oelie7 collected $2.38 from pot
Oelie7: doesn't show hand 
*** SUMMARY ***
Total pot $2.50 | Rake $0.12 
Board [6d 2c 9d]
Seat 1: deadkiller1 (big blind) folded on the Flop
Seat 2: Oelie7 collected ($2.38)
Seat 3: matiko09 folded before Flop (didn't bet)
Seat 4: HITYESCA folded before Flop (didn't bet)
Seat 5: tipner folded before Flop (didn't bet)
Seat 6: lydia12345 folded before Flop (didn't bet)
Seat 7: nickreason17 folded before Flop (didn't bet)
Seat 8: cobrik23 (button) folded before Flop (didn't bet)
Seat 9: altunaelisa (small blind) folded before Flop





PokerStars Hand #153501936628:  Hold'em No Limit ($1/$2 USD) - 2016/05/18 20:24:33 CET [2016/05/18 14:24:33 ET]
Table 'Letaba' 9-max Seat #8 is the button
Seat 2: staruk669 ($77.99 in chips) 
Seat 3: ersevi6 ($211.04 in chips) 
Seat 4: matiko09 ($200 in chips) 
Seat 5: tipner ($200 in chips) 
Seat 6: donald0404 ($324.19 in chips) 
Seat 8: lydia12345 ($200 in chips) 
Seat 9: tepi_guy ($228.75 in chips) 
tepi_guy: posts small blind $1
FREDY BULLIT: is sitting out 
staruk669: posts big blind $2
FREDY BULLIT leaves the table
moshmachine: sits out 
*** HOLE CARDS ***
Dealt to matiko09 [Td 8h]
I The King I joins the table at seat #1 
ersevi6: raises $3 to $5
matiko09: folds 
tipner: folds 
I The King I leaves the table
donald0404: folds 
lydia12345: folds 
tepi_guy: folds 
staruk669: calls $3
*** FLOP *** [5c 9d Qs]
staruk669: checks 
ersevi6: checks 
*** TURN *** [5c 9d Qs] [6h]
staruk669: checks 
vanilica joins the table at seat #1 
ersevi6: bets $8.56
staruk669: calls $8.56
*** RIVER *** [5c 9d Qs 6h] [3d]
staruk669: checks 
ersevi6: bets $18
staruk669: calls $18
*** SHOW DOWN ***
ersevi6: shows [Qd As] (a pair of Queens)
staruk669: mucks hand 
ersevi6 collected $61.37 from pot
*** SUMMARY ***
Total pot $64.12 | Rake $2.75 
Board [5c 9d Qs 6h 3d]
Seat 2: staruk669 (big blind) mucked [2c Qc]
Seat 3: ersevi6 showed [Qd As] and won ($61.37) with a pair of Queens
Seat 4: matiko09 folded before Flop (didn't bet)
Seat 5: tipner folded before Flop (didn't bet)
Seat 6: donald0404 folded before Flop (didn't bet)
Seat 8: lydia12345 (button) folded before Flop (didn't bet)
Seat 9: tepi_guy (small blind) folded before Flop





PokerStars Hand #153501937640:  Hold'em No Limit (€0.50/€1.00 EUR) - 2016/05/18 20:24:34 CET [2016/05/18 14:24:34 ET]
Table 'Pallas II' 9-max Seat #8 is the button
Seat 1: deadkiller1 (€100 in chips) 
Seat 2: matiko09 (€203.99 in chips) 
Seat 3: JACQUILF (€111.52 in chips) 
Seat 4: torkkdnm (€145.18 in chips) 
Seat 5: cobrik23 (€73.74 in chips) 
Seat 6: HITYESCA (€109.62 in chips) 
Seat 8: lydia12345 (€100 in chips) 
Seat 9: stijner1986 (€141.51 in chips) 
stijner1986: posts small blind €0.50
deadkiller1: posts big blind €1
*** HOLE CARDS ***
Dealt to matiko09 [8h 5d]
matiko09: folds 
JACQUILF: folds 
torkkdnm: raises €2 to €3
cobrik23: folds 
HITYESCA: folds 
lydia12345: folds 
stijner1986: calls €2.50
deadkiller1: folds 
*** FLOP *** [Qc 5s 3c]
stijner1986: checks 
torkkdnm: bets €4
stijner1986: folds 
Uncalled bet (€4) returned to torkkdnm
torkkdnm collected €6.65 from pot
*** SUMMARY ***
Total pot €7 | Rake €0.35 
Board [Qc 5s 3c]
Seat 1: deadkiller1 (big blind) folded before Flop
Seat 2: matiko09 folded before Flop (didn't bet)
Seat 3: JACQUILF folded before Flop (didn't bet)
Seat 4: torkkdnm collected (€6.65)
Seat 5: cobrik23 folded before Flop (didn't bet)
Seat 6: HITYESCA folded before Flop (didn't bet)
Seat 8: lydia12345 (button) folded before Flop (didn't bet)
Seat 9: stijner1986 (small blind) folded on the Flop





PokerStars Hand #153501943617:  Hold'em No Limit ($1/$2 USD) - 2016/05/18 20:24:41 CET [2016/05/18 14:24:41 ET]
Table 'Chlosinde' 9-max Seat #6 is the button
Seat 1: ersevi6 ($153 in chips) 
Seat 2: lydia12345 ($201.40 in chips) 
Seat 3: matiko09 ($231.16 in chips) 
Seat 4: FREDY BULLIT ($234.85 in chips) 
Seat 5: tepi_guy ($838.25 in chips) 
Seat 6: tipner ($200 in chips) 
Seat 7: donald0404 ($206.38 in chips) 
Seat 8: sanducu_eu ($212.03 in chips) 
Seat 9: Tey113 ($628.64 in chips) 
donald0404: posts small blind $1
sanducu_eu: posts big blind $2
*** HOLE CARDS ***
Dealt to matiko09 [6c Qd]
Tey113: calls $2
ersevi6: folds 
lydia12345: folds 
matiko09: folds 
FREDY BULLIT: folds 
tepi_guy has timed out
tepi_guy: folds 
tipner: folds 
donald0404: raises $5 to $7
sanducu_eu: folds 
Tey113: calls $5
*** FLOP *** [4s 4c Ac]
donald0404: checks 
Tey113: bets $5.50
donald0404: calls $5.50
*** TURN *** [4s 4c Ac] [6h]
donald0404: checks 
Tey113: bets $8.20
donald0404: calls $8.20
*** RIVER *** [4s 4c Ac 6h] [2d]
donald0404: bets $26.38
Tey113: calls $26.38
*** SHOW DOWN ***
donald0404: shows [Jc Ah] (two pair, Aces and Fours)
Tey113: mucks hand 
donald0404 collected $93.41 from pot
*** SUMMARY ***
Total pot $96.16 | Rake $2.75 
Board [4s 4c Ac 6h 2d]
Seat 1: ersevi6 folded before Flop (didn't bet)
Seat 2: lydia12345 folded before Flop (didn't bet)
Seat 3: matiko09 folded before Flop (didn't bet)
Seat 4: FREDY BULLIT folded before Flop (didn't bet)
Seat 5: tepi_guy folded before Flop (didn't bet)
Seat 6: tipner (button) folded before Flop (didn't bet)
Seat 7: donald0404 (small blind) showed [Jc Ah] and won ($93.41) with two pair, Aces and Fours
Seat 8: sanducu_eu (big blind) folded before Flop
Seat 9: Tey113 mucked [3h 3s]





PokerStars Hand #153501954026:  Hold'em No Limit ($0.50/$1.00 USD) - 2016/05/18 20:24:52 CET [2016/05/18 14:24:52 ET]
Table 'Pandora' 9-max Seat #7 is the button
Seat 1: deadkiller1 ($138.02 in chips) 
Seat 2: fack_vi ($77.12 in chips) 
Seat 3: tipner ($114.02 in chips) 
Seat 4: mooose100 ($89.94 in chips) 
Seat 6: Mulgraver25 ($13.61 in chips) 
Seat 7: lydia12345 ($107.32 in chips) 
Seat 8: matiko09 ($100 in chips) 
Seat 9: oscarleon ($115.48 in chips) 
matiko09: posts small blind $0.50
oscarleon: posts big blind $1
*** HOLE CARDS ***
Dealt to matiko09 [Ac 3s]
deadkiller1: folds 
fack_vi: raises $2 to $3
tipner: folds 
mooose100: calls $3
Mulgraver25: raises $10.61 to $13.61 and is all-in
lydia12345: folds 
matiko09: folds 
oscarleon: folds 
fack_vi: folds 
mooose100: calls $10.61
*** FLOP *** [7h 5c Qs]
*** TURN *** [7h 5c Qs] [3c]
*** RIVER *** [7h 5c Qs 3c] [5d]
*** SHOW DOWN ***
mooose100: shows [As 2s] (a pair of Fives)
Mulgraver25: shows [8s 9c] (a pair of Fives - lower kicker)
mooose100 collected $30.13 from pot
*** SUMMARY ***
Total pot $31.72 | Rake $1.59 
Board [7h 5c Qs 3c 5d]
Seat 1: deadkiller1 folded before Flop (didn't bet)
Seat 2: fack_vi folded before Flop
Seat 3: tipner folded before Flop (didn't bet)
Seat 4: mooose100 showed [As 2s] and won ($30.13) with a pair of Fives
Seat 6: Mulgraver25 showed [8s 9c] and lost with a pair of Fives
Seat 7: lydia12345 (button) folded before Flop (didn't bet)
Seat 8: matiko09 (small blind) folded before Flop
Seat 9: oscarleon (big blind) folded before Flop





PokerStars Hand #153501953783:  Hold'em No Limit ($0.50/$1.00 USD) - 2016/05/18 20:24:52 CET [2016/05/18 14:24:52 ET]
Table 'Erida II' 9-max Seat #3 is the button
Seat 1: vanilica ($100 in chips) 
Seat 2: cobrik23 ($98.50 in chips) 
Seat 3: Kelvin sai ($97.28 in chips) 
Seat 4: FLQHenrici ($100 in chips) 
Seat 5: Moszes360 ($100 in chips) 
Seat 6: deadkiller1 ($155.36 in chips) 
Seat 7: matiko09 ($104.50 in chips) 
Seat 9: sanr23 ($102.40 in chips) 
FLQHenrici: posts small blind $0.50
Moszes360: posts big blind $1
*** HOLE CARDS ***
Dealt to matiko09 [5d 5c]
deadkiller1: folds 
matiko09: raises $2 to $3
sanr23: folds 
vanilica: folds 
cobrik23: folds 
Kelvin sai: raises $4 to $7
FLQHenrici: folds 
Moszes360: folds 
matiko09: folds 
Uncalled bet ($4) returned to Kelvin sai
Kelvin sai collected $7.50 from pot
Kelvin sai: doesn't show hand 
*** SUMMARY ***
Total pot $7.50 | Rake $0 
Seat 1: vanilica folded before Flop (didn't bet)
Seat 2: cobrik23 folded before Flop (didn't bet)
Seat 3: Kelvin sai (button) collected ($7.50)
Seat 4: FLQHenrici (small blind) folded before Flop
Seat 5: Moszes360 (big blind) folded before Flop
Seat 6: deadkiller1 folded before Flop (didn't bet)
Seat 7: matiko09 folded before Flop
Seat 9: sanr23 folded before Flop (didn't bet)





PokerStars Hand #153501966237:  Hold'em No Limit ($0.50/$1.00 USD) - 2016/05/18 20:25:06 CET [2016/05/18 14:25:06 ET]
Table 'Tatjana III' 9-max Seat #6 is the button
Seat 1: cobrik23 ($48.14 in chips) 
Seat 2: HITYESCA ($125.32 in chips) 
Seat 3: matiko09 ($188.34 in chips) 
Seat 4: lydia12345 ($116.90 in chips) 
Seat 5: deadkiller1 ($100 in chips) 
Seat 6: nickreason17 ($127.62 in chips) 
Seat 7: rene1984tsv ($171.65 in chips) 
Seat 8: JACQUILF ($109 in chips) 
Seat 9: Moszes360 ($102 in chips) 
rene1984tsv: posts small blind $0.50
JACQUILF: posts big blind $1
*** HOLE CARDS ***
Dealt to matiko09 [6h Qd]
Moszes360: folds 
cobrik23: folds 
HITYESCA: folds 
matiko09: folds 
lydia12345: folds 
deadkiller1: folds 
nickreason17: folds 
rene1984tsv: calls $0.50
JACQUILF: checks 
*** FLOP *** [4c 9h 8d]
rene1984tsv: bets $1
JACQUILF: calls $1
*** TURN *** [4c 9h 8d] [As]
rene1984tsv: checks 
JACQUILF: checks 
*** RIVER *** [4c 9h 8d As] [5c]
rene1984tsv: checks 
JACQUILF: checks 
*** SHOW DOWN ***
rene1984tsv: shows [6d 3h] (high card Ace)
JACQUILF: shows [3c 4h] (a pair of Fours)
JACQUILF collected $3.80 from pot
*** SUMMARY ***
Total pot $4 | Rake $0.20 
Board [4c 9h 8d As 5c]
Seat 1: cobrik23 folded before Flop (didn't bet)
Seat 2: HITYESCA folded before Flop (didn't bet)
Seat 3: matiko09 folded before Flop (didn't bet)
Seat 4: lydia12345 folded before Flop (didn't bet)
Seat 5: deadkiller1 folded before Flop (didn't bet)
Seat 6: nickreason17 (button) folded before Flop (didn't bet)
Seat 7: rene1984tsv (small blind) showed [6d 3h] and lost with high card Ace
Seat 8: JACQUILF (big blind) showed [3c 4h] and won ($3.80) with a pair of Fours
Seat 9: Moszes360 folded before Flop (didn't bet)





PokerStars Hand #153501971019:  Hold'em No Limit ($0.50/$1.00 USD) - 2016/05/18 20:25:12 CET [2016/05/18 14:25:12 ET]
Table 'Saiph II' 9-max Seat #6 is the button
Seat 1: MAARKKKK ($73.66 in chips) 
Seat 2: matiko09 ($103 in chips) 
Seat 4: deadkiller1 ($100 in chips) 
Seat 5: cobrik23 ($71.48 in chips) 
Seat 6: LadyMaCe86 ($102.62 in chips) 
Seat 7: nickreason17 ($134.47 in chips) 
Seat 8: vanilica ($100 in chips) 
Seat 9: HITYESCA ($100 in chips) 
nickreason17: posts small blind $0.50
vanilica: posts big blind $1
*** HOLE CARDS ***
Dealt to matiko09 [2s 2h]
HITYESCA: folds 
MAARKKKK: folds 
matiko09: raises $2 to $3
deadkiller1: calls $3
cobrik23: folds 
LadyMaCe86: folds 
nickreason17: folds 
vanilica: folds 
*** FLOP *** [9s 9d Qd]
matiko09: checks 
deadkiller1: bets $4.69
matiko09: folds 
Uncalled bet ($4.69) returned to deadkiller1
deadkiller1 collected $7.12 from pot
deadkiller1: doesn't show hand 
*** SUMMARY ***
Total pot $7.50 | Rake $0.38 
Board [9s 9d Qd]
Seat 1: MAARKKKK folded before Flop (didn't bet)
Seat 2: matiko09 folded on the Flop
Seat 4: deadkiller1 collected ($7.12)
Seat 5: cobrik23 folded before Flop (didn't bet)
Seat 6: LadyMaCe86 (button) folded before Flop (didn't bet)
Seat 7: nickreason17 (small blind) folded before Flop
Seat 8: vanilica (big blind) folded before Flop
Seat 9: HITYESCA folded before Flop (didn't bet)





PokerStars Hand #153501970636:  Hold'em No Limit ($0.50/$1.00 USD) - 2016/05/18 20:25:12 CET [2016/05/18 14:25:12 ET]
Table 'Suevia' 9-max Seat #3 is the button
Seat 1: Bimaxa ($100 in chips) 
Seat 2: deadkiller1 ($100 in chips) 
Seat 3: matiko09 ($100 in chips) 
Seat 4: HITYESCA ($100 in chips) 
Seat 6: torkkdnm ($127.16 in chips) 
Seat 7: cobrik23 ($72.80 in chips) 
Seat 8: ama58 ($55.68 in chips) 
Seat 9: oscarleon ($137.87 in chips) 
HITYESCA: posts small blind $0.50
torkkdnm: posts big blind $1
*** HOLE CARDS ***
Dealt to matiko09 [7h 2d]
cobrik23: folds 
ama58: folds 
oscarleon: folds 
Bimaxa: raises $2 to $3
deadkiller1: folds 
matiko09: folds 
HITYESCA: folds 
torkkdnm: folds 
Uncalled bet ($2) returned to Bimaxa
Bimaxa collected $2.50 from pot
Bimaxa: doesn't show hand 
*** SUMMARY ***
Total pot $2.50 | Rake $0 
Seat 1: Bimaxa collected ($2.50)
Seat 2: deadkiller1 folded before Flop (didn't bet)
Seat 3: matiko09 (button) folded before Flop (didn't bet)
Seat 4: HITYESCA (small blind) folded before Flop
Seat 6: torkkdnm (big blind) folded before Flop
Seat 7: cobrik23 folded before Flop (didn't bet)
Seat 8: ama58 folded before Flop (didn't bet)
Seat 9: oscarleon folded before Flop (didn't bet)





PokerStars Hand #153501974963:  Hold'em No Limit ($0.50/$1.00 USD) - 2016/05/18 20:25:16 CET [2016/05/18 14:25:16 ET]
Table 'Kayala' 9-max Seat #9 is the button
Seat 1: deadkiller1 ($108.40 in chips) 
Seat 2: Oelie7 ($110.43 in chips) 
Seat 3: matiko09 ($100 in chips) 
Seat 4: HITYESCA ($100 in chips) 
Seat 5: tipner ($100 in chips) 
Seat 6: lydia12345 ($118.94 in chips) 
Seat 7: nickreason17 ($110.11 in chips) 
Seat 8: cobrik23 ($89.54 in chips) 
Seat 9: altunaelisa ($33.80 in chips) 
deadkiller1: posts small blind $0.50
Oelie7: posts big blind $1
*** HOLE CARDS ***
Dealt to matiko09 [Kd Ac]
matiko09: raises $2 to $3
HITYESCA: folds 
tipner: calls $3
lydia12345: folds 
nickreason17: folds 
cobrik23: folds 
altunaelisa: raises $5 to $8
deadkiller1: folds 
Oelie7: folds 
matiko09: raises $10 to $18
tipner: folds 
altunaelisa: raises $15.80 to $33.80 and is all-in
matiko09: calls $15.80
*** FLOP *** [7h 5h Jh]
*** TURN *** [7h 5h Jh] [2s]
*** RIVER *** [7h 5h Jh 2s] [9s]
*** SHOW DOWN ***
matiko09: shows [Kd Ac] (high card Ace)
altunaelisa: shows [7s 7c] (three of a kind, Sevens)
altunaelisa collected $69.60 from pot
*** SUMMARY ***
Total pot $72.10 | Rake $2.50 
Board [7h 5h Jh 2s 9s]
Seat 1: deadkiller1 (small blind) folded before Flop
Seat 2: Oelie7 (big blind) folded before Flop
Seat 3: matiko09 showed [Kd Ac] and lost with high card Ace
Seat 4: HITYESCA folded before Flop (didn't bet)
Seat 5: tipner folded before Flop
Seat 6: lydia12345 folded before Flop (didn't bet)
Seat 7: nickreason17 folded before Flop (didn't bet)
Seat 8: cobrik23 folded before Flop (didn't bet)
Seat 9: altunaelisa (button) showed [7s 7c] and won ($69.60) with three of a kind, Sevens





PokerStars Hand #153501977537:  Hold'em No Limit (€0.50/€1.00 EUR) - 2016/05/18 20:25:19 CET [2016/05/18 14:25:19 ET]
Table 'Pallas II' 9-max Seat #9 is the button
Seat 1: deadkiller1 (€100 in chips) 
Seat 2: matiko09 (€203.99 in chips) 
Seat 3: JACQUILF (€111.52 in chips) 
Seat 4: torkkdnm (€148.83 in chips) 
Seat 5: cobrik23 (€73.74 in chips) 
Seat 6: HITYESCA (€109.62 in chips) 
Seat 8: lydia12345 (€100 in chips) 
Seat 9: stijner1986 (€138.51 in chips) 
deadkiller1: posts small blind €0.50
matiko09: posts big blind €1
*** HOLE CARDS ***
Dealt to matiko09 [8h As]
JACQUILF: folds 
torkkdnm: folds 
cobrik23: raises €2 to €3
HITYESCA: folds 
lydia12345: folds 
JACQUILF leaves the table
stijner1986: folds 
Vikulja1993 joins the table at seat #3 
deadkiller1: folds 
matiko09: folds 
Uncalled bet (€2) returned to cobrik23
cobrik23 collected €2.50 from pot
cobrik23: doesn't show hand 
*** SUMMARY ***
Total pot €2.50 | Rake €0 
Seat 1: deadkiller1 (small blind) folded before Flop
Seat 2: matiko09 (big blind) folded before Flop
Seat 3: JACQUILF folded before Flop (didn't bet)
Seat 4: torkkdnm folded before Flop (didn't bet)
Seat 5: cobrik23 collected (€2.50)
Seat 6: HITYESCA folded before Flop (didn't bet)
Seat 8: lydia12345 folded before Flop (didn't bet)
Seat 9: stijner1986 (button) folded before Flop (didn't bet)





PokerStars Hand #153501983824:  Hold'em No Limit ($0.50/$1.00 USD) - 2016/05/18 20:25:27 CET [2016/05/18 14:25:27 ET]
Table 'Erida II' 9-max Seat #4 is the button
Seat 1: vanilica ($100 in chips) 
Seat 2: cobrik23 ($98.50 in chips) 
Seat 3: Kelvin sai ($101.78 in chips) 
Seat 4: FLQHenrici ($100 in chips) 
Seat 5: Moszes360 ($100 in chips) 
Seat 6: deadkiller1 ($155.36 in chips) 
Seat 7: matiko09 ($101.50 in chips) 
Seat 9: sanr23 ($102.40 in chips) 
Moszes360: posts small blind $0.50
deadkiller1: posts big blind $1
*** HOLE CARDS ***
Dealt to matiko09 [Jc 8s]
matiko09: folds 
sanr23: folds 
vanilica: folds 
cobrik23: raises $2 to $3
Kelvin sai: folds 
FLQHenrici: calls $3
Moszes360: folds 
deadkiller1: folds 
*** FLOP *** [Td Ks 7c]
cobrik23: checks 
FLQHenrici: bets $3.35
cobrik23: folds 
Uncalled bet ($3.35) returned to FLQHenrici
FLQHenrici collected $7.12 from pot
*** SUMMARY ***
Total pot $7.50 | Rake $0.38 
Board [Td Ks 7c]
Seat 1: vanilica folded before Flop (didn't bet)
Seat 2: cobrik23 folded on the Flop
Seat 3: Kelvin sai folded before Flop (didn't bet)
Seat 4: FLQHenrici (button) collected ($7.12)
Seat 5: Moszes360 (small blind) folded before Flop
Seat 6: deadkiller1 (big blind) folded before Flop
Seat 7: matiko09 folded before Flop (didn't bet)
Seat 9: sanr23 folded before Flop (didn't bet)





PokerStars Hand #153502000389:  Hold'em No Limit ($1/$2 USD) - 2016/05/18 20:25:46 CET [2016/05/18 14:25:46 ET]
Table 'Letaba' 9-max Seat #9 is the button
Seat 2: staruk669 ($46.43 in chips) 
Seat 3: ersevi6 ($240.85 in chips) 
Seat 4: matiko09 ($200 in chips) 
Seat 5: tipner ($200 in chips) 
Seat 6: donald0404 ($324.19 in chips) 
Seat 8: lydia12345 ($200 in chips) 
Seat 9: tepi_guy ($227.75 in chips) 
vanilica will be allowed to play after the button
staruk669: posts small blind $1
ersevi6: posts big blind $2
moshmachine: sits out 
*** HOLE CARDS ***
Dealt to matiko09 [Jc Jd]
matiko09: raises $3 to $5
tipner: folds 
donald0404: folds 
lydia12345: folds 
tepi_guy: calls $5
staruk669: calls $4
ersevi6: calls $3
*** FLOP *** [Ad Qs Ts]
staruk669: checks 
ersevi6: checks 
matiko09: checks 
tepi_guy: checks 
*** TURN *** [Ad Qs Ts] [6s]
staruk669: checks 
ersevi6: checks 
matiko09: checks 
tepi_guy: checks 
*** RIVER *** [Ad Qs Ts 6s] [9h]
staruk669: checks 
ersevi6: checks 
matiko09: checks 
tepi_guy: checks 
*** SHOW DOWN ***
staruk669: shows [Td 8s] (a pair of Tens)
ersevi6: shows [Qc 5c] (a pair of Queens)
matiko09: mucks hand 
tepi_guy: mucks hand 
ersevi6 collected $19 from pot
*** SUMMARY ***
Total pot $20 | Rake $1 
Board [Ad Qs Ts 6s 9h]
Seat 2: staruk669 (small blind) showed [Td 8s] and lost with a pair of Tens
Seat 3: ersevi6 (big blind) showed [Qc 5c] and won ($19) with a pair of Queens
Seat 4: matiko09 mucked [Jc Jd]
Seat 5: tipner folded before Flop (didn't bet)
Seat 6: donald0404 folded before Flop (didn't bet)
Seat 8: lydia12345 folded before Flop (didn't bet)
Seat 9: tepi_guy (button) mucked [4h 4c]





PokerStars Hand #153502002570:  Hold'em No Limit ($0.50/$1.00 USD) - 2016/05/18 20:25:48 CET [2016/05/18 14:25:48 ET]
Table 'Abetti II' 9-max Seat #7 is the button
Seat 1: matiko09 ($131.08 in chips) 
Seat 2: Bimaxa ($127.34 in chips) 
Seat 3: cobrik23 ($143.13 in chips) 
Seat 4: ipashutapkom ($40 in chips) 
Seat 6: I The King I ($154.89 in chips) 
Seat 7: nickreason17 ($133.46 in chips) 
Seat 8: roadster683 ($71.46 in chips) 
Seat 9: lydia12345 ($251.98 in chips) 
roadster683: posts small blind $0.50
lydia12345: posts big blind $1
*** HOLE CARDS ***
Dealt to matiko09 [3h Th]
matiko09: folds 
Bimaxa: raises $2 to $3
cobrik23: folds 
ipashutapkom: folds 
I The King I: folds 
nickreason17: folds 
roadster683: calls $2.50
lydia12345: calls $2
*** FLOP *** [3d As Kd]
roadster683: checks 
lydia12345: bets $5.81
Bimaxa: folds 
roadster683: folds 
Uncalled bet ($5.81) returned to lydia12345
lydia12345 collected $8.55 from pot
*** SUMMARY ***
Total pot $9 | Rake $0.45 
Board [3d As Kd]
Seat 1: matiko09 folded before Flop (didn't bet)
Seat 2: Bimaxa folded on the Flop
Seat 3: cobrik23 folded before Flop (didn't bet)
Seat 4: ipashutapkom folded before Flop (didn't bet)
Seat 6: I The King I folded before Flop (didn't bet)
Seat 7: nickreason17 (button) folded before Flop (didn't bet)
Seat 8: roadster683 (small blind) folded on the Flop
Seat 9: lydia12345 (big blind) collected ($8.55)





PokerStars Hand #153502008166:  Hold'em No Limit (€0.50/€1.00 EUR) - 2016/05/18 20:25:54 CET [2016/05/18 14:25:54 ET]
Table 'Pallas II' 9-max Seat #1 is the button
Seat 1: deadkiller1 (€100 in chips) 
Seat 2: matiko09 (€202.99 in chips) 
Seat 3: Vikulja1993 (€100 in chips) 
Seat 4: torkkdnm (€148.83 in chips) 
Seat 5: cobrik23 (€75.24 in chips) 
Seat 6: HITYESCA (€109.62 in chips) 
Seat 8: lydia12345 (€100 in chips) 
Seat 9: stijner1986 (€138.51 in chips) 
matiko09: posts small blind €0.50
Vikulja1993: posts big blind €1
*** HOLE CARDS ***
Dealt to matiko09 [Td 2s]
torkkdnm: folds 
cobrik23: raises €2 to €3
HITYESCA: folds 
lydia12345: folds 
stijner1986: calls €3
deadkiller1: folds 
matiko09: folds 
Vikulja1993: folds 
*** FLOP *** [Ah Kc 8c]
cobrik23: bets €2
stijner1986: calls €2
*** TURN *** [Ah Kc 8c] [Ac]
cobrik23: checks 
stijner1986: bets €1
cobrik23: calls €1
*** RIVER *** [Ah Kc 8c Ac] [Jd]
cobrik23: checks 
stijner1986: bets €12
cobrik23: folds 
Uncalled bet (€12) returned to stijner1986
stijner1986 collected €12.82 from pot
stijner1986: doesn't show hand 
*** SUMMARY ***
Total pot €13.50 | Rake €0.68 
Board [Ah Kc 8c Ac Jd]
Seat 1: deadkiller1 (button) folded before Flop (didn't bet)
Seat 2: matiko09 (small blind) folded before Flop
Seat 3: Vikulja1993 (big blind) folded before Flop
Seat 4: torkkdnm folded before Flop (didn't bet)
Seat 5: cobrik23 folded on the River
Seat 6: HITYESCA folded before Flop (didn't bet)
Seat 8: lydia12345 folded before Flop (didn't bet)
Seat 9: stijner1986 collected (€12.82)





PokerStars Hand #153502025132:  Hold'em No Limit ($0.50/$1.00 USD) - 2016/05/18 20:26:05 CET [2016/05/18 14:26:05 ET]
Table 'Suevia' 9-max Seat #4 is the button
Seat 1: Bimaxa ($101.50 in chips) 
Seat 2: deadkiller1 ($100 in chips) 
Seat 3: matiko09 ($100 in chips) 
Seat 4: HITYESCA ($100 in chips) 
Seat 6: torkkdnm ($126.16 in chips) 
Seat 7: cobrik23 ($72.80 in chips) 
Seat 8: ama58 ($55.68 in chips) 
Seat 9: oscarleon ($137.87 in chips) 
torkkdnm: posts small blind $0.50
cobrik23: posts big blind $1
*** HOLE CARDS ***
Dealt to matiko09 [Ah Jh]
ama58: raises $1 to $2
oscarleon: folds 
Bimaxa: folds 
deadkiller1: folds 
matiko09: calls $2
HITYESCA: folds 
torkkdnm: folds 
cobrik23: calls $1
*** FLOP *** [6d Qd 9d]
cobrik23: checks 
ama58: bets $3
matiko09: folds 
cobrik23: folds 
Uncalled bet ($3) returned to ama58
ama58 collected $6.18 from pot
*** SUMMARY ***
Total pot $6.50 | Rake $0.32 
Board [6d Qd 9d]
Seat 1: Bimaxa folded before Flop (didn't bet)
Seat 2: deadkiller1 folded before Flop (didn't bet)
Seat 3: matiko09 folded on the Flop
Seat 4: HITYESCA (button) folded before Flop (didn't bet)
Seat 6: torkkdnm (small blind) folded before Flop
Seat 7: cobrik23 (big blind) folded on the Flop
Seat 8: ama58 collected ($6.18)
Seat 9: oscarleon folded before Flop (didn't bet)





PokerStars Hand #153502032146:  Hold'em No Limit ($0.50/$1.00 USD) - 2016/05/18 20:26:13 CET [2016/05/18 14:26:13 ET]
Table 'Tatjana III' 9-max Seat #7 is the button
Seat 1: cobrik23 ($48.14 in chips) 
Seat 2: HITYESCA ($125.32 in chips) 
Seat 3: matiko09 ($188.34 in chips) 
Seat 4: lydia12345 ($116.90 in chips) 
Seat 5: deadkiller1 ($100 in chips) 
Seat 6: nickreason17 ($127.62 in chips) 
Seat 7: rene1984tsv ($169.65 in chips) 
Seat 8: JACQUILF ($110.80 in chips) 
Seat 9: Moszes360 ($102 in chips) 
JACQUILF: posts small blind $0.50
Moszes360: posts big blind $1
*** HOLE CARDS ***
Dealt to matiko09 [Qh 2d]
cobrik23: raises $3 to $4
HITYESCA: folds 
matiko09: folds 
lydia12345: folds 
deadkiller1: calls $4
nickreason17: folds 
rene1984tsv: calls $4
JACQUILF: folds 
Moszes360: folds 
*** FLOP *** [7d Ah 8h]
cobrik23: checks 
deadkiller1: bets $8.46
rene1984tsv: calls $8.46
cobrik23: folds 
*** TURN *** [7d Ah 8h] [8s]
deadkiller1: bets $28
rene1984tsv: folds 
Uncalled bet ($28) returned to deadkiller1
deadkiller1 collected $28.90 from pot
deadkiller1: doesn't show hand 
*** SUMMARY ***
Total pot $30.42 | Rake $1.52 
Board [7d Ah 8h 8s]
Seat 1: cobrik23 folded on the Flop
Seat 2: HITYESCA folded before Flop (didn't bet)
Seat 3: matiko09 folded before Flop (didn't bet)
Seat 4: lydia12345 folded before Flop (didn't bet)
Seat 5: deadkiller1 collected ($28.90)
Seat 6: nickreason17 folded before Flop (didn't bet)
Seat 7: rene1984tsv (button) folded on the Turn
Seat 8: JACQUILF (small blind) folded before Flop
Seat 9: Moszes360 (big blind) folded before Flop





PokerStars Hand #153502034837:  Hold'em No Limit ($0.50/$1.00 USD) - 2016/05/18 20:26:16 CET [2016/05/18 14:26:16 ET]
Table 'Saiph II' 9-max Seat #7 is the button
Seat 1: MAARKKKK ($73.66 in chips) 
Seat 2: matiko09 ($100 in chips) 
Seat 4: deadkiller1 ($104.12 in chips) 
Seat 5: cobrik23 ($71.48 in chips) 
Seat 6: LadyMaCe86 ($102.62 in chips) 
Seat 7: nickreason17 ($133.97 in chips) 
Seat 8: vanilica ($100 in chips) 
Seat 9: HITYESCA ($100 in chips) 
vanilica: posts small blind $0.50
HITYESCA: posts big blind $1
*** HOLE CARDS ***
Dealt to matiko09 [Qd Qh]
MAARKKKK: folds 
matiko09: raises $2 to $3
deadkiller1: folds 
cobrik23: folds 
LadyMaCe86: folds 
nickreason17: folds 
vanilica: folds 
HITYESCA: folds 
Uncalled bet ($2) returned to matiko09
matiko09 collected $2.50 from pot
matiko09: doesn't show hand 
*** SUMMARY ***
Total pot $2.50 | Rake $0 
Seat 1: MAARKKKK folded before Flop (didn't bet)
Seat 2: matiko09 collected ($2.50)
Seat 4: deadkiller1 folded before Flop (didn't bet)
Seat 5: cobrik23 folded before Flop (didn't bet)
Seat 6: LadyMaCe86 folded before Flop (didn't bet)
Seat 7: nickreason17 (button) folded before Flop (didn't bet)
Seat 8: vanilica (small blind) folded before Flop
Seat 9: HITYESCA (big blind) folded before Flop





PokerStars Hand #153502035365:  Hold'em No Limit ($0.50/$1.00 USD) - 2016/05/18 20:26:17 CET [2016/05/18 14:26:17 ET]
Table 'Pandora' 9-max Seat #8 is the button
Seat 1: deadkiller1 ($138.02 in chips) 
Seat 2: fack_vi ($74.12 in chips) 
Seat 3: tipner ($114.02 in chips) 
Seat 4: mooose100 ($106.46 in chips) 
Seat 7: lydia12345 ($107.32 in chips) 
Seat 8: matiko09 ($100 in chips) 
Seat 9: oscarleon ($114.48 in chips) 
oscarleon: posts small blind $0.50
deadkiller1: posts big blind $1
*** HOLE CARDS ***
Dealt to matiko09 [As 6h]
fack_vi: folds 
Mulgraver25 leaves the table
tipner: folds 
mooose100: folds 
lydia12345: folds 
matiko09: raises $1.27 to $2.27
oscarleon: folds 
deadkiller1: folds 
Uncalled bet ($1.27) returned to matiko09
matiko09 collected $2.50 from pot
matiko09: doesn't show hand 
*** SUMMARY ***
Total pot $2.50 | Rake $0 
Seat 1: deadkiller1 (big blind) folded before Flop
Seat 2: fack_vi folded before Flop (didn't bet)
Seat 3: tipner folded before Flop (didn't bet)
Seat 4: mooose100 folded before Flop (didn't bet)
Seat 7: lydia12345 folded before Flop (didn't bet)
Seat 8: matiko09 (button) collected ($2.50)
Seat 9: oscarleon (small blind) folded before Flop





PokerStars Hand #153502036241:  Hold'em No Limit ($0.50/$1.00 USD) - 2016/05/18 20:26:18 CET [2016/05/18 14:26:18 ET]
Table 'Kayala' 9-max Seat #1 is the button
Seat 1: deadkiller1 ($107.90 in chips) 
Seat 2: Oelie7 ($109.43 in chips) 
Seat 3: matiko09 ($100 in chips) 
Seat 4: HITYESCA ($100 in chips) 
Seat 5: tipner ($100 in chips) 
Seat 6: lydia12345 ($118.94 in chips) 
Seat 7: nickreason17 ($110.11 in chips) 
Seat 8: cobrik23 ($89.54 in chips) 
Seat 9: altunaelisa ($69.60 in chips) 
Oelie7: posts small blind $0.50
matiko09: posts big blind $1
*** HOLE CARDS ***
Dealt to matiko09 [9d 4d]
HITYESCA: folds 
tipner: folds 
lydia12345: folds 
nickreason17: folds 
cobrik23: folds 
altunaelisa: folds 
deadkiller1: raises $1.50 to $2.50
Oelie7: folds 
matiko09: folds 
Uncalled bet ($1.50) returned to deadkiller1
deadkiller1 collected $2.50 from pot
deadkiller1: doesn't show hand 
*** SUMMARY ***
Total pot $2.50 | Rake $0 
Seat 1: deadkiller1 (button) collected ($2.50)
Seat 2: Oelie7 (small blind) folded before Flop
Seat 3: matiko09 (big blind) folded before Flop
Seat 4: HITYESCA folded before Flop (didn't bet)
Seat 5: tipner folded before Flop (didn't bet)
Seat 6: lydia12345 folded before Flop (didn't bet)
Seat 7: nickreason17 folded before Flop (didn't bet)
Seat 8: cobrik23 folded before Flop (didn't bet)
Seat 9: altunaelisa folded before Flop (didn't bet)





PokerStars Hand #153502042324:  Hold'em No Limit ($0.50/$1.00 USD) - 2016/05/18 20:26:25 CET [2016/05/18 14:26:25 ET]
Table 'Erida II' 9-max Seat #5 is the button
Seat 1: vanilica ($100 in chips) 
Seat 2: cobrik23 ($95.50 in chips) 
Seat 3: Kelvin sai ($101.78 in chips) 
Seat 4: FLQHenrici ($104.12 in chips) 
Seat 5: Moszes360 ($100 in chips) 
Seat 6: deadkiller1 ($154.36 in chips) 
Seat 7: matiko09 ($101.50 in chips) 
Seat 9: sanr23 ($102.40 in chips) 
deadkiller1: posts small blind $0.50
matiko09: posts big blind $1
*** HOLE CARDS ***
Dealt to matiko09 [8h 5d]
sanr23: folds 
vanilica: folds 
cobrik23: folds 
Kelvin sai: raises $1 to $2
FLQHenrici: folds 
Moszes360: folds 
deadkiller1: folds 
matiko09: folds 
Uncalled bet ($1) returned to Kelvin sai
Kelvin sai collected $2.50 from pot
Kelvin sai: doesn't show hand 
*** SUMMARY ***
Total pot $2.50 | Rake $0 
Seat 1: vanilica folded before Flop (didn't bet)
Seat 2: cobrik23 folded before Flop (didn't bet)
Seat 3: Kelvin sai collected ($2.50)
Seat 4: FLQHenrici folded before Flop (didn't bet)
Seat 5: Moszes360 (button) folded before Flop (didn't bet)
Seat 6: deadkiller1 (small blind) folded before Flop
Seat 7: matiko09 (big blind) folded before Flop
Seat 9: sanr23 folded before Flop (didn't bet)





PokerStars Hand #153502047082:  Hold'em No Limit ($0.50/$1.00 USD) - 2016/05/18 20:26:31 CET [2016/05/18 14:26:31 ET]
Table 'Abetti II' 9-max Seat #8 is the button
Seat 1: matiko09 ($131.08 in chips) 
Seat 2: Bimaxa ($124.34 in chips) 
Seat 3: cobrik23 ($143.13 in chips) 
Seat 4: ipashutapkom ($40 in chips) 
Seat 6: I The King I ($154.89 in chips) 
Seat 7: nickreason17 ($133.46 in chips) 
Seat 8: roadster683 ($68.46 in chips) 
Seat 9: lydia12345 ($257.53 in chips) 
lydia12345: posts small blind $0.50
matiko09: posts big blind $1
*** HOLE CARDS ***
Dealt to matiko09 [5h Ts]
Bimaxa: folds 
cobrik23: raises $3 to $4
ipashutapkom: raises $6 to $10
I The King I: folds 
nickreason17: folds 
roadster683: folds 
lydia12345: folds 
matiko09: folds 
cobrik23: folds 
Uncalled bet ($6) returned to ipashutapkom
ipashutapkom collected $9.50 from pot
ipashutapkom: doesn't show hand 
*** SUMMARY ***
Total pot $9.50 | Rake $0 
Seat 1: matiko09 (big blind) folded before Flop
Seat 2: Bimaxa folded before Flop (didn't bet)
Seat 3: cobrik23 folded before Flop
Seat 4: ipashutapkom collected ($9.50)
Seat 6: I The King I folded before Flop (didn't bet)
Seat 7: nickreason17 folded before Flop (didn't bet)
Seat 8: roadster683 (button) folded before Flop (didn't bet)
Seat 9: lydia12345 (small blind) folded before Flop





PokerStars Hand #153502052928:  Hold'em No Limit ($0.50/$1.00 USD) - 2016/05/18 20:26:37 CET [2016/05/18 14:26:37 ET]
Table 'Saiph II' 9-max Seat #8 is the button
Seat 1: MAARKKKK ($73.66 in chips) 
Seat 2: matiko09 ($101.50 in chips) 
Seat 4: deadkiller1 ($104.12 in chips) 
Seat 5: cobrik23 ($71.48 in chips) 
Seat 6: LadyMaCe86 ($102.62 in chips) 
Seat 7: nickreason17 ($133.97 in chips) 
Seat 8: vanilica ($100 in chips) 
Seat 9: HITYESCA ($100 in chips) 
HITYESCA: posts small blind $0.50
MAARKKKK: posts big blind $1
*** HOLE CARDS ***
Dealt to matiko09 [5h Ah]
matiko09: folds 
deadkiller1: folds 
cobrik23: folds 
LadyMaCe86: folds 
nickreason17: folds 
vanilica: folds 
HITYESCA: folds 
Uncalled bet ($0.50) returned to MAARKKKK
MAARKKKK collected $1 from pot
*** SUMMARY ***
Total pot $1 | Rake $0 
Seat 1: MAARKKKK (big blind) collected ($1)
Seat 2: matiko09 folded before Flop (didn't bet)
Seat 4: deadkiller1 folded before Flop (didn't bet)
Seat 5: cobrik23 folded before Flop (didn't bet)
Seat 6: LadyMaCe86 folded before Flop (didn't bet)
Seat 7: nickreason17 folded before Flop (didn't bet)
Seat 8: vanilica (button) folded before Flop (didn't bet)
Seat 9: HITYESCA (small blind) folded before Flop





PokerStars Hand #153502059554:  Hold'em No Limit ($0.50/$1.00 USD) - 2016/05/18 20:26:45 CET [2016/05/18 14:26:45 ET]
Table 'Pandora' 9-max Seat #9 is the button
Seat 1: deadkiller1 ($137.02 in chips) 
Seat 2: fack_vi ($74.12 in chips) 
Seat 3: tipner ($114.02 in chips) 
Seat 4: mooose100 ($106.46 in chips) 
Seat 7: lydia12345 ($107.32 in chips) 
Seat 8: matiko09 ($101.50 in chips) 
Seat 9: oscarleon ($113.98 in chips) 
deadkiller1: posts small blind $0.50
fack_vi: posts big blind $1
*** HOLE CARDS ***
Dealt to matiko09 [2s 8d]
tipner: folds 
mooose100: folds 
lydia12345: folds 
matiko09: folds 
oscarleon: folds 
deadkiller1: raises $1.50 to $2.50
fack_vi: calls $1.50
*** FLOP *** [Ts Kd 7h]
Moszes360 joins the table at seat #6 
deadkiller1: checks 
fack_vi: checks 
*** TURN *** [Ts Kd 7h] [2c]
deadkiller1: checks 
fack_vi: checks 
*** RIVER *** [Ts Kd 7h 2c] [Qd]
deadkiller1: checks 
fack_vi: bets $1.50
deadkiller1: folds 
Uncalled bet ($1.50) returned to fack_vi
fack_vi collected $4.75 from pot
fack_vi: doesn't show hand 
*** SUMMARY ***
Total pot $5 | Rake $0.25 
Board [Ts Kd 7h 2c Qd]
Seat 1: deadkiller1 (small blind) folded on the River
Seat 2: fack_vi (big blind) collected ($4.75)
Seat 3: tipner folded before Flop (didn't bet)
Seat 4: mooose100 folded before Flop (didn't bet)
Seat 7: lydia12345 folded before Flop (didn't bet)
Seat 8: matiko09 folded before Flop (didn't bet)
Seat 9: oscarleon (button) folded before Flop (didn't bet)





PokerStars Hand #153502067540:  Hold'em No Limit ($0.50/$1.00 USD) - 2016/05/18 20:26:54 CET [2016/05/18 14:26:54 ET]
Table 'Erida II' 9-max Seat #6 is the button
Seat 1: vanilica ($100 in chips) 
Seat 2: cobrik23 ($95.50 in chips) 
Seat 3: Kelvin sai ($103.28 in chips) 
Seat 4: FLQHenrici ($104.12 in chips) 
Seat 5: Moszes360 ($100 in chips) 
Seat 6: deadkiller1 ($153.86 in chips) 
Seat 7: matiko09 ($100.50 in chips) 
Seat 9: sanr23 ($102.40 in chips) 
matiko09: posts small blind $0.50
sanr23: posts big blind $1
*** HOLE CARDS ***
Dealt to matiko09 [6d Ts]
vanilica: folds 
cobrik23: folds 
Kelvin sai: folds 
FLQHenrici: folds 
Moszes360: raises $1.10 to $2.10
deadkiller1: folds 
matiko09: folds 
sanr23: folds 
Uncalled bet ($1.10) returned to Moszes360
Moszes360 collected $2.50 from pot
Moszes360: doesn't show hand 
*** SUMMARY ***
Total pot $2.50 | Rake $0 
Seat 1: vanilica folded before Flop (didn't bet)
Seat 2: cobrik23 folded before Flop (didn't bet)
Seat 3: Kelvin sai folded before Flop (didn't bet)
Seat 4: FLQHenrici folded before Flop (didn't bet)
Seat 5: Moszes360 collected ($2.50)
Seat 6: deadkiller1 (button) folded before Flop (didn't bet)
Seat 7: matiko09 (small blind) folded before Flop
Seat 9: sanr23 (big blind) folded before Flop





PokerStars Hand #153502068234:  Hold'em No Limit ($1/$2 USD) - 2016/05/18 20:26:55 CET [2016/05/18 14:26:55 ET]
Table 'Chlosinde' 9-max Seat #7 is the button
Seat 1: ersevi6 ($153 in chips) 
Seat 2: lydia12345 ($201.40 in chips) 
Seat 3: matiko09 ($231.16 in chips) 
Seat 4: FREDY BULLIT ($234.85 in chips) 
Seat 5: tepi_guy ($838.25 in chips) 
Seat 6: tipner ($200 in chips) 
Seat 7: donald0404 ($252.71 in chips) 
Seat 8: sanducu_eu ($210.03 in chips) 
Seat 9: Tey113 ($581.56 in chips) 
sanducu_eu: posts small blind $1
Tey113: posts big blind $2
*** HOLE CARDS ***
Dealt to matiko09 [8h Kd]
ersevi6: folds 
lydia12345: folds 
matiko09: folds 
FREDY BULLIT: folds 
tepi_guy has timed out
tepi_guy: folds 
tipner: raises $2 to $4
donald0404: calls $4
sanducu_eu: folds 
Tey113: calls $2
*** FLOP *** [2c Td 5h]
Tey113: checks 
tipner: bets $8
donald0404: calls $8
Tey113: calls $8
*** TURN *** [2c Td 5h] [7s]
Tey113: checks 
tipner: bets $26
donald0404: folds 
Tey113: calls $26
*** RIVER *** [2c Td 5h 7s] [Jd]
Tey113: checks 
tipner: checks 
*** SHOW DOWN ***
Tey113: shows [2h 4d] (a pair of Deuces)
tipner: shows [Qh Ts] (a pair of Tens)
tipner collected $86.25 from pot
*** SUMMARY ***
Total pot $89 | Rake $2.75 
Board [2c Td 5h 7s Jd]
Seat 1: ersevi6 folded before Flop (didn't bet)
Seat 2: lydia12345 folded before Flop (didn't bet)
Seat 3: matiko09 folded before Flop (didn't bet)
Seat 4: FREDY BULLIT folded before Flop (didn't bet)
Seat 5: tepi_guy folded before Flop (didn't bet)
Seat 6: tipner showed [Qh Ts] and won ($86.25) with a pair of Tens
Seat 7: donald0404 (button) folded on the Turn
Seat 8: sanducu_eu (small blind) folded before Flop
Seat 9: Tey113 (big blind) showed [2h 4d] and lost with a pair of Deuces





PokerStars Hand #153502068795:  Hold'em No Limit ($0.50/$1.00 USD) - 2016/05/18 20:26:56 CET [2016/05/18 14:26:56 ET]
Table 'Kayala' 9-max Seat #2 is the button
Seat 1: deadkiller1 ($109.40 in chips) 
Seat 2: Oelie7 ($108.93 in chips) 
Seat 3: matiko09 ($100 in chips) 
Seat 4: HITYESCA ($100 in chips) 
Seat 5: tipner ($100 in chips) 
Seat 6: lydia12345 ($118.94 in chips) 
Seat 7: nickreason17 ($110.11 in chips) 
Seat 8: cobrik23 ($89.54 in chips) 
Seat 9: altunaelisa ($69.60 in chips) 
matiko09: posts small blind $0.50
HITYESCA: posts big blind $1
*** HOLE CARDS ***
Dealt to matiko09 [Ah 3d]
tipner: folds 
lydia12345: folds 
nickreason17: raises $1.50 to $2.50
cobrik23: folds 
altunaelisa: calls $2.50
deadkiller1: folds 
Oelie7: raises $9 to $11.50
matiko09: folds 
HITYESCA: folds 
nickreason17: folds 
altunaelisa: calls $9
*** FLOP *** [8d Ts 8s]
altunaelisa: bets $9
Oelie7: calls $9
*** TURN *** [8d Ts 8s] [Qc]
altunaelisa: bets $49.10 and is all-in
Oelie7: calls $49.10
*** RIVER *** [8d Ts 8s Qc] [Kh]
*** SHOW DOWN ***
altunaelisa: shows [Qh 9h] (two pair, Queens and Eights)
Oelie7: shows [Kc Ks] (a full house, Kings full of Eights)
Oelie7 collected $140.70 from pot
*** SUMMARY ***
Total pot $143.20 | Rake $2.50 
Board [8d Ts 8s Qc Kh]
Seat 1: deadkiller1 folded before Flop (didn't bet)
Seat 2: Oelie7 (button) showed [Kc Ks] and won ($140.70) with a full house, Kings full of Eights
Seat 3: matiko09 (small blind) folded before Flop
Seat 4: HITYESCA (big blind) folded before Flop
Seat 5: tipner folded before Flop (didn't bet)
Seat 6: lydia12345 folded before Flop (didn't bet)
Seat 7: nickreason17 folded before Flop
Seat 8: cobrik23 folded before Flop (didn't bet)
Seat 9: altunaelisa showed [Qh 9h] and lost with two pair, Queens and Eights





PokerStars Hand #153502083439:  Hold'em No Limit (€0.50/€1.00 EUR) - 2016/05/18 20:27:13 CET [2016/05/18 14:27:13 ET]
Table 'Pallas II' 9-max Seat #2 is the button
Seat 1: deadkiller1 (€100 in chips) 
Seat 2: matiko09 (€202.49 in chips) 
Seat 3: Vikulja1993 (€100 in chips) 
Seat 4: torkkdnm (€148.83 in chips) 
Seat 5: cobrik23 (€69.24 in chips) 
Seat 6: HITYESCA (€109.62 in chips) 
Seat 8: lydia12345 (€100 in chips) 
Seat 9: stijner1986 (€145.33 in chips) 
Vikulja1993: posts small blind €0.50
torkkdnm: posts big blind €1
*** HOLE CARDS ***
Dealt to matiko09 [3c 2c]
cobrik23: folds 
HITYESCA: folds 
lydia12345: folds 
stijner1986: calls €1
deadkiller1: folds 
matiko09: folds 
Vikulja1993: folds 
torkkdnm: checks 
*** FLOP *** [8c 6h 2d]
torkkdnm: bets €2
stijner1986: folds 
Uncalled bet (€2) returned to torkkdnm
torkkdnm collected €2.38 from pot
*** SUMMARY ***
Total pot €2.50 | Rake €0.12 
Board [8c 6h 2d]
Seat 1: deadkiller1 folded before Flop (didn't bet)
Seat 2: matiko09 (button) folded before Flop (didn't bet)
Seat 3: Vikulja1993 (small blind) folded before Flop
Seat 4: torkkdnm (big blind) collected (€2.38)
Seat 5: cobrik23 folded before Flop (didn't bet)
Seat 6: HITYESCA folded before Flop (didn't bet)
Seat 8: lydia12345 folded before Flop (didn't bet)
Seat 9: stijner1986 folded on the Flop





PokerStars Hand #153502084463:  Hold'em No Limit ($0.50/$1.00 USD) - 2016/05/18 20:27:15 CET [2016/05/18 14:27:15 ET]
Table 'Tatjana III' 9-max Seat #8 is the button
Seat 1: cobrik23 ($44.14 in chips) 
Seat 2: HITYESCA ($125.32 in chips) 
Seat 3: matiko09 ($188.34 in chips) 
Seat 4: lydia12345 ($116.90 in chips) 
Seat 5: deadkiller1 ($116.44 in chips) 
Seat 6: nickreason17 ($127.62 in chips) 
Seat 7: rene1984tsv ($157.19 in chips) 
Seat 8: JACQUILF ($110.30 in chips) 
Seat 9: Moszes360 ($101 in chips) 
Moszes360: posts small blind $0.50
cobrik23: posts big blind $1
*** HOLE CARDS ***
Dealt to matiko09 [5c 2c]
HITYESCA: folds 
matiko09: folds 
lydia12345: folds 
deadkiller1: folds 
nickreason17: folds 
rene1984tsv: calls $1
JACQUILF: folds 
Moszes360: calls $0.50
cobrik23: checks 
*** FLOP *** [4d 6c Ts]
Moszes360: checks 
cobrik23: bets $2
rene1984tsv: calls $2
Moszes360: folds 
*** TURN *** [4d 6c Ts] [7d]
cobrik23: bets $6.65
rene1984tsv: folds 
Uncalled bet ($6.65) returned to cobrik23
cobrik23 collected $6.65 from pot
cobrik23: doesn't show hand 
*** SUMMARY ***
Total pot $7 | Rake $0.35 
Board [4d 6c Ts 7d]
Seat 1: cobrik23 (big blind) collected ($6.65)
Seat 2: HITYESCA folded before Flop (didn't bet)
Seat 3: matiko09 folded before Flop (didn't bet)
Seat 4: lydia12345 folded before Flop (didn't bet)
Seat 5: deadkiller1 folded before Flop (didn't bet)
Seat 6: nickreason17 folded before Flop (didn't bet)
Seat 7: rene1984tsv folded on the Turn
Seat 8: JACQUILF (button) folded before Flop (didn't bet)
Seat 9: Moszes360 (small blind) folded on the Flop





PokerStars Hand #153502085875:  Hold'em No Limit ($1/$2 USD) - 2016/05/18 20:27:16 CET [2016/05/18 14:27:16 ET]
Table 'Letaba' 9-max Seat #2 is the button
Seat 2: staruk669 ($41.43 in chips) 
Seat 3: ersevi6 ($254.85 in chips) 
Seat 4: matiko09 ($200 in chips) 
Seat 5: tipner ($200 in chips) 
Seat 6: donald0404 ($324.19 in chips) 
Seat 8: lydia12345 ($200 in chips) 
Seat 9: tepi_guy ($222.75 in chips) 
ersevi6: posts small blind $1
matiko09: posts big blind $2
moshmachine: sits out 
vanilica: sits out 
*** HOLE CARDS ***
Dealt to matiko09 [2d 7d]
tipner: folds 
donald0404: raises $4 to $6
lydia12345: folds 
tepi_guy: raises $12 to $18
staruk669: raises $23.43 to $41.43 and is all-in
ersevi6: folds 
matiko09: folds 
donald0404: folds 
tepi_guy: calls $23.43
*** FLOP *** [Js 3d Td]
*** TURN *** [Js 3d Td] [7h]
*** RIVER *** [Js 3d Td 7h] [Ac]
*** SHOW DOWN ***
tepi_guy: shows [Qd Ad] (a pair of Aces)
staruk669: shows [Ah 5h] (a pair of Aces - lower kicker)
tepi_guy collected $89.11 from pot
*** SUMMARY ***
Total pot $91.86 | Rake $2.75 
Board [Js 3d Td 7h Ac]
Seat 2: staruk669 (button) showed [Ah 5h] and lost with a pair of Aces
Seat 3: ersevi6 (small blind) folded before Flop
Seat 4: matiko09 (big blind) folded before Flop
Seat 5: tipner folded before Flop (didn't bet)
Seat 6: donald0404 folded before Flop
Seat 8: lydia12345 folded before Flop (didn't bet)
Seat 9: tepi_guy showed [Qd Ad] and won ($89.11) with a pair of Aces





PokerStars Hand #153502086599:  Hold'em No Limit ($0.50/$1.00 USD) - 2016/05/18 20:27:17 CET [2016/05/18 14:27:17 ET]
Table 'Abetti II' 9-max Seat #9 is the button
Seat 1: matiko09 ($130.08 in chips) 
Seat 3: cobrik23 ($139.13 in chips) 
Seat 4: ipashutapkom ($45.50 in chips) 
Seat 6: I The King I ($154.89 in chips) 
Seat 7: nickreason17 ($133.46 in chips) 
Seat 8: roadster683 ($68.46 in chips) 
Seat 9: lydia12345 ($257.03 in chips) 
matiko09: posts small blind $0.50
Bimaxa: is sitting out 
Bimaxa leaves the table
cobrik23: posts big blind $1
*** HOLE CARDS ***
Dealt to matiko09 [Jh Qc]
Vikulja1993 joins the table at seat #2 
ipashutapkom: folds 
I The King I: folds 
nickreason17: folds 
roadster683: raises $1 to $2
lydia12345: folds 
matiko09: folds 
cobrik23: calls $1
*** FLOP *** [Qh 4h 2d]
cobrik23: bets $2.85
roadster683: calls $2.85
*** TURN *** [Qh 4h 2d] [9c]
cobrik23: checks 
roadster683: checks 
*** RIVER *** [Qh 4h 2d 9c] [6c]
cobrik23: checks 
roadster683: bets $5
cobrik23: folds 
Uncalled bet ($5) returned to roadster683
roadster683 collected $9.69 from pot
roadster683: doesn't show hand 
*** SUMMARY ***
Total pot $10.20 | Rake $0.51 
Board [Qh 4h 2d 9c 6c]
Seat 1: matiko09 (small blind) folded before Flop
Seat 3: cobrik23 (big blind) folded on the River
Seat 4: ipashutapkom folded before Flop (didn't bet)
Seat 6: I The King I folded before Flop (didn't bet)
Seat 7: nickreason17 folded before Flop (didn't bet)
Seat 8: roadster683 collected ($9.69)
Seat 9: lydia12345 (button) folded before Flop (didn't bet)





PokerStars Hand #153502098886:  Hold'em No Limit ($0.50/$1.00 USD) - 2016/05/18 20:27:31 CET [2016/05/18 14:27:31 ET]
Table 'Suevia' 9-max Seat #6 is the button
Seat 1: Bimaxa ($101.50 in chips) 
Seat 2: deadkiller1 ($100 in chips) 
Seat 3: matiko09 ($100 in chips) 
Seat 4: HITYESCA ($100 in chips) 
Seat 6: torkkdnm ($125.66 in chips) 
Seat 7: cobrik23 ($70.80 in chips) 
Seat 8: ama58 ($59.86 in chips) 
Seat 9: oscarleon ($137.87 in chips) 
cobrik23: posts small blind $0.50
ama58: posts big blind $1
*** HOLE CARDS ***
Dealt to matiko09 [4c Ac]
oscarleon: folds 
Bimaxa: folds 
deadkiller1: folds 
matiko09: raises $2 to $3
HITYESCA: folds 
torkkdnm: folds 
cobrik23: raises $7 to $10
ama58: calls $9
matiko09: folds 
*** FLOP *** [3s Th 3d]
cobrik23: bets $14
ama58: folds 
Uncalled bet ($14) returned to cobrik23
cobrik23 collected $21.85 from pot
cobrik23: doesn't show hand 
*** SUMMARY ***
Total pot $23 | Rake $1.15 
Board [3s Th 3d]
Seat 1: Bimaxa folded before Flop (didn't bet)
Seat 2: deadkiller1 folded before Flop (didn't bet)
Seat 3: matiko09 folded before Flop
Seat 4: HITYESCA folded before Flop (didn't bet)
Seat 6: torkkdnm (button) folded before Flop (didn't bet)
Seat 7: cobrik23 (small blind) collected ($21.85)
Seat 8: ama58 (big blind) folded on the Flop
Seat 9: oscarleon folded before Flop (didn't bet)





PokerStars Hand #153502106874:  Hold'em No Limit ($0.50/$1.00 USD) - 2016/05/18 20:27:41 CET [2016/05/18 14:27:41 ET]
Table 'Erida II' 9-max Seat #7 is the button
Seat 1: vanilica ($100 in chips) 
Seat 2: cobrik23 ($95.50 in chips) 
Seat 3: Kelvin sai ($103.28 in chips) 
Seat 4: FLQHenrici ($104.12 in chips) 
Seat 5: Moszes360 ($101.50 in chips) 
Seat 6: deadkiller1 ($153.86 in chips) 
Seat 7: matiko09 ($100 in chips) 
Seat 9: sanr23 ($101.40 in chips) 
sanr23: posts small blind $0.50
vanilica: posts big blind $1
*** HOLE CARDS ***
Dealt to matiko09 [9c 6d]
cobrik23: folds 
Kelvin sai: raises $2 to $3
FLQHenrici: folds 
Moszes360: folds 
deadkiller1: folds 
matiko09: folds 
sanr23: calls $2.50
vanilica: calls $2
*** FLOP *** [8s 3s 9d]
sanr23: checks 
vanilica: checks 
Kelvin sai: bets $5
rate8 leaves the table
sanr23: calls $5
vanilica: folds 
*** TURN *** [8s 3s 9d] [Qc]
sanr23: checks 
Kelvin sai: bets $15
Kihog joins the table at seat #8 
sanr23: raises $22.50 to $37.50
Kelvin sai: calls $22.50
*** RIVER *** [8s 3s 9d Qc] [2c]
sanr23: checks 
Kelvin sai: checks 
*** SHOW DOWN ***
sanr23: shows [Jd Ks] (high card King)
Kelvin sai: shows [Ad Ah] (a pair of Aces)
Kelvin sai collected $91.50 from pot
*** SUMMARY ***
Total pot $94 | Rake $2.50 
Board [8s 3s 9d Qc 2c]
Seat 1: vanilica (big blind) folded on the Flop
Seat 2: cobrik23 folded before Flop (didn't bet)
Seat 3: Kelvin sai showed [Ad Ah] and won ($91.50) with a pair of Aces
Seat 4: FLQHenrici folded before Flop (didn't bet)
Seat 5: Moszes360 folded before Flop (didn't bet)
Seat 6: deadkiller1 folded before Flop (didn't bet)
Seat 7: matiko09 (button) folded before Flop (didn't bet)
Seat 9: sanr23 (small blind) showed [Jd Ks] and lost with high card King





PokerStars Hand #153502108770:  Hold'em No Limit ($0.50/$1.00 USD) - 2016/05/18 20:27:43 CET [2016/05/18 14:27:43 ET]
Table 'Pandora' 9-max Seat #1 is the button
Seat 1: deadkiller1 ($134.52 in chips) 
Seat 2: fack_vi ($76.37 in chips) 
Seat 3: tipner ($114.02 in chips) 
Seat 4: mooose100 ($106.46 in chips) 
Seat 7: lydia12345 ($107.32 in chips) 
Seat 8: matiko09 ($101.50 in chips) 
Seat 9: oscarleon ($113.98 in chips) 
fack_vi: posts small blind $0.50
tipner: posts big blind $1
Moszes360: sits out 
*** HOLE CARDS ***
Dealt to matiko09 [Ks 9s]
mooose100: calls $1
lydia12345: folds 
matiko09: raises $4 to $5
oscarleon: folds 
deadkiller1: folds 
fack_vi: folds 
tipner: folds 
mooose100: folds 
Uncalled bet ($4) returned to matiko09
matiko09 collected $3.50 from pot
matiko09: doesn't show hand 
*** SUMMARY ***
Total pot $3.50 | Rake $0 
Seat 1: deadkiller1 (button) folded before Flop (didn't bet)
Seat 2: fack_vi (small blind) folded before Flop
Seat 3: tipner (big blind) folded before Flop
Seat 4: mooose100 folded before Flop
Seat 7: lydia12345 folded before Flop (didn't bet)
Seat 8: matiko09 collected ($3.50)
Seat 9: oscarleon folded before Flop (didn't bet)





PokerStars Hand #153502119263:  Hold'em No Limit ($0.50/$1.00 USD) - 2016/05/18 20:27:55 CET [2016/05/18 14:27:55 ET]
Table 'Terpsichore' 9-max Seat #6 is the button
Seat 1: oscarleon ($153.75 in chips) 
Seat 2: Moszes360 ($108.46 in chips) 
Seat 4: torkkdnm ($127.69 in chips) 
Seat 5: I The King I ($138.29 in chips) 
Seat 6: pyfyezi2016 ($93.63 in chips) 
Seat 7: cobrik23 ($100.50 in chips) 
Seat 8: matiko09 ($100 in chips) 
Seat 9: Quangis ($62.62 in chips) 
cobrik23: posts small blind $0.50
matiko09: posts big blind $1
blufthenuts: sits out 
*** HOLE CARDS ***
Dealt to matiko09 [7s 6h]
Quangis: folds 
oscarleon: folds 
Moszes360: folds 
torkkdnm: folds 
I The King I: raises $1.50 to $2.50
pyfyezi2016: folds 
cobrik23: folds 
matiko09: folds 
Uncalled bet ($1.50) returned to I The King I
I The King I collected $2.50 from pot
I The King I: doesn't show hand 
*** SUMMARY ***
Total pot $2.50 | Rake $0 
Seat 1: oscarleon folded before Flop (didn't bet)
Seat 2: Moszes360 folded before Flop (didn't bet)
Seat 4: torkkdnm folded before Flop (didn't bet)
Seat 5: I The King I collected ($2.50)
Seat 6: pyfyezi2016 (button) folded before Flop (didn't bet)
Seat 7: cobrik23 (small blind) folded before Flop
Seat 8: matiko09 (big blind) folded before Flop
Seat 9: Quangis folded before Flop (didn't bet)





PokerStars Hand #153502124645:  Hold'em No Limit (€0.50/€1.00 EUR) - 2016/05/18 20:28:01 CET [2016/05/18 14:28:01 ET]
Table 'Pallas II' 9-max Seat #3 is the button
Seat 1: deadkiller1 (€100 in chips) 
Seat 2: matiko09 (€202.49 in chips) 
Seat 3: Vikulja1993 (€100 in chips) 
Seat 4: torkkdnm (€150.21 in chips) 
Seat 5: cobrik23 (€69.24 in chips) 
Seat 6: HITYESCA (€109.62 in chips) 
Seat 8: lydia12345 (€100 in chips) 
Seat 9: stijner1986 (€144.33 in chips) 
torkkdnm: posts small blind €0.50
cobrik23: posts big blind €1
*** HOLE CARDS ***
Dealt to matiko09 [3d Jc]
HITYESCA: raises €2 to €3
lydia12345: folds 
stijner1986: folds 
deadkiller1: folds 
matiko09: folds 
Vikulja1993: raises €6 to €9
torkkdnm: folds 
cobrik23: folds 
HITYESCA: folds 
Uncalled bet (€6) returned to Vikulja1993
Vikulja1993 collected €7.50 from pot
Vikulja1993: doesn't show hand 
*** SUMMARY ***
Total pot €7.50 | Rake €0 
Seat 1: deadkiller1 folded before Flop (didn't bet)
Seat 2: matiko09 folded before Flop (didn't bet)
Seat 3: Vikulja1993 (button) collected (€7.50)
Seat 4: torkkdnm (small blind) folded before Flop
Seat 5: cobrik23 (big blind) folded before Flop
Seat 6: HITYESCA folded before Flop
Seat 8: lydia12345 folded before Flop (didn't bet)
Seat 9: stijner1986 folded before Flop (didn't bet)





PokerStars Hand #153502132245:  Hold'em No Limit ($1/$2 USD) - 2016/05/18 20:28:10 CET [2016/05/18 14:28:10 ET]
Table 'Letaba' 9-max Seat #3 is the button
Seat 3: ersevi6 ($253.85 in chips) 
Seat 4: matiko09 ($200 in chips) 
Seat 6: donald0404 ($318.19 in chips) 
Seat 8: lydia12345 ($200 in chips) 
Seat 9: tepi_guy ($270.43 in chips) 
matiko09: posts small blind $1
tipner: is sitting out 
tipner leaves the table
donald0404: posts big blind $2
moshmachine: sits out 
vanilica: sits out 
*** HOLE CARDS ***
Dealt to matiko09 [Qh 4c]
uonlylive1ce joins the table at seat #5 
lydia12345: folds 
uonlylive1ce leaves the table
Vikulja1993 joins the table at seat #5 
tepi_guy: folds 
ersevi6: folds 
matiko09: folds 
Uncalled bet ($1) returned to donald0404
donald0404 collected $2 from pot
donald0404: doesn't show hand 
*** SUMMARY ***
Total pot $2 | Rake $0 
Seat 3: ersevi6 (button) folded before Flop (didn't bet)
Seat 4: matiko09 (small blind) folded before Flop
Seat 6: donald0404 (big blind) collected ($2)
Seat 8: lydia12345 folded before Flop (didn't bet)
Seat 9: tepi_guy folded before Flop (didn't bet)





PokerStars Hand #153502135612:  Hold'em No Limit ($0.50/$1.00 USD) - 2016/05/18 20:28:14 CET [2016/05/18 14:28:14 ET]
Table 'Pandora' 9-max Seat #2 is the button
Seat 1: deadkiller1 ($134.52 in chips) 
Seat 2: fack_vi ($75.87 in chips) 
Seat 3: tipner ($113.02 in chips) 
Seat 4: mooose100 ($105.46 in chips) 
Seat 7: lydia12345 ($107.32 in chips) 
Seat 8: matiko09 ($104 in chips) 
Seat 9: oscarleon ($113.98 in chips) 
tipner: posts small blind $0.50
mooose100: posts big blind $1
Moszes360: sits out 
*** HOLE CARDS ***
Dealt to matiko09 [9s 5c]
lydia12345: folds 
matiko09: folds 
oscarleon: folds 
deadkiller1: folds 
fack_vi: folds 
tipner: folds 
Uncalled bet ($0.50) returned to mooose100
mooose100 collected $1 from pot
mooose100: doesn't show hand 
*** SUMMARY ***
Total pot $1 | Rake $0 
Seat 1: deadkiller1 folded before Flop (didn't bet)
Seat 2: fack_vi (button) folded before Flop (didn't bet)
Seat 3: tipner (small blind) folded before Flop
Seat 4: mooose100 (big blind) collected ($1)
Seat 7: lydia12345 folded before Flop (didn't bet)
Seat 8: matiko09 folded before Flop (didn't bet)
Seat 9: oscarleon folded before Flop (didn't bet)





PokerStars Hand #153502136716:  Hold'em No Limit ($0.50/$1.00 USD) - 2016/05/18 20:28:15 CET [2016/05/18 14:28:15 ET]
Table 'Tatjana III' 9-max Seat #9 is the button
Seat 1: cobrik23 ($47.79 in chips) 
Seat 2: HITYESCA ($125.32 in chips) 
Seat 3: matiko09 ($188.34 in chips) 
Seat 4: lydia12345 ($116.90 in chips) 
Seat 5: deadkiller1 ($116.44 in chips) 
Seat 6: nickreason17 ($127.62 in chips) 
Seat 7: rene1984tsv ($154.19 in chips) 
Seat 8: JACQUILF ($110.30 in chips) 
Seat 9: Moszes360 ($100 in chips) 
cobrik23: posts small blind $0.50
HITYESCA: posts big blind $1
*** HOLE CARDS ***
Dealt to matiko09 [8c 4h]
matiko09: folds 
lydia12345: folds 
deadkiller1: folds 
nickreason17: folds 
rene1984tsv: raises $2 to $3
JACQUILF: folds 
Moszes360: calls $3
cobrik23: folds 
HITYESCA: folds 
*** FLOP *** [Qc 6d Ad]
rene1984tsv: checks 
Moszes360: checks 
*** TURN *** [Qc 6d Ad] [5c]
rene1984tsv: checks 
Moszes360: bets $6.26
rene1984tsv: folds 
Uncalled bet ($6.26) returned to Moszes360
Moszes360 collected $7.12 from pot
Moszes360: doesn't show hand 
*** SUMMARY ***
Total pot $7.50 | Rake $0.38 
Board [Qc 6d Ad 5c]
Seat 1: cobrik23 (small blind) folded before Flop
Seat 2: HITYESCA (big blind) folded before Flop
Seat 3: matiko09 folded before Flop (didn't bet)
Seat 4: lydia12345 folded before Flop (didn't bet)
Seat 5: deadkiller1 folded before Flop (didn't bet)
Seat 6: nickreason17 folded before Flop (didn't bet)
Seat 7: rene1984tsv folded on the Turn
Seat 8: JACQUILF folded before Flop (didn't bet)
Seat 9: Moszes360 (button) collected ($7.12)





PokerStars Hand #153502140587:  Hold'em No Limit ($0.50/$1.00 USD) - 2016/05/18 20:28:20 CET [2016/05/18 14:28:20 ET]
Table 'Kayala' 9-max Seat #3 is the button
Seat 1: deadkiller1 ($109.40 in chips) 
Seat 2: Oelie7 ($180.03 in chips) 
Seat 3: matiko09 ($100 in chips) 
Seat 4: HITYESCA ($100 in chips) 
Seat 6: lydia12345 ($118.94 in chips) 
Seat 7: nickreason17 ($107.61 in chips) 
Seat 8: cobrik23 ($89.54 in chips) 
HITYESCA: posts small blind $0.50
tipner: is sitting out 
tipner leaves the table
lydia12345: posts big blind $1
*** HOLE CARDS ***
Dealt to matiko09 [3c 4s]
nickreason17: raises $1.50 to $2.50
cobrik23: calls $2.50
altunaelisa leaves the table
deadkiller1: folds 
Vikulja1993 joins the table at seat #9 
Oelie7: calls $2.50
matiko09: folds 
HITYESCA: folds 
lydia12345: folds 
*** FLOP *** [4d 7d 2s]
nickreason17: checks 
rate8 joins the table at seat #5 
cobrik23: checks 
Oelie7: checks 
*** TURN *** [4d 7d 2s] [8h]
nickreason17: bets $5
cobrik23: folds 
Oelie7: folds 
Uncalled bet ($5) returned to nickreason17
nickreason17 collected $8.55 from pot
*** SUMMARY ***
Total pot $9 | Rake $0.45 
Board [4d 7d 2s 8h]
Seat 1: deadkiller1 folded before Flop (didn't bet)
Seat 2: Oelie7 folded on the Turn
Seat 3: matiko09 (button) folded before Flop (didn't bet)
Seat 4: HITYESCA (small blind) folded before Flop
Seat 6: lydia12345 (big blind) folded before Flop
Seat 7: nickreason17 collected ($8.55)
Seat 8: cobrik23 folded on the Turn





PokerStars Hand #153502141411:  Hold'em No Limit ($0.50/$1.00 USD) - 2016/05/18 20:28:21 CET [2016/05/18 14:28:21 ET]
Table 'Abetti II' 9-max Seat #1 is the button
Seat 1: matiko09 ($129.58 in chips) 
Seat 3: cobrik23 ($134.28 in chips) 
Seat 4: ipashutapkom ($45.50 in chips) 
Seat 6: I The King I ($154.89 in chips) 
Seat 7: nickreason17 ($133.46 in chips) 
Seat 8: roadster683 ($73.30 in chips) 
Seat 9: lydia12345 ($257.03 in chips) 
Vikulja1993 will be allowed to play after the button
cobrik23: posts small blind $0.50
ipashutapkom: posts big blind $1
blufthenuts: sits out 
*** HOLE CARDS ***
Dealt to matiko09 [Ac 4d]
I The King I: folds 
nickreason17: raises $1.50 to $2.50
roadster683: folds 
lydia12345: folds 
matiko09: folds 
cobrik23: folds 
ipashutapkom: folds 
Uncalled bet ($1.50) returned to nickreason17
nickreason17 collected $2.50 from pot
*** SUMMARY ***
Total pot $2.50 | Rake $0 
Seat 1: matiko09 (button) folded before Flop (didn't bet)
Seat 3: cobrik23 (small blind) folded before Flop
Seat 4: ipashutapkom (big blind) folded before Flop
Seat 6: I The King I folded before Flop (didn't bet)
Seat 7: nickreason17 collected ($2.50)
Seat 8: roadster683 folded before Flop (didn't bet)
Seat 9: lydia12345 folded before Flop (didn't bet)





PokerStars Hand #153502143386:  Hold'em No Limit ($0.50/$1.00 USD) - 2016/05/18 20:28:23 CET [2016/05/18 14:28:23 ET]
Table 'Terpsichore' 9-max Seat #7 is the button
Seat 1: oscarleon ($153.75 in chips) 
Seat 2: Moszes360 ($108.46 in chips) 
Seat 4: torkkdnm ($127.69 in chips) 
Seat 5: I The King I ($139.79 in chips) 
Seat 6: pyfyezi2016 ($93.63 in chips) 
Seat 7: cobrik23 ($100 in chips) 
Seat 8: matiko09 ($100 in chips) 
Seat 9: Quangis ($62.62 in chips) 
matiko09: posts small blind $0.50
Quangis: posts big blind $1
blufthenuts: sits out 
*** HOLE CARDS ***
Dealt to matiko09 [8h 3c]
oscarleon: folds 
Moszes360: folds 
torkkdnm: folds 
I The King I: folds 
pyfyezi2016: folds 
cobrik23: raises $2 to $3
matiko09: folds 
Quangis: folds 
Uncalled bet ($2) returned to cobrik23
cobrik23 collected $2.50 from pot
cobrik23: doesn't show hand 
*** SUMMARY ***
Total pot $2.50 | Rake $0 
Seat 1: oscarleon folded before Flop (didn't bet)
Seat 2: Moszes360 folded before Flop (didn't bet)
Seat 4: torkkdnm folded before Flop (didn't bet)
Seat 5: I The King I folded before Flop (didn't bet)
Seat 6: pyfyezi2016 folded before Flop (didn't bet)
Seat 7: cobrik23 (button) collected ($2.50)
Seat 8: matiko09 (small blind) folded before Flop
Seat 9: Quangis (big blind) folded before Flop





PokerStars Hand #153502154362:  Hold'em No Limit (€0.50/€1.00 EUR) - 2016/05/18 20:28:36 CET [2016/05/18 14:28:36 ET]
Table 'Pallas II' 9-max Seat #4 is the button
Seat 1: deadkiller1 (€100 in chips) 
Seat 2: matiko09 (€202.49 in chips) 
Seat 3: Vikulja1993 (€104.50 in chips) 
Seat 4: torkkdnm (€149.71 in chips) 
Seat 5: cobrik23 (€68.24 in chips) 
Seat 6: HITYESCA (€106.62 in chips) 
Seat 8: lydia12345 (€100 in chips) 
Seat 9: stijner1986 (€144.33 in chips) 
cobrik23: posts small blind €0.50
HITYESCA: posts big blind €1
rate8: sits out 
*** HOLE CARDS ***
Dealt to matiko09 [4d 5h]
lydia12345: folds 
stijner1986: raises €1 to €2
deadkiller1: folds 
matiko09: folds 
Vikulja1993: raises €5 to €7
torkkdnm: folds 
cobrik23: folds 
HITYESCA: folds 
stijner1986: folds 
Uncalled bet (€5) returned to Vikulja1993
Vikulja1993 collected €5.50 from pot
Vikulja1993: doesn't show hand 
*** SUMMARY ***
Total pot €5.50 | Rake €0 
Seat 1: deadkiller1 folded before Flop (didn't bet)
Seat 2: matiko09 folded before Flop (didn't bet)
Seat 3: Vikulja1993 collected (€5.50)
Seat 4: torkkdnm (button) folded before Flop (didn't bet)
Seat 5: cobrik23 (small blind) folded before Flop
Seat 6: HITYESCA (big blind) folded before Flop
Seat 8: lydia12345 folded before Flop (didn't bet)
Seat 9: stijner1986 folded before Flop





PokerStars Hand #153502162045:  Hold'em No Limit ($1/$2 USD) - 2016/05/18 20:28:44 CET [2016/05/18 14:28:44 ET]
Table 'Letaba' 9-max Seat #4 is the button
Seat 2: staruk669 ($126.14 in chips) 
Seat 3: ersevi6 ($253.85 in chips) 
Seat 4: matiko09 ($200 in chips) 
Seat 6: donald0404 ($319.19 in chips) 
Seat 7: moshmachine ($293.97 in chips) 
Seat 8: lydia12345 ($200 in chips) 
Seat 9: tepi_guy ($270.43 in chips) 
Vikulja1993 will be allowed to play after the button
donald0404: posts small blind $1
moshmachine: posts big blind $2
vanilica: sits out 
*** HOLE CARDS ***
Dealt to matiko09 [3c As]
lydia12345: folds 
tepi_guy: raises $3.40 to $5.40
staruk669: calls $5.40
ersevi6: folds 
matiko09: folds 
donald0404: folds 
moshmachine: folds 
*** FLOP *** [Qs 9h Jd]
tepi_guy: checks 
staruk669: checks 
*** TURN *** [Qs 9h Jd] [8s]
tepi_guy: checks 
staruk669: bets $2
tepi_guy: calls $2
*** RIVER *** [Qs 9h Jd 8s] [8c]
tepi_guy: checks 
staruk669: checks 
*** SHOW DOWN ***
tepi_guy: shows [Tc 9c] (a straight, Eight to Queen)
staruk669: mucks hand 
tepi_guy collected $16.91 from pot
*** SUMMARY ***
Total pot $17.80 | Rake $0.89 
Board [Qs 9h Jd 8s 8c]
Seat 2: staruk669 mucked [7c Ad]
Seat 3: ersevi6 folded before Flop (didn't bet)
Seat 4: matiko09 (button) folded before Flop (didn't bet)
Seat 6: donald0404 (small blind) folded before Flop
Seat 7: moshmachine (big blind) folded before Flop
Seat 8: lydia12345 folded before Flop (didn't bet)
Seat 9: tepi_guy showed [Tc 9c] and won ($16.91) with a straight, Eight to Queen





PokerStars Hand #153502166408:  Hold'em No Limit ($0.50/$1.00 USD) - 2016/05/18 20:28:50 CET [2016/05/18 14:28:50 ET]
Table 'Abetti II' 9-max Seat #3 is the button
Seat 1: matiko09 ($129.58 in chips) 
Seat 3: cobrik23 ($133.78 in chips) 
Seat 4: ipashutapkom ($44.50 in chips) 
Seat 5: blufthenuts ($138.52 in chips) 
Seat 6: I The King I ($154.89 in chips) 
Seat 7: nickreason17 ($134.96 in chips) 
Seat 8: roadster683 ($73.30 in chips) 
Seat 9: lydia12345 ($257.03 in chips) 
ipashutapkom: posts small blind $0.50
blufthenuts: posts big blind $1
Vikulja1993: sits out 
*** HOLE CARDS ***
Dealt to matiko09 [6s Qc]
I The King I: folds 
nickreason17: folds 
roadster683: calls $1
lydia12345: folds 
matiko09: folds 
cobrik23: folds 
ipashutapkom: folds 
blufthenuts: checks 
*** FLOP *** [Ts 5s Qd]
blufthenuts: checks 
roadster683: bets $2
blufthenuts: folds 
Uncalled bet ($2) returned to roadster683
roadster683 collected $2.38 from pot
roadster683: doesn't show hand 
*** SUMMARY ***
Total pot $2.50 | Rake $0.12 
Board [Ts 5s Qd]
Seat 1: matiko09 folded before Flop (didn't bet)
Seat 3: cobrik23 (button) folded before Flop (didn't bet)
Seat 4: ipashutapkom (small blind) folded before Flop
Seat 5: blufthenuts (big blind) folded on the Flop
Seat 6: I The King I folded before Flop (didn't bet)
Seat 7: nickreason17 folded before Flop (didn't bet)
Seat 8: roadster683 collected ($2.38)
Seat 9: lydia12345 folded before Flop (didn't bet)





PokerStars Hand #153502171211:  Hold'em No Limit ($0.50/$1.00 USD) - 2016/05/18 20:28:55 CET [2016/05/18 14:28:55 ET]
Table 'Pandora' 9-max Seat #3 is the button
Seat 1: deadkiller1 ($134.52 in chips) 
Seat 2: fack_vi ($75.87 in chips) 
Seat 3: tipner ($112.52 in chips) 
Seat 4: mooose100 ($105.96 in chips) 
Seat 6: Moszes360 ($100 in chips) 
Seat 7: lydia12345 ($107.32 in chips) 
Seat 8: matiko09 ($104 in chips) 
Seat 9: oscarleon ($113.98 in chips) 
mooose100: posts small blind $0.50
Moszes360: posts big blind $1
*** HOLE CARDS ***
Dealt to matiko09 [As Ah]
lydia12345: folds 
matiko09: raises $2 to $3
oscarleon: folds 
deadkiller1: folds 
fack_vi: folds 
tipner: raises $6 to $9
mooose100: folds 
Moszes360: folds 
matiko09: raises $10 to $19
tipner: calls $10
*** FLOP *** [7s Qs 2d]
matiko09: bets $19
tipner: folds 
Uncalled bet ($19) returned to matiko09
matiko09 collected $37.52 from pot
matiko09: doesn't show hand 
*** SUMMARY ***
Total pot $39.50 | Rake $1.98 
Board [7s Qs 2d]
Seat 1: deadkiller1 folded before Flop (didn't bet)
Seat 2: fack_vi folded before Flop (didn't bet)
Seat 3: tipner (button) folded on the Flop
Seat 4: mooose100 (small blind) folded before Flop
Seat 6: Moszes360 (big blind) folded before Flop
Seat 7: lydia12345 folded before Flop (didn't bet)
Seat 8: matiko09 collected ($37.52)
Seat 9: oscarleon folded before Flop (didn't bet)





PokerStars Hand #153502179808:  Hold'em No Limit ($0.50/$1.00 USD) - 2016/05/18 20:29:05 CET [2016/05/18 14:29:05 ET]
Table 'Tatjana III' 9-max Seat #1 is the button
Seat 1: cobrik23 ($47.29 in chips) 
Seat 2: HITYESCA ($124.32 in chips) 
Seat 3: matiko09 ($188.34 in chips) 
Seat 4: lydia12345 ($116.90 in chips) 
Seat 5: deadkiller1 ($116.44 in chips) 
Seat 6: nickreason17 ($127.62 in chips) 
Seat 7: rene1984tsv ($151.19 in chips) 
Seat 8: JACQUILF ($110.30 in chips) 
Seat 9: Moszes360 ($104.12 in chips) 
HITYESCA: posts small blind $0.50
matiko09: posts big blind $1
*** HOLE CARDS ***
Dealt to matiko09 [Ac 6h]
lydia12345: folds 
deadkiller1: folds 
nickreason17: folds 
rene1984tsv: raises $1 to $2
JACQUILF: folds 
Moszes360: folds 
cobrik23: raises $5 to $7
HITYESCA: folds 
matiko09: folds 
rene1984tsv: calls $5
*** FLOP *** [3c 4s 4c]
rene1984tsv: bets $1
cobrik23: raises $8.36 to $9.36
rene1984tsv: folds 
Uncalled bet ($8.36) returned to cobrik23
cobrik23 collected $16.62 from pot
cobrik23: doesn't show hand 
*** SUMMARY ***
Total pot $17.50 | Rake $0.88 
Board [3c 4s 4c]
Seat 1: cobrik23 (button) collected ($16.62)
Seat 2: HITYESCA (small blind) folded before Flop
Seat 3: matiko09 (big blind) folded before Flop
Seat 4: lydia12345 folded before Flop (didn't bet)
Seat 5: deadkiller1 folded before Flop (didn't bet)
Seat 6: nickreason17 folded before Flop (didn't bet)
Seat 7: rene1984tsv folded on the Flop
Seat 8: JACQUILF folded before Flop (didn't bet)
Seat 9: Moszes360 folded before Flop (didn't bet)





PokerStars Hand #153502180729:  Hold'em No Limit ($0.50/$1.00 USD) - 2016/05/18 20:29:06 CET [2016/05/18 14:29:06 ET]
Table 'Terpsichore' 9-max Seat #8 is the button
Seat 1: oscarleon ($153.75 in chips) 
Seat 2: Moszes360 ($108.46 in chips) 
Seat 4: torkkdnm ($127.69 in chips) 
Seat 5: I The King I ($139.79 in chips) 
Seat 6: pyfyezi2016 ($93.63 in chips) 
Seat 7: cobrik23 ($101.50 in chips) 
Seat 8: matiko09 ($100 in chips) 
Seat 9: Quangis ($61.62 in chips) 
Quangis: posts small blind $0.50
oscarleon: posts big blind $1
blufthenuts: sits out 
*** HOLE CARDS ***
Dealt to matiko09 [2s 3h]
Moszes360: folds 
torkkdnm: folds 
I The King I: folds 
pyfyezi2016: folds 
cobrik23 has timed out
cobrik23: folds 
matiko09: folds 
Quangis: calls $0.50
oscarleon: checks 
*** FLOP *** [3s 4c 4d]
Quangis: checks 
oscarleon: checks 
*** TURN *** [3s 4c 4d] [7c]
Quangis: bets $1
oscarleon: folds 
Uncalled bet ($1) returned to Quangis
Quangis collected $1.90 from pot
Quangis: doesn't show hand 
*** SUMMARY ***
Total pot $2 | Rake $0.10 
Board [3s 4c 4d 7c]
Seat 1: oscarleon (big blind) folded on the Turn
Seat 2: Moszes360 folded before Flop (didn't bet)
Seat 4: torkkdnm folded before Flop (didn't bet)
Seat 5: I The King I folded before Flop (didn't bet)
Seat 6: pyfyezi2016 folded before Flop (didn't bet)
Seat 7: cobrik23 folded before Flop (didn't bet)
Seat 8: matiko09 (button) folded before Flop (didn't bet)
Seat 9: Quangis (small blind) collected ($1.90)





PokerStars Hand #153502181053:  Hold'em No Limit ($1/$2 USD) - 2016/05/18 20:29:07 CET [2016/05/18 14:29:07 ET]
Table 'Chlosinde' 9-max Seat #8 is the button
Seat 2: lydia12345 ($201.40 in chips) 
Seat 3: matiko09 ($231.16 in chips) 
Seat 4: FREDY BULLIT ($234.85 in chips) 
Seat 5: tepi_guy ($838.25 in chips) 
Seat 6: tipner ($248.25 in chips) 
Seat 7: donald0404 ($240.71 in chips) 
Seat 8: sanducu_eu ($209.03 in chips) 
Seat 9: Tey113 ($543.56 in chips) 
Tey113: posts small blind $1
ersevi6: is sitting out 
ersevi6 leaves the table
lydia12345: posts big blind $2
*** HOLE CARDS ***
Dealt to matiko09 [2s As]
matiko09: folds 
FREDY BULLIT: folds 
tepi_guy has timed out
tepi_guy: folds 
uonlylive1ce joins the table at seat #1 
tipner has timed out
tipner: folds 
donald0404: folds 
sanducu_eu: folds 
Tey113: folds 
Uncalled bet ($1) returned to lydia12345
lydia12345 collected $2 from pot
*** SUMMARY ***
Total pot $2 | Rake $0 
Seat 2: lydia12345 (big blind) collected ($2)
Seat 3: matiko09 folded before Flop (didn't bet)
Seat 4: FREDY BULLIT folded before Flop (didn't bet)
Seat 5: tepi_guy folded before Flop (didn't bet)
Seat 6: tipner folded before Flop (didn't bet)
Seat 7: donald0404 folded before Flop (didn't bet)
Seat 8: sanducu_eu (button) folded before Flop (didn't bet)
Seat 9: Tey113 (small blind) folded before Flop





PokerStars Hand #153502189081:  Hold'em No Limit ($0.50/$1.00 USD) - 2016/05/18 20:29:16 CET [2016/05/18 14:29:16 ET]
Table 'Suevia' 9-max Seat #7 is the button
Seat 1: Bimaxa ($101.50 in chips) 
Seat 2: deadkiller1 ($100 in chips) 
Seat 3: matiko09 ($100 in chips) 
Seat 4: HITYESCA ($100 in chips) 
Seat 6: torkkdnm ($125.66 in chips) 
Seat 7: cobrik23 ($82.65 in chips) 
Seat 8: ama58 ($49.86 in chips) 
Seat 9: oscarleon ($137.87 in chips) 
ama58: posts small blind $0.50
oscarleon: posts big blind $1
*** HOLE CARDS ***
Dealt to matiko09 [As 8h]
Bimaxa: folds 
deadkiller1: folds 
matiko09: folds 
HITYESCA: folds 
torkkdnm: raises $2 to $3
cobrik23: folds 
ama58: folds 
oscarleon: folds 
Uncalled bet ($2) returned to torkkdnm
torkkdnm collected $2.50 from pot
*** SUMMARY ***
Total pot $2.50 | Rake $0 
Seat 1: Bimaxa folded before Flop (didn't bet)
Seat 2: deadkiller1 folded before Flop (didn't bet)
Seat 3: matiko09 folded before Flop (didn't bet)
Seat 4: HITYESCA folded before Flop (didn't bet)
Seat 6: torkkdnm collected ($2.50)
Seat 7: cobrik23 (button) folded before Flop (didn't bet)
Seat 8: ama58 (small blind) folded before Flop
Seat 9: oscarleon (big blind) folded before Flop





PokerStars Hand #153502193776:  Hold'em No Limit (€0.50/€1.00 EUR) - 2016/05/18 20:29:22 CET [2016/05/18 14:29:22 ET]
Table 'Pallas II' 9-max Seat #5 is the button
Seat 1: deadkiller1 (€100 in chips) 
Seat 2: matiko09 (€202.49 in chips) 
Seat 3: Vikulja1993 (€108 in chips) 
Seat 4: torkkdnm (€149.71 in chips) 
Seat 5: cobrik23 (€67.74 in chips) 
Seat 6: HITYESCA (€105.62 in chips) 
Seat 7: rate8 (€100 in chips) 
Seat 8: lydia12345 (€100 in chips) 
Seat 9: stijner1986 (€142.33 in chips) 
HITYESCA: posts small blind €0.50
rate8: posts big blind €1
*** HOLE CARDS ***
Dealt to matiko09 [9s Js]
lydia12345: folds 
stijner1986: folds 
deadkiller1: folds 
matiko09: raises €2 to €3
Vikulja1993: folds 
torkkdnm: folds 
cobrik23: folds 
HITYESCA: folds 
rate8: folds 
Uncalled bet (€2) returned to matiko09
matiko09 collected €2.50 from pot
matiko09: doesn't show hand 
*** SUMMARY ***
Total pot €2.50 | Rake €0 
Seat 1: deadkiller1 folded before Flop (didn't bet)
Seat 2: matiko09 collected (€2.50)
Seat 3: Vikulja1993 folded before Flop (didn't bet)
Seat 4: torkkdnm folded before Flop (didn't bet)
Seat 5: cobrik23 (button) folded before Flop (didn't bet)
Seat 6: HITYESCA (small blind) folded before Flop
Seat 7: rate8 (big blind) folded before Flop
Seat 8: lydia12345 folded before Flop (didn't bet)
Seat 9: stijner1986 folded before Flop (didn't bet)





PokerStars Hand #153502212768:  Hold'em No Limit ($0.50/$1.00 USD) - 2016/05/18 20:29:44 CET [2016/05/18 14:29:44 ET]
Table 'Abetti II' 9-max Seat #4 is the button
Seat 1: matiko09 ($129.58 in chips) 
Seat 3: cobrik23 ($133.78 in chips) 
Seat 4: ipashutapkom ($44 in chips) 
Seat 5: blufthenuts ($137.52 in chips) 
Seat 6: I The King I ($154.89 in chips) 
Seat 7: nickreason17 ($134.96 in chips) 
Seat 8: roadster683 ($74.68 in chips) 
Seat 9: lydia12345 ($257.03 in chips) 
blufthenuts: posts small blind $0.50
I The King I: posts big blind $1
Vikulja1993: sits out 
*** HOLE CARDS ***
Dealt to matiko09 [Kh Kd]
nickreason17: folds 
roadster683: folds 
lydia12345: folds 
matiko09: raises $2 to $3
cobrik23: folds 
ipashutapkom: folds 
blufthenuts: folds 
I The King I: folds 
Uncalled bet ($2) returned to matiko09
matiko09 collected $2.50 from pot
matiko09: doesn't show hand 
*** SUMMARY ***
Total pot $2.50 | Rake $0 
Seat 1: matiko09 collected ($2.50)
Seat 3: cobrik23 folded before Flop (didn't bet)
Seat 4: ipashutapkom (button) folded before Flop (didn't bet)
Seat 5: blufthenuts (small blind) folded before Flop
Seat 6: I The King I (big blind) folded before Flop
Seat 7: nickreason17 folded before Flop (didn't bet)
Seat 8: roadster683 folded before Flop (didn't bet)
Seat 9: lydia12345 folded before Flop (didn't bet)





PokerStars Hand #153502214144:  Hold'em No Limit ($0.50/$1.00 USD) - 2016/05/18 20:29:45 CET [2016/05/18 14:29:45 ET]
Table 'Tatjana III' 9-max Seat #2 is the button
Seat 1: cobrik23 ($55.91 in chips) 
Seat 2: HITYESCA ($123.82 in chips) 
Seat 3: matiko09 ($187.34 in chips) 
Seat 4: lydia12345 ($116.90 in chips) 
Seat 5: deadkiller1 ($116.44 in chips) 
Seat 6: nickreason17 ($127.62 in chips) 
Seat 7: rene1984tsv ($143.19 in chips) 
Seat 8: JACQUILF ($110.30 in chips) 
Seat 9: Moszes360 ($104.12 in chips) 
matiko09: posts small blind $0.50
lydia12345: posts big blind $1
*** HOLE CARDS ***
Dealt to matiko09 [2h 6c]
deadkiller1: folds 
nickreason17: folds 
rene1984tsv: folds 
JACQUILF: raises $2 to $3
Moszes360: folds 
cobrik23: folds 
HITYESCA: folds 
matiko09: folds 
lydia12345: folds 
Uncalled bet ($2) returned to JACQUILF
JACQUILF collected $2.50 from pot
JACQUILF: doesn't show hand 
*** SUMMARY ***
Total pot $2.50 | Rake $0 
Seat 1: cobrik23 folded before Flop (didn't bet)
Seat 2: HITYESCA (button) folded before Flop (didn't bet)
Seat 3: matiko09 (small blind) folded before Flop
Seat 4: lydia12345 (big blind) folded before Flop
Seat 5: deadkiller1 folded before Flop (didn't bet)
Seat 6: nickreason17 folded before Flop (didn't bet)
Seat 7: rene1984tsv folded before Flop (didn't bet)
Seat 8: JACQUILF collected ($2.50)
Seat 9: Moszes360 folded before Flop (didn't bet)





PokerStars Hand #153502219049:  Hold'em No Limit ($0.50/$1.00 USD) - 2016/05/18 20:29:51 CET [2016/05/18 14:29:51 ET]
Table 'Kayala' 9-max Seat #4 is the button
Seat 1: deadkiller1 ($109.40 in chips) 
Seat 2: Oelie7 ($177.53 in chips) 
Seat 3: matiko09 ($100 in chips) 
Seat 4: HITYESCA ($100 in chips) 
Seat 6: lydia12345 ($117.94 in chips) 
Seat 7: nickreason17 ($113.66 in chips) 
Seat 8: cobrik23 ($87.04 in chips) 
rate8 will be allowed to play after the button
lydia12345: posts small blind $0.50
nickreason17: posts big blind $1
Vikulja1993: sits out 
*** HOLE CARDS ***
Dealt to matiko09 [2d 6c]
cobrik23 has timed out
cobrik23: folds 
deadkiller1: folds 
Oelie7: calls $1
matiko09: folds 
HITYESCA: folds 
lydia12345: folds 
nickreason17: raises $4 to $5
Oelie7: folds 
Uncalled bet ($4) returned to nickreason17
nickreason17 collected $2.50 from pot
*** SUMMARY ***
Total pot $2.50 | Rake $0 
Seat 1: deadkiller1 folded before Flop (didn't bet)
Seat 2: Oelie7 folded before Flop
Seat 3: matiko09 folded before Flop (didn't bet)
Seat 4: HITYESCA (button) folded before Flop (didn't bet)
Seat 6: lydia12345 (small blind) folded before Flop
Seat 7: nickreason17 (big blind) collected ($2.50)
Seat 8: cobrik23 folded before Flop (didn't bet)





PokerStars Hand #153502221362:  Hold'em No Limit ($0.50/$1.00 USD) - 2016/05/18 20:29:54 CET [2016/05/18 14:29:54 ET]
Table 'Suevia' 9-max Seat #8 is the button
Seat 2: deadkiller1 ($100 in chips) 
Seat 3: matiko09 ($100 in chips) 
Seat 4: HITYESCA ($100 in chips) 
Seat 6: torkkdnm ($127.16 in chips) 
Seat 7: cobrik23 ($82.65 in chips) 
Seat 8: ama58 ($49.36 in chips) 
Seat 9: oscarleon ($136.87 in chips) 
oscarleon: posts small blind $0.50
Bimaxa: is sitting out 
Bimaxa leaves the table
deadkiller1: posts big blind $1
*** HOLE CARDS ***
Dealt to matiko09 [Qc 4c]
smolski15 joins the table at seat #1 
matiko09: folds 
HITYESCA: folds 
smolski15 leaves the table
torkkdnm: folds 
Moszes360 joins the table at seat #1 
cobrik23: raises $2 to $3
ama58: folds 
oscarleon: folds 
deadkiller1: folds 
Uncalled bet ($2) returned to cobrik23
cobrik23 collected $2.50 from pot
cobrik23: doesn't show hand 
*** SUMMARY ***
Total pot $2.50 | Rake $0 
Seat 2: deadkiller1 (big blind) folded before Flop
Seat 3: matiko09 folded before Flop (didn't bet)
Seat 4: HITYESCA folded before Flop (didn't bet)
Seat 6: torkkdnm folded before Flop (didn't bet)
Seat 7: cobrik23 collected ($2.50)
Seat 8: ama58 (button) folded before Flop (didn't bet)
Seat 9: oscarleon (small blind) folded before Flop





PokerStars Hand #153502223299:  Hold'em No Limit ($1/$2 USD) - 2016/05/18 20:29:56 CET [2016/05/18 14:29:56 ET]
Table 'Letaba' 9-max Seat #6 is the button
Seat 2: staruk669 ($118.74 in chips) 
Seat 3: ersevi6 ($253.85 in chips) 
Seat 4: matiko09 ($200 in chips) 
Seat 5: Vikulja1993 ($200 in chips) 
Seat 6: donald0404 ($318.19 in chips) 
Seat 7: moshmachine ($291.97 in chips) 
Seat 8: lydia12345 ($200 in chips) 
Seat 9: tepi_guy ($279.94 in chips) 
moshmachine: posts small blind $1
lydia12345: posts big blind $2
vanilica: sits out 
Vikulja1993: posts big blind $2
*** HOLE CARDS ***
Dealt to matiko09 [2d Kh]
tepi_guy: folds 
staruk669: calls $2
ersevi6: folds 
matiko09: folds 
Vikulja1993: raises $6 to $8
donald0404: folds 
moshmachine: folds 
lydia12345: folds 
staruk669: calls $6
*** FLOP *** [Td Tc Jh]
staruk669: checks 
Vikulja1993: bets $7
staruk669: calls $7
*** TURN *** [Td Tc Jh] [6s]
staruk669: checks 
Vikulja1993: bets $19
staruk669: calls $19
*** RIVER *** [Td Tc Jh 6s] [Jc]
staruk669: bets $68
Vikulja1993: raises $98 to $166 and is all-in
staruk669: folds 
Uncalled bet ($98) returned to Vikulja1993
Vikulja1993 collected $204.25 from pot
Vikulja1993: doesn't show hand 
*** SUMMARY ***
Total pot $207 | Rake $2.75 
Board [Td Tc Jh 6s Jc]
Seat 2: staruk669 folded on the River
Seat 3: ersevi6 folded before Flop (didn't bet)
Seat 4: matiko09 folded before Flop (didn't bet)
Seat 5: Vikulja1993 collected ($204.25)
Seat 6: donald0404 (button) folded before Flop (didn't bet)
Seat 7: moshmachine (small blind) folded before Flop
Seat 8: lydia12345 (big blind) folded before Flop
Seat 9: tepi_guy folded before Flop (didn't bet)





PokerStars Hand #153502227882:  Hold'em No Limit ($1/$2 USD) - 2016/05/18 20:30:01 CET [2016/05/18 14:30:01 ET]
Table 'Chlosinde' 9-max Seat #9 is the button
Seat 2: lydia12345 ($202.40 in chips) 
Seat 3: matiko09 ($231.16 in chips) 
Seat 4: FREDY BULLIT ($234.85 in chips) 
Seat 5: tepi_guy ($838.25 in chips) 
Seat 7: donald0404 ($240.71 in chips) 
Seat 8: sanducu_eu ($209.03 in chips) 
Seat 9: Tey113 ($542.56 in chips) 
uonlylive1ce will be allowed to play after the button
lydia12345: posts small blind $1
matiko09: posts big blind $2
*** HOLE CARDS ***
Dealt to matiko09 [6c 8c]
FREDY BULLIT: raises $3.60 to $5.60
tepi_guy: calls $5.60
donald0404: calls $5.60
sanducu_eu: folds 
Tey113: folds 
lydia12345: folds 
matiko09: calls $3.60
*** FLOP *** [As 9s 3c]
matiko09: checks 
tipner leaves the table
FREDY BULLIT: bets $7.34
tepi_guy: raises $17.30 to $24.64
I The King I joins the table at seat #6 
donald0404: folds 
matiko09: folds 
I The King I leaves the table
Vikulja1993 joins the table at seat #6 
FREDY BULLIT: folds 
Uncalled bet ($17.30) returned to tepi_guy
tepi_guy collected $36.18 from pot
tepi_guy: doesn't show hand 
*** SUMMARY ***
Total pot $38.08 | Rake $1.90 
Board [As 9s 3c]
Seat 2: lydia12345 (small blind) folded before Flop
Seat 3: matiko09 (big blind) folded on the Flop
Seat 4: FREDY BULLIT folded on the Flop
Seat 5: tepi_guy collected ($36.18)
Seat 7: donald0404 folded on the Flop
Seat 8: sanducu_eu folded before Flop (didn't bet)
Seat 9: Tey113 (button) folded before Flop (didn't bet)





PokerStars Hand #153502228706:  Hold'em No Limit ($0.50/$1.00 USD) - 2016/05/18 20:30:02 CET [2016/05/18 14:30:02 ET]
Table 'Abetti II' 9-max Seat #5 is the button
Seat 1: matiko09 ($131.08 in chips) 
Seat 3: cobrik23 ($133.78 in chips) 
Seat 4: ipashutapkom ($44 in chips) 
Seat 5: blufthenuts ($137.02 in chips) 
Seat 6: I The King I ($153.89 in chips) 
Seat 7: nickreason17 ($134.96 in chips) 
Seat 8: roadster683 ($74.68 in chips) 
Seat 9: lydia12345 ($257.03 in chips) 
I The King I: posts small blind $0.50
nickreason17: posts big blind $1
Vikulja1993: sits out 
*** HOLE CARDS ***
Dealt to matiko09 [Qd 7h]
roadster683: calls $1
lydia12345: raises $4 to $5
matiko09: folds 
cobrik23: folds 
ipashutapkom: folds 
blufthenuts: folds 
I The King I: folds 
nickreason17: folds 
roadster683: calls $4
*** FLOP *** [8h 2s 8d]
roadster683: checks 
lydia12345: bets $7.43
roadster683: folds 
Uncalled bet ($7.43) returned to lydia12345
lydia12345 collected $10.92 from pot
*** SUMMARY ***
Total pot $11.50 | Rake $0.58 
Board [8h 2s 8d]
Seat 1: matiko09 folded before Flop (didn't bet)
Seat 3: cobrik23 folded before Flop (didn't bet)
Seat 4: ipashutapkom folded before Flop (didn't bet)
Seat 5: blufthenuts (button) folded before Flop (didn't bet)
Seat 6: I The King I (small blind) folded before Flop
Seat 7: nickreason17 (big blind) folded before Flop
Seat 8: roadster683 folded on the Flop
Seat 9: lydia12345 collected ($10.92)





PokerStars Hand #153502235819:  Hold'em No Limit ($0.50/$1.00 USD) - 2016/05/18 20:30:10 CET [2016/05/18 14:30:10 ET]
Table 'Terpsichore' 9-max Seat #9 is the button
Seat 1: oscarleon ($152.75 in chips) 
Seat 2: Moszes360 ($108.46 in chips) 
Seat 4: torkkdnm ($127.69 in chips) 
Seat 5: I The King I ($139.79 in chips) 
Seat 6: pyfyezi2016 ($93.63 in chips) 
Seat 8: matiko09 ($100 in chips) 
Seat 9: Quangis ($62.52 in chips) 
oscarleon: posts small blind $0.50
Moszes360: posts big blind $1
blufthenuts: sits out 
*** HOLE CARDS ***
Dealt to matiko09 [9c 5c]
torkkdnm: folds 
I The King I: folds 
pyfyezi2016: folds 
matiko09: folds 
Quangis: folds 
oscarleon: raises $2 to $3
Moszes360: folds 
Uncalled bet ($2) returned to oscarleon
oscarleon collected $2 from pot
oscarleon: doesn't show hand 
*** SUMMARY ***
Total pot $2 | Rake $0 
Seat 1: oscarleon (small blind) collected ($2)
Seat 2: Moszes360 (big blind) folded before Flop
Seat 4: torkkdnm folded before Flop (didn't bet)
Seat 5: I The King I folded before Flop (didn't bet)
Seat 6: pyfyezi2016 folded before Flop (didn't bet)
Seat 8: matiko09 folded before Flop (didn't bet)
Seat 9: Quangis (button) folded before Flop (didn't bet)





PokerStars Hand #153502236188:  Hold'em No Limit (€0.50/€1.00 EUR) - 2016/05/18 20:30:11 CET [2016/05/18 14:30:11 ET]
Table 'Pallas II' 9-max Seat #6 is the button
Seat 1: deadkiller1 (€100 in chips) 
Seat 2: matiko09 (€203.99 in chips) 
Seat 3: Vikulja1993 (€108 in chips) 
Seat 4: torkkdnm (€149.71 in chips) 
Seat 5: cobrik23 (€67.74 in chips) 
Seat 6: HITYESCA (€105.12 in chips) 
Seat 7: rate8 (€100 in chips) 
Seat 8: lydia12345 (€100 in chips) 
Seat 9: stijner1986 (€142.33 in chips) 
rate8: posts small blind €0.50
lydia12345: posts big blind €1
*** HOLE CARDS ***
Dealt to matiko09 [8s 2d]
stijner1986: calls €1
deadkiller1: raises €3 to €4
matiko09: folds 
Vikulja1993: folds 
torkkdnm: folds 
cobrik23: folds 
HITYESCA: folds 
rate8: calls €3.50
lydia12345: folds 
stijner1986: folds 
*** FLOP *** [3h 3c 5s]
rate8: checks 
deadkiller1: bets €6.27
rate8: folds 
Uncalled bet (€6.27) returned to deadkiller1
deadkiller1 collected €9.50 from pot
deadkiller1: doesn't show hand 
*** SUMMARY ***
Total pot €10 | Rake €0.50 
Board [3h 3c 5s]
Seat 1: deadkiller1 collected (€9.50)
Seat 2: matiko09 folded before Flop (didn't bet)
Seat 3: Vikulja1993 folded before Flop (didn't bet)
Seat 4: torkkdnm folded before Flop (didn't bet)
Seat 5: cobrik23 folded before Flop (didn't bet)
Seat 6: HITYESCA (button) folded before Flop (didn't bet)
Seat 7: rate8 (small blind) folded on the Flop
Seat 8: lydia12345 (big blind) folded before Flop
Seat 9: stijner1986 folded before Flop





PokerStars Hand #153502245778:  Hold'em No Limit ($0.50/$1.00 USD) - 2016/05/18 20:30:22 CET [2016/05/18 14:30:22 ET]
Table 'Erida II' 9-max Seat #9 is the button
Seat 1: vanilica ($100 in chips) 
Seat 2: cobrik23 ($95.50 in chips) 
Seat 3: Kelvin sai ($149.28 in chips) 
Seat 4: FLQHenrici ($104.12 in chips) 
Seat 5: Moszes360 ($101.50 in chips) 
Seat 6: deadkiller1 ($153.86 in chips) 
Seat 7: matiko09 ($100 in chips) 
Seat 9: sanr23 ($100 in chips) 
vanilica: posts small blind $0.50
cobrik23: posts big blind $1
Kihog: sits out 
*** HOLE CARDS ***
Dealt to matiko09 [Js Tc]
Kelvin sai: raises $1 to $2
FLQHenrici: folds 
Moszes360: folds 
deadkiller1: folds 
matiko09: folds 
sanr23: calls $2
vanilica: folds 
cobrik23: calls $1
*** FLOP *** [2d 4s Jd]
cobrik23: checks 
Kelvin sai: bets $2
sanr23: raises $4 to $6
cobrik23: folds 
Kelvin sai: calls $4
*** TURN *** [2d 4s Jd] [2c]
Kelvin sai: bets $6
sanr23: calls $6
*** RIVER *** [2d 4s Jd 2c] [9c]
Kelvin sai: bets $10
sanr23: folds 
Uncalled bet ($10) returned to Kelvin sai
Kelvin sai collected $28.98 from pot
Kelvin sai: doesn't show hand 
*** SUMMARY ***
Total pot $30.50 | Rake $1.52 
Board [2d 4s Jd 2c 9c]
Seat 1: vanilica (small blind) folded before Flop
Seat 2: cobrik23 (big blind) folded on the Flop
Seat 3: Kelvin sai collected ($28.98)
Seat 4: FLQHenrici folded before Flop (didn't bet)
Seat 5: Moszes360 folded before Flop (didn't bet)
Seat 6: deadkiller1 folded before Flop (didn't bet)
Seat 7: matiko09 folded before Flop (didn't bet)
Seat 9: sanr23 (button) folded on the River





PokerStars Hand #153502250042:  Hold'em No Limit ($0.50/$1.00 USD) - 2016/05/18 20:30:27 CET [2016/05/18 14:30:27 ET]
Table 'Tatjana III' 9-max Seat #3 is the button
Seat 1: cobrik23 ($55.91 in chips) 
Seat 2: HITYESCA ($123.82 in chips) 
Seat 3: matiko09 ($186.84 in chips) 
Seat 4: lydia12345 ($115.90 in chips) 
Seat 5: deadkiller1 ($116.44 in chips) 
Seat 6: nickreason17 ($127.62 in chips) 
Seat 7: rene1984tsv ($143.19 in chips) 
Seat 8: JACQUILF ($111.80 in chips) 
Seat 9: Moszes360 ($104.12 in chips) 
lydia12345: posts small blind $0.50
deadkiller1: posts big blind $1
*** HOLE CARDS ***
Dealt to matiko09 [Ac Th]
nickreason17: folds 
rene1984tsv: raises $1 to $2
JACQUILF: folds 
Moszes360: folds 
cobrik23: raises $5 to $7
HITYESCA: folds 
matiko09: folds 
lydia12345: calls $6.50
deadkiller1: folds 
rene1984tsv: calls $5
*** FLOP *** [8s 2c 9c]
lydia12345: bets $14.21
rene1984tsv: folds 
cobrik23: folds 
Uncalled bet ($14.21) returned to lydia12345
lydia12345 collected $20.90 from pot
*** SUMMARY ***
Total pot $22 | Rake $1.10 
Board [8s 2c 9c]
Seat 1: cobrik23 folded on the Flop
Seat 2: HITYESCA folded before Flop (didn't bet)
Seat 3: matiko09 (button) folded before Flop (didn't bet)
Seat 4: lydia12345 (small blind) collected ($20.90)
Seat 5: deadkiller1 (big blind) folded before Flop
Seat 6: nickreason17 folded before Flop (didn't bet)
Seat 7: rene1984tsv folded on the Flop
Seat 8: JACQUILF folded before Flop (didn't bet)
Seat 9: Moszes360 folded before Flop (didn't bet)





PokerStars Hand #153502252956:  Hold'em No Limit ($0.50/$1.00 USD) - 2016/05/18 20:30:30 CET [2016/05/18 14:30:30 ET]
Table 'Suevia' 9-max Seat #9 is the button
Seat 2: deadkiller1 ($100 in chips) 
Seat 3: matiko09 ($100 in chips) 
Seat 4: HITYESCA ($100 in chips) 
Seat 6: torkkdnm ($127.16 in chips) 
Seat 7: cobrik23 ($84.15 in chips) 
Seat 8: ama58 ($49.36 in chips) 
Seat 9: oscarleon ($136.37 in chips) 
Moszes360 will be allowed to play after the button
deadkiller1: posts small blind $0.50
matiko09: posts big blind $1
*** HOLE CARDS ***
Dealt to matiko09 [Jd 5c]
HITYESCA: folds 
torkkdnm: folds 
cobrik23: folds 
ama58: raises $2 to $3
oscarleon: folds 
deadkiller1: folds 
matiko09: folds 
Uncalled bet ($2) returned to ama58
ama58 collected $2.50 from pot
*** SUMMARY ***
Total pot $2.50 | Rake $0 
Seat 2: deadkiller1 (small blind) folded before Flop
Seat 3: matiko09 (big blind) folded before Flop
Seat 4: HITYESCA folded before Flop (didn't bet)
Seat 6: torkkdnm folded before Flop (didn't bet)
Seat 7: cobrik23 folded before Flop (didn't bet)
Seat 8: ama58 collected ($2.50)
Seat 9: oscarleon (button) folded before Flop (didn't bet)





PokerStars Hand #153502258468:  Hold'em No Limit ($0.50/$1.00 USD) - 2016/05/18 20:30:36 CET [2016/05/18 14:30:36 ET]
Table 'Terpsichore' 9-max Seat #1 is the button
Seat 1: oscarleon ($153.75 in chips) 
Seat 2: Moszes360 ($107.46 in chips) 
Seat 3: blufthenuts ($308.57 in chips) 
Seat 4: torkkdnm ($127.69 in chips) 
Seat 5: I The King I ($139.79 in chips) 
Seat 6: pyfyezi2016 ($93.63 in chips) 
Seat 8: matiko09 ($100 in chips) 
Seat 9: Quangis ($62.52 in chips) 
Moszes360: posts small blind $0.50
blufthenuts: posts big blind $1
*** HOLE CARDS ***
Dealt to matiko09 [9h 3d]
torkkdnm: raises $2 to $3
I The King I: folds 
pyfyezi2016: folds 
matiko09: folds 
Quangis: calls $3
oscarleon: folds 
Moszes360: folds 
blufthenuts: folds 
*** FLOP *** [As 5s Ad]
torkkdnm: checks 
Quangis: bets $4
torkkdnm: calls $4
*** TURN *** [As 5s Ad] [7d]
torkkdnm: checks 
Quangis: checks 
*** RIVER *** [As 5s Ad 7d] [7s]
torkkdnm: bets $10
Quangis: calls $10
*** SHOW DOWN ***
torkkdnm: shows [Ah Kc] (a full house, Aces full of Sevens)
Quangis: mucks hand 
torkkdnm collected $33.72 from pot
*** SUMMARY ***
Total pot $35.50 | Rake $1.78 
Board [As 5s Ad 7d 7s]
Seat 1: oscarleon (button) folded before Flop (didn't bet)
Seat 2: Moszes360 (small blind) folded before Flop
Seat 3: blufthenuts (big blind) folded before Flop
Seat 4: torkkdnm showed [Ah Kc] and won ($33.72) with a full house, Aces full of Sevens
Seat 5: I The King I folded before Flop (didn't bet)
Seat 6: pyfyezi2016 folded before Flop (didn't bet)
Seat 8: matiko09 folded before Flop (didn't bet)
Seat 9: Quangis mucked [6s 6c]





PokerStars Hand #153502258689:  Hold'em No Limit ($0.50/$1.00 USD) - 2016/05/18 20:30:37 CET [2016/05/18 14:30:37 ET]
Table 'Kayala' 9-max Seat #6 is the button
Seat 1: deadkiller1 ($109.40 in chips) 
Seat 2: Oelie7 ($176.53 in chips) 
Seat 3: matiko09 ($100 in chips) 
Seat 4: HITYESCA ($100 in chips) 
Seat 6: lydia12345 ($117.44 in chips) 
Seat 7: nickreason17 ($115.16 in chips) 
Seat 9: Vikulja1993 ($100 in chips) 
nickreason17: posts small blind $0.50
Vikulja1993: posts big blind $1
rate8: sits out 
*** HOLE CARDS ***
Dealt to matiko09 [3h Tc]
deadkiller1: folds 
Oelie7: folds 
matiko09: folds 
HITYESCA: folds 
lydia12345: raises $2 to $3
nickreason17: folds 
Vikulja1993: calls $2
*** FLOP *** [9d 4h Ts]
Vikulja1993: checks 
lydia12345: bets $4.20
Vikulja1993: folds 
Uncalled bet ($4.20) returned to lydia12345
lydia12345 collected $6.18 from pot
*** SUMMARY ***
Total pot $6.50 | Rake $0.32 
Board [9d 4h Ts]
Seat 1: deadkiller1 folded before Flop (didn't bet)
Seat 2: Oelie7 folded before Flop (didn't bet)
Seat 3: matiko09 folded before Flop (didn't bet)
Seat 4: HITYESCA folded before Flop (didn't bet)
Seat 6: lydia12345 (button) collected ($6.18)
Seat 7: nickreason17 (small blind) folded before Flop
Seat 9: Vikulja1993 (big blind) folded on the Flop





PokerStars Hand #153502269188:  Hold'em No Limit ($0.50/$1.00 USD) - 2016/05/18 20:30:48 CET [2016/05/18 14:30:48 ET]
Table 'Abetti II' 9-max Seat #6 is the button
Seat 1: matiko09 ($131.08 in chips) 
Seat 3: cobrik23 ($133.78 in chips) 
Seat 4: ipashutapkom ($44 in chips) 
Seat 5: blufthenuts ($137.02 in chips) 
Seat 6: I The King I ($153.39 in chips) 
Seat 7: nickreason17 ($133.96 in chips) 
Seat 8: roadster683 ($69.68 in chips) 
Seat 9: lydia12345 ($262.95 in chips) 
nickreason17: posts small blind $0.50
roadster683: posts big blind $1
Vikulja1993: sits out 
*** HOLE CARDS ***
Dealt to matiko09 [Kd 4s]
lydia12345: folds 
matiko09: folds 
cobrik23: folds 
ipashutapkom: raises $1.26 to $2.26
blufthenuts: folds 
I The King I: folds 
nickreason17: folds 
roadster683: folds 
Uncalled bet ($1.26) returned to ipashutapkom
ipashutapkom collected $2.50 from pot
ipashutapkom: doesn't show hand 
*** SUMMARY ***
Total pot $2.50 | Rake $0 
Seat 1: matiko09 folded before Flop (didn't bet)
Seat 3: cobrik23 folded before Flop (didn't bet)
Seat 4: ipashutapkom collected ($2.50)
Seat 5: blufthenuts folded before Flop (didn't bet)
Seat 6: I The King I (button) folded before Flop (didn't bet)
Seat 7: nickreason17 (small blind) folded before Flop
Seat 8: roadster683 (big blind) folded before Flop
Seat 9: lydia12345 folded before Flop (didn't bet)





PokerStars Hand #153502271636:  Hold'em No Limit ($0.50/$1.00 USD) - 2016/05/18 20:30:51 CET [2016/05/18 14:30:51 ET]
Table 'Pandora' 9-max Seat #4 is the button
Seat 1: deadkiller1 ($134.52 in chips) 
Seat 2: fack_vi ($75.87 in chips) 
Seat 3: tipner ($100 in chips) 
Seat 4: mooose100 ($105.46 in chips) 
Seat 6: Moszes360 ($100 in chips) 
Seat 7: lydia12345 ($107.32 in chips) 
Seat 8: matiko09 ($122.52 in chips) 
Seat 9: oscarleon ($113.98 in chips) 
Moszes360: posts small blind $0.50
lydia12345: posts big blind $1
*** HOLE CARDS ***
Dealt to matiko09 [9c 9h]
matiko09: raises $2 to $3
oscarleon: folds 
deadkiller1: raises $6 to $9
fack_vi: folds 
tipner: folds 
mooose100: folds 
Moszes360: folds 
lydia12345: folds 
Mr Seelen leaves the table
matiko09: folds 
Uncalled bet ($6) returned to deadkiller1
deadkiller1 collected $7.50 from pot
deadkiller1: doesn't show hand 
nickreason17 joins the table at seat #5 
*** SUMMARY ***
Total pot $7.50 | Rake $0 
Seat 1: deadkiller1 collected ($7.50)
Seat 2: fack_vi folded before Flop (didn't bet)
Seat 3: tipner folded before Flop (didn't bet)
Seat 4: mooose100 (button) folded before Flop (didn't bet)
Seat 6: Moszes360 (small blind) folded before Flop
Seat 7: lydia12345 (big blind) folded before Flop
Seat 8: matiko09 folded before Flop
Seat 9: oscarleon folded before Flop (didn't bet)





PokerStars Hand #153502281670:  Hold'em No Limit ($0.50/$1.00 USD) - 2016/05/18 20:31:03 CET [2016/05/18 14:31:03 ET]
Table 'Suevia' 9-max Seat #2 is the button
Seat 2: deadkiller1 ($100 in chips) 
Seat 3: matiko09 ($100 in chips) 
Seat 4: HITYESCA ($100 in chips) 
Seat 6: torkkdnm ($127.16 in chips) 
Seat 7: cobrik23 ($84.15 in chips) 
Seat 8: ama58 ($50.86 in chips) 
Seat 9: oscarleon ($136.37 in chips) 
matiko09: posts small blind $0.50
HITYESCA: posts big blind $1
Moszes360: sits out 
*** HOLE CARDS ***
Dealt to matiko09 [7c 8d]
torkkdnm: folds 
cobrik23: raises $1 to $2
ama58: calls $2
oscarleon: folds 
deadkiller1: folds 
matiko09: folds 
HITYESCA: folds 
*** FLOP *** [Jd 5c 6s]
cobrik23: checks 
ama58: bets $3
cobrik23: folds 
Uncalled bet ($3) returned to ama58
ama58 collected $5.22 from pot
*** SUMMARY ***
Total pot $5.50 | Rake $0.28 
Board [Jd 5c 6s]
Seat 2: deadkiller1 (button) folded before Flop (didn't bet)
Seat 3: matiko09 (small blind) folded before Flop
Seat 4: HITYESCA (big blind) folded before Flop
Seat 6: torkkdnm folded before Flop (didn't bet)
Seat 7: cobrik23 folded on the Flop
Seat 8: ama58 collected ($5.22)
Seat 9: oscarleon folded before Flop (didn't bet)





PokerStars Hand #153502286737:  Hold'em No Limit ($0.50/$1.00 USD) - 2016/05/18 20:31:09 CET [2016/05/18 14:31:09 ET]
Table 'Kayala' 9-max Seat #7 is the button
Seat 1: deadkiller1 ($109.40 in chips) 
Seat 2: Oelie7 ($176.53 in chips) 
Seat 3: matiko09 ($100 in chips) 
Seat 4: HITYESCA ($100 in chips) 
Seat 6: lydia12345 ($120.62 in chips) 
Seat 7: nickreason17 ($114.66 in chips) 
Seat 9: Vikulja1993 ($100 in chips) 
Vikulja1993: posts small blind $0.50
deadkiller1: posts big blind $1
rate8: sits out 
*** HOLE CARDS ***
Dealt to matiko09 [Th 8h]
Oelie7: folds 
matiko09: folds 
HITYESCA: folds 
lydia12345: folds 
nickreason17: raises $1 to $2
Vikulja1993: folds 
deadkiller1: folds 
Uncalled bet ($1) returned to nickreason17
nickreason17 collected $2.50 from pot
*** SUMMARY ***
Total pot $2.50 | Rake $0 
Seat 1: deadkiller1 (big blind) folded before Flop
Seat 2: Oelie7 folded before Flop (didn't bet)
Seat 3: matiko09 folded before Flop (didn't bet)
Seat 4: HITYESCA folded before Flop (didn't bet)
Seat 6: lydia12345 folded before Flop (didn't bet)
Seat 7: nickreason17 (button) collected ($2.50)
Seat 9: Vikulja1993 (small blind) folded before Flop





PokerStars Hand #153502291541:  Hold'em No Limit (€0.50/€1.00 EUR) - 2016/05/18 20:31:14 CET [2016/05/18 14:31:14 ET]
Table 'Pallas II' 9-max Seat #7 is the button
Seat 1: deadkiller1 (€105.50 in chips) 
Seat 2: matiko09 (€203.99 in chips) 
Seat 3: Vikulja1993 (€108 in chips) 
Seat 4: torkkdnm (€149.71 in chips) 
Seat 5: cobrik23 (€67.74 in chips) 
Seat 6: HITYESCA (€105.12 in chips) 
Seat 7: rate8 (€100 in chips) 
Seat 8: lydia12345 (€100 in chips) 
Seat 9: stijner1986 (€141.33 in chips) 
lydia12345: posts small blind €0.50
stijner1986: posts big blind €1
*** HOLE CARDS ***
Dealt to matiko09 [2h 4s]
deadkiller1: folds 
matiko09: folds 
Vikulja1993: folds 
torkkdnm: folds 
cobrik23 has timed out
cobrik23: folds 
HITYESCA: folds 
rate8: folds 
lydia12345: folds 
Uncalled bet (€0.50) returned to stijner1986
stijner1986 collected €1 from pot
stijner1986: doesn't show hand 
*** SUMMARY ***
Total pot €1 | Rake €0 
Seat 1: deadkiller1 folded before Flop (didn't bet)
Seat 2: matiko09 folded before Flop (didn't bet)
Seat 3: Vikulja1993 folded before Flop (didn't bet)
Seat 4: torkkdnm folded before Flop (didn't bet)
Seat 5: cobrik23 folded before Flop (didn't bet)
Seat 6: HITYESCA folded before Flop (didn't bet)
Seat 7: rate8 (button) folded before Flop (didn't bet)
Seat 8: lydia12345 (small blind) folded before Flop
Seat 9: stijner1986 (big blind) collected (€1)





PokerStars Hand #153502293016:  Hold'em No Limit ($0.50/$1.00 USD) - 2016/05/18 20:31:16 CET [2016/05/18 14:31:16 ET]
Table 'Abetti II' 9-max Seat #7 is the button
Seat 1: matiko09 ($131.08 in chips) 
Seat 3: cobrik23 ($133.78 in chips) 
Seat 4: ipashutapkom ($45.50 in chips) 
Seat 5: blufthenuts ($137.02 in chips) 
Seat 6: I The King I ($153.39 in chips) 
Seat 7: nickreason17 ($133.46 in chips) 
Seat 8: roadster683 ($68.68 in chips) 
Seat 9: lydia12345 ($262.95 in chips) 
roadster683: posts small blind $0.50
lydia12345: posts big blind $1
Vikulja1993: sits out 
*** HOLE CARDS ***
Dealt to matiko09 [4s 5c]
matiko09: folds 
cobrik23: folds 
ipashutapkom: folds 
blufthenuts: raises $2 to $3
I The King I: folds 
nickreason17: folds 
roadster683: raises $4 to $7
lydia12345: folds 
blufthenuts: calls $4
*** FLOP *** [6h 9h 3c]
roadster683: bets $12
blufthenuts: folds 
Uncalled bet ($12) returned to roadster683
roadster683 collected $14.25 from pot
roadster683: doesn't show hand 
*** SUMMARY ***
Total pot $15 | Rake $0.75 
Board [6h 9h 3c]
Seat 1: matiko09 folded before Flop (didn't bet)
Seat 3: cobrik23 folded before Flop (didn't bet)
Seat 4: ipashutapkom folded before Flop (didn't bet)
Seat 5: blufthenuts folded on the Flop
Seat 6: I The King I folded before Flop (didn't bet)
Seat 7: nickreason17 (button) folded before Flop (didn't bet)
Seat 8: roadster683 (small blind) collected ($14.25)
Seat 9: lydia12345 (big blind) folded before Flop





PokerStars Hand #153502296522:  Hold'em No Limit ($1/$2 USD) - 2016/05/18 20:31:20 CET [2016/05/18 14:31:20 ET]
Table 'Letaba' 9-max Seat #7 is the button
Seat 2: staruk669 ($16.74 in chips) 
Seat 3: ersevi6 ($253.85 in chips) 
Seat 4: matiko09 ($200 in chips) 
Seat 5: Vikulja1993 ($302.25 in chips) 
Seat 6: donald0404 ($318.19 in chips) 
Seat 7: moshmachine ($290.97 in chips) 
Seat 8: lydia12345 ($200 in chips) 
Seat 9: tepi_guy ($279.94 in chips) 
lydia12345: posts small blind $1
tepi_guy: posts big blind $2
vanilica: sits out 
*** HOLE CARDS ***
Dealt to matiko09 [7s 5d]
staruk669: calls $2
ersevi6: raises $5 to $7
matiko09: folds 
Vikulja1993: folds 
donald0404: folds 
moshmachine: folds 
lydia12345: folds 
tepi_guy: folds 
staruk669: raises $9.74 to $16.74 and is all-in
ersevi6: calls $9.74
*** FLOP *** [8s Qc 7c]
*** TURN *** [8s Qc 7c] [8d]
*** RIVER *** [8s Qc 7c 8d] [4c]
*** SHOW DOWN ***
staruk669: shows [5h 5c] (two pair, Eights and Fives)
ersevi6: shows [Kc 9c] (a flush, King high)
ersevi6 collected $34.66 from pot
*** SUMMARY ***
Total pot $36.48 | Rake $1.82 
Board [8s Qc 7c 8d 4c]
Seat 2: staruk669 showed [5h 5c] and lost with two pair, Eights and Fives
Seat 3: ersevi6 showed [Kc 9c] and won ($34.66) with a flush, King high
Seat 4: matiko09 folded before Flop (didn't bet)
Seat 5: Vikulja1993 folded before Flop (didn't bet)
Seat 6: donald0404 folded before Flop (didn't bet)
Seat 7: moshmachine (button) folded before Flop (didn't bet)
Seat 8: lydia12345 (small blind) folded before Flop
Seat 9: tepi_guy (big blind) folded before Flop





PokerStars Hand #153502300357:  Hold'em No Limit ($1/$2 USD) - 2016/05/18 20:31:24 CET [2016/05/18 14:31:24 ET]
Table 'Chlosinde' 9-max Seat #2 is the button
Seat 2: lydia12345 ($201.40 in chips) 
Seat 3: matiko09 ($225.56 in chips) 
Seat 5: tepi_guy ($861.49 in chips) 
Seat 7: donald0404 ($235.11 in chips) 
Seat 8: sanducu_eu ($209.03 in chips) 
Seat 9: Tey113 ($542.56 in chips) 
matiko09: posts small blind $1
FREDY BULLIT: is sitting out 
tepi_guy: posts big blind $2
Vikulja1993: sits out 
FREDY BULLIT leaves the table
uonlylive1ce: sits out 
*** HOLE CARDS ***
Dealt to matiko09 [3d 8s]
donald0404: folds 
sanducu_eu: folds 
Tey113: folds 
lydia12345: raises $2 to $4
matiko09: folds 
vanilica joins the table at seat #4 
tepi_guy has timed out
tepi_guy: folds 
Uncalled bet ($2) returned to lydia12345
lydia12345 collected $5 from pot
*** SUMMARY ***
Total pot $5 | Rake $0 
Seat 2: lydia12345 (button) collected ($5)
Seat 3: matiko09 (small blind) folded before Flop
Seat 5: tepi_guy (big blind) folded before Flop
Seat 7: donald0404 folded before Flop (didn't bet)
Seat 8: sanducu_eu folded before Flop (didn't bet)
Seat 9: Tey113 folded before Flop (didn't bet)





PokerStars Hand #153502304859:  Hold'em No Limit ($0.50/$1.00 USD) - 2016/05/18 20:31:29 CET [2016/05/18 14:31:29 ET]
Table 'Pandora' 9-max Seat #6 is the button
Seat 1: deadkiller1 ($139.02 in chips) 
Seat 2: fack_vi ($75.87 in chips) 
Seat 3: tipner ($100 in chips) 
Seat 4: mooose100 ($105.46 in chips) 
Seat 6: Moszes360 ($100 in chips) 
Seat 7: lydia12345 ($106.32 in chips) 
Seat 8: matiko09 ($119.52 in chips) 
Seat 9: oscarleon ($113.98 in chips) 
lydia12345: posts small blind $0.50
matiko09: posts big blind $1
nickreason17: sits out 
*** HOLE CARDS ***
Dealt to matiko09 [Qh Kc]
oscarleon: folds 
deadkiller1: folds 
fack_vi: folds 
tipner: folds 
tipner leaves the table
smolski15 joins the table at seat #3 
mooose100 has timed out
mooose100: folds 
Moszes360: raises $1.10 to $2.10
smolski15 leaves the table
lydia12345: folds 
matiko09: folds 
Uncalled bet ($1.10) returned to Moszes360
Moszes360 collected $2.50 from pot
Moszes360: doesn't show hand 
*** SUMMARY ***
Total pot $2.50 | Rake $0 
Seat 1: deadkiller1 folded before Flop (didn't bet)
Seat 2: fack_vi folded before Flop (didn't bet)
Seat 3: tipner folded before Flop (didn't bet)
Seat 4: mooose100 folded before Flop (didn't bet)
Seat 6: Moszes360 (button) collected ($2.50)
Seat 7: lydia12345 (small blind) folded before Flop
Seat 8: matiko09 (big blind) folded before Flop
Seat 9: oscarleon folded before Flop (didn't bet)





PokerStars Hand #153502314517:  Hold'em No Limit ($0.50/$1.00 USD) - 2016/05/18 20:31:40 CET [2016/05/18 14:31:40 ET]
Table 'Kayala' 9-max Seat #9 is the button
Seat 1: deadkiller1 ($108.40 in chips) 
Seat 2: Oelie7 ($176.53 in chips) 
Seat 3: matiko09 ($100 in chips) 
Seat 4: HITYESCA ($100 in chips) 
Seat 6: lydia12345 ($120.62 in chips) 
Seat 7: nickreason17 ($116.16 in chips) 
Seat 9: Vikulja1993 ($100 in chips) 
deadkiller1: posts small blind $0.50
Oelie7: posts big blind $1
rate8: sits out 
*** HOLE CARDS ***
Dealt to matiko09 [3c 9s]
matiko09: folds 
HITYESCA has timed out
HITYESCA: folds 
lydia12345: folds 
nickreason17: folds 
Vikulja1993: raises $1 to $2
deadkiller1: folds 
Oelie7: calls $1
*** FLOP *** [3h Kd 4h]
Oelie7: checks 
Vikulja1993: bets $3
Oelie7: folds 
Uncalled bet ($3) returned to Vikulja1993
Vikulja1993 collected $4.28 from pot
Vikulja1993: doesn't show hand 
*** SUMMARY ***
Total pot $4.50 | Rake $0.22 
Board [3h Kd 4h]
Seat 1: deadkiller1 (small blind) folded before Flop
Seat 2: Oelie7 (big blind) folded on the Flop
Seat 3: matiko09 folded before Flop (didn't bet)
Seat 4: HITYESCA folded before Flop (didn't bet)
Seat 6: lydia12345 folded before Flop (didn't bet)
Seat 7: nickreason17 folded before Flop (didn't bet)
Seat 9: Vikulja1993 (button) collected ($4.28)





PokerStars Hand #153502321241:  Hold'em No Limit ($0.50/$1.00 USD) - 2016/05/18 20:31:48 CET [2016/05/18 14:31:48 ET]
Table 'Tatjana III' 9-max Seat #4 is the button
Seat 1: cobrik23 ($48.91 in chips) 
Seat 2: HITYESCA ($123.82 in chips) 
Seat 3: matiko09 ($186.84 in chips) 
Seat 4: lydia12345 ($129.80 in chips) 
Seat 5: deadkiller1 ($115.44 in chips) 
Seat 6: nickreason17 ($127.62 in chips) 
Seat 7: rene1984tsv ($136.19 in chips) 
Seat 8: JACQUILF ($111.80 in chips) 
Seat 9: Moszes360 ($104.12 in chips) 
deadkiller1: posts small blind $0.50
nickreason17: posts big blind $1
*** HOLE CARDS ***
Dealt to matiko09 [6d Kc]
rene1984tsv: calls $1
JACQUILF: folds 
Moszes360: folds 
cobrik23: raises $4 to $5
HITYESCA: folds 
matiko09: folds 
lydia12345: folds 
deadkiller1: folds 
nickreason17: folds 
rene1984tsv: calls $4
*** FLOP *** [9c 9h 8c]
rene1984tsv: checks 
cobrik23: bets $8
rene1984tsv: calls $8
*** TURN *** [9c 9h 8c] [2d]
rene1984tsv: checks 
cobrik23: bets $35.91 and is all-in
rene1984tsv: calls $35.91
*** RIVER *** [9c 9h 8c 2d] [4c]
*** SHOW DOWN ***
rene1984tsv: shows [4s 8s] (two pair, Nines and Eights)
cobrik23: shows [Tc Qc] (a flush, Queen high)
cobrik23 collected $96.82 from pot
*** SUMMARY ***
Total pot $99.32 | Rake $2.50 
Board [9c 9h 8c 2d 4c]
Seat 1: cobrik23 showed [Tc Qc] and won ($96.82) with a flush, Queen high
Seat 2: HITYESCA folded before Flop (didn't bet)
Seat 3: matiko09 folded before Flop (didn't bet)
Seat 4: lydia12345 (button) folded before Flop (didn't bet)
Seat 5: deadkiller1 (small blind) folded before Flop
Seat 6: nickreason17 (big blind) folded before Flop
Seat 7: rene1984tsv showed [4s 8s] and lost with two pair, Nines and Eights
Seat 8: JACQUILF folded before Flop (didn't bet)
Seat 9: Moszes360 folded before Flop (didn't bet)





PokerStars Hand #153502327686:  Hold'em No Limit ($0.50/$1.00 USD) - 2016/05/18 20:31:55 CET [2016/05/18 14:31:55 ET]
Table 'Terpsichore' 9-max Seat #2 is the button
Seat 1: oscarleon ($153.75 in chips) 
Seat 2: Moszes360 ($106.96 in chips) 
Seat 3: blufthenuts ($307.57 in chips) 
Seat 4: torkkdnm ($144.41 in chips) 
Seat 5: I The King I ($139.79 in chips) 
Seat 6: pyfyezi2016 ($93.63 in chips) 
Seat 8: matiko09 ($100 in chips) 
Seat 9: Quangis ($45.52 in chips) 
blufthenuts: posts small blind $0.50
torkkdnm: posts big blind $1
*** HOLE CARDS ***
Dealt to matiko09 [Kc Tc]
I The King I: folds 
pyfyezi2016: folds 
matiko09: raises $2 to $3
Quangis: folds 
oscarleon: folds 
Moszes360: folds 
blufthenuts: folds 
torkkdnm: calls $2
*** FLOP *** [6s 8s 7d]
torkkdnm: checks 
matiko09: checks 
*** TURN *** [6s 8s 7d] [5d]
torkkdnm: bets $4
matiko09: folds 
Uncalled bet ($4) returned to torkkdnm
torkkdnm collected $6.18 from pot
*** SUMMARY ***
Total pot $6.50 | Rake $0.32 
Board [6s 8s 7d 5d]
Seat 1: oscarleon folded before Flop (didn't bet)
Seat 2: Moszes360 (button) folded before Flop (didn't bet)
Seat 3: blufthenuts (small blind) folded before Flop
Seat 4: torkkdnm (big blind) collected ($6.18)
Seat 5: I The King I folded before Flop (didn't bet)
Seat 6: pyfyezi2016 folded before Flop (didn't bet)
Seat 8: matiko09 folded on the Turn
Seat 9: Quangis folded before Flop (didn't bet)





PokerStars Hand #153502337561:  Hold'em No Limit ($1/$2 USD) - 2016/05/18 20:32:07 CET [2016/05/18 14:32:07 ET]
Table 'Chlosinde' 9-max Seat #3 is the button
Seat 2: lydia12345 ($204.40 in chips) 
Seat 3: matiko09 ($224.56 in chips) 
Seat 5: tepi_guy ($859.49 in chips) 
Seat 6: Vikulja1993 ($200 in chips) 
Seat 7: donald0404 ($235.11 in chips) 
Seat 8: sanducu_eu ($209.03 in chips) 
Seat 9: Tey113 ($542.56 in chips) 
vanilica will be allowed to play after the button
tepi_guy: posts small blind $1
Vikulja1993: posts big blind $2
uonlylive1ce: sits out 
*** HOLE CARDS ***
Dealt to matiko09 [6h 8c]
donald0404: folds 
sanducu_eu: folds 
Tey113: calls $2
lydia12345: folds 
matiko09: folds 
tepi_guy has timed out
tepi_guy: folds 
Vikulja1993: raises $6 to $8
Tey113: calls $6
*** FLOP *** [2h 8h Js]
Vikulja1993: bets $10
Tey113: folds 
Uncalled bet ($10) returned to Vikulja1993
Vikulja1993 collected $16.15 from pot
Vikulja1993: doesn't show hand 
*** SUMMARY ***
Total pot $17 | Rake $0.85 
Board [2h 8h Js]
Seat 2: lydia12345 folded before Flop (didn't bet)
Seat 3: matiko09 (button) folded before Flop (didn't bet)
Seat 5: tepi_guy (small blind) folded before Flop
Seat 6: Vikulja1993 (big blind) collected ($16.15)
Seat 7: donald0404 folded before Flop (didn't bet)
Seat 8: sanducu_eu folded before Flop (didn't bet)
Seat 9: Tey113 folded on the Flop





PokerStars Hand #153502339334:  Hold'em No Limit ($0.50/$1.00 USD) - 2016/05/18 20:32:09 CET [2016/05/18 14:32:09 ET]
Table 'Pandora' 9-max Seat #7 is the button
Seat 1: deadkiller1 ($139.02 in chips) 
Seat 2: fack_vi ($75.87 in chips) 
Seat 6: Moszes360 ($101.50 in chips) 
Seat 7: lydia12345 ($105.82 in chips) 
Seat 8: matiko09 ($118.52 in chips) 
Seat 9: oscarleon ($113.98 in chips) 
matiko09: posts small blind $0.50
oscarleon: posts big blind $1
*** HOLE CARDS ***
Dealt to matiko09 [3h Jd]
deadkiller1: folds 
TimStone joins the table at seat #3 
fack_vi: folds 
Moszes360: folds 
lydia12345: folds 
matiko09: folds 
Uncalled bet ($0.50) returned to oscarleon
oscarleon collected $1 from pot
oscarleon: doesn't show hand 
*** SUMMARY ***
Total pot $1 | Rake $0 
Seat 1: deadkiller1 folded before Flop (didn't bet)
Seat 2: fack_vi folded before Flop (didn't bet)
Seat 6: Moszes360 folded before Flop (didn't bet)
Seat 7: lydia12345 (button) folded before Flop (didn't bet)
Seat 8: matiko09 (small blind) folded before Flop
Seat 9: oscarleon (big blind) collected ($1)





PokerStars Hand #153502345080:  Hold'em No Limit ($0.50/$1.00 USD) - 2016/05/18 20:32:15 CET [2016/05/18 14:32:15 ET]
Table 'Suevia' 9-max Seat #3 is the button
Seat 2: deadkiller1 ($100 in chips) 
Seat 3: matiko09 ($100 in chips) 
Seat 4: HITYESCA ($100 in chips) 
Seat 5: bello1310 ($84.45 in chips) 
Seat 6: torkkdnm ($127.16 in chips) 
Seat 7: cobrik23 ($82.15 in chips) 
Seat 8: ama58 ($54.08 in chips) 
Seat 9: oscarleon ($136.37 in chips) 
HITYESCA: posts small blind $0.50
bello1310: posts big blind $1
Moszes360: sits out 
*** HOLE CARDS ***
Dealt to matiko09 [5s 3d]
torkkdnm: folds 
cobrik23: folds 
ama58: folds 
cobrik23 leaves the table
oscarleon: folds 
deadkiller1: folds 
IRAVABAN joins the table at seat #7 
matiko09: folds 
HITYESCA: folds 
Uncalled bet ($0.50) returned to bello1310
bello1310 collected $1 from pot
bello1310: doesn't show hand 
*** SUMMARY ***
Total pot $1 | Rake $0 
Seat 2: deadkiller1 folded before Flop (didn't bet)
Seat 3: matiko09 (button) folded before Flop (didn't bet)
Seat 4: HITYESCA (small blind) folded before Flop
Seat 5: bello1310 (big blind) collected ($1)
Seat 6: torkkdnm folded before Flop (didn't bet)
Seat 7: cobrik23 folded before Flop (didn't bet)
Seat 8: ama58 folded before Flop (didn't bet)
Seat 9: oscarleon folded before Flop (didn't bet)





PokerStars Hand #153502345782:  Hold'em No Limit ($0.50/$1.00 USD) - 2016/05/18 20:32:16 CET [2016/05/18 14:32:16 ET]
Table 'Barto' 9-max Seat #3 is the button
Seat 1: IRAVABAN ($44.50 in chips) 
Seat 2: buttonlife ($100 in chips) 
Seat 3: pokerstereke ($94.21 in chips) 
Seat 4: Kihog ($103.62 in chips) 
Seat 5: matiko09 ($100 in chips) 
Seat 6: Mumerka ($40 in chips) 
Seat 7: deadkiller1 ($100 in chips) 
Seat 8: sanr23 ($100 in chips) 
Seat 9: gongqingss ($47.88 in chips) 
Kihog: posts small blind $0.50
matiko09: posts big blind $1
*** HOLE CARDS ***
Dealt to matiko09 [As 7h]
Mumerka: folds 
deadkiller1: folds 
sanr23: raises $2 to $3
gongqingss: folds 
IRAVABAN: folds 
buttonlife: folds 
pokerstereke: folds 
Kihog: folds 
Mumerka leaves the table
matiko09: folds 
Uncalled bet ($2) returned to sanr23
sanr23 collected $2.50 from pot
sanr23: doesn't show hand 
*** SUMMARY ***
Total pot $2.50 | Rake $0 
Seat 1: IRAVABAN folded before Flop (didn't bet)
Seat 2: buttonlife folded before Flop (didn't bet)
Seat 3: pokerstereke (button) folded before Flop (didn't bet)
Seat 4: Kihog (small blind) folded before Flop
Seat 5: matiko09 (big blind) folded before Flop
Seat 6: Mumerka folded before Flop (didn't bet)
Seat 7: deadkiller1 folded before Flop (didn't bet)
Seat 8: sanr23 collected ($2.50)
Seat 9: gongqingss folded before Flop (didn't bet)





PokerStars Hand #153502357270:  Hold'em No Limit ($0.50/$1.00 USD) - 2016/05/18 20:32:30 CET [2016/05/18 14:32:30 ET]
Table 'Pandora' 9-max Seat #8 is the button
Seat 1: deadkiller1 ($139.02 in chips) 
Seat 2: fack_vi ($75.87 in chips) 
Seat 4: mooose100 ($105.46 in chips) 
Seat 6: Moszes360 ($101.50 in chips) 
Seat 7: lydia12345 ($105.82 in chips) 
Seat 8: matiko09 ($118.02 in chips) 
Seat 9: oscarleon ($114.48 in chips) 
oscarleon: posts small blind $0.50
deadkiller1: posts big blind $1
TimStone: sits out 
*** HOLE CARDS ***
Dealt to matiko09 [Th 6c]
fack_vi: folds 
mooose100: calls $1
Moszes360: folds 
lydia12345: folds 
matiko09: folds 
oscarleon: folds 
deadkiller1: checks 
*** FLOP *** [6s Ac 7s]
deadkiller1: checks 
mooose100: checks 
*** TURN *** [6s Ac 7s] [Ad]
deadkiller1: bets $2
mooose100: folds 
Uncalled bet ($2) returned to deadkiller1
deadkiller1 collected $2.38 from pot
deadkiller1: doesn't show hand 
*** SUMMARY ***
Total pot $2.50 | Rake $0.12 
Board [6s Ac 7s Ad]
Seat 1: deadkiller1 (big blind) collected ($2.38)
Seat 2: fack_vi folded before Flop (didn't bet)
Seat 4: mooose100 folded on the Turn
Seat 6: Moszes360 folded before Flop (didn't bet)
Seat 7: lydia12345 folded before Flop (didn't bet)
Seat 8: matiko09 (button) folded before Flop (didn't bet)
Seat 9: oscarleon (small blind) folded before Flop





PokerStars Hand #153502361198:  Hold'em No Limit ($0.50/$1.00 USD) - 2016/05/18 20:32:34 CET [2016/05/18 14:32:34 ET]
Table 'Barto' 9-max Seat #4 is the button
Seat 1: IRAVABAN ($44.50 in chips) 
Seat 2: buttonlife ($100 in chips) 
Seat 3: pokerstereke ($94.21 in chips) 
Seat 4: Kihog ($103.12 in chips) 
Seat 5: matiko09 ($100 in chips) 
Seat 7: deadkiller1 ($100 in chips) 
Seat 8: sanr23 ($101.50 in chips) 
Seat 9: gongqingss ($47.88 in chips) 
matiko09: posts small blind $0.50
deadkiller1: posts big blind $1
*** HOLE CARDS ***
Dealt to matiko09 [3h 8d]
vanilica joins the table at seat #6 
sanr23: folds 
gongqingss: calls $1
IRAVABAN: folds 
buttonlife: folds 
pokerstereke: folds 
Kihog: raises $2.50 to $3.50
matiko09: folds 
deadkiller1: folds 
gongqingss: calls $2.50
*** FLOP *** [Ah Ts 5d]
gongqingss: checks 
Kihog: bets $4
gongqingss: folds 
Uncalled bet ($4) returned to Kihog
Kihog collected $8.08 from pot
Kihog: doesn't show hand 
*** SUMMARY ***
Total pot $8.50 | Rake $0.42 
Board [Ah Ts 5d]
Seat 1: IRAVABAN folded before Flop (didn't bet)
Seat 2: buttonlife folded before Flop (didn't bet)
Seat 3: pokerstereke folded before Flop (didn't bet)
Seat 4: Kihog (button) collected ($8.08)
Seat 5: matiko09 (small blind) folded before Flop
Seat 7: deadkiller1 (big blind) folded before Flop
Seat 8: sanr23 folded before Flop (didn't bet)
Seat 9: gongqingss folded on the Flop





PokerStars Hand #153502362066:  Hold'em No Limit ($1/$2 USD) - 2016/05/18 20:32:35 CET [2016/05/18 14:32:35 ET]
Table 'Letaba' 9-max Seat #8 is the button
Seat 1: vanilica ($200 in chips) 
Seat 3: ersevi6 ($271.77 in chips) 
Seat 4: matiko09 ($200 in chips) 
Seat 5: Vikulja1993 ($302.25 in chips) 
Seat 6: donald0404 ($318.19 in chips) 
Seat 7: moshmachine ($290.97 in chips) 
Seat 8: lydia12345 ($200 in chips) 
Seat 9: tepi_guy ($277.94 in chips) 
tepi_guy: posts small blind $1
vanilica: posts big blind $2
*** HOLE CARDS ***
Dealt to matiko09 [Jc 3s]
ersevi6: folds 
matiko09: folds 
staruk669 leaves the table
Sharknebulah joins the table at seat #2 
Vikulja1993: folds 
donald0404: folds 
moshmachine: raises $2.68 to $4.68
lydia12345: raises $13.32 to $18
tepi_guy: folds 
vanilica: folds 
moshmachine: folds 
Uncalled bet ($13.32) returned to lydia12345
lydia12345 collected $12.36 from pot
*** SUMMARY ***
Total pot $12.36 | Rake $0 
Seat 1: vanilica (big blind) folded before Flop
Seat 3: ersevi6 folded before Flop (didn't bet)
Seat 4: matiko09 folded before Flop (didn't bet)
Seat 5: Vikulja1993 folded before Flop (didn't bet)
Seat 6: donald0404 folded before Flop (didn't bet)
Seat 7: moshmachine folded before Flop
Seat 8: lydia12345 (button) collected ($12.36)
Seat 9: tepi_guy (small blind) folded before Flop





PokerStars Hand #153502362643:  Hold'em No Limit ($0.50/$1.00 USD) - 2016/05/18 20:32:36 CET [2016/05/18 14:32:36 ET]
Table 'Suevia' 9-max Seat #4 is the button
Seat 2: deadkiller1 ($100 in chips) 
Seat 3: matiko09 ($100 in chips) 
Seat 4: HITYESCA ($100 in chips) 
Seat 5: bello1310 ($84.95 in chips) 
Seat 6: torkkdnm ($127.16 in chips) 
Seat 8: ama58 ($54.08 in chips) 
Seat 9: oscarleon ($136.37 in chips) 
bello1310: posts small blind $0.50
torkkdnm: posts big blind $1
IRAVABAN: sits out 
Moszes360: sits out 
*** HOLE CARDS ***
Dealt to matiko09 [4c Kd]
ama58: folds 
oscarleon: folds 
deadkiller1: raises $2 to $3
matiko09: folds 
HITYESCA: folds 
bello1310: folds 
torkkdnm: folds 
Uncalled bet ($2) returned to deadkiller1
deadkiller1 collected $2.50 from pot
deadkiller1: doesn't show hand 
*** SUMMARY ***
Total pot $2.50 | Rake $0 
Seat 2: deadkiller1 collected ($2.50)
Seat 3: matiko09 folded before Flop (didn't bet)
Seat 4: HITYESCA (button) folded before Flop (didn't bet)
Seat 5: bello1310 (small blind) folded before Flop
Seat 6: torkkdnm (big blind) folded before Flop
Seat 8: ama58 folded before Flop (didn't bet)
Seat 9: oscarleon folded before Flop (didn't bet)





PokerStars Hand #153502364870:  Hold'em No Limit (€0.50/€1.00 EUR) - 2016/05/18 20:32:38 CET [2016/05/18 14:32:38 ET]
Table 'Pallas II' 9-max Seat #8 is the button
Seat 1: deadkiller1 (€105.50 in chips) 
Seat 2: matiko09 (€203.99 in chips) 
Seat 3: Vikulja1993 (€108 in chips) 
Seat 4: torkkdnm (€149.71 in chips) 
Seat 5: cobrik23 (€67.74 in chips) 
Seat 6: HITYESCA (€105.12 in chips) 
Seat 7: rate8 (€100 in chips) 
Seat 8: lydia12345 (€100 in chips) 
Seat 9: stijner1986 (€141.83 in chips) 
stijner1986: posts small blind €0.50
deadkiller1: posts big blind €1
*** HOLE CARDS ***
Dealt to matiko09 [8s Jc]
matiko09: folds 
Vikulja1993: folds 
torkkdnm: raises €2 to €3
cobrik23: folds 
HITYESCA: folds 
rate8: folds 
lydia12345: folds 
stijner1986: calls €2.50
deadkiller1: folds 
*** FLOP *** [Qs 5c 4d]
stijner1986: bets €5
torkkdnm: folds 
Uncalled bet (€5) returned to stijner1986
stijner1986 collected €6.65 from pot
stijner1986: doesn't show hand 
*** SUMMARY ***
Total pot €7 | Rake €0.35 
Board [Qs 5c 4d]
Seat 1: deadkiller1 (big blind) folded before Flop
Seat 2: matiko09 folded before Flop (didn't bet)
Seat 3: Vikulja1993 folded before Flop (didn't bet)
Seat 4: torkkdnm folded on the Flop
Seat 5: cobrik23 folded before Flop (didn't bet)
Seat 6: HITYESCA folded before Flop (didn't bet)
Seat 7: rate8 folded before Flop (didn't bet)
Seat 8: lydia12345 (button) folded before Flop (didn't bet)
Seat 9: stijner1986 (small blind) collected (€6.65)





PokerStars Hand #153502379387:  Hold'em No Limit ($0.50/$1.00 USD) - 2016/05/18 20:32:55 CET [2016/05/18 14:32:55 ET]
Table 'Terpsichore' 9-max Seat #3 is the button
Seat 1: oscarleon ($153.75 in chips) 
Seat 2: Moszes360 ($106.96 in chips) 
Seat 3: blufthenuts ($307.07 in chips) 
Seat 4: torkkdnm ($147.59 in chips) 
Seat 5: I The King I ($139.79 in chips) 
Seat 6: pyfyezi2016 ($93.63 in chips) 
Seat 8: matiko09 ($100 in chips) 
Seat 9: Quangis ($45.52 in chips) 
torkkdnm: posts small blind $0.50
I The King I: posts big blind $1
*** HOLE CARDS ***
Dealt to matiko09 [Kh 6s]
pyfyezi2016: folds 
matiko09: folds 
Quangis: folds 
oscarleon: folds 
Moszes360: folds 
blufthenuts: raises $2 to $3
torkkdnm: folds 
I The King I: folds 
Uncalled bet ($2) returned to blufthenuts
blufthenuts collected $2.50 from pot
blufthenuts: doesn't show hand 
*** SUMMARY ***
Total pot $2.50 | Rake $0 
Seat 1: oscarleon folded before Flop (didn't bet)
Seat 2: Moszes360 folded before Flop (didn't bet)
Seat 3: blufthenuts (button) collected ($2.50)
Seat 4: torkkdnm (small blind) folded before Flop
Seat 5: I The King I (big blind) folded before Flop
Seat 6: pyfyezi2016 folded before Flop (didn't bet)
Seat 8: matiko09 folded before Flop (didn't bet)
Seat 9: Quangis folded before Flop (didn't bet)





PokerStars Hand #153502379142:  Hold'em No Limit ($0.50/$1.00 USD) - 2016/05/18 20:32:55 CET [2016/05/18 14:32:55 ET]
Table 'Abetti II' 9-max Seat #8 is the button
Seat 1: matiko09 ($131.08 in chips) 
Seat 3: cobrik23 ($133.78 in chips) 
Seat 4: ipashutapkom ($45.50 in chips) 
Seat 5: blufthenuts ($130.02 in chips) 
Seat 6: I The King I ($153.39 in chips) 
Seat 7: nickreason17 ($133.46 in chips) 
Seat 8: roadster683 ($75.93 in chips) 
Seat 9: lydia12345 ($261.95 in chips) 
lydia12345: posts small blind $0.50
matiko09: posts big blind $1
Vikulja1993: sits out 
*** HOLE CARDS ***
Dealt to matiko09 [Th 6h]
cobrik23: raises $1 to $2
ipashutapkom: folds 
blufthenuts: folds 
I The King I: folds 
nickreason17: folds 
roadster683: raises $3 to $5
lydia12345: folds 
matiko09: folds 
cobrik23: calls $3
*** FLOP *** [7c 5h 5c]
cobrik23: checks 
roadster683: bets $10
cobrik23: folds 
Uncalled bet ($10) returned to roadster683
roadster683 collected $10.92 from pot
roadster683: doesn't show hand 
*** SUMMARY ***
Total pot $11.50 | Rake $0.58 
Board [7c 5h 5c]
Seat 1: matiko09 (big blind) folded before Flop
Seat 3: cobrik23 folded on the Flop
Seat 4: ipashutapkom folded before Flop (didn't bet)
Seat 5: blufthenuts folded before Flop (didn't bet)
Seat 6: I The King I folded before Flop (didn't bet)
Seat 7: nickreason17 folded before Flop (didn't bet)
Seat 8: roadster683 (button) collected ($10.92)
Seat 9: lydia12345 (small blind) folded before Flop





PokerStars Hand #153502381893:  Hold'em No Limit ($0.50/$1.00 USD) - 2016/05/18 20:32:58 CET [2016/05/18 14:32:58 ET]
Table 'Suevia' 9-max Seat #5 is the button
Seat 2: deadkiller1 ($101.50 in chips) 
Seat 3: matiko09 ($100 in chips) 
Seat 4: HITYESCA ($100 in chips) 
Seat 5: bello1310 ($84.45 in chips) 
Seat 6: torkkdnm ($126.16 in chips) 
Seat 7: IRAVABAN ($40 in chips) 
Seat 8: ama58 ($54.08 in chips) 
Seat 9: oscarleon ($136.37 in chips) 
torkkdnm: posts small blind $0.50
IRAVABAN: posts big blind $1
Moszes360: sits out 
*** HOLE CARDS ***
Dealt to matiko09 [6c Td]
ama58: folds 
oscarleon: folds 
deadkiller1: folds 
matiko09: folds 
HITYESCA: folds 
bello1310: folds 
torkkdnm: folds 
Uncalled bet ($0.50) returned to IRAVABAN
IRAVABAN collected $1 from pot
IRAVABAN: doesn't show hand 
*** SUMMARY ***
Total pot $1 | Rake $0 
Seat 2: deadkiller1 folded before Flop (didn't bet)
Seat 3: matiko09 folded before Flop (didn't bet)
Seat 4: HITYESCA folded before Flop (didn't bet)
Seat 5: bello1310 (button) folded before Flop (didn't bet)
Seat 6: torkkdnm (small blind) folded before Flop
Seat 7: IRAVABAN (big blind) collected ($1)
Seat 8: ama58 folded before Flop (didn't bet)
Seat 9: oscarleon folded before Flop (didn't bet)





PokerStars Hand #153502387296:  Hold'em No Limit ($0.50/$1.00 USD) - 2016/05/18 20:33:04 CET [2016/05/18 14:33:04 ET]
Table 'Kayala' 9-max Seat #1 is the button
Seat 1: deadkiller1 ($107.90 in chips) 
Seat 2: Oelie7 ($174.53 in chips) 
Seat 3: matiko09 ($100 in chips) 
Seat 4: HITYESCA ($100 in chips) 
Seat 6: lydia12345 ($120.62 in chips) 
Seat 7: nickreason17 ($116.16 in chips) 
Seat 9: Vikulja1993 ($102.28 in chips) 
Oelie7: posts small blind $0.50
matiko09: posts big blind $1
rate8: sits out 
cobrik23: sits out 
*** HOLE CARDS ***
Dealt to matiko09 [4s Tc]
HITYESCA: folds 
lydia12345: folds 
nickreason17: folds 
Vikulja1993: raises $1.50 to $2.50
deadkiller1: folds 
Oelie7: calls $2
matiko09: folds 
*** FLOP *** [9s 3h Ah]
Oelie7: checks 
Vikulja1993: bets $3
Oelie7: folds 
Uncalled bet ($3) returned to Vikulja1993
Vikulja1993 collected $5.70 from pot
Vikulja1993: doesn't show hand 
*** SUMMARY ***
Total pot $6 | Rake $0.30 
Board [9s 3h Ah]
Seat 1: deadkiller1 (button) folded before Flop (didn't bet)
Seat 2: Oelie7 (small blind) folded on the Flop
Seat 3: matiko09 (big blind) folded before Flop
Seat 4: HITYESCA folded before Flop (didn't bet)
Seat 6: lydia12345 folded before Flop (didn't bet)
Seat 7: nickreason17 folded before Flop (didn't bet)
Seat 9: Vikulja1993 collected ($5.70)





PokerStars Hand #153502388024:  Hold'em No Limit ($0.50/$1.00 USD) - 2016/05/18 20:33:05 CET [2016/05/18 14:33:05 ET]
Table 'Tatjana III' 9-max Seat #5 is the button
Seat 1: cobrik23 ($96.82 in chips) 
Seat 2: HITYESCA ($123.82 in chips) 
Seat 3: matiko09 ($186.84 in chips) 
Seat 4: lydia12345 ($129.80 in chips) 
Seat 5: deadkiller1 ($114.94 in chips) 
Seat 6: nickreason17 ($126.62 in chips) 
Seat 7: rene1984tsv ($87.28 in chips) 
Seat 8: JACQUILF ($111.80 in chips) 
Seat 9: Moszes360 ($104.12 in chips) 
nickreason17: posts small blind $0.50
rene1984tsv: posts big blind $1
*** HOLE CARDS ***
Dealt to matiko09 [9h 4d]
JACQUILF: folds 
Moszes360: folds 
cobrik23: folds 
HITYESCA: folds 
matiko09: folds 
lydia12345: raises $2 to $3
deadkiller1: folds 
nickreason17: folds 
rene1984tsv: calls $2
*** FLOP *** [Ad 8h Kd]
rene1984tsv: checks 
lydia12345: bets $4.20
rene1984tsv: folds 
Uncalled bet ($4.20) returned to lydia12345
lydia12345 collected $6.18 from pot
*** SUMMARY ***
Total pot $6.50 | Rake $0.32 
Board [Ad 8h Kd]
Seat 1: cobrik23 folded before Flop (didn't bet)
Seat 2: HITYESCA folded before Flop (didn't bet)
Seat 3: matiko09 folded before Flop (didn't bet)
Seat 4: lydia12345 collected ($6.18)
Seat 5: deadkiller1 (button) folded before Flop (didn't bet)
Seat 6: nickreason17 (small blind) folded before Flop
Seat 7: rene1984tsv (big blind) folded on the Flop
Seat 8: JACQUILF folded before Flop (didn't bet)
Seat 9: Moszes360 folded before Flop (didn't bet)





PokerStars Hand #153502395125:  Hold'em No Limit ($0.50/$1.00 USD) - 2016/05/18 20:33:13 CET [2016/05/18 14:33:13 ET]
Table 'Erida II' 9-max Seat #1 is the button
Seat 1: vanilica ($100 in chips) 
Seat 2: cobrik23 ($93.50 in chips) 
Seat 3: Kelvin sai ($164.26 in chips) 
Seat 4: FLQHenrici ($104.12 in chips) 
Seat 5: Moszes360 ($101.50 in chips) 
Seat 6: deadkiller1 ($153.86 in chips) 
Seat 7: matiko09 ($100 in chips) 
Seat 9: sanr23 ($100 in chips) 
cobrik23: posts small blind $0.50
Kelvin sai: posts big blind $1
Kihog: sits out 
*** HOLE CARDS ***
Dealt to matiko09 [Jh Th]
FLQHenrici: folds 
Moszes360: folds 
FLQHenrici leaves the table
deadkiller1: folds 
HITYESCA joins the table at seat #4 
matiko09: raises $2 to $3
sanr23: folds 
vanilica: calls $3
cobrik23: folds 
Kelvin sai: calls $2
*** FLOP *** [Ts 3c Qs]
Kelvin sai: bets $3
matiko09: calls $3
vanilica: raises $8 to $11
Kelvin sai: calls $8
matiko09: folds 
*** TURN *** [Ts 3c Qs] [6d]
Kelvin sai: checks 
vanilica: bets $24.25
Kelvin sai: calls $24.25
*** RIVER *** [Ts 3c Qs 6d] [Js]
Kelvin sai: checks 
vanilica: bets $61.75 and is all-in
Kelvin sai: calls $61.75
*** SHOW DOWN ***
vanilica: shows [Qc Qh] (three of a kind, Queens)
Kelvin sai: shows [2s 4s] (a flush, Queen high)
Kelvin sai collected $204 from pot
*** SUMMARY ***
Total pot $206.50 | Rake $2.50 
Board [Ts 3c Qs 6d Js]
Seat 1: vanilica (button) showed [Qc Qh] and lost with three of a kind, Queens
Seat 2: cobrik23 (small blind) folded before Flop
Seat 3: Kelvin sai (big blind) showed [2s 4s] and won ($204) with a flush, Queen high
Seat 4: FLQHenrici folded before Flop (didn't bet)
Seat 5: Moszes360 folded before Flop (didn't bet)
Seat 6: deadkiller1 folded before Flop (didn't bet)
Seat 7: matiko09 folded on the Flop
Seat 9: sanr23 folded before Flop (didn't bet)





PokerStars Hand #153502404153:  Hold'em No Limit ($0.50/$1.00 USD) - 2016/05/18 20:33:23 CET [2016/05/18 14:33:23 ET]
Table 'Terpsichore' 9-max Seat #4 is the button
Seat 1: oscarleon ($153.75 in chips) 
Seat 2: Moszes360 ($106.96 in chips) 
Seat 3: blufthenuts ($308.57 in chips) 
Seat 4: torkkdnm ($147.09 in chips) 
Seat 5: I The King I ($138.79 in chips) 
Seat 6: pyfyezi2016 ($93.63 in chips) 
Seat 8: matiko09 ($100 in chips) 
Seat 9: Quangis ($45.52 in chips) 
I The King I: posts small blind $0.50
pyfyezi2016: posts big blind $1
*** HOLE CARDS ***
Dealt to matiko09 [3h Js]
matiko09: folds 
Quangis: folds 
oscarleon: raises $2 to $3
Moszes360: folds 
blufthenuts: folds 
torkkdnm: folds 
I The King I: raises $7 to $10
pyfyezi2016: folds 
oscarleon: calls $7
*** FLOP *** [5h 9c 3s]
I The King I: bets $10
oscarleon: calls $10
*** TURN *** [5h 9c 3s] [Tc]
I The King I: checks 
oscarleon: checks 
*** RIVER *** [5h 9c 3s Tc] [As]
I The King I: bets $24
oscarleon: folds 
Uncalled bet ($24) returned to I The King I
I The King I collected $38.95 from pot
I The King I: doesn't show hand 
*** SUMMARY ***
Total pot $41 | Rake $2.05 
Board [5h 9c 3s Tc As]
Seat 1: oscarleon folded on the River
Seat 2: Moszes360 folded before Flop (didn't bet)
Seat 3: blufthenuts folded before Flop (didn't bet)
Seat 4: torkkdnm (button) folded before Flop (didn't bet)
Seat 5: I The King I (small blind) collected ($38.95)
Seat 6: pyfyezi2016 (big blind) folded before Flop
Seat 8: matiko09 folded before Flop (didn't bet)
Seat 9: Quangis folded before Flop (didn't bet)





PokerStars Hand #153502406198:  Hold'em No Limit ($0.50/$1.00 USD) - 2016/05/18 20:33:26 CET [2016/05/18 14:33:26 ET]
Table 'Barto' 9-max Seat #5 is the button
Seat 1: IRAVABAN ($44.50 in chips) 
Seat 2: buttonlife ($100 in chips) 
Seat 3: pokerstereke ($94.21 in chips) 
Seat 4: Kihog ($107.70 in chips) 
Seat 5: matiko09 ($100 in chips) 
Seat 7: deadkiller1 ($100 in chips) 
Seat 9: gongqingss ($44.38 in chips) 
vanilica will be allowed to play after the button
deadkiller1: posts small blind $0.50
sanr23: is sitting out 
gongqingss: posts big blind $1
*** HOLE CARDS ***
Dealt to matiko09 [Jh 3c]
IRAVABAN: folds 
sanr23 leaves the table
buttonlife: folds 
pokerstereke: folds 
Kihog: raises $1.50 to $2.50
matiko09: folds 
deadkiller1: folds 
gongqingss: calls $1.50
*** FLOP *** [8c 4c 8h]
gongqingss: checks 
Kihog: bets $2.50
gongqingss: calls $2.50
*** TURN *** [8c 4c 8h] [6s]
gongqingss: checks 
Kihog: checks 
*** RIVER *** [8c 4c 8h 6s] [6c]
gongqingss: checks 
Kihog: checks 
*** SHOW DOWN ***
gongqingss: shows [Tc Js] (two pair, Eights and Sixes)
Kihog: shows [7h Ah] (two pair, Eights and Sixes - Ace kicker)
Kihog collected $9.98 from pot
*** SUMMARY ***
Total pot $10.50 | Rake $0.52 
Board [8c 4c 8h 6s 6c]
Seat 1: IRAVABAN folded before Flop (didn't bet)
Seat 2: buttonlife folded before Flop (didn't bet)
Seat 3: pokerstereke folded before Flop (didn't bet)
Seat 4: Kihog showed [7h Ah] and won ($9.98) with two pair, Eights and Sixes
Seat 5: matiko09 (button) folded before Flop (didn't bet)
Seat 7: deadkiller1 (small blind) folded before Flop
Seat 9: gongqingss (big blind) showed [Tc Js] and lost with two pair, Eights and Sixes





PokerStars Hand #153502408351:  Hold'em No Limit ($0.50/$1.00 USD) - 2016/05/18 20:33:28 CET [2016/05/18 14:33:28 ET]
Table 'Pandora' 9-max Seat #9 is the button
Seat 1: deadkiller1 ($140.40 in chips) 
Seat 2: fack_vi ($75.87 in chips) 
Seat 4: mooose100 ($104.46 in chips) 
Seat 6: Moszes360 ($101.50 in chips) 
Seat 7: lydia12345 ($105.82 in chips) 
Seat 8: matiko09 ($118.02 in chips) 
Seat 9: oscarleon ($113.98 in chips) 
deadkiller1: posts small blind $0.50
fack_vi: posts big blind $1
TimStone: sits out 
*** HOLE CARDS ***
Dealt to matiko09 [4h Th]
mooose100: calls $1
Moszes360: folds 
lydia12345: folds 
matiko09: folds 
oscarleon: folds 
deadkiller1: raises $4 to $5
fack_vi: folds 
mooose100: calls $4
*** FLOP *** [6h Jc 6c]
deadkiller1: checks 
mooose100: bets $5.22
deadkiller1: folds 
Uncalled bet ($5.22) returned to mooose100
mooose100 collected $10.45 from pot
mooose100: doesn't show hand 
*** SUMMARY ***
Total pot $11 | Rake $0.55 
Board [6h Jc 6c]
Seat 1: deadkiller1 (small blind) folded on the Flop
Seat 2: fack_vi (big blind) folded before Flop
Seat 4: mooose100 collected ($10.45)
Seat 6: Moszes360 folded before Flop (didn't bet)
Seat 7: lydia12345 folded before Flop (didn't bet)
Seat 8: matiko09 folded before Flop (didn't bet)
Seat 9: oscarleon (button) folded before Flop (didn't bet)





PokerStars Hand #153502412315:  Hold'em No Limit ($0.50/$1.00 USD) - 2016/05/18 20:33:33 CET [2016/05/18 14:33:33 ET]
Table 'Suevia' 9-max Seat #6 is the button
Seat 2: deadkiller1 ($101.50 in chips) 
Seat 3: matiko09 ($100 in chips) 
Seat 4: HITYESCA ($100 in chips) 
Seat 5: bello1310 ($84.45 in chips) 
Seat 6: torkkdnm ($125.66 in chips) 
Seat 7: IRAVABAN ($40.50 in chips) 
Seat 8: ama58 ($54.08 in chips) 
Seat 9: oscarleon ($136.37 in chips) 
IRAVABAN: posts small blind $0.50
ama58: posts big blind $1
Moszes360: sits out 
*** HOLE CARDS ***
Dealt to matiko09 [4c 2s]
oscarleon: folds 
deadkiller1: raises $2 to $3
matiko09: folds 
HITYESCA: folds 
bello1310: calls $3
torkkdnm: folds 
IRAVABAN: folds 
ama58: calls $2
*** FLOP *** [7c Qc 5d]
ama58: checks 
deadkiller1: checks 
bello1310: checks 
*** TURN *** [7c Qc 5d] [Tc]
ama58: checks 
deadkiller1: bets $5.95
bello1310: calls $5.95
ama58: folds 
*** RIVER *** [7c Qc 5d Tc] [Jd]
deadkiller1: bets $13
bello1310: raises $13 to $26
deadkiller1: folds 
Uncalled bet ($13) returned to bello1310
bello1310 collected $45.03 from pot
bello1310: doesn't show hand 
*** SUMMARY ***
Total pot $47.40 | Rake $2.37 
Board [7c Qc 5d Tc Jd]
Seat 2: deadkiller1 folded on the River
Seat 3: matiko09 folded before Flop (didn't bet)
Seat 4: HITYESCA folded before Flop (didn't bet)
Seat 5: bello1310 collected ($45.03)
Seat 6: torkkdnm (button) folded before Flop (didn't bet)
Seat 7: IRAVABAN (small blind) folded before Flop
Seat 8: ama58 (big blind) folded on the Turn
Seat 9: oscarleon folded before Flop (didn't bet)





PokerStars Hand #153502415854:  Hold'em No Limit ($1/$2 USD) - 2016/05/18 20:33:37 CET [2016/05/18 14:33:37 ET]
Table 'Letaba' 9-max Seat #9 is the button
Seat 1: vanilica ($200 in chips) 
Seat 2: Sharknebulah ($200 in chips) 
Seat 3: ersevi6 ($271.77 in chips) 
Seat 4: matiko09 ($200 in chips) 
Seat 5: Vikulja1993 ($302.25 in chips) 
Seat 6: donald0404 ($318.19 in chips) 
Seat 7: moshmachine ($286.29 in chips) 
Seat 8: lydia12345 ($207.68 in chips) 
Seat 9: tepi_guy ($276.94 in chips) 
vanilica: posts small blind $1
Sharknebulah: posts big blind $2
*** HOLE CARDS ***
Dealt to matiko09 [6c Tc]
ersevi6: folds 
matiko09: folds 
Vikulja1993: folds 
donald0404: folds 
moshmachine: raises $2.68 to $4.68
lydia12345: calls $4.68
tepi_guy: folds 
vanilica: folds 
Sharknebulah: calls $2.68
*** FLOP *** [2c Ad Kd]
Sharknebulah: checks 
moshmachine: bets $9.43
lydia12345: folds 
Sharknebulah: folds 
Uncalled bet ($9.43) returned to moshmachine
moshmachine collected $14.29 from pot
moshmachine: doesn't show hand 
*** SUMMARY ***
Total pot $15.04 | Rake $0.75 
Board [2c Ad Kd]
Seat 1: vanilica (small blind) folded before Flop
Seat 2: Sharknebulah (big blind) folded on the Flop
Seat 3: ersevi6 folded before Flop (didn't bet)
Seat 4: matiko09 folded before Flop (didn't bet)
Seat 5: Vikulja1993 folded before Flop (didn't bet)
Seat 6: donald0404 folded before Flop (didn't bet)
Seat 7: moshmachine collected ($14.29)
Seat 8: lydia12345 folded on the Flop
Seat 9: tepi_guy (button) folded before Flop (didn't bet)





PokerStars Hand #153502417714:  Hold'em No Limit ($0.50/$1.00 USD) - 2016/05/18 20:33:39 CET [2016/05/18 14:33:39 ET]
Table 'Abetti II' 9-max Seat #9 is the button
Seat 1: matiko09 ($130.08 in chips) 
Seat 2: Vikulja1993 ($100 in chips) 
Seat 3: cobrik23 ($128.78 in chips) 
Seat 4: ipashutapkom ($45.50 in chips) 
Seat 5: blufthenuts ($130.02 in chips) 
Seat 6: I The King I ($153.39 in chips) 
Seat 7: nickreason17 ($133.46 in chips) 
Seat 8: roadster683 ($81.85 in chips) 
Seat 9: lydia12345 ($261.45 in chips) 
matiko09: posts small blind $0.50
Vikulja1993: posts big blind $1
*** HOLE CARDS ***
Dealt to matiko09 [7s 2d]
cobrik23: folds 
ipashutapkom: folds 
blufthenuts: folds 
I The King I: raises $2 to $3
nickreason17: folds 
roadster683: calls $3
lydia12345: folds 
matiko09: folds 
Vikulja1993: folds 
*** FLOP *** [8s 6s Ts]
I The King I: bets $5
roadster683: calls $5
*** TURN *** [8s 6s Ts] [Kh]
I The King I: bets $11
roadster683: calls $11
*** RIVER *** [8s 6s Ts Kh] [Kd]
I The King I: bets $29
roadster683: folds 
Uncalled bet ($29) returned to I The King I
I The King I collected $37.52 from pot
*** SUMMARY ***
Total pot $39.50 | Rake $1.98 
Board [8s 6s Ts Kh Kd]
Seat 1: matiko09 (small blind) folded before Flop
Seat 2: Vikulja1993 (big blind) folded before Flop
Seat 3: cobrik23 folded before Flop (didn't bet)
Seat 4: ipashutapkom folded before Flop (didn't bet)
Seat 5: blufthenuts folded before Flop (didn't bet)
Seat 6: I The King I collected ($37.52)
Seat 7: nickreason17 folded before Flop (didn't bet)
Seat 8: roadster683 folded on the River
Seat 9: lydia12345 (button) folded before Flop (didn't bet)





PokerStars Hand #153502424448:  Hold'em No Limit ($1/$2 USD) - 2016/05/18 20:33:46 CET [2016/05/18 14:33:46 ET]
Table 'Chlosinde' 9-max Seat #5 is the button
Seat 2: lydia12345 ($204.40 in chips) 
Seat 3: matiko09 ($224.56 in chips) 
Seat 5: tepi_guy ($858.49 in chips) 
Seat 6: Vikulja1993 ($208.15 in chips) 
Seat 7: donald0404 ($235.11 in chips) 
Seat 8: sanducu_eu ($209.03 in chips) 
Seat 9: Tey113 ($534.56 in chips) 
Vikulja1993: posts small blind $1
donald0404: posts big blind $2
uonlylive1ce: sits out 
vanilica: sits out 
*** HOLE CARDS ***
Dealt to matiko09 [Qc 8d]
sanducu_eu: folds 
Tey113: folds 
lydia12345: folds 
matiko09: folds 
Tey113 leaves the table
Sharknebulah joins the table at seat #9 
uonlylive1ce leaves the table
tepi_guy has timed out
tepi_guy: folds 
sanducu_eu leaves the table
Vikulja1993: folds 
Uncalled bet ($1) returned to donald0404
donald0404 collected $2 from pot
donald0404: doesn't show hand 
*** SUMMARY ***
Total pot $2 | Rake $0 
Seat 2: lydia12345 folded before Flop (didn't bet)
Seat 3: matiko09 folded before Flop (didn't bet)
Seat 5: tepi_guy (button) folded before Flop (didn't bet)
Seat 6: Vikulja1993 (small blind) folded before Flop
Seat 7: donald0404 (big blind) collected ($2)
Seat 8: sanducu_eu folded before Flop (didn't bet)
Seat 9: Tey113 folded before Flop (didn't bet)





PokerStars Hand #153502425256:  Hold'em No Limit ($0.50/$1.00 USD) - 2016/05/18 20:33:47 CET [2016/05/18 14:33:47 ET]
Table 'Kayala' 9-max Seat #2 is the button
Seat 1: deadkiller1 ($107.90 in chips) 
Seat 2: Oelie7 ($172.03 in chips) 
Seat 3: matiko09 ($100 in chips) 
Seat 4: HITYESCA ($100 in chips) 
Seat 6: lydia12345 ($120.62 in chips) 
Seat 7: nickreason17 ($116.16 in chips) 
Seat 9: Vikulja1993 ($105.48 in chips) 
matiko09: posts small blind $0.50
HITYESCA: posts big blind $1
rate8: sits out 
cobrik23: sits out 
*** HOLE CARDS ***
Dealt to matiko09 [Tc 8c]
lydia12345: folds 
nickreason17: folds 
Vikulja1993: folds 
deadkiller1: folds 
Oelie7: calls $1
matiko09: raises $3.50 to $4.50
HITYESCA: folds 
Oelie7: folds 
Uncalled bet ($3.50) returned to matiko09
matiko09 collected $3 from pot
matiko09: doesn't show hand 
*** SUMMARY ***
Total pot $3 | Rake $0 
Seat 1: deadkiller1 folded before Flop (didn't bet)
Seat 2: Oelie7 (button) folded before Flop
Seat 3: matiko09 (small blind) collected ($3)
Seat 4: HITYESCA (big blind) folded before Flop
Seat 6: lydia12345 folded before Flop (didn't bet)
Seat 7: nickreason17 folded before Flop (didn't bet)
Seat 9: Vikulja1993 folded before Flop (didn't bet)





PokerStars Hand #153502426006:  Hold'em No Limit (€0.50/€1.00 EUR) - 2016/05/18 20:33:48 CET [2016/05/18 14:33:48 ET]
Table 'Pallas II' 9-max Seat #9 is the button
Seat 1: deadkiller1 (€104.50 in chips) 
Seat 2: matiko09 (€203.99 in chips) 
Seat 3: Vikulja1993 (€108 in chips) 
Seat 4: torkkdnm (€146.71 in chips) 
Seat 5: cobrik23 (€67.74 in chips) 
Seat 6: HITYESCA (€105.12 in chips) 
Seat 7: rate8 (€100 in chips) 
Seat 8: lydia12345 (€100 in chips) 
Seat 9: stijner1986 (€145.48 in chips) 
deadkiller1: posts small blind €0.50
matiko09: posts big blind €1
*** HOLE CARDS ***
Dealt to matiko09 [3d 9s]
Vikulja1993: folds 
torkkdnm: folds 
cobrik23: raises €2 to €3
HITYESCA: folds 
rate8: folds 
lydia12345: folds 
stijner1986: calls €3
deadkiller1: folds 
matiko09: folds 
*** FLOP *** [2c As Th]
cobrik23: bets €4.74
stijner1986: folds 
Uncalled bet (€4.74) returned to cobrik23
cobrik23 collected €7.12 from pot
cobrik23: doesn't show hand 
*** SUMMARY ***
Total pot €7.50 | Rake €0.38 
Board [2c As Th]
Seat 1: deadkiller1 (small blind) folded before Flop
Seat 2: matiko09 (big blind) folded before Flop
Seat 3: Vikulja1993 folded before Flop (didn't bet)
Seat 4: torkkdnm folded before Flop (didn't bet)
Seat 5: cobrik23 collected (€7.12)
Seat 6: HITYESCA folded before Flop (didn't bet)
Seat 7: rate8 folded before Flop (didn't bet)
Seat 8: lydia12345 folded before Flop (didn't bet)
Seat 9: stijner1986 (button) folded on the Flop





PokerStars Hand #153502433126:  Hold'em No Limit ($0.50/$1.00 USD) - 2016/05/18 20:33:56 CET [2016/05/18 14:33:56 ET]
Table 'Tatjana III' 9-max Seat #6 is the button
Seat 1: cobrik23 ($96.82 in chips) 
Seat 2: HITYESCA ($123.82 in chips) 
Seat 3: matiko09 ($186.84 in chips) 
Seat 4: lydia12345 ($132.98 in chips) 
Seat 5: deadkiller1 ($114.94 in chips) 
Seat 6: nickreason17 ($126.12 in chips) 
Seat 7: rene1984tsv ($84.28 in chips) 
Seat 8: JACQUILF ($111.80 in chips) 
Seat 9: Moszes360 ($104.12 in chips) 
rene1984tsv: posts small blind $0.50
JACQUILF: posts big blind $1
*** HOLE CARDS ***
Dealt to matiko09 [Ts 6c]
Moszes360: folds 
cobrik23: folds 
HITYESCA: folds 
matiko09: folds 
lydia12345: folds 
deadkiller1: folds 
nickreason17: raises $1 to $2
rene1984tsv: calls $1.50
JACQUILF: folds 
*** FLOP *** [5d Jh 3d]
rene1984tsv: bets $2.37
nickreason17: folds 
Uncalled bet ($2.37) returned to rene1984tsv
rene1984tsv collected $4.75 from pot
*** SUMMARY ***
Total pot $5 | Rake $0.25 
Board [5d Jh 3d]
Seat 1: cobrik23 folded before Flop (didn't bet)
Seat 2: HITYESCA folded before Flop (didn't bet)
Seat 3: matiko09 folded before Flop (didn't bet)
Seat 4: lydia12345 folded before Flop (didn't bet)
Seat 5: deadkiller1 folded before Flop (didn't bet)
Seat 6: nickreason17 (button) folded on the Flop
Seat 7: rene1984tsv (small blind) collected ($4.75)
Seat 8: JACQUILF (big blind) folded before Flop
Seat 9: Moszes360 folded before Flop (didn't bet)





PokerStars Hand #153502454445:  Hold'em No Limit ($0.50/$1.00 USD) - 2016/05/18 20:34:21 CET [2016/05/18 14:34:21 ET]
Table 'Barto' 9-max Seat #7 is the button
Seat 1: IRAVABAN ($44.50 in chips) 
Seat 2: buttonlife ($100 in chips) 
Seat 3: pokerstereke ($94.21 in chips) 
Seat 4: Kihog ($112.68 in chips) 
Seat 5: matiko09 ($100 in chips) 
Seat 7: deadkiller1 ($100 in chips) 
Seat 9: gongqingss ($39.38 in chips) 
gongqingss: posts small blind $0.50
IRAVABAN: posts big blind $1
vanilica: sits out 
*** HOLE CARDS ***
Dealt to matiko09 [Ad 6d]
buttonlife: folds 
pokerstereke: folds 
Kihog: folds 
matiko09: raises $1.50 to $2.50
deadkiller1: folds 
gongqingss: calls $2
IRAVABAN: folds 
*** FLOP *** [Qh 5d Qs]
gongqingss: checks 
matiko09: checks 
*** TURN *** [Qh 5d Qs] [7s]
gongqingss: bets $5
matiko09: folds 
Uncalled bet ($5) returned to gongqingss
gongqingss collected $5.70 from pot
gongqingss: doesn't show hand 
*** SUMMARY ***
Total pot $6 | Rake $0.30 
Board [Qh 5d Qs 7s]
Seat 1: IRAVABAN (big blind) folded before Flop
Seat 2: buttonlife folded before Flop (didn't bet)
Seat 3: pokerstereke folded before Flop (didn't bet)
Seat 4: Kihog folded before Flop (didn't bet)
Seat 5: matiko09 folded on the Turn
Seat 7: deadkiller1 (button) folded before Flop (didn't bet)
Seat 9: gongqingss (small blind) collected ($5.70)





PokerStars Hand #153502455387:  Hold'em No Limit ($0.50/$1.00 USD) - 2016/05/18 20:34:22 CET [2016/05/18 14:34:22 ET]
Table 'Kayala' 9-max Seat #3 is the button
Seat 1: deadkiller1 ($107.90 in chips) 
Seat 2: Oelie7 ($171.03 in chips) 
Seat 3: matiko09 ($102 in chips) 
Seat 4: HITYESCA ($100 in chips) 
Seat 5: rate8 ($100 in chips) 
Seat 6: lydia12345 ($120.62 in chips) 
Seat 7: nickreason17 ($116.16 in chips) 
Seat 9: Vikulja1993 ($105.48 in chips) 
HITYESCA: posts small blind $0.50
rate8: posts big blind $1
cobrik23: sits out 
*** HOLE CARDS ***
Dealt to matiko09 [As 7s]
lydia12345: raises $2 to $3
nickreason17: folds 
Vikulja1993: folds 
deadkiller1: folds 
Oelie7: folds 
matiko09: folds 
HITYESCA: folds 
rate8: folds 
Uncalled bet ($2) returned to lydia12345
lydia12345 collected $2.50 from pot
*** SUMMARY ***
Total pot $2.50 | Rake $0 
Seat 1: deadkiller1 folded before Flop (didn't bet)
Seat 2: Oelie7 folded before Flop (didn't bet)
Seat 3: matiko09 (button) folded before Flop (didn't bet)
Seat 4: HITYESCA (small blind) folded before Flop
Seat 5: rate8 (big blind) folded before Flop
Seat 6: lydia12345 collected ($2.50)
Seat 7: nickreason17 folded before Flop (didn't bet)
Seat 9: Vikulja1993 folded before Flop (didn't bet)





PokerStars Hand #153502463602:  Hold'em No Limit ($1/$2 USD) - 2016/05/18 20:34:31 CET [2016/05/18 14:34:31 ET]
Table 'Chlosinde' 9-max Seat #6 is the button
Seat 3: matiko09 ($224.56 in chips) 
Seat 5: tepi_guy ($858.49 in chips) 
Seat 6: Vikulja1993 ($207.15 in chips) 
Seat 7: donald0404 ($236.11 in chips) 
donald0404: posts small blind $1
lydia12345: is sitting out 
matiko09: posts big blind $2
vanilica: sits out 
*** HOLE CARDS ***
Dealt to matiko09 [2s 7c]
lydia12345 leaves the table
tepi_guy: raises $3.40 to $5.40
Vikulja1993: folds 
donald0404: folds 
matiko09: folds 
Uncalled bet ($3.40) returned to tepi_guy
tepi_guy collected $5 from pot
tepi_guy: doesn't show hand 
*** SUMMARY ***
Total pot $5 | Rake $0 
Seat 3: matiko09 (big blind) folded before Flop
Seat 5: tepi_guy collected ($5)
Seat 6: Vikulja1993 (button) folded before Flop (didn't bet)
Seat 7: donald0404 (small blind) folded before Flop





PokerStars Hand #153502465405:  Hold'em No Limit ($0.50/$1.00 USD) - 2016/05/18 20:34:33 CET [2016/05/18 14:34:33 ET]
Table 'Tatjana III' 9-max Seat #7 is the button
Seat 1: cobrik23 ($96.82 in chips) 
Seat 2: HITYESCA ($123.82 in chips) 
Seat 3: matiko09 ($186.84 in chips) 
Seat 4: lydia12345 ($132.98 in chips) 
Seat 5: deadkiller1 ($114.94 in chips) 
Seat 6: nickreason17 ($124.12 in chips) 
Seat 7: rene1984tsv ($87.03 in chips) 
Seat 8: JACQUILF ($110.80 in chips) 
Seat 9: Moszes360 ($104.12 in chips) 
JACQUILF: posts small blind $0.50
Moszes360: posts big blind $1
*** HOLE CARDS ***
Dealt to matiko09 [Kh 4h]
cobrik23: folds 
HITYESCA: folds 
matiko09: folds 
lydia12345: folds 
deadkiller1: folds 
nickreason17: folds 
rene1984tsv: raises $2.50 to $3.50
JACQUILF: folds 
Moszes360: folds 
Uncalled bet ($2.50) returned to rene1984tsv
rene1984tsv collected $2.50 from pot
rene1984tsv: doesn't show hand 
*** SUMMARY ***
Total pot $2.50 | Rake $0 
Seat 1: cobrik23 folded before Flop (didn't bet)
Seat 2: HITYESCA folded before Flop (didn't bet)
Seat 3: matiko09 folded before Flop (didn't bet)
Seat 4: lydia12345 folded before Flop (didn't bet)
Seat 5: deadkiller1 folded before Flop (didn't bet)
Seat 6: nickreason17 folded before Flop (didn't bet)
Seat 7: rene1984tsv (button) collected ($2.50)
Seat 8: JACQUILF (small blind) folded before Flop
Seat 9: Moszes360 (big blind) folded before Flop





PokerStars Hand #153502469166:  Hold'em No Limit ($0.50/$1.00 USD) - 2016/05/18 20:34:38 CET [2016/05/18 14:34:38 ET]
Table 'Pandora' 9-max Seat #1 is the button
Seat 1: deadkiller1 ($135.40 in chips) 
Seat 2: fack_vi ($74.87 in chips) 
Seat 3: TimStone ($100 in chips) 
Seat 4: mooose100 ($109.91 in chips) 
Seat 6: Moszes360 ($101.50 in chips) 
Seat 7: lydia12345 ($105.82 in chips) 
Seat 8: matiko09 ($118.02 in chips) 
Seat 9: oscarleon ($113.98 in chips) 
fack_vi: posts small blind $0.50
TimStone: posts big blind $1
*** HOLE CARDS ***
Dealt to matiko09 [5s Qh]
mooose100: folds 
Moszes360: folds 
lydia12345: folds 
matiko09: folds 
oscarleon: folds 
deadkiller1: folds 
fack_vi: folds 
Uncalled bet ($0.50) returned to TimStone
TimStone collected $1 from pot
TimStone: doesn't show hand 
*** SUMMARY ***
Total pot $1 | Rake $0 
Seat 1: deadkiller1 (button) folded before Flop (didn't bet)
Seat 2: fack_vi (small blind) folded before Flop
Seat 3: TimStone (big blind) collected ($1)
Seat 4: mooose100 folded before Flop (didn't bet)
Seat 6: Moszes360 folded before Flop (didn't bet)
Seat 7: lydia12345 folded before Flop (didn't bet)
Seat 8: matiko09 folded before Flop (didn't bet)
Seat 9: oscarleon folded before Flop (didn't bet)





PokerStars Hand #153502473230:  Hold'em No Limit (€0.50/€1.00 EUR) - 2016/05/18 20:34:42 CET [2016/05/18 14:34:42 ET]
Table 'Pallas II' 9-max Seat #1 is the button
Seat 1: deadkiller1 (€104 in chips) 
Seat 2: matiko09 (€202.99 in chips) 
Seat 3: Vikulja1993 (€108 in chips) 
Seat 4: torkkdnm (€146.71 in chips) 
Seat 5: cobrik23 (€71.86 in chips) 
Seat 6: HITYESCA (€105.12 in chips) 
Seat 7: rate8 (€100 in chips) 
Seat 8: lydia12345 (€100 in chips) 
Seat 9: stijner1986 (€142.48 in chips) 
matiko09: posts small blind €0.50
Vikulja1993: posts big blind €1
*** HOLE CARDS ***
Dealt to matiko09 [2d 5s]
torkkdnm: folds 
cobrik23: raises €2 to €3
HITYESCA: folds 
rate8: folds 
lydia12345: folds 
stijner1986: folds 
deadkiller1: folds 
matiko09: folds 
Vikulja1993: folds 
Uncalled bet (€2) returned to cobrik23
cobrik23 collected €2.50 from pot
cobrik23: doesn't show hand 
*** SUMMARY ***
Total pot €2.50 | Rake €0 
Seat 1: deadkiller1 (button) folded before Flop (didn't bet)
Seat 2: matiko09 (small blind) folded before Flop
Seat 3: Vikulja1993 (big blind) folded before Flop
Seat 4: torkkdnm folded before Flop (didn't bet)
Seat 5: cobrik23 collected (€2.50)
Seat 6: HITYESCA folded before Flop (didn't bet)
Seat 7: rate8 folded before Flop (didn't bet)
Seat 8: lydia12345 folded before Flop (didn't bet)
Seat 9: stijner1986 folded before Flop (didn't bet)





PokerStars Hand #153502478287:  Hold'em No Limit ($1/$2 USD) - 2016/05/18 20:34:48 CET [2016/05/18 14:34:48 ET]
Table 'Letaba' 9-max Seat #1 is the button
Seat 1: vanilica ($200 in chips) 
Seat 2: Sharknebulah ($200 in chips) 
Seat 4: matiko09 ($200 in chips) 
Seat 5: Vikulja1993 ($302.25 in chips) 
Seat 6: donald0404 ($318.19 in chips) 
Seat 7: moshmachine ($295.90 in chips) 
Seat 8: lydia12345 ($203 in chips) 
Seat 9: tepi_guy ($276.94 in chips) 
Sharknebulah: posts small blind $1
ersevi6: is sitting out 
matiko09: posts big blind $2
*** HOLE CARDS ***
Dealt to matiko09 [Qh 7s]
ersevi6 leaves the table
Vikulja1993: folds 
donald0404: folds 
moshmachine: folds 
Vikulja1993 leaves the table
lydia12345: folds 
I The King I joins the table at seat #5 
I The King I leaves the table
tepi_guy has timed out
tepi_guy: folds 
vanilica: folds 
Sharknebulah: raises $4 to $6
matiko09: folds 
Uncalled bet ($4) returned to Sharknebulah
Sharknebulah collected $4 from pot
*** SUMMARY ***
Total pot $4 | Rake $0 
Seat 1: vanilica (button) folded before Flop (didn't bet)
Seat 2: Sharknebulah (small blind) collected ($4)
Seat 4: matiko09 (big blind) folded before Flop
Seat 5: Vikulja1993 folded before Flop (didn't bet)
Seat 6: donald0404 folded before Flop (didn't bet)
Seat 7: moshmachine folded before Flop (didn't bet)
Seat 8: lydia12345 folded before Flop (didn't bet)
Seat 9: tepi_guy folded before Flop (didn't bet)





PokerStars Hand #153502486951:  Hold'em No Limit ($0.50/$1.00 USD) - 2016/05/18 20:34:58 CET [2016/05/18 14:34:58 ET]
Table 'Tatjana III' 9-max Seat #8 is the button
Seat 1: cobrik23 ($96.82 in chips) 
Seat 2: HITYESCA ($123.82 in chips) 
Seat 3: matiko09 ($186.84 in chips) 
Seat 4: lydia12345 ($132.98 in chips) 
Seat 5: deadkiller1 ($114.94 in chips) 
Seat 6: nickreason17 ($124.12 in chips) 
Seat 7: rene1984tsv ($88.53 in chips) 
Seat 8: JACQUILF ($110.30 in chips) 
Seat 9: Moszes360 ($103.12 in chips) 
Moszes360: posts small blind $0.50
cobrik23: posts big blind $1
*** HOLE CARDS ***
Dealt to matiko09 [2c Ad]
HITYESCA: folds 
matiko09: folds 
lydia12345: raises $2 to $3
deadkiller1: folds 
nickreason17: folds 
rene1984tsv: folds 
JACQUILF: folds 
Moszes360: folds 
cobrik23: folds 
Uncalled bet ($2) returned to lydia12345
lydia12345 collected $2.50 from pot
*** SUMMARY ***
Total pot $2.50 | Rake $0 
Seat 1: cobrik23 (big blind) folded before Flop
Seat 2: HITYESCA folded before Flop (didn't bet)
Seat 3: matiko09 folded before Flop (didn't bet)
Seat 4: lydia12345 collected ($2.50)
Seat 5: deadkiller1 folded before Flop (didn't bet)
Seat 6: nickreason17 folded before Flop (didn't bet)
Seat 7: rene1984tsv folded before Flop (didn't bet)
Seat 8: JACQUILF (button) folded before Flop (didn't bet)
Seat 9: Moszes360 (small blind) folded before Flop





PokerStars Hand #153502487199:  Hold'em No Limit ($1/$2 USD) - 2016/05/18 20:34:58 CET [2016/05/18 14:34:58 ET]
Table 'Chlosinde' 9-max Seat #7 is the button
Seat 3: matiko09 ($222.56 in chips) 
Seat 4: vanilica ($200 in chips) 
Seat 5: tepi_guy ($861.49 in chips) 
Seat 6: Vikulja1993 ($207.15 in chips) 
Seat 7: donald0404 ($235.11 in chips) 
matiko09: posts small blind $1
vanilica: posts big blind $2
*** HOLE CARDS ***
Dealt to matiko09 [As 6c]
tepi_guy: folds 
Vikulja1993: raises $3 to $5
donald0404: raises $11 to $16
matiko09: folds 
vanilica: folds 
Vikulja1993: folds 
Uncalled bet ($11) returned to donald0404
donald0404 collected $13 from pot
donald0404: doesn't show hand 
*** SUMMARY ***
Total pot $13 | Rake $0 
Seat 3: matiko09 (small blind) folded before Flop
Seat 4: vanilica (big blind) folded before Flop
Seat 5: tepi_guy folded before Flop (didn't bet)
Seat 6: Vikulja1993 folded before Flop
Seat 7: donald0404 (button) collected ($13)





PokerStars Hand #153502489966:  Hold'em No Limit ($0.50/$1.00 USD) - 2016/05/18 20:35:01 CET [2016/05/18 14:35:01 ET]
Table 'Abetti II' 9-max Seat #1 is the button
Seat 1: matiko09 ($129.58 in chips) 
Seat 2: Vikulja1993 ($100 in chips) 
Seat 3: cobrik23 ($128.78 in chips) 
Seat 4: ipashutapkom ($45.50 in chips) 
Seat 5: blufthenuts ($130.02 in chips) 
Seat 6: I The King I ($171.91 in chips) 
Seat 7: nickreason17 ($133.46 in chips) 
Seat 8: roadster683 ($62.85 in chips) 
Seat 9: lydia12345 ($261.45 in chips) 
Vikulja1993: posts small blind $0.50
cobrik23: posts big blind $1
*** HOLE CARDS ***
Dealt to matiko09 [7c Kc]
ipashutapkom: folds 
blufthenuts: folds 
I The King I: folds 
nickreason17: folds 
roadster683: raises $1 to $2
lydia12345: folds 
matiko09: folds 
Vikulja1993: folds 
cobrik23: folds 
Uncalled bet ($1) returned to roadster683
roadster683 collected $2.50 from pot
roadster683: doesn't show hand 
*** SUMMARY ***
Total pot $2.50 | Rake $0 
Seat 1: matiko09 (button) folded before Flop (didn't bet)
Seat 2: Vikulja1993 (small blind) folded before Flop
Seat 3: cobrik23 (big blind) folded before Flop
Seat 4: ipashutapkom folded before Flop (didn't bet)
Seat 5: blufthenuts folded before Flop (didn't bet)
Seat 6: I The King I folded before Flop (didn't bet)
Seat 7: nickreason17 folded before Flop (didn't bet)
Seat 8: roadster683 collected ($2.50)
Seat 9: lydia12345 folded before Flop (didn't bet)





PokerStars Hand #153502496041:  Hold'em No Limit ($0.50/$1.00 USD) - 2016/05/18 20:35:09 CET [2016/05/18 14:35:09 ET]
Table 'Kayala' 9-max Seat #4 is the button
Seat 1: deadkiller1 ($107.90 in chips) 
Seat 2: Oelie7 ($171.03 in chips) 
Seat 3: matiko09 ($102 in chips) 
Seat 4: HITYESCA ($100 in chips) 
Seat 5: rate8 ($100 in chips) 
Seat 6: lydia12345 ($122.12 in chips) 
Seat 7: nickreason17 ($116.16 in chips) 
Seat 9: Vikulja1993 ($105.48 in chips) 
rate8: posts small blind $0.50
lydia12345: posts big blind $1
cobrik23: sits out 
*** HOLE CARDS ***
Dealt to matiko09 [4h 2s]
nickreason17: folds 
Vikulja1993: folds 
deadkiller1: folds 
Oelie7: folds 
matiko09: folds 
HITYESCA: raises $1.50 to $2.50
rate8: folds 
lydia12345: folds 
Uncalled bet ($1.50) returned to HITYESCA
HITYESCA collected $2.50 from pot
HITYESCA: doesn't show hand 
*** SUMMARY ***
Total pot $2.50 | Rake $0 
Seat 1: deadkiller1 folded before Flop (didn't bet)
Seat 2: Oelie7 folded before Flop (didn't bet)
Seat 3: matiko09 folded before Flop (didn't bet)
Seat 4: HITYESCA (button) collected ($2.50)
Seat 5: rate8 (small blind) folded before Flop
Seat 6: lydia12345 (big blind) folded before Flop
Seat 7: nickreason17 folded before Flop (didn't bet)
Seat 9: Vikulja1993 folded before Flop (didn't bet)





PokerStars Hand #153502509170:  Hold'em No Limit (€0.50/€1.00 EUR) - 2016/05/18 20:35:24 CET [2016/05/18 14:35:24 ET]
Table 'Pallas II' 9-max Seat #2 is the button
Seat 1: deadkiller1 (€104 in chips) 
Seat 2: matiko09 (€202.49 in chips) 
Seat 3: Vikulja1993 (€107 in chips) 
Seat 4: torkkdnm (€146.71 in chips) 
Seat 5: cobrik23 (€73.36 in chips) 
Seat 6: HITYESCA (€105.12 in chips) 
Seat 7: rate8 (€100 in chips) 
Seat 8: lydia12345 (€100 in chips) 
Seat 9: stijner1986 (€142.48 in chips) 
Vikulja1993: posts small blind €0.50
torkkdnm: posts big blind €1
*** HOLE CARDS ***
Dealt to matiko09 [As 8c]
cobrik23: folds 
HITYESCA: folds 
rate8: folds 
lydia12345: folds 
stijner1986: folds 
deadkiller1: folds 
matiko09: raises €1.27 to €2.27
Vikulja1993: folds 
torkkdnm: folds 
Uncalled bet (€1.27) returned to matiko09
matiko09 collected €2.50 from pot
matiko09: doesn't show hand 
*** SUMMARY ***
Total pot €2.50 | Rake €0 
Seat 1: deadkiller1 folded before Flop (didn't bet)
Seat 2: matiko09 (button) collected (€2.50)
Seat 3: Vikulja1993 (small blind) folded before Flop
Seat 4: torkkdnm (big blind) folded before Flop
Seat 5: cobrik23 folded before Flop (didn't bet)
Seat 6: HITYESCA folded before Flop (didn't bet)
Seat 7: rate8 folded before Flop (didn't bet)
Seat 8: lydia12345 folded before Flop (didn't bet)
Seat 9: stijner1986 folded before Flop (didn't bet)





PokerStars Hand #153502511924:  Hold'em No Limit ($0.50/$1.00 USD) - 2016/05/18 20:35:27 CET [2016/05/18 14:35:27 ET]
Table 'Barto' 9-max Seat #9 is the button
Seat 1: IRAVABAN ($43.50 in chips) 
Seat 3: pokerstereke ($94.21 in chips) 
Seat 4: Kihog ($112.68 in chips) 
Seat 5: matiko09 ($100 in chips) 
Seat 7: deadkiller1 ($100 in chips) 
Seat 9: gongqingss ($42.58 in chips) 
IRAVABAN: posts small blind $0.50
pokerstereke: posts big blind $1
vanilica: sits out 
*** HOLE CARDS ***
Dealt to matiko09 [5c 3s]
Kihog: folds 
matiko09: folds 
deadkiller1: raises $1.50 to $2.50
gongqingss: calls $2.50
IRAVABAN: folds 
pokerstereke: folds 
*** FLOP *** [9s 6s 6d]
deadkiller1: bets $4.07
gongqingss: calls $4.07
*** TURN *** [9s 6s 6d] [5s]
deadkiller1: checks 
gongqingss: bets $15
deadkiller1: folds 
Uncalled bet ($15) returned to gongqingss
gongqingss collected $13.91 from pot
gongqingss: doesn't show hand 
*** SUMMARY ***
Total pot $14.64 | Rake $0.73 
Board [9s 6s 6d 5s]
Seat 1: IRAVABAN (small blind) folded before Flop
Seat 3: pokerstereke (big blind) folded before Flop
Seat 4: Kihog folded before Flop (didn't bet)
Seat 5: matiko09 folded before Flop (didn't bet)
Seat 7: deadkiller1 folded on the Turn
Seat 9: gongqingss (button) collected ($13.91)





PokerStars Hand #153502512064:  Hold'em No Limit ($0.50/$1.00 USD) - 2016/05/18 20:35:27 CET [2016/05/18 14:35:27 ET]
Table 'Pandora' 9-max Seat #2 is the button
Seat 1: deadkiller1 ($135.40 in chips) 
Seat 2: fack_vi ($74.37 in chips) 
Seat 3: TimStone ($100.50 in chips) 
Seat 4: mooose100 ($109.91 in chips) 
Seat 6: Moszes360 ($101.50 in chips) 
Seat 7: lydia12345 ($105.82 in chips) 
Seat 8: matiko09 ($118.02 in chips) 
Seat 9: oscarleon ($113.98 in chips) 
TimStone: posts small blind $0.50
mooose100: posts big blind $1
nickreason17: sits out 
*** HOLE CARDS ***
Dealt to matiko09 [3s 4c]
Moszes360: folds 
lydia12345: folds 
matiko09: folds 
oscarleon: folds 
deadkiller1: raises $1.50 to $2.50
fack_vi: folds 
TimStone: folds 
mooose100: calls $1.50
*** FLOP *** [6c Kc 6s]
mooose100: checks 
deadkiller1: bets $3.44
mooose100: calls $3.44
*** TURN *** [6c Kc 6s] [9d]
mooose100: checks 
deadkiller1: checks 
*** RIVER *** [6c Kc 6s 9d] [9s]
mooose100: bets $5.88
deadkiller1: calls $5.88
*** SHOW DOWN ***
mooose100: shows [6d 2d] (a full house, Sixes full of Nines)
deadkiller1: mucks hand 
mooose100 collected $22.93 from pot
*** SUMMARY ***
Total pot $24.14 | Rake $1.21 
Board [6c Kc 6s 9d 9s]
Seat 1: deadkiller1 mucked [4s Ac]
Seat 2: fack_vi (button) folded before Flop (didn't bet)
Seat 3: TimStone (small blind) folded before Flop
Seat 4: mooose100 (big blind) showed [6d 2d] and won ($22.93) with a full house, Sixes full of Nines
Seat 6: Moszes360 folded before Flop (didn't bet)
Seat 7: lydia12345 folded before Flop (didn't bet)
Seat 8: matiko09 folded before Flop (didn't bet)
Seat 9: oscarleon folded before Flop (didn't bet)





PokerStars Hand #153502516929:  Hold'em No Limit ($0.50/$1.00 USD) - 2016/05/18 20:35:33 CET [2016/05/18 14:35:33 ET]
Table 'Suevia' 9-max Seat #7 is the button
Seat 2: deadkiller1 ($100 in chips) 
Seat 3: matiko09 ($100 in chips) 
Seat 4: HITYESCA ($100 in chips) 
Seat 5: bello1310 ($107.53 in chips) 
Seat 6: torkkdnm ($125.66 in chips) 
Seat 7: IRAVABAN ($40 in chips) 
Seat 8: ama58 ($51.08 in chips) 
Seat 9: oscarleon ($136.37 in chips) 
ama58: posts small blind $0.50
oscarleon: posts big blind $1
Moszes360: sits out 
*** HOLE CARDS ***
Dealt to matiko09 [7d 7c]
deadkiller1: raises $2 to $3
matiko09: folds 
HITYESCA: calls $3
bello1310: folds 
torkkdnm: folds 
IRAVABAN: folds 
ama58: folds 
oscarleon: folds 
*** FLOP *** [9c Jc 8c]
deadkiller1: bets $4.69
HITYESCA: calls $4.69
*** TURN *** [9c Jc 8c] [Jd]
deadkiller1: bets $10.58
HITYESCA: folds 
Uncalled bet ($10.58) returned to deadkiller1
deadkiller1 collected $16.04 from pot
deadkiller1: doesn't show hand 
*** SUMMARY ***
Total pot $16.88 | Rake $0.84 
Board [9c Jc 8c Jd]
Seat 2: deadkiller1 collected ($16.04)
Seat 3: matiko09 folded before Flop (didn't bet)
Seat 4: HITYESCA folded on the Turn
Seat 5: bello1310 folded before Flop (didn't bet)
Seat 6: torkkdnm folded before Flop (didn't bet)
Seat 7: IRAVABAN (button) folded before Flop (didn't bet)
Seat 8: ama58 (small blind) folded before Flop
Seat 9: oscarleon (big blind) folded before Flop





PokerStars Hand #153502520364:  Hold'em No Limit ($0.50/$1.00 USD) - 2016/05/18 20:35:37 CET [2016/05/18 14:35:37 ET]
Table 'Tatjana III' 9-max Seat #9 is the button
Seat 1: cobrik23 ($95.82 in chips) 
Seat 2: HITYESCA ($123.82 in chips) 
Seat 3: matiko09 ($186.84 in chips) 
Seat 4: lydia12345 ($134.48 in chips) 
Seat 5: deadkiller1 ($114.94 in chips) 
Seat 6: nickreason17 ($124.12 in chips) 
Seat 7: rene1984tsv ($88.53 in chips) 
Seat 8: JACQUILF ($110.30 in chips) 
Seat 9: Moszes360 ($102.62 in chips) 
cobrik23: posts small blind $0.50
HITYESCA: posts big blind $1
*** HOLE CARDS ***
Dealt to matiko09 [9d Td]
matiko09: raises $2 to $3
lydia12345: folds 
deadkiller1: folds 
nickreason17: folds 
rene1984tsv: folds 
JACQUILF: folds 
Moszes360: folds 
cobrik23: folds 
HITYESCA: folds 
Uncalled bet ($2) returned to matiko09
matiko09 collected $2.50 from pot
matiko09: doesn't show hand 
*** SUMMARY ***
Total pot $2.50 | Rake $0 
Seat 1: cobrik23 (small blind) folded before Flop
Seat 2: HITYESCA (big blind) folded before Flop
Seat 3: matiko09 collected ($2.50)
Seat 4: lydia12345 folded before Flop (didn't bet)
Seat 5: deadkiller1 folded before Flop (didn't bet)
Seat 6: nickreason17 folded before Flop (didn't bet)
Seat 7: rene1984tsv folded before Flop (didn't bet)
Seat 8: JACQUILF folded before Flop (didn't bet)
Seat 9: Moszes360 (button) folded before Flop (didn't bet)





PokerStars Hand #153502521076:  Hold'em No Limit ($0.50/$1.00 USD) - 2016/05/18 20:35:37 CET [2016/05/18 14:35:37 ET]
Table 'Abetti II' 9-max Seat #2 is the button
Seat 1: matiko09 ($129.58 in chips) 
Seat 2: Vikulja1993 ($100 in chips) 
Seat 3: cobrik23 ($127.78 in chips) 
Seat 4: ipashutapkom ($45.50 in chips) 
Seat 5: blufthenuts ($130.02 in chips) 
Seat 6: I The King I ($171.91 in chips) 
Seat 7: nickreason17 ($133.46 in chips) 
Seat 8: roadster683 ($64.35 in chips) 
Seat 9: lydia12345 ($261.45 in chips) 
cobrik23: posts small blind $0.50
ipashutapkom: posts big blind $1
*** HOLE CARDS ***
Dealt to matiko09 [Js 5s]
blufthenuts: folds 
I The King I: raises $2 to $3
nickreason17: raises $6 to $9
roadster683: raises $22.50 to $31.50
lydia12345: folds 
matiko09: folds 
Vikulja1993: folds 
cobrik23: folds 
ipashutapkom: folds 
I The King I: folds 
nickreason17: folds 
Uncalled bet ($22.50) returned to roadster683
roadster683 collected $22.50 from pot
roadster683: doesn't show hand 
*** SUMMARY ***
Total pot $22.50 | Rake $0 
Seat 1: matiko09 folded before Flop (didn't bet)
Seat 2: Vikulja1993 (button) folded before Flop (didn't bet)
Seat 3: cobrik23 (small blind) folded before Flop
Seat 4: ipashutapkom (big blind) folded before Flop
Seat 5: blufthenuts folded before Flop (didn't bet)
Seat 6: I The King I folded before Flop
Seat 7: nickreason17 folded before Flop
Seat 8: roadster683 collected ($22.50)
Seat 9: lydia12345 folded before Flop (didn't bet)





PokerStars Hand #153502523248:  Hold'em No Limit ($0.50/$1.00 USD) - 2016/05/18 20:35:40 CET [2016/05/18 14:35:40 ET]
Table 'Kayala' 9-max Seat #5 is the button
Seat 1: deadkiller1 ($107.90 in chips) 
Seat 2: Oelie7 ($171.03 in chips) 
Seat 3: matiko09 ($102 in chips) 
Seat 4: HITYESCA ($101.50 in chips) 
Seat 5: rate8 ($100 in chips) 
Seat 6: lydia12345 ($121.12 in chips) 
Seat 7: nickreason17 ($116.16 in chips) 
Seat 9: Vikulja1993 ($105.48 in chips) 
lydia12345: posts small blind $0.50
nickreason17: posts big blind $1
cobrik23: sits out 
*** HOLE CARDS ***
Dealt to matiko09 [3s Th]
Vikulja1993: folds 
deadkiller1: folds 
Oelie7: calls $1
matiko09: folds 
HITYESCA: folds 
rate8: folds 
lydia12345: calls $0.50
nickreason17: checks 
*** FLOP *** [8c 7d Ad]
lydia12345: checks 
nickreason17: checks 
Oelie7: checks 
*** TURN *** [8c 7d Ad] [Ac]
lydia12345: checks 
nickreason17: checks 
Oelie7: checks 
*** RIVER *** [8c 7d Ad Ac] [9s]
lydia12345: bets $1.94
nickreason17: folds 
Oelie7: calls $1.94
*** SHOW DOWN ***
lydia12345: shows [As 7c] (a full house, Aces full of Sevens)
Oelie7: mucks hand 
lydia12345 collected $6.54 from pot
*** SUMMARY ***
Total pot $6.88 | Rake $0.34 
Board [8c 7d Ad Ac 9s]
Seat 1: deadkiller1 folded before Flop (didn't bet)
Seat 2: Oelie7 mucked [Qh Ks]
Seat 3: matiko09 folded before Flop (didn't bet)
Seat 4: HITYESCA folded before Flop (didn't bet)
Seat 5: rate8 (button) folded before Flop (didn't bet)
Seat 6: lydia12345 (small blind) showed [As 7c] and won ($6.54) with a full house, Aces full of Sevens
Seat 7: nickreason17 (big blind) folded on the River
Seat 9: Vikulja1993 folded before Flop (didn't bet)





PokerStars Hand #153502523663:  Hold'em No Limit ($0.50/$1.00 USD) - 2016/05/18 20:35:40 CET [2016/05/18 14:35:40 ET]
Table 'Erida II' 9-max Seat #2 is the button
Seat 1: vanilica ($100 in chips) 
Seat 2: cobrik23 ($93 in chips) 
Seat 5: Moszes360 ($101.50 in chips) 
Seat 6: deadkiller1 ($153.86 in chips) 
Seat 7: matiko09 ($100 in chips) 
Seat 9: sanr23 ($100 in chips) 
HITYESCA will be allowed to play after the button
Moszes360: posts small blind $0.50
deadkiller1: posts big blind $1
Kihog: sits out 
*** HOLE CARDS ***
Dealt to matiko09 [3s 6s]
matiko09: folds 
sanr23: folds 
vanilica: folds 
cobrik23: folds 
Moszes360: folds 
Uncalled bet ($0.50) returned to deadkiller1
deadkiller1 collected $1 from pot
deadkiller1: doesn't show hand 
*** SUMMARY ***
Total pot $1 | Rake $0 
Seat 1: vanilica folded before Flop (didn't bet)
Seat 2: cobrik23 (button) folded before Flop (didn't bet)
Seat 5: Moszes360 (small blind) folded before Flop
Seat 6: deadkiller1 (big blind) collected ($1)
Seat 7: matiko09 folded before Flop (didn't bet)
Seat 9: sanr23 folded before Flop (didn't bet)





PokerStars Hand #153502523913:  Hold'em No Limit ($1/$2 USD) - 2016/05/18 20:35:41 CET [2016/05/18 14:35:41 ET]
Table 'Chlosinde' 9-max Seat #3 is the button
Seat 3: matiko09 ($221.56 in chips) 
Seat 4: vanilica ($200 in chips) 
Seat 5: tepi_guy ($861.49 in chips) 
Seat 6: Vikulja1993 ($202.15 in chips) 
Seat 7: donald0404 ($243.11 in chips) 
vanilica: posts small blind $1
tepi_guy: posts big blind $2
*** HOLE CARDS ***
Dealt to matiko09 [Td Qh]
Vikulja1993: folds 
Vikulja1993 leaves the table
donald0404: folds 
matiko09: raises $2.54 to $4.54
vanilica: folds 
tepi_guy: raises $12.08 to $16.62
matiko09: folds 
Uncalled bet ($12.08) returned to tepi_guy
tepi_guy collected $10.08 from pot
tepi_guy: doesn't show hand 
*** SUMMARY ***
Total pot $10.08 | Rake $0 
Seat 3: matiko09 (button) folded before Flop
Seat 4: vanilica (small blind) folded before Flop
Seat 5: tepi_guy (big blind) collected ($10.08)
Seat 6: Vikulja1993 folded before Flop (didn't bet)
Seat 7: donald0404 folded before Flop (didn't bet)





PokerStars Hand #153502542253:  Hold'em No Limit (€0.50/€1.00 EUR) - 2016/05/18 20:36:01 CET [2016/05/18 14:36:01 ET]
Table 'Pallas II' 9-max Seat #3 is the button
Seat 1: deadkiller1 (€104 in chips) 
Seat 2: matiko09 (€203.99 in chips) 
Seat 3: Vikulja1993 (€106.50 in chips) 
Seat 4: torkkdnm (€145.71 in chips) 
Seat 5: cobrik23 (€73.36 in chips) 
Seat 6: HITYESCA (€105.12 in chips) 
Seat 7: rate8 (€100 in chips) 
Seat 8: lydia12345 (€100 in chips) 
Seat 9: stijner1986 (€142.48 in chips) 
torkkdnm: posts small blind €0.50
cobrik23: posts big blind €1
*** HOLE CARDS ***
Dealt to matiko09 [Tc 3c]
HITYESCA: folds 
rate8: folds 
lydia12345: folds 
stijner1986: folds 
deadkiller1: raises €2 to €3
matiko09: folds 
Vikulja1993: folds 
torkkdnm: folds 
cobrik23: folds 
Uncalled bet (€2) returned to deadkiller1
deadkiller1 collected €2.50 from pot
deadkiller1: doesn't show hand 
*** SUMMARY ***
Total pot €2.50 | Rake €0 
Seat 1: deadkiller1 collected (€2.50)
Seat 2: matiko09 folded before Flop (didn't bet)
Seat 3: Vikulja1993 (button) folded before Flop (didn't bet)
Seat 4: torkkdnm (small blind) folded before Flop
Seat 5: cobrik23 (big blind) folded before Flop
Seat 6: HITYESCA folded before Flop (didn't bet)
Seat 7: rate8 folded before Flop (didn't bet)
Seat 8: lydia12345 folded before Flop (didn't bet)
Seat 9: stijner1986 folded before Flop (didn't bet)





PokerStars Hand #153502549351:  Hold'em No Limit ($0.50/$1.00 USD) - 2016/05/18 20:36:09 CET [2016/05/18 14:36:09 ET]
Table 'Erida II' 9-max Seat #5 is the button
Seat 1: vanilica ($100 in chips) 
Seat 2: cobrik23 ($93 in chips) 
Seat 5: Moszes360 ($101 in chips) 
Seat 6: deadkiller1 ($154.36 in chips) 
Seat 7: matiko09 ($100 in chips) 
Seat 9: sanr23 ($100 in chips) 
deadkiller1: posts small blind $0.50
matiko09: posts big blind $1
Kihog: sits out 
HITYESCA: sits out 
*** HOLE CARDS ***
Dealt to matiko09 [Jd Td]
sanr23: folds 
vanilica: folds 
cobrik23: folds 
Moszes360: folds 
deadkiller1: raises $1.50 to $2.50
matiko09: calls $1.50
*** FLOP *** [Qs 2h 6s]
deadkiller1: checks 
matiko09: checks 
*** TURN *** [Qs 2h 6s] [As]
deadkiller1: checks 
matiko09: checks 
*** RIVER *** [Qs 2h 6s As] [7c]
deadkiller1: checks 
Kelvin sai leaves the table
smolski15 joins the table at seat #3 
matiko09: checks 
*** SHOW DOWN ***
deadkiller1: shows [7d 4c] (a pair of Sevens)
matiko09: mucks hand 
deadkiller1 collected $4.75 from pot
smolski15 leaves the table
*** SUMMARY ***
Total pot $5 | Rake $0.25 
Board [Qs 2h 6s As 7c]
Seat 1: vanilica folded before Flop (didn't bet)
Seat 2: cobrik23 folded before Flop (didn't bet)
Seat 5: Moszes360 (button) folded before Flop (didn't bet)
Seat 6: deadkiller1 (small blind) showed [7d 4c] and won ($4.75) with a pair of Sevens
Seat 7: matiko09 (big blind) mucked [Jd Td]
Seat 9: sanr23 folded before Flop (didn't bet)





PokerStars Hand #153502551387:  Hold'em No Limit ($1/$2 USD) - 2016/05/18 20:36:11 CET [2016/05/18 14:36:11 ET]
Table 'Letaba' 9-max Seat #2 is the button
Seat 1: vanilica ($200 in chips) 
Seat 2: Sharknebulah ($202 in chips) 
Seat 4: matiko09 ($200 in chips) 
Seat 9: tepi_guy ($276.94 in chips) 
matiko09: posts small blind $1
donald0404: is sitting out 
donald0404 leaves the table
techitch13 joins the table at seat #5 
moshmachine: is sitting out 
lydia12345: is sitting out 
tepi_guy: posts big blind $2
*** HOLE CARDS ***
Dealt to matiko09 [9s 2h]
moshmachine leaves the table
lydia12345 leaves the table
vanilica: folds 
Sharknebulah: folds 
matiko09: folds 
Uncalled bet ($1) returned to tepi_guy
tepi_guy collected $2 from pot
tepi_guy: doesn't show hand 
*** SUMMARY ***
Total pot $2 | Rake $0 
Seat 1: vanilica folded before Flop (didn't bet)
Seat 2: Sharknebulah (button) folded before Flop (didn't bet)
Seat 4: matiko09 (small blind) folded before Flop
Seat 9: tepi_guy (big blind) collected ($2)





PokerStars Hand #153502555565:  Hold'em No Limit ($0.50/$1.00 USD) - 2016/05/18 20:36:16 CET [2016/05/18 14:36:16 ET]
Table 'Tatjana III' 9-max Seat #1 is the button
Seat 1: cobrik23 ($95.32 in chips) 
Seat 2: HITYESCA ($122.82 in chips) 
Seat 3: matiko09 ($188.34 in chips) 
Seat 4: lydia12345 ($134.48 in chips) 
Seat 5: deadkiller1 ($114.94 in chips) 
Seat 6: nickreason17 ($124.12 in chips) 
Seat 7: rene1984tsv ($88.53 in chips) 
Seat 8: JACQUILF ($110.30 in chips) 
Seat 9: Moszes360 ($102.62 in chips) 
HITYESCA: posts small blind $0.50
matiko09: posts big blind $1
*** HOLE CARDS ***
Dealt to matiko09 [7c Ac]
lydia12345: folds 
deadkiller1: folds 
nickreason17: raises $1.50 to $2.50
rene1984tsv: folds 
JACQUILF: folds 
Moszes360: folds 
cobrik23: calls $2.50
HITYESCA: folds 
matiko09: folds 
*** FLOP *** [Js Kc 9s]
nickreason17: checks 
cobrik23: checks 
*** TURN *** [Js Kc 9s] [8s]
nickreason17: bets $3.25
cobrik23: folds 
Uncalled bet ($3.25) returned to nickreason17
nickreason17 collected $6.18 from pot
*** SUMMARY ***
Total pot $6.50 | Rake $0.32 
Board [Js Kc 9s 8s]
Seat 1: cobrik23 (button) folded on the Turn
Seat 2: HITYESCA (small blind) folded before Flop
Seat 3: matiko09 (big blind) folded before Flop
Seat 4: lydia12345 folded before Flop (didn't bet)
Seat 5: deadkiller1 folded before Flop (didn't bet)
Seat 6: nickreason17 collected ($6.18)
Seat 7: rene1984tsv folded before Flop (didn't bet)
Seat 8: JACQUILF folded before Flop (didn't bet)
Seat 9: Moszes360 folded before Flop (didn't bet)





PokerStars Hand #153502555906:  Hold'em No Limit ($0.50/$1.00 USD) - 2016/05/18 20:36:17 CET [2016/05/18 14:36:17 ET]
Table 'Barto' 9-max Seat #1 is the button
Seat 1: IRAVABAN ($43 in chips) 
Seat 3: pokerstereke ($93.21 in chips) 
Seat 4: Kihog ($112.68 in chips) 
Seat 5: matiko09 ($100 in chips) 
Seat 7: deadkiller1 ($100 in chips) 
Seat 9: gongqingss ($49.92 in chips) 
pokerstereke: posts small blind $0.50
Kihog: posts big blind $1
vanilica: sits out 
*** HOLE CARDS ***
Dealt to matiko09 [9s Ts]
matiko09: raises $2 to $3
deadkiller1: folds 
gongqingss: calls $3
IRAVABAN: folds 
pokerstereke: calls $2.50
Kihog: folds 
*** FLOP *** [6h 6d 9d]
pokerstereke: checks 
matiko09: bets $5
rate8 joins the table at seat #8 
gongqingss: raises $5 to $10
pokerstereke: folds 
matiko09: folds 
Uncalled bet ($5) returned to gongqingss
gongqingss collected $19 from pot
gongqingss: doesn't show hand 
*** SUMMARY ***
Total pot $20 | Rake $1 
Board [6h 6d 9d]
Seat 1: IRAVABAN (button) folded before Flop (didn't bet)
Seat 3: pokerstereke (small blind) folded on the Flop
Seat 4: Kihog (big blind) folded before Flop
Seat 5: matiko09 folded on the Flop
Seat 7: deadkiller1 folded before Flop (didn't bet)
Seat 9: gongqingss collected ($19)





PokerStars Hand #153502563472:  Hold'em No Limit ($0.50/$1.00 USD) - 2016/05/18 20:36:25 CET [2016/05/18 14:36:25 ET]
Table 'Abetti II' 9-max Seat #3 is the button
Seat 1: matiko09 ($129.58 in chips) 
Seat 2: Vikulja1993 ($100 in chips) 
Seat 3: cobrik23 ($127.28 in chips) 
Seat 4: ipashutapkom ($44.50 in chips) 
Seat 5: blufthenuts ($130.02 in chips) 
Seat 6: I The King I ($168.91 in chips) 
Seat 7: nickreason17 ($124.46 in chips) 
Seat 8: roadster683 ($77.85 in chips) 
Seat 9: lydia12345 ($261.45 in chips) 
ipashutapkom: posts small blind $0.50
blufthenuts: posts big blind $1
*** HOLE CARDS ***
Dealt to matiko09 [5d Th]
I The King I: folds 
nickreason17: folds 
roadster683: folds 
lydia12345: folds 
matiko09: folds 
Vikulja1993: folds 
cobrik23: raises $2 to $3
ipashutapkom: folds 
blufthenuts: folds 
Uncalled bet ($2) returned to cobrik23
cobrik23 collected $2.50 from pot
cobrik23: doesn't show hand 
*** SUMMARY ***
Total pot $2.50 | Rake $0 
Seat 1: matiko09 folded before Flop (didn't bet)
Seat 2: Vikulja1993 folded before Flop (didn't bet)
Seat 3: cobrik23 (button) collected ($2.50)
Seat 4: ipashutapkom (small blind) folded before Flop
Seat 5: blufthenuts (big blind) folded before Flop
Seat 6: I The King I folded before Flop (didn't bet)
Seat 7: nickreason17 folded before Flop (didn't bet)
Seat 8: roadster683 folded before Flop (didn't bet)
Seat 9: lydia12345 folded before Flop (didn't bet)





PokerStars Hand #153502567099:  Hold'em No Limit ($0.50/$1.00 USD) - 2016/05/18 20:36:29 CET [2016/05/18 14:36:29 ET]
Table 'Suevia' 9-max Seat #8 is the button
Seat 1: Moszes360 ($100 in chips) 
Seat 2: deadkiller1 ($108.35 in chips) 
Seat 3: matiko09 ($100 in chips) 
Seat 4: HITYESCA ($100 in chips) 
Seat 5: bello1310 ($107.53 in chips) 
Seat 6: torkkdnm ($125.66 in chips) 
Seat 7: IRAVABAN ($40 in chips) 
Seat 8: ama58 ($50.58 in chips) 
Seat 9: oscarleon ($135.37 in chips) 
oscarleon: posts small blind $0.50
Moszes360: posts big blind $1
*** HOLE CARDS ***
Dealt to matiko09 [Kd 8s]
deadkiller1: raises $2 to $3
matiko09: folds 
HITYESCA: folds 
bello1310: folds 
torkkdnm: folds 
IRAVABAN: folds 
ama58: folds 
oscarleon: folds 
Moszes360: folds 
Uncalled bet ($2) returned to deadkiller1
deadkiller1 collected $2.50 from pot
deadkiller1: doesn't show hand 
*** SUMMARY ***
Total pot $2.50 | Rake $0 
Seat 1: Moszes360 (big blind) folded before Flop
Seat 2: deadkiller1 collected ($2.50)
Seat 3: matiko09 folded before Flop (didn't bet)
Seat 4: HITYESCA folded before Flop (didn't bet)
Seat 5: bello1310 folded before Flop (didn't bet)
Seat 6: torkkdnm folded before Flop (didn't bet)
Seat 7: IRAVABAN folded before Flop (didn't bet)
Seat 8: ama58 (button) folded before Flop (didn't bet)
Seat 9: oscarleon (small blind) folded before Flop





PokerStars Hand #153502567290:  Hold'em No Limit (€0.50/€1.00 EUR) - 2016/05/18 20:36:30 CET [2016/05/18 14:36:30 ET]
Table 'Lamberta IV' 9-max Seat #1 is the button
Seat 1: Trompeneers (€50.16 in chips) 
Seat 2: TimStone (€100 in chips) 
Seat 3: JACQUILF (€100 in chips) 
Seat 4: matiko09 (€100 in chips) 
TimStone: posts small blind €0.50
Skum1986 joins the table at seat #6 
JACQUILF: posts big blind €1
*** HOLE CARDS ***
Dealt to matiko09 [Jh Kd]
HomerrrJay joins the table at seat #5 
matiko09: raises €1.50 to €2.50
Trompeneers: folds 
TimStone: folds 
JACQUILF: folds 
Uncalled bet (€1.50) returned to matiko09
matiko09 collected €2.50 from pot
matiko09: doesn't show hand 
*** SUMMARY ***
Total pot €2.50 | Rake €0 
Seat 1: Trompeneers (button) folded before Flop (didn't bet)
Seat 2: TimStone (small blind) folded before Flop
Seat 3: JACQUILF (big blind) folded before Flop
Seat 4: matiko09 collected (€2.50)





PokerStars Hand #153502590938:  Hold'em No Limit (€0.50/€1.00 EUR) - 2016/05/18 20:36:57 CET [2016/05/18 14:36:57 ET]
Table 'Pallas II' 9-max Seat #4 is the button
Seat 1: deadkiller1 (€105.50 in chips) 
Seat 2: matiko09 (€203.99 in chips) 
Seat 3: Vikulja1993 (€106.50 in chips) 
Seat 4: torkkdnm (€145.21 in chips) 
Seat 5: cobrik23 (€72.36 in chips) 
Seat 6: HITYESCA (€105.12 in chips) 
Seat 7: rate8 (€100 in chips) 
Seat 8: lydia12345 (€100 in chips) 
Seat 9: stijner1986 (€142.48 in chips) 
cobrik23: posts small blind €0.50
HITYESCA: posts big blind €1
*** HOLE CARDS ***
Dealt to matiko09 [8d 9d]
rate8: folds 
lydia12345: raises €2 to €3
stijner1986: folds 
deadkiller1: folds 
matiko09: folds 
Vikulja1993: raises €6 to €9
torkkdnm: folds 
cobrik23: folds 
HITYESCA: folds 
lydia12345: folds 
Uncalled bet (€6) returned to Vikulja1993
Vikulja1993 collected €7.50 from pot
Vikulja1993: doesn't show hand 
*** SUMMARY ***
Total pot €7.50 | Rake €0 
Seat 1: deadkiller1 folded before Flop (didn't bet)
Seat 2: matiko09 folded before Flop (didn't bet)
Seat 3: Vikulja1993 collected (€7.50)
Seat 4: torkkdnm (button) folded before Flop (didn't bet)
Seat 5: cobrik23 (small blind) folded before Flop
Seat 6: HITYESCA (big blind) folded before Flop
Seat 7: rate8 folded before Flop (didn't bet)
Seat 8: lydia12345 folded before Flop
Seat 9: stijner1986 folded before Flop (didn't bet)





PokerStars Hand #153502591475:  Hold'em No Limit ($0.50/$1.00 USD) - 2016/05/18 20:36:57 CET [2016/05/18 14:36:57 ET]
Table 'Abetti II' 9-max Seat #4 is the button
Seat 1: matiko09 ($129.58 in chips) 
Seat 2: Vikulja1993 ($100 in chips) 
Seat 3: cobrik23 ($128.78 in chips) 
Seat 4: ipashutapkom ($44 in chips) 
Seat 5: blufthenuts ($129.02 in chips) 
Seat 6: I The King I ($168.91 in chips) 
Seat 7: nickreason17 ($124.46 in chips) 
Seat 8: roadster683 ($77.85 in chips) 
Seat 9: lydia12345 ($261.45 in chips) 
blufthenuts: posts small blind $0.50
I The King I: posts big blind $1
*** HOLE CARDS ***
Dealt to matiko09 [As 4s]
nickreason17: folds 
roadster683: folds 
lydia12345: folds 
matiko09: folds 
Vikulja1993: raises $2 to $3
cobrik23: folds 
ipashutapkom: folds 
nickreason17 leaves the table
blufthenuts: calls $2.50
I The King I: calls $2
*** FLOP *** [6s 3c 6c]
blufthenuts: checks 
I The King I: bets $6
Vikulja1993: calls $6
blufthenuts: folds 
*** TURN *** [6s 3c 6c] [6d]
I The King I: checks 
Vikulja1993: bets $7
I The King I: folds 
Uncalled bet ($7) returned to Vikulja1993
Vikulja1993 collected $19.95 from pot
Vikulja1993: doesn't show hand 
*** SUMMARY ***
Total pot $21 | Rake $1.05 
Board [6s 3c 6c 6d]
Seat 1: matiko09 folded before Flop (didn't bet)
Seat 2: Vikulja1993 collected ($19.95)
Seat 3: cobrik23 folded before Flop (didn't bet)
Seat 4: ipashutapkom (button) folded before Flop (didn't bet)
Seat 5: blufthenuts (small blind) folded on the Flop
Seat 6: I The King I (big blind) folded on the Turn
Seat 7: nickreason17 folded before Flop (didn't bet)
Seat 8: roadster683 folded before Flop (didn't bet)
Seat 9: lydia12345 folded before Flop (didn't bet)





PokerStars Hand #153502594199:  Hold'em No Limit ($0.50/$1.00 USD) - 2016/05/18 20:37:00 CET [2016/05/18 14:37:00 ET]
Table 'Erida II' 9-max Seat #6 is the button
Seat 1: vanilica ($100 in chips) 
Seat 2: cobrik23 ($93 in chips) 
Seat 5: Moszes360 ($101 in chips) 
Seat 6: deadkiller1 ($156.61 in chips) 
Seat 7: matiko09 ($100 in chips) 
Seat 8: Kihog ($100 in chips) 
Seat 9: sanr23 ($100 in chips) 
matiko09: posts small blind $0.50
Kihog: posts big blind $1
HITYESCA: sits out 
*** HOLE CARDS ***
Dealt to matiko09 [5h Jd]
sanr23: folds 
vanilica: folds 
vanilica leaves the table
cobrik23: raises $2 to $3
Moszes360: folds 
deadkiller1: folds 
matiko09: folds 
Kihog: folds 
Uncalled bet ($2) returned to cobrik23
cobrik23 collected $2.50 from pot
cobrik23: doesn't show hand 
*** SUMMARY ***
Total pot $2.50 | Rake $0 
Seat 1: vanilica folded before Flop (didn't bet)
Seat 2: cobrik23 collected ($2.50)
Seat 5: Moszes360 folded before Flop (didn't bet)
Seat 6: deadkiller1 (button) folded before Flop (didn't bet)
Seat 7: matiko09 (small blind) folded before Flop
Seat 8: Kihog (big blind) folded before Flop
Seat 9: sanr23 folded before Flop (didn't bet)





PokerStars Hand #153502603855:  Hold'em No Limit (€0.50/€1.00 EUR) - 2016/05/18 20:37:11 CET [2016/05/18 14:37:11 ET]
Table 'Lamberta IV' 9-max Seat #2 is the button
Seat 1: Trompeneers (€50.16 in chips) 
Seat 2: TimStone (€100 in chips) 
Seat 3: JACQUILF (€100 in chips) 
Seat 4: matiko09 (€101.50 in chips) 
JACQUILF: posts small blind €0.50
matiko09: posts big blind €1
HomerrrJay: sits out 
vanilica joins the table at seat #7 
Skum1986: sits out 
*** HOLE CARDS ***
Dealt to matiko09 [2s Jh]
lydia12345 joins the table at seat #8 
Trompeneers has timed out
Trompeneers: folds 
TimStone: folds 
JACQUILF: folds 
Uncalled bet (€0.50) returned to matiko09
matiko09 collected €1 from pot
matiko09: doesn't show hand 
*** SUMMARY ***
Total pot €1 | Rake €0 
Seat 1: Trompeneers folded before Flop (didn't bet)
Seat 2: TimStone (button) folded before Flop (didn't bet)
Seat 3: JACQUILF (small blind) folded before Flop
Seat 4: matiko09 (big blind) collected (€1)





PokerStars Hand #153502604930:  Hold'em No Limit ($0.50/$1.00 USD) - 2016/05/18 20:37:13 CET [2016/05/18 14:37:13 ET]
Table 'Pandora' 9-max Seat #3 is the button
Seat 1: deadkiller1 ($123.58 in chips) 
Seat 2: fack_vi ($74.37 in chips) 
Seat 3: TimStone ($100 in chips) 
Seat 4: mooose100 ($121.02 in chips) 
Seat 5: nickreason17 ($100 in chips) 
Seat 6: Moszes360 ($101.50 in chips) 
Seat 7: lydia12345 ($105.82 in chips) 
Seat 8: matiko09 ($118.02 in chips) 
Seat 9: oscarleon ($113.98 in chips) 
mooose100: posts small blind $0.50
nickreason17: posts big blind $1
*** HOLE CARDS ***
Dealt to matiko09 [7s 2h]
Moszes360: folds 
lydia12345: folds 
matiko09: folds 
oscarleon: folds 
deadkiller1: folds 
fack_vi: folds 
TimStone: folds 
mooose100: calls $0.50
nickreason17: checks 
*** FLOP *** [9d 7c Qh]
mooose100: bets $1.90
nickreason17: folds 
Uncalled bet ($1.90) returned to mooose100
mooose100 collected $1.90 from pot
mooose100: doesn't show hand 
*** SUMMARY ***
Total pot $2 | Rake $0.10 
Board [9d 7c Qh]
Seat 1: deadkiller1 folded before Flop (didn't bet)
Seat 2: fack_vi folded before Flop (didn't bet)
Seat 3: TimStone (button) folded before Flop (didn't bet)
Seat 4: mooose100 (small blind) collected ($1.90)
Seat 5: nickreason17 (big blind) folded on the Flop
Seat 6: Moszes360 folded before Flop (didn't bet)
Seat 7: lydia12345 folded before Flop (didn't bet)
Seat 8: matiko09 folded before Flop (didn't bet)
Seat 9: oscarleon folded before Flop (didn't bet)





PokerStars Hand #153502606266:  Hold'em No Limit ($0.50/$1.00 USD) - 2016/05/18 20:37:14 CET [2016/05/18 14:37:14 ET]
Table 'Barto' 9-max Seat #3 is the button
Seat 1: IRAVABAN ($43 in chips) 
Seat 3: pokerstereke ($90.21 in chips) 
Seat 4: Kihog ($111.68 in chips) 
Seat 5: matiko09 ($100 in chips) 
Seat 7: deadkiller1 ($100 in chips) 
Seat 9: gongqingss ($60.92 in chips) 
Kihog: posts small blind $0.50
matiko09: posts big blind $1
vanilica: sits out 
rate8: sits out 
*** HOLE CARDS ***
Dealt to matiko09 [Th 2c]
deadkiller1: folds 
gongqingss: calls $1
IRAVABAN: folds 
pokerstereke: folds 
Kihog: folds 
matiko09: checks 
*** FLOP *** [Jc 7h 6d]
matiko09: checks 
gongqingss: checks 
*** TURN *** [Jc 7h 6d] [8d]
matiko09: checks 
gongqingss: bets $3
matiko09: folds 
Uncalled bet ($3) returned to gongqingss
gongqingss collected $2.38 from pot
gongqingss: doesn't show hand 
*** SUMMARY ***
Total pot $2.50 | Rake $0.12 
Board [Jc 7h 6d 8d]
Seat 1: IRAVABAN folded before Flop (didn't bet)
Seat 3: pokerstereke (button) folded before Flop (didn't bet)
Seat 4: Kihog (small blind) folded before Flop
Seat 5: matiko09 (big blind) folded on the Turn
Seat 7: deadkiller1 folded before Flop (didn't bet)
Seat 9: gongqingss collected ($2.38)





PokerStars Hand #153502607808:  Hold'em No Limit ($0.50/$1.00 USD) - 2016/05/18 20:37:16 CET [2016/05/18 14:37:16 ET]
Table 'Tatjana III' 9-max Seat #2 is the button
Seat 1: cobrik23 ($92.82 in chips) 
Seat 2: HITYESCA ($122.32 in chips) 
Seat 3: matiko09 ($187.34 in chips) 
Seat 4: lydia12345 ($134.48 in chips) 
Seat 5: deadkiller1 ($114.94 in chips) 
Seat 6: nickreason17 ($127.80 in chips) 
Seat 7: rene1984tsv ($88.53 in chips) 
Seat 8: JACQUILF ($110.30 in chips) 
Seat 9: Moszes360 ($102.62 in chips) 
matiko09: posts small blind $0.50
lydia12345: posts big blind $1
*** HOLE CARDS ***
Dealt to matiko09 [6d 9h]
deadkiller1: folds 
nickreason17: folds 
rene1984tsv: raises $1 to $2
JACQUILF: folds 
Moszes360: folds 
cobrik23: raises $4 to $6
HITYESCA: folds 
matiko09: folds 
lydia12345: folds 
rene1984tsv: calls $4
*** FLOP *** [8h Ts Tc]
rene1984tsv: checks 
cobrik23: bets $9
rene1984tsv: calls $9
*** TURN *** [8h Ts Tc] [Jc]
rene1984tsv: checks 
cobrik23: bets $24
rene1984tsv: calls $24
*** RIVER *** [8h Ts Tc Jc] [4s]
rene1984tsv: checks 
cobrik23: bets $53.82 and is all-in
rene1984tsv: calls $49.53 and is all-in
Uncalled bet ($4.29) returned to cobrik23
*** SHOW DOWN ***
cobrik23: shows [Td Kd] (three of a kind, Tens)
rene1984tsv: mucks hand 
cobrik23 collected $176.06 from pot
*** SUMMARY ***
Total pot $178.56 | Rake $2.50 
Board [8h Ts Tc Jc 4s]
Seat 1: cobrik23 showed [Td Kd] and won ($176.06) with three of a kind, Tens
Seat 2: HITYESCA (button) folded before Flop (didn't bet)
Seat 3: matiko09 (small blind) folded before Flop
Seat 4: lydia12345 (big blind) folded before Flop
Seat 5: deadkiller1 folded before Flop (didn't bet)
Seat 6: nickreason17 folded before Flop (didn't bet)
Seat 7: rene1984tsv mucked [Qh Js]
Seat 8: JACQUILF folded before Flop (didn't bet)
Seat 9: Moszes360 folded before Flop (didn't bet)





PokerStars Hand #153502610083:  Hold'em No Limit ($0.50/$1.00 USD) - 2016/05/18 20:37:19 CET [2016/05/18 14:37:19 ET]
Table 'Kayala' 9-max Seat #6 is the button
Seat 1: deadkiller1 ($107.90 in chips) 
Seat 2: Oelie7 ($168.09 in chips) 
Seat 3: matiko09 ($102 in chips) 
Seat 4: HITYESCA ($101.50 in chips) 
Seat 5: rate8 ($100 in chips) 
Seat 6: lydia12345 ($124.72 in chips) 
Seat 7: nickreason17 ($115.16 in chips) 
Seat 8: cobrik23 ($87.04 in chips) 
Seat 9: Vikulja1993 ($105.48 in chips) 
nickreason17: posts small blind $0.50
cobrik23: posts big blind $1
*** HOLE CARDS ***
Dealt to matiko09 [2d 9c]
Vikulja1993: folds 
deadkiller1: folds 
Oelie7: folds 
matiko09: folds 
HITYESCA: folds 
rate8: folds 
lydia12345: raises $1 to $2
nickreason17: folds 
cobrik23: raises $6 to $8
lydia12345: folds 
Uncalled bet ($6) returned to cobrik23
cobrik23 collected $4.50 from pot
cobrik23: doesn't show hand 
*** SUMMARY ***
Total pot $4.50 | Rake $0 
Seat 1: deadkiller1 folded before Flop (didn't bet)
Seat 2: Oelie7 folded before Flop (didn't bet)
Seat 3: matiko09 folded before Flop (didn't bet)
Seat 4: HITYESCA folded before Flop (didn't bet)
Seat 5: rate8 folded before Flop (didn't bet)
Seat 6: lydia12345 (button) folded before Flop
Seat 7: nickreason17 (small blind) folded before Flop
Seat 8: cobrik23 (big blind) collected ($4.50)
Seat 9: Vikulja1993 folded before Flop (didn't bet)





PokerStars Hand #153502612626:  Hold'em No Limit ($0.50/$1.00 USD) - 2016/05/18 20:37:21 CET [2016/05/18 14:37:21 ET]
Table 'Erida II' 9-max Seat #7 is the button
Seat 2: cobrik23 ($94.50 in chips) 
Seat 5: Moszes360 ($101 in chips) 
Seat 6: deadkiller1 ($156.61 in chips) 
Seat 7: matiko09 ($100 in chips) 
Seat 8: Kihog ($100 in chips) 
Kihog: posts small blind $0.50
sanr23: is sitting out 
cobrik23: posts big blind $1
sanr23 leaves the table
HITYESCA: sits out 
*** HOLE CARDS ***
Dealt to matiko09 [Kd 6s]
Moszes360: folds 
deadkiller1: raises $1.50 to $2.50
matiko09: folds 
Kihog: folds 
cobrik23: folds 
Uncalled bet ($1.50) returned to deadkiller1
deadkiller1 collected $2.50 from pot
deadkiller1: doesn't show hand 
*** SUMMARY ***
Total pot $2.50 | Rake $0 
Seat 2: cobrik23 (big blind) folded before Flop
Seat 5: Moszes360 folded before Flop (didn't bet)
Seat 6: deadkiller1 collected ($2.50)
Seat 7: matiko09 (button) folded before Flop (didn't bet)
Seat 8: Kihog (small blind) folded before Flop





PokerStars Hand #153502620407:  Hold'em No Limit ($0.50/$1.00 USD) - 2016/05/18 20:37:30 CET [2016/05/18 14:37:30 ET]
Table 'Suevia' 9-max Seat #9 is the button
Seat 1: Moszes360 ($100 in chips) 
Seat 2: deadkiller1 ($109.85 in chips) 
Seat 3: matiko09 ($100 in chips) 
Seat 4: HITYESCA ($100 in chips) 
Seat 5: bello1310 ($107.53 in chips) 
Seat 6: torkkdnm ($125.66 in chips) 
Seat 7: IRAVABAN ($40 in chips) 
Seat 8: ama58 ($50.58 in chips) 
Seat 9: oscarleon ($134.87 in chips) 
Moszes360: posts small blind $0.50
deadkiller1: posts big blind $1
*** HOLE CARDS ***
Dealt to matiko09 [Td 2c]
matiko09: folds 
HITYESCA: folds 
bello1310: folds 
torkkdnm: folds 
IRAVABAN: folds 
ama58: folds 
oscarleon: folds 
Moszes360: raises $2 to $3
deadkiller1: raises $6 to $9
Moszes360: folds 
Uncalled bet ($6) returned to deadkiller1
deadkiller1 collected $6 from pot
deadkiller1: doesn't show hand 
*** SUMMARY ***
Total pot $6 | Rake $0 
Seat 1: Moszes360 (small blind) folded before Flop
Seat 2: deadkiller1 (big blind) collected ($6)
Seat 3: matiko09 folded before Flop (didn't bet)
Seat 4: HITYESCA folded before Flop (didn't bet)
Seat 5: bello1310 folded before Flop (didn't bet)
Seat 6: torkkdnm folded before Flop (didn't bet)
Seat 7: IRAVABAN folded before Flop (didn't bet)
Seat 8: ama58 folded before Flop (didn't bet)
Seat 9: oscarleon (button) folded before Flop (didn't bet)





PokerStars Hand #153502626253:  Hold'em No Limit (€0.50/€1.00 EUR) - 2016/05/18 20:37:37 CET [2016/05/18 14:37:37 ET]
Table 'Lamberta IV' 9-max Seat #3 is the button
Seat 2: TimStone (€100 in chips) 
Seat 3: JACQUILF (€100 in chips) 
Seat 4: matiko09 (€102 in chips) 
Seat 5: HomerrrJay (€100 in chips) 
matiko09: posts small blind €0.50
HomerrrJay: posts big blind €1
Skum1986: sits out 
vanilica: sits out 
lydia12345: sits out 
*** HOLE CARDS ***
Dealt to matiko09 [Ac Ad]
Kihog joins the table at seat #9 
TimStone: folds 
JACQUILF: folds 
matiko09: raises €1.50 to €2.50
HomerrrJay: raises €5 to €7.50
matiko09: raises €9 to €16.50
HomerrrJay: folds 
Uncalled bet (€9) returned to matiko09
matiko09 collected €15 from pot
matiko09: doesn't show hand 
*** SUMMARY ***
Total pot €15 | Rake €0 
Seat 2: TimStone folded before Flop (didn't bet)
Seat 3: JACQUILF (button) folded before Flop (didn't bet)
Seat 4: matiko09 (small blind) collected (€15)
Seat 5: HomerrrJay (big blind) folded before Flop





PokerStars Hand #153502642932:  Hold'em No Limit ($0.50/$1.00 USD) - 2016/05/18 20:37:56 CET [2016/05/18 14:37:56 ET]
Table 'Kayala' 9-max Seat #7 is the button
Seat 1: deadkiller1 ($107.90 in chips) 
Seat 2: Oelie7 ($168.09 in chips) 
Seat 3: matiko09 ($102 in chips) 
Seat 4: HITYESCA ($101.50 in chips) 
Seat 5: rate8 ($100 in chips) 
Seat 6: lydia12345 ($122.72 in chips) 
Seat 7: nickreason17 ($114.66 in chips) 
Seat 8: cobrik23 ($89.54 in chips) 
Seat 9: Vikulja1993 ($105.48 in chips) 
cobrik23: posts small blind $0.50
Vikulja1993: posts big blind $1
*** HOLE CARDS ***
Dealt to matiko09 [4h Th]
deadkiller1: folds 
Oelie7: calls $1
matiko09: folds 
HITYESCA: folds 
rate8: folds 
lydia12345: calls $1
nickreason17: calls $1
cobrik23: folds 
Vikulja1993: checks 
*** FLOP *** [Kd Kh 9c]
Vikulja1993: checks 
Oelie7: checks 
lydia12345: checks 
nickreason17: checks 
*** TURN *** [Kd Kh 9c] [4c]
Vikulja1993: checks 
Oelie7: checks 
lydia12345: checks 
nickreason17: checks 
*** RIVER *** [Kd Kh 9c 4c] [8d]
Vikulja1993: checks 
Oelie7: checks 
lydia12345: checks 
nickreason17: checks 
*** SHOW DOWN ***
Vikulja1993: shows [7s Tc] (a pair of Kings)
Oelie7: shows [Jd Ac] (a pair of Kings - Ace kicker)
lydia12345: shows [2h 2c] (two pair, Kings and Deuces)
nickreason17: shows [Qh 8h] (two pair, Kings and Eights)
nickreason17 collected $4.28 from pot
*** SUMMARY ***
Total pot $4.50 | Rake $0.22 
Board [Kd Kh 9c 4c 8d]
Seat 1: deadkiller1 folded before Flop (didn't bet)
Seat 2: Oelie7 showed [Jd Ac] and lost with a pair of Kings
Seat 3: matiko09 folded before Flop (didn't bet)
Seat 4: HITYESCA folded before Flop (didn't bet)
Seat 5: rate8 folded before Flop (didn't bet)
Seat 6: lydia12345 showed [2h 2c] and lost with two pair, Kings and Deuces
Seat 7: nickreason17 (button) showed [Qh 8h] and won ($4.28) with two pair, Kings and Eights
Seat 8: cobrik23 (small blind) folded before Flop
Seat 9: Vikulja1993 (big blind) showed [7s Tc] and lost with a pair of Kings





PokerStars Hand #153502645745:  Hold'em No Limit ($0.50/$1.00 USD) - 2016/05/18 20:37:59 CET [2016/05/18 14:37:59 ET]
Table 'Barto' 9-max Seat #4 is the button
Seat 1: IRAVABAN ($43 in chips) 
Seat 3: pokerstereke ($90.21 in chips) 
Seat 4: Kihog ($111.18 in chips) 
Seat 5: matiko09 ($100 in chips) 
Seat 6: vanilica ($100 in chips) 
Seat 7: deadkiller1 ($100 in chips) 
Seat 9: gongqingss ($62.30 in chips) 
matiko09: posts small blind $0.50
vanilica: posts big blind $1
rate8: sits out 
*** HOLE CARDS ***
Dealt to matiko09 [Qd 6s]
deadkiller1: folds 
gongqingss: calls $1
IRAVABAN: folds 
pokerstereke: raises $1 to $2
Kihog: folds 
matiko09: folds 
vanilica: folds 
gongqingss: calls $1
*** FLOP *** [6c Js Td]
gongqingss: checks 
pokerstereke: bets $3
gongqingss: folds 
Uncalled bet ($3) returned to pokerstereke
pokerstereke collected $5.22 from pot
pokerstereke: doesn't show hand 
*** SUMMARY ***
Total pot $5.50 | Rake $0.28 
Board [6c Js Td]
Seat 1: IRAVABAN folded before Flop (didn't bet)
Seat 3: pokerstereke collected ($5.22)
Seat 4: Kihog (button) folded before Flop (didn't bet)
Seat 5: matiko09 (small blind) folded before Flop
Seat 6: vanilica (big blind) folded before Flop
Seat 7: deadkiller1 folded before Flop (didn't bet)
Seat 9: gongqingss folded on the Flop





PokerStars Hand #153502646992:  Hold'em No Limit ($0.50/$1.00 USD) - 2016/05/18 20:38:01 CET [2016/05/18 14:38:01 ET]
Table 'Erida II' 9-max Seat #8 is the button
Seat 2: cobrik23 ($93.50 in chips) 
Seat 4: HITYESCA ($100 in chips) 
Seat 5: Moszes360 ($101 in chips) 
Seat 6: deadkiller1 ($158.11 in chips) 
Seat 7: matiko09 ($100 in chips) 
Seat 8: Kihog ($100 in chips) 
cobrik23: posts small blind $0.50
HITYESCA: posts big blind $1
*** HOLE CARDS ***
Dealt to matiko09 [2s 3h]
Moszes360: folds 
Mulgraver25 joins the table at seat #3 
deadkiller1: raises $2 to $3
lydia12345 joins the table at seat #1 
matiko09: folds 
Kihog: folds 
cobrik23: folds 
HITYESCA: folds 
Uncalled bet ($2) returned to deadkiller1
deadkiller1 collected $2.50 from pot
deadkiller1: doesn't show hand 
*** SUMMARY ***
Total pot $2.50 | Rake $0 
Seat 2: cobrik23 (small blind) folded before Flop
Seat 4: HITYESCA (big blind) folded before Flop
Seat 5: Moszes360 folded before Flop (didn't bet)
Seat 6: deadkiller1 collected ($2.50)
Seat 7: matiko09 folded before Flop (didn't bet)
Seat 8: Kihog (button) folded before Flop (didn't bet)





PokerStars Hand #153502670117:  Hold'em No Limit ($0.50/$1.00 USD) - 2016/05/18 20:38:27 CET [2016/05/18 14:38:27 ET]
Table 'Tatjana III' 9-max Seat #3 is the button
Seat 1: cobrik23 ($180.35 in chips) 
Seat 2: HITYESCA ($122.32 in chips) 
Seat 3: matiko09 ($186.84 in chips) 
Seat 4: lydia12345 ($133.48 in chips) 
Seat 5: deadkiller1 ($114.94 in chips) 
Seat 6: nickreason17 ($127.80 in chips) 
Seat 8: JACQUILF ($110.30 in chips) 
Seat 9: Moszes360 ($102.62 in chips) 
lydia12345: posts small blind $0.50
deadkiller1: posts big blind $1
*** HOLE CARDS ***
Dealt to matiko09 [Jd 5s]
nickreason17: folds 
nickreason17 leaves the table
JACQUILF: folds 
Moszes360: folds 
cobrik23: folds 
HITYESCA: folds 
matiko09: folds 
lydia12345: folds 
Uncalled bet ($0.50) returned to deadkiller1
deadkiller1 collected $1 from pot
deadkiller1: doesn't show hand 
*** SUMMARY ***
Total pot $1 | Rake $0 
Seat 1: cobrik23 folded before Flop (didn't bet)
Seat 2: HITYESCA folded before Flop (didn't bet)
Seat 3: matiko09 (button) folded before Flop (didn't bet)
Seat 4: lydia12345 (small blind) folded before Flop
Seat 5: deadkiller1 (big blind) collected ($1)
Seat 6: nickreason17 folded before Flop (didn't bet)
Seat 8: JACQUILF folded before Flop (didn't bet)
Seat 9: Moszes360 folded before Flop (didn't bet)





PokerStars Hand #153502670308:  Hold'em No Limit ($0.50/$1.00 USD) - 2016/05/18 20:38:27 CET [2016/05/18 14:38:27 ET]
Table 'Abetti II' 9-max Seat #5 is the button
Seat 1: matiko09 ($129.58 in chips) 
Seat 2: Vikulja1993 ($110.95 in chips) 
Seat 3: cobrik23 ($128.78 in chips) 
Seat 4: ipashutapkom ($44 in chips) 
Seat 5: blufthenuts ($126.02 in chips) 
Seat 6: I The King I ($159.91 in chips) 
Seat 8: roadster683 ($77.85 in chips) 
Seat 9: lydia12345 ($261.45 in chips) 
I The King I: posts small blind $0.50
roadster683: posts big blind $1
*** HOLE CARDS ***
Dealt to matiko09 [Ks Ac]
rate8 joins the table at seat #7 
lydia12345: folds 
matiko09: raises $3 to $4
Vikulja1993: raises $8 to $12
cobrik23: folds 
ipashutapkom: folds 
blufthenuts: folds 
I The King I: folds 
roadster683: calls $11
matiko09: raises $15 to $27
Vikulja1993: folds 
roadster683: calls $15
*** FLOP *** [2h 6h 9s]
roadster683: checks 
matiko09: bets $51
roadster683: calls $50.85 and is all-in
Uncalled bet ($0.15) returned to matiko09
*** TURN *** [2h 6h 9s] [2d]
*** RIVER *** [2h 6h 9s 2d] [Qs]
*** SHOW DOWN ***
roadster683: shows [8s 8d] (two pair, Eights and Deuces)
matiko09: mucks hand 
roadster683 collected $165.70 from pot
*** SUMMARY ***
Total pot $168.20 | Rake $2.50 
Board [2h 6h 9s 2d Qs]
Seat 1: matiko09 mucked [Ks Ac]
Seat 2: Vikulja1993 folded before Flop
Seat 3: cobrik23 folded before Flop (didn't bet)
Seat 4: ipashutapkom folded before Flop (didn't bet)
Seat 5: blufthenuts (button) folded before Flop (didn't bet)
Seat 6: I The King I (small blind) folded before Flop
Seat 8: roadster683 (big blind) showed [8s 8d] and won ($165.70) with two pair, Eights and Deuces
Seat 9: lydia12345 folded before Flop (didn't bet)





PokerStars Hand #153502670792:  Hold'em No Limit (€0.50/€1.00 EUR) - 2016/05/18 20:38:28 CET [2016/05/18 14:38:28 ET]
Table 'Pallas II' 9-max Seat #5 is the button
Seat 1: deadkiller1 (€105.50 in chips) 
Seat 2: matiko09 (€203.99 in chips) 
Seat 3: Vikulja1993 (€111 in chips) 
Seat 4: torkkdnm (€145.21 in chips) 
Seat 5: cobrik23 (€71.86 in chips) 
Seat 6: HITYESCA (€104.12 in chips) 
Seat 7: rate8 (€100 in chips) 
Seat 8: lydia12345 (€100 in chips) 
Seat 9: stijner1986 (€142.48 in chips) 
HITYESCA: posts small blind €0.50
rate8: posts big blind €1
*** HOLE CARDS ***
Dealt to matiko09 [6s 2h]
lydia12345: folds 
lydia12345 leaves the table
stijner1986: calls €1
deadkiller1: folds 
matiko09: folds 
Kihog joins the table at seat #8 
Vikulja1993: folds 
torkkdnm: folds 
cobrik23: folds 
HITYESCA: folds 
rate8: checks 
*** FLOP *** [3h Kh Kc]
rate8: bets €1.23
stijner1986: folds 
Uncalled bet (€1.23) returned to rate8
rate8 collected €2.38 from pot
rate8: doesn't show hand 
*** SUMMARY ***
Total pot €2.50 | Rake €0.12 
Board [3h Kh Kc]
Seat 1: deadkiller1 folded before Flop (didn't bet)
Seat 2: matiko09 folded before Flop (didn't bet)
Seat 3: Vikulja1993 folded before Flop (didn't bet)
Seat 4: torkkdnm folded before Flop (didn't bet)
Seat 5: cobrik23 (button) folded before Flop (didn't bet)
Seat 6: HITYESCA (small blind) folded before Flop
Seat 7: rate8 (big blind) collected (€2.38)
Seat 8: lydia12345 folded before Flop (didn't bet)
Seat 9: stijner1986 folded on the Flop





PokerStars Hand #153502682545:  Hold'em No Limit ($0.50/$1.00 USD) - 2016/05/18 20:38:41 CET [2016/05/18 14:38:41 ET]
Table 'Pandora' 9-max Seat #4 is the button
Seat 1: deadkiller1 ($123.58 in chips) 
Seat 2: fack_vi ($74.37 in chips) 
Seat 3: TimStone ($100 in chips) 
Seat 4: mooose100 ($121.92 in chips) 
Seat 5: nickreason17 ($100 in chips) 
Seat 6: Moszes360 ($101.50 in chips) 
Seat 7: lydia12345 ($105.82 in chips) 
Seat 8: matiko09 ($118.02 in chips) 
Seat 9: oscarleon ($113.98 in chips) 
nickreason17: posts small blind $0.50
Moszes360: posts big blind $1
*** HOLE CARDS ***
Dealt to matiko09 [9c Jd]
lydia12345: folds 
matiko09: folds 
oscarleon: folds 
deadkiller1: folds 
fack_vi: raises $2 to $3
TimStone: folds 
mooose100: folds 
nickreason17: folds 
Moszes360: folds 
Uncalled bet ($2) returned to fack_vi
fack_vi collected $2.50 from pot
fack_vi: doesn't show hand 
*** SUMMARY ***
Total pot $2.50 | Rake $0 
Seat 1: deadkiller1 folded before Flop (didn't bet)
Seat 2: fack_vi collected ($2.50)
Seat 3: TimStone folded before Flop (didn't bet)
Seat 4: mooose100 (button) folded before Flop (didn't bet)
Seat 5: nickreason17 (small blind) folded before Flop
Seat 6: Moszes360 (big blind) folded before Flop
Seat 7: lydia12345 folded before Flop (didn't bet)
Seat 8: matiko09 folded before Flop (didn't bet)
Seat 9: oscarleon folded before Flop (didn't bet)





PokerStars Hand #153502686425:  Hold'em No Limit ($0.50/$1.00 USD) - 2016/05/18 20:38:46 CET [2016/05/18 14:38:46 ET]
Table 'Suevia' 9-max Seat #1 is the button
Seat 1: Moszes360 ($100 in chips) 
Seat 2: deadkiller1 ($112.85 in chips) 
Seat 3: matiko09 ($100 in chips) 
Seat 4: HITYESCA ($100 in chips) 
Seat 5: bello1310 ($107.53 in chips) 
Seat 6: torkkdnm ($125.66 in chips) 
Seat 7: IRAVABAN ($40 in chips) 
Seat 8: ama58 ($50.58 in chips) 
Seat 9: oscarleon ($134.87 in chips) 
deadkiller1: posts small blind $0.50
matiko09: posts big blind $1
*** HOLE CARDS ***
Dealt to matiko09 [8s Kh]
HITYESCA: folds 
bello1310: folds 
torkkdnm: raises $2 to $3
IRAVABAN: folds 
ama58: folds 
oscarleon: folds 
Moszes360: folds 
deadkiller1: folds 
matiko09: folds 
Uncalled bet ($2) returned to torkkdnm
torkkdnm collected $2.50 from pot
*** SUMMARY ***
Total pot $2.50 | Rake $0 
Seat 1: Moszes360 (button) folded before Flop (didn't bet)
Seat 2: deadkiller1 (small blind) folded before Flop
Seat 3: matiko09 (big blind) folded before Flop
Seat 4: HITYESCA folded before Flop (didn't bet)
Seat 5: bello1310 folded before Flop (didn't bet)
Seat 6: torkkdnm collected ($2.50)
Seat 7: IRAVABAN folded before Flop (didn't bet)
Seat 8: ama58 folded before Flop (didn't bet)
Seat 9: oscarleon folded before Flop (didn't bet)





PokerStars Hand #153502691773:  Hold'em No Limit ($0.50/$1.00 USD) - 2016/05/18 20:38:52 CET [2016/05/18 14:38:52 ET]
Table 'Barto' 9-max Seat #5 is the button
Seat 1: IRAVABAN ($43 in chips) 
Seat 3: pokerstereke ($93.43 in chips) 
Seat 4: Kihog ($111.18 in chips) 
Seat 5: matiko09 ($100 in chips) 
Seat 6: vanilica ($100 in chips) 
Seat 7: deadkiller1 ($100 in chips) 
Seat 9: gongqingss ($60.30 in chips) 
vanilica: posts small blind $0.50
deadkiller1: posts big blind $1
rate8: sits out 
*** HOLE CARDS ***
Dealt to matiko09 [Jd 8h]
gongqingss: folds 
IRAVABAN: folds 
pokerstereke: folds 
Kihog: raises $1.50 to $2.50
matiko09: folds 
vanilica: folds 
deadkiller1: folds 
Uncalled bet ($1.50) returned to Kihog
Kihog collected $2.50 from pot
Kihog: doesn't show hand 
*** SUMMARY ***
Total pot $2.50 | Rake $0 
Seat 1: IRAVABAN folded before Flop (didn't bet)
Seat 3: pokerstereke folded before Flop (didn't bet)
Seat 4: Kihog collected ($2.50)
Seat 5: matiko09 (button) folded before Flop (didn't bet)
Seat 6: vanilica (small blind) folded before Flop
Seat 7: deadkiller1 (big blind) folded before Flop
Seat 9: gongqingss folded before Flop (didn't bet)





PokerStars Hand #153502692465:  Hold'em No Limit (€0.50/€1.00 EUR) - 2016/05/18 20:38:52 CET [2016/05/18 14:38:52 ET]
Table 'Lamberta IV' 9-max Seat #4 is the button
Seat 1: Trompeneers (€50.16 in chips) 
Seat 2: TimStone (€100 in chips) 
Seat 3: JACQUILF (€100 in chips) 
Seat 4: matiko09 (€109.50 in chips) 
Seat 5: HomerrrJay (€100 in chips) 
Seat 6: Skum1986 (€100 in chips) 
HomerrrJay: posts small blind €0.50
Skum1986: posts big blind €1
vanilica: sits out 
lydia12345: sits out 
Kihog: sits out 
*** HOLE CARDS ***
Dealt to matiko09 [2h Tc]
Trompeneers: calls €1
TimStone: folds 
JACQUILF: raises €3 to €4
matiko09: folds 
HomerrrJay: folds 
Skum1986: folds 
Trompeneers: calls €3
*** FLOP *** [Qc 9d Kd]
Trompeneers: bets €2
JACQUILF: calls €2
*** TURN *** [Qc 9d Kd] [6h]
Trompeneers: bets €5
JACQUILF: calls €5
*** RIVER *** [Qc 9d Kd 6h] [7h]
Trompeneers: bets €10
JACQUILF: calls €10
*** SHOW DOWN ***
Trompeneers: shows [7d 6d] (two pair, Sevens and Sixes)
JACQUILF: mucks hand 
Trompeneers collected €41.32 from pot
*** SUMMARY ***
Total pot €43.50 | Rake €2.18 
Board [Qc 9d Kd 6h 7h]
Seat 1: Trompeneers showed [7d 6d] and won (€41.32) with two pair, Sevens and Sixes
Seat 2: TimStone folded before Flop (didn't bet)
Seat 3: JACQUILF mucked [Td Kh]
Seat 4: matiko09 (button) folded before Flop (didn't bet)
Seat 5: HomerrrJay (small blind) folded before Flop
Seat 6: Skum1986 (big blind) folded before Flop





PokerStars Hand #153502703070:  Hold'em No Limit ($0.50/$1.00 USD) - 2016/05/18 20:39:04 CET [2016/05/18 14:39:04 ET]
Table 'Tatjana III' 9-max Seat #4 is the button
Seat 1: cobrik23 ($180.35 in chips) 
Seat 2: HITYESCA ($122.32 in chips) 
Seat 3: matiko09 ($186.84 in chips) 
Seat 4: lydia12345 ($132.98 in chips) 
Seat 5: deadkiller1 ($115.44 in chips) 
Seat 7: rene1984tsv ($98.43 in chips) 
Seat 8: JACQUILF ($110.30 in chips) 
Seat 9: Moszes360 ($102.62 in chips) 
deadkiller1: posts small blind $0.50
rene1984tsv: posts big blind $1
*** HOLE CARDS ***
Dealt to matiko09 [2c 3c]
JACQUILF: folds 
Moszes360: folds 
Kihog joins the table at seat #6 
cobrik23: raises $2 to $3
HITYESCA: calls $3
matiko09: folds 
lydia12345: folds 
deadkiller1: folds 
rene1984tsv: calls $2
*** FLOP *** [As 9d Qd]
rene1984tsv: checks 
cobrik23: checks 
HITYESCA: checks 
*** TURN *** [As 9d Qd] [4d]
rene1984tsv: checks 
cobrik23: checks 
HITYESCA: bets $7
rene1984tsv: folds 
cobrik23: folds 
Uncalled bet ($7) returned to HITYESCA
HITYESCA collected $9.02 from pot
HITYESCA: doesn't show hand 
*** SUMMARY ***
Total pot $9.50 | Rake $0.48 
Board [As 9d Qd 4d]
Seat 1: cobrik23 folded on the Turn
Seat 2: HITYESCA collected ($9.02)
Seat 3: matiko09 folded before Flop (didn't bet)
Seat 4: lydia12345 (button) folded before Flop (didn't bet)
Seat 5: deadkiller1 (small blind) folded before Flop
Seat 7: rene1984tsv (big blind) folded on the Turn
Seat 8: JACQUILF folded before Flop (didn't bet)
Seat 9: Moszes360 folded before Flop (didn't bet)





PokerStars Hand #153502711839:  Hold'em No Limit ($0.50/$1.00 USD) - 2016/05/18 20:39:15 CET [2016/05/18 14:39:15 ET]
Table 'Barto' 9-max Seat #6 is the button
Seat 1: IRAVABAN ($43 in chips) 
Seat 3: pokerstereke ($93.43 in chips) 
Seat 4: Kihog ($112.68 in chips) 
Seat 5: matiko09 ($100 in chips) 
Seat 6: vanilica ($100 in chips) 
Seat 7: deadkiller1 ($100 in chips) 
Seat 8: rate8 ($100 in chips) 
Seat 9: gongqingss ($60.30 in chips) 
deadkiller1: posts small blind $0.50
rate8: posts big blind $1
*** HOLE CARDS ***
Dealt to matiko09 [Kh 6c]
gongqingss: calls $1
IRAVABAN: folds 
pokerstereke: folds 
Kihog: folds 
buttonlife leaves the table
matiko09: folds 
vanilica: folds 
IRAVABAN is disconnected 
deadkiller1: calls $0.50
rate8: checks 
*** FLOP *** [Qd 8h 7h]
deadkiller1: bets $2
rate8: folds 
Moszes360 joins the table at seat #2 
gongqingss: calls $2
*** TURN *** [Qd 8h 7h] [6h]
deadkiller1: bets $5
gongqingss: folds 
Uncalled bet ($5) returned to deadkiller1
deadkiller1 collected $6.65 from pot
deadkiller1: doesn't show hand 
*** SUMMARY ***
Total pot $7 | Rake $0.35 
Board [Qd 8h 7h 6h]
Seat 1: IRAVABAN folded before Flop (didn't bet)
Seat 3: pokerstereke folded before Flop (didn't bet)
Seat 4: Kihog folded before Flop (didn't bet)
Seat 5: matiko09 folded before Flop (didn't bet)
Seat 6: vanilica (button) folded before Flop (didn't bet)
Seat 7: deadkiller1 (small blind) collected ($6.65)
Seat 8: rate8 (big blind) folded on the Flop
Seat 9: gongqingss folded on the Turn





PokerStars Hand #153502716873:  Hold'em No Limit ($0.50/$1.00 USD) - 2016/05/18 20:39:20 CET [2016/05/18 14:39:20 ET]
Table 'Pandora' 9-max Seat #5 is the button
Seat 1: deadkiller1 ($123.58 in chips) 
Seat 2: fack_vi ($75.87 in chips) 
Seat 3: TimStone ($100 in chips) 
Seat 4: mooose100 ($121.92 in chips) 
Seat 5: nickreason17 ($100 in chips) 
Seat 6: Moszes360 ($100.50 in chips) 
Seat 7: lydia12345 ($105.82 in chips) 
Seat 8: matiko09 ($118.02 in chips) 
Seat 9: oscarleon ($113.98 in chips) 
Moszes360: posts small blind $0.50
lydia12345: posts big blind $1
*** HOLE CARDS ***
Dealt to matiko09 [Js 3c]
matiko09: folds 
oscarleon: folds 
deadkiller1: raises $2 to $3
fack_vi: folds 
TimStone: folds 
mooose100: calls $3
nickreason17: folds 
Moszes360: folds 
lydia12345: folds 
*** FLOP *** [2s Kh Jc]
deadkiller1: checks 
mooose100: checks 
*** TURN *** [2s Kh Jc] [Kd]
deadkiller1: checks 
mooose100: bets $3.56
deadkiller1: calls $3.56
*** RIVER *** [2s Kh Jc Kd] [3d]
deadkiller1: checks 
mooose100: bets $13.89
deadkiller1: calls $13.89
*** SHOW DOWN ***
mooose100: shows [Qh 6h] (a pair of Kings)
deadkiller1: shows [9d 9h] (two pair, Kings and Nines)
deadkiller1 collected $40.28 from pot
*** SUMMARY ***
Total pot $42.40 | Rake $2.12 
Board [2s Kh Jc Kd 3d]
Seat 1: deadkiller1 showed [9d 9h] and won ($40.28) with two pair, Kings and Nines
Seat 2: fack_vi folded before Flop (didn't bet)
Seat 3: TimStone folded before Flop (didn't bet)
Seat 4: mooose100 showed [Qh 6h] and lost with a pair of Kings
Seat 5: nickreason17 (button) folded before Flop (didn't bet)
Seat 6: Moszes360 (small blind) folded before Flop
Seat 7: lydia12345 (big blind) folded before Flop
Seat 8: matiko09 folded before Flop (didn't bet)
Seat 9: oscarleon folded before Flop (didn't bet)





PokerStars Hand #153502730999:  Hold'em No Limit (€0.50/€1.00 EUR) - 2016/05/18 20:39:36 CET [2016/05/18 14:39:36 ET]
Table 'Pallas II' 9-max Seat #6 is the button
Seat 1: deadkiller1 (€105.50 in chips) 
Seat 2: matiko09 (€203.99 in chips) 
Seat 3: Vikulja1993 (€111 in chips) 
Seat 4: torkkdnm (€145.21 in chips) 
Seat 5: cobrik23 (€71.86 in chips) 
Seat 6: HITYESCA (€103.62 in chips) 
Seat 7: rate8 (€101.38 in chips) 
Seat 8: Kihog (€100 in chips) 
Seat 9: stijner1986 (€141.48 in chips) 
rate8: posts small blind €0.50
Kihog: posts big blind €1
*** HOLE CARDS ***
Dealt to matiko09 [Tc Kh]
stijner1986: folds 
deadkiller1: raises €2 to €3
matiko09: folds 
Vikulja1993: folds 
torkkdnm: folds 
cobrik23: folds 
HITYESCA: folds 
rate8: folds 
Kihog: folds 
Uncalled bet (€2) returned to deadkiller1
deadkiller1 collected €2.50 from pot
deadkiller1: doesn't show hand 
*** SUMMARY ***
Total pot €2.50 | Rake €0 
Seat 1: deadkiller1 collected (€2.50)
Seat 2: matiko09 folded before Flop (didn't bet)
Seat 3: Vikulja1993 folded before Flop (didn't bet)
Seat 4: torkkdnm folded before Flop (didn't bet)
Seat 5: cobrik23 folded before Flop (didn't bet)
Seat 6: HITYESCA (button) folded before Flop (didn't bet)
Seat 7: rate8 (small blind) folded before Flop
Seat 8: Kihog (big blind) folded before Flop
Seat 9: stijner1986 folded before Flop (didn't bet)





PokerStars Hand #153502739329:  Hold'em No Limit ($0.50/$1.00 USD) - 2016/05/18 20:39:46 CET [2016/05/18 14:39:46 ET]
Table 'Suevia' 9-max Seat #2 is the button
Seat 1: Moszes360 ($100 in chips) 
Seat 2: deadkiller1 ($112.35 in chips) 
Seat 3: matiko09 ($100 in chips) 
Seat 4: HITYESCA ($100 in chips) 
Seat 5: bello1310 ($107.53 in chips) 
Seat 6: torkkdnm ($127.16 in chips) 
Seat 7: IRAVABAN ($40 in chips) 
Seat 8: ama58 ($50.58 in chips) 
Seat 9: oscarleon ($134.87 in chips) 
matiko09: posts small blind $0.50
HITYESCA: posts big blind $1
*** HOLE CARDS ***
Dealt to matiko09 [Qc Tc]
bello1310: folds 
IRAVABAN is disconnected 
torkkdnm: folds 
IRAVABAN is connected 
IRAVABAN: folds 
ama58: folds 
oscarleon: folds 
Moszes360: folds 
deadkiller1: raises $1.50 to $2.50
matiko09: raises $6.50 to $9
HITYESCA: folds 
deadkiller1: folds 
Uncalled bet ($6.50) returned to matiko09
matiko09 collected $6 from pot
matiko09: doesn't show hand 
*** SUMMARY ***
Total pot $6 | Rake $0 
Seat 1: Moszes360 folded before Flop (didn't bet)
Seat 2: deadkiller1 (button) folded before Flop
Seat 3: matiko09 (small blind) collected ($6)
Seat 4: HITYESCA (big blind) folded before Flop
Seat 5: bello1310 folded before Flop (didn't bet)
Seat 6: torkkdnm folded before Flop (didn't bet)
Seat 7: IRAVABAN folded before Flop (didn't bet)
Seat 8: ama58 folded before Flop (didn't bet)
Seat 9: oscarleon folded before Flop (didn't bet)





PokerStars Hand #153502750951:  Hold'em No Limit ($0.50/$1.00 USD) - 2016/05/18 20:39:59 CET [2016/05/18 14:39:59 ET]
Table 'Kayala' 9-max Seat #8 is the button
Seat 1: deadkiller1 ($107.90 in chips) 
Seat 2: Oelie7 ($167.09 in chips) 
Seat 3: matiko09 ($102 in chips) 
Seat 4: HITYESCA ($101.50 in chips) 
Seat 5: rate8 ($100 in chips) 
Seat 6: lydia12345 ($121.72 in chips) 
Seat 7: nickreason17 ($117.94 in chips) 
Seat 8: cobrik23 ($89.04 in chips) 
Seat 9: Vikulja1993 ($104.48 in chips) 
Vikulja1993: posts small blind $0.50
deadkiller1: posts big blind $1
*** HOLE CARDS ***
Dealt to matiko09 [7c 9d]
Oelie7: folds 
matiko09: folds 
HITYESCA: folds 
rate8: folds 
lydia12345: folds 
nickreason17: folds 
cobrik23: folds 
Vikulja1993: folds 
Uncalled bet ($0.50) returned to deadkiller1
deadkiller1 collected $1 from pot
deadkiller1: doesn't show hand 
*** SUMMARY ***
Total pot $1 | Rake $0 
Seat 1: deadkiller1 (big blind) collected ($1)
Seat 2: Oelie7 folded before Flop (didn't bet)
Seat 3: matiko09 folded before Flop (didn't bet)
Seat 4: HITYESCA folded before Flop (didn't bet)
Seat 5: rate8 folded before Flop (didn't bet)
Seat 6: lydia12345 folded before Flop (didn't bet)
Seat 7: nickreason17 folded before Flop (didn't bet)
Seat 8: cobrik23 (button) folded before Flop (didn't bet)
Seat 9: Vikulja1993 (small blind) folded before Flop





PokerStars Hand #153502758517:  Hold'em No Limit (€0.50/€1.00 EUR) - 2016/05/18 20:40:08 CET [2016/05/18 14:40:08 ET]
Table 'Lamberta IV' 9-max Seat #5 is the button
Seat 1: Trompeneers (€70.48 in chips) 
Seat 2: TimStone (€100 in chips) 
Seat 3: JACQUILF (€100 in chips) 
Seat 4: matiko09 (€109.50 in chips) 
Seat 5: HomerrrJay (€100 in chips) 
Seat 6: Skum1986 (€100 in chips) 
Seat 7: vanilica (€100 in chips) 
Skum1986: posts small blind €0.50
vanilica: posts big blind €1
lydia12345: sits out 
Kihog: sits out 
*** HOLE CARDS ***
Dealt to matiko09 [Qc Kh]
Trompeneers: folds 
TimStone: folds 
JACQUILF: folds 
matiko09: raises €1.50 to €2.50
HomerrrJay: folds 
Skum1986: folds 
vanilica: folds 
Uncalled bet (€1.50) returned to matiko09
matiko09 collected €2.50 from pot
matiko09: doesn't show hand 
*** SUMMARY ***
Total pot €2.50 | Rake €0 
Seat 1: Trompeneers folded before Flop (didn't bet)
Seat 2: TimStone folded before Flop (didn't bet)
Seat 3: JACQUILF folded before Flop (didn't bet)
Seat 4: matiko09 collected (€2.50)
Seat 5: HomerrrJay (button) folded before Flop (didn't bet)
Seat 6: Skum1986 (small blind) folded before Flop
Seat 7: vanilica (big blind) folded before Flop





PokerStars Hand #153502770889:  Hold'em No Limit ($0.50/$1.00 USD) - 2016/05/18 20:40:23 CET [2016/05/18 14:40:23 ET]
Table 'Tatjana III' 9-max Seat #5 is the button
Seat 1: cobrik23 ($177.35 in chips) 
Seat 2: HITYESCA ($128.34 in chips) 
Seat 3: matiko09 ($186.84 in chips) 
Seat 4: lydia12345 ($132.98 in chips) 
Seat 5: deadkiller1 ($114.94 in chips) 
Seat 7: rene1984tsv ($95.43 in chips) 
Seat 8: JACQUILF ($110.30 in chips) 
Seat 9: Moszes360 ($102.62 in chips) 
Kihog will be allowed to play after the button
rene1984tsv: posts small blind $0.50
JACQUILF: posts big blind $1
*** HOLE CARDS ***
Dealt to matiko09 [2h Ts]
Moszes360: folds 
cobrik23: folds 
HITYESCA: raises $2 to $3
matiko09: folds 
lydia12345: folds 
deadkiller1: folds 
rene1984tsv: folds 
JACQUILF: raises $7 to $10
HITYESCA: calls $7
*** FLOP *** [Qd 3c 9h]
JACQUILF: bets $9.74
HITYESCA: calls $9.74
*** TURN *** [Qd 3c 9h] [Th]
JACQUILF: checks 
HITYESCA: checks 
*** RIVER *** [Qd 3c 9h Th] [4h]
JACQUILF: checks 
HITYESCA: bets $25
JACQUILF: folds 
Uncalled bet ($25) returned to HITYESCA
HITYESCA collected $37.98 from pot
HITYESCA: doesn't show hand 
*** SUMMARY ***
Total pot $39.98 | Rake $2 
Board [Qd 3c 9h Th 4h]
Seat 1: cobrik23 folded before Flop (didn't bet)
Seat 2: HITYESCA collected ($37.98)
Seat 3: matiko09 folded before Flop (didn't bet)
Seat 4: lydia12345 folded before Flop (didn't bet)
Seat 5: deadkiller1 (button) folded before Flop (didn't bet)
Seat 7: rene1984tsv (small blind) folded before Flop
Seat 8: JACQUILF (big blind) folded on the River
Seat 9: Moszes360 folded before Flop (didn't bet)





PokerStars Hand #153502772718:  Hold'em No Limit ($0.50/$1.00 USD) - 2016/05/18 20:40:25 CET [2016/05/18 14:40:25 ET]
Table 'Barto' 9-max Seat #7 is the button
Seat 1: IRAVABAN ($43 in chips) 
Seat 3: pokerstereke ($93.43 in chips) 
Seat 4: Kihog ($112.68 in chips) 
Seat 5: matiko09 ($100 in chips) 
Seat 6: vanilica ($100 in chips) 
Seat 7: deadkiller1 ($103.65 in chips) 
Seat 8: rate8 ($100 in chips) 
Seat 9: gongqingss ($57.30 in chips) 
rate8: posts small blind $0.50
gongqingss: posts big blind $1
Moszes360: sits out 
*** HOLE CARDS ***
Dealt to matiko09 [2s 8s]
IRAVABAN: folds 
pokerstereke: folds 
Kihog: folds 
matiko09: folds 
vanilica: folds 
deadkiller1: folds 
rate8: folds 
Uncalled bet ($0.50) returned to gongqingss
gongqingss collected $1 from pot
gongqingss: doesn't show hand 
*** SUMMARY ***
Total pot $1 | Rake $0 
Seat 1: IRAVABAN folded before Flop (didn't bet)
Seat 3: pokerstereke folded before Flop (didn't bet)
Seat 4: Kihog folded before Flop (didn't bet)
Seat 5: matiko09 folded before Flop (didn't bet)
Seat 6: vanilica folded before Flop (didn't bet)
Seat 7: deadkiller1 (button) folded before Flop (didn't bet)
Seat 8: rate8 (small blind) folded before Flop
Seat 9: gongqingss (big blind) collected ($1)





PokerStars Hand #153502773229:  Hold'em No Limit ($0.50/$1.00 USD) - 2016/05/18 20:40:25 CET [2016/05/18 14:40:25 ET]
Table 'Kayala' 9-max Seat #9 is the button
Seat 1: deadkiller1 ($108.40 in chips) 
Seat 2: Oelie7 ($167.09 in chips) 
Seat 3: matiko09 ($102 in chips) 
Seat 4: HITYESCA ($101.50 in chips) 
Seat 5: rate8 ($100 in chips) 
Seat 6: lydia12345 ($121.72 in chips) 
Seat 7: nickreason17 ($117.94 in chips) 
Seat 8: cobrik23 ($89.04 in chips) 
Seat 9: Vikulja1993 ($103.98 in chips) 
deadkiller1: posts small blind $0.50
Oelie7: posts big blind $1
*** HOLE CARDS ***
Dealt to matiko09 [Ac Td]
matiko09: folds 
HITYESCA: folds 
rate8: folds 
lydia12345: folds 
nickreason17: folds 
cobrik23: folds 
Vikulja1993: raises $1 to $2
deadkiller1: folds 
Oelie7: calls $1
*** FLOP *** [9c 3s 3d]
Oelie7: checks 
Vikulja1993: checks 
*** TURN *** [9c 3s 3d] [Qd]
Oelie7: checks 
Vikulja1993: bets $3.50
Oelie7: folds 
Uncalled bet ($3.50) returned to Vikulja1993
Vikulja1993 collected $4.28 from pot
Vikulja1993: doesn't show hand 
*** SUMMARY ***
Total pot $4.50 | Rake $0.22 
Board [9c 3s 3d Qd]
Seat 1: deadkiller1 (small blind) folded before Flop
Seat 2: Oelie7 (big blind) folded on the Turn
Seat 3: matiko09 folded before Flop (didn't bet)
Seat 4: HITYESCA folded before Flop (didn't bet)
Seat 5: rate8 folded before Flop (didn't bet)
Seat 6: lydia12345 folded before Flop (didn't bet)
Seat 7: nickreason17 folded before Flop (didn't bet)
Seat 8: cobrik23 folded before Flop (didn't bet)
Seat 9: Vikulja1993 (button) collected ($4.28)





PokerStars Hand #153502776467:  Hold'em No Limit (€0.50/€1.00 EUR) - 2016/05/18 20:40:29 CET [2016/05/18 14:40:29 ET]
Table 'Lamberta IV' 9-max Seat #6 is the button
Seat 1: Trompeneers (€70.48 in chips) 
Seat 2: TimStone (€100 in chips) 
Seat 3: JACQUILF (€100 in chips) 
Seat 4: matiko09 (€111 in chips) 
Seat 5: HomerrrJay (€100 in chips) 
Seat 6: Skum1986 (€100 in chips) 
Seat 7: vanilica (€100 in chips) 
Seat 8: lydia12345 (€100 in chips) 
vanilica: posts small blind €0.50
lydia12345: posts big blind €1
Kihog: sits out 
*** HOLE CARDS ***
Dealt to matiko09 [7h Ad]
Trompeneers: calls €1
TimStone: raises €3.90 to €4.90
JACQUILF: folds 
matiko09: folds 
HomerrrJay: folds 
Skum1986: folds 
vanilica: folds 
lydia12345: folds 
Trompeneers: raises €7.10 to €12
TimStone: folds 
Uncalled bet (€7.10) returned to Trompeneers
Trompeneers collected €11.30 from pot
*** SUMMARY ***
Total pot €11.30 | Rake €0 
Seat 1: Trompeneers collected (€11.30)
Seat 2: TimStone folded before Flop
Seat 3: JACQUILF folded before Flop (didn't bet)
Seat 4: matiko09 folded before Flop (didn't bet)
Seat 5: HomerrrJay folded before Flop (didn't bet)
Seat 6: Skum1986 (button) folded before Flop (didn't bet)
Seat 7: vanilica (small blind) folded before Flop
Seat 8: lydia12345 (big blind) folded before Flop





PokerStars Hand #153502778991:  Hold'em No Limit ($0.50/$1.00 USD) - 2016/05/18 20:40:32 CET [2016/05/18 14:40:32 ET]
Table 'Abetti II' 9-max Seat #6 is the button
Seat 1: matiko09 ($100 in chips) 
Seat 2: Vikulja1993 ($100 in chips) 
Seat 3: cobrik23 ($128.78 in chips) 
Seat 4: ipashutapkom ($44 in chips) 
Seat 5: blufthenuts ($126.02 in chips) 
Seat 6: I The King I ($159.41 in chips) 
Seat 8: roadster683 ($165.70 in chips) 
rate8 will be allowed to play after the button
roadster683: posts small blind $0.50
lydia12345: is sitting out 
matiko09: posts big blind $1
*** HOLE CARDS ***
Dealt to matiko09 [3c 4c]
Vikulja1993: folds 
cobrik23: folds 
ipashutapkom: folds 
blufthenuts: raises $2 to $3
I The King I: folds 
roadster683: calls $2.50
matiko09: folds 
*** FLOP *** [9d Th 4h]
roadster683: checks 
blufthenuts: bets $3.32
roadster683: calls $3.32
*** TURN *** [9d Th 4h] [4d]
roadster683: checks 
blufthenuts: checks 
*** RIVER *** [9d Th 4h 4d] [Kd]
roadster683: checks 
blufthenuts: bets $10
roadster683: calls $10
*** SHOW DOWN ***
blufthenuts: shows [8h Qh] (a pair of Fours)
roadster683: shows [Tc Jd] (two pair, Tens and Fours)
roadster683 collected $31.96 from pot
*** SUMMARY ***
Total pot $33.64 | Rake $1.68 
Board [9d Th 4h 4d Kd]
Seat 1: matiko09 (big blind) folded before Flop
Seat 2: Vikulja1993 folded before Flop (didn't bet)
Seat 3: cobrik23 folded before Flop (didn't bet)
Seat 4: ipashutapkom folded before Flop (didn't bet)
Seat 5: blufthenuts showed [8h Qh] and lost with a pair of Fours
Seat 6: I The King I (button) folded before Flop (didn't bet)
Seat 8: roadster683 (small blind) showed [Tc Jd] and won ($31.96) with two pair, Tens and Fours





PokerStars Hand #153502783618:  Hold'em No Limit ($0.50/$1.00 USD) - 2016/05/18 20:40:37 CET [2016/05/18 14:40:37 ET]
Table 'Suevia' 9-max Seat #3 is the button
Seat 1: Moszes360 ($100 in chips) 
Seat 2: deadkiller1 ($109.85 in chips) 
Seat 3: matiko09 ($103.50 in chips) 
Seat 4: HITYESCA ($100 in chips) 
Seat 5: bello1310 ($107.53 in chips) 
Seat 6: torkkdnm ($127.16 in chips) 
Seat 7: IRAVABAN ($40 in chips) 
Seat 8: ama58 ($50.58 in chips) 
Seat 9: oscarleon ($134.87 in chips) 
HITYESCA: posts small blind $0.50
bello1310: posts big blind $1
*** HOLE CARDS ***
Dealt to matiko09 [Ts 9d]
torkkdnm: folds 
IRAVABAN: folds 
ama58: folds 
oscarleon: folds 
Moszes360: raises $2 to $3
deadkiller1: raises $6 to $9
matiko09: folds 
HITYESCA: folds 
bello1310: folds 
Moszes360: folds 
Uncalled bet ($6) returned to deadkiller1
deadkiller1 collected $7.50 from pot
deadkiller1: doesn't show hand 
*** SUMMARY ***
Total pot $7.50 | Rake $0 
Seat 1: Moszes360 folded before Flop
Seat 2: deadkiller1 collected ($7.50)
Seat 3: matiko09 (button) folded before Flop (didn't bet)
Seat 4: HITYESCA (small blind) folded before Flop
Seat 5: bello1310 (big blind) folded before Flop
Seat 6: torkkdnm folded before Flop (didn't bet)
Seat 7: IRAVABAN folded before Flop (didn't bet)
Seat 8: ama58 folded before Flop (didn't bet)
Seat 9: oscarleon folded before Flop (didn't bet)





PokerStars Hand #153502787360:  Hold'em No Limit (€0.50/€1.00 EUR) - 2016/05/18 20:40:41 CET [2016/05/18 14:40:41 ET]
Table 'Pallas II' 9-max Seat #7 is the button
Seat 1: deadkiller1 (€107 in chips) 
Seat 2: matiko09 (€203.99 in chips) 
Seat 3: Vikulja1993 (€111 in chips) 
Seat 4: torkkdnm (€145.21 in chips) 
Seat 5: cobrik23 (€71.86 in chips) 
Seat 6: HITYESCA (€103.62 in chips) 
Seat 7: rate8 (€100.88 in chips) 
Seat 8: Kihog (€100 in chips) 
Seat 9: stijner1986 (€141.48 in chips) 
Kihog: posts small blind €0.50
stijner1986: posts big blind €1
*** HOLE CARDS ***
Dealt to matiko09 [Jc Jd]
deadkiller1: folds 
matiko09: raises €2 to €3
Vikulja1993: raises €6 to €9
torkkdnm: folds 
cobrik23: folds 
HITYESCA: folds 
rate8: folds 
Kihog: folds 
stijner1986: folds 
matiko09: calls €6
*** FLOP *** [Qs 6s 5d]
matiko09: checks 
Vikulja1993: bets €10
matiko09: calls €10
*** TURN *** [Qs 6s 5d] [2c]
matiko09: checks 
Vikulja1993: bets €24
matiko09: folds 
Uncalled bet (€24) returned to Vikulja1993
Vikulja1993 collected €37.52 from pot
Vikulja1993: doesn't show hand 
*** SUMMARY ***
Total pot €39.50 | Rake €1.98 
Board [Qs 6s 5d 2c]
Seat 1: deadkiller1 folded before Flop (didn't bet)
Seat 2: matiko09 folded on the Turn
Seat 3: Vikulja1993 collected (€37.52)
Seat 4: torkkdnm folded before Flop (didn't bet)
Seat 5: cobrik23 folded before Flop (didn't bet)
Seat 6: HITYESCA folded before Flop (didn't bet)
Seat 7: rate8 (button) folded before Flop (didn't bet)
Seat 8: Kihog (small blind) folded before Flop
Seat 9: stijner1986 (big blind) folded before Flop





PokerStars Hand #153502793235:  Hold'em No Limit ($0.50/$1.00 USD) - 2016/05/18 20:40:48 CET [2016/05/18 14:40:48 ET]
Table 'Pandora' 9-max Seat #6 is the button
Seat 1: deadkiller1 ($143.41 in chips) 
Seat 2: fack_vi ($75.87 in chips) 
Seat 3: TimStone ($100 in chips) 
Seat 4: mooose100 ($101.47 in chips) 
Seat 5: nickreason17 ($100 in chips) 
Seat 6: Moszes360 ($100 in chips) 
Seat 7: lydia12345 ($104.82 in chips) 
Seat 8: matiko09 ($118.02 in chips) 
Seat 9: oscarleon ($113.98 in chips) 
lydia12345: posts small blind $0.50
matiko09: posts big blind $1
*** HOLE CARDS ***
Dealt to matiko09 [8c 9d]
oscarleon: raises $2 to $3
deadkiller1: folds 
fack_vi: folds 
TimStone: folds 
mooose100: folds 
nickreason17: folds 
Moszes360: folds 
lydia12345: folds 
matiko09: folds 
Uncalled bet ($2) returned to oscarleon
oscarleon collected $2.50 from pot
oscarleon: doesn't show hand 
*** SUMMARY ***
Total pot $2.50 | Rake $0 
Seat 1: deadkiller1 folded before Flop (didn't bet)
Seat 2: fack_vi folded before Flop (didn't bet)
Seat 3: TimStone folded before Flop (didn't bet)
Seat 4: mooose100 folded before Flop (didn't bet)
Seat 5: nickreason17 folded before Flop (didn't bet)
Seat 6: Moszes360 (button) folded before Flop (didn't bet)
Seat 7: lydia12345 (small blind) folded before Flop
Seat 8: matiko09 (big blind) folded before Flop
Seat 9: oscarleon collected ($2.50)





PokerStars Hand #153502806487:  Hold'em No Limit ($0.50/$1.00 USD) - 2016/05/18 20:41:03 CET [2016/05/18 14:41:03 ET]
Table 'Barto' 9-max Seat #8 is the button
Seat 1: IRAVABAN ($43 in chips) 
Seat 3: pokerstereke ($93.43 in chips) 
Seat 4: Kihog ($112.68 in chips) 
Seat 5: matiko09 ($100 in chips) 
Seat 6: vanilica ($100 in chips) 
Seat 7: deadkiller1 ($103.65 in chips) 
Seat 8: rate8 ($100 in chips) 
Seat 9: gongqingss ($57.80 in chips) 
gongqingss: posts small blind $0.50
IRAVABAN: posts big blind $1
Moszes360: sits out 
*** HOLE CARDS ***
Dealt to matiko09 [7h 5h]
pokerstereke: folds 
Kihog: folds 
matiko09: folds 
vanilica: folds 
deadkiller1: folds 
rate8: raises $1 to $2
gongqingss: folds 
IRAVABAN: folds 
Uncalled bet ($1) returned to rate8
rate8 collected $2.50 from pot
rate8: doesn't show hand 
*** SUMMARY ***
Total pot $2.50 | Rake $0 
Seat 1: IRAVABAN (big blind) folded before Flop
Seat 3: pokerstereke folded before Flop (didn't bet)
Seat 4: Kihog folded before Flop (didn't bet)
Seat 5: matiko09 folded before Flop (didn't bet)
Seat 6: vanilica folded before Flop (didn't bet)
Seat 7: deadkiller1 folded before Flop (didn't bet)
Seat 8: rate8 (button) collected ($2.50)
Seat 9: gongqingss (small blind) folded before Flop





PokerStars Hand #153502810647:  Hold'em No Limit ($0.50/$1.00 USD) - 2016/05/18 20:41:08 CET [2016/05/18 14:41:08 ET]
Table 'Abetti II' 9-max Seat #8 is the button
Seat 1: matiko09 ($100 in chips) 
Seat 2: Vikulja1993 ($100 in chips) 
Seat 3: cobrik23 ($128.78 in chips) 
Seat 4: ipashutapkom ($44 in chips) 
Seat 5: blufthenuts ($109.70 in chips) 
Seat 6: I The King I ($159.41 in chips) 
Seat 8: roadster683 ($181.34 in chips) 
lydia12345 will be allowed to play after the button
matiko09: posts small blind $0.50
Vikulja1993: posts big blind $1
rate8: sits out 
*** HOLE CARDS ***
Dealt to matiko09 [6d 5c]
cobrik23: folds 
ipashutapkom: folds 
blufthenuts: folds 
I The King I: folds 
roadster683: raises $1 to $2
matiko09: folds 
Vikulja1993: folds 
Uncalled bet ($1) returned to roadster683
roadster683 collected $2.50 from pot
roadster683: doesn't show hand 
*** SUMMARY ***
Total pot $2.50 | Rake $0 
Seat 1: matiko09 (small blind) folded before Flop
Seat 2: Vikulja1993 (big blind) folded before Flop
Seat 3: cobrik23 folded before Flop (didn't bet)
Seat 4: ipashutapkom folded before Flop (didn't bet)
Seat 5: blufthenuts folded before Flop (didn't bet)
Seat 6: I The King I folded before Flop (didn't bet)
Seat 8: roadster683 (button) collected ($2.50)





PokerStars Hand #153502824550:  Hold'em No Limit ($0.50/$1.00 USD) - 2016/05/18 20:41:24 CET [2016/05/18 14:41:24 ET]
Table 'Suevia' 9-max Seat #4 is the button
Seat 1: Moszes360 ($100 in chips) 
Seat 2: deadkiller1 ($114.35 in chips) 
Seat 3: matiko09 ($103.50 in chips) 
Seat 4: HITYESCA ($100 in chips) 
Seat 5: bello1310 ($106.53 in chips) 
Seat 6: torkkdnm ($127.16 in chips) 
Seat 7: IRAVABAN ($40 in chips) 
Seat 8: ama58 ($50.58 in chips) 
Seat 9: oscarleon ($134.87 in chips) 
bello1310: posts small blind $0.50
torkkdnm: posts big blind $1
*** HOLE CARDS ***
Dealt to matiko09 [4c 4d]
IRAVABAN: folds 
ama58: folds 
oscarleon: folds 
Moszes360: folds 
deadkiller1: folds 
matiko09: raises $1.50 to $2.50
HITYESCA: folds 
bello1310: folds 
torkkdnm: calls $1.50
*** FLOP *** [8c Kd 5d]
torkkdnm: checks 
matiko09: checks 
*** TURN *** [8c Kd 5d] [8h]
torkkdnm: checks 
matiko09: checks 
*** RIVER *** [8c Kd 5d 8h] [6h]
torkkdnm: checks 
matiko09: checks 
*** SHOW DOWN ***
torkkdnm: shows [9d Ts] (a pair of Eights)
matiko09: shows [4c 4d] (two pair, Eights and Fours)
matiko09 collected $5.22 from pot
*** SUMMARY ***
Total pot $5.50 | Rake $0.28 
Board [8c Kd 5d 8h 6h]
Seat 1: Moszes360 folded before Flop (didn't bet)
Seat 2: deadkiller1 folded before Flop (didn't bet)
Seat 3: matiko09 showed [4c 4d] and won ($5.22) with two pair, Eights and Fours
Seat 4: HITYESCA (button) folded before Flop (didn't bet)
Seat 5: bello1310 (small blind) folded before Flop
Seat 6: torkkdnm (big blind) showed [9d Ts] and lost with a pair of Eights
Seat 7: IRAVABAN folded before Flop (didn't bet)
Seat 8: ama58 folded before Flop (didn't bet)
Seat 9: oscarleon folded before Flop (didn't bet)





PokerStars Hand #153502824589:  Hold'em No Limit ($0.50/$1.00 USD) - 2016/05/18 20:41:24 CET [2016/05/18 14:41:24 ET]
Table 'Kayala' 9-max Seat #1 is the button
Seat 1: deadkiller1 ($107.90 in chips) 
Seat 2: Oelie7 ($165.09 in chips) 
Seat 3: matiko09 ($102 in chips) 
Seat 4: HITYESCA ($101.50 in chips) 
Seat 5: rate8 ($100 in chips) 
Seat 6: lydia12345 ($121.72 in chips) 
Seat 7: nickreason17 ($117.94 in chips) 
Seat 8: cobrik23 ($89.04 in chips) 
Seat 9: Vikulja1993 ($106.26 in chips) 
Oelie7: posts small blind $0.50
matiko09: posts big blind $1
*** HOLE CARDS ***
Dealt to matiko09 [4s 8d]
HITYESCA: folds 
rate8: folds 
lydia12345: raises $2 to $3
nickreason17: folds 
cobrik23: folds 
Vikulja1993: folds 
deadkiller1: folds 
Oelie7: folds 
matiko09: folds 
Uncalled bet ($2) returned to lydia12345
lydia12345 collected $2.50 from pot
*** SUMMARY ***
Total pot $2.50 | Rake $0 
Seat 1: deadkiller1 (button) folded before Flop (didn't bet)
Seat 2: Oelie7 (small blind) folded before Flop
Seat 3: matiko09 (big blind) folded before Flop
Seat 4: HITYESCA folded before Flop (didn't bet)
Seat 5: rate8 folded before Flop (didn't bet)
Seat 6: lydia12345 collected ($2.50)
Seat 7: nickreason17 folded before Flop (didn't bet)
Seat 8: cobrik23 folded before Flop (didn't bet)
Seat 9: Vikulja1993 folded before Flop (didn't bet)





PokerStars Hand #153502833722:  Hold'em No Limit ($0.50/$1.00 USD) - 2016/05/18 20:41:35 CET [2016/05/18 14:41:35 ET]
Table 'Abetti II' 9-max Seat #1 is the button
Seat 1: matiko09 ($100 in chips) 
Seat 2: Vikulja1993 ($100 in chips) 
Seat 3: cobrik23 ($128.78 in chips) 
Seat 4: ipashutapkom ($44 in chips) 
Seat 5: blufthenuts ($109.70 in chips) 
Seat 6: I The King I ($159.41 in chips) 
Seat 8: roadster683 ($182.84 in chips) 
Vikulja1993: posts small blind $0.50
cobrik23: posts big blind $1
rate8: sits out 
lydia12345: sits out 
*** HOLE CARDS ***
Dealt to matiko09 [3c 2s]
ipashutapkom: folds 
blufthenuts: folds 
I The King I: folds 
roadster683: calls $1
matiko09: folds 
Vikulja1993: folds 
cobrik23: checks 
*** FLOP *** [Kc 2d 7s]
cobrik23: checks 
roadster683: bets $2
cobrik23: calls $2
*** TURN *** [Kc 2d 7s] [3h]
cobrik23: checks 
roadster683: checks 
*** RIVER *** [Kc 2d 7s 3h] [9c]
cobrik23: checks 
roadster683: checks 
*** SHOW DOWN ***
cobrik23: shows [Kd 4h] (a pair of Kings)
roadster683: mucks hand 
cobrik23 collected $6.18 from pot
*** SUMMARY ***
Total pot $6.50 | Rake $0.32 
Board [Kc 2d 7s 3h 9c]
Seat 1: matiko09 (button) folded before Flop (didn't bet)
Seat 2: Vikulja1993 (small blind) folded before Flop
Seat 3: cobrik23 (big blind) showed [Kd 4h] and won ($6.18) with a pair of Kings
Seat 4: ipashutapkom folded before Flop (didn't bet)
Seat 5: blufthenuts folded before Flop (didn't bet)
Seat 6: I The King I folded before Flop (didn't bet)
Seat 8: roadster683 mucked [9s Qs]





PokerStars Hand #153502834614:  Hold'em No Limit ($0.50/$1.00 USD) - 2016/05/18 20:41:36 CET [2016/05/18 14:41:36 ET]
Table 'Pandora' 9-max Seat #7 is the button
Seat 1: deadkiller1 ($143.41 in chips) 
Seat 2: fack_vi ($75.87 in chips) 
Seat 3: TimStone ($100 in chips) 
Seat 4: mooose100 ($101.47 in chips) 
Seat 5: nickreason17 ($100 in chips) 
Seat 6: Moszes360 ($100 in chips) 
Seat 7: lydia12345 ($104.32 in chips) 
Seat 8: matiko09 ($117.02 in chips) 
Seat 9: oscarleon ($115.48 in chips) 
matiko09: posts small blind $0.50
oscarleon: posts big blind $1
*** HOLE CARDS ***
Dealt to matiko09 [3d Jd]
deadkiller1: folds 
fack_vi: folds 
TimStone: folds 
mooose100: calls $1
nickreason17: raises $3 to $4
Moszes360: folds 
lydia12345: folds 
matiko09: folds 
oscarleon: folds 
mooose100: calls $3
*** FLOP *** [Qs Qd 7h]
mooose100: checks 
nickreason17: bets $3.60
mooose100: folds 
Uncalled bet ($3.60) returned to nickreason17
nickreason17 collected $9.02 from pot
*** SUMMARY ***
Total pot $9.50 | Rake $0.48 
Board [Qs Qd 7h]
Seat 1: deadkiller1 folded before Flop (didn't bet)
Seat 2: fack_vi folded before Flop (didn't bet)
Seat 3: TimStone folded before Flop (didn't bet)
Seat 4: mooose100 folded on the Flop
Seat 5: nickreason17 collected ($9.02)
Seat 6: Moszes360 folded before Flop (didn't bet)
Seat 7: lydia12345 (button) folded before Flop (didn't bet)
Seat 8: matiko09 (small blind) folded before Flop
Seat 9: oscarleon (big blind) folded before Flop





PokerStars Hand #153502836529:  Hold'em No Limit (€0.50/€1.00 EUR) - 2016/05/18 20:41:38 CET [2016/05/18 14:41:38 ET]
Table 'Lamberta IV' 9-max Seat #7 is the button
Seat 1: Trompeneers (€76.88 in chips) 
Seat 2: TimStone (€100 in chips) 
Seat 3: JACQUILF (€100 in chips) 
Seat 4: matiko09 (€111 in chips) 
Seat 5: HomerrrJay (€100 in chips) 
Seat 6: Skum1986 (€100 in chips) 
Seat 7: vanilica (€100 in chips) 
Seat 8: lydia12345 (€100 in chips) 
Seat 9: Kihog (€100 in chips) 
lydia12345: posts small blind €0.50
Kihog: posts big blind €1
*** HOLE CARDS ***
Dealt to matiko09 [Kc Ac]
Trompeneers: calls €1
TimStone: folds 
JACQUILF: folds 
matiko09: raises €3 to €4
HomerrrJay: folds 
Skum1986: folds 
vanilica: folds 
lydia12345: folds 
Kihog: folds 
Trompeneers: calls €3
*** FLOP *** [Jd Qc Js]
Trompeneers: bets €3
matiko09: calls €3
*** TURN *** [Jd Qc Js] [Kh]
Trompeneers: bets €4
matiko09: calls €4
*** RIVER *** [Jd Qc Js Kh] [2s]
Trompeneers: checks 
matiko09: bets €6.91
Trompeneers: folds 
Uncalled bet (€6.91) returned to matiko09
matiko09 collected €22.32 from pot
matiko09: doesn't show hand 
*** SUMMARY ***
Total pot €23.50 | Rake €1.18 
Board [Jd Qc Js Kh 2s]
Seat 1: Trompeneers folded on the River
Seat 2: TimStone folded before Flop (didn't bet)
Seat 3: JACQUILF folded before Flop (didn't bet)
Seat 4: matiko09 collected (€22.32)
Seat 5: HomerrrJay folded before Flop (didn't bet)
Seat 6: Skum1986 folded before Flop (didn't bet)
Seat 7: vanilica (button) folded before Flop (didn't bet)
Seat 8: lydia12345 (small blind) folded before Flop
Seat 9: Kihog (big blind) folded before Flop





PokerStars Hand #153502847227:  Hold'em No Limit (€0.50/€1.00 EUR) - 2016/05/18 20:41:50 CET [2016/05/18 14:41:50 ET]
Table 'Pallas II' 9-max Seat #8 is the button
Seat 1: deadkiller1 (€107 in chips) 
Seat 2: matiko09 (€184.99 in chips) 
Seat 3: Vikulja1993 (€129.52 in chips) 
Seat 4: torkkdnm (€145.21 in chips) 
Seat 5: cobrik23 (€71.86 in chips) 
Seat 6: HITYESCA (€103.62 in chips) 
Seat 7: rate8 (€100.88 in chips) 
Seat 8: Kihog (€100 in chips) 
Seat 9: stijner1986 (€140.48 in chips) 
stijner1986: posts small blind €0.50
deadkiller1: posts big blind €1
*** HOLE CARDS ***
Dealt to matiko09 [4d 6d]
matiko09: folds 
Vikulja1993: folds 
torkkdnm: raises €2 to €3
cobrik23: folds 
HITYESCA: folds 
rate8: raises €6 to €9
Kihog: folds 
stijner1986: folds 
deadkiller1: folds 
torkkdnm: folds 
Uncalled bet (€6) returned to rate8
rate8 collected €7.50 from pot
rate8: doesn't show hand 
*** SUMMARY ***
Total pot €7.50 | Rake €0 
Seat 1: deadkiller1 (big blind) folded before Flop
Seat 2: matiko09 folded before Flop (didn't bet)
Seat 3: Vikulja1993 folded before Flop (didn't bet)
Seat 4: torkkdnm folded before Flop
Seat 5: cobrik23 folded before Flop (didn't bet)
Seat 6: HITYESCA folded before Flop (didn't bet)
Seat 7: rate8 collected (€7.50)
Seat 8: Kihog (button) folded before Flop (didn't bet)
Seat 9: stijner1986 (small blind) folded before Flop





PokerStars Hand #153502847734:  Hold'em No Limit ($0.50/$1.00 USD) - 2016/05/18 20:41:50 CET [2016/05/18 14:41:50 ET]
Table 'Barto' 9-max Seat #9 is the button
Seat 1: IRAVABAN ($42 in chips) 
Seat 2: Moszes360 ($100 in chips) 
Seat 3: pokerstereke ($93.43 in chips) 
Seat 4: Kihog ($112.68 in chips) 
Seat 5: matiko09 ($100 in chips) 
Seat 6: vanilica ($100 in chips) 
Seat 7: deadkiller1 ($103.65 in chips) 
Seat 8: rate8 ($101.50 in chips) 
Seat 9: gongqingss ($57.30 in chips) 
IRAVABAN: posts small blind $0.50
Moszes360: posts big blind $1
*** HOLE CARDS ***
Dealt to matiko09 [2c 5d]
pokerstereke: folds 
Kihog: folds 
matiko09: folds 
vanilica: folds 
deadkiller1: raises $2 to $3
rate8: folds 
gongqingss: folds 
IRAVABAN: folds 
Moszes360: folds 
Uncalled bet ($2) returned to deadkiller1
deadkiller1 collected $2.50 from pot
deadkiller1: doesn't show hand 
*** SUMMARY ***
Total pot $2.50 | Rake $0 
Seat 1: IRAVABAN (small blind) folded before Flop
Seat 2: Moszes360 (big blind) folded before Flop
Seat 3: pokerstereke folded before Flop (didn't bet)
Seat 4: Kihog folded before Flop (didn't bet)
Seat 5: matiko09 folded before Flop (didn't bet)
Seat 6: vanilica folded before Flop (didn't bet)
Seat 7: deadkiller1 collected ($2.50)
Seat 8: rate8 folded before Flop (didn't bet)
Seat 9: gongqingss (button) folded before Flop (didn't bet)





PokerStars Hand #153502851780:  Hold'em No Limit ($0.50/$1.00 USD) - 2016/05/18 20:41:55 CET [2016/05/18 14:41:55 ET]
Table 'Kayala' 9-max Seat #2 is the button
Seat 1: deadkiller1 ($107.90 in chips) 
Seat 2: Oelie7 ($164.59 in chips) 
Seat 3: matiko09 ($101 in chips) 
Seat 4: HITYESCA ($101.50 in chips) 
Seat 5: rate8 ($100 in chips) 
Seat 6: lydia12345 ($123.22 in chips) 
Seat 7: nickreason17 ($117.94 in chips) 
Seat 8: cobrik23 ($89.04 in chips) 
Seat 9: Vikulja1993 ($106.26 in chips) 
matiko09: posts small blind $0.50
HITYESCA: posts big blind $1
*** HOLE CARDS ***
Dealt to matiko09 [6s 7c]
rate8: raises $2 to $3
lydia12345: folds 
nickreason17: folds 
cobrik23: folds 
Vikulja1993: folds 
deadkiller1: folds 
Oelie7: calls $3
matiko09: folds 
HITYESCA: folds 
*** FLOP *** [2s 6c Ts]
rate8: bets $5.06
Oelie7: folds 
Uncalled bet ($5.06) returned to rate8
rate8 collected $7.12 from pot
rate8: doesn't show hand 
*** SUMMARY ***
Total pot $7.50 | Rake $0.38 
Board [2s 6c Ts]
Seat 1: deadkiller1 folded before Flop (didn't bet)
Seat 2: Oelie7 (button) folded on the Flop
Seat 3: matiko09 (small blind) folded before Flop
Seat 4: HITYESCA (big blind) folded before Flop
Seat 5: rate8 collected ($7.12)
Seat 6: lydia12345 folded before Flop (didn't bet)
Seat 7: nickreason17 folded before Flop (didn't bet)
Seat 8: cobrik23 folded before Flop (didn't bet)
Seat 9: Vikulja1993 folded before Flop (didn't bet)





PokerStars Hand #153502869060:  Hold'em No Limit ($0.50/$1.00 USD) - 2016/05/18 20:42:15 CET [2016/05/18 14:42:15 ET]
Table 'Tatjana III' 9-max Seat #7 is the button
Seat 1: cobrik23 ($177.35 in chips) 
Seat 2: HITYESCA ($146.58 in chips) 
Seat 3: matiko09 ($186.84 in chips) 
Seat 4: lydia12345 ($132.98 in chips) 
Seat 5: deadkiller1 ($114.94 in chips) 
Seat 7: rene1984tsv ($94.93 in chips) 
Seat 8: JACQUILF ($100 in chips) 
Seat 9: Moszes360 ($102.62 in chips) 
JACQUILF: posts small blind $0.50
Moszes360: posts big blind $1
Kihog: sits out 
*** HOLE CARDS ***
Dealt to matiko09 [3d Js]
cobrik23: folds 
HITYESCA: raises $2 to $3
matiko09: folds 
lydia12345: folds 
deadkiller1: folds 
rene1984tsv: calls $3
JACQUILF: calls $2.50
Moszes360: folds 
*** FLOP *** [Kh 8d Ts]
JACQUILF: checks 
HITYESCA: bets $6
rene1984tsv: folds 
JACQUILF: folds 
Uncalled bet ($6) returned to HITYESCA
HITYESCA collected $9.50 from pot
HITYESCA: doesn't show hand 
*** SUMMARY ***
Total pot $10 | Rake $0.50 
Board [Kh 8d Ts]
Seat 1: cobrik23 folded before Flop (didn't bet)
Seat 2: HITYESCA collected ($9.50)
Seat 3: matiko09 folded before Flop (didn't bet)
Seat 4: lydia12345 folded before Flop (didn't bet)
Seat 5: deadkiller1 folded before Flop (didn't bet)
Seat 7: rene1984tsv (button) folded on the Flop
Seat 8: JACQUILF (small blind) folded on the Flop
Seat 9: Moszes360 (big blind) folded before Flop





PokerStars Hand #153502877100:  Hold'em No Limit ($0.50/$1.00 USD) - 2016/05/18 20:42:24 CET [2016/05/18 14:42:24 ET]
Table 'Barto' 9-max Seat #1 is the button
Seat 1: IRAVABAN ($41.50 in chips) 
Seat 2: Moszes360 ($100 in chips) 
Seat 3: pokerstereke ($93.43 in chips) 
Seat 4: Kihog ($112.68 in chips) 
Seat 5: matiko09 ($100 in chips) 
Seat 6: vanilica ($100 in chips) 
Seat 7: deadkiller1 ($105.15 in chips) 
Seat 8: rate8 ($101.50 in chips) 
Seat 9: gongqingss ($57.30 in chips) 
Moszes360: posts small blind $0.50
pokerstereke: posts big blind $1
*** HOLE CARDS ***
Dealt to matiko09 [Kh 4c]
Kihog: folds 
matiko09: folds 
vanilica: folds 
deadkiller1: folds 
rate8: raises $2 to $3
gongqingss: folds 
IRAVABAN: folds 
Moszes360: folds 
pokerstereke: folds 
Uncalled bet ($2) returned to rate8
rate8 collected $2.50 from pot
rate8: doesn't show hand 
*** SUMMARY ***
Total pot $2.50 | Rake $0 
Seat 1: IRAVABAN (button) folded before Flop (didn't bet)
Seat 2: Moszes360 (small blind) folded before Flop
Seat 3: pokerstereke (big blind) folded before Flop
Seat 4: Kihog folded before Flop (didn't bet)
Seat 5: matiko09 folded before Flop (didn't bet)
Seat 6: vanilica folded before Flop (didn't bet)
Seat 7: deadkiller1 folded before Flop (didn't bet)
Seat 8: rate8 collected ($2.50)
Seat 9: gongqingss folded before Flop (didn't bet)





PokerStars Hand #153502878040:  Hold'em No Limit ($0.50/$1.00 USD) - 2016/05/18 20:42:25 CET [2016/05/18 14:42:25 ET]
Table 'Pandora' 9-max Seat #8 is the button
Seat 1: deadkiller1 ($143.41 in chips) 
Seat 2: fack_vi ($75.87 in chips) 
Seat 3: TimStone ($100 in chips) 
Seat 4: mooose100 ($97.47 in chips) 
Seat 5: nickreason17 ($105.02 in chips) 
Seat 6: Moszes360 ($100 in chips) 
Seat 7: lydia12345 ($104.32 in chips) 
Seat 8: matiko09 ($116.52 in chips) 
Seat 9: oscarleon ($114.48 in chips) 
oscarleon: posts small blind $0.50
deadkiller1: posts big blind $1
*** HOLE CARDS ***
Dealt to matiko09 [Jd 8d]
fack_vi: raises $2 to $3
TimStone: folds 
mooose100: calls $3
nickreason17: folds 
Moszes360: calls $3
lydia12345: folds 
matiko09: folds 
oscarleon: calls $2.50
deadkiller1: folds 
*** FLOP *** [8s Ks 3c]
oscarleon: checks 
fack_vi: checks 
mooose100: checks 
Moszes360: checks 
*** TURN *** [8s Ks 3c] [Ad]
oscarleon: checks 
fack_vi: bets $2.70
mooose100: raises $8.87 to $11.57
Moszes360: folds 
oscarleon: folds 
fack_vi: calls $8.87
*** RIVER *** [8s Ks 3c Ad] [9d]
fack_vi: checks 
mooose100: bets $34.33
fack_vi: calls $34.33
*** SHOW DOWN ***
mooose100: shows [Kc Kh] (three of a kind, Kings)
fack_vi: mucks hand 
mooose100 collected $102.30 from pot
*** SUMMARY ***
Total pot $104.80 | Rake $2.50 
Board [8s Ks 3c Ad 9d]
Seat 1: deadkiller1 (big blind) folded before Flop
Seat 2: fack_vi mucked [Ac Qd]
Seat 3: TimStone folded before Flop (didn't bet)
Seat 4: mooose100 showed [Kc Kh] and won ($102.30) with three of a kind, Kings
Seat 5: nickreason17 folded before Flop (didn't bet)
Seat 6: Moszes360 folded on the Turn
Seat 7: lydia12345 folded before Flop (didn't bet)
Seat 8: matiko09 (button) folded before Flop (didn't bet)
Seat 9: oscarleon (small blind) folded on the Turn





PokerStars Hand #153502886326:  Hold'em No Limit ($0.50/$1.00 USD) - 2016/05/18 20:42:35 CET [2016/05/18 14:42:35 ET]
Table 'Kayala' 9-max Seat #3 is the button
Seat 1: deadkiller1 ($107.90 in chips) 
Seat 2: Oelie7 ($161.59 in chips) 
Seat 3: matiko09 ($100.50 in chips) 
Seat 4: HITYESCA ($100.50 in chips) 
Seat 5: rate8 ($104.12 in chips) 
Seat 6: lydia12345 ($123.22 in chips) 
Seat 7: nickreason17 ($117.94 in chips) 
Seat 8: cobrik23 ($89.04 in chips) 
Seat 9: Vikulja1993 ($106.26 in chips) 
HITYESCA: posts small blind $0.50
rate8: posts big blind $1
*** HOLE CARDS ***
Dealt to matiko09 [5s 5c]
lydia12345: folds 
nickreason17: raises $1.50 to $2.50
cobrik23: calls $2.50
Vikulja1993: calls $2.50
deadkiller1: calls $2.50
Oelie7: raises $1.50 to $4
matiko09: calls $4
HITYESCA: folds 
rate8: folds 
nickreason17: calls $1.50
cobrik23: calls $1.50
Vikulja1993: calls $1.50
deadkiller1: calls $1.50
*** FLOP *** [Ks Qc Kc]
nickreason17: checks 
cobrik23: checks 
Vikulja1993: checks 
deadkiller1: checks 
Oelie7: checks 
matiko09: checks 
*** TURN *** [Ks Qc Kc] [Td]
nickreason17: bets $1
cobrik23: folds 
Vikulja1993: folds 
deadkiller1: folds 
Oelie7: calls $1
matiko09: folds 
*** RIVER *** [Ks Qc Kc Td] [2s]
nickreason17: bets $1
Oelie7: raises $14.06 to $15.06
nickreason17: folds 
Uncalled bet ($14.06) returned to Oelie7
Oelie7 collected $28.02 from pot
Oelie7: doesn't show hand 
*** SUMMARY ***
Total pot $29.50 | Rake $1.48 
Board [Ks Qc Kc Td 2s]
Seat 1: deadkiller1 folded on the Turn
Seat 2: Oelie7 collected ($28.02)
Seat 3: matiko09 (button) folded on the Turn
Seat 4: HITYESCA (small blind) folded before Flop
Seat 5: rate8 (big blind) folded before Flop
Seat 6: lydia12345 folded before Flop (didn't bet)
Seat 7: nickreason17 folded on the River
Seat 8: cobrik23 folded on the Turn
Seat 9: Vikulja1993 folded on the Turn





PokerStars Hand #153502896483:  Hold'em No Limit ($0.50/$1.00 USD) - 2016/05/18 20:42:46 CET [2016/05/18 14:42:46 ET]
Table 'Suevia' 9-max Seat #5 is the button
Seat 1: Moszes360 ($100 in chips) 
Seat 2: deadkiller1 ($114.35 in chips) 
Seat 3: matiko09 ($106.22 in chips) 
Seat 4: HITYESCA ($100 in chips) 
Seat 5: bello1310 ($106.03 in chips) 
Seat 6: torkkdnm ($124.66 in chips) 
Seat 7: IRAVABAN ($40 in chips) 
Seat 8: ama58 ($50.58 in chips) 
Seat 9: oscarleon ($134.87 in chips) 
torkkdnm: posts small blind $0.50
IRAVABAN: posts big blind $1
*** HOLE CARDS ***
Dealt to matiko09 [2c 9d]
ama58: folds 
oscarleon: folds 
Moszes360: folds 
deadkiller1: folds 
matiko09: folds 
HITYESCA: folds 
bello1310: raises $1 to $2
torkkdnm: folds 
IRAVABAN: calls $1
*** FLOP *** [Jh Kd 2d]
IRAVABAN: checks 
bello1310: bets $4.28
IRAVABAN: folds 
Uncalled bet ($4.28) returned to bello1310
bello1310 collected $4.28 from pot
bello1310: doesn't show hand 
*** SUMMARY ***
Total pot $4.50 | Rake $0.22 
Board [Jh Kd 2d]
Seat 1: Moszes360 folded before Flop (didn't bet)
Seat 2: deadkiller1 folded before Flop (didn't bet)
Seat 3: matiko09 folded before Flop (didn't bet)
Seat 4: HITYESCA folded before Flop (didn't bet)
Seat 5: bello1310 (button) collected ($4.28)
Seat 6: torkkdnm (small blind) folded before Flop
Seat 7: IRAVABAN (big blind) folded on the Flop
Seat 8: ama58 folded before Flop (didn't bet)
Seat 9: oscarleon folded before Flop (didn't bet)





PokerStars Hand #153502899567:  Hold'em No Limit (€0.50/€1.00 EUR) - 2016/05/18 20:42:50 CET [2016/05/18 14:42:50 ET]
Table 'Lamberta IV' 9-max Seat #8 is the button
Seat 1: Trompeneers (€65.88 in chips) 
Seat 2: TimStone (€100 in chips) 
Seat 3: JACQUILF (€100 in chips) 
Seat 4: matiko09 (€122.32 in chips) 
Seat 5: HomerrrJay (€100 in chips) 
Seat 6: Skum1986 (€100 in chips) 
Seat 7: vanilica (€100 in chips) 
Seat 8: lydia12345 (€100 in chips) 
Seat 9: Kihog (€100 in chips) 
Kihog: posts small blind €0.50
Trompeneers: posts big blind €1
*** HOLE CARDS ***
Dealt to matiko09 [5h 9h]
TimStone: folds 
JACQUILF: folds 
matiko09: folds 
HomerrrJay: folds 
Skum1986: folds 
vanilica: raises €2 to €3
lydia12345: folds 
Kihog: calls €2.50
Trompeneers: calls €2
*** FLOP *** [4c 5s Jh]
Kihog: bets €6
Trompeneers: folds 
vanilica: folds 
Uncalled bet (€6) returned to Kihog
Kihog collected €8.55 from pot
Kihog: doesn't show hand 
*** SUMMARY ***
Total pot €9 | Rake €0.45 
Board [4c 5s Jh]
Seat 1: Trompeneers (big blind) folded on the Flop
Seat 2: TimStone folded before Flop (didn't bet)
Seat 3: JACQUILF folded before Flop (didn't bet)
Seat 4: matiko09 folded before Flop (didn't bet)
Seat 5: HomerrrJay folded before Flop (didn't bet)
Seat 6: Skum1986 folded before Flop (didn't bet)
Seat 7: vanilica folded on the Flop
Seat 8: lydia12345 (button) folded before Flop (didn't bet)
Seat 9: Kihog (small blind) collected (€8.55)





PokerStars Hand #153502901933:  Hold'em No Limit ($0.50/$1.00 USD) - 2016/05/18 20:42:53 CET [2016/05/18 14:42:53 ET]
Table 'Barto' 9-max Seat #2 is the button
Seat 1: IRAVABAN ($41.50 in chips) 
Seat 2: Moszes360 ($100 in chips) 
Seat 3: pokerstereke ($92.43 in chips) 
Seat 4: Kihog ($112.68 in chips) 
Seat 5: matiko09 ($100 in chips) 
Seat 6: vanilica ($100 in chips) 
Seat 7: deadkiller1 ($105.15 in chips) 
Seat 8: rate8 ($103 in chips) 
Seat 9: gongqingss ($57.30 in chips) 
pokerstereke: posts small blind $0.50
Kihog: posts big blind $1
*** HOLE CARDS ***
Dealt to matiko09 [8s 9s]
matiko09: raises $2 to $3
vanilica: folds 
deadkiller1: folds 
rate8: folds 
gongqingss: calls $3
IRAVABAN: folds 
Moszes360: folds 
pokerstereke: folds 
Kihog: folds 
*** FLOP *** [Qc 9h Qs]
matiko09: checks 
gongqingss: bets $5
matiko09: calls $5
*** TURN *** [Qc 9h Qs] [Th]
matiko09: checks 
gongqingss: checks 
*** RIVER *** [Qc 9h Qs Th] [Jc]
matiko09: checks 
gongqingss: bets $15
matiko09: folds 
Uncalled bet ($15) returned to gongqingss
gongqingss collected $16.62 from pot
gongqingss: doesn't show hand 
*** SUMMARY ***
Total pot $17.50 | Rake $0.88 
Board [Qc 9h Qs Th Jc]
Seat 1: IRAVABAN folded before Flop (didn't bet)
Seat 2: Moszes360 (button) folded before Flop (didn't bet)
Seat 3: pokerstereke (small blind) folded before Flop
Seat 4: Kihog (big blind) folded before Flop
Seat 5: matiko09 folded on the River
Seat 6: vanilica folded before Flop (didn't bet)
Seat 7: deadkiller1 folded before Flop (didn't bet)
Seat 8: rate8 folded before Flop (didn't bet)
Seat 9: gongqingss collected ($16.62)





PokerStars Hand #153502910200:  Hold'em No Limit (€0.50/€1.00 EUR) - 2016/05/18 20:43:02 CET [2016/05/18 14:43:02 ET]
Table 'Pallas II' 9-max Seat #9 is the button
Seat 1: deadkiller1 (€106 in chips) 
Seat 2: matiko09 (€184.99 in chips) 
Seat 3: Vikulja1993 (€129.52 in chips) 
Seat 4: torkkdnm (€142.21 in chips) 
Seat 5: cobrik23 (€71.86 in chips) 
Seat 6: HITYESCA (€103.62 in chips) 
Seat 7: rate8 (€105.38 in chips) 
Seat 8: Kihog (€100 in chips) 
Seat 9: stijner1986 (€139.98 in chips) 
deadkiller1: posts small blind €0.50
matiko09: posts big blind €1
*** HOLE CARDS ***
Dealt to matiko09 [8d 6c]
Vikulja1993: raises €2 to €3
torkkdnm: folds 
cobrik23: folds 
HITYESCA: folds 
rate8: folds 
Kihog: calls €3
stijner1986: folds 
deadkiller1: folds 
matiko09: folds 
*** FLOP *** [8c 4s 2c]
Vikulja1993: checks 
Kihog: bets €5
Vikulja1993: calls €5
*** TURN *** [8c 4s 2c] [Tc]
Vikulja1993: checks 
Kihog: bets €11.50
Vikulja1993: calls €11.50
*** RIVER *** [8c 4s 2c Tc] [Ah]
Vikulja1993: checks 
Kihog: bets €24
Vikulja1993: calls €24
*** SHOW DOWN ***
Kihog: shows [Jc Qc] (a flush, Queen high)
Vikulja1993: mucks hand 
Kihog collected €86.25 from pot
*** SUMMARY ***
Total pot €88.50 | Rake €2.25 
Board [8c 4s 2c Tc Ah]
Seat 1: deadkiller1 (small blind) folded before Flop
Seat 2: matiko09 (big blind) folded before Flop
Seat 3: Vikulja1993 mucked [8s 8h]
Seat 4: torkkdnm folded before Flop (didn't bet)
Seat 5: cobrik23 folded before Flop (didn't bet)
Seat 6: HITYESCA folded before Flop (didn't bet)
Seat 7: rate8 folded before Flop (didn't bet)
Seat 8: Kihog showed [Jc Qc] and won (€86.25) with a flush, Queen high
Seat 9: stijner1986 (button) folded before Flop (didn't bet)





PokerStars Hand #153502911451:  Hold'em No Limit ($0.50/$1.00 USD) - 2016/05/18 20:43:04 CET [2016/05/18 14:43:04 ET]
Table 'Abetti II' 9-max Seat #2 is the button
Seat 1: matiko09 ($100 in chips) 
Seat 2: Vikulja1993 ($100 in chips) 
Seat 3: cobrik23 ($131.96 in chips) 
Seat 4: ipashutapkom ($44 in chips) 
Seat 5: blufthenuts ($109.70 in chips) 
Seat 6: I The King I ($159.41 in chips) 
Seat 8: roadster683 ($179.84 in chips) 
cobrik23: posts small blind $0.50
ipashutapkom: posts big blind $1
rate8: sits out 
lydia12345: sits out 
*** HOLE CARDS ***
Dealt to matiko09 [6s 6d]
blufthenuts: folds 
I The King I: folds 
roadster683: folds 
matiko09: raises $1.50 to $2.50
Vikulja1993: folds 
cobrik23: folds 
ipashutapkom: folds 
Uncalled bet ($1.50) returned to matiko09
matiko09 collected $2.50 from pot
matiko09: doesn't show hand 
*** SUMMARY ***
Total pot $2.50 | Rake $0 
Seat 1: matiko09 collected ($2.50)
Seat 2: Vikulja1993 (button) folded before Flop (didn't bet)
Seat 3: cobrik23 (small blind) folded before Flop
Seat 4: ipashutapkom (big blind) folded before Flop
Seat 5: blufthenuts folded before Flop (didn't bet)
Seat 6: I The King I folded before Flop (didn't bet)
Seat 8: roadster683 folded before Flop (didn't bet)





PokerStars Hand #153502914445:  Hold'em No Limit ($0.50/$1.00 USD) - 2016/05/18 20:43:07 CET [2016/05/18 14:43:07 ET]
Table 'Tatjana III' 9-max Seat #8 is the button
Seat 1: cobrik23 ($177.35 in chips) 
Seat 2: HITYESCA ($153.08 in chips) 
Seat 3: matiko09 ($186.84 in chips) 
Seat 4: lydia12345 ($132.98 in chips) 
Seat 5: deadkiller1 ($114.94 in chips) 
Seat 7: rene1984tsv ($91.93 in chips) 
Seat 8: JACQUILF ($100 in chips) 
Seat 9: Moszes360 ($101.62 in chips) 
Moszes360: posts small blind $0.50
cobrik23: posts big blind $1
Kihog: sits out 
*** HOLE CARDS ***
Dealt to matiko09 [5d Qd]
HITYESCA: folds 
matiko09: folds 
lydia12345: folds 
deadkiller1: folds 
rene1984tsv: raises $1 to $2
JACQUILF: calls $2
Moszes360: folds 
cobrik23: calls $1
*** FLOP *** [6c 3s 9s]
cobrik23: checks 
rene1984tsv: bets $3.09
JACQUILF: calls $3.09
cobrik23 has timed out
cobrik23: folds 
*** TURN *** [6c 3s 9s] [8d]
rene1984tsv: bets $6
JACQUILF: calls $6
*** RIVER *** [6c 3s 9s 8d] [Qs]
rene1984tsv: checks 
JACQUILF: bets $13.99
rene1984tsv: folds 
Uncalled bet ($13.99) returned to JACQUILF
JACQUILF collected $23.45 from pot
JACQUILF: doesn't show hand 
*** SUMMARY ***
Total pot $24.68 | Rake $1.23 
Board [6c 3s 9s 8d Qs]
Seat 1: cobrik23 (big blind) folded on the Flop
Seat 2: HITYESCA folded before Flop (didn't bet)
Seat 3: matiko09 folded before Flop (didn't bet)
Seat 4: lydia12345 folded before Flop (didn't bet)
Seat 5: deadkiller1 folded before Flop (didn't bet)
Seat 7: rene1984tsv folded on the River
Seat 8: JACQUILF (button) collected ($23.45)
Seat 9: Moszes360 (small blind) folded before Flop





PokerStars Hand #153502939985:  Hold'em No Limit ($0.50/$1.00 USD) - 2016/05/18 20:43:36 CET [2016/05/18 14:43:36 ET]
Table 'Suevia' 9-max Seat #6 is the button
Seat 1: Moszes360 ($100 in chips) 
Seat 2: deadkiller1 ($114.35 in chips) 
Seat 3: matiko09 ($106.22 in chips) 
Seat 4: HITYESCA ($100 in chips) 
Seat 5: bello1310 ($108.31 in chips) 
Seat 6: torkkdnm ($124.16 in chips) 
Seat 7: IRAVABAN ($40 in chips) 
Seat 8: ama58 ($50.58 in chips) 
Seat 9: oscarleon ($134.87 in chips) 
IRAVABAN: posts small blind $0.50
ama58: posts big blind $1
*** HOLE CARDS ***
Dealt to matiko09 [8h 9h]
oscarleon: raises $2 to $3
Moszes360: folds 
deadkiller1: folds 
matiko09: folds 
HITYESCA: folds 
bello1310: calls $3
torkkdnm: calls $3
IRAVABAN: folds 
ama58: folds 
*** FLOP *** [9s Kh Tc]
oscarleon: checks 
bello1310: checks 
torkkdnm: checks 
*** TURN *** [9s Kh Tc] [Ks]
oscarleon: bets $7
bello1310: folds 
torkkdnm: folds 
Uncalled bet ($7) returned to oscarleon
oscarleon collected $9.98 from pot
oscarleon: doesn't show hand 
*** SUMMARY ***
Total pot $10.50 | Rake $0.52 
Board [9s Kh Tc Ks]
Seat 1: Moszes360 folded before Flop (didn't bet)
Seat 2: deadkiller1 folded before Flop (didn't bet)
Seat 3: matiko09 folded before Flop (didn't bet)
Seat 4: HITYESCA folded before Flop (didn't bet)
Seat 5: bello1310 folded on the Turn
Seat 6: torkkdnm (button) folded on the Turn
Seat 7: IRAVABAN (small blind) folded before Flop
Seat 8: ama58 (big blind) folded before Flop
Seat 9: oscarleon collected ($9.98)





PokerStars Hand #153502954789:  Hold'em No Limit (€0.50/€1.00 EUR) - 2016/05/18 20:43:53 CET [2016/05/18 14:43:53 ET]
Table 'Lamberta IV' 9-max Seat #9 is the button
Seat 1: Trompeneers (€62.88 in chips) 
Seat 2: TimStone (€100 in chips) 
Seat 3: JACQUILF (€100 in chips) 
Seat 4: matiko09 (€122.32 in chips) 
Seat 5: HomerrrJay (€100 in chips) 
Seat 6: Skum1986 (€100 in chips) 
Seat 7: vanilica (€100 in chips) 
Seat 8: lydia12345 (€100 in chips) 
Seat 9: Kihog (€105.55 in chips) 
Trompeneers: posts small blind €0.50
TimStone: posts big blind €1
*** HOLE CARDS ***
Dealt to matiko09 [4c 2h]
JACQUILF: folds 
matiko09: folds 
HomerrrJay: folds 
Skum1986: folds 
vanilica: folds 
lydia12345: folds 
Kihog: raises €1 to €2
Trompeneers: calls €1.50
TimStone: calls €1
*** FLOP *** [Ad 5c Jd]
Trompeneers: bets €2
TimStone: calls €2
Kihog: raises €8 to €10
Trompeneers: folds 
TimStone: folds 
Uncalled bet (€8) returned to Kihog
Kihog collected €11.40 from pot
Kihog: doesn't show hand 
*** SUMMARY ***
Total pot €12 | Rake €0.60 
Board [Ad 5c Jd]
Seat 1: Trompeneers (small blind) folded on the Flop
Seat 2: TimStone (big blind) folded on the Flop
Seat 3: JACQUILF folded before Flop (didn't bet)
Seat 4: matiko09 folded before Flop (didn't bet)
Seat 5: HomerrrJay folded before Flop (didn't bet)
Seat 6: Skum1986 folded before Flop (didn't bet)
Seat 7: vanilica folded before Flop (didn't bet)
Seat 8: lydia12345 folded before Flop (didn't bet)
Seat 9: Kihog (button) collected (€11.40)





PokerStars Hand #153502958060:  Hold'em No Limit ($0.50/$1.00 USD) - 2016/05/18 20:43:57 CET [2016/05/18 14:43:57 ET]
Table 'Abetti II' 9-max Seat #3 is the button
Seat 1: matiko09 ($101.50 in chips) 
Seat 2: Vikulja1993 ($100 in chips) 
Seat 3: cobrik23 ($131.46 in chips) 
Seat 4: ipashutapkom ($43 in chips) 
Seat 5: blufthenuts ($109.70 in chips) 
Seat 6: I The King I ($159.41 in chips) 
Seat 8: roadster683 ($179.84 in chips) 
ipashutapkom: posts small blind $0.50
blufthenuts: posts big blind $1
rate8: sits out 
lydia12345: sits out 
*** HOLE CARDS ***
Dealt to matiko09 [9h 8c]
I The King I: folds 
roadster683: folds 
I The King I leaves the table
matiko09: folds 
Vikulja1993: raises $1.50 to $2.50
Kihog joins the table at seat #6 
cobrik23: folds 
ipashutapkom: folds 
blufthenuts: raises $6.50 to $9
Vikulja1993: folds 
Uncalled bet ($6.50) returned to blufthenuts
blufthenuts collected $5.50 from pot
blufthenuts: doesn't show hand 
*** SUMMARY ***
Total pot $5.50 | Rake $0 
Seat 1: matiko09 folded before Flop (didn't bet)
Seat 2: Vikulja1993 folded before Flop
Seat 3: cobrik23 (button) folded before Flop (didn't bet)
Seat 4: ipashutapkom (small blind) folded before Flop
Seat 5: blufthenuts (big blind) collected ($5.50)
Seat 6: I The King I folded before Flop (didn't bet)
Seat 8: roadster683 folded before Flop (didn't bet)





PokerStars Hand #153502965651:  Hold'em No Limit ($0.50/$1.00 USD) - 2016/05/18 20:44:06 CET [2016/05/18 14:44:06 ET]
Table 'Pandora' 9-max Seat #9 is the button
Seat 1: deadkiller1 ($142.41 in chips) 
Seat 2: fack_vi ($26.97 in chips) 
Seat 3: TimStone ($100 in chips) 
Seat 4: mooose100 ($150.87 in chips) 
Seat 5: nickreason17 ($105.02 in chips) 
Seat 6: Moszes360 ($100 in chips) 
Seat 7: lydia12345 ($104.32 in chips) 
Seat 8: matiko09 ($116.52 in chips) 
Seat 9: oscarleon ($111.48 in chips) 
deadkiller1: posts small blind $0.50
fack_vi: posts big blind $1
*** HOLE CARDS ***
Dealt to matiko09 [Ts 2d]
TimStone: folds 
mooose100: folds 
nickreason17: folds 
Moszes360: folds 
lydia12345: folds 
matiko09: folds 
oscarleon: folds 
deadkiller1: raises $1.50 to $2.50
fack_vi: folds 
Uncalled bet ($1.50) returned to deadkiller1
deadkiller1 collected $2 from pot
deadkiller1: doesn't show hand 
*** SUMMARY ***
Total pot $2 | Rake $0 
Seat 1: deadkiller1 (small blind) collected ($2)
Seat 2: fack_vi (big blind) folded before Flop
Seat 3: TimStone folded before Flop (didn't bet)
Seat 4: mooose100 folded before Flop (didn't bet)
Seat 5: nickreason17 folded before Flop (didn't bet)
Seat 6: Moszes360 folded before Flop (didn't bet)
Seat 7: lydia12345 folded before Flop (didn't bet)
Seat 8: matiko09 folded before Flop (didn't bet)
Seat 9: oscarleon (button) folded before Flop (didn't bet)





PokerStars Hand #153502982701:  Hold'em No Limit ($1/$2 USD) - 2016/05/18 20:44:25 CET [2016/05/18 14:44:25 ET]
Table 'Wild' 9-max Seat #5 is the button
Seat 1: Sharknebulah ($215.60 in chips) 
Seat 2: zigzag972 ($365.70 in chips) 
Seat 3: Momess ($242.01 in chips) 
Seat 4: hg1317 ($113.22 in chips) 
Seat 5: Ravnica11 ($79 in chips) 
Seat 6: tepi_guy ($240.44 in chips) 
Seat 7: matiko09 ($200 in chips) 
Seat 8: donald0404 ($252.25 in chips) 
Seat 9: Vikulja1993 ($203.50 in chips) 
tepi_guy: posts small blind $1
matiko09: posts big blind $2
*** HOLE CARDS ***
Dealt to matiko09 [8h Ts]
donald0404: folds 
Vikulja1993: folds 
Sharknebulah: folds 
zigzag972: folds 
Momess: folds 
hg1317: folds 
Ravnica11: folds 
tepi_guy has timed out
tepi_guy: folds 
Uncalled bet ($1) returned to matiko09
matiko09 collected $2 from pot
matiko09: doesn't show hand 
*** SUMMARY ***
Total pot $2 | Rake $0 
Seat 1: Sharknebulah folded before Flop (didn't bet)
Seat 2: zigzag972 folded before Flop (didn't bet)
Seat 3: Momess folded before Flop (didn't bet)
Seat 4: hg1317 folded before Flop (didn't bet)
Seat 5: Ravnica11 (button) folded before Flop (didn't bet)
Seat 6: tepi_guy (small blind) folded before Flop
Seat 7: matiko09 (big blind) collected ($2)
Seat 8: donald0404 folded before Flop (didn't bet)
Seat 9: Vikulja1993 folded before Flop (didn't bet)





PokerStars Hand #153502990911:  Hold'em No Limit ($0.50/$1.00 USD) - 2016/05/18 20:44:35 CET [2016/05/18 14:44:35 ET]
Table 'Pandora' 9-max Seat #1 is the button
Seat 1: deadkiller1 ($143.41 in chips) 
Seat 2: fack_vi ($25.97 in chips) 
Seat 4: mooose100 ($150.87 in chips) 
Seat 5: nickreason17 ($105.02 in chips) 
Seat 6: Moszes360 ($100 in chips) 
Seat 7: lydia12345 ($104.32 in chips) 
Seat 8: matiko09 ($116.52 in chips) 
Seat 9: oscarleon ($111.48 in chips) 
fack_vi: posts small blind $0.50
TimStone: is sitting out 
TimStone leaves the table
mooose100: posts big blind $1
*** HOLE CARDS ***
Dealt to matiko09 [6h Qh]
nickreason17: raises $1.50 to $2.50
Moszes360: folds 
lydia12345: folds 
matiko09: folds 
vanilica joins the table at seat #3 
oscarleon: folds 
deadkiller1: folds 
fack_vi: folds 
mooose100: calls $1.50
*** FLOP *** [3h 4d 3s]
mooose100: checks 
nickreason17: bets $3.50
mooose100: folds 
Uncalled bet ($3.50) returned to nickreason17
nickreason17 collected $5.22 from pot
*** SUMMARY ***
Total pot $5.50 | Rake $0.28 
Board [3h 4d 3s]
Seat 1: deadkiller1 (button) folded before Flop (didn't bet)
Seat 2: fack_vi (small blind) folded before Flop
Seat 4: mooose100 (big blind) folded on the Flop
Seat 5: nickreason17 collected ($5.22)
Seat 6: Moszes360 folded before Flop (didn't bet)
Seat 7: lydia12345 folded before Flop (didn't bet)
Seat 8: matiko09 folded before Flop (didn't bet)
Seat 9: oscarleon folded before Flop (didn't bet)





PokerStars Hand #153502995444:  Hold'em No Limit ($0.50/$1.00 USD) - 2016/05/18 20:44:40 CET [2016/05/18 14:44:40 ET]
Table 'Suevia' 9-max Seat #7 is the button
Seat 1: Moszes360 ($100 in chips) 
Seat 2: deadkiller1 ($114.35 in chips) 
Seat 3: matiko09 ($106.22 in chips) 
Seat 4: HITYESCA ($100 in chips) 
Seat 5: bello1310 ($105.31 in chips) 
Seat 6: torkkdnm ($121.16 in chips) 
Seat 7: IRAVABAN ($40 in chips) 
Seat 8: ama58 ($49.58 in chips) 
Seat 9: oscarleon ($141.85 in chips) 
ama58: posts small blind $0.50
oscarleon: posts big blind $1
*** HOLE CARDS ***
Dealt to matiko09 [6d Ac]
Moszes360: folds 
deadkiller1: raises $2 to $3
matiko09: folds 
HITYESCA: folds 
bello1310: folds 
torkkdnm: calls $3
IRAVABAN: folds 
ama58: folds 
oscarleon: folds 
*** FLOP *** [5d 5c 9s]
deadkiller1: bets $4.69
torkkdnm: folds 
Uncalled bet ($4.69) returned to deadkiller1
deadkiller1 collected $7.12 from pot
deadkiller1: doesn't show hand 
*** SUMMARY ***
Total pot $7.50 | Rake $0.38 
Board [5d 5c 9s]
Seat 1: Moszes360 folded before Flop (didn't bet)
Seat 2: deadkiller1 collected ($7.12)
Seat 3: matiko09 folded before Flop (didn't bet)
Seat 4: HITYESCA folded before Flop (didn't bet)
Seat 5: bello1310 folded before Flop (didn't bet)
Seat 6: torkkdnm folded on the Flop
Seat 7: IRAVABAN (button) folded before Flop (didn't bet)
Seat 8: ama58 (small blind) folded before Flop
Seat 9: oscarleon (big blind) folded before Flop





PokerStars Hand #153503001790:  Hold'em No Limit ($0.50/$1.00 USD) - 2016/05/18 20:44:47 CET [2016/05/18 14:44:47 ET]
Table 'Abetti II' 9-max Seat #4 is the button
Seat 1: matiko09 ($101.50 in chips) 
Seat 2: Vikulja1993 ($100 in chips) 
Seat 3: cobrik23 ($131.46 in chips) 
Seat 4: ipashutapkom ($42.50 in chips) 
Seat 5: blufthenuts ($112.70 in chips) 
Seat 6: Kihog ($100 in chips) 
Seat 8: roadster683 ($179.84 in chips) 
blufthenuts: posts small blind $0.50
Kihog: posts big blind $1
rate8: sits out 
lydia12345: sits out 
*** HOLE CARDS ***
Dealt to matiko09 [4h 8d]
roadster683: calls $1
matiko09: folds 
Vikulja1993: folds 
cobrik23: folds 
ipashutapkom: folds 
blufthenuts: calls $0.50
Kihog: checks 
*** FLOP *** [As 7d 2d]
blufthenuts: checks 
Kihog: checks 
roadster683: bets $2
blufthenuts: calls $2
Kihog: folds 
*** TURN *** [As 7d 2d] [Ac]
blufthenuts: checks 
roadster683: checks 
*** RIVER *** [As 7d 2d Ac] [4s]
blufthenuts: checks 
roadster683: checks 
*** SHOW DOWN ***
blufthenuts: shows [7h 8c] (two pair, Aces and Sevens)
roadster683: mucks hand 
blufthenuts collected $6.65 from pot
*** SUMMARY ***
Total pot $7 | Rake $0.35 
Board [As 7d 2d Ac 4s]
Seat 1: matiko09 folded before Flop (didn't bet)
Seat 2: Vikulja1993 folded before Flop (didn't bet)
Seat 3: cobrik23 folded before Flop (didn't bet)
Seat 4: ipashutapkom (button) folded before Flop (didn't bet)
Seat 5: blufthenuts (small blind) showed [7h 8c] and won ($6.65) with two pair, Aces and Sevens
Seat 6: Kihog (big blind) folded on the Flop
Seat 8: roadster683 mucked [Qd Js]





PokerStars Hand #153503015664:  Hold'em No Limit (€0.50/€1.00 EUR) - 2016/05/18 20:45:03 CET [2016/05/18 14:45:03 ET]
Table 'Lamberta IV' 9-max Seat #1 is the button
Seat 1: Trompeneers (€58.88 in chips) 
Seat 2: TimStone (€100 in chips) 
Seat 3: JACQUILF (€100 in chips) 
Seat 4: matiko09 (€122.32 in chips) 
Seat 5: HomerrrJay (€100 in chips) 
Seat 6: Skum1986 (€100 in chips) 
Seat 7: vanilica (€100 in chips) 
Seat 8: lydia12345 (€100 in chips) 
Seat 9: Kihog (€112.95 in chips) 
TimStone: posts small blind €0.50
JACQUILF: posts big blind €1
*** HOLE CARDS ***
Dealt to matiko09 [7d 4h]
matiko09: folds 
HomerrrJay: folds 
Skum1986: folds 
vanilica: folds 
lydia12345: folds 
Kihog: folds 
Trompeneers: calls €1
TimStone: folds 
JACQUILF: checks 
*** FLOP *** [7s Qc 6s]
JACQUILF: checks 
Trompeneers: bets €2
JACQUILF: folds 
Uncalled bet (€2) returned to Trompeneers
Trompeneers collected €2.38 from pot
*** SUMMARY ***
Total pot €2.50 | Rake €0.12 
Board [7s Qc 6s]
Seat 1: Trompeneers (button) collected (€2.38)
Seat 2: TimStone (small blind) folded before Flop
Seat 3: JACQUILF (big blind) folded on the Flop
Seat 4: matiko09 folded before Flop (didn't bet)
Seat 5: HomerrrJay folded before Flop (didn't bet)
Seat 6: Skum1986 folded before Flop (didn't bet)
Seat 7: vanilica folded before Flop (didn't bet)
Seat 8: lydia12345 folded before Flop (didn't bet)
Seat 9: Kihog folded before Flop (didn't bet)





PokerStars Hand #153503020274:  Hold'em No Limit ($1/$2 USD) - 2016/05/18 20:45:08 CET [2016/05/18 14:45:08 ET]
Table 'Wild' 9-max Seat #6 is the button
Seat 1: Sharknebulah ($215.60 in chips) 
Seat 2: zigzag972 ($365.70 in chips) 
Seat 3: Momess ($242.01 in chips) 
Seat 4: hg1317 ($113.22 in chips) 
Seat 5: Ravnica11 ($79 in chips) 
Seat 6: tepi_guy ($239.44 in chips) 
Seat 7: matiko09 ($201 in chips) 
Seat 8: donald0404 ($252.25 in chips) 
Seat 9: Vikulja1993 ($203.50 in chips) 
matiko09: posts small blind $1
donald0404: posts big blind $2
*** HOLE CARDS ***
Dealt to matiko09 [Ks Ts]
Vikulja1993: raises $4 to $6
Sharknebulah: folds 
zigzag972: folds 
Momess: folds 
hg1317: folds 
Ravnica11: folds 
tepi_guy: folds 
matiko09: folds 
donald0404: folds 
Uncalled bet ($4) returned to Vikulja1993
Vikulja1993 collected $5 from pot
Vikulja1993: doesn't show hand 
*** SUMMARY ***
Total pot $5 | Rake $0 
Seat 1: Sharknebulah folded before Flop (didn't bet)
Seat 2: zigzag972 folded before Flop (didn't bet)
Seat 3: Momess folded before Flop (didn't bet)
Seat 4: hg1317 folded before Flop (didn't bet)
Seat 5: Ravnica11 folded before Flop (didn't bet)
Seat 6: tepi_guy (button) folded before Flop (didn't bet)
Seat 7: matiko09 (small blind) folded before Flop
Seat 8: donald0404 (big blind) folded before Flop
Seat 9: Vikulja1993 collected ($5)





PokerStars Hand #153503027938:  Hold'em No Limit ($0.50/$1.00 USD) - 2016/05/18 20:45:17 CET [2016/05/18 14:45:17 ET]
Table 'Tatjana III' 9-max Seat #9 is the button
Seat 2: HITYESCA ($153.08 in chips) 
Seat 3: matiko09 ($186.84 in chips) 
Seat 4: lydia12345 ($132.98 in chips) 
Seat 5: deadkiller1 ($114.94 in chips) 
Seat 7: rene1984tsv ($80.84 in chips) 
Seat 8: JACQUILF ($112.36 in chips) 
Seat 9: Moszes360 ($101.12 in chips) 
HITYESCA: posts small blind $0.50
matiko09: posts big blind $1
Kihog: sits out 
*** HOLE CARDS ***
Dealt to matiko09 [4d 5s]
lydia12345: folds 
deadkiller1: raises $2 to $3
rene1984tsv: calls $3
JACQUILF: raises $9 to $12
Moszes360: folds 
HITYESCA: folds 
matiko09: folds 
deadkiller1: folds 
rene1984tsv: calls $9
*** FLOP *** [6h 9c 6s]
rene1984tsv: bets $1
JACQUILF: calls $1
*** TURN *** [6h 9c 6s] [3h]
rene1984tsv: bets $3
JACQUILF: calls $3
*** RIVER *** [6h 9c 6s 3h] [Kh]
rene1984tsv: bets $4
JACQUILF: calls $4
*** SHOW DOWN ***
rene1984tsv: shows [Qc 3c] (two pair, Sixes and Threes)
JACQUILF: mucks hand 
rene1984tsv collected $42.28 from pot
*** SUMMARY ***
Total pot $44.50 | Rake $2.22 
Board [6h 9c 6s 3h Kh]
Seat 2: HITYESCA (small blind) folded before Flop
Seat 3: matiko09 (big blind) folded before Flop
Seat 4: lydia12345 folded before Flop (didn't bet)
Seat 5: deadkiller1 folded before Flop
Seat 7: rene1984tsv showed [Qc 3c] and won ($42.28) with two pair, Sixes and Threes
Seat 8: JACQUILF mucked [Ac Jd]
Seat 9: Moszes360 (button) folded before Flop (didn't bet)





PokerStars Hand #153503044567:  Hold'em No Limit ($0.50/$1.00 USD) - 2016/05/18 20:45:36 CET [2016/05/18 14:45:36 ET]
Table 'Pandora' 9-max Seat #2 is the button
Seat 1: deadkiller1 ($143.41 in chips) 
Seat 2: fack_vi ($25.47 in chips) 
Seat 4: mooose100 ($148.37 in chips) 
Seat 6: Moszes360 ($100 in chips) 
Seat 7: lydia12345 ($104.32 in chips) 
Seat 8: matiko09 ($116.52 in chips) 
Seat 9: oscarleon ($111.48 in chips) 
vanilica will be allowed to play after the button
mooose100: posts small blind $0.50
nickreason17: is sitting out 
Moszes360: posts big blind $1
*** HOLE CARDS ***
Dealt to matiko09 [5s 6h]
nickreason17 leaves the table
lydia12345: folds 
matiko09: folds 
oscarleon: raises $2 to $3
deadkiller1: folds 
fack_vi: folds 
mooose100: folds 
Moszes360: folds 
Uncalled bet ($2) returned to oscarleon
oscarleon collected $2.50 from pot
*** SUMMARY ***
Total pot $2.50 | Rake $0 
Seat 1: deadkiller1 folded before Flop (didn't bet)
Seat 2: fack_vi (button) folded before Flop (didn't bet)
Seat 4: mooose100 (small blind) folded before Flop
Seat 6: Moszes360 (big blind) folded before Flop
Seat 7: lydia12345 folded before Flop (didn't bet)
Seat 8: matiko09 folded before Flop (didn't bet)
Seat 9: oscarleon collected ($2.50)





PokerStars Hand #153503050653:  Hold'em No Limit ($0.50/$1.00 USD) - 2016/05/18 20:45:43 CET [2016/05/18 14:45:43 ET]
Table 'Suevia' 9-max Seat #8 is the button
Seat 1: Moszes360 ($100 in chips) 
Seat 2: deadkiller1 ($118.47 in chips) 
Seat 3: matiko09 ($106.22 in chips) 
Seat 4: HITYESCA ($100 in chips) 
Seat 5: bello1310 ($105.31 in chips) 
Seat 6: torkkdnm ($118.16 in chips) 
Seat 7: IRAVABAN ($40 in chips) 
Seat 8: ama58 ($49.08 in chips) 
Seat 9: oscarleon ($140.85 in chips) 
oscarleon: posts small blind $0.50
Moszes360: posts big blind $1
*** HOLE CARDS ***
Dealt to matiko09 [9c 5d]
deadkiller1: folds 
matiko09: folds 
HITYESCA: folds 
bello1310: folds 
torkkdnm: folds 
IRAVABAN: folds 
ama58: folds 
oscarleon: folds 
Uncalled bet ($0.50) returned to Moszes360
Moszes360 collected $1 from pot
Moszes360: doesn't show hand 
*** SUMMARY ***
Total pot $1 | Rake $0 
Seat 1: Moszes360 (big blind) collected ($1)
Seat 2: deadkiller1 folded before Flop (didn't bet)
Seat 3: matiko09 folded before Flop (didn't bet)
Seat 4: HITYESCA folded before Flop (didn't bet)
Seat 5: bello1310 folded before Flop (didn't bet)
Seat 6: torkkdnm folded before Flop (didn't bet)
Seat 7: IRAVABAN folded before Flop (didn't bet)
Seat 8: ama58 (button) folded before Flop (didn't bet)
Seat 9: oscarleon (small blind) folded before Flop





PokerStars Hand #153503056822:  Hold'em No Limit (€0.50/€1.00 EUR) - 2016/05/18 20:45:50 CET [2016/05/18 14:45:50 ET]
Table 'Pallas II' 9-max Seat #1 is the button
Seat 1: deadkiller1 (€105.50 in chips) 
Seat 2: matiko09 (€183.99 in chips) 
Seat 3: Vikulja1993 (€100 in chips) 
Seat 4: torkkdnm (€142.21 in chips) 
Seat 5: cobrik23 (€71.86 in chips) 
Seat 6: HITYESCA (€103.62 in chips) 
Seat 7: rate8 (€105.38 in chips) 
Seat 8: Kihog (€142.75 in chips) 
Seat 9: stijner1986 (€139.98 in chips) 
matiko09: posts small blind €0.50
Vikulja1993: posts big blind €1
*** HOLE CARDS ***
Dealt to matiko09 [Ac 2h]
torkkdnm: folds 
cobrik23: folds 
HITYESCA: raises €2 to €3
rate8: folds 
Kihog: folds 
stijner1986: folds 
deadkiller1: folds 
matiko09: folds 
Vikulja1993: folds 
Uncalled bet (€2) returned to HITYESCA
HITYESCA collected €2.50 from pot
HITYESCA: doesn't show hand 
*** SUMMARY ***
Total pot €2.50 | Rake €0 
Seat 1: deadkiller1 (button) folded before Flop (didn't bet)
Seat 2: matiko09 (small blind) folded before Flop
Seat 3: Vikulja1993 (big blind) folded before Flop
Seat 4: torkkdnm folded before Flop (didn't bet)
Seat 5: cobrik23 folded before Flop (didn't bet)
Seat 6: HITYESCA collected (€2.50)
Seat 7: rate8 folded before Flop (didn't bet)
Seat 8: Kihog folded before Flop (didn't bet)
Seat 9: stijner1986 folded before Flop (didn't bet)





PokerStars Hand #153503058751:  Hold'em No Limit ($0.50/$1.00 USD) - 2016/05/18 20:45:53 CET [2016/05/18 14:45:53 ET]
Table 'Kayala' 9-max Seat #4 is the button
Seat 1: deadkiller1 ($103.90 in chips) 
Seat 2: Oelie7 ($183.61 in chips) 
Seat 3: matiko09 ($100 in chips) 
Seat 4: HITYESCA ($100 in chips) 
Seat 5: rate8 ($103.12 in chips) 
Seat 8: cobrik23 ($85.04 in chips) 
Seat 9: Vikulja1993 ($102.26 in chips) 
rate8: posts small blind $0.50
lydia12345: is sitting out 
nickreason17: is sitting out 
nickreason17 leaves the table
cobrik23: posts big blind $1
*** HOLE CARDS ***
Dealt to matiko09 [6d Ac]
lydia12345 leaves the table
Vikulja1993: raises $2 to $3
deadkiller1: folds 
Oelie7: folds 
matiko09: folds 
HITYESCA: folds 
rate8: folds 
cobrik23: folds 
Uncalled bet ($2) returned to Vikulja1993
Vikulja1993 collected $2.50 from pot
Vikulja1993: doesn't show hand 
*** SUMMARY ***
Total pot $2.50 | Rake $0 
Seat 1: deadkiller1 folded before Flop (didn't bet)
Seat 2: Oelie7 folded before Flop (didn't bet)
Seat 3: matiko09 folded before Flop (didn't bet)
Seat 4: HITYESCA (button) folded before Flop (didn't bet)
Seat 5: rate8 (small blind) folded before Flop
Seat 8: cobrik23 (big blind) folded before Flop
Seat 9: Vikulja1993 collected ($2.50)





PokerStars Hand #153503058864:  Hold'em No Limit ($1/$2 USD) - 2016/05/18 20:45:53 CET [2016/05/18 14:45:53 ET]
Table 'Wild' 9-max Seat #7 is the button
Seat 1: Sharknebulah ($215.60 in chips) 
Seat 2: zigzag972 ($365.70 in chips) 
Seat 3: Momess ($242.01 in chips) 
Seat 4: hg1317 ($113.22 in chips) 
Seat 5: Ravnica11 ($79 in chips) 
Seat 6: tepi_guy ($239.44 in chips) 
Seat 7: matiko09 ($200 in chips) 
Seat 8: donald0404 ($250.25 in chips) 
Seat 9: Vikulja1993 ($206.50 in chips) 
donald0404: posts small blind $1
Vikulja1993: posts big blind $2
*** HOLE CARDS ***
Dealt to matiko09 [7h 9h]
Sharknebulah: folds 
zigzag972: folds 
Momess: folds 
hg1317: folds 
Ravnica11: folds 
tepi_guy: folds 
matiko09: raises $2.54 to $4.54
donald0404: folds 
Vikulja1993: folds 
Uncalled bet ($2.54) returned to matiko09
matiko09 collected $5 from pot
matiko09: doesn't show hand 
*** SUMMARY ***
Total pot $5 | Rake $0 
Seat 1: Sharknebulah folded before Flop (didn't bet)
Seat 2: zigzag972 folded before Flop (didn't bet)
Seat 3: Momess folded before Flop (didn't bet)
Seat 4: hg1317 folded before Flop (didn't bet)
Seat 5: Ravnica11 folded before Flop (didn't bet)
Seat 6: tepi_guy folded before Flop (didn't bet)
Seat 7: matiko09 (button) collected ($5)
Seat 8: donald0404 (small blind) folded before Flop
Seat 9: Vikulja1993 (big blind) folded before Flop





PokerStars Hand #153503065220:  Hold'em No Limit (€0.50/€1.00 EUR) - 2016/05/18 20:46:00 CET [2016/05/18 14:46:00 ET]
Table 'Lamberta IV' 9-max Seat #2 is the button
Seat 1: Trompeneers (€60.26 in chips) 
Seat 2: TimStone (€100 in chips) 
Seat 3: JACQUILF (€100 in chips) 
Seat 4: matiko09 (€122.32 in chips) 
Seat 5: HomerrrJay (€100 in chips) 
Seat 6: Skum1986 (€100 in chips) 
Seat 7: vanilica (€100 in chips) 
Seat 8: lydia12345 (€100 in chips) 
Seat 9: Kihog (€112.95 in chips) 
JACQUILF: posts small blind €0.50
matiko09: posts big blind €1
*** HOLE CARDS ***
Dealt to matiko09 [6s Jc]
HomerrrJay: folds 
Skum1986: folds 
vanilica: folds 
lydia12345: raises €2 to €3
Kihog: folds 
Trompeneers: folds 
TimStone: folds 
JACQUILF: folds 
matiko09: folds 
Uncalled bet (€2) returned to lydia12345
lydia12345 collected €2.50 from pot
*** SUMMARY ***
Total pot €2.50 | Rake €0 
Seat 1: Trompeneers folded before Flop (didn't bet)
Seat 2: TimStone (button) folded before Flop (didn't bet)
Seat 3: JACQUILF (small blind) folded before Flop
Seat 4: matiko09 (big blind) folded before Flop
Seat 5: HomerrrJay folded before Flop (didn't bet)
Seat 6: Skum1986 folded before Flop (didn't bet)
Seat 7: vanilica folded before Flop (didn't bet)
Seat 8: lydia12345 collected (€2.50)
Seat 9: Kihog folded before Flop (didn't bet)





PokerStars Hand #153503067374:  Hold'em No Limit ($0.50/$1.00 USD) - 2016/05/18 20:46:02 CET [2016/05/18 14:46:02 ET]
Table 'Abetti II' 9-max Seat #5 is the button
Seat 1: matiko09 ($101.50 in chips) 
Seat 2: Vikulja1993 ($100 in chips) 
Seat 3: cobrik23 ($131.46 in chips) 
Seat 4: ipashutapkom ($42.50 in chips) 
Seat 5: blufthenuts ($116.35 in chips) 
Seat 6: Kihog ($100 in chips) 
Seat 7: rate8 ($100 in chips) 
Seat 8: roadster683 ($176.84 in chips) 
Kihog: posts small blind $0.50
rate8: posts big blind $1
lydia12345: sits out 
*** HOLE CARDS ***
Dealt to matiko09 [5h Jh]
roadster683: folds 
matiko09: folds 
Vikulja1993: folds 
cobrik23: folds 
ipashutapkom: folds 
blufthenuts: raises $2 to $3
Kihog: folds 
rate8: folds 
Uncalled bet ($2) returned to blufthenuts
blufthenuts collected $2.50 from pot
blufthenuts: doesn't show hand 
*** SUMMARY ***
Total pot $2.50 | Rake $0 
Seat 1: matiko09 folded before Flop (didn't bet)
Seat 2: Vikulja1993 folded before Flop (didn't bet)
Seat 3: cobrik23 folded before Flop (didn't bet)
Seat 4: ipashutapkom folded before Flop (didn't bet)
Seat 5: blufthenuts (button) collected ($2.50)
Seat 6: Kihog (small blind) folded before Flop
Seat 7: rate8 (big blind) folded before Flop
Seat 8: roadster683 folded before Flop (didn't bet)





PokerStars Hand #153503067459:  Hold'em No Limit ($0.50/$1.00 USD) - 2016/05/18 20:46:03 CET [2016/05/18 14:46:03 ET]
Table 'Pandora' 9-max Seat #4 is the button
Seat 1: deadkiller1 ($143.41 in chips) 
Seat 2: fack_vi ($40 in chips) 
Seat 4: mooose100 ($147.87 in chips) 
Seat 6: Moszes360 ($100 in chips) 
Seat 8: matiko09 ($116.52 in chips) 
Seat 9: oscarleon ($112.98 in chips) 
Moszes360: posts small blind $0.50
lydia12345: is sitting out 
matiko09: posts big blind $1
vanilica: sits out 
*** HOLE CARDS ***
Dealt to matiko09 [Qh 8s]
oscarleon: folds 
lydia12345 leaves the table
deadkiller1: folds 
fack_vi: folds 
mooose100: raises $2 to $3
Strikerman25 joins the table at seat #5 
Moszes360: raises $7 to $10
matiko09: folds 
smolski15 joins the table at seat #7 
smolski15 leaves the table
mooose100: calls $7
*** FLOP *** [5c 3h 9s]
Moszes360: bets $15.36
torkkdnm joins the table at seat #7 
mooose100: folds 
Uncalled bet ($15.36) returned to Moszes360
Moszes360 collected $19.95 from pot
Moszes360: doesn't show hand 
*** SUMMARY ***
Total pot $21 | Rake $1.05 
Board [5c 3h 9s]
Seat 1: deadkiller1 folded before Flop (didn't bet)
Seat 2: fack_vi folded before Flop (didn't bet)
Seat 4: mooose100 (button) folded on the Flop
Seat 6: Moszes360 (small blind) collected ($19.95)
Seat 8: matiko09 (big blind) folded before Flop
Seat 9: oscarleon folded before Flop (didn't bet)





PokerStars Hand #153503079287:  Hold'em No Limit ($0.50/$1.00 USD) - 2016/05/18 20:46:17 CET [2016/05/18 14:46:17 ET]
Table 'Suevia' 9-max Seat #9 is the button
Seat 1: Moszes360 ($100.50 in chips) 
Seat 2: deadkiller1 ($118.47 in chips) 
Seat 3: matiko09 ($106.22 in chips) 
Seat 4: HITYESCA ($100 in chips) 
Seat 5: bello1310 ($105.31 in chips) 
Seat 6: torkkdnm ($118.16 in chips) 
Seat 7: IRAVABAN ($40 in chips) 
Seat 8: ama58 ($49.08 in chips) 
Seat 9: oscarleon ($140.35 in chips) 
Moszes360: posts small blind $0.50
deadkiller1: posts big blind $1
*** HOLE CARDS ***
Dealt to matiko09 [7d 7s]
matiko09: raises $2 to $3
HITYESCA: folds 
bello1310: folds 
torkkdnm: folds 
IRAVABAN: folds 
ama58: calls $3
oscarleon: folds 
Moszes360: raises $9 to $12
deadkiller1: folds 
matiko09: folds 
ama58: folds 
Uncalled bet ($9) returned to Moszes360
Moszes360 collected $10 from pot
Moszes360: doesn't show hand 
*** SUMMARY ***
Total pot $10 | Rake $0 
Seat 1: Moszes360 (small blind) collected ($10)
Seat 2: deadkiller1 (big blind) folded before Flop
Seat 3: matiko09 folded before Flop
Seat 4: HITYESCA folded before Flop (didn't bet)
Seat 5: bello1310 folded before Flop (didn't bet)
Seat 6: torkkdnm folded before Flop (didn't bet)
Seat 7: IRAVABAN folded before Flop (didn't bet)
Seat 8: ama58 folded before Flop
Seat 9: oscarleon (button) folded before Flop (didn't bet)





PokerStars Hand #153503091195:  Hold'em No Limit ($0.50/$1.00 USD) - 2016/05/18 20:46:30 CET [2016/05/18 14:46:30 ET]
Table 'Kayala' 9-max Seat #5 is the button
Seat 1: deadkiller1 ($103.90 in chips) 
Seat 2: Oelie7 ($183.61 in chips) 
Seat 3: matiko09 ($100 in chips) 
Seat 4: HITYESCA ($100 in chips) 
Seat 5: rate8 ($102.62 in chips) 
Seat 8: cobrik23 ($84.04 in chips) 
Seat 9: Vikulja1993 ($103.76 in chips) 
cobrik23: posts small blind $0.50
Vikulja1993: posts big blind $1
*** HOLE CARDS ***
Dealt to matiko09 [3c Kd]
deadkiller1: folds 
Oelie7: folds 
matiko09: folds 
Strikerman25 joins the table at seat #6 
HITYESCA: folds 
rate8: raises $1 to $2
kenan-lola joins the table at seat #7 
cobrik23: folds 
Vikulja1993: folds 
Uncalled bet ($1) returned to rate8
rate8 collected $2.50 from pot
rate8: doesn't show hand 
*** SUMMARY ***
Total pot $2.50 | Rake $0 
Seat 1: deadkiller1 folded before Flop (didn't bet)
Seat 2: Oelie7 folded before Flop (didn't bet)
Seat 3: matiko09 folded before Flop (didn't bet)
Seat 4: HITYESCA folded before Flop (didn't bet)
Seat 5: rate8 (button) collected ($2.50)
Seat 8: cobrik23 (small blind) folded before Flop
Seat 9: Vikulja1993 (big blind) folded before Flop





PokerStars Hand #153503097920:  Hold'em No Limit ($0.50/$1.00 USD) - 2016/05/18 20:46:38 CET [2016/05/18 14:46:38 ET]
Table 'Abetti II' 9-max Seat #6 is the button
Seat 1: matiko09 ($101.50 in chips) 
Seat 2: Vikulja1993 ($100 in chips) 
Seat 3: cobrik23 ($131.46 in chips) 
Seat 4: ipashutapkom ($42.50 in chips) 
Seat 5: blufthenuts ($117.85 in chips) 
Seat 6: Kihog ($100 in chips) 
Seat 7: rate8 ($100 in chips) 
Seat 8: roadster683 ($176.84 in chips) 
rate8: posts small blind $0.50
roadster683: posts big blind $1
lydia12345: sits out 
*** HOLE CARDS ***
Dealt to matiko09 [2c 4d]
matiko09: folds 
Vikulja1993: folds 
cobrik23: folds 
ipashutapkom: folds 
blufthenuts: folds 
Kihog: raises $1 to $2
rate8: folds 
roadster683: folds 
Uncalled bet ($1) returned to Kihog
Kihog collected $2.50 from pot
Kihog: doesn't show hand 
*** SUMMARY ***
Total pot $2.50 | Rake $0 
Seat 1: matiko09 folded before Flop (didn't bet)
Seat 2: Vikulja1993 folded before Flop (didn't bet)
Seat 3: cobrik23 folded before Flop (didn't bet)
Seat 4: ipashutapkom folded before Flop (didn't bet)
Seat 5: blufthenuts folded before Flop (didn't bet)
Seat 6: Kihog (button) collected ($2.50)
Seat 7: rate8 (small blind) folded before Flop
Seat 8: roadster683 (big blind) folded before Flop





PokerStars Hand #153503099874:  Hold'em No Limit ($0.50/$1.00 USD) - 2016/05/18 20:46:40 CET [2016/05/18 14:46:40 ET]
Table 'Tatjana III' 9-max Seat #2 is the button
Seat 1: cobrik23 ($175.35 in chips) 
Seat 2: HITYESCA ($152.58 in chips) 
Seat 3: matiko09 ($185.84 in chips) 
Seat 4: lydia12345 ($132.98 in chips) 
Seat 5: deadkiller1 ($111.94 in chips) 
Seat 7: rene1984tsv ($103.12 in chips) 
Seat 8: JACQUILF ($100 in chips) 
Seat 9: Moszes360 ($101.12 in chips) 
matiko09: posts small blind $0.50
lydia12345: posts big blind $1
Kihog: sits out 
cobrik23: posts small blind $0.50
*** HOLE CARDS ***
Dealt to matiko09 [6d Ks]
deadkiller1: raises $2 to $3
rene1984tsv: calls $3
JACQUILF: folds 
Moszes360: calls $3
cobrik23: folds 
HITYESCA: folds 
matiko09: folds 
lydia12345: folds 
*** FLOP *** [5s 7c Qh]
deadkiller1: checks 
rene1984tsv: checks 
Moszes360: bets $5.74
deadkiller1: folds 
rene1984tsv: folds 
Uncalled bet ($5.74) returned to Moszes360
Moszes360 collected $10.45 from pot
Moszes360: doesn't show hand 
*** SUMMARY ***
Total pot $11 | Rake $0.55 
Board [5s 7c Qh]
Seat 1: cobrik23 folded before Flop
Seat 2: HITYESCA (button) folded before Flop (didn't bet)
Seat 3: matiko09 (small blind) folded before Flop
Seat 4: lydia12345 (big blind) folded before Flop
Seat 5: deadkiller1 folded on the Flop
Seat 7: rene1984tsv folded on the Flop
Seat 8: JACQUILF folded before Flop (didn't bet)
Seat 9: Moszes360 collected ($10.45)





PokerStars Hand #153503104904:  Hold'em No Limit ($1/$2 USD) - 2016/05/18 20:46:46 CET [2016/05/18 14:46:46 ET]
Table 'Wild' 9-max Seat #8 is the button
Seat 1: Sharknebulah ($215.60 in chips) 
Seat 2: zigzag972 ($365.70 in chips) 
Seat 3: Momess ($242.01 in chips) 
Seat 4: hg1317 ($113.22 in chips) 
Seat 5: Ravnica11 ($79 in chips) 
Seat 6: tepi_guy ($239.44 in chips) 
Seat 7: matiko09 ($203 in chips) 
Seat 8: donald0404 ($249.25 in chips) 
Seat 9: Vikulja1993 ($204.50 in chips) 
Vikulja1993: posts small blind $1
Sharknebulah: posts big blind $2
*** HOLE CARDS ***
Dealt to matiko09 [7s 5d]
zigzag972: folds 
Momess: folds 
hg1317: folds 
Ravnica11: raises $2.40 to $4.40
tepi_guy: calls $4.40
matiko09: folds 
hg1317 leaves the table
chipiflautic joins the table at seat #4 
donald0404: folds 
Vikulja1993: folds 
Sharknebulah: folds 
*** FLOP *** [2s Qc 4h]
Ravnica11: checks 
tepi_guy: checks 
*** TURN *** [2s Qc 4h] [7h]
Ravnica11: checks 
tepi_guy: checks 
*** RIVER *** [2s Qc 4h 7h] [6c]
Ravnica11: checks 
tepi_guy: bets $11.21
Ravnica11: folds 
Uncalled bet ($11.21) returned to tepi_guy
tepi_guy collected $11.21 from pot
tepi_guy: doesn't show hand 
*** SUMMARY ***
Total pot $11.80 | Rake $0.59 
Board [2s Qc 4h 7h 6c]
Seat 1: Sharknebulah (big blind) folded before Flop
Seat 2: zigzag972 folded before Flop (didn't bet)
Seat 3: Momess folded before Flop (didn't bet)
Seat 4: hg1317 folded before Flop (didn't bet)
Seat 5: Ravnica11 folded on the River
Seat 6: tepi_guy collected ($11.21)
Seat 7: matiko09 folded before Flop (didn't bet)
Seat 8: donald0404 (button) folded before Flop (didn't bet)
Seat 9: Vikulja1993 (small blind) folded before Flop





PokerStars Hand #153503114894:  Hold'em No Limit (€0.50/€1.00 EUR) - 2016/05/18 20:46:58 CET [2016/05/18 14:46:58 ET]
Table 'Lamberta IV' 9-max Seat #3 is the button
Seat 1: Trompeneers (€60.26 in chips) 
Seat 2: TimStone (€100 in chips) 
Seat 3: JACQUILF (€100 in chips) 
Seat 4: matiko09 (€121.32 in chips) 
Seat 5: HomerrrJay (€100 in chips) 
Seat 6: Skum1986 (€100 in chips) 
Seat 7: vanilica (€100 in chips) 
Seat 8: lydia12345 (€101.50 in chips) 
Seat 9: Kihog (€112.95 in chips) 
matiko09: posts small blind €0.50
HomerrrJay: posts big blind €1
*** HOLE CARDS ***
Dealt to matiko09 [9c 5d]
Skum1986: folds 
vanilica: folds 
lydia12345: folds 
Kihog: raises €1.50 to €2.50
Trompeneers: folds 
TimStone: raises €6.60 to €9.10
JACQUILF: folds 
matiko09: folds 
HomerrrJay: folds 
Kihog: raises €12.90 to €22
TimStone: raises €78 to €100 and is all-in
Kihog: folds 
Uncalled bet (€78) returned to TimStone
TimStone collected €45.50 from pot
TimStone: doesn't show hand 
*** SUMMARY ***
Total pot €45.50 | Rake €0 
Seat 1: Trompeneers folded before Flop (didn't bet)
Seat 2: TimStone collected (€45.50)
Seat 3: JACQUILF (button) folded before Flop (didn't bet)
Seat 4: matiko09 (small blind) folded before Flop
Seat 5: HomerrrJay (big blind) folded before Flop
Seat 6: Skum1986 folded before Flop (didn't bet)
Seat 7: vanilica folded before Flop (didn't bet)
Seat 8: lydia12345 folded before Flop (didn't bet)
Seat 9: Kihog folded before Flop





PokerStars Hand #153503123865:  Hold'em No Limit ($0.50/$1.00 USD) - 2016/05/18 20:47:07 CET [2016/05/18 14:47:07 ET]
Table 'Suevia' 9-max Seat #1 is the button
Seat 1: Moszes360 ($107.50 in chips) 
Seat 2: deadkiller1 ($117.47 in chips) 
Seat 3: matiko09 ($103.22 in chips) 
Seat 4: HITYESCA ($100 in chips) 
Seat 5: bello1310 ($105.31 in chips) 
Seat 6: torkkdnm ($118.16 in chips) 
Seat 7: IRAVABAN ($40 in chips) 
Seat 8: ama58 ($46.08 in chips) 
Seat 9: oscarleon ($140.35 in chips) 
deadkiller1: posts small blind $0.50
matiko09: posts big blind $1
*** HOLE CARDS ***
Dealt to matiko09 [9h Kh]
HITYESCA: folds 
bello1310: folds 
torkkdnm: folds 
IRAVABAN: raises $2 to $3
ama58: folds 
oscarleon: folds 
Moszes360: folds 
deadkiller1: raises $6 to $9
matiko09: folds 
IRAVABAN: folds 
Uncalled bet ($6) returned to deadkiller1
deadkiller1 collected $7 from pot
deadkiller1: doesn't show hand 
*** SUMMARY ***
Total pot $7 | Rake $0 
Seat 1: Moszes360 (button) folded before Flop (didn't bet)
Seat 2: deadkiller1 (small blind) collected ($7)
Seat 3: matiko09 (big blind) folded before Flop
Seat 4: HITYESCA folded before Flop (didn't bet)
Seat 5: bello1310 folded before Flop (didn't bet)
Seat 6: torkkdnm folded before Flop (didn't bet)
Seat 7: IRAVABAN folded before Flop
Seat 8: ama58 folded before Flop (didn't bet)
Seat 9: oscarleon folded before Flop (didn't bet)





PokerStars Hand #153503123810:  Hold'em No Limit (€0.50/€1.00 EUR) - 2016/05/18 20:47:07 CET [2016/05/18 14:47:07 ET]
Table 'Pallas II' 9-max Seat #2 is the button
Seat 1: deadkiller1 (€105.50 in chips) 
Seat 2: matiko09 (€183.49 in chips) 
Seat 3: Vikulja1993 (€100 in chips) 
Seat 4: torkkdnm (€142.21 in chips) 
Seat 5: cobrik23 (€71.86 in chips) 
Seat 6: HITYESCA (€105.12 in chips) 
Seat 7: rate8 (€105.38 in chips) 
Seat 8: Kihog (€142.75 in chips) 
Seat 9: stijner1986 (€139.98 in chips) 
Vikulja1993: posts small blind €0.50
torkkdnm: posts big blind €1
*** HOLE CARDS ***
Dealt to matiko09 [9c 7c]
cobrik23: folds 
HITYESCA: folds 
rate8: folds 
Kihog: folds 
stijner1986: calls €1
deadkiller1: raises €3 to €4
matiko09: raises €8 to €12
Vikulja1993: folds 
torkkdnm: folds 
stijner1986: folds 
deadkiller1: folds 
Uncalled bet (€8) returned to matiko09
matiko09 collected €10.50 from pot
matiko09: doesn't show hand 
*** SUMMARY ***
Total pot €10.50 | Rake €0 
Seat 1: deadkiller1 folded before Flop
Seat 2: matiko09 (button) collected (€10.50)
Seat 3: Vikulja1993 (small blind) folded before Flop
Seat 4: torkkdnm (big blind) folded before Flop
Seat 5: cobrik23 folded before Flop (didn't bet)
Seat 6: HITYESCA folded before Flop (didn't bet)
Seat 7: rate8 folded before Flop (didn't bet)
Seat 8: Kihog folded before Flop (didn't bet)
Seat 9: stijner1986 folded before Flop





PokerStars Hand #153503140816:  Hold'em No Limit ($0.50/$1.00 USD) - 2016/05/18 20:47:27 CET [2016/05/18 14:47:27 ET]
Table 'Tatjana III' 9-max Seat #3 is the button
Seat 1: cobrik23 ($174.85 in chips) 
Seat 2: HITYESCA ($152.58 in chips) 
Seat 3: matiko09 ($185.34 in chips) 
Seat 4: lydia12345 ($131.98 in chips) 
Seat 5: deadkiller1 ($108.94 in chips) 
Seat 7: rene1984tsv ($100.12 in chips) 
Seat 8: JACQUILF ($100 in chips) 
Seat 9: Moszes360 ($108.57 in chips) 
lydia12345: posts small blind $0.50
deadkiller1: posts big blind $1
Kihog: sits out 
*** HOLE CARDS ***
Dealt to matiko09 [Jd 6s]
rene1984tsv: calls $1
JACQUILF: folds 
Moszes360: folds 
cobrik23: folds 
HITYESCA: folds 
matiko09: folds 
lydia12345: folds 
deadkiller1: checks 
*** FLOP *** [Qh 8d 7h]
deadkiller1: bets $2
rene1984tsv: calls $2
*** TURN *** [Qh 8d 7h] [2h]
deadkiller1: bets $4
rene1984tsv: raises $7.09 to $11.09
deadkiller1: folds 
Uncalled bet ($7.09) returned to rene1984tsv
rene1984tsv collected $13.78 from pot
rene1984tsv: shows [6d Ah] (high card Ace)
*** SUMMARY ***
Total pot $14.50 | Rake $0.72 
Board [Qh 8d 7h 2h]
Seat 1: cobrik23 folded before Flop (didn't bet)
Seat 2: HITYESCA folded before Flop (didn't bet)
Seat 3: matiko09 (button) folded before Flop (didn't bet)
Seat 4: lydia12345 (small blind) folded before Flop
Seat 5: deadkiller1 (big blind) folded on the Turn
Seat 7: rene1984tsv collected ($13.78)
Seat 8: JACQUILF folded before Flop (didn't bet)
Seat 9: Moszes360 folded before Flop (didn't bet)





PokerStars Hand #153503147746:  Hold'em No Limit ($0.50/$1.00 USD) - 2016/05/18 20:47:35 CET [2016/05/18 14:47:35 ET]
Table 'Abetti II' 9-max Seat #7 is the button
Seat 1: matiko09 ($101.50 in chips) 
Seat 2: Vikulja1993 ($100 in chips) 
Seat 3: cobrik23 ($131.46 in chips) 
Seat 4: ipashutapkom ($42.50 in chips) 
Seat 5: blufthenuts ($117.85 in chips) 
Seat 6: Kihog ($101.50 in chips) 
Seat 7: rate8 ($100 in chips) 
Seat 8: roadster683 ($175.84 in chips) 
Seat 9: lydia12345 ($261.45 in chips) 
roadster683: posts small blind $0.50
lydia12345: posts big blind $1
*** HOLE CARDS ***
Dealt to matiko09 [7s 2d]
matiko09: folds 
Vikulja1993: folds 
cobrik23: folds 
ipashutapkom: folds 
blufthenuts: folds 
Kihog: folds 
rate8: raises $1 to $2
roadster683: folds 
lydia12345: raises $7 to $9
rate8: calls $7
*** FLOP *** [Jc 5s 9c]
lydia12345: checks 
rate8: bets $9.14
lydia12345: raises $243.31 to $252.45 and is all-in
rate8: folds 
Uncalled bet ($243.31) returned to lydia12345
lydia12345 collected $34.94 from pot
*** SUMMARY ***
Total pot $36.78 | Rake $1.84 
Board [Jc 5s 9c]
Seat 1: matiko09 folded before Flop (didn't bet)
Seat 2: Vikulja1993 folded before Flop (didn't bet)
Seat 3: cobrik23 folded before Flop (didn't bet)
Seat 4: ipashutapkom folded before Flop (didn't bet)
Seat 5: blufthenuts folded before Flop (didn't bet)
Seat 6: Kihog folded before Flop (didn't bet)
Seat 7: rate8 (button) folded on the Flop
Seat 8: roadster683 (small blind) folded before Flop
Seat 9: lydia12345 (big blind) collected ($34.94)





PokerStars Hand #153503147562:  Hold'em No Limit ($0.50/$1.00 USD) - 2016/05/18 20:47:35 CET [2016/05/18 14:47:35 ET]
Table 'Kayala' 9-max Seat #8 is the button
Seat 1: deadkiller1 ($103.90 in chips) 
Seat 2: Oelie7 ($183.61 in chips) 
Seat 3: matiko09 ($100 in chips) 
Seat 4: HITYESCA ($100 in chips) 
Seat 5: rate8 ($104.12 in chips) 
Seat 7: kenan-lola ($45.19 in chips) 
Seat 8: cobrik23 ($83.54 in chips) 
Seat 9: Vikulja1993 ($102.76 in chips) 
Vikulja1993: posts small blind $0.50
deadkiller1: posts big blind $1
Strikerman25: sits out 
kenan-lola: posts big blind $1
*** HOLE CARDS ***
Dealt to matiko09 [Kd 8d]
Oelie7: folds 
matiko09: folds 
HITYESCA: folds 
rate8: folds 
kenan-lola: checks 
cobrik23: folds 
Vikulja1993: folds 
deadkiller1: checks 
*** FLOP *** [9d Ah As]
deadkiller1: checks 
kenan-lola: checks 
*** TURN *** [9d Ah As] [Th]
deadkiller1: bets $2
kenan-lola: folds 
Uncalled bet ($2) returned to deadkiller1
deadkiller1 collected $2.38 from pot
deadkiller1: doesn't show hand 
*** SUMMARY ***
Total pot $2.50 | Rake $0.12 
Board [9d Ah As Th]
Seat 1: deadkiller1 (big blind) collected ($2.38)
Seat 2: Oelie7 folded before Flop (didn't bet)
Seat 3: matiko09 folded before Flop (didn't bet)
Seat 4: HITYESCA folded before Flop (didn't bet)
Seat 5: rate8 folded before Flop (didn't bet)
Seat 7: kenan-lola folded on the Turn
Seat 8: cobrik23 (button) folded before Flop (didn't bet)
Seat 9: Vikulja1993 (small blind) folded before Flop





PokerStars Hand #153503151816:  Hold'em No Limit ($0.50/$1.00 USD) - 2016/05/18 20:47:39 CET [2016/05/18 14:47:39 ET]
Table 'Pandora' 9-max Seat #6 is the button
Seat 1: deadkiller1 ($143.41 in chips) 
Seat 2: fack_vi ($40 in chips) 
Seat 4: mooose100 ($137.87 in chips) 
Seat 6: Moszes360 ($109.95 in chips) 
Seat 8: matiko09 ($115.52 in chips) 
Seat 9: oscarleon ($112.98 in chips) 
torkkdnm will be allowed to play after the button
matiko09: posts small blind $0.50
oscarleon: posts big blind $1
vanilica: sits out 
Strikerman25: sits out 
*** HOLE CARDS ***
Dealt to matiko09 [8c 4s]
deadkiller1: folds 
fack_vi: folds 
mooose100: calls $1
Moszes360: folds 
matiko09: folds 
oscarleon: raises $3 to $4
mooose100: folds 
Uncalled bet ($3) returned to oscarleon
oscarleon collected $2.50 from pot
oscarleon: doesn't show hand 
*** SUMMARY ***
Total pot $2.50 | Rake $0 
Seat 1: deadkiller1 folded before Flop (didn't bet)
Seat 2: fack_vi folded before Flop (didn't bet)
Seat 4: mooose100 folded before Flop
Seat 6: Moszes360 (button) folded before Flop (didn't bet)
Seat 8: matiko09 (small blind) folded before Flop
Seat 9: oscarleon (big blind) collected ($2.50)





PokerStars Hand #153503170590:  Hold'em No Limit (€0.50/€1.00 EUR) - 2016/05/18 20:48:01 CET [2016/05/18 14:48:01 ET]
Table 'Lamberta IV' 9-max Seat #4 is the button
Seat 1: Trompeneers (€60.26 in chips) 
Seat 2: TimStone (€123.50 in chips) 
Seat 3: JACQUILF (€100 in chips) 
Seat 4: matiko09 (€120.82 in chips) 
Seat 5: HomerrrJay (€100 in chips) 
Seat 6: Skum1986 (€100 in chips) 
Seat 7: vanilica (€100 in chips) 
Seat 8: lydia12345 (€101.50 in chips) 
Seat 9: Kihog (€100 in chips) 
HomerrrJay: posts small blind €0.50
Skum1986: posts big blind €1
*** HOLE CARDS ***
Dealt to matiko09 [7d 9c]
vanilica: folds 
lydia12345: folds 
Kihog: folds 
Trompeneers: calls €1
TimStone: folds 
JACQUILF: raises €3 to €4
matiko09: folds 
HomerrrJay: folds 
Skum1986: folds 
Trompeneers: calls €3
*** FLOP *** [5h Kh Tc]
Trompeneers: checks 
JACQUILF: bets €5.41
Trompeneers: calls €5.41
*** TURN *** [5h Kh Tc] [2s]
Trompeneers: bets €1
JACQUILF: raises €14.91 to €15.91
Trompeneers: calls €14.91
*** RIVER *** [5h Kh Tc 2s] [4h]
Trompeneers: bets €34.94 and is all-in
JACQUILF: folds 
Uncalled bet (€34.94) returned to Trompeneers
Trompeneers collected €49.89 from pot
*** SUMMARY ***
Total pot €52.14 | Rake €2.25 
Board [5h Kh Tc 2s 4h]
Seat 1: Trompeneers collected (€49.89)
Seat 2: TimStone folded before Flop (didn't bet)
Seat 3: JACQUILF folded on the River
Seat 4: matiko09 (button) folded before Flop (didn't bet)
Seat 5: HomerrrJay (small blind) folded before Flop
Seat 6: Skum1986 (big blind) folded before Flop
Seat 7: vanilica folded before Flop (didn't bet)
Seat 8: lydia12345 folded before Flop (didn't bet)
Seat 9: Kihog folded before Flop (didn't bet)





PokerStars Hand #153503172596:  Hold'em No Limit ($0.50/$1.00 USD) - 2016/05/18 20:48:03 CET [2016/05/18 14:48:03 ET]
Table 'Suevia' 9-max Seat #2 is the button
Seat 1: Moszes360 ($107.50 in chips) 
Seat 2: deadkiller1 ($121.47 in chips) 
Seat 3: matiko09 ($102.22 in chips) 
Seat 4: HITYESCA ($100 in chips) 
Seat 5: bello1310 ($105.31 in chips) 
Seat 6: torkkdnm ($118.16 in chips) 
Seat 7: IRAVABAN ($40 in chips) 
Seat 8: ama58 ($46.08 in chips) 
Seat 9: oscarleon ($140.35 in chips) 
matiko09: posts small blind $0.50
HITYESCA: posts big blind $1
*** HOLE CARDS ***
Dealt to matiko09 [Ac Kd]
bello1310: folds 
torkkdnm: folds 
IRAVABAN: folds 
ama58: folds 
oscarleon: folds 
Moszes360: folds 
deadkiller1: folds 
matiko09: raises $1.50 to $2.50
HITYESCA: raises $5.50 to $8
matiko09: raises $10 to $18
HITYESCA: calls $10
*** FLOP *** [8h Ks 9s]
matiko09: bets $18
HITYESCA: calls $18
*** TURN *** [8h Ks 9s] [7s]
matiko09: bets $45.18
HITYESCA: folds 
Uncalled bet ($45.18) returned to matiko09
matiko09 collected $69.50 from pot
matiko09: doesn't show hand 
*** SUMMARY ***
Total pot $72 | Rake $2.50 
Board [8h Ks 9s 7s]
Seat 1: Moszes360 folded before Flop (didn't bet)
Seat 2: deadkiller1 (button) folded before Flop (didn't bet)
Seat 3: matiko09 (small blind) collected ($69.50)
Seat 4: HITYESCA (big blind) folded on the Turn
Seat 5: bello1310 folded before Flop (didn't bet)
Seat 6: torkkdnm folded before Flop (didn't bet)
Seat 7: IRAVABAN folded before Flop (didn't bet)
Seat 8: ama58 folded before Flop (didn't bet)
Seat 9: oscarleon folded before Flop (didn't bet)





PokerStars Hand #153503174756:  Hold'em No Limit ($0.50/$1.00 USD) - 2016/05/18 20:48:06 CET [2016/05/18 14:48:06 ET]
Table 'Samitchell II' 9-max Seat #5 is the button
Seat 1: riggedsh** ($100 in chips) 
Seat 3: vanilica ($101.50 in chips) 
Seat 4: TimStone ($100 in chips) 
Seat 5: nuuaber ($113.69 in chips) 
Seat 6: Strikerman25 ($39 in chips) 
Seat 7: matiko09 ($100 in chips) 
Seat 8: rate8 ($138.52 in chips) 
Seat 9: HomerrrJay ($100 in chips) 
Strikerman25: posts small blind $0.50
matiko09: posts big blind $1
*** HOLE CARDS ***
Dealt to matiko09 [2s Kc]
rate8: folds 
HomerrrJay: folds 
riggedsh**: folds 
vanilica: folds 
TimStone: folds 
nuuaber: folds 
Strikerman25: folds 
Uncalled bet ($0.50) returned to matiko09
matiko09 collected $1 from pot
matiko09: doesn't show hand 
*** SUMMARY ***
Total pot $1 | Rake $0 
Seat 1: riggedsh** folded before Flop (didn't bet)
Seat 3: vanilica folded before Flop (didn't bet)
Seat 4: TimStone folded before Flop (didn't bet)
Seat 5: nuuaber (button) folded before Flop (didn't bet)
Seat 6: Strikerman25 (small blind) folded before Flop
Seat 7: matiko09 (big blind) collected ($1)
Seat 8: rate8 folded before Flop (didn't bet)
Seat 9: HomerrrJay folded before Flop (didn't bet)





PokerStars Hand #153503178515:  Hold'em No Limit ($1/$2 USD) - 2016/05/18 20:48:10 CET [2016/05/18 14:48:10 ET]
Table 'Wild' 9-max Seat #9 is the button
Seat 1: Sharknebulah ($213.60 in chips) 
Seat 2: zigzag972 ($365.70 in chips) 
Seat 3: Momess ($242.01 in chips) 
Seat 5: Ravnica11 ($74.60 in chips) 
Seat 6: tepi_guy ($246.25 in chips) 
Seat 7: matiko09 ($203 in chips) 
Seat 8: donald0404 ($249.25 in chips) 
Seat 9: Vikulja1993 ($203.50 in chips) 
Sharknebulah: posts small blind $1
zigzag972: posts big blind $2
chipiflautic: sits out 
*** HOLE CARDS ***
Dealt to matiko09 [3d 4h]
Momess: folds 
Ravnica11: folds 
tepi_guy: folds 
matiko09: folds 
donald0404: folds 
Vikulja1993: folds 
Sharknebulah: folds 
Uncalled bet ($1) returned to zigzag972
zigzag972 collected $2 from pot
zigzag972: doesn't show hand 
*** SUMMARY ***
Total pot $2 | Rake $0 
Seat 1: Sharknebulah (small blind) folded before Flop
Seat 2: zigzag972 (big blind) collected ($2)
Seat 3: Momess folded before Flop (didn't bet)
Seat 5: Ravnica11 folded before Flop (didn't bet)
Seat 6: tepi_guy folded before Flop (didn't bet)
Seat 7: matiko09 folded before Flop (didn't bet)
Seat 8: donald0404 folded before Flop (didn't bet)
Seat 9: Vikulja1993 (button) folded before Flop (didn't bet)





PokerStars Hand #153503183265:  Hold'em No Limit ($0.50/$1.00 USD) - 2016/05/18 20:48:15 CET [2016/05/18 14:48:15 ET]
Table 'Pandora' 9-max Seat #8 is the button
Seat 1: deadkiller1 ($143.41 in chips) 
Seat 2: fack_vi ($40 in chips) 
Seat 4: mooose100 ($136.87 in chips) 
Seat 6: Moszes360 ($109.95 in chips) 
Seat 8: matiko09 ($115.02 in chips) 
Seat 9: oscarleon ($114.48 in chips) 
oscarleon: posts small blind $0.50
deadkiller1: posts big blind $1
vanilica: sits out 
Strikerman25: sits out 
torkkdnm: sits out 
*** HOLE CARDS ***
Dealt to matiko09 [3h Qd]
fack_vi: folds 
mooose100: raises $2 to $3
Moszes360: folds 
matiko09: folds 
oscarleon: folds 
deadkiller1: folds 
Uncalled bet ($2) returned to mooose100
mooose100 collected $2.50 from pot
mooose100: doesn't show hand 
*** SUMMARY ***
Total pot $2.50 | Rake $0 
Seat 1: deadkiller1 (big blind) folded before Flop
Seat 2: fack_vi folded before Flop (didn't bet)
Seat 4: mooose100 collected ($2.50)
Seat 6: Moszes360 folded before Flop (didn't bet)
Seat 8: matiko09 (button) folded before Flop (didn't bet)
Seat 9: oscarleon (small blind) folded before Flop





PokerStars Hand #153503183544:  Hold'em No Limit ($0.50/$1.00 USD) - 2016/05/18 20:48:16 CET [2016/05/18 14:48:16 ET]
Table 'Kayala' 9-max Seat #9 is the button
Seat 1: deadkiller1 ($105.28 in chips) 
Seat 2: Oelie7 ($183.61 in chips) 
Seat 3: matiko09 ($100 in chips) 
Seat 4: HITYESCA ($100 in chips) 
Seat 5: rate8 ($104.12 in chips) 
Seat 7: kenan-lola ($84.19 in chips) 
Seat 8: cobrik23 ($83.54 in chips) 
Seat 9: Vikulja1993 ($102.26 in chips) 
deadkiller1: posts small blind $0.50
Oelie7: posts big blind $1
Strikerman25: sits out 
*** HOLE CARDS ***
Dealt to matiko09 [7c Kc]
matiko09: folds 
HITYESCA: folds 
rate8: folds 
kenan-lola: raises $1 to $2
cobrik23: raises $6 to $8
Vikulja1993: folds 
deadkiller1: folds 
Oelie7: folds 
kenan-lola: calls $6
*** FLOP *** [3h 5d Ah]
Oelie7 leaves the table
kenan-lola: checks 
cobrik23: bets $7
kenan-lola: folds 
Uncalled bet ($7) returned to cobrik23
cobrik23 collected $16.62 from pot
cobrik23: doesn't show hand 
*** SUMMARY ***
Total pot $17.50 | Rake $0.88 
Board [3h 5d Ah]
Seat 1: deadkiller1 (small blind) folded before Flop
Seat 2: Oelie7 (big blind) folded before Flop
Seat 3: matiko09 folded before Flop (didn't bet)
Seat 4: HITYESCA folded before Flop (didn't bet)
Seat 5: rate8 folded before Flop (didn't bet)
Seat 7: kenan-lola folded on the Flop
Seat 8: cobrik23 collected ($16.62)
Seat 9: Vikulja1993 (button) folded before Flop (didn't bet)





PokerStars Hand #153503185265:  Hold'em No Limit (€0.50/€1.00 EUR) - 2016/05/18 20:48:18 CET [2016/05/18 14:48:18 ET]
Table 'Pallas II' 9-max Seat #3 is the button
Seat 1: deadkiller1 (€101.50 in chips) 
Seat 2: matiko09 (€189.99 in chips) 
Seat 3: Vikulja1993 (€100 in chips) 
Seat 4: torkkdnm (€141.21 in chips) 
Seat 5: cobrik23 (€71.86 in chips) 
Seat 6: HITYESCA (€105.12 in chips) 
Seat 7: rate8 (€105.38 in chips) 
Seat 8: Kihog (€142.75 in chips) 
Seat 9: stijner1986 (€138.98 in chips) 
torkkdnm: posts small blind €0.50
cobrik23: posts big blind €1
*** HOLE CARDS ***
Dealt to matiko09 [5s Jh]
HITYESCA: folds 
rate8: folds 
Kihog: raises €1.50 to €2.50
stijner1986: folds 
deadkiller1: folds 
matiko09: folds 
Vikulja1993: raises €5.50 to €8
torkkdnm: folds 
cobrik23: folds 
Kihog: raises €12 to €20
Vikulja1993: calls €12
*** FLOP *** [2c 5h 4h]
Kihog: checks 
Vikulja1993: bets €11.50
Kihog: raises €16 to €27.50
Vikulja1993: folds 
Uncalled bet (€16) returned to Kihog
Kihog collected €62.25 from pot
Kihog: doesn't show hand 
*** SUMMARY ***
Total pot €64.50 | Rake €2.25 
Board [2c 5h 4h]
Seat 1: deadkiller1 folded before Flop (didn't bet)
Seat 2: matiko09 folded before Flop (didn't bet)
Seat 3: Vikulja1993 (button) folded on the Flop
Seat 4: torkkdnm (small blind) folded before Flop
Seat 5: cobrik23 (big blind) folded before Flop
Seat 6: HITYESCA folded before Flop (didn't bet)
Seat 7: rate8 folded before Flop (didn't bet)
Seat 8: Kihog collected (€62.25)
Seat 9: stijner1986 folded before Flop (didn't bet)





PokerStars Hand #153503186575:  Hold'em No Limit ($0.50/$1.00 USD) - 2016/05/18 20:48:19 CET [2016/05/18 14:48:19 ET]
Table 'Tatjana III' 9-max Seat #4 is the button
Seat 1: cobrik23 ($174.85 in chips) 
Seat 2: HITYESCA ($152.58 in chips) 
Seat 3: matiko09 ($185.34 in chips) 
Seat 4: lydia12345 ($131.48 in chips) 
Seat 5: deadkiller1 ($101.94 in chips) 
Seat 6: Kihog ($100 in chips) 
Seat 7: rene1984tsv ($106.90 in chips) 
Seat 8: JACQUILF ($100 in chips) 
Seat 9: Moszes360 ($108.57 in chips) 
deadkiller1: posts small blind $0.50
Kihog: posts big blind $1
*** HOLE CARDS ***
Dealt to matiko09 [6d Ts]
rene1984tsv: calls $1
JACQUILF: folds 
Moszes360: folds 
cobrik23: folds 
HITYESCA: folds 
matiko09: folds 
lydia12345: folds 
deadkiller1: folds 
Kihog: checks 
*** FLOP *** [9d 6s Jh]
Kihog: checks 
rene1984tsv: bets $1
Kihog: folds 
Uncalled bet ($1) returned to rene1984tsv
rene1984tsv collected $2.38 from pot
*** SUMMARY ***
Total pot $2.50 | Rake $0.12 
Board [9d 6s Jh]
Seat 1: cobrik23 folded before Flop (didn't bet)
Seat 2: HITYESCA folded before Flop (didn't bet)
Seat 3: matiko09 folded before Flop (didn't bet)
Seat 4: lydia12345 (button) folded before Flop (didn't bet)
Seat 5: deadkiller1 (small blind) folded before Flop
Seat 6: Kihog (big blind) folded on the Flop
Seat 7: rene1984tsv collected ($2.38)
Seat 8: JACQUILF folded before Flop (didn't bet)
Seat 9: Moszes360 folded before Flop (didn't bet)





PokerStars Hand #153503198339:  Hold'em No Limit ($0.50/$1.00 USD) - 2016/05/18 20:48:33 CET [2016/05/18 14:48:33 ET]
Table 'Samitchell II' 9-max Seat #6 is the button
Seat 1: riggedsh** ($100 in chips) 
Seat 3: vanilica ($101.50 in chips) 
Seat 4: TimStone ($100 in chips) 
Seat 5: nuuaber ($113.69 in chips) 
Seat 6: Strikerman25 ($38.50 in chips) 
Seat 7: matiko09 ($100.50 in chips) 
Seat 8: rate8 ($138.52 in chips) 
Seat 9: HomerrrJay ($100 in chips) 
matiko09: posts small blind $0.50
rate8: posts big blind $1
*** HOLE CARDS ***
Dealt to matiko09 [8c 5h]
HomerrrJay: folds 
riggedsh**: folds 
vanilica: folds 
TimStone: folds 
nuuaber: raises $1 to $2
Strikerman25: folds 
cobrik23 joins the table at seat #2 
matiko09: folds 
rate8: folds 
Uncalled bet ($1) returned to nuuaber
nuuaber collected $2.50 from pot
nuuaber: doesn't show hand 
*** SUMMARY ***
Total pot $2.50 | Rake $0 
Seat 1: riggedsh** folded before Flop (didn't bet)
Seat 3: vanilica folded before Flop (didn't bet)
Seat 4: TimStone folded before Flop (didn't bet)
Seat 5: nuuaber collected ($2.50)
Seat 6: Strikerman25 (button) folded before Flop (didn't bet)
Seat 7: matiko09 (small blind) folded before Flop
Seat 8: rate8 (big blind) folded before Flop
Seat 9: HomerrrJay folded before Flop (didn't bet)





PokerStars Hand #153503202327:  Hold'em No Limit ($1/$2 USD) - 2016/05/18 20:48:37 CET [2016/05/18 14:48:37 ET]
Table 'Wild' 9-max Seat #1 is the button
Seat 1: Sharknebulah ($212.60 in chips) 
Seat 2: zigzag972 ($366.70 in chips) 
Seat 3: Momess ($242.01 in chips) 
Seat 5: Ravnica11 ($74.60 in chips) 
Seat 6: tepi_guy ($246.25 in chips) 
Seat 7: matiko09 ($203 in chips) 
Seat 8: donald0404 ($249.25 in chips) 
Seat 9: Vikulja1993 ($203.50 in chips) 
zigzag972: posts small blind $1
Momess: posts big blind $2
chipiflautic: sits out 
*** HOLE CARDS ***
Dealt to matiko09 [Jc 9d]
Ravnica11: folds 
tepi_guy: folds 
matiko09: folds 
donald0404: folds 
Vikulja1993: raises $3 to $5
Sharknebulah: raises $13 to $18
zigzag972: folds 
Momess: folds 
Vikulja1993: raises $24 to $42
Sharknebulah: folds 
Uncalled bet ($24) returned to Vikulja1993
Vikulja1993 collected $39 from pot
Vikulja1993: doesn't show hand 
*** SUMMARY ***
Total pot $39 | Rake $0 
Seat 1: Sharknebulah (button) folded before Flop
Seat 2: zigzag972 (small blind) folded before Flop
Seat 3: Momess (big blind) folded before Flop
Seat 5: Ravnica11 folded before Flop (didn't bet)
Seat 6: tepi_guy folded before Flop (didn't bet)
Seat 7: matiko09 folded before Flop (didn't bet)
Seat 8: donald0404 folded before Flop (didn't bet)
Seat 9: Vikulja1993 collected ($39)





PokerStars Hand #153503208151:  Hold'em No Limit ($0.50/$1.00 USD) - 2016/05/18 20:48:44 CET [2016/05/18 14:48:44 ET]
Table 'Abetti II' 9-max Seat #8 is the button
Seat 1: matiko09 ($101.50 in chips) 
Seat 2: Vikulja1993 ($100 in chips) 
Seat 3: cobrik23 ($131.46 in chips) 
Seat 4: ipashutapkom ($42.50 in chips) 
Seat 5: blufthenuts ($117.85 in chips) 
Seat 6: Kihog ($101.50 in chips) 
Seat 7: rate8 ($100 in chips) 
Seat 8: roadster683 ($175.34 in chips) 
Seat 9: lydia12345 ($278.25 in chips) 
lydia12345: posts small blind $0.50
matiko09: posts big blind $1
*** HOLE CARDS ***
Dealt to matiko09 [9h 9d]
Vikulja1993: folds 
cobrik23: folds 
ipashutapkom: folds 
blufthenuts: raises $2 to $3
Kihog: folds 
rate8: folds 
roadster683: calls $3
lydia12345: folds 
matiko09: calls $2
*** FLOP *** [4h 7h 5h]
matiko09: bets $5.86
blufthenuts: folds 
roadster683: folds 
Uncalled bet ($5.86) returned to matiko09
matiko09 collected $9.02 from pot
matiko09: doesn't show hand 
*** SUMMARY ***
Total pot $9.50 | Rake $0.48 
Board [4h 7h 5h]
Seat 1: matiko09 (big blind) collected ($9.02)
Seat 2: Vikulja1993 folded before Flop (didn't bet)
Seat 3: cobrik23 folded before Flop (didn't bet)
Seat 4: ipashutapkom folded before Flop (didn't bet)
Seat 5: blufthenuts folded on the Flop
Seat 6: Kihog folded before Flop (didn't bet)
Seat 7: rate8 folded before Flop (didn't bet)
Seat 8: roadster683 (button) folded on the Flop
Seat 9: lydia12345 (small blind) folded before Flop





PokerStars Hand #153503212610:  Hold'em No Limit ($0.50/$1.00 USD) - 2016/05/18 20:48:49 CET [2016/05/18 14:48:49 ET]
Table 'Pandora' 9-max Seat #9 is the button
Seat 1: deadkiller1 ($142.41 in chips) 
Seat 2: fack_vi ($40 in chips) 
Seat 4: mooose100 ($138.37 in chips) 
Seat 6: Moszes360 ($109.95 in chips) 
Seat 8: matiko09 ($115.02 in chips) 
Seat 9: oscarleon ($113.98 in chips) 
deadkiller1: posts small blind $0.50
fack_vi: posts big blind $1
vanilica: sits out 
Strikerman25: sits out 
torkkdnm: sits out 
*** HOLE CARDS ***
Dealt to matiko09 [3d 8s]
mooose100: calls $1
Moszes360: raises $3 to $4
matiko09: folds 
oscarleon: calls $4
deadkiller1: calls $3.50
fack_vi: calls $3
mooose100: calls $3
*** FLOP *** [2d 3c Qh]
deadkiller1: checks 
fack_vi: checks 
mooose100: bets $19
Moszes360: folds 
oscarleon: folds 
deadkiller1: folds 
fack_vi: raises $17 to $36 and is all-in
mooose100: calls $17
*** TURN *** [2d 3c Qh] [2s]
*** RIVER *** [2d 3c Qh 2s] [8h]
*** SHOW DOWN ***
fack_vi: shows [Ks Qs] (two pair, Queens and Deuces)
mooose100: shows [8c Qc] (two pair, Queens and Eights)
mooose100 collected $89.50 from pot
*** SUMMARY ***
Total pot $92 | Rake $2.50 
Board [2d 3c Qh 2s 8h]
Seat 1: deadkiller1 (small blind) folded on the Flop
Seat 2: fack_vi (big blind) showed [Ks Qs] and lost with two pair, Queens and Deuces
Seat 4: mooose100 showed [8c Qc] and won ($89.50) with two pair, Queens and Eights
Seat 6: Moszes360 folded on the Flop
Seat 8: matiko09 folded before Flop (didn't bet)
Seat 9: oscarleon (button) folded on the Flop





PokerStars Hand #153503221959:  Hold'em No Limit ($0.50/$1.00 USD) - 2016/05/18 20:49:00 CET [2016/05/18 14:49:00 ET]
Table 'Kayala' 9-max Seat #1 is the button
Seat 1: deadkiller1 ($104.78 in chips) 
Seat 3: matiko09 ($100 in chips) 
Seat 4: HITYESCA ($100 in chips) 
Seat 5: rate8 ($104.12 in chips) 
Seat 7: kenan-lola ($76.19 in chips) 
Seat 8: cobrik23 ($92.16 in chips) 
Seat 9: Vikulja1993 ($102.26 in chips) 
matiko09: posts small blind $0.50
HITYESCA: posts big blind $1
Strikerman25: sits out 
*** HOLE CARDS ***
Dealt to matiko09 [Td Ah]
rate8: raises $2 to $3
kenan-lola: folds 
cobrik23: folds 
Vikulja1993: folds 
deadkiller1: folds 
matiko09: folds 
HITYESCA: folds 
Uncalled bet ($2) returned to rate8
rate8 collected $2.50 from pot
*** SUMMARY ***
Total pot $2.50 | Rake $0 
Seat 1: deadkiller1 (button) folded before Flop (didn't bet)
Seat 3: matiko09 (small blind) folded before Flop
Seat 4: HITYESCA (big blind) folded before Flop
Seat 5: rate8 collected ($2.50)
Seat 7: kenan-lola folded before Flop (didn't bet)
Seat 8: cobrik23 folded before Flop (didn't bet)
Seat 9: Vikulja1993 folded before Flop (didn't bet)





PokerStars Hand #153503237405:  Hold'em No Limit ($0.50/$1.00 USD) - 2016/05/18 20:49:18 CET [2016/05/18 14:49:18 ET]
Table 'Kayala' 9-max Seat #3 is the button
Seat 1: deadkiller1 ($104.78 in chips) 
Seat 3: matiko09 ($100 in chips) 
Seat 4: HITYESCA ($100 in chips) 
Seat 5: rate8 ($105.62 in chips) 
Seat 7: kenan-lola ($76.19 in chips) 
Seat 8: cobrik23 ($92.16 in chips) 
Seat 9: Vikulja1993 ($102.26 in chips) 
HITYESCA: posts small blind $0.50
rate8: posts big blind $1
Strikerman25: sits out 
*** HOLE CARDS ***
Dealt to matiko09 [Kc 5s]
kenan-lola: raises $2 to $3
cobrik23: raises $6 to $9
Vikulja1993: calls $9
deadkiller1: folds 
matiko09: folds 
HITYESCA: folds 
rate8: folds 
kenan-lola: calls $6
*** FLOP *** [3c 6s As]
kenan-lola: checks 
vanilica joins the table at seat #2 
vanilica leaves the table
cobrik23: checks 
Vikulja1993: checks 
*** TURN *** [3c 6s As] [4c]
kenan-lola: bets $9
cobrik23: calls $9
Vikulja1993: folds 
*** RIVER *** [3c 6s As 4c] [Qs]
solbi86 joins the table at seat #2 
kenan-lola: checks 
cobrik23: bets $30
kenan-lola: folds 
Uncalled bet ($30) returned to cobrik23
cobrik23 collected $44.18 from pot
cobrik23: doesn't show hand 
*** SUMMARY ***
Total pot $46.50 | Rake $2.32 
Board [3c 6s As 4c Qs]
Seat 1: deadkiller1 folded before Flop (didn't bet)
Seat 3: matiko09 (button) folded before Flop (didn't bet)
Seat 4: HITYESCA (small blind) folded before Flop
Seat 5: rate8 (big blind) folded before Flop
Seat 7: kenan-lola folded on the River
Seat 8: cobrik23 collected ($44.18)
Seat 9: Vikulja1993 folded on the Turn





PokerStars Hand #153503238258:  Hold'em No Limit ($0.50/$1.00 USD) - 2016/05/18 20:49:19 CET [2016/05/18 14:49:19 ET]
Table 'Suevia' 9-max Seat #3 is the button
Seat 1: Moszes360 ($107.50 in chips) 
Seat 2: deadkiller1 ($121.47 in chips) 
Seat 3: matiko09 ($135.72 in chips) 
Seat 4: HITYESCA ($100 in chips) 
Seat 5: bello1310 ($105.31 in chips) 
Seat 6: torkkdnm ($118.16 in chips) 
Seat 7: IRAVABAN ($40 in chips) 
Seat 8: ama58 ($46.08 in chips) 
Seat 9: oscarleon ($140.35 in chips) 
HITYESCA: posts small blind $0.50
bello1310: posts big blind $1
*** HOLE CARDS ***
Dealt to matiko09 [Kh 2d]
torkkdnm: folds 
IRAVABAN: folds 
ama58: folds 
oscarleon: folds 
Moszes360: folds 
deadkiller1: raises $1.50 to $2.50
matiko09: folds 
HITYESCA: folds 
bello1310: folds 
Uncalled bet ($1.50) returned to deadkiller1
deadkiller1 collected $2.50 from pot
deadkiller1: doesn't show hand 
*** SUMMARY ***
Total pot $2.50 | Rake $0 
Seat 1: Moszes360 folded before Flop (didn't bet)
Seat 2: deadkiller1 collected ($2.50)
Seat 3: matiko09 (button) folded before Flop (didn't bet)
Seat 4: HITYESCA (small blind) folded before Flop
Seat 5: bello1310 (big blind) folded before Flop
Seat 6: torkkdnm folded before Flop (didn't bet)
Seat 7: IRAVABAN folded before Flop (didn't bet)
Seat 8: ama58 folded before Flop (didn't bet)
Seat 9: oscarleon folded before Flop (didn't bet)





PokerStars Hand #153503242843:  Hold'em No Limit ($0.50/$1.00 USD) - 2016/05/18 20:49:24 CET [2016/05/18 14:49:24 ET]
Table 'Tatjana III' 9-max Seat #5 is the button
Seat 1: cobrik23 ($174.85 in chips) 
Seat 2: HITYESCA ($152.58 in chips) 
Seat 3: matiko09 ($185.34 in chips) 
Seat 4: lydia12345 ($131.48 in chips) 
Seat 5: deadkiller1 ($101.44 in chips) 
Seat 6: Kihog ($100 in chips) 
Seat 7: rene1984tsv ($108.28 in chips) 
Seat 8: JACQUILF ($100 in chips) 
Seat 9: Moszes360 ($108.57 in chips) 
Kihog: posts small blind $0.50
rene1984tsv: posts big blind $1
*** HOLE CARDS ***
Dealt to matiko09 [Ah 3d]
JACQUILF: folds 
Moszes360: folds 
cobrik23: raises $3 to $4
HITYESCA: folds 
matiko09: folds 
lydia12345: folds 
deadkiller1: folds 
Kihog: folds 
rene1984tsv: calls $3
*** FLOP *** [Qh Ac 9d]
rene1984tsv: checks 
cobrik23: checks 
*** TURN *** [Qh Ac 9d] [Th]
rene1984tsv: bets $1
cobrik23: raises $9 to $10
rene1984tsv: folds 
Uncalled bet ($9) returned to cobrik23
cobrik23 collected $9.98 from pot
cobrik23: doesn't show hand 
*** SUMMARY ***
Total pot $10.50 | Rake $0.52 
Board [Qh Ac 9d Th]
Seat 1: cobrik23 collected ($9.98)
Seat 2: HITYESCA folded before Flop (didn't bet)
Seat 3: matiko09 folded before Flop (didn't bet)
Seat 4: lydia12345 folded before Flop (didn't bet)
Seat 5: deadkiller1 (button) folded before Flop (didn't bet)
Seat 6: Kihog (small blind) folded before Flop
Seat 7: rene1984tsv (big blind) folded on the Turn
Seat 8: JACQUILF folded before Flop (didn't bet)
Seat 9: Moszes360 folded before Flop (didn't bet)





PokerStars Hand #153503257164:  Hold'em No Limit ($0.50/$1.00 USD) - 2016/05/18 20:49:40 CET [2016/05/18 14:49:40 ET]
Table 'Samitchell II' 9-max Seat #7 is the button
Seat 1: riggedsh** ($100 in chips) 
Seat 3: vanilica ($101.50 in chips) 
Seat 4: TimStone ($100 in chips) 
Seat 5: nuuaber ($115.19 in chips) 
Seat 6: Strikerman25 ($38.50 in chips) 
Seat 7: matiko09 ($100 in chips) 
Seat 8: rate8 ($137.52 in chips) 
rate8: posts small blind $0.50
HomerrrJay: is sitting out 
riggedsh**: posts big blind $1
cobrik23: sits out 
*** HOLE CARDS ***
Dealt to matiko09 [5s 3s]
vanilica: raises $2 to $3
HomerrrJay leaves the table
TimStone: folds 
nuuaber: raises $3 to $6
Strikerman25: folds 
matiko09: folds 
rate8: folds 
riggedsh**: folds 
vanilica: raises $15 to $21
nuuaber: folds 
Uncalled bet ($15) returned to vanilica
vanilica collected $13.50 from pot
vanilica: doesn't show hand 
*** SUMMARY ***
Total pot $13.50 | Rake $0 
Seat 1: riggedsh** (big blind) folded before Flop
Seat 3: vanilica collected ($13.50)
Seat 4: TimStone folded before Flop (didn't bet)
Seat 5: nuuaber folded before Flop
Seat 6: Strikerman25 folded before Flop (didn't bet)
Seat 7: matiko09 (button) folded before Flop (didn't bet)
Seat 8: rate8 (small blind) folded before Flop





PokerStars Hand #153503260138:  Hold'em No Limit ($0.50/$1.00 USD) - 2016/05/18 20:49:43 CET [2016/05/18 14:49:43 ET]
Table 'Suevia' 9-max Seat #4 is the button
Seat 1: Moszes360 ($107.50 in chips) 
Seat 2: deadkiller1 ($122.97 in chips) 
Seat 3: matiko09 ($135.72 in chips) 
Seat 4: HITYESCA ($100 in chips) 
Seat 5: bello1310 ($104.31 in chips) 
Seat 6: torkkdnm ($118.16 in chips) 
Seat 7: IRAVABAN ($40 in chips) 
Seat 8: ama58 ($46.08 in chips) 
Seat 9: oscarleon ($140.35 in chips) 
bello1310: posts small blind $0.50
torkkdnm: posts big blind $1
*** HOLE CARDS ***
Dealt to matiko09 [6d Ac]
IRAVABAN: folds 
ama58: folds 
oscarleon: folds 
Moszes360: folds 
deadkiller1: raises $2 to $3
matiko09: folds 
HITYESCA: folds 
bello1310: folds 
torkkdnm: folds 
Uncalled bet ($2) returned to deadkiller1
deadkiller1 collected $2.50 from pot
deadkiller1: doesn't show hand 
*** SUMMARY ***
Total pot $2.50 | Rake $0 
Seat 1: Moszes360 folded before Flop (didn't bet)
Seat 2: deadkiller1 collected ($2.50)
Seat 3: matiko09 folded before Flop (didn't bet)
Seat 4: HITYESCA (button) folded before Flop (didn't bet)
Seat 5: bello1310 (small blind) folded before Flop
Seat 6: torkkdnm (big blind) folded before Flop
Seat 7: IRAVABAN folded before Flop (didn't bet)
Seat 8: ama58 folded before Flop (didn't bet)
Seat 9: oscarleon folded before Flop (didn't bet)





PokerStars Hand #153503262407:  Hold'em No Limit ($0.50/$1.00 USD) - 2016/05/18 20:49:46 CET [2016/05/18 14:49:46 ET]
Table 'Abetti II' 9-max Seat #9 is the button
Seat 1: matiko09 ($107.52 in chips) 
Seat 2: Vikulja1993 ($100 in chips) 
Seat 3: cobrik23 ($131.46 in chips) 
Seat 4: ipashutapkom ($42.50 in chips) 
Seat 5: blufthenuts ($114.85 in chips) 
Seat 6: Kihog ($101.50 in chips) 
Seat 7: rate8 ($100 in chips) 
Seat 8: roadster683 ($172.34 in chips) 
Seat 9: lydia12345 ($277.75 in chips) 
matiko09: posts small blind $0.50
Vikulja1993: posts big blind $1
*** HOLE CARDS ***
Dealt to matiko09 [7d 8d]
cobrik23: raises $3 to $4
ipashutapkom: folds 
blufthenuts: folds 
Kihog: folds 
rate8: folds 
roadster683: calls $4
lydia12345: folds 
matiko09: folds 
Vikulja1993: folds 
*** FLOP *** [Tc Th 2s]
cobrik23: bets $5
roadster683: calls $5
*** TURN *** [Tc Th 2s] [7h]
cobrik23: bets $12.34
roadster683: folds 
Uncalled bet ($12.34) returned to cobrik23
cobrik23 collected $18.52 from pot
cobrik23: doesn't show hand 
*** SUMMARY ***
Total pot $19.50 | Rake $0.98 
Board [Tc Th 2s 7h]
Seat 1: matiko09 (small blind) folded before Flop
Seat 2: Vikulja1993 (big blind) folded before Flop
Seat 3: cobrik23 collected ($18.52)
Seat 4: ipashutapkom folded before Flop (didn't bet)
Seat 5: blufthenuts folded before Flop (didn't bet)
Seat 6: Kihog folded before Flop (didn't bet)
Seat 7: rate8 folded before Flop (didn't bet)
Seat 8: roadster683 folded on the Turn
Seat 9: lydia12345 (button) folded before Flop (didn't bet)





PokerStars Hand #153503264680:  Hold'em No Limit ($1/$2 USD) - 2016/05/18 20:49:49 CET [2016/05/18 14:49:49 ET]
Table 'Wild' 9-max Seat #2 is the button
Seat 1: Sharknebulah ($200 in chips) 
Seat 2: zigzag972 ($365.70 in chips) 
Seat 3: Momess ($240.01 in chips) 
Seat 4: chipiflautic ($200 in chips) 
Seat 5: Ravnica11 ($74.60 in chips) 
Seat 6: tepi_guy ($246.25 in chips) 
Seat 7: matiko09 ($203 in chips) 
Seat 8: donald0404 ($249.25 in chips) 
Seat 9: Vikulja1993 ($224.50 in chips) 
Momess: posts small blind $1
chipiflautic: posts big blind $2
*** HOLE CARDS ***
Dealt to matiko09 [3d Qd]
Ravnica11: folds 
Ravnica11 leaves the table
tepi_guy has timed out
tepi_guy: folds 
matiko09: folds 
donald0404: folds 
Vikulja1993: raises $4 to $6
Sharknebulah: folds 
zigzag972: raises $12 to $18
Momess: folds 
chipiflautic: folds 
Vikulja1993: calls $12
*** FLOP *** [5s 5c 3s]
Vikulja1993: checks 
zigzag972: bets $28
Vikulja1993: folds 
Uncalled bet ($28) returned to zigzag972
zigzag972 collected $37.05 from pot
zigzag972: doesn't show hand 
*** SUMMARY ***
Total pot $39 | Rake $1.95 
Board [5s 5c 3s]
Seat 1: Sharknebulah folded before Flop (didn't bet)
Seat 2: zigzag972 (button) collected ($37.05)
Seat 3: Momess (small blind) folded before Flop
Seat 4: chipiflautic (big blind) folded before Flop
Seat 5: Ravnica11 folded before Flop (didn't bet)
Seat 6: tepi_guy folded before Flop (didn't bet)
Seat 7: matiko09 folded before Flop (didn't bet)
Seat 8: donald0404 folded before Flop (didn't bet)
Seat 9: Vikulja1993 folded on the Flop





PokerStars Hand #153503269197:  Hold'em No Limit (€0.50/€1.00 EUR) - 2016/05/18 20:49:54 CET [2016/05/18 14:49:54 ET]
Table 'Lamberta IV' 9-max Seat #5 is the button
Seat 1: Trompeneers (€84.83 in chips) 
Seat 2: TimStone (€123.50 in chips) 
Seat 3: JACQUILF (€100 in chips) 
Seat 4: matiko09 (€120.82 in chips) 
Seat 5: HomerrrJay (€100 in chips) 
Seat 6: Skum1986 (€100 in chips) 
Seat 7: vanilica (€100 in chips) 
Seat 8: lydia12345 (€101.50 in chips) 
Seat 9: Kihog (€100 in chips) 
Skum1986: posts small blind €0.50
vanilica: posts big blind €1
*** HOLE CARDS ***
Dealt to matiko09 [3d 4h]
lydia12345: folds 
Kihog: folds 
Trompeneers: folds 
TimStone: folds 
JACQUILF: folds 
matiko09: folds 
HomerrrJay: folds 
Skum1986: raises €1.70 to €2.70
vanilica: raises €6.30 to €9
Skum1986: folds 
Uncalled bet (€6.30) returned to vanilica
vanilica collected €5.40 from pot
vanilica: doesn't show hand 
*** SUMMARY ***
Total pot €5.40 | Rake €0 
Seat 1: Trompeneers folded before Flop (didn't bet)
Seat 2: TimStone folded before Flop (didn't bet)
Seat 3: JACQUILF folded before Flop (didn't bet)
Seat 4: matiko09 folded before Flop (didn't bet)
Seat 5: HomerrrJay (button) folded before Flop (didn't bet)
Seat 6: Skum1986 (small blind) folded before Flop
Seat 7: vanilica (big blind) collected (€5.40)
Seat 8: lydia12345 folded before Flop (didn't bet)
Seat 9: Kihog folded before Flop (didn't bet)





PokerStars Hand #153503278413:  Hold'em No Limit ($0.50/$1.00 USD) - 2016/05/18 20:50:05 CET [2016/05/18 14:50:05 ET]
Table 'Suevia' 9-max Seat #5 is the button
Seat 1: Moszes360 ($107.50 in chips) 
Seat 2: deadkiller1 ($124.47 in chips) 
Seat 3: matiko09 ($135.72 in chips) 
Seat 4: HITYESCA ($100 in chips) 
Seat 5: bello1310 ($103.81 in chips) 
Seat 6: torkkdnm ($117.16 in chips) 
Seat 7: IRAVABAN ($40 in chips) 
Seat 8: ama58 ($46.08 in chips) 
Seat 9: oscarleon ($140.35 in chips) 
torkkdnm: posts small blind $0.50
IRAVABAN: posts big blind $1
*** HOLE CARDS ***
Dealt to matiko09 [7d 2d]
ama58: calls $1
oscarleon: folds 
Moszes360: folds 
deadkiller1: folds 
matiko09: folds 
HITYESCA: folds 
bello1310: folds 
torkkdnm: folds 
IRAVABAN: checks 
*** FLOP *** [Kc 5d Ks]
IRAVABAN: checks 
ama58: bets $1
IRAVABAN: folds 
Uncalled bet ($1) returned to ama58
ama58 collected $2.38 from pot
*** SUMMARY ***
Total pot $2.50 | Rake $0.12 
Board [Kc 5d Ks]
Seat 1: Moszes360 folded before Flop (didn't bet)
Seat 2: deadkiller1 folded before Flop (didn't bet)
Seat 3: matiko09 folded before Flop (didn't bet)
Seat 4: HITYESCA folded before Flop (didn't bet)
Seat 5: bello1310 (button) folded before Flop (didn't bet)
Seat 6: torkkdnm (small blind) folded before Flop
Seat 7: IRAVABAN (big blind) folded on the Flop
Seat 8: ama58 collected ($2.38)
Seat 9: oscarleon folded before Flop (didn't bet)





PokerStars Hand #153503289941:  Hold'em No Limit ($0.50/$1.00 USD) - 2016/05/18 20:50:18 CET [2016/05/18 14:50:18 ET]
Table 'Tatjana III' 9-max Seat #6 is the button
Seat 1: cobrik23 ($179.83 in chips) 
Seat 2: HITYESCA ($152.58 in chips) 
Seat 3: matiko09 ($185.34 in chips) 
Seat 4: lydia12345 ($131.48 in chips) 
Seat 5: deadkiller1 ($101.44 in chips) 
Seat 6: Kihog ($100 in chips) 
Seat 7: rene1984tsv ($103.28 in chips) 
Seat 8: JACQUILF ($100 in chips) 
Seat 9: Moszes360 ($108.57 in chips) 
rene1984tsv: posts small blind $0.50
JACQUILF: posts big blind $1
*** HOLE CARDS ***
Dealt to matiko09 [7d 5s]
Moszes360: raises $2 to $3
cobrik23: folds 
HITYESCA: folds 
matiko09: folds 
lydia12345: folds 
deadkiller1: folds 
Kihog: folds 
rene1984tsv: folds 
JACQUILF: folds 
Uncalled bet ($2) returned to Moszes360
Moszes360 collected $2.50 from pot
Moszes360: doesn't show hand 
*** SUMMARY ***
Total pot $2.50 | Rake $0 
Seat 1: cobrik23 folded before Flop (didn't bet)
Seat 2: HITYESCA folded before Flop (didn't bet)
Seat 3: matiko09 folded before Flop (didn't bet)
Seat 4: lydia12345 folded before Flop (didn't bet)
Seat 5: deadkiller1 folded before Flop (didn't bet)
Seat 6: Kihog (button) folded before Flop (didn't bet)
Seat 7: rene1984tsv (small blind) folded before Flop
Seat 8: JACQUILF (big blind) folded before Flop
Seat 9: Moszes360 collected ($2.50)





PokerStars Hand #153503299087:  Hold'em No Limit ($0.50/$1.00 USD) - 2016/05/18 20:50:29 CET [2016/05/18 14:50:29 ET]
Table 'Samitchell II' 9-max Seat #8 is the button
Seat 1: riggedsh** ($100 in chips) 
Seat 2: cobrik23 ($92.25 in chips) 
Seat 3: vanilica ($109 in chips) 
Seat 4: TimStone ($100 in chips) 
Seat 5: nuuaber ($109.19 in chips) 
Seat 6: Strikerman25 ($38.50 in chips) 
Seat 7: matiko09 ($100 in chips) 
Seat 8: rate8 ($137.02 in chips) 
riggedsh**: posts small blind $0.50
cobrik23: posts big blind $1
*** HOLE CARDS ***
Dealt to matiko09 [6h Qc]
vanilica: folds 
TimStone: folds 
nuuaber: folds 
Strikerman25: raises $1.50 to $2.50
matiko09: folds 
solbi86 joins the table at seat #9 
rate8: folds 
riggedsh**: folds 
cobrik23: folds 
Uncalled bet ($1.50) returned to Strikerman25
Strikerman25 collected $2.50 from pot
Strikerman25: doesn't show hand 
*** SUMMARY ***
Total pot $2.50 | Rake $0 
Seat 1: riggedsh** (small blind) folded before Flop
Seat 2: cobrik23 (big blind) folded before Flop
Seat 3: vanilica folded before Flop (didn't bet)
Seat 4: TimStone folded before Flop (didn't bet)
Seat 5: nuuaber folded before Flop (didn't bet)
Seat 6: Strikerman25 collected ($2.50)
Seat 7: matiko09 folded before Flop (didn't bet)
Seat 8: rate8 (button) folded before Flop (didn't bet)





PokerStars Hand #153503301292:  Hold'em No Limit ($0.50/$1.00 USD) - 2016/05/18 20:50:31 CET [2016/05/18 14:50:31 ET]
Table 'Pandora' 9-max Seat #1 is the button
Seat 1: deadkiller1 ($138.41 in chips) 
Seat 4: mooose100 ($187.87 in chips) 
Seat 5: Strikerman25 ($40 in chips) 
Seat 6: Moszes360 ($105.95 in chips) 
Seat 8: matiko09 ($115.02 in chips) 
Seat 9: oscarleon ($109.98 in chips) 
vanilica will be allowed to play after the button
mooose100: posts small blind $0.50
Strikerman25: posts big blind $1
torkkdnm: sits out 
*** HOLE CARDS ***
Dealt to matiko09 [9d 4s]
Moszes360: folds 
matiko09: folds 
oscarleon: folds 
fack_vi leaves the table
deadkiller1: raises $1.50 to $2.50
mooose100: folds 
Strikerman25: folds 
Uncalled bet ($1.50) returned to deadkiller1
deadkiller1 collected $2.50 from pot
deadkiller1: doesn't show hand 
*** SUMMARY ***
Total pot $2.50 | Rake $0 
Seat 1: deadkiller1 (button) collected ($2.50)
Seat 4: mooose100 (small blind) folded before Flop
Seat 5: Strikerman25 (big blind) folded before Flop
Seat 6: Moszes360 folded before Flop (didn't bet)
Seat 8: matiko09 folded before Flop (didn't bet)
Seat 9: oscarleon folded before Flop (didn't bet)





PokerStars Hand #153503303829:  Hold'em No Limit (€0.50/€1.00 EUR) - 2016/05/18 20:50:34 CET [2016/05/18 14:50:34 ET]
Table 'Pallas II' 9-max Seat #4 is the button
Seat 1: deadkiller1 (€101.50 in chips) 
Seat 2: matiko09 (€189.99 in chips) 
Seat 3: Vikulja1993 (€100 in chips) 
Seat 4: torkkdnm (€140.71 in chips) 
Seat 5: cobrik23 (€70.86 in chips) 
Seat 6: HITYESCA (€105.12 in chips) 
Seat 7: rate8 (€105.38 in chips) 
Seat 8: Kihog (€173.50 in chips) 
Seat 9: stijner1986 (€138.98 in chips) 
cobrik23: posts small blind €0.50
HITYESCA: posts big blind €1
*** HOLE CARDS ***
Dealt to matiko09 [Jc 9s]
rate8: folds 
Kihog: folds 
stijner1986: folds 
deadkiller1: folds 
matiko09: folds 
Vikulja1993: raises €1.50 to €2.50
torkkdnm: folds 
cobrik23: folds 
HITYESCA: folds 
Uncalled bet (€1.50) returned to Vikulja1993
Vikulja1993 collected €2.50 from pot
Vikulja1993: doesn't show hand 
*** SUMMARY ***
Total pot €2.50 | Rake €0 
Seat 1: deadkiller1 folded before Flop (didn't bet)
Seat 2: matiko09 folded before Flop (didn't bet)
Seat 3: Vikulja1993 collected (€2.50)
Seat 4: torkkdnm (button) folded before Flop (didn't bet)
Seat 5: cobrik23 (small blind) folded before Flop
Seat 6: HITYESCA (big blind) folded before Flop
Seat 7: rate8 folded before Flop (didn't bet)
Seat 8: Kihog folded before Flop (didn't bet)
Seat 9: stijner1986 folded before Flop (didn't bet)





PokerStars Hand #153503306831:  Hold'em No Limit ($0.50/$1.00 USD) - 2016/05/18 20:50:38 CET [2016/05/18 14:50:38 ET]
Table 'Tatjana III' 9-max Seat #7 is the button
Seat 1: cobrik23 ($179.83 in chips) 
Seat 2: HITYESCA ($152.58 in chips) 
Seat 3: matiko09 ($185.34 in chips) 
Seat 4: lydia12345 ($131.48 in chips) 
Seat 5: deadkiller1 ($101.44 in chips) 
Seat 6: Kihog ($100 in chips) 
Seat 7: rene1984tsv ($102.78 in chips) 
Seat 8: JACQUILF ($100 in chips) 
Seat 9: Moszes360 ($110.07 in chips) 
JACQUILF: posts small blind $0.50
Moszes360: posts big blind $1
*** HOLE CARDS ***
Dealt to matiko09 [3d Qh]
cobrik23: raises $2 to $3
HITYESCA: folds 
matiko09: folds 
lydia12345: folds 
deadkiller1: folds 
Kihog: folds 
rene1984tsv: calls $3
JACQUILF: folds 
Moszes360: calls $2
*** FLOP *** [Td 9d Ah]
Moszes360: checks 
cobrik23: checks 
rene1984tsv: bets $9.02
Moszes360: folds 
cobrik23 has timed out
cobrik23: folds 
Uncalled bet ($9.02) returned to rene1984tsv
rene1984tsv collected $9.02 from pot
rene1984tsv: doesn't show hand 
*** SUMMARY ***
Total pot $9.50 | Rake $0.48 
Board [Td 9d Ah]
Seat 1: cobrik23 folded on the Flop
Seat 2: HITYESCA folded before Flop (didn't bet)
Seat 3: matiko09 folded before Flop (didn't bet)
Seat 4: lydia12345 folded before Flop (didn't bet)
Seat 5: deadkiller1 folded before Flop (didn't bet)
Seat 6: Kihog folded before Flop (didn't bet)
Seat 7: rene1984tsv (button) collected ($9.02)
Seat 8: JACQUILF (small blind) folded before Flop
Seat 9: Moszes360 (big blind) folded on the Flop





PokerStars Hand #153503310167:  Hold'em No Limit ($0.50/$1.00 USD) - 2016/05/18 20:50:42 CET [2016/05/18 14:50:42 ET]
Table 'Suevia' 9-max Seat #6 is the button
Seat 1: Moszes360 ($107.50 in chips) 
Seat 2: deadkiller1 ($124.47 in chips) 
Seat 3: matiko09 ($135.72 in chips) 
Seat 4: HITYESCA ($100 in chips) 
Seat 5: bello1310 ($103.81 in chips) 
Seat 6: torkkdnm ($116.66 in chips) 
Seat 7: IRAVABAN ($40 in chips) 
Seat 8: ama58 ($47.46 in chips) 
Seat 9: oscarleon ($140.35 in chips) 
IRAVABAN: posts small blind $0.50
ama58: posts big blind $1
*** HOLE CARDS ***
Dealt to matiko09 [Ts Qc]
oscarleon: folds 
Moszes360: folds 
deadkiller1: folds 
matiko09: folds 
HITYESCA: folds 
bello1310: folds 
torkkdnm: raises $1 to $2
IRAVABAN: folds 
ama58: calls $1
*** FLOP *** [9c 5c Jc]
ama58: checks 
torkkdnm: bets $3
ama58: folds 
Uncalled bet ($3) returned to torkkdnm
torkkdnm collected $4.28 from pot
*** SUMMARY ***
Total pot $4.50 | Rake $0.22 
Board [9c 5c Jc]
Seat 1: Moszes360 folded before Flop (didn't bet)
Seat 2: deadkiller1 folded before Flop (didn't bet)
Seat 3: matiko09 folded before Flop (didn't bet)
Seat 4: HITYESCA folded before Flop (didn't bet)
Seat 5: bello1310 folded before Flop (didn't bet)
Seat 6: torkkdnm (button) collected ($4.28)
Seat 7: IRAVABAN (small blind) folded before Flop
Seat 8: ama58 (big blind) folded on the Flop
Seat 9: oscarleon folded before Flop (didn't bet)





PokerStars Hand #153503316658:  Hold'em No Limit (€0.50/€1.00 EUR) - 2016/05/18 20:50:49 CET [2016/05/18 14:50:49 ET]
Table 'Lamberta IV' 9-max Seat #6 is the button
Seat 1: Trompeneers (€84.83 in chips) 
Seat 2: TimStone (€123.50 in chips) 
Seat 3: JACQUILF (€100 in chips) 
Seat 4: matiko09 (€120.82 in chips) 
Seat 5: HomerrrJay (€100 in chips) 
Seat 6: Skum1986 (€100 in chips) 
Seat 7: vanilica (€102.70 in chips) 
Seat 8: lydia12345 (€101.50 in chips) 
Seat 9: Kihog (€100 in chips) 
vanilica: posts small blind €0.50
lydia12345: posts big blind €1
*** HOLE CARDS ***
Dealt to matiko09 [5c 7d]
Kihog: raises €1.50 to €2.50
Trompeneers: folds 
TimStone: folds 
JACQUILF: folds 
matiko09: folds 
HomerrrJay: folds 
Skum1986: folds 
vanilica: folds 
lydia12345: folds 
Uncalled bet (€1.50) returned to Kihog
Kihog collected €2.50 from pot
Kihog: doesn't show hand 
*** SUMMARY ***
Total pot €2.50 | Rake €0 
Seat 1: Trompeneers folded before Flop (didn't bet)
Seat 2: TimStone folded before Flop (didn't bet)
Seat 3: JACQUILF folded before Flop (didn't bet)
Seat 4: matiko09 folded before Flop (didn't bet)
Seat 5: HomerrrJay folded before Flop (didn't bet)
Seat 6: Skum1986 (button) folded before Flop (didn't bet)
Seat 7: vanilica (small blind) folded before Flop
Seat 8: lydia12345 (big blind) folded before Flop
Seat 9: Kihog collected (€2.50)





PokerStars Hand #153503322233:  Hold'em No Limit ($0.50/$1.00 USD) - 2016/05/18 20:50:55 CET [2016/05/18 14:50:55 ET]
Table 'Abetti II' 9-max Seat #1 is the button
Seat 1: matiko09 ($107.02 in chips) 
Seat 2: Vikulja1993 ($100 in chips) 
Seat 3: cobrik23 ($140.98 in chips) 
Seat 4: ipashutapkom ($42.50 in chips) 
Seat 5: blufthenuts ($114.85 in chips) 
Seat 6: Kihog ($101.50 in chips) 
Seat 7: rate8 ($100 in chips) 
Seat 8: roadster683 ($163.34 in chips) 
Seat 9: lydia12345 ($277.75 in chips) 
Vikulja1993: posts small blind $0.50
cobrik23: posts big blind $1
*** HOLE CARDS ***
Dealt to matiko09 [Qc 8c]
ipashutapkom: folds 
blufthenuts: folds 
Kihog: folds 
rate8: folds 
roadster683: folds 
lydia12345: raises $2 to $3
matiko09: folds 
Vikulja1993: folds 
cobrik23: calls $2
*** FLOP *** [7d 6d 5h]
cobrik23: checks 
lydia12345: bets $4.20
cobrik23: calls $4.20
*** TURN *** [7d 6d 5h] [Js]
cobrik23: checks 
lydia12345: bets $9.63
cobrik23: folds 
Uncalled bet ($9.63) returned to lydia12345
lydia12345 collected $14.16 from pot
*** SUMMARY ***
Total pot $14.90 | Rake $0.74 
Board [7d 6d 5h Js]
Seat 1: matiko09 (button) folded before Flop (didn't bet)
Seat 2: Vikulja1993 (small blind) folded before Flop
Seat 3: cobrik23 (big blind) folded on the Turn
Seat 4: ipashutapkom folded before Flop (didn't bet)
Seat 5: blufthenuts folded before Flop (didn't bet)
Seat 6: Kihog folded before Flop (didn't bet)
Seat 7: rate8 folded before Flop (didn't bet)
Seat 8: roadster683 folded before Flop (didn't bet)
Seat 9: lydia12345 collected ($14.16)





PokerStars Hand #153503329029:  Hold'em No Limit ($0.50/$1.00 USD) - 2016/05/18 20:51:03 CET [2016/05/18 14:51:03 ET]
Table 'Pandora' 9-max Seat #4 is the button
Seat 1: deadkiller1 ($139.91 in chips) 
Seat 4: mooose100 ($187.37 in chips) 
Seat 5: Strikerman25 ($39 in chips) 
Seat 6: Moszes360 ($105.95 in chips) 
Seat 8: matiko09 ($115.02 in chips) 
Seat 9: oscarleon ($109.98 in chips) 
Strikerman25: posts small blind $0.50
Moszes360: posts big blind $1
torkkdnm: sits out 
vanilica: sits out 
*** HOLE CARDS ***
Dealt to matiko09 [4d 7d]
matiko09: folds 
oscarleon: folds 
deadkiller1: raises $1.50 to $2.50
mooose100: calls $2.50
Strikerman25: folds 
Moszes360: folds 
*** FLOP *** [5s 3s 4h]
deadkiller1: bets $4.07
mooose100: calls $4.07
*** TURN *** [5s 3s 4h] [7s]
deadkiller1: bets $9.18
mooose100: calls $9.18
*** RIVER *** [5s 3s 4h 7s] [Ts]
Vikulja1993 joins the table at seat #2 
deadkiller1: checks 
mooose100: checks 
*** SHOW DOWN ***
deadkiller1: shows [Tc Td] (three of a kind, Tens)
mooose100: shows [3h 6h] (a straight, Three to Seven)
mooose100 collected $31.35 from pot
*** SUMMARY ***
Total pot $33 | Rake $1.65 
Board [5s 3s 4h 7s Ts]
Seat 1: deadkiller1 showed [Tc Td] and lost with three of a kind, Tens
Seat 4: mooose100 (button) showed [3h 6h] and won ($31.35) with a straight, Three to Seven
Seat 5: Strikerman25 (small blind) folded before Flop
Seat 6: Moszes360 (big blind) folded before Flop
Seat 8: matiko09 folded before Flop (didn't bet)
Seat 9: oscarleon folded before Flop (didn't bet)





PokerStars Hand #153503344542:  Hold'em No Limit (€0.50/€1.00 EUR) - 2016/05/18 20:51:21 CET [2016/05/18 14:51:21 ET]
Table 'Lamberta IV' 9-max Seat #7 is the button
Seat 1: Trompeneers (€84.83 in chips) 
Seat 2: TimStone (€123.50 in chips) 
Seat 3: JACQUILF (€100 in chips) 
Seat 4: matiko09 (€120.82 in chips) 
Seat 5: HomerrrJay (€100 in chips) 
Seat 6: Skum1986 (€100 in chips) 
Seat 7: vanilica (€102.20 in chips) 
Seat 8: lydia12345 (€100.50 in chips) 
Seat 9: Kihog (€101.50 in chips) 
lydia12345: posts small blind €0.50
Kihog: posts big blind €1
*** HOLE CARDS ***
Dealt to matiko09 [Ts 6s]
Trompeneers: folds 
TimStone: folds 
JACQUILF: folds 
matiko09: folds 
HomerrrJay: folds 
Skum1986: folds 
vanilica: folds 
lydia12345: folds 
Uncalled bet (€0.50) returned to Kihog
Kihog collected €1 from pot
Kihog: doesn't show hand 
*** SUMMARY ***
Total pot €1 | Rake €0 
Seat 1: Trompeneers folded before Flop (didn't bet)
Seat 2: TimStone folded before Flop (didn't bet)
Seat 3: JACQUILF folded before Flop (didn't bet)
Seat 4: matiko09 folded before Flop (didn't bet)
Seat 5: HomerrrJay folded before Flop (didn't bet)
Seat 6: Skum1986 folded before Flop (didn't bet)
Seat 7: vanilica (button) folded before Flop (didn't bet)
Seat 8: lydia12345 (small blind) folded before Flop
Seat 9: Kihog (big blind) collected (€1)





PokerStars Hand #153503347588:  Hold'em No Limit (€0.50/€1.00 EUR) - 2016/05/18 20:51:25 CET [2016/05/18 14:51:25 ET]
Table 'Pallas II' 9-max Seat #5 is the button
Seat 1: deadkiller1 (€101.50 in chips) 
Seat 2: matiko09 (€189.99 in chips) 
Seat 3: Vikulja1993 (€101.50 in chips) 
Seat 4: torkkdnm (€140.71 in chips) 
Seat 5: cobrik23 (€70.36 in chips) 
Seat 6: HITYESCA (€104.12 in chips) 
Seat 7: rate8 (€105.38 in chips) 
Seat 8: Kihog (€173.50 in chips) 
Seat 9: stijner1986 (€138.98 in chips) 
HITYESCA: posts small blind €0.50
rate8: posts big blind €1
*** HOLE CARDS ***
Dealt to matiko09 [2d 3c]
Kihog: folds 
stijner1986: calls €1
deadkiller1: folds 
matiko09: folds 
Vikulja1993: folds 
torkkdnm has timed out
torkkdnm: folds 
cobrik23: folds 
HITYESCA: folds 
rate8: checks 
*** FLOP *** [Ac 5d 7h]
rate8: bets €1.23
stijner1986: calls €1.23
*** TURN *** [Ac 5d 7h] [3d]
rate8: bets €3.39
stijner1986: calls €3.39
*** RIVER *** [Ac 5d 7h 3d] [Th]
rate8: checks 
stijner1986: bets €16
rate8: folds 
Uncalled bet (€16) returned to stijner1986
stijner1986 collected €11.15 from pot
stijner1986: doesn't show hand 
*** SUMMARY ***
Total pot €11.74 | Rake €0.59 
Board [Ac 5d 7h 3d Th]
Seat 1: deadkiller1 folded before Flop (didn't bet)
Seat 2: matiko09 folded before Flop (didn't bet)
Seat 3: Vikulja1993 folded before Flop (didn't bet)
Seat 4: torkkdnm folded before Flop (didn't bet)
Seat 5: cobrik23 (button) folded before Flop (didn't bet)
Seat 6: HITYESCA (small blind) folded before Flop
Seat 7: rate8 (big blind) folded on the River
Seat 8: Kihog folded before Flop (didn't bet)
Seat 9: stijner1986 collected (€11.15)





PokerStars Hand #153503349276:  Hold'em No Limit ($0.50/$1.00 USD) - 2016/05/18 20:51:26 CET [2016/05/18 14:51:26 ET]
Table 'Suevia' 9-max Seat #7 is the button
Seat 1: Moszes360 ($107.50 in chips) 
Seat 2: deadkiller1 ($124.47 in chips) 
Seat 3: matiko09 ($135.72 in chips) 
Seat 4: HITYESCA ($100 in chips) 
Seat 5: bello1310 ($103.81 in chips) 
Seat 6: torkkdnm ($118.94 in chips) 
Seat 7: IRAVABAN ($40 in chips) 
Seat 8: ama58 ($45.46 in chips) 
Seat 9: oscarleon ($140.35 in chips) 
ama58: posts small blind $0.50
oscarleon: posts big blind $1
*** HOLE CARDS ***
Dealt to matiko09 [Ad 4h]
Moszes360: raises $2 to $3
deadkiller1: folds 
matiko09: folds 
HITYESCA: folds 
bello1310: folds 
torkkdnm: folds 
IRAVABAN: folds 
ama58: folds 
oscarleon: folds 
Uncalled bet ($2) returned to Moszes360
Moszes360 collected $2.50 from pot
Moszes360: doesn't show hand 
*** SUMMARY ***
Total pot $2.50 | Rake $0 
Seat 1: Moszes360 collected ($2.50)
Seat 2: deadkiller1 folded before Flop (didn't bet)
Seat 3: matiko09 folded before Flop (didn't bet)
Seat 4: HITYESCA folded before Flop (didn't bet)
Seat 5: bello1310 folded before Flop (didn't bet)
Seat 6: torkkdnm folded before Flop (didn't bet)
Seat 7: IRAVABAN (button) folded before Flop (didn't bet)
Seat 8: ama58 (small blind) folded before Flop
Seat 9: oscarleon (big blind) folded before Flop





PokerStars Hand #153503354530:  Hold'em No Limit ($0.50/$1.00 USD) - 2016/05/18 20:51:32 CET [2016/05/18 14:51:32 ET]
Table 'Samitchell II' 9-max Seat #1 is the button
Seat 1: riggedsh** ($100 in chips) 
Seat 2: cobrik23 ($91.25 in chips) 
Seat 3: vanilica ($109 in chips) 
Seat 4: TimStone ($100 in chips) 
Seat 5: nuuaber ($109.19 in chips) 
Seat 6: Strikerman25 ($40 in chips) 
Seat 7: matiko09 ($100 in chips) 
Seat 8: rate8 ($137.02 in chips) 
cobrik23: posts small blind $0.50
vanilica: posts big blind $1
solbi86: sits out 
*** HOLE CARDS ***
Dealt to matiko09 [Jh Qh]
TimStone: folds 
nuuaber: folds 
Strikerman25: folds 
matiko09: raises $2 to $3
rate8: folds 
riggedsh**: folds 
cobrik23: folds 
vanilica: folds 
Uncalled bet ($2) returned to matiko09
matiko09 collected $2.50 from pot
matiko09: doesn't show hand 
*** SUMMARY ***
Total pot $2.50 | Rake $0 
Seat 1: riggedsh** (button) folded before Flop (didn't bet)
Seat 2: cobrik23 (small blind) folded before Flop
Seat 3: vanilica (big blind) folded before Flop
Seat 4: TimStone folded before Flop (didn't bet)
Seat 5: nuuaber folded before Flop (didn't bet)
Seat 6: Strikerman25 folded before Flop (didn't bet)
Seat 7: matiko09 collected ($2.50)
Seat 8: rate8 folded before Flop (didn't bet)





PokerStars Hand #153503359814:  Hold'em No Limit ($0.50/$1.00 USD) - 2016/05/18 20:51:38 CET [2016/05/18 14:51:38 ET]
Table 'Kayala' 9-max Seat #4 is the button
Seat 1: deadkiller1 ($104.78 in chips) 
Seat 3: matiko09 ($100 in chips) 
Seat 4: HITYESCA ($100 in chips) 
Seat 5: rate8 ($104.62 in chips) 
Seat 6: Strikerman25 ($40 in chips) 
Seat 7: kenan-lola ($98.19 in chips) 
Seat 8: cobrik23 ($118.34 in chips) 
Seat 9: Vikulja1993 ($100 in chips) 
rate8: posts small blind $0.50
Strikerman25: posts big blind $1
solbi86: sits out 
*** HOLE CARDS ***
Dealt to matiko09 [9d 2c]
kenan-lola: folds 
cobrik23: raises $2 to $3
Vikulja1993: folds 
deadkiller1: folds 
matiko09: folds 
HITYESCA: folds 
rate8: folds 
Strikerman25: folds 
Uncalled bet ($2) returned to cobrik23
cobrik23 collected $2.50 from pot
cobrik23: doesn't show hand 
*** SUMMARY ***
Total pot $2.50 | Rake $0 
Seat 1: deadkiller1 folded before Flop (didn't bet)
Seat 3: matiko09 folded before Flop (didn't bet)
Seat 4: HITYESCA (button) folded before Flop (didn't bet)
Seat 5: rate8 (small blind) folded before Flop
Seat 6: Strikerman25 (big blind) folded before Flop
Seat 7: kenan-lola folded before Flop (didn't bet)
Seat 8: cobrik23 collected ($2.50)
Seat 9: Vikulja1993 folded before Flop (didn't bet)





PokerStars Hand #153503371016:  Hold'em No Limit ($0.50/$1.00 USD) - 2016/05/18 20:51:51 CET [2016/05/18 14:51:51 ET]
Table 'Lorcia II' 9-max Seat #1 is the button
Seat 1: HomerrrJay ($100 in chips) 
Seat 2: lydia12345 ($100 in chips) 
Seat 3: matiko09 ($100 in chips) 
Seat 5: nuuaber ($77 in chips) 
Seat 7: rate8 ($105.55 in chips) 
Seat 8: Skum1986 ($100 in chips) 
Seat 9: porgol ($86 in chips) 
lydia12345: posts small blind $0.50
matiko09: posts big blind $1
vanilica: sits out 
gkm0nk3y: sits out 
*** HOLE CARDS ***
Dealt to matiko09 [Kc 4h]
nuuaber: calls $1
rate8: folds 
Skum1986: raises $2.70 to $3.70
porgol: folds 
HomerrrJay: folds 
lydia12345: folds 
matiko09: folds 
nuuaber: calls $2.70
*** FLOP *** [4s 9d 7h]
nuuaber: checks 
Skum1986: checks 
*** TURN *** [4s 9d 7h] [Qd]
nuuaber: checks 
Skum1986: checks 
*** RIVER *** [4s 9d 7h Qd] [3s]
nuuaber: checks 
Skum1986: checks 
*** SHOW DOWN ***
nuuaber: shows [6d Ah] (high card Ace)
Skum1986: shows [8c 7c] (a pair of Sevens)
Skum1986 collected $8.46 from pot
*** SUMMARY ***
Total pot $8.90 | Rake $0.44 
Board [4s 9d 7h Qd 3s]
Seat 1: HomerrrJay (button) folded before Flop (didn't bet)
Seat 2: lydia12345 (small blind) folded before Flop
Seat 3: matiko09 (big blind) folded before Flop
Seat 5: nuuaber showed [6d Ah] and lost with high card Ace
Seat 7: rate8 folded before Flop (didn't bet)
Seat 8: Skum1986 showed [8c 7c] and won ($8.46) with a pair of Sevens
Seat 9: porgol folded before Flop (didn't bet)





PokerStars Hand #153503372648:  Hold'em No Limit ($0.50/$1.00 USD) - 2016/05/18 20:51:53 CET [2016/05/18 14:51:53 ET]
Table 'Tatjana III' 9-max Seat #8 is the button
Seat 1: cobrik23 ($176.83 in chips) 
Seat 2: HITYESCA ($152.58 in chips) 
Seat 3: matiko09 ($185.34 in chips) 
Seat 4: lydia12345 ($131.48 in chips) 
Seat 5: deadkiller1 ($101.44 in chips) 
Seat 6: Kihog ($100 in chips) 
Seat 7: rene1984tsv ($108.80 in chips) 
Seat 8: JACQUILF ($100 in chips) 
Seat 9: Moszes360 ($107.07 in chips) 
Moszes360: posts small blind $0.50
cobrik23: posts big blind $1
*** HOLE CARDS ***
Dealt to matiko09 [6h 8s]
HITYESCA: folds 
matiko09: folds 
lydia12345: folds 
deadkiller1: folds 
Kihog: folds 
rene1984tsv: raises $1 to $2
JACQUILF: folds 
Moszes360: folds 
cobrik23: folds 
Uncalled bet ($1) returned to rene1984tsv
rene1984tsv collected $2.50 from pot
rene1984tsv: doesn't show hand 
*** SUMMARY ***
Total pot $2.50 | Rake $0 
Seat 1: cobrik23 (big blind) folded before Flop
Seat 2: HITYESCA folded before Flop (didn't bet)
Seat 3: matiko09 folded before Flop (didn't bet)
Seat 4: lydia12345 folded before Flop (didn't bet)
Seat 5: deadkiller1 folded before Flop (didn't bet)
Seat 6: Kihog folded before Flop (didn't bet)
Seat 7: rene1984tsv collected ($2.50)
Seat 8: JACQUILF (button) folded before Flop (didn't bet)
Seat 9: Moszes360 (small blind) folded before Flop





PokerStars Hand #153503377546:  Hold'em No Limit (€0.50/€1.00 EUR) - 2016/05/18 20:51:59 CET [2016/05/18 14:51:59 ET]
Table 'Lamberta IV' 9-max Seat #8 is the button
Seat 1: Trompeneers (€84.83 in chips) 
Seat 2: TimStone (€123.50 in chips) 
Seat 3: JACQUILF (€100 in chips) 
Seat 4: matiko09 (€120.82 in chips) 
Seat 5: HomerrrJay (€100 in chips) 
Seat 6: Skum1986 (€100 in chips) 
Seat 7: vanilica (€102.20 in chips) 
Seat 8: lydia12345 (€100 in chips) 
Seat 9: Kihog (€102 in chips) 
Kihog: posts small blind €0.50
Trompeneers: posts big blind €1
*** HOLE CARDS ***
Dealt to matiko09 [6h 6d]
TimStone: folds 
JACQUILF: folds 
matiko09: raises €2 to €3
HomerrrJay: folds 
Skum1986: folds 
vanilica: calls €3
lydia12345: folds 
Kihog: folds 
Trompeneers: folds 
*** FLOP *** [2s Ad 3s]
matiko09: checks 
vanilica: checks 
*** TURN *** [2s Ad 3s] [9s]
matiko09: checks 
vanilica: checks 
*** RIVER *** [2s Ad 3s 9s] [4h]
matiko09: checks 
vanilica: bets €5.26
matiko09: folds 
Uncalled bet (€5.26) returned to vanilica
vanilica collected €7.12 from pot
vanilica: doesn't show hand 
*** SUMMARY ***
Total pot €7.50 | Rake €0.38 
Board [2s Ad 3s 9s 4h]
Seat 1: Trompeneers (big blind) folded before Flop
Seat 2: TimStone folded before Flop (didn't bet)
Seat 3: JACQUILF folded before Flop (didn't bet)
Seat 4: matiko09 folded on the River
Seat 5: HomerrrJay folded before Flop (didn't bet)
Seat 6: Skum1986 folded before Flop (didn't bet)
Seat 7: vanilica collected (€7.12)
Seat 8: lydia12345 (button) folded before Flop (didn't bet)
Seat 9: Kihog (small blind) folded before Flop





PokerStars Hand #153503382536:  Hold'em No Limit ($0.50/$1.00 USD) - 2016/05/18 20:52:05 CET [2016/05/18 14:52:05 ET]
Table 'Abetti II' 9-max Seat #2 is the button
Seat 1: matiko09 ($107.02 in chips) 
Seat 2: Vikulja1993 ($100 in chips) 
Seat 3: cobrik23 ($133.78 in chips) 
Seat 4: ipashutapkom ($42.50 in chips) 
Seat 5: blufthenuts ($114.85 in chips) 
Seat 6: Kihog ($101.50 in chips) 
Seat 7: rate8 ($100 in chips) 
Seat 8: roadster683 ($163.34 in chips) 
Seat 9: lydia12345 ($284.71 in chips) 
cobrik23: posts small blind $0.50
ipashutapkom: posts big blind $1
*** HOLE CARDS ***
Dealt to matiko09 [5h 5s]
blufthenuts: folds 
Kihog: raises $1.50 to $2.50
rate8: folds 
roadster683: calls $2.50
lydia12345: calls $2.50
matiko09: calls $2.50
Vikulja1993: folds 
cobrik23: folds 
ipashutapkom: calls $1.50
*** FLOP *** [Kc Qc 4s]
ipashutapkom: checks 
Kihog: checks 
roadster683: checks 
lydia12345: bets $8.40
matiko09: folds 
ipashutapkom: folds 
Kihog: folds 
roadster683: folds 
Uncalled bet ($8.40) returned to lydia12345
lydia12345 collected $12.35 from pot
*** SUMMARY ***
Total pot $13 | Rake $0.65 
Board [Kc Qc 4s]
Seat 1: matiko09 folded on the Flop
Seat 2: Vikulja1993 (button) folded before Flop (didn't bet)
Seat 3: cobrik23 (small blind) folded before Flop
Seat 4: ipashutapkom (big blind) folded on the Flop
Seat 5: blufthenuts folded before Flop (didn't bet)
Seat 6: Kihog folded on the Flop
Seat 7: rate8 folded before Flop (didn't bet)
Seat 8: roadster683 folded on the Flop
Seat 9: lydia12345 collected ($12.35)





PokerStars Hand #153503386075:  Hold'em No Limit ($0.50/$1.00 USD) - 2016/05/18 20:52:09 CET [2016/05/18 14:52:09 ET]
Table 'Kayala' 9-max Seat #5 is the button
Seat 1: deadkiller1 ($104.78 in chips) 
Seat 3: matiko09 ($100 in chips) 
Seat 4: HITYESCA ($100 in chips) 
Seat 5: rate8 ($104.12 in chips) 
Seat 6: Strikerman25 ($39 in chips) 
Seat 7: kenan-lola ($98.19 in chips) 
Seat 8: cobrik23 ($119.84 in chips) 
Seat 9: Vikulja1993 ($100 in chips) 
Strikerman25: posts small blind $0.50
kenan-lola: posts big blind $1
solbi86: sits out 
*** HOLE CARDS ***
Dealt to matiko09 [Qc 4c]
cobrik23: folds 
Vikulja1993: folds 
deadkiller1: raises $2 to $3
matiko09: folds 
HITYESCA: folds 
rate8: folds 
Strikerman25: folds 
kenan-lola: folds 
Uncalled bet ($2) returned to deadkiller1
deadkiller1 collected $2.50 from pot
deadkiller1: doesn't show hand 
*** SUMMARY ***
Total pot $2.50 | Rake $0 
Seat 1: deadkiller1 collected ($2.50)
Seat 3: matiko09 folded before Flop (didn't bet)
Seat 4: HITYESCA folded before Flop (didn't bet)
Seat 5: rate8 (button) folded before Flop (didn't bet)
Seat 6: Strikerman25 (small blind) folded before Flop
Seat 7: kenan-lola (big blind) folded before Flop
Seat 8: cobrik23 folded before Flop (didn't bet)
Seat 9: Vikulja1993 folded before Flop (didn't bet)





PokerStars Hand #153503388854:  Hold'em No Limit ($0.50/$1.00 USD) - 2016/05/18 20:52:12 CET [2016/05/18 14:52:12 ET]
Table 'Samitchell II' 9-max Seat #2 is the button
Seat 1: riggedsh** ($100 in chips) 
Seat 2: cobrik23 ($90.75 in chips) 
Seat 3: vanilica ($108 in chips) 
Seat 5: nuuaber ($109.19 in chips) 
Seat 6: Strikerman25 ($40 in chips) 
Seat 7: matiko09 ($101.50 in chips) 
Seat 8: rate8 ($137.02 in chips) 
vanilica: posts small blind $0.50
TimStone: is sitting out 
nuuaber: posts big blind $1
solbi86: sits out 
*** HOLE CARDS ***
Dealt to matiko09 [6d Ks]
TimStone leaves the table
Strikerman25: folds 
matiko09: folds 
rate8: folds 
riggedsh**: folds 
Zeeshka joins the table at seat #4 
cobrik23: folds 
vanilica: raises $2 to $3
nuuaber: calls $2
*** FLOP *** [6c 7s 8h]
vanilica: checks 
nuuaber: checks 
*** TURN *** [6c 7s 8h] [3s]
vanilica: checks 
nuuaber: checks 
*** RIVER *** [6c 7s 8h 3s] [3d]
vanilica: checks 
nuuaber: checks 
*** SHOW DOWN ***
vanilica: shows [Ts Ad] (a pair of Threes)
nuuaber: mucks hand 
vanilica collected $5.70 from pot
*** SUMMARY ***
Total pot $6 | Rake $0.30 
Board [6c 7s 8h 3s 3d]
Seat 1: riggedsh** folded before Flop (didn't bet)
Seat 2: cobrik23 (button) folded before Flop (didn't bet)
Seat 3: vanilica (small blind) showed [Ts Ad] and won ($5.70) with a pair of Threes
Seat 5: nuuaber (big blind) mucked [5h Ac]
Seat 6: Strikerman25 folded before Flop (didn't bet)
Seat 7: matiko09 folded before Flop (didn't bet)
Seat 8: rate8 folded before Flop (didn't bet)





PokerStars Hand #153503391825:  Hold'em No Limit ($0.50/$1.00 USD) - 2016/05/18 20:52:15 CET [2016/05/18 14:52:15 ET]
Table 'Suevia' 9-max Seat #8 is the button
Seat 1: Moszes360 ($109 in chips) 
Seat 2: deadkiller1 ($124.47 in chips) 
Seat 3: matiko09 ($135.72 in chips) 
Seat 4: HITYESCA ($100 in chips) 
Seat 5: bello1310 ($103.81 in chips) 
Seat 6: torkkdnm ($118.94 in chips) 
Seat 7: IRAVABAN ($40 in chips) 
Seat 8: ama58 ($44.96 in chips) 
Seat 9: oscarleon ($139.35 in chips) 
oscarleon: posts small blind $0.50
Moszes360: posts big blind $1
*** HOLE CARDS ***
Dealt to matiko09 [As 4d]
deadkiller1: folds 
matiko09: folds 
HITYESCA: folds 
bello1310: folds 
torkkdnm: raises $2 to $3
IRAVABAN: folds 
ama58: folds 
oscarleon: folds 
Moszes360: folds 
Uncalled bet ($2) returned to torkkdnm
torkkdnm collected $2.50 from pot
*** SUMMARY ***
Total pot $2.50 | Rake $0 
Seat 1: Moszes360 (big blind) folded before Flop
Seat 2: deadkiller1 folded before Flop (didn't bet)
Seat 3: matiko09 folded before Flop (didn't bet)
Seat 4: HITYESCA folded before Flop (didn't bet)
Seat 5: bello1310 folded before Flop (didn't bet)
Seat 6: torkkdnm collected ($2.50)
Seat 7: IRAVABAN folded before Flop (didn't bet)
Seat 8: ama58 (button) folded before Flop (didn't bet)
Seat 9: oscarleon (small blind) folded before Flop





PokerStars Hand #153503405622:  Hold'em No Limit ($0.50/$1.00 USD) - 2016/05/18 20:52:31 CET [2016/05/18 14:52:31 ET]
Table 'Kayala' 9-max Seat #6 is the button
Seat 1: deadkiller1 ($106.28 in chips) 
Seat 3: matiko09 ($100 in chips) 
Seat 4: HITYESCA ($100 in chips) 
Seat 5: rate8 ($104.12 in chips) 
Seat 6: Strikerman25 ($38.50 in chips) 
Seat 7: kenan-lola ($97.19 in chips) 
Seat 8: cobrik23 ($119.84 in chips) 
Seat 9: Vikulja1993 ($100 in chips) 
kenan-lola: posts small blind $0.50
cobrik23: posts big blind $1
solbi86: sits out 
*** HOLE CARDS ***
Dealt to matiko09 [3s Tc]
Vikulja1993: raises $2 to $3
deadkiller1: folds 
matiko09: folds 
HITYESCA: folds 
rate8: folds 
Strikerman25: folds 
kenan-lola: folds 
cobrik23: folds 
Uncalled bet ($2) returned to Vikulja1993
Vikulja1993 collected $2.50 from pot
Vikulja1993: doesn't show hand 
*** SUMMARY ***
Total pot $2.50 | Rake $0 
Seat 1: deadkiller1 folded before Flop (didn't bet)
Seat 3: matiko09 folded before Flop (didn't bet)
Seat 4: HITYESCA folded before Flop (didn't bet)
Seat 5: rate8 folded before Flop (didn't bet)
Seat 6: Strikerman25 (button) folded before Flop (didn't bet)
Seat 7: kenan-lola (small blind) folded before Flop
Seat 8: cobrik23 (big blind) folded before Flop
Seat 9: Vikulja1993 collected ($2.50)





PokerStars Hand #153503409195:  Hold'em No Limit ($0.50/$1.00 USD) - 2016/05/18 20:52:35 CET [2016/05/18 14:52:35 ET]
Table 'Pandora' 9-max Seat #5 is the button
Seat 1: deadkiller1 ($124.16 in chips) 
Seat 4: mooose100 ($202.97 in chips) 
Seat 5: Strikerman25 ($38.50 in chips) 
Seat 6: Moszes360 ($104.95 in chips) 
Seat 7: torkkdnm ($100 in chips) 
Seat 8: matiko09 ($115.02 in chips) 
Seat 9: oscarleon ($109.98 in chips) 
Moszes360: posts small blind $0.50
torkkdnm: posts big blind $1
Vikulja1993: sits out 
vanilica: sits out 
*** HOLE CARDS ***
Dealt to matiko09 [8d 4d]
matiko09: folds 
oscarleon: folds 
deadkiller1: folds 
mooose100: folds 
Strikerman25: raises $1.09 to $2.09
Moszes360: folds 
torkkdnm: folds 
Uncalled bet ($1.09) returned to Strikerman25
Strikerman25 collected $2.50 from pot
Strikerman25: doesn't show hand 
*** SUMMARY ***
Total pot $2.50 | Rake $0 
Seat 1: deadkiller1 folded before Flop (didn't bet)
Seat 4: mooose100 folded before Flop (didn't bet)
Seat 5: Strikerman25 (button) collected ($2.50)
Seat 6: Moszes360 (small blind) folded before Flop
Seat 7: torkkdnm (big blind) folded before Flop
Seat 8: matiko09 folded before Flop (didn't bet)
Seat 9: oscarleon folded before Flop (didn't bet)





PokerStars Hand #153503419127:  Hold'em No Limit ($0.50/$1.00 USD) - 2016/05/18 20:52:46 CET [2016/05/18 14:52:46 ET]
Table 'Samitchell II' 9-max Seat #3 is the button
Seat 1: riggedsh** ($100 in chips) 
Seat 2: cobrik23 ($90.75 in chips) 
Seat 3: vanilica ($110.70 in chips) 
Seat 5: nuuaber ($106.19 in chips) 
Seat 6: Strikerman25 ($40 in chips) 
Seat 7: matiko09 ($101.50 in chips) 
Seat 8: rate8 ($137.02 in chips) 
Zeeshka will be allowed to play after the button
nuuaber: posts small blind $0.50
Strikerman25: posts big blind $1
solbi86: sits out 
*** HOLE CARDS ***
Dealt to matiko09 [Ac Qd]
matiko09: raises $2 to $3
rate8: folds 
riggedsh**: folds 
cobrik23: folds 
vanilica: folds 
nuuaber: folds 
Strikerman25: folds 
Uncalled bet ($2) returned to matiko09
matiko09 collected $2.50 from pot
matiko09: doesn't show hand 
*** SUMMARY ***
Total pot $2.50 | Rake $0 
Seat 1: riggedsh** folded before Flop (didn't bet)
Seat 2: cobrik23 folded before Flop (didn't bet)
Seat 3: vanilica (button) folded before Flop (didn't bet)
Seat 5: nuuaber (small blind) folded before Flop
Seat 6: Strikerman25 (big blind) folded before Flop
Seat 7: matiko09 collected ($2.50)
Seat 8: rate8 folded before Flop (didn't bet)





PokerStars Hand #153503419931:  Hold'em No Limit ($0.50/$1.00 USD) - 2016/05/18 20:52:47 CET [2016/05/18 14:52:47 ET]
Table 'Lorcia II' 9-max Seat #2 is the button
Seat 1: HomerrrJay ($100 in chips) 
Seat 2: lydia12345 ($100 in chips) 
Seat 3: matiko09 ($100 in chips) 
Seat 4: vanilica ($100 in chips) 
Seat 5: nuuaber ($73.30 in chips) 
Seat 7: rate8 ($105.55 in chips) 
Seat 8: Skum1986 ($104.76 in chips) 
Seat 9: porgol ($86 in chips) 
matiko09: posts small blind $0.50
vanilica: posts big blind $1
gkm0nk3y: sits out 
*** HOLE CARDS ***
Dealt to matiko09 [Js 7d]
nuuaber: folds 
rate8: folds 
Skum1986: folds 
porgol: folds 
HomerrrJay: folds 
lydia12345: raises $1 to $2
matiko09: folds 
vanilica: raises $7 to $9
lydia12345: folds 
Uncalled bet ($7) returned to vanilica
vanilica collected $4.50 from pot
vanilica: doesn't show hand 
*** SUMMARY ***
Total pot $4.50 | Rake $0 
Seat 1: HomerrrJay folded before Flop (didn't bet)
Seat 2: lydia12345 (button) folded before Flop
Seat 3: matiko09 (small blind) folded before Flop
Seat 4: vanilica (big blind) collected ($4.50)
Seat 5: nuuaber folded before Flop (didn't bet)
Seat 7: rate8 folded before Flop (didn't bet)
Seat 8: Skum1986 folded before Flop (didn't bet)
Seat 9: porgol folded before Flop (didn't bet)





PokerStars Hand #153503425730:  Hold'em No Limit ($0.50/$1.00 USD) - 2016/05/18 20:52:54 CET [2016/05/18 14:52:54 ET]
Table 'Tatjana III' 9-max Seat #9 is the button
Seat 1: cobrik23 ($175.83 in chips) 
Seat 2: HITYESCA ($152.58 in chips) 
Seat 3: matiko09 ($185.34 in chips) 
Seat 4: lydia12345 ($131.48 in chips) 
Seat 5: deadkiller1 ($101.44 in chips) 
Seat 6: Kihog ($100 in chips) 
Seat 7: rene1984tsv ($110.30 in chips) 
Seat 8: JACQUILF ($100 in chips) 
Seat 9: Moszes360 ($106.57 in chips) 
cobrik23: posts small blind $0.50
HITYESCA: posts big blind $1
*** HOLE CARDS ***
Dealt to matiko09 [7s 9c]
matiko09: folds 
lydia12345: folds 
deadkiller1: folds 
Kihog: raises $1.50 to $2.50
rene1984tsv: calls $2.50
JACQUILF: folds 
Moszes360: folds 
cobrik23: folds 
HITYESCA: calls $1.50
*** FLOP *** [5c 4c Tc]
HITYESCA: checks 
Kihog: bets $5.50
rene1984tsv: folds 
HITYESCA: raises $13.50 to $19
Kihog: calls $13.50
*** TURN *** [5c 4c Tc] [6h]
HITYESCA: bets $18
Kihog: calls $18
*** RIVER *** [5c 4c Tc 6h] [2h]
HITYESCA: bets $69
Kihog: folds 
Uncalled bet ($69) returned to HITYESCA
HITYESCA collected $79.50 from pot
*** SUMMARY ***
Total pot $82 | Rake $2.50 
Board [5c 4c Tc 6h 2h]
Seat 1: cobrik23 (small blind) folded before Flop
Seat 2: HITYESCA (big blind) collected ($79.50)
Seat 3: matiko09 folded before Flop (didn't bet)
Seat 4: lydia12345 folded before Flop (didn't bet)
Seat 5: deadkiller1 folded before Flop (didn't bet)
Seat 6: Kihog folded on the River
Seat 7: rene1984tsv folded on the Flop
Seat 8: JACQUILF folded before Flop (didn't bet)
Seat 9: Moszes360 (button) folded before Flop (didn't bet)





PokerStars Hand #153503431553:  Hold'em No Limit ($0.50/$1.00 USD) - 2016/05/18 20:53:01 CET [2016/05/18 14:53:01 ET]
Table 'Abetti II' 9-max Seat #3 is the button
Seat 1: matiko09 ($104.52 in chips) 
Seat 2: Vikulja1993 ($100 in chips) 
Seat 3: cobrik23 ($133.28 in chips) 
Seat 4: ipashutapkom ($40 in chips) 
Seat 5: blufthenuts ($114.85 in chips) 
Seat 6: Kihog ($100 in chips) 
Seat 7: rate8 ($100 in chips) 
Seat 8: roadster683 ($160.84 in chips) 
Seat 9: lydia12345 ($294.56 in chips) 
ipashutapkom: posts small blind $0.50
blufthenuts: posts big blind $1
*** HOLE CARDS ***
Dealt to matiko09 [7d 6c]
Kihog: folds 
rate8: folds 
roadster683: folds 
lydia12345: folds 
matiko09: folds 
Vikulja1993: folds 
cobrik23: raises $2 to $3
ipashutapkom: folds 
blufthenuts: folds 
Uncalled bet ($2) returned to cobrik23
cobrik23 collected $2.50 from pot
cobrik23: doesn't show hand 
*** SUMMARY ***
Total pot $2.50 | Rake $0 
Seat 1: matiko09 folded before Flop (didn't bet)
Seat 2: Vikulja1993 folded before Flop (didn't bet)
Seat 3: cobrik23 (button) collected ($2.50)
Seat 4: ipashutapkom (small blind) folded before Flop
Seat 5: blufthenuts (big blind) folded before Flop
Seat 6: Kihog folded before Flop (didn't bet)
Seat 7: rate8 folded before Flop (didn't bet)
Seat 8: roadster683 folded before Flop (didn't bet)
Seat 9: lydia12345 folded before Flop (didn't bet)





PokerStars Hand #153503432526:  Hold'em No Limit (€0.50/€1.00 EUR) - 2016/05/18 20:53:02 CET [2016/05/18 14:53:02 ET]
Table 'Pallas II' 9-max Seat #6 is the button
Seat 1: deadkiller1 (€101.50 in chips) 
Seat 2: matiko09 (€189.99 in chips) 
Seat 3: Vikulja1993 (€101.50 in chips) 
Seat 5: cobrik23 (€70.36 in chips) 
Seat 6: HITYESCA (€103.62 in chips) 
Seat 7: rate8 (€100 in chips) 
Seat 8: Kihog (€173.50 in chips) 
Seat 9: stijner1986 (€144.51 in chips) 
rate8: posts small blind €0.50
Kihog: posts big blind €1
*** HOLE CARDS ***
Dealt to matiko09 [5d 7c]
stijner1986: calls €1
deadkiller1: folds 
matiko09: folds 
Vikulja1993: folds 
cobrik23: folds 
HITYESCA: folds 
rate8: folds 
Kihog: checks 
*** FLOP *** [Jd 7s Qd]
Kihog: checks 
stijner1986: bets €2.38
Kihog: calls €2.38
*** TURN *** [Jd 7s Qd] [2s]
Kihog: checks 
stijner1986: bets €4
Kihog: folds 
Uncalled bet (€4) returned to stijner1986
stijner1986 collected €6.90 from pot
stijner1986: doesn't show hand 
*** SUMMARY ***
Total pot €7.26 | Rake €0.36 
Board [Jd 7s Qd 2s]
Seat 1: deadkiller1 folded before Flop (didn't bet)
Seat 2: matiko09 folded before Flop (didn't bet)
Seat 3: Vikulja1993 folded before Flop (didn't bet)
Seat 5: cobrik23 folded before Flop (didn't bet)
Seat 6: HITYESCA (button) folded before Flop (didn't bet)
Seat 7: rate8 (small blind) folded before Flop
Seat 8: Kihog (big blind) folded on the Turn
Seat 9: stijner1986 collected (€6.90)





PokerStars Hand #153503432863:  Hold'em No Limit (€0.50/€1.00 EUR) - 2016/05/18 20:53:02 CET [2016/05/18 14:53:02 ET]
Table 'Lamberta IV' 9-max Seat #9 is the button
Seat 1: Trompeneers (€83.83 in chips) 
Seat 2: TimStone (€123.50 in chips) 
Seat 3: JACQUILF (€100 in chips) 
Seat 4: matiko09 (€117.82 in chips) 
Seat 5: HomerrrJay (€100 in chips) 
Seat 6: Skum1986 (€100 in chips) 
Seat 7: vanilica (€106.32 in chips) 
Seat 8: lydia12345 (€100 in chips) 
Seat 9: Kihog (€101.50 in chips) 
Trompeneers: posts small blind €0.50
TimStone: posts big blind €1
*** HOLE CARDS ***
Dealt to matiko09 [Th 8c]
JACQUILF: folds 
JACQUILF leaves the table
matiko09: folds 
HomerrrJay: folds 
Zeeshka joins the table at seat #3 
Skum1986: folds 
vanilica: folds 
lydia12345: raises €2 to €3
Kihog: folds 
Trompeneers: calls €2.50
TimStone: folds 
*** FLOP *** [4h Jc Qc]
Trompeneers: bets €3
lydia12345: calls €3
*** TURN *** [4h Jc Qc] [Tc]
Trompeneers: bets €5
lydia12345: calls €5
*** RIVER *** [4h Jc Qc Tc] [9s]
Trompeneers: checks 
lydia12345: bets €9
Trompeneers: folds 
Uncalled bet (€9) returned to lydia12345
lydia12345 collected €21.85 from pot
*** SUMMARY ***
Total pot €23 | Rake €1.15 
Board [4h Jc Qc Tc 9s]
Seat 1: Trompeneers (small blind) folded on the River
Seat 2: TimStone (big blind) folded before Flop
Seat 3: JACQUILF folded before Flop (didn't bet)
Seat 4: matiko09 folded before Flop (didn't bet)
Seat 5: HomerrrJay folded before Flop (didn't bet)
Seat 6: Skum1986 folded before Flop (didn't bet)
Seat 7: vanilica folded before Flop (didn't bet)
Seat 8: lydia12345 collected (€21.85)
Seat 9: Kihog (button) folded before Flop (didn't bet)





PokerStars Hand #153503434780:  Hold'em No Limit ($0.50/$1.00 USD) - 2016/05/18 20:53:05 CET [2016/05/18 14:53:05 ET]
Table 'Kayala' 9-max Seat #7 is the button
Seat 1: deadkiller1 ($106.28 in chips) 
Seat 3: matiko09 ($100 in chips) 
Seat 4: HITYESCA ($100 in chips) 
Seat 5: rate8 ($104.12 in chips) 
Seat 6: Strikerman25 ($38.50 in chips) 
Seat 7: kenan-lola ($96.69 in chips) 
Seat 8: cobrik23 ($118.84 in chips) 
Seat 9: Vikulja1993 ($101.50 in chips) 
cobrik23: posts small blind $0.50
Vikulja1993: posts big blind $1
solbi86: sits out 
*** HOLE CARDS ***
Dealt to matiko09 [Ac 8c]
deadkiller1: folds 
matiko09: folds 
HITYESCA: folds 
rate8: raises $2 to $3
Strikerman25: folds 
kenan-lola: folds 
cobrik23: folds 
Vikulja1993: folds 
Uncalled bet ($2) returned to rate8
rate8 collected $2.50 from pot
rate8: doesn't show hand 
*** SUMMARY ***
Total pot $2.50 | Rake $0 
Seat 1: deadkiller1 folded before Flop (didn't bet)
Seat 3: matiko09 folded before Flop (didn't bet)
Seat 4: HITYESCA folded before Flop (didn't bet)
Seat 5: rate8 collected ($2.50)
Seat 6: Strikerman25 folded before Flop (didn't bet)
Seat 7: kenan-lola (button) folded before Flop (didn't bet)
Seat 8: cobrik23 (small blind) folded before Flop
Seat 9: Vikulja1993 (big blind) folded before Flop





PokerStars Hand #153503445116:  Hold'em No Limit ($0.50/$1.00 USD) - 2016/05/18 20:53:17 CET [2016/05/18 14:53:17 ET]
Table 'Samitchell II' 9-max Seat #5 is the button
Seat 1: riggedsh** ($100 in chips) 
Seat 2: cobrik23 ($90.75 in chips) 
Seat 3: vanilica ($110.70 in chips) 
Seat 5: nuuaber ($105.69 in chips) 
Seat 6: Strikerman25 ($39 in chips) 
Seat 7: matiko09 ($103 in chips) 
Seat 8: rate8 ($137.02 in chips) 
Strikerman25: posts small blind $0.50
matiko09: posts big blind $1
solbi86: sits out 
Zeeshka: sits out 
*** HOLE CARDS ***
Dealt to matiko09 [8c 4c]
rate8: folds 
riggedsh**: raises $2 to $3
cobrik23: folds 
vanilica: calls $3
nuuaber: folds 
Strikerman25: folds 
matiko09: folds 
*** FLOP *** [7c 3h 9d]
riggedsh**: checks 
vanilica: checks 
*** TURN *** [7c 3h 9d] [7d]
riggedsh**: checks 
vanilica: checks 
*** RIVER *** [7c 3h 9d 7d] [2h]
riggedsh**: checks 
vanilica: checks 
*** SHOW DOWN ***
riggedsh**: shows [Ah Ts] (a pair of Sevens)
vanilica: shows [Qd As] (a pair of Sevens - Ace+Queen kicker)
vanilica collected $7.12 from pot
*** SUMMARY ***
Total pot $7.50 | Rake $0.38 
Board [7c 3h 9d 7d 2h]
Seat 1: riggedsh** showed [Ah Ts] and lost with a pair of Sevens
Seat 2: cobrik23 folded before Flop (didn't bet)
Seat 3: vanilica showed [Qd As] and won ($7.12) with a pair of Sevens
Seat 5: nuuaber (button) folded before Flop (didn't bet)
Seat 6: Strikerman25 (small blind) folded before Flop
Seat 7: matiko09 (big blind) folded before Flop
Seat 8: rate8 folded before Flop (didn't bet)





PokerStars Hand #153503447859:  Hold'em No Limit ($0.50/$1.00 USD) - 2016/05/18 20:53:20 CET [2016/05/18 14:53:20 ET]
Table 'Pandora' 9-max Seat #6 is the button
Seat 1: deadkiller1 ($124.16 in chips) 
Seat 4: mooose100 ($202.97 in chips) 
Seat 5: Strikerman25 ($40 in chips) 
Seat 6: Moszes360 ($104.45 in chips) 
Seat 7: torkkdnm ($100 in chips) 
Seat 8: matiko09 ($115.02 in chips) 
Seat 9: oscarleon ($109.98 in chips) 
torkkdnm: posts small blind $0.50
matiko09: posts big blind $1
Vikulja1993: sits out 
vanilica: sits out 
*** HOLE CARDS ***
Dealt to matiko09 [Jc Js]
oscarleon: raises $2 to $3
deadkiller1: folds 
mooose100: calls $3
Strikerman25: folds 
Moszes360: folds 
torkkdnm: folds 
matiko09: calls $2
*** FLOP *** [7s 3c 6c]
matiko09: bets $7
oscarleon: folds 
mooose100: folds 
Uncalled bet ($7) returned to matiko09
matiko09 collected $9.02 from pot
matiko09: doesn't show hand 
*** SUMMARY ***
Total pot $9.50 | Rake $0.48 
Board [7s 3c 6c]
Seat 1: deadkiller1 folded before Flop (didn't bet)
Seat 4: mooose100 folded on the Flop
Seat 5: Strikerman25 folded before Flop (didn't bet)
Seat 6: Moszes360 (button) folded before Flop (didn't bet)
Seat 7: torkkdnm (small blind) folded before Flop
Seat 8: matiko09 (big blind) collected ($9.02)
Seat 9: oscarleon folded on the Flop





PokerStars Hand #153503449257:  Hold'em No Limit ($0.50/$1.00 USD) - 2016/05/18 20:53:21 CET [2016/05/18 14:53:21 ET]
Table 'Lorcia II' 9-max Seat #3 is the button
Seat 1: HomerrrJay ($100 in chips) 
Seat 2: lydia12345 ($100 in chips) 
Seat 3: matiko09 ($100 in chips) 
Seat 4: vanilica ($102.50 in chips) 
Seat 5: nuuaber ($73.30 in chips) 
Seat 7: rate8 ($105.55 in chips) 
Seat 8: Skum1986 ($104.76 in chips) 
Seat 9: porgol ($86 in chips) 
vanilica: posts small blind $0.50
nuuaber: posts big blind $1
gkm0nk3y: sits out 
*** HOLE CARDS ***
Dealt to matiko09 [5d Kd]
rate8: folds 
Skum1986: folds 
porgol: folds 
HomerrrJay: folds 
lydia12345: folds 
matiko09: raises $1.27 to $2.27
vanilica: folds 
nuuaber: raises $5.04 to $7.31
matiko09: folds 
Uncalled bet ($5.04) returned to nuuaber
nuuaber collected $5.04 from pot
nuuaber: doesn't show hand 
*** SUMMARY ***
Total pot $5.04 | Rake $0 
Seat 1: HomerrrJay folded before Flop (didn't bet)
Seat 2: lydia12345 folded before Flop (didn't bet)
Seat 3: matiko09 (button) folded before Flop
Seat 4: vanilica (small blind) folded before Flop
Seat 5: nuuaber (big blind) collected ($5.04)
Seat 7: rate8 folded before Flop (didn't bet)
Seat 8: Skum1986 folded before Flop (didn't bet)
Seat 9: porgol folded before Flop (didn't bet)





PokerStars Hand #153503463524:  Hold'em No Limit ($0.50/$1.00 USD) - 2016/05/18 20:53:38 CET [2016/05/18 14:53:38 ET]
Table 'Abetti II' 9-max Seat #4 is the button
Seat 1: matiko09 ($104.52 in chips) 
Seat 2: Vikulja1993 ($100 in chips) 
Seat 3: cobrik23 ($134.78 in chips) 
Seat 4: ipashutapkom ($40 in chips) 
Seat 5: blufthenuts ($113.85 in chips) 
Seat 6: Kihog ($100 in chips) 
Seat 7: rate8 ($100 in chips) 
Seat 8: roadster683 ($160.84 in chips) 
Seat 9: lydia12345 ($294.56 in chips) 
blufthenuts: posts small blind $0.50
Kihog: posts big blind $1
*** HOLE CARDS ***
Dealt to matiko09 [2s Qs]
rate8: folds 
roadster683: folds 
lydia12345: folds 
matiko09: folds 
Vikulja1993: folds 
cobrik23: folds 
ipashutapkom: folds 
blufthenuts: calls $0.50
Kihog: checks 
*** FLOP *** [4d 9c Th]
blufthenuts: checks 
Kihog: checks 
*** TURN *** [4d 9c Th] [Ts]
blufthenuts: bets $2
Kihog: folds 
Uncalled bet ($2) returned to blufthenuts
blufthenuts collected $1.90 from pot
blufthenuts: doesn't show hand 
*** SUMMARY ***
Total pot $2 | Rake $0.10 
Board [4d 9c Th Ts]
Seat 1: matiko09 folded before Flop (didn't bet)
Seat 2: Vikulja1993 folded before Flop (didn't bet)
Seat 3: cobrik23 folded before Flop (didn't bet)
Seat 4: ipashutapkom (button) folded before Flop (didn't bet)
Seat 5: blufthenuts (small blind) collected ($1.90)
Seat 6: Kihog (big blind) folded on the Turn
Seat 7: rate8 folded before Flop (didn't bet)
Seat 8: roadster683 folded before Flop (didn't bet)
Seat 9: lydia12345 folded before Flop (didn't bet)





PokerStars Hand #153503466830:  Hold'em No Limit ($0.50/$1.00 USD) - 2016/05/18 20:53:42 CET [2016/05/18 14:53:42 ET]
Table 'Kayala' 9-max Seat #8 is the button
Seat 1: deadkiller1 ($106.28 in chips) 
Seat 3: matiko09 ($100 in chips) 
Seat 4: HITYESCA ($100 in chips) 
Seat 5: rate8 ($105.62 in chips) 
Seat 6: Strikerman25 ($38.50 in chips) 
Seat 7: kenan-lola ($96.69 in chips) 
Seat 8: cobrik23 ($118.34 in chips) 
Seat 9: Vikulja1993 ($100.50 in chips) 
Vikulja1993: posts small blind $0.50
deadkiller1: posts big blind $1
solbi86: sits out 
*** HOLE CARDS ***
Dealt to matiko09 [7s 8c]
matiko09: folds 
HITYESCA: folds 
rate8: folds 
Strikerman25: raises $2 to $3
kenan-lola: calls $3
cobrik23: folds 
Vikulja1993: folds 
deadkiller1: folds 
*** FLOP *** [3s Tc 4c]
Strikerman25: bets $3.56
kenan-lola: calls $3.56
*** TURN *** [3s Tc 4c] [2c]
Strikerman25: checks 
kenan-lola: checks 
*** RIVER *** [3s Tc 4c 2c] [Ts]
Strikerman25: checks 
kenan-lola: bets $10
Strikerman25: folds 
Uncalled bet ($10) returned to kenan-lola
kenan-lola collected $13.89 from pot
kenan-lola: doesn't show hand 
*** SUMMARY ***
Total pot $14.62 | Rake $0.73 
Board [3s Tc 4c 2c Ts]
Seat 1: deadkiller1 (big blind) folded before Flop
Seat 3: matiko09 folded before Flop (didn't bet)
Seat 4: HITYESCA folded before Flop (didn't bet)
Seat 5: rate8 folded before Flop (didn't bet)
Seat 6: Strikerman25 folded on the River
Seat 7: kenan-lola collected ($13.89)
Seat 8: cobrik23 (button) folded before Flop (didn't bet)
Seat 9: Vikulja1993 (small blind) folded before Flop





PokerStars Hand #153503488423:  Hold'em No Limit ($0.50/$1.00 USD) - 2016/05/18 20:54:07 CET [2016/05/18 14:54:07 ET]
Table 'Pandora' 9-max Seat #7 is the button
Seat 1: deadkiller1 ($124.16 in chips) 
Seat 4: mooose100 ($199.97 in chips) 
Seat 5: Strikerman25 ($40 in chips) 
Seat 6: Moszes360 ($104.45 in chips) 
Seat 7: torkkdnm ($100 in chips) 
Seat 8: matiko09 ($121.04 in chips) 
Seat 9: oscarleon ($106.98 in chips) 
matiko09: posts small blind $0.50
oscarleon: posts big blind $1
Vikulja1993: sits out 
vanilica: sits out 
*** HOLE CARDS ***
Dealt to matiko09 [2s Jh]
deadkiller1: folds 
mooose100: calls $1
Strikerman25: raises $3 to $4
Moszes360: folds 
torkkdnm: folds 
matiko09: folds 
oscarleon: folds 
mooose100: folds 
Uncalled bet ($3) returned to Strikerman25
Strikerman25 collected $3.50 from pot
Strikerman25: doesn't show hand 
*** SUMMARY ***
Total pot $3.50 | Rake $0 
Seat 1: deadkiller1 folded before Flop (didn't bet)
Seat 4: mooose100 folded before Flop
Seat 5: Strikerman25 collected ($3.50)
Seat 6: Moszes360 folded before Flop (didn't bet)
Seat 7: torkkdnm (button) folded before Flop (didn't bet)
Seat 8: matiko09 (small blind) folded before Flop
Seat 9: oscarleon (big blind) folded before Flop





PokerStars Hand #153503490863:  Hold'em No Limit ($0.50/$1.00 USD) - 2016/05/18 20:54:09 CET [2016/05/18 14:54:09 ET]
Table 'Lorcia II' 9-max Seat #4 is the button
Seat 1: HomerrrJay ($100 in chips) 
Seat 2: lydia12345 ($100 in chips) 
Seat 3: matiko09 ($100 in chips) 
Seat 4: vanilica ($102 in chips) 
Seat 5: nuuaber ($76.07 in chips) 
Seat 6: gkm0nk3y ($100 in chips) 
Seat 7: rate8 ($105.55 in chips) 
Seat 8: Skum1986 ($104.76 in chips) 
Seat 9: porgol ($86 in chips) 
nuuaber: posts small blind $0.50
gkm0nk3y: posts big blind $1
*** HOLE CARDS ***
Dealt to matiko09 [Kc 4h]
rate8: folds 
Skum1986: folds 
porgol: raises $5 to $6
HomerrrJay: folds 
lydia12345: folds 
matiko09: folds 
vanilica: folds 
nuuaber: folds 
gkm0nk3y: folds 
Uncalled bet ($5) returned to porgol
porgol collected $2.50 from pot
porgol: doesn't show hand 
*** SUMMARY ***
Total pot $2.50 | Rake $0 
Seat 1: HomerrrJay folded before Flop (didn't bet)
Seat 2: lydia12345 folded before Flop (didn't bet)
Seat 3: matiko09 folded before Flop (didn't bet)
Seat 4: vanilica (button) folded before Flop (didn't bet)
Seat 5: nuuaber (small blind) folded before Flop
Seat 6: gkm0nk3y (big blind) folded before Flop
Seat 7: rate8 folded before Flop (didn't bet)
Seat 8: Skum1986 folded before Flop (didn't bet)
Seat 9: porgol collected ($2.50)





PokerStars Hand #153503516735:  Hold'em No Limit (€0.50/€1.00 EUR) - 2016/05/18 20:54:39 CET [2016/05/18 14:54:39 ET]
Table 'Lamberta IV' 9-max Seat #1 is the button
Seat 1: Trompeneers (€72.83 in chips) 
Seat 2: TimStone (€122.50 in chips) 
Seat 3: Zeeshka (€100 in chips) 
Seat 4: matiko09 (€117.82 in chips) 
Seat 5: HomerrrJay (€100 in chips) 
Seat 6: Skum1986 (€100 in chips) 
Seat 7: vanilica (€106.32 in chips) 
Seat 8: lydia12345 (€110.85 in chips) 
Seat 9: Kihog (€101.50 in chips) 
TimStone: posts small blind €0.50
Zeeshka: posts big blind €1
*** HOLE CARDS ***
Dealt to matiko09 [5c Js]
matiko09: folds 
HomerrrJay: folds 
Skum1986: raises €2 to €3
vanilica: folds 
lydia12345: calls €3
Kihog: folds 
Trompeneers: raises €3 to €6
TimStone: folds 
Zeeshka: folds 
Skum1986: calls €3
lydia12345: raises €22 to €28
Trompeneers: raises €44.83 to €72.83 and is all-in
Skum1986: folds 
lydia12345: calls €44.83
*** FLOP *** [As 2c Kc]
*** TURN *** [As 2c Kc] [6d]
*** RIVER *** [As 2c Kc 6d] [4s]
*** SHOW DOWN ***
lydia12345: shows [Ks Kh] (three of a kind, Kings)
Trompeneers: shows [Qc Qd] (a pair of Queens)
lydia12345 collected €150.91 from pot
*** SUMMARY ***
Total pot €153.16 | Rake €2.25 
Board [As 2c Kc 6d 4s]
Seat 1: Trompeneers (button) showed [Qc Qd] and lost with a pair of Queens
Seat 2: TimStone (small blind) folded before Flop
Seat 3: Zeeshka (big blind) folded before Flop
Seat 4: matiko09 folded before Flop (didn't bet)
Seat 5: HomerrrJay folded before Flop (didn't bet)
Seat 6: Skum1986 folded before Flop
Seat 7: vanilica folded before Flop (didn't bet)
Seat 8: lydia12345 showed [Ks Kh] and won (€150.91) with three of a kind, Kings
Seat 9: Kihog folded before Flop (didn't bet)





PokerStars Hand #153503521977:  Hold'em No Limit ($0.50/$1.00 USD) - 2016/05/18 20:54:45 CET [2016/05/18 14:54:45 ET]
Table 'Abetti II' 9-max Seat #5 is the button
Seat 1: matiko09 ($104.52 in chips) 
Seat 2: Vikulja1993 ($100 in chips) 
Seat 3: cobrik23 ($134.78 in chips) 
Seat 4: ipashutapkom ($40 in chips) 
Seat 5: blufthenuts ($114.75 in chips) 
Seat 6: Kihog ($100 in chips) 
Seat 7: rate8 ($100 in chips) 
Seat 8: roadster683 ($160.84 in chips) 
Seat 9: lydia12345 ($294.56 in chips) 
Kihog: posts small blind $0.50
rate8: posts big blind $1
*** HOLE CARDS ***
Dealt to matiko09 [7s 3c]
roadster683: folds 
lydia12345: folds 
matiko09: folds 
Vikulja1993: folds 
cobrik23: raises $2 to $3
ipashutapkom: raises $5 to $8
blufthenuts: raises $11 to $19
Kihog: folds 
rate8: folds 
cobrik23: folds 
ipashutapkom: folds 
Uncalled bet ($11) returned to blufthenuts
blufthenuts collected $20.50 from pot
blufthenuts: doesn't show hand 
*** SUMMARY ***
Total pot $20.50 | Rake $0 
Seat 1: matiko09 folded before Flop (didn't bet)
Seat 2: Vikulja1993 folded before Flop (didn't bet)
Seat 3: cobrik23 folded before Flop
Seat 4: ipashutapkom folded before Flop
Seat 5: blufthenuts (button) collected ($20.50)
Seat 6: Kihog (small blind) folded before Flop
Seat 7: rate8 (big blind) folded before Flop
Seat 8: roadster683 folded before Flop (didn't bet)
Seat 9: lydia12345 folded before Flop (didn't bet)





PokerStars Hand #153503523924:  Hold'em No Limit (€0.50/€1.00 EUR) - 2016/05/18 20:54:48 CET [2016/05/18 14:54:48 ET]
Table 'Pallas II' 9-max Seat #7 is the button
Seat 1: deadkiller1 (€101.50 in chips) 
Seat 2: matiko09 (€189.99 in chips) 
Seat 3: Vikulja1993 (€101.50 in chips) 
Seat 5: cobrik23 (€70.36 in chips) 
Seat 6: HITYESCA (€103.62 in chips) 
Seat 7: rate8 (€100 in chips) 
Seat 8: Kihog (€170.12 in chips) 
Seat 9: stijner1986 (€148.03 in chips) 
Kihog: posts small blind €0.50
stijner1986: posts big blind €1
*** HOLE CARDS ***
Dealt to matiko09 [9d 8h]
deadkiller1: folds 
matiko09: folds 
Vikulja1993: folds 
cobrik23: folds 
HITYESCA: raises €1.50 to €2.50
rate8: calls €2.50
Kihog: calls €2
stijner1986: calls €1.50
*** FLOP *** [6s 6h 3s]
Kihog: checks 
stijner1986: checks 
HITYESCA: bets €6
rate8: calls €6
Kihog: folds 
stijner1986: folds 
*** TURN *** [6s 6h 3s] [As]
HITYESCA: checks 
rate8: checks 
*** RIVER *** [6s 6h 3s As] [Qh]
HITYESCA: checks 
rate8: bets €14.84
HITYESCA: folds 
Uncalled bet (€14.84) returned to rate8
rate8 collected €20.90 from pot
rate8: doesn't show hand 
*** SUMMARY ***
Total pot €22 | Rake €1.10 
Board [6s 6h 3s As Qh]
Seat 1: deadkiller1 folded before Flop (didn't bet)
Seat 2: matiko09 folded before Flop (didn't bet)
Seat 3: Vikulja1993 folded before Flop (didn't bet)
Seat 5: cobrik23 folded before Flop (didn't bet)
Seat 6: HITYESCA folded on the River
Seat 7: rate8 (button) collected (€20.90)
Seat 8: Kihog (small blind) folded on the Flop
Seat 9: stijner1986 (big blind) folded on the Flop





PokerStars Hand #153503525479:  Hold'em No Limit ($0.50/$1.00 USD) - 2016/05/18 20:54:49 CET [2016/05/18 14:54:49 ET]
Table 'Samitchell II' 9-max Seat #6 is the button
Seat 1: riggedsh** ($100 in chips) 
Seat 2: cobrik23 ($90.75 in chips) 
Seat 3: vanilica ($114.82 in chips) 
Seat 5: nuuaber ($105.69 in chips) 
Seat 6: Strikerman25 ($38.50 in chips) 
Seat 7: matiko09 ($102 in chips) 
Seat 8: rate8 ($137.02 in chips) 
matiko09: posts small blind $0.50
rate8: posts big blind $1
solbi86: sits out 
Zeeshka: sits out 
*** HOLE CARDS ***
Dealt to matiko09 [6s 5s]
riggedsh**: raises $2 to $3
cobrik23: folds 
vanilica: calls $3
nuuaber: folds 
Strikerman25: folds 
matiko09: folds 
rate8: folds 
*** FLOP *** [6h 3d 5d]
riggedsh**: checks 
vanilica: checks 
*** TURN *** [6h 3d 5d] [8c]
riggedsh**: checks 
vanilica: checks 
*** RIVER *** [6h 3d 5d 8c] [Kc]
riggedsh**: checks 
vanilica: checks 
*** SHOW DOWN ***
riggedsh**: shows [Kd Ah] (a pair of Kings)
vanilica: mucks hand 
riggedsh** collected $7.12 from pot
*** SUMMARY ***
Total pot $7.50 | Rake $0.38 
Board [6h 3d 5d 8c Kc]
Seat 1: riggedsh** showed [Kd Ah] and won ($7.12) with a pair of Kings
Seat 2: cobrik23 folded before Flop (didn't bet)
Seat 3: vanilica mucked [2c 2d]
Seat 5: nuuaber folded before Flop (didn't bet)
Seat 6: Strikerman25 (button) folded before Flop (didn't bet)
Seat 7: matiko09 (small blind) folded before Flop
Seat 8: rate8 (big blind) folded before Flop





PokerStars Hand #153503528932:  Hold'em No Limit ($0.50/$1.00 USD) - 2016/05/18 20:54:53 CET [2016/05/18 14:54:53 ET]
Table 'Lorcia II' 9-max Seat #5 is the button
Seat 1: HomerrrJay ($100 in chips) 
Seat 2: lydia12345 ($100 in chips) 
Seat 3: matiko09 ($100 in chips) 
Seat 4: vanilica ($102 in chips) 
Seat 5: nuuaber ($75.57 in chips) 
Seat 6: gkm0nk3y ($100 in chips) 
Seat 7: rate8 ($105.55 in chips) 
Seat 8: Skum1986 ($104.76 in chips) 
Seat 9: porgol ($87.50 in chips) 
gkm0nk3y: posts small blind $0.50
rate8: posts big blind $1
*** HOLE CARDS ***
Dealt to matiko09 [5s 4c]
Skum1986: folds 
porgol: calls $1
HomerrrJay: folds 
lydia12345: calls $1
matiko09: folds 
vanilica: calls $1
nuuaber: calls $1
gkm0nk3y: folds 
rate8: checks 
*** FLOP *** [8s Jh 6d]
rate8: checks 
porgol: checks 
lydia12345: bets $6
vanilica: folds 
nuuaber: folds 
rate8: folds 
porgol: folds 
Uncalled bet ($6) returned to lydia12345
lydia12345 collected $5.22 from pot
*** SUMMARY ***
Total pot $5.50 | Rake $0.28 
Board [8s Jh 6d]
Seat 1: HomerrrJay folded before Flop (didn't bet)
Seat 2: lydia12345 collected ($5.22)
Seat 3: matiko09 folded before Flop (didn't bet)
Seat 4: vanilica folded on the Flop
Seat 5: nuuaber (button) folded on the Flop
Seat 6: gkm0nk3y (small blind) folded before Flop
Seat 7: rate8 (big blind) folded on the Flop
Seat 8: Skum1986 folded before Flop (didn't bet)
Seat 9: porgol folded on the Flop





PokerStars Hand #153503539376:  Hold'em No Limit ($0.50/$1.00 USD) - 2016/05/18 20:55:06 CET [2016/05/18 14:55:06 ET]
Table 'Tatjana III' 9-max Seat #1 is the button
Seat 1: cobrik23 ($175.33 in chips) 
Seat 2: HITYESCA ($192.58 in chips) 
Seat 3: matiko09 ($185.34 in chips) 
Seat 4: lydia12345 ($131.48 in chips) 
Seat 5: deadkiller1 ($101.44 in chips) 
Seat 6: Kihog ($100 in chips) 
Seat 7: rene1984tsv ($107.80 in chips) 
Seat 8: JACQUILF ($100 in chips) 
Seat 9: Moszes360 ($106.57 in chips) 
HITYESCA: posts small blind $0.50
matiko09: posts big blind $1
*** HOLE CARDS ***
Dealt to matiko09 [Tc 6d]
lydia12345: folds 
deadkiller1: folds 
Kihog: folds 
rene1984tsv: calls $1
JACQUILF: folds 
Moszes360: folds 
cobrik23: folds 
HITYESCA: folds 
matiko09: checks 
*** FLOP *** [5c 3h 4d]
matiko09: bets $1.55
rene1984tsv: calls $1.55
*** TURN *** [5c 3h 4d] [Kc]
matiko09: checks 
rene1984tsv: bets $5.32
matiko09: folds 
Uncalled bet ($5.32) returned to rene1984tsv
rene1984tsv collected $5.32 from pot
rene1984tsv: doesn't show hand 
*** SUMMARY ***
Total pot $5.60 | Rake $0.28 
Board [5c 3h 4d Kc]
Seat 1: cobrik23 (button) folded before Flop (didn't bet)
Seat 2: HITYESCA (small blind) folded before Flop
Seat 3: matiko09 (big blind) folded on the Turn
Seat 4: lydia12345 folded before Flop (didn't bet)
Seat 5: deadkiller1 folded before Flop (didn't bet)
Seat 6: Kihog folded before Flop (didn't bet)
Seat 7: rene1984tsv collected ($5.32)
Seat 8: JACQUILF folded before Flop (didn't bet)
Seat 9: Moszes360 folded before Flop (didn't bet)





PokerStars Hand #153503544245:  Hold'em No Limit ($0.50/$1.00 USD) - 2016/05/18 20:55:12 CET [2016/05/18 14:55:12 ET]
Table 'Pandora' 9-max Seat #8 is the button
Seat 1: deadkiller1 ($124.16 in chips) 
Seat 4: mooose100 ($198.97 in chips) 
Seat 5: Strikerman25 ($42.50 in chips) 
Seat 6: Moszes360 ($104.45 in chips) 
Seat 7: torkkdnm ($100 in chips) 
Seat 8: matiko09 ($120.54 in chips) 
Seat 9: oscarleon ($105.98 in chips) 
oscarleon: posts small blind $0.50
deadkiller1: posts big blind $1
Vikulja1993: sits out 
vanilica: sits out 
*** HOLE CARDS ***
Dealt to matiko09 [8s 4d]
mooose100: calls $1
Strikerman25: folds 
Moszes360: raises $3 to $4
torkkdnm: folds 
matiko09: folds 
oscarleon: folds 
deadkiller1: folds 
mooose100: folds 
Uncalled bet ($3) returned to Moszes360
Moszes360 collected $3.50 from pot
Moszes360: doesn't show hand 
*** SUMMARY ***
Total pot $3.50 | Rake $0 
Seat 1: deadkiller1 (big blind) folded before Flop
Seat 4: mooose100 folded before Flop
Seat 5: Strikerman25 folded before Flop (didn't bet)
Seat 6: Moszes360 collected ($3.50)
Seat 7: torkkdnm folded before Flop (didn't bet)
Seat 8: matiko09 (button) folded before Flop (didn't bet)
Seat 9: oscarleon (small blind) folded before Flop





PokerStars Hand #153503961785:  Hold'em No Limit ($0.50/$1.00 USD) - 2016/05/18 21:04:33 CET [2016/05/18 15:04:33 ET]
Table 'Samitchell II' 9-max Seat #5 is the button
Seat 1: riggedsh** ($115.50 in chips) 
Seat 2: IRAVABAN ($40 in chips) 
Seat 3: vanilica ($110.32 in chips) 
Seat 4: Zeeshka ($100 in chips) 
Seat 5: nuuaber ($109.64 in chips) 
Seat 6: Strikerman25 ($39 in chips) 
Seat 7: matiko09 ($101.50 in chips) 
Seat 8: rate8 ($131.52 in chips) 
Seat 9: solbi86 ($105.92 in chips) 
Strikerman25: posts small blind $0.50
matiko09: posts big blind $1
*** HOLE CARDS ***
Dealt to matiko09 [6s 3h]
rate8: folds 
solbi86: raises $2 to $3
riggedsh**: folds 
IRAVABAN: folds 
vanilica: folds 
Zeeshka: folds 
nuuaber: folds 
Strikerman25: folds 
matiko09: folds 
Uncalled bet ($2) returned to solbi86
solbi86 collected $2.50 from pot
solbi86: doesn't show hand 
*** SUMMARY ***
Total pot $2.50 | Rake $0 
Seat 1: riggedsh** folded before Flop (didn't bet)
Seat 2: IRAVABAN folded before Flop (didn't bet)
Seat 3: vanilica folded before Flop (didn't bet)
Seat 4: Zeeshka folded before Flop (didn't bet)
Seat 5: nuuaber (button) folded before Flop (didn't bet)
Seat 6: Strikerman25 (small blind) folded before Flop
Seat 7: matiko09 (big blind) folded before Flop
Seat 8: rate8 folded before Flop (didn't bet)
Seat 9: solbi86 collected ($2.50)





PokerStars Hand #153503988036:  Hold'em No Limit ($0.50/$1.00 USD) - 2016/05/18 21:05:02 CET [2016/05/18 15:05:02 ET]
Table 'Samitchell II' 9-max Seat #6 is the button
Seat 1: riggedsh** ($115.50 in chips) 
Seat 2: IRAVABAN ($40 in chips) 
Seat 3: vanilica ($110.32 in chips) 
Seat 4: Zeeshka ($100 in chips) 
Seat 5: nuuaber ($109.64 in chips) 
Seat 6: Strikerman25 ($38.50 in chips) 
Seat 7: matiko09 ($100.50 in chips) 
Seat 8: rate8 ($131.52 in chips) 
Seat 9: solbi86 ($107.42 in chips) 
matiko09: posts small blind $0.50
rate8: posts big blind $1
*** HOLE CARDS ***
Dealt to matiko09 [6d 8d]
solbi86: folds 
riggedsh**: folds 
IRAVABAN: folds 
vanilica: folds 
Zeeshka: folds 
nuuaber: raises $2.50 to $3.50
Strikerman25: folds 
matiko09: folds 
rate8: folds 
Uncalled bet ($2.50) returned to nuuaber
nuuaber collected $2.50 from pot
nuuaber: doesn't show hand 
*** SUMMARY ***
Total pot $2.50 | Rake $0 
Seat 1: riggedsh** folded before Flop (didn't bet)
Seat 2: IRAVABAN folded before Flop (didn't bet)
Seat 3: vanilica folded before Flop (didn't bet)
Seat 4: Zeeshka folded before Flop (didn't bet)
Seat 5: nuuaber collected ($2.50)
Seat 6: Strikerman25 (button) folded before Flop (didn't bet)
Seat 7: matiko09 (small blind) folded before Flop
Seat 8: rate8 (big blind) folded before Flop
Seat 9: solbi86 folded before Flop (didn't bet)





PokerStars Hand #153504014989:  Hold'em No Limit ($0.50/$1.00 USD) - 2016/05/18 21:05:32 CET [2016/05/18 15:05:32 ET]
Table 'Samitchell II' 9-max Seat #7 is the button
Seat 1: riggedsh** ($115.50 in chips) 
Seat 2: IRAVABAN ($40 in chips) 
Seat 3: vanilica ($110.32 in chips) 
Seat 4: Zeeshka ($100 in chips) 
Seat 5: nuuaber ($111.14 in chips) 
Seat 6: Strikerman25 ($38.50 in chips) 
Seat 7: matiko09 ($100 in chips) 
Seat 8: rate8 ($130.52 in chips) 
Seat 9: solbi86 ($107.42 in chips) 
rate8: posts small blind $0.50
solbi86: posts big blind $1
*** HOLE CARDS ***
Dealt to matiko09 [6c 9h]
riggedsh**: folds 
IRAVABAN: folds 
vanilica: folds 
Zeeshka: raises $2 to $3
nuuaber: folds 
Strikerman25: raises $4.50 to $7.50
matiko09: folds 
rate8: folds 
solbi86: folds 
Zeeshka: folds 
Uncalled bet ($4.50) returned to Strikerman25
Strikerman25 collected $7.50 from pot
Strikerman25: doesn't show hand 
*** SUMMARY ***
Total pot $7.50 | Rake $0 
Seat 1: riggedsh** folded before Flop (didn't bet)
Seat 2: IRAVABAN folded before Flop (didn't bet)
Seat 3: vanilica folded before Flop (didn't bet)
Seat 4: Zeeshka folded before Flop
Seat 5: nuuaber folded before Flop (didn't bet)
Seat 6: Strikerman25 collected ($7.50)
Seat 7: matiko09 (button) folded before Flop (didn't bet)
Seat 8: rate8 (small blind) folded before Flop
Seat 9: solbi86 (big blind) folded before Flop





PokerStars Hand #153504026232:  Hold'em No Limit ($0.50/$1.00 USD) - 2016/05/18 21:05:45 CET [2016/05/18 15:05:45 ET]
Table 'Abetti II' 9-max Seat #8 is the button
Seat 1: matiko09 ($104.52 in chips) 
Seat 2: Vikulja1993 ($100 in chips) 
Seat 3: cobrik23 ($155.13 in chips) 
Seat 4: ipashutapkom ($40 in chips) 
Seat 5: blufthenuts ($150.75 in chips) 
Seat 6: Kihog ($100 in chips) 
Seat 7: rate8 ($100 in chips) 
Seat 8: roadster683 ($171.34 in chips) 
Seat 9: lydia12345 ($275.23 in chips) 
lydia12345: posts small blind $0.50
matiko09: posts big blind $1
*** HOLE CARDS ***
Dealt to matiko09 [Kc 5c]
Vikulja1993: folds 
cobrik23: folds 
ipashutapkom: folds 
blufthenuts: folds 
Kihog: folds 
rate8: raises $2 to $3
roadster683: folds 
lydia12345: folds 
matiko09: folds 
Uncalled bet ($2) returned to rate8
rate8 collected $2.50 from pot
*** SUMMARY ***
Total pot $2.50 | Rake $0 
Seat 1: matiko09 (big blind) folded before Flop
Seat 2: Vikulja1993 folded before Flop (didn't bet)
Seat 3: cobrik23 folded before Flop (didn't bet)
Seat 4: ipashutapkom folded before Flop (didn't bet)
Seat 5: blufthenuts folded before Flop (didn't bet)
Seat 6: Kihog folded before Flop (didn't bet)
Seat 7: rate8 collected ($2.50)
Seat 8: roadster683 (button) folded before Flop (didn't bet)
Seat 9: lydia12345 (small blind) folded before Flop





PokerStars Hand #153504047206:  Hold'em No Limit ($0.50/$1.00 USD) - 2016/05/18 21:06:08 CET [2016/05/18 15:06:08 ET]
Table 'Samitchell II' 9-max Seat #8 is the button
Seat 1: riggedsh** ($115.50 in chips) 
Seat 2: IRAVABAN ($40 in chips) 
Seat 3: vanilica ($110.32 in chips) 
Seat 4: Zeeshka ($100 in chips) 
Seat 5: nuuaber ($111.14 in chips) 
Seat 6: Strikerman25 ($43 in chips) 
Seat 7: matiko09 ($100 in chips) 
Seat 8: rate8 ($130.02 in chips) 
Seat 9: solbi86 ($106.42 in chips) 
solbi86: posts small blind $0.50
riggedsh**: posts big blind $1
*** HOLE CARDS ***
Dealt to matiko09 [9s 4c]
IRAVABAN: folds 
vanilica: folds 
Zeeshka: folds 
nuuaber: folds 
Strikerman25: raises $1.50 to $2.50
matiko09: folds 
rate8: folds 
solbi86: folds 
riggedsh**: folds 
Uncalled bet ($1.50) returned to Strikerman25
Strikerman25 collected $2.50 from pot
Strikerman25: doesn't show hand 
*** SUMMARY ***
Total pot $2.50 | Rake $0 
Seat 1: riggedsh** (big blind) folded before Flop
Seat 2: IRAVABAN folded before Flop (didn't bet)
Seat 3: vanilica folded before Flop (didn't bet)
Seat 4: Zeeshka folded before Flop (didn't bet)
Seat 5: nuuaber folded before Flop (didn't bet)
Seat 6: Strikerman25 collected ($2.50)
Seat 7: matiko09 folded before Flop (didn't bet)
Seat 8: rate8 (button) folded before Flop (didn't bet)
Seat 9: solbi86 (small blind) folded before Flop





PokerStars Hand #153504074379:  Hold'em No Limit ($0.50/$1.00 USD) - 2016/05/18 21:06:38 CET [2016/05/18 15:06:38 ET]
Table 'Abetti II' 9-max Seat #9 is the button
Seat 1: matiko09 ($103.52 in chips) 
Seat 2: Vikulja1993 ($100 in chips) 
Seat 3: cobrik23 ($155.13 in chips) 
Seat 4: ipashutapkom ($40 in chips) 
Seat 5: blufthenuts ($150.75 in chips) 
Seat 6: Kihog ($100 in chips) 
Seat 7: rate8 ($101.50 in chips) 
Seat 8: roadster683 ($171.34 in chips) 
Seat 9: lydia12345 ($274.73 in chips) 
matiko09: posts small blind $0.50
Vikulja1993: posts big blind $1
*** HOLE CARDS ***
Dealt to matiko09 [3h 6h]
cobrik23: folds 
ipashutapkom: folds 
blufthenuts: folds 
Kihog: folds 
rate8: folds 
roadster683: folds 
lydia12345: raises $2 to $3
matiko09: folds 
Vikulja1993: calls $2
*** FLOP *** [Qc 9c Ts]
Vikulja1993: checks 
lydia12345: checks 
*** TURN *** [Qc 9c Ts] [Th]
Vikulja1993: bets $4
lydia12345: calls $4
*** RIVER *** [Qc 9c Ts Th] [9s]
Vikulja1993: checks 
lydia12345: bets $9.37
Vikulja1993: folds 
Uncalled bet ($9.37) returned to lydia12345
lydia12345 collected $13.78 from pot
*** SUMMARY ***
Total pot $14.50 | Rake $0.72 
Board [Qc 9c Ts Th 9s]
Seat 1: matiko09 (small blind) folded before Flop
Seat 2: Vikulja1993 (big blind) folded on the River
Seat 3: cobrik23 folded before Flop (didn't bet)
Seat 4: ipashutapkom folded before Flop (didn't bet)
Seat 5: blufthenuts folded before Flop (didn't bet)
Seat 6: Kihog folded before Flop (didn't bet)
Seat 7: rate8 folded before Flop (didn't bet)
Seat 8: roadster683 folded before Flop (didn't bet)
Seat 9: lydia12345 (button) collected ($13.78)





PokerStars Hand #153504084838:  Hold'em No Limit ($0.50/$1.00 USD) - 2016/05/18 21:06:50 CET [2016/05/18 15:06:50 ET]
Table 'Samitchell II' 9-max Seat #9 is the button
Seat 1: riggedsh** ($114.50 in chips) 
Seat 2: IRAVABAN ($40 in chips) 
Seat 3: vanilica ($110.32 in chips) 
Seat 4: Zeeshka ($100 in chips) 
Seat 5: nuuaber ($111.14 in chips) 
Seat 6: Strikerman25 ($44.50 in chips) 
Seat 7: matiko09 ($100 in chips) 
Seat 8: rate8 ($130.02 in chips) 
Seat 9: solbi86 ($105.92 in chips) 
riggedsh**: posts small blind $0.50
IRAVABAN: posts big blind $1
*** HOLE CARDS ***
Dealt to matiko09 [5d 3d]
vanilica: folds 
Zeeshka: folds 
nuuaber: folds 
Strikerman25: folds 
matiko09: folds 
rate8: folds 
solbi86: folds 
riggedsh**: folds 
Uncalled bet ($0.50) returned to IRAVABAN
IRAVABAN collected $1 from pot
IRAVABAN: doesn't show hand 
*** SUMMARY ***
Total pot $1 | Rake $0 
Seat 1: riggedsh** (small blind) folded before Flop
Seat 2: IRAVABAN (big blind) collected ($1)
Seat 3: vanilica folded before Flop (didn't bet)
Seat 4: Zeeshka folded before Flop (didn't bet)
Seat 5: nuuaber folded before Flop (didn't bet)
Seat 6: Strikerman25 folded before Flop (didn't bet)
Seat 7: matiko09 folded before Flop (didn't bet)
Seat 8: rate8 folded before Flop (didn't bet)
Seat 9: solbi86 (button) folded before Flop (didn't bet)





PokerStars Hand #153504119557:  Hold'em No Limit ($0.50/$1.00 USD) - 2016/05/18 21:07:29 CET [2016/05/18 15:07:29 ET]
Table 'Samitchell II' 9-max Seat #1 is the button
Seat 1: riggedsh** ($114 in chips) 
Seat 2: IRAVABAN ($40.50 in chips) 
Seat 3: vanilica ($110.32 in chips) 
Seat 4: Zeeshka ($100 in chips) 
Seat 5: nuuaber ($111.14 in chips) 
Seat 6: Strikerman25 ($44.50 in chips) 
Seat 7: matiko09 ($100 in chips) 
Seat 8: rate8 ($130.02 in chips) 
Seat 9: solbi86 ($105.92 in chips) 
IRAVABAN: posts small blind $0.50
vanilica: posts big blind $1
*** HOLE CARDS ***
Dealt to matiko09 [6s 8d]
Zeeshka: folds 
nuuaber: raises $3.50 to $4.50
Strikerman25: folds 
matiko09: folds 
rate8: folds 
solbi86: folds 
riggedsh**: folds 
IRAVABAN: folds 
vanilica: calls $3.50
*** FLOP *** [3c Js 5c]
vanilica: checks 
nuuaber: bets $5
vanilica: calls $5
*** TURN *** [3c Js 5c] [4s]
vanilica: checks 
nuuaber: bets $9
vanilica: calls $9
*** RIVER *** [3c Js 5c 4s] [9d]
vanilica: checks 
nuuaber: bets $18
vanilica: calls $18
*** SHOW DOWN ***
nuuaber: shows [Th As] (high card Ace)
vanilica: shows [7h 7s] (a pair of Sevens)
vanilica collected $71 from pot
*** SUMMARY ***
Total pot $73.50 | Rake $2.50 
Board [3c Js 5c 4s 9d]
Seat 1: riggedsh** (button) folded before Flop (didn't bet)
Seat 2: IRAVABAN (small blind) folded before Flop
Seat 3: vanilica (big blind) showed [7h 7s] and won ($71) with a pair of Sevens
Seat 4: Zeeshka folded before Flop (didn't bet)
Seat 5: nuuaber showed [Th As] and lost with high card Ace
Seat 6: Strikerman25 folded before Flop (didn't bet)
Seat 7: matiko09 folded before Flop (didn't bet)
Seat 8: rate8 folded before Flop (didn't bet)
Seat 9: solbi86 folded before Flop (didn't bet)





PokerStars Hand #153504152213:  Hold'em No Limit ($0.50/$1.00 USD) - 2016/05/18 21:08:06 CET [2016/05/18 15:08:06 ET]
Table 'Brendelia II' 9-max Seat #5 is the button
Seat 5: Vulturinus ($80 in chips) 
Seat 7: matiko09 ($100 in chips) 
Vulturinus: posts small blind $0.50
solbi86 joins the table at seat #8 
Kihog joins the table at seat #9 
matiko09: posts big blind $1
*** HOLE CARDS ***
Dealt to matiko09 [Tc 9s]
person74 joins the table at seat #4 
vanilica joins the table at seat #1 
Zeeshka joins the table at seat #3 
Vulturinus: calls $0.50
matiko09: checks 
*** FLOP *** [Ah 6c 5d]
matiko09: checks 
Vulturinus: checks 
*** TURN *** [Ah 6c 5d] [Kh]
matiko09: checks 
Vulturinus: checks 
*** RIVER *** [Ah 6c 5d Kh] [Th]
matiko09: checks 
Vulturinus: checks 
*** SHOW DOWN ***
matiko09: shows [Tc 9s] (a pair of Tens)
Vulturinus: mucks hand 
matiko09 collected $1.90 from pot
*** SUMMARY ***
Total pot $2 | Rake $0.10 
Board [Ah 6c 5d Kh Th]
Seat 5: Vulturinus (button) (small blind) mucked [7d 8d]
Seat 7: matiko09 (big blind) showed [Tc 9s] and won ($1.90) with a pair of Tens





PokerStars Hand #153504160284:  Hold'em No Limit ($0.50/$1.00 USD) - 2016/05/18 21:08:15 CET [2016/05/18 15:08:15 ET]
Table 'Abetti II' 9-max Seat #1 is the button
Seat 1: matiko09 ($103.02 in chips) 
Seat 2: Vikulja1993 ($100 in chips) 
Seat 3: cobrik23 ($155.13 in chips) 
Seat 4: ipashutapkom ($40 in chips) 
Seat 5: blufthenuts ($150.75 in chips) 
Seat 6: Kihog ($100 in chips) 
Seat 7: rate8 ($101.50 in chips) 
Seat 8: roadster683 ($171.34 in chips) 
Seat 9: lydia12345 ($281.51 in chips) 
Vikulja1993: posts small blind $0.50
cobrik23: posts big blind $1
*** HOLE CARDS ***
Dealt to matiko09 [5c 9d]
ipashutapkom: folds 
blufthenuts: folds 
Kihog: folds 
rate8: folds 
roadster683: raises $1 to $2
lydia12345: raises $6 to $8
matiko09: folds 
Vikulja1993: folds 
cobrik23: folds 
roadster683: calls $6
*** FLOP *** [4s Qs Ah]
roadster683: checks 
lydia12345: bets $11.30
roadster683: folds 
Uncalled bet ($11.30) returned to lydia12345
lydia12345 collected $16.62 from pot
*** SUMMARY ***
Total pot $17.50 | Rake $0.88 
Board [4s Qs Ah]
Seat 1: matiko09 (button) folded before Flop (didn't bet)
Seat 2: Vikulja1993 (small blind) folded before Flop
Seat 3: cobrik23 (big blind) folded before Flop
Seat 4: ipashutapkom folded before Flop (didn't bet)
Seat 5: blufthenuts folded before Flop (didn't bet)
Seat 6: Kihog folded before Flop (didn't bet)
Seat 7: rate8 folded before Flop (didn't bet)
Seat 8: roadster683 folded on the Flop
Seat 9: lydia12345 collected ($16.62)





PokerStars Hand #153504183520:  Hold'em No Limit ($0.50/$1.00 USD) - 2016/05/18 21:08:40 CET [2016/05/18 15:08:40 ET]
Table 'Samitchell II' 9-max Seat #2 is the button
Seat 1: riggedsh** ($114 in chips) 
Seat 2: IRAVABAN ($40 in chips) 
Seat 3: vanilica ($144.82 in chips) 
Seat 4: Zeeshka ($100 in chips) 
Seat 5: nuuaber ($74.64 in chips) 
Seat 6: Strikerman25 ($44.50 in chips) 
Seat 7: matiko09 ($100 in chips) 
Seat 8: rate8 ($130.02 in chips) 
Seat 9: solbi86 ($105.92 in chips) 
vanilica: posts small blind $0.50
Zeeshka: posts big blind $1
*** HOLE CARDS ***
Dealt to matiko09 [6h 7s]
nuuaber: calls $1
Strikerman25: folds 
matiko09: folds 
rate8: folds 
solbi86: raises $3 to $4
riggedsh**: folds 
IRAVABAN: folds 
vanilica: folds 
Zeeshka: folds 
nuuaber: raises $4 to $8
solbi86: calls $4
*** FLOP *** [7c 5d 6d]
nuuaber: bets $8
solbi86: folds 
Uncalled bet ($8) returned to nuuaber
nuuaber collected $16.62 from pot
nuuaber: doesn't show hand 
*** SUMMARY ***
Total pot $17.50 | Rake $0.88 
Board [7c 5d 6d]
Seat 1: riggedsh** folded before Flop (didn't bet)
Seat 2: IRAVABAN (button) folded before Flop (didn't bet)
Seat 3: vanilica (small blind) folded before Flop
Seat 4: Zeeshka (big blind) folded before Flop
Seat 5: nuuaber collected ($16.62)
Seat 6: Strikerman25 folded before Flop (didn't bet)
Seat 7: matiko09 folded before Flop (didn't bet)
Seat 8: rate8 folded before Flop (didn't bet)
Seat 9: solbi86 folded on the Flop





PokerStars Hand #153504186241:  Hold'em No Limit ($0.50/$1.00 USD) - 2016/05/18 21:08:43 CET [2016/05/18 15:08:43 ET]
Table 'Brendelia II' 9-max Seat #5 is the button
Seat 5: Vulturinus ($79 in chips) 
Seat 7: matiko09 ($100.90 in chips) 
Seat 8: solbi86 ($100 in chips) 
TimStone will be allowed to play after the button
matiko09: posts small blind $0.50
solbi86: posts big blind $1
Kihog: sits out 
vanilica: sits out 
Zeeshka: sits out 
person74: sits out 
*** HOLE CARDS ***
Dealt to matiko09 [7d 7c]
Vulturinus: folds 
matiko09: raises $1.50 to $2.50
solbi86: folds 
Uncalled bet ($1.50) returned to matiko09
LebzLouda joins the table at seat #2 
matiko09 collected $2 from pot
matiko09: doesn't show hand 
*** SUMMARY ***
Total pot $2 | Rake $0 
Seat 5: Vulturinus (button) folded before Flop (didn't bet)
Seat 7: matiko09 (small blind) collected ($2)
Seat 8: solbi86 (big blind) folded before Flop





PokerStars Hand #153504195532:  Hold'em No Limit ($0.50/$1.00 USD) - 2016/05/18 21:08:54 CET [2016/05/18 15:08:54 ET]
Table 'Brendelia II' 9-max Seat #7 is the button
Seat 4: person74 ($50 in chips) 
Seat 5: Vulturinus ($79 in chips) 
Seat 7: matiko09 ($101.90 in chips) 
Seat 8: solbi86 ($100 in chips) 
Seat 9: Kihog ($100 in chips) 
solbi86: posts small blind $0.50
Kihog: posts big blind $1
vanilica: sits out 
LebzLouda: sits out 
Zeeshka: sits out 
person74: posts big blind $1
TimStone: sits out 
*** HOLE CARDS ***
Dealt to matiko09 [6s 6c]
person74: checks 
Vulturinus: folds 
matiko09: raises $2.50 to $3.50
solbi86: calls $3
Kihog: folds 
person74: folds 
*** FLOP *** [8c Js 8d]
solbi86: checks 
matiko09: checks 
*** TURN *** [8c Js 8d] [7c]
solbi86: bets $4.70
matiko09: folds 
Uncalled bet ($4.70) returned to solbi86
solbi86 collected $8.55 from pot
solbi86: doesn't show hand 
*** SUMMARY ***
Total pot $9 | Rake $0.45 
Board [8c Js 8d 7c]
Seat 4: person74 folded before Flop
Seat 5: Vulturinus folded before Flop (didn't bet)
Seat 7: matiko09 (button) folded on the Turn
Seat 8: solbi86 (small blind) collected ($8.55)
Seat 9: Kihog (big blind) folded before Flop





PokerStars Hand #153504197691:  Hold'em No Limit (€0.50/€1.00 EUR) - 2016/05/18 21:08:56 CET [2016/05/18 15:08:56 ET]
Table 'Pallas II' 9-max Seat #9 is the button
Seat 1: deadkiller1 (€100 in chips) 
Seat 2: matiko09 (€189.99 in chips) 
Seat 3: Vikulja1993 (€100 in chips) 
Seat 4: torkkdnm (€153.63 in chips) 
Seat 5: cobrik23 (€40 in chips) 
Seat 6: HITYESCA (€178.69 in chips) 
Seat 7: rate8 (€100 in chips) 
Seat 8: Kihog (€167.30 in chips) 
Seat 9: stijner1986 (€175.56 in chips) 
deadkiller1: posts small blind €0.50
matiko09: posts big blind €1
*** HOLE CARDS ***
Dealt to matiko09 [Js As]
Vikulja1993: folds 
torkkdnm: folds 
cobrik23: folds 
HITYESCA: folds 
rate8: raises €2 to €3
Kihog: folds 
stijner1986: folds 
deadkiller1: calls €2.50
matiko09: calls €2
*** FLOP *** [2s 3s Qc]
deadkiller1: checks 
matiko09: bets €5.56
rate8: calls €5.56
deadkiller1: raises €13.44 to €19
matiko09: raises €27 to €46
rate8: folds 
deadkiller1: raises €51 to €97 and is all-in
matiko09: calls €51
*** TURN *** [2s 3s Qc] [8c]
*** RIVER *** [2s 3s Qc 8c] [8d]
*** SHOW DOWN ***
deadkiller1: shows [3c 3h] (a full house, Threes full of Eights)
matiko09: mucks hand 
deadkiller1 collected €206.31 from pot
*** SUMMARY ***
Total pot €208.56 | Rake €2.25 
Board [2s 3s Qc 8c 8d]
Seat 1: deadkiller1 (small blind) showed [3c 3h] and won (€206.31) with a full house, Threes full of Eights
Seat 2: matiko09 (big blind) mucked [Js As]
Seat 3: Vikulja1993 folded before Flop (didn't bet)
Seat 4: torkkdnm folded before Flop (didn't bet)
Seat 5: cobrik23 folded before Flop (didn't bet)
Seat 6: HITYESCA folded before Flop (didn't bet)
Seat 7: rate8 folded on the Flop
Seat 8: Kihog folded before Flop (didn't bet)
Seat 9: stijner1986 (button) folded before Flop (didn't bet)





PokerStars Hand #153504219204:  Hold'em No Limit ($0.50/$1.00 USD) - 2016/05/18 21:09:20 CET [2016/05/18 15:09:20 ET]
Table 'Abetti II' 9-max Seat #2 is the button
Seat 1: matiko09 ($103.02 in chips) 
Seat 2: Vikulja1993 ($100 in chips) 
Seat 3: cobrik23 ($154.13 in chips) 
Seat 4: ipashutapkom ($40 in chips) 
Seat 5: blufthenuts ($150.75 in chips) 
Seat 6: Kihog ($100 in chips) 
Seat 7: rate8 ($101.50 in chips) 
Seat 8: roadster683 ($163.34 in chips) 
Seat 9: lydia12345 ($290.13 in chips) 
cobrik23: posts small blind $0.50
ipashutapkom: posts big blind $1
*** HOLE CARDS ***
Dealt to matiko09 [6d 4h]
blufthenuts: raises $2 to $3
Kihog: folds 
rate8: folds 
roadster683: folds 
lydia12345: folds 
matiko09: folds 
Vikulja1993: folds 
cobrik23: calls $2.50
ipashutapkom: folds 
*** FLOP *** [9d 8h Jh]
cobrik23: checks 
blufthenuts: checks 
*** TURN *** [9d 8h Jh] [Td]
cobrik23: bets $6.65
blufthenuts: folds 
Uncalled bet ($6.65) returned to cobrik23
cobrik23 collected $6.65 from pot
cobrik23: doesn't show hand 
*** SUMMARY ***
Total pot $7 | Rake $0.35 
Board [9d 8h Jh Td]
Seat 1: matiko09 folded before Flop (didn't bet)
Seat 2: Vikulja1993 (button) folded before Flop (didn't bet)
Seat 3: cobrik23 (small blind) collected ($6.65)
Seat 4: ipashutapkom (big blind) folded before Flop
Seat 5: blufthenuts folded on the Turn
Seat 6: Kihog folded before Flop (didn't bet)
Seat 7: rate8 folded before Flop (didn't bet)
Seat 8: roadster683 folded before Flop (didn't bet)
Seat 9: lydia12345 folded before Flop (didn't bet)





PokerStars Hand #153504242065:  Hold'em No Limit ($0.50/$1.00 USD) - 2016/05/18 21:09:45 CET [2016/05/18 15:09:45 ET]
Table 'Samitchell II' 9-max Seat #3 is the button
Seat 1: riggedsh** ($114 in chips) 
Seat 2: IRAVABAN ($40 in chips) 
Seat 3: vanilica ($144.32 in chips) 
Seat 4: Zeeshka ($100 in chips) 
Seat 5: nuuaber ($83.26 in chips) 
Seat 6: Strikerman25 ($44.50 in chips) 
Seat 7: matiko09 ($100 in chips) 
Seat 8: rate8 ($130.02 in chips) 
Seat 9: solbi86 ($100 in chips) 
Zeeshka: posts small blind $0.50
nuuaber: posts big blind $1
*** HOLE CARDS ***
Dealt to matiko09 [8h 7c]
Strikerman25: folds 
matiko09: folds 
rate8: folds 
solbi86: folds 
riggedsh**: folds 
IRAVABAN: folds 
vanilica: raises $1.50 to $2.50
Zeeshka: folds 
nuuaber: raises $2.50 to $5
vanilica: calls $2.50
*** FLOP *** [Ts Th 5d]
nuuaber: checks 
vanilica: bets $4
nuuaber: raises $18 to $22
vanilica: calls $18
*** TURN *** [Ts Th 5d] [Qs]
nuuaber: checks 
vanilica: bets $10
nuuaber: calls $10
*** RIVER *** [Ts Th 5d Qs] [8s]
nuuaber: checks 
vanilica: bets $50
nuuaber: folds 
Uncalled bet ($50) returned to vanilica
vanilica collected $72 from pot
vanilica: doesn't show hand 
*** SUMMARY ***
Total pot $74.50 | Rake $2.50 
Board [Ts Th 5d Qs 8s]
Seat 1: riggedsh** folded before Flop (didn't bet)
Seat 2: IRAVABAN folded before Flop (didn't bet)
Seat 3: vanilica (button) collected ($72)
Seat 4: Zeeshka (small blind) folded before Flop
Seat 5: nuuaber (big blind) folded on the River
Seat 6: Strikerman25 folded before Flop (didn't bet)
Seat 7: matiko09 folded before Flop (didn't bet)
Seat 8: rate8 folded before Flop (didn't bet)
Seat 9: solbi86 folded before Flop (didn't bet)





PokerStars Hand #153504246563:  Hold'em No Limit ($0.50/$1.00 USD) - 2016/05/18 21:09:50 CET [2016/05/18 15:09:50 ET]
Table 'Lorcia II' 9-max Seat #1 is the button
Seat 1: HomerrrJay ($100 in chips) 
Seat 2: lydia12345 ($100 in chips) 
Seat 3: matiko09 ($100 in chips) 
Seat 4: vanilica ($100 in chips) 
Seat 5: nuuaber ($88.09 in chips) 
Seat 6: gkm0nk3y ($100 in chips) 
Seat 7: rate8 ($109.90 in chips) 
Seat 8: Skum1986 ($105.91 in chips) 
Seat 9: porgol ($259.25 in chips) 
lydia12345: posts small blind $0.50
matiko09: posts big blind $1
*** HOLE CARDS ***
Dealt to matiko09 [Qd Kc]
vanilica: folds 
nuuaber: folds 
gkm0nk3y: folds 
rate8: folds 
Skum1986: folds 
porgol: calls $1
HomerrrJay: folds 
lydia12345: folds 
matiko09: raises $3.50 to $4.50
porgol: calls $3.50
*** FLOP *** [Ad Js 6h]
matiko09: bets $5
porgol: folds 
Uncalled bet ($5) returned to matiko09
matiko09 collected $9.02 from pot
matiko09: doesn't show hand 
*** SUMMARY ***
Total pot $9.50 | Rake $0.48 
Board [Ad Js 6h]
Seat 1: HomerrrJay (button) folded before Flop (didn't bet)
Seat 2: lydia12345 (small blind) folded before Flop
Seat 3: matiko09 (big blind) collected ($9.02)
Seat 4: vanilica folded before Flop (didn't bet)
Seat 5: nuuaber folded before Flop (didn't bet)
Seat 6: gkm0nk3y folded before Flop (didn't bet)
Seat 7: rate8 folded before Flop (didn't bet)
Seat 8: Skum1986 folded before Flop (didn't bet)
Seat 9: porgol folded on the Flop





PokerStars Hand #153504253691:  Hold'em No Limit ($0.50/$1.00 USD) - 2016/05/18 21:09:59 CET [2016/05/18 15:09:59 ET]
Table 'Abetti II' 9-max Seat #3 is the button
Seat 1: matiko09 ($103.02 in chips) 
Seat 2: Vikulja1993 ($100 in chips) 
Seat 3: cobrik23 ($157.78 in chips) 
Seat 4: ipashutapkom ($40 in chips) 
Seat 5: blufthenuts ($147.75 in chips) 
Seat 6: Kihog ($100 in chips) 
Seat 7: rate8 ($101.50 in chips) 
Seat 8: roadster683 ($163.34 in chips) 
Seat 9: lydia12345 ($290.13 in chips) 
ipashutapkom: posts small blind $0.50
blufthenuts: posts big blind $1
*** HOLE CARDS ***
Dealt to matiko09 [8s 3c]
Kihog: folds 
rate8: folds 
roadster683: raises $1 to $2
lydia12345: folds 
matiko09: folds 
Vikulja1993: folds 
cobrik23: folds 
ipashutapkom: folds 
blufthenuts: folds 
Uncalled bet ($1) returned to roadster683
roadster683 collected $2.50 from pot
roadster683: doesn't show hand 
*** SUMMARY ***
Total pot $2.50 | Rake $0 
Seat 1: matiko09 folded before Flop (didn't bet)
Seat 2: Vikulja1993 folded before Flop (didn't bet)
Seat 3: cobrik23 (button) folded before Flop (didn't bet)
Seat 4: ipashutapkom (small blind) folded before Flop
Seat 5: blufthenuts (big blind) folded before Flop
Seat 6: Kihog folded before Flop (didn't bet)
Seat 7: rate8 folded before Flop (didn't bet)
Seat 8: roadster683 collected ($2.50)
Seat 9: lydia12345 folded before Flop (didn't bet)





PokerStars Hand #153504263389:  Hold'em No Limit ($0.50/$1.00 USD) - 2016/05/18 21:10:10 CET [2016/05/18 15:10:10 ET]
Table 'Pandora' 9-max Seat #6 is the button
Seat 1: deadkiller1 ($100 in chips) 
Seat 2: Vikulja1993 ($116.58 in chips) 
Seat 3: vanilica ($100 in chips) 
Seat 5: Strikerman25 ($38 in chips) 
Seat 6: Moszes360 ($166.77 in chips) 
Seat 7: torkkdnm ($102.65 in chips) 
Seat 8: matiko09 ($120.54 in chips) 
Seat 9: oscarleon ($113.98 in chips) 
torkkdnm: posts small blind $0.50
matiko09: posts big blind $1
janarr5: sits out 
*** HOLE CARDS ***
Dealt to matiko09 [Th Qc]
oscarleon: folds 
deadkiller1: raises $2 to $3
Vikulja1993: folds 
vanilica: folds 
Strikerman25: raises $4.50 to $7.50
Moszes360: folds 
torkkdnm: folds 
matiko09: folds 
deadkiller1: raises $92.50 to $100 and is all-in
Strikerman25: folds 
Uncalled bet ($92.50) returned to deadkiller1
deadkiller1 collected $16.50 from pot
deadkiller1: doesn't show hand 
*** SUMMARY ***
Total pot $16.50 | Rake $0 
Seat 1: deadkiller1 collected ($16.50)
Seat 2: Vikulja1993 folded before Flop (didn't bet)
Seat 3: vanilica folded before Flop (didn't bet)
Seat 5: Strikerman25 folded before Flop
Seat 6: Moszes360 (button) folded before Flop (didn't bet)
Seat 7: torkkdnm (small blind) folded before Flop
Seat 8: matiko09 (big blind) folded before Flop
Seat 9: oscarleon folded before Flop (didn't bet)





PokerStars Hand #153504268283:  Hold'em No Limit ($0.50/$1.00 USD) - 2016/05/18 21:10:15 CET [2016/05/18 15:10:15 ET]
Table 'Abetti II' 9-max Seat #4 is the button
Seat 1: matiko09 ($103.02 in chips) 
Seat 2: Vikulja1993 ($100 in chips) 
Seat 3: cobrik23 ($157.78 in chips) 
Seat 4: ipashutapkom ($40 in chips) 
Seat 5: blufthenuts ($146.75 in chips) 
Seat 6: Kihog ($100 in chips) 
Seat 7: rate8 ($101.50 in chips) 
Seat 8: roadster683 ($164.84 in chips) 
Seat 9: lydia12345 ($290.13 in chips) 
blufthenuts: posts small blind $0.50
Kihog: posts big blind $1
*** HOLE CARDS ***
Dealt to matiko09 [7s 3d]
rate8: raises $2 to $3
roadster683: calls $3
lydia12345: folds 
matiko09: folds 
Vikulja1993: raises $9 to $12
cobrik23: folds 
ipashutapkom: folds 
blufthenuts: folds 
Kihog: folds 
rate8: calls $9
roadster683: calls $9
*** FLOP *** [8h Kc 2c]
rate8: checks 
roadster683: checks 
Vikulja1993: bets $9
rate8: folds 
roadster683: folds 
Uncalled bet ($9) returned to Vikulja1993
Vikulja1993 collected $35.62 from pot
Vikulja1993: doesn't show hand 
*** SUMMARY ***
Total pot $37.50 | Rake $1.88 
Board [8h Kc 2c]
Seat 1: matiko09 folded before Flop (didn't bet)
Seat 2: Vikulja1993 collected ($35.62)
Seat 3: cobrik23 folded before Flop (didn't bet)
Seat 4: ipashutapkom (button) folded before Flop (didn't bet)
Seat 5: blufthenuts (small blind) folded before Flop
Seat 6: Kihog (big blind) folded before Flop
Seat 7: rate8 folded on the Flop
Seat 8: roadster683 folded on the Flop
Seat 9: lydia12345 folded before Flop (didn't bet)





PokerStars Hand #153504270895:  Hold'em No Limit ($0.50/$1.00 USD) - 2016/05/18 21:10:18 CET [2016/05/18 15:10:18 ET]
Table 'Brendelia II' 9-max Seat #8 is the button
Seat 1: vanilica ($100 in chips) 
Seat 4: person74 ($49 in chips) 
Seat 5: Vulturinus ($79 in chips) 
Seat 7: matiko09 ($100 in chips) 
Seat 8: solbi86 ($105.05 in chips) 
Seat 9: Kihog ($100 in chips) 
Kihog: posts small blind $0.50
vanilica: posts big blind $1
LebzLouda: sits out 
Zeeshka: sits out 
TimStone: sits out 
*** HOLE CARDS ***
Dealt to matiko09 [2h 5s]
person74: raises $2 to $3
Vulturinus: folds 
matiko09: folds 
solbi86: folds 
Kihog: raises $7 to $10
vanilica: folds 
person74: raises $20 to $30
Kihog: raises $70 to $100 and is all-in
person74: calls $19 and is all-in
Uncalled bet ($51) returned to Kihog
*** FLOP *** [Kc 2d 4c]
*** TURN *** [Kc 2d 4c] [Qd]
*** RIVER *** [Kc 2d 4c Qd] [5c]
*** SHOW DOWN ***
Kihog: shows [Js As] (high card Ace)
person74: shows [9s 9h] (a pair of Nines)
person74 collected $96.50 from pot
*** SUMMARY ***
Total pot $99 | Rake $2.50 
Board [Kc 2d 4c Qd 5c]
Seat 1: vanilica (big blind) folded before Flop
Seat 4: person74 showed [9s 9h] and won ($96.50) with a pair of Nines
Seat 5: Vulturinus folded before Flop (didn't bet)
Seat 7: matiko09 folded before Flop (didn't bet)
Seat 8: solbi86 (button) folded before Flop (didn't bet)
Seat 9: Kihog (small blind) showed [Js As] and lost with high card Ace





PokerStars Hand #153504287848:  Hold'em No Limit ($0.50/$1.00 USD) - 2016/05/18 21:10:38 CET [2016/05/18 15:10:38 ET]
Table 'Lorcia II' 9-max Seat #2 is the button
Seat 1: HomerrrJay ($100 in chips) 
Seat 2: lydia12345 ($100 in chips) 
Seat 3: matiko09 ($104.52 in chips) 
Seat 4: vanilica ($100 in chips) 
Seat 5: nuuaber ($88.09 in chips) 
Seat 6: gkm0nk3y ($100 in chips) 
Seat 7: rate8 ($109.90 in chips) 
Seat 8: Skum1986 ($105.91 in chips) 
Seat 9: porgol ($254.75 in chips) 
matiko09: posts small blind $0.50
vanilica: posts big blind $1
*** HOLE CARDS ***
Dealt to matiko09 [9s Ts]
nuuaber: folds 
gkm0nk3y: folds 
rate8: folds 
Skum1986: folds 
porgol: calls $1
HomerrrJay: raises $3.50 to $4.50
lydia12345: raises $7.50 to $12
matiko09: folds 
vanilica: folds 
porgol has timed out
porgol: folds 
HomerrrJay: raises $12 to $24
lydia12345: raises $76 to $100 and is all-in
HomerrrJay: folds 
Uncalled bet ($76) returned to lydia12345
lydia12345 collected $50.50 from pot
*** SUMMARY ***
Total pot $50.50 | Rake $0 
Seat 1: HomerrrJay folded before Flop
Seat 2: lydia12345 (button) collected ($50.50)
Seat 3: matiko09 (small blind) folded before Flop
Seat 4: vanilica (big blind) folded before Flop
Seat 5: nuuaber folded before Flop (didn't bet)
Seat 6: gkm0nk3y folded before Flop (didn't bet)
Seat 7: rate8 folded before Flop (didn't bet)
Seat 8: Skum1986 folded before Flop (didn't bet)
Seat 9: porgol folded before Flop





PokerStars Hand #153504294809:  Hold'em No Limit ($0.50/$1.00 USD) - 2016/05/18 21:10:45 CET [2016/05/18 15:10:45 ET]
Table 'Martir' 9-max Seat #6 is the button
Seat 1: Vivaoo ($125.55 in chips) 
Seat 2: TimStone ($101.82 in chips) 
Seat 3: deadkiller1 ($100 in chips) 
Seat 4: cobrik23 ($88.93 in chips) 
Seat 5: stimp0r ($83.33 in chips) 
Seat 6: blufthenuts ($170.49 in chips) 
Seat 7: HITYESCA ($127.29 in chips) 
Seat 8: matiko09 ($100 in chips) 
Seat 9: torkkdnm ($118.21 in chips) 
HITYESCA: posts small blind $0.50
matiko09: posts big blind $1
*** HOLE CARDS ***
Dealt to matiko09 [8h 3c]
torkkdnm: folds 
Vivaoo: folds 
TimStone: folds 
deadkiller1: folds 
cobrik23: folds 
stimp0r: raises $2 to $3
blufthenuts: folds 
HITYESCA: raises $6 to $9
matiko09: folds 
stimp0r: raises $18 to $27
HITYESCA: folds 
Uncalled bet ($18) returned to stimp0r
stimp0r collected $19 from pot
stimp0r: doesn't show hand 
*** SUMMARY ***
Total pot $19 | Rake $0 
Seat 1: Vivaoo folded before Flop (didn't bet)
Seat 2: TimStone folded before Flop (didn't bet)
Seat 3: deadkiller1 folded before Flop (didn't bet)
Seat 4: cobrik23 folded before Flop (didn't bet)
Seat 5: stimp0r collected ($19)
Seat 6: blufthenuts (button) folded before Flop (didn't bet)
Seat 7: HITYESCA (small blind) folded before Flop
Seat 8: matiko09 (big blind) folded before Flop
Seat 9: torkkdnm folded before Flop (didn't bet)





PokerStars Hand #153504321046:  Hold'em No Limit ($0.50/$1.00 USD) - 2016/05/18 21:11:14 CET [2016/05/18 15:11:14 ET]
Table 'Tatjana III' 9-max Seat #1 is the button
Seat 1: cobrik23 ($160.33 in chips) 
Seat 2: HITYESCA ($177.01 in chips) 
Seat 3: matiko09 ($182.79 in chips) 
Seat 4: lydia12345 ($121.98 in chips) 
Seat 5: deadkiller1 ($104.32 in chips) 
Seat 6: Kihog ($153.39 in chips) 
Seat 7: rene1984tsv ($105.59 in chips) 
Seat 8: JACQUILF ($100 in chips) 
Seat 9: Moszes360 ($100 in chips) 
HITYESCA: posts small blind $0.50
matiko09: posts big blind $1
*** HOLE CARDS ***
Dealt to matiko09 [2d 4h]
lydia12345: folds 
deadkiller1: folds 
Kihog: raises $1.50 to $2.50
rene1984tsv: folds 
JACQUILF: folds 
Moszes360: folds 
cobrik23: folds 
HITYESCA: folds 
matiko09: folds 
Uncalled bet ($1.50) returned to Kihog
Kihog collected $2.50 from pot
Kihog: doesn't show hand 
*** SUMMARY ***
Total pot $2.50 | Rake $0 
Seat 1: cobrik23 (button) folded before Flop (didn't bet)
Seat 2: HITYESCA (small blind) folded before Flop
Seat 3: matiko09 (big blind) folded before Flop
Seat 4: lydia12345 folded before Flop (didn't bet)
Seat 5: deadkiller1 folded before Flop (didn't bet)
Seat 6: Kihog collected ($2.50)
Seat 7: rene1984tsv folded before Flop (didn't bet)
Seat 8: JACQUILF folded before Flop (didn't bet)
Seat 9: Moszes360 folded before Flop (didn't bet)





PokerStars Hand #153504325573:  Hold'em No Limit ($0.50/$1.00 USD) - 2016/05/18 21:11:19 CET [2016/05/18 15:11:19 ET]
Table 'Samitchell II' 9-max Seat #4 is the button
Seat 1: riggedsh** ($114 in chips) 
Seat 2: IRAVABAN ($40 in chips) 
Seat 3: vanilica ($179.32 in chips) 
Seat 4: Zeeshka ($100 in chips) 
Seat 5: nuuaber ($46.26 in chips) 
Seat 6: Strikerman25 ($44.50 in chips) 
Seat 7: matiko09 ($100 in chips) 
Seat 8: rate8 ($130.02 in chips) 
Seat 9: solbi86 ($100 in chips) 
nuuaber: posts small blind $0.50
Strikerman25: posts big blind $1
*** HOLE CARDS ***
Dealt to matiko09 [3h Js]
matiko09: folds 
rate8: folds 
solbi86: folds 
riggedsh**: folds 
IRAVABAN: folds 
vanilica: folds 
Zeeshka: folds 
nuuaber: folds 
Uncalled bet ($0.50) returned to Strikerman25
Strikerman25 collected $1 from pot
Strikerman25: doesn't show hand 
*** SUMMARY ***
Total pot $1 | Rake $0 
Seat 1: riggedsh** folded before Flop (didn't bet)
Seat 2: IRAVABAN folded before Flop (didn't bet)
Seat 3: vanilica folded before Flop (didn't bet)
Seat 4: Zeeshka (button) folded before Flop (didn't bet)
Seat 5: nuuaber (small blind) folded before Flop
Seat 6: Strikerman25 (big blind) collected ($1)
Seat 7: matiko09 folded before Flop (didn't bet)
Seat 8: rate8 folded before Flop (didn't bet)
Seat 9: solbi86 folded before Flop (didn't bet)





PokerStars Hand #153504329394:  Hold'em No Limit (€0.50/€1.00 EUR) - 2016/05/18 21:11:24 CET [2016/05/18 15:11:24 ET]
Table 'Pallas II' 9-max Seat #1 is the button
Seat 1: deadkiller1 (€206.31 in chips) 
Seat 2: matiko09 (€100 in chips) 
Seat 3: Vikulja1993 (€100 in chips) 
Seat 4: torkkdnm (€153.63 in chips) 
Seat 5: cobrik23 (€40 in chips) 
Seat 6: HITYESCA (€178.69 in chips) 
Seat 7: rate8 (€100 in chips) 
Seat 8: Kihog (€167.30 in chips) 
Seat 9: stijner1986 (€175.56 in chips) 
matiko09: posts small blind €0.50
Vikulja1993: posts big blind €1
*** HOLE CARDS ***
Dealt to matiko09 [Kd 5d]
torkkdnm: raises €2 to €3
cobrik23: folds 
HITYESCA: folds 
rate8: folds 
Kihog: folds 
stijner1986: folds 
deadkiller1: folds 
matiko09: folds 
Vikulja1993: raises €7 to €10
torkkdnm: folds 
Uncalled bet (€7) returned to Vikulja1993
Vikulja1993 collected €6.50 from pot
Vikulja1993: doesn't show hand 
*** SUMMARY ***
Total pot €6.50 | Rake €0 
Seat 1: deadkiller1 (button) folded before Flop (didn't bet)
Seat 2: matiko09 (small blind) folded before Flop
Seat 3: Vikulja1993 (big blind) collected (€6.50)
Seat 4: torkkdnm folded before Flop
Seat 5: cobrik23 folded before Flop (didn't bet)
Seat 6: HITYESCA folded before Flop (didn't bet)
Seat 7: rate8 folded before Flop (didn't bet)
Seat 8: Kihog folded before Flop (didn't bet)
Seat 9: stijner1986 folded before Flop (didn't bet)





PokerStars Hand #153504338920:  Hold'em No Limit ($0.50/$1.00 USD) - 2016/05/18 21:11:34 CET [2016/05/18 15:11:34 ET]
Table 'Pandora' 9-max Seat #7 is the button
Seat 1: deadkiller1 ($109 in chips) 
Seat 2: Vikulja1993 ($116.58 in chips) 
Seat 3: vanilica ($100 in chips) 
Seat 5: Strikerman25 ($30.50 in chips) 
Seat 6: Moszes360 ($166.77 in chips) 
Seat 7: torkkdnm ($102.15 in chips) 
Seat 8: matiko09 ($119.54 in chips) 
matiko09: posts small blind $0.50
oscarleon: is sitting out 
deadkiller1: posts big blind $1
oscarleon leaves the table
janarr5: sits out 
*** HOLE CARDS ***
Dealt to matiko09 [9s Ac]
cobrik23 joins the table at seat #9 
Vikulja1993: folds 
Vikulja1993 leaves the table
vanilica: folds 
Strikerman25: raises $2 to $3
Moszes360: folds 
torkkdnm: folds 
matiko09: folds 
deadkiller1: folds 
Uncalled bet ($2) returned to Strikerman25
Strikerman25 collected $2.50 from pot
Strikerman25: doesn't show hand 
*** SUMMARY ***
Total pot $2.50 | Rake $0 
Seat 1: deadkiller1 (big blind) folded before Flop
Seat 2: Vikulja1993 folded before Flop (didn't bet)
Seat 3: vanilica folded before Flop (didn't bet)
Seat 5: Strikerman25 collected ($2.50)
Seat 6: Moszes360 folded before Flop (didn't bet)
Seat 7: torkkdnm (button) folded before Flop (didn't bet)
Seat 8: matiko09 (small blind) folded before Flop





PokerStars Hand #153504342315:  Hold'em No Limit ($0.50/$1.00 USD) - 2016/05/18 21:11:38 CET [2016/05/18 15:11:38 ET]
Table 'Martir' 9-max Seat #8 is the button
Seat 1: Vivaoo ($125.55 in chips) 
Seat 2: TimStone ($101.82 in chips) 
Seat 3: deadkiller1 ($100 in chips) 
Seat 4: cobrik23 ($88.93 in chips) 
Seat 5: stimp0r ($93.33 in chips) 
Seat 6: blufthenuts ($170.49 in chips) 
Seat 8: matiko09 ($100 in chips) 
Seat 9: torkkdnm ($118.21 in chips) 
torkkdnm: posts small blind $0.50
Vivaoo: posts big blind $1
*** HOLE CARDS ***
Dealt to matiko09 [3s 2c]
TimStone: folds 
deadkiller1: folds 
cobrik23: raises $2 to $3
stimp0r: folds 
blufthenuts: folds 
HITYESCA leaves the table
Vikulja1993 joins the table at seat #7 
matiko09: folds 
Vikulja1993 leaves the table
torkkdnm: folds 
Vivaoo: folds 
Uncalled bet ($2) returned to cobrik23
cobrik23 collected $2.50 from pot
cobrik23: doesn't show hand 
*** SUMMARY ***
Total pot $2.50 | Rake $0 
Seat 1: Vivaoo (big blind) folded before Flop
Seat 2: TimStone folded before Flop (didn't bet)
Seat 3: deadkiller1 folded before Flop (didn't bet)
Seat 4: cobrik23 collected ($2.50)
Seat 5: stimp0r folded before Flop (didn't bet)
Seat 6: blufthenuts folded before Flop (didn't bet)
Seat 8: matiko09 (button) folded before Flop (didn't bet)
Seat 9: torkkdnm (small blind) folded before Flop





PokerStars Hand #153504343394:  Hold'em No Limit ($0.50/$1.00 USD) - 2016/05/18 21:11:39 CET [2016/05/18 15:11:39 ET]
Table 'Samitchell II' 9-max Seat #5 is the button
Seat 1: riggedsh** ($114 in chips) 
Seat 2: IRAVABAN ($40 in chips) 
Seat 3: vanilica ($179.32 in chips) 
Seat 4: Zeeshka ($100 in chips) 
Seat 5: nuuaber ($45.76 in chips) 
Seat 6: Strikerman25 ($45 in chips) 
Seat 7: matiko09 ($100 in chips) 
Seat 8: rate8 ($130.02 in chips) 
Seat 9: solbi86 ($100 in chips) 
Strikerman25: posts small blind $0.50
matiko09: posts big blind $1
*** HOLE CARDS ***
Dealt to matiko09 [Qs Qc]
rate8: folds 
solbi86: folds 
riggedsh**: folds 
IRAVABAN: folds 
vanilica: folds 
Zeeshka: raises $2 to $3
nuuaber: folds 
Strikerman25: folds 
matiko09: raises $7 to $10
Zeeshka: folds 
Uncalled bet ($7) returned to matiko09
matiko09 collected $6.50 from pot
matiko09: doesn't show hand 
*** SUMMARY ***
Total pot $6.50 | Rake $0 
Seat 1: riggedsh** folded before Flop (didn't bet)
Seat 2: IRAVABAN folded before Flop (didn't bet)
Seat 3: vanilica folded before Flop (didn't bet)
Seat 4: Zeeshka folded before Flop
Seat 5: nuuaber (button) folded before Flop (didn't bet)
Seat 6: Strikerman25 (small blind) folded before Flop
Seat 7: matiko09 (big blind) collected ($6.50)
Seat 8: rate8 folded before Flop (didn't bet)
Seat 9: solbi86 folded before Flop (didn't bet)





PokerStars Hand #153504357961:  Hold'em No Limit ($0.50/$1.00 USD) - 2016/05/18 21:11:55 CET [2016/05/18 15:11:55 ET]
Table 'Tatjana III' 9-max Seat #3 is the button
Seat 1: cobrik23 ($160.33 in chips) 
Seat 3: matiko09 ($181.79 in chips) 
Seat 4: lydia12345 ($121.98 in chips) 
Seat 5: deadkiller1 ($104.32 in chips) 
Seat 6: Kihog ($154.89 in chips) 
Seat 7: rene1984tsv ($105.59 in chips) 
Seat 8: JACQUILF ($100 in chips) 
Seat 9: Moszes360 ($100 in chips) 
lydia12345: posts small blind $0.50
deadkiller1: posts big blind $1
*** HOLE CARDS ***
Dealt to matiko09 [7h 5d]
Kihog: folds 
rene1984tsv: calls $1
JACQUILF: folds 
HITYESCA leaves the table
Moszes360: folds 
cobrik23: folds 
matiko09: folds 
lydia12345: folds 
deadkiller1: checks 
*** FLOP *** [Ks 9h Td]
deadkiller1: checks 
rene1984tsv: bets $1
deadkiller1: folds 
Uncalled bet ($1) returned to rene1984tsv
rene1984tsv collected $2.38 from pot
rene1984tsv: doesn't show hand 
*** SUMMARY ***
Total pot $2.50 | Rake $0.12 
Board [Ks 9h Td]
Seat 1: cobrik23 folded before Flop (didn't bet)
Seat 3: matiko09 (button) folded before Flop (didn't bet)
Seat 4: lydia12345 (small blind) folded before Flop
Seat 5: deadkiller1 (big blind) folded on the Flop
Seat 6: Kihog folded before Flop (didn't bet)
Seat 7: rene1984tsv collected ($2.38)
Seat 8: JACQUILF folded before Flop (didn't bet)
Seat 9: Moszes360 folded before Flop (didn't bet)





PokerStars Hand #153504360870:  Hold'em No Limit ($0.50/$1.00 USD) - 2016/05/18 21:11:58 CET [2016/05/18 15:11:58 ET]
Table 'Abetti II' 9-max Seat #5 is the button
Seat 1: matiko09 ($103.02 in chips) 
Seat 2: Vikulja1993 ($123.62 in chips) 
Seat 3: cobrik23 ($157.78 in chips) 
Seat 4: ipashutapkom ($40 in chips) 
Seat 5: blufthenuts ($146.25 in chips) 
Seat 6: Kihog ($100 in chips) 
Seat 7: rate8 ($100 in chips) 
Seat 8: roadster683 ($152.84 in chips) 
Seat 9: lydia12345 ($290.13 in chips) 
Kihog: posts small blind $0.50
rate8: posts big blind $1
*** HOLE CARDS ***
Dealt to matiko09 [2h Qd]
roadster683: folds 
lydia12345: folds 
matiko09: folds 
Vikulja1993: folds 
cobrik23: folds 
ipashutapkom: folds 
blufthenuts: raises $2 to $3
Kihog: folds 
rate8: folds 
Uncalled bet ($2) returned to blufthenuts
blufthenuts collected $2.50 from pot
blufthenuts: doesn't show hand 
*** SUMMARY ***
Total pot $2.50 | Rake $0 
Seat 1: matiko09 folded before Flop (didn't bet)
Seat 2: Vikulja1993 folded before Flop (didn't bet)
Seat 3: cobrik23 folded before Flop (didn't bet)
Seat 4: ipashutapkom folded before Flop (didn't bet)
Seat 5: blufthenuts (button) collected ($2.50)
Seat 6: Kihog (small blind) folded before Flop
Seat 7: rate8 (big blind) folded before Flop
Seat 8: roadster683 folded before Flop (didn't bet)
Seat 9: lydia12345 folded before Flop (didn't bet)





PokerStars Hand #153504361591:  Hold'em No Limit ($0.50/$1.00 USD) - 2016/05/18 21:11:59 CET [2016/05/18 15:11:59 ET]
Table 'Brendelia II' 9-max Seat #9 is the button
Seat 1: vanilica ($100 in chips) 
Seat 2: LebzLouda ($80 in chips) 
Seat 4: person74 ($96.50 in chips) 
Seat 5: Vulturinus ($79 in chips) 
Seat 7: matiko09 ($100 in chips) 
Seat 8: solbi86 ($105.05 in chips) 
Seat 9: Kihog ($100 in chips) 
vanilica: posts small blind $0.50
LebzLouda: posts big blind $1
Zeeshka: sits out 
TimStone: sits out 
*** HOLE CARDS ***
Dealt to matiko09 [Jh 5h]
person74: raises $2 to $3
Vulturinus: folds 
matiko09: folds 
solbi86: folds 
Kihog: folds 
vanilica: folds 
LebzLouda: calls $2
*** FLOP *** [Ts 9c Qc]
LebzLouda: checks 
person74: checks 
*** TURN *** [Ts 9c Qc] [9d]
LebzLouda: bets $3
person74: calls $3
*** RIVER *** [Ts 9c Qc 9d] [9h]
LebzLouda: bets $6
person74: raises $24 to $30
LebzLouda: calls $24
*** SHOW DOWN ***
person74: shows [Ac Ah] (a full house, Nines full of Aces)
LebzLouda: mucks hand 
person74 collected $70 from pot
*** SUMMARY ***
Total pot $72.50 | Rake $2.50 
Board [Ts 9c Qc 9d 9h]
Seat 1: vanilica (small blind) folded before Flop
Seat 2: LebzLouda (big blind) mucked [Ad Qh]
Seat 4: person74 showed [Ac Ah] and won ($70) with a full house, Nines full of Aces
Seat 5: Vulturinus folded before Flop (didn't bet)
Seat 7: matiko09 folded before Flop (didn't bet)
Seat 8: solbi86 folded before Flop (didn't bet)
Seat 9: Kihog (button) folded before Flop (didn't bet)





PokerStars Hand #153504364367:  Hold'em No Limit (€0.50/€1.00 EUR) - 2016/05/18 21:12:02 CET [2016/05/18 15:12:02 ET]
Table 'Pallas II' 9-max Seat #2 is the button
Seat 1: deadkiller1 (€206.31 in chips) 
Seat 2: matiko09 (€100 in chips) 
Seat 3: Vikulja1993 (€103.50 in chips) 
Seat 4: torkkdnm (€150.63 in chips) 
Seat 5: cobrik23 (€40 in chips) 
Seat 7: rate8 (€100 in chips) 
Seat 8: Kihog (€167.30 in chips) 
Seat 9: stijner1986 (€175.56 in chips) 
Vikulja1993: posts small blind €0.50
torkkdnm: posts big blind €1
*** HOLE CARDS ***
Dealt to matiko09 [4d Js]
HITYESCA leaves the table
cobrik23: folds 
rate8: folds 
Kihog: folds 
stijner1986: folds 
deadkiller1: folds 
matiko09: folds 
Vikulja1993: folds 
Uncalled bet (€0.50) returned to torkkdnm
torkkdnm collected €1 from pot
*** SUMMARY ***
Total pot €1 | Rake €0 
Seat 1: deadkiller1 folded before Flop (didn't bet)
Seat 2: matiko09 (button) folded before Flop (didn't bet)
Seat 3: Vikulja1993 (small blind) folded before Flop
Seat 4: torkkdnm (big blind) collected (€1)
Seat 5: cobrik23 folded before Flop (didn't bet)
Seat 7: rate8 folded before Flop (didn't bet)
Seat 8: Kihog folded before Flop (didn't bet)
Seat 9: stijner1986 folded before Flop (didn't bet)





PokerStars Hand #153504374686:  Hold'em No Limit ($0.50/$1.00 USD) - 2016/05/18 21:12:14 CET [2016/05/18 15:12:14 ET]
Table 'Pandora' 9-max Seat #8 is the button
Seat 1: deadkiller1 ($108 in chips) 
Seat 4: janarr5 ($100 in chips) 
Seat 5: Strikerman25 ($32 in chips) 
Seat 6: Moszes360 ($166.77 in chips) 
Seat 7: torkkdnm ($102.15 in chips) 
Seat 8: matiko09 ($119.04 in chips) 
cobrik23 will be allowed to play after the button
deadkiller1: posts small blind $0.50
vanilica: is sitting out 
janarr5: posts big blind $1
*** HOLE CARDS ***
Dealt to matiko09 [Ac Jd]
vanilica leaves the table
Strikerman25: raises $2 to $3
Moszes360: folds 
torkkdnm: folds 
matiko09: folds 
deadkiller1: folds 
Vikulja1993 joins the table at seat #2 
janarr5: folds 
Uncalled bet ($2) returned to Strikerman25
Vikulja1993 leaves the table
Strikerman25 collected $2.50 from pot
Strikerman25: doesn't show hand 
*** SUMMARY ***
Total pot $2.50 | Rake $0 
Seat 1: deadkiller1 (small blind) folded before Flop
Seat 4: janarr5 (big blind) folded before Flop
Seat 5: Strikerman25 collected ($2.50)
Seat 6: Moszes360 folded before Flop (didn't bet)
Seat 7: torkkdnm folded before Flop (didn't bet)
Seat 8: matiko09 (button) folded before Flop (didn't bet)





PokerStars Hand #153504376242:  Hold'em No Limit ($0.50/$1.00 USD) - 2016/05/18 21:12:15 CET [2016/05/18 15:12:15 ET]
Table 'Samitchell II' 9-max Seat #6 is the button
Seat 1: riggedsh** ($114 in chips) 
Seat 2: IRAVABAN ($40 in chips) 
Seat 3: vanilica ($179.32 in chips) 
Seat 4: Zeeshka ($100 in chips) 
Seat 5: nuuaber ($45.76 in chips) 
Seat 6: Strikerman25 ($44.50 in chips) 
Seat 7: matiko09 ($103.50 in chips) 
Seat 8: rate8 ($130.02 in chips) 
Seat 9: solbi86 ($100 in chips) 
matiko09: posts small blind $0.50
rate8: posts big blind $1
*** HOLE CARDS ***
Dealt to matiko09 [Js Td]
solbi86: folds 
riggedsh**: folds 
IRAVABAN: folds 
vanilica: folds 
Zeeshka: raises $2 to $3
nuuaber: raises $7.50 to $10.50
Strikerman25: folds 
matiko09: folds 
rate8: folds 
Zeeshka: folds 
Uncalled bet ($7.50) returned to nuuaber
nuuaber collected $7.50 from pot
nuuaber: doesn't show hand 
*** SUMMARY ***
Total pot $7.50 | Rake $0 
Seat 1: riggedsh** folded before Flop (didn't bet)
Seat 2: IRAVABAN folded before Flop (didn't bet)
Seat 3: vanilica folded before Flop (didn't bet)
Seat 4: Zeeshka folded before Flop
Seat 5: nuuaber collected ($7.50)
Seat 6: Strikerman25 (button) folded before Flop (didn't bet)
Seat 7: matiko09 (small blind) folded before Flop
Seat 8: rate8 (big blind) folded before Flop
Seat 9: solbi86 folded before Flop (didn't bet)





PokerStars Hand #153504380293:  Hold'em No Limit ($0.50/$1.00 USD) - 2016/05/18 21:12:20 CET [2016/05/18 15:12:20 ET]
Table 'Martir' 9-max Seat #9 is the button
Seat 1: Vivaoo ($124.55 in chips) 
Seat 2: TimStone ($101.82 in chips) 
Seat 3: deadkiller1 ($100 in chips) 
Seat 4: cobrik23 ($90.43 in chips) 
Seat 5: stimp0r ($93.33 in chips) 
Seat 6: blufthenuts ($170.49 in chips) 
Seat 8: matiko09 ($100 in chips) 
Seat 9: torkkdnm ($117.71 in chips) 
Vivaoo: posts small blind $0.50
TimStone: posts big blind $1
*** HOLE CARDS ***
Dealt to matiko09 [5h Qc]
deadkiller1: folds 
janarr5 joins the table at seat #7 
cobrik23: folds 
stimp0r: folds 
blufthenuts: folds 
matiko09: folds 
torkkdnm: raises $1 to $2
Vivaoo: folds 
TimStone: raises $6.60 to $8.60
torkkdnm: folds 
Uncalled bet ($6.60) returned to TimStone
TimStone collected $4.50 from pot
TimStone: doesn't show hand 
*** SUMMARY ***
Total pot $4.50 | Rake $0 
Seat 1: Vivaoo (small blind) folded before Flop
Seat 2: TimStone (big blind) collected ($4.50)
Seat 3: deadkiller1 folded before Flop (didn't bet)
Seat 4: cobrik23 folded before Flop (didn't bet)
Seat 5: stimp0r folded before Flop (didn't bet)
Seat 6: blufthenuts folded before Flop (didn't bet)
Seat 8: matiko09 folded before Flop (didn't bet)
Seat 9: torkkdnm (button) folded before Flop





PokerStars Hand #153504398014:  Hold'em No Limit (€0.50/€1.00 EUR) - 2016/05/18 21:12:40 CET [2016/05/18 15:12:40 ET]
Table 'Pallas II' 9-max Seat #3 is the button
Seat 1: deadkiller1 (€206.31 in chips) 
Seat 2: matiko09 (€100 in chips) 
Seat 3: Vikulja1993 (€103 in chips) 
Seat 4: torkkdnm (€151.13 in chips) 
Seat 5: cobrik23 (€40 in chips) 
Seat 7: rate8 (€100 in chips) 
Seat 8: Kihog (€167.30 in chips) 
Seat 9: stijner1986 (€175.56 in chips) 
torkkdnm: posts small blind €0.50
cobrik23: posts big blind €1
*** HOLE CARDS ***
Dealt to matiko09 [2h 6s]
rate8: folds 
Kihog: folds 
stijner1986: calls €1
janarr5 joins the table at seat #6 
deadkiller1: folds 
matiko09: folds 
Vikulja1993: raises €3 to €4
torkkdnm: folds 
cobrik23: calls €3
stijner1986: calls €3
*** FLOP *** [Ah 8s 7d]
cobrik23: checks 
stijner1986: checks 
Vikulja1993: checks 
*** TURN *** [Ah 8s 7d] [7h]
cobrik23: bets €7
stijner1986: folds 
Vikulja1993: calls €7
*** RIVER *** [Ah 8s 7d 7h] [3h]
cobrik23: bets €15
Vikulja1993: calls €15
*** SHOW DOWN ***
cobrik23: shows [2c 2d] (two pair, Sevens and Deuces)
Vikulja1993: shows [Jh 8h] (a flush, Ace high)
Vikulja1993 collected €54.25 from pot
*** SUMMARY ***
Total pot €56.50 | Rake €2.25 
Board [Ah 8s 7d 7h 3h]
Seat 1: deadkiller1 folded before Flop (didn't bet)
Seat 2: matiko09 folded before Flop (didn't bet)
Seat 3: Vikulja1993 (button) showed [Jh 8h] and won (€54.25) with a flush, Ace high
Seat 4: torkkdnm (small blind) folded before Flop
Seat 5: cobrik23 (big blind) showed [2c 2d] and lost with two pair, Sevens and Deuces
Seat 7: rate8 folded before Flop (didn't bet)
Seat 8: Kihog folded before Flop (didn't bet)
Seat 9: stijner1986 folded on the Turn





PokerStars Hand #153504401772:  Hold'em No Limit ($0.50/$1.00 USD) - 2016/05/18 21:12:44 CET [2016/05/18 15:12:44 ET]
Table 'Pandora' 9-max Seat #1 is the button
Seat 1: deadkiller1 ($107.50 in chips) 
Seat 4: janarr5 ($100 in chips) 
Seat 7: torkkdnm ($102.15 in chips) 
Seat 8: matiko09 ($119.04 in chips) 
janarr5: posts small blind $0.50
Strikerman25: is sitting out 
Strikerman25 leaves the table
Moszes360: is sitting out 
torkkdnm: posts big blind $1
cobrik23: sits out 
*** HOLE CARDS ***
Dealt to matiko09 [Td Th]
Moszes360 leaves the table
matiko09: raises $1.50 to $2.50
deadkiller1: folds 
janarr5: folds 
torkkdnm: calls $1.50
*** FLOP *** [2c Ah 6h]
janarr5 leaves the table
torkkdnm: checks 
matiko09: checks 
*** TURN *** [2c Ah 6h] [5s]
torkkdnm: bets $4
matiko09: calls $4
*** RIVER *** [2c Ah 6h 5s] [Tc]
torkkdnm: checks 
matiko09: bets $9
torkkdnm: folds 
Uncalled bet ($9) returned to matiko09
matiko09 collected $12.82 from pot
matiko09: doesn't show hand 
*** SUMMARY ***
Total pot $13.50 | Rake $0.68 
Board [2c Ah 6h 5s Tc]
Seat 1: deadkiller1 (button) folded before Flop (didn't bet)
Seat 4: janarr5 (small blind) folded before Flop
Seat 7: torkkdnm (big blind) folded on the River
Seat 8: matiko09 collected ($12.82)





PokerStars Hand #153504405755:  Hold'em No Limit ($0.50/$1.00 USD) - 2016/05/18 21:12:48 CET [2016/05/18 15:12:48 ET]
Table 'Tatjana III' 9-max Seat #4 is the button
Seat 1: cobrik23 ($160.33 in chips) 
Seat 3: matiko09 ($181.79 in chips) 
Seat 4: lydia12345 ($121.48 in chips) 
Seat 5: deadkiller1 ($103.32 in chips) 
Seat 6: Kihog ($154.89 in chips) 
Seat 7: rene1984tsv ($106.97 in chips) 
Seat 8: JACQUILF ($100 in chips) 
Seat 9: Moszes360 ($100 in chips) 
deadkiller1: posts small blind $0.50
Kihog: posts big blind $1
*** HOLE CARDS ***
Dealt to matiko09 [4c Ad]
vanilica joins the table at seat #2 
rene1984tsv: raises $1 to $2
JACQUILF: folds 
Moszes360: folds 
cobrik23: folds 
matiko09: folds 
lydia12345: folds 
deadkiller1: folds 
Kihog: folds 
Uncalled bet ($1) returned to rene1984tsv
rene1984tsv collected $2.50 from pot
rene1984tsv: shows [7h Tc] (high card Ten)
*** SUMMARY ***
Total pot $2.50 | Rake $0 
Seat 1: cobrik23 folded before Flop (didn't bet)
Seat 3: matiko09 folded before Flop (didn't bet)
Seat 4: lydia12345 (button) folded before Flop (didn't bet)
Seat 5: deadkiller1 (small blind) folded before Flop
Seat 6: Kihog (big blind) folded before Flop
Seat 7: rene1984tsv collected ($2.50)
Seat 8: JACQUILF folded before Flop (didn't bet)
Seat 9: Moszes360 folded before Flop (didn't bet)





PokerStars Hand #153504414805:  Hold'em No Limit ($0.50/$1.00 USD) - 2016/05/18 21:12:58 CET [2016/05/18 15:12:58 ET]
Table 'Abetti II' 9-max Seat #6 is the button
Seat 1: matiko09 ($103.02 in chips) 
Seat 2: Vikulja1993 ($123.62 in chips) 
Seat 3: cobrik23 ($157.78 in chips) 
Seat 4: ipashutapkom ($40 in chips) 
Seat 5: blufthenuts ($147.75 in chips) 
Seat 6: Kihog ($100 in chips) 
Seat 7: rate8 ($100 in chips) 
Seat 8: roadster683 ($152.84 in chips) 
Seat 9: lydia12345 ($290.13 in chips) 
rate8: posts small blind $0.50
roadster683: posts big blind $1
*** HOLE CARDS ***
Dealt to matiko09 [9c 7h]
lydia12345: folds 
matiko09: folds 
Vikulja1993: folds 
cobrik23: folds 
ipashutapkom: folds 
blufthenuts: raises $2 to $3
Kihog: calls $3
rate8: folds 
roadster683: calls $2
*** FLOP *** [6d As Jc]
roadster683: checks 
blufthenuts: checks 
Kihog: checks 
*** TURN *** [6d As Jc] [3c]
roadster683: bets $5
blufthenuts: calls $5
Kihog: folds 
*** RIVER *** [6d As Jc 3c] [2d]
roadster683: checks 
blufthenuts: checks 
*** SHOW DOWN ***
roadster683: shows [5c 4h] (a straight, Deuce to Six)
blufthenuts: mucks hand 
roadster683 collected $18.52 from pot
*** SUMMARY ***
Total pot $19.50 | Rake $0.98 
Board [6d As Jc 3c 2d]
Seat 1: matiko09 folded before Flop (didn't bet)
Seat 2: Vikulja1993 folded before Flop (didn't bet)
Seat 3: cobrik23 folded before Flop (didn't bet)
Seat 4: ipashutapkom folded before Flop (didn't bet)
Seat 5: blufthenuts mucked [Qd Qc]
Seat 6: Kihog (button) folded on the Turn
Seat 7: rate8 (small blind) folded before Flop
Seat 8: roadster683 (big blind) showed [5c 4h] and won ($18.52) with a straight, Deuce to Six
Seat 9: lydia12345 folded before Flop (didn't bet)





PokerStars Hand #153504420595:  Hold'em No Limit ($0.50/$1.00 USD) - 2016/05/18 21:13:05 CET [2016/05/18 15:13:05 ET]
Table 'Samitchell II' 9-max Seat #7 is the button
Seat 1: riggedsh** ($114 in chips) 
Seat 2: IRAVABAN ($40 in chips) 
Seat 3: vanilica ($179.32 in chips) 
Seat 4: Zeeshka ($100 in chips) 
Seat 5: nuuaber ($50.26 in chips) 
Seat 6: Strikerman25 ($44.50 in chips) 
Seat 7: matiko09 ($103 in chips) 
Seat 8: rate8 ($129.02 in chips) 
rate8: posts small blind $0.50
solbi86: is sitting out 
riggedsh**: posts big blind $1
*** HOLE CARDS ***
Dealt to matiko09 [Kd 5d]
IRAVABAN: folds 
vanilica: folds 
Zeeshka: folds 
nuuaber: folds 
Strikerman25: folds 
matiko09: raises $1.27 to $2.27
rate8: folds 
riggedsh**: folds 
Uncalled bet ($1.27) returned to matiko09
matiko09 collected $2.50 from pot
matiko09: doesn't show hand 
*** SUMMARY ***
Total pot $2.50 | Rake $0 
Seat 1: riggedsh** (big blind) folded before Flop
Seat 2: IRAVABAN folded before Flop (didn't bet)
Seat 3: vanilica folded before Flop (didn't bet)
Seat 4: Zeeshka folded before Flop (didn't bet)
Seat 5: nuuaber folded before Flop (didn't bet)
Seat 6: Strikerman25 folded before Flop (didn't bet)
Seat 7: matiko09 (button) collected ($2.50)
Seat 8: rate8 (small blind) folded before Flop





PokerStars Hand #153504427149:  Hold'em No Limit ($0.50/$1.00 USD) - 2016/05/18 21:13:12 CET [2016/05/18 15:13:12 ET]
Table 'Martir' 9-max Seat #1 is the button
Seat 1: Vivaoo ($124.05 in chips) 
Seat 2: TimStone ($104.32 in chips) 
Seat 3: deadkiller1 ($100 in chips) 
Seat 4: cobrik23 ($90.43 in chips) 
Seat 5: stimp0r ($93.33 in chips) 
Seat 6: blufthenuts ($170.49 in chips) 
Seat 8: matiko09 ($100 in chips) 
Seat 9: torkkdnm ($115.71 in chips) 
TimStone: posts small blind $0.50
deadkiller1: posts big blind $1
janarr5: sits out 
*** HOLE CARDS ***
Dealt to matiko09 [2h Ts]
cobrik23: folds 
stimp0r: folds 
blufthenuts: raises $2 to $3
matiko09: folds 
torkkdnm: folds 
Vivaoo: calls $3
TimStone: folds 
deadkiller1: folds 
*** FLOP *** [2c 9s 8d]
blufthenuts: checks 
Vivaoo: bets $3.56
blufthenuts: calls $3.56
*** TURN *** [2c 9s 8d] [3h]
blufthenuts: checks 
Vivaoo: bets $6.94
blufthenuts: calls $6.94
*** RIVER *** [2c 9s 8d 3h] [Qd]
blufthenuts: checks 
Vivaoo: checks 
*** SHOW DOWN ***
blufthenuts: shows [Kd Kh] (a pair of Kings)
Vivaoo: mucks hand 
blufthenuts collected $27.08 from pot
*** SUMMARY ***
Total pot $28.50 | Rake $1.42 
Board [2c 9s 8d 3h Qd]
Seat 1: Vivaoo (button) mucked [9c Kc]
Seat 2: TimStone (small blind) folded before Flop
Seat 3: deadkiller1 (big blind) folded before Flop
Seat 4: cobrik23 folded before Flop (didn't bet)
Seat 5: stimp0r folded before Flop (didn't bet)
Seat 6: blufthenuts showed [Kd Kh] and won ($27.08) with a pair of Kings
Seat 8: matiko09 folded before Flop (didn't bet)
Seat 9: torkkdnm folded before Flop (didn't bet)





PokerStars Hand #153504431645:  Hold'em No Limit ($0.50/$1.00 USD) - 2016/05/18 21:13:17 CET [2016/05/18 15:13:17 ET]
Table 'Tatjana III' 9-max Seat #5 is the button
Seat 1: cobrik23 ($160.33 in chips) 
Seat 3: matiko09 ($181.79 in chips) 
Seat 4: lydia12345 ($121.48 in chips) 
Seat 5: deadkiller1 ($102.82 in chips) 
Seat 6: Kihog ($153.89 in chips) 
Seat 7: rene1984tsv ($108.47 in chips) 
Seat 8: JACQUILF ($100 in chips) 
Seat 9: Moszes360 ($100 in chips) 
Kihog: posts small blind $0.50
rene1984tsv: posts big blind $1
vanilica: sits out 
*** HOLE CARDS ***
Dealt to matiko09 [4h 9h]
JACQUILF: raises $2 to $3
Moszes360: folds 
cobrik23: folds 
matiko09: folds 
lydia12345: folds 
deadkiller1: folds 
Kihog: folds 
rene1984tsv: calls $2
*** FLOP *** [5h 8c Ts]
rene1984tsv: checks 
JACQUILF: checks 
*** TURN *** [5h 8c Ts] [Jh]
rene1984tsv: bets $3.09
JACQUILF: calls $3.09
*** RIVER *** [5h 8c Ts Jh] [9d]
rene1984tsv: bets $6.02
JACQUILF: folds 
Uncalled bet ($6.02) returned to rene1984tsv
rene1984tsv collected $12.05 from pot
rene1984tsv: doesn't show hand 
*** SUMMARY ***
Total pot $12.68 | Rake $0.63 
Board [5h 8c Ts Jh 9d]
Seat 1: cobrik23 folded before Flop (didn't bet)
Seat 3: matiko09 folded before Flop (didn't bet)
Seat 4: lydia12345 folded before Flop (didn't bet)
Seat 5: deadkiller1 (button) folded before Flop (didn't bet)
Seat 6: Kihog (small blind) folded before Flop
Seat 7: rene1984tsv (big blind) collected ($12.05)
Seat 8: JACQUILF folded on the River
Seat 9: Moszes360 folded before Flop (didn't bet)





PokerStars Hand #153504438635:  Hold'em No Limit ($0.50/$1.00 USD) - 2016/05/18 21:13:25 CET [2016/05/18 15:13:25 ET]
Table 'Brendelia II' 9-max Seat #1 is the button
Seat 1: vanilica ($100 in chips) 
Seat 2: LebzLouda ($44 in chips) 
Seat 3: Zeeshka ($100 in chips) 
Seat 4: person74 ($130.50 in chips) 
Seat 5: Vulturinus ($79 in chips) 
Seat 7: matiko09 ($100 in chips) 
Seat 8: solbi86 ($105.05 in chips) 
Seat 9: Kihog ($100 in chips) 
LebzLouda: posts small blind $0.50
Zeeshka: posts big blind $1
TimStone: sits out 
*** HOLE CARDS ***
Dealt to matiko09 [4h 5s]
person74: raises $1 to $2
Vulturinus: calls $2
matiko09: folds 
solbi86: folds 
Kihog: folds 
vanilica: calls $2
LebzLouda: folds 
Zeeshka: folds 
*** FLOP *** [Ah 2c 9h]
person74: bets $3.56
Vulturinus: folds 
vanilica: folds 
Uncalled bet ($3.56) returned to person74
person74 collected $7.12 from pot
person74: doesn't show hand 
*** SUMMARY ***
Total pot $7.50 | Rake $0.38 
Board [Ah 2c 9h]
Seat 1: vanilica (button) folded on the Flop
Seat 2: LebzLouda (small blind) folded before Flop
Seat 3: Zeeshka (big blind) folded before Flop
Seat 4: person74 collected ($7.12)
Seat 5: Vulturinus folded on the Flop
Seat 7: matiko09 folded before Flop (didn't bet)
Seat 8: solbi86 folded before Flop (didn't bet)
Seat 9: Kihog folded before Flop (didn't bet)





PokerStars Hand #153504449807:  Hold'em No Limit ($0.50/$1.00 USD) - 2016/05/18 21:13:37 CET [2016/05/18 15:13:37 ET]
Table 'Samitchell II' 9-max Seat #8 is the button
Seat 1: riggedsh** ($113 in chips) 
Seat 2: IRAVABAN ($40 in chips) 
Seat 3: vanilica ($179.32 in chips) 
Seat 4: Zeeshka ($100 in chips) 
Seat 5: nuuaber ($50.26 in chips) 
Seat 6: Strikerman25 ($44.50 in chips) 
Seat 7: matiko09 ($104.50 in chips) 
Seat 8: rate8 ($128.52 in chips) 
riggedsh**: posts small blind $0.50
IRAVABAN: posts big blind $1
*** HOLE CARDS ***
Dealt to matiko09 [3s 6d]
vanilica: folds 
Zeeshka: folds 
nuuaber: folds 
Strikerman25: raises $2 to $3
matiko09: folds 
rate8: raises $4 to $7
riggedsh**: folds 
IRAVABAN: folds 
Strikerman25: raises $37.50 to $44.50 and is all-in
rate8: folds 
Uncalled bet ($37.50) returned to Strikerman25
Strikerman25 collected $15.50 from pot
Strikerman25: doesn't show hand 
*** SUMMARY ***
Total pot $15.50 | Rake $0 
Seat 1: riggedsh** (small blind) folded before Flop
Seat 2: IRAVABAN (big blind) folded before Flop
Seat 3: vanilica folded before Flop (didn't bet)
Seat 4: Zeeshka folded before Flop (didn't bet)
Seat 5: nuuaber folded before Flop (didn't bet)
Seat 6: Strikerman25 collected ($15.50)
Seat 7: matiko09 folded before Flop (didn't bet)
Seat 8: rate8 (button) folded before Flop





PokerStars Hand #153504451607:  Hold'em No Limit ($0.50/$1.00 USD) - 2016/05/18 21:13:39 CET [2016/05/18 15:13:39 ET]
Table 'Lorcia II' 9-max Seat #3 is the button
Seat 1: HomerrrJay ($100 in chips) 
Seat 2: lydia12345 ($126.50 in chips) 
Seat 3: matiko09 ($104.02 in chips) 
Seat 4: vanilica ($100 in chips) 
Seat 5: nuuaber ($88.09 in chips) 
Seat 6: gkm0nk3y ($100 in chips) 
Seat 7: rate8 ($109.90 in chips) 
Seat 8: Skum1986 ($105.91 in chips) 
vanilica: posts small blind $0.50
nuuaber: posts big blind $1
*** HOLE CARDS ***
Dealt to matiko09 [5d Kd]
gkm0nk3y: folds 
rate8: folds 
Skum1986: folds 
HomerrrJay: folds 
lydia12345: folds 
matiko09: raises $1.27 to $2.27
vanilica: raises $5.54 to $7.81
nuuaber: raises $17.89 to $25.70
matiko09: folds 
vanilica: raises $74.30 to $100 and is all-in
nuuaber: calls $62.39 and is all-in
Uncalled bet ($11.91) returned to vanilica
*** FLOP *** [8s Kh 7h]
*** TURN *** [8s Kh 7h] [9s]
*** RIVER *** [8s Kh 7h 9s] [Qs]
*** SHOW DOWN ***
vanilica: shows [Jc Jd] (a pair of Jacks)
nuuaber: shows [Js As] (a flush, Ace high)
nuuaber collected $175.95 from pot
*** SUMMARY ***
Total pot $178.45 | Rake $2.50 
Board [8s Kh 7h 9s Qs]
Seat 1: HomerrrJay folded before Flop (didn't bet)
Seat 2: lydia12345 folded before Flop (didn't bet)
Seat 3: matiko09 (button) folded before Flop
Seat 4: vanilica (small blind) showed [Jc Jd] and lost with a pair of Jacks
Seat 5: nuuaber (big blind) showed [Js As] and won ($175.95) with a flush, Ace high
Seat 6: gkm0nk3y folded before Flop (didn't bet)
Seat 7: rate8 folded before Flop (didn't bet)
Seat 8: Skum1986 folded before Flop (didn't bet)





PokerStars Hand #153504469703:  Hold'em No Limit ($0.50/$1.00 USD) - 2016/05/18 21:13:59 CET [2016/05/18 15:13:59 ET]
Table 'Pandora' 9-max Seat #7 is the button
Seat 1: deadkiller1 ($107.50 in chips) 
Seat 7: torkkdnm ($100 in chips) 
Seat 8: matiko09 ($125.36 in chips) 
Seat 9: cobrik23 ($100 in chips) 
matiko09: posts small blind $0.50
cobrik23: posts big blind $1
*** HOLE CARDS ***
Dealt to matiko09 [Jd 6c]
deadkiller1: folds 
torkkdnm: raises $1 to $2
matiko09: folds 
cobrik23: folds 
Uncalled bet ($1) returned to torkkdnm
torkkdnm collected $2.50 from pot
*** SUMMARY ***
Total pot $2.50 | Rake $0 
Seat 1: deadkiller1 folded before Flop (didn't bet)
Seat 7: torkkdnm (button) collected ($2.50)
Seat 8: matiko09 (small blind) folded before Flop
Seat 9: cobrik23 (big blind) folded before Flop





PokerStars Hand #153504470917:  Hold'em No Limit ($0.50/$1.00 USD) - 2016/05/18 21:14:00 CET [2016/05/18 15:14:00 ET]
Table 'Brendelia II' 9-max Seat #2 is the button
Seat 1: vanilica ($100 in chips) 
Seat 2: LebzLouda ($43.50 in chips) 
Seat 3: Zeeshka ($100 in chips) 
Seat 4: person74 ($135.62 in chips) 
Seat 5: Vulturinus ($77 in chips) 
Seat 7: matiko09 ($100 in chips) 
Seat 8: solbi86 ($105.05 in chips) 
Seat 9: Kihog ($100 in chips) 
Zeeshka: posts small blind $0.50
person74: posts big blind $1
TimStone: sits out 
*** HOLE CARDS ***
Dealt to matiko09 [Kh 9s]
Vulturinus: folds 
matiko09: folds 
solbi86: raises $2 to $3
Kihog: calls $3
vanilica: folds 
LebzLouda: folds 
Zeeshka: folds 
person74: calls $2
*** FLOP *** [7s Jc Ah]
person74: checks 
solbi86: checks 
Kihog: bets $6.50
person74: calls $6.50
solbi86: folds 
*** TURN *** [7s Jc Ah] [6s]
person74: checks 
Kihog: bets $17.50
person74: folds 
Uncalled bet ($17.50) returned to Kihog
Kihog collected $21.38 from pot
Kihog: doesn't show hand 
*** SUMMARY ***
Total pot $22.50 | Rake $1.12 
Board [7s Jc Ah 6s]
Seat 1: vanilica folded before Flop (didn't bet)
Seat 2: LebzLouda (button) folded before Flop (didn't bet)
Seat 3: Zeeshka (small blind) folded before Flop
Seat 4: person74 (big blind) folded on the Turn
Seat 5: Vulturinus folded before Flop (didn't bet)
Seat 7: matiko09 folded before Flop (didn't bet)
Seat 8: solbi86 folded on the Flop
Seat 9: Kihog collected ($21.38)





PokerStars Hand #153504481416:  Hold'em No Limit ($0.50/$1.00 USD) - 2016/05/18 21:14:12 CET [2016/05/18 15:14:12 ET]
Table 'Tatjana III' 9-max Seat #6 is the button
Seat 1: cobrik23 ($160.33 in chips) 
Seat 3: matiko09 ($181.79 in chips) 
Seat 4: lydia12345 ($121.48 in chips) 
Seat 5: deadkiller1 ($102.82 in chips) 
Seat 6: Kihog ($153.39 in chips) 
Seat 7: rene1984tsv ($114.43 in chips) 
Seat 8: JACQUILF ($100 in chips) 
Seat 9: Moszes360 ($100 in chips) 
rene1984tsv: posts small blind $0.50
JACQUILF: posts big blind $1
vanilica: sits out 
*** HOLE CARDS ***
Dealt to matiko09 [3d Qh]
Moszes360: folds 
cobrik23: folds 
rene1984tsv said, "haha bluffend youu"
matiko09: folds 
lydia12345: folds 
deadkiller1: folds 
Kihog: folds 
rene1984tsv: calls $0.50
JACQUILF: raises $3 to $4
rene1984tsv: calls $3
*** FLOP *** [8h 2s 3c]
rene1984tsv: checks 
JACQUILF: checks 
*** TURN *** [8h 2s 3c] [Qd]
rene1984tsv: checks 
JACQUILF: bets $3.99
rene1984tsv: folds 
Uncalled bet ($3.99) returned to JACQUILF
JACQUILF collected $7.60 from pot
JACQUILF: doesn't show hand 
*** SUMMARY ***
Total pot $8 | Rake $0.40 
Board [8h 2s 3c Qd]
Seat 1: cobrik23 folded before Flop (didn't bet)
Seat 3: matiko09 folded before Flop (didn't bet)
Seat 4: lydia12345 folded before Flop (didn't bet)
Seat 5: deadkiller1 folded before Flop (didn't bet)
Seat 6: Kihog (button) folded before Flop (didn't bet)
Seat 7: rene1984tsv (small blind) folded on the Turn
Seat 8: JACQUILF (big blind) collected ($7.60)
Seat 9: Moszes360 folded before Flop (didn't bet)





PokerStars Hand #153504493844:  Hold'em No Limit ($0.50/$1.00 USD) - 2016/05/18 21:14:16 CET [2016/05/18 15:14:16 ET]
Table 'Abetti II' 9-max Seat #7 is the button
Seat 1: matiko09 ($103.02 in chips) 
Seat 2: Vikulja1993 ($123.62 in chips) 
Seat 3: cobrik23 ($157.78 in chips) 
Seat 4: ipashutapkom ($40 in chips) 
Seat 5: blufthenuts ($139.75 in chips) 
Seat 6: Kihog ($100 in chips) 
Seat 7: rate8 ($100 in chips) 
Seat 8: roadster683 ($163.36 in chips) 
Seat 9: lydia12345 ($290.13 in chips) 
roadster683: posts small blind $0.50
lydia12345: posts big blind $1
*** HOLE CARDS ***
Dealt to matiko09 [7d 9s]
matiko09: folds 
Vikulja1993: folds 
cobrik23: folds 
ipashutapkom: folds 
blufthenuts: folds 
Kihog: folds 
rate8: raises $1 to $2
roadster683: calls $1.50
lydia12345: folds 
*** FLOP *** [2c Jc 8d]
roadster683: checks 
rate8: bets $3.37
roadster683: calls $3.37
*** TURN *** [2c Jc 8d] [5h]
roadster683: checks 
rate8: bets $8.03
roadster683: folds 
Uncalled bet ($8.03) returned to rate8
rate8 collected $11.15 from pot
*** SUMMARY ***
Total pot $11.74 | Rake $0.59 
Board [2c Jc 8d 5h]
Seat 1: matiko09 folded before Flop (didn't bet)
Seat 2: Vikulja1993 folded before Flop (didn't bet)
Seat 3: cobrik23 folded before Flop (didn't bet)
Seat 4: ipashutapkom folded before Flop (didn't bet)
Seat 5: blufthenuts folded before Flop (didn't bet)
Seat 6: Kihog folded before Flop (didn't bet)
Seat 7: rate8 (button) collected ($11.15)
Seat 8: roadster683 (small blind) folded on the Turn
Seat 9: lydia12345 (big blind) folded before Flop





PokerStars Hand #153504504440:  Hold'em No Limit ($0.50/$1.00 USD) - 2016/05/18 21:14:28 CET [2016/05/18 15:14:28 ET]
Table 'Lorcia II' 9-max Seat #4 is the button
Seat 1: HomerrrJay ($100 in chips) 
Seat 2: lydia12345 ($126.50 in chips) 
Seat 3: matiko09 ($101.75 in chips) 
Seat 4: vanilica ($100 in chips) 
Seat 5: nuuaber ($175.95 in chips) 
Seat 6: gkm0nk3y ($100 in chips) 
Seat 7: rate8 ($109.90 in chips) 
Seat 8: Skum1986 ($105.91 in chips) 
nuuaber: posts small blind $0.50
gkm0nk3y: posts big blind $1
*** HOLE CARDS ***
Dealt to matiko09 [5h 2d]
rate8: folds 
Skum1986: folds 
HomerrrJay: raises $2 to $3
lydia12345: calls $3
matiko09: folds 
vanilica: folds 
nuuaber: folds 
gkm0nk3y: folds 
*** FLOP *** [Ac Ts Qc]
HomerrrJay: bets $5.69
lydia12345: calls $5.69
*** TURN *** [Ac Ts Qc] [5c]
HomerrrJay: checks 
lydia12345: bets $12.20
HomerrrJay: folds 
Uncalled bet ($12.20) returned to lydia12345
lydia12345 collected $17.94 from pot
*** SUMMARY ***
Total pot $18.88 | Rake $0.94 
Board [Ac Ts Qc 5c]
Seat 1: HomerrrJay folded on the Turn
Seat 2: lydia12345 collected ($17.94)
Seat 3: matiko09 folded before Flop (didn't bet)
Seat 4: vanilica (button) folded before Flop (didn't bet)
Seat 5: nuuaber (small blind) folded before Flop
Seat 6: gkm0nk3y (big blind) folded before Flop
Seat 7: rate8 folded before Flop (didn't bet)
Seat 8: Skum1986 folded before Flop (didn't bet)





PokerStars Hand #153504504864:  Hold'em No Limit ($0.50/$1.00 USD) - 2016/05/18 21:14:29 CET [2016/05/18 15:14:29 ET]
Table 'Pandora' 9-max Seat #8 is the button
Seat 1: deadkiller1 ($107.50 in chips) 
Seat 7: torkkdnm ($101.50 in chips) 
Seat 8: matiko09 ($124.86 in chips) 
Seat 9: cobrik23 ($99 in chips) 
cobrik23: posts small blind $0.50
deadkiller1: posts big blind $1
*** HOLE CARDS ***
Dealt to matiko09 [Kd Qs]
torkkdnm: folds 
matiko09: raises $1.27 to $2.27
cobrik23: calls $1.77
deadkiller1: folds 
*** FLOP *** [Kh 5h 2c]
cobrik23: checks 
matiko09: bets $3.42
cobrik23: folds 
Uncalled bet ($3.42) returned to matiko09
matiko09 collected $5.26 from pot
matiko09: doesn't show hand 
*** SUMMARY ***
Total pot $5.54 | Rake $0.28 
Board [Kh 5h 2c]
Seat 1: deadkiller1 (big blind) folded before Flop
Seat 7: torkkdnm folded before Flop (didn't bet)
Seat 8: matiko09 (button) collected ($5.26)
Seat 9: cobrik23 (small blind) folded on the Flop





PokerStars Hand #153504508078:  Hold'em No Limit (€0.50/€1.00 EUR) - 2016/05/18 21:14:32 CET [2016/05/18 15:14:32 ET]
Table 'Pallas II' 9-max Seat #4 is the button
Seat 1: deadkiller1 (€206.31 in chips) 
Seat 2: matiko09 (€100 in chips) 
Seat 3: Vikulja1993 (€131.25 in chips) 
Seat 4: torkkdnm (€150.63 in chips) 
Seat 5: cobrik23 (€40 in chips) 
Seat 6: janarr5 (€100 in chips) 
Seat 7: rate8 (€100 in chips) 
Seat 8: Kihog (€167.30 in chips) 
Seat 9: stijner1986 (€171.56 in chips) 
cobrik23: posts small blind €0.50
janarr5: posts big blind €1
*** HOLE CARDS ***
Dealt to matiko09 [4c 8h]
rate8: folds 
Kihog: folds 
stijner1986: calls €1
deadkiller1: folds 
matiko09: folds 
Vikulja1993: folds 
torkkdnm: folds 
cobrik23: raises €4 to €5
janarr5: folds 
stijner1986: calls €4
*** FLOP *** [7c Jc Jh]
cobrik23: checks 
stijner1986: bets €5
cobrik23: calls €5
*** TURN *** [7c Jc Jh] [9d]
cobrik23: checks 
stijner1986: bets €10
cobrik23: calls €10
*** RIVER *** [7c Jc Jh 9d] [5c]
cobrik23: checks 
stijner1986: checks 
*** SHOW DOWN ***
cobrik23: shows [Qc Qd] (two pair, Queens and Jacks)
stijner1986: shows [Js Qs] (three of a kind, Jacks)
stijner1986 collected €38.95 from pot
*** SUMMARY ***
Total pot €41 | Rake €2.05 
Board [7c Jc Jh 9d 5c]
Seat 1: deadkiller1 folded before Flop (didn't bet)
Seat 2: matiko09 folded before Flop (didn't bet)
Seat 3: Vikulja1993 folded before Flop (didn't bet)
Seat 4: torkkdnm (button) folded before Flop (didn't bet)
Seat 5: cobrik23 (small blind) showed [Qc Qd] and lost with two pair, Queens and Jacks
Seat 6: janarr5 (big blind) folded before Flop
Seat 7: rate8 folded before Flop (didn't bet)
Seat 8: Kihog folded before Flop (didn't bet)
Seat 9: stijner1986 showed [Js Qs] and won (€38.95) with three of a kind, Jacks





PokerStars Hand #153504508755:  Hold'em No Limit ($0.50/$1.00 USD) - 2016/05/18 21:14:33 CET [2016/05/18 15:14:33 ET]
Table 'Samitchell II' 9-max Seat #1 is the button
Seat 1: riggedsh** ($112.50 in chips) 
Seat 2: IRAVABAN ($40 in chips) 
Seat 3: vanilica ($179.32 in chips) 
Seat 4: Zeeshka ($100 in chips) 
Seat 5: nuuaber ($50.26 in chips) 
Seat 6: Strikerman25 ($53 in chips) 
Seat 7: matiko09 ($104.50 in chips) 
Seat 8: rate8 ($121.52 in chips) 
IRAVABAN: posts small blind $0.50
vanilica: posts big blind $1
*** HOLE CARDS ***
Dealt to matiko09 [2c Th]
Zeeshka: folds 
nuuaber: folds 
Strikerman25: folds 
matiko09: folds 
rate8: folds 
riggedsh**: folds 
IRAVABAN: raises $1.50 to $2.50
vanilica: folds 
Uncalled bet ($1.50) returned to IRAVABAN
IRAVABAN collected $2 from pot
IRAVABAN: doesn't show hand 
*** SUMMARY ***
Total pot $2 | Rake $0 
Seat 1: riggedsh** (button) folded before Flop (didn't bet)
Seat 2: IRAVABAN (small blind) collected ($2)
Seat 3: vanilica (big blind) folded before Flop
Seat 4: Zeeshka folded before Flop (didn't bet)
Seat 5: nuuaber folded before Flop (didn't bet)
Seat 6: Strikerman25 folded before Flop (didn't bet)
Seat 7: matiko09 folded before Flop (didn't bet)
Seat 8: rate8 folded before Flop (didn't bet)





PokerStars Hand #153504512626:  Hold'em No Limit ($0.50/$1.00 USD) - 2016/05/18 21:14:37 CET [2016/05/18 15:14:37 ET]
Table 'Martir' 9-max Seat #2 is the button
Seat 1: Vivaoo ($110.55 in chips) 
Seat 2: TimStone ($103.82 in chips) 
Seat 3: deadkiller1 ($100 in chips) 
Seat 4: cobrik23 ($90.43 in chips) 
Seat 5: stimp0r ($93.33 in chips) 
Seat 6: blufthenuts ($184.07 in chips) 
Seat 8: matiko09 ($100 in chips) 
Seat 9: torkkdnm ($115.71 in chips) 
deadkiller1: posts small blind $0.50
cobrik23: posts big blind $1
janarr5: sits out 
*** HOLE CARDS ***
Dealt to matiko09 [Kd 6s]
stimp0r: folds 
blufthenuts: folds 
matiko09: folds 
torkkdnm: folds 
Vivaoo: folds 
TimStone: folds 
deadkiller1: raises $1.50 to $2.50
cobrik23: folds 
Uncalled bet ($1.50) returned to deadkiller1
deadkiller1 collected $2 from pot
deadkiller1: doesn't show hand 
*** SUMMARY ***
Total pot $2 | Rake $0 
Seat 1: Vivaoo folded before Flop (didn't bet)
Seat 2: TimStone (button) folded before Flop (didn't bet)
Seat 3: deadkiller1 (small blind) collected ($2)
Seat 4: cobrik23 (big blind) folded before Flop
Seat 5: stimp0r folded before Flop (didn't bet)
Seat 6: blufthenuts folded before Flop (didn't bet)
Seat 8: matiko09 folded before Flop (didn't bet)
Seat 9: torkkdnm folded before Flop (didn't bet)





PokerStars Hand #153504536965:  Hold'em No Limit ($0.50/$1.00 USD) - 2016/05/18 21:15:04 CET [2016/05/18 15:15:04 ET]
Table 'Brendelia II' 9-max Seat #3 is the button
Seat 1: vanilica ($100 in chips) 
Seat 2: LebzLouda ($43.50 in chips) 
Seat 3: Zeeshka ($100 in chips) 
Seat 4: person74 ($126.12 in chips) 
Seat 5: Vulturinus ($77 in chips) 
Seat 7: matiko09 ($100 in chips) 
Seat 8: solbi86 ($102.05 in chips) 
Seat 9: Kihog ($111.88 in chips) 
person74: posts small blind $0.50
Vulturinus: posts big blind $1
TimStone: sits out 
*** HOLE CARDS ***
Dealt to matiko09 [5c Kd]
matiko09: folds 
solbi86: folds 
Kihog: folds 
vanilica: folds 
LebzLouda: folds 
Zeeshka: folds 
person74: calls $0.50
Vulturinus: raises $2 to $3
person74: calls $2
*** FLOP *** [2s 7c Qs]
person74: bets $2.85
Vulturinus: raises $3.85 to $6.70
person74: folds 
Uncalled bet ($3.85) returned to Vulturinus
Vulturinus collected $11.12 from pot
*** SUMMARY ***
Total pot $11.70 | Rake $0.58 
Board [2s 7c Qs]
Seat 1: vanilica folded before Flop (didn't bet)
Seat 2: LebzLouda folded before Flop (didn't bet)
Seat 3: Zeeshka (button) folded before Flop (didn't bet)
Seat 4: person74 (small blind) folded on the Flop
Seat 5: Vulturinus (big blind) collected ($11.12)
Seat 7: matiko09 folded before Flop (didn't bet)
Seat 8: solbi86 folded before Flop (didn't bet)
Seat 9: Kihog folded before Flop (didn't bet)





PokerStars Hand #153504539044:  Hold'em No Limit ($0.50/$1.00 USD) - 2016/05/18 21:15:06 CET [2016/05/18 15:15:06 ET]
Table 'Abetti II' 9-max Seat #8 is the button
Seat 1: matiko09 ($103.02 in chips) 
Seat 2: Vikulja1993 ($123.62 in chips) 
Seat 3: cobrik23 ($157.78 in chips) 
Seat 4: ipashutapkom ($40 in chips) 
Seat 5: blufthenuts ($139.75 in chips) 
Seat 6: Kihog ($100 in chips) 
Seat 7: rate8 ($105.78 in chips) 
Seat 8: roadster683 ($157.99 in chips) 
Seat 9: lydia12345 ($289.13 in chips) 
lydia12345: posts small blind $0.50
matiko09: posts big blind $1
*** HOLE CARDS ***
Dealt to matiko09 [Ks 6h]
Vikulja1993: raises $2 to $3
cobrik23: folds 
ipashutapkom: folds 
blufthenuts: folds 
Kihog: folds 
rate8: folds 
roadster683: calls $3
lydia12345: folds 
matiko09: folds 
*** FLOP *** [9h Jd Qc]
Vikulja1993: bets $5.95
roadster683: raises $8.95 to $14.90
Vikulja1993: folds 
Uncalled bet ($8.95) returned to roadster683
roadster683 collected $18.43 from pot
roadster683: doesn't show hand 
*** SUMMARY ***
Total pot $19.40 | Rake $0.97 
Board [9h Jd Qc]
Seat 1: matiko09 (big blind) folded before Flop
Seat 2: Vikulja1993 folded on the Flop
Seat 3: cobrik23 folded before Flop (didn't bet)
Seat 4: ipashutapkom folded before Flop (didn't bet)
Seat 5: blufthenuts folded before Flop (didn't bet)
Seat 6: Kihog folded before Flop (didn't bet)
Seat 7: rate8 folded before Flop (didn't bet)
Seat 8: roadster683 (button) collected ($18.43)
Seat 9: lydia12345 (small blind) folded before Flop





PokerStars Hand #153504539464:  Hold'em No Limit ($0.50/$1.00 USD) - 2016/05/18 21:15:07 CET [2016/05/18 15:15:07 ET]
Table 'Samitchell II' 9-max Seat #2 is the button
Seat 1: riggedsh** ($112.50 in chips) 
Seat 2: IRAVABAN ($41 in chips) 
Seat 3: vanilica ($178.32 in chips) 
Seat 4: Zeeshka ($100 in chips) 
Seat 5: nuuaber ($50.26 in chips) 
Seat 6: Strikerman25 ($53 in chips) 
Seat 7: matiko09 ($104.50 in chips) 
Seat 8: rate8 ($121.52 in chips) 
vanilica: posts small blind $0.50
Zeeshka: posts big blind $1
*** HOLE CARDS ***
Dealt to matiko09 [Kh Td]
nuuaber: folds 
Strikerman25: folds 
matiko09: folds 
rate8: raises $2 to $3
riggedsh**: folds 
IRAVABAN: folds 
vanilica: folds 
Zeeshka: folds 
Uncalled bet ($2) returned to rate8
rate8 collected $2.50 from pot
*** SUMMARY ***
Total pot $2.50 | Rake $0 
Seat 1: riggedsh** folded before Flop (didn't bet)
Seat 2: IRAVABAN (button) folded before Flop (didn't bet)
Seat 3: vanilica (small blind) folded before Flop
Seat 4: Zeeshka (big blind) folded before Flop
Seat 5: nuuaber folded before Flop (didn't bet)
Seat 6: Strikerman25 folded before Flop (didn't bet)
Seat 7: matiko09 folded before Flop (didn't bet)
Seat 8: rate8 collected ($2.50)





PokerStars Hand #153504551174:  Hold'em No Limit ($0.50/$1.00 USD) - 2016/05/18 21:15:20 CET [2016/05/18 15:15:20 ET]
Table 'Martir' 9-max Seat #3 is the button
Seat 1: Vivaoo ($110.55 in chips) 
Seat 2: TimStone ($103.82 in chips) 
Seat 3: deadkiller1 ($101 in chips) 
Seat 4: cobrik23 ($89.43 in chips) 
Seat 5: stimp0r ($93.33 in chips) 
Seat 6: blufthenuts ($184.07 in chips) 
Seat 8: matiko09 ($100 in chips) 
Seat 9: torkkdnm ($115.71 in chips) 
cobrik23: posts small blind $0.50
stimp0r: posts big blind $1
janarr5: sits out 
*** HOLE CARDS ***
Dealt to matiko09 [Qd 2d]
blufthenuts: folds 
matiko09: folds 
torkkdnm: folds 
Vivaoo: folds 
TimStone: folds 
deadkiller1: folds 
cobrik23: raises $2 to $3
stimp0r: folds 
Uncalled bet ($2) returned to cobrik23
cobrik23 collected $2 from pot
cobrik23: doesn't show hand 
*** SUMMARY ***
Total pot $2 | Rake $0 
Seat 1: Vivaoo folded before Flop (didn't bet)
Seat 2: TimStone folded before Flop (didn't bet)
Seat 3: deadkiller1 (button) folded before Flop (didn't bet)
Seat 4: cobrik23 (small blind) collected ($2)
Seat 5: stimp0r (big blind) folded before Flop
Seat 6: blufthenuts folded before Flop (didn't bet)
Seat 8: matiko09 folded before Flop (didn't bet)
Seat 9: torkkdnm folded before Flop (didn't bet)





PokerStars Hand #153504552803:  Hold'em No Limit ($0.50/$1.00 USD) - 2016/05/18 21:15:22 CET [2016/05/18 15:15:22 ET]
Table 'Tatjana III' 9-max Seat #7 is the button
Seat 1: cobrik23 ($160.33 in chips) 
Seat 3: matiko09 ($181.79 in chips) 
Seat 4: lydia12345 ($121.48 in chips) 
Seat 5: deadkiller1 ($102.82 in chips) 
Seat 6: Kihog ($153.39 in chips) 
Seat 7: rene1984tsv ($110.43 in chips) 
Seat 8: JACQUILF ($103.60 in chips) 
Seat 9: Moszes360 ($100 in chips) 
JACQUILF: posts small blind $0.50
Moszes360: posts big blind $1
vanilica: sits out 
*** HOLE CARDS ***
Dealt to matiko09 [3d 3h]
cobrik23: raises $3 to $4
matiko09: folds 
lydia12345: folds 
deadkiller1: folds 
Kihog: folds 
rene1984tsv: calls $4
JACQUILF: folds 
Moszes360: folds 
*** FLOP *** [Qd Ks Kc]
cobrik23: checks 
rene1984tsv: checks 
*** TURN *** [Qd Ks Kc] [Kd]
cobrik23: bets $6.01
rene1984tsv: calls $6.01
*** RIVER *** [Qd Ks Kc Kd] [6c]
cobrik23: checks 
rene1984tsv: bets $12
cobrik23: calls $12
*** SHOW DOWN ***
rene1984tsv: shows [Js Qc] (a full house, Kings full of Queens)
cobrik23: shows [Qs Ts] (a full house, Kings full of Queens)
cobrik23 collected $21.62 from pot
rene1984tsv collected $21.62 from pot
*** SUMMARY ***
Total pot $45.52 | Rake $2.28 
Board [Qd Ks Kc Kd 6c]
Seat 1: cobrik23 showed [Qs Ts] and won ($21.62) with a full house, Kings full of Queens
Seat 3: matiko09 folded before Flop (didn't bet)
Seat 4: lydia12345 folded before Flop (didn't bet)
Seat 5: deadkiller1 folded before Flop (didn't bet)
Seat 6: Kihog folded before Flop (didn't bet)
Seat 7: rene1984tsv (button) showed [Js Qc] and won ($21.62) with a full house, Kings full of Queens
Seat 8: JACQUILF (small blind) folded before Flop
Seat 9: Moszes360 (big blind) folded before Flop





PokerStars Hand #153504570658:  Hold'em No Limit ($0.50/$1.00 USD) - 2016/05/18 21:15:41 CET [2016/05/18 15:15:41 ET]
Table 'Samitchell II' 9-max Seat #3 is the button
Seat 1: riggedsh** ($112.50 in chips) 
Seat 2: IRAVABAN ($41 in chips) 
Seat 3: vanilica ($177.82 in chips) 
Seat 4: Zeeshka ($100 in chips) 
Seat 5: nuuaber ($50.26 in chips) 
Seat 6: Strikerman25 ($53 in chips) 
Seat 7: matiko09 ($104.50 in chips) 
Seat 8: rate8 ($123.02 in chips) 
Zeeshka: posts small blind $0.50
nuuaber: posts big blind $1
*** HOLE CARDS ***
Dealt to matiko09 [Ah 2d]
Strikerman25: folds 
matiko09: folds 
rate8: folds 
riggedsh**: folds 
IRAVABAN: raises $2 to $3
vanilica: folds 
Zeeshka: folds 
solbi86 leaves the table
nuuaber: folds 
Uncalled bet ($2) returned to IRAVABAN
IRAVABAN collected $2.50 from pot
IRAVABAN: doesn't show hand 
*** SUMMARY ***
Total pot $2.50 | Rake $0 
Seat 1: riggedsh** folded before Flop (didn't bet)
Seat 2: IRAVABAN collected ($2.50)
Seat 3: vanilica (button) folded before Flop (didn't bet)
Seat 4: Zeeshka (small blind) folded before Flop
Seat 5: nuuaber (big blind) folded before Flop
Seat 6: Strikerman25 folded before Flop (didn't bet)
Seat 7: matiko09 folded before Flop (didn't bet)
Seat 8: rate8 folded before Flop (didn't bet)





PokerStars Hand #153504587283:  Hold'em No Limit ($0.50/$1.00 USD) - 2016/05/18 21:15:59 CET [2016/05/18 15:15:59 ET]
Table 'Abetti II' 9-max Seat #9 is the button
Seat 1: matiko09 ($102.02 in chips) 
Seat 2: Vikulja1993 ($114.67 in chips) 
Seat 3: cobrik23 ($157.78 in chips) 
Seat 4: ipashutapkom ($40 in chips) 
Seat 5: blufthenuts ($139.75 in chips) 
Seat 6: Kihog ($100 in chips) 
Seat 7: rate8 ($105.78 in chips) 
Seat 8: roadster683 ($167.47 in chips) 
Seat 9: lydia12345 ($288.63 in chips) 
matiko09: posts small blind $0.50
Vikulja1993: posts big blind $1
*** HOLE CARDS ***
Dealt to matiko09 [Kh Qh]
cobrik23 has timed out
cobrik23: folds 
ipashutapkom: raises $1.26 to $2.26
blufthenuts: folds 
Kihog: calls $2.26
rate8: folds 
roadster683: calls $2.26
lydia12345: folds 
matiko09: raises $7.74 to $10
Vikulja1993: folds 
ipashutapkom: folds 
Kihog: calls $7.74
roadster683: calls $7.74
*** FLOP *** [4s 7s Jc]
matiko09: checks 
Kihog: checks 
roadster683: checks 
*** TURN *** [4s 7s Jc] [5h]
matiko09: checks 
Kihog: checks 
roadster683: checks 
*** RIVER *** [4s 7s Jc 5h] [Th]
matiko09: checks 
Kihog: checks 
roadster683: bets $12
matiko09: folds 
Kihog: folds 
Uncalled bet ($12) returned to roadster683
roadster683 collected $31.60 from pot
roadster683: doesn't show hand 
*** SUMMARY ***
Total pot $33.26 | Rake $1.66 
Board [4s 7s Jc 5h Th]
Seat 1: matiko09 (small blind) folded on the River
Seat 2: Vikulja1993 (big blind) folded before Flop
Seat 3: cobrik23 folded before Flop (didn't bet)
Seat 4: ipashutapkom folded before Flop
Seat 5: blufthenuts folded before Flop (didn't bet)
Seat 6: Kihog folded on the River
Seat 7: rate8 folded before Flop (didn't bet)
Seat 8: roadster683 collected ($31.60)
Seat 9: lydia12345 (button) folded before Flop (didn't bet)





PokerStars Hand #153504592848:  Hold'em No Limit ($0.50/$1.00 USD) - 2016/05/18 21:16:05 CET [2016/05/18 15:16:05 ET]
Table 'Lorcia II' 9-max Seat #5 is the button
Seat 1: HomerrrJay ($100 in chips) 
Seat 2: lydia12345 ($135.75 in chips) 
Seat 3: matiko09 ($101.75 in chips) 
Seat 4: vanilica ($100 in chips) 
Seat 5: nuuaber ($175.45 in chips) 
Seat 6: gkm0nk3y ($100 in chips) 
Seat 7: rate8 ($109.90 in chips) 
Seat 8: Skum1986 ($105.91 in chips) 
gkm0nk3y: posts small blind $0.50
rate8: posts big blind $1
*** HOLE CARDS ***
Dealt to matiko09 [3c 2s]
Skum1986: folds 
HomerrrJay: folds 
lydia12345: folds 
matiko09: folds 
vanilica: folds 
nuuaber: folds 
gkm0nk3y: raises $1.50 to $2.50
rate8: folds 
Uncalled bet ($1.50) returned to gkm0nk3y
gkm0nk3y collected $2 from pot
*** SUMMARY ***
Total pot $2 | Rake $0 
Seat 1: HomerrrJay folded before Flop (didn't bet)
Seat 2: lydia12345 folded before Flop (didn't bet)
Seat 3: matiko09 folded before Flop (didn't bet)
Seat 4: vanilica folded before Flop (didn't bet)
Seat 5: nuuaber (button) folded before Flop (didn't bet)
Seat 6: gkm0nk3y (small blind) collected ($2)
Seat 7: rate8 (big blind) folded before Flop
Seat 8: Skum1986 folded before Flop (didn't bet)





PokerStars Hand #153504596995:  Hold'em No Limit ($0.50/$1.00 USD) - 2016/05/18 21:16:09 CET [2016/05/18 15:16:09 ET]
Table 'Brendelia II' 9-max Seat #4 is the button
Seat 1: vanilica ($100 in chips) 
Seat 2: LebzLouda ($43.50 in chips) 
Seat 3: Zeeshka ($100 in chips) 
Seat 4: person74 ($120.27 in chips) 
Seat 5: Vulturinus ($82.27 in chips) 
Seat 6: TimStone ($100 in chips) 
Seat 7: matiko09 ($100 in chips) 
Seat 8: solbi86 ($102.05 in chips) 
Seat 9: Kihog ($111.88 in chips) 
Vulturinus: posts small blind $0.50
TimStone: posts big blind $1
*** HOLE CARDS ***
Dealt to matiko09 [As 5c]
matiko09: folds 
solbi86: folds 
Kihog: folds 
vanilica: raises $1.50 to $2.50
LebzLouda: folds 
Zeeshka: folds 
person74: folds 
Vulturinus: calls $2
TimStone: folds 
*** FLOP *** [3h 4s 9d]
Vulturinus: checks 
vanilica: checks 
*** TURN *** [3h 4s 9d] [3d]
Vulturinus: checks 
vanilica: checks 
*** RIVER *** [3h 4s 9d 3d] [4h]
Vulturinus: checks 
vanilica: checks 
*** SHOW DOWN ***
Vulturinus: shows [Js Ac] (two pair, Fours and Threes)
vanilica: shows [5s 5d] (two pair, Fives and Fours)
vanilica collected $5.70 from pot
*** SUMMARY ***
Total pot $6 | Rake $0.30 
Board [3h 4s 9d 3d 4h]
Seat 1: vanilica showed [5s 5d] and won ($5.70) with two pair, Fives and Fours
Seat 2: LebzLouda folded before Flop (didn't bet)
Seat 3: Zeeshka folded before Flop (didn't bet)
Seat 4: person74 (button) folded before Flop (didn't bet)
Seat 5: Vulturinus (small blind) showed [Js Ac] and lost with two pair, Fours and Threes
Seat 6: TimStone (big blind) folded before Flop
Seat 7: matiko09 folded before Flop (didn't bet)
Seat 8: solbi86 folded before Flop (didn't bet)
Seat 9: Kihog folded before Flop (didn't bet)





PokerStars Hand #153504601909:  Hold'em No Limit ($0.50/$1.00 USD) - 2016/05/18 21:16:15 CET [2016/05/18 15:16:15 ET]
Table 'Samitchell II' 9-max Seat #4 is the button
Seat 1: riggedsh** ($112.50 in chips) 
Seat 2: IRAVABAN ($42.50 in chips) 
Seat 3: vanilica ($177.82 in chips) 
Seat 4: Zeeshka ($100 in chips) 
Seat 5: nuuaber ($49.26 in chips) 
Seat 6: Strikerman25 ($53 in chips) 
Seat 7: matiko09 ($104.50 in chips) 
Seat 8: rate8 ($123.02 in chips) 
nuuaber: posts small blind $0.50
janarr5 joins the table at seat #9 
Strikerman25: posts big blind $1
*** HOLE CARDS ***
Dealt to matiko09 [Kh 3c]
matiko09: folds 
rate8: folds 
riggedsh**: folds 
IRAVABAN: folds 
vanilica: folds 
Zeeshka: folds 
nuuaber: calls $0.50
Strikerman25: checks 
*** FLOP *** [Qh 5c Jh]
nuuaber: bets $4
Strikerman25: folds 
Uncalled bet ($4) returned to nuuaber
nuuaber collected $1.90 from pot
nuuaber: doesn't show hand 
*** SUMMARY ***
Total pot $2 | Rake $0.10 
Board [Qh 5c Jh]
Seat 1: riggedsh** folded before Flop (didn't bet)
Seat 2: IRAVABAN folded before Flop (didn't bet)
Seat 3: vanilica folded before Flop (didn't bet)
Seat 4: Zeeshka (button) folded before Flop (didn't bet)
Seat 5: nuuaber (small blind) collected ($1.90)
Seat 6: Strikerman25 (big blind) folded on the Flop
Seat 7: matiko09 folded before Flop (didn't bet)
Seat 8: rate8 folded before Flop (didn't bet)





PokerStars Hand #153504609206:  Hold'em No Limit ($0.50/$1.00 USD) - 2016/05/18 21:16:23 CET [2016/05/18 15:16:23 ET]
Table 'Martir' 9-max Seat #4 is the button
Seat 1: Vivaoo ($110.55 in chips) 
Seat 2: TimStone ($103.82 in chips) 
Seat 3: deadkiller1 ($101 in chips) 
Seat 4: cobrik23 ($90.43 in chips) 
Seat 5: stimp0r ($92.33 in chips) 
Seat 6: blufthenuts ($184.07 in chips) 
Seat 8: matiko09 ($100 in chips) 
Seat 9: torkkdnm ($115.71 in chips) 
stimp0r: posts small blind $0.50
blufthenuts: posts big blind $1
janarr5: sits out 
*** HOLE CARDS ***
Dealt to matiko09 [Qs 3h]
matiko09: folds 
torkkdnm has timed out
torkkdnm: folds 
Vivaoo: folds 
TimStone: folds 
deadkiller1: folds 
cobrik23: raises $1.50 to $2.50
stimp0r: folds 
blufthenuts: folds 
Uncalled bet ($1.50) returned to cobrik23
cobrik23 collected $2.50 from pot
cobrik23: doesn't show hand 
*** SUMMARY ***
Total pot $2.50 | Rake $0 
Seat 1: Vivaoo folded before Flop (didn't bet)
Seat 2: TimStone folded before Flop (didn't bet)
Seat 3: deadkiller1 folded before Flop (didn't bet)
Seat 4: cobrik23 (button) collected ($2.50)
Seat 5: stimp0r (small blind) folded before Flop
Seat 6: blufthenuts (big blind) folded before Flop
Seat 8: matiko09 folded before Flop (didn't bet)
Seat 9: torkkdnm folded before Flop (didn't bet)





PokerStars Hand #153504623211:  Hold'em No Limit (€0.50/€1.00 EUR) - 2016/05/18 21:16:38 CET [2016/05/18 15:16:38 ET]
Table 'Pallas II' 9-max Seat #5 is the button
Seat 1: deadkiller1 (€206.31 in chips) 
Seat 2: matiko09 (€100 in chips) 
Seat 3: Vikulja1993 (€131.25 in chips) 
Seat 4: torkkdnm (€150.63 in chips) 
Seat 5: cobrik23 (€40 in chips) 
Seat 6: janarr5 (€100 in chips) 
Seat 7: rate8 (€100 in chips) 
Seat 8: Kihog (€167.30 in chips) 
Seat 9: stijner1986 (€190.51 in chips) 
janarr5: posts small blind €0.50
rate8: posts big blind €1
*** HOLE CARDS ***
Dealt to matiko09 [9d Ah]
Kihog: folds 
stijner1986: calls €1
deadkiller1: folds 
matiko09: folds 
Vikulja1993: folds 
torkkdnm: raises €4 to €5
cobrik23: calls €5
janarr5: folds 
rate8: folds 
stijner1986: calls €4
*** FLOP *** [6h 8d 2d]
stijner1986: checks 
torkkdnm: bets €12
cobrik23: folds 
stijner1986: folds 
Uncalled bet (€12) returned to torkkdnm
torkkdnm collected €15.68 from pot
*** SUMMARY ***
Total pot €16.50 | Rake €0.82 
Board [6h 8d 2d]
Seat 1: deadkiller1 folded before Flop (didn't bet)
Seat 2: matiko09 folded before Flop (didn't bet)
Seat 3: Vikulja1993 folded before Flop (didn't bet)
Seat 4: torkkdnm collected (€15.68)
Seat 5: cobrik23 (button) folded on the Flop
Seat 6: janarr5 (small blind) folded before Flop
Seat 7: rate8 (big blind) folded before Flop
Seat 8: Kihog folded before Flop (didn't bet)
Seat 9: stijner1986 folded on the Flop





PokerStars Hand #153504634568:  Hold'em No Limit ($0.50/$1.00 USD) - 2016/05/18 21:16:50 CET [2016/05/18 15:16:50 ET]
Table 'Lorcia II' 9-max Seat #6 is the button
Seat 2: lydia12345 ($135.75 in chips) 
Seat 3: matiko09 ($101.75 in chips) 
Seat 4: vanilica ($100 in chips) 
Seat 5: nuuaber ($175.45 in chips) 
Seat 6: gkm0nk3y ($101 in chips) 
Seat 7: rate8 ($108.90 in chips) 
rate8: posts small blind $0.50
Skum1986: is sitting out 
HomerrrJay: is sitting out 
lydia12345: posts big blind $1
*** HOLE CARDS ***
Dealt to matiko09 [8s Qc]
matiko09: folds 
vanilica: folds 
nuuaber: raises $2 to $3
gkm0nk3y: folds 
rate8: folds 
lydia12345: folds 
Uncalled bet ($2) returned to nuuaber
nuuaber collected $2.50 from pot
nuuaber: doesn't show hand 
*** SUMMARY ***
Total pot $2.50 | Rake $0 
Seat 2: lydia12345 (big blind) folded before Flop
Seat 3: matiko09 folded before Flop (didn't bet)
Seat 4: vanilica folded before Flop (didn't bet)
Seat 5: nuuaber collected ($2.50)
Seat 6: gkm0nk3y (button) folded before Flop (didn't bet)
Seat 7: rate8 (small blind) folded before Flop





PokerStars Hand #153504636082:  Hold'em No Limit ($0.50/$1.00 USD) - 2016/05/18 21:16:52 CET [2016/05/18 15:16:52 ET]
Table 'Samitchell II' 9-max Seat #5 is the button
Seat 1: riggedsh** ($112.50 in chips) 
Seat 2: IRAVABAN ($42.50 in chips) 
Seat 3: vanilica ($177.82 in chips) 
Seat 4: Zeeshka ($100 in chips) 
Seat 5: nuuaber ($50.16 in chips) 
Seat 6: Strikerman25 ($52 in chips) 
Seat 7: matiko09 ($104.50 in chips) 
Seat 8: rate8 ($123.02 in chips) 
Strikerman25: posts small blind $0.50
matiko09: posts big blind $1
janarr5: sits out 
*** HOLE CARDS ***
Dealt to matiko09 [Kc Qc]
rate8: folds 
riggedsh**: folds 
IRAVABAN: folds 
vanilica: folds 
Zeeshka: raises $2 to $3
nuuaber: folds 
Strikerman25: folds 
matiko09: raises $7 to $10
Zeeshka: folds 
Uncalled bet ($7) returned to matiko09
matiko09 collected $6.50 from pot
matiko09: doesn't show hand 
*** SUMMARY ***
Total pot $6.50 | Rake $0 
Seat 1: riggedsh** folded before Flop (didn't bet)
Seat 2: IRAVABAN folded before Flop (didn't bet)
Seat 3: vanilica folded before Flop (didn't bet)
Seat 4: Zeeshka folded before Flop
Seat 5: nuuaber (button) folded before Flop (didn't bet)
Seat 6: Strikerman25 (small blind) folded before Flop
Seat 7: matiko09 (big blind) collected ($6.50)
Seat 8: rate8 folded before Flop (didn't bet)





PokerStars Hand #153504641250:  Hold'em No Limit ($0.50/$1.00 USD) - 2016/05/18 21:16:58 CET [2016/05/18 15:16:58 ET]
Table 'Tatjana III' 9-max Seat #8 is the button
Seat 1: cobrik23 ($159.94 in chips) 
Seat 3: matiko09 ($181.79 in chips) 
Seat 4: lydia12345 ($121.48 in chips) 
Seat 5: deadkiller1 ($102.82 in chips) 
Seat 6: Kihog ($153.39 in chips) 
Seat 7: rene1984tsv ($110.04 in chips) 
Seat 8: JACQUILF ($103.10 in chips) 
Seat 9: Moszes360 ($100 in chips) 
Moszes360: posts small blind $0.50
cobrik23: posts big blind $1
vanilica: sits out 
*** HOLE CARDS ***
Dealt to matiko09 [Jd 4c]
matiko09: folds 
lydia12345: folds 
deadkiller1: folds 
Kihog: raises $1.50 to $2.50
rene1984tsv: calls $2.50
JACQUILF: raises $10 to $12.50
Moszes360: folds 
cobrik23: folds 
Kihog: calls $10
rene1984tsv: folds 
*** FLOP *** [2c 5h 8h]
Kihog: checks 
JACQUILF: bets $12.50
Kihog: folds 
Uncalled bet ($12.50) returned to JACQUILF
JACQUILF collected $27.55 from pot
JACQUILF: doesn't show hand 
*** SUMMARY ***
Total pot $29 | Rake $1.45 
Board [2c 5h 8h]
Seat 1: cobrik23 (big blind) folded before Flop
Seat 3: matiko09 folded before Flop (didn't bet)
Seat 4: lydia12345 folded before Flop (didn't bet)
Seat 5: deadkiller1 folded before Flop (didn't bet)
Seat 6: Kihog folded on the Flop
Seat 7: rene1984tsv folded before Flop
Seat 8: JACQUILF (button) collected ($27.55)
Seat 9: Moszes360 (small blind) folded before Flop





PokerStars Hand #153504651133:  Hold'em No Limit ($0.50/$1.00 USD) - 2016/05/18 21:17:09 CET [2016/05/18 15:17:09 ET]
Table 'Martir' 9-max Seat #5 is the button
Seat 1: Vivaoo ($110.55 in chips) 
Seat 2: TimStone ($103.82 in chips) 
Seat 3: deadkiller1 ($101 in chips) 
Seat 4: cobrik23 ($91.93 in chips) 
Seat 5: stimp0r ($91.83 in chips) 
Seat 6: blufthenuts ($183.07 in chips) 
Seat 7: janarr5 ($100 in chips) 
Seat 8: matiko09 ($100 in chips) 
blufthenuts: posts small blind $0.50
janarr5: posts big blind $1
*** HOLE CARDS ***
Dealt to matiko09 [8s 4h]
matiko09: folds 
Vivaoo: raises $1.25 to $2.25
TimStone: folds 
deadkiller1: folds 
cobrik23: folds 
stimp0r: folds 
blufthenuts: folds 
janarr5: folds 
Uncalled bet ($1.25) returned to Vivaoo
Vivaoo collected $2.50 from pot
Vivaoo: doesn't show hand 
*** SUMMARY ***
Total pot $2.50 | Rake $0 
Seat 1: Vivaoo collected ($2.50)
Seat 2: TimStone folded before Flop (didn't bet)
Seat 3: deadkiller1 folded before Flop (didn't bet)
Seat 4: cobrik23 folded before Flop (didn't bet)
Seat 5: stimp0r (button) folded before Flop (didn't bet)
Seat 6: blufthenuts (small blind) folded before Flop
Seat 7: janarr5 (big blind) folded before Flop
Seat 8: matiko09 folded before Flop (didn't bet)





PokerStars Hand #153504661831:  Hold'em No Limit ($0.50/$1.00 USD) - 2016/05/18 21:17:20 CET [2016/05/18 15:17:20 ET]
Table 'Brendelia II' 9-max Seat #5 is the button
Seat 1: vanilica ($103.20 in chips) 
Seat 2: LebzLouda ($43.50 in chips) 
Seat 3: Zeeshka ($100 in chips) 
Seat 4: person74 ($120.27 in chips) 
Seat 5: Vulturinus ($79.77 in chips) 
Seat 6: TimStone ($100 in chips) 
Seat 7: matiko09 ($100 in chips) 
Seat 8: solbi86 ($102.05 in chips) 
Seat 9: Kihog ($111.88 in chips) 
TimStone: posts small blind $0.50
matiko09: posts big blind $1
*** HOLE CARDS ***
Dealt to matiko09 [9h 5c]
solbi86: folds 
Kihog: raises $1.50 to $2.50
vanilica: folds 
LebzLouda: folds 
Zeeshka: folds 
person74: folds 
Vulturinus: folds 
TimStone: folds 
matiko09: folds 
Uncalled bet ($1.50) returned to Kihog
Kihog collected $2.50 from pot
Kihog: doesn't show hand 
*** SUMMARY ***
Total pot $2.50 | Rake $0 
Seat 1: vanilica folded before Flop (didn't bet)
Seat 2: LebzLouda folded before Flop (didn't bet)
Seat 3: Zeeshka folded before Flop (didn't bet)
Seat 4: person74 folded before Flop (didn't bet)
Seat 5: Vulturinus (button) folded before Flop (didn't bet)
Seat 6: TimStone (small blind) folded before Flop
Seat 7: matiko09 (big blind) folded before Flop
Seat 8: solbi86 folded before Flop (didn't bet)
Seat 9: Kihog collected ($2.50)





PokerStars Hand #153504669899:  Hold'em No Limit ($0.50/$1.00 USD) - 2016/05/18 21:17:29 CET [2016/05/18 15:17:29 ET]
Table 'Lorcia II' 9-max Seat #7 is the button
Seat 2: lydia12345 ($134.75 in chips) 
Seat 3: matiko09 ($101.75 in chips) 
Seat 4: vanilica ($100 in chips) 
Seat 5: nuuaber ($176.95 in chips) 
Seat 6: gkm0nk3y ($101 in chips) 
Seat 7: rate8 ($108.40 in chips) 
Skum1986 will be allowed to play after the button
porgol will be allowed to play after the button
HomerrrJay will be allowed to play after the button
lydia12345: posts small blind $0.50
matiko09: posts big blind $1
*** HOLE CARDS ***
Dealt to matiko09 [Ts 3h]
vanilica: folds 
nuuaber: calls $1
gkm0nk3y: raises $3 to $4
rate8: folds 
lydia12345: folds 
matiko09: folds 
nuuaber: folds 
Uncalled bet ($3) returned to gkm0nk3y
gkm0nk3y collected $3.50 from pot
*** SUMMARY ***
Total pot $3.50 | Rake $0 
Seat 2: lydia12345 (small blind) folded before Flop
Seat 3: matiko09 (big blind) folded before Flop
Seat 4: vanilica folded before Flop (didn't bet)
Seat 5: nuuaber folded before Flop
Seat 6: gkm0nk3y collected ($3.50)
Seat 7: rate8 (button) folded before Flop (didn't bet)





PokerStars Hand #153504684642:  Hold'em No Limit ($0.50/$1.00 USD) - 2016/05/18 21:17:45 CET [2016/05/18 15:17:45 ET]
Table 'Martir' 9-max Seat #6 is the button
Seat 1: Vivaoo ($112.05 in chips) 
Seat 2: TimStone ($103.82 in chips) 
Seat 3: deadkiller1 ($101 in chips) 
Seat 4: cobrik23 ($91.93 in chips) 
Seat 5: stimp0r ($91.83 in chips) 
Seat 6: blufthenuts ($182.57 in chips) 
Seat 7: janarr5 ($100 in chips) 
Seat 8: matiko09 ($100 in chips) 
janarr5: posts small blind $0.50
matiko09: posts big blind $1
*** HOLE CARDS ***
Dealt to matiko09 [Ac Qd]
Vivaoo: folds 
TimStone: folds 
deadkiller1: raises $2 to $3
cobrik23: raises $6 to $9
stimp0r: folds 
torkkdnm leaves the table
blufthenuts: folds 
janarr5: folds 
matiko09: folds 
deadkiller1: calls $6
*** FLOP *** [7c 2s Jh]
deadkiller1: checks 
cobrik23: bets $9.26
deadkiller1: calls $9.26
*** TURN *** [7c 2s Jh] [Jc]
deadkiller1: checks 
stimp0r leaves the table
cobrik23: checks 
*** RIVER *** [7c 2s Jh Jc] [Jd]
deadkiller1: checks 
cobrik23: checks 
*** SHOW DOWN ***
deadkiller1: shows [As Ah] (a full house, Jacks full of Aces)
cobrik23: mucks hand 
deadkiller1 collected $36.12 from pot
*** SUMMARY ***
Total pot $38.02 | Rake $1.90 
Board [7c 2s Jh Jc Jd]
Seat 1: Vivaoo folded before Flop (didn't bet)
Seat 2: TimStone folded before Flop (didn't bet)
Seat 3: deadkiller1 showed [As Ah] and won ($36.12) with a full house, Jacks full of Aces
Seat 4: cobrik23 mucked [Ad 6d]
Seat 5: stimp0r folded before Flop (didn't bet)
Seat 6: blufthenuts (button) folded before Flop (didn't bet)
Seat 7: janarr5 (small blind) folded before Flop
Seat 8: matiko09 (big blind) folded before Flop





PokerStars Hand #153504693874:  Hold'em No Limit ($0.50/$1.00 USD) - 2016/05/18 21:17:56 CET [2016/05/18 15:17:56 ET]
Table 'Samitchell II' 9-max Seat #6 is the button
Seat 1: riggedsh** ($112.50 in chips) 
Seat 2: IRAVABAN ($42.50 in chips) 
Seat 3: vanilica ($177.82 in chips) 
Seat 4: Zeeshka ($100 in chips) 
Seat 5: nuuaber ($50.16 in chips) 
Seat 6: Strikerman25 ($51.50 in chips) 
Seat 7: matiko09 ($108 in chips) 
Seat 8: rate8 ($123.02 in chips) 
matiko09: posts small blind $0.50
rate8: posts big blind $1
janarr5: sits out 
*** HOLE CARDS ***
Dealt to matiko09 [8s 7h]
riggedsh**: folds 
IRAVABAN: folds 
vanilica: folds 
Zeeshka: folds 
nuuaber: calls $1
Strikerman25: folds 
matiko09: folds 
rate8: raises $3.50 to $4.50
nuuaber: folds 
Uncalled bet ($3.50) returned to rate8
rate8 collected $2.50 from pot
rate8: doesn't show hand 
*** SUMMARY ***
Total pot $2.50 | Rake $0 
Seat 1: riggedsh** folded before Flop (didn't bet)
Seat 2: IRAVABAN folded before Flop (didn't bet)
Seat 3: vanilica folded before Flop (didn't bet)
Seat 4: Zeeshka folded before Flop (didn't bet)
Seat 5: nuuaber folded before Flop
Seat 6: Strikerman25 (button) folded before Flop (didn't bet)
Seat 7: matiko09 (small blind) folded before Flop
Seat 8: rate8 (big blind) collected ($2.50)





PokerStars Hand #153504704064:  Hold'em No Limit ($0.50/$1.00 USD) - 2016/05/18 21:18:07 CET [2016/05/18 15:18:07 ET]
Table 'Brendelia II' 9-max Seat #6 is the button
Seat 1: vanilica ($103.20 in chips) 
Seat 2: LebzLouda ($43.50 in chips) 
Seat 3: Zeeshka ($100 in chips) 
Seat 4: person74 ($120.27 in chips) 
Seat 5: Vulturinus ($79.77 in chips) 
Seat 6: TimStone ($100 in chips) 
Seat 7: matiko09 ($100 in chips) 
Seat 8: solbi86 ($102.05 in chips) 
Seat 9: Kihog ($113.38 in chips) 
matiko09: posts small blind $0.50
solbi86: posts big blind $1
*** HOLE CARDS ***
Dealt to matiko09 [Th 2s]
Kihog: folds 
vanilica: folds 
LebzLouda: calls $1
Zeeshka: folds 
person74: folds 
Vulturinus: folds 
TimStone: folds 
matiko09: folds 
solbi86: checks 
*** FLOP *** [9c 8d Td]
solbi86: checks 
LebzLouda: checks 
*** TURN *** [9c 8d Td] [6c]
solbi86: checks 
LebzLouda: checks 
*** RIVER *** [9c 8d Td 6c] [6d]
solbi86: checks 
LebzLouda: checks 
*** SHOW DOWN ***
solbi86: shows [Kh 3c] (a pair of Sixes)
LebzLouda: shows [2c 2h] (two pair, Sixes and Deuces)
LebzLouda collected $2.38 from pot
*** SUMMARY ***
Total pot $2.50 | Rake $0.12 
Board [9c 8d Td 6c 6d]
Seat 1: vanilica folded before Flop (didn't bet)
Seat 2: LebzLouda showed [2c 2h] and won ($2.38) with two pair, Sixes and Deuces
Seat 3: Zeeshka folded before Flop (didn't bet)
Seat 4: person74 folded before Flop (didn't bet)
Seat 5: Vulturinus folded before Flop (didn't bet)
Seat 6: TimStone (button) folded before Flop (didn't bet)
Seat 7: matiko09 (small blind) folded before Flop
Seat 8: solbi86 (big blind) showed [Kh 3c] and lost with a pair of Sixes
Seat 9: Kihog folded before Flop (didn't bet)





PokerStars Hand #153504708560:  Hold'em No Limit ($0.50/$1.00 USD) - 2016/05/18 21:18:12 CET [2016/05/18 15:18:12 ET]
Table 'Lorcia II' 9-max Seat #2 is the button
Seat 2: lydia12345 ($134.25 in chips) 
Seat 3: matiko09 ($100.75 in chips) 
Seat 4: vanilica ($100 in chips) 
Seat 5: nuuaber ($175.95 in chips) 
Seat 6: gkm0nk3y ($103.50 in chips) 
Seat 7: rate8 ($108.40 in chips) 
Seat 9: porgol ($253.75 in chips) 
matiko09: posts small blind $0.50
vanilica: posts big blind $1
Skum1986: sits out 
porgol: posts small & big blinds $1.50
HomerrrJay: sits out 
*** HOLE CARDS ***
Dealt to matiko09 [Js 9c]
nuuaber: calls $1
gkm0nk3y: folds 
rate8: folds 
porgol: checks 
lydia12345: calls $1
matiko09: calls $0.50
vanilica: raises $5.50 to $6.50
nuuaber: calls $5.50
porgol: folds 
lydia12345: folds 
matiko09: folds 
*** FLOP *** [Qh Jc Jh]
vanilica: checks 
nuuaber: checks 
*** TURN *** [Qh Jc Jh] [6d]
vanilica: checks 
nuuaber: checks 
*** RIVER *** [Qh Jc Jh 6d] [Qs]
vanilica: bets $11.60
nuuaber: folds 
Uncalled bet ($11.60) returned to vanilica
vanilica collected $15.68 from pot
vanilica: doesn't show hand 
*** SUMMARY ***
Total pot $16.50 | Rake $0.82 
Board [Qh Jc Jh 6d Qs]
Seat 2: lydia12345 (button) folded before Flop
Seat 3: matiko09 (small blind) folded before Flop
Seat 4: vanilica (big blind) collected ($15.68)
Seat 5: nuuaber folded on the River
Seat 6: gkm0nk3y folded before Flop (didn't bet)
Seat 7: rate8 folded before Flop (didn't bet)
Seat 9: porgol folded before Flop





PokerStars Hand #153504716305:  Hold'em No Limit ($0.50/$1.00 USD) - 2016/05/18 21:18:20 CET [2016/05/18 15:18:20 ET]
Table 'Tatjana III' 9-max Seat #9 is the button
Seat 1: cobrik23 ($158.94 in chips) 
Seat 2: vanilica ($100 in chips) 
Seat 3: matiko09 ($181.79 in chips) 
Seat 4: lydia12345 ($121.48 in chips) 
Seat 5: deadkiller1 ($102.82 in chips) 
Seat 6: Kihog ($140.89 in chips) 
Seat 7: rene1984tsv ($107.54 in chips) 
Seat 8: JACQUILF ($118.15 in chips) 
Seat 9: Moszes360 ($100 in chips) 
cobrik23: posts small blind $0.50
vanilica: posts big blind $1
*** HOLE CARDS ***
Dealt to matiko09 [4d 5c]
matiko09: folds 
lydia12345: folds 
deadkiller1: folds 
Kihog: folds 
rene1984tsv: raises $1 to $2
JACQUILF: folds 
Moszes360: folds 
cobrik23: raises $5 to $7
vanilica: calls $6
rene1984tsv: calls $5
*** FLOP *** [3s Ad 3d]
cobrik23: checks 
vanilica: bets $11.97
rene1984tsv: calls $11.97
cobrik23: folds 
*** TURN *** [3s Ad 3d] [2s]
vanilica: checks 
rene1984tsv: checks 
*** RIVER *** [3s Ad 3d 2s] [2h]
vanilica: checks 
rene1984tsv: checks 
*** SHOW DOWN ***
vanilica: shows [Kc Qc] (two pair, Threes and Deuces)
rene1984tsv: shows [Ac Th] (two pair, Aces and Threes)
rene1984tsv collected $42.69 from pot
*** SUMMARY ***
Total pot $44.94 | Rake $2.25 
Board [3s Ad 3d 2s 2h]
Seat 1: cobrik23 (small blind) folded on the Flop
Seat 2: vanilica (big blind) showed [Kc Qc] and lost with two pair, Threes and Deuces
Seat 3: matiko09 folded before Flop (didn't bet)
Seat 4: lydia12345 folded before Flop (didn't bet)
Seat 5: deadkiller1 folded before Flop (didn't bet)
Seat 6: Kihog folded before Flop (didn't bet)
Seat 7: rene1984tsv showed [Ac Th] and won ($42.69) with two pair, Aces and Threes
Seat 8: JACQUILF folded before Flop (didn't bet)
Seat 9: Moszes360 (button) folded before Flop (didn't bet)





PokerStars Hand #153504725117:  Hold'em No Limit ($0.50/$1.00 USD) - 2016/05/18 21:18:30 CET [2016/05/18 15:18:30 ET]
Table 'Samitchell II' 9-max Seat #7 is the button
Seat 1: riggedsh** ($112.50 in chips) 
Seat 2: IRAVABAN ($42.50 in chips) 
Seat 3: vanilica ($177.82 in chips) 
Seat 4: Zeeshka ($100 in chips) 
Seat 5: nuuaber ($49.16 in chips) 
Seat 6: Strikerman25 ($51.50 in chips) 
Seat 7: matiko09 ($107.50 in chips) 
Seat 8: rate8 ($124.52 in chips) 
Seat 9: janarr5 ($100 in chips) 
rate8: posts small blind $0.50
janarr5: posts big blind $1
*** HOLE CARDS ***
Dealt to matiko09 [8d Kc]
riggedsh**: folds 
IRAVABAN: raises $2 to $3
vanilica: folds 
Zeeshka: folds 
nuuaber: folds 
Strikerman25: folds 
matiko09: folds 
rate8: folds 
janarr5: folds 
Uncalled bet ($2) returned to IRAVABAN
IRAVABAN collected $2.50 from pot
IRAVABAN: doesn't show hand 
*** SUMMARY ***
Total pot $2.50 | Rake $0 
Seat 1: riggedsh** folded before Flop (didn't bet)
Seat 2: IRAVABAN collected ($2.50)
Seat 3: vanilica folded before Flop (didn't bet)
Seat 4: Zeeshka folded before Flop (didn't bet)
Seat 5: nuuaber folded before Flop (didn't bet)
Seat 6: Strikerman25 folded before Flop (didn't bet)
Seat 7: matiko09 (button) folded before Flop (didn't bet)
Seat 8: rate8 (small blind) folded before Flop
Seat 9: janarr5 (big blind) folded before Flop





PokerStars Hand #153504745399:  Hold'em No Limit ($0.50/$1.00 USD) - 2016/05/18 21:18:53 CET [2016/05/18 15:18:53 ET]
Table 'Brendelia II' 9-max Seat #7 is the button
Seat 1: vanilica ($103.20 in chips) 
Seat 2: LebzLouda ($44.88 in chips) 
Seat 3: Zeeshka ($100 in chips) 
Seat 4: person74 ($120.27 in chips) 
Seat 5: Vulturinus ($79.77 in chips) 
Seat 6: TimStone ($100 in chips) 
Seat 7: matiko09 ($100 in chips) 
Seat 8: solbi86 ($101.05 in chips) 
Seat 9: Kihog ($113.38 in chips) 
solbi86: posts small blind $0.50
Kihog: posts big blind $1
*** HOLE CARDS ***
Dealt to matiko09 [Qd 4c]
vanilica: folds 
LebzLouda: raises $2 to $3
Zeeshka: folds 
person74: calls $3
Vulturinus: folds 
TimStone: calls $3
matiko09: folds 
solbi86: folds 
Kihog: raises $12 to $15
LebzLouda: folds 
person74: folds 
TimStone: folds 
Uncalled bet ($12) returned to Kihog
Kihog collected $12.50 from pot
Kihog: doesn't show hand 
*** SUMMARY ***
Total pot $12.50 | Rake $0 
Seat 1: vanilica folded before Flop (didn't bet)
Seat 2: LebzLouda folded before Flop
Seat 3: Zeeshka folded before Flop (didn't bet)
Seat 4: person74 folded before Flop
Seat 5: Vulturinus folded before Flop (didn't bet)
Seat 6: TimStone folded before Flop
Seat 7: matiko09 (button) folded before Flop (didn't bet)
Seat 8: solbi86 (small blind) folded before Flop
Seat 9: Kihog (big blind) collected ($12.50)





PokerStars Hand #153504748492:  Hold'em No Limit ($0.50/$1.00 USD) - 2016/05/18 21:18:56 CET [2016/05/18 15:18:56 ET]
Table 'Samitchell II' 9-max Seat #8 is the button
Seat 1: riggedsh** ($112.50 in chips) 
Seat 2: IRAVABAN ($44 in chips) 
Seat 3: vanilica ($177.82 in chips) 
Seat 4: Zeeshka ($100 in chips) 
Seat 5: nuuaber ($49.16 in chips) 
Seat 6: Strikerman25 ($51.50 in chips) 
Seat 7: matiko09 ($107.50 in chips) 
Seat 8: rate8 ($124.02 in chips) 
Seat 9: janarr5 ($100 in chips) 
janarr5: posts small blind $0.50
riggedsh**: posts big blind $1
*** HOLE CARDS ***
Dealt to matiko09 [5d 4d]
IRAVABAN: folds 
IRAVABAN leaves the table
vanilica: folds 
Zeeshka: folds 
nuuaber: folds 
Strikerman25: folds 
matiko09: raises $2 to $3
rate8: folds 
janarr5: folds 
riggedsh**: calls $2
*** FLOP *** [Qd 9c Qh]
riggedsh**: checks 
matiko09: checks 
*** TURN *** [Qd 9c Qh] [Ah]
riggedsh**: checks 
matiko09: checks 
*** RIVER *** [Qd 9c Qh Ah] [9h]
riggedsh**: checks 
matiko09: checks 
*** SHOW DOWN ***
riggedsh**: shows [Tc Qs] (a full house, Queens full of Nines)
matiko09: mucks hand 
riggedsh** collected $6.18 from pot
*** SUMMARY ***
Total pot $6.50 | Rake $0.32 
Board [Qd 9c Qh Ah 9h]
Seat 1: riggedsh** (big blind) showed [Tc Qs] and won ($6.18) with a full house, Queens full of Nines
Seat 2: IRAVABAN folded before Flop (didn't bet)
Seat 3: vanilica folded before Flop (didn't bet)
Seat 4: Zeeshka folded before Flop (didn't bet)
Seat 5: nuuaber folded before Flop (didn't bet)
Seat 6: Strikerman25 folded before Flop (didn't bet)
Seat 7: matiko09 mucked [5d 4d]
Seat 8: rate8 (button) folded before Flop (didn't bet)
Seat 9: janarr5 (small blind) folded before Flop





PokerStars Hand #153504752665:  Hold'em No Limit ($0.50/$1.00 USD) - 2016/05/18 21:19:01 CET [2016/05/18 15:19:01 ET]
Table 'Abetti II' 9-max Seat #1 is the button
Seat 1: matiko09 ($100 in chips) 
Seat 2: Vikulja1993 ($113.67 in chips) 
Seat 4: ipashutapkom ($40 in chips) 
Seat 5: blufthenuts ($139.75 in chips) 
Seat 6: Kihog ($100 in chips) 
Seat 7: rate8 ($105.78 in chips) 
Seat 8: roadster683 ($189.07 in chips) 
Seat 9: lydia12345 ($288.63 in chips) 
Vikulja1993: posts small blind $0.50
ipashutapkom: posts big blind $1
*** HOLE CARDS ***
Dealt to matiko09 [Qs Td]
blufthenuts: folds 
Kihog: folds 
rate8: folds 
roadster683: folds 
lydia12345: folds 
matiko09: raises $1.27 to $2.27
Vikulja1993: raises $5.73 to $8
ipashutapkom: folds 
matiko09: folds 
Uncalled bet ($5.73) returned to Vikulja1993
Vikulja1993 collected $5.54 from pot
Vikulja1993: doesn't show hand 
*** SUMMARY ***
Total pot $5.54 | Rake $0 
Seat 1: matiko09 (button) folded before Flop
Seat 2: Vikulja1993 (small blind) collected ($5.54)
Seat 4: ipashutapkom (big blind) folded before Flop
Seat 5: blufthenuts folded before Flop (didn't bet)
Seat 6: Kihog folded before Flop (didn't bet)
Seat 7: rate8 folded before Flop (didn't bet)
Seat 8: roadster683 folded before Flop (didn't bet)
Seat 9: lydia12345 folded before Flop (didn't bet)





PokerStars Hand #153504754594:  Hold'em No Limit (€0.50/€1.00 EUR) - 2016/05/18 21:19:03 CET [2016/05/18 15:19:03 ET]
Table 'Pallas II' 9-max Seat #6 is the button
Seat 1: deadkiller1 (€206.31 in chips) 
Seat 2: matiko09 (€100 in chips) 
Seat 3: Vikulja1993 (€131.25 in chips) 
Seat 4: torkkdnm (€161.31 in chips) 
Seat 5: cobrik23 (€35 in chips) 
Seat 6: janarr5 (€100 in chips) 
Seat 7: rate8 (€100 in chips) 
Seat 8: Kihog (€167.30 in chips) 
Seat 9: stijner1986 (€185.51 in chips) 
rate8: posts small blind €0.50
Kihog: posts big blind €1
*** HOLE CARDS ***
Dealt to matiko09 [4s Js]
stijner1986: calls €1
deadkiller1: folds 
matiko09: folds 
Vikulja1993: folds 
torkkdnm: folds 
cobrik23: folds 
janarr5: folds 
rate8: folds 
Kihog: raises €3 to €4
stijner1986: calls €3
*** FLOP *** [4d 2c 9d]
Kihog: checks 
stijner1986: checks 
*** TURN *** [4d 2c 9d] [Tc]
Kihog: checks 
stijner1986: bets €3
Kihog: folds 
Uncalled bet (€3) returned to stijner1986
stijner1986 collected €8.08 from pot
stijner1986: doesn't show hand 
*** SUMMARY ***
Total pot €8.50 | Rake €0.42 
Board [4d 2c 9d Tc]
Seat 1: deadkiller1 folded before Flop (didn't bet)
Seat 2: matiko09 folded before Flop (didn't bet)
Seat 3: Vikulja1993 folded before Flop (didn't bet)
Seat 4: torkkdnm folded before Flop (didn't bet)
Seat 5: cobrik23 folded before Flop (didn't bet)
Seat 6: janarr5 (button) folded before Flop (didn't bet)
Seat 7: rate8 (small blind) folded before Flop
Seat 8: Kihog (big blind) folded on the Turn
Seat 9: stijner1986 collected (€8.08)





PokerStars Hand #153504791295:  Hold'em No Limit ($0.50/$1.00 USD) - 2016/05/18 21:19:43 CET [2016/05/18 15:19:43 ET]
Table 'Tatjana III' 9-max Seat #1 is the button
Seat 1: cobrik23 ($151.94 in chips) 
Seat 2: vanilica ($100 in chips) 
Seat 3: matiko09 ($181.79 in chips) 
Seat 4: lydia12345 ($121.48 in chips) 
Seat 5: deadkiller1 ($102.82 in chips) 
Seat 6: Kihog ($140.89 in chips) 
Seat 7: rene1984tsv ($131.26 in chips) 
Seat 8: JACQUILF ($118.15 in chips) 
Seat 9: Moszes360 ($100 in chips) 
vanilica: posts small blind $0.50
matiko09: posts big blind $1
*** HOLE CARDS ***
Dealt to matiko09 [9c 7c]
lydia12345: folds 
deadkiller1: folds 
Kihog: raises $1.50 to $2.50
rene1984tsv: calls $2.50
JACQUILF: folds 
Moszes360: calls $2.50
cobrik23: folds 
vanilica: folds 
matiko09: calls $1.50
*** FLOP *** [6h 7s 8c]
matiko09: checks 
Kihog: checks 
rene1984tsv: bets $4.99
Moszes360: calls $4.99
matiko09: calls $4.99
Kihog: folds 
*** TURN *** [6h 7s 8c] [5d]
matiko09: checks 
rene1984tsv: checks 
Moszes360: checks 
*** RIVER *** [6h 7s 8c 5d] [9d]
matiko09: checks 
rene1984tsv: bets $6
Moszes360: raises $86.51 to $92.51 and is all-in
matiko09: folds 
rene1984tsv: folds 
Uncalled bet ($86.51) returned to Moszes360
Moszes360 collected $35.60 from pot
Moszes360: doesn't show hand 
*** SUMMARY ***
Total pot $37.47 | Rake $1.87 
Board [6h 7s 8c 5d 9d]
Seat 1: cobrik23 (button) folded before Flop (didn't bet)
Seat 2: vanilica (small blind) folded before Flop
Seat 3: matiko09 (big blind) folded on the River
Seat 4: lydia12345 folded before Flop (didn't bet)
Seat 5: deadkiller1 folded before Flop (didn't bet)
Seat 6: Kihog folded on the Flop
Seat 7: rene1984tsv folded on the River
Seat 8: JACQUILF folded before Flop (didn't bet)
Seat 9: Moszes360 collected ($35.60)





PokerStars Hand #153504796067:  Hold'em No Limit ($0.50/$1.00 USD) - 2016/05/18 21:19:49 CET [2016/05/18 15:19:49 ET]
Table 'Martir' 9-max Seat #7 is the button
Seat 1: Vivaoo ($112.05 in chips) 
Seat 2: TimStone ($103.82 in chips) 
Seat 3: deadkiller1 ($118.86 in chips) 
Seat 4: cobrik23 ($73.67 in chips) 
Seat 6: blufthenuts ($182.57 in chips) 
Seat 7: janarr5 ($100 in chips) 
Seat 8: matiko09 ($100 in chips) 
matiko09: posts small blind $0.50
Vivaoo: posts big blind $1
*** HOLE CARDS ***
Dealt to matiko09 [Kd Th]
Mashulia7777 joins the table at seat #9 
TimStone: folds 
deadkiller1: folds 
cobrik23: folds 
blufthenuts: raises $2 to $3
fack_vi joins the table at seat #5 
janarr5: folds 
matiko09: folds 
Vivaoo: folds 
Uncalled bet ($2) returned to blufthenuts
blufthenuts collected $2.50 from pot
blufthenuts: doesn't show hand 
*** SUMMARY ***
Total pot $2.50 | Rake $0 
Seat 1: Vivaoo (big blind) folded before Flop
Seat 2: TimStone folded before Flop (didn't bet)
Seat 3: deadkiller1 folded before Flop (didn't bet)
Seat 4: cobrik23 folded before Flop (didn't bet)
Seat 6: blufthenuts collected ($2.50)
Seat 7: janarr5 (button) folded before Flop (didn't bet)
Seat 8: matiko09 (small blind) folded before Flop





PokerStars Hand #153504799529:  Hold'em No Limit ($0.50/$1.00 USD) - 2016/05/18 21:19:53 CET [2016/05/18 15:19:53 ET]
Table 'Abetti II' 9-max Seat #2 is the button
Seat 1: matiko09 ($100 in chips) 
Seat 2: Vikulja1993 ($116.94 in chips) 
Seat 4: ipashutapkom ($40 in chips) 
Seat 5: blufthenuts ($139.75 in chips) 
Seat 6: Kihog ($100 in chips) 
Seat 7: rate8 ($105.78 in chips) 
Seat 8: roadster683 ($189.07 in chips) 
Seat 9: lydia12345 ($288.63 in chips) 
ipashutapkom: posts small blind $0.50
blufthenuts: posts big blind $1
*** HOLE CARDS ***
Dealt to matiko09 [Kd 5d]
Kihog: folds 
rate8: folds 
roadster683: folds 
lydia12345: folds 
matiko09: folds 
Vikulja1993: folds 
ipashutapkom: raises $1.73 to $2.73
blufthenuts: calls $1.73
*** FLOP *** [As 5h Js]
ipashutapkom: bets $3.48
blufthenuts: calls $3.48
*** TURN *** [As 5h Js] [Jc]
ipashutapkom: checks 
blufthenuts: checks 
*** RIVER *** [As 5h Js Jc] [7s]
ipashutapkom: checks 
blufthenuts: bets $5.90
ipashutapkom: folds 
Uncalled bet ($5.90) returned to blufthenuts
blufthenuts collected $11.80 from pot
blufthenuts: doesn't show hand 
*** SUMMARY ***
Total pot $12.42 | Rake $0.62 
Board [As 5h Js Jc 7s]
Seat 1: matiko09 folded before Flop (didn't bet)
Seat 2: Vikulja1993 (button) folded before Flop (didn't bet)
Seat 4: ipashutapkom (small blind) folded on the River
Seat 5: blufthenuts (big blind) collected ($11.80)
Seat 6: Kihog folded before Flop (didn't bet)
Seat 7: rate8 folded before Flop (didn't bet)
Seat 8: roadster683 folded before Flop (didn't bet)
Seat 9: lydia12345 folded before Flop (didn't bet)





PokerStars Hand #153504801705:  Hold'em No Limit ($0.50/$1.00 USD) - 2016/05/18 21:19:55 CET [2016/05/18 15:19:55 ET]
Table 'Samitchell II' 9-max Seat #9 is the button
Seat 1: riggedsh** ($115.68 in chips) 
Seat 3: vanilica ($177.82 in chips) 
Seat 4: Zeeshka ($100 in chips) 
Seat 5: nuuaber ($49.16 in chips) 
Seat 6: Strikerman25 ($51.50 in chips) 
Seat 7: matiko09 ($104.50 in chips) 
Seat 8: rate8 ($124.02 in chips) 
Seat 9: janarr5 ($100 in chips) 
riggedsh**: posts small blind $0.50
vanilica: posts big blind $1
*** HOLE CARDS ***
Dealt to matiko09 [Th Jd]
Zeeshka: folds 
nuuaber: folds 
Strikerman25: raises $2 to $3
matiko09: folds 
rate8: folds 
janarr5: calls $3
riggedsh**: folds 
vanilica: folds 
*** FLOP *** [Kh Jc 6h]
Strikerman25: bets $4.50
janarr5: folds 
Uncalled bet ($4.50) returned to Strikerman25
Strikerman25 collected $7.12 from pot
Strikerman25: doesn't show hand 
*** SUMMARY ***
Total pot $7.50 | Rake $0.38 
Board [Kh Jc 6h]
Seat 1: riggedsh** (small blind) folded before Flop
Seat 3: vanilica (big blind) folded before Flop
Seat 4: Zeeshka folded before Flop (didn't bet)
Seat 5: nuuaber folded before Flop (didn't bet)
Seat 6: Strikerman25 collected ($7.12)
Seat 7: matiko09 folded before Flop (didn't bet)
Seat 8: rate8 folded before Flop (didn't bet)
Seat 9: janarr5 (button) folded on the Flop





PokerStars Hand #153504805811:  Hold'em No Limit ($0.50/$1.00 USD) - 2016/05/18 21:20:00 CET [2016/05/18 15:20:00 ET]
Table 'Lorcia II' 9-max Seat #3 is the button
Seat 1: HomerrrJay ($100 in chips) 
Seat 2: lydia12345 ($133.25 in chips) 
Seat 3: matiko09 ($100 in chips) 
Seat 4: vanilica ($109.18 in chips) 
Seat 5: nuuaber ($169.45 in chips) 
Seat 6: gkm0nk3y ($103.50 in chips) 
Seat 7: rate8 ($108.40 in chips) 
Seat 9: porgol ($252.25 in chips) 
vanilica: posts small blind $0.50
nuuaber: posts big blind $1
Skum1986: sits out 
HomerrrJay: posts small & big blinds $1.50
*** HOLE CARDS ***
Dealt to matiko09 [Ks Ad]
gkm0nk3y: folds 
rate8: folds 
porgol: calls $1
HomerrrJay: checks 
lydia12345: folds 
matiko09: raises $4 to $5
vanilica: folds 
nuuaber: folds 
porgol: folds 
HomerrrJay: folds 
Uncalled bet ($4) returned to matiko09
matiko09 collected $5 from pot
matiko09: doesn't show hand 
*** SUMMARY ***
Total pot $5 | Rake $0 
Seat 1: HomerrrJay folded before Flop
Seat 2: lydia12345 folded before Flop (didn't bet)
Seat 3: matiko09 (button) collected ($5)
Seat 4: vanilica (small blind) folded before Flop
Seat 5: nuuaber (big blind) folded before Flop
Seat 6: gkm0nk3y folded before Flop (didn't bet)
Seat 7: rate8 folded before Flop (didn't bet)
Seat 9: porgol folded before Flop





PokerStars Hand #153504819809:  Hold'em No Limit (€0.50/€1.00 EUR) - 2016/05/18 21:20:16 CET [2016/05/18 15:20:16 ET]
Table 'Pallas II' 9-max Seat #7 is the button
Seat 1: deadkiller1 (€206.31 in chips) 
Seat 2: matiko09 (€100 in chips) 
Seat 3: Vikulja1993 (€131.25 in chips) 
Seat 4: torkkdnm (€161.31 in chips) 
Seat 5: cobrik23 (€35 in chips) 
Seat 6: janarr5 (€100 in chips) 
Seat 7: rate8 (€100 in chips) 
Seat 8: Kihog (€163.30 in chips) 
Seat 9: stijner1986 (€189.59 in chips) 
Kihog: posts small blind €0.50
stijner1986: posts big blind €1
*** HOLE CARDS ***
Dealt to matiko09 [Ad 5s]
deadkiller1: folds 
matiko09: folds 
Vikulja1993: raises €2 to €3
torkkdnm: folds 
cobrik23: folds 
janarr5: folds 
rate8: folds 
Kihog: folds 
stijner1986: calls €2
*** FLOP *** [2d 2s Th]
stijner1986: checks 
Vikulja1993: bets €3.50
stijner1986: folds 
Uncalled bet (€3.50) returned to Vikulja1993
Vikulja1993 collected €6.18 from pot
Vikulja1993: doesn't show hand 
*** SUMMARY ***
Total pot €6.50 | Rake €0.32 
Board [2d 2s Th]
Seat 1: deadkiller1 folded before Flop (didn't bet)
Seat 2: matiko09 folded before Flop (didn't bet)
Seat 3: Vikulja1993 collected (€6.18)
Seat 4: torkkdnm folded before Flop (didn't bet)
Seat 5: cobrik23 folded before Flop (didn't bet)
Seat 6: janarr5 folded before Flop (didn't bet)
Seat 7: rate8 (button) folded before Flop (didn't bet)
Seat 8: Kihog (small blind) folded before Flop
Seat 9: stijner1986 (big blind) folded on the Flop





PokerStars Hand #153504826630:  Hold'em No Limit ($0.50/$1.00 USD) - 2016/05/18 21:20:24 CET [2016/05/18 15:20:24 ET]
Table 'Brendelia II' 9-max Seat #8 is the button
Seat 1: vanilica ($103.20 in chips) 
Seat 2: LebzLouda ($41.88 in chips) 
Seat 3: Zeeshka ($100 in chips) 
Seat 4: person74 ($117.27 in chips) 
Seat 5: Vulturinus ($79.77 in chips) 
Seat 6: TimStone ($100 in chips) 
Seat 7: matiko09 ($100 in chips) 
Seat 8: solbi86 ($100.55 in chips) 
Seat 9: Kihog ($122.88 in chips) 
Kihog: posts small blind $0.50
vanilica: posts big blind $1
*** HOLE CARDS ***
Dealt to matiko09 [Qd Ad]
LebzLouda: folds 
Zeeshka: folds 
person74: folds 
person74 leaves the table
Vulturinus: folds 
gkm0nk3y joins the table at seat #4 
TimStone: raises $1.62 to $2.62
matiko09: calls $2.62
solbi86: folds 
Kihog: folds 
vanilica: folds 
*** FLOP *** [3s 7d Qh]
TimStone: bets $3.72
matiko09: calls $3.72
*** TURN *** [3s 7d Qh] [9d]
TimStone: bets $9.89
matiko09: calls $9.89
*** RIVER *** [3s 7d Qh 9d] [6s]
TimStone: bets $22.44
matiko09: calls $22.44
*** SHOW DOWN ***
TimStone: shows [9h 9c] (three of a kind, Nines)
matiko09: mucks hand 
TimStone collected $76.34 from pot
*** SUMMARY ***
Total pot $78.84 | Rake $2.50 
Board [3s 7d Qh 9d 6s]
Seat 1: vanilica (big blind) folded before Flop
Seat 2: LebzLouda folded before Flop (didn't bet)
Seat 3: Zeeshka folded before Flop (didn't bet)
Seat 4: person74 folded before Flop (didn't bet)
Seat 5: Vulturinus folded before Flop (didn't bet)
Seat 6: TimStone showed [9h 9c] and won ($76.34) with three of a kind, Nines
Seat 7: matiko09 mucked [Qd Ad]
Seat 8: solbi86 (button) folded before Flop (didn't bet)
Seat 9: Kihog (small blind) folded before Flop





PokerStars Hand #153504832206:  Hold'em No Limit ($0.50/$1.00 USD) - 2016/05/18 21:20:30 CET [2016/05/18 15:20:30 ET]
Table 'Martir' 9-max Seat #8 is the button
Seat 1: Vivaoo ($111.05 in chips) 
Seat 2: TimStone ($103.82 in chips) 
Seat 3: deadkiller1 ($118.86 in chips) 
Seat 4: cobrik23 ($73.67 in chips) 
Seat 6: blufthenuts ($184.07 in chips) 
Seat 7: janarr5 ($100 in chips) 
Seat 8: matiko09 ($100 in chips) 
Mashulia7777 will be allowed to play after the button
Vivaoo: posts small blind $0.50
TimStone: posts big blind $1
fack_vi: sits out 
*** HOLE CARDS ***
Dealt to matiko09 [4s 9c]
deadkiller1: folds 
cobrik23: raises $2 to $3
blufthenuts: folds 
janarr5: folds 
matiko09: folds 
Vivaoo: calls $2.50
TimStone: folds 
*** FLOP *** [7d 7c 8c]
Vivaoo: checks 
cobrik23: checks 
*** TURN *** [7d 7c 8c] [Qd]
Vivaoo: bets $3.32
cobrik23: folds 
Uncalled bet ($3.32) returned to Vivaoo
Vivaoo collected $6.65 from pot
Vivaoo: doesn't show hand 
*** SUMMARY ***
Total pot $7 | Rake $0.35 
Board [7d 7c 8c Qd]
Seat 1: Vivaoo (small blind) collected ($6.65)
Seat 2: TimStone (big blind) folded before Flop
Seat 3: deadkiller1 folded before Flop (didn't bet)
Seat 4: cobrik23 folded on the Turn
Seat 6: blufthenuts folded before Flop (didn't bet)
Seat 7: janarr5 folded before Flop (didn't bet)
Seat 8: matiko09 (button) folded before Flop (didn't bet)





PokerStars Hand #153504833823:  Hold'em No Limit ($0.50/$1.00 USD) - 2016/05/18 21:20:32 CET [2016/05/18 15:20:32 ET]
Table 'Samitchell II' 9-max Seat #1 is the button
Seat 1: riggedsh** ($115.18 in chips) 
Seat 3: vanilica ($176.82 in chips) 
Seat 4: Zeeshka ($100 in chips) 
Seat 5: nuuaber ($49.16 in chips) 
Seat 6: Strikerman25 ($55.62 in chips) 
Seat 7: matiko09 ($104.50 in chips) 
Seat 8: rate8 ($124.02 in chips) 
Seat 9: janarr5 ($100 in chips) 
vanilica: posts small blind $0.50
Zeeshka: posts big blind $1
*** HOLE CARDS ***
Dealt to matiko09 [3c 2h]
nuuaber: calls $1
Strikerman25: folds 
matiko09: folds 
rate8: folds 
janarr5: raises $3 to $4
riggedsh**: folds 
vanilica: folds 
Zeeshka: folds 
nuuaber: folds 
Uncalled bet ($3) returned to janarr5
janarr5 collected $3.50 from pot
janarr5: doesn't show hand 
*** SUMMARY ***
Total pot $3.50 | Rake $0 
Seat 1: riggedsh** (button) folded before Flop (didn't bet)
Seat 3: vanilica (small blind) folded before Flop
Seat 4: Zeeshka (big blind) folded before Flop
Seat 5: nuuaber folded before Flop
Seat 6: Strikerman25 folded before Flop (didn't bet)
Seat 7: matiko09 folded before Flop (didn't bet)
Seat 8: rate8 folded before Flop (didn't bet)
Seat 9: janarr5 collected ($3.50)





PokerStars Hand #153504850168:  Hold'em No Limit ($0.50/$1.00 USD) - 2016/05/18 21:20:50 CET [2016/05/18 15:20:50 ET]
Table 'Lorcia II' 9-max Seat #4 is the button
Seat 1: HomerrrJay ($100 in chips) 
Seat 2: lydia12345 ($133.25 in chips) 
Seat 3: matiko09 ($104 in chips) 
Seat 4: vanilica ($108.68 in chips) 
Seat 5: nuuaber ($168.45 in chips) 
Seat 6: gkm0nk3y ($103.50 in chips) 
Seat 7: rate8 ($108.40 in chips) 
Seat 9: porgol ($251.25 in chips) 
nuuaber: posts small blind $0.50
gkm0nk3y: posts big blind $1
Skum1986: sits out 
*** HOLE CARDS ***
Dealt to matiko09 [Ts Qs]
rate8: folds 
porgol: calls $1
HomerrrJay: folds 
lydia12345: folds 
matiko09: raises $3 to $4
vanilica: calls $4
nuuaber: folds 
gkm0nk3y: folds 
porgol: folds 
*** FLOP *** [4s 4c 5d]
matiko09: bets $6
vanilica: calls $6
*** TURN *** [4s 4c 5d] [4d]
rate8 is disconnected 
matiko09: checks 
vanilica: bets $12.82
matiko09: folds 
Uncalled bet ($12.82) returned to vanilica
vanilica collected $21.38 from pot
vanilica: doesn't show hand 
*** SUMMARY ***
Total pot $22.50 | Rake $1.12 
Board [4s 4c 5d 4d]
Seat 1: HomerrrJay folded before Flop (didn't bet)
Seat 2: lydia12345 folded before Flop (didn't bet)
Seat 3: matiko09 folded on the Turn
Seat 4: vanilica (button) collected ($21.38)
Seat 5: nuuaber (small blind) folded before Flop
Seat 6: gkm0nk3y (big blind) folded before Flop
Seat 7: rate8 folded before Flop (didn't bet)
Seat 9: porgol folded before Flop





PokerStars Hand #153504853626:  Hold'em No Limit (€0.50/€1.00 EUR) - 2016/05/18 21:20:54 CET [2016/05/18 15:20:54 ET]
Table 'Pallas II' 9-max Seat #8 is the button
Seat 1: deadkiller1 (€206.31 in chips) 
Seat 2: matiko09 (€100 in chips) 
Seat 3: Vikulja1993 (€134.43 in chips) 
Seat 4: torkkdnm (€161.31 in chips) 
Seat 5: cobrik23 (€35 in chips) 
Seat 6: janarr5 (€100 in chips) 
Seat 7: rate8 (€100 in chips) 
Seat 8: Kihog (€162.80 in chips) 
Seat 9: stijner1986 (€186.59 in chips) 
stijner1986: posts small blind €0.50
deadkiller1: posts big blind €1
*** HOLE CARDS ***
Dealt to matiko09 [3h Tc]
matiko09: folds 
Vikulja1993: folds 
torkkdnm: folds 
cobrik23: folds 
janarr5: raises €2 to €3
rate8: folds 
Kihog: calls €3
stijner1986: folds 
deadkiller1: folds 
*** FLOP *** [7d 5s 6c]
janarr5: checks 
Kihog: bets €5
janarr5: folds 
Uncalled bet (€5) returned to Kihog
Kihog collected €7.12 from pot
Kihog: doesn't show hand 
*** SUMMARY ***
Total pot €7.50 | Rake €0.38 
Board [7d 5s 6c]
Seat 1: deadkiller1 (big blind) folded before Flop
Seat 2: matiko09 folded before Flop (didn't bet)
Seat 3: Vikulja1993 folded before Flop (didn't bet)
Seat 4: torkkdnm folded before Flop (didn't bet)
Seat 5: cobrik23 folded before Flop (didn't bet)
Seat 6: janarr5 folded on the Flop
Seat 7: rate8 folded before Flop (didn't bet)
Seat 8: Kihog (button) collected (€7.12)
Seat 9: stijner1986 (small blind) folded before Flop





PokerStars Hand #153504869261:  Hold'em No Limit ($0.50/$1.00 USD) - 2016/05/18 21:21:12 CET [2016/05/18 15:21:12 ET]
Table 'Samitchell II' 9-max Seat #3 is the button
Seat 1: riggedsh** ($115.18 in chips) 
Seat 3: vanilica ($176.32 in chips) 
Seat 4: Zeeshka ($100 in chips) 
Seat 5: nuuaber ($48.16 in chips) 
Seat 6: Strikerman25 ($55.62 in chips) 
Seat 7: matiko09 ($104.50 in chips) 
Seat 8: rate8 ($124.02 in chips) 
Seat 9: janarr5 ($102.50 in chips) 
Zeeshka: posts small blind $0.50
nuuaber: posts big blind $1
*** HOLE CARDS ***
Dealt to matiko09 [4s Js]
Strikerman25: folds 
cobrik23 joins the table at seat #2 
matiko09: folds 
rate8 has timed out while being disconnected
rate8: folds 
janarr5: folds 
rate8 is disconnected 
riggedsh**: raises $1.50 to $2.50
vanilica: folds 
Zeeshka: folds 
nuuaber: folds 
Uncalled bet ($1.50) returned to riggedsh**
riggedsh** collected $2.50 from pot
riggedsh**: doesn't show hand 
*** SUMMARY ***
Total pot $2.50 | Rake $0 
Seat 1: riggedsh** collected ($2.50)
Seat 3: vanilica (button) folded before Flop (didn't bet)
Seat 4: Zeeshka (small blind) folded before Flop
Seat 5: nuuaber (big blind) folded before Flop
Seat 6: Strikerman25 folded before Flop (didn't bet)
Seat 7: matiko09 folded before Flop (didn't bet)
Seat 8: rate8 folded before Flop (didn't bet)
Seat 9: janarr5 folded before Flop (didn't bet)





PokerStars Hand #153504882766:  Hold'em No Limit ($0.50/$1.00 USD) - 2016/05/18 21:21:26 CET [2016/05/18 15:21:26 ET]
Table 'Tatjana III' 9-max Seat #2 is the button
Seat 1: cobrik23 ($151.94 in chips) 
Seat 2: vanilica ($100 in chips) 
Seat 3: matiko09 ($174.30 in chips) 
Seat 4: lydia12345 ($121.48 in chips) 
Seat 5: deadkiller1 ($102.82 in chips) 
Seat 6: Kihog ($138.39 in chips) 
Seat 7: rene1984tsv ($117.77 in chips) 
Seat 8: JACQUILF ($118.15 in chips) 
Seat 9: Moszes360 ($122.11 in chips) 
matiko09: posts small blind $0.50
lydia12345: posts big blind $1
*** HOLE CARDS ***
Dealt to matiko09 [4c 5h]
deadkiller1: folds 
Kihog: folds 
rene1984tsv: raises $1 to $2
JACQUILF: raises $6 to $8
Moszes360: folds 
cobrik23: folds 
vanilica: folds 
matiko09: folds 
lydia12345: folds 
rene1984tsv: calls $6
*** FLOP *** [Kc 2c 8s]
rene1984tsv: checks 
JACQUILF: bets $7.99
rene1984tsv: folds 
Uncalled bet ($7.99) returned to JACQUILF
JACQUILF collected $16.62 from pot
JACQUILF: doesn't show hand 
*** SUMMARY ***
Total pot $17.50 | Rake $0.88 
Board [Kc 2c 8s]
Seat 1: cobrik23 folded before Flop (didn't bet)
Seat 2: vanilica (button) folded before Flop (didn't bet)
Seat 3: matiko09 (small blind) folded before Flop
Seat 4: lydia12345 (big blind) folded before Flop
Seat 5: deadkiller1 folded before Flop (didn't bet)
Seat 6: Kihog folded before Flop (didn't bet)
Seat 7: rene1984tsv folded on the Flop
Seat 8: JACQUILF collected ($16.62)
Seat 9: Moszes360 folded before Flop (didn't bet)





PokerStars Hand #153504883234:  Hold'em No Limit ($0.50/$1.00 USD) - 2016/05/18 21:21:27 CET [2016/05/18 15:21:27 ET]
Table 'Martir' 9-max Seat #1 is the button
Seat 1: Vivaoo ($114.70 in chips) 
Seat 2: TimStone ($102.82 in chips) 
Seat 3: deadkiller1 ($118.86 in chips) 
Seat 4: cobrik23 ($70.67 in chips) 
Seat 6: blufthenuts ($184.07 in chips) 
Seat 7: janarr5 ($100 in chips) 
Seat 8: matiko09 ($100 in chips) 
TimStone: posts small blind $0.50
deadkiller1: posts big blind $1
fack_vi: sits out 
Mashulia7777: sits out 
*** HOLE CARDS ***
Dealt to matiko09 [6c Jh]
cobrik23: folds 
blufthenuts: folds 
janarr5: raises $2 to $3
matiko09: folds 
Vivaoo: folds 
TimStone: folds 
deadkiller1: calls $2
*** FLOP *** [8c Ks Th]
deadkiller1: checks 
janarr5: bets $4
deadkiller1: folds 
Uncalled bet ($4) returned to janarr5
janarr5 collected $6.18 from pot
janarr5: doesn't show hand 
*** SUMMARY ***
Total pot $6.50 | Rake $0.32 
Board [8c Ks Th]
Seat 1: Vivaoo (button) folded before Flop (didn't bet)
Seat 2: TimStone (small blind) folded before Flop
Seat 3: deadkiller1 (big blind) folded on the Flop
Seat 4: cobrik23 folded before Flop (didn't bet)
Seat 6: blufthenuts folded before Flop (didn't bet)
Seat 7: janarr5 collected ($6.18)
Seat 8: matiko09 folded before Flop (didn't bet)





PokerStars Hand #153504894740:  Hold'em No Limit (€0.50/€1.00 EUR) - 2016/05/18 21:21:40 CET [2016/05/18 15:21:40 ET]
Table 'Pallas II' 9-max Seat #9 is the button
Seat 1: deadkiller1 (€205.31 in chips) 
Seat 2: matiko09 (€100 in chips) 
Seat 3: Vikulja1993 (€134.43 in chips) 
Seat 4: torkkdnm (€161.31 in chips) 
Seat 5: cobrik23 (€35 in chips) 
Seat 6: janarr5 (€100 in chips) 
Seat 7: rate8 (€100 in chips) 
Seat 8: Kihog (€166.92 in chips) 
Seat 9: stijner1986 (€186.09 in chips) 
deadkiller1: posts small blind €0.50
matiko09: posts big blind €1
*** HOLE CARDS ***
Dealt to matiko09 [Kh Jh]
Vikulja1993: folds 
Vikulja1993 leaves the table
torkkdnm: folds 
cobrik23: folds 
rate8 is disconnected 
cobrik23 leaves the table
Ouga Buga joins the table at seat #3 
janarr5: folds 
rate8 has timed out while disconnected
rate8: folds 
vanilica joins the table at seat #5 
Kihog: folds 
stijner1986: calls €1
deadkiller1: folds 
matiko09: raises €3 to €4
stijner1986: calls €3
*** FLOP *** [Th 2s Tc]
matiko09: checks 
stijner1986: checks 
*** TURN *** [Th 2s Tc] [8s]
matiko09: checks 
stijner1986: checks 
*** RIVER *** [Th 2s Tc 8s] [5d]
matiko09: checks 
stijner1986: checks 
*** SHOW DOWN ***
matiko09: shows [Kh Jh] (a pair of Tens)
stijner1986: shows [5s Ks] (two pair, Tens and Fives)
stijner1986 collected €8.08 from pot
*** SUMMARY ***
Total pot €8.50 | Rake €0.42 
Board [Th 2s Tc 8s 5d]
Seat 1: deadkiller1 (small blind) folded before Flop
Seat 2: matiko09 (big blind) showed [Kh Jh] and lost with a pair of Tens
Seat 3: Vikulja1993 folded before Flop (didn't bet)
Seat 4: torkkdnm folded before Flop (didn't bet)
Seat 5: cobrik23 folded before Flop (didn't bet)
Seat 6: janarr5 folded before Flop (didn't bet)
Seat 7: rate8 folded before Flop (didn't bet)
Seat 8: Kihog folded before Flop (didn't bet)
Seat 9: stijner1986 (button) showed [5s Ks] and won (€8.08) with two pair, Tens and Fives





PokerStars Hand #153504896413:  Hold'em No Limit ($0.50/$1.00 USD) - 2016/05/18 21:21:42 CET [2016/05/18 15:21:42 ET]
Table 'Brendelia II' 9-max Seat #9 is the button
Seat 1: vanilica ($102.20 in chips) 
Seat 2: LebzLouda ($41.88 in chips) 
Seat 3: Zeeshka ($100 in chips) 
Seat 5: Vulturinus ($79.77 in chips) 
Seat 6: TimStone ($137.67 in chips) 
Seat 7: matiko09 ($100 in chips) 
Seat 8: solbi86 ($100.55 in chips) 
Seat 9: Kihog ($122.38 in chips) 
vanilica: posts small blind $0.50
LebzLouda: posts big blind $1
gkm0nk3y: sits out 
*** HOLE CARDS ***
Dealt to matiko09 [Ad Ah]
Zeeshka: folds 
Vulturinus: raises $2 to $3
TimStone: folds 
matiko09: raises $7 to $10
solbi86: folds 
Kihog: folds 
vanilica: folds 
LebzLouda: folds 
Vulturinus: folds 
Uncalled bet ($7) returned to matiko09
matiko09 collected $7.50 from pot
matiko09: doesn't show hand 
*** SUMMARY ***
Total pot $7.50 | Rake $0 
Seat 1: vanilica (small blind) folded before Flop
Seat 2: LebzLouda (big blind) folded before Flop
Seat 3: Zeeshka folded before Flop (didn't bet)
Seat 5: Vulturinus folded before Flop
Seat 6: TimStone folded before Flop (didn't bet)
Seat 7: matiko09 collected ($7.50)
Seat 8: solbi86 folded before Flop (didn't bet)
Seat 9: Kihog (button) folded before Flop (didn't bet)





PokerStars Hand #153504898109:  Hold'em No Limit ($0.50/$1.00 USD) - 2016/05/18 21:21:44 CET [2016/05/18 15:21:44 ET]
Table 'Abetti II' 9-max Seat #4 is the button
Seat 1: matiko09 ($100 in chips) 
Seat 2: Vikulja1993 ($116.94 in chips) 
Seat 4: ipashutapkom ($40 in chips) 
Seat 5: blufthenuts ($145.34 in chips) 
Seat 6: Kihog ($100 in chips) 
Seat 7: rate8 ($105.78 in chips) 
Seat 8: roadster683 ($189.07 in chips) 
Seat 9: lydia12345 ($288.63 in chips) 
blufthenuts: posts small blind $0.50
Kihog: posts big blind $1
*** HOLE CARDS ***
Dealt to matiko09 [Qc 9d]
rate8 is disconnected 
rate8 has timed out while disconnected
rate8: folds 
roadster683: folds 
lydia12345: folds 
matiko09: folds 
Vikulja1993: raises $1.50 to $2.50
ipashutapkom: folds 
blufthenuts: folds 
Kihog: folds 
Uncalled bet ($1.50) returned to Vikulja1993
Vikulja1993 collected $2.50 from pot
Vikulja1993: doesn't show hand 
*** SUMMARY ***
Total pot $2.50 | Rake $0 
Seat 1: matiko09 folded before Flop (didn't bet)
Seat 2: Vikulja1993 collected ($2.50)
Seat 4: ipashutapkom (button) folded before Flop (didn't bet)
Seat 5: blufthenuts (small blind) folded before Flop
Seat 6: Kihog (big blind) folded before Flop
Seat 7: rate8 folded before Flop (didn't bet)
Seat 8: roadster683 folded before Flop (didn't bet)
Seat 9: lydia12345 folded before Flop (didn't bet)





PokerStars Hand #153504913378:  Hold'em No Limit ($0.50/$1.00 USD) - 2016/05/18 21:22:00 CET [2016/05/18 15:22:00 ET]
Table 'Tatjana III' 9-max Seat #3 is the button
Seat 1: cobrik23 ($151.94 in chips) 
Seat 2: vanilica ($100 in chips) 
Seat 3: matiko09 ($173.80 in chips) 
Seat 4: lydia12345 ($120.48 in chips) 
Seat 5: deadkiller1 ($102.82 in chips) 
Seat 6: Kihog ($138.39 in chips) 
Seat 7: rene1984tsv ($109.77 in chips) 
Seat 8: JACQUILF ($126.77 in chips) 
Seat 9: Moszes360 ($122.11 in chips) 
lydia12345: posts small blind $0.50
deadkiller1: posts big blind $1
*** HOLE CARDS ***
Dealt to matiko09 [2d Td]
Kihog: folds 
rene1984tsv: raises $2 to $3
JACQUILF: folds 
Moszes360: folds 
cobrik23: folds 
vanilica: calls $3
matiko09: folds 
lydia12345: folds 
deadkiller1: folds 
*** FLOP *** [9s Th Js]
rene1984tsv: bets $3.56
vanilica: calls $3.56
*** TURN *** [9s Th Js] [5h]
rene1984tsv: bets $3
vanilica: calls $3
*** RIVER *** [9s Th Js 5h] [Kd]
rene1984tsv: bets $12
vanilica: folds 
Uncalled bet ($12) returned to rene1984tsv
rene1984tsv collected $19.59 from pot
rene1984tsv: doesn't show hand 
*** SUMMARY ***
Total pot $20.62 | Rake $1.03 
Board [9s Th Js 5h Kd]
Seat 1: cobrik23 folded before Flop (didn't bet)
Seat 2: vanilica folded on the River
Seat 3: matiko09 (button) folded before Flop (didn't bet)
Seat 4: lydia12345 (small blind) folded before Flop
Seat 5: deadkiller1 (big blind) folded before Flop
Seat 6: Kihog folded before Flop (didn't bet)
Seat 7: rene1984tsv collected ($19.59)
Seat 8: JACQUILF folded before Flop (didn't bet)
Seat 9: Moszes360 folded before Flop (didn't bet)





PokerStars Hand #153504926317:  Hold'em No Limit ($0.50/$1.00 USD) - 2016/05/18 21:22:15 CET [2016/05/18 15:22:15 ET]
Table 'Samitchell II' 9-max Seat #4 is the button
Seat 1: riggedsh** ($116.68 in chips) 
Seat 3: vanilica ($176.32 in chips) 
Seat 4: Zeeshka ($100 in chips) 
Seat 5: nuuaber ($47.16 in chips) 
Seat 6: Strikerman25 ($55.62 in chips) 
Seat 7: matiko09 ($104.50 in chips) 
Seat 9: janarr5 ($102.50 in chips) 
nuuaber: posts small blind $0.50
Strikerman25: posts big blind $1
cobrik23: sits out 
*** HOLE CARDS ***
Dealt to matiko09 [Jc 8c]
matiko09: folds 
janarr5: folds 
riggedsh**: folds 
vanilica: raises $1.50 to $2.50
Zeeshka: calls $2.50
nuuaber: folds 
Strikerman25: folds 
*** FLOP *** [Js 2c 5d]
vanilica: bets $4.57
Zeeshka: calls $4.57
*** TURN *** [Js 2c 5d] [6s]
vanilica: checks 
Zeeshka: checks 
*** RIVER *** [Js 2c 5d 6s] [Th]
vanilica: checks 
Zeeshka: bets $9.95
vanilica: folds 
Uncalled bet ($9.95) returned to Zeeshka
Zeeshka collected $14.86 from pot
Zeeshka: doesn't show hand 
*** SUMMARY ***
Total pot $15.64 | Rake $0.78 
Board [Js 2c 5d 6s Th]
Seat 1: riggedsh** folded before Flop (didn't bet)
Seat 3: vanilica folded on the River
Seat 4: Zeeshka (button) collected ($14.86)
Seat 5: nuuaber (small blind) folded before Flop
Seat 6: Strikerman25 (big blind) folded before Flop
Seat 7: matiko09 folded before Flop (didn't bet)
Seat 9: janarr5 folded before Flop (didn't bet)





PokerStars Hand #153504926388:  Hold'em No Limit ($0.50/$1.00 USD) - 2016/05/18 21:22:15 CET [2016/05/18 15:22:15 ET]
Table 'Lorcia II' 9-max Seat #5 is the button
Seat 1: HomerrrJay ($100 in chips) 
Seat 2: lydia12345 ($133.25 in chips) 
Seat 3: matiko09 ($100 in chips) 
Seat 4: vanilica ($120.06 in chips) 
Seat 5: nuuaber ($167.95 in chips) 
Seat 6: gkm0nk3y ($102.50 in chips) 
Seat 8: Skum1986 ($105.91 in chips) 
Seat 9: porgol ($250.25 in chips) 
gkm0nk3y: posts small blind $0.50
rate8 has timed out while disconnected
rate8: is sitting out 
Skum1986: posts big blind $1
*** HOLE CARDS ***
Dealt to matiko09 [2h 5h]
porgol has timed out
porgol: folds 
HomerrrJay: folds 
lydia12345: raises $2 to $3
matiko09: folds 
vanilica: folds 
nuuaber: folds 
gkm0nk3y: folds 
Skum1986: folds 
Uncalled bet ($2) returned to lydia12345
lydia12345 collected $2.50 from pot
*** SUMMARY ***
Total pot $2.50 | Rake $0 
Seat 1: HomerrrJay folded before Flop (didn't bet)
Seat 2: lydia12345 collected ($2.50)
Seat 3: matiko09 folded before Flop (didn't bet)
Seat 4: vanilica folded before Flop (didn't bet)
Seat 5: nuuaber (button) folded before Flop (didn't bet)
Seat 6: gkm0nk3y (small blind) folded before Flop
Seat 8: Skum1986 (big blind) folded before Flop
Seat 9: porgol folded before Flop (didn't bet)





PokerStars Hand #153504945279:  Hold'em No Limit ($0.50/$1.00 USD) - 2016/05/18 21:22:36 CET [2016/05/18 15:22:36 ET]
Table 'Abetti II' 9-max Seat #5 is the button
Seat 1: matiko09 ($100 in chips) 
Seat 2: Vikulja1993 ($118.44 in chips) 
Seat 4: ipashutapkom ($40 in chips) 
Seat 5: blufthenuts ($144.84 in chips) 
Seat 6: Kihog ($100 in chips) 
Seat 8: roadster683 ($189.07 in chips) 
Seat 9: lydia12345 ($288.63 in chips) 
Kihog: posts small blind $0.50
roadster683: posts big blind $1
cobrik23: sits out 
*** HOLE CARDS ***
Dealt to matiko09 [8c 3h]
lydia12345: folds 
matiko09: folds 
Vikulja1993: folds 
ipashutapkom: folds 
blufthenuts: folds 
Kihog: folds 
Uncalled bet ($0.50) returned to roadster683
roadster683 collected $1 from pot
roadster683: doesn't show hand 
*** SUMMARY ***
Total pot $1 | Rake $0 
Seat 1: matiko09 folded before Flop (didn't bet)
Seat 2: Vikulja1993 folded before Flop (didn't bet)
Seat 4: ipashutapkom folded before Flop (didn't bet)
Seat 5: blufthenuts (button) folded before Flop (didn't bet)
Seat 6: Kihog (small blind) folded before Flop
Seat 8: roadster683 (big blind) collected ($1)
Seat 9: lydia12345 folded before Flop (didn't bet)





PokerStars Hand #153504948175:  Hold'em No Limit ($0.50/$1.00 USD) - 2016/05/18 21:22:39 CET [2016/05/18 15:22:39 ET]
Table 'Martir' 9-max Seat #2 is the button
Seat 1: Vivaoo ($114.70 in chips) 
Seat 2: TimStone ($102.32 in chips) 
Seat 3: deadkiller1 ($115.86 in chips) 
Seat 4: cobrik23 ($70.67 in chips) 
Seat 5: fack_vi ($100 in chips) 
Seat 6: blufthenuts ($184.07 in chips) 
Seat 7: janarr5 ($103.18 in chips) 
Seat 8: matiko09 ($100 in chips) 
deadkiller1: posts small blind $0.50
cobrik23: posts big blind $1
fack_vi: posts big blind $1
Mashulia7777: sits out 
*** HOLE CARDS ***
Dealt to matiko09 [8h Ah]
fack_vi: checks 
blufthenuts: folds 
janarr5: folds 
matiko09: raises $3 to $4
Vivaoo: folds 
TimStone: folds 
deadkiller1: folds 
cobrik23: folds 
fack_vi: calls $3
*** FLOP *** [As Jd 6d]
fack_vi: checks 
matiko09: checks 
*** TURN *** [As Jd 6d] [6s]
fack_vi: checks 
matiko09: bets $5
fack_vi: calls $5
*** RIVER *** [As Jd 6d 6s] [4h]
fack_vi: checks 
matiko09: checks 
*** SHOW DOWN ***
fack_vi: shows [9d 7d] (a pair of Sixes)
matiko09: shows [8h Ah] (two pair, Aces and Sixes)
matiko09 collected $18.52 from pot
*** SUMMARY ***
Total pot $19.50 | Rake $0.98 
Board [As Jd 6d 6s 4h]
Seat 1: Vivaoo folded before Flop (didn't bet)
Seat 2: TimStone (button) folded before Flop (didn't bet)
Seat 3: deadkiller1 (small blind) folded before Flop
Seat 4: cobrik23 (big blind) folded before Flop
Seat 5: fack_vi showed [9d 7d] and lost with a pair of Sixes
Seat 6: blufthenuts folded before Flop (didn't bet)
Seat 7: janarr5 folded before Flop (didn't bet)
Seat 8: matiko09 showed [8h Ah] and won ($18.52) with two pair, Aces and Sixes





PokerStars Hand #153504949654:  Hold'em No Limit ($0.50/$1.00 USD) - 2016/05/18 21:22:41 CET [2016/05/18 15:22:41 ET]
Table 'Brendelia II' 9-max Seat #1 is the button
Seat 1: vanilica ($101.70 in chips) 
Seat 2: LebzLouda ($40.88 in chips) 
Seat 3: Zeeshka ($100 in chips) 
Seat 5: Vulturinus ($76.77 in chips) 
Seat 6: TimStone ($137.67 in chips) 
Seat 7: matiko09 ($104.50 in chips) 
Seat 8: solbi86 ($100.55 in chips) 
Seat 9: Kihog ($122.38 in chips) 
LebzLouda: posts small blind $0.50
Zeeshka: posts big blind $1
gkm0nk3y: sits out 
*** HOLE CARDS ***
Dealt to matiko09 [6s 5d]
Vulturinus: folds 
TimStone: folds 
matiko09: folds 
solbi86: folds 
Kihog: folds 
vanilica: folds 
LebzLouda: raises $2 to $3
Zeeshka: calls $2
*** FLOP *** [Jh Th 2d]
LebzLouda: bets $3
Zeeshka: calls $3
*** TURN *** [Jh Th 2d] [2h]
LebzLouda: bets $6
Zeeshka: folds 
Uncalled bet ($6) returned to LebzLouda
LebzLouda collected $11.40 from pot
LebzLouda: doesn't show hand 
*** SUMMARY ***
Total pot $12 | Rake $0.60 
Board [Jh Th 2d 2h]
Seat 1: vanilica (button) folded before Flop (didn't bet)
Seat 2: LebzLouda (small blind) collected ($11.40)
Seat 3: Zeeshka (big blind) folded on the Turn
Seat 5: Vulturinus folded before Flop (didn't bet)
Seat 6: TimStone folded before Flop (didn't bet)
Seat 7: matiko09 folded before Flop (didn't bet)
Seat 8: solbi86 folded before Flop (didn't bet)
Seat 9: Kihog folded before Flop (didn't bet)





PokerStars Hand #153504958396:  Hold'em No Limit (€0.50/€1.00 EUR) - 2016/05/18 21:22:50 CET [2016/05/18 15:22:50 ET]
Table 'Pallas II' 9-max Seat #1 is the button
Seat 1: deadkiller1 (€204.81 in chips) 
Seat 2: matiko09 (€100 in chips) 
Seat 3: Ouga Buga (€100 in chips) 
Seat 4: torkkdnm (€161.31 in chips) 
Seat 6: janarr5 (€100 in chips) 
Seat 7: rate8 (€100 in chips) 
Seat 8: Kihog (€166.92 in chips) 
Seat 9: stijner1986 (€190.17 in chips) 
matiko09: posts small blind €0.50
Ouga Buga: posts big blind €1
vanilica: sits out 
*** HOLE CARDS ***
Dealt to matiko09 [5c Qh]
torkkdnm: folds 
janarr5: folds 
rate8: folds 
Kihog: folds 
stijner1986: calls €1
deadkiller1: folds 
matiko09: folds 
Ouga Buga: checks 
*** FLOP *** [Qc 6s 9d]
Ouga Buga: checks 
stijner1986: bets €2
Ouga Buga: folds 
Uncalled bet (€2) returned to stijner1986
stijner1986 collected €2.38 from pot
stijner1986: doesn't show hand 
*** SUMMARY ***
Total pot €2.50 | Rake €0.12 
Board [Qc 6s 9d]
Seat 1: deadkiller1 (button) folded before Flop (didn't bet)
Seat 2: matiko09 (small blind) folded before Flop
Seat 3: Ouga Buga (big blind) folded on the Flop
Seat 4: torkkdnm folded before Flop (didn't bet)
Seat 6: janarr5 folded before Flop (didn't bet)
Seat 7: rate8 folded before Flop (didn't bet)
Seat 8: Kihog folded before Flop (didn't bet)
Seat 9: stijner1986 collected (€2.38)





PokerStars Hand #153504959680:  Hold'em No Limit ($0.50/$1.00 USD) - 2016/05/18 21:22:52 CET [2016/05/18 15:22:52 ET]
Table 'Tatjana III' 9-max Seat #4 is the button
Seat 1: cobrik23 ($151.94 in chips) 
Seat 2: vanilica ($100 in chips) 
Seat 3: matiko09 ($173.80 in chips) 
Seat 4: lydia12345 ($119.98 in chips) 
Seat 5: deadkiller1 ($101.82 in chips) 
Seat 6: Kihog ($138.39 in chips) 
Seat 7: rene1984tsv ($119.80 in chips) 
Seat 8: JACQUILF ($126.77 in chips) 
Seat 9: Moszes360 ($122.11 in chips) 
deadkiller1: posts small blind $0.50
Kihog: posts big blind $1
*** HOLE CARDS ***
Dealt to matiko09 [2s 6d]
rene1984tsv: calls $1
JACQUILF: folds 
Moszes360: folds 
cobrik23: raises $3 to $4
vanilica: folds 
matiko09: folds 
lydia12345: folds 
deadkiller1: folds 
Kihog: folds 
rene1984tsv: calls $3
*** FLOP *** [8d 7c 9d]
rene1984tsv: checks 
cobrik23: checks 
*** TURN *** [8d 7c 9d] [5h]
rene1984tsv: checks 
cobrik23: checks 
*** RIVER *** [8d 7c 9d 5h] [6c]
rene1984tsv: bets $7
cobrik23: folds 
Uncalled bet ($7) returned to rene1984tsv
rene1984tsv collected $9.02 from pot
rene1984tsv: doesn't show hand 
*** SUMMARY ***
Total pot $9.50 | Rake $0.48 
Board [8d 7c 9d 5h 6c]
Seat 1: cobrik23 folded on the River
Seat 2: vanilica folded before Flop (didn't bet)
Seat 3: matiko09 folded before Flop (didn't bet)
Seat 4: lydia12345 (button) folded before Flop (didn't bet)
Seat 5: deadkiller1 (small blind) folded before Flop
Seat 6: Kihog (big blind) folded before Flop
Seat 7: rene1984tsv collected ($9.02)
Seat 8: JACQUILF folded before Flop (didn't bet)
Seat 9: Moszes360 folded before Flop (didn't bet)





PokerStars Hand #153504964058:  Hold'em No Limit ($0.50/$1.00 USD) - 2016/05/18 21:22:56 CET [2016/05/18 15:22:56 ET]
Table 'Abetti II' 9-max Seat #6 is the button
Seat 1: matiko09 ($100 in chips) 
Seat 2: Vikulja1993 ($118.44 in chips) 
Seat 4: ipashutapkom ($40 in chips) 
Seat 5: blufthenuts ($144.84 in chips) 
Seat 6: Kihog ($100 in chips) 
Seat 8: roadster683 ($189.57 in chips) 
Seat 9: lydia12345 ($288.63 in chips) 
rate8 will be allowed to play after the button
roadster683: posts small blind $0.50
lydia12345: posts big blind $1
cobrik23: sits out 
*** HOLE CARDS ***
Dealt to matiko09 [2s Tc]
matiko09: folds 
Vikulja1993: folds 
ipashutapkom: raises $1.26 to $2.26
blufthenuts: calls $2.26
Kihog: folds 
roadster683: calls $1.76
lydia12345: folds 
*** FLOP *** [2h 5s Ts]
roadster683: checks 
ipashutapkom: checks 
blufthenuts: bets $3.69
roadster683: folds 
ipashutapkom: folds 
Uncalled bet ($3.69) returned to blufthenuts
blufthenuts collected $7.39 from pot
blufthenuts: doesn't show hand 
*** SUMMARY ***
Total pot $7.78 | Rake $0.39 
Board [2h 5s Ts]
Seat 1: matiko09 folded before Flop (didn't bet)
Seat 2: Vikulja1993 folded before Flop (didn't bet)
Seat 4: ipashutapkom folded on the Flop
Seat 5: blufthenuts collected ($7.39)
Seat 6: Kihog (button) folded before Flop (didn't bet)
Seat 8: roadster683 (small blind) folded on the Flop
Seat 9: lydia12345 (big blind) folded before Flop





PokerStars Hand #153504981240:  Hold'em No Limit ($0.50/$1.00 USD) - 2016/05/18 21:23:15 CET [2016/05/18 15:23:15 ET]
Table 'Samitchell II' 9-max Seat #5 is the button
Seat 1: riggedsh** ($116.68 in chips) 
Seat 3: vanilica ($169.25 in chips) 
Seat 4: Zeeshka ($107.79 in chips) 
Seat 5: nuuaber ($46.66 in chips) 
Seat 6: Strikerman25 ($54.62 in chips) 
Seat 7: matiko09 ($104.50 in chips) 
Seat 8: rate8 ($124.02 in chips) 
Seat 9: janarr5 ($102.50 in chips) 
Strikerman25: posts small blind $0.50
matiko09: posts big blind $1
cobrik23: sits out 
*** HOLE CARDS ***
Dealt to matiko09 [4d Kd]
rate8: folds 
janarr5: folds 
riggedsh**: folds 
vanilica: folds 
Zeeshka: folds 
nuuaber: folds 
Strikerman25: folds 
Uncalled bet ($0.50) returned to matiko09
matiko09 collected $1 from pot
matiko09: doesn't show hand 
*** SUMMARY ***
Total pot $1 | Rake $0 
Seat 1: riggedsh** folded before Flop (didn't bet)
Seat 3: vanilica folded before Flop (didn't bet)
Seat 4: Zeeshka folded before Flop (didn't bet)
Seat 5: nuuaber (button) folded before Flop (didn't bet)
Seat 6: Strikerman25 (small blind) folded before Flop
Seat 7: matiko09 (big blind) collected ($1)
Seat 8: rate8 folded before Flop (didn't bet)
Seat 9: janarr5 folded before Flop (didn't bet)





PokerStars Hand #153504989362:  Hold'em No Limit ($0.50/$1.00 USD) - 2016/05/18 21:23:24 CET [2016/05/18 15:23:24 ET]
Table 'Lorcia II' 9-max Seat #6 is the button
Seat 1: HomerrrJay ($100 in chips) 
Seat 2: lydia12345 ($134.75 in chips) 
Seat 3: matiko09 ($100 in chips) 
Seat 4: vanilica ($120.06 in chips) 
Seat 5: nuuaber ($167.95 in chips) 
Seat 6: gkm0nk3y ($102 in chips) 
Seat 8: Skum1986 ($104.91 in chips) 
rate8 will be allowed to play after the button
Skum1986: posts small blind $0.50
HomerrrJay: posts big blind $1
*** HOLE CARDS ***
Dealt to matiko09 [2d 8d]
lydia12345: folds 
matiko09: folds 
vanilica: folds 
nuuaber: calls $1
gkm0nk3y: folds 
Skum1986: folds 
HomerrrJay: checks 
*** FLOP *** [Td Ac 3d]
HomerrrJay: checks 
nuuaber: bets $1
HomerrrJay: folds 
Uncalled bet ($1) returned to nuuaber
nuuaber collected $2.38 from pot
nuuaber: doesn't show hand 
*** SUMMARY ***
Total pot $2.50 | Rake $0.12 
Board [Td Ac 3d]
Seat 1: HomerrrJay (big blind) folded on the Flop
Seat 2: lydia12345 folded before Flop (didn't bet)
Seat 3: matiko09 folded before Flop (didn't bet)
Seat 4: vanilica folded before Flop (didn't bet)
Seat 5: nuuaber collected ($2.38)
Seat 6: gkm0nk3y (button) folded before Flop (didn't bet)
Seat 8: Skum1986 (small blind) folded before Flop





PokerStars Hand #153505005548:  Hold'em No Limit (€0.50/€1.00 EUR) - 2016/05/18 21:23:42 CET [2016/05/18 15:23:42 ET]
Table 'Pallas II' 9-max Seat #2 is the button
Seat 1: deadkiller1 (€204.81 in chips) 
Seat 2: matiko09 (€100 in chips) 
Seat 3: Ouga Buga (€100 in chips) 
Seat 4: torkkdnm (€161.31 in chips) 
Seat 6: janarr5 (€100 in chips) 
Seat 7: rate8 (€100 in chips) 
Seat 8: Kihog (€166.92 in chips) 
Seat 9: stijner1986 (€191.55 in chips) 
Ouga Buga: posts small blind €0.50
torkkdnm: posts big blind €1
vanilica: sits out 
*** HOLE CARDS ***
Dealt to matiko09 [3h Ah]
janarr5: raises €2 to €3
rate8: folds 
Kihog: folds 
stijner1986: calls €3
deadkiller1: folds 
matiko09: folds 
Ouga Buga: folds 
torkkdnm: folds 
*** FLOP *** [Qh 7d 4s]
janarr5: checks 
stijner1986: checks 
*** TURN *** [Qh 7d 4s] [4h]
janarr5: bets €4
stijner1986: calls €4
*** RIVER *** [Qh 7d 4s 4h] [4c]
janarr5: bets €9
stijner1986: folds 
Uncalled bet (€9) returned to janarr5
janarr5 collected €14.72 from pot
janarr5: doesn't show hand 
*** SUMMARY ***
Total pot €15.50 | Rake €0.78 
Board [Qh 7d 4s 4h 4c]
Seat 1: deadkiller1 folded before Flop (didn't bet)
Seat 2: matiko09 (button) folded before Flop (didn't bet)
Seat 3: Ouga Buga (small blind) folded before Flop
Seat 4: torkkdnm (big blind) folded before Flop
Seat 6: janarr5 collected (€14.72)
Seat 7: rate8 folded before Flop (didn't bet)
Seat 8: Kihog folded before Flop (didn't bet)
Seat 9: stijner1986 folded on the River





PokerStars Hand #153505009426:  Hold'em No Limit ($0.50/$1.00 USD) - 2016/05/18 21:23:47 CET [2016/05/18 15:23:47 ET]
Table 'Martir' 9-max Seat #3 is the button
Seat 1: Vivaoo ($114.70 in chips) 
Seat 2: TimStone ($102.32 in chips) 
Seat 3: deadkiller1 ($115.36 in chips) 
Seat 4: cobrik23 ($69.67 in chips) 
Seat 5: fack_vi ($91 in chips) 
Seat 6: blufthenuts ($184.07 in chips) 
Seat 7: janarr5 ($103.18 in chips) 
Seat 8: matiko09 ($109.52 in chips) 
cobrik23: posts small blind $0.50
fack_vi: posts big blind $1
Mashulia7777: sits out 
*** HOLE CARDS ***
Dealt to matiko09 [Tc 8d]
blufthenuts: folds 
janarr5: folds 
matiko09: folds 
Vivaoo: folds 
TimStone: folds 
deadkiller1: raises $1.50 to $2.50
cobrik23: folds 
fack_vi: folds 
Uncalled bet ($1.50) returned to deadkiller1
deadkiller1 collected $2.50 from pot
deadkiller1: doesn't show hand 
*** SUMMARY ***
Total pot $2.50 | Rake $0 
Seat 1: Vivaoo folded before Flop (didn't bet)
Seat 2: TimStone folded before Flop (didn't bet)
Seat 3: deadkiller1 (button) collected ($2.50)
Seat 4: cobrik23 (small blind) folded before Flop
Seat 5: fack_vi (big blind) folded before Flop
Seat 6: blufthenuts folded before Flop (didn't bet)
Seat 7: janarr5 folded before Flop (didn't bet)
Seat 8: matiko09 folded before Flop (didn't bet)





PokerStars Hand #153505010786:  Hold'em No Limit ($0.50/$1.00 USD) - 2016/05/18 21:23:48 CET [2016/05/18 15:23:48 ET]
Table 'Brendelia II' 9-max Seat #2 is the button
Seat 1: vanilica ($101.70 in chips) 
Seat 2: LebzLouda ($46.28 in chips) 
Seat 3: Zeeshka ($100 in chips) 
Seat 4: gkm0nk3y ($100 in chips) 
Seat 5: Vulturinus ($76.77 in chips) 
Seat 6: TimStone ($137.67 in chips) 
Seat 7: matiko09 ($104.50 in chips) 
Seat 8: solbi86 ($100.55 in chips) 
Seat 9: Kihog ($122.38 in chips) 
Zeeshka: posts small blind $0.50
gkm0nk3y: posts big blind $1
*** HOLE CARDS ***
Dealt to matiko09 [Jh 2s]
Vulturinus: folds 
TimStone: folds 
matiko09: folds 
solbi86: folds 
Kihog: folds 
vanilica: folds 
LebzLouda: folds 
Zeeshka: folds 
Uncalled bet ($0.50) returned to gkm0nk3y
gkm0nk3y collected $1 from pot
*** SUMMARY ***
Total pot $1 | Rake $0 
Seat 1: vanilica folded before Flop (didn't bet)
Seat 2: LebzLouda (button) folded before Flop (didn't bet)
Seat 3: Zeeshka (small blind) folded before Flop
Seat 4: gkm0nk3y (big blind) collected ($1)
Seat 5: Vulturinus folded before Flop (didn't bet)
Seat 6: TimStone folded before Flop (didn't bet)
Seat 7: matiko09 folded before Flop (didn't bet)
Seat 8: solbi86 folded before Flop (didn't bet)
Seat 9: Kihog folded before Flop (didn't bet)





PokerStars Hand #153505016546:  Hold'em No Limit ($0.50/$1.00 USD) - 2016/05/18 21:23:54 CET [2016/05/18 15:23:54 ET]
Table 'Tatjana III' 9-max Seat #5 is the button
Seat 1: cobrik23 ($147.94 in chips) 
Seat 2: vanilica ($100 in chips) 
Seat 3: matiko09 ($173.80 in chips) 
Seat 4: lydia12345 ($119.98 in chips) 
Seat 5: deadkiller1 ($101.32 in chips) 
Seat 6: Kihog ($137.39 in chips) 
Seat 7: rene1984tsv ($124.82 in chips) 
Seat 8: JACQUILF ($126.77 in chips) 
Seat 9: Moszes360 ($122.11 in chips) 
Kihog: posts small blind $0.50
rene1984tsv: posts big blind $1
*** HOLE CARDS ***
Dealt to matiko09 [9h Td]
JACQUILF: folds 
Moszes360: raises $2 to $3
cobrik23: folds 
vanilica: folds 
matiko09: folds 
lydia12345: folds 
deadkiller1: folds 
Kihog: calls $2.50
rene1984tsv: calls $2
*** FLOP *** [8c 6s 8d]
Kihog: bets $6
rene1984tsv: folds 
Moszes360: folds 
Uncalled bet ($6) returned to Kihog
Kihog collected $8.55 from pot
Kihog: doesn't show hand 
*** SUMMARY ***
Total pot $9 | Rake $0.45 
Board [8c 6s 8d]
Seat 1: cobrik23 folded before Flop (didn't bet)
Seat 2: vanilica folded before Flop (didn't bet)
Seat 3: matiko09 folded before Flop (didn't bet)
Seat 4: lydia12345 folded before Flop (didn't bet)
Seat 5: deadkiller1 (button) folded before Flop (didn't bet)
Seat 6: Kihog (small blind) collected ($8.55)
Seat 7: rene1984tsv (big blind) folded on the Flop
Seat 8: JACQUILF folded before Flop (didn't bet)
Seat 9: Moszes360 folded on the Flop





PokerStars Hand #153505022218:  Hold'em No Limit ($0.50/$1.00 USD) - 2016/05/18 21:24:01 CET [2016/05/18 15:24:01 ET]
Table 'Samitchell II' 9-max Seat #6 is the button
Seat 1: riggedsh** ($116.68 in chips) 
Seat 3: vanilica ($169.25 in chips) 
Seat 4: Zeeshka ($107.79 in chips) 
Seat 5: nuuaber ($46.66 in chips) 
Seat 6: Strikerman25 ($54.12 in chips) 
Seat 7: matiko09 ($105 in chips) 
Seat 8: rate8 ($124.02 in chips) 
Seat 9: janarr5 ($102.50 in chips) 
matiko09: posts small blind $0.50
rate8: posts big blind $1
cobrik23: sits out 
*** HOLE CARDS ***
Dealt to matiko09 [5s As]
cobrik23 leaves the table
janarr5: folds 
riggedsh**: folds 
vanilica: folds 
Zeeshka: folds 
nuuaber: folds 
Strikerman25: raises $1.09 to $2.09
matiko09: raises $5.91 to $8
rate8: folds 
Strikerman25: calls $5.91
*** FLOP *** [6s 4h 2s]
matiko09: bets $10
Strikerman25: calls $10
*** TURN *** [6s 4h 2s] [Qc]
matiko09: bets $87 and is all-in
Strikerman25: folds 
Uncalled bet ($87) returned to matiko09
matiko09 collected $35.15 from pot
matiko09: doesn't show hand 
*** SUMMARY ***
Total pot $37 | Rake $1.85 
Board [6s 4h 2s Qc]
Seat 1: riggedsh** folded before Flop (didn't bet)
Seat 3: vanilica folded before Flop (didn't bet)
Seat 4: Zeeshka folded before Flop (didn't bet)
Seat 5: nuuaber folded before Flop (didn't bet)
Seat 6: Strikerman25 (button) folded on the Turn
Seat 7: matiko09 (small blind) collected ($35.15)
Seat 8: rate8 (big blind) folded before Flop
Seat 9: janarr5 folded before Flop (didn't bet)





PokerStars Hand #153505035626:  Hold'em No Limit ($0.50/$1.00 USD) - 2016/05/18 21:24:15 CET [2016/05/18 15:24:15 ET]
Table 'Brendelia II' 9-max Seat #3 is the button
Seat 1: vanilica ($101.70 in chips) 
Seat 2: LebzLouda ($46.28 in chips) 
Seat 3: Zeeshka ($100 in chips) 
Seat 4: gkm0nk3y ($100.50 in chips) 
Seat 5: Vulturinus ($76.77 in chips) 
Seat 6: TimStone ($137.67 in chips) 
Seat 7: matiko09 ($104.50 in chips) 
Seat 8: solbi86 ($100.55 in chips) 
Seat 9: Kihog ($122.38 in chips) 
gkm0nk3y: posts small blind $0.50
Vulturinus: posts big blind $1
*** HOLE CARDS ***
Dealt to matiko09 [Jd 5d]
TimStone: folds 
matiko09: folds 
solbi86: folds 
Kihog: folds 
vanilica: folds 
LebzLouda: folds 
Zeeshka: raises $1.50 to $2.50
gkm0nk3y: folds 
Vulturinus: folds 
Uncalled bet ($1.50) returned to Zeeshka
Zeeshka collected $2.50 from pot
Zeeshka: doesn't show hand 
*** SUMMARY ***
Total pot $2.50 | Rake $0 
Seat 1: vanilica folded before Flop (didn't bet)
Seat 2: LebzLouda folded before Flop (didn't bet)
Seat 3: Zeeshka (button) collected ($2.50)
Seat 4: gkm0nk3y (small blind) folded before Flop
Seat 5: Vulturinus (big blind) folded before Flop
Seat 6: TimStone folded before Flop (didn't bet)
Seat 7: matiko09 folded before Flop (didn't bet)
Seat 8: solbi86 folded before Flop (didn't bet)
Seat 9: Kihog folded before Flop (didn't bet)





PokerStars Hand #153505036267:  Hold'em No Limit ($0.50/$1.00 USD) - 2016/05/18 21:24:16 CET [2016/05/18 15:24:16 ET]
Table 'Abetti II' 9-max Seat #8 is the button
Seat 1: matiko09 ($100 in chips) 
Seat 2: Vikulja1993 ($118.44 in chips) 
Seat 4: ipashutapkom ($40 in chips) 
Seat 5: blufthenuts ($149.97 in chips) 
Seat 6: Kihog ($100 in chips) 
Seat 8: roadster683 ($187.31 in chips) 
Seat 9: lydia12345 ($287.63 in chips) 
lydia12345: posts small blind $0.50
matiko09: posts big blind $1
cobrik23: sits out 
rate8: sits out 
*** HOLE CARDS ***
Dealt to matiko09 [3d 9s]
Vikulja1993: folds 
ipashutapkom: folds 
Vikulja1993 leaves the table
blufthenuts: folds 
Kihog: raises $1.50 to $2.50
roadster683: calls $2.50
lydia12345: folds 
matiko09: folds 
*** FLOP *** [Qd Kh Qs]
Kihog: checks 
roadster683: bets $3
Kihog: folds 
Uncalled bet ($3) returned to roadster683
roadster683 collected $6.18 from pot
roadster683: doesn't show hand 
*** SUMMARY ***
Total pot $6.50 | Rake $0.32 
Board [Qd Kh Qs]
Seat 1: matiko09 (big blind) folded before Flop
Seat 2: Vikulja1993 folded before Flop (didn't bet)
Seat 4: ipashutapkom folded before Flop (didn't bet)
Seat 5: blufthenuts folded before Flop (didn't bet)
Seat 6: Kihog folded on the Flop
Seat 8: roadster683 (button) collected ($6.18)
Seat 9: lydia12345 (small blind) folded before Flop





PokerStars Hand #153505036061:  Hold'em No Limit ($0.50/$1.00 USD) - 2016/05/18 21:24:16 CET [2016/05/18 15:24:16 ET]
Table 'Martir' 9-max Seat #4 is the button
Seat 1: Vivaoo ($114.70 in chips) 
Seat 2: TimStone ($102.32 in chips) 
Seat 3: deadkiller1 ($116.86 in chips) 
Seat 4: cobrik23 ($69.17 in chips) 
Seat 5: fack_vi ($90 in chips) 
Seat 6: blufthenuts ($184.07 in chips) 
Seat 7: janarr5 ($103.18 in chips) 
Seat 8: matiko09 ($109.52 in chips) 
fack_vi: posts small blind $0.50
blufthenuts: posts big blind $1
Mashulia7777: sits out 
*** HOLE CARDS ***
Dealt to matiko09 [Kh 5s]
janarr5: folds 
matiko09: folds 
Vivaoo: folds 
TimStone: raises $1.62 to $2.62
deadkiller1: folds 
cobrik23: folds 
fack_vi: folds 
blufthenuts: folds 
Uncalled bet ($1.62) returned to TimStone
TimStone collected $2.50 from pot
TimStone: doesn't show hand 
*** SUMMARY ***
Total pot $2.50 | Rake $0 
Seat 1: Vivaoo folded before Flop (didn't bet)
Seat 2: TimStone collected ($2.50)
Seat 3: deadkiller1 folded before Flop (didn't bet)
Seat 4: cobrik23 (button) folded before Flop (didn't bet)
Seat 5: fack_vi (small blind) folded before Flop
Seat 6: blufthenuts (big blind) folded before Flop
Seat 7: janarr5 folded before Flop (didn't bet)
Seat 8: matiko09 folded before Flop (didn't bet)





PokerStars Hand #153505049732:  Hold'em No Limit ($0.50/$1.00 USD) - 2016/05/18 21:24:31 CET [2016/05/18 15:24:31 ET]
Table 'Zaurak II' 9-max Seat #9 is the button
Seat 1: TimStone ($111.92 in chips) 
Seat 2: matiko09 ($100 in chips) 
Seat 3: janarr5 ($121.38 in chips) 
Seat 4: cobrik23 ($40 in chips) 
Seat 5: rate8 ($120.18 in chips) 
Seat 6: deadkiller1 ($107.38 in chips) 
Seat 7: Kihog ($100 in chips) 
Seat 8: Asgel22 ($223.82 in chips) 
Seat 9: torkkdnm ($105.45 in chips) 
TimStone: posts small blind $0.50
matiko09: posts big blind $1
*** HOLE CARDS ***
Dealt to matiko09 [Jc 2c]
janarr5: folds 
cobrik23: raises $2 to $3
rate8: folds 
deadkiller1: calls $3
Kihog: folds 
Asgel22: calls $3
torkkdnm: folds 
TimStone: folds 
matiko09: folds 
*** FLOP *** [3d 8c Th]
cobrik23: checks 
deadkiller1: bets $6.58
Asgel22: folds 
cobrik23: folds 
Uncalled bet ($6.58) returned to deadkiller1
deadkiller1 collected $9.98 from pot
deadkiller1: doesn't show hand 
*** SUMMARY ***
Total pot $10.50 | Rake $0.52 
Board [3d 8c Th]
Seat 1: TimStone (small blind) folded before Flop
Seat 2: matiko09 (big blind) folded before Flop
Seat 3: janarr5 folded before Flop (didn't bet)
Seat 4: cobrik23 folded on the Flop
Seat 5: rate8 folded before Flop (didn't bet)
Seat 6: deadkiller1 collected ($9.98)
Seat 7: Kihog folded before Flop (didn't bet)
Seat 8: Asgel22 folded on the Flop
Seat 9: torkkdnm (button) folded before Flop (didn't bet)





PokerStars Hand #153505053849:  Hold'em No Limit ($0.50/$1.00 USD) - 2016/05/18 21:24:36 CET [2016/05/18 15:24:36 ET]
Table 'Lorcia II' 9-max Seat #8 is the button
Seat 1: HomerrrJay ($100 in chips) 
Seat 2: lydia12345 ($134.75 in chips) 
Seat 3: matiko09 ($100 in chips) 
Seat 4: vanilica ($120.06 in chips) 
Seat 5: nuuaber ($169.33 in chips) 
Seat 6: gkm0nk3y ($102 in chips) 
Seat 8: Skum1986 ($104.41 in chips) 
HomerrrJay: posts small blind $0.50
lydia12345: posts big blind $1
rate8: sits out 
*** HOLE CARDS ***
Dealt to matiko09 [2d Jc]
matiko09: folds 
vanilica: folds 
nuuaber: raises $1 to $2
gkm0nk3y: raises $6 to $8
Skum1986: folds 
HomerrrJay: calls $7.50
lydia12345: folds 
nuuaber: calls $6
*** FLOP *** [6h 8c 5s]
HomerrrJay: bets $10.50
nuuaber: folds 
gkm0nk3y: folds 
Uncalled bet ($10.50) returned to HomerrrJay
HomerrrJay collected $23.75 from pot
HomerrrJay: doesn't show hand 
*** SUMMARY ***
Total pot $25 | Rake $1.25 
Board [6h 8c 5s]
Seat 1: HomerrrJay (small blind) collected ($23.75)
Seat 2: lydia12345 (big blind) folded before Flop
Seat 3: matiko09 folded before Flop (didn't bet)
Seat 4: vanilica folded before Flop (didn't bet)
Seat 5: nuuaber folded on the Flop
Seat 6: gkm0nk3y folded on the Flop
Seat 8: Skum1986 (button) folded before Flop (didn't bet)





PokerStars Hand #153505054875:  Hold'em No Limit (€0.50/€1.00 EUR) - 2016/05/18 21:24:37 CET [2016/05/18 15:24:37 ET]
Table 'Pallas II' 9-max Seat #3 is the button
Seat 1: deadkiller1 (€204.81 in chips) 
Seat 2: matiko09 (€100 in chips) 
Seat 3: Ouga Buga (€100 in chips) 
Seat 4: torkkdnm (€160.31 in chips) 
Seat 5: vanilica (€100 in chips) 
Seat 6: janarr5 (€107.72 in chips) 
Seat 7: rate8 (€100 in chips) 
Seat 8: Kihog (€166.92 in chips) 
Seat 9: stijner1986 (€184.55 in chips) 
torkkdnm: posts small blind €0.50
vanilica: posts big blind €1
*** HOLE CARDS ***
Dealt to matiko09 [3c 7s]
janarr5: folds 
rate8: folds 
Kihog: folds 
stijner1986: folds 
deadkiller1: folds 
matiko09: folds 
Ouga Buga: raises €1.50 to €2.50
torkkdnm: folds 
vanilica: folds 
Uncalled bet (€1.50) returned to Ouga Buga
Ouga Buga collected €2.50 from pot
Ouga Buga: doesn't show hand 
*** SUMMARY ***
Total pot €2.50 | Rake €0 
Seat 1: deadkiller1 folded before Flop (didn't bet)
Seat 2: matiko09 folded before Flop (didn't bet)
Seat 3: Ouga Buga (button) collected (€2.50)
Seat 4: torkkdnm (small blind) folded before Flop
Seat 5: vanilica (big blind) folded before Flop
Seat 6: janarr5 folded before Flop (didn't bet)
Seat 7: rate8 folded before Flop (didn't bet)
Seat 8: Kihog folded before Flop (didn't bet)
Seat 9: stijner1986 folded before Flop (didn't bet)





PokerStars Hand #153505060248:  Hold'em No Limit ($0.50/$1.00 USD) - 2016/05/18 21:24:43 CET [2016/05/18 15:24:43 ET]
Table 'Martir' 9-max Seat #5 is the button
Seat 1: Vivaoo ($114.70 in chips) 
Seat 2: TimStone ($103.82 in chips) 
Seat 3: deadkiller1 ($116.86 in chips) 
Seat 4: cobrik23 ($69.17 in chips) 
Seat 5: fack_vi ($89.50 in chips) 
Seat 6: blufthenuts ($183.07 in chips) 
Seat 7: janarr5 ($103.18 in chips) 
Seat 8: matiko09 ($109.52 in chips) 
blufthenuts: posts small blind $0.50
janarr5: posts big blind $1
Mashulia7777: sits out 
*** HOLE CARDS ***
Dealt to matiko09 [Qd 6d]
matiko09: folds 
Vivaoo: folds 
TimStone: folds 
deadkiller1: raises $2 to $3
cobrik23: folds 
fack_vi has timed out
fack_vi: folds 
blufthenuts: folds 
janarr5: folds 
Uncalled bet ($2) returned to deadkiller1
deadkiller1 collected $2.50 from pot
deadkiller1: doesn't show hand 
*** SUMMARY ***
Total pot $2.50 | Rake $0 
Seat 1: Vivaoo folded before Flop (didn't bet)
Seat 2: TimStone folded before Flop (didn't bet)
Seat 3: deadkiller1 collected ($2.50)
Seat 4: cobrik23 folded before Flop (didn't bet)
Seat 5: fack_vi (button) folded before Flop (didn't bet)
Seat 6: blufthenuts (small blind) folded before Flop
Seat 7: janarr5 (big blind) folded before Flop
Seat 8: matiko09 folded before Flop (didn't bet)





PokerStars Hand #153505067804:  Hold'em No Limit ($0.50/$1.00 USD) - 2016/05/18 21:24:52 CET [2016/05/18 15:24:52 ET]
Table 'Brendelia II' 9-max Seat #4 is the button
Seat 1: vanilica ($101.70 in chips) 
Seat 2: LebzLouda ($46.28 in chips) 
Seat 3: Zeeshka ($101.50 in chips) 
Seat 4: gkm0nk3y ($100 in chips) 
Seat 5: Vulturinus ($75.77 in chips) 
Seat 6: TimStone ($137.67 in chips) 
Seat 7: matiko09 ($104.50 in chips) 
Seat 8: solbi86 ($100.55 in chips) 
Seat 9: Kihog ($122.38 in chips) 
Vulturinus: posts small blind $0.50
TimStone: posts big blind $1
*** HOLE CARDS ***
Dealt to matiko09 [Tc Jh]
matiko09: folds 
solbi86: folds 
Kihog: raises $1.50 to $2.50
vanilica: folds 
LebzLouda: folds 
Zeeshka: folds 
gkm0nk3y: folds 
Vulturinus: folds 
TimStone: folds 
Uncalled bet ($1.50) returned to Kihog
Kihog collected $2.50 from pot
Kihog: doesn't show hand 
*** SUMMARY ***
Total pot $2.50 | Rake $0 
Seat 1: vanilica folded before Flop (didn't bet)
Seat 2: LebzLouda folded before Flop (didn't bet)
Seat 3: Zeeshka folded before Flop (didn't bet)
Seat 4: gkm0nk3y (button) folded before Flop (didn't bet)
Seat 5: Vulturinus (small blind) folded before Flop
Seat 6: TimStone (big blind) folded before Flop
Seat 7: matiko09 folded before Flop (didn't bet)
Seat 8: solbi86 folded before Flop (didn't bet)
Seat 9: Kihog collected ($2.50)





PokerStars Hand #153505071571:  Hold'em No Limit ($0.50/$1.00 USD) - 2016/05/18 21:24:56 CET [2016/05/18 15:24:56 ET]
Table 'Tatjana III' 9-max Seat #6 is the button
Seat 1: cobrik23 ($147.94 in chips) 
Seat 2: vanilica ($100 in chips) 
Seat 3: matiko09 ($173.80 in chips) 
Seat 4: lydia12345 ($119.98 in chips) 
Seat 5: deadkiller1 ($101.32 in chips) 
Seat 6: Kihog ($142.94 in chips) 
Seat 7: rene1984tsv ($121.82 in chips) 
Seat 8: JACQUILF ($126.77 in chips) 
Seat 9: Moszes360 ($119.11 in chips) 
rene1984tsv: posts small blind $0.50
JACQUILF: posts big blind $1
*** HOLE CARDS ***
Dealt to matiko09 [Kc 5h]
Moszes360: folds 
cobrik23: folds 
vanilica: folds 
matiko09: folds 
lydia12345: folds 
deadkiller1: folds 
Kihog: raises $1 to $2
rene1984tsv: calls $1.50
JACQUILF: folds 
*** FLOP *** [Ac 7h 4h]
rene1984tsv: checks 
Kihog: bets $3.50
rene1984tsv: folds 
Uncalled bet ($3.50) returned to Kihog
Kihog collected $4.75 from pot
Kihog: doesn't show hand 
*** SUMMARY ***
Total pot $5 | Rake $0.25 
Board [Ac 7h 4h]
Seat 1: cobrik23 folded before Flop (didn't bet)
Seat 2: vanilica folded before Flop (didn't bet)
Seat 3: matiko09 folded before Flop (didn't bet)
Seat 4: lydia12345 folded before Flop (didn't bet)
Seat 5: deadkiller1 folded before Flop (didn't bet)
Seat 6: Kihog (button) collected ($4.75)
Seat 7: rene1984tsv (small blind) folded on the Flop
Seat 8: JACQUILF (big blind) folded before Flop
Seat 9: Moszes360 folded before Flop (didn't bet)





PokerStars Hand #153505085152:  Hold'em No Limit ($0.50/$1.00 USD) - 2016/05/18 21:25:12 CET [2016/05/18 15:25:12 ET]
Table 'Abetti II' 9-max Seat #9 is the button
Seat 1: matiko09 ($100 in chips) 
Seat 3: cobrik23 ($157.78 in chips) 
Seat 4: ipashutapkom ($40 in chips) 
Seat 5: blufthenuts ($149.97 in chips) 
Seat 6: Kihog ($100 in chips) 
Seat 8: roadster683 ($190.99 in chips) 
Seat 9: lydia12345 ($287.13 in chips) 
matiko09: posts small blind $0.50
cobrik23: posts big blind $1
rate8: sits out 
*** HOLE CARDS ***
Dealt to matiko09 [9d Jh]
ipashutapkom: folds 
blufthenuts: folds 
Kihog: folds 
roadster683: raises $1 to $2
lydia12345: folds 
matiko09: folds 
cobrik23: folds 
Uncalled bet ($1) returned to roadster683
torkkdnm joins the table at seat #2 
roadster683 collected $2.50 from pot
roadster683: doesn't show hand 
*** SUMMARY ***
Total pot $2.50 | Rake $0 
Seat 1: matiko09 (small blind) folded before Flop
Seat 3: cobrik23 (big blind) folded before Flop
Seat 4: ipashutapkom folded before Flop (didn't bet)
Seat 5: blufthenuts folded before Flop (didn't bet)
Seat 6: Kihog folded before Flop (didn't bet)
Seat 8: roadster683 collected ($2.50)
Seat 9: lydia12345 (button) folded before Flop (didn't bet)





PokerStars Hand #153505097620:  Hold'em No Limit ($0.50/$1.00 USD) - 2016/05/18 21:25:25 CET [2016/05/18 15:25:25 ET]
Table 'Brendelia II' 9-max Seat #5 is the button
Seat 1: vanilica ($101.70 in chips) 
Seat 2: LebzLouda ($46.28 in chips) 
Seat 3: Zeeshka ($101.50 in chips) 
Seat 4: gkm0nk3y ($100 in chips) 
Seat 5: Vulturinus ($75.27 in chips) 
Seat 6: TimStone ($136.67 in chips) 
Seat 7: matiko09 ($104.50 in chips) 
Seat 8: solbi86 ($100.55 in chips) 
Seat 9: Kihog ($123.88 in chips) 
TimStone: posts small blind $0.50
matiko09: posts big blind $1
*** HOLE CARDS ***
Dealt to matiko09 [Ac 5s]
solbi86: raises $2 to $3
Kihog: folds 
vanilica: folds 
LebzLouda: folds 
Zeeshka: folds 
gkm0nk3y: calls $3
Vulturinus: folds 
TimStone: folds 
matiko09: folds 
*** FLOP *** [7c 6c 5d]
solbi86: checks 
gkm0nk3y: bets $4.50
solbi86: folds 
Uncalled bet ($4.50) returned to gkm0nk3y
gkm0nk3y collected $7.12 from pot
*** SUMMARY ***
Total pot $7.50 | Rake $0.38 
Board [7c 6c 5d]
Seat 1: vanilica folded before Flop (didn't bet)
Seat 2: LebzLouda folded before Flop (didn't bet)
Seat 3: Zeeshka folded before Flop (didn't bet)
Seat 4: gkm0nk3y collected ($7.12)
Seat 5: Vulturinus (button) folded before Flop (didn't bet)
Seat 6: TimStone (small blind) folded before Flop
Seat 7: matiko09 (big blind) folded before Flop
Seat 8: solbi86 folded on the Flop
Seat 9: Kihog folded before Flop (didn't bet)





PokerStars Hand #153505099854:  Hold'em No Limit ($0.50/$1.00 USD) - 2016/05/18 21:25:28 CET [2016/05/18 15:25:28 ET]
Table 'Tatjana III' 9-max Seat #7 is the button
Seat 1: cobrik23 ($147.94 in chips) 
Seat 2: vanilica ($100 in chips) 
Seat 3: matiko09 ($173.80 in chips) 
Seat 4: lydia12345 ($119.98 in chips) 
Seat 5: deadkiller1 ($101.32 in chips) 
Seat 6: Kihog ($145.69 in chips) 
Seat 7: rene1984tsv ($119.82 in chips) 
Seat 8: JACQUILF ($125.77 in chips) 
Seat 9: Moszes360 ($119.11 in chips) 
JACQUILF: posts small blind $0.50
Moszes360: posts big blind $1
*** HOLE CARDS ***
Dealt to matiko09 [4c 6c]
cobrik23: folds 
vanilica: raises $1.85 to $2.85
matiko09: folds 
lydia12345: folds 
deadkiller1: folds 
Kihog: folds 
rene1984tsv: calls $2.85
JACQUILF: folds 
Moszes360: folds 
*** FLOP *** [2d 5d 4s]
vanilica: bets $5.06
rene1984tsv: folds 
Uncalled bet ($5.06) returned to vanilica
vanilica collected $6.84 from pot
vanilica: doesn't show hand 
*** SUMMARY ***
Total pot $7.20 | Rake $0.36 
Board [2d 5d 4s]
Seat 1: cobrik23 folded before Flop (didn't bet)
Seat 2: vanilica collected ($6.84)
Seat 3: matiko09 folded before Flop (didn't bet)
Seat 4: lydia12345 folded before Flop (didn't bet)
Seat 5: deadkiller1 folded before Flop (didn't bet)
Seat 6: Kihog folded before Flop (didn't bet)
Seat 7: rene1984tsv (button) folded on the Flop
Seat 8: JACQUILF (small blind) folded before Flop
Seat 9: Moszes360 (big blind) folded before Flop





PokerStars Hand #153505101057:  Hold'em No Limit ($0.50/$1.00 USD) - 2016/05/18 21:25:29 CET [2016/05/18 15:25:29 ET]
Table 'Samitchell II' 9-max Seat #7 is the button
Seat 1: riggedsh** ($116.68 in chips) 
Seat 3: vanilica ($169.25 in chips) 
Seat 4: Zeeshka ($107.79 in chips) 
Seat 5: nuuaber ($46.66 in chips) 
Seat 6: Strikerman25 ($36.12 in chips) 
Seat 7: matiko09 ($122.15 in chips) 
Seat 8: rate8 ($123.02 in chips) 
Seat 9: janarr5 ($102.50 in chips) 
rate8: posts small blind $0.50
janarr5: posts big blind $1
*** HOLE CARDS ***
Dealt to matiko09 [7h 2h]
riggedsh**: raises $2 to $3
vanilica: folds 
Zeeshka: folds 
nuuaber: calls $3
Strikerman25: folds 
matiko09: folds 
rate8: folds 
janarr5: folds 
*** FLOP *** [Tc Th 3h]
riggedsh**: bets $2.34
nuuaber: raises $2.34 to $4.68
riggedsh**: calls $2.34
*** TURN *** [Tc Th 3h] [Kd]
riggedsh**: checks 
nuuaber: checks 
*** RIVER *** [Tc Th 3h Kd] [Ks]
riggedsh**: bets $5.28
nuuaber: raises $13.72 to $19
Mr. Booker T joins the table at seat #2 
riggedsh**: folds 
Uncalled bet ($13.72) returned to nuuaber
nuuaber collected $26.05 from pot
nuuaber: doesn't show hand 
*** SUMMARY ***
Total pot $27.42 | Rake $1.37 
Board [Tc Th 3h Kd Ks]
Seat 1: riggedsh** folded on the River
Seat 3: vanilica folded before Flop (didn't bet)
Seat 4: Zeeshka folded before Flop (didn't bet)
Seat 5: nuuaber collected ($26.05)
Seat 6: Strikerman25 folded before Flop (didn't bet)
Seat 7: matiko09 (button) folded before Flop (didn't bet)
Seat 8: rate8 (small blind) folded before Flop
Seat 9: janarr5 (big blind) folded before Flop





PokerStars Hand #153505103488:  Hold'em No Limit (€0.50/€1.00 EUR) - 2016/05/18 21:25:32 CET [2016/05/18 15:25:32 ET]
Table 'Pallas II' 9-max Seat #4 is the button
Seat 1: deadkiller1 (€204.81 in chips) 
Seat 2: matiko09 (€100 in chips) 
Seat 3: Ouga Buga (€101.50 in chips) 
Seat 4: torkkdnm (€159.81 in chips) 
Seat 5: vanilica (€100 in chips) 
Seat 6: janarr5 (€107.72 in chips) 
Seat 7: rate8 (€100 in chips) 
Seat 8: Kihog (€166.92 in chips) 
Seat 9: stijner1986 (€184.55 in chips) 
vanilica: posts small blind €0.50
janarr5: posts big blind €1
*** HOLE CARDS ***
Dealt to matiko09 [9s 3s]
rate8: folds 
Kihog: folds 
stijner1986: calls €1
deadkiller1: folds 
matiko09: folds 
Ouga Buga: folds 
torkkdnm: raises €4 to €5
vanilica: folds 
janarr5: folds 
stijner1986: calls €4
*** FLOP *** [5c Jc Th]
stijner1986: checks 
torkkdnm: bets €10
stijner1986: calls €10
*** TURN *** [5c Jc Th] [7d]
stijner1986: checks 
torkkdnm: bets €19
stijner1986: folds 
Uncalled bet (€19) returned to torkkdnm
torkkdnm collected €29.92 from pot
*** SUMMARY ***
Total pot €31.50 | Rake €1.58 
Board [5c Jc Th 7d]
Seat 1: deadkiller1 folded before Flop (didn't bet)
Seat 2: matiko09 folded before Flop (didn't bet)
Seat 3: Ouga Buga folded before Flop (didn't bet)
Seat 4: torkkdnm (button) collected (€29.92)
Seat 5: vanilica (small blind) folded before Flop
Seat 6: janarr5 (big blind) folded before Flop
Seat 7: rate8 folded before Flop (didn't bet)
Seat 8: Kihog folded before Flop (didn't bet)
Seat 9: stijner1986 folded on the Turn





PokerStars Hand #153505111383:  Hold'em No Limit ($0.50/$1.00 USD) - 2016/05/18 21:25:41 CET [2016/05/18 15:25:41 ET]
Table 'Lorcia II' 9-max Seat #1 is the button
Seat 1: HomerrrJay ($115.75 in chips) 
Seat 2: lydia12345 ($133.75 in chips) 
Seat 3: matiko09 ($100 in chips) 
Seat 4: vanilica ($120.06 in chips) 
Seat 5: nuuaber ($161.33 in chips) 
Seat 6: gkm0nk3y ($100 in chips) 
Seat 8: Skum1986 ($104.41 in chips) 
lydia12345: posts small blind $0.50
matiko09: posts big blind $1
rate8: sits out 
*** HOLE CARDS ***
Dealt to matiko09 [9d Js]
vanilica: folds 
nuuaber: raises $3 to $4
gkm0nk3y: folds 
Skum1986: calls $4
HomerrrJay: folds 
lydia12345: folds 
matiko09: folds 
*** FLOP *** [5c Kc 7s]
nuuaber: bets $3
Skum1986: calls $3
*** TURN *** [5c Kc 7s] [7h]
nuuaber: bets $3
Skum1986: calls $3
*** RIVER *** [5c Kc 7s 7h] [6c]
nuuaber: bets $10
Skum1986: folds 
Uncalled bet ($10) returned to nuuaber
nuuaber collected $20.42 from pot
nuuaber: doesn't show hand 
*** SUMMARY ***
Total pot $21.50 | Rake $1.08 
Board [5c Kc 7s 7h 6c]
Seat 1: HomerrrJay (button) folded before Flop (didn't bet)
Seat 2: lydia12345 (small blind) folded before Flop
Seat 3: matiko09 (big blind) folded before Flop
Seat 4: vanilica folded before Flop (didn't bet)
Seat 5: nuuaber collected ($20.42)
Seat 6: gkm0nk3y folded before Flop (didn't bet)
Seat 8: Skum1986 folded on the River





PokerStars Hand #153505122565:  Hold'em No Limit ($0.50/$1.00 USD) - 2016/05/18 21:25:53 CET [2016/05/18 15:25:53 ET]
Table 'Abetti II' 9-max Seat #1 is the button
Seat 1: matiko09 ($100 in chips) 
Seat 3: cobrik23 ($156.78 in chips) 
Seat 4: ipashutapkom ($40 in chips) 
Seat 5: blufthenuts ($149.97 in chips) 
Seat 6: Kihog ($100 in chips) 
Seat 8: roadster683 ($192.49 in chips) 
Seat 9: lydia12345 ($287.13 in chips) 
torkkdnm will be allowed to play after the button
cobrik23: posts small blind $0.50
ipashutapkom: posts big blind $1
rate8: sits out 
*** HOLE CARDS ***
Dealt to matiko09 [3d Ks]
blufthenuts: folds 
Kihog: folds 
roadster683: folds 
lydia12345: raises $2 to $3
matiko09: folds 
cobrik23: folds 
ipashutapkom: folds 
Uncalled bet ($2) returned to lydia12345
lydia12345 collected $2.50 from pot
*** SUMMARY ***
Total pot $2.50 | Rake $0 
Seat 1: matiko09 (button) folded before Flop (didn't bet)
Seat 3: cobrik23 (small blind) folded before Flop
Seat 4: ipashutapkom (big blind) folded before Flop
Seat 5: blufthenuts folded before Flop (didn't bet)
Seat 6: Kihog folded before Flop (didn't bet)
Seat 8: roadster683 folded before Flop (didn't bet)
Seat 9: lydia12345 collected ($2.50)





PokerStars Hand #153505138512:  Hold'em No Limit ($0.50/$1.00 USD) - 2016/05/18 21:26:11 CET [2016/05/18 15:26:11 ET]
Table 'Tatjana III' 9-max Seat #8 is the button
Seat 1: cobrik23 ($147.94 in chips) 
Seat 2: vanilica ($103.99 in chips) 
Seat 3: matiko09 ($173.80 in chips) 
Seat 4: lydia12345 ($119.98 in chips) 
Seat 5: deadkiller1 ($101.32 in chips) 
Seat 6: Kihog ($145.69 in chips) 
Seat 7: rene1984tsv ($116.97 in chips) 
Seat 8: JACQUILF ($125.27 in chips) 
Seat 9: Moszes360 ($118.11 in chips) 
Moszes360: posts small blind $0.50
cobrik23: posts big blind $1
*** HOLE CARDS ***
Dealt to matiko09 [7h Ac]
vanilica: folds 
matiko09: folds 
lydia12345: folds 
deadkiller1: folds 
Kihog: folds 
rene1984tsv: folds 
JACQUILF: folds 
Moszes360: raises $2 to $3
cobrik23: calls $2
*** FLOP *** [Js 5s 4s]
Moszes360: checks 
cobrik23: checks 
*** TURN *** [Js 5s 4s] [3d]
Moszes360: checks 
cobrik23: checks 
*** RIVER *** [Js 5s 4s 3d] [8c]
Moszes360: checks 
cobrik23: checks 
*** SHOW DOWN ***
Moszes360: shows [Qd Kc] (high card King)
cobrik23: shows [Ad 9d] (high card Ace)
cobrik23 collected $5.70 from pot
*** SUMMARY ***
Total pot $6 | Rake $0.30 
Board [Js 5s 4s 3d 8c]
Seat 1: cobrik23 (big blind) showed [Ad 9d] and won ($5.70) with high card Ace
Seat 2: vanilica folded before Flop (didn't bet)
Seat 3: matiko09 folded before Flop (didn't bet)
Seat 4: lydia12345 folded before Flop (didn't bet)
Seat 5: deadkiller1 folded before Flop (didn't bet)
Seat 6: Kihog folded before Flop (didn't bet)
Seat 7: rene1984tsv folded before Flop (didn't bet)
Seat 8: JACQUILF (button) folded before Flop (didn't bet)
Seat 9: Moszes360 (small blind) showed [Qd Kc] and lost with high card King





PokerStars Hand #153505141600:  Hold'em No Limit ($0.50/$1.00 USD) - 2016/05/18 21:26:14 CET [2016/05/18 15:26:14 ET]
Table 'Zaurak II' 9-max Seat #1 is the button
Seat 1: TimStone ($111.42 in chips) 
Seat 2: matiko09 ($100 in chips) 
Seat 3: janarr5 ($121.38 in chips) 
Seat 4: cobrik23 ($40 in chips) 
Seat 5: rate8 ($120.18 in chips) 
Seat 6: deadkiller1 ($114.36 in chips) 
Seat 7: Kihog ($100 in chips) 
Seat 8: Asgel22 ($220.82 in chips) 
Seat 9: torkkdnm ($105.45 in chips) 
matiko09: posts small blind $0.50
janarr5: posts big blind $1
*** HOLE CARDS ***
Dealt to matiko09 [As Jc]
cobrik23: folds 
rate8: folds 
deadkiller1: folds 
Kihog: folds 
Asgel22: folds 
torkkdnm: folds 
cobrik23 leaves the table
TimStone: folds 
matiko09: raises $1.50 to $2.50
janarr5: raises $6.50 to $9
matiko09: calls $6.50
*** FLOP *** [Kc 6c Th]
matiko09: checks 
janarr5: bets $9
matiko09: folds 
Uncalled bet ($9) returned to janarr5
janarr5 collected $17.10 from pot
janarr5: doesn't show hand 
*** SUMMARY ***
Total pot $18 | Rake $0.90 
Board [Kc 6c Th]
Seat 1: TimStone (button) folded before Flop (didn't bet)
Seat 2: matiko09 (small blind) folded on the Flop
Seat 3: janarr5 (big blind) collected ($17.10)
Seat 4: cobrik23 folded before Flop (didn't bet)
Seat 5: rate8 folded before Flop (didn't bet)
Seat 6: deadkiller1 folded before Flop (didn't bet)
Seat 7: Kihog folded before Flop (didn't bet)
Seat 8: Asgel22 folded before Flop (didn't bet)
Seat 9: torkkdnm folded before Flop (didn't bet)





PokerStars Hand #153505141091:  Hold'em No Limit ($0.50/$1.00 USD) - 2016/05/18 21:26:14 CET [2016/05/18 15:26:14 ET]
Table 'Abetti II' 9-max Seat #3 is the button
Seat 1: matiko09 ($100 in chips) 
Seat 3: cobrik23 ($156.28 in chips) 
Seat 4: ipashutapkom ($40 in chips) 
Seat 5: blufthenuts ($149.97 in chips) 
Seat 6: Kihog ($100 in chips) 
Seat 8: roadster683 ($192.49 in chips) 
Seat 9: lydia12345 ($288.63 in chips) 
ipashutapkom: posts small blind $0.50
blufthenuts: posts big blind $1
rate8: sits out 
torkkdnm: sits out 
*** HOLE CARDS ***
Dealt to matiko09 [4s Qd]
Kihog: folds 
roadster683: calls $1
lydia12345: folds 
matiko09: folds 
cobrik23: folds 
ipashutapkom: folds 
blufthenuts: checks 
*** FLOP *** [Kh 3h 2d]
blufthenuts: checks 
roadster683: bets $2
blufthenuts: folds 
Uncalled bet ($2) returned to roadster683
roadster683 collected $2.38 from pot
roadster683: doesn't show hand 
*** SUMMARY ***
Total pot $2.50 | Rake $0.12 
Board [Kh 3h 2d]
Seat 1: matiko09 folded before Flop (didn't bet)
Seat 3: cobrik23 (button) folded before Flop (didn't bet)
Seat 4: ipashutapkom (small blind) folded before Flop
Seat 5: blufthenuts (big blind) folded on the Flop
Seat 6: Kihog folded before Flop (didn't bet)
Seat 8: roadster683 collected ($2.38)
Seat 9: lydia12345 folded before Flop (didn't bet)





PokerStars Hand #153505148460:  Hold'em No Limit ($0.50/$1.00 USD) - 2016/05/18 21:26:22 CET [2016/05/18 15:26:22 ET]
Table 'Brendelia II' 9-max Seat #6 is the button
Seat 1: vanilica ($101.70 in chips) 
Seat 2: LebzLouda ($46.28 in chips) 
Seat 3: Zeeshka ($101.50 in chips) 
Seat 4: gkm0nk3y ($104.12 in chips) 
Seat 5: Vulturinus ($75.27 in chips) 
Seat 6: TimStone ($136.17 in chips) 
Seat 7: matiko09 ($103.50 in chips) 
Seat 8: solbi86 ($100 in chips) 
Seat 9: Kihog ($123.88 in chips) 
matiko09: posts small blind $0.50
solbi86: posts big blind $1
*** HOLE CARDS ***
Dealt to matiko09 [Js Qh]
Kihog: raises $1.50 to $2.50
vanilica: folds 
LebzLouda: folds 
Zeeshka: folds 
gkm0nk3y: folds 
Vulturinus: folds 
TimStone: folds 
matiko09: folds 
solbi86: folds 
Uncalled bet ($1.50) returned to Kihog
Kihog collected $2.50 from pot
Kihog: doesn't show hand 
*** SUMMARY ***
Total pot $2.50 | Rake $0 
Seat 1: vanilica folded before Flop (didn't bet)
Seat 2: LebzLouda folded before Flop (didn't bet)
Seat 3: Zeeshka folded before Flop (didn't bet)
Seat 4: gkm0nk3y folded before Flop (didn't bet)
Seat 5: Vulturinus folded before Flop (didn't bet)
Seat 6: TimStone (button) folded before Flop (didn't bet)
Seat 7: matiko09 (small blind) folded before Flop
Seat 8: solbi86 (big blind) folded before Flop
Seat 9: Kihog collected ($2.50)





PokerStars Hand #153505162485:  Hold'em No Limit (€0.50/€1.00 EUR) - 2016/05/18 21:26:37 CET [2016/05/18 15:26:37 ET]
Table 'Pallas II' 9-max Seat #5 is the button
Seat 1: deadkiller1 (€204.81 in chips) 
Seat 2: matiko09 (€100 in chips) 
Seat 3: Ouga Buga (€101.50 in chips) 
Seat 4: torkkdnm (€174.73 in chips) 
Seat 5: vanilica (€100 in chips) 
Seat 6: janarr5 (€106.72 in chips) 
Seat 7: rate8 (€100 in chips) 
Seat 8: Kihog (€166.92 in chips) 
Seat 9: stijner1986 (€169.55 in chips) 
janarr5: posts small blind €0.50
rate8: posts big blind €1
*** HOLE CARDS ***
Dealt to matiko09 [2c 5d]
Kihog: folds 
stijner1986: raises €2 to €3
deadkiller1: folds 
matiko09: folds 
Ouga Buga: folds 
torkkdnm: folds 
vanilica: folds 
janarr5: folds 
rate8: folds 
Uncalled bet (€2) returned to stijner1986
stijner1986 collected €2.50 from pot
stijner1986: doesn't show hand 
*** SUMMARY ***
Total pot €2.50 | Rake €0 
Seat 1: deadkiller1 folded before Flop (didn't bet)
Seat 2: matiko09 folded before Flop (didn't bet)
Seat 3: Ouga Buga folded before Flop (didn't bet)
Seat 4: torkkdnm folded before Flop (didn't bet)
Seat 5: vanilica (button) folded before Flop (didn't bet)
Seat 6: janarr5 (small blind) folded before Flop
Seat 7: rate8 (big blind) folded before Flop
Seat 8: Kihog folded before Flop (didn't bet)
Seat 9: stijner1986 collected (€2.50)





PokerStars Hand #153505174416:  Hold'em No Limit ($0.50/$1.00 USD) - 2016/05/18 21:26:50 CET [2016/05/18 15:26:50 ET]
Table 'Brendelia II' 9-max Seat #7 is the button
Seat 1: vanilica ($101.70 in chips) 
Seat 2: LebzLouda ($46.28 in chips) 
Seat 3: Zeeshka ($101.50 in chips) 
Seat 4: gkm0nk3y ($104.12 in chips) 
Seat 5: Vulturinus ($75.27 in chips) 
Seat 6: TimStone ($136.17 in chips) 
Seat 7: matiko09 ($103 in chips) 
Seat 8: solbi86 ($100 in chips) 
Seat 9: Kihog ($125.38 in chips) 
solbi86: posts small blind $0.50
Kihog: posts big blind $1
*** HOLE CARDS ***
Dealt to matiko09 [4h 9s]
vanilica: folds 
LebzLouda: raises $2 to $3
Zeeshka: folds 
gkm0nk3y: folds 
Vulturinus: folds 
TimStone: folds 
matiko09: folds 
solbi86: folds 
Kihog: folds 
Uncalled bet ($2) returned to LebzLouda
LebzLouda collected $2.50 from pot
LebzLouda: doesn't show hand 
*** SUMMARY ***
Total pot $2.50 | Rake $0 
Seat 1: vanilica folded before Flop (didn't bet)
Seat 2: LebzLouda collected ($2.50)
Seat 3: Zeeshka folded before Flop (didn't bet)
Seat 4: gkm0nk3y folded before Flop (didn't bet)
Seat 5: Vulturinus folded before Flop (didn't bet)
Seat 6: TimStone folded before Flop (didn't bet)
Seat 7: matiko09 (button) folded before Flop (didn't bet)
Seat 8: solbi86 (small blind) folded before Flop
Seat 9: Kihog (big blind) folded before Flop





PokerStars Hand #153505181799:  Hold'em No Limit ($0.50/$1.00 USD) - 2016/05/18 21:26:58 CET [2016/05/18 15:26:58 ET]
Table 'Lorcia II' 9-max Seat #2 is the button
Seat 1: HomerrrJay ($115.75 in chips) 
Seat 2: lydia12345 ($133.25 in chips) 
Seat 3: matiko09 ($100 in chips) 
Seat 4: vanilica ($120.06 in chips) 
Seat 5: nuuaber ($171.75 in chips) 
Seat 6: gkm0nk3y ($100 in chips) 
Seat 8: Skum1986 ($100 in chips) 
matiko09: posts small blind $0.50
vanilica: posts big blind $1
rate8: sits out 
*** HOLE CARDS ***
Dealt to matiko09 [Ad Ac]
nuuaber: folds 
gkm0nk3y: folds 
Skum1986: folds 
HomerrrJay: folds 
lydia12345: raises $1 to $2
matiko09: raises $6 to $8
vanilica: folds 
lydia12345: calls $6
*** FLOP *** [2h Kd 6c]
matiko09: bets $8.39
lydia12345: calls $8.39
*** TURN *** [2h Kd 6c] [5d]
matiko09: bets $18
lydia12345: folds 
Uncalled bet ($18) returned to matiko09
matiko09 collected $32.09 from pot
matiko09: doesn't show hand 
*** SUMMARY ***
Total pot $33.78 | Rake $1.69 
Board [2h Kd 6c 5d]
Seat 1: HomerrrJay folded before Flop (didn't bet)
Seat 2: lydia12345 (button) folded on the Turn
Seat 3: matiko09 (small blind) collected ($32.09)
Seat 4: vanilica (big blind) folded before Flop
Seat 5: nuuaber folded before Flop (didn't bet)
Seat 6: gkm0nk3y folded before Flop (didn't bet)
Seat 8: Skum1986 folded before Flop (didn't bet)





PokerStars Hand #153505187580:  Hold'em No Limit ($0.50/$1.00 USD) - 2016/05/18 21:27:05 CET [2016/05/18 15:27:05 ET]
Table 'Samitchell II' 9-max Seat #8 is the button
Seat 1: riggedsh** ($103.72 in chips) 
Seat 3: vanilica ($169.25 in chips) 
Seat 4: Zeeshka ($107.79 in chips) 
Seat 5: nuuaber ($59.75 in chips) 
Seat 6: Strikerman25 ($36.12 in chips) 
Seat 7: matiko09 ($122.15 in chips) 
Seat 8: rate8 ($122.52 in chips) 
Seat 9: janarr5 ($101.50 in chips) 
janarr5: posts small blind $0.50
riggedsh**: posts big blind $1
Mr. Booker T: sits out 
*** HOLE CARDS ***
Dealt to matiko09 [2c 9d]
Mr. Booker T leaves the table
vanilica: folds 
Zeeshka: raises $2 to $3
nuuaber: folds 
Strikerman25: folds 
matiko09: folds 
rate8: folds 
janarr5: folds 
riggedsh**: folds 
Uncalled bet ($2) returned to Zeeshka
Zeeshka collected $2.50 from pot
Zeeshka: doesn't show hand 
*** SUMMARY ***
Total pot $2.50 | Rake $0 
Seat 1: riggedsh** (big blind) folded before Flop
Seat 3: vanilica folded before Flop (didn't bet)
Seat 4: Zeeshka collected ($2.50)
Seat 5: nuuaber folded before Flop (didn't bet)
Seat 6: Strikerman25 folded before Flop (didn't bet)
Seat 7: matiko09 folded before Flop (didn't bet)
Seat 8: rate8 (button) folded before Flop (didn't bet)
Seat 9: janarr5 (small blind) folded before Flop





PokerStars Hand #153505190510:  Hold'em No Limit ($0.50/$1.00 USD) - 2016/05/18 21:27:08 CET [2016/05/18 15:27:08 ET]
Table 'Zaurak II' 9-max Seat #2 is the button
Seat 1: TimStone ($111.42 in chips) 
Seat 2: matiko09 ($100 in chips) 
Seat 3: janarr5 ($129.48 in chips) 
Seat 5: rate8 ($120.18 in chips) 
Seat 6: deadkiller1 ($114.36 in chips) 
Seat 7: Kihog ($100 in chips) 
Seat 8: Asgel22 ($220.82 in chips) 
Seat 9: torkkdnm ($105.45 in chips) 
janarr5: posts small blind $0.50
rate8: posts big blind $1
*** HOLE CARDS ***
Dealt to matiko09 [8h Kc]
deadkiller1: folds 
Kihog: raises $1.50 to $2.50
Asgel22: folds 
torkkdnm: folds 
Mumerka joins the table at seat #4 
TimStone: folds 
matiko09: folds 
janarr5: folds 
Mumerka leaves the table
rate8: calls $1.50
*** FLOP *** [9d 5d Qh]
rate8: checks 
Kihog: checks 
*** TURN *** [9d 5d Qh] [5s]
rate8: checks 
solbi86 joins the table at seat #4 
Kihog: bets $3
rate8: folds 
Uncalled bet ($3) returned to Kihog
Kihog collected $5.22 from pot
Kihog: doesn't show hand 
*** SUMMARY ***
Total pot $5.50 | Rake $0.28 
Board [9d 5d Qh 5s]
Seat 1: TimStone folded before Flop (didn't bet)
Seat 2: matiko09 (button) folded before Flop (didn't bet)
Seat 3: janarr5 (small blind) folded before Flop
Seat 5: rate8 (big blind) folded on the Turn
Seat 6: deadkiller1 folded before Flop (didn't bet)
Seat 7: Kihog collected ($5.22)
Seat 8: Asgel22 folded before Flop (didn't bet)
Seat 9: torkkdnm folded before Flop (didn't bet)





PokerStars Hand #153505195818:  Hold'em No Limit ($0.50/$1.00 USD) - 2016/05/18 21:27:14 CET [2016/05/18 15:27:14 ET]
Table 'Abetti II' 9-max Seat #4 is the button
Seat 1: matiko09 ($100 in chips) 
Seat 3: cobrik23 ($156.28 in chips) 
Seat 4: ipashutapkom ($40 in chips) 
Seat 5: blufthenuts ($148.97 in chips) 
Seat 6: Kihog ($100 in chips) 
Seat 8: roadster683 ($193.87 in chips) 
Seat 9: lydia12345 ($288.63 in chips) 
blufthenuts: posts small blind $0.50
Kihog: posts big blind $1
rate8: sits out 
torkkdnm: sits out 
*** HOLE CARDS ***
Dealt to matiko09 [Kd 7c]
roadster683: folds 
lydia12345: raises $2 to $3
matiko09: folds 
cobrik23: folds 
ipashutapkom: folds 
blufthenuts: folds 
Kihog: folds 
Uncalled bet ($2) returned to lydia12345
lydia12345 collected $2.50 from pot
*** SUMMARY ***
Total pot $2.50 | Rake $0 
Seat 1: matiko09 folded before Flop (didn't bet)
Seat 3: cobrik23 folded before Flop (didn't bet)
Seat 4: ipashutapkom (button) folded before Flop (didn't bet)
Seat 5: blufthenuts (small blind) folded before Flop
Seat 6: Kihog (big blind) folded before Flop
Seat 8: roadster683 folded before Flop (didn't bet)
Seat 9: lydia12345 collected ($2.50)





PokerStars Hand #153505198827:  Hold'em No Limit (€0.50/€1.00 EUR) - 2016/05/18 21:27:17 CET [2016/05/18 15:27:17 ET]
Table 'Pallas II' 9-max Seat #6 is the button
Seat 1: deadkiller1 (€204.81 in chips) 
Seat 2: matiko09 (€100 in chips) 
Seat 3: Ouga Buga (€101.50 in chips) 
Seat 4: torkkdnm (€174.73 in chips) 
Seat 5: vanilica (€100 in chips) 
Seat 6: janarr5 (€106.22 in chips) 
Seat 7: rate8 (€100 in chips) 
Seat 8: Kihog (€166.92 in chips) 
Seat 9: stijner1986 (€171.05 in chips) 
rate8: posts small blind €0.50
Kihog: posts big blind €1
*** HOLE CARDS ***
Dealt to matiko09 [6h 4c]
stijner1986: folds 
deadkiller1: raises €2 to €3
matiko09: folds 
Ouga Buga: folds 
torkkdnm: folds 
vanilica: folds 
janarr5: folds 
rate8: folds 
Kihog: folds 
Uncalled bet (€2) returned to deadkiller1
deadkiller1 collected €2.50 from pot
deadkiller1: doesn't show hand 
*** SUMMARY ***
Total pot €2.50 | Rake €0 
Seat 1: deadkiller1 collected (€2.50)
Seat 2: matiko09 folded before Flop (didn't bet)
Seat 3: Ouga Buga folded before Flop (didn't bet)
Seat 4: torkkdnm folded before Flop (didn't bet)
Seat 5: vanilica folded before Flop (didn't bet)
Seat 6: janarr5 (button) folded before Flop (didn't bet)
Seat 7: rate8 (small blind) folded before Flop
Seat 8: Kihog (big blind) folded before Flop
Seat 9: stijner1986 folded before Flop (didn't bet)





PokerStars Hand #153505201365:  Hold'em No Limit ($0.50/$1.00 USD) - 2016/05/18 21:27:20 CET [2016/05/18 15:27:20 ET]
Table 'Brendelia II' 9-max Seat #8 is the button
Seat 1: vanilica ($101.70 in chips) 
Seat 2: LebzLouda ($47.78 in chips) 
Seat 3: Zeeshka ($101.50 in chips) 
Seat 4: gkm0nk3y ($104.12 in chips) 
Seat 5: Vulturinus ($75.27 in chips) 
Seat 6: TimStone ($136.17 in chips) 
Seat 7: matiko09 ($103 in chips) 
Seat 8: solbi86 ($100 in chips) 
Seat 9: Kihog ($124.38 in chips) 
Kihog: posts small blind $0.50
vanilica: posts big blind $1
*** HOLE CARDS ***
Dealt to matiko09 [As Ts]
LebzLouda: folds 
Zeeshka: folds 
gkm0nk3y: raises $2 to $3
Vulturinus: folds 
TimStone: folds 
matiko09: calls $3
solbi86: folds 
Kihog: folds 
vanilica: folds 
*** FLOP *** [9d 8s Qh]
gkm0nk3y: checks 
matiko09: bets $4.63
gkm0nk3y: folds 
Uncalled bet ($4.63) returned to matiko09
matiko09 collected $7.12 from pot
matiko09: doesn't show hand 
*** SUMMARY ***
Total pot $7.50 | Rake $0.38 
Board [9d 8s Qh]
Seat 1: vanilica (big blind) folded before Flop
Seat 2: LebzLouda folded before Flop (didn't bet)
Seat 3: Zeeshka folded before Flop (didn't bet)
Seat 4: gkm0nk3y folded on the Flop
Seat 5: Vulturinus folded before Flop (didn't bet)
Seat 6: TimStone folded before Flop (didn't bet)
Seat 7: matiko09 collected ($7.12)
Seat 8: solbi86 (button) folded before Flop (didn't bet)
Seat 9: Kihog (small blind) folded before Flop





PokerStars Hand #153505208049:  Hold'em No Limit ($0.50/$1.00 USD) - 2016/05/18 21:27:27 CET [2016/05/18 15:27:27 ET]
Table 'Tatjana III' 9-max Seat #9 is the button
Seat 1: cobrik23 ($150.64 in chips) 
Seat 2: vanilica ($103.99 in chips) 
Seat 3: matiko09 ($173.80 in chips) 
Seat 4: lydia12345 ($119.98 in chips) 
Seat 5: deadkiller1 ($101.32 in chips) 
Seat 6: Kihog ($145.69 in chips) 
Seat 7: rene1984tsv ($116.97 in chips) 
Seat 8: JACQUILF ($125.27 in chips) 
Seat 9: Moszes360 ($115.11 in chips) 
cobrik23: posts small blind $0.50
vanilica: posts big blind $1
*** HOLE CARDS ***
Dealt to matiko09 [6s 9c]
matiko09: folds 
lydia12345: folds 
deadkiller1: folds 
Kihog: folds 
rene1984tsv: raises $2 to $3
JACQUILF: folds 
Moszes360: calls $3
cobrik23: folds 
vanilica: raises $11 to $14
rene1984tsv: calls $11
Moszes360: folds 
*** FLOP *** [6d Qc 2c]
vanilica: bets $13
rene1984tsv: raises $23 to $36
vanilica: folds 
Uncalled bet ($23) returned to rene1984tsv
rene1984tsv collected $55 from pot
rene1984tsv: doesn't show hand 
*** SUMMARY ***
Total pot $57.50 | Rake $2.50 
Board [6d Qc 2c]
Seat 1: cobrik23 (small blind) folded before Flop
Seat 2: vanilica (big blind) folded on the Flop
Seat 3: matiko09 folded before Flop (didn't bet)
Seat 4: lydia12345 folded before Flop (didn't bet)
Seat 5: deadkiller1 folded before Flop (didn't bet)
Seat 6: Kihog folded before Flop (didn't bet)
Seat 7: rene1984tsv collected ($55)
Seat 8: JACQUILF folded before Flop (didn't bet)
Seat 9: Moszes360 (button) folded before Flop





PokerStars Hand #153505215571:  Hold'em No Limit ($0.50/$1.00 USD) - 2016/05/18 21:27:35 CET [2016/05/18 15:27:35 ET]
Table 'Samitchell II' 9-max Seat #9 is the button
Seat 1: riggedsh** ($102.72 in chips) 
Seat 3: vanilica ($169.25 in chips) 
Seat 4: Zeeshka ($109.29 in chips) 
Seat 5: nuuaber ($59.75 in chips) 
Seat 6: Strikerman25 ($36.12 in chips) 
Seat 7: matiko09 ($122.15 in chips) 
Seat 8: rate8 ($122.52 in chips) 
Seat 9: janarr5 ($101 in chips) 
riggedsh**: posts small blind $0.50
vanilica: posts big blind $1
*** HOLE CARDS ***
Dealt to matiko09 [4s 7d]
Zeeshka: folds 
nuuaber: folds 
Strikerman25: folds 
matiko09: folds 
rate8: raises $2 to $3
janarr5: folds 
riggedsh**: folds 
vanilica: folds 
Uncalled bet ($2) returned to rate8
rate8 collected $2.50 from pot
rate8: doesn't show hand 
*** SUMMARY ***
Total pot $2.50 | Rake $0 
Seat 1: riggedsh** (small blind) folded before Flop
Seat 3: vanilica (big blind) folded before Flop
Seat 4: Zeeshka folded before Flop (didn't bet)
Seat 5: nuuaber folded before Flop (didn't bet)
Seat 6: Strikerman25 folded before Flop (didn't bet)
Seat 7: matiko09 folded before Flop (didn't bet)
Seat 8: rate8 collected ($2.50)
Seat 9: janarr5 (button) folded before Flop (didn't bet)





PokerStars Hand #153505232509:  Hold'em No Limit ($0.50/$1.00 USD) - 2016/05/18 21:27:54 CET [2016/05/18 15:27:54 ET]
Table 'Abetti II' 9-max Seat #5 is the button
Seat 1: matiko09 ($100 in chips) 
Seat 3: cobrik23 ($156.28 in chips) 
Seat 4: ipashutapkom ($40 in chips) 
Seat 5: blufthenuts ($148.47 in chips) 
Seat 6: Kihog ($100 in chips) 
Seat 7: rate8 ($105.78 in chips) 
Seat 8: roadster683 ($193.87 in chips) 
Seat 9: lydia12345 ($290.13 in chips) 
Kihog: posts small blind $0.50
rate8: posts big blind $1
torkkdnm: sits out 
*** HOLE CARDS ***
Dealt to matiko09 [Ah Td]
roadster683: calls $1
lydia12345: folds 
matiko09: raises $4 to $5
cobrik23: folds 
ipashutapkom: folds 
blufthenuts: folds 
Kihog: folds 
rate8: folds 
roadster683: calls $4
*** FLOP *** [Js Ac 6d]
roadster683: checks 
matiko09: checks 
*** TURN *** [Js Ac 6d] [Ks]
roadster683: bets $5
matiko09: calls $5
*** RIVER *** [Js Ac 6d Ks] [4d]
roadster683: checks 
matiko09: bets $10
roadster683: folds 
Uncalled bet ($10) returned to matiko09
matiko09 collected $20.42 from pot
matiko09: doesn't show hand 
*** SUMMARY ***
Total pot $21.50 | Rake $1.08 
Board [Js Ac 6d Ks 4d]
Seat 1: matiko09 collected ($20.42)
Seat 3: cobrik23 folded before Flop (didn't bet)
Seat 4: ipashutapkom folded before Flop (didn't bet)
Seat 5: blufthenuts (button) folded before Flop (didn't bet)
Seat 6: Kihog (small blind) folded before Flop
Seat 7: rate8 (big blind) folded before Flop
Seat 8: roadster683 folded on the River
Seat 9: lydia12345 folded before Flop (didn't bet)





PokerStars Hand #153505240816:  Hold'em No Limit (€0.50/€1.00 EUR) - 2016/05/18 21:28:03 CET [2016/05/18 15:28:03 ET]
Table 'Pallas II' 9-max Seat #7 is the button
Seat 1: deadkiller1 (€206.31 in chips) 
Seat 2: matiko09 (€100 in chips) 
Seat 3: Ouga Buga (€101.50 in chips) 
Seat 4: torkkdnm (€174.73 in chips) 
Seat 5: vanilica (€100 in chips) 
Seat 6: janarr5 (€106.22 in chips) 
Seat 7: rate8 (€100 in chips) 
Seat 8: Kihog (€165.92 in chips) 
Seat 9: stijner1986 (€171.05 in chips) 
Kihog: posts small blind €0.50
stijner1986: posts big blind €1
*** HOLE CARDS ***
Dealt to matiko09 [3h 9c]
deadkiller1: folds 
matiko09: folds 
Ouga Buga: folds 
torkkdnm: folds 
vanilica: folds 
janarr5: folds 
rate8: folds 
Kihog: raises €1.50 to €2.50
stijner1986: folds 
Uncalled bet (€1.50) returned to Kihog
Kihog collected €2 from pot
Kihog: doesn't show hand 
*** SUMMARY ***
Total pot €2 | Rake €0 
Seat 1: deadkiller1 folded before Flop (didn't bet)
Seat 2: matiko09 folded before Flop (didn't bet)
Seat 3: Ouga Buga folded before Flop (didn't bet)
Seat 4: torkkdnm folded before Flop (didn't bet)
Seat 5: vanilica folded before Flop (didn't bet)
Seat 6: janarr5 folded before Flop (didn't bet)
Seat 7: rate8 (button) folded before Flop (didn't bet)
Seat 8: Kihog (small blind) collected (€2)
Seat 9: stijner1986 (big blind) folded before Flop





PokerStars Hand #153505242544:  Hold'em No Limit ($0.50/$1.00 USD) - 2016/05/18 21:28:05 CET [2016/05/18 15:28:05 ET]
Table 'Zaurak II' 9-max Seat #3 is the button
Seat 1: TimStone ($111.42 in chips) 
Seat 2: matiko09 ($100 in chips) 
Seat 3: janarr5 ($128.98 in chips) 
Seat 5: rate8 ($117.68 in chips) 
Seat 6: deadkiller1 ($114.36 in chips) 
Seat 7: Kihog ($102.72 in chips) 
Seat 8: Asgel22 ($220.82 in chips) 
Seat 9: torkkdnm ($105.45 in chips) 
solbi86 will be allowed to play after the button
rate8: posts small blind $0.50
deadkiller1: posts big blind $1
*** HOLE CARDS ***
Dealt to matiko09 [Ts Jd]
Kihog: folds 
Asgel22: folds 
torkkdnm: raises $2 to $3
TimStone: raises $6.85 to $9.85
matiko09: folds 
janarr5: folds 
rate8: folds 
deadkiller1: folds 
torkkdnm: calls $6.85
*** FLOP *** [Jc 3h 5s]
torkkdnm: checks 
TimStone: bets $10.98
torkkdnm: calls $10.98
*** TURN *** [Jc 3h 5s] [Ad]
torkkdnm: checks 
TimStone: bets $10.03
torkkdnm: raises $17.97 to $28
TimStone said, ":O"
TimStone said, "****ing nit"
TimStone: folds 
Uncalled bet ($17.97) returned to torkkdnm
torkkdnm collected $60.72 from pot
*** SUMMARY ***
Total pot $63.22 | Rake $2.50 
Board [Jc 3h 5s Ad]
Seat 1: TimStone folded on the Turn
Seat 2: matiko09 folded before Flop (didn't bet)
Seat 3: janarr5 (button) folded before Flop (didn't bet)
Seat 5: rate8 (small blind) folded before Flop
Seat 6: deadkiller1 (big blind) folded before Flop
Seat 7: Kihog folded before Flop (didn't bet)
Seat 8: Asgel22 folded before Flop (didn't bet)
Seat 9: torkkdnm collected ($60.72)





PokerStars Hand #153505244483:  Hold'em No Limit ($0.50/$1.00 USD) - 2016/05/18 21:28:07 CET [2016/05/18 15:28:07 ET]
Table 'Samitchell II' 9-max Seat #1 is the button
Seat 1: riggedsh** ($102.22 in chips) 
Seat 3: vanilica ($168.25 in chips) 
Seat 4: Zeeshka ($109.29 in chips) 
Seat 5: nuuaber ($59.75 in chips) 
Seat 6: Strikerman25 ($36.12 in chips) 
Seat 7: matiko09 ($122.15 in chips) 
Seat 8: rate8 ($124.02 in chips) 
Seat 9: janarr5 ($101 in chips) 
vanilica: posts small blind $0.50
Zeeshka: posts big blind $1
*** HOLE CARDS ***
Dealt to matiko09 [Ac Qs]
nuuaber: raises $2 to $3
Strikerman25: folds 
matiko09: raises $6 to $9
mooose100 joins the table at seat #2 
rate8: folds 
janarr5: folds 
riggedsh**: folds 
vanilica: folds 
Zeeshka: folds 
nuuaber: calls $6
*** FLOP *** [2h 4h 6h]
nuuaber: bets $19
matiko09: folds 
Uncalled bet ($19) returned to nuuaber
nuuaber collected $18.52 from pot
nuuaber: doesn't show hand 
*** SUMMARY ***
Total pot $19.50 | Rake $0.98 
Board [2h 4h 6h]
Seat 1: riggedsh** (button) folded before Flop (didn't bet)
Seat 3: vanilica (small blind) folded before Flop
Seat 4: Zeeshka (big blind) folded before Flop
Seat 5: nuuaber collected ($18.52)
Seat 6: Strikerman25 folded before Flop (didn't bet)
Seat 7: matiko09 folded on the Flop
Seat 8: rate8 folded before Flop (didn't bet)
Seat 9: janarr5 folded before Flop (didn't bet)





PokerStars Hand #153505245261:  Hold'em No Limit ($0.50/$1.00 USD) - 2016/05/18 21:28:08 CET [2016/05/18 15:28:08 ET]
Table 'Lorcia II' 9-max Seat #3 is the button
Seat 1: HomerrrJay ($115.75 in chips) 
Seat 2: lydia12345 ($116.86 in chips) 
Seat 3: matiko09 ($115.70 in chips) 
Seat 4: vanilica ($119.06 in chips) 
Seat 5: nuuaber ($171.75 in chips) 
Seat 6: gkm0nk3y ($100 in chips) 
Seat 8: Skum1986 ($100 in chips) 
vanilica: posts small blind $0.50
nuuaber: posts big blind $1
rate8: sits out 
*** HOLE CARDS ***
Dealt to matiko09 [Ks Td]
gkm0nk3y: folds 
Skum1986: folds 
HomerrrJay: folds 
lydia12345: folds 
matiko09: raises $1.27 to $2.27
vanilica: folds 
nuuaber: calls $1.27
*** FLOP *** [6c 2s 4h]
nuuaber: bets $1
matiko09: calls $1
*** TURN *** [6c 2s 4h] [4d]
nuuaber: bets $1
matiko09: calls $1
*** RIVER *** [6c 2s 4h 4d] [5h]
nuuaber: bets $1
matiko09: calls $1
*** SHOW DOWN ***
nuuaber: shows [2c Ah] (two pair, Fours and Deuces)
matiko09: mucks hand 
nuuaber collected $10.49 from pot
*** SUMMARY ***
Total pot $11.04 | Rake $0.55 
Board [6c 2s 4h 4d 5h]
Seat 1: HomerrrJay folded before Flop (didn't bet)
Seat 2: lydia12345 folded before Flop (didn't bet)
Seat 3: matiko09 (button) mucked [Ks Td]
Seat 4: vanilica (small blind) folded before Flop
Seat 5: nuuaber (big blind) showed [2c Ah] and won ($10.49) with two pair, Fours and Deuces
Seat 6: gkm0nk3y folded before Flop (didn't bet)
Seat 8: Skum1986 folded before Flop (didn't bet)





PokerStars Hand #153505270461:  Hold'em No Limit ($0.50/$1.00 USD) - 2016/05/18 21:28:36 CET [2016/05/18 15:28:36 ET]
Table 'Tatjana III' 9-max Seat #1 is the button
Seat 1: cobrik23 ($150.14 in chips) 
Seat 2: vanilica ($100 in chips) 
Seat 3: matiko09 ($173.80 in chips) 
Seat 4: lydia12345 ($119.98 in chips) 
Seat 5: deadkiller1 ($101.32 in chips) 
Seat 6: Kihog ($145.69 in chips) 
Seat 7: rene1984tsv ($144.97 in chips) 
Seat 8: JACQUILF ($125.27 in chips) 
Seat 9: Moszes360 ($112.11 in chips) 
vanilica: posts small blind $0.50
matiko09: posts big blind $1
*** HOLE CARDS ***
Dealt to matiko09 [7s 4s]
lydia12345: folds 
deadkiller1: folds 
Kihog: folds 
rene1984tsv: calls $1
JACQUILF: folds 
Moszes360: raises $3 to $4
cobrik23: raises $8 to $12
vanilica: folds 
matiko09: folds 
rene1984tsv: calls $11
Moszes360: folds 
*** FLOP *** [Jd 6d Th]
rene1984tsv: checks 
cobrik23: checks 
*** TURN *** [Jd 6d Th] [Qh]
rene1984tsv: checks 
cobrik23: bets $16
rene1984tsv: calls $16
*** RIVER *** [Jd 6d Th Qh] [6c]
rene1984tsv: checks 
cobrik23: bets $63
rene1984tsv: folds 
Uncalled bet ($63) returned to cobrik23
cobrik23 collected $59 from pot
cobrik23: doesn't show hand 
*** SUMMARY ***
Total pot $61.50 | Rake $2.50 
Board [Jd 6d Th Qh 6c]
Seat 1: cobrik23 (button) collected ($59)
Seat 2: vanilica (small blind) folded before Flop
Seat 3: matiko09 (big blind) folded before Flop
Seat 4: lydia12345 folded before Flop (didn't bet)
Seat 5: deadkiller1 folded before Flop (didn't bet)
Seat 6: Kihog folded before Flop (didn't bet)
Seat 7: rene1984tsv folded on the River
Seat 8: JACQUILF folded before Flop (didn't bet)
Seat 9: Moszes360 folded before Flop





PokerStars Hand #153505271812:  Hold'em No Limit (€0.50/€1.00 EUR) - 2016/05/18 21:28:37 CET [2016/05/18 15:28:37 ET]
Table 'Pallas II' 9-max Seat #8 is the button
Seat 1: deadkiller1 (€206.31 in chips) 
Seat 2: matiko09 (€100 in chips) 
Seat 3: Ouga Buga (€101.50 in chips) 
Seat 4: torkkdnm (€174.73 in chips) 
Seat 5: vanilica (€100 in chips) 
Seat 6: janarr5 (€106.22 in chips) 
Seat 7: rate8 (€100 in chips) 
Seat 8: Kihog (€166.92 in chips) 
Seat 9: stijner1986 (€170.05 in chips) 
stijner1986: posts small blind €0.50
deadkiller1: posts big blind €1
*** HOLE CARDS ***
Dealt to matiko09 [Kh 9c]
matiko09: folds 
Ouga Buga: folds 
torkkdnm: raises €2 to €3
vanilica: folds 
janarr5: folds 
rate8: folds 
Kihog: folds 
stijner1986: folds 
deadkiller1: folds 
Uncalled bet (€2) returned to torkkdnm
torkkdnm collected €2.50 from pot
*** SUMMARY ***
Total pot €2.50 | Rake €0 
Seat 1: deadkiller1 (big blind) folded before Flop
Seat 2: matiko09 folded before Flop (didn't bet)
Seat 3: Ouga Buga folded before Flop (didn't bet)
Seat 4: torkkdnm collected (€2.50)
Seat 5: vanilica folded before Flop (didn't bet)
Seat 6: janarr5 folded before Flop (didn't bet)
Seat 7: rate8 folded before Flop (didn't bet)
Seat 8: Kihog (button) folded before Flop (didn't bet)
Seat 9: stijner1986 (small blind) folded before Flop





PokerStars Hand #153505281514:  Hold'em No Limit ($0.50/$1.00 USD) - 2016/05/18 21:28:48 CET [2016/05/18 15:28:48 ET]
Table 'Samitchell II' 9-max Seat #3 is the button
Seat 1: riggedsh** ($102.22 in chips) 
Seat 3: vanilica ($167.75 in chips) 
Seat 4: Zeeshka ($108.29 in chips) 
Seat 5: nuuaber ($69.27 in chips) 
Seat 6: Strikerman25 ($36.12 in chips) 
Seat 7: matiko09 ($113.15 in chips) 
Seat 8: rate8 ($124.02 in chips) 
Seat 9: janarr5 ($101 in chips) 
Zeeshka: posts small blind $0.50
nuuaber: posts big blind $1
mooose100: sits out 
*** HOLE CARDS ***
Dealt to matiko09 [4h 5c]
Strikerman25: folds 
matiko09: folds 
rate8: folds 
janarr5: folds 
riggedsh**: folds 
vanilica: folds 
Zeeshka: raises $2 to $3
nuuaber: calls $2
*** FLOP *** [Tc Qd Th]
Zeeshka: checks 
nuuaber: checks 
*** TURN *** [Tc Qd Th] [Ts]
Zeeshka: checks 
nuuaber: bets $3
Zeeshka: folds 
Uncalled bet ($3) returned to nuuaber
nuuaber collected $5.70 from pot
nuuaber: doesn't show hand 
*** SUMMARY ***
Total pot $6 | Rake $0.30 
Board [Tc Qd Th Ts]
Seat 1: riggedsh** folded before Flop (didn't bet)
Seat 3: vanilica (button) folded before Flop (didn't bet)
Seat 4: Zeeshka (small blind) folded on the Turn
Seat 5: nuuaber (big blind) collected ($5.70)
Seat 6: Strikerman25 folded before Flop (didn't bet)
Seat 7: matiko09 folded before Flop (didn't bet)
Seat 8: rate8 folded before Flop (didn't bet)
Seat 9: janarr5 folded before Flop (didn't bet)





PokerStars Hand #153505293751:  Hold'em No Limit ($0.50/$1.00 USD) - 2016/05/18 21:29:01 CET [2016/05/18 15:29:01 ET]
Table 'Brendelia II' 9-max Seat #9 is the button
Seat 1: vanilica ($100.70 in chips) 
Seat 2: LebzLouda ($47.78 in chips) 
Seat 3: Zeeshka ($101.50 in chips) 
Seat 4: gkm0nk3y ($101.12 in chips) 
Seat 5: Vulturinus ($75.27 in chips) 
Seat 6: TimStone ($136.17 in chips) 
Seat 7: matiko09 ($107.12 in chips) 
Seat 8: solbi86 ($100 in chips) 
Seat 9: Kihog ($123.88 in chips) 
vanilica: posts small blind $0.50
LebzLouda: posts big blind $1
*** HOLE CARDS ***
Dealt to matiko09 [Ks Kh]
Zeeshka: folds 
gkm0nk3y: folds 
Vulturinus: calls $1
TimStone: folds 
matiko09: raises $3 to $4
solbi86: folds 
Kihog: folds 
vanilica: folds 
LebzLouda: folds 
Vulturinus: folds 
Uncalled bet ($3) returned to matiko09
matiko09 collected $3.50 from pot
matiko09: doesn't show hand 
*** SUMMARY ***
Total pot $3.50 | Rake $0 
Seat 1: vanilica (small blind) folded before Flop
Seat 2: LebzLouda (big blind) folded before Flop
Seat 3: Zeeshka folded before Flop (didn't bet)
Seat 4: gkm0nk3y folded before Flop (didn't bet)
Seat 5: Vulturinus folded before Flop
Seat 6: TimStone folded before Flop (didn't bet)
Seat 7: matiko09 collected ($3.50)
Seat 8: solbi86 folded before Flop (didn't bet)
Seat 9: Kihog (button) folded before Flop (didn't bet)





PokerStars Hand #153505302263:  Hold'em No Limit ($0.50/$1.00 USD) - 2016/05/18 21:29:11 CET [2016/05/18 15:29:11 ET]
Table 'Lorcia II' 9-max Seat #4 is the button
Seat 1: HomerrrJay ($115.75 in chips) 
Seat 2: lydia12345 ($116.86 in chips) 
Seat 3: matiko09 ($110.43 in chips) 
Seat 4: vanilica ($118.56 in chips) 
Seat 5: nuuaber ($176.97 in chips) 
Seat 6: gkm0nk3y ($100 in chips) 
Seat 8: Skum1986 ($100 in chips) 
nuuaber: posts small blind $0.50
gkm0nk3y: posts big blind $1
rate8: sits out 
*** HOLE CARDS ***
Dealt to matiko09 [4c Tc]
Skum1986: folds 
HomerrrJay: folds 
lydia12345: folds 
matiko09: folds 
vanilica: folds 
nuuaber: calls $0.50
gkm0nk3y: raises $3 to $4
nuuaber: calls $3
*** FLOP *** [2c Qd 9h]
nuuaber: checks 
gkm0nk3y: checks 
*** TURN *** [2c Qd 9h] [Ts]
nuuaber: bets $4
gkm0nk3y: raises $8 to $12
nuuaber: raises $8 to $20
gkm0nk3y: calls $8
*** RIVER *** [2c Qd 9h Ts] [9s]
nuuaber: bets $46
gkm0nk3y: folds 
Uncalled bet ($46) returned to nuuaber
nuuaber collected $45.60 from pot
nuuaber: doesn't show hand 
*** SUMMARY ***
Total pot $48 | Rake $2.40 
Board [2c Qd 9h Ts 9s]
Seat 1: HomerrrJay folded before Flop (didn't bet)
Seat 2: lydia12345 folded before Flop (didn't bet)
Seat 3: matiko09 folded before Flop (didn't bet)
Seat 4: vanilica (button) folded before Flop (didn't bet)
Seat 5: nuuaber (small blind) collected ($45.60)
Seat 6: gkm0nk3y (big blind) folded on the River
Seat 8: Skum1986 folded before Flop (didn't bet)





PokerStars Hand #153505307930:  Hold'em No Limit ($0.50/$1.00 USD) - 2016/05/18 21:29:17 CET [2016/05/18 15:29:17 ET]
Table 'Abetti II' 9-max Seat #6 is the button
Seat 1: matiko09 ($110.42 in chips) 
Seat 3: cobrik23 ($156.28 in chips) 
Seat 4: ipashutapkom ($40 in chips) 
Seat 5: blufthenuts ($148.47 in chips) 
Seat 6: Kihog ($100 in chips) 
Seat 7: rate8 ($104.78 in chips) 
Seat 8: roadster683 ($183.87 in chips) 
Seat 9: lydia12345 ($290.13 in chips) 
rate8: posts small blind $0.50
roadster683: posts big blind $1
torkkdnm: sits out 
*** HOLE CARDS ***
Dealt to matiko09 [3h Jd]
lydia12345: folds 
matiko09: folds 
cobrik23 has timed out
cobrik23: folds 
ipashutapkom: folds 
blufthenuts: raises $2 to $3
Kihog: calls $3
rate8: folds 
roadster683: calls $2
*** FLOP *** [Kc Ad Tc]
roadster683: checks 
blufthenuts: bets $6.31
Kihog: folds 
roadster683: folds 
Uncalled bet ($6.31) returned to blufthenuts
blufthenuts collected $9.02 from pot
blufthenuts: doesn't show hand 
*** SUMMARY ***
Total pot $9.50 | Rake $0.48 
Board [Kc Ad Tc]
Seat 1: matiko09 folded before Flop (didn't bet)
Seat 3: cobrik23 folded before Flop (didn't bet)
Seat 4: ipashutapkom folded before Flop (didn't bet)
Seat 5: blufthenuts collected ($9.02)
Seat 6: Kihog (button) folded on the Flop
Seat 7: rate8 (small blind) folded before Flop
Seat 8: roadster683 (big blind) folded on the Flop
Seat 9: lydia12345 folded before Flop (didn't bet)





PokerStars Hand #153505315057:  Hold'em No Limit (€0.50/€1.00 EUR) - 2016/05/18 21:29:25 CET [2016/05/18 15:29:25 ET]
Table 'Pallas II' 9-max Seat #9 is the button
Seat 1: deadkiller1 (€205.31 in chips) 
Seat 2: matiko09 (€100 in chips) 
Seat 3: Ouga Buga (€101.50 in chips) 
Seat 4: torkkdnm (€176.23 in chips) 
Seat 5: vanilica (€100 in chips) 
Seat 6: janarr5 (€106.22 in chips) 
Seat 7: rate8 (€100 in chips) 
Seat 8: Kihog (€166.92 in chips) 
Seat 9: stijner1986 (€169.55 in chips) 
deadkiller1: posts small blind €0.50
matiko09: posts big blind €1
*** HOLE CARDS ***
Dealt to matiko09 [3h 9c]
Ouga Buga: folds 
torkkdnm: folds 
vanilica: folds 
janarr5: raises €2 to €3
rate8: folds 
Kihog: folds 
stijner1986: folds 
deadkiller1: folds 
matiko09: folds 
Uncalled bet (€2) returned to janarr5
janarr5 collected €2.50 from pot
janarr5: doesn't show hand 
*** SUMMARY ***
Total pot €2.50 | Rake €0 
Seat 1: deadkiller1 (small blind) folded before Flop
Seat 2: matiko09 (big blind) folded before Flop
Seat 3: Ouga Buga folded before Flop (didn't bet)
Seat 4: torkkdnm folded before Flop (didn't bet)
Seat 5: vanilica folded before Flop (didn't bet)
Seat 6: janarr5 collected (€2.50)
Seat 7: rate8 folded before Flop (didn't bet)
Seat 8: Kihog folded before Flop (didn't bet)
Seat 9: stijner1986 (button) folded before Flop (didn't bet)





PokerStars Hand #153505318108:  Hold'em No Limit ($0.50/$1.00 USD) - 2016/05/18 21:29:28 CET [2016/05/18 15:29:28 ET]
Table 'Samitchell II' 9-max Seat #4 is the button
Seat 1: riggedsh** ($102.22 in chips) 
Seat 2: mooose100 ($80 in chips) 
Seat 3: vanilica ($167.75 in chips) 
Seat 4: Zeeshka ($105.29 in chips) 
Seat 5: nuuaber ($71.97 in chips) 
Seat 6: Strikerman25 ($36.12 in chips) 
Seat 7: matiko09 ($113.15 in chips) 
Seat 8: rate8 ($124.02 in chips) 
Seat 9: janarr5 ($101 in chips) 
nuuaber: posts small blind $0.50
Strikerman25: posts big blind $1
mooose100: posts big blind $1
*** HOLE CARDS ***
Dealt to matiko09 [2c Jh]
matiko09: folds 
rate8: raises $3 to $4
janarr5: folds 
riggedsh**: folds 
mooose100: folds 
vanilica: folds 
Zeeshka: folds 
nuuaber: folds 
Strikerman25: folds 
Uncalled bet ($3) returned to rate8
rate8 collected $3.50 from pot
rate8: doesn't show hand 
*** SUMMARY ***
Total pot $3.50 | Rake $0 
Seat 1: riggedsh** folded before Flop (didn't bet)
Seat 2: mooose100 folded before Flop
Seat 3: vanilica folded before Flop (didn't bet)
Seat 4: Zeeshka (button) folded before Flop (didn't bet)
Seat 5: nuuaber (small blind) folded before Flop
Seat 6: Strikerman25 (big blind) folded before Flop
Seat 7: matiko09 folded before Flop (didn't bet)
Seat 8: rate8 collected ($3.50)
Seat 9: janarr5 folded before Flop (didn't bet)





PokerStars Hand #153505318997:  Hold'em No Limit ($0.50/$1.00 USD) - 2016/05/18 21:29:29 CET [2016/05/18 15:29:29 ET]
Table 'Brendelia II' 9-max Seat #1 is the button
Seat 1: vanilica ($100.20 in chips) 
Seat 2: LebzLouda ($46.78 in chips) 
Seat 3: Zeeshka ($101.50 in chips) 
Seat 4: gkm0nk3y ($101.12 in chips) 
Seat 5: Vulturinus ($74.27 in chips) 
Seat 6: TimStone ($136.17 in chips) 
Seat 7: matiko09 ($109.62 in chips) 
Seat 8: solbi86 ($100 in chips) 
Seat 9: Kihog ($123.88 in chips) 
LebzLouda: posts small blind $0.50
Zeeshka: posts big blind $1
*** HOLE CARDS ***
Dealt to matiko09 [Qs Td]
gkm0nk3y: folds 
Vulturinus: raises $2 to $3
TimStone: folds 
matiko09: folds 
solbi86: folds 
Kihog: folds 
vanilica: folds 
LebzLouda: folds 
Zeeshka: folds 
Uncalled bet ($2) returned to Vulturinus
Vulturinus collected $2.50 from pot
*** SUMMARY ***
Total pot $2.50 | Rake $0 
Seat 1: vanilica (button) folded before Flop (didn't bet)
Seat 2: LebzLouda (small blind) folded before Flop
Seat 3: Zeeshka (big blind) folded before Flop
Seat 4: gkm0nk3y folded before Flop (didn't bet)
Seat 5: Vulturinus collected ($2.50)
Seat 6: TimStone folded before Flop (didn't bet)
Seat 7: matiko09 folded before Flop (didn't bet)
Seat 8: solbi86 folded before Flop (didn't bet)
Seat 9: Kihog folded before Flop (didn't bet)





PokerStars Hand #153505336749:  Hold'em No Limit ($0.50/$1.00 USD) - 2016/05/18 21:29:49 CET [2016/05/18 15:29:49 ET]
Table 'Tatjana III' 9-max Seat #2 is the button
Seat 1: cobrik23 ($181.14 in chips) 
Seat 2: vanilica ($100 in chips) 
Seat 3: matiko09 ($172.80 in chips) 
Seat 4: lydia12345 ($119.98 in chips) 
Seat 5: deadkiller1 ($101.32 in chips) 
Seat 6: Kihog ($145.69 in chips) 
Seat 7: rene1984tsv ($116.97 in chips) 
Seat 8: JACQUILF ($125.27 in chips) 
Seat 9: Moszes360 ($108.11 in chips) 
matiko09: posts small blind $0.50
lydia12345: posts big blind $1
*** HOLE CARDS ***
Dealt to matiko09 [As 7h]
deadkiller1: folds 
Kihog: folds 
rene1984tsv: calls $1
JACQUILF: folds 
Moszes360: folds 
cobrik23: folds 
vanilica: calls $1
matiko09: calls $0.50
lydia12345: checks 
*** FLOP *** [4h Ac Th]
matiko09: bets $2.47
lydia12345: folds 
rene1984tsv: folds 
vanilica: folds 
Uncalled bet ($2.47) returned to matiko09
matiko09 collected $3.80 from pot
matiko09: doesn't show hand 
*** SUMMARY ***
Total pot $4 | Rake $0.20 
Board [4h Ac Th]
Seat 1: cobrik23 folded before Flop (didn't bet)
Seat 2: vanilica (button) folded on the Flop
Seat 3: matiko09 (small blind) collected ($3.80)
Seat 4: lydia12345 (big blind) folded on the Flop
Seat 5: deadkiller1 folded before Flop (didn't bet)
Seat 6: Kihog folded before Flop (didn't bet)
Seat 7: rene1984tsv folded on the Flop
Seat 8: JACQUILF folded before Flop (didn't bet)
Seat 9: Moszes360 folded before Flop (didn't bet)





PokerStars Hand #153505348880:  Hold'em No Limit ($0.50/$1.00 USD) - 2016/05/18 21:30:02 CET [2016/05/18 15:30:02 ET]
Table 'Samitchell II' 9-max Seat #5 is the button
Seat 1: riggedsh** ($102.22 in chips) 
Seat 2: mooose100 ($79 in chips) 
Seat 3: vanilica ($167.75 in chips) 
Seat 4: Zeeshka ($105.29 in chips) 
Seat 5: nuuaber ($71.47 in chips) 
Seat 6: Strikerman25 ($35.12 in chips) 
Seat 7: matiko09 ($113.15 in chips) 
Seat 8: rate8 ($126.52 in chips) 
Seat 9: janarr5 ($101 in chips) 
Strikerman25: posts small blind $0.50
matiko09: posts big blind $1
*** HOLE CARDS ***
Dealt to matiko09 [4h 9h]
rate8: raises $2 to $3
janarr5: folds 
riggedsh**: folds 
mooose100: folds 
vanilica: folds 
Zeeshka: folds 
nuuaber: folds 
Strikerman25: folds 
matiko09: folds 
Uncalled bet ($2) returned to rate8
rate8 collected $2.50 from pot
rate8: doesn't show hand 
*** SUMMARY ***
Total pot $2.50 | Rake $0 
Seat 1: riggedsh** folded before Flop (didn't bet)
Seat 2: mooose100 folded before Flop (didn't bet)
Seat 3: vanilica folded before Flop (didn't bet)
Seat 4: Zeeshka folded before Flop (didn't bet)
Seat 5: nuuaber (button) folded before Flop (didn't bet)
Seat 6: Strikerman25 (small blind) folded before Flop
Seat 7: matiko09 (big blind) folded before Flop
Seat 8: rate8 collected ($2.50)
Seat 9: janarr5 folded before Flop (didn't bet)





PokerStars Hand #153505351830:  Hold'em No Limit (€0.50/€1.00 EUR) - 2016/05/18 21:30:05 CET [2016/05/18 15:30:05 ET]
Table 'Pallas II' 9-max Seat #1 is the button
Seat 1: deadkiller1 (€204.81 in chips) 
Seat 2: matiko09 (€100 in chips) 
Seat 3: Ouga Buga (€101.50 in chips) 
Seat 4: torkkdnm (€176.23 in chips) 
Seat 5: vanilica (€100 in chips) 
Seat 6: janarr5 (€107.72 in chips) 
Seat 7: rate8 (€100 in chips) 
Seat 8: Kihog (€166.92 in chips) 
Seat 9: stijner1986 (€169.55 in chips) 
matiko09: posts small blind €0.50
Ouga Buga: posts big blind €1
*** HOLE CARDS ***
Dealt to matiko09 [4s 6d]
torkkdnm: folds 
vanilica: folds 
janarr5: folds 
rate8: folds 
Kihog: folds 
stijner1986: folds 
deadkiller1: folds 
matiko09: folds 
Uncalled bet (€0.50) returned to Ouga Buga
Ouga Buga collected €1 from pot
Ouga Buga: doesn't show hand 
*** SUMMARY ***
Total pot €1 | Rake €0 
Seat 1: deadkiller1 (button) folded before Flop (didn't bet)
Seat 2: matiko09 (small blind) folded before Flop
Seat 3: Ouga Buga (big blind) collected (€1)
Seat 4: torkkdnm folded before Flop (didn't bet)
Seat 5: vanilica folded before Flop (didn't bet)
Seat 6: janarr5 folded before Flop (didn't bet)
Seat 7: rate8 folded before Flop (didn't bet)
Seat 8: Kihog folded before Flop (didn't bet)
Seat 9: stijner1986 folded before Flop (didn't bet)





PokerStars Hand #153505352053:  Hold'em No Limit ($0.50/$1.00 USD) - 2016/05/18 21:30:06 CET [2016/05/18 15:30:06 ET]
Table 'Zaurak II' 9-max Seat #5 is the button
Seat 1: TimStone ($100 in chips) 
Seat 2: matiko09 ($100 in chips) 
Seat 3: janarr5 ($128.98 in chips) 
Seat 5: rate8 ($117.18 in chips) 
Seat 6: deadkiller1 ($113.36 in chips) 
Seat 7: Kihog ($102.72 in chips) 
Seat 8: Asgel22 ($220.82 in chips) 
Seat 9: torkkdnm ($135.31 in chips) 
deadkiller1: posts small blind $0.50
Kihog: posts big blind $1
solbi86: sits out 
*** HOLE CARDS ***
Dealt to matiko09 [3s 2d]
Asgel22: folds 
torkkdnm: folds 
TimStone: folds 
matiko09: folds 
janarr5: folds 
rate8: folds 
deadkiller1: raises $1.50 to $2.50
Kihog: folds 
Uncalled bet ($1.50) returned to deadkiller1
deadkiller1 collected $2 from pot
deadkiller1: doesn't show hand 
*** SUMMARY ***
Total pot $2 | Rake $0 
Seat 1: TimStone folded before Flop (didn't bet)
Seat 2: matiko09 folded before Flop (didn't bet)
Seat 3: janarr5 folded before Flop (didn't bet)
Seat 5: rate8 (button) folded before Flop (didn't bet)
Seat 6: deadkiller1 (small blind) collected ($2)
Seat 7: Kihog (big blind) folded before Flop
Seat 8: Asgel22 folded before Flop (didn't bet)
Seat 9: torkkdnm folded before Flop (didn't bet)





PokerStars Hand #153505358758:  Hold'em No Limit ($0.50/$1.00 USD) - 2016/05/18 21:30:14 CET [2016/05/18 15:30:14 ET]
Table 'Brendelia II' 9-max Seat #2 is the button
Seat 1: vanilica ($100.20 in chips) 
Seat 2: LebzLouda ($46.28 in chips) 
Seat 3: Zeeshka ($100.50 in chips) 
Seat 4: gkm0nk3y ($101.12 in chips) 
Seat 5: Vulturinus ($75.77 in chips) 
Seat 6: TimStone ($136.17 in chips) 
Seat 7: matiko09 ($109.62 in chips) 
Seat 8: solbi86 ($100 in chips) 
Seat 9: Kihog ($123.88 in chips) 
Zeeshka: posts small blind $0.50
gkm0nk3y: posts big blind $1
*** HOLE CARDS ***
Dealt to matiko09 [7h 9d]
Vulturinus: raises $2 to $3
TimStone: folds 
matiko09: folds 
solbi86: folds 
Kihog: raises $7 to $10
vanilica: folds 
LebzLouda: folds 
Zeeshka: folds 
gkm0nk3y: calls $9
Vulturinus: calls $7
*** FLOP *** [6c 8s Qh]
gkm0nk3y: checks 
Vulturinus: checks 
Kihog: bets $14
gkm0nk3y: folds 
Vulturinus: folds 
Uncalled bet ($14) returned to Kihog
Kihog collected $28.98 from pot
Kihog: doesn't show hand 
*** SUMMARY ***
Total pot $30.50 | Rake $1.52 
Board [6c 8s Qh]
Seat 1: vanilica folded before Flop (didn't bet)
Seat 2: LebzLouda (button) folded before Flop (didn't bet)
Seat 3: Zeeshka (small blind) folded before Flop
Seat 4: gkm0nk3y (big blind) folded on the Flop
Seat 5: Vulturinus folded on the Flop
Seat 6: TimStone folded before Flop (didn't bet)
Seat 7: matiko09 folded before Flop (didn't bet)
Seat 8: solbi86 folded before Flop (didn't bet)
Seat 9: Kihog collected ($28.98)





PokerStars Hand #153505378174:  Hold'em No Limit ($0.50/$1.00 USD) - 2016/05/18 21:30:35 CET [2016/05/18 15:30:35 ET]
Table 'Abetti II' 9-max Seat #7 is the button
Seat 1: matiko09 ($110.42 in chips) 
Seat 4: ipashutapkom ($40 in chips) 
Seat 5: blufthenuts ($154.49 in chips) 
Seat 6: Kihog ($100 in chips) 
Seat 7: rate8 ($104.28 in chips) 
Seat 8: roadster683 ($180.87 in chips) 
Seat 9: lydia12345 ($290.13 in chips) 
roadster683: posts small blind $0.50
lydia12345: posts big blind $1
torkkdnm: sits out 
*** HOLE CARDS ***
Dealt to matiko09 [7s Ts]
matiko09: folds 
ipashutapkom: folds 
blufthenuts: folds 
Kihog: raises $1.50 to $2.50
rate8: folds 
roadster683: calls $2
lydia12345: folds 
*** FLOP *** [Jh 8s 7d]
roadster683: checks 
Kihog: checks 
*** TURN *** [Jh 8s 7d] [6h]
roadster683: bets $3
Kihog: calls $3
*** RIVER *** [Jh 8s 7d 6h] [2s]
roadster683: bets $7
Kihog: folds 
Uncalled bet ($7) returned to roadster683
roadster683 collected $11.40 from pot
roadster683: doesn't show hand 
*** SUMMARY ***
Total pot $12 | Rake $0.60 
Board [Jh 8s 7d 6h 2s]
Seat 1: matiko09 folded before Flop (didn't bet)
Seat 4: ipashutapkom folded before Flop (didn't bet)
Seat 5: blufthenuts folded before Flop (didn't bet)
Seat 6: Kihog folded on the River
Seat 7: rate8 (button) folded before Flop (didn't bet)
Seat 8: roadster683 (small blind) collected ($11.40)
Seat 9: lydia12345 (big blind) folded before Flop





PokerStars Hand #153505380673:  Hold'em No Limit ($0.50/$1.00 USD) - 2016/05/18 21:30:38 CET [2016/05/18 15:30:38 ET]
Table 'Tatjana III' 9-max Seat #3 is the button
Seat 1: cobrik23 ($181.14 in chips) 
Seat 2: vanilica ($100 in chips) 
Seat 3: matiko09 ($175.60 in chips) 
Seat 4: lydia12345 ($118.98 in chips) 
Seat 5: deadkiller1 ($101.32 in chips) 
Seat 6: Kihog ($145.69 in chips) 
Seat 7: rene1984tsv ($115.97 in chips) 
Seat 8: JACQUILF ($125.27 in chips) 
Seat 9: Moszes360 ($108.11 in chips) 
lydia12345: posts small blind $0.50
deadkiller1: posts big blind $1
*** HOLE CARDS ***
Dealt to matiko09 [3s 4h]
Kihog: folds 
rene1984tsv: folds 
JACQUILF: folds 
Moszes360: folds 
cobrik23: folds 
vanilica: raises $1.50 to $2.50
matiko09: folds 
lydia12345: folds 
deadkiller1: folds 
Uncalled bet ($1.50) returned to vanilica
vanilica collected $2.50 from pot
vanilica: doesn't show hand 
*** SUMMARY ***
Total pot $2.50 | Rake $0 
Seat 1: cobrik23 folded before Flop (didn't bet)
Seat 2: vanilica collected ($2.50)
Seat 3: matiko09 (button) folded before Flop (didn't bet)
Seat 4: lydia12345 (small blind) folded before Flop
Seat 5: deadkiller1 (big blind) folded before Flop
Seat 6: Kihog folded before Flop (didn't bet)
Seat 7: rene1984tsv folded before Flop (didn't bet)
Seat 8: JACQUILF folded before Flop (didn't bet)
Seat 9: Moszes360 folded before Flop (didn't bet)





PokerStars Hand #153505380381:  Hold'em No Limit (€0.50/€1.00 EUR) - 2016/05/18 21:30:38 CET [2016/05/18 15:30:38 ET]
Table 'Pallas II' 9-max Seat #2 is the button
Seat 1: deadkiller1 (€204.81 in chips) 
Seat 2: matiko09 (€100 in chips) 
Seat 3: Ouga Buga (€102 in chips) 
Seat 4: torkkdnm (€176.23 in chips) 
Seat 5: vanilica (€100 in chips) 
Seat 6: janarr5 (€107.72 in chips) 
Seat 7: rate8 (€100 in chips) 
Seat 8: Kihog (€166.92 in chips) 
Seat 9: stijner1986 (€169.55 in chips) 
Ouga Buga: posts small blind €0.50
torkkdnm: posts big blind €1
*** HOLE CARDS ***
Dealt to matiko09 [7c 9s]
vanilica: raises €2 to €3
janarr5: folds 
rate8: folds 
Kihog: folds 
stijner1986: folds 
deadkiller1: calls €3
matiko09: folds 
Ouga Buga: folds 
torkkdnm: folds 
*** FLOP *** [7h Qh 9h]
vanilica: bets €4.27
deadkiller1: folds 
Uncalled bet (€4.27) returned to vanilica
vanilica collected €7.12 from pot
vanilica: doesn't show hand 
*** SUMMARY ***
Total pot €7.50 | Rake €0.38 
Board [7h Qh 9h]
Seat 1: deadkiller1 folded on the Flop
Seat 2: matiko09 (button) folded before Flop (didn't bet)
Seat 3: Ouga Buga (small blind) folded before Flop
Seat 4: torkkdnm (big blind) folded before Flop
Seat 5: vanilica collected (€7.12)
Seat 6: janarr5 folded before Flop (didn't bet)
Seat 7: rate8 folded before Flop (didn't bet)
Seat 8: Kihog folded before Flop (didn't bet)
Seat 9: stijner1986 folded before Flop (didn't bet)





PokerStars Hand #153505382902:  Hold'em No Limit ($0.50/$1.00 USD) - 2016/05/18 21:30:41 CET [2016/05/18 15:30:41 ET]
Table 'Samitchell II' 9-max Seat #6 is the button
Seat 1: riggedsh** ($102.22 in chips) 
Seat 2: mooose100 ($79 in chips) 
Seat 3: vanilica ($167.75 in chips) 
Seat 4: Zeeshka ($105.29 in chips) 
Seat 5: nuuaber ($71.47 in chips) 
Seat 6: Strikerman25 ($34.62 in chips) 
Seat 7: matiko09 ($112.15 in chips) 
Seat 8: rate8 ($128.02 in chips) 
Seat 9: janarr5 ($101 in chips) 
matiko09: posts small blind $0.50
rate8: posts big blind $1
*** HOLE CARDS ***
Dealt to matiko09 [7c 2s]
janarr5: folds 
riggedsh**: raises $2 to $3
mooose100: folds 
vanilica: folds 
Zeeshka: folds 
nuuaber: folds 
Strikerman25: folds 
matiko09: folds 
rate8: calls $2
*** FLOP *** [8h 9c 8d]
rate8: checks 
riggedsh**: checks 
*** TURN *** [8h 9c 8d] [2c]
rate8: checks 
nuuaber is disconnected 
riggedsh**: bets $4.14
rate8: calls $4.14
*** RIVER *** [8h 9c 8d 2c] [8c]
rate8: checks 
riggedsh**: bets $14.50
rate8: calls $14.50
*** SHOW DOWN ***
riggedsh**: shows [9h 7h] (a full house, Eights full of Nines)
rate8: mucks hand 
riggedsh** collected $41.59 from pot
*** SUMMARY ***
Total pot $43.78 | Rake $2.19 
Board [8h 9c 8d 2c 8c]
Seat 1: riggedsh** showed [9h 7h] and won ($41.59) with a full house, Eights full of Nines
Seat 2: mooose100 folded before Flop (didn't bet)
Seat 3: vanilica folded before Flop (didn't bet)
Seat 4: Zeeshka folded before Flop (didn't bet)
Seat 5: nuuaber folded before Flop (didn't bet)
Seat 6: Strikerman25 (button) folded before Flop (didn't bet)
Seat 7: matiko09 (small blind) folded before Flop
Seat 8: rate8 (big blind) mucked [Kh As]
Seat 9: janarr5 folded before Flop (didn't bet)





PokerStars Hand #153505391601:  Hold'em No Limit ($0.50/$1.00 USD) - 2016/05/18 21:30:50 CET [2016/05/18 15:30:50 ET]
Table 'Zaurak II' 9-max Seat #6 is the button
Seat 1: TimStone ($100 in chips) 
Seat 2: matiko09 ($100 in chips) 
Seat 3: janarr5 ($128.98 in chips) 
Seat 5: rate8 ($117.18 in chips) 
Seat 6: deadkiller1 ($114.36 in chips) 
Seat 7: Kihog ($101.72 in chips) 
Seat 8: Asgel22 ($220.82 in chips) 
Seat 9: torkkdnm ($135.31 in chips) 
Kihog: posts small blind $0.50
Asgel22: posts big blind $1
solbi86: sits out 
*** HOLE CARDS ***
Dealt to matiko09 [Kc 9c]
torkkdnm: raises $2 to $3
TimStone: folds 
matiko09: folds 
janarr5: folds 
rate8: folds 
deadkiller1: folds 
Kihog: folds 
Asgel22: calls $2
*** FLOP *** [Ah 9h 9s]
Asgel22: bets $2
torkkdnm: raises $4 to $6
Asgel22: folds 
Uncalled bet ($4) returned to torkkdnm
torkkdnm collected $9.98 from pot
*** SUMMARY ***
Total pot $10.50 | Rake $0.52 
Board [Ah 9h 9s]
Seat 1: TimStone folded before Flop (didn't bet)
Seat 2: matiko09 folded before Flop (didn't bet)
Seat 3: janarr5 folded before Flop (didn't bet)
Seat 5: rate8 folded before Flop (didn't bet)
Seat 6: deadkiller1 (button) folded before Flop (didn't bet)
Seat 7: Kihog (small blind) folded before Flop
Seat 8: Asgel22 (big blind) folded on the Flop
Seat 9: torkkdnm collected ($9.98)





PokerStars Hand #153505405194:  Hold'em No Limit ($0.50/$1.00 USD) - 2016/05/18 21:31:05 CET [2016/05/18 15:31:05 ET]
Table 'Lorcia II' 9-max Seat #5 is the button
Seat 1: HomerrrJay ($115.75 in chips) 
Seat 2: lydia12345 ($116.86 in chips) 
Seat 3: matiko09 ($110.43 in chips) 
Seat 4: vanilica ($118.56 in chips) 
Seat 5: nuuaber ($198.57 in chips) 
Seat 6: gkm0nk3y ($100 in chips) 
Seat 7: rate8 ($108.40 in chips) 
Seat 8: Skum1986 ($100 in chips) 
gkm0nk3y: posts small blind $0.50
rate8: posts big blind $1
*** HOLE CARDS ***
Dealt to matiko09 [Jc 4d]
Skum1986: folds 
HomerrrJay: folds 
lydia12345: folds 
matiko09: folds 
vanilica: folds 
nuuaber: calls $1
gkm0nk3y: folds 
rate8: checks 
*** FLOP *** [Qs 8d Kd]
nuuaber is disconnected 
rate8: checks 
nuuaber is connected 
nuuaber: bets $1
rate8: folds 
Uncalled bet ($1) returned to nuuaber
nuuaber collected $2.38 from pot
nuuaber: doesn't show hand 
*** SUMMARY ***
Total pot $2.50 | Rake $0.12 
Board [Qs 8d Kd]
Seat 1: HomerrrJay folded before Flop (didn't bet)
Seat 2: lydia12345 folded before Flop (didn't bet)
Seat 3: matiko09 folded before Flop (didn't bet)
Seat 4: vanilica folded before Flop (didn't bet)
Seat 5: nuuaber (button) collected ($2.38)
Seat 6: gkm0nk3y (small blind) folded before Flop
Seat 7: rate8 (big blind) folded on the Flop
Seat 8: Skum1986 folded before Flop (didn't bet)





PokerStars Hand #153505418013:  Hold'em No Limit ($0.50/$1.00 USD) - 2016/05/18 21:31:19 CET [2016/05/18 15:31:19 ET]
Table 'Tatjana III' 9-max Seat #4 is the button
Seat 1: cobrik23 ($181.14 in chips) 
Seat 2: vanilica ($101.50 in chips) 
Seat 3: matiko09 ($175.60 in chips) 
Seat 4: lydia12345 ($118.48 in chips) 
Seat 5: deadkiller1 ($100.32 in chips) 
Seat 6: Kihog ($145.69 in chips) 
Seat 7: rene1984tsv ($115.97 in chips) 
Seat 8: JACQUILF ($125.27 in chips) 
Seat 9: Moszes360 ($108.11 in chips) 
deadkiller1: posts small blind $0.50
Kihog: posts big blind $1
*** HOLE CARDS ***
Dealt to matiko09 [Jh 7d]
rene1984tsv: calls $1
JACQUILF: folds 
Moszes360: folds 
cobrik23: folds 
vanilica: raises $3.50 to $4.50
matiko09: folds 
lydia12345: folds 
deadkiller1: folds 
Kihog: calls $3.50
rene1984tsv: calls $3.50
*** FLOP *** [Qc 5c 4s]
Kihog: checks 
rene1984tsv: checks 
vanilica: bets $7.98
Kihog: folds 
rene1984tsv: folds 
Uncalled bet ($7.98) returned to vanilica
vanilica collected $13.30 from pot
vanilica: doesn't show hand 
*** SUMMARY ***
Total pot $14 | Rake $0.70 
Board [Qc 5c 4s]
Seat 1: cobrik23 folded before Flop (didn't bet)
Seat 2: vanilica collected ($13.30)
Seat 3: matiko09 folded before Flop (didn't bet)
Seat 4: lydia12345 (button) folded before Flop (didn't bet)
Seat 5: deadkiller1 (small blind) folded before Flop
Seat 6: Kihog (big blind) folded on the Flop
Seat 7: rene1984tsv folded on the Flop
Seat 8: JACQUILF folded before Flop (didn't bet)
Seat 9: Moszes360 folded before Flop (didn't bet)





PokerStars Hand #153505421480:  Hold'em No Limit (€0.50/€1.00 EUR) - 2016/05/18 21:31:23 CET [2016/05/18 15:31:23 ET]
Table 'Pallas II' 9-max Seat #3 is the button
Seat 1: deadkiller1 (€201.81 in chips) 
Seat 2: matiko09 (€100 in chips) 
Seat 3: Ouga Buga (€101.50 in chips) 
Seat 4: torkkdnm (€175.23 in chips) 
Seat 5: vanilica (€104.12 in chips) 
Seat 6: janarr5 (€107.72 in chips) 
Seat 7: rate8 (€100 in chips) 
Seat 8: Kihog (€166.92 in chips) 
Seat 9: stijner1986 (€169.55 in chips) 
torkkdnm: posts small blind €0.50
vanilica: posts big blind €1
*** HOLE CARDS ***
Dealt to matiko09 [Qd 9s]
janarr5: folds 
rate8: raises €2 to €3
Kihog: folds 
stijner1986: folds 
deadkiller1: folds 
matiko09: folds 
Ouga Buga: folds 
torkkdnm: folds 
vanilica: folds 
Uncalled bet (€2) returned to rate8
rate8 collected €2.50 from pot
rate8: doesn't show hand 
*** SUMMARY ***
Total pot €2.50 | Rake €0 
Seat 1: deadkiller1 folded before Flop (didn't bet)
Seat 2: matiko09 folded before Flop (didn't bet)
Seat 3: Ouga Buga (button) folded before Flop (didn't bet)
Seat 4: torkkdnm (small blind) folded before Flop
Seat 5: vanilica (big blind) folded before Flop
Seat 6: janarr5 folded before Flop (didn't bet)
Seat 7: rate8 collected (€2.50)
Seat 8: Kihog folded before Flop (didn't bet)
Seat 9: stijner1986 folded before Flop (didn't bet)





PokerStars Hand #153505439855:  Hold'em No Limit ($0.50/$1.00 USD) - 2016/05/18 21:31:43 CET [2016/05/18 15:31:43 ET]
Table 'Abetti II' 9-max Seat #8 is the button
Seat 1: matiko09 ($110.42 in chips) 
Seat 3: cobrik23 ($156.28 in chips) 
Seat 4: ipashutapkom ($40 in chips) 
Seat 5: blufthenuts ($154.49 in chips) 
Seat 6: Kihog ($100 in chips) 
Seat 7: rate8 ($104.28 in chips) 
Seat 8: roadster683 ($186.77 in chips) 
Seat 9: lydia12345 ($289.13 in chips) 
lydia12345: posts small blind $0.50
matiko09: posts big blind $1
torkkdnm: sits out 
*** HOLE CARDS ***
Dealt to matiko09 [2d 3d]
cobrik23: folds 
ipashutapkom: folds 
blufthenuts: folds 
Kihog: folds 
rate8: folds 
roadster683: raises $1 to $2
lydia12345: calls $1.50
matiko09: calls $1
*** FLOP *** [9d Ts Tc]
lydia12345: bets $3.88
matiko09: folds 
roadster683: folds 
Uncalled bet ($3.88) returned to lydia12345
lydia12345 collected $5.70 from pot
*** SUMMARY ***
Total pot $6 | Rake $0.30 
Board [9d Ts Tc]
Seat 1: matiko09 (big blind) folded on the Flop
Seat 3: cobrik23 folded before Flop (didn't bet)
Seat 4: ipashutapkom folded before Flop (didn't bet)
Seat 5: blufthenuts folded before Flop (didn't bet)
Seat 6: Kihog folded before Flop (didn't bet)
Seat 7: rate8 folded before Flop (didn't bet)
Seat 8: roadster683 (button) folded on the Flop
Seat 9: lydia12345 (small blind) collected ($5.70)





PokerStars Hand #153505445152:  Hold'em No Limit ($0.50/$1.00 USD) - 2016/05/18 21:31:49 CET [2016/05/18 15:31:49 ET]
Table 'Zaurak II' 9-max Seat #7 is the button
Seat 1: TimStone ($100 in chips) 
Seat 2: matiko09 ($100 in chips) 
Seat 3: janarr5 ($128.98 in chips) 
Seat 5: rate8 ($117.18 in chips) 
Seat 6: deadkiller1 ($114.36 in chips) 
Seat 7: Kihog ($101.22 in chips) 
Seat 8: Asgel22 ($215.82 in chips) 
Seat 9: torkkdnm ($140.29 in chips) 
Asgel22: posts small blind $0.50
torkkdnm: posts big blind $1
solbi86: sits out 
*** HOLE CARDS ***
Dealt to matiko09 [Kh 5c]
TimStone: folds 
matiko09: folds 
janarr5: folds 
rate8: folds 
deadkiller1: folds 
Kihog: folds 
Asgel22: folds 
Uncalled bet ($0.50) returned to torkkdnm
torkkdnm collected $1 from pot
*** SUMMARY ***
Total pot $1 | Rake $0 
Seat 1: TimStone folded before Flop (didn't bet)
Seat 2: matiko09 folded before Flop (didn't bet)
Seat 3: janarr5 folded before Flop (didn't bet)
Seat 5: rate8 folded before Flop (didn't bet)
Seat 6: deadkiller1 folded before Flop (didn't bet)
Seat 7: Kihog (button) folded before Flop (didn't bet)
Seat 8: Asgel22 (small blind) folded before Flop
Seat 9: torkkdnm (big blind) collected ($1)





PokerStars Hand #153505447539:  Hold'em No Limit ($0.50/$1.00 USD) - 2016/05/18 21:31:51 CET [2016/05/18 15:31:51 ET]
Table 'Brendelia II' 9-max Seat #3 is the button
Seat 1: vanilica ($100.20 in chips) 
Seat 2: LebzLouda ($46.28 in chips) 
Seat 3: Zeeshka ($100 in chips) 
Seat 4: gkm0nk3y ($100 in chips) 
Seat 5: Vulturinus ($65.77 in chips) 
Seat 6: TimStone ($136.17 in chips) 
Seat 7: matiko09 ($109.62 in chips) 
Seat 8: solbi86 ($100 in chips) 
Seat 9: Kihog ($142.86 in chips) 
gkm0nk3y: posts small blind $0.50
Vulturinus: posts big blind $1
*** HOLE CARDS ***
Dealt to matiko09 [9s 5c]
TimStone: raises $1.62 to $2.62
matiko09: folds 
solbi86: folds 
Kihog: folds 
vanilica: folds 
LebzLouda: folds 
Zeeshka: folds 
gkm0nk3y: folds 
Vulturinus: calls $1.62
*** FLOP *** [2d 2h Td]
Vulturinus: checks 
TimStone: bets $4.09
Vulturinus: folds 
Uncalled bet ($4.09) returned to TimStone
TimStone collected $5.45 from pot
TimStone: doesn't show hand 
*** SUMMARY ***
Total pot $5.74 | Rake $0.29 
Board [2d 2h Td]
Seat 1: vanilica folded before Flop (didn't bet)
Seat 2: LebzLouda folded before Flop (didn't bet)
Seat 3: Zeeshka (button) folded before Flop (didn't bet)
Seat 4: gkm0nk3y (small blind) folded before Flop
Seat 5: Vulturinus (big blind) folded on the Flop
Seat 6: TimStone collected ($5.45)
Seat 7: matiko09 folded before Flop (didn't bet)
Seat 8: solbi86 folded before Flop (didn't bet)
Seat 9: Kihog folded before Flop (didn't bet)





PokerStars Hand #153505459511:  Hold'em No Limit ($0.50/$1.00 USD) - 2016/05/18 21:32:05 CET [2016/05/18 15:32:05 ET]
Table 'Zaurak II' 9-max Seat #8 is the button
Seat 1: TimStone ($100 in chips) 
Seat 2: matiko09 ($100 in chips) 
Seat 3: janarr5 ($128.98 in chips) 
Seat 5: rate8 ($117.18 in chips) 
Seat 6: deadkiller1 ($114.36 in chips) 
Seat 7: Kihog ($101.22 in chips) 
Seat 8: Asgel22 ($215.32 in chips) 
Seat 9: torkkdnm ($140.79 in chips) 
torkkdnm: posts small blind $0.50
TimStone: posts big blind $1
solbi86: sits out 
*** HOLE CARDS ***
Dealt to matiko09 [9d 2d]
matiko09: folds 
janarr5: folds 
rate8: folds 
deadkiller1: raises $2 to $3
Kihog: folds 
Asgel22: calls $3
torkkdnm: folds 
TimStone: folds 
*** FLOP *** [Kh 8d Ad]
deadkiller1: bets $4.69
Asgel22: folds 
Uncalled bet ($4.69) returned to deadkiller1
deadkiller1 collected $7.12 from pot
deadkiller1: doesn't show hand 
*** SUMMARY ***
Total pot $7.50 | Rake $0.38 
Board [Kh 8d Ad]
Seat 1: TimStone (big blind) folded before Flop
Seat 2: matiko09 folded before Flop (didn't bet)
Seat 3: janarr5 folded before Flop (didn't bet)
Seat 5: rate8 folded before Flop (didn't bet)
Seat 6: deadkiller1 collected ($7.12)
Seat 7: Kihog folded before Flop (didn't bet)
Seat 8: Asgel22 (button) folded on the Flop
Seat 9: torkkdnm (small blind) folded before Flop





PokerStars Hand #153505465063:  Hold'em No Limit ($0.50/$1.00 USD) - 2016/05/18 21:32:11 CET [2016/05/18 15:32:11 ET]
Table 'Lorcia II' 9-max Seat #6 is the button
Seat 1: HomerrrJay ($115.75 in chips) 
Seat 2: lydia12345 ($116.86 in chips) 
Seat 3: matiko09 ($110.43 in chips) 
Seat 4: vanilica ($118.56 in chips) 
Seat 5: nuuaber ($199.95 in chips) 
Seat 6: gkm0nk3y ($100 in chips) 
Seat 7: rate8 ($107.40 in chips) 
Seat 8: Skum1986 ($100 in chips) 
rate8: posts small blind $0.50
Skum1986: posts big blind $1
*** HOLE CARDS ***
Dealt to matiko09 [Ah Kh]
HomerrrJay: folds 
lydia12345: folds 
matiko09: raises $2 to $3
vanilica: folds 
nuuaber: calls $3
gkm0nk3y: folds 
rate8: folds 
Skum1986: folds 
*** FLOP *** [Qh 2h 4d]
matiko09: bets $4.63
nuuaber: folds 
Uncalled bet ($4.63) returned to matiko09
matiko09 collected $7.12 from pot
matiko09: doesn't show hand 
*** SUMMARY ***
Total pot $7.50 | Rake $0.38 
Board [Qh 2h 4d]
Seat 1: HomerrrJay folded before Flop (didn't bet)
Seat 2: lydia12345 folded before Flop (didn't bet)
Seat 3: matiko09 collected ($7.12)
Seat 4: vanilica folded before Flop (didn't bet)
Seat 5: nuuaber folded on the Flop
Seat 6: gkm0nk3y (button) folded before Flop (didn't bet)
Seat 7: rate8 (small blind) folded before Flop
Seat 8: Skum1986 (big blind) folded before Flop





PokerStars Hand #153505480355:  Hold'em No Limit (€0.50/€1.00 EUR) - 2016/05/18 21:32:28 CET [2016/05/18 15:32:28 ET]
Table 'Pallas II' 9-max Seat #4 is the button
Seat 1: deadkiller1 (€201.81 in chips) 
Seat 2: matiko09 (€100 in chips) 
Seat 3: Ouga Buga (€101.50 in chips) 
Seat 4: torkkdnm (€174.73 in chips) 
Seat 5: vanilica (€103.12 in chips) 
Seat 6: janarr5 (€107.72 in chips) 
Seat 7: rate8 (€101.50 in chips) 
Seat 8: Kihog (€166.92 in chips) 
Seat 9: stijner1986 (€169.55 in chips) 
vanilica: posts small blind €0.50
janarr5: posts big blind €1
*** HOLE CARDS ***
Dealt to matiko09 [8s 7d]
rate8: raises €2 to €3
Kihog: folds 
stijner1986: folds 
deadkiller1: folds 
matiko09: folds 
Ouga Buga: folds 
torkkdnm: calls €3
vanilica: folds 
janarr5: folds 
*** FLOP *** [3d 5s 4d]
rate8: bets €5.06
torkkdnm: folds 
Uncalled bet (€5.06) returned to rate8
rate8 collected €7.12 from pot
rate8: doesn't show hand 
*** SUMMARY ***
Total pot €7.50 | Rake €0.38 
Board [3d 5s 4d]
Seat 1: deadkiller1 folded before Flop (didn't bet)
Seat 2: matiko09 folded before Flop (didn't bet)
Seat 3: Ouga Buga folded before Flop (didn't bet)
Seat 4: torkkdnm (button) folded on the Flop
Seat 5: vanilica (small blind) folded before Flop
Seat 6: janarr5 (big blind) folded before Flop
Seat 7: rate8 collected (€7.12)
Seat 8: Kihog folded before Flop (didn't bet)
Seat 9: stijner1986 folded before Flop (didn't bet)





PokerStars Hand #153505490247:  Hold'em No Limit ($0.50/$1.00 USD) - 2016/05/18 21:32:39 CET [2016/05/18 15:32:39 ET]
Table 'Tatjana III' 9-max Seat #5 is the button
Seat 1: cobrik23 ($181.14 in chips) 
Seat 2: vanilica ($110.30 in chips) 
Seat 3: matiko09 ($175.60 in chips) 
Seat 4: lydia12345 ($118.48 in chips) 
Seat 5: deadkiller1 ($100 in chips) 
Seat 6: Kihog ($141.19 in chips) 
Seat 7: rene1984tsv ($111.47 in chips) 
Seat 8: JACQUILF ($125.27 in chips) 
Seat 9: Moszes360 ($108.11 in chips) 
Kihog: posts small blind $0.50
rene1984tsv: posts big blind $1
*** HOLE CARDS ***
Dealt to matiko09 [Js 4d]
JACQUILF: folds 
Moszes360: folds 
cobrik23: folds 
vanilica: raises $1.85 to $2.85
matiko09: folds 
lydia12345: folds 
deadkiller1: folds 
Kihog: calls $2.35
rene1984tsv: calls $1.85
*** FLOP *** [8d 3d Ad]
Kihog: checks 
rene1984tsv: checks 
vanilica: checks 
*** TURN *** [8d 3d Ad] [5s]
Kihog: checks 
rene1984tsv: checks 
vanilica: bets $6
Kihog: calls $6
rene1984tsv: folds 
*** RIVER *** [8d 3d Ad 5s] [6s]
Kihog: checks 
vanilica: checks 
*** SHOW DOWN ***
Kihog: shows [9h 9d] (a pair of Nines)
vanilica: shows [As Jc] (a pair of Aces)
vanilica collected $19.52 from pot
*** SUMMARY ***
Total pot $20.55 | Rake $1.03 
Board [8d 3d Ad 5s 6s]
Seat 1: cobrik23 folded before Flop (didn't bet)
Seat 2: vanilica showed [As Jc] and won ($19.52) with a pair of Aces
Seat 3: matiko09 folded before Flop (didn't bet)
Seat 4: lydia12345 folded before Flop (didn't bet)
Seat 5: deadkiller1 (button) folded before Flop (didn't bet)
Seat 6: Kihog (small blind) showed [9h 9d] and lost with a pair of Nines
Seat 7: rene1984tsv (big blind) folded on the Turn
Seat 8: JACQUILF folded before Flop (didn't bet)
Seat 9: Moszes360 folded before Flop (didn't bet)





PokerStars Hand #153505492281:  Hold'em No Limit ($0.50/$1.00 USD) - 2016/05/18 21:32:41 CET [2016/05/18 15:32:41 ET]
Table 'Abetti II' 9-max Seat #9 is the button
Seat 1: matiko09 ($108.42 in chips) 
Seat 2: torkkdnm ($100 in chips) 
Seat 3: cobrik23 ($156.28 in chips) 
Seat 4: ipashutapkom ($40 in chips) 
Seat 5: blufthenuts ($154.49 in chips) 
Seat 6: Kihog ($100 in chips) 
Seat 7: rate8 ($104.28 in chips) 
Seat 8: roadster683 ($184.77 in chips) 
Seat 9: lydia12345 ($292.83 in chips) 
matiko09: posts small blind $0.50
torkkdnm: posts big blind $1
*** HOLE CARDS ***
Dealt to matiko09 [4s 4d]
cobrik23: folds 
ipashutapkom: folds 
blufthenuts: folds 
Kihog: folds 
rate8: folds 
roadster683: folds 
lydia12345: folds 
matiko09: raises $1.50 to $2.50
torkkdnm: folds 
Uncalled bet ($1.50) returned to matiko09
matiko09 collected $2 from pot
matiko09: doesn't show hand 
*** SUMMARY ***
Total pot $2 | Rake $0 
Seat 1: matiko09 (small blind) collected ($2)
Seat 2: torkkdnm (big blind) folded before Flop
Seat 3: cobrik23 folded before Flop (didn't bet)
Seat 4: ipashutapkom folded before Flop (didn't bet)
Seat 5: blufthenuts folded before Flop (didn't bet)
Seat 6: Kihog folded before Flop (didn't bet)
Seat 7: rate8 folded before Flop (didn't bet)
Seat 8: roadster683 folded before Flop (didn't bet)
Seat 9: lydia12345 (button) folded before Flop (didn't bet)





PokerStars Hand #153505494389:  Hold'em No Limit ($0.50/$1.00 USD) - 2016/05/18 21:32:43 CET [2016/05/18 15:32:43 ET]
Table 'Samitchell II' 9-max Seat #7 is the button
Seat 1: riggedsh** ($122.17 in chips) 
Seat 2: mooose100 ($79 in chips) 
Seat 3: vanilica ($167.75 in chips) 
Seat 4: Zeeshka ($105.29 in chips) 
Seat 5: nuuaber ($71.47 in chips) 
Seat 6: Strikerman25 ($34.62 in chips) 
Seat 7: matiko09 ($111.65 in chips) 
Seat 8: rate8 ($106.38 in chips) 
Seat 9: janarr5 ($101 in chips) 
rate8: posts small blind $0.50
janarr5: posts big blind $1
*** HOLE CARDS ***
Dealt to matiko09 [3h 4d]
riggedsh**: folds 
mooose100: calls $1
vanilica: folds 
Zeeshka: raises $2.95 to $3.95
nuuaber: folds 
Strikerman25: folds 
matiko09: folds 
rate8: folds 
janarr5: folds 
mooose100: calls $2.95
*** FLOP *** [Jc Qs 5d]
mooose100: checks 
Zeeshka: bets $5.98
mooose100: folds 
Uncalled bet ($5.98) returned to Zeeshka
Zeeshka collected $8.93 from pot
Zeeshka: doesn't show hand 
*** SUMMARY ***
Total pot $9.40 | Rake $0.47 
Board [Jc Qs 5d]
Seat 1: riggedsh** folded before Flop (didn't bet)
Seat 2: mooose100 folded on the Flop
Seat 3: vanilica folded before Flop (didn't bet)
Seat 4: Zeeshka collected ($8.93)
Seat 5: nuuaber folded before Flop (didn't bet)
Seat 6: Strikerman25 folded before Flop (didn't bet)
Seat 7: matiko09 (button) folded before Flop (didn't bet)
Seat 8: rate8 (small blind) folded before Flop
Seat 9: janarr5 (big blind) folded before Flop





PokerStars Hand #153505496716:  Hold'em No Limit ($0.50/$1.00 USD) - 2016/05/18 21:32:46 CET [2016/05/18 15:32:46 ET]
Table 'Brendelia II' 9-max Seat #4 is the button
Seat 1: vanilica ($100.20 in chips) 
Seat 2: LebzLouda ($46.28 in chips) 
Seat 3: Zeeshka ($100 in chips) 
Seat 4: gkm0nk3y ($100 in chips) 
Seat 5: Vulturinus ($63.15 in chips) 
Seat 6: TimStone ($139 in chips) 
Seat 7: matiko09 ($109.62 in chips) 
Seat 8: solbi86 ($100 in chips) 
Seat 9: Kihog ($142.86 in chips) 
Vulturinus: posts small blind $0.50
TimStone: posts big blind $1
*** HOLE CARDS ***
Dealt to matiko09 [8c 5s]
matiko09: folds 
solbi86: folds 
Kihog: raises $1.50 to $2.50
vanilica: folds 
LebzLouda: folds 
Zeeshka: folds 
gkm0nk3y: folds 
Vulturinus: folds 
TimStone: calls $1.50
*** FLOP *** [5d 2c Qs]
TimStone: checks 
Kihog: bets $3
TimStone: folds 
Uncalled bet ($3) returned to Kihog
Kihog collected $5.22 from pot
Kihog: doesn't show hand 
*** SUMMARY ***
Total pot $5.50 | Rake $0.28 
Board [5d 2c Qs]
Seat 1: vanilica folded before Flop (didn't bet)
Seat 2: LebzLouda folded before Flop (didn't bet)
Seat 3: Zeeshka folded before Flop (didn't bet)
Seat 4: gkm0nk3y (button) folded before Flop (didn't bet)
Seat 5: Vulturinus (small blind) folded before Flop
Seat 6: TimStone (big blind) folded on the Flop
Seat 7: matiko09 folded before Flop (didn't bet)
Seat 8: solbi86 folded before Flop (didn't bet)
Seat 9: Kihog collected ($5.22)





PokerStars Hand #153505516164:  Hold'em No Limit ($0.50/$1.00 USD) - 2016/05/18 21:33:07 CET [2016/05/18 15:33:07 ET]
Table 'Zaurak II' 9-max Seat #9 is the button
Seat 1: TimStone ($100 in chips) 
Seat 2: matiko09 ($100 in chips) 
Seat 3: janarr5 ($128.98 in chips) 
Seat 5: rate8 ($117.18 in chips) 
Seat 6: deadkiller1 ($118.48 in chips) 
Seat 7: Kihog ($101.22 in chips) 
Seat 8: Asgel22 ($212.32 in chips) 
Seat 9: torkkdnm ($140.29 in chips) 
TimStone: posts small blind $0.50
matiko09: posts big blind $1
solbi86: sits out 
*** HOLE CARDS ***
Dealt to matiko09 [4d Jh]
janarr5: folds 
rate8: raises $2 to $3
deadkiller1: raises $6 to $9
Kihog: folds 
Asgel22: folds 
torkkdnm: folds 
TimStone: folds 
matiko09: folds 
rate8: calls $6
*** FLOP *** [3h 3c 7s]
rate8: checks 
deadkiller1: checks 
*** TURN *** [3h 3c 7s] [9s]
rate8: bets $9.63
deadkiller1: folds 
Uncalled bet ($9.63) returned to rate8
rate8 collected $18.52 from pot
rate8: doesn't show hand 
*** SUMMARY ***
Total pot $19.50 | Rake $0.98 
Board [3h 3c 7s 9s]
Seat 1: TimStone (small blind) folded before Flop
Seat 2: matiko09 (big blind) folded before Flop
Seat 3: janarr5 folded before Flop (didn't bet)
Seat 5: rate8 collected ($18.52)
Seat 6: deadkiller1 folded on the Turn
Seat 7: Kihog folded before Flop (didn't bet)
Seat 8: Asgel22 folded before Flop (didn't bet)
Seat 9: torkkdnm (button) folded before Flop (didn't bet)





PokerStars Hand #153505525616:  Hold'em No Limit ($0.50/$1.00 USD) - 2016/05/18 21:33:17 CET [2016/05/18 15:33:17 ET]
Table 'Lorcia II' 9-max Seat #7 is the button
Seat 2: lydia12345 ($116.86 in chips) 
Seat 3: matiko09 ($114.55 in chips) 
Seat 4: vanilica ($118.56 in chips) 
Seat 5: nuuaber ($196.95 in chips) 
Seat 6: gkm0nk3y ($100 in chips) 
Seat 7: rate8 ($106.90 in chips) 
Seat 8: Skum1986 ($100 in chips) 
Skum1986: posts small blind $0.50
HomerrrJay: is sitting out 
lydia12345: posts big blind $1
*** HOLE CARDS ***
Dealt to matiko09 [Ts 8s]
HomerrrJay leaves the table
TimStone joins the table at seat #1 
matiko09: folds 
vanilica: folds 
nuuaber: folds 
gkm0nk3y: folds 
rate8: folds 
Skum1986: raises $1.70 to $2.70
lydia12345: folds 
Uncalled bet ($1.70) returned to Skum1986
Skum1986 collected $2 from pot
Skum1986: doesn't show hand 
*** SUMMARY ***
Total pot $2 | Rake $0 
Seat 2: lydia12345 (big blind) folded before Flop
Seat 3: matiko09 folded before Flop (didn't bet)
Seat 4: vanilica folded before Flop (didn't bet)
Seat 5: nuuaber folded before Flop (didn't bet)
Seat 6: gkm0nk3y folded before Flop (didn't bet)
Seat 7: rate8 (button) folded before Flop (didn't bet)
Seat 8: Skum1986 (small blind) collected ($2)





PokerStars Hand #153505541308:  Hold'em No Limit ($0.50/$1.00 USD) - 2016/05/18 21:33:34 CET [2016/05/18 15:33:34 ET]
Table 'Brendelia II' 9-max Seat #5 is the button
Seat 1: vanilica ($100.20 in chips) 
Seat 2: LebzLouda ($46.28 in chips) 
Seat 3: Zeeshka ($100 in chips) 
Seat 4: gkm0nk3y ($100 in chips) 
Seat 5: Vulturinus ($62.65 in chips) 
Seat 6: TimStone ($136.50 in chips) 
Seat 7: matiko09 ($109.62 in chips) 
Seat 8: solbi86 ($100 in chips) 
Seat 9: Kihog ($145.58 in chips) 
TimStone: posts small blind $0.50
matiko09: posts big blind $1
*** HOLE CARDS ***
Dealt to matiko09 [Jc 7s]
solbi86: raises $2 to $3
Kihog: folds 
vanilica: folds 
LebzLouda: folds 
Zeeshka: folds 
gkm0nk3y: folds 
Vulturinus: calls $3
TimStone: calls $2.50
matiko09: folds 
*** FLOP *** [8s 4d 2c]
TimStone: checks 
solbi86: bets $5
vanilica leaves the table
Vulturinus: folds 
TimStone: folds 
Uncalled bet ($5) returned to solbi86
solbi86 collected $9.50 from pot
solbi86: doesn't show hand 
*** SUMMARY ***
Total pot $10 | Rake $0.50 
Board [8s 4d 2c]
Seat 1: vanilica folded before Flop (didn't bet)
Seat 2: LebzLouda folded before Flop (didn't bet)
Seat 3: Zeeshka folded before Flop (didn't bet)
Seat 4: gkm0nk3y folded before Flop (didn't bet)
Seat 5: Vulturinus (button) folded on the Flop
Seat 6: TimStone (small blind) folded on the Flop
Seat 7: matiko09 (big blind) folded before Flop
Seat 8: solbi86 collected ($9.50)
Seat 9: Kihog folded before Flop (didn't bet)





PokerStars Hand #153505556133:  Hold'em No Limit ($0.50/$1.00 USD) - 2016/05/18 21:33:51 CET [2016/05/18 15:33:51 ET]
Table 'Samitchell II' 9-max Seat #8 is the button
Seat 1: riggedsh** ($122.17 in chips) 
Seat 2: mooose100 ($75.05 in chips) 
Seat 3: vanilica ($167.75 in chips) 
Seat 4: Zeeshka ($110.27 in chips) 
Seat 5: nuuaber ($71.47 in chips) 
Seat 6: Strikerman25 ($34.62 in chips) 
Seat 7: matiko09 ($111.65 in chips) 
Seat 8: rate8 ($105.88 in chips) 
Seat 9: janarr5 ($100 in chips) 
janarr5: posts small blind $0.50
riggedsh**: posts big blind $1
*** HOLE CARDS ***
Dealt to matiko09 [Td 7h]
mooose100: folds 
vanilica: folds 
Zeeshka: folds 
nuuaber: calls $1
Strikerman25: folds 
matiko09: folds 
rate8: folds 
janarr5: folds 
riggedsh**: checks 
*** FLOP *** [5d Js Kh]
riggedsh**: checks 
nuuaber: checks 
*** TURN *** [5d Js Kh] [Qc]
riggedsh**: bets $2
nuuaber: calls $2
*** RIVER *** [5d Js Kh Qc] [Qs]
riggedsh**: checks 
nuuaber: bets $6
riggedsh**: calls $6
*** SHOW DOWN ***
nuuaber: shows [5h As] (two pair, Queens and Fives)
riggedsh**: shows [4s Kd] (two pair, Kings and Queens)
riggedsh** collected $17.58 from pot
*** SUMMARY ***
Total pot $18.50 | Rake $0.92 
Board [5d Js Kh Qc Qs]
Seat 1: riggedsh** (big blind) showed [4s Kd] and won ($17.58) with two pair, Kings and Queens
Seat 2: mooose100 folded before Flop (didn't bet)
Seat 3: vanilica folded before Flop (didn't bet)
Seat 4: Zeeshka folded before Flop (didn't bet)
Seat 5: nuuaber showed [5h As] and lost with two pair, Queens and Fives
Seat 6: Strikerman25 folded before Flop (didn't bet)
Seat 7: matiko09 folded before Flop (didn't bet)
Seat 8: rate8 (button) folded before Flop (didn't bet)
Seat 9: janarr5 (small blind) folded before Flop





PokerStars Hand #153505556816:  Hold'em No Limit (€0.50/€1.00 EUR) - 2016/05/18 21:33:51 CET [2016/05/18 15:33:51 ET]
Table 'Pallas II' 9-max Seat #5 is the button
Seat 1: deadkiller1 (€201.81 in chips) 
Seat 2: matiko09 (€100 in chips) 
Seat 3: Ouga Buga (€101.50 in chips) 
Seat 4: torkkdnm (€171.73 in chips) 
Seat 5: vanilica (€102.62 in chips) 
Seat 6: janarr5 (€106.72 in chips) 
Seat 7: rate8 (€105.62 in chips) 
Seat 8: Kihog (€166.92 in chips) 
Seat 9: stijner1986 (€169.55 in chips) 
janarr5: posts small blind €0.50
rate8: posts big blind €1
*** HOLE CARDS ***
Dealt to matiko09 [7d 4s]
Kihog: folds 
stijner1986: calls €1
deadkiller1: folds 
matiko09: folds 
Ouga Buga: folds 
torkkdnm: folds 
vanilica: folds 
janarr5: folds 
rate8: raises €3.50 to €4.50
stijner1986: calls €3.50
*** FLOP *** [8d Tc 3s]
rate8: bets €6.40
stijner1986: calls €6.40
*** TURN *** [8d Tc 3s] [6c]
rate8: bets €15.25
stijner1986: folds 
Uncalled bet (€15.25) returned to rate8
rate8 collected €21.18 from pot
rate8: doesn't show hand 
*** SUMMARY ***
Total pot €22.30 | Rake €1.12 
Board [8d Tc 3s 6c]
Seat 1: deadkiller1 folded before Flop (didn't bet)
Seat 2: matiko09 folded before Flop (didn't bet)
Seat 3: Ouga Buga folded before Flop (didn't bet)
Seat 4: torkkdnm folded before Flop (didn't bet)
Seat 5: vanilica (button) folded before Flop (didn't bet)
Seat 6: janarr5 (small blind) folded before Flop
Seat 7: rate8 (big blind) collected (€21.18)
Seat 8: Kihog folded before Flop (didn't bet)
Seat 9: stijner1986 folded on the Turn





PokerStars Hand #153505558049:  Hold'em No Limit ($0.50/$1.00 USD) - 2016/05/18 21:33:53 CET [2016/05/18 15:33:53 ET]
Table 'Abetti II' 9-max Seat #1 is the button
Seat 1: matiko09 ($109.42 in chips) 
Seat 2: torkkdnm ($100 in chips) 
Seat 3: cobrik23 ($156.28 in chips) 
Seat 4: ipashutapkom ($40 in chips) 
Seat 5: blufthenuts ($154.49 in chips) 
Seat 6: Kihog ($100 in chips) 
Seat 7: rate8 ($104.28 in chips) 
Seat 8: roadster683 ($184.77 in chips) 
Seat 9: lydia12345 ($292.83 in chips) 
torkkdnm: posts small blind $0.50
cobrik23: posts big blind $1
*** HOLE CARDS ***
Dealt to matiko09 [8h 9s]
ipashutapkom: folds 
blufthenuts: folds 
Kihog: folds 
rate8: folds 
roadster683: raises $1 to $2
lydia12345: calls $2
matiko09: folds 
torkkdnm: folds 
cobrik23: folds 
*** FLOP *** [2c 2s Jc]
roadster683: bets $3
lydia12345: raises $9 to $12
roadster683: folds 
Uncalled bet ($9) returned to lydia12345
lydia12345 collected $10.92 from pot
*** SUMMARY ***
Total pot $11.50 | Rake $0.58 
Board [2c 2s Jc]
Seat 1: matiko09 (button) folded before Flop (didn't bet)
Seat 2: torkkdnm (small blind) folded before Flop
Seat 3: cobrik23 (big blind) folded before Flop
Seat 4: ipashutapkom folded before Flop (didn't bet)
Seat 5: blufthenuts folded before Flop (didn't bet)
Seat 6: Kihog folded before Flop (didn't bet)
Seat 7: rate8 folded before Flop (didn't bet)
Seat 8: roadster683 folded on the Flop
Seat 9: lydia12345 collected ($10.92)





PokerStars Hand #153505566147:  Hold'em No Limit ($0.50/$1.00 USD) - 2016/05/18 21:34:02 CET [2016/05/18 15:34:02 ET]
Table 'Tatjana III' 9-max Seat #6 is the button
Seat 1: cobrik23 ($181.14 in chips) 
Seat 2: vanilica ($120.97 in chips) 
Seat 3: matiko09 ($175.60 in chips) 
Seat 4: lydia12345 ($118.48 in chips) 
Seat 5: deadkiller1 ($100 in chips) 
Seat 6: Kihog ($132.34 in chips) 
Seat 7: rene1984tsv ($108.62 in chips) 
Seat 8: JACQUILF ($125.27 in chips) 
Seat 9: Moszes360 ($108.11 in chips) 
rene1984tsv: posts small blind $0.50
JACQUILF: posts big blind $1
*** HOLE CARDS ***
Dealt to matiko09 [9h Kh]
Moszes360: raises $2 to $3
cobrik23 has timed out
cobrik23: folds 
vanilica: folds 
matiko09: folds 
lydia12345: folds 
deadkiller1: folds 
Kihog: calls $3
rene1984tsv: calls $2.50
JACQUILF: folds 
*** FLOP *** [4d 6s 9d]
rene1984tsv: bets $4.75
Moszes360: folds 
Kihog: calls $4.75
*** TURN *** [4d 6s 9d] [4c]
rene1984tsv: checks 
Kihog: bets $10
rene1984tsv: calls $10
*** RIVER *** [4d 6s 9d 4c] [Qh]
rene1984tsv: checks 
Kihog: checks 
*** SHOW DOWN ***
rene1984tsv: shows [Qs 9c] (two pair, Queens and Nines)
Kihog: mucks hand 
rene1984tsv collected $37.52 from pot
*** SUMMARY ***
Total pot $39.50 | Rake $1.98 
Board [4d 6s 9d 4c Qh]
Seat 1: cobrik23 folded before Flop (didn't bet)
Seat 2: vanilica folded before Flop (didn't bet)
Seat 3: matiko09 folded before Flop (didn't bet)
Seat 4: lydia12345 folded before Flop (didn't bet)
Seat 5: deadkiller1 folded before Flop (didn't bet)
Seat 6: Kihog (button) mucked [3d Ad]
Seat 7: rene1984tsv (small blind) showed [Qs 9c] and won ($37.52) with two pair, Queens and Nines
Seat 8: JACQUILF (big blind) folded before Flop
Seat 9: Moszes360 folded on the Flop





PokerStars Hand #153505567571:  Hold'em No Limit ($0.50/$1.00 USD) - 2016/05/18 21:34:03 CET [2016/05/18 15:34:03 ET]
Table 'Lorcia II' 9-max Seat #8 is the button
Seat 2: lydia12345 ($115.86 in chips) 
Seat 3: matiko09 ($114.55 in chips) 
Seat 4: vanilica ($118.56 in chips) 
Seat 5: nuuaber ($196.95 in chips) 
Seat 6: gkm0nk3y ($100 in chips) 
Seat 7: rate8 ($106.90 in chips) 
Seat 8: Skum1986 ($101 in chips) 
TimStone will be allowed to play after the button
lydia12345: posts small blind $0.50
matiko09: posts big blind $1
*** HOLE CARDS ***
Dealt to matiko09 [6h 7d]
vanilica: folds 
nuuaber: folds 
gkm0nk3y: folds 
rate8: folds 
Skum1986: folds 
lydia12345: folds 
Uncalled bet ($0.50) returned to matiko09
matiko09 collected $1 from pot
matiko09: doesn't show hand 
*** SUMMARY ***
Total pot $1 | Rake $0 
Seat 2: lydia12345 (small blind) folded before Flop
Seat 3: matiko09 (big blind) collected ($1)
Seat 4: vanilica folded before Flop (didn't bet)
Seat 5: nuuaber folded before Flop (didn't bet)
Seat 6: gkm0nk3y folded before Flop (didn't bet)
Seat 7: rate8 folded before Flop (didn't bet)
Seat 8: Skum1986 (button) folded before Flop (didn't bet)





PokerStars Hand #153505584941:  Hold'em No Limit ($0.50/$1.00 USD) - 2016/05/18 21:34:22 CET [2016/05/18 15:34:22 ET]
Table 'Lorcia II' 9-max Seat #2 is the button
Seat 2: lydia12345 ($115.36 in chips) 
Seat 3: matiko09 ($115.05 in chips) 
Seat 4: vanilica ($118.56 in chips) 
Seat 5: nuuaber ($196.95 in chips) 
Seat 6: gkm0nk3y ($100 in chips) 
Seat 7: rate8 ($106.90 in chips) 
Seat 8: Skum1986 ($101 in chips) 
matiko09: posts small blind $0.50
vanilica: posts big blind $1
TimStone: sits out 
*** HOLE CARDS ***
Dealt to matiko09 [4s 7s]
nuuaber: folds 
gkm0nk3y: folds 
rate8: folds 
Skum1986: folds 
lydia12345: raises $2 to $3
matiko09: folds 
vanilica: folds 
Uncalled bet ($2) returned to lydia12345
lydia12345 collected $2.50 from pot
*** SUMMARY ***
Total pot $2.50 | Rake $0 
Seat 2: lydia12345 (button) collected ($2.50)
Seat 3: matiko09 (small blind) folded before Flop
Seat 4: vanilica (big blind) folded before Flop
Seat 5: nuuaber folded before Flop (didn't bet)
Seat 6: gkm0nk3y folded before Flop (didn't bet)
Seat 7: rate8 folded before Flop (didn't bet)
Seat 8: Skum1986 folded before Flop (didn't bet)





PokerStars Hand #153505610163:  Hold'em No Limit ($0.50/$1.00 USD) - 2016/05/18 21:34:50 CET [2016/05/18 15:34:50 ET]
Table 'Abetti II' 9-max Seat #2 is the button
Seat 1: matiko09 ($109.42 in chips) 
Seat 2: torkkdnm ($100 in chips) 
Seat 3: cobrik23 ($155.28 in chips) 
Seat 4: ipashutapkom ($40 in chips) 
Seat 5: blufthenuts ($154.49 in chips) 
Seat 6: Kihog ($100 in chips) 
Seat 7: rate8 ($104.28 in chips) 
Seat 8: roadster683 ($179.77 in chips) 
Seat 9: lydia12345 ($298.75 in chips) 
cobrik23: posts small blind $0.50
ipashutapkom: posts big blind $1
*** HOLE CARDS ***
Dealt to matiko09 [8d 2c]
blufthenuts: folds 
Kihog: folds 
rate8: folds 
roadster683: folds 
lydia12345: folds 
matiko09: folds 
torkkdnm: folds 
cobrik23: folds 
Uncalled bet ($0.50) returned to ipashutapkom
ipashutapkom collected $1 from pot
ipashutapkom: doesn't show hand 
*** SUMMARY ***
Total pot $1 | Rake $0 
Seat 1: matiko09 folded before Flop (didn't bet)
Seat 2: torkkdnm (button) folded before Flop (didn't bet)
Seat 3: cobrik23 (small blind) folded before Flop
Seat 4: ipashutapkom (big blind) collected ($1)
Seat 5: blufthenuts folded before Flop (didn't bet)
Seat 6: Kihog folded before Flop (didn't bet)
Seat 7: rate8 folded before Flop (didn't bet)
Seat 8: roadster683 folded before Flop (didn't bet)
Seat 9: lydia12345 folded before Flop (didn't bet)





PokerStars Hand #153505613866:  Hold'em No Limit ($0.50/$1.00 USD) - 2016/05/18 21:34:54 CET [2016/05/18 15:34:54 ET]
Table 'Zaurak II' 9-max Seat #1 is the button
Seat 1: TimStone ($100 in chips) 
Seat 2: matiko09 ($100 in chips) 
Seat 3: janarr5 ($128.98 in chips) 
Seat 5: rate8 ($126.70 in chips) 
Seat 6: deadkiller1 ($109.48 in chips) 
Seat 7: Kihog ($101.22 in chips) 
Seat 8: Asgel22 ($212.32 in chips) 
Seat 9: torkkdnm ($140.29 in chips) 
matiko09: posts small blind $0.50
janarr5: posts big blind $1
solbi86: sits out 
*** HOLE CARDS ***
Dealt to matiko09 [8d 6s]
rate8: folds 
deadkiller1: folds 
Kihog: folds 
Asgel22: folds 
torkkdnm: folds 
TimStone: folds 
matiko09: folds 
Uncalled bet ($0.50) returned to janarr5
janarr5 collected $1 from pot
janarr5: doesn't show hand 
*** SUMMARY ***
Total pot $1 | Rake $0 
Seat 1: TimStone (button) folded before Flop (didn't bet)
Seat 2: matiko09 (small blind) folded before Flop
Seat 3: janarr5 (big blind) collected ($1)
Seat 5: rate8 folded before Flop (didn't bet)
Seat 6: deadkiller1 folded before Flop (didn't bet)
Seat 7: Kihog folded before Flop (didn't bet)
Seat 8: Asgel22 folded before Flop (didn't bet)
Seat 9: torkkdnm folded before Flop (didn't bet)





PokerStars Hand #153505615785:  Hold'em No Limit (€0.50/€1.00 EUR) - 2016/05/18 21:34:56 CET [2016/05/18 15:34:56 ET]
Table 'Pallas II' 9-max Seat #6 is the button
Seat 1: deadkiller1 (€201.81 in chips) 
Seat 2: matiko09 (€100 in chips) 
Seat 3: Ouga Buga (€101.50 in chips) 
Seat 4: torkkdnm (€171.73 in chips) 
Seat 5: vanilica (€102.62 in chips) 
Seat 6: janarr5 (€106.22 in chips) 
Seat 7: rate8 (€115.90 in chips) 
Seat 8: Kihog (€166.92 in chips) 
Seat 9: stijner1986 (€158.65 in chips) 
rate8: posts small blind €0.50
Kihog: posts big blind €1
*** HOLE CARDS ***
Dealt to matiko09 [6c Qh]
stijner1986: raises €3 to €4
deadkiller1: folds 
matiko09: folds 
Ouga Buga: folds 
torkkdnm: folds 
vanilica: folds 
janarr5: folds 
rate8: folds 
Kihog: folds 
Uncalled bet (€3) returned to stijner1986
stijner1986 collected €2.50 from pot
stijner1986: doesn't show hand 
*** SUMMARY ***
Total pot €2.50 | Rake €0 
Seat 1: deadkiller1 folded before Flop (didn't bet)
Seat 2: matiko09 folded before Flop (didn't bet)
Seat 3: Ouga Buga folded before Flop (didn't bet)
Seat 4: torkkdnm folded before Flop (didn't bet)
Seat 5: vanilica folded before Flop (didn't bet)
Seat 6: janarr5 (button) folded before Flop (didn't bet)
Seat 7: rate8 (small blind) folded before Flop
Seat 8: Kihog (big blind) folded before Flop
Seat 9: stijner1986 collected (€2.50)





PokerStars Hand #153505616079:  Hold'em No Limit ($0.50/$1.00 USD) - 2016/05/18 21:34:56 CET [2016/05/18 15:34:56 ET]
Table 'Brendelia II' 9-max Seat #6 is the button
Seat 2: LebzLouda ($46.28 in chips) 
Seat 3: Zeeshka ($100 in chips) 
Seat 4: gkm0nk3y ($100 in chips) 
Seat 5: Vulturinus ($59.65 in chips) 
Seat 6: TimStone ($133.50 in chips) 
Seat 7: matiko09 ($108.62 in chips) 
Seat 8: solbi86 ($106.50 in chips) 
Seat 9: Kihog ($145.58 in chips) 
matiko09: posts small blind $0.50
solbi86: posts big blind $1
*** HOLE CARDS ***
Dealt to matiko09 [7s Ah]
Kihog: folds 
LebzLouda: folds 
Zeeshka: folds 
gkm0nk3y: folds 
Vulturinus: folds 
Kihog leaves the table
TimStone: folds 
matiko09: raises $1.50 to $2.50
fr3314nc3 joins the table at seat #9 
solbi86: calls $1.50
*** FLOP *** [6c 5s 5c]
matiko09: bets $3.09
solbi86: calls $3.09
*** TURN *** [6c 5s 5c] [Qh]
matiko09: checks 
Mumerka joins the table at seat #1 
Mumerka leaves the table
cobrik23 joins the table at seat #1 
solbi86: checks 
*** RIVER *** [6c 5s 5c Qh] [Ac]
matiko09: checks 
solbi86: bets $7
matiko09: calls $7
*** SHOW DOWN ***
solbi86: shows [8c 9c] (a flush, Ace high)
matiko09: mucks hand 
solbi86 collected $23.92 from pot
*** SUMMARY ***
Total pot $25.18 | Rake $1.26 
Board [6c 5s 5c Qh Ac]
Seat 2: LebzLouda folded before Flop (didn't bet)
Seat 3: Zeeshka folded before Flop (didn't bet)
Seat 4: gkm0nk3y folded before Flop (didn't bet)
Seat 5: Vulturinus folded before Flop (didn't bet)
Seat 6: TimStone (button) folded before Flop (didn't bet)
Seat 7: matiko09 (small blind) mucked [7s Ah]
Seat 8: solbi86 (big blind) showed [8c 9c] and won ($23.92) with a flush, Ace high
Seat 9: Kihog folded before Flop (didn't bet)





PokerStars Hand #153505617959:  Hold'em No Limit ($0.50/$1.00 USD) - 2016/05/18 21:34:58 CET [2016/05/18 15:34:58 ET]
Table 'Lorcia II' 9-max Seat #3 is the button
Seat 2: lydia12345 ($116.86 in chips) 
Seat 3: matiko09 ($114.55 in chips) 
Seat 4: vanilica ($117.56 in chips) 
Seat 5: nuuaber ($196.95 in chips) 
Seat 6: gkm0nk3y ($100 in chips) 
Seat 7: rate8 ($106.90 in chips) 
Seat 8: Skum1986 ($101 in chips) 
vanilica: posts small blind $0.50
nuuaber: posts big blind $1
TimStone: sits out 
*** HOLE CARDS ***
Dealt to matiko09 [Ad Qh]
gkm0nk3y: raises $2 to $3
rate8: folds 
Skum1986: folds 
lydia12345: folds 
matiko09: calls $3
vanilica: folds 
nuuaber: folds 
*** FLOP *** [5d 4s Kd]
gkm0nk3y: checks 
matiko09: bets $4.63
gkm0nk3y: calls $4.63
*** TURN *** [5d 4s Kd] [Qd]
gkm0nk3y: checks 
matiko09: checks 
*** RIVER *** [5d 4s Kd Qd] [Js]
gkm0nk3y: checks 
matiko09: checks 
*** SHOW DOWN ***
gkm0nk3y: shows [Ks As] (a pair of Kings)
matiko09: mucks hand 
gkm0nk3y collected $15.92 from pot
*** SUMMARY ***
Total pot $16.76 | Rake $0.84 
Board [5d 4s Kd Qd Js]
Seat 2: lydia12345 folded before Flop (didn't bet)
Seat 3: matiko09 (button) mucked [Ad Qh]
Seat 4: vanilica (small blind) folded before Flop
Seat 5: nuuaber (big blind) folded before Flop
Seat 6: gkm0nk3y showed [Ks As] and won ($15.92) with a pair of Kings
Seat 7: rate8 folded before Flop (didn't bet)
Seat 8: Skum1986 folded before Flop (didn't bet)





PokerStars Hand #153505639379:  Hold'em No Limit ($0.50/$1.00 USD) - 2016/05/18 21:35:22 CET [2016/05/18 15:35:22 ET]
Table 'Abetti II' 9-max Seat #3 is the button
Seat 1: matiko09 ($109.42 in chips) 
Seat 2: torkkdnm ($100 in chips) 
Seat 3: cobrik23 ($154.78 in chips) 
Seat 4: ipashutapkom ($40.50 in chips) 
Seat 5: blufthenuts ($154.49 in chips) 
Seat 6: Kihog ($100 in chips) 
Seat 7: rate8 ($104.28 in chips) 
Seat 8: roadster683 ($179.77 in chips) 
Seat 9: lydia12345 ($298.75 in chips) 
ipashutapkom: posts small blind $0.50
blufthenuts: posts big blind $1
*** HOLE CARDS ***
Dealt to matiko09 [Ah 5c]
Kihog: folds 
rate8: folds 
roadster683: folds 
lydia12345: folds 
matiko09: folds 
torkkdnm: folds 
cobrik23: raises $1.50 to $2.50
ipashutapkom: folds 
blufthenuts: raises $6.50 to $9
cobrik23: folds 
Uncalled bet ($6.50) returned to blufthenuts
blufthenuts collected $5.50 from pot
blufthenuts: doesn't show hand 
*** SUMMARY ***
Total pot $5.50 | Rake $0 
Seat 1: matiko09 folded before Flop (didn't bet)
Seat 2: torkkdnm folded before Flop (didn't bet)
Seat 3: cobrik23 (button) folded before Flop
Seat 4: ipashutapkom (small blind) folded before Flop
Seat 5: blufthenuts (big blind) collected ($5.50)
Seat 6: Kihog folded before Flop (didn't bet)
Seat 7: rate8 folded before Flop (didn't bet)
Seat 8: roadster683 folded before Flop (didn't bet)
Seat 9: lydia12345 folded before Flop (didn't bet)





PokerStars Hand #153505640237:  Hold'em No Limit ($0.50/$1.00 USD) - 2016/05/18 21:35:23 CET [2016/05/18 15:35:23 ET]
Table 'Samitchell II' 9-max Seat #9 is the button
Seat 1: riggedsh** ($130.75 in chips) 
Seat 2: mooose100 ($75.05 in chips) 
Seat 3: vanilica ($167.75 in chips) 
Seat 4: Zeeshka ($110.27 in chips) 
Seat 5: nuuaber ($62.47 in chips) 
Seat 6: Strikerman25 ($34.62 in chips) 
Seat 7: matiko09 ($111.65 in chips) 
Seat 8: rate8 ($105.88 in chips) 
Seat 9: janarr5 ($100 in chips) 
riggedsh**: posts small blind $0.50
mooose100: posts big blind $1
*** HOLE CARDS ***
Dealt to matiko09 [Tc 6c]
vanilica: folds 
Zeeshka: folds 
nuuaber: raises $2.50 to $3.50
Strikerman25: folds 
matiko09: folds 
rate8: folds 
janarr5: folds 
riggedsh**: folds 
mooose100: folds 
Uncalled bet ($2.50) returned to nuuaber
nuuaber collected $2.50 from pot
nuuaber: doesn't show hand 
*** SUMMARY ***
Total pot $2.50 | Rake $0 
Seat 1: riggedsh** (small blind) folded before Flop
Seat 2: mooose100 (big blind) folded before Flop
Seat 3: vanilica folded before Flop (didn't bet)
Seat 4: Zeeshka folded before Flop (didn't bet)
Seat 5: nuuaber collected ($2.50)
Seat 6: Strikerman25 folded before Flop (didn't bet)
Seat 7: matiko09 folded before Flop (didn't bet)
Seat 8: rate8 folded before Flop (didn't bet)
Seat 9: janarr5 (button) folded before Flop (didn't bet)





PokerStars Hand #153505652887:  Hold'em No Limit (€0.50/€1.00 EUR) - 2016/05/18 21:35:37 CET [2016/05/18 15:35:37 ET]
Table 'Pallas II' 9-max Seat #7 is the button
Seat 1: deadkiller1 (€201.81 in chips) 
Seat 2: matiko09 (€100 in chips) 
Seat 3: Ouga Buga (€101.50 in chips) 
Seat 4: torkkdnm (€171.73 in chips) 
Seat 5: vanilica (€102.62 in chips) 
Seat 6: janarr5 (€106.22 in chips) 
Seat 7: rate8 (€115.40 in chips) 
Seat 8: Kihog (€165.92 in chips) 
Seat 9: stijner1986 (€160.15 in chips) 
Kihog: posts small blind €0.50
stijner1986: posts big blind €1
*** HOLE CARDS ***
Dealt to matiko09 [6s Kc]
deadkiller1: folds 
matiko09: folds 
Ouga Buga: folds 
torkkdnm: folds 
vanilica: folds 
janarr5: folds 
rate8: raises €1 to €2
Kihog: calls €1.50
stijner1986: calls €1
*** FLOP *** [Jd 7c 3d]
Kihog: checks 
stijner1986: checks 
rate8: bets €4.05
Kihog: folds 
stijner1986: folds 
Uncalled bet (€4.05) returned to rate8
rate8 collected €5.70 from pot
rate8: doesn't show hand 
*** SUMMARY ***
Total pot €6 | Rake €0.30 
Board [Jd 7c 3d]
Seat 1: deadkiller1 folded before Flop (didn't bet)
Seat 2: matiko09 folded before Flop (didn't bet)
Seat 3: Ouga Buga folded before Flop (didn't bet)
Seat 4: torkkdnm folded before Flop (didn't bet)
Seat 5: vanilica folded before Flop (didn't bet)
Seat 6: janarr5 folded before Flop (didn't bet)
Seat 7: rate8 (button) collected (€5.70)
Seat 8: Kihog (small blind) folded on the Flop
Seat 9: stijner1986 (big blind) folded on the Flop





PokerStars Hand #153505654440:  Hold'em No Limit ($0.50/$1.00 USD) - 2016/05/18 21:35:38 CET [2016/05/18 15:35:38 ET]
Table 'Tatjana III' 9-max Seat #7 is the button
Seat 2: vanilica ($120.97 in chips) 
Seat 3: matiko09 ($175.60 in chips) 
Seat 4: lydia12345 ($118.48 in chips) 
Seat 5: deadkiller1 ($100 in chips) 
Seat 6: Kihog ($114.59 in chips) 
Seat 7: rene1984tsv ($128.39 in chips) 
Seat 8: JACQUILF ($124.27 in chips) 
Seat 9: Moszes360 ($105.11 in chips) 
JACQUILF: posts small blind $0.50
Moszes360: posts big blind $1
*** HOLE CARDS ***
Dealt to matiko09 [As Kc]
vanilica: raises $1.85 to $2.85
matiko09: calls $2.85
lydia12345: folds 
deadkiller1: folds 
Kihog: folds 
rene1984tsv: calls $2.85
JACQUILF: raises $12.15 to $15
Moszes360: folds 
vanilica: folds 
matiko09: calls $12.15
rene1984tsv: folds 
*** FLOP *** [Ts Th 8h]
JACQUILF: bets $12
matiko09: calls $12
*** TURN *** [Ts Th 8h] [5c]
JACQUILF: bets $29
matiko09: folds 
Uncalled bet ($29) returned to JACQUILF
JACQUILF collected $58.20 from pot
JACQUILF: doesn't show hand 
*** SUMMARY ***
Total pot $60.70 | Rake $2.50 
Board [Ts Th 8h 5c]
Seat 2: vanilica folded before Flop
Seat 3: matiko09 folded on the Turn
Seat 4: lydia12345 folded before Flop (didn't bet)
Seat 5: deadkiller1 folded before Flop (didn't bet)
Seat 6: Kihog folded before Flop (didn't bet)
Seat 7: rene1984tsv (button) folded before Flop
Seat 8: JACQUILF (small blind) collected ($58.20)
Seat 9: Moszes360 (big blind) folded before Flop





PokerStars Hand #153505665321:  Hold'em No Limit ($0.50/$1.00 USD) - 2016/05/18 21:35:50 CET [2016/05/18 15:35:50 ET]
Table 'Zaurak II' 9-max Seat #2 is the button
Seat 1: TimStone ($100 in chips) 
Seat 2: matiko09 ($100 in chips) 
Seat 3: janarr5 ($129.48 in chips) 
Seat 4: solbi86 ($143 in chips) 
Seat 5: rate8 ($126.70 in chips) 
Seat 6: deadkiller1 ($109.48 in chips) 
Seat 7: Kihog ($101.22 in chips) 
Seat 8: Asgel22 ($212.32 in chips) 
Seat 9: torkkdnm ($140.29 in chips) 
janarr5: posts small blind $0.50
solbi86: posts big blind $1
*** HOLE CARDS ***
Dealt to matiko09 [4c Ts]
rate8: folds 
deadkiller1: folds 
Kihog: folds 
Asgel22: folds 
torkkdnm: folds 
TimStone: raises $1.52 to $2.52
matiko09: folds 
janarr5: folds 
solbi86: folds 
Uncalled bet ($1.52) returned to TimStone
TimStone collected $2.50 from pot
TimStone: doesn't show hand 
*** SUMMARY ***
Total pot $2.50 | Rake $0 
Seat 1: TimStone collected ($2.50)
Seat 2: matiko09 (button) folded before Flop (didn't bet)
Seat 3: janarr5 (small blind) folded before Flop
Seat 4: solbi86 (big blind) folded before Flop
Seat 5: rate8 folded before Flop (didn't bet)
Seat 6: deadkiller1 folded before Flop (didn't bet)
Seat 7: Kihog folded before Flop (didn't bet)
Seat 8: Asgel22 folded before Flop (didn't bet)
Seat 9: torkkdnm folded before Flop (didn't bet)





PokerStars Hand #153505670726:  Hold'em No Limit ($0.50/$1.00 USD) - 2016/05/18 21:35:56 CET [2016/05/18 15:35:56 ET]
Table 'Lorcia II' 9-max Seat #4 is the button
Seat 2: lydia12345 ($116.86 in chips) 
Seat 3: matiko09 ($106.92 in chips) 
Seat 4: vanilica ($117.06 in chips) 
Seat 5: nuuaber ($195.95 in chips) 
Seat 6: gkm0nk3y ($108.29 in chips) 
Seat 7: rate8 ($106.90 in chips) 
Seat 8: Skum1986 ($101 in chips) 
nuuaber: posts small blind $0.50
gkm0nk3y: posts big blind $1
TimStone: sits out 
*** HOLE CARDS ***
Dealt to matiko09 [Jc 5s]
rate8: folds 
Skum1986: folds 
lydia12345: folds 
matiko09: folds 
vanilica: folds 
nuuaber: calls $0.50
gkm0nk3y: raises $3 to $4
nuuaber: calls $3
*** FLOP *** [8c 6s Qs]
nuuaber: bets $7
gkm0nk3y: folds 
Uncalled bet ($7) returned to nuuaber
nuuaber collected $7.60 from pot
nuuaber: doesn't show hand 
*** SUMMARY ***
Total pot $8 | Rake $0.40 
Board [8c 6s Qs]
Seat 2: lydia12345 folded before Flop (didn't bet)
Seat 3: matiko09 folded before Flop (didn't bet)
Seat 4: vanilica (button) folded before Flop (didn't bet)
Seat 5: nuuaber (small blind) collected ($7.60)
Seat 6: gkm0nk3y (big blind) folded on the Flop
Seat 7: rate8 folded before Flop (didn't bet)
Seat 8: Skum1986 folded before Flop (didn't bet)





PokerStars Hand #153505677123:  Hold'em No Limit ($0.50/$1.00 USD) - 2016/05/18 21:36:03 CET [2016/05/18 15:36:03 ET]
Table 'Abetti II' 9-max Seat #4 is the button
Seat 1: matiko09 ($109.42 in chips) 
Seat 2: torkkdnm ($100 in chips) 
Seat 3: cobrik23 ($152.28 in chips) 
Seat 4: ipashutapkom ($40 in chips) 
Seat 5: blufthenuts ($157.49 in chips) 
Seat 6: Kihog ($100 in chips) 
Seat 7: rate8 ($104.28 in chips) 
Seat 8: roadster683 ($179.77 in chips) 
Seat 9: lydia12345 ($298.75 in chips) 
blufthenuts: posts small blind $0.50
Kihog: posts big blind $1
*** HOLE CARDS ***
Dealt to matiko09 [Ts 2s]
rate8: folds 
roadster683: calls $1
lydia12345: folds 
matiko09: folds 
torkkdnm: folds 
cobrik23: folds 
ipashutapkom: folds 
blufthenuts: folds 
Kihog: checks 
*** FLOP *** [Kh Kd Qs]
Kihog: checks 
roadster683: bets $1
Kihog: folds 
Uncalled bet ($1) returned to roadster683
roadster683 collected $2.38 from pot
roadster683: doesn't show hand 
*** SUMMARY ***
Total pot $2.50 | Rake $0.12 
Board [Kh Kd Qs]
Seat 1: matiko09 folded before Flop (didn't bet)
Seat 2: torkkdnm folded before Flop (didn't bet)
Seat 3: cobrik23 folded before Flop (didn't bet)
Seat 4: ipashutapkom (button) folded before Flop (didn't bet)
Seat 5: blufthenuts (small blind) folded before Flop
Seat 6: Kihog (big blind) folded on the Flop
Seat 7: rate8 folded before Flop (didn't bet)
Seat 8: roadster683 collected ($2.38)
Seat 9: lydia12345 folded before Flop (didn't bet)





PokerStars Hand #153505677457:  Hold'em No Limit ($0.50/$1.00 USD) - 2016/05/18 21:36:03 CET [2016/05/18 15:36:03 ET]
Table 'Samitchell II' 9-max Seat #1 is the button
Seat 1: riggedsh** ($130.25 in chips) 
Seat 2: mooose100 ($74.05 in chips) 
Seat 3: vanilica ($167.75 in chips) 
Seat 4: Zeeshka ($110.27 in chips) 
Seat 5: nuuaber ($63.97 in chips) 
Seat 6: Strikerman25 ($34.62 in chips) 
Seat 7: matiko09 ($111.65 in chips) 
Seat 8: rate8 ($105.88 in chips) 
Seat 9: janarr5 ($100 in chips) 
mooose100: posts small blind $0.50
vanilica: posts big blind $1
*** HOLE CARDS ***
Dealt to matiko09 [3c 7d]
Zeeshka: folds 
nuuaber: raises $3 to $4
Strikerman25: folds 
matiko09: folds 
rate8: folds 
janarr5: folds 
riggedsh**: folds 
mooose100: folds 
vanilica: folds 
Uncalled bet ($3) returned to nuuaber
nuuaber collected $2.50 from pot
nuuaber: doesn't show hand 
*** SUMMARY ***
Total pot $2.50 | Rake $0 
Seat 1: riggedsh** (button) folded before Flop (didn't bet)
Seat 2: mooose100 (small blind) folded before Flop
Seat 3: vanilica (big blind) folded before Flop
Seat 4: Zeeshka folded before Flop (didn't bet)
Seat 5: nuuaber collected ($2.50)
Seat 6: Strikerman25 folded before Flop (didn't bet)
Seat 7: matiko09 folded before Flop (didn't bet)
Seat 8: rate8 folded before Flop (didn't bet)
Seat 9: janarr5 folded before Flop (didn't bet)





PokerStars Hand #153505695236:  Hold'em No Limit ($0.50/$1.00 USD) - 2016/05/18 21:36:22 CET [2016/05/18 15:36:22 ET]
Table 'Zaurak II' 9-max Seat #3 is the button
Seat 1: TimStone ($101.50 in chips) 
Seat 2: matiko09 ($100 in chips) 
Seat 3: janarr5 ($128.98 in chips) 
Seat 4: solbi86 ($142 in chips) 
Seat 5: rate8 ($126.70 in chips) 
Seat 6: deadkiller1 ($109.48 in chips) 
Seat 7: Kihog ($101.22 in chips) 
Seat 8: Asgel22 ($212.32 in chips) 
Seat 9: torkkdnm ($140.29 in chips) 
solbi86: posts small blind $0.50
rate8: posts big blind $1
*** HOLE CARDS ***
Dealt to matiko09 [Kd 2d]
deadkiller1: folds 
Kihog: folds 
Asgel22: folds 
torkkdnm: folds 
TimStone: folds 
matiko09: folds 
janarr5: raises $1.50 to $2.50
solbi86: folds 
rate8: folds 
Uncalled bet ($1.50) returned to janarr5
janarr5 collected $2.50 from pot
janarr5: doesn't show hand 
*** SUMMARY ***
Total pot $2.50 | Rake $0 
Seat 1: TimStone folded before Flop (didn't bet)
Seat 2: matiko09 folded before Flop (didn't bet)
Seat 3: janarr5 (button) collected ($2.50)
Seat 4: solbi86 (small blind) folded before Flop
Seat 5: rate8 (big blind) folded before Flop
Seat 6: deadkiller1 folded before Flop (didn't bet)
Seat 7: Kihog folded before Flop (didn't bet)
Seat 8: Asgel22 folded before Flop (didn't bet)
Seat 9: torkkdnm folded before Flop (didn't bet)





PokerStars Hand #153505700489:  Hold'em No Limit (€0.50/€1.00 EUR) - 2016/05/18 21:36:28 CET [2016/05/18 15:36:28 ET]
Table 'Pallas II' 9-max Seat #8 is the button
Seat 1: deadkiller1 (€201.81 in chips) 
Seat 2: matiko09 (€100 in chips) 
Seat 3: Ouga Buga (€101.50 in chips) 
Seat 4: torkkdnm (€171.73 in chips) 
Seat 5: vanilica (€102.62 in chips) 
Seat 6: janarr5 (€106.22 in chips) 
Seat 7: rate8 (€119.10 in chips) 
Seat 8: Kihog (€163.92 in chips) 
Seat 9: stijner1986 (€158.15 in chips) 
stijner1986: posts small blind €0.50
deadkiller1: posts big blind €1
*** HOLE CARDS ***
Dealt to matiko09 [3c Td]
matiko09: folds 
Ouga Buga: folds 
torkkdnm: raises €2 to €3
vanilica: folds 
janarr5: folds 
rate8: calls €3
Kihog: calls €3
stijner1986: folds 
deadkiller1: folds 
*** FLOP *** [Ah 6h 5c]
torkkdnm: bets €7
rate8: calls €7
Kihog: raises €18 to €25
torkkdnm: folds 
rate8: folds 
Uncalled bet (€18) returned to Kihog
Kihog collected €29.92 from pot
Kihog: doesn't show hand 
*** SUMMARY ***
Total pot €31.50 | Rake €1.58 
Board [Ah 6h 5c]
Seat 1: deadkiller1 (big blind) folded before Flop
Seat 2: matiko09 folded before Flop (didn't bet)
Seat 3: Ouga Buga folded before Flop (didn't bet)
Seat 4: torkkdnm folded on the Flop
Seat 5: vanilica folded before Flop (didn't bet)
Seat 6: janarr5 folded before Flop (didn't bet)
Seat 7: rate8 folded on the Flop
Seat 8: Kihog (button) collected (€29.92)
Seat 9: stijner1986 (small blind) folded before Flop





PokerStars Hand #153505714744:  Hold'em No Limit ($0.50/$1.00 USD) - 2016/05/18 21:36:43 CET [2016/05/18 15:36:43 ET]
Table 'Lorcia II' 9-max Seat #5 is the button
Seat 2: lydia12345 ($116.86 in chips) 
Seat 3: matiko09 ($106.92 in chips) 
Seat 4: vanilica ($117.06 in chips) 
Seat 5: nuuaber ($199.55 in chips) 
Seat 6: gkm0nk3y ($104.29 in chips) 
Seat 7: rate8 ($106.90 in chips) 
Seat 8: Skum1986 ($101 in chips) 
gkm0nk3y: posts small blind $0.50
rate8: posts big blind $1
TimStone: sits out 
*** HOLE CARDS ***
Dealt to matiko09 [3c Ah]
Skum1986: raises $2 to $3
lydia12345: folds 
matiko09: folds 
vanilica: folds 
nuuaber: raises $3 to $6
gkm0nk3y: folds 
rate8: folds 
Skum1986: calls $3
*** FLOP *** [7s 2d 7d]
Skum1986: checks 
nuuaber: bets $6
Skum1986: folds 
Uncalled bet ($6) returned to nuuaber
nuuaber collected $12.82 from pot
nuuaber: doesn't show hand 
*** SUMMARY ***
Total pot $13.50 | Rake $0.68 
Board [7s 2d 7d]
Seat 2: lydia12345 folded before Flop (didn't bet)
Seat 3: matiko09 folded before Flop (didn't bet)
Seat 4: vanilica folded before Flop (didn't bet)
Seat 5: nuuaber (button) collected ($12.82)
Seat 6: gkm0nk3y (small blind) folded before Flop
Seat 7: rate8 (big blind) folded before Flop
Seat 8: Skum1986 folded on the Flop





PokerStars Hand #153505721266:  Hold'em No Limit ($0.50/$1.00 USD) - 2016/05/18 21:36:51 CET [2016/05/18 15:36:51 ET]
Table 'Zaurak II' 9-max Seat #4 is the button
Seat 1: TimStone ($101.50 in chips) 
Seat 2: matiko09 ($100 in chips) 
Seat 3: janarr5 ($130.48 in chips) 
Seat 4: solbi86 ($141.50 in chips) 
Seat 5: rate8 ($125.70 in chips) 
Seat 6: deadkiller1 ($109.48 in chips) 
Seat 7: Kihog ($101.22 in chips) 
Seat 8: Asgel22 ($212.32 in chips) 
Seat 9: torkkdnm ($140.29 in chips) 
rate8: posts small blind $0.50
deadkiller1: posts big blind $1
*** HOLE CARDS ***
Dealt to matiko09 [Ks 8s]
Kihog: folds 
Asgel22: calls $1
torkkdnm: folds 
TimStone: folds 
matiko09: folds 
janarr5: folds 
solbi86: folds 
rate8: folds 
deadkiller1: raises $4 to $5
Asgel22: calls $4
*** FLOP *** [4d Qd 2d]
deadkiller1: checks 
Asgel22: bets $5
deadkiller1: calls $5
*** TURN *** [4d Qd 2d] [Jc]
deadkiller1: checks 
Asgel22: bets $7
deadkiller1: calls $7
*** RIVER *** [4d Qd 2d Jc] [8c]
deadkiller1: checks 
Asgel22: checks 
*** SHOW DOWN ***
deadkiller1: shows [9c 9d] (a pair of Nines)
Asgel22: shows [Qh As] (a pair of Queens)
Asgel22 collected $32.78 from pot
*** SUMMARY ***
Total pot $34.50 | Rake $1.72 
Board [4d Qd 2d Jc 8c]
Seat 1: TimStone folded before Flop (didn't bet)
Seat 2: matiko09 folded before Flop (didn't bet)
Seat 3: janarr5 folded before Flop (didn't bet)
Seat 4: solbi86 (button) folded before Flop (didn't bet)
Seat 5: rate8 (small blind) folded before Flop
Seat 6: deadkiller1 (big blind) showed [9c 9d] and lost with a pair of Nines
Seat 7: Kihog folded before Flop (didn't bet)
Seat 8: Asgel22 showed [Qh As] and won ($32.78) with a pair of Queens
Seat 9: torkkdnm folded before Flop (didn't bet)





PokerStars Hand #153505723006:  Hold'em No Limit ($0.50/$1.00 USD) - 2016/05/18 21:36:53 CET [2016/05/18 15:36:53 ET]
Table 'Brendelia II' 9-max Seat #7 is the button
Seat 2: LebzLouda ($46.28 in chips) 
Seat 3: Zeeshka ($100 in chips) 
Seat 4: gkm0nk3y ($100 in chips) 
Seat 5: Vulturinus ($59.65 in chips) 
Seat 6: TimStone ($133.50 in chips) 
Seat 7: matiko09 ($100 in chips) 
Seat 8: solbi86 ($117.83 in chips) 
Seat 9: fr3314nc3 ($100 in chips) 
solbi86: posts small blind $0.50
fr3314nc3: posts big blind $1
cobrik23: sits out 
*** HOLE CARDS ***
Dealt to matiko09 [4c Ac]
LebzLouda: folds 
Zeeshka: folds 
gkm0nk3y: folds 
Vulturinus: folds 
TimStone: raises $1.52 to $2.52
matiko09: raises $6.48 to $9
solbi86: raises $11 to $20
fr3314nc3: folds 
TimStone: folds 
matiko09: folds 
Uncalled bet ($11) returned to solbi86
solbi86 collected $21.52 from pot
solbi86: doesn't show hand 
*** SUMMARY ***
Total pot $21.52 | Rake $0 
Seat 2: LebzLouda folded before Flop (didn't bet)
Seat 3: Zeeshka folded before Flop (didn't bet)
Seat 4: gkm0nk3y folded before Flop (didn't bet)
Seat 5: Vulturinus folded before Flop (didn't bet)
Seat 6: TimStone folded before Flop
Seat 7: matiko09 (button) folded before Flop
Seat 8: solbi86 (small blind) collected ($21.52)
Seat 9: fr3314nc3 (big blind) folded before Flop





PokerStars Hand #153505727204:  Hold'em No Limit ($0.50/$1.00 USD) - 2016/05/18 21:36:57 CET [2016/05/18 15:36:57 ET]
Table 'Tatjana III' 9-max Seat #8 is the button
Seat 2: vanilica ($118.12 in chips) 
Seat 3: matiko09 ($148.60 in chips) 
Seat 4: lydia12345 ($118.48 in chips) 
Seat 5: deadkiller1 ($100 in chips) 
Seat 6: Kihog ($114.59 in chips) 
Seat 7: rene1984tsv ($125.54 in chips) 
Seat 8: JACQUILF ($155.47 in chips) 
Seat 9: Moszes360 ($104.11 in chips) 
Moszes360: posts small blind $0.50
vanilica: posts big blind $1
*** HOLE CARDS ***
Dealt to matiko09 [Ad Ah]
matiko09: calls $1
lydia12345: folds 
lydia12345 leaves the table
deadkiller1: folds 
Kihog: folds 
rene1984tsv: raises $2 to $3
JACQUILF: folds 
Moszes360: folds 
vanilica: folds 
matiko09: raises $9 to $12
rene1984tsv: calls $9
*** FLOP *** [Js 5h Tc]
matiko09: bets $16
rene1984tsv: calls $16
*** TURN *** [Js 5h Tc] [As]
ipashutapkom joins the table at seat #4 
matiko09: bets $35
rene1984tsv: folds 
Uncalled bet ($35) returned to matiko09
matiko09 collected $55 from pot
matiko09: doesn't show hand 
*** SUMMARY ***
Total pot $57.50 | Rake $2.50 
Board [Js 5h Tc As]
Seat 2: vanilica (big blind) folded before Flop
Seat 3: matiko09 collected ($55)
Seat 4: lydia12345 folded before Flop (didn't bet)
Seat 5: deadkiller1 folded before Flop (didn't bet)
Seat 6: Kihog folded before Flop (didn't bet)
Seat 7: rene1984tsv folded on the Turn
Seat 8: JACQUILF (button) folded before Flop (didn't bet)
Seat 9: Moszes360 (small blind) folded before Flop





PokerStars Hand #153505727976:  Hold'em No Limit ($0.50/$1.00 USD) - 2016/05/18 21:36:58 CET [2016/05/18 15:36:58 ET]
Table 'Samitchell II' 9-max Seat #2 is the button
Seat 1: riggedsh** ($130.25 in chips) 
Seat 2: mooose100 ($73.55 in chips) 
Seat 3: vanilica ($166.75 in chips) 
Seat 4: Zeeshka ($110.27 in chips) 
Seat 5: nuuaber ($65.47 in chips) 
Seat 6: Strikerman25 ($34.62 in chips) 
Seat 7: matiko09 ($111.65 in chips) 
Seat 8: rate8 ($105.88 in chips) 
Seat 9: janarr5 ($100 in chips) 
vanilica: posts small blind $0.50
Zeeshka: posts big blind $1
*** HOLE CARDS ***
Dealt to matiko09 [Kd 7s]
nuuaber: folds 
Strikerman25: folds 
matiko09: folds 
rate8: folds 
janarr5: raises $2 to $3
riggedsh**: folds 
mooose100: calls $3
vanilica: calls $2.50
Zeeshka: folds 
*** FLOP *** [5h 7d 5c]
vanilica: checks 
janarr5: bets $7
mooose100: folds 
vanilica: folds 
Uncalled bet ($7) returned to janarr5
janarr5 collected $9.50 from pot
janarr5: doesn't show hand 
*** SUMMARY ***
Total pot $10 | Rake $0.50 
Board [5h 7d 5c]
Seat 1: riggedsh** folded before Flop (didn't bet)
Seat 2: mooose100 (button) folded on the Flop
Seat 3: vanilica (small blind) folded on the Flop
Seat 4: Zeeshka (big blind) folded before Flop
Seat 5: nuuaber folded before Flop (didn't bet)
Seat 6: Strikerman25 folded before Flop (didn't bet)
Seat 7: matiko09 folded before Flop (didn't bet)
Seat 8: rate8 folded before Flop (didn't bet)
Seat 9: janarr5 collected ($9.50)





PokerStars Hand #153505730517:  Hold'em No Limit ($0.50/$1.00 USD) - 2016/05/18 21:37:01 CET [2016/05/18 15:37:01 ET]
Table 'Abetti II' 9-max Seat #5 is the button
Seat 1: matiko09 ($109.42 in chips) 
Seat 2: torkkdnm ($100 in chips) 
Seat 3: cobrik23 ($152.28 in chips) 
Seat 4: ipashutapkom ($40 in chips) 
Seat 5: blufthenuts ($156.99 in chips) 
Seat 6: Kihog ($100 in chips) 
Seat 7: rate8 ($104.28 in chips) 
Seat 8: roadster683 ($181.15 in chips) 
Seat 9: lydia12345 ($298.75 in chips) 
Kihog: posts small blind $0.50
rate8: posts big blind $1
*** HOLE CARDS ***
Dealt to matiko09 [3d As]
roadster683: folds 
lydia12345: folds 
matiko09: folds 
torkkdnm: folds 
cobrik23: folds 
ipashutapkom: folds 
blufthenuts: folds 
Kihog: raises $1.50 to $2.50
rate8: folds 
Uncalled bet ($1.50) returned to Kihog
Kihog collected $2 from pot
Kihog: doesn't show hand 
*** SUMMARY ***
Total pot $2 | Rake $0 
Seat 1: matiko09 folded before Flop (didn't bet)
Seat 2: torkkdnm folded before Flop (didn't bet)
Seat 3: cobrik23 folded before Flop (didn't bet)
Seat 4: ipashutapkom folded before Flop (didn't bet)
Seat 5: blufthenuts (button) folded before Flop (didn't bet)
Seat 6: Kihog (small blind) collected ($2)
Seat 7: rate8 (big blind) folded before Flop
Seat 8: roadster683 folded before Flop (didn't bet)
Seat 9: lydia12345 folded before Flop (didn't bet)





PokerStars Hand #153505763626:  Hold'em No Limit ($0.50/$1.00 USD) - 2016/05/18 21:37:37 CET [2016/05/18 15:37:37 ET]
Table 'Lorcia II' 9-max Seat #6 is the button
Seat 2: lydia12345 ($116.86 in chips) 
Seat 3: matiko09 ($106.92 in chips) 
Seat 4: vanilica ($117.06 in chips) 
Seat 5: nuuaber ($206.37 in chips) 
Seat 6: gkm0nk3y ($103.79 in chips) 
Seat 7: rate8 ($105.90 in chips) 
Seat 8: Skum1986 ($100 in chips) 
rate8: posts small blind $0.50
Skum1986: posts big blind $1
TimStone: sits out 
*** HOLE CARDS ***
Dealt to matiko09 [9d Jd]
lydia12345: raises $2 to $3
matiko09: folds 
vanilica: folds 
nuuaber: folds 
gkm0nk3y: folds 
rate8: folds 
Skum1986: folds 
Uncalled bet ($2) returned to lydia12345
lydia12345 collected $2.50 from pot
*** SUMMARY ***
Total pot $2.50 | Rake $0 
Seat 2: lydia12345 collected ($2.50)
Seat 3: matiko09 folded before Flop (didn't bet)
Seat 4: vanilica folded before Flop (didn't bet)
Seat 5: nuuaber folded before Flop (didn't bet)
Seat 6: gkm0nk3y (button) folded before Flop (didn't bet)
Seat 7: rate8 (small blind) folded before Flop
Seat 8: Skum1986 (big blind) folded before Flop





PokerStars Hand #153505764418:  Hold'em No Limit ($0.50/$1.00 USD) - 2016/05/18 21:37:37 CET [2016/05/18 15:37:37 ET]
Table 'Abetti II' 9-max Seat #6 is the button
Seat 1: matiko09 ($109.42 in chips) 
Seat 2: torkkdnm ($100 in chips) 
Seat 3: cobrik23 ($152.28 in chips) 
Seat 4: ipashutapkom ($40 in chips) 
Seat 5: blufthenuts ($156.99 in chips) 
Seat 6: Kihog ($101 in chips) 
Seat 7: rate8 ($103.28 in chips) 
Seat 8: roadster683 ($181.15 in chips) 
Seat 9: lydia12345 ($298.75 in chips) 
rate8: posts small blind $0.50
roadster683: posts big blind $1
*** HOLE CARDS ***
Dealt to matiko09 [6d Qh]
lydia12345: folds 
matiko09: folds 
lydia12345 leaves the table
torkkdnm: folds 
cobrik23: folds 
ipashutapkom: folds 
vanilica joins the table at seat #9 
blufthenuts: raises $2 to $3
Kihog: folds 
rate8: folds 
roadster683: calls $2
*** FLOP *** [5s Qd 5d]
roadster683: checks 
blufthenuts: checks 
*** TURN *** [5s Qd 5d] [7s]
roadster683: checks 
blufthenuts: bets $4.32
roadster683: folds 
Uncalled bet ($4.32) returned to blufthenuts
blufthenuts collected $6.18 from pot
blufthenuts: doesn't show hand 
*** SUMMARY ***
Total pot $6.50 | Rake $0.32 
Board [5s Qd 5d 7s]
Seat 1: matiko09 folded before Flop (didn't bet)
Seat 2: torkkdnm folded before Flop (didn't bet)
Seat 3: cobrik23 folded before Flop (didn't bet)
Seat 4: ipashutapkom folded before Flop (didn't bet)
Seat 5: blufthenuts collected ($6.18)
Seat 6: Kihog (button) folded before Flop (didn't bet)
Seat 7: rate8 (small blind) folded before Flop
Seat 8: roadster683 (big blind) folded on the Turn
Seat 9: lydia12345 folded before Flop (didn't bet)





PokerStars Hand #153505765694:  Hold'em No Limit ($0.50/$1.00 USD) - 2016/05/18 21:37:39 CET [2016/05/18 15:37:39 ET]
Table 'Tatjana III' 9-max Seat #9 is the button
Seat 2: vanilica ($117.12 in chips) 
Seat 3: matiko09 ($175.60 in chips) 
Seat 5: deadkiller1 ($100 in chips) 
Seat 6: Kihog ($114.59 in chips) 
Seat 7: rene1984tsv ($97.54 in chips) 
Seat 8: JACQUILF ($155.47 in chips) 
Seat 9: Moszes360 ($103.61 in chips) 
cobrik23 will be allowed to play after the button
vanilica: posts small blind $0.50
matiko09: posts big blind $1
ipashutapkom: sits out 
*** HOLE CARDS ***
Dealt to matiko09 [Jc 9h]
deadkiller1: folds 
Kihog: folds 
rene1984tsv: raises $2.50 to $3.50
JACQUILF: calls $3.50
Moszes360: folds 
vanilica: folds 
matiko09: folds 
*** FLOP *** [6s 8s 8c]
rene1984tsv: checks 
JACQUILF: bets $5.65
rene1984tsv: raises $5.65 to $11.30
JACQUILF: calls $5.65
*** TURN *** [6s 8s 8c] [8d]
rene1984tsv: checks 
JACQUILF: checks 
*** RIVER *** [6s 8s 8c 8d] [3s]
rene1984tsv: checks 
JACQUILF: bets $19.50
rene1984tsv: folds 
Uncalled bet ($19.50) returned to JACQUILF
JACQUILF collected $29.54 from pot
JACQUILF: doesn't show hand 
*** SUMMARY ***
Total pot $31.10 | Rake $1.56 
Board [6s 8s 8c 8d 3s]
Seat 2: vanilica (small blind) folded before Flop
Seat 3: matiko09 (big blind) folded before Flop
Seat 5: deadkiller1 folded before Flop (didn't bet)
Seat 6: Kihog folded before Flop (didn't bet)
Seat 7: rene1984tsv folded on the River
Seat 8: JACQUILF collected ($29.54)
Seat 9: Moszes360 (button) folded before Flop (didn't bet)





PokerStars Hand #153505770329:  Hold'em No Limit ($0.50/$1.00 USD) - 2016/05/18 21:37:44 CET [2016/05/18 15:37:44 ET]
Table 'Brendelia II' 9-max Seat #8 is the button
Seat 1: cobrik23 ($72.92 in chips) 
Seat 2: LebzLouda ($46.28 in chips) 
Seat 3: Zeeshka ($100 in chips) 
Seat 4: gkm0nk3y ($100 in chips) 
Seat 5: Vulturinus ($59.65 in chips) 
Seat 6: TimStone ($130.98 in chips) 
Seat 7: matiko09 ($100 in chips) 
Seat 8: solbi86 ($130.35 in chips) 
Seat 9: fr3314nc3 ($99 in chips) 
fr3314nc3: posts small blind $0.50
cobrik23: posts big blind $1
*** HOLE CARDS ***
Dealt to matiko09 [4h Qs]
LebzLouda: raises $2 to $3
Zeeshka: folds 
gkm0nk3y: raises $6 to $9
Vulturinus: folds 
TimStone: folds 
matiko09: folds 
solbi86: folds 
fr3314nc3: folds 
cobrik23: folds 
LebzLouda: calls $6
*** FLOP *** [2s Tc 3c]
LebzLouda: checks 
gkm0nk3y: checks 
*** TURN *** [2s Tc 3c] [Jh]
LebzLouda: checks 
gkm0nk3y: bets $9
LebzLouda: calls $9
*** RIVER *** [2s Tc 3c Jh] [6d]
LebzLouda: checks 
gkm0nk3y: bets $82 and is all-in
LebzLouda: folds 
Uncalled bet ($82) returned to gkm0nk3y
gkm0nk3y collected $35.62 from pot
*** SUMMARY ***
Total pot $37.50 | Rake $1.88 
Board [2s Tc 3c Jh 6d]
Seat 1: cobrik23 (big blind) folded before Flop
Seat 2: LebzLouda folded on the River
Seat 3: Zeeshka folded before Flop (didn't bet)
Seat 4: gkm0nk3y collected ($35.62)
Seat 5: Vulturinus folded before Flop (didn't bet)
Seat 6: TimStone folded before Flop (didn't bet)
Seat 7: matiko09 folded before Flop (didn't bet)
Seat 8: solbi86 (button) folded before Flop (didn't bet)
Seat 9: fr3314nc3 (small blind) folded before Flop





PokerStars Hand #153505776118:  Hold'em No Limit ($0.50/$1.00 USD) - 2016/05/18 21:37:50 CET [2016/05/18 15:37:50 ET]
Table 'Samitchell II' 9-max Seat #3 is the button
Seat 1: riggedsh** ($130.25 in chips) 
Seat 2: mooose100 ($70.55 in chips) 
Seat 3: vanilica ($163.75 in chips) 
Seat 4: Zeeshka ($109.27 in chips) 
Seat 5: nuuaber ($65.47 in chips) 
Seat 6: Strikerman25 ($34.62 in chips) 
Seat 7: matiko09 ($111.65 in chips) 
Seat 8: rate8 ($105.88 in chips) 
Seat 9: janarr5 ($106.50 in chips) 
Zeeshka: posts small blind $0.50
nuuaber: posts big blind $1
*** HOLE CARDS ***
Dealt to matiko09 [7c Ks]
Strikerman25: folds 
matiko09: folds 
rate8: raises $2 to $3
janarr5: folds 
riggedsh**: calls $3
mooose100: folds 
vanilica: folds 
Zeeshka: folds 
nuuaber: calls $2
*** FLOP *** [5c 2d Qc]
nuuaber: checks 
rate8: checks 
riggedsh**: bets $4.51
nuuaber: folds 
rate8: folds 
Uncalled bet ($4.51) returned to riggedsh**
riggedsh** collected $9.02 from pot
riggedsh**: doesn't show hand 
*** SUMMARY ***
Total pot $9.50 | Rake $0.48 
Board [5c 2d Qc]
Seat 1: riggedsh** collected ($9.02)
Seat 2: mooose100 folded before Flop (didn't bet)
Seat 3: vanilica (button) folded before Flop (didn't bet)
Seat 4: Zeeshka (small blind) folded before Flop
Seat 5: nuuaber (big blind) folded on the Flop
Seat 6: Strikerman25 folded before Flop (didn't bet)
Seat 7: matiko09 folded before Flop (didn't bet)
Seat 8: rate8 folded on the Flop
Seat 9: janarr5 folded before Flop (didn't bet)





PokerStars Hand #153505790709:  Hold'em No Limit ($0.50/$1.00 USD) - 2016/05/18 21:38:06 CET [2016/05/18 15:38:06 ET]
Table 'Lorcia II' 9-max Seat #7 is the button
Seat 1: TimStone ($100 in chips) 
Seat 2: lydia12345 ($118.36 in chips) 
Seat 3: matiko09 ($106.92 in chips) 
Seat 4: vanilica ($117.06 in chips) 
Seat 5: nuuaber ($206.37 in chips) 
Seat 6: gkm0nk3y ($103.79 in chips) 
Seat 7: rate8 ($105.40 in chips) 
Seat 8: Skum1986 ($100 in chips) 
Skum1986: posts small blind $0.50
TimStone: posts big blind $1
*** HOLE CARDS ***
Dealt to matiko09 [2h 8c]
lydia12345: folds 
lydia12345 leaves the table
matiko09: folds 
vanilica: raises $1.85 to $2.85
nuuaber: folds 
gkm0nk3y: folds 
janarr5 joins the table at seat #2 
rate8: calls $2.85
Skum1986: folds 
TimStone: folds 
*** FLOP *** [As 3s Ad]
vanilica: checks 
rate8: checks 
*** TURN *** [As 3s Ad] [8h]
vanilica: bets $5.06
rate8: calls $5.06
*** RIVER *** [As 3s Ad 8h] [9c]
vanilica: checks 
rate8: checks 
*** SHOW DOWN ***
vanilica: shows [Tc Ah] (three of a kind, Aces)
rate8: mucks hand 
vanilica collected $16.45 from pot
*** SUMMARY ***
Total pot $17.32 | Rake $0.87 
Board [As 3s Ad 8h 9c]
Seat 1: TimStone (big blind) folded before Flop
Seat 2: lydia12345 folded before Flop (didn't bet)
Seat 3: matiko09 folded before Flop (didn't bet)
Seat 4: vanilica showed [Tc Ah] and won ($16.45) with three of a kind, Aces
Seat 5: nuuaber folded before Flop (didn't bet)
Seat 6: gkm0nk3y folded before Flop (didn't bet)
Seat 7: rate8 (button) mucked [6d 6c]
Seat 8: Skum1986 (small blind) folded before Flop





PokerStars Hand #153505809007:  Hold'em No Limit ($0.50/$1.00 USD) - 2016/05/18 21:38:25 CET [2016/05/18 15:38:25 ET]
Table 'Tatjana III' 9-max Seat #2 is the button
Seat 1: cobrik23 ($181.14 in chips) 
Seat 2: vanilica ($116.62 in chips) 
Seat 3: matiko09 ($174.60 in chips) 
Seat 4: ipashutapkom ($47.74 in chips) 
Seat 5: deadkiller1 ($100 in chips) 
Seat 6: Kihog ($114.59 in chips) 
Seat 7: rene1984tsv ($82.74 in chips) 
Seat 8: JACQUILF ($170.21 in chips) 
Seat 9: Moszes360 ($103.61 in chips) 
matiko09: posts small blind $0.50
ipashutapkom: posts big blind $1
cobrik23: posts small & big blinds $1.50
*** HOLE CARDS ***
Dealt to matiko09 [Td 5s]
deadkiller1: folds 
Kihog: raises $2.50 to $3.50
rene1984tsv: calls $3.50
JACQUILF: folds 
Moszes360: folds 
cobrik23: calls $2.50
vanilica: folds 
matiko09: folds 
ipashutapkom: calls $2.50
*** FLOP *** [5c Ac 6c]
ipashutapkom: checks 
Kihog: checks 
rene1984tsv: checks 
cobrik23: checks 
*** TURN *** [5c Ac 6c] [2d]
ipashutapkom: bets $7.41
Kihog: folds 
rene1984tsv: calls $7.41
cobrik23: folds 
*** RIVER *** [5c Ac 6c 2d] [7c]
ipashutapkom: bets $14.73
rene1984tsv: folds 
Uncalled bet ($14.73) returned to ipashutapkom
ipashutapkom collected $28.33 from pot
ipashutapkom: doesn't show hand 
*** SUMMARY ***
Total pot $29.82 | Rake $1.49 
Board [5c Ac 6c 2d 7c]
Seat 1: cobrik23 folded on the Turn
Seat 2: vanilica (button) folded before Flop (didn't bet)
Seat 3: matiko09 (small blind) folded before Flop
Seat 4: ipashutapkom (big blind) collected ($28.33)
Seat 5: deadkiller1 folded before Flop (didn't bet)
Seat 6: Kihog folded on the Turn
Seat 7: rene1984tsv folded on the River
Seat 8: JACQUILF folded before Flop (didn't bet)
Seat 9: Moszes360 folded before Flop (didn't bet)





PokerStars Hand #153505813906:  Hold'em No Limit ($0.50/$1.00 USD) - 2016/05/18 21:38:31 CET [2016/05/18 15:38:31 ET]
Table 'Zaurak II' 9-max Seat #5 is the button
Seat 1: TimStone ($101.50 in chips) 
Seat 2: matiko09 ($100 in chips) 
Seat 3: janarr5 ($130.48 in chips) 
Seat 4: solbi86 ($141.50 in chips) 
Seat 5: rate8 ($125.20 in chips) 
Seat 6: deadkiller1 ($100 in chips) 
Seat 7: Kihog ($101.22 in chips) 
Seat 8: Asgel22 ($228.10 in chips) 
Seat 9: torkkdnm ($140.29 in chips) 
deadkiller1: posts small blind $0.50
Kihog: posts big blind $1
*** HOLE CARDS ***
Dealt to matiko09 [Ah 3c]
Asgel22: folds 
torkkdnm: folds 
TimStone: folds 
matiko09: folds 
janarr5: folds 
solbi86: raises $1.50 to $2.50
rate8: folds 
deadkiller1: folds 
Kihog: calls $1.50
*** FLOP *** [2c Qh Tc]
Kihog: checks 
solbi86: bets $3.39
Kihog: folds 
Uncalled bet ($3.39) returned to solbi86
solbi86 collected $5.22 from pot
solbi86: doesn't show hand 
*** SUMMARY ***
Total pot $5.50 | Rake $0.28 
Board [2c Qh Tc]
Seat 1: TimStone folded before Flop (didn't bet)
Seat 2: matiko09 folded before Flop (didn't bet)
Seat 3: janarr5 folded before Flop (didn't bet)
Seat 4: solbi86 collected ($5.22)
Seat 5: rate8 (button) folded before Flop (didn't bet)
Seat 6: deadkiller1 (small blind) folded before Flop
Seat 7: Kihog (big blind) folded on the Flop
Seat 8: Asgel22 folded before Flop (didn't bet)
Seat 9: torkkdnm folded before Flop (didn't bet)





PokerStars Hand #153505829284:  Hold'em No Limit (€0.50/€1.00 EUR) - 2016/05/18 21:38:47 CET [2016/05/18 15:38:47 ET]
Table 'Pallas II' 9-max Seat #9 is the button
Seat 1: deadkiller1 (€200.81 in chips) 
Seat 2: matiko09 (€100 in chips) 
Seat 3: Ouga Buga (€101.50 in chips) 
Seat 4: torkkdnm (€161.73 in chips) 
Seat 5: vanilica (€102.62 in chips) 
Seat 6: janarr5 (€106.22 in chips) 
Seat 7: rate8 (€109.10 in chips) 
Seat 8: Kihog (€183.84 in chips) 
Seat 9: stijner1986 (€157.65 in chips) 
deadkiller1: posts small blind €0.50
matiko09: posts big blind €1
*** HOLE CARDS ***
Dealt to matiko09 [4c Kd]
Ouga Buga: folds 
torkkdnm: folds 
vanilica: folds 
janarr5: folds 
rate8: folds 
Kihog: raises €1.50 to €2.50
stijner1986: calls €2.50
deadkiller1: calls €2
matiko09: folds 
*** FLOP *** [3h 2s 3s]
deadkiller1: checks 
Kihog: bets €5.50
stijner1986: folds 
deadkiller1: folds 
Uncalled bet (€5.50) returned to Kihog
Kihog collected €8.08 from pot
Kihog: doesn't show hand 
*** SUMMARY ***
Total pot €8.50 | Rake €0.42 
Board [3h 2s 3s]
Seat 1: deadkiller1 (small blind) folded on the Flop
Seat 2: matiko09 (big blind) folded before Flop
Seat 3: Ouga Buga folded before Flop (didn't bet)
Seat 4: torkkdnm folded before Flop (didn't bet)
Seat 5: vanilica folded before Flop (didn't bet)
Seat 6: janarr5 folded before Flop (didn't bet)
Seat 7: rate8 folded before Flop (didn't bet)
Seat 8: Kihog collected (€8.08)
Seat 9: stijner1986 (button) folded on the Flop





PokerStars Hand #153505838198:  Hold'em No Limit ($0.50/$1.00 USD) - 2016/05/18 21:38:57 CET [2016/05/18 15:38:57 ET]
Table 'Lorcia II' 9-max Seat #8 is the button
Seat 1: TimStone ($100 in chips) 
Seat 2: janarr5 ($100 in chips) 
Seat 3: matiko09 ($106.92 in chips) 
Seat 4: vanilica ($125.60 in chips) 
Seat 5: nuuaber ($206.37 in chips) 
Seat 6: gkm0nk3y ($103.79 in chips) 
Seat 7: rate8 ($100 in chips) 
Seat 8: Skum1986 ($100 in chips) 
TimStone: posts small blind $0.50
janarr5: posts big blind $1
*** HOLE CARDS ***
Dealt to matiko09 [2s 4s]
matiko09: folds 
vanilica: folds 
nuuaber: folds 
gkm0nk3y: folds 
rate8: raises $2 to $3
Skum1986: folds 
TimStone: folds 
janarr5: folds 
Uncalled bet ($2) returned to rate8
rate8 collected $2.50 from pot
rate8: doesn't show hand 
*** SUMMARY ***
Total pot $2.50 | Rake $0 
Seat 1: TimStone (small blind) folded before Flop
Seat 2: janarr5 (big blind) folded before Flop
Seat 3: matiko09 folded before Flop (didn't bet)
Seat 4: vanilica folded before Flop (didn't bet)
Seat 5: nuuaber folded before Flop (didn't bet)
Seat 6: gkm0nk3y folded before Flop (didn't bet)
Seat 7: rate8 collected ($2.50)
Seat 8: Skum1986 (button) folded before Flop (didn't bet)





PokerStars Hand #153505858462:  Hold'em No Limit ($0.50/$1.00 USD) - 2016/05/18 21:39:19 CET [2016/05/18 15:39:19 ET]
Table 'Abetti II' 9-max Seat #7 is the button
Seat 1: matiko09 ($109.42 in chips) 
Seat 2: torkkdnm ($100 in chips) 
Seat 3: cobrik23 ($152.28 in chips) 
Seat 4: ipashutapkom ($40 in chips) 
Seat 5: blufthenuts ($160.17 in chips) 
Seat 6: Kihog ($101 in chips) 
Seat 7: rate8 ($102.78 in chips) 
Seat 8: roadster683 ($178.15 in chips) 
Seat 9: vanilica ($100 in chips) 
roadster683: posts small blind $0.50
vanilica: posts big blind $1
*** HOLE CARDS ***
Dealt to matiko09 [Tc 2h]
matiko09: folds 
torkkdnm: folds 
cobrik23: folds 
ipashutapkom: folds 
blufthenuts: folds 
Kihog: raises $1.50 to $2.50
rate8: folds 
roadster683: calls $2
vanilica: calls $1.50
*** FLOP *** [Td 8s Ks]
roadster683: checks 
vanilica: checks 
Kihog: bets $5
roadster683: calls $5
vanilica: folds 
*** TURN *** [Td 8s Ks] [5d]
roadster683: checks 
Kihog: bets $9
roadster683: calls $9
*** RIVER *** [Td 8s Ks 5d] [5c]
roadster683: checks 
Kihog: checks 
*** SHOW DOWN ***
roadster683: shows [Jd Kh] (two pair, Kings and Fives)
Kihog: mucks hand 
roadster683 collected $33.72 from pot
*** SUMMARY ***
Total pot $35.50 | Rake $1.78 
Board [Td 8s Ks 5d 5c]
Seat 1: matiko09 folded before Flop (didn't bet)
Seat 2: torkkdnm folded before Flop (didn't bet)
Seat 3: cobrik23 folded before Flop (didn't bet)
Seat 4: ipashutapkom folded before Flop (didn't bet)
Seat 5: blufthenuts folded before Flop (didn't bet)
Seat 6: Kihog mucked [9d Jh]
Seat 7: rate8 (button) folded before Flop (didn't bet)
Seat 8: roadster683 (small blind) showed [Jd Kh] and won ($33.72) with two pair, Kings and Fives
Seat 9: vanilica (big blind) folded on the Flop





PokerStars Hand #153505866118:  Hold'em No Limit ($0.50/$1.00 USD) - 2016/05/18 21:39:27 CET [2016/05/18 15:39:27 ET]
Table 'Zaurak II' 9-max Seat #6 is the button
Seat 1: TimStone ($101.50 in chips) 
Seat 2: matiko09 ($100 in chips) 
Seat 3: janarr5 ($130.48 in chips) 
Seat 4: solbi86 ($144.22 in chips) 
Seat 5: rate8 ($125.20 in chips) 
Seat 6: deadkiller1 ($100 in chips) 
Seat 7: Kihog ($100 in chips) 
Seat 8: Asgel22 ($228.10 in chips) 
Seat 9: torkkdnm ($140.29 in chips) 
Kihog: posts small blind $0.50
Asgel22: posts big blind $1
*** HOLE CARDS ***
Dealt to matiko09 [Qs 7h]
torkkdnm: raises $3 to $4
TimStone: folds 
matiko09: folds 
janarr5: folds 
solbi86: folds 
rate8: folds 
deadkiller1: folds 
Kihog: calls $3.50
Asgel22: calls $3
*** FLOP *** [6s Ad 8h]
Kihog: bets $7
Asgel22: calls $7
torkkdnm: folds 
*** TURN *** [6s Ad 8h] [Kh]
Kihog: checks 
Asgel22: checks 
*** RIVER *** [6s Ad 8h Kh] [9h]
Kihog: bets $17.50
Asgel22: calls $17.50
*** SHOW DOWN ***
Kihog: shows [9d 8d] (two pair, Nines and Eights)
Asgel22: mucks hand 
Kihog collected $58.50 from pot
*** SUMMARY ***
Total pot $61 | Rake $2.50 
Board [6s Ad 8h Kh 9h]
Seat 1: TimStone folded before Flop (didn't bet)
Seat 2: matiko09 folded before Flop (didn't bet)
Seat 3: janarr5 folded before Flop (didn't bet)
Seat 4: solbi86 folded before Flop (didn't bet)
Seat 5: rate8 folded before Flop (didn't bet)
Seat 6: deadkiller1 (button) folded before Flop (didn't bet)
Seat 7: Kihog (small blind) showed [9d 8d] and won ($58.50) with two pair, Nines and Eights
Seat 8: Asgel22 (big blind) mucked [Ts Ac]
Seat 9: torkkdnm folded on the Flop





PokerStars Hand #153505870462:  Hold'em No Limit ($0.50/$1.00 USD) - 2016/05/18 21:39:32 CET [2016/05/18 15:39:32 ET]
Table 'Lorcia II' 9-max Seat #1 is the button
Seat 1: TimStone ($100 in chips) 
Seat 2: janarr5 ($100 in chips) 
Seat 3: matiko09 ($106.92 in chips) 
Seat 4: vanilica ($125.60 in chips) 
Seat 5: nuuaber ($206.37 in chips) 
Seat 6: gkm0nk3y ($103.79 in chips) 
Seat 7: rate8 ($101.50 in chips) 
Seat 8: Skum1986 ($100 in chips) 
janarr5: posts small blind $0.50
matiko09: posts big blind $1
*** HOLE CARDS ***
Dealt to matiko09 [3d 7c]
vanilica: folds 
nuuaber: folds 
gkm0nk3y: folds 
rate8: folds 
Skum1986 has timed out
Skum1986: folds 
TimStone: raises $1.22 to $2.22
janarr5: folds 
matiko09: folds 
Uncalled bet ($1.22) returned to TimStone
TimStone collected $2.50 from pot
TimStone: doesn't show hand 
*** SUMMARY ***
Total pot $2.50 | Rake $0 
Seat 1: TimStone (button) collected ($2.50)
Seat 2: janarr5 (small blind) folded before Flop
Seat 3: matiko09 (big blind) folded before Flop
Seat 4: vanilica folded before Flop (didn't bet)
Seat 5: nuuaber folded before Flop (didn't bet)
Seat 6: gkm0nk3y folded before Flop (didn't bet)
Seat 7: rate8 folded before Flop (didn't bet)
Seat 8: Skum1986 folded before Flop (didn't bet)





PokerStars Hand #153505870531:  Hold'em No Limit ($0.50/$1.00 USD) - 2016/05/18 21:39:32 CET [2016/05/18 15:39:32 ET]
Table 'Brendelia II' 9-max Seat #9 is the button
Seat 1: cobrik23 ($71.92 in chips) 
Seat 2: LebzLouda ($28.28 in chips) 
Seat 3: Zeeshka ($100 in chips) 
Seat 4: gkm0nk3y ($117.62 in chips) 
Seat 5: Vulturinus ($59.65 in chips) 
Seat 6: TimStone ($130.98 in chips) 
Seat 7: matiko09 ($100 in chips) 
Seat 8: solbi86 ($130.35 in chips) 
Seat 9: fr3314nc3 ($98.50 in chips) 
cobrik23: posts small blind $0.50
LebzLouda: posts big blind $1
*** HOLE CARDS ***
Dealt to matiko09 [7d 7h]
Zeeshka: folds 
gkm0nk3y: folds 
Vulturinus: folds 
TimStone: folds 
matiko09: raises $2 to $3
solbi86: raises $6 to $9
fr3314nc3: folds 
cobrik23: folds 
LebzLouda: folds 
matiko09: folds 
Uncalled bet ($6) returned to solbi86
solbi86 collected $7.50 from pot
solbi86: doesn't show hand 
*** SUMMARY ***
Total pot $7.50 | Rake $0 
Seat 1: cobrik23 (small blind) folded before Flop
Seat 2: LebzLouda (big blind) folded before Flop
Seat 3: Zeeshka folded before Flop (didn't bet)
Seat 4: gkm0nk3y folded before Flop (didn't bet)
Seat 5: Vulturinus folded before Flop (didn't bet)
Seat 6: TimStone folded before Flop (didn't bet)
Seat 7: matiko09 folded before Flop
Seat 8: solbi86 collected ($7.50)
Seat 9: fr3314nc3 (button) folded before Flop (didn't bet)





PokerStars Hand #153505873683:  Hold'em No Limit ($0.50/$1.00 USD) - 2016/05/18 21:39:35 CET [2016/05/18 15:39:35 ET]
Table 'Samitchell II' 9-max Seat #4 is the button
Seat 1: riggedsh** ($136.27 in chips) 
Seat 2: mooose100 ($70.55 in chips) 
Seat 3: vanilica ($163.75 in chips) 
Seat 4: Zeeshka ($108.77 in chips) 
Seat 5: nuuaber ($62.47 in chips) 
Seat 6: Strikerman25 ($34.62 in chips) 
Seat 7: matiko09 ($111.65 in chips) 
Seat 8: rate8 ($102.88 in chips) 
Seat 9: janarr5 ($106.50 in chips) 
nuuaber: posts small blind $0.50
Strikerman25: posts big blind $1
*** HOLE CARDS ***
Dealt to matiko09 [Tc 2h]
matiko09: folds 
rate8: folds 
janarr5: folds 
riggedsh**: folds 
mooose100: calls $1
vanilica: raises $3.50 to $4.50
Zeeshka: folds 
nuuaber: folds 
Strikerman25: folds 
mooose100: folds 
Uncalled bet ($3.50) returned to vanilica
vanilica collected $3.50 from pot
vanilica: doesn't show hand 
*** SUMMARY ***
Total pot $3.50 | Rake $0 
Seat 1: riggedsh** folded before Flop (didn't bet)
Seat 2: mooose100 folded before Flop
Seat 3: vanilica collected ($3.50)
Seat 4: Zeeshka (button) folded before Flop (didn't bet)
Seat 5: nuuaber (small blind) folded before Flop
Seat 6: Strikerman25 (big blind) folded before Flop
Seat 7: matiko09 folded before Flop (didn't bet)
Seat 8: rate8 folded before Flop (didn't bet)
Seat 9: janarr5 folded before Flop (didn't bet)





PokerStars Hand #153505875319:  Hold'em No Limit (€0.50/€1.00 EUR) - 2016/05/18 21:39:37 CET [2016/05/18 15:39:37 ET]
Table 'Pallas II' 9-max Seat #1 is the button
Seat 1: deadkiller1 (€198.31 in chips) 
Seat 2: matiko09 (€100 in chips) 
Seat 3: Ouga Buga (€101.50 in chips) 
Seat 4: torkkdnm (€161.73 in chips) 
Seat 5: vanilica (€102.62 in chips) 
Seat 6: janarr5 (€106.22 in chips) 
Seat 7: rate8 (€109.10 in chips) 
Seat 8: Kihog (€189.42 in chips) 
Seat 9: stijner1986 (€155.15 in chips) 
matiko09: posts small blind €0.50
Ouga Buga: posts big blind €1
*** HOLE CARDS ***
Dealt to matiko09 [Td Kh]
torkkdnm: raises €2 to €3
vanilica: folds 
janarr5: folds 
rate8: folds 
Kihog: folds 
stijner1986: calls €3
deadkiller1: folds 
matiko09: folds 
Ouga Buga: folds 
*** FLOP *** [7h Qd 5s]
torkkdnm: bets €6
stijner1986: calls €6
*** TURN *** [7h Qd 5s] [3s]
torkkdnm: bets €16
stijner1986: folds 
Uncalled bet (€16) returned to torkkdnm
torkkdnm collected €18.52 from pot
*** SUMMARY ***
Total pot €19.50 | Rake €0.98 
Board [7h Qd 5s 3s]
Seat 1: deadkiller1 (button) folded before Flop (didn't bet)
Seat 2: matiko09 (small blind) folded before Flop
Seat 3: Ouga Buga (big blind) folded before Flop
Seat 4: torkkdnm collected (€18.52)
Seat 5: vanilica folded before Flop (didn't bet)
Seat 6: janarr5 folded before Flop (didn't bet)
Seat 7: rate8 folded before Flop (didn't bet)
Seat 8: Kihog folded before Flop (didn't bet)
Seat 9: stijner1986 folded on the Turn





PokerStars Hand #153505892569:  Hold'em No Limit ($0.50/$1.00 USD) - 2016/05/18 21:39:56 CET [2016/05/18 15:39:56 ET]
Table 'Tatjana III' 9-max Seat #3 is the button
Seat 1: cobrik23 ($177.14 in chips) 
Seat 2: vanilica ($116.62 in chips) 
Seat 3: matiko09 ($174.10 in chips) 
Seat 4: ipashutapkom ($65.16 in chips) 
Seat 5: deadkiller1 ($100 in chips) 
Seat 6: Kihog ($111.09 in chips) 
Seat 7: rene1984tsv ($71.83 in chips) 
Seat 8: JACQUILF ($170.21 in chips) 
Seat 9: Moszes360 ($103.61 in chips) 
ipashutapkom: posts small blind $0.50
deadkiller1: posts big blind $1
*** HOLE CARDS ***
Dealt to matiko09 [Kh 5c]
Kihog: folds 
rene1984tsv: raises $1 to $2
JACQUILF: calls $2
Moszes360: folds 
cobrik23: folds 
vanilica: folds 
matiko09: folds 
ipashutapkom: folds 
deadkiller1: folds 
*** FLOP *** [Tc 3d Ah]
rene1984tsv: bets $2.61
JACQUILF: calls $2.61
*** TURN *** [Tc 3d Ah] [Th]
rene1984tsv: bets $10.18
JACQUILF: calls $10.18
*** RIVER *** [Tc 3d Ah Th] [7s]
rene1984tsv: bets $57.04 and is all-in
JACQUILF: folds 
Uncalled bet ($57.04) returned to rene1984tsv
rene1984tsv collected $29.53 from pot
rene1984tsv: doesn't show hand 
*** SUMMARY ***
Total pot $31.08 | Rake $1.55 
Board [Tc 3d Ah Th 7s]
Seat 1: cobrik23 folded before Flop (didn't bet)
Seat 2: vanilica folded before Flop (didn't bet)
Seat 3: matiko09 (button) folded before Flop (didn't bet)
Seat 4: ipashutapkom (small blind) folded before Flop
Seat 5: deadkiller1 (big blind) folded before Flop
Seat 6: Kihog folded before Flop (didn't bet)
Seat 7: rene1984tsv collected ($29.53)
Seat 8: JACQUILF folded on the River
Seat 9: Moszes360 folded before Flop (didn't bet)





PokerStars Hand #153505910454:  Hold'em No Limit ($0.50/$1.00 USD) - 2016/05/18 21:40:16 CET [2016/05/18 15:40:16 ET]
Table 'Samitchell II' 9-max Seat #5 is the button
Seat 1: riggedsh** ($136.27 in chips) 
Seat 2: mooose100 ($69.55 in chips) 
Seat 3: vanilica ($166.25 in chips) 
Seat 4: Zeeshka ($108.77 in chips) 
Seat 5: nuuaber ($61.97 in chips) 
Seat 6: Strikerman25 ($33.62 in chips) 
Seat 7: matiko09 ($111.65 in chips) 
Seat 8: rate8 ($102.88 in chips) 
Seat 9: janarr5 ($106.50 in chips) 
Strikerman25: posts small blind $0.50
matiko09: posts big blind $1
*** HOLE CARDS ***
Dealt to matiko09 [Qd 8c]
rate8: folds 
janarr5: folds 
riggedsh**: folds 
mooose100: folds 
vanilica: raises $1.50 to $2.50
Zeeshka: folds 
nuuaber: folds 
Strikerman25: folds 
matiko09: folds 
Uncalled bet ($1.50) returned to vanilica
vanilica collected $2.50 from pot
vanilica: doesn't show hand 
*** SUMMARY ***
Total pot $2.50 | Rake $0 
Seat 1: riggedsh** folded before Flop (didn't bet)
Seat 2: mooose100 folded before Flop (didn't bet)
Seat 3: vanilica collected ($2.50)
Seat 4: Zeeshka folded before Flop (didn't bet)
Seat 5: nuuaber (button) folded before Flop (didn't bet)
Seat 6: Strikerman25 (small blind) folded before Flop
Seat 7: matiko09 (big blind) folded before Flop
Seat 8: rate8 folded before Flop (didn't bet)
Seat 9: janarr5 folded before Flop (didn't bet)





PokerStars Hand #153505914624:  Hold'em No Limit ($0.50/$1.00 USD) - 2016/05/18 21:40:20 CET [2016/05/18 15:40:20 ET]
Table 'Lorcia II' 9-max Seat #2 is the button
Seat 1: TimStone ($101.50 in chips) 
Seat 2: janarr5 ($100 in chips) 
Seat 3: matiko09 ($105.92 in chips) 
Seat 4: vanilica ($125.60 in chips) 
Seat 5: nuuaber ($206.37 in chips) 
Seat 6: gkm0nk3y ($103.79 in chips) 
Seat 7: rate8 ($101.50 in chips) 
matiko09: posts small blind $0.50
vanilica: posts big blind $1
*** HOLE CARDS ***
Dealt to matiko09 [Kh 9d]
nuuaber: folds 
gkm0nk3y: raises $2 to $3
rate8: folds 
TimStone: folds 
janarr5: folds 
matiko09: folds 
vanilica: folds 
Uncalled bet ($2) returned to gkm0nk3y
gkm0nk3y collected $2.50 from pot
*** SUMMARY ***
Total pot $2.50 | Rake $0 
Seat 1: TimStone folded before Flop (didn't bet)
Seat 2: janarr5 (button) folded before Flop (didn't bet)
Seat 3: matiko09 (small blind) folded before Flop
Seat 4: vanilica (big blind) folded before Flop
Seat 5: nuuaber folded before Flop (didn't bet)
Seat 6: gkm0nk3y collected ($2.50)
Seat 7: rate8 folded before Flop (didn't bet)





PokerStars Hand #153505930831:  Hold'em No Limit ($0.50/$1.00 USD) - 2016/05/18 21:40:37 CET [2016/05/18 15:40:37 ET]
Table 'Abetti II' 9-max Seat #8 is the button
Seat 1: matiko09 ($109.42 in chips) 
Seat 2: torkkdnm ($100 in chips) 
Seat 3: cobrik23 ($152.28 in chips) 
Seat 4: ipashutapkom ($40 in chips) 
Seat 5: blufthenuts ($160.17 in chips) 
Seat 6: Kihog ($100 in chips) 
Seat 7: rate8 ($102.78 in chips) 
Seat 8: roadster683 ($195.37 in chips) 
Seat 9: vanilica ($100 in chips) 
vanilica: posts small blind $0.50
matiko09: posts big blind $1
*** HOLE CARDS ***
Dealt to matiko09 [8c 3h]
torkkdnm: folds 
cobrik23: folds 
ipashutapkom: raises $1.26 to $2.26
blufthenuts: folds 
Kihog: folds 
rate8: folds 
roadster683: folds 
vanilica: folds 
matiko09: folds 
Uncalled bet ($1.26) returned to ipashutapkom
ipashutapkom collected $2.50 from pot
ipashutapkom: doesn't show hand 
*** SUMMARY ***
Total pot $2.50 | Rake $0 
Seat 1: matiko09 (big blind) folded before Flop
Seat 2: torkkdnm folded before Flop (didn't bet)
Seat 3: cobrik23 folded before Flop (didn't bet)
Seat 4: ipashutapkom collected ($2.50)
Seat 5: blufthenuts folded before Flop (didn't bet)
Seat 6: Kihog folded before Flop (didn't bet)
Seat 7: rate8 folded before Flop (didn't bet)
Seat 8: roadster683 (button) folded before Flop (didn't bet)
Seat 9: vanilica (small blind) folded before Flop





PokerStars Hand #153505933129:  Hold'em No Limit ($0.50/$1.00 USD) - 2016/05/18 21:40:40 CET [2016/05/18 15:40:40 ET]
Table 'Brendelia II' 9-max Seat #1 is the button
Seat 1: cobrik23 ($71.42 in chips) 
Seat 2: LebzLouda ($27.28 in chips) 
Seat 3: Zeeshka ($100 in chips) 
Seat 4: gkm0nk3y ($117.62 in chips) 
Seat 5: Vulturinus ($59.65 in chips) 
Seat 6: TimStone ($130.98 in chips) 
Seat 7: matiko09 ($100 in chips) 
Seat 8: solbi86 ($134.85 in chips) 
Seat 9: fr3314nc3 ($98.50 in chips) 
LebzLouda: posts small blind $0.50
Zeeshka: posts big blind $1
*** HOLE CARDS ***
Dealt to matiko09 [2s Qc]
gkm0nk3y: folds 
Vulturinus: folds 
TimStone: folds 
matiko09: folds 
solbi86: folds 
fr3314nc3: folds 
cobrik23: folds 
LebzLouda: folds 
Uncalled bet ($0.50) returned to Zeeshka
Zeeshka collected $1 from pot
Zeeshka: doesn't show hand 
*** SUMMARY ***
Total pot $1 | Rake $0 
Seat 1: cobrik23 (button) folded before Flop (didn't bet)
Seat 2: LebzLouda (small blind) folded before Flop
Seat 3: Zeeshka (big blind) collected ($1)
Seat 4: gkm0nk3y folded before Flop (didn't bet)
Seat 5: Vulturinus folded before Flop (didn't bet)
Seat 6: TimStone folded before Flop (didn't bet)
Seat 7: matiko09 folded before Flop (didn't bet)
Seat 8: solbi86 folded before Flop (didn't bet)
Seat 9: fr3314nc3 folded before Flop (didn't bet)





PokerStars Hand #153505936895:  Hold'em No Limit ($0.50/$1.00 USD) - 2016/05/18 21:40:44 CET [2016/05/18 15:40:44 ET]
Table 'Zaurak II' 9-max Seat #7 is the button
Seat 1: TimStone ($101.50 in chips) 
Seat 2: matiko09 ($100 in chips) 
Seat 3: janarr5 ($130.48 in chips) 
Seat 4: solbi86 ($144.22 in chips) 
Seat 5: rate8 ($125.20 in chips) 
Seat 6: deadkiller1 ($100 in chips) 
Seat 7: Kihog ($130 in chips) 
Seat 8: Asgel22 ($199.60 in chips) 
Seat 9: torkkdnm ($136.29 in chips) 
Asgel22: posts small blind $0.50
torkkdnm: posts big blind $1
*** HOLE CARDS ***
Dealt to matiko09 [7h Kh]
TimStone: raises $1.62 to $2.62
matiko09: folds 
janarr5: folds 
solbi86: folds 
rate8: folds 
deadkiller1: folds 
Kihog: calls $2.62
Asgel22: folds 
torkkdnm: calls $1.62
*** FLOP *** [As 5c Th]
Asgel22 leaves the table
torkkdnm: checks 
TimStone: checks 
Kihog: bets $5
torkkdnm: folds 
TimStone: folds 
Uncalled bet ($5) returned to Kihog
Kihog collected $7.94 from pot
Kihog: doesn't show hand 
*** SUMMARY ***
Total pot $8.36 | Rake $0.42 
Board [As 5c Th]
Seat 1: TimStone folded on the Flop
Seat 2: matiko09 folded before Flop (didn't bet)
Seat 3: janarr5 folded before Flop (didn't bet)
Seat 4: solbi86 folded before Flop (didn't bet)
Seat 5: rate8 folded before Flop (didn't bet)
Seat 6: deadkiller1 folded before Flop (didn't bet)
Seat 7: Kihog (button) collected ($7.94)
Seat 8: Asgel22 (small blind) folded before Flop
Seat 9: torkkdnm (big blind) folded on the Flop





PokerStars Hand #153505938342:  Hold'em No Limit ($0.50/$1.00 USD) - 2016/05/18 21:40:45 CET [2016/05/18 15:40:45 ET]
Table 'Samitchell II' 9-max Seat #6 is the button
Seat 1: riggedsh** ($136.27 in chips) 
Seat 2: mooose100 ($69.55 in chips) 
Seat 3: vanilica ($167.75 in chips) 
Seat 4: Zeeshka ($108.77 in chips) 
Seat 5: nuuaber ($61.97 in chips) 
Seat 6: Strikerman25 ($33.12 in chips) 
Seat 7: matiko09 ($110.65 in chips) 
Seat 8: rate8 ($102.88 in chips) 
Seat 9: janarr5 ($106.50 in chips) 
matiko09: posts small blind $0.50
rate8: posts big blind $1
*** HOLE CARDS ***
Dealt to matiko09 [2c Qs]
janarr5: folds 
riggedsh**: folds 
mooose100: folds 
mooose100 leaves the table
vanilica: folds 
Cortine joins the table at seat #2 
Zeeshka: folds 
nuuaber: folds 
Strikerman25 has timed out
Strikerman25: folds 
matiko09: folds 
Uncalled bet ($0.50) returned to rate8
rate8 collected $1 from pot
rate8: doesn't show hand 
*** SUMMARY ***
Total pot $1 | Rake $0 
Seat 1: riggedsh** folded before Flop (didn't bet)
Seat 2: mooose100 folded before Flop (didn't bet)
Seat 3: vanilica folded before Flop (didn't bet)
Seat 4: Zeeshka folded before Flop (didn't bet)
Seat 5: nuuaber folded before Flop (didn't bet)
Seat 6: Strikerman25 (button) folded before Flop (didn't bet)
Seat 7: matiko09 (small blind) folded before Flop
Seat 8: rate8 (big blind) collected ($1)
Seat 9: janarr5 folded before Flop (didn't bet)





PokerStars Hand #153505943556:  Hold'em No Limit (€0.50/€1.00 EUR) - 2016/05/18 21:40:51 CET [2016/05/18 15:40:51 ET]
Table 'Pallas II' 9-max Seat #2 is the button
Seat 1: deadkiller1 (€198.31 in chips) 
Seat 2: matiko09 (€100 in chips) 
Seat 3: Ouga Buga (€100.50 in chips) 
Seat 4: torkkdnm (€171.25 in chips) 
Seat 5: vanilica (€102.62 in chips) 
Seat 6: janarr5 (€106.22 in chips) 
Seat 7: rate8 (€109.10 in chips) 
Seat 8: Kihog (€189.42 in chips) 
Seat 9: stijner1986 (€146.15 in chips) 
Ouga Buga: posts small blind €0.50
torkkdnm: posts big blind €1
*** HOLE CARDS ***
Dealt to matiko09 [Kh 8d]
vanilica: folds 
janarr5: folds 
rate8: folds 
Kihog: folds 
stijner1986: folds 
deadkiller1: folds 
matiko09: raises €1.27 to €2.27
Ouga Buga: folds 
torkkdnm: folds 
Uncalled bet (€1.27) returned to matiko09
matiko09 collected €2.50 from pot
matiko09: doesn't show hand 
*** SUMMARY ***
Total pot €2.50 | Rake €0 
Seat 1: deadkiller1 folded before Flop (didn't bet)
Seat 2: matiko09 (button) collected (€2.50)
Seat 3: Ouga Buga (small blind) folded before Flop
Seat 4: torkkdnm (big blind) folded before Flop
Seat 5: vanilica folded before Flop (didn't bet)
Seat 6: janarr5 folded before Flop (didn't bet)
Seat 7: rate8 folded before Flop (didn't bet)
Seat 8: Kihog folded before Flop (didn't bet)
Seat 9: stijner1986 folded before Flop (didn't bet)





PokerStars Hand #153505946575:  Hold'em No Limit ($0.50/$1.00 USD) - 2016/05/18 21:40:54 CET [2016/05/18 15:40:54 ET]
Table 'Lorcia II' 9-max Seat #3 is the button
Seat 1: TimStone ($101.50 in chips) 
Seat 2: janarr5 ($100 in chips) 
Seat 3: matiko09 ($105.42 in chips) 
Seat 4: vanilica ($124.60 in chips) 
Seat 5: nuuaber ($206.37 in chips) 
Seat 6: gkm0nk3y ($105.29 in chips) 
Seat 7: rate8 ($101.50 in chips) 
vanilica: posts small blind $0.50
nuuaber: posts big blind $1
*** HOLE CARDS ***
Dealt to matiko09 [7h 6d]
gkm0nk3y: folds 
rate8: raises $2 to $3
TimStone: calls $3
janarr5: folds 
matiko09: folds 
vanilica: folds 
nuuaber: calls $2
*** FLOP *** [Th 6c Tc]
nuuaber: checks 
rate8: bets $6.40
TimStone: calls $6.40
nuuaber: folds 
*** TURN *** [Th 6c Tc] [Kd]
rate8: bets $15.25
TimStone: folds 
Uncalled bet ($15.25) returned to rate8
rate8 collected $21.18 from pot
rate8: doesn't show hand 
*** SUMMARY ***
Total pot $22.30 | Rake $1.12 
Board [Th 6c Tc Kd]
Seat 1: TimStone folded on the Turn
Seat 2: janarr5 folded before Flop (didn't bet)
Seat 3: matiko09 (button) folded before Flop (didn't bet)
Seat 4: vanilica (small blind) folded before Flop
Seat 5: nuuaber (big blind) folded on the Flop
Seat 6: gkm0nk3y folded before Flop (didn't bet)
Seat 7: rate8 collected ($21.18)





PokerStars Hand #153505962425:  Hold'em No Limit ($0.50/$1.00 USD) - 2016/05/18 21:41:12 CET [2016/05/18 15:41:12 ET]
Table 'Tatjana III' 9-max Seat #4 is the button
Seat 1: cobrik23 ($177.14 in chips) 
Seat 2: vanilica ($116.62 in chips) 
Seat 3: matiko09 ($174.10 in chips) 
Seat 4: ipashutapkom ($64.66 in chips) 
Seat 5: deadkiller1 ($100 in chips) 
Seat 6: Kihog ($111.09 in chips) 
Seat 7: rene1984tsv ($86.57 in chips) 
Seat 8: JACQUILF ($155.42 in chips) 
Seat 9: Moszes360 ($103.61 in chips) 
deadkiller1: posts small blind $0.50
Kihog: posts big blind $1
*** HOLE CARDS ***
Dealt to matiko09 [Qd 9h]
rene1984tsv: calls $1
JACQUILF: folds 
Moszes360: folds 
cobrik23: folds 
vanilica: folds 
matiko09: folds 
ipashutapkom: folds 
deadkiller1: folds 
Kihog: checks 
*** FLOP *** [9s 5c Th]
Kihog: checks 
rene1984tsv: bets $1
Kihog: calls $1
*** TURN *** [9s 5c Th] [Jc]
Kihog: checks 
rene1984tsv: bets $2.14
Kihog: folds 
Uncalled bet ($2.14) returned to rene1984tsv
rene1984tsv collected $4.28 from pot
rene1984tsv: shows [Jd 3d] (a pair of Jacks)
*** SUMMARY ***
Total pot $4.50 | Rake $0.22 
Board [9s 5c Th Jc]
Seat 1: cobrik23 folded before Flop (didn't bet)
Seat 2: vanilica folded before Flop (didn't bet)
Seat 3: matiko09 folded before Flop (didn't bet)
Seat 4: ipashutapkom (button) folded before Flop (didn't bet)
Seat 5: deadkiller1 (small blind) folded before Flop
Seat 6: Kihog (big blind) folded on the Turn
Seat 7: rene1984tsv collected ($4.28)
Seat 8: JACQUILF folded before Flop (didn't bet)
Seat 9: Moszes360 folded before Flop (didn't bet)





PokerStars Hand #153505963213:  Hold'em No Limit (€0.50/€1.00 EUR) - 2016/05/18 21:41:12 CET [2016/05/18 15:41:12 ET]
Table 'Pallas II' 9-max Seat #3 is the button
Seat 1: deadkiller1 (€198.31 in chips) 
Seat 2: matiko09 (€101.50 in chips) 
Seat 3: Ouga Buga (€100 in chips) 
Seat 4: torkkdnm (€170.25 in chips) 
Seat 6: janarr5 (€106.22 in chips) 
Seat 7: rate8 (€109.10 in chips) 
Seat 8: Kihog (€189.42 in chips) 
Seat 9: stijner1986 (€146.15 in chips) 
torkkdnm: posts small blind €0.50
vanilica: is sitting out 
vanilica leaves the table
janarr5: posts big blind €1
*** HOLE CARDS ***
Dealt to matiko09 [3c Qd]
rate8: raises €2 to €3
Kihog: folds 
stijner1986: folds 
deadkiller1: calls €3
matiko09: folds 
Ouga Buga: folds 
torkkdnm: folds 
janarr5: folds 
*** FLOP *** [3d 6c As]
rate8: checks 
deadkiller1: checks 
*** TURN *** [3d 6c As] [7s]
rate8: bets €5.13
deadkiller1: folds 
Uncalled bet (€5.13) returned to rate8
rate8 collected €7.12 from pot
rate8: doesn't show hand 
*** SUMMARY ***
Total pot €7.50 | Rake €0.38 
Board [3d 6c As 7s]
Seat 1: deadkiller1 folded on the Turn
Seat 2: matiko09 folded before Flop (didn't bet)
Seat 3: Ouga Buga (button) folded before Flop (didn't bet)
Seat 4: torkkdnm (small blind) folded before Flop
Seat 6: janarr5 (big blind) folded before Flop
Seat 7: rate8 collected (€7.12)
Seat 8: Kihog folded before Flop (didn't bet)
Seat 9: stijner1986 folded before Flop (didn't bet)





PokerStars Hand #153505963612:  Hold'em No Limit ($0.50/$1.00 USD) - 2016/05/18 21:41:13 CET [2016/05/18 15:41:13 ET]
Table 'Brendelia II' 9-max Seat #2 is the button
Seat 1: cobrik23 ($71.42 in chips) 
Seat 2: LebzLouda ($26.78 in chips) 
Seat 3: Zeeshka ($100.50 in chips) 
Seat 4: gkm0nk3y ($117.62 in chips) 
Seat 5: Vulturinus ($59.65 in chips) 
Seat 6: TimStone ($130.98 in chips) 
Seat 7: matiko09 ($100 in chips) 
Seat 8: solbi86 ($134.85 in chips) 
Zeeshka: posts small blind $0.50
gkm0nk3y: posts big blind $1
*** HOLE CARDS ***
Dealt to matiko09 [Jh 4d]
Vulturinus: folds 
TimStone: folds 
matiko09: folds 
solbi86: folds 
cobrik23: folds 
LebzLouda: raises $2 to $3
Zeeshka: folds 
gkm0nk3y: folds 
Uncalled bet ($2) returned to LebzLouda
LebzLouda collected $2.50 from pot
LebzLouda: doesn't show hand 
*** SUMMARY ***
Total pot $2.50 | Rake $0 
Seat 1: cobrik23 folded before Flop (didn't bet)
Seat 2: LebzLouda (button) collected ($2.50)
Seat 3: Zeeshka (small blind) folded before Flop
Seat 4: gkm0nk3y (big blind) folded before Flop
Seat 5: Vulturinus folded before Flop (didn't bet)
Seat 6: TimStone folded before Flop (didn't bet)
Seat 7: matiko09 folded before Flop (didn't bet)
Seat 8: solbi86 folded before Flop (didn't bet)





PokerStars Hand #153505978769:  Hold'em No Limit ($0.50/$1.00 USD) - 2016/05/18 21:41:29 CET [2016/05/18 15:41:29 ET]
Table 'Samitchell II' 9-max Seat #7 is the button
Seat 1: riggedsh** ($136.27 in chips) 
Seat 3: vanilica ($167.75 in chips) 
Seat 4: Zeeshka ($108.77 in chips) 
Seat 5: nuuaber ($61.97 in chips) 
Seat 6: Strikerman25 ($33.12 in chips) 
Seat 7: matiko09 ($110.15 in chips) 
Seat 8: rate8 ($103.38 in chips) 
Seat 9: janarr5 ($106.50 in chips) 
rate8: posts small blind $0.50
janarr5: posts big blind $1
*** HOLE CARDS ***
Dealt to matiko09 [6d 7h]
riggedsh**: folds 
vanilica: folds 
Zeeshka: raises $2 to $3
nuuaber: folds 
Strikerman25: folds 
matiko09: folds 
rate8: folds 
janarr5: folds 
Uncalled bet ($2) returned to Zeeshka
Zeeshka collected $2.50 from pot
Zeeshka: doesn't show hand 
*** SUMMARY ***
Total pot $2.50 | Rake $0 
Seat 1: riggedsh** folded before Flop (didn't bet)
Seat 3: vanilica folded before Flop (didn't bet)
Seat 4: Zeeshka collected ($2.50)
Seat 5: nuuaber folded before Flop (didn't bet)
Seat 6: Strikerman25 folded before Flop (didn't bet)
Seat 7: matiko09 (button) folded before Flop (didn't bet)
Seat 8: rate8 (small blind) folded before Flop
Seat 9: janarr5 (big blind) folded before Flop





PokerStars Hand #153505987254:  Hold'em No Limit ($0.50/$1.00 USD) - 2016/05/18 21:41:38 CET [2016/05/18 15:41:38 ET]
Table 'Abetti II' 9-max Seat #9 is the button
Seat 1: matiko09 ($108.42 in chips) 
Seat 2: torkkdnm ($100 in chips) 
Seat 3: cobrik23 ($152.28 in chips) 
Seat 4: ipashutapkom ($41.50 in chips) 
Seat 5: blufthenuts ($160.17 in chips) 
Seat 6: Kihog ($100 in chips) 
Seat 7: rate8 ($102.78 in chips) 
Seat 8: roadster683 ($195.37 in chips) 
Seat 9: vanilica ($100 in chips) 
matiko09: posts small blind $0.50
torkkdnm: posts big blind $1
*** HOLE CARDS ***
Dealt to matiko09 [9s Th]
cobrik23: folds 
ipashutapkom: folds 
blufthenuts: folds 
Kihog: folds 
rate8: folds 
roadster683: folds 
vanilica: raises $1.85 to $2.85
matiko09: folds 
torkkdnm: calls $1.85
*** FLOP *** [Kc 7d 4c]
torkkdnm: checks 
vanilica: bets $3.53
torkkdnm: calls $3.53
*** TURN *** [Kc 7d 4c] [2c]
torkkdnm: checks 
vanilica: bets $7.56
torkkdnm: calls $7.56
*** RIVER *** [Kc 7d 4c 2c] [Kh]
torkkdnm: checks 
vanilica: bets $16.17
torkkdnm: calls $16.17
*** SHOW DOWN ***
vanilica: shows [Qc Ac] (a flush, Ace high)
torkkdnm: mucks hand 
vanilica collected $58.22 from pot
*** SUMMARY ***
Total pot $60.72 | Rake $2.50 
Board [Kc 7d 4c 2c Kh]
Seat 1: matiko09 (small blind) folded before Flop
Seat 2: torkkdnm (big blind) mucked [9c 7c]
Seat 3: cobrik23 folded before Flop (didn't bet)
Seat 4: ipashutapkom folded before Flop (didn't bet)
Seat 5: blufthenuts folded before Flop (didn't bet)
Seat 6: Kihog folded before Flop (didn't bet)
Seat 7: rate8 folded before Flop (didn't bet)
Seat 8: roadster683 folded before Flop (didn't bet)
Seat 9: vanilica (button) showed [Qc Ac] and won ($58.22) with a flush, Ace high





PokerStars Hand #153505999585:  Hold'em No Limit ($0.50/$1.00 USD) - 2016/05/18 21:41:52 CET [2016/05/18 15:41:52 ET]
Table 'Zaurak II' 9-max Seat #9 is the button
Seat 1: TimStone ($100 in chips) 
Seat 2: matiko09 ($100 in chips) 
Seat 3: janarr5 ($130.48 in chips) 
Seat 4: solbi86 ($144.22 in chips) 
Seat 5: rate8 ($125.20 in chips) 
Seat 6: deadkiller1 ($100 in chips) 
Seat 7: Kihog ($135.32 in chips) 
Seat 9: torkkdnm ($133.67 in chips) 
TimStone: posts small blind $0.50
matiko09: posts big blind $1
*** HOLE CARDS ***
Dealt to matiko09 [7h Ah]
janarr5: folds 
solbi86: folds 
rate8: folds 
deadkiller1: raises $2 to $3
Kihog: folds 
torkkdnm: folds 
TimStone: folds 
matiko09: folds 
Uncalled bet ($2) returned to deadkiller1
deadkiller1 collected $2.50 from pot
deadkiller1: doesn't show hand 
*** SUMMARY ***
Total pot $2.50 | Rake $0 
Seat 1: TimStone (small blind) folded before Flop
Seat 2: matiko09 (big blind) folded before Flop
Seat 3: janarr5 folded before Flop (didn't bet)
Seat 4: solbi86 folded before Flop (didn't bet)
Seat 5: rate8 folded before Flop (didn't bet)
Seat 6: deadkiller1 collected ($2.50)
Seat 7: Kihog folded before Flop (didn't bet)
Seat 9: torkkdnm (button) folded before Flop (didn't bet)





PokerStars Hand #153506006842:  Hold'em No Limit ($0.50/$1.00 USD) - 2016/05/18 21:41:59 CET [2016/05/18 15:41:59 ET]
Table 'Lorcia II' 9-max Seat #4 is the button
Seat 1: TimStone ($100 in chips) 
Seat 2: janarr5 ($100 in chips) 
Seat 3: matiko09 ($105.42 in chips) 
Seat 4: vanilica ($124.10 in chips) 
Seat 5: nuuaber ($203.37 in chips) 
Seat 6: gkm0nk3y ($105.29 in chips) 
Seat 7: rate8 ($113.28 in chips) 
nuuaber: posts small blind $0.50
gkm0nk3y: posts big blind $1
*** HOLE CARDS ***
Dealt to matiko09 [Qc 8h]
rate8: folds 
TimStone: folds 
janarr5: folds 
matiko09: folds 
vanilica: folds 
nuuaber: calls $0.50
gkm0nk3y: raises $3 to $4
nuuaber: raises $9 to $13
gkm0nk3y: folds 
Uncalled bet ($9) returned to nuuaber
nuuaber collected $8 from pot
nuuaber: doesn't show hand 
*** SUMMARY ***
Total pot $8 | Rake $0 
Seat 1: TimStone folded before Flop (didn't bet)
Seat 2: janarr5 folded before Flop (didn't bet)
Seat 3: matiko09 folded before Flop (didn't bet)
Seat 4: vanilica (button) folded before Flop (didn't bet)
Seat 5: nuuaber (small blind) collected ($8)
Seat 6: gkm0nk3y (big blind) folded before Flop
Seat 7: rate8 folded before Flop (didn't bet)





PokerStars Hand #153506008016:  Hold'em No Limit ($0.50/$1.00 USD) - 2016/05/18 21:42:01 CET [2016/05/18 15:42:01 ET]
Table 'Brendelia II' 9-max Seat #3 is the button
Seat 1: cobrik23 ($71.42 in chips) 
Seat 2: LebzLouda ($28.28 in chips) 
Seat 3: Zeeshka ($100 in chips) 
Seat 4: gkm0nk3y ($116.62 in chips) 
Seat 5: Vulturinus ($59.65 in chips) 
Seat 6: TimStone ($130.98 in chips) 
Seat 7: matiko09 ($100 in chips) 
Seat 8: solbi86 ($134.85 in chips) 
gkm0nk3y: posts small blind $0.50
Vulturinus: posts big blind $1
*** HOLE CARDS ***
Dealt to matiko09 [3d 8s]
TimStone: folds 
matiko09: folds 
solbi86: folds 
cobrik23: folds 
LebzLouda: raises $2 to $3
Zeeshka: folds 
gkm0nk3y: folds 
Vulturinus: folds 
Uncalled bet ($2) returned to LebzLouda
LebzLouda collected $2.50 from pot
LebzLouda: doesn't show hand 
*** SUMMARY ***
Total pot $2.50 | Rake $0 
Seat 1: cobrik23 folded before Flop (didn't bet)
Seat 2: LebzLouda collected ($2.50)
Seat 3: Zeeshka (button) folded before Flop (didn't bet)
Seat 4: gkm0nk3y (small blind) folded before Flop
Seat 5: Vulturinus (big blind) folded before Flop
Seat 6: TimStone folded before Flop (didn't bet)
Seat 7: matiko09 folded before Flop (didn't bet)
Seat 8: solbi86 folded before Flop (didn't bet)





PokerStars Hand #153506008911:  Hold'em No Limit ($0.50/$1.00 USD) - 2016/05/18 21:42:02 CET [2016/05/18 15:42:02 ET]
Table 'Samitchell II' 9-max Seat #8 is the button
Seat 1: riggedsh** ($136.27 in chips) 
Seat 3: vanilica ($167.75 in chips) 
Seat 4: Zeeshka ($110.27 in chips) 
Seat 5: nuuaber ($61.97 in chips) 
Seat 6: Strikerman25 ($33.12 in chips) 
Seat 7: matiko09 ($110.15 in chips) 
Seat 8: rate8 ($102.88 in chips) 
Seat 9: janarr5 ($105.50 in chips) 
janarr5: posts small blind $0.50
riggedsh**: posts big blind $1
*** HOLE CARDS ***
Dealt to matiko09 [Ac 8d]
vanilica: folds 
Zeeshka: folds 
nuuaber: folds 
Strikerman25: folds 
matiko09: folds 
rate8: folds 
janarr5: folds 
Uncalled bet ($0.50) returned to riggedsh**
riggedsh** collected $1 from pot
riggedsh**: doesn't show hand 
*** SUMMARY ***
Total pot $1 | Rake $0 
Seat 1: riggedsh** (big blind) collected ($1)
Seat 3: vanilica folded before Flop (didn't bet)
Seat 4: Zeeshka folded before Flop (didn't bet)
Seat 5: nuuaber folded before Flop (didn't bet)
Seat 6: Strikerman25 folded before Flop (didn't bet)
Seat 7: matiko09 folded before Flop (didn't bet)
Seat 8: rate8 (button) folded before Flop (didn't bet)
Seat 9: janarr5 (small blind) folded before Flop





PokerStars Hand #153506016959:  Hold'em No Limit (€0.50/€1.00 EUR) - 2016/05/18 21:42:10 CET [2016/05/18 15:42:10 ET]
Table 'Pallas II' 9-max Seat #4 is the button
Seat 1: deadkiller1 (€195.31 in chips) 
Seat 2: matiko09 (€101.50 in chips) 
Seat 3: Ouga Buga (€100 in chips) 
Seat 4: torkkdnm (€169.75 in chips) 
Seat 6: janarr5 (€105.22 in chips) 
Seat 7: rate8 (€113.22 in chips) 
Seat 8: Kihog (€189.42 in chips) 
Seat 9: stijner1986 (€146.15 in chips) 
janarr5: posts small blind €0.50
rate8: posts big blind €1
*** HOLE CARDS ***
Dealt to matiko09 [9s 3s]
Kihog: raises €1.50 to €2.50
stijner1986: raises €1.50 to €4
deadkiller1: folds 
matiko09: folds 
Ouga Buga: folds 
torkkdnm: folds 
janarr5: folds 
rate8: folds 
Kihog: calls €1.50
*** FLOP *** [4d Qc 6s]
Kihog: checks 
stijner1986: bets €7
Kihog: folds 
Uncalled bet (€7) returned to stijner1986
stijner1986 collected €9.02 from pot
stijner1986: doesn't show hand 
*** SUMMARY ***
Total pot €9.50 | Rake €0.48 
Board [4d Qc 6s]
Seat 1: deadkiller1 folded before Flop (didn't bet)
Seat 2: matiko09 folded before Flop (didn't bet)
Seat 3: Ouga Buga folded before Flop (didn't bet)
Seat 4: torkkdnm (button) folded before Flop (didn't bet)
Seat 6: janarr5 (small blind) folded before Flop
Seat 7: rate8 (big blind) folded before Flop
Seat 8: Kihog folded on the Flop
Seat 9: stijner1986 collected (€9.02)





PokerStars Hand #153506021282:  Hold'em No Limit ($0.50/$1.00 USD) - 2016/05/18 21:42:15 CET [2016/05/18 15:42:15 ET]
Table 'Tatjana III' 9-max Seat #5 is the button
Seat 1: cobrik23 ($177.14 in chips) 
Seat 2: vanilica ($116.62 in chips) 
Seat 3: matiko09 ($174.10 in chips) 
Seat 4: ipashutapkom ($64.66 in chips) 
Seat 5: deadkiller1 ($100 in chips) 
Seat 6: Kihog ($109.09 in chips) 
Seat 7: rene1984tsv ($88.85 in chips) 
Seat 8: JACQUILF ($155.42 in chips) 
Seat 9: Moszes360 ($103.61 in chips) 
Kihog: posts small blind $0.50
rene1984tsv: posts big blind $1
*** HOLE CARDS ***
Dealt to matiko09 [5d 2d]
JACQUILF: folds 
Moszes360: folds 
cobrik23: raises $1 to $2
vanilica: folds 
matiko09: folds 
ipashutapkom: folds 
deadkiller1: folds 
Kihog: folds 
rene1984tsv: calls $1
*** FLOP *** [Ad 9c 5s]
rene1984tsv: checks 
cobrik23: checks 
*** TURN *** [Ad 9c 5s] [6s]
rene1984tsv: bets $4.28
cobrik23: folds 
Uncalled bet ($4.28) returned to rene1984tsv
rene1984tsv collected $4.28 from pot
rene1984tsv: doesn't show hand 
*** SUMMARY ***
Total pot $4.50 | Rake $0.22 
Board [Ad 9c 5s 6s]
Seat 1: cobrik23 folded on the Turn
Seat 2: vanilica folded before Flop (didn't bet)
Seat 3: matiko09 folded before Flop (didn't bet)
Seat 4: ipashutapkom folded before Flop (didn't bet)
Seat 5: deadkiller1 (button) folded before Flop (didn't bet)
Seat 6: Kihog (small blind) folded before Flop
Seat 7: rene1984tsv (big blind) collected ($4.28)
Seat 8: JACQUILF folded before Flop (didn't bet)
Seat 9: Moszes360 folded before Flop (didn't bet)





PokerStars Hand #153506035756:  Hold'em No Limit ($0.50/$1.00 USD) - 2016/05/18 21:42:30 CET [2016/05/18 15:42:30 ET]
Table 'Zaurak II' 9-max Seat #1 is the button
Seat 1: TimStone ($100 in chips) 
Seat 2: matiko09 ($100 in chips) 
Seat 3: janarr5 ($130.48 in chips) 
Seat 4: solbi86 ($144.22 in chips) 
Seat 5: rate8 ($125.20 in chips) 
Seat 6: deadkiller1 ($101.50 in chips) 
Seat 7: Kihog ($135.32 in chips) 
Seat 9: torkkdnm ($133.67 in chips) 
matiko09: posts small blind $0.50
janarr5: posts big blind $1
*** HOLE CARDS ***
Dealt to matiko09 [Jh Ad]
solbi86: folds 
rate8: folds 
deadkiller1: folds 
Kihog: folds 
torkkdnm: folds 
TimStone: folds 
matiko09: raises $1.50 to $2.50
janarr5: raises $7.50 to $10
matiko09: calls $7.50
*** FLOP *** [Qs 5h Qd]
matiko09: checks 
janarr5: bets $10
matiko09: calls $10
*** TURN *** [Qs 5h Qd] [Ac]
matiko09: checks 
janarr5: bets $18
matiko09: calls $18
*** RIVER *** [Qs 5h Qd Ac] [4h]
matiko09: checks 
janarr5: checks 
*** SHOW DOWN ***
matiko09: shows [Jh Ad] (two pair, Aces and Queens)
janarr5: mucks hand 
matiko09 collected $73.50 from pot
*** SUMMARY ***
Total pot $76 | Rake $2.50 
Board [Qs 5h Qd Ac 4h]
Seat 1: TimStone (button) folded before Flop (didn't bet)
Seat 2: matiko09 (small blind) showed [Jh Ad] and won ($73.50) with two pair, Aces and Queens
Seat 3: janarr5 (big blind) mucked [3d 5d]
Seat 4: solbi86 folded before Flop (didn't bet)
Seat 5: rate8 folded before Flop (didn't bet)
Seat 6: deadkiller1 folded before Flop (didn't bet)
Seat 7: Kihog folded before Flop (didn't bet)
Seat 9: torkkdnm folded before Flop (didn't bet)





PokerStars Hand #153506036176:  Hold'em No Limit ($0.50/$1.00 USD) - 2016/05/18 21:42:31 CET [2016/05/18 15:42:31 ET]
Table 'Brendelia II' 9-max Seat #4 is the button
Seat 1: cobrik23 ($71.42 in chips) 
Seat 2: LebzLouda ($29.78 in chips) 
Seat 3: Zeeshka ($100 in chips) 
Seat 4: gkm0nk3y ($116.12 in chips) 
Seat 5: Vulturinus ($58.65 in chips) 
Seat 6: TimStone ($130.98 in chips) 
Seat 7: matiko09 ($100 in chips) 
Seat 8: solbi86 ($134.85 in chips) 
Vulturinus: posts small blind $0.50
TimStone: posts big blind $1
*** HOLE CARDS ***
Dealt to matiko09 [5s 9c]
matiko09: folds 
solbi86: folds 
cobrik23: raises $2 to $3
LebzLouda: calls $3
Zeeshka: folds 
gkm0nk3y: folds 
Vulturinus: folds 
TimStone: folds 
*** FLOP *** [7h Kc 3h]
cobrik23: checks 
LebzLouda: checks 
*** TURN *** [7h Kc 3h] [3c]
cobrik23: checks 
LebzLouda: checks 
*** RIVER *** [7h Kc 3h 3c] [Jc]
cobrik23: checks 
LebzLouda: checks 
*** SHOW DOWN ***
cobrik23: shows [Qd Jd] (two pair, Jacks and Threes)
LebzLouda: mucks hand 
cobrik23 collected $7.12 from pot
*** SUMMARY ***
Total pot $7.50 | Rake $0.38 
Board [7h Kc 3h 3c Jc]
Seat 1: cobrik23 showed [Qd Jd] and won ($7.12) with two pair, Jacks and Threes
Seat 2: LebzLouda mucked [Tc Ts]
Seat 3: Zeeshka folded before Flop (didn't bet)
Seat 4: gkm0nk3y (button) folded before Flop (didn't bet)
Seat 5: Vulturinus (small blind) folded before Flop
Seat 6: TimStone (big blind) folded before Flop
Seat 7: matiko09 folded before Flop (didn't bet)
Seat 8: solbi86 folded before Flop (didn't bet)





PokerStars Hand #153506037923:  Hold'em No Limit ($0.50/$1.00 USD) - 2016/05/18 21:42:33 CET [2016/05/18 15:42:33 ET]
Table 'Samitchell II' 9-max Seat #9 is the button
Seat 1: riggedsh** ($136.77 in chips) 
Seat 3: vanilica ($167.75 in chips) 
Seat 4: Zeeshka ($110.27 in chips) 
Seat 5: nuuaber ($61.97 in chips) 
Seat 6: Strikerman25 ($33.12 in chips) 
Seat 7: matiko09 ($110.15 in chips) 
Seat 8: rate8 ($102.88 in chips) 
Seat 9: janarr5 ($105 in chips) 
riggedsh**: posts small blind $0.50
vanilica: posts big blind $1
*** HOLE CARDS ***
Dealt to matiko09 [8s 9d]
Zeeshka: raises $2 to $3
nuuaber: folds 
Strikerman25: folds 
matiko09: folds 
rate8: folds 
janarr5: folds 
riggedsh**: folds 
vanilica: folds 
Uncalled bet ($2) returned to Zeeshka
Zeeshka collected $2.50 from pot
Zeeshka: doesn't show hand 
*** SUMMARY ***
Total pot $2.50 | Rake $0 
Seat 1: riggedsh** (small blind) folded before Flop
Seat 3: vanilica (big blind) folded before Flop
Seat 4: Zeeshka collected ($2.50)
Seat 5: nuuaber folded before Flop (didn't bet)
Seat 6: Strikerman25 folded before Flop (didn't bet)
Seat 7: matiko09 folded before Flop (didn't bet)
Seat 8: rate8 folded before Flop (didn't bet)
Seat 9: janarr5 (button) folded before Flop (didn't bet)





PokerStars Hand #153506049536:  Hold'em No Limit ($0.50/$1.00 USD) - 2016/05/18 21:42:45 CET [2016/05/18 15:42:45 ET]
Table 'Abetti II' 9-max Seat #1 is the button
Seat 1: matiko09 ($107.92 in chips) 
Seat 2: torkkdnm ($100 in chips) 
Seat 3: cobrik23 ($152.28 in chips) 
Seat 4: ipashutapkom ($41.50 in chips) 
Seat 5: blufthenuts ($160.17 in chips) 
Seat 6: Kihog ($100 in chips) 
Seat 7: rate8 ($102.78 in chips) 
Seat 8: roadster683 ($195.37 in chips) 
Seat 9: vanilica ($128.11 in chips) 
torkkdnm: posts small blind $0.50
cobrik23: posts big blind $1
*** HOLE CARDS ***
Dealt to matiko09 [4c 5d]
ipashutapkom: folds 
blufthenuts has timed out
blufthenuts: folds 
Kihog: folds 
rate8: folds 
roadster683: raises $1 to $2
vanilica: calls $2
matiko09: folds 
torkkdnm: folds 
cobrik23: folds 
*** FLOP *** [2c Jh Ad]
roadster683: bets $3
vanilica: calls $3
*** TURN *** [2c Jh Ad] [8c]
roadster683: checks 
vanilica: checks 
*** RIVER *** [2c Jh Ad 8c] [5s]
roadster683: checks 
vanilica: checks 
*** SHOW DOWN ***
roadster683: shows [8h 7d] (a pair of Eights)
vanilica: mucks hand 
roadster683 collected $10.92 from pot
*** SUMMARY ***
Total pot $11.50 | Rake $0.58 
Board [2c Jh Ad 8c 5s]
Seat 1: matiko09 (button) folded before Flop (didn't bet)
Seat 2: torkkdnm (small blind) folded before Flop
Seat 3: cobrik23 (big blind) folded before Flop
Seat 4: ipashutapkom folded before Flop (didn't bet)
Seat 5: blufthenuts folded before Flop (didn't bet)
Seat 6: Kihog folded before Flop (didn't bet)
Seat 7: rate8 folded before Flop (didn't bet)
Seat 8: roadster683 showed [8h 7d] and won ($10.92) with a pair of Eights
Seat 9: vanilica mucked [Qc Td]





PokerStars Hand #153506051471:  Hold'em No Limit ($0.50/$1.00 USD) - 2016/05/18 21:42:47 CET [2016/05/18 15:42:47 ET]
Table 'Lorcia II' 9-max Seat #5 is the button
Seat 1: TimStone ($100 in chips) 
Seat 2: janarr5 ($100 in chips) 
Seat 3: matiko09 ($105.42 in chips) 
Seat 4: vanilica ($124.10 in chips) 
Seat 5: nuuaber ($207.37 in chips) 
Seat 6: gkm0nk3y ($101.29 in chips) 
Seat 7: rate8 ($113.28 in chips) 
gkm0nk3y: posts small blind $0.50
rate8: posts big blind $1
*** HOLE CARDS ***
Dealt to matiko09 [Tc 3d]
TimStone: folds 
janarr5: folds 
matiko09: folds 
vanilica: raises $1.85 to $2.85
nuuaber: folds 
gkm0nk3y: folds 
rate8: folds 
Uncalled bet ($1.85) returned to vanilica
vanilica collected $2.50 from pot
vanilica: doesn't show hand 
*** SUMMARY ***
Total pot $2.50 | Rake $0 
Seat 1: TimStone folded before Flop (didn't bet)
Seat 2: janarr5 folded before Flop (didn't bet)
Seat 3: matiko09 folded before Flop (didn't bet)
Seat 4: vanilica collected ($2.50)
Seat 5: nuuaber (button) folded before Flop (didn't bet)
Seat 6: gkm0nk3y (small blind) folded before Flop
Seat 7: rate8 (big blind) folded before Flop





PokerStars Hand #153506053054:  Hold'em No Limit ($0.50/$1.00 USD) - 2016/05/18 21:42:49 CET [2016/05/18 15:42:49 ET]
Table 'Tatjana III' 9-max Seat #6 is the button
Seat 1: cobrik23 ($175.14 in chips) 
Seat 2: vanilica ($116.62 in chips) 
Seat 3: matiko09 ($174.10 in chips) 
Seat 4: ipashutapkom ($64.66 in chips) 
Seat 5: deadkiller1 ($100 in chips) 
Seat 6: Kihog ($108.59 in chips) 
Seat 7: rene1984tsv ($91.13 in chips) 
Seat 8: JACQUILF ($155.42 in chips) 
Seat 9: Moszes360 ($103.61 in chips) 
rene1984tsv: posts small blind $0.50
JACQUILF: posts big blind $1
*** HOLE CARDS ***
Dealt to matiko09 [Qs 9s]
Moszes360: folds 
cobrik23: folds 
vanilica: folds 
matiko09: folds 
ipashutapkom: raises $1.26 to $2.26
deadkiller1: folds 
Kihog: calls $2.26
rene1984tsv: calls $1.76
JACQUILF: folds 
*** FLOP *** [9d Ad Jh]
rene1984tsv: folds 
ipashutapkom: bets $2.36
Kihog: calls $2.36
*** TURN *** [9d Ad Jh] [7s]
ipashutapkom: checks 
Kihog: checks 
*** RIVER *** [9d Ad Jh 7s] [Kc]
ipashutapkom: bets $7.96
Kihog: folds 
Uncalled bet ($7.96) returned to ipashutapkom
ipashutapkom collected $11.88 from pot
ipashutapkom: doesn't show hand 
*** SUMMARY ***
Total pot $12.50 | Rake $0.62 
Board [9d Ad Jh 7s Kc]
Seat 1: cobrik23 folded before Flop (didn't bet)
Seat 2: vanilica folded before Flop (didn't bet)
Seat 3: matiko09 folded before Flop (didn't bet)
Seat 4: ipashutapkom collected ($11.88)
Seat 5: deadkiller1 folded before Flop (didn't bet)
Seat 6: Kihog (button) folded on the River
Seat 7: rene1984tsv (small blind) folded on the Flop
Seat 8: JACQUILF (big blind) folded before Flop
Seat 9: Moszes360 folded before Flop (didn't bet)





PokerStars Hand #153506071646:  Hold'em No Limit (€0.50/€1.00 EUR) - 2016/05/18 21:43:09 CET [2016/05/18 15:43:09 ET]
Table 'Pallas II' 9-max Seat #6 is the button
Seat 1: deadkiller1 (€195.31 in chips) 
Seat 2: matiko09 (€101.50 in chips) 
Seat 3: Ouga Buga (€100 in chips) 
Seat 4: torkkdnm (€169.75 in chips) 
Seat 6: janarr5 (€104.72 in chips) 
Seat 7: rate8 (€112.22 in chips) 
Seat 8: Kihog (€185.42 in chips) 
Seat 9: stijner1986 (€151.17 in chips) 
rate8: posts small blind €0.50
Kihog: posts big blind €1
*** HOLE CARDS ***
Dealt to matiko09 [Jc 7h]
stijner1986: raises €1 to €2
deadkiller1: folds 
matiko09: folds 
Ouga Buga: folds 
edidaz joins the table at seat #5 
torkkdnm: folds 
edidaz leaves the table
janarr5: folds 
rate8: folds 
Kihog: folds 
Uncalled bet (€1) returned to stijner1986
stijner1986 collected €2.50 from pot
stijner1986: doesn't show hand 
*** SUMMARY ***
Total pot €2.50 | Rake €0 
Seat 1: deadkiller1 folded before Flop (didn't bet)
Seat 2: matiko09 folded before Flop (didn't bet)
Seat 3: Ouga Buga folded before Flop (didn't bet)
Seat 4: torkkdnm folded before Flop (didn't bet)
Seat 6: janarr5 (button) folded before Flop (didn't bet)
Seat 7: rate8 (small blind) folded before Flop
Seat 8: Kihog (big blind) folded before Flop
Seat 9: stijner1986 collected (€2.50)





PokerStars Hand #153506084816:  Hold'em No Limit ($0.50/$1.00 USD) - 2016/05/18 21:43:23 CET [2016/05/18 15:43:23 ET]
Table 'Samitchell II' 9-max Seat #1 is the button
Seat 1: riggedsh** ($136.27 in chips) 
Seat 3: vanilica ($166.75 in chips) 
Seat 4: Zeeshka ($111.77 in chips) 
Seat 5: nuuaber ($61.97 in chips) 
Seat 6: Strikerman25 ($33.12 in chips) 
Seat 7: matiko09 ($110.15 in chips) 
Seat 8: rate8 ($102.88 in chips) 
Seat 9: janarr5 ($105 in chips) 
vanilica: posts small blind $0.50
Zeeshka: posts big blind $1
*** HOLE CARDS ***
Dealt to matiko09 [5s 2s]
nuuaber: raises $2 to $3
Strikerman25: folds 
matiko09: folds 
rate8: calls $3
janarr5: folds 
riggedsh**: folds 
vanilica: folds 
Zeeshka: calls $2
*** FLOP *** [Ad 9d 5c]
Zeeshka: checks 
nuuaber: checks 
rate8: bets $6.40
Zeeshka: folds 
nuuaber: folds 
Uncalled bet ($6.40) returned to rate8
rate8 collected $9.02 from pot
rate8: doesn't show hand 
*** SUMMARY ***
Total pot $9.50 | Rake $0.48 
Board [Ad 9d 5c]
Seat 1: riggedsh** (button) folded before Flop (didn't bet)
Seat 3: vanilica (small blind) folded before Flop
Seat 4: Zeeshka (big blind) folded on the Flop
Seat 5: nuuaber folded on the Flop
Seat 6: Strikerman25 folded before Flop (didn't bet)
Seat 7: matiko09 folded before Flop (didn't bet)
Seat 8: rate8 collected ($9.02)
Seat 9: janarr5 folded before Flop (didn't bet)





PokerStars Hand #153506086941:  Hold'em No Limit ($0.50/$1.00 USD) - 2016/05/18 21:43:25 CET [2016/05/18 15:43:25 ET]
Table 'Lorcia II' 9-max Seat #6 is the button
Seat 1: TimStone ($100 in chips) 
Seat 2: janarr5 ($100 in chips) 
Seat 3: matiko09 ($105.42 in chips) 
Seat 4: vanilica ($125.60 in chips) 
Seat 5: nuuaber ($207.37 in chips) 
Seat 6: gkm0nk3y ($100.79 in chips) 
Seat 7: rate8 ($112.28 in chips) 
rate8: posts small blind $0.50
TimStone: posts big blind $1
*** HOLE CARDS ***
Dealt to matiko09 [2h 4s]
janarr5: folds 
matiko09: folds 
vanilica: raises $2 to $3
nuuaber: calls $3
gkm0nk3y: folds 
rate8: folds 
TimStone: folds 
*** FLOP *** [9d Ts 8h]
vanilica: bets $5.34
nuuaber: calls $5.34
*** TURN *** [9d Ts 8h] [7c]
vanilica: checks 
nuuaber: bets $9
vanilica: calls $9
*** RIVER *** [9d Ts 8h 7c] [9s]
vanilica: checks 
nuuaber: bets $3
vanilica: raises $20 to $23
nuuaber: calls $20
*** SHOW DOWN ***
vanilica: shows [Jh Jc] (a straight, Seven to Jack)
nuuaber: mucks hand 
vanilica collected $79.68 from pot
*** SUMMARY ***
Total pot $82.18 | Rake $2.50 
Board [9d Ts 8h 7c 9s]
Seat 1: TimStone (big blind) folded before Flop
Seat 2: janarr5 folded before Flop (didn't bet)
Seat 3: matiko09 folded before Flop (didn't bet)
Seat 4: vanilica showed [Jh Jc] and won ($79.68) with a straight, Seven to Jack
Seat 5: nuuaber mucked [9h Ad]
Seat 6: gkm0nk3y (button) folded before Flop (didn't bet)
Seat 7: rate8 (small blind) folded before Flop





PokerStars Hand #153506088109:  Hold'em No Limit ($0.50/$1.00 USD) - 2016/05/18 21:43:26 CET [2016/05/18 15:43:26 ET]
Table 'Brendelia II' 9-max Seat #5 is the button
Seat 1: cobrik23 ($75.54 in chips) 
Seat 2: LebzLouda ($26.78 in chips) 
Seat 3: Zeeshka ($100 in chips) 
Seat 4: gkm0nk3y ($116.12 in chips) 
Seat 5: Vulturinus ($58.15 in chips) 
Seat 6: TimStone ($129.98 in chips) 
Seat 7: matiko09 ($100 in chips) 
Seat 8: solbi86 ($134.85 in chips) 
TimStone: posts small blind $0.50
matiko09: posts big blind $1
*** HOLE CARDS ***
Dealt to matiko09 [8d 3d]
solbi86: folds 
cobrik23: folds 
LebzLouda: folds 
Zeeshka: raises $2 to $3
gkm0nk3y: calls $3
Vulturinus: folds 
TimStone: folds 
matiko09: folds 
*** FLOP *** [3h 8h Ks]
Zeeshka: bets $4.77
gkm0nk3y: calls $4.77
*** TURN *** [3h 8h Ks] [6d]
Zeeshka: checks 
gkm0nk3y: checks 
*** RIVER *** [3h 8h Ks 6d] [Th]
Zeeshka: checks 
gkm0nk3y: bets $9
Zeeshka: calls $9
*** SHOW DOWN ***
gkm0nk3y: shows [Kc Ah] (a pair of Kings)
Zeeshka: shows [Kd As] (a pair of Kings)
Zeeshka collected $16.65 from pot
gkm0nk3y collected $16.64 from pot
*** SUMMARY ***
Total pot $35.04 | Rake $1.75 
Board [3h 8h Ks 6d Th]
Seat 1: cobrik23 folded before Flop (didn't bet)
Seat 2: LebzLouda folded before Flop (didn't bet)
Seat 3: Zeeshka showed [Kd As] and won ($16.65) with a pair of Kings
Seat 4: gkm0nk3y showed [Kc Ah] and won ($16.64) with a pair of Kings
Seat 5: Vulturinus (button) folded before Flop (didn't bet)
Seat 6: TimStone (small blind) folded before Flop
Seat 7: matiko09 (big blind) folded before Flop
Seat 8: solbi86 folded before Flop (didn't bet)





PokerStars Hand #153506103775:  Hold'em No Limit ($0.50/$1.00 USD) - 2016/05/18 21:43:43 CET [2016/05/18 15:43:43 ET]
Table 'Zaurak II' 9-max Seat #2 is the button
Seat 1: TimStone ($100 in chips) 
Seat 2: matiko09 ($135.50 in chips) 
Seat 3: janarr5 ($100 in chips) 
Seat 6: deadkiller1 ($101.50 in chips) 
Seat 7: Kihog ($135.32 in chips) 
Seat 9: torkkdnm ($133.67 in chips) 
janarr5: posts small blind $0.50
solbi86: is sitting out 
rate8: is sitting out 
deadkiller1: posts big blind $1
*** HOLE CARDS ***
Dealt to matiko09 [8d 5h]
rate8 leaves the table
Kihog: folds 
torkkdnm: folds 
TimStone: folds 
matiko09: folds 
janarr5: folds 
Uncalled bet ($0.50) returned to deadkiller1
deadkiller1 collected $1 from pot
deadkiller1: doesn't show hand 
*** SUMMARY ***
Total pot $1 | Rake $0 
Seat 1: TimStone folded before Flop (didn't bet)
Seat 2: matiko09 (button) folded before Flop (didn't bet)
Seat 3: janarr5 (small blind) folded before Flop
Seat 6: deadkiller1 (big blind) collected ($1)
Seat 7: Kihog folded before Flop (didn't bet)
Seat 9: torkkdnm folded before Flop (didn't bet)





PokerStars Hand #153506113706:  Hold'em No Limit ($0.50/$1.00 USD) - 2016/05/18 21:43:53 CET [2016/05/18 15:43:53 ET]
Table 'Abetti II' 9-max Seat #2 is the button
Seat 1: matiko09 ($107.92 in chips) 
Seat 2: torkkdnm ($100 in chips) 
Seat 3: cobrik23 ($151.28 in chips) 
Seat 4: ipashutapkom ($41.50 in chips) 
Seat 6: Kihog ($100 in chips) 
Seat 7: rate8 ($102.78 in chips) 
Seat 8: roadster683 ($201.29 in chips) 
Seat 9: vanilica ($123.11 in chips) 
cobrik23: posts small blind $0.50
ipashutapkom: posts big blind $1
*** HOLE CARDS ***
Dealt to matiko09 [Jd 5h]
Kihog: folds 
rate8: folds 
roadster683: folds 
vanilica: folds 
matiko09: folds 
torkkdnm: raises $1 to $2
cobrik23: folds 
ipashutapkom: raises $4 to $6
torkkdnm: folds 
Uncalled bet ($4) returned to ipashutapkom
ipashutapkom collected $4.50 from pot
ipashutapkom: doesn't show hand 
*** SUMMARY ***
Total pot $4.50 | Rake $0 
Seat 1: matiko09 folded before Flop (didn't bet)
Seat 2: torkkdnm (button) folded before Flop
Seat 3: cobrik23 (small blind) folded before Flop
Seat 4: ipashutapkom (big blind) collected ($4.50)
Seat 6: Kihog folded before Flop (didn't bet)
Seat 7: rate8 folded before Flop (didn't bet)
Seat 8: roadster683 folded before Flop (didn't bet)
Seat 9: vanilica folded before Flop (didn't bet)





PokerStars Hand #153506122099:  Hold'em No Limit (€0.50/€1.00 EUR) - 2016/05/18 21:44:02 CET [2016/05/18 15:44:02 ET]
Table 'Pallas II' 9-max Seat #7 is the button
Seat 1: deadkiller1 (€195.31 in chips) 
Seat 2: matiko09 (€101.50 in chips) 
Seat 3: Ouga Buga (€100 in chips) 
Seat 4: torkkdnm (€169.75 in chips) 
Seat 6: janarr5 (€104.72 in chips) 
Seat 7: rate8 (€111.72 in chips) 
Seat 8: Kihog (€184.42 in chips) 
Seat 9: stijner1986 (€152.67 in chips) 
Kihog: posts small blind €0.50
stijner1986: posts big blind €1
*** HOLE CARDS ***
Dealt to matiko09 [8d 8h]
deadkiller1: raises €2 to €3
matiko09: calls €3
Ouga Buga: folds 
florrin92 joins the table at seat #5 
torkkdnm: folds 
janarr5: folds 
rate8: folds 
Kihog: folds 
stijner1986: folds 
*** FLOP *** [9d 9h Ts]
deadkiller1: bets €4.69
matiko09: calls €4.69
*** TURN *** [9d 9h Ts] [3d]
deadkiller1: checks 
matiko09: checks 
*** RIVER *** [9d 9h Ts 3d] [Qh]
deadkiller1: checks 
matiko09: checks 
*** SHOW DOWN ***
deadkiller1: shows [5c 5s] (two pair, Nines and Fives)
matiko09: shows [8d 8h] (two pair, Nines and Eights)
matiko09 collected €16.04 from pot
*** SUMMARY ***
Total pot €16.88 | Rake €0.84 
Board [9d 9h Ts 3d Qh]
Seat 1: deadkiller1 showed [5c 5s] and lost with two pair, Nines and Fives
Seat 2: matiko09 showed [8d 8h] and won (€16.04) with two pair, Nines and Eights
Seat 3: Ouga Buga folded before Flop (didn't bet)
Seat 4: torkkdnm folded before Flop (didn't bet)
Seat 6: janarr5 folded before Flop (didn't bet)
Seat 7: rate8 (button) folded before Flop (didn't bet)
Seat 8: Kihog (small blind) folded before Flop
Seat 9: stijner1986 (big blind) folded before Flop





PokerStars Hand #153506122792:  Hold'em No Limit ($0.50/$1.00 USD) - 2016/05/18 21:44:03 CET [2016/05/18 15:44:03 ET]
Table 'Tatjana III' 9-max Seat #7 is the button
Seat 1: cobrik23 ($175.14 in chips) 
Seat 2: vanilica ($116.62 in chips) 
Seat 3: matiko09 ($174.10 in chips) 
Seat 4: ipashutapkom ($71.92 in chips) 
Seat 5: deadkiller1 ($100 in chips) 
Seat 6: Kihog ($103.97 in chips) 
Seat 7: rene1984tsv ($88.87 in chips) 
Seat 8: JACQUILF ($154.42 in chips) 
JACQUILF: posts small blind $0.50
Moszes360: is sitting out 
cobrik23: posts big blind $1
*** HOLE CARDS ***
Dealt to matiko09 [Tc 4c]
vanilica: folds 
matiko09: folds 
ipashutapkom: raises $1.26 to $2.26
deadkiller1: folds 
Kihog: folds 
rene1984tsv: calls $2.26
JACQUILF: folds 
cobrik23: folds 
*** FLOP *** [2s 7c Kd]
ipashutapkom: bets $1.83
rene1984tsv: raises $1.83 to $3.66
ipashutapkom: folds 
Uncalled bet ($1.83) returned to rene1984tsv
rene1984tsv collected $9.20 from pot
rene1984tsv: shows [Jh 5h] (high card King)
*** SUMMARY ***
Total pot $9.68 | Rake $0.48 
Board [2s 7c Kd]
Seat 1: cobrik23 (big blind) folded before Flop
Seat 2: vanilica folded before Flop (didn't bet)
Seat 3: matiko09 folded before Flop (didn't bet)
Seat 4: ipashutapkom folded on the Flop
Seat 5: deadkiller1 folded before Flop (didn't bet)
Seat 6: Kihog folded before Flop (didn't bet)
Seat 7: rene1984tsv (button) collected ($9.20)
Seat 8: JACQUILF (small blind) folded before Flop





PokerStars Hand #153506125043:  Hold'em No Limit ($0.50/$1.00 USD) - 2016/05/18 21:44:05 CET [2016/05/18 15:44:05 ET]
Table 'Zaurak II' 9-max Seat #3 is the button
Seat 1: TimStone ($100 in chips) 
Seat 2: matiko09 ($135.50 in chips) 
Seat 3: janarr5 ($100 in chips) 
Seat 6: deadkiller1 ($102 in chips) 
Seat 9: torkkdnm ($133.67 in chips) 
deadkiller1: posts small blind $0.50
Kihog: is sitting out 
Kihog leaves the table
torkkdnm: posts big blind $1
*** HOLE CARDS ***
Dealt to matiko09 [Ks Qc]
stepan0605 joins the table at seat #5 
TimStone: raises $1.62 to $2.62
matiko09: raises $6.38 to $9
Cortine joins the table at seat #7 
janarr5: folds 
janarr5 leaves the table
antohka123 joins the table at seat #8 
deadkiller1: folds 
LadyMaCe86 joins the table at seat #3 
torkkdnm: folds 
solbi86 leaves the table
TimStone: folds 
Uncalled bet ($6.38) returned to matiko09
matiko09 collected $6.74 from pot
matiko09: doesn't show hand 
*** SUMMARY ***
Total pot $6.74 | Rake $0 
Seat 1: TimStone folded before Flop
Seat 2: matiko09 collected ($6.74)
Seat 3: janarr5 (button) folded before Flop (didn't bet)
Seat 6: deadkiller1 (small blind) folded before Flop
Seat 9: torkkdnm (big blind) folded before Flop





PokerStars Hand #153506138213:  Hold'em No Limit ($0.50/$1.00 USD) - 2016/05/18 21:44:20 CET [2016/05/18 15:44:20 ET]
Table 'Samitchell II' 9-max Seat #3 is the button
Seat 1: riggedsh** ($136.27 in chips) 
Seat 3: vanilica ($166.25 in chips) 
Seat 4: Zeeshka ($108.77 in chips) 
Seat 5: nuuaber ($58.97 in chips) 
Seat 6: Strikerman25 ($33.12 in chips) 
Seat 7: matiko09 ($110.15 in chips) 
Seat 8: rate8 ($108.90 in chips) 
Seat 9: janarr5 ($105 in chips) 
Zeeshka: posts small blind $0.50
nuuaber: posts big blind $1
*** HOLE CARDS ***
Dealt to matiko09 [2c 3h]
Strikerman25: folds 
matiko09: folds 
rate8: raises $2 to $3
janarr5: folds 
riggedsh**: folds 
vanilica: folds 
Zeeshka: folds 
nuuaber: calls $2
*** FLOP *** [Ah Jc 7s]
nuuaber: bets $3
rate8: calls $3
*** TURN *** [Ah Jc 7s] [6d]
nuuaber: bets $6
rate8: calls $6
*** RIVER *** [Ah Jc 7s 6d] [Kc]
nuuaber: bets $6
rate8: folds 
Uncalled bet ($6) returned to nuuaber
nuuaber collected $23.28 from pot
nuuaber: doesn't show hand 
*** SUMMARY ***
Total pot $24.50 | Rake $1.22 
Board [Ah Jc 7s 6d Kc]
Seat 1: riggedsh** folded before Flop (didn't bet)
Seat 3: vanilica (button) folded before Flop (didn't bet)
Seat 4: Zeeshka (small blind) folded before Flop
Seat 5: nuuaber (big blind) collected ($23.28)
Seat 6: Strikerman25 folded before Flop (didn't bet)
Seat 7: matiko09 folded before Flop (didn't bet)
Seat 8: rate8 folded on the River
Seat 9: janarr5 folded before Flop (didn't bet)





PokerStars Hand #153506140060:  Hold'em No Limit ($0.50/$1.00 USD) - 2016/05/18 21:44:22 CET [2016/05/18 15:44:22 ET]
Table 'Lorcia II' 9-max Seat #7 is the button
Seat 1: TimStone ($100 in chips) 
Seat 2: janarr5 ($100 in chips) 
Seat 3: matiko09 ($105.42 in chips) 
Seat 4: vanilica ($164.94 in chips) 
Seat 5: nuuaber ($167.03 in chips) 
Seat 6: gkm0nk3y ($100.79 in chips) 
Seat 7: rate8 ($111.78 in chips) 
TimStone: posts small blind $0.50
janarr5: posts big blind $1
*** HOLE CARDS ***
Dealt to matiko09 [Js 2s]
matiko09: folds 
vanilica: folds 
nuuaber: calls $1
gkm0nk3y: folds 
rate8: folds 
TimStone: calls $0.50
janarr5: checks 
*** FLOP *** [Ad 7s 3s]
TimStone: bets $1.63
janarr5: calls $1.63
nuuaber: calls $1.63
*** TURN *** [Ad 7s 3s] [Th]
TimStone: bets $3.95
janarr5: folds 
nuuaber: folds 
Uncalled bet ($3.95) returned to TimStone
TimStone collected $7.50 from pot
TimStone: doesn't show hand 
*** SUMMARY ***
Total pot $7.89 | Rake $0.39 
Board [Ad 7s 3s Th]
Seat 1: TimStone (small blind) collected ($7.50)
Seat 2: janarr5 (big blind) folded on the Turn
Seat 3: matiko09 folded before Flop (didn't bet)
Seat 4: vanilica folded before Flop (didn't bet)
Seat 5: nuuaber folded on the Turn
Seat 6: gkm0nk3y folded before Flop (didn't bet)
Seat 7: rate8 (button) folded before Flop (didn't bet)





PokerStars Hand #153506154733:  Hold'em No Limit ($0.50/$1.00 USD) - 2016/05/18 21:44:37 CET [2016/05/18 15:44:37 ET]
Table 'Brendelia II' 9-max Seat #6 is the button
Seat 1: cobrik23 ($75.54 in chips) 
Seat 2: LebzLouda ($26.78 in chips) 
Seat 3: Zeeshka ($100 in chips) 
Seat 4: gkm0nk3y ($115.99 in chips) 
Seat 5: Vulturinus ($58.15 in chips) 
Seat 6: TimStone ($129.48 in chips) 
Seat 7: matiko09 ($100 in chips) 
Seat 8: solbi86 ($134.85 in chips) 
matiko09: posts small blind $0.50
solbi86: posts big blind $1
*** HOLE CARDS ***
Dealt to matiko09 [5d 6c]
cobrik23: folds 
LebzLouda: folds 
Zeeshka: folds 
gkm0nk3y: folds 
Vulturinus: raises $2 to $3
TimStone: folds 
matiko09: folds 
solbi86: folds 
Uncalled bet ($2) returned to Vulturinus
Vulturinus collected $2.50 from pot
*** SUMMARY ***
Total pot $2.50 | Rake $0 
Seat 1: cobrik23 folded before Flop (didn't bet)
Seat 2: LebzLouda folded before Flop (didn't bet)
Seat 3: Zeeshka folded before Flop (didn't bet)
Seat 4: gkm0nk3y folded before Flop (didn't bet)
Seat 5: Vulturinus collected ($2.50)
Seat 6: TimStone (button) folded before Flop (didn't bet)
Seat 7: matiko09 (small blind) folded before Flop
Seat 8: solbi86 (big blind) folded before Flop





PokerStars Hand #153506156603:  Hold'em No Limit ($0.50/$1.00 USD) - 2016/05/18 21:44:39 CET [2016/05/18 15:44:39 ET]
Table 'Abetti II' 9-max Seat #3 is the button
Seat 1: matiko09 ($107.92 in chips) 
Seat 2: torkkdnm ($100 in chips) 
Seat 3: cobrik23 ($150.78 in chips) 
Seat 4: ipashutapkom ($44 in chips) 
Seat 6: Kihog ($100 in chips) 
Seat 7: rate8 ($102.78 in chips) 
Seat 8: roadster683 ($201.29 in chips) 
Seat 9: vanilica ($123.11 in chips) 
ipashutapkom: posts small blind $0.50
Kihog: posts big blind $1
*** HOLE CARDS ***
Dealt to matiko09 [6s As]
rate8: folds 
roadster683: folds 
vanilica: folds 
matiko09: raises $2 to $3
torkkdnm: folds 
cobrik23: calls $3
ipashutapkom: folds 
Kihog: calls $2
*** FLOP *** [6c Js 3c]
Kihog: checks 
matiko09: checks 
cobrik23: checks 
*** TURN *** [6c Js 3c] [9d]
Kihog: bets $6.50
matiko09: folds 
cobrik23: calls $6.50
*** RIVER *** [6c Js 3c 9d] [Td]
Kihog: checks 
cobrik23: bets $14.25
Kihog: raises $34.75 to $49
cobrik23: folds 
Uncalled bet ($34.75) returned to Kihog
Kihog collected $48.50 from pot
Kihog: doesn't show hand 
*** SUMMARY ***
Total pot $51 | Rake $2.50 
Board [6c Js 3c 9d Td]
Seat 1: matiko09 folded on the Turn
Seat 2: torkkdnm folded before Flop (didn't bet)
Seat 3: cobrik23 (button) folded on the River
Seat 4: ipashutapkom (small blind) folded before Flop
Seat 6: Kihog (big blind) collected ($48.50)
Seat 7: rate8 folded before Flop (didn't bet)
Seat 8: roadster683 folded before Flop (didn't bet)
Seat 9: vanilica folded before Flop (didn't bet)





PokerStars Hand #153506158531:  Hold'em No Limit ($0.50/$1.00 USD) - 2016/05/18 21:44:41 CET [2016/05/18 15:44:41 ET]
Table 'Tatjana III' 9-max Seat #8 is the button
Seat 1: cobrik23 ($174.14 in chips) 
Seat 2: vanilica ($116.62 in chips) 
Seat 3: matiko09 ($174.10 in chips) 
Seat 4: ipashutapkom ($67.83 in chips) 
Seat 5: deadkiller1 ($100 in chips) 
Seat 6: Kihog ($103.97 in chips) 
Seat 7: rene1984tsv ($93.98 in chips) 
Seat 8: JACQUILF ($153.92 in chips) 
cobrik23: posts small blind $0.50
vanilica: posts big blind $1
*** HOLE CARDS ***
Dealt to matiko09 [3d As]
matiko09: folds 
ipashutapkom: folds 
deadkiller1: folds 
Kihog: folds 
rene1984tsv: calls $1
JACQUILF: raises $3 to $4
cobrik23: folds 
vanilica: folds 
rene1984tsv: calls $3
*** FLOP *** [2d 9c 3c]
rene1984tsv: checks 
JACQUILF: bets $6.31
rene1984tsv: calls $6.31
*** TURN *** [2d 9c 3c] [9s]
rene1984tsv: checks 
JACQUILF: bets $13
rene1984tsv: raises $23.50 to $36.50
JACQUILF: folds 
Uncalled bet ($23.50) returned to rene1984tsv
rene1984tsv collected $45.71 from pot
rene1984tsv: doesn't show hand 
*** SUMMARY ***
Total pot $48.12 | Rake $2.41 
Board [2d 9c 3c 9s]
Seat 1: cobrik23 (small blind) folded before Flop
Seat 2: vanilica (big blind) folded before Flop
Seat 3: matiko09 folded before Flop (didn't bet)
Seat 4: ipashutapkom folded before Flop (didn't bet)
Seat 5: deadkiller1 folded before Flop (didn't bet)
Seat 6: Kihog folded before Flop (didn't bet)
Seat 7: rene1984tsv collected ($45.71)
Seat 8: JACQUILF (button) folded on the Turn





PokerStars Hand #153506187581:  Hold'em No Limit ($0.50/$1.00 USD) - 2016/05/18 21:45:13 CET [2016/05/18 15:45:13 ET]
Table 'Brendelia II' 9-max Seat #7 is the button
Seat 2: LebzLouda ($26.78 in chips) 
Seat 3: Zeeshka ($100 in chips) 
Seat 4: gkm0nk3y ($115.99 in chips) 
Seat 5: Vulturinus ($59.65 in chips) 
Seat 6: TimStone ($129.48 in chips) 
Seat 7: matiko09 ($100 in chips) 
Seat 8: solbi86 ($133.85 in chips) 
solbi86: posts small blind $0.50
cobrik23: is sitting out 
cobrik23 leaves the table
LebzLouda: posts big blind $1
*** HOLE CARDS ***
Dealt to matiko09 [Th 9c]
Zeeshka: folds 
gkm0nk3y: folds 
Vulturinus has timed out
Vulturinus: folds 
janarr5 joins the table at seat #1 
TimStone: raises $1.52 to $2.52
matiko09: folds 
solbi86: folds 
LebzLouda: calls $1.52
*** FLOP *** [Jd Qh Td]
LebzLouda: checks 
TimStone: bets $4.94
LebzLouda: folds 
Uncalled bet ($4.94) returned to TimStone
TimStone collected $5.26 from pot
TimStone: doesn't show hand 
*** SUMMARY ***
Total pot $5.54 | Rake $0.28 
Board [Jd Qh Td]
Seat 2: LebzLouda (big blind) folded on the Flop
Seat 3: Zeeshka folded before Flop (didn't bet)
Seat 4: gkm0nk3y folded before Flop (didn't bet)
Seat 5: Vulturinus folded before Flop (didn't bet)
Seat 6: TimStone collected ($5.26)
Seat 7: matiko09 (button) folded before Flop (didn't bet)
Seat 8: solbi86 (small blind) folded before Flop





PokerStars Hand #153506197681:  Hold'em No Limit ($0.50/$1.00 USD) - 2016/05/18 21:45:23 CET [2016/05/18 15:45:23 ET]
Table 'Lorcia II' 9-max Seat #1 is the button
Seat 1: TimStone ($104.87 in chips) 
Seat 2: janarr5 ($100 in chips) 
Seat 3: matiko09 ($105.42 in chips) 
Seat 4: vanilica ($164.94 in chips) 
Seat 5: nuuaber ($164.40 in chips) 
Seat 6: gkm0nk3y ($100.79 in chips) 
Seat 7: rate8 ($111.78 in chips) 
janarr5: posts small blind $0.50
matiko09: posts big blind $1
*** HOLE CARDS ***
Dealt to matiko09 [6d 9d]
vanilica: folds 
nuuaber: folds 
gkm0nk3y: folds 
rate8: folds 
TimStone: raises $1.22 to $2.22
janarr5: folds 
matiko09: calls $1.22
*** FLOP *** [Qc 6c 7d]
matiko09: checks 
TimStone: checks 
*** TURN *** [Qc 6c 7d] [2c]
matiko09: checks 
TimStone: checks 
*** RIVER *** [Qc 6c 7d 2c] [Th]
matiko09: checks 
TimStone: checks 
*** SHOW DOWN ***
matiko09: shows [6d 9d] (a pair of Sixes)
TimStone: shows [Ad 6s] (a pair of Sixes - Ace kicker)
TimStone collected $4.69 from pot
*** SUMMARY ***
Total pot $4.94 | Rake $0.25 
Board [Qc 6c 7d 2c Th]
Seat 1: TimStone (button) showed [Ad 6s] and won ($4.69) with a pair of Sixes
Seat 2: janarr5 (small blind) folded before Flop
Seat 3: matiko09 (big blind) showed [6d 9d] and lost with a pair of Sixes
Seat 4: vanilica folded before Flop (didn't bet)
Seat 5: nuuaber folded before Flop (didn't bet)
Seat 6: gkm0nk3y folded before Flop (didn't bet)
Seat 7: rate8 folded before Flop (didn't bet)





PokerStars Hand #153506205813:  Hold'em No Limit (€0.50/€1.00 EUR) - 2016/05/18 21:45:32 CET [2016/05/18 15:45:32 ET]
Table 'Pallas II' 9-max Seat #8 is the button
Seat 1: deadkiller1 (€187.62 in chips) 
Seat 2: matiko09 (€109.85 in chips) 
Seat 3: Ouga Buga (€100 in chips) 
Seat 4: torkkdnm (€169.75 in chips) 
Seat 6: janarr5 (€104.72 in chips) 
Seat 7: rate8 (€111.72 in chips) 
Seat 8: Kihog (€183.92 in chips) 
Seat 9: stijner1986 (€151.67 in chips) 
stijner1986: posts small blind €0.50
deadkiller1: posts big blind €1
*** HOLE CARDS ***
Dealt to matiko09 [Ad Js]
matiko09: raises €2 to €3
Ouga Buga: folds 
torkkdnm: folds 
janarr5: folds 
rate8: folds 
Kihog: calls €3
stijner1986: folds 
deadkiller1: folds 
*** FLOP *** [9c 5s 8h]
matiko09: checks 
Kihog: bets €4
matiko09: folds 
Uncalled bet (€4) returned to Kihog
Kihog collected €7.12 from pot
*** SUMMARY ***
Total pot €7.50 | Rake €0.38 
Board [9c 5s 8h]
Seat 1: deadkiller1 (big blind) folded before Flop
Seat 2: matiko09 folded on the Flop
Seat 3: Ouga Buga folded before Flop (didn't bet)
Seat 4: torkkdnm folded before Flop (didn't bet)
Seat 6: janarr5 folded before Flop (didn't bet)
Seat 7: rate8 folded before Flop (didn't bet)
Seat 8: Kihog (button) collected (€7.12)
Seat 9: stijner1986 (small blind) folded before Flop





PokerStars Hand #153506227849:  Hold'em No Limit ($0.50/$1.00 USD) - 2016/05/18 21:45:56 CET [2016/05/18 15:45:56 ET]
Table 'Samitchell II' 9-max Seat #4 is the button
Seat 1: riggedsh** ($136.27 in chips) 
Seat 3: vanilica ($166.25 in chips) 
Seat 4: Zeeshka ($108.27 in chips) 
Seat 5: nuuaber ($70.25 in chips) 
Seat 6: Strikerman25 ($33.12 in chips) 
Seat 7: matiko09 ($110.15 in chips) 
Seat 8: rate8 ($100 in chips) 
Seat 9: janarr5 ($105 in chips) 
nuuaber: posts small blind $0.50
Strikerman25: posts big blind $1
Cortine: sits out 
*** HOLE CARDS ***
Dealt to matiko09 [Kd Qc]
matiko09: raises $2 to $3
rate8: folds 
janarr5: folds 
riggedsh**: folds 
vanilica: folds 
Zeeshka: folds 
nuuaber: folds 
Strikerman25: folds 
Uncalled bet ($2) returned to matiko09
matiko09 collected $2.50 from pot
matiko09: doesn't show hand 
*** SUMMARY ***
Total pot $2.50 | Rake $0 
Seat 1: riggedsh** folded before Flop (didn't bet)
Seat 3: vanilica folded before Flop (didn't bet)
Seat 4: Zeeshka (button) folded before Flop (didn't bet)
Seat 5: nuuaber (small blind) folded before Flop
Seat 6: Strikerman25 (big blind) folded before Flop
Seat 7: matiko09 collected ($2.50)
Seat 8: rate8 folded before Flop (didn't bet)
Seat 9: janarr5 folded before Flop (didn't bet)





PokerStars Hand #153506231576:  Hold'em No Limit ($0.50/$1.00 USD) - 2016/05/18 21:46:00 CET [2016/05/18 15:46:00 ET]
Table 'Tatjana III' 9-max Seat #1 is the button
Seat 1: cobrik23 ($173.64 in chips) 
Seat 2: vanilica ($115.62 in chips) 
Seat 3: matiko09 ($174.10 in chips) 
Seat 4: ipashutapkom ($67.83 in chips) 
Seat 5: deadkiller1 ($100 in chips) 
Seat 6: Kihog ($103.97 in chips) 
Seat 7: rene1984tsv ($116.38 in chips) 
Seat 8: JACQUILF ($130.61 in chips) 
vanilica: posts small blind $0.50
matiko09: posts big blind $1
*** HOLE CARDS ***
Dealt to matiko09 [Qd Kc]
ipashutapkom: folds 
deadkiller1: folds 
rene1984tsv said, "hahan only flush draw i had"
rene1984tsv said, ":):)"
Kihog: folds 
rene1984tsv: calls $1
JACQUILF: folds 
cobrik23: raises $3 to $4
vanilica: folds 
matiko09: calls $3
rene1984tsv: calls $3
*** FLOP *** [3s 5h Ad]
matiko09: checks 
rene1984tsv: checks 
cobrik23: bets $7.91
matiko09: folds 
rene1984tsv: calls $7.91
*** TURN *** [3s 5h Ad] [2s]
rene1984tsv: bets $19
cobrik23: calls $19
*** RIVER *** [3s 5h Ad 2s] [Qc]
rene1984tsv: bets $59
cobrik23: calls $59
*** SHOW DOWN ***
rene1984tsv: shows [4d 3h] (a straight, Ace to Five)
cobrik23: mucks hand 
rene1984tsv collected $181.82 from pot
*** SUMMARY ***
Total pot $184.32 | Rake $2.50 
Board [3s 5h Ad 2s Qc]
Seat 1: cobrik23 (button) mucked [Qs Ah]
Seat 2: vanilica (small blind) folded before Flop
Seat 3: matiko09 (big blind) folded on the Flop
Seat 4: ipashutapkom folded before Flop (didn't bet)
Seat 5: deadkiller1 folded before Flop (didn't bet)
Seat 6: Kihog folded before Flop (didn't bet)
Seat 7: rene1984tsv showed [4d 3h] and won ($181.82) with a straight, Ace to Five
Seat 8: JACQUILF folded before Flop (didn't bet)





PokerStars Hand #153506238015:  Hold'em No Limit ($0.50/$1.00 USD) - 2016/05/18 21:46:06 CET [2016/05/18 15:46:06 ET]
Table 'Brendelia II' 9-max Seat #8 is the button
Seat 2: LebzLouda ($24.26 in chips) 
Seat 3: Zeeshka ($100 in chips) 
Seat 4: gkm0nk3y ($115.99 in chips) 
Seat 5: Vulturinus ($59.65 in chips) 
Seat 6: TimStone ($132.22 in chips) 
Seat 7: matiko09 ($100 in chips) 
Seat 8: solbi86 ($133.35 in chips) 
janarr5 will be allowed to play after the button
LebzLouda: posts small blind $0.50
Zeeshka: posts big blind $1
*** HOLE CARDS ***
Dealt to matiko09 [4s Ah]
gkm0nk3y: folds 
Vulturinus: folds 
TimStone: folds 
matiko09: folds 
solbi86: folds 
LebzLouda: raises $2 to $3
Zeeshka: folds 
Uncalled bet ($2) returned to LebzLouda
LebzLouda collected $2 from pot
LebzLouda: doesn't show hand 
*** SUMMARY ***
Total pot $2 | Rake $0 
Seat 2: LebzLouda (small blind) collected ($2)
Seat 3: Zeeshka (big blind) folded before Flop
Seat 4: gkm0nk3y folded before Flop (didn't bet)
Seat 5: Vulturinus folded before Flop (didn't bet)
Seat 6: TimStone folded before Flop (didn't bet)
Seat 7: matiko09 folded before Flop (didn't bet)
Seat 8: solbi86 (button) folded before Flop (didn't bet)





PokerStars Hand #153506253414:  Hold'em No Limit ($0.50/$1.00 USD) - 2016/05/18 21:46:23 CET [2016/05/18 15:46:23 ET]
Table 'Lorcia II' 9-max Seat #3 is the button
Seat 1: TimStone ($107.34 in chips) 
Seat 3: matiko09 ($103.20 in chips) 
Seat 4: vanilica ($164.94 in chips) 
Seat 5: nuuaber ($164.40 in chips) 
Seat 6: gkm0nk3y ($100.79 in chips) 
Seat 7: rate8 ($111.78 in chips) 
vanilica: posts small blind $0.50
nuuaber: posts big blind $1
*** HOLE CARDS ***
Dealt to matiko09 [7s Ah]
gkm0nk3y: folds 
rate8: folds 
TimStone: raises $1.52 to $2.52
matiko09: folds 
vanilica: folds 
nuuaber: folds 
Uncalled bet ($1.52) returned to TimStone
TimStone collected $2.50 from pot
TimStone: doesn't show hand 
*** SUMMARY ***
Total pot $2.50 | Rake $0 
Seat 1: TimStone collected ($2.50)
Seat 3: matiko09 (button) folded before Flop (didn't bet)
Seat 4: vanilica (small blind) folded before Flop
Seat 5: nuuaber (big blind) folded before Flop
Seat 6: gkm0nk3y folded before Flop (didn't bet)
Seat 7: rate8 folded before Flop (didn't bet)





PokerStars Hand #153506253605:  Hold'em No Limit ($0.50/$1.00 USD) - 2016/05/18 21:46:23 CET [2016/05/18 15:46:23 ET]
Table 'Samitchell II' 9-max Seat #5 is the button
Seat 1: riggedsh** ($136.27 in chips) 
Seat 3: vanilica ($166.25 in chips) 
Seat 4: Zeeshka ($108.27 in chips) 
Seat 5: nuuaber ($69.75 in chips) 
Seat 6: Strikerman25 ($32.12 in chips) 
Seat 7: matiko09 ($111.65 in chips) 
Seat 8: rate8 ($100 in chips) 
Strikerman25: posts small blind $0.50
matiko09: posts big blind $1
Cortine: sits out 
*** HOLE CARDS ***
Dealt to matiko09 [Qh 6s]
rate8: folds 
riggedsh**: raises $2 to $3
vanilica: folds 
Zeeshka: folds 
nuuaber: calls $3
Strikerman25: folds 
matiko09: folds 
*** FLOP *** [2d Kc Ah]
riggedsh**: checks 
nuuaber: bets $3
riggedsh**: folds 
Uncalled bet ($3) returned to nuuaber
nuuaber collected $7.12 from pot
nuuaber: doesn't show hand 
*** SUMMARY ***
Total pot $7.50 | Rake $0.38 
Board [2d Kc Ah]
Seat 1: riggedsh** folded on the Flop
Seat 3: vanilica folded before Flop (didn't bet)
Seat 4: Zeeshka folded before Flop (didn't bet)
Seat 5: nuuaber (button) collected ($7.12)
Seat 6: Strikerman25 (small blind) folded before Flop
Seat 7: matiko09 (big blind) folded before Flop
Seat 8: rate8 folded before Flop (didn't bet)





PokerStars Hand #153506254026:  Hold'em No Limit ($0.50/$1.00 USD) - 2016/05/18 21:46:24 CET [2016/05/18 15:46:24 ET]
Table 'Abetti II' 9-max Seat #4 is the button
Seat 1: matiko09 ($104.92 in chips) 
Seat 2: torkkdnm ($100 in chips) 
Seat 3: cobrik23 ($127.03 in chips) 
Seat 4: ipashutapkom ($43.50 in chips) 
Seat 6: Kihog ($124.75 in chips) 
Seat 7: rate8 ($102.78 in chips) 
Seat 8: roadster683 ($201.29 in chips) 
Seat 9: vanilica ($123.11 in chips) 
Kihog: posts small blind $0.50
rate8: posts big blind $1
*** HOLE CARDS ***
Dealt to matiko09 [9c Tc]
roadster683: folds 
vanilica: folds 
matiko09: raises $2 to $3
torkkdnm: folds 
cobrik23: folds 
ipashutapkom: folds 
Kihog: folds 
rate8: folds 
Uncalled bet ($2) returned to matiko09
matiko09 collected $2.50 from pot
matiko09: doesn't show hand 
*** SUMMARY ***
Total pot $2.50 | Rake $0 
Seat 1: matiko09 collected ($2.50)
Seat 2: torkkdnm folded before Flop (didn't bet)
Seat 3: cobrik23 folded before Flop (didn't bet)
Seat 4: ipashutapkom (button) folded before Flop (didn't bet)
Seat 6: Kihog (small blind) folded before Flop
Seat 7: rate8 (big blind) folded before Flop
Seat 8: roadster683 folded before Flop (didn't bet)
Seat 9: vanilica folded before Flop (didn't bet)





PokerStars Hand #153506262633:  Hold'em No Limit (€0.50/€1.00 EUR) - 2016/05/18 21:46:33 CET [2016/05/18 15:46:33 ET]
Table 'Pallas II' 9-max Seat #9 is the button
Seat 1: deadkiller1 (€186.62 in chips) 
Seat 2: matiko09 (€106.85 in chips) 
Seat 3: Ouga Buga (€100 in chips) 
Seat 4: torkkdnm (€169.75 in chips) 
Seat 7: rate8 (€111.72 in chips) 
Seat 8: Kihog (€188.04 in chips) 
Seat 9: stijner1986 (€151.17 in chips) 
deadkiller1: posts small blind €0.50
matiko09: posts big blind €1
*** HOLE CARDS ***
Dealt to matiko09 [5d 3c]
Ouga Buga: folds 
torkkdnm: folds 
rate8: folds 
Kihog: folds 
stijner1986: calls €1
deadkiller1: raises €4 to €5
matiko09: folds 
stijner1986: calls €4
*** FLOP *** [4d 3s Js]
deadkiller1: bets €6.89
stijner1986: calls €6.89
*** TURN *** [4d 3s Js] [Qs]
deadkiller1: checks 
stijner1986: checks 
*** RIVER *** [4d 3s Js Qs] [9c]
deadkiller1: checks 
stijner1986: bets €14
deadkiller1: calls €14
*** SHOW DOWN ***
stijner1986: shows [2s Ts] (a flush, Queen high)
deadkiller1: mucks hand 
stijner1986 collected €50.53 from pot
*** SUMMARY ***
Total pot €52.78 | Rake €2.25 
Board [4d 3s Js Qs 9c]
Seat 1: deadkiller1 (small blind) mucked [7c 7d]
Seat 2: matiko09 (big blind) folded before Flop
Seat 3: Ouga Buga folded before Flop (didn't bet)
Seat 4: torkkdnm folded before Flop (didn't bet)
Seat 7: rate8 folded before Flop (didn't bet)
Seat 8: Kihog folded before Flop (didn't bet)
Seat 9: stijner1986 (button) showed [2s Ts] and won (€50.53) with a flush, Queen high





PokerStars Hand #153506263608:  Hold'em No Limit ($0.50/$1.00 USD) - 2016/05/18 21:46:34 CET [2016/05/18 15:46:34 ET]
Table 'Brendelia II' 9-max Seat #2 is the button
Seat 2: LebzLouda ($25.26 in chips) 
Seat 3: Zeeshka ($100 in chips) 
Seat 4: gkm0nk3y ($115.99 in chips) 
Seat 5: Vulturinus ($59.65 in chips) 
Seat 6: TimStone ($132.22 in chips) 
Seat 7: matiko09 ($100 in chips) 
Seat 8: solbi86 ($133.35 in chips) 
Zeeshka: posts small blind $0.50
gkm0nk3y: posts big blind $1
janarr5: sits out 
*** HOLE CARDS ***
Dealt to matiko09 [8c 9s]
Vulturinus: folds 
TimStone: folds 
matiko09: folds 
solbi86: folds 
LebzLouda: folds 
Zeeshka: folds 
Uncalled bet ($0.50) returned to gkm0nk3y
gkm0nk3y collected $1 from pot
*** SUMMARY ***
Total pot $1 | Rake $0 
Seat 2: LebzLouda (button) folded before Flop (didn't bet)
Seat 3: Zeeshka (small blind) folded before Flop
Seat 4: gkm0nk3y (big blind) collected ($1)
Seat 5: Vulturinus folded before Flop (didn't bet)
Seat 6: TimStone folded before Flop (didn't bet)
Seat 7: matiko09 folded before Flop (didn't bet)
Seat 8: solbi86 folded before Flop (didn't bet)





PokerStars Hand #153506284337:  Hold'em No Limit ($0.50/$1.00 USD) - 2016/05/18 21:46:56 CET [2016/05/18 15:46:56 ET]
Table 'Lorcia II' 9-max Seat #4 is the button
Seat 1: TimStone ($108.84 in chips) 
Seat 3: matiko09 ($103.20 in chips) 
Seat 4: vanilica ($164.44 in chips) 
Seat 5: nuuaber ($163.40 in chips) 
Seat 6: gkm0nk3y ($100.79 in chips) 
Seat 7: rate8 ($111.78 in chips) 
nuuaber: posts small blind $0.50
gkm0nk3y: posts big blind $1
*** HOLE CARDS ***
Dealt to matiko09 [7h 6s]
rate8: raises $2 to $3
TimStone: folds 
matiko09: folds 
vanilica: folds 
nuuaber: folds 
gkm0nk3y: folds 
Uncalled bet ($2) returned to rate8
rate8 collected $2.50 from pot
rate8: doesn't show hand 
*** SUMMARY ***
Total pot $2.50 | Rake $0 
Seat 1: TimStone folded before Flop (didn't bet)
Seat 3: matiko09 folded before Flop (didn't bet)
Seat 4: vanilica (button) folded before Flop (didn't bet)
Seat 5: nuuaber (small blind) folded before Flop
Seat 6: gkm0nk3y (big blind) folded before Flop
Seat 7: rate8 collected ($2.50)





PokerStars Hand #153506286388:  Hold'em No Limit ($0.50/$1.00 USD) - 2016/05/18 21:46:58 CET [2016/05/18 15:46:58 ET]
Table 'Abetti II' 9-max Seat #6 is the button
Seat 1: matiko09 ($106.42 in chips) 
Seat 2: torkkdnm ($100 in chips) 
Seat 3: cobrik23 ($127.03 in chips) 
Seat 4: ipashutapkom ($43.50 in chips) 
Seat 6: Kihog ($124.25 in chips) 
Seat 7: rate8 ($101.78 in chips) 
Seat 8: roadster683 ($201.29 in chips) 
Seat 9: vanilica ($123.11 in chips) 
rate8: posts small blind $0.50
roadster683: posts big blind $1
*** HOLE CARDS ***
Dealt to matiko09 [Th 2h]
vanilica: folds 
matiko09: folds 
torkkdnm: raises $2 to $3
cobrik23: folds 
ipashutapkom: raises $5 to $8
Kihog: folds 
rate8: folds 
roadster683: calls $7
torkkdnm: calls $5
*** FLOP *** [3d 3h 5d]
roadster683: checks 
torkkdnm: bets $14
ipashutapkom: calls $14
roadster683: raises $33 to $47
torkkdnm: folds 
ipashutapkom: calls $21.50 and is all-in
Uncalled bet ($11.50) returned to roadster683
*** TURN *** [3d 3h 5d] [6h]
*** RIVER *** [3d 3h 5d 6h] [Jd]
*** SHOW DOWN ***
roadster683: shows [9h 9c] (two pair, Nines and Threes)
ipashutapkom: shows [Td Tc] (two pair, Tens and Threes)
ipashutapkom collected $107 from pot
*** SUMMARY ***
Total pot $109.50 | Rake $2.50 
Board [3d 3h 5d 6h Jd]
Seat 1: matiko09 folded before Flop (didn't bet)
Seat 2: torkkdnm folded on the Flop
Seat 3: cobrik23 folded before Flop (didn't bet)
Seat 4: ipashutapkom showed [Td Tc] and won ($107) with two pair, Tens and Threes
Seat 6: Kihog (button) folded before Flop (didn't bet)
Seat 7: rate8 (small blind) folded before Flop
Seat 8: roadster683 (big blind) showed [9h 9c] and lost with two pair, Nines and Threes
Seat 9: vanilica folded before Flop (didn't bet)





PokerStars Hand #153506291371:  Hold'em No Limit ($0.50/$1.00 USD) - 2016/05/18 21:47:03 CET [2016/05/18 15:47:03 ET]
Table 'Brendelia II' 9-max Seat #3 is the button
Seat 2: LebzLouda ($25.26 in chips) 
Seat 3: Zeeshka ($100 in chips) 
Seat 4: gkm0nk3y ($116.49 in chips) 
Seat 5: Vulturinus ($59.65 in chips) 
Seat 6: TimStone ($132.22 in chips) 
Seat 7: matiko09 ($100 in chips) 
Seat 8: solbi86 ($133.35 in chips) 
gkm0nk3y: posts small blind $0.50
Vulturinus: posts big blind $1
janarr5: sits out 
*** HOLE CARDS ***
Dealt to matiko09 [7d 7s]
TimStone: folds 
matiko09: raises $2 to $3
solbi86: calls $3
LebzLouda: folds 
Zeeshka: folds 
gkm0nk3y: folds 
Vulturinus: folds 
*** FLOP *** [Ts Td 4d]
matiko09: bets $3.70
solbi86: folds 
Uncalled bet ($3.70) returned to matiko09
matiko09 collected $7.12 from pot
matiko09: doesn't show hand 
*** SUMMARY ***
Total pot $7.50 | Rake $0.38 
Board [Ts Td 4d]
Seat 2: LebzLouda folded before Flop (didn't bet)
Seat 3: Zeeshka (button) folded before Flop (didn't bet)
Seat 4: gkm0nk3y (small blind) folded before Flop
Seat 5: Vulturinus (big blind) folded before Flop
Seat 6: TimStone folded before Flop (didn't bet)
Seat 7: matiko09 collected ($7.12)
Seat 8: solbi86 folded on the Flop





PokerStars Hand #153506302297:  Hold'em No Limit ($0.50/$1.00 USD) - 2016/05/18 21:47:16 CET [2016/05/18 15:47:16 ET]
Table 'Lorcia II' 9-max Seat #5 is the button
Seat 1: TimStone ($108.84 in chips) 
Seat 3: matiko09 ($103.20 in chips) 
Seat 4: vanilica ($164.44 in chips) 
Seat 5: nuuaber ($162.90 in chips) 
Seat 6: gkm0nk3y ($100 in chips) 
Seat 7: rate8 ($113.28 in chips) 
gkm0nk3y: posts small blind $0.50
rate8: posts big blind $1
*** HOLE CARDS ***
Dealt to matiko09 [8c Jh]
TimStone: raises $1.62 to $2.62
matiko09: folds 
vanilica: calls $2.62
nuuaber: calls $2.62
gkm0nk3y: folds 
rate8: folds 
*** FLOP *** [Js 7h 6s]
TimStone: checks 
vanilica: checks 
nuuaber: checks 
*** TURN *** [Js 7h 6s] [5s]
TimStone: checks 
vanilica: checks 
nuuaber: checks 
*** RIVER *** [Js 7h 6s 5s] [8h]
TimStone: checks 
vanilica: checks 
nuuaber: bets $4
TimStone: folds 
vanilica: folds 
Uncalled bet ($4) returned to nuuaber
nuuaber collected $8.89 from pot
nuuaber: doesn't show hand 
*** SUMMARY ***
Total pot $9.36 | Rake $0.47 
Board [Js 7h 6s 5s 8h]
Seat 1: TimStone folded on the River
Seat 3: matiko09 folded before Flop (didn't bet)
Seat 4: vanilica folded on the River
Seat 5: nuuaber (button) collected ($8.89)
Seat 6: gkm0nk3y (small blind) folded before Flop
Seat 7: rate8 (big blind) folded before Flop





PokerStars Hand #153506303289:  Hold'em No Limit ($0.50/$1.00 USD) - 2016/05/18 21:47:17 CET [2016/05/18 15:47:17 ET]
Table 'Tatjana III' 9-max Seat #2 is the button
Seat 1: cobrik23 ($83.73 in chips) 
Seat 2: vanilica ($115.12 in chips) 
Seat 3: matiko09 ($170.10 in chips) 
Seat 5: deadkiller1 ($100 in chips) 
Seat 6: Kihog ($103.97 in chips) 
Seat 7: rene1984tsv ($208.29 in chips) 
Seat 8: JACQUILF ($130.61 in chips) 
matiko09: posts small blind $0.50
ipashutapkom: is sitting out 
ipashutapkom leaves the table
deadkiller1: posts big blind $1
*** HOLE CARDS ***
Dealt to matiko09 [Ad 5d]
Kihog: folds 
rene1984tsv: calls $1
JACQUILF: folds 
cobrik23: folds 
vanilica: raises $3.50 to $4.50
matiko09: raises $9.50 to $14
deadkiller1: folds 
rene1984tsv: folds 
vanilica: folds 
Uncalled bet ($9.50) returned to matiko09
matiko09 collected $11 from pot
matiko09: doesn't show hand 
*** SUMMARY ***
Total pot $11 | Rake $0 
Seat 1: cobrik23 folded before Flop (didn't bet)
Seat 2: vanilica (button) folded before Flop
Seat 3: matiko09 (small blind) collected ($11)
Seat 5: deadkiller1 (big blind) folded before Flop
Seat 6: Kihog folded before Flop (didn't bet)
Seat 7: rene1984tsv folded before Flop
Seat 8: JACQUILF folded before Flop (didn't bet)





PokerStars Hand #153506309746:  Hold'em No Limit ($0.50/$1.00 USD) - 2016/05/18 21:47:24 CET [2016/05/18 15:47:24 ET]
Table 'Samitchell II' 9-max Seat #6 is the button
Seat 1: riggedsh** ($133.27 in chips) 
Seat 3: vanilica ($166.25 in chips) 
Seat 4: Zeeshka ($108.27 in chips) 
Seat 5: nuuaber ($73.87 in chips) 
Seat 6: Strikerman25 ($31.62 in chips) 
Seat 7: matiko09 ($110.65 in chips) 
Seat 8: rate8 ($100 in chips) 
matiko09: posts small blind $0.50
rate8: posts big blind $1
Cortine: sits out 
*** HOLE CARDS ***
Dealt to matiko09 [2c Ts]
riggedsh**: folds 
vanilica: folds 
Zeeshka: folds 
nuuaber: folds 
Strikerman25: raises $1.09 to $2.09
matiko09: folds 
rate8: folds 
Uncalled bet ($1.09) returned to Strikerman25
Strikerman25 collected $2.50 from pot
Strikerman25: doesn't show hand 
*** SUMMARY ***
Total pot $2.50 | Rake $0 
Seat 1: riggedsh** folded before Flop (didn't bet)
Seat 3: vanilica folded before Flop (didn't bet)
Seat 4: Zeeshka folded before Flop (didn't bet)
Seat 5: nuuaber folded before Flop (didn't bet)
Seat 6: Strikerman25 (button) collected ($2.50)
Seat 7: matiko09 (small blind) folded before Flop
Seat 8: rate8 (big blind) folded before Flop





PokerStars Hand #153506327880:  Hold'em No Limit (€0.50/€1.00 EUR) - 2016/05/18 21:47:43 CET [2016/05/18 15:47:43 ET]
Table 'Pallas II' 9-max Seat #1 is the button
Seat 1: deadkiller1 (€160.73 in chips) 
Seat 2: matiko09 (€105.85 in chips) 
Seat 3: Ouga Buga (€100 in chips) 
Seat 4: torkkdnm (€169.75 in chips) 
Seat 7: rate8 (€111.72 in chips) 
Seat 8: Kihog (€188.04 in chips) 
Seat 9: stijner1986 (€175.81 in chips) 
matiko09: posts small blind €0.50
Ouga Buga: posts big blind €1
*** HOLE CARDS ***
Dealt to matiko09 [As 6s]
torkkdnm: folds 
rate8: folds 
Kihog: folds 
stijner1986: folds 
deadkiller1: folds 
matiko09: raises €1.50 to €2.50
Ouga Buga: calls €1.50
*** FLOP *** [3d 6h Kh]
matiko09: bets €2.47
Ouga Buga: calls €2.47
*** TURN *** [3d 6h Kh] [7s]
matiko09: checks 
Ouga Buga: bets €6.23
matiko09: calls €6.23
*** RIVER *** [3d 6h Kh 7s] [Tc]
matiko09: checks 
Ouga Buga: checks 
*** SHOW DOWN ***
matiko09: shows [As 6s] (a pair of Sixes)
Ouga Buga: mucks hand 
matiko09 collected €21.28 from pot
*** SUMMARY ***
Total pot €22.40 | Rake €1.12 
Board [3d 6h Kh 7s Tc]
Seat 1: deadkiller1 (button) folded before Flop (didn't bet)
Seat 2: matiko09 (small blind) showed [As 6s] and won (€21.28) with a pair of Sixes
Seat 3: Ouga Buga (big blind) mucked [Qh Js]
Seat 4: torkkdnm folded before Flop (didn't bet)
Seat 7: rate8 folded before Flop (didn't bet)
Seat 8: Kihog folded before Flop (didn't bet)
Seat 9: stijner1986 folded before Flop (didn't bet)





PokerStars Hand #153506334740:  Hold'em No Limit ($0.50/$1.00 USD) - 2016/05/18 21:47:50 CET [2016/05/18 15:47:50 ET]
Table 'Brendelia II' 9-max Seat #4 is the button
Seat 2: LebzLouda ($25.26 in chips) 
Seat 3: Zeeshka ($100 in chips) 
Seat 4: gkm0nk3y ($115.99 in chips) 
Seat 5: Vulturinus ($58.65 in chips) 
Seat 6: TimStone ($132.22 in chips) 
Seat 7: matiko09 ($104.12 in chips) 
Seat 8: solbi86 ($130.35 in chips) 
Vulturinus: posts small blind $0.50
TimStone: posts big blind $1
janarr5: sits out 
*** HOLE CARDS ***
Dealt to matiko09 [4h 5c]
matiko09: folds 
solbi86: folds 
LebzLouda: folds 
Zeeshka: raises $2 to $3
gkm0nk3y: folds 
Vulturinus: folds 
TimStone: folds 
Uncalled bet ($2) returned to Zeeshka
Zeeshka collected $2.50 from pot
Zeeshka: doesn't show hand 
*** SUMMARY ***
Total pot $2.50 | Rake $0 
Seat 2: LebzLouda folded before Flop (didn't bet)
Seat 3: Zeeshka collected ($2.50)
Seat 4: gkm0nk3y (button) folded before Flop (didn't bet)
Seat 5: Vulturinus (small blind) folded before Flop
Seat 6: TimStone (big blind) folded before Flop
Seat 7: matiko09 folded before Flop (didn't bet)
Seat 8: solbi86 folded before Flop (didn't bet)





PokerStars Hand #153506335832:  Hold'em No Limit ($0.50/$1.00 USD) - 2016/05/18 21:47:51 CET [2016/05/18 15:47:51 ET]
Table 'Tatjana III' 9-max Seat #3 is the button
Seat 1: cobrik23 ($83.73 in chips) 
Seat 2: vanilica ($110.62 in chips) 
Seat 3: matiko09 ($176.60 in chips) 
Seat 5: deadkiller1 ($100 in chips) 
Seat 6: Kihog ($103.97 in chips) 
Seat 7: rene1984tsv ($207.29 in chips) 
Seat 8: JACQUILF ($130.61 in chips) 
deadkiller1: posts small blind $0.50
Kihog: posts big blind $1
*** HOLE CARDS ***
Dealt to matiko09 [Jd 7d]
rene1984tsv: calls $1
JACQUILF: folds 
cobrik23: folds 
vanilica: raises $2.59 to $3.59
matiko09: folds 
deadkiller1: folds 
Kihog: folds 
rene1984tsv: calls $2.59
*** FLOP *** [Ts 9c Js]
rene1984tsv: checks 
vanilica: bets $4.95
rene1984tsv: calls $4.95
*** TURN *** [Ts 9c Js] [Jc]
rene1984tsv: checks 
vanilica: checks 
*** RIVER *** [Ts 9c Js Jc] [4c]
rene1984tsv: checks 
vanilica: checks 
*** SHOW DOWN ***
rene1984tsv: shows [Td Qs] (two pair, Jacks and Tens)
vanilica: mucks hand 
rene1984tsv collected $17.65 from pot
*** SUMMARY ***
Total pot $18.58 | Rake $0.93 
Board [Ts 9c Js Jc 4c]
Seat 1: cobrik23 folded before Flop (didn't bet)
Seat 2: vanilica mucked [5s 6s]
Seat 3: matiko09 (button) folded before Flop (didn't bet)
Seat 5: deadkiller1 (small blind) folded before Flop
Seat 6: Kihog (big blind) folded before Flop
Seat 7: rene1984tsv showed [Td Qs] and won ($17.65) with two pair, Jacks and Tens
Seat 8: JACQUILF folded before Flop (didn't bet)





PokerStars Hand #153506352777:  Hold'em No Limit ($0.50/$1.00 USD) - 2016/05/18 21:48:10 CET [2016/05/18 15:48:10 ET]
Table 'Samitchell II' 9-max Seat #7 is the button
Seat 1: riggedsh** ($133.27 in chips) 
Seat 3: vanilica ($166.25 in chips) 
Seat 4: Zeeshka ($108.27 in chips) 
Seat 5: nuuaber ($73.87 in chips) 
Seat 6: Strikerman25 ($33.12 in chips) 
Seat 7: matiko09 ($110.15 in chips) 
Seat 8: rate8 ($100 in chips) 
rate8: posts small blind $0.50
riggedsh**: posts big blind $1
Cortine: sits out 
*** HOLE CARDS ***
Dealt to matiko09 [2c 7c]
vanilica: raises $1.85 to $2.85
Zeeshka: folds 
nuuaber: folds 
Strikerman25: folds 
matiko09: folds 
rate8: folds 
riggedsh**: folds 
Uncalled bet ($1.85) returned to vanilica
vanilica collected $2.50 from pot
vanilica: doesn't show hand 
*** SUMMARY ***
Total pot $2.50 | Rake $0 
Seat 1: riggedsh** (big blind) folded before Flop
Seat 3: vanilica collected ($2.50)
Seat 4: Zeeshka folded before Flop (didn't bet)
Seat 5: nuuaber folded before Flop (didn't bet)
Seat 6: Strikerman25 folded before Flop (didn't bet)
Seat 7: matiko09 (button) folded before Flop (didn't bet)
Seat 8: rate8 (small blind) folded before Flop





PokerStars Hand #153506368657:  Hold'em No Limit ($0.50/$1.00 USD) - 2016/05/18 21:48:26 CET [2016/05/18 15:48:26 ET]
Table 'Brendelia II' 9-max Seat #5 is the button
Seat 2: LebzLouda ($25.26 in chips) 
Seat 3: Zeeshka ($101.50 in chips) 
Seat 4: gkm0nk3y ($115.99 in chips) 
Seat 5: Vulturinus ($58.15 in chips) 
Seat 6: TimStone ($131.22 in chips) 
Seat 7: matiko09 ($104.12 in chips) 
Seat 8: solbi86 ($130.35 in chips) 
TimStone: posts small blind $0.50
matiko09: posts big blind $1
janarr5: sits out 
*** HOLE CARDS ***
Dealt to matiko09 [5s 7d]
solbi86: folds 
LebzLouda: raises $2 to $3
Zeeshka: folds 
gkm0nk3y: calls $3
Vulturinus: folds 
TimStone: raises $9.50 to $12.50
matiko09: folds 
LebzLouda: raises $12.76 to $25.26 and is all-in
gkm0nk3y: folds 
TimStone: calls $12.76
*** FLOP *** [6s Td 9d]
*** TURN *** [6s Td 9d] [3h]
*** RIVER *** [6s Td 9d 3h] [2c]
*** SHOW DOWN ***
TimStone: shows [Kh Ad] (high card Ace)
LebzLouda: shows [Jd 8d] (high card Jack)
TimStone collected $52.02 from pot
*** SUMMARY ***
Total pot $54.52 | Rake $2.50 
Board [6s Td 9d 3h 2c]
Seat 2: LebzLouda showed [Jd 8d] and lost with high card Jack
Seat 3: Zeeshka folded before Flop (didn't bet)
Seat 4: gkm0nk3y folded before Flop
Seat 5: Vulturinus (button) folded before Flop (didn't bet)
Seat 6: TimStone (small blind) showed [Kh Ad] and won ($52.02) with high card Ace
Seat 7: matiko09 (big blind) folded before Flop
Seat 8: solbi86 folded before Flop (didn't bet)





PokerStars Hand #153506370689:  Hold'em No Limit ($0.50/$1.00 USD) - 2016/05/18 21:48:28 CET [2016/05/18 15:48:28 ET]
Table 'Tatjana III' 9-max Seat #5 is the button
Seat 1: cobrik23 ($83.73 in chips) 
Seat 2: vanilica ($102.08 in chips) 
Seat 3: matiko09 ($176.60 in chips) 
Seat 5: deadkiller1 ($100 in chips) 
Seat 6: Kihog ($102.97 in chips) 
Seat 7: rene1984tsv ($216.40 in chips) 
Seat 8: JACQUILF ($130.61 in chips) 
Kihog: posts small blind $0.50
rene1984tsv: posts big blind $1
*** HOLE CARDS ***
Dealt to matiko09 [2s Jh]
Strikerman25 joins the table at seat #4 
JACQUILF: folds 
JACQUILF leaves the table
b_____a__242 joins the table at seat #8 
cobrik23: folds 
vanilica: raises $1.50 to $2.50
matiko09: folds 
deadkiller1: calls $2.50
Kihog: folds 
rene1984tsv: raises $13.50 to $16
vanilica: folds 
deadkiller1: folds 
Uncalled bet ($13.50) returned to rene1984tsv
rene1984tsv collected $8 from pot
rene1984tsv: doesn't show hand 
*** SUMMARY ***
Total pot $8 | Rake $0 
Seat 1: cobrik23 folded before Flop (didn't bet)
Seat 2: vanilica folded before Flop
Seat 3: matiko09 folded before Flop (didn't bet)
Seat 5: deadkiller1 (button) folded before Flop
Seat 6: Kihog (small blind) folded before Flop
Seat 7: rene1984tsv (big blind) collected ($8)
Seat 8: JACQUILF folded before Flop (didn't bet)





PokerStars Hand #153506377579:  Hold'em No Limit ($0.50/$1.00 USD) - 2016/05/18 21:48:36 CET [2016/05/18 15:48:36 ET]
Table 'Samitchell II' 9-max Seat #8 is the button
Seat 1: riggedsh** ($132.27 in chips) 
Seat 2: Cortine ($100 in chips) 
Seat 3: vanilica ($167.75 in chips) 
Seat 4: Zeeshka ($108.27 in chips) 
Seat 5: nuuaber ($73.87 in chips) 
Seat 6: Strikerman25 ($33.12 in chips) 
Seat 7: matiko09 ($110.15 in chips) 
Seat 8: rate8 ($100 in chips) 
riggedsh**: posts small blind $0.50
Cortine: posts big blind $1
*** HOLE CARDS ***
Dealt to matiko09 [Tc 7h]
vanilica: folds 
Zeeshka: folds 
nuuaber: raises $1 to $2
Strikerman25: folds 
matiko09: folds 
rate8: folds 
riggedsh**: folds 
Cortine: folds 
Uncalled bet ($1) returned to nuuaber
nuuaber collected $2.50 from pot
nuuaber: doesn't show hand 
*** SUMMARY ***
Total pot $2.50 | Rake $0 
Seat 1: riggedsh** (small blind) folded before Flop
Seat 2: Cortine (big blind) folded before Flop
Seat 3: vanilica folded before Flop (didn't bet)
Seat 4: Zeeshka folded before Flop (didn't bet)
Seat 5: nuuaber collected ($2.50)
Seat 6: Strikerman25 folded before Flop (didn't bet)
Seat 7: matiko09 folded before Flop (didn't bet)
Seat 8: rate8 (button) folded before Flop (didn't bet)





PokerStars Hand #153506382856:  Hold'em No Limit ($0.50/$1.00 USD) - 2016/05/18 21:48:42 CET [2016/05/18 15:48:42 ET]
Table 'Abetti II' 9-max Seat #7 is the button
Seat 1: matiko09 ($106.42 in chips) 
Seat 2: torkkdnm ($100 in chips) 
Seat 3: cobrik23 ($127.03 in chips) 
Seat 4: ipashutapkom ($107 in chips) 
Seat 6: Kihog ($124.25 in chips) 
Seat 7: rate8 ($101.28 in chips) 
Seat 8: roadster683 ($157.79 in chips) 
Seat 9: vanilica ($123.11 in chips) 
roadster683: posts small blind $0.50
vanilica: posts big blind $1
*** HOLE CARDS ***
Dealt to matiko09 [Jc 6s]
matiko09: folds 
torkkdnm: folds 
cobrik23: raises $2 to $3
ipashutapkom: folds 
Kihog: calls $3
rate8: raises $9.50 to $12.50
roadster683: calls $12
vanilica: folds 
cobrik23: folds 
Kihog: calls $9.50
*** FLOP *** [Jd 5c 7d]
roadster683: checks 
Kihog: checks 
rate8: checks 
*** TURN *** [Jd 5c 7d] [As]
roadster683: bets $1
Kihog: raises $19 to $20
rate8: calls $20
roadster683: folds 
*** RIVER *** [Jd 5c 7d As] [Kc]
Kihog: checks 
rate8: checks 
*** SHOW DOWN ***
Kihog: shows [9d Kd] (a pair of Kings)
rate8: shows [Ac Td] (a pair of Aces)
rate8 collected $80 from pot
*** SUMMARY ***
Total pot $82.50 | Rake $2.50 
Board [Jd 5c 7d As Kc]
Seat 1: matiko09 folded before Flop (didn't bet)
Seat 2: torkkdnm folded before Flop (didn't bet)
Seat 3: cobrik23 folded before Flop
Seat 4: ipashutapkom folded before Flop (didn't bet)
Seat 6: Kihog showed [9d Kd] and lost with a pair of Kings
Seat 7: rate8 (button) showed [Ac Td] and won ($80) with a pair of Aces
Seat 8: roadster683 (small blind) folded on the Turn
Seat 9: vanilica (big blind) folded before Flop





PokerStars Hand #153506384733:  Hold'em No Limit ($0.50/$1.00 USD) - 2016/05/18 21:48:44 CET [2016/05/18 15:48:44 ET]
Table 'Lorcia II' 9-max Seat #6 is the button
Seat 1: TimStone ($106.22 in chips) 
Seat 3: matiko09 ($103.20 in chips) 
Seat 4: vanilica ($161.82 in chips) 
Seat 5: nuuaber ($169.17 in chips) 
Seat 6: gkm0nk3y ($100 in chips) 
Seat 7: rate8 ($112.28 in chips) 
rate8: posts small blind $0.50
porgol was removed from the table for failing to post
TimStone: posts big blind $1
*** HOLE CARDS ***
Dealt to matiko09 [7d 6s]
cobrik23 joins the table at seat #9 
matiko09: folds 
vanilica: folds 
nuuaber: folds 
gkm0nk3y: folds 
rate8: raises $1.50 to $2.50
TimStone: raises $6.60 to $9.10
rate8: folds 
Uncalled bet ($6.60) returned to TimStone
TimStone collected $5 from pot
TimStone: doesn't show hand 
*** SUMMARY ***
Total pot $5 | Rake $0 
Seat 1: TimStone (big blind) collected ($5)
Seat 3: matiko09 folded before Flop (didn't bet)
Seat 4: vanilica folded before Flop (didn't bet)
Seat 5: nuuaber folded before Flop (didn't bet)
Seat 6: gkm0nk3y (button) folded before Flop (didn't bet)
Seat 7: rate8 (small blind) folded before Flop





PokerStars Hand #153506400278:  Hold'em No Limit ($0.50/$1.00 USD) - 2016/05/18 21:49:00 CET [2016/05/18 15:49:00 ET]
Table 'Samitchell II' 9-max Seat #1 is the button
Seat 1: riggedsh** ($131.77 in chips) 
Seat 2: Cortine ($100 in chips) 
Seat 3: vanilica ($167.75 in chips) 
Seat 4: Zeeshka ($108.27 in chips) 
Seat 5: nuuaber ($75.37 in chips) 
Seat 6: Strikerman25 ($33.12 in chips) 
Seat 7: matiko09 ($110.15 in chips) 
Seat 8: rate8 ($100 in chips) 
Cortine: posts small blind $0.50
vanilica: posts big blind $1
*** HOLE CARDS ***
Dealt to matiko09 [6d Qh]
Zeeshka: folds 
nuuaber: raises $3.50 to $4.50
Strikerman25: folds 
matiko09: folds 
rate8: folds 
riggedsh**: folds 
Cortine: raises $9 to $13.50
vanilica: folds 
nuuaber: calls $9
*** FLOP *** [Qc Ac 7s]
Cortine: bets $17.55
nuuaber: folds [9c 9h]
Uncalled bet ($17.55) returned to Cortine
Cortine collected $26.60 from pot
Cortine: doesn't show hand 
*** SUMMARY ***
Total pot $28 | Rake $1.40 
Board [Qc Ac 7s]
Seat 1: riggedsh** (button) folded before Flop (didn't bet)
Seat 2: Cortine (small blind) collected ($26.60)
Seat 3: vanilica (big blind) folded before Flop
Seat 4: Zeeshka folded before Flop (didn't bet)
Seat 5: nuuaber folded on the Flop
Seat 6: Strikerman25 folded before Flop (didn't bet)
Seat 7: matiko09 folded before Flop (didn't bet)
Seat 8: rate8 folded before Flop (didn't bet)





PokerStars Hand #153506400412:  Hold'em No Limit (€0.50/€1.00 EUR) - 2016/05/18 21:49:01 CET [2016/05/18 15:49:01 ET]
Table 'Pallas II' 9-max Seat #2 is the button
Seat 1: deadkiller1 (€160.73 in chips) 
Seat 2: matiko09 (€115.93 in chips) 
Seat 3: Ouga Buga (€100 in chips) 
Seat 4: torkkdnm (€169.75 in chips) 
Seat 7: rate8 (€111.72 in chips) 
Seat 8: Kihog (€188.04 in chips) 
Seat 9: stijner1986 (€175.81 in chips) 
Ouga Buga: posts small blind €0.50
torkkdnm: posts big blind €1
florrin92: sits out 
*** HOLE CARDS ***
Dealt to matiko09 [Th Jh]
rate8: folds 
Kihog: folds 
stijner1986: folds 
deadkiller1: folds 
matiko09: raises €1.27 to €2.27
Ouga Buga: folds 
torkkdnm: calls €1.27
*** FLOP *** [As 8h Jd]
torkkdnm: checks 
matiko09: checks 
*** TURN *** [As 8h Jd] [Kh]
torkkdnm: checks 
matiko09: checks 
*** RIVER *** [As 8h Jd Kh] [Ks]
torkkdnm: checks 
matiko09: checks 
*** SHOW DOWN ***
torkkdnm: shows [7s 8c] (two pair, Kings and Eights)
matiko09: shows [Th Jh] (two pair, Kings and Jacks)
matiko09 collected €4.79 from pot
*** SUMMARY ***
Total pot €5.04 | Rake €0.25 
Board [As 8h Jd Kh Ks]
Seat 1: deadkiller1 folded before Flop (didn't bet)
Seat 2: matiko09 (button) showed [Th Jh] and won (€4.79) with two pair, Kings and Jacks
Seat 3: Ouga Buga (small blind) folded before Flop
Seat 4: torkkdnm (big blind) showed [7s 8c] and lost with two pair, Kings and Eights
Seat 7: rate8 folded before Flop (didn't bet)
Seat 8: Kihog folded before Flop (didn't bet)
Seat 9: stijner1986 folded before Flop (didn't bet)





PokerStars Hand #153506412279:  Hold'em No Limit ($0.50/$1.00 USD) - 2016/05/18 21:49:14 CET [2016/05/18 15:49:14 ET]
Table 'Lorcia II' 9-max Seat #7 is the button
Seat 3: matiko09 ($103.20 in chips) 
Seat 4: vanilica ($161.82 in chips) 
Seat 5: nuuaber ($169.17 in chips) 
Seat 6: gkm0nk3y ($100 in chips) 
Seat 7: rate8 ($109.78 in chips) 
cobrik23 will be allowed to play after the button
matiko09: posts small blind $0.50
vanilica: posts big blind $1
*** HOLE CARDS ***
Dealt to matiko09 [As Tc]
TimStone leaves the table
nuuaber: folds 
gkm0nk3y: folds 
rate8: raises $1 to $2
matiko09: folds 
vanilica: folds 
Uncalled bet ($1) returned to rate8
rate8 collected $2.50 from pot
rate8: doesn't show hand 
*** SUMMARY ***
Total pot $2.50 | Rake $0 
Seat 3: matiko09 (small blind) folded before Flop
Seat 4: vanilica (big blind) folded before Flop
Seat 5: nuuaber folded before Flop (didn't bet)
Seat 6: gkm0nk3y folded before Flop (didn't bet)
Seat 7: rate8 (button) collected ($2.50)





PokerStars Hand #153506415553:  Hold'em No Limit ($0.50/$1.00 USD) - 2016/05/18 21:49:17 CET [2016/05/18 15:49:17 ET]
Table 'Saiph II' 9-max Seat #3 is the button
Seat 2: Skum1986 ($103.20 in chips) 
Seat 3: jezzaber ($52.12 in chips) 
Seat 4: deadkiller1 ($100 in chips) 
Seat 5: matiko09 ($101.50 in chips) 
Seat 6: JACQUILF ($109.05 in chips) 
Seat 7: solbi86 ($101.50 in chips) 
Seat 8: Mashulia7777 ($71.03 in chips) 
Seat 9: Zeeshka ($142.14 in chips) 
deadkiller1: posts small blind $0.50
matiko09: posts big blind $1
*** HOLE CARDS ***
Dealt to matiko09 [Th Ts]
JACQUILF: folds 
solbi86: raises $2 to $3
JACQUILF leaves the table
Mashulia7777: folds 
Zeeshka: folds 
Skum1986: calls $3
jezzaber: folds 
cap. marb joins the table at seat #6 
deadkiller1: folds 
matiko09: calls $2
*** FLOP *** [6s Ah Js]
matiko09: checks 
solbi86: checks 
Skum1986: checks 
*** TURN *** [6s Ah Js] [7h]
matiko09: checks 
solbi86: bets $7
Skum1986: calls $7
matiko09: folds 
*** RIVER *** [6s Ah Js 7h] [5d]
solbi86: bets $14
Skum1986: calls $14
*** SHOW DOWN ***
solbi86: shows [9h 9c] (a pair of Nines)
Skum1986: shows [Ks As] (a pair of Aces)
Skum1986 collected $49 from pot
*** SUMMARY ***
Total pot $51.50 | Rake $2.50 
Board [6s Ah Js 7h 5d]
Seat 2: Skum1986 showed [Ks As] and won ($49) with a pair of Aces
Seat 3: jezzaber (button) folded before Flop (didn't bet)
Seat 4: deadkiller1 (small blind) folded before Flop
Seat 5: matiko09 (big blind) folded on the Turn
Seat 6: JACQUILF folded before Flop (didn't bet)
Seat 7: solbi86 showed [9h 9c] and lost with a pair of Nines
Seat 8: Mashulia7777 folded before Flop (didn't bet)
Seat 9: Zeeshka folded before Flop (didn't bet)





PokerStars Hand #153506415400:  Hold'em No Limit ($0.50/$1.00 USD) - 2016/05/18 21:49:17 CET [2016/05/18 15:49:17 ET]
Table 'Tatjana III' 9-max Seat #6 is the button
Seat 1: cobrik23 ($83.73 in chips) 
Seat 2: vanilica ($100 in chips) 
Seat 3: matiko09 ($176.60 in chips) 
Seat 5: deadkiller1 ($100 in chips) 
Seat 6: Kihog ($102.47 in chips) 
Seat 7: rene1984tsv ($221.90 in chips) 
Seat 8: b_____a__242 ($40 in chips) 
rene1984tsv: posts small blind $0.50
b_____a__242: posts big blind $1
Strikerman25: sits out 
*** HOLE CARDS ***
Dealt to matiko09 [Js 9d]
cobrik23: raises $3 to $4
vanilica: folds 
matiko09: folds 
deadkiller1: folds 
Kihog: folds 
rene1984tsv: calls $3.50
b_____a__242: folds 
*** FLOP *** [6s 6h Jh]
rene1984tsv: checks 
cobrik23: checks 
*** TURN *** [6s 6h Jh] [4c]
rene1984tsv: checks 
cobrik23: checks 
*** RIVER *** [6s 6h Jh 4c] [3h]
rene1984tsv: bets $8.55
cobrik23: folds 
Uncalled bet ($8.55) returned to rene1984tsv
rene1984tsv collected $8.55 from pot
rene1984tsv: doesn't show hand 
*** SUMMARY ***
Total pot $9 | Rake $0.45 
Board [6s 6h Jh 4c 3h]
Seat 1: cobrik23 folded on the River
Seat 2: vanilica folded before Flop (didn't bet)
Seat 3: matiko09 folded before Flop (didn't bet)
Seat 5: deadkiller1 folded before Flop (didn't bet)
Seat 6: Kihog (button) folded before Flop (didn't bet)
Seat 7: rene1984tsv (small blind) collected ($8.55)
Seat 8: b_____a__242 (big blind) folded before Flop





PokerStars Hand #153506424354:  Hold'em No Limit ($0.50/$1.00 USD) - 2016/05/18 21:49:27 CET [2016/05/18 15:49:27 ET]
Table 'Brendelia II' 9-max Seat #6 is the button
Seat 1: janarr5 ($100 in chips) 
Seat 3: Zeeshka ($101.50 in chips) 
Seat 4: gkm0nk3y ($112.99 in chips) 
Seat 5: Vulturinus ($58.15 in chips) 
Seat 6: TimStone ($157.98 in chips) 
Seat 7: matiko09 ($103.12 in chips) 
matiko09: posts small blind $0.50
janarr5: posts big blind $1
*** HOLE CARDS ***
Dealt to matiko09 [3h 5s]
Zeeshka: folds 
gkm0nk3y: folds 
LebzLouda leaves the table
Vulturinus: raises $2 to $3
TimStone: folds 
matiko09: folds 
janarr5: folds 
Uncalled bet ($2) returned to Vulturinus
janarr5 leaves the table
Vulturinus collected $2.50 from pot
*** SUMMARY ***
Total pot $2.50 | Rake $0 
Seat 1: janarr5 (big blind) folded before Flop
Seat 3: Zeeshka folded before Flop (didn't bet)
Seat 4: gkm0nk3y folded before Flop (didn't bet)
Seat 5: Vulturinus collected ($2.50)
Seat 6: TimStone (button) folded before Flop (didn't bet)
Seat 7: matiko09 (small blind) folded before Flop





PokerStars Hand #153506428417:  Hold'em No Limit ($0.50/$1.00 USD) - 2016/05/18 21:49:31 CET [2016/05/18 15:49:31 ET]
Table 'Lorcia II' 9-max Seat #3 is the button
Seat 3: matiko09 ($102.70 in chips) 
Seat 4: vanilica ($160.82 in chips) 
Seat 5: nuuaber ($169.17 in chips) 
Seat 6: gkm0nk3y ($100 in chips) 
Seat 7: rate8 ($111.28 in chips) 
vanilica: posts small blind $0.50
nuuaber: posts big blind $1
cobrik23: sits out 
*** HOLE CARDS ***
Dealt to matiko09 [7h 4s]
gkm0nk3y: folds 
rate8: raises $2 to $3
matiko09: folds 
vanilica: folds 
nuuaber: folds 
Uncalled bet ($2) returned to rate8
rate8 collected $2.50 from pot
rate8: doesn't show hand 
*** SUMMARY ***
Total pot $2.50 | Rake $0 
Seat 3: matiko09 (button) folded before Flop (didn't bet)
Seat 4: vanilica (small blind) folded before Flop
Seat 5: nuuaber (big blind) folded before Flop
Seat 6: gkm0nk3y folded before Flop (didn't bet)
Seat 7: rate8 collected ($2.50)





PokerStars Hand #153506446884:  Hold'em No Limit ($0.50/$1.00 USD) - 2016/05/18 21:49:51 CET [2016/05/18 15:49:51 ET]
Table 'Lorcia II' 9-max Seat #4 is the button
Seat 3: matiko09 ($102.70 in chips) 
Seat 4: vanilica ($160.32 in chips) 
Seat 5: nuuaber ($168.17 in chips) 
Seat 6: gkm0nk3y ($100 in chips) 
Seat 7: rate8 ($112.78 in chips) 
nuuaber: posts small blind $0.50
gkm0nk3y: posts big blind $1
cobrik23: sits out 
*** HOLE CARDS ***
Dealt to matiko09 [2s 4s]
rate8: folds 
matiko09: folds 
vanilica: folds 
nuuaber: calls $0.50
gkm0nk3y: checks 
*** FLOP *** [5d Ah Td]
nuuaber: bets $1
gkm0nk3y: folds 
Uncalled bet ($1) returned to nuuaber
nuuaber collected $1.90 from pot
nuuaber: doesn't show hand 
*** SUMMARY ***
Total pot $2 | Rake $0.10 
Board [5d Ah Td]
Seat 3: matiko09 folded before Flop (didn't bet)
Seat 4: vanilica (button) folded before Flop (didn't bet)
Seat 5: nuuaber (small blind) collected ($1.90)
Seat 6: gkm0nk3y (big blind) folded on the Flop
Seat 7: rate8 folded before Flop (didn't bet)





PokerStars Hand #153506452325:  Hold'em No Limit ($0.50/$1.00 USD) - 2016/05/18 21:49:57 CET [2016/05/18 15:49:57 ET]
Table 'Samitchell II' 9-max Seat #2 is the button
Seat 1: riggedsh** ($131.77 in chips) 
Seat 2: Cortine ($113.10 in chips) 
Seat 3: vanilica ($166.75 in chips) 
Seat 4: Zeeshka ($108.27 in chips) 
Seat 5: nuuaber ($61.87 in chips) 
Seat 6: Strikerman25 ($40 in chips) 
Seat 7: matiko09 ($110.15 in chips) 
Seat 8: rate8 ($100 in chips) 
vanilica: posts small blind $0.50
Zeeshka: posts big blind $1
*** HOLE CARDS ***
Dealt to matiko09 [5h 8s]
nuuaber: calls $1
Strikerman25: folds 
matiko09: folds 
rate8: raises $3 to $4
riggedsh**: folds 
Cortine: folds 
vanilica: folds 
Zeeshka: folds 
nuuaber: calls $3
*** FLOP *** [Ah 4h 8h]
nuuaber: checks 
rate8: checks 
*** TURN *** [Ah 4h 8h] [Qs]
nuuaber: bets $1
rate8: raises $6 to $7
nuuaber: folds 
Uncalled bet ($6) returned to rate8
rate8 collected $10.92 from pot
rate8: doesn't show hand 
*** SUMMARY ***
Total pot $11.50 | Rake $0.58 
Board [Ah 4h 8h Qs]
Seat 1: riggedsh** folded before Flop (didn't bet)
Seat 2: Cortine (button) folded before Flop (didn't bet)
Seat 3: vanilica (small blind) folded before Flop
Seat 4: Zeeshka (big blind) folded before Flop
Seat 5: nuuaber folded on the Turn
Seat 6: Strikerman25 folded before Flop (didn't bet)
Seat 7: matiko09 folded before Flop (didn't bet)
Seat 8: rate8 collected ($10.92)





PokerStars Hand #153506461988:  Hold'em No Limit (€0.50/€1.00 EUR) - 2016/05/18 21:50:07 CET [2016/05/18 15:50:07 ET]
Table 'Pallas II' 9-max Seat #3 is the button
Seat 1: deadkiller1 (€160.73 in chips) 
Seat 2: matiko09 (€118.45 in chips) 
Seat 3: Ouga Buga (€100 in chips) 
Seat 4: torkkdnm (€167.48 in chips) 
Seat 5: florrin92 (€100 in chips) 
Seat 7: rate8 (€111.72 in chips) 
Seat 8: Kihog (€188.04 in chips) 
Seat 9: stijner1986 (€175.81 in chips) 
torkkdnm: posts small blind €0.50
florrin92: posts big blind €1
*** HOLE CARDS ***
Dealt to matiko09 [Tc 5c]
rate8: folds 
Kihog: folds 
stijner1986: calls €1
deadkiller1: folds 
matiko09: folds 
Ouga Buga: raises €3 to €4
torkkdnm: folds 
florrin92: folds 
stijner1986: calls €3
*** FLOP *** [4h 7d As]
stijner1986: bets €4.51
Ouga Buga: folds 
Uncalled bet (€4.51) returned to stijner1986
stijner1986 collected €9.02 from pot
stijner1986: doesn't show hand 
*** SUMMARY ***
Total pot €9.50 | Rake €0.48 
Board [4h 7d As]
Seat 1: deadkiller1 folded before Flop (didn't bet)
Seat 2: matiko09 folded before Flop (didn't bet)
Seat 3: Ouga Buga (button) folded on the Flop
Seat 4: torkkdnm (small blind) folded before Flop
Seat 5: florrin92 (big blind) folded before Flop
Seat 7: rate8 folded before Flop (didn't bet)
Seat 8: Kihog folded before Flop (didn't bet)
Seat 9: stijner1986 collected (€9.02)





PokerStars Hand #153506463361:  Hold'em No Limit ($0.50/$1.00 USD) - 2016/05/18 21:50:09 CET [2016/05/18 15:50:09 ET]
Table 'Brendelia II' 9-max Seat #7 is the button
Seat 3: Zeeshka ($101.50 in chips) 
Seat 4: gkm0nk3y ($112.99 in chips) 
Seat 5: Vulturinus ($59.65 in chips) 
Seat 6: TimStone ($157.98 in chips) 
Seat 7: matiko09 ($102.62 in chips) 
Zeeshka: posts small blind $0.50
gkm0nk3y: posts big blind $1
*** HOLE CARDS ***
Dealt to matiko09 [7h 5d]
Vulturinus: calls $1
TimStone: folds 
cap. marb joins the table at seat #1 
matiko09: folds 
Zeeshka: folds 
gkm0nk3y: checks 
*** FLOP *** [6s 5s 2h]
gkm0nk3y: checks 
Vulturinus: checks 
*** TURN *** [6s 5s 2h] [8s]
gkm0nk3y: bets $1
Vulturinus: calls $1
*** RIVER *** [6s 5s 2h 8s] [Kh]
gkm0nk3y: checks 
Vulturinus: checks 
*** SHOW DOWN ***
gkm0nk3y: shows [3h 5h] (a pair of Fives)
Vulturinus: shows [Ad 8d] (a pair of Eights)
Vulturinus collected $4.28 from pot
*** SUMMARY ***
Total pot $4.50 | Rake $0.22 
Board [6s 5s 2h 8s Kh]
Seat 3: Zeeshka (small blind) folded before Flop
Seat 4: gkm0nk3y (big blind) showed [3h 5h] and lost with a pair of Fives
Seat 5: Vulturinus showed [Ad 8d] and won ($4.28) with a pair of Eights
Seat 6: TimStone folded before Flop (didn't bet)
Seat 7: matiko09 (button) folded before Flop (didn't bet)





PokerStars Hand #153506480820:  Hold'em No Limit ($0.50/$1.00 USD) - 2016/05/18 21:50:28 CET [2016/05/18 15:50:28 ET]
Table 'Abetti II' 9-max Seat #8 is the button
Seat 1: matiko09 ($106.42 in chips) 
Seat 2: torkkdnm ($100 in chips) 
Seat 3: cobrik23 ($124.03 in chips) 
Seat 4: ipashutapkom ($107 in chips) 
Seat 6: Kihog ($100 in chips) 
Seat 7: rate8 ($148.78 in chips) 
Seat 8: roadster683 ($144.29 in chips) 
Seat 9: vanilica ($122.11 in chips) 
vanilica: posts small blind $0.50
matiko09: posts big blind $1
*** HOLE CARDS ***
Dealt to matiko09 [9c 7c]
torkkdnm: folds 
cobrik23: folds 
ipashutapkom: folds 
Kihog: folds 
rate8: folds 
roadster683: raises $1 to $2
vanilica: folds 
matiko09: calls $1
*** FLOP *** [4s 9d 6s]
matiko09: checks 
roadster683: bets $2
matiko09: calls $2
*** TURN *** [4s 9d 6s] [4d]
matiko09: checks 
roadster683: checks 
*** RIVER *** [4s 9d 6s 4d] [3c]
matiko09: bets $2.50
roadster683: folds 
Uncalled bet ($2.50) returned to matiko09
matiko09 collected $8.08 from pot
matiko09: doesn't show hand 
*** SUMMARY ***
Total pot $8.50 | Rake $0.42 
Board [4s 9d 6s 4d 3c]
Seat 1: matiko09 (big blind) collected ($8.08)
Seat 2: torkkdnm folded before Flop (didn't bet)
Seat 3: cobrik23 folded before Flop (didn't bet)
Seat 4: ipashutapkom folded before Flop (didn't bet)
Seat 6: Kihog folded before Flop (didn't bet)
Seat 7: rate8 folded before Flop (didn't bet)
Seat 8: roadster683 (button) folded on the River
Seat 9: vanilica (small blind) folded before Flop





PokerStars Hand #153506482896:  Hold'em No Limit ($0.50/$1.00 USD) - 2016/05/18 21:50:30 CET [2016/05/18 15:50:30 ET]
Table 'Tatjana III' 9-max Seat #7 is the button
Seat 1: cobrik23 ($79.73 in chips) 
Seat 2: vanilica ($100 in chips) 
Seat 3: matiko09 ($176.60 in chips) 
Seat 5: deadkiller1 ($100 in chips) 
Seat 6: Kihog ($102.47 in chips) 
Seat 7: rene1984tsv ($226.45 in chips) 
Seat 8: b_____a__242 ($39 in chips) 
b_____a__242: posts small blind $0.50
cobrik23: posts big blind $1
Strikerman25: sits out 
*** HOLE CARDS ***
Dealt to matiko09 [Ah Qd]
vanilica: folds 
matiko09: raises $2 to $3
deadkiller1: folds 
Kihog: folds 
rene1984tsv: folds 
b_____a__242: folds 
cobrik23: folds 
Uncalled bet ($2) returned to matiko09
matiko09 collected $2.50 from pot
matiko09: doesn't show hand 
*** SUMMARY ***
Total pot $2.50 | Rake $0 
Seat 1: cobrik23 (big blind) folded before Flop
Seat 2: vanilica folded before Flop (didn't bet)
Seat 3: matiko09 collected ($2.50)
Seat 5: deadkiller1 folded before Flop (didn't bet)
Seat 6: Kihog folded before Flop (didn't bet)
Seat 7: rene1984tsv (button) folded before Flop (didn't bet)
Seat 8: b_____a__242 (small blind) folded before Flop





PokerStars Hand #153506482956:  Hold'em No Limit ($0.50/$1.00 USD) - 2016/05/18 21:50:30 CET [2016/05/18 15:50:30 ET]
Table 'Saiph II' 9-max Seat #4 is the button
Seat 2: Skum1986 ($128.20 in chips) 
Seat 3: jezzaber ($52.12 in chips) 
Seat 4: deadkiller1 ($100 in chips) 
Seat 5: matiko09 ($100 in chips) 
Seat 6: cap. marb ($40 in chips) 
Seat 7: solbi86 ($100 in chips) 
Seat 8: Mashulia7777 ($71.03 in chips) 
Seat 9: Zeeshka ($142.14 in chips) 
matiko09: posts small blind $0.50
cap. marb: posts big blind $1
*** HOLE CARDS ***
Dealt to matiko09 [3s 9c]
solbi86: folds 
Mashulia7777: raises $1.50 to $2.50
Zeeshka: folds 
Skum1986: folds 
jezzaber: folds 
stepan0605 joins the table at seat #1 
deadkiller1: folds 
matiko09: folds 
cap. marb: folds 
Uncalled bet ($1.50) returned to Mashulia7777
Mashulia7777 collected $2.50 from pot
Mashulia7777: doesn't show hand 
*** SUMMARY ***
Total pot $2.50 | Rake $0 
Seat 2: Skum1986 folded before Flop (didn't bet)
Seat 3: jezzaber folded before Flop (didn't bet)
Seat 4: deadkiller1 (button) folded before Flop (didn't bet)
Seat 5: matiko09 (small blind) folded before Flop
Seat 6: cap. marb (big blind) folded before Flop
Seat 7: solbi86 folded before Flop (didn't bet)
Seat 8: Mashulia7777 collected ($2.50)
Seat 9: Zeeshka folded before Flop (didn't bet)





PokerStars Hand #153506485630:  Hold'em No Limit ($0.50/$1.00 USD) - 2016/05/18 21:50:33 CET [2016/05/18 15:50:33 ET]
Table 'Lorcia II' 9-max Seat #5 is the button
Seat 3: matiko09 ($102.70 in chips) 
Seat 4: vanilica ($160.32 in chips) 
Seat 5: nuuaber ($169.07 in chips) 
Seat 6: gkm0nk3y ($100 in chips) 
Seat 7: rate8 ($112.78 in chips) 
gkm0nk3y: posts small blind $0.50
rate8: posts big blind $1
cobrik23: sits out 
*** HOLE CARDS ***
Dealt to matiko09 [Kd 7h]
matiko09: folds 
vanilica: folds 
nuuaber: calls $1
gkm0nk3y: folds 
rate8: checks 
*** FLOP *** [3c Th 5h]
rate8: checks 
nuuaber: bets $2
rate8: raises $5 to $7
nuuaber: folds 
Uncalled bet ($5) returned to rate8
rate8 collected $6.18 from pot
rate8: doesn't show hand 
*** SUMMARY ***
Total pot $6.50 | Rake $0.32 
Board [3c Th 5h]
Seat 3: matiko09 folded before Flop (didn't bet)
Seat 4: vanilica folded before Flop (didn't bet)
Seat 5: nuuaber (button) folded on the Flop
Seat 6: gkm0nk3y (small blind) folded before Flop
Seat 7: rate8 (big blind) collected ($6.18)





PokerStars Hand #153506508207:  Hold'em No Limit ($0.50/$1.00 USD) - 2016/05/18 21:50:57 CET [2016/05/18 15:50:57 ET]
Table 'Saiph II' 9-max Seat #5 is the button
Seat 1: stepan0605 ($100 in chips) 
Seat 2: Skum1986 ($128.20 in chips) 
Seat 3: jezzaber ($52.12 in chips) 
Seat 4: deadkiller1 ($100 in chips) 
Seat 5: matiko09 ($100 in chips) 
Seat 6: cap. marb ($39 in chips) 
cap. marb: posts small blind $0.50
Mashulia7777: is sitting out 
Zeeshka: is sitting out 
Zeeshka leaves the table
stepan0605: posts big blind $1
*** HOLE CARDS ***
Dealt to matiko09 [Td 3s]
Mashulia7777 leaves the table
Skum1986: raises $2 to $3
jezzaber: folds 
deadkiller1: folds 
matiko09: folds 
cap. marb: raises $4 to $7
stepan0605: folds 
Skum1986: folds 
Uncalled bet ($4) returned to cap. marb
cap. marb collected $7 from pot
cap. marb: doesn't show hand 
*** SUMMARY ***
Total pot $7 | Rake $0 
Seat 1: stepan0605 (big blind) folded before Flop
Seat 2: Skum1986 folded before Flop
Seat 3: jezzaber folded before Flop (didn't bet)
Seat 4: deadkiller1 folded before Flop (didn't bet)
Seat 5: matiko09 (button) folded before Flop (didn't bet)
Seat 6: cap. marb (small blind) collected ($7)





PokerStars Hand #153506510056:  Hold'em No Limit ($0.50/$1.00 USD) - 2016/05/18 21:51:00 CET [2016/05/18 15:51:00 ET]
Table 'Brendelia II' 9-max Seat #3 is the button
Seat 3: Zeeshka ($101 in chips) 
Seat 4: gkm0nk3y ($110.99 in chips) 
Seat 5: Vulturinus ($61.93 in chips) 
Seat 6: TimStone ($157.98 in chips) 
Seat 7: matiko09 ($102.62 in chips) 
gkm0nk3y: posts small blind $0.50
Vulturinus: posts big blind $1
cap. marb: sits out 
*** HOLE CARDS ***
Dealt to matiko09 [7d 2d]
Kihog joins the table at seat #2 
TimStone: folds 
matiko09: folds 
Zeeshka: folds 
gkm0nk3y: folds 
Uncalled bet ($0.50) returned to Vulturinus
Vulturinus collected $1 from pot
*** SUMMARY ***
Total pot $1 | Rake $0 
Seat 3: Zeeshka (button) folded before Flop (didn't bet)
Seat 4: gkm0nk3y (small blind) folded before Flop
Seat 5: Vulturinus (big blind) collected ($1)
Seat 6: TimStone folded before Flop (didn't bet)
Seat 7: matiko09 folded before Flop (didn't bet)





PokerStars Hand #153506515406:  Hold'em No Limit ($0.50/$1.00 USD) - 2016/05/18 21:51:05 CET [2016/05/18 15:51:05 ET]
Table 'Tatjana III' 9-max Seat #8 is the button
Seat 1: cobrik23 ($78.73 in chips) 
Seat 2: vanilica ($100 in chips) 
Seat 3: matiko09 ($178.10 in chips) 
Seat 5: deadkiller1 ($100 in chips) 
Seat 6: Kihog ($102.47 in chips) 
Seat 7: rene1984tsv ($226.45 in chips) 
Seat 8: b_____a__242 ($38.50 in chips) 
cobrik23: posts small blind $0.50
vanilica: posts big blind $1
Strikerman25: sits out 
*** HOLE CARDS ***
Dealt to matiko09 [3s 8d]
matiko09: folds 
deadkiller1: folds 
Kihog: folds 
rene1984tsv: folds 
b_____a__242: raises $1 to $2
cobrik23: raises $5 to $7
vanilica: folds 
b_____a__242: folds 
Uncalled bet ($5) returned to cobrik23
cobrik23 collected $5 from pot
cobrik23: doesn't show hand 
*** SUMMARY ***
Total pot $5 | Rake $0 
Seat 1: cobrik23 (small blind) collected ($5)
Seat 2: vanilica (big blind) folded before Flop
Seat 3: matiko09 folded before Flop (didn't bet)
Seat 5: deadkiller1 folded before Flop (didn't bet)
Seat 6: Kihog folded before Flop (didn't bet)
Seat 7: rene1984tsv folded before Flop (didn't bet)
Seat 8: b_____a__242 (button) folded before Flop





PokerStars Hand #153506516361:  Hold'em No Limit (€0.50/€1.00 EUR) - 2016/05/18 21:51:06 CET [2016/05/18 15:51:06 ET]
Table 'Pallas II' 9-max Seat #4 is the button
Seat 1: deadkiller1 (€160.73 in chips) 
Seat 2: matiko09 (€118.45 in chips) 
Seat 3: Ouga Buga (€100 in chips) 
Seat 4: torkkdnm (€166.98 in chips) 
Seat 5: florrin92 (€100 in chips) 
Seat 7: rate8 (€111.72 in chips) 
Seat 8: Kihog (€188.04 in chips) 
Seat 9: stijner1986 (€180.83 in chips) 
florrin92: posts small blind €0.50
rate8: posts big blind €1
*** HOLE CARDS ***
Dealt to matiko09 [8c 3h]
Kihog: folds 
stijner1986: calls €1
deadkiller1: folds 
matiko09: folds 
Ouga Buga: raises €3 to €4
torkkdnm: folds 
florrin92: folds 
rate8: calls €3
stijner1986: calls €3
*** FLOP *** [Ts 4s Jd]
rate8: bets €8.43
stijner1986: folds 
Ouga Buga: folds 
Uncalled bet (€8.43) returned to rate8
rate8 collected €11.88 from pot
rate8: doesn't show hand 
*** SUMMARY ***
Total pot €12.50 | Rake €0.62 
Board [Ts 4s Jd]
Seat 1: deadkiller1 folded before Flop (didn't bet)
Seat 2: matiko09 folded before Flop (didn't bet)
Seat 3: Ouga Buga folded on the Flop
Seat 4: torkkdnm (button) folded before Flop (didn't bet)
Seat 5: florrin92 (small blind) folded before Flop
Seat 7: rate8 (big blind) collected (€11.88)
Seat 8: Kihog folded before Flop (didn't bet)
Seat 9: stijner1986 folded on the Flop





PokerStars Hand #153506525693:  Hold'em No Limit ($0.50/$1.00 USD) - 2016/05/18 21:51:16 CET [2016/05/18 15:51:16 ET]
Table 'Brendelia II' 9-max Seat #4 is the button
Seat 3: Zeeshka ($101 in chips) 
Seat 4: gkm0nk3y ($110.49 in chips) 
Seat 5: Vulturinus ($62.43 in chips) 
Seat 6: TimStone ($157.98 in chips) 
Seat 7: matiko09 ($102.62 in chips) 
Vulturinus: posts small blind $0.50
TimStone: posts big blind $1
cap. marb: sits out 
Kihog: sits out 
*** HOLE CARDS ***
Dealt to matiko09 [As 3c]
Kihog leaves the table
matiko09: folds 
Zeeshka: folds 
gkm0nk3y: folds 
Vulturinus: calls $0.50
TimStone: checks 
*** FLOP *** [Kd Qd Tc]
Vulturinus: checks 
TimStone: checks 
*** TURN *** [Kd Qd Tc] [7h]
Vulturinus: checks 
TimStone: bets $1.50
Vulturinus: folds 
Uncalled bet ($1.50) returned to TimStone
TimStone collected $1.90 from pot
TimStone: doesn't show hand 
*** SUMMARY ***
Total pot $2 | Rake $0.10 
Board [Kd Qd Tc 7h]
Seat 3: Zeeshka folded before Flop (didn't bet)
Seat 4: gkm0nk3y (button) folded before Flop (didn't bet)
Seat 5: Vulturinus (small blind) folded on the Turn
Seat 6: TimStone (big blind) collected ($1.90)
Seat 7: matiko09 folded before Flop (didn't bet)





PokerStars Hand #153506526105:  Hold'em No Limit ($0.50/$1.00 USD) - 2016/05/18 21:51:17 CET [2016/05/18 15:51:17 ET]
Table 'Lorcia II' 9-max Seat #6 is the button
Seat 3: matiko09 ($102.70 in chips) 
Seat 4: vanilica ($160.32 in chips) 
Seat 5: nuuaber ($166.07 in chips) 
Seat 6: gkm0nk3y ($100 in chips) 
Seat 7: rate8 ($115.96 in chips) 
Seat 9: cobrik23 ($98.50 in chips) 
rate8: posts small blind $0.50
cobrik23: posts big blind $1
*** HOLE CARDS ***
Dealt to matiko09 [5d 5s]
matiko09: raises $2 to $3
vanilica: folds 
nuuaber: folds 
gkm0nk3y: folds 
rate8: folds 
cobrik23: folds 
Uncalled bet ($2) returned to matiko09
matiko09 collected $2.50 from pot
matiko09: doesn't show hand 
*** SUMMARY ***
Total pot $2.50 | Rake $0 
Seat 3: matiko09 collected ($2.50)
Seat 4: vanilica folded before Flop (didn't bet)
Seat 5: nuuaber folded before Flop (didn't bet)
Seat 6: gkm0nk3y (button) folded before Flop (didn't bet)
Seat 7: rate8 (small blind) folded before Flop
Seat 9: cobrik23 (big blind) folded before Flop





PokerStars Hand #153506534769:  Hold'em No Limit ($0.50/$1.00 USD) - 2016/05/18 21:51:26 CET [2016/05/18 15:51:26 ET]
Table 'Abetti II' 9-max Seat #9 is the button
Seat 1: matiko09 ($110.50 in chips) 
Seat 2: torkkdnm ($100 in chips) 
Seat 3: cobrik23 ($124.03 in chips) 
Seat 4: ipashutapkom ($107 in chips) 
Seat 6: Kihog ($100 in chips) 
Seat 7: rate8 ($148.78 in chips) 
Seat 8: roadster683 ($140.29 in chips) 
Seat 9: vanilica ($121.61 in chips) 
matiko09: posts small blind $0.50
torkkdnm: posts big blind $1
*** HOLE CARDS ***
Dealt to matiko09 [Tc Qh]
cobrik23: folds 
ipashutapkom: folds 
Kihog: folds 
rate8: folds 
roadster683: raises $1 to $2
vanilica: raises $6 to $8
matiko09: folds 
torkkdnm: folds 
roadster683: calls $6
*** FLOP *** [Ts 4s 8h]
roadster683: checks 
vanilica: bets $9.97
roadster683: calls $9.97
*** TURN *** [Ts 4s 8h] [7c]
roadster683: checks 
vanilica: checks 
*** RIVER *** [Ts 4s 8h 7c] [6s]
roadster683: checks 
vanilica: bets $21.34
roadster683: calls $21.34
*** SHOW DOWN ***
vanilica: shows [9s Ac] (a straight, Six to Ten)
roadster683: shows [9h 4h] (a straight, Six to Ten)
roadster683 collected $38.81 from pot
vanilica collected $38.81 from pot
*** SUMMARY ***
Total pot $80.12 | Rake $2.50 
Board [Ts 4s 8h 7c 6s]
Seat 1: matiko09 (small blind) folded before Flop
Seat 2: torkkdnm (big blind) folded before Flop
Seat 3: cobrik23 folded before Flop (didn't bet)
Seat 4: ipashutapkom folded before Flop (didn't bet)
Seat 6: Kihog folded before Flop (didn't bet)
Seat 7: rate8 folded before Flop (didn't bet)
Seat 8: roadster683 showed [9h 4h] and won ($38.81) with a straight, Six to Ten
Seat 9: vanilica (button) showed [9s Ac] and won ($38.81) with a straight, Six to Ten





PokerStars Hand #153506545223:  Hold'em No Limit ($0.50/$1.00 USD) - 2016/05/18 21:51:37 CET [2016/05/18 15:51:37 ET]
Table 'Samitchell II' 9-max Seat #3 is the button
Seat 1: riggedsh** ($131.77 in chips) 
Seat 2: Cortine ($113.10 in chips) 
Seat 3: vanilica ($166.25 in chips) 
Seat 4: Zeeshka ($107.27 in chips) 
Seat 5: nuuaber ($56.87 in chips) 
Seat 6: Strikerman25 ($40 in chips) 
Seat 7: matiko09 ($110.15 in chips) 
Seat 8: rate8 ($105.92 in chips) 
Zeeshka: posts small blind $0.50
nuuaber: posts big blind $1
*** HOLE CARDS ***
Dealt to matiko09 [Td Kh]
Strikerman25: folds 
matiko09: folds 
rate8: folds 
riggedsh**: raises $2 to $3
Cortine: folds 
vanilica: folds 
Zeeshka: folds 
nuuaber: folds 
Uncalled bet ($2) returned to riggedsh**
riggedsh** collected $2.50 from pot
riggedsh**: doesn't show hand 
*** SUMMARY ***
Total pot $2.50 | Rake $0 
Seat 1: riggedsh** collected ($2.50)
Seat 2: Cortine folded before Flop (didn't bet)
Seat 3: vanilica (button) folded before Flop (didn't bet)
Seat 4: Zeeshka (small blind) folded before Flop
Seat 5: nuuaber (big blind) folded before Flop
Seat 6: Strikerman25 folded before Flop (didn't bet)
Seat 7: matiko09 folded before Flop (didn't bet)
Seat 8: rate8 folded before Flop (didn't bet)





PokerStars Hand #153506558661:  Hold'em No Limit ($0.50/$1.00 USD) - 2016/05/18 21:51:51 CET [2016/05/18 15:51:51 ET]
Table 'Tatjana III' 9-max Seat #1 is the button
Seat 1: cobrik23 ($81.73 in chips) 
Seat 2: vanilica ($100 in chips) 
Seat 3: matiko09 ($178.10 in chips) 
Seat 5: deadkiller1 ($100 in chips) 
Seat 6: Kihog ($102.47 in chips) 
Seat 7: rene1984tsv ($226.45 in chips) 
Seat 8: b_____a__242 ($36.50 in chips) 
vanilica: posts small blind $0.50
matiko09: posts big blind $1
Strikerman25: sits out 
*** HOLE CARDS ***
Dealt to matiko09 [9s 9h]
deadkiller1: raises $2 to $3
Kihog: folds 
rene1984tsv: calls $3
b_____a__242: folds 
cobrik23: folds 
vanilica: folds 
matiko09: calls $2
*** FLOP *** [3d 6c 2d]
matiko09: bets $6
deadkiller1: folds 
rene1984tsv: calls $6
*** TURN *** [3d 6c 2d] [Ts]
matiko09: bets $12
rene1984tsv: folds 
Uncalled bet ($12) returned to matiko09
matiko09 collected $20.42 from pot
matiko09: doesn't show hand 
*** SUMMARY ***
Total pot $21.50 | Rake $1.08 
Board [3d 6c 2d Ts]
Seat 1: cobrik23 (button) folded before Flop (didn't bet)
Seat 2: vanilica (small blind) folded before Flop
Seat 3: matiko09 (big blind) collected ($20.42)
Seat 5: deadkiller1 folded on the Flop
Seat 6: Kihog folded before Flop (didn't bet)
Seat 7: rene1984tsv folded on the Turn
Seat 8: b_____a__242 folded before Flop (didn't bet)





PokerStars Hand #153506565688:  Hold'em No Limit ($0.50/$1.00 USD) - 2016/05/18 21:51:59 CET [2016/05/18 15:51:59 ET]
Table 'Saiph II' 9-max Seat #6 is the button
Seat 1: stepan0605 ($100 in chips) 
Seat 3: jezzaber ($52.12 in chips) 
Seat 4: deadkiller1 ($100 in chips) 
Seat 5: matiko09 ($100 in chips) 
Seat 6: cap. marb ($43 in chips) 
stepan0605: posts small blind $0.50
Skum1986: is sitting out 
jezzaber: posts big blind $1
*** HOLE CARDS ***
Dealt to matiko09 [Th 8s]
Skum1986 leaves the table
deadkiller1: folds 
Cortine joins the table at seat #2 
matiko09: folds 
cap. marb: folds 
pokerstereke joins the table at seat #9 
gkm0nk3y joins the table at seat #8 
stepan0605: raises $1.50 to $2.50
jezzaber: calls $1.50
*** FLOP *** [Tc Ts Qc]
stepan0605: checks 
jezzaber: bets $5
stepan0605: calls $5
*** TURN *** [Tc Ts Qc] [Js]
stepan0605: checks 
jezzaber: bets $7
stepan0605: calls $7
*** RIVER *** [Tc Ts Qc Js] [8d]
stepan0605: checks 
jezzaber: checks 
*** SHOW DOWN ***
stepan0605: shows [Jh Qs] (two pair, Queens and Jacks)
jezzaber: mucks hand 
stepan0605 collected $27.55 from pot
*** SUMMARY ***
Total pot $29 | Rake $1.45 
Board [Tc Ts Qc Js 8d]
Seat 1: stepan0605 (small blind) showed [Jh Qs] and won ($27.55) with two pair, Queens and Jacks
Seat 3: jezzaber (big blind) mucked [5s 5d]
Seat 4: deadkiller1 folded before Flop (didn't bet)
Seat 5: matiko09 folded before Flop (didn't bet)
Seat 6: cap. marb (button) folded before Flop (didn't bet)





PokerStars Hand #153506571777:  Hold'em No Limit (€0.50/€1.00 EUR) - 2016/05/18 21:52:05 CET [2016/05/18 15:52:05 ET]
Table 'Pallas II' 9-max Seat #5 is the button
Seat 1: deadkiller1 (€160.73 in chips) 
Seat 2: matiko09 (€118.45 in chips) 
Seat 3: Ouga Buga (€100 in chips) 
Seat 4: torkkdnm (€166.98 in chips) 
Seat 5: florrin92 (€100 in chips) 
Seat 7: rate8 (€119.60 in chips) 
Seat 8: Kihog (€188.04 in chips) 
Seat 9: stijner1986 (€176.83 in chips) 
rate8: posts small blind €0.50
Kihog: posts big blind €1
*** HOLE CARDS ***
Dealt to matiko09 [Qc Ks]
stijner1986: calls €1
deadkiller1: raises €3 to €4
matiko09: folds 
Ouga Buga: folds 
torkkdnm: folds 
florrin92: calls €4
rate8: folds 
Kihog: folds 
stijner1986: calls €3
*** FLOP *** [4s 5c 3s]
stijner1986: checks 
deadkiller1: bets €8.46
florrin92: calls €8.46
stijner1986: folds 
*** TURN *** [4s 5c 3s] [Jc]
deadkiller1: bets €19.07
florrin92: folds 
Uncalled bet (€19.07) returned to deadkiller1
deadkiller1 collected €28.90 from pot
deadkiller1: doesn't show hand 
*** SUMMARY ***
Total pot €30.42 | Rake €1.52 
Board [4s 5c 3s Jc]
Seat 1: deadkiller1 collected (€28.90)
Seat 2: matiko09 folded before Flop (didn't bet)
Seat 3: Ouga Buga folded before Flop (didn't bet)
Seat 4: torkkdnm folded before Flop (didn't bet)
Seat 5: florrin92 (button) folded on the Turn
Seat 7: rate8 (small blind) folded before Flop
Seat 8: Kihog (big blind) folded before Flop
Seat 9: stijner1986 folded on the Flop





PokerStars Hand #153506572597:  Hold'em No Limit ($0.50/$1.00 USD) - 2016/05/18 21:52:06 CET [2016/05/18 15:52:06 ET]
Table 'Brendelia II' 9-max Seat #5 is the button
Seat 3: Zeeshka ($101 in chips) 
Seat 4: gkm0nk3y ($110.49 in chips) 
Seat 5: Vulturinus ($61.43 in chips) 
Seat 6: TimStone ($158.88 in chips) 
Seat 7: matiko09 ($102.62 in chips) 
TimStone: posts small blind $0.50
matiko09: posts big blind $1
cap. marb: sits out 
*** HOLE CARDS ***
Dealt to matiko09 [8s Js]
Zeeshka: raises $2 to $3
gkm0nk3y: folds 
Vulturinus: folds 
rate8 joins the table at seat #2 
TimStone: folds 
matiko09: folds 
Uncalled bet ($2) returned to Zeeshka
Zeeshka collected $2.50 from pot
Zeeshka: doesn't show hand 
*** SUMMARY ***
Total pot $2.50 | Rake $0 
Seat 3: Zeeshka collected ($2.50)
Seat 4: gkm0nk3y folded before Flop (didn't bet)
Seat 5: Vulturinus (button) folded before Flop (didn't bet)
Seat 6: TimStone (small blind) folded before Flop
Seat 7: matiko09 (big blind) folded before Flop





PokerStars Hand #153506596601:  Hold'em No Limit ($0.50/$1.00 USD) - 2016/05/18 21:52:32 CET [2016/05/18 15:52:32 ET]
Table 'Samitchell II' 9-max Seat #4 is the button
Seat 1: riggedsh** ($133.27 in chips) 
Seat 2: Cortine ($113.10 in chips) 
Seat 3: vanilica ($166.25 in chips) 
Seat 4: Zeeshka ($106.77 in chips) 
Seat 5: nuuaber ($55.87 in chips) 
Seat 6: Strikerman25 ($40 in chips) 
Seat 7: matiko09 ($110.15 in chips) 
Seat 8: rate8 ($105.92 in chips) 
nuuaber: posts small blind $0.50
Strikerman25: posts big blind $1
*** HOLE CARDS ***
Dealt to matiko09 [4d 3d]
matiko09: folds 
rate8: folds 
riggedsh**: folds 
Cortine: folds 
vanilica: raises $1.50 to $2.50
Zeeshka: folds 
nuuaber: folds 
Strikerman25: folds 
Uncalled bet ($1.50) returned to vanilica
vanilica collected $2.50 from pot
vanilica: doesn't show hand 
*** SUMMARY ***
Total pot $2.50 | Rake $0 
Seat 1: riggedsh** folded before Flop (didn't bet)
Seat 2: Cortine folded before Flop (didn't bet)
Seat 3: vanilica collected ($2.50)
Seat 4: Zeeshka (button) folded before Flop (didn't bet)
Seat 5: nuuaber (small blind) folded before Flop
Seat 6: Strikerman25 (big blind) folded before Flop
Seat 7: matiko09 folded before Flop (didn't bet)
Seat 8: rate8 folded before Flop (didn't bet)





PokerStars Hand #153506599019:  Hold'em No Limit ($0.50/$1.00 USD) - 2016/05/18 21:52:35 CET [2016/05/18 15:52:35 ET]
Table 'Tatjana III' 9-max Seat #2 is the button
Seat 1: cobrik23 ($81.73 in chips) 
Seat 2: vanilica ($100 in chips) 
Seat 3: matiko09 ($189.52 in chips) 
Seat 4: Strikerman25 ($44.96 in chips) 
Seat 5: deadkiller1 ($100 in chips) 
Seat 6: Kihog ($102.47 in chips) 
Seat 7: rene1984tsv ($217.45 in chips) 
Seat 8: b_____a__242 ($36.50 in chips) 
matiko09: posts small blind $0.50
Strikerman25: posts big blind $1
Moszes360: sits out 
*** HOLE CARDS ***
Dealt to matiko09 [2c 8d]
deadkiller1: folds 
Kihog: folds 
rene1984tsv: calls $1
b_____a__242: raises $2.48 to $3.48
cobrik23: folds 
vanilica: folds 
matiko09: folds 
Strikerman25: folds 
rene1984tsv: calls $2.48
*** FLOP *** [7h Ac 3h]
rene1984tsv: checks 
b_____a__242: bets $4.58
rene1984tsv: folds 
Uncalled bet ($4.58) returned to b_____a__242
b_____a__242 collected $8.04 from pot
b_____a__242: doesn't show hand 
*** SUMMARY ***
Total pot $8.46 | Rake $0.42 
Board [7h Ac 3h]
Seat 1: cobrik23 folded before Flop (didn't bet)
Seat 2: vanilica (button) folded before Flop (didn't bet)
Seat 3: matiko09 (small blind) folded before Flop
Seat 4: Strikerman25 (big blind) folded before Flop
Seat 5: deadkiller1 folded before Flop (didn't bet)
Seat 6: Kihog folded before Flop (didn't bet)
Seat 7: rene1984tsv folded on the Flop
Seat 8: b_____a__242 collected ($8.04)





PokerStars Hand #153506606557:  Hold'em No Limit ($0.50/$1.00 USD) - 2016/05/18 21:52:43 CET [2016/05/18 15:52:43 ET]
Table 'Brendelia II' 9-max Seat #6 is the button
Seat 1: cap. marb ($40 in chips) 
Seat 3: Zeeshka ($102.50 in chips) 
Seat 4: gkm0nk3y ($110.49 in chips) 
Seat 5: Vulturinus ($61.43 in chips) 
Seat 6: TimStone ($158.38 in chips) 
Seat 7: matiko09 ($101.62 in chips) 
matiko09: posts small blind $0.50
cap. marb: posts big blind $1
rate8: sits out 
*** HOLE CARDS ***
Dealt to matiko09 [7s 9h]
Zeeshka: folds 
gkm0nk3y: raises $2 to $3
Vulturinus: folds 
TimStone: folds 
matiko09: folds 
cap. marb: raises $4 to $7
gkm0nk3y: folds 
Uncalled bet ($4) returned to cap. marb
cap. marb collected $6.50 from pot
*** SUMMARY ***
Total pot $6.50 | Rake $0 
Seat 1: cap. marb (big blind) collected ($6.50)
Seat 3: Zeeshka folded before Flop (didn't bet)
Seat 4: gkm0nk3y folded before Flop
Seat 5: Vulturinus folded before Flop (didn't bet)
Seat 6: TimStone (button) folded before Flop (didn't bet)
Seat 7: matiko09 (small blind) folded before Flop





PokerStars Hand #153506610743:  Hold'em No Limit ($0.50/$1.00 USD) - 2016/05/18 21:52:47 CET [2016/05/18 15:52:47 ET]
Table 'Abetti II' 9-max Seat #1 is the button
Seat 1: matiko09 ($110 in chips) 
Seat 2: torkkdnm ($100 in chips) 
Seat 6: Kihog ($100 in chips) 
Seat 7: rate8 ($148.78 in chips) 
Seat 8: roadster683 ($139.79 in chips) 
Seat 9: vanilica ($121.11 in chips) 
torkkdnm: posts small blind $0.50
cobrik23: is sitting out 
cobrik23 leaves the table
ipashutapkom: is sitting out 
ipashutapkom leaves the table
Kihog: posts big blind $1
*** HOLE CARDS ***
Dealt to matiko09 [Ac Kc]
rate8: folds 
roadster683: folds 
vanilica: folds 
matiko09: raises $1.27 to $2.27
torkkdnm: folds 
Kihog: calls $1.27
*** FLOP *** [3h Tc Ts]
Kihog: checks 
matiko09: checks 
*** TURN *** [3h Tc Ts] [Td]
Kihog: checks 
matiko09: bets $2.49
Kihog: folds 
Uncalled bet ($2.49) returned to matiko09
matiko09 collected $4.79 from pot
matiko09: doesn't show hand 
*** SUMMARY ***
Total pot $5.04 | Rake $0.25 
Board [3h Tc Ts Td]
Seat 1: matiko09 (button) collected ($4.79)
Seat 2: torkkdnm (small blind) folded before Flop
Seat 6: Kihog (big blind) folded on the Turn
Seat 7: rate8 folded before Flop (didn't bet)
Seat 8: roadster683 folded before Flop (didn't bet)
Seat 9: vanilica folded before Flop (didn't bet)





PokerStars Hand #153506623383:  Hold'em No Limit ($0.50/$1.00 USD) - 2016/05/18 21:53:01 CET [2016/05/18 15:53:01 ET]
Table 'Saiph II' 9-max Seat #1 is the button
Seat 1: stepan0605 ($113.05 in chips) 
Seat 3: jezzaber ($37.62 in chips) 
Seat 4: deadkiller1 ($100 in chips) 
Seat 5: matiko09 ($100 in chips) 
Seat 6: cap. marb ($43 in chips) 
Seat 9: pokerstereke ($99.17 in chips) 
Cortine will be allowed to play after the button
jezzaber: posts small blind $0.50
deadkiller1: posts big blind $1
gkm0nk3y: sits out 
pokerstereke: posts big blind $1
*** HOLE CARDS ***
Dealt to matiko09 [Jd 3c]
matiko09: folds 
cap. marb: folds 
pokerstereke: checks 
stepan0605: raises $2 to $3
jezzaber: folds 
deadkiller1: folds 
pokerstereke: folds 
Uncalled bet ($2) returned to stepan0605
stepan0605 collected $3.50 from pot
stepan0605: doesn't show hand 
*** SUMMARY ***
Total pot $3.50 | Rake $0 
Seat 1: stepan0605 (button) collected ($3.50)
Seat 3: jezzaber (small blind) folded before Flop
Seat 4: deadkiller1 (big blind) folded before Flop
Seat 5: matiko09 folded before Flop (didn't bet)
Seat 6: cap. marb folded before Flop (didn't bet)
Seat 9: pokerstereke folded before Flop





PokerStars Hand #153506629847:  Hold'em No Limit ($0.50/$1.00 USD) - 2016/05/18 21:53:07 CET [2016/05/18 15:53:07 ET]
Table 'Samitchell II' 9-max Seat #5 is the button
Seat 1: riggedsh** ($133.27 in chips) 
Seat 2: Cortine ($113.10 in chips) 
Seat 3: vanilica ($167.75 in chips) 
Seat 4: Zeeshka ($106.77 in chips) 
Seat 5: nuuaber ($55.37 in chips) 
Seat 6: Strikerman25 ($39 in chips) 
Seat 7: matiko09 ($110.15 in chips) 
Seat 8: rate8 ($105.92 in chips) 
Strikerman25: posts small blind $0.50
matiko09: posts big blind $1
*** HOLE CARDS ***
Dealt to matiko09 [Jd Ah]
rate8: folds 
riggedsh**: folds 
Cortine: folds 
vanilica: folds 
Zeeshka: folds 
nuuaber: folds 
Strikerman25: folds 
Uncalled bet ($0.50) returned to matiko09
matiko09 collected $1 from pot
matiko09: doesn't show hand 
*** SUMMARY ***
Total pot $1 | Rake $0 
Seat 1: riggedsh** folded before Flop (didn't bet)
Seat 2: Cortine folded before Flop (didn't bet)
Seat 3: vanilica folded before Flop (didn't bet)
Seat 4: Zeeshka folded before Flop (didn't bet)
Seat 5: nuuaber (button) folded before Flop (didn't bet)
Seat 6: Strikerman25 (small blind) folded before Flop
Seat 7: matiko09 (big blind) collected ($1)
Seat 8: rate8 folded before Flop (didn't bet)





PokerStars Hand #153506631427:  Hold'em No Limit ($0.50/$1.00 USD) - 2016/05/18 21:53:09 CET [2016/05/18 15:53:09 ET]
Table 'Brendelia II' 9-max Seat #7 is the button
Seat 1: cap. marb ($43.50 in chips) 
Seat 2: rate8 ($100 in chips) 
Seat 3: Zeeshka ($102.50 in chips) 
Seat 4: gkm0nk3y ($107.49 in chips) 
Seat 5: Vulturinus ($61.43 in chips) 
Seat 6: TimStone ($158.38 in chips) 
Seat 7: matiko09 ($101.12 in chips) 
cap. marb: posts small blind $0.50
rate8: posts big blind $1
*** HOLE CARDS ***
Dealt to matiko09 [Jc 7s]
Zeeshka: folds 
gkm0nk3y: folds 
Vulturinus: folds 
TimStone: raises $1.52 to $2.52
matiko09: folds 
cap. marb: raises $3.48 to $6
rate8: folds 
TimStone: calls $3.48
*** FLOP *** [Ah Js Jh]
cap. marb: checks 
TimStone: checks 
*** TURN *** [Ah Js Jh] [2s]
cap. marb: checks 
TimStone: bets $6.66
cap. marb: calls $6.66
*** RIVER *** [Ah Js Jh 2s] [4d]
cap. marb: checks 
TimStone: checks 
*** SHOW DOWN ***
cap. marb: shows [Qs Qh] (two pair, Queens and Jacks)
TimStone: shows [As Qc] (two pair, Aces and Jacks)
TimStone collected $25 from pot
*** SUMMARY ***
Total pot $26.32 | Rake $1.32 
Board [Ah Js Jh 2s 4d]
Seat 1: cap. marb (small blind) showed [Qs Qh] and lost with two pair, Queens and Jacks
Seat 2: rate8 (big blind) folded before Flop
Seat 3: Zeeshka folded before Flop (didn't bet)
Seat 4: gkm0nk3y folded before Flop (didn't bet)
Seat 5: Vulturinus folded before Flop (didn't bet)
Seat 6: TimStone showed [As Qc] and won ($25) with two pair, Aces and Jacks
Seat 7: matiko09 (button) folded before Flop (didn't bet)





PokerStars Hand #153506641519:  Hold'em No Limit ($0.50/$1.00 USD) - 2016/05/18 21:53:20 CET [2016/05/18 15:53:20 ET]
Table 'Tatjana III' 9-max Seat #3 is the button
Seat 1: cobrik23 ($81.73 in chips) 
Seat 2: vanilica ($100 in chips) 
Seat 3: matiko09 ($189.02 in chips) 
Seat 4: Strikerman25 ($43.96 in chips) 
Seat 5: deadkiller1 ($100 in chips) 
Seat 6: Kihog ($102.47 in chips) 
Seat 7: rene1984tsv ($213.97 in chips) 
Seat 8: b_____a__242 ($41.06 in chips) 
Strikerman25: posts small blind $0.50
deadkiller1: posts big blind $1
Moszes360: sits out 
*** HOLE CARDS ***
Dealt to matiko09 [8h 4c]
Kihog: folds 
rene1984tsv: calls $1
b_____a__242: folds 
cobrik23: folds 
vanilica: folds 
matiko09: folds 
cobrik23 leaves the table
Strikerman25: folds 
deadkiller1: checks 
*** FLOP *** [Ah Qh Jd]
deadkiller1: bets $2
rene1984tsv: folds 
Uncalled bet ($2) returned to deadkiller1
deadkiller1 collected $2.38 from pot
deadkiller1: doesn't show hand 
*** SUMMARY ***
Total pot $2.50 | Rake $0.12 
Board [Ah Qh Jd]
Seat 1: cobrik23 folded before Flop (didn't bet)
Seat 2: vanilica folded before Flop (didn't bet)
Seat 3: matiko09 (button) folded before Flop (didn't bet)
Seat 4: Strikerman25 (small blind) folded before Flop
Seat 5: deadkiller1 (big blind) collected ($2.38)
Seat 6: Kihog folded before Flop (didn't bet)
Seat 7: rene1984tsv folded on the Flop
Seat 8: b_____a__242 folded before Flop (didn't bet)





PokerStars Hand #153506646310:  Hold'em No Limit (€0.50/€1.00 EUR) - 2016/05/18 21:53:25 CET [2016/05/18 15:53:25 ET]
Table 'Pallas II' 9-max Seat #7 is the button
Seat 1: deadkiller1 (€177.17 in chips) 
Seat 2: matiko09 (€118.45 in chips) 
Seat 3: Ouga Buga (€100 in chips) 
Seat 4: torkkdnm (€166.98 in chips) 
Seat 5: florrin92 (€100 in chips) 
Seat 7: rate8 (€119.10 in chips) 
Seat 8: Kihog (€187.04 in chips) 
Seat 9: stijner1986 (€172.83 in chips) 
Kihog: posts small blind €0.50
stijner1986: posts big blind €1
*** HOLE CARDS ***
Dealt to matiko09 [8d 5c]
deadkiller1: folds 
matiko09: folds 
Ouga Buga: folds 
torkkdnm: folds 
florrin92: folds 
rate8: raises €1 to €2
Kihog: folds 
stijner1986: folds 
Uncalled bet (€1) returned to rate8
rate8 collected €2.50 from pot
rate8: doesn't show hand 
*** SUMMARY ***
Total pot €2.50 | Rake €0 
Seat 1: deadkiller1 folded before Flop (didn't bet)
Seat 2: matiko09 folded before Flop (didn't bet)
Seat 3: Ouga Buga folded before Flop (didn't bet)
Seat 4: torkkdnm folded before Flop (didn't bet)
Seat 5: florrin92 folded before Flop (didn't bet)
Seat 7: rate8 (button) collected (€2.50)
Seat 8: Kihog (small blind) folded before Flop
Seat 9: stijner1986 (big blind) folded before Flop





PokerStars Hand #153506658813:  Hold'em No Limit ($0.50/$1.00 USD) - 2016/05/18 21:53:39 CET [2016/05/18 15:53:39 ET]
Table 'Abetti II' 9-max Seat #2 is the button
Seat 1: matiko09 ($112.52 in chips) 
Seat 2: torkkdnm ($100 in chips) 
Seat 6: Kihog ($100 in chips) 
Seat 7: rate8 ($148.78 in chips) 
Seat 8: roadster683 ($139.79 in chips) 
Seat 9: vanilica ($121.11 in chips) 
Kihog: posts small blind $0.50
rate8: posts big blind $1
*** HOLE CARDS ***
Dealt to matiko09 [Kc Qh]
roadster683: folds 
vanilica: folds 
matiko09: raises $1.50 to $2.50
torkkdnm: calls $2.50
Kihog: folds 
rate8: folds 
*** FLOP *** [9d Ah Jh]
matiko09: bets $4.02
cap. marb joins the table at seat #3 
torkkdnm: calls $4.02
*** TURN *** [9d Ah Jh] [Th]
matiko09: bets $9
torkkdnm: calls $9
*** RIVER *** [9d Ah Jh Th] [7s]
stepan0605 joins the table at seat #4 
matiko09: checks 
torkkdnm: checks 
*** SHOW DOWN ***
matiko09: shows [Kc Qh] (a straight, Ten to Ace)
torkkdnm: mucks hand 
matiko09 collected $30.91 from pot
*** SUMMARY ***
Total pot $32.54 | Rake $1.63 
Board [9d Ah Jh Th 7s]
Seat 1: matiko09 showed [Kc Qh] and won ($30.91) with a straight, Ten to Ace
Seat 2: torkkdnm (button) mucked [Ad Ts]
Seat 6: Kihog (small blind) folded before Flop
Seat 7: rate8 (big blind) folded before Flop
Seat 8: roadster683 folded before Flop (didn't bet)
Seat 9: vanilica folded before Flop (didn't bet)





PokerStars Hand #153506668401:  Hold'em No Limit ($0.50/$1.00 USD) - 2016/05/18 21:53:49 CET [2016/05/18 15:53:49 ET]
Table 'Tatjana III' 9-max Seat #4 is the button
Seat 2: vanilica ($100 in chips) 
Seat 3: matiko09 ($189.02 in chips) 
Seat 4: Strikerman25 ($43.46 in chips) 
Seat 5: deadkiller1 ($101.38 in chips) 
Seat 6: Kihog ($102.47 in chips) 
Seat 7: rene1984tsv ($212.97 in chips) 
Seat 8: b_____a__242 ($81.06 in chips) 
deadkiller1: posts small blind $0.50
Kihog: posts big blind $1
Moszes360: sits out 
*** HOLE CARDS ***
Dealt to matiko09 [Jh Ts]
rene1984tsv: raises $1 to $2
b_____a__242: folds 
vanilica: raises $7 to $9
cap. marb joins the table at seat #1 
matiko09: folds 
Strikerman25: folds 
deadkiller1: folds 
Kihog: folds 
rene1984tsv: calls $7
*** FLOP *** [4h 8c 2d]
rene1984tsv: checks 
vanilica: bets $11.11
rene1984tsv: calls $11.11
*** TURN *** [4h 8c 2d] [2c]
rene1984tsv: checks 
vanilica: checks 
*** RIVER *** [4h 8c 2d 2c] [3c]
rene1984tsv: bets $9
vanilica: folds 
Uncalled bet ($9) returned to rene1984tsv
rene1984tsv collected $39.63 from pot
rene1984tsv: shows [8d 9h] (two pair, Eights and Deuces)
*** SUMMARY ***
Total pot $41.72 | Rake $2.09 
Board [4h 8c 2d 2c 3c]
Seat 2: vanilica folded on the River
Seat 3: matiko09 folded before Flop (didn't bet)
Seat 4: Strikerman25 (button) folded before Flop (didn't bet)
Seat 5: deadkiller1 (small blind) folded before Flop
Seat 6: Kihog (big blind) folded before Flop
Seat 7: rene1984tsv collected ($39.63)
Seat 8: b_____a__242 folded before Flop (didn't bet)





PokerStars Hand #153506682524:  Hold'em No Limit ($0.50/$1.00 USD) - 2016/05/18 21:54:04 CET [2016/05/18 15:54:04 ET]
Table 'Samitchell II' 9-max Seat #6 is the button
Seat 1: riggedsh** ($133.27 in chips) 
Seat 2: Cortine ($113.10 in chips) 
Seat 3: vanilica ($167.75 in chips) 
Seat 4: Zeeshka ($106.77 in chips) 
Seat 5: nuuaber ($55.37 in chips) 
Seat 6: Strikerman25 ($38.50 in chips) 
Seat 7: matiko09 ($110.65 in chips) 
Seat 8: rate8 ($105.92 in chips) 
matiko09: posts small blind $0.50
rate8: posts big blind $1
*** HOLE CARDS ***
Dealt to matiko09 [6d As]
riggedsh**: folds 
Cortine: folds 
vanilica: folds 
Zeeshka: folds 
nuuaber: folds 
Strikerman25: raises $1.09 to $2.09
matiko09: folds 
rate8: calls $1.09
*** FLOP *** [Kh 5c 9d]
rate8: checks 
Strikerman25: checks 
*** TURN *** [Kh 5c 9d] [5h]
rate8: checks 
Strikerman25: bets $3
rate8: raises $6 to $9
Strikerman25: folds 
Uncalled bet ($6) returned to rate8
rate8 collected $10.15 from pot
rate8: doesn't show hand 
*** SUMMARY ***
Total pot $10.68 | Rake $0.53 
Board [Kh 5c 9d 5h]
Seat 1: riggedsh** folded before Flop (didn't bet)
Seat 2: Cortine folded before Flop (didn't bet)
Seat 3: vanilica folded before Flop (didn't bet)
Seat 4: Zeeshka folded before Flop (didn't bet)
Seat 5: nuuaber folded before Flop (didn't bet)
Seat 6: Strikerman25 (button) folded on the Turn
Seat 7: matiko09 (small blind) folded before Flop
Seat 8: rate8 (big blind) collected ($10.15)





PokerStars Hand #153506682353:  Hold'em No Limit (€0.50/€1.00 EUR) - 2016/05/18 21:54:04 CET [2016/05/18 15:54:04 ET]
Table 'Pallas II' 9-max Seat #8 is the button
Seat 1: deadkiller1 (€177.17 in chips) 
Seat 2: matiko09 (€118.45 in chips) 
Seat 3: Ouga Buga (€100 in chips) 
Seat 4: torkkdnm (€166.98 in chips) 
Seat 5: florrin92 (€100 in chips) 
Seat 7: rate8 (€120.60 in chips) 
Seat 8: Kihog (€186.54 in chips) 
Seat 9: stijner1986 (€171.83 in chips) 
stijner1986: posts small blind €0.50
deadkiller1: posts big blind €1
*** HOLE CARDS ***
Dealt to matiko09 [Th 9d]
matiko09: folds 
Ouga Buga: folds 
torkkdnm: folds 
florrin92: folds 
rate8: folds 
Kihog: folds 
stijner1986: calls €0.50
deadkiller1: raises €3 to €4
stijner1986: calls €3
*** FLOP *** [Ks 7c Tc]
stijner1986: checks 
deadkiller1: bets €5.01
stijner1986: calls €5.01
*** TURN *** [Ks 7c Tc] [Ts]
stijner1986: bets €12
deadkiller1: folds 
Uncalled bet (€12) returned to stijner1986
stijner1986 collected €17.12 from pot
stijner1986: doesn't show hand 
*** SUMMARY ***
Total pot €18.02 | Rake €0.90 
Board [Ks 7c Tc Ts]
Seat 1: deadkiller1 (big blind) folded on the Turn
Seat 2: matiko09 folded before Flop (didn't bet)
Seat 3: Ouga Buga folded before Flop (didn't bet)
Seat 4: torkkdnm folded before Flop (didn't bet)
Seat 5: florrin92 folded before Flop (didn't bet)
Seat 7: rate8 folded before Flop (didn't bet)
Seat 8: Kihog (button) folded before Flop (didn't bet)
Seat 9: stijner1986 (small blind) collected (€17.12)





PokerStars Hand #153506712701:  Hold'em No Limit ($0.50/$1.00 USD) - 2016/05/18 21:54:37 CET [2016/05/18 15:54:37 ET]
Table 'Brendelia II' 9-max Seat #1 is the button
Seat 1: cap. marb ($40 in chips) 
Seat 2: rate8 ($100 in chips) 
Seat 3: Zeeshka ($102.50 in chips) 
Seat 4: gkm0nk3y ($107.49 in chips) 
Seat 5: Vulturinus ($61.43 in chips) 
Seat 6: TimStone ($170.72 in chips) 
Seat 7: matiko09 ($101.12 in chips) 
rate8: posts small blind $0.50
Zeeshka: posts big blind $1
*** HOLE CARDS ***
Dealt to matiko09 [8c Qh]
gkm0nk3y: folds 
Vulturinus: folds 
TimStone: folds 
matiko09: folds 
cap. marb: raises $1.12 to $2.12
rate8: raises $3.88 to $6
Zeeshka: folds 
cap. marb: folds 
Uncalled bet ($3.88) returned to rate8
rate8 collected $5.24 from pot
rate8: doesn't show hand 
*** SUMMARY ***
Total pot $5.24 | Rake $0 
Seat 1: cap. marb (button) folded before Flop
Seat 2: rate8 (small blind) collected ($5.24)
Seat 3: Zeeshka (big blind) folded before Flop
Seat 4: gkm0nk3y folded before Flop (didn't bet)
Seat 5: Vulturinus folded before Flop (didn't bet)
Seat 6: TimStone folded before Flop (didn't bet)
Seat 7: matiko09 folded before Flop (didn't bet)





PokerStars Hand #153506717841:  Hold'em No Limit ($0.50/$1.00 USD) - 2016/05/18 21:54:43 CET [2016/05/18 15:54:43 ET]
Table 'Abetti II' 9-max Seat #6 is the button
Seat 1: matiko09 ($127.91 in chips) 
Seat 2: torkkdnm ($84.48 in chips) 
Seat 6: Kihog ($100 in chips) 
Seat 7: rate8 ($147.78 in chips) 
Seat 8: roadster683 ($139.79 in chips) 
Seat 9: vanilica ($121.11 in chips) 
rate8: posts small blind $0.50
roadster683: posts big blind $1
cap. marb: sits out 
stepan0605: sits out 
*** HOLE CARDS ***
Dealt to matiko09 [5h 3c]
vanilica: folds 
matiko09: folds 
torkkdnm: folds 
Kihog: raises $1 to $2
rate8: folds 
roadster683: calls $1
*** FLOP *** [5d Js 8h]
roadster683: checks 
Kihog: bets $2.50
roadster683: calls $2.50
*** TURN *** [5d Js 8h] [2h]
roadster683: checks 
Kihog: checks 
*** RIVER *** [5d Js 8h 2h] [Kc]
roadster683: bets $4
Kihog: folds 
Uncalled bet ($4) returned to roadster683
roadster683 collected $9.02 from pot
roadster683: doesn't show hand 
*** SUMMARY ***
Total pot $9.50 | Rake $0.48 
Board [5d Js 8h 2h Kc]
Seat 1: matiko09 folded before Flop (didn't bet)
Seat 2: torkkdnm folded before Flop (didn't bet)
Seat 6: Kihog (button) folded on the River
Seat 7: rate8 (small blind) folded before Flop
Seat 8: roadster683 (big blind) collected ($9.02)
Seat 9: vanilica folded before Flop (didn't bet)





PokerStars Hand #153506720318:  Hold'em No Limit ($0.50/$1.00 USD) - 2016/05/18 21:54:45 CET [2016/05/18 15:54:45 ET]
Table 'Tatjana III' 9-max Seat #5 is the button
Seat 2: vanilica ($100 in chips) 
Seat 3: matiko09 ($189.02 in chips) 
Seat 4: Strikerman25 ($43.46 in chips) 
Seat 5: deadkiller1 ($100.88 in chips) 
Seat 6: Kihog ($101.47 in chips) 
Seat 7: rene1984tsv ($232.49 in chips) 
Seat 8: b_____a__242 ($81.06 in chips) 
Kihog: posts small blind $0.50
rene1984tsv: posts big blind $1
Moszes360: sits out 
cap. marb: sits out 
*** HOLE CARDS ***
Dealt to matiko09 [6h 8s]
b_____a__242: folds 
vanilica: raises $1.50 to $2.50
matiko09: folds 
Strikerman25: folds 
deadkiller1: folds 
Kihog: folds 
rene1984tsv: calls $1.50
*** FLOP *** [2c 9c 5h]
rene1984tsv: checks 
vanilica: bets $2
rene1984tsv: calls $2
*** TURN *** [2c 9c 5h] [4d]
rene1984tsv: checks 
vanilica: bets $5.41
rene1984tsv: folds 
Uncalled bet ($5.41) returned to vanilica
vanilica collected $9.02 from pot
vanilica: doesn't show hand 
*** SUMMARY ***
Total pot $9.50 | Rake $0.48 
Board [2c 9c 5h 4d]
Seat 2: vanilica collected ($9.02)
Seat 3: matiko09 folded before Flop (didn't bet)
Seat 4: Strikerman25 folded before Flop (didn't bet)
Seat 5: deadkiller1 (button) folded before Flop (didn't bet)
Seat 6: Kihog (small blind) folded before Flop
Seat 7: rene1984tsv (big blind) folded on the Turn
Seat 8: b_____a__242 folded before Flop (didn't bet)





PokerStars Hand #153506744198:  Hold'em No Limit (€0.50/€1.00 EUR) - 2016/05/18 21:55:12 CET [2016/05/18 15:55:12 ET]
Table 'Pallas II' 9-max Seat #9 is the button
Seat 1: deadkiller1 (€168.16 in chips) 
Seat 2: matiko09 (€118.45 in chips) 
Seat 3: Ouga Buga (€100 in chips) 
Seat 4: torkkdnm (€166.98 in chips) 
Seat 5: florrin92 (€100 in chips) 
Seat 7: rate8 (€120.60 in chips) 
Seat 8: Kihog (€186.54 in chips) 
Seat 9: stijner1986 (€179.94 in chips) 
deadkiller1: posts small blind €0.50
matiko09: posts big blind €1
*** HOLE CARDS ***
Dealt to matiko09 [6d Td]
Ouga Buga: folds 
torkkdnm: folds 
florrin92: folds 
rate8: folds 
Kihog: raises €1.50 to €2.50
stijner1986: calls €2.50
deadkiller1: raises €7.50 to €10
matiko09: folds 
Kihog: calls €7.50
stijner1986: folds 
*** FLOP *** [4s Tc Ad]
deadkiller1: bets €14.73
Kihog: calls €14.73
*** TURN *** [4s Tc Ad] [7d]
deadkiller1: bets €33.46
Kihog: calls €33.46
*** RIVER *** [4s Tc Ad 7d] [3h]
deadkiller1: bets €109.97 and is all-in
Kihog: calls €109.97
*** SHOW DOWN ***
deadkiller1: shows [Th Ts] (three of a kind, Tens)
Kihog: shows [4h Ah] (two pair, Aces and Fours)
deadkiller1 collected €337.57 from pot
*** SUMMARY ***
Total pot €339.82 | Rake €2.25 
Board [4s Tc Ad 7d 3h]
Seat 1: deadkiller1 (small blind) showed [Th Ts] and won (€337.57) with three of a kind, Tens
Seat 2: matiko09 (big blind) folded before Flop
Seat 3: Ouga Buga folded before Flop (didn't bet)
Seat 4: torkkdnm folded before Flop (didn't bet)
Seat 5: florrin92 folded before Flop (didn't bet)
Seat 7: rate8 folded before Flop (didn't bet)
Seat 8: Kihog showed [4h Ah] and lost with two pair, Aces and Fours
Seat 9: stijner1986 (button) folded before Flop





PokerStars Hand #153506752034:  Hold'em No Limit ($0.50/$1.00 USD) - 2016/05/18 21:55:22 CET [2016/05/18 15:55:22 ET]
Table 'Tatjana III' 9-max Seat #6 is the button
Seat 2: vanilica ($104.52 in chips) 
Seat 3: matiko09 ($189.02 in chips) 
Seat 4: Strikerman25 ($43.46 in chips) 
Seat 5: deadkiller1 ($100.88 in chips) 
Seat 6: Kihog ($100.97 in chips) 
Seat 7: rene1984tsv ($227.99 in chips) 
Seat 8: b_____a__242 ($81.06 in chips) 
rene1984tsv: posts small blind $0.50
b_____a__242: posts big blind $1
Moszes360: sits out 
cap. marb: sits out 
*** HOLE CARDS ***
Dealt to matiko09 [8h 4c]
vanilica: folds 
matiko09: folds 
Strikerman25: raises $2 to $3
deadkiller1: folds 
Kihog: folds 
rene1984tsv: folds 
b_____a__242: folds 
Uncalled bet ($2) returned to Strikerman25
Strikerman25 collected $2.50 from pot
Strikerman25: doesn't show hand 
*** SUMMARY ***
Total pot $2.50 | Rake $0 
Seat 2: vanilica folded before Flop (didn't bet)
Seat 3: matiko09 folded before Flop (didn't bet)
Seat 4: Strikerman25 collected ($2.50)
Seat 5: deadkiller1 folded before Flop (didn't bet)
Seat 6: Kihog (button) folded before Flop (didn't bet)
Seat 7: rene1984tsv (small blind) folded before Flop
Seat 8: b_____a__242 (big blind) folded before Flop





PokerStars Hand #153506761983:  Hold'em No Limit ($0.50/$1.00 USD) - 2016/05/18 21:55:36 CET [2016/05/18 15:55:36 ET]
Table 'Samitchell II' 9-max Seat #7 is the button
Seat 1: riggedsh** ($133.27 in chips) 
Seat 2: Cortine ($113.10 in chips) 
Seat 3: vanilica ($167.75 in chips) 
Seat 4: Zeeshka ($106.77 in chips) 
Seat 5: nuuaber ($55.37 in chips) 
Seat 6: Strikerman25 ($33.41 in chips) 
Seat 7: matiko09 ($110.15 in chips) 
Seat 8: rate8 ($110.98 in chips) 
rate8: posts small blind $0.50
riggedsh**: posts big blind $1
*** HOLE CARDS ***
Dealt to matiko09 [8c 8d]
Cortine: folds 
vanilica: folds 
Zeeshka: folds 
nuuaber: raises $2 to $3
Strikerman25: folds 
matiko09: calls $3
rate8: calls $2.50
riggedsh**: folds 
*** FLOP *** [6c 2h 3c]
rate8: checks 
nuuaber: checks 
matiko09: bets $6.18
rate8: folds 
nuuaber: folds 
Uncalled bet ($6.18) returned to matiko09
matiko09 collected $9.50 from pot
matiko09: doesn't show hand 
*** SUMMARY ***
Total pot $10 | Rake $0.50 
Board [6c 2h 3c]
Seat 1: riggedsh** (big blind) folded before Flop
Seat 2: Cortine folded before Flop (didn't bet)
Seat 3: vanilica folded before Flop (didn't bet)
Seat 4: Zeeshka folded before Flop (didn't bet)
Seat 5: nuuaber folded on the Flop
Seat 6: Strikerman25 folded before Flop (didn't bet)
Seat 7: matiko09 (button) collected ($9.50)
Seat 8: rate8 (small blind) folded on the Flop





PokerStars Hand #153506764079:  Hold'em No Limit ($0.50/$1.00 USD) - 2016/05/18 21:55:39 CET [2016/05/18 15:55:39 ET]
Table 'Brendelia II' 9-max Seat #2 is the button
Seat 1: cap. marb ($37.88 in chips) 
Seat 2: rate8 ($103.12 in chips) 
Seat 3: Zeeshka ($101.50 in chips) 
Seat 4: gkm0nk3y ($107.49 in chips) 
Seat 5: Vulturinus ($61.43 in chips) 
Seat 6: TimStone ($170.72 in chips) 
Seat 7: matiko09 ($101.12 in chips) 
Zeeshka: posts small blind $0.50
gkm0nk3y: posts big blind $1
*** HOLE CARDS ***
Dealt to matiko09 [Js 7s]
Vulturinus: folds 
TimStone: folds 
matiko09: folds 
cap. marb: folds 
rate8: raises $1 to $2
Zeeshka: folds 
gkm0nk3y: folds 
Uncalled bet ($1) returned to rate8
rate8 collected $2.50 from pot
rate8: doesn't show hand 
*** SUMMARY ***
Total pot $2.50 | Rake $0 
Seat 1: cap. marb folded before Flop (didn't bet)
Seat 2: rate8 (button) collected ($2.50)
Seat 3: Zeeshka (small blind) folded before Flop
Seat 4: gkm0nk3y (big blind) folded before Flop
Seat 5: Vulturinus folded before Flop (didn't bet)
Seat 6: TimStone folded before Flop (didn't bet)
Seat 7: matiko09 folded before Flop (didn't bet)





PokerStars Hand #153506764928:  Hold'em No Limit ($0.50/$1.00 USD) - 2016/05/18 21:55:41 CET [2016/05/18 15:55:41 ET]
Table 'Abetti II' 9-max Seat #7 is the button
Seat 1: matiko09 ($127.91 in chips) 
Seat 2: torkkdnm ($84.48 in chips) 
Seat 6: Kihog ($100 in chips) 
Seat 7: rate8 ($147.28 in chips) 
Seat 8: roadster683 ($144.31 in chips) 
Seat 9: vanilica ($121.11 in chips) 
roadster683: posts small blind $0.50
vanilica: posts big blind $1
cap. marb: sits out 
stepan0605: sits out 
*** HOLE CARDS ***
Dealt to matiko09 [9c Ts]
matiko09: folds 
torkkdnm: raises $2 to $3
Kihog: folds 
rate8: folds 
roadster683: calls $2.50
vanilica: folds 
*** FLOP *** [9h 8c Kh]
roadster683: checks 
torkkdnm: bets $5
roadster683: raises $11 to $16
torkkdnm: calls $11
*** TURN *** [9h 8c Kh] [2s]
roadster683: bets $37
torkkdnm: folds 
Uncalled bet ($37) returned to roadster683
roadster683 collected $37.05 from pot
roadster683: doesn't show hand 
*** SUMMARY ***
Total pot $39 | Rake $1.95 
Board [9h 8c Kh 2s]
Seat 1: matiko09 folded before Flop (didn't bet)
Seat 2: torkkdnm folded on the Turn
Seat 6: Kihog folded before Flop (didn't bet)
Seat 7: rate8 (button) folded before Flop (didn't bet)
Seat 8: roadster683 (small blind) collected ($37.05)
Seat 9: vanilica (big blind) folded before Flop





PokerStars Hand #153506778311:  Hold'em No Limit ($0.50/$1.00 USD) - 2016/05/18 21:55:59 CET [2016/05/18 15:55:59 ET]
Table 'Tatjana III' 9-max Seat #7 is the button
Seat 2: vanilica ($104.52 in chips) 
Seat 3: matiko09 ($189.02 in chips) 
Seat 4: Strikerman25 ($44.96 in chips) 
Seat 5: deadkiller1 ($100.88 in chips) 
Seat 6: Kihog ($100.97 in chips) 
Seat 7: rene1984tsv ($227.49 in chips) 
Seat 8: b_____a__242 ($80.06 in chips) 
Seat 9: Moszes360 ($103.61 in chips) 
b_____a__242: posts small blind $0.50
Moszes360: posts big blind $1
cap. marb: sits out 
*** HOLE CARDS ***
Dealt to matiko09 [Qs 6h]
vanilica: folds 
matiko09: folds 
Strikerman25: folds 
deadkiller1: folds 
Kihog: raises $1.50 to $2.50
rene1984tsv: calls $2.50
b_____a__242: folds 
Moszes360: folds 
*** FLOP *** [4s 2h Kc]
Kihog: checks 
rene1984tsv: bets $3.09
Kihog: calls $3.09
*** TURN *** [4s 2h Kc] [3d]
Kihog: checks 
rene1984tsv: bets $8
Kihog: calls $8
*** RIVER *** [4s 2h Kc 3d] [8s]
Kihog: checks 
rene1984tsv: checks 
*** SHOW DOWN ***
Kihog: shows [Qc Qh] (a pair of Queens)
rene1984tsv: mucks hand 
Kihog collected $27.25 from pot
*** SUMMARY ***
Total pot $28.68 | Rake $1.43 
Board [4s 2h Kc 3d 8s]
Seat 2: vanilica folded before Flop (didn't bet)
Seat 3: matiko09 folded before Flop (didn't bet)
Seat 4: Strikerman25 folded before Flop (didn't bet)
Seat 5: deadkiller1 folded before Flop (didn't bet)
Seat 6: Kihog showed [Qc Qh] and won ($27.25) with a pair of Queens
Seat 7: rene1984tsv (button) mucked [Ts Ad]
Seat 8: b_____a__242 (small blind) folded before Flop
Seat 9: Moszes360 (big blind) folded before Flop





PokerStars Hand #153506781937:  Hold'em No Limit ($0.50/$1.00 USD) - 2016/05/18 21:56:05 CET [2016/05/18 15:56:05 ET]
Table 'Brendelia II' 9-max Seat #3 is the button
Seat 1: cap. marb ($37.88 in chips) 
Seat 2: rate8 ($104.62 in chips) 
Seat 3: Zeeshka ($101 in chips) 
Seat 4: gkm0nk3y ($106.49 in chips) 
Seat 5: Vulturinus ($61.43 in chips) 
Seat 6: TimStone ($170.72 in chips) 
Seat 7: matiko09 ($101.12 in chips) 
gkm0nk3y: posts small blind $0.50
Vulturinus: posts big blind $1
*** HOLE CARDS ***
Dealt to matiko09 [Jd Kd]
TimStone: raises $1.62 to $2.62
matiko09: folds 
cap. marb: folds 
rate8: folds 
Zeeshka: folds 
gkm0nk3y: folds 
Vulturinus: folds 
Uncalled bet ($1.62) returned to TimStone
TimStone collected $2.50 from pot
TimStone: doesn't show hand 
*** SUMMARY ***
Total pot $2.50 | Rake $0 
Seat 1: cap. marb folded before Flop (didn't bet)
Seat 2: rate8 folded before Flop (didn't bet)
Seat 3: Zeeshka (button) folded before Flop (didn't bet)
Seat 4: gkm0nk3y (small blind) folded before Flop
Seat 5: Vulturinus (big blind) folded before Flop
Seat 6: TimStone collected ($2.50)
Seat 7: matiko09 folded before Flop (didn't bet)





PokerStars Hand #153506804921:  Hold'em No Limit ($0.50/$1.00 USD) - 2016/05/18 21:56:38 CET [2016/05/18 15:56:38 ET]
Table 'Samitchell II' 9-max Seat #8 is the button
Seat 1: riggedsh** ($132.27 in chips) 
Seat 2: Cortine ($113.10 in chips) 
Seat 3: vanilica ($167.75 in chips) 
Seat 4: Zeeshka ($106.77 in chips) 
Seat 5: nuuaber ($52.37 in chips) 
Seat 6: Strikerman25 ($33.41 in chips) 
Seat 7: matiko09 ($116.65 in chips) 
Seat 8: rate8 ($107.98 in chips) 
riggedsh**: posts small blind $0.50
Cortine: posts big blind $1
*** HOLE CARDS ***
Dealt to matiko09 [9d Th]
vanilica: raises $1.85 to $2.85
Zeeshka: folds 
nuuaber: folds 
Strikerman25: folds 
matiko09: folds 
rate8: calls $2.85
riggedsh**: folds 
Cortine: folds 
*** FLOP *** [Ts 8h 2c]
vanilica: checks 
rate8: bets $4.86
vanilica: folds 
Uncalled bet ($4.86) returned to rate8
rate8 collected $6.84 from pot
rate8: doesn't show hand 
*** SUMMARY ***
Total pot $7.20 | Rake $0.36 
Board [Ts 8h 2c]
Seat 1: riggedsh** (small blind) folded before Flop
Seat 2: Cortine (big blind) folded before Flop
Seat 3: vanilica folded on the Flop
Seat 4: Zeeshka folded before Flop (didn't bet)
Seat 5: nuuaber folded before Flop (didn't bet)
Seat 6: Strikerman25 folded before Flop (didn't bet)
Seat 7: matiko09 folded before Flop (didn't bet)
Seat 8: rate8 (button) collected ($6.84)





PokerStars Hand #153506813650:  Hold'em No Limit ($0.50/$1.00 USD) - 2016/05/18 21:56:50 CET [2016/05/18 15:56:50 ET]
Table 'Abetti II' 9-max Seat #8 is the button
Seat 1: matiko09 ($127.91 in chips) 
Seat 2: torkkdnm ($65.48 in chips) 
Seat 6: Kihog ($100 in chips) 
Seat 7: rate8 ($147.28 in chips) 
Seat 8: roadster683 ($162.36 in chips) 
Seat 9: vanilica ($120.11 in chips) 
vanilica: posts small blind $0.50
matiko09: posts big blind $1
cap. marb: sits out 
stepan0605: sits out 
*** HOLE CARDS ***
Dealt to matiko09 [Js 7s]
torkkdnm: folds 
Kihog: raises $1.50 to $2.50
rate8: folds 
roadster683: folds 
vanilica: folds 
matiko09: folds 
Uncalled bet ($1.50) returned to Kihog
Kihog collected $2.50 from pot
Kihog: doesn't show hand 
*** SUMMARY ***
Total pot $2.50 | Rake $0 
Seat 1: matiko09 (big blind) folded before Flop
Seat 2: torkkdnm folded before Flop (didn't bet)
Seat 6: Kihog collected ($2.50)
Seat 7: rate8 folded before Flop (didn't bet)
Seat 8: roadster683 (button) folded before Flop (didn't bet)
Seat 9: vanilica (small blind) folded before Flop





PokerStars Hand #153506814366:  Hold'em No Limit ($0.50/$1.00 USD) - 2016/05/18 21:56:51 CET [2016/05/18 15:56:51 ET]
Table 'Brendelia II' 9-max Seat #4 is the button
Seat 1: cap. marb ($37.88 in chips) 
Seat 2: rate8 ($104.62 in chips) 
Seat 3: Zeeshka ($101 in chips) 
Seat 4: gkm0nk3y ($105.99 in chips) 
Seat 5: Vulturinus ($60.43 in chips) 
Seat 6: TimStone ($172.22 in chips) 
Seat 7: matiko09 ($101.12 in chips) 
Vulturinus: posts small blind $0.50
TimStone: posts big blind $1
solbi86: sits out 
*** HOLE CARDS ***
Dealt to matiko09 [5c 4d]
matiko09: folds 
cap. marb: folds 
rate8: folds 
Zeeshka: folds 
gkm0nk3y: raises $1 to $2
Vulturinus: folds 
TimStone: folds 
Uncalled bet ($1) returned to gkm0nk3y
gkm0nk3y collected $2.50 from pot
*** SUMMARY ***
Total pot $2.50 | Rake $0 
Seat 1: cap. marb folded before Flop (didn't bet)
Seat 2: rate8 folded before Flop (didn't bet)
Seat 3: Zeeshka folded before Flop (didn't bet)
Seat 4: gkm0nk3y (button) collected ($2.50)
Seat 5: Vulturinus (small blind) folded before Flop
Seat 6: TimStone (big blind) folded before Flop
Seat 7: matiko09 folded before Flop (didn't bet)





PokerStars Hand #153506815905:  Hold'em No Limit (€0.50/€1.00 EUR) - 2016/05/18 21:56:53 CET [2016/05/18 15:56:53 ET]
Table 'Pallas II' 9-max Seat #1 is the button
Seat 1: deadkiller1 (€337.57 in chips) 
Seat 2: matiko09 (€117.45 in chips) 
Seat 3: Ouga Buga (€100 in chips) 
Seat 4: torkkdnm (€166.98 in chips) 
Seat 5: florrin92 (€100 in chips) 
Seat 7: rate8 (€120.60 in chips) 
Seat 8: Kihog (€100 in chips) 
Seat 9: stijner1986 (€177.44 in chips) 
matiko09: posts small blind €0.50
Ouga Buga: posts big blind €1
*** HOLE CARDS ***
Dealt to matiko09 [Kh Tc]
torkkdnm: folds 
florrin92: folds 
rate8: raises €2 to €3
Kihog: folds 
stijner1986: folds 
deadkiller1: folds 
matiko09: folds 
Ouga Buga: folds 
Uncalled bet (€2) returned to rate8
rate8 collected €2.50 from pot
*** SUMMARY ***
Total pot €2.50 | Rake €0 
Seat 1: deadkiller1 (button) folded before Flop (didn't bet)
Seat 2: matiko09 (small blind) folded before Flop
Seat 3: Ouga Buga (big blind) folded before Flop
Seat 4: torkkdnm folded before Flop (didn't bet)
Seat 5: florrin92 folded before Flop (didn't bet)
Seat 7: rate8 collected (€2.50)
Seat 8: Kihog folded before Flop (didn't bet)
Seat 9: stijner1986 folded before Flop (didn't bet)





PokerStars Hand #153506832682:  Hold'em No Limit ($0.50/$1.00 USD) - 2016/05/18 21:57:16 CET [2016/05/18 15:57:16 ET]
Table 'Samitchell II' 9-max Seat #1 is the button
Seat 1: riggedsh** ($131.77 in chips) 
Seat 2: Cortine ($112.10 in chips) 
Seat 3: vanilica ($164.90 in chips) 
Seat 4: Zeeshka ($106.77 in chips) 
Seat 5: nuuaber ($52.37 in chips) 
Seat 6: Strikerman25 ($33.41 in chips) 
Seat 7: matiko09 ($116.65 in chips) 
Seat 8: rate8 ($111.97 in chips) 
Cortine: posts small blind $0.50
vanilica: posts big blind $1
*** HOLE CARDS ***
Dealt to matiko09 [5s Qd]
Zeeshka: folds 
nuuaber: raises $1 to $2
Strikerman25: folds 
matiko09: folds 
rate8: raises $5 to $7
riggedsh**: folds 
Cortine: folds 
vanilica: folds 
nuuaber: folds 
Uncalled bet ($5) returned to rate8
rate8 collected $5.50 from pot
rate8: doesn't show hand 
*** SUMMARY ***
Total pot $5.50 | Rake $0 
Seat 1: riggedsh** (button) folded before Flop (didn't bet)
Seat 2: Cortine (small blind) folded before Flop
Seat 3: vanilica (big blind) folded before Flop
Seat 4: Zeeshka folded before Flop (didn't bet)
Seat 5: nuuaber folded before Flop
Seat 6: Strikerman25 folded before Flop (didn't bet)
Seat 7: matiko09 folded before Flop (didn't bet)
Seat 8: rate8 collected ($5.50)





PokerStars Hand #153506833870:  Hold'em No Limit ($0.50/$1.00 USD) - 2016/05/18 21:57:18 CET [2016/05/18 15:57:18 ET]
Table 'Brendelia II' 9-max Seat #5 is the button
Seat 1: cap. marb ($37.88 in chips) 
Seat 2: rate8 ($104.62 in chips) 
Seat 3: Zeeshka ($101 in chips) 
Seat 4: gkm0nk3y ($107.49 in chips) 
Seat 5: Vulturinus ($59.93 in chips) 
Seat 6: TimStone ($171.22 in chips) 
Seat 7: matiko09 ($101.12 in chips) 
TimStone: posts small blind $0.50
matiko09: posts big blind $1
solbi86: sits out 
*** HOLE CARDS ***
Dealt to matiko09 [Qs 7d]
cap. marb: folds 
rate8: raises $2 to $3
Zeeshka: folds 
gkm0nk3y: folds 
Vulturinus: folds 
TimStone: folds 
matiko09: folds 
Uncalled bet ($2) returned to rate8
rate8 collected $2.50 from pot
rate8: doesn't show hand 
*** SUMMARY ***
Total pot $2.50 | Rake $0 
Seat 1: cap. marb folded before Flop (didn't bet)
Seat 2: rate8 collected ($2.50)
Seat 3: Zeeshka folded before Flop (didn't bet)
Seat 4: gkm0nk3y folded before Flop (didn't bet)
Seat 5: Vulturinus (button) folded before Flop (didn't bet)
Seat 6: TimStone (small blind) folded before Flop
Seat 7: matiko09 (big blind) folded before Flop





PokerStars Hand #153506840124:  Hold'em No Limit ($0.50/$1.00 USD) - 2016/05/18 21:57:27 CET [2016/05/18 15:57:27 ET]
Table 'Abetti II' 9-max Seat #9 is the button
Seat 1: matiko09 ($126.91 in chips) 
Seat 3: cap. marb ($40 in chips) 
Seat 6: Kihog ($101.50 in chips) 
Seat 7: rate8 ($147.28 in chips) 
Seat 8: roadster683 ($162.36 in chips) 
Seat 9: vanilica ($119.61 in chips) 
matiko09: posts small blind $0.50
torkkdnm: is sitting out 
cap. marb: posts big blind $1
stepan0605: sits out 
blufthenuts: sits out 
*** HOLE CARDS ***
Dealt to matiko09 [5c 5h]
Kihog: folds 
rate8: folds 
roadster683: raises $1 to $2
vanilica: folds 
matiko09: calls $1.50
cap. marb: folds 
*** FLOP *** [3c 2s 7h]
matiko09: checks 
roadster683: checks 
*** TURN *** [3c 2s 7h] [Kd]
matiko09: checks 
roadster683: checks 
*** RIVER *** [3c 2s 7h Kd] [6d]
matiko09: checks 
roadster683: checks 
*** SHOW DOWN ***
matiko09: shows [5c 5h] (a pair of Fives)
roadster683: mucks hand 
matiko09 collected $4.75 from pot
*** SUMMARY ***
Total pot $5 | Rake $0.25 
Board [3c 2s 7h Kd 6d]
Seat 1: matiko09 (small blind) showed [5c 5h] and won ($4.75) with a pair of Fives
Seat 3: cap. marb (big blind) folded before Flop
Seat 6: Kihog folded before Flop (didn't bet)
Seat 7: rate8 folded before Flop (didn't bet)
Seat 8: roadster683 mucked [Qd Ah]
Seat 9: vanilica (button) folded before Flop (didn't bet)





PokerStars Hand #153506840035:  Hold'em No Limit (€0.50/€1.00 EUR) - 2016/05/18 21:57:27 CET [2016/05/18 15:57:27 ET]
Table 'Pallas II' 9-max Seat #2 is the button
Seat 1: deadkiller1 (€337.57 in chips) 
Seat 2: matiko09 (€116.95 in chips) 
Seat 3: Ouga Buga (€100 in chips) 
Seat 5: florrin92 (€100 in chips) 
Seat 7: rate8 (€122.10 in chips) 
Seat 8: Kihog (€100 in chips) 
Seat 9: stijner1986 (€177.44 in chips) 
Ouga Buga: posts small blind €0.50
torkkdnm: is sitting out 
florrin92: posts big blind €1
*** HOLE CARDS ***
Dealt to matiko09 [Qh As]
rate8: folds 
Kihog: folds 
stijner1986: folds 
deadkiller1: folds 
matiko09: raises €1.27 to €2.27
Ouga Buga: raises €5.54 to €7.81
florrin92: folds 
matiko09: calls €5.54
*** FLOP *** [Tc Js 9h]
Ouga Buga: checks 
matiko09: bets €9
torkkdnm leaves the table
Ouga Buga: calls €9
*** TURN *** [Tc Js 9h] [Ah]
Ouga Buga: checks 
matiko09: checks 
*** RIVER *** [Tc Js 9h Ah] [6s]
Ouga Buga: bets €21.70
matiko09: calls €21.70
*** SHOW DOWN ***
Ouga Buga: shows [Ad Jc] (two pair, Aces and Jacks)
matiko09: mucks hand 
Ouga Buga collected €75.77 from pot
*** SUMMARY ***
Total pot €78.02 | Rake €2.25 
Board [Tc Js 9h Ah 6s]
Seat 1: deadkiller1 folded before Flop (didn't bet)
Seat 2: matiko09 (button) mucked [Qh As]
Seat 3: Ouga Buga (small blind) showed [Ad Jc] and won (€75.77) with two pair, Aces and Jacks
Seat 5: florrin92 (big blind) folded before Flop
Seat 7: rate8 folded before Flop (didn't bet)
Seat 8: Kihog folded before Flop (didn't bet)
Seat 9: stijner1986 folded before Flop (didn't bet)





PokerStars Hand #153506845908:  Hold'em No Limit ($0.50/$1.00 USD) - 2016/05/18 21:57:35 CET [2016/05/18 15:57:35 ET]
Table 'Tatjana III' 9-max Seat #8 is the button
Seat 1: cap. marb ($40 in chips) 
Seat 2: vanilica ($104.52 in chips) 
Seat 3: matiko09 ($189.02 in chips) 
Seat 4: Strikerman25 ($44.96 in chips) 
Seat 5: deadkiller1 ($100.88 in chips) 
Seat 6: Kihog ($114.63 in chips) 
Seat 7: rene1984tsv ($213.90 in chips) 
Seat 8: b_____a__242 ($79.56 in chips) 
Seat 9: Moszes360 ($102.61 in chips) 
Moszes360: posts small blind $0.50
cap. marb: posts big blind $1
*** HOLE CARDS ***
Dealt to matiko09 [4s Td]
vanilica: folds 
matiko09: folds 
Strikerman25: raises $2 to $3
deadkiller1: folds 
Kihog: folds 
rene1984tsv: calls $3
b_____a__242: folds 
Moszes360: folds 
cap. marb: folds 
*** FLOP *** [Jd Th 9h]
Strikerman25: bets $5.50
rene1984tsv: folds 
Uncalled bet ($5.50) returned to Strikerman25
Strikerman25 collected $7.12 from pot
Strikerman25: doesn't show hand 
*** SUMMARY ***
Total pot $7.50 | Rake $0.38 
Board [Jd Th 9h]
Seat 1: cap. marb (big blind) folded before Flop
Seat 2: vanilica folded before Flop (didn't bet)
Seat 3: matiko09 folded before Flop (didn't bet)
Seat 4: Strikerman25 collected ($7.12)
Seat 5: deadkiller1 folded before Flop (didn't bet)
Seat 6: Kihog folded before Flop (didn't bet)
Seat 7: rene1984tsv folded on the Flop
Seat 8: b_____a__242 (button) folded before Flop (didn't bet)
Seat 9: Moszes360 (small blind) folded before Flop





PokerStars Hand #153506849060:  Hold'em No Limit ($0.50/$1.00 USD) - 2016/05/18 21:57:39 CET [2016/05/18 15:57:39 ET]
Table 'Samitchell II' 9-max Seat #2 is the button
Seat 1: riggedsh** ($131.77 in chips) 
Seat 2: Cortine ($111.60 in chips) 
Seat 3: vanilica ($163.90 in chips) 
Seat 4: Zeeshka ($106.77 in chips) 
Seat 5: nuuaber ($50.37 in chips) 
Seat 6: Strikerman25 ($33.41 in chips) 
Seat 7: matiko09 ($116.65 in chips) 
Seat 8: rate8 ($115.47 in chips) 
vanilica: posts small blind $0.50
Zeeshka: posts big blind $1
*** HOLE CARDS ***
Dealt to matiko09 [4d 5c]
nuuaber: folds 
Strikerman25: folds 
matiko09: folds 
rate8: folds 
riggedsh**: folds 
Cortine: folds 
vanilica: folds 
Uncalled bet ($0.50) returned to Zeeshka
Zeeshka collected $1 from pot
Zeeshka: doesn't show hand 
*** SUMMARY ***
Total pot $1 | Rake $0 
Seat 1: riggedsh** folded before Flop (didn't bet)
Seat 2: Cortine (button) folded before Flop (didn't bet)
Seat 3: vanilica (small blind) folded before Flop
Seat 4: Zeeshka (big blind) collected ($1)
Seat 5: nuuaber folded before Flop (didn't bet)
Seat 6: Strikerman25 folded before Flop (didn't bet)
Seat 7: matiko09 folded before Flop (didn't bet)
Seat 8: rate8 folded before Flop (didn't bet)





PokerStars Hand #153506876118:  Hold'em No Limit ($0.50/$1.00 USD) - 2016/05/18 21:58:18 CET [2016/05/18 15:58:18 ET]
Table 'Samitchell II' 9-max Seat #3 is the button
Seat 1: riggedsh** ($131.77 in chips) 
Seat 2: Cortine ($111.60 in chips) 
Seat 3: vanilica ($163.40 in chips) 
Seat 4: Zeeshka ($107.27 in chips) 
Seat 5: nuuaber ($50.37 in chips) 
Seat 6: Strikerman25 ($33.41 in chips) 
Seat 7: matiko09 ($116.65 in chips) 
Seat 8: rate8 ($115.47 in chips) 
Zeeshka: posts small blind $0.50
nuuaber: posts big blind $1
*** HOLE CARDS ***
Dealt to matiko09 [4d 4s]
Strikerman25: folds 
matiko09: raises $2 to $3
rate8: folds 
riggedsh**: folds 
Cortine: folds 
vanilica: folds 
Zeeshka: folds 
nuuaber: folds 
Uncalled bet ($2) returned to matiko09
matiko09 collected $2.50 from pot
matiko09: doesn't show hand 
*** SUMMARY ***
Total pot $2.50 | Rake $0 
Seat 1: riggedsh** folded before Flop (didn't bet)
Seat 2: Cortine folded before Flop (didn't bet)
Seat 3: vanilica (button) folded before Flop (didn't bet)
Seat 4: Zeeshka (small blind) folded before Flop
Seat 5: nuuaber (big blind) folded before Flop
Seat 6: Strikerman25 folded before Flop (didn't bet)
Seat 7: matiko09 collected ($2.50)
Seat 8: rate8 folded before Flop (didn't bet)





PokerStars Hand #153506876806:  Hold'em No Limit ($0.50/$1.00 USD) - 2016/05/18 21:58:19 CET [2016/05/18 15:58:19 ET]
Table 'Brendelia II' 9-max Seat #6 is the button
Seat 1: cap. marb ($37.88 in chips) 
Seat 2: rate8 ($106.12 in chips) 
Seat 3: Zeeshka ($101 in chips) 
Seat 4: gkm0nk3y ($107.49 in chips) 
Seat 5: Vulturinus ($59.93 in chips) 
Seat 6: TimStone ($170.72 in chips) 
Seat 7: matiko09 ($100.12 in chips) 
Seat 8: solbi86 ($130.35 in chips) 
matiko09: posts small blind $0.50
solbi86: posts big blind $1
*** HOLE CARDS ***
Dealt to matiko09 [2h Jh]
cap. marb: folds 
rate8: folds 
Zeeshka: raises $2 to $3
gkm0nk3y: folds 
Vulturinus: folds 
TimStone: folds 
matiko09: folds 
solbi86: folds 
Uncalled bet ($2) returned to Zeeshka
Zeeshka collected $2.50 from pot
Zeeshka: doesn't show hand 
*** SUMMARY ***
Total pot $2.50 | Rake $0 
Seat 1: cap. marb folded before Flop (didn't bet)
Seat 2: rate8 folded before Flop (didn't bet)
Seat 3: Zeeshka collected ($2.50)
Seat 4: gkm0nk3y folded before Flop (didn't bet)
Seat 5: Vulturinus folded before Flop (didn't bet)
Seat 6: TimStone (button) folded before Flop (didn't bet)
Seat 7: matiko09 (small blind) folded before Flop
Seat 8: solbi86 (big blind) folded before Flop





PokerStars Hand #153506876830:  Hold'em No Limit ($0.50/$1.00 USD) - 2016/05/18 21:58:19 CET [2016/05/18 15:58:19 ET]
Table 'Tatjana III' 9-max Seat #9 is the button
Seat 1: cap. marb ($39 in chips) 
Seat 2: vanilica ($104.52 in chips) 
Seat 3: matiko09 ($189.02 in chips) 
Seat 4: Strikerman25 ($49.08 in chips) 
Seat 5: deadkiller1 ($100.88 in chips) 
Seat 6: Kihog ($114.63 in chips) 
Seat 7: rene1984tsv ($210.90 in chips) 
Seat 8: b_____a__242 ($79.56 in chips) 
Seat 9: Moszes360 ($102.11 in chips) 
cap. marb: posts small blind $0.50
vanilica: posts big blind $1
*** HOLE CARDS ***
Dealt to matiko09 [8s 5c]
matiko09: folds 
Strikerman25: raises $1.50 to $2.50
deadkiller1: folds 
Kihog: folds 
rene1984tsv: folds 
b_____a__242: folds 
Moszes360: folds 
cap. marb: folds 
vanilica: folds 
Uncalled bet ($1.50) returned to Strikerman25
Strikerman25 collected $2.50 from pot
Strikerman25: doesn't show hand 
*** SUMMARY ***
Total pot $2.50 | Rake $0 
Seat 1: cap. marb (small blind) folded before Flop
Seat 2: vanilica (big blind) folded before Flop
Seat 3: matiko09 folded before Flop (didn't bet)
Seat 4: Strikerman25 collected ($2.50)
Seat 5: deadkiller1 folded before Flop (didn't bet)
Seat 6: Kihog folded before Flop (didn't bet)
Seat 7: rene1984tsv folded before Flop (didn't bet)
Seat 8: b_____a__242 folded before Flop (didn't bet)
Seat 9: Moszes360 (button) folded before Flop (didn't bet)





PokerStars Hand #153506880403:  Hold'em No Limit ($0.50/$1.00 USD) - 2016/05/18 21:58:24 CET [2016/05/18 15:58:24 ET]
Table 'Abetti II' 9-max Seat #1 is the button
Seat 1: matiko09 ($129.66 in chips) 
Seat 3: cap. marb ($39 in chips) 
Seat 4: stepan0605 ($100 in chips) 
Seat 6: Kihog ($101.50 in chips) 
Seat 7: rate8 ($147.28 in chips) 
Seat 8: roadster683 ($160.36 in chips) 
Seat 9: vanilica ($119.61 in chips) 
cap. marb: posts small blind $0.50
stepan0605: posts big blind $1
blufthenuts: sits out 
*** HOLE CARDS ***
Dealt to matiko09 [Qc 6h]
Kihog: folds 
rate8: folds 
roadster683: raises $1 to $2
torkkdnm leaves the table
vanilica: folds 
matiko09: folds 
Cortine joins the table at seat #2 
cap. marb: folds 
stepan0605: folds 
Uncalled bet ($1) returned to roadster683
roadster683 collected $2.50 from pot
roadster683: doesn't show hand 
*** SUMMARY ***
Total pot $2.50 | Rake $0 
Seat 1: matiko09 (button) folded before Flop (didn't bet)
Seat 3: cap. marb (small blind) folded before Flop
Seat 4: stepan0605 (big blind) folded before Flop
Seat 6: Kihog folded before Flop (didn't bet)
Seat 7: rate8 folded before Flop (didn't bet)
Seat 8: roadster683 collected ($2.50)
Seat 9: vanilica folded before Flop (didn't bet)





PokerStars Hand #153506900025:  Hold'em No Limit ($0.50/$1.00 USD) - 2016/05/18 21:58:51 CET [2016/05/18 15:58:51 ET]
Table 'Brendelia II' 9-max Seat #7 is the button
Seat 1: cap. marb ($37.88 in chips) 
Seat 2: rate8 ($106.12 in chips) 
Seat 3: Zeeshka ($102.50 in chips) 
Seat 4: gkm0nk3y ($107.49 in chips) 
Seat 5: Vulturinus ($59.93 in chips) 
Seat 6: TimStone ($170.72 in chips) 
Seat 7: matiko09 ($100 in chips) 
Seat 8: solbi86 ($129.35 in chips) 
solbi86: posts small blind $0.50
cap. marb: posts big blind $1
*** HOLE CARDS ***
Dealt to matiko09 [Ah 7c]
rate8: raises $2 to $3
Zeeshka: folds 
gkm0nk3y: folds 
Vulturinus: folds 
TimStone: folds 
matiko09: folds 
solbi86: folds 
cap. marb: folds 
Uncalled bet ($2) returned to rate8
rate8 collected $2.50 from pot
*** SUMMARY ***
Total pot $2.50 | Rake $0 
Seat 1: cap. marb (big blind) folded before Flop
Seat 2: rate8 collected ($2.50)
Seat 3: Zeeshka folded before Flop (didn't bet)
Seat 4: gkm0nk3y folded before Flop (didn't bet)
Seat 5: Vulturinus folded before Flop (didn't bet)
Seat 6: TimStone folded before Flop (didn't bet)
Seat 7: matiko09 (button) folded before Flop (didn't bet)
Seat 8: solbi86 (small blind) folded before Flop





PokerStars Hand #153506899799:  Hold'em No Limit ($0.50/$1.00 USD) - 2016/05/18 21:58:51 CET [2016/05/18 15:58:51 ET]
Table 'Tatjana III' 9-max Seat #1 is the button
Seat 1: cap. marb ($38.50 in chips) 
Seat 2: vanilica ($103.52 in chips) 
Seat 3: matiko09 ($189.02 in chips) 
Seat 4: Strikerman25 ($50.58 in chips) 
Seat 5: deadkiller1 ($100.88 in chips) 
Seat 6: Kihog ($114.63 in chips) 
Seat 7: rene1984tsv ($210.90 in chips) 
Seat 8: b_____a__242 ($79.56 in chips) 
Seat 9: Moszes360 ($102.11 in chips) 
vanilica: posts small blind $0.50
matiko09: posts big blind $1
*** HOLE CARDS ***
Dealt to matiko09 [Js 8d]
Strikerman25: folds 
deadkiller1: folds 
Kihog: folds 
rene1984tsv: raises $2 to $3
b_____a__242: folds 
Moszes360: folds 
cap. marb: folds 
vanilica: folds 
matiko09: folds 
Uncalled bet ($2) returned to rene1984tsv
rene1984tsv collected $2.50 from pot
rene1984tsv: doesn't show hand 
*** SUMMARY ***
Total pot $2.50 | Rake $0 
Seat 1: cap. marb (button) folded before Flop (didn't bet)
Seat 2: vanilica (small blind) folded before Flop
Seat 3: matiko09 (big blind) folded before Flop
Seat 4: Strikerman25 folded before Flop (didn't bet)
Seat 5: deadkiller1 folded before Flop (didn't bet)
Seat 6: Kihog folded before Flop (didn't bet)
Seat 7: rene1984tsv collected ($2.50)
Seat 8: b_____a__242 folded before Flop (didn't bet)
Seat 9: Moszes360 folded before Flop (didn't bet)





PokerStars Hand #153506904258:  Hold'em No Limit ($0.50/$1.00 USD) - 2016/05/18 21:58:57 CET [2016/05/18 15:58:57 ET]
Table 'Samitchell II' 9-max Seat #4 is the button
Seat 1: riggedsh** ($131.77 in chips) 
Seat 2: Cortine ($111.60 in chips) 
Seat 3: vanilica ($163.40 in chips) 
Seat 4: Zeeshka ($106.77 in chips) 
Seat 5: nuuaber ($49.37 in chips) 
Seat 6: Strikerman25 ($33.41 in chips) 
Seat 7: matiko09 ($118.15 in chips) 
Seat 8: rate8 ($115.47 in chips) 
nuuaber: posts small blind $0.50
Strikerman25: posts big blind $1
*** HOLE CARDS ***
Dealt to matiko09 [5d Kh]
matiko09: folds 
rate8: folds 
riggedsh**: folds 
Cortine: folds 
vanilica: folds 
Zeeshka: raises $1.50 to $2.50
nuuaber: folds 
Strikerman25: folds 
Uncalled bet ($1.50) returned to Zeeshka
Zeeshka collected $2.50 from pot
Zeeshka: doesn't show hand 
*** SUMMARY ***
Total pot $2.50 | Rake $0 
Seat 1: riggedsh** folded before Flop (didn't bet)
Seat 2: Cortine folded before Flop (didn't bet)
Seat 3: vanilica folded before Flop (didn't bet)
Seat 4: Zeeshka (button) collected ($2.50)
Seat 5: nuuaber (small blind) folded before Flop
Seat 6: Strikerman25 (big blind) folded before Flop
Seat 7: matiko09 folded before Flop (didn't bet)
Seat 8: rate8 folded before Flop (didn't bet)





PokerStars Hand #153506907488:  Hold'em No Limit ($0.50/$1.00 USD) - 2016/05/18 21:59:02 CET [2016/05/18 15:59:02 ET]
Table 'Abetti II' 9-max Seat #3 is the button
Seat 1: matiko09 ($129.66 in chips) 
Seat 3: cap. marb ($38.50 in chips) 
Seat 4: stepan0605 ($100 in chips) 
Seat 5: blufthenuts ($160.17 in chips) 
Seat 6: Kihog ($101.50 in chips) 
Seat 7: rate8 ($147.28 in chips) 
Seat 8: roadster683 ($161.86 in chips) 
Seat 9: vanilica ($119.61 in chips) 
stepan0605: posts small blind $0.50
blufthenuts: posts big blind $1
Cortine: sits out 
*** HOLE CARDS ***
Dealt to matiko09 [6c 3d]
Kihog: folds 
rate8: folds 
roadster683: calls $1
vanilica: folds 
matiko09: folds 
cap. marb: folds 
stepan0605: folds 
blufthenuts: checks 
*** FLOP *** [4c 2d Kd]
blufthenuts: bets $2
roadster683: calls $2
*** TURN *** [4c 2d Kd] [6d]
blufthenuts: bets $1
roadster683: calls $1
*** RIVER *** [4c 2d Kd 6d] [5s]
blufthenuts: checks 
roadster683: checks 
*** SHOW DOWN ***
blufthenuts: shows [Kc 2s] (two pair, Kings and Deuces)
roadster683: mucks hand 
blufthenuts collected $8.08 from pot
*** SUMMARY ***
Total pot $8.50 | Rake $0.42 
Board [4c 2d Kd 6d 5s]
Seat 1: matiko09 folded before Flop (didn't bet)
Seat 3: cap. marb (button) folded before Flop (didn't bet)
Seat 4: stepan0605 (small blind) folded before Flop
Seat 5: blufthenuts (big blind) showed [Kc 2s] and won ($8.08) with two pair, Kings and Deuces
Seat 6: Kihog folded before Flop (didn't bet)
Seat 7: rate8 folded before Flop (didn't bet)
Seat 8: roadster683 mucked [4h Ah]
Seat 9: vanilica folded before Flop (didn't bet)





PokerStars Hand #153506926662:  Hold'em No Limit (€0.50/€1.00 EUR) - 2016/05/18 21:59:29 CET [2016/05/18 15:59:29 ET]
Table 'Pallas II' 9-max Seat #3 is the button
Seat 1: deadkiller1 (€337.57 in chips) 
Seat 2: matiko09 (€100 in chips) 
Seat 3: Ouga Buga (€137.26 in chips) 
Seat 5: florrin92 (€100 in chips) 
Seat 8: Kihog (€100 in chips) 
Seat 9: stijner1986 (€177.44 in chips) 
florrin92: posts small blind €0.50
rate8: is sitting out 
Kihog: posts big blind €1
*** HOLE CARDS ***
Dealt to matiko09 [Ts Tc]
stijner1986: calls €1
deadkiller1: folds 
matiko09: raises €3 to €4
Ouga Buga: folds 
florrin92: folds 
Strikerman25 joins the table at seat #4 
Kihog: folds 
stijner1986: calls €3
*** FLOP *** [3c 8s 7d]
stijner1986: checks 
matiko09: bets €6
stijner1986: folds 
Uncalled bet (€6) returned to matiko09
matiko09 collected €9.02 from pot
matiko09: doesn't show hand 
*** SUMMARY ***
Total pot €9.50 | Rake €0.48 
Board [3c 8s 7d]
Seat 1: deadkiller1 folded before Flop (didn't bet)
Seat 2: matiko09 collected (€9.02)
Seat 3: Ouga Buga (button) folded before Flop (didn't bet)
Seat 5: florrin92 (small blind) folded before Flop
Seat 8: Kihog (big blind) folded before Flop
Seat 9: stijner1986 folded on the Flop





PokerStars Hand #153506933284:  Hold'em No Limit ($0.50/$1.00 USD) - 2016/05/18 21:59:38 CET [2016/05/18 15:59:38 ET]
Table 'Brendelia II' 9-max Seat #8 is the button
Seat 1: cap. marb ($36.88 in chips) 
Seat 3: Zeeshka ($102.50 in chips) 
Seat 4: gkm0nk3y ($107.49 in chips) 
Seat 5: Vulturinus ($59.93 in chips) 
Seat 6: TimStone ($170.72 in chips) 
Seat 7: matiko09 ($100 in chips) 
Seat 8: solbi86 ($128.85 in chips) 
cap. marb: posts small blind $0.50
rate8: is sitting out 
Zeeshka: posts big blind $1
*** HOLE CARDS ***
Dealt to matiko09 [Qd 5d]
gkm0nk3y: folds 
Vulturinus: folds 
TimStone: folds 
matiko09: folds 
solbi86: folds 
cap. marb: raises $1.50 to $2.50
Zeeshka: folds 
Uncalled bet ($1.50) returned to cap. marb
cap. marb collected $2 from pot
cap. marb: doesn't show hand 
*** SUMMARY ***
Total pot $2 | Rake $0 
Seat 1: cap. marb (small blind) collected ($2)
Seat 3: Zeeshka (big blind) folded before Flop
Seat 4: gkm0nk3y folded before Flop (didn't bet)
Seat 5: Vulturinus folded before Flop (didn't bet)
Seat 6: TimStone folded before Flop (didn't bet)
Seat 7: matiko09 folded before Flop (didn't bet)
Seat 8: solbi86 (button) folded before Flop (didn't bet)





PokerStars Hand #153506934098:  Hold'em No Limit ($0.50/$1.00 USD) - 2016/05/18 21:59:39 CET [2016/05/18 15:59:39 ET]
Table 'Tatjana III' 9-max Seat #2 is the button
Seat 1: cap. marb ($38.50 in chips) 
Seat 2: vanilica ($103.02 in chips) 
Seat 3: matiko09 ($188.02 in chips) 
Seat 4: Strikerman25 ($50.58 in chips) 
Seat 5: deadkiller1 ($100.88 in chips) 
Seat 6: Kihog ($114.63 in chips) 
Seat 7: rene1984tsv ($212.40 in chips) 
Seat 8: b_____a__242 ($79.56 in chips) 
Seat 9: Moszes360 ($102.11 in chips) 
matiko09: posts small blind $0.50
Strikerman25: posts big blind $1
*** HOLE CARDS ***
Dealt to matiko09 [9d 4h]
deadkiller1: folds 
Kihog: folds 
rene1984tsv: calls $1
b_____a__242: folds 
Moszes360: folds 
cap. marb: folds 
vanilica: raises $3.50 to $4.50
matiko09: folds 
Strikerman25: raises $7 to $11.50
rene1984tsv: folds 
vanilica: raises $33.50 to $45
Strikerman25: folds 
Uncalled bet ($33.50) returned to vanilica
vanilica collected $24.50 from pot
vanilica: doesn't show hand 
*** SUMMARY ***
Total pot $24.50 | Rake $0 
Seat 1: cap. marb folded before Flop (didn't bet)
Seat 2: vanilica (button) collected ($24.50)
Seat 3: matiko09 (small blind) folded before Flop
Seat 4: Strikerman25 (big blind) folded before Flop
Seat 5: deadkiller1 folded before Flop (didn't bet)
Seat 6: Kihog folded before Flop (didn't bet)
Seat 7: rene1984tsv folded before Flop
Seat 8: b_____a__242 folded before Flop (didn't bet)
Seat 9: Moszes360 folded before Flop (didn't bet)





PokerStars Hand #153507377031:  Hold'em No Limit (€0.50/€1.00 EUR) - 2016/05/18 22:07:53 CET [2016/05/18 16:07:53 ET]
Table 'Pallas II' 9-max Seat #7 is the button
Seat 1: deadkiller1 (€497.34 in chips) 
Seat 2: matiko09 (€105.02 in chips) 
Seat 3: Ouga Buga (€135.76 in chips) 
Seat 4: Strikerman25 (€45.62 in chips) 
Seat 5: florrin92 (€102.63 in chips) 
Seat 6: janarr5 (€107.67 in chips) 
Seat 7: rate8 (€120.60 in chips) 
deadkiller1: posts small blind €0.50
matiko09: posts big blind €1
*** HOLE CARDS ***
Dealt to matiko09 [Ah Jh]
Ouga Buga: raises €1.50 to €2.50
Strikerman25: folds 
stijner1986 leaves the table
florrin92: folds 
Ty Nick 420 joins the table at seat #8 
Ty Nick 420 leaves the table
janarr5: raises €6.50 to €9
rate8: folds 
deadkiller1: folds 
matiko09: folds 
Ouga Buga: calls €6.50
*** FLOP *** [2s 2d 4h]
Ouga Buga: checks 
janarr5: bets €10
Ouga Buga: folds 
Uncalled bet (€10) returned to janarr5
janarr5 collected €18.52 from pot
janarr5: doesn't show hand 
*** SUMMARY ***
Total pot €19.50 | Rake €0.98 
Board [2s 2d 4h]
Seat 1: deadkiller1 (small blind) folded before Flop
Seat 2: matiko09 (big blind) folded before Flop
Seat 3: Ouga Buga folded on the Flop
Seat 4: Strikerman25 folded before Flop (didn't bet)
Seat 5: florrin92 folded before Flop (didn't bet)
Seat 6: janarr5 collected (€18.52)
Seat 7: rate8 (button) folded before Flop (didn't bet)





PokerStars Hand #153507409630:  Hold'em No Limit ($0.50/$1.00 USD) - 2016/05/18 22:08:28 CET [2016/05/18 16:08:28 ET]
Table 'Tatjana III' 9-max Seat #1 is the button
Seat 1: cap. marb ($49.70 in chips) 
Seat 2: vanilica ($108.52 in chips) 
Seat 3: matiko09 ($187.52 in chips) 
Seat 4: Strikerman25 ($35.58 in chips) 
Seat 5: deadkiller1 ($112.93 in chips) 
Seat 6: maunzz ($100 in chips) 
Seat 7: rene1984tsv ($211.24 in chips) 
Seat 8: florrin92 ($100 in chips) 
Seat 9: Moszes360 ($107 in chips) 
vanilica: posts small blind $0.50
matiko09: posts big blind $1
*** HOLE CARDS ***
Dealt to matiko09 [3c 6c]
Strikerman25: raises $2 to $3
deadkiller1: folds 
maunzz: folds 
rene1984tsv: calls $3
florrin92: folds 
Moszes360: folds 
cap. marb: folds 
vanilica: calls $2.50
matiko09: folds 
*** FLOP *** [5s Ac 2d]
vanilica: checks 
Strikerman25: bets $5.69
rene1984tsv: calls $5.69
vanilica: folds 
*** TURN *** [5s Ac 2d] [Qs]
Strikerman25: checks 
rene1984tsv: bets $10.15
Strikerman25: folds 
Uncalled bet ($10.15) returned to rene1984tsv
rene1984tsv collected $20.31 from pot
rene1984tsv: shows [5c 6s] (a pair of Fives)
*** SUMMARY ***
Total pot $21.38 | Rake $1.07 
Board [5s Ac 2d Qs]
Seat 1: cap. marb (button) folded before Flop (didn't bet)
Seat 2: vanilica (small blind) folded on the Flop
Seat 3: matiko09 (big blind) folded before Flop
Seat 4: Strikerman25 folded on the Turn
Seat 5: deadkiller1 folded before Flop (didn't bet)
Seat 6: maunzz folded before Flop (didn't bet)
Seat 7: rene1984tsv collected ($20.31)
Seat 8: florrin92 folded before Flop (didn't bet)
Seat 9: Moszes360 folded before Flop (didn't bet)





PokerStars Hand #153507456664:  Hold'em No Limit (€0.50/€1.00 EUR) - 2016/05/18 22:09:18 CET [2016/05/18 16:09:18 ET]
Table 'Pallas II' 9-max Seat #1 is the button
Seat 1: deadkiller1 (€496.84 in chips) 
Seat 2: matiko09 (€104.02 in chips) 
Seat 6: janarr5 (€117.19 in chips) 
Seat 7: rate8 (€120.60 in chips) 
matiko09: posts small blind €0.50
Ouga Buga: is sitting out 
Strikerman25: is sitting out 
florrin92: is sitting out 
Strikerman25 leaves the table
Ouga Buga leaves the table
janarr5: posts big blind €1
*** HOLE CARDS ***
Dealt to matiko09 [Kh Kc]
florrin92 leaves the table
rate8: folds 
deadkiller1: folds 
matiko09: raises €1.50 to €2.50
rate8 leaves the table
janarr5: folds 
Uncalled bet (€1.50) returned to matiko09
janarr5 leaves the table
matiko09 collected €2 from pot
matiko09: doesn't show hand 
*** SUMMARY ***
Total pot €2 | Rake €0 
Seat 1: deadkiller1 (button) folded before Flop (didn't bet)
Seat 2: matiko09 (small blind) collected (€2)
Seat 6: janarr5 (big blind) folded before Flop
Seat 7: rate8 folded before Flop (didn't bet)





PokerStars Hand #153507475611:  Hold'em No Limit ($0.50/$1.00 USD) - 2016/05/18 22:09:39 CET [2016/05/18 16:09:39 ET]
Table 'Tatjana III' 9-max Seat #2 is the button
Seat 1: cap. marb ($49.70 in chips) 
Seat 2: vanilica ($105.52 in chips) 
Seat 3: matiko09 ($186.52 in chips) 
Seat 4: Strikerman25 ($26.89 in chips) 
Seat 5: deadkiller1 ($112.93 in chips) 
Seat 6: maunzz ($100 in chips) 
Seat 7: rene1984tsv ($222.86 in chips) 
Seat 8: florrin92 ($100 in chips) 
Seat 9: Moszes360 ($107 in chips) 
matiko09: posts small blind $0.50
Strikerman25: posts big blind $1
*** HOLE CARDS ***
Dealt to matiko09 [Qs 9d]
deadkiller1: raises $2 to $3
maunzz: folds 
rene1984tsv: calls $3
florrin92: folds 
Moszes360: folds 
cap. marb: folds 
vanilica: folds 
matiko09: folds 
Strikerman25: folds 
*** FLOP *** [8d 5s 2d]
deadkiller1: checks 
rene1984tsv: bets $3.56
deadkiller1: folds 
Uncalled bet ($3.56) returned to rene1984tsv
rene1984tsv collected $7.12 from pot
rene1984tsv: doesn't show hand 
*** SUMMARY ***
Total pot $7.50 | Rake $0.38 
Board [8d 5s 2d]
Seat 1: cap. marb folded before Flop (didn't bet)
Seat 2: vanilica (button) folded before Flop (didn't bet)
Seat 3: matiko09 (small blind) folded before Flop
Seat 4: Strikerman25 (big blind) folded before Flop
Seat 5: deadkiller1 folded on the Flop
Seat 6: maunzz folded before Flop (didn't bet)
Seat 7: rene1984tsv collected ($7.12)
Seat 8: florrin92 folded before Flop (didn't bet)
Seat 9: Moszes360 folded before Flop (didn't bet)





PokerStars Hand #153507485385:  Hold'em No Limit ($0.50/$1.00 USD) - 2016/05/18 22:09:49 CET [2016/05/18 16:09:49 ET]
Table 'Abetti II' 9-max Seat #8 is the button
Seat 1: matiko09 ($129.66 in chips) 
Seat 2: Cortine ($100 in chips) 
Seat 3: cap. marb ($72.26 in chips) 
Seat 4: stepan0605 ($215 in chips) 
Seat 5: blufthenuts ($165.75 in chips) 
Seat 6: florrin92 ($100 in chips) 
Seat 7: rate8 ($145.78 in chips) 
Seat 8: roadster683 ($19.54 in chips) 
Seat 9: vanilica ($143.61 in chips) 
vanilica: posts small blind $0.50
matiko09: posts big blind $1
*** HOLE CARDS ***
Dealt to matiko09 [Ac 2c]
Cortine: folds 
cap. marb: folds 
stepan0605: folds 
blufthenuts: raises $2 to $3
florrin92: folds 
rate8: folds 
roadster683: folds 
vanilica: folds 
matiko09: folds 
Uncalled bet ($2) returned to blufthenuts
blufthenuts collected $2.50 from pot
blufthenuts: doesn't show hand 
*** SUMMARY ***
Total pot $2.50 | Rake $0 
Seat 1: matiko09 (big blind) folded before Flop
Seat 2: Cortine folded before Flop (didn't bet)
Seat 3: cap. marb folded before Flop (didn't bet)
Seat 4: stepan0605 folded before Flop (didn't bet)
Seat 5: blufthenuts collected ($2.50)
Seat 6: florrin92 folded before Flop (didn't bet)
Seat 7: rate8 folded before Flop (didn't bet)
Seat 8: roadster683 (button) folded before Flop (didn't bet)
Seat 9: vanilica (small blind) folded before Flop





PokerStars Hand #153507513508:  Hold'em No Limit ($0.50/$1.00 USD) - 2016/05/18 22:10:20 CET [2016/05/18 16:10:20 ET]
Table 'Tatjana III' 9-max Seat #3 is the button
Seat 1: cap. marb ($49.70 in chips) 
Seat 2: vanilica ($105.52 in chips) 
Seat 3: matiko09 ($186.02 in chips) 
Seat 4: Strikerman25 ($25.89 in chips) 
Seat 5: deadkiller1 ($109.93 in chips) 
Seat 6: maunzz ($100 in chips) 
Seat 7: rene1984tsv ($226.98 in chips) 
Seat 8: florrin92 ($100 in chips) 
Seat 9: Moszes360 ($107 in chips) 
Strikerman25: posts small blind $0.50
deadkiller1: posts big blind $1
*** HOLE CARDS ***
Dealt to matiko09 [5d 9h]
maunzz: raises $2 to $3
rene1984tsv: calls $3
florrin92: folds 
Moszes360: folds 
cap. marb: folds 
vanilica: folds 
matiko09: folds 
Strikerman25: folds 
deadkiller1: folds 
*** FLOP *** [Th 7d 9s]
maunzz: checks 
rene1984tsv: bets $3.56
maunzz: folds 
Uncalled bet ($3.56) returned to rene1984tsv
rene1984tsv collected $7.12 from pot
rene1984tsv: shows [7h Ad] (a pair of Sevens)
*** SUMMARY ***
Total pot $7.50 | Rake $0.38 
Board [Th 7d 9s]
Seat 1: cap. marb folded before Flop (didn't bet)
Seat 2: vanilica folded before Flop (didn't bet)
Seat 3: matiko09 (button) folded before Flop (didn't bet)
Seat 4: Strikerman25 (small blind) folded before Flop
Seat 5: deadkiller1 (big blind) folded before Flop
Seat 6: maunzz folded on the Flop
Seat 7: rene1984tsv collected ($7.12)
Seat 8: florrin92 folded before Flop (didn't bet)
Seat 9: Moszes360 folded before Flop (didn't bet)





PokerStars Hand #153507515169:  Hold'em No Limit ($0.50/$1.00 USD) - 2016/05/18 22:10:22 CET [2016/05/18 16:10:22 ET]
Table 'Abetti II' 9-max Seat #9 is the button
Seat 1: matiko09 ($128.66 in chips) 
Seat 2: Cortine ($100 in chips) 
Seat 3: cap. marb ($72.26 in chips) 
Seat 4: stepan0605 ($215 in chips) 
Seat 5: blufthenuts ($167.25 in chips) 
Seat 6: florrin92 ($100 in chips) 
Seat 7: rate8 ($145.78 in chips) 
Seat 8: roadster683 ($19.54 in chips) 
Seat 9: vanilica ($143.11 in chips) 
matiko09: posts small blind $0.50
Cortine: posts big blind $1
*** HOLE CARDS ***
Dealt to matiko09 [Qs 5d]
cap. marb: folds 
stepan0605: folds 
blufthenuts: folds 
florrin92: raises $2 to $3
rate8: folds 
roadster683: folds 
vanilica: folds 
matiko09: folds 
Cortine: folds 
Uncalled bet ($2) returned to florrin92
florrin92 collected $2.50 from pot
florrin92: doesn't show hand 
*** SUMMARY ***
Total pot $2.50 | Rake $0 
Seat 1: matiko09 (small blind) folded before Flop
Seat 2: Cortine (big blind) folded before Flop
Seat 3: cap. marb folded before Flop (didn't bet)
Seat 4: stepan0605 folded before Flop (didn't bet)
Seat 5: blufthenuts folded before Flop (didn't bet)
Seat 6: florrin92 collected ($2.50)
Seat 7: rate8 folded before Flop (didn't bet)
Seat 8: roadster683 folded before Flop (didn't bet)
Seat 9: vanilica (button) folded before Flop (didn't bet)





PokerStars Hand #153507561226:  Hold'em No Limit ($0.50/$1.00 USD) - 2016/05/18 22:11:12 CET [2016/05/18 16:11:12 ET]
Table 'Tatjana III' 9-max Seat #4 is the button
Seat 1: cap. marb ($49.70 in chips) 
Seat 2: vanilica ($105.52 in chips) 
Seat 3: matiko09 ($186.02 in chips) 
Seat 4: Strikerman25 ($40 in chips) 
Seat 5: deadkiller1 ($108.93 in chips) 
Seat 6: maunzz ($100 in chips) 
Seat 7: rene1984tsv ($231.10 in chips) 
Seat 8: florrin92 ($100 in chips) 
Seat 9: Moszes360 ($107 in chips) 
deadkiller1: posts small blind $0.50
maunzz: posts big blind $1
*** HOLE CARDS ***
Dealt to matiko09 [4s 2d]
rene1984tsv: calls $1
florrin92: folds 
Moszes360: folds 
cap. marb: folds 
vanilica: raises $3.50 to $4.50
matiko09: folds 
Strikerman25: folds 
deadkiller1: folds 
maunzz: folds 
rene1984tsv: calls $3.50
*** FLOP *** [Ts 5c Jh]
rene1984tsv: checks 
vanilica: bets $5.98
rene1984tsv: calls $5.98
*** TURN *** [Ts 5c Jh] [2h]
rene1984tsv: checks 
vanilica: checks 
*** RIVER *** [Ts 5c Jh 2h] [8d]
rene1984tsv: bets $10.67
vanilica: folds 
Uncalled bet ($10.67) returned to rene1984tsv
rene1984tsv collected $21.34 from pot
rene1984tsv: doesn't show hand 
*** SUMMARY ***
Total pot $22.46 | Rake $1.12 
Board [Ts 5c Jh 2h 8d]
Seat 1: cap. marb folded before Flop (didn't bet)
Seat 2: vanilica folded on the River
Seat 3: matiko09 folded before Flop (didn't bet)
Seat 4: Strikerman25 (button) folded before Flop (didn't bet)
Seat 5: deadkiller1 (small blind) folded before Flop
Seat 6: maunzz (big blind) folded before Flop
Seat 7: rene1984tsv collected ($21.34)
Seat 8: florrin92 folded before Flop (didn't bet)
Seat 9: Moszes360 folded before Flop (didn't bet)





PokerStars Hand #153507567547:  Hold'em No Limit ($0.50/$1.00 USD) - 2016/05/18 22:11:18 CET [2016/05/18 16:11:18 ET]
Table 'Abetti II' 9-max Seat #1 is the button
Seat 1: matiko09 ($128.16 in chips) 
Seat 2: Cortine ($100 in chips) 
Seat 3: cap. marb ($72.26 in chips) 
Seat 4: stepan0605 ($215 in chips) 
Seat 5: blufthenuts ($167.25 in chips) 
Seat 6: florrin92 ($101.50 in chips) 
Seat 7: rate8 ($145.78 in chips) 
Seat 8: roadster683 ($19.54 in chips) 
Seat 9: vanilica ($143.11 in chips) 
Cortine: posts small blind $0.50
cap. marb: posts big blind $1
*** HOLE CARDS ***
Dealt to matiko09 [4h 2d]
stepan0605: folds 
blufthenuts: folds 
florrin92: folds 
rate8: folds 
roadster683: folds 
vanilica: folds 
matiko09: folds 
Cortine: folds 
Uncalled bet ($0.50) returned to cap. marb
cap. marb collected $1 from pot
cap. marb: doesn't show hand 
*** SUMMARY ***
Total pot $1 | Rake $0 
Seat 1: matiko09 (button) folded before Flop (didn't bet)
Seat 2: Cortine (small blind) folded before Flop
Seat 3: cap. marb (big blind) collected ($1)
Seat 4: stepan0605 folded before Flop (didn't bet)
Seat 5: blufthenuts folded before Flop (didn't bet)
Seat 6: florrin92 folded before Flop (didn't bet)
Seat 7: rate8 folded before Flop (didn't bet)
Seat 8: roadster683 folded before Flop (didn't bet)
Seat 9: vanilica folded before Flop (didn't bet)





PokerStars Hand #153507603419:  Hold'em No Limit ($0.50/$1.00 USD) - 2016/05/18 22:11:57 CET [2016/05/18 16:11:57 ET]
Table 'Abetti II' 9-max Seat #2 is the button
Seat 1: matiko09 ($128.16 in chips) 
Seat 2: Cortine ($100 in chips) 
Seat 3: cap. marb ($72.76 in chips) 
Seat 4: stepan0605 ($215 in chips) 
Seat 5: blufthenuts ($167.25 in chips) 
Seat 6: florrin92 ($101.50 in chips) 
Seat 7: rate8 ($145.78 in chips) 
Seat 8: roadster683 ($19.54 in chips) 
Seat 9: vanilica ($143.11 in chips) 
cap. marb: posts small blind $0.50
stepan0605: posts big blind $1
*** HOLE CARDS ***
Dealt to matiko09 [5h Jh]
blufthenuts: raises $2 to $3
florrin92: folds 
rate8: folds 
roadster683: folds 
vanilica: folds 
matiko09: folds 
Cortine: folds 
cap. marb: folds 
florrin92 leaves the table
stepan0605: folds 
Uncalled bet ($2) returned to blufthenuts
blufthenuts collected $2.50 from pot
blufthenuts: doesn't show hand 
*** SUMMARY ***
Total pot $2.50 | Rake $0 
Seat 1: matiko09 folded before Flop (didn't bet)
Seat 2: Cortine (button) folded before Flop (didn't bet)
Seat 3: cap. marb (small blind) folded before Flop
Seat 4: stepan0605 (big blind) folded before Flop
Seat 5: blufthenuts collected ($2.50)
Seat 6: florrin92 folded before Flop (didn't bet)
Seat 7: rate8 folded before Flop (didn't bet)
Seat 8: roadster683 folded before Flop (didn't bet)
Seat 9: vanilica folded before Flop (didn't bet)





PokerStars Hand #153507607428:  Hold'em No Limit ($0.50/$1.00 USD) - 2016/05/18 22:12:01 CET [2016/05/18 16:12:01 ET]
Table 'Tatjana III' 9-max Seat #5 is the button
Seat 1: cap. marb ($49.70 in chips) 
Seat 2: vanilica ($100 in chips) 
Seat 3: matiko09 ($186.02 in chips) 
Seat 4: Strikerman25 ($40 in chips) 
Seat 5: deadkiller1 ($108.43 in chips) 
Seat 6: maunzz ($100 in chips) 
Seat 7: rene1984tsv ($241.96 in chips) 
Seat 8: florrin92 ($100 in chips) 
Seat 9: Moszes360 ($107 in chips) 
maunzz: posts small blind $0.50
rene1984tsv: posts big blind $1
*** HOLE CARDS ***
Dealt to matiko09 [6s 6h]
florrin92: folds 
florrin92 leaves the table
Moszes360: folds 
badmadrabbit joins the table at seat #8 
cap. marb: raises $1.12 to $2.12
vanilica: folds 
matiko09: calls $2.12
Strikerman25: folds 
deadkiller1: folds 
maunzz: folds 
rene1984tsv: calls $1.12
*** FLOP *** [Td 5s Kh]
rene1984tsv: checks 
cap. marb: checks 
matiko09: checks 
*** TURN *** [Td 5s Kh] [7s]
rene1984tsv: checks 
cap. marb: bets $4
matiko09: folds 
rene1984tsv: folds 
Uncalled bet ($4) returned to cap. marb
cap. marb collected $6.52 from pot
cap. marb: doesn't show hand 
*** SUMMARY ***
Total pot $6.86 | Rake $0.34 
Board [Td 5s Kh 7s]
Seat 1: cap. marb collected ($6.52)
Seat 2: vanilica folded before Flop (didn't bet)
Seat 3: matiko09 folded on the Turn
Seat 4: Strikerman25 folded before Flop (didn't bet)
Seat 5: deadkiller1 (button) folded before Flop (didn't bet)
Seat 6: maunzz (small blind) folded before Flop
Seat 7: rene1984tsv (big blind) folded on the Turn
Seat 8: florrin92 folded before Flop (didn't bet)
Seat 9: Moszes360 folded before Flop (didn't bet)





PokerStars Hand #153507649468:  Hold'em No Limit ($0.50/$1.00 USD) - 2016/05/18 22:12:48 CET [2016/05/18 16:12:48 ET]
Table 'Abetti II' 9-max Seat #3 is the button
Seat 1: matiko09 ($128.16 in chips) 
Seat 2: Cortine ($100 in chips) 
Seat 3: cap. marb ($72.26 in chips) 
Seat 4: stepan0605 ($214 in chips) 
Seat 5: blufthenuts ($168.75 in chips) 
Seat 7: rate8 ($145.78 in chips) 
Seat 8: roadster683 ($19.54 in chips) 
Seat 9: vanilica ($143.11 in chips) 
stepan0605: posts small blind $0.50
blufthenuts: posts big blind $1
*** HOLE CARDS ***
Dealt to matiko09 [Qd Qh]
rate8: folds 
roadster683: folds 
vanilica: folds 
matiko09: raises $2 to $3
Cortine: calls $3
cap. marb: folds 
stepan0605: folds 
blufthenuts: calls $2
*** FLOP *** [7h 2h 4c]
blufthenuts: checks 
Ty Nick 420 joins the table at seat #6 
matiko09: bets $6
Ty Nick 420 leaves the table
Cortine: calls $6
maunzz joins the table at seat #6 
maunzz leaves the table
blufthenuts: folds 
*** TURN *** [7h 2h 4c] [2s]
matiko09: bets $13
Cortine: calls $13
*** RIVER *** [7h 2h 4c 2s] [Qs]
matiko09: bets $29.32
Cortine: folds 
Uncalled bet ($29.32) returned to matiko09
matiko09 collected $45.12 from pot
matiko09: doesn't show hand 
*** SUMMARY ***
Total pot $47.50 | Rake $2.38 
Board [7h 2h 4c 2s Qs]
Seat 1: matiko09 collected ($45.12)
Seat 2: Cortine folded on the River
Seat 3: cap. marb (button) folded before Flop (didn't bet)
Seat 4: stepan0605 (small blind) folded before Flop
Seat 5: blufthenuts (big blind) folded on the Flop
Seat 7: rate8 folded before Flop (didn't bet)
Seat 8: roadster683 folded before Flop (didn't bet)
Seat 9: vanilica folded before Flop (didn't bet)





PokerStars Hand #153507671756:  Hold'em No Limit ($0.50/$1.00 USD) - 2016/05/18 22:13:12 CET [2016/05/18 16:13:12 ET]
Table 'Samitchell II' 9-max Seat #5 is the button
Seat 1: cap. marb ($38.50 in chips) 
Seat 2: Cortine ($110.10 in chips) 
Seat 3: vanilica ($166.60 in chips) 
Seat 4: Zeeshka ($109.77 in chips) 
Seat 5: nuuaber ($62.85 in chips) 
Seat 6: Strikerman25 ($29.91 in chips) 
Seat 7: matiko09 ($118.15 in chips) 
Seat 8: rate8 ($105.02 in chips) 
Seat 9: janarr5 ($105 in chips) 
Strikerman25: posts small blind $0.50
matiko09: posts big blind $1
*** HOLE CARDS ***
Dealt to matiko09 [Tc Qc]
rate8: folds 
janarr5: folds 
cap. marb: folds 
Cortine: folds 
vanilica: folds 
Zeeshka: folds 
nuuaber: calls $1
Strikerman25: folds 
matiko09: raises $3 to $4
nuuaber: folds 
Uncalled bet ($3) returned to matiko09
matiko09 collected $2.50 from pot
matiko09: doesn't show hand 
*** SUMMARY ***
Total pot $2.50 | Rake $0 
Seat 1: cap. marb folded before Flop (didn't bet)
Seat 2: Cortine folded before Flop (didn't bet)
Seat 3: vanilica folded before Flop (didn't bet)
Seat 4: Zeeshka folded before Flop (didn't bet)
Seat 5: nuuaber (button) folded before Flop
Seat 6: Strikerman25 (small blind) folded before Flop
Seat 7: matiko09 (big blind) collected ($2.50)
Seat 8: rate8 folded before Flop (didn't bet)
Seat 9: janarr5 folded before Flop (didn't bet)





PokerStars Hand #153507673296:  Hold'em No Limit ($0.50/$1.00 USD) - 2016/05/18 22:13:14 CET [2016/05/18 16:13:14 ET]
Table 'Tatjana III' 9-max Seat #6 is the button
Seat 1: cap. marb ($54.10 in chips) 
Seat 2: vanilica ($100 in chips) 
Seat 3: matiko09 ($183.90 in chips) 
Seat 4: Strikerman25 ($40 in chips) 
Seat 5: deadkiller1 ($108.43 in chips) 
Seat 6: maunzz ($100 in chips) 
Seat 7: rene1984tsv ($239.84 in chips) 
Seat 8: badmadrabbit ($100 in chips) 
Seat 9: Moszes360 ($107 in chips) 
rene1984tsv: posts small blind $0.50
badmadrabbit: posts big blind $1
*** HOLE CARDS ***
Dealt to matiko09 [4d 7s]
Moszes360: folds 
cap. marb: folds 
vanilica: folds 
matiko09: folds 
Strikerman25: folds 
deadkiller1: folds 
maunzz: raises $1 to $2
rene1984tsv: calls $1.50
badmadrabbit: calls $1
*** FLOP *** [6h 8s Qh]
rene1984tsv: checks 
badmadrabbit: checks 
maunzz: bets $3.99
rene1984tsv: folds 
badmadrabbit: raises $9.01 to $13
maunzz: folds 
Uncalled bet ($9.01) returned to badmadrabbit
badmadrabbit collected $13.28 from pot
badmadrabbit: doesn't show hand 
*** SUMMARY ***
Total pot $13.98 | Rake $0.70 
Board [6h 8s Qh]
Seat 1: cap. marb folded before Flop (didn't bet)
Seat 2: vanilica folded before Flop (didn't bet)
Seat 3: matiko09 folded before Flop (didn't bet)
Seat 4: Strikerman25 folded before Flop (didn't bet)
Seat 5: deadkiller1 folded before Flop (didn't bet)
Seat 6: maunzz (button) folded on the Flop
Seat 7: rene1984tsv (small blind) folded on the Flop
Seat 8: badmadrabbit (big blind) collected ($13.28)
Seat 9: Moszes360 folded before Flop (didn't bet)





PokerStars Hand #153507699605:  Hold'em No Limit ($0.50/$1.00 USD) - 2016/05/18 22:13:43 CET [2016/05/18 16:13:43 ET]
Table 'Samitchell II' 9-max Seat #6 is the button
Seat 1: cap. marb ($38.50 in chips) 
Seat 2: Cortine ($110.10 in chips) 
Seat 3: vanilica ($166.60 in chips) 
Seat 4: Zeeshka ($109.77 in chips) 
Seat 5: nuuaber ($61.85 in chips) 
Seat 6: Strikerman25 ($29.41 in chips) 
Seat 7: matiko09 ($119.65 in chips) 
Seat 8: rate8 ($105.02 in chips) 
Seat 9: janarr5 ($105 in chips) 
matiko09: posts small blind $0.50
rate8: posts big blind $1
*** HOLE CARDS ***
Dealt to matiko09 [6d 2s]
janarr5: folds 
cap. marb: folds 
Cortine: folds 
vanilica: folds 
Zeeshka: raises $2 to $3
nuuaber: folds 
Strikerman25: folds 
matiko09: folds 
rate8: folds 
Uncalled bet ($2) returned to Zeeshka
Zeeshka collected $2.50 from pot
Zeeshka: doesn't show hand 
*** SUMMARY ***
Total pot $2.50 | Rake $0 
Seat 1: cap. marb folded before Flop (didn't bet)
Seat 2: Cortine folded before Flop (didn't bet)
Seat 3: vanilica folded before Flop (didn't bet)
Seat 4: Zeeshka collected ($2.50)
Seat 5: nuuaber folded before Flop (didn't bet)
Seat 6: Strikerman25 (button) folded before Flop (didn't bet)
Seat 7: matiko09 (small blind) folded before Flop
Seat 8: rate8 (big blind) folded before Flop
Seat 9: janarr5 folded before Flop (didn't bet)





PokerStars Hand #153507705224:  Hold'em No Limit ($0.50/$1.00 USD) - 2016/05/18 22:13:49 CET [2016/05/18 16:13:49 ET]
Table 'Brendelia II' 9-max Seat #4 is the button
Seat 1: cap. marb ($60.72 in chips) 
Seat 2: rate8 ($106.12 in chips) 
Seat 3: Zeeshka ($100 in chips) 
Seat 4: gkm0nk3y ($114.24 in chips) 
Seat 5: Vulturinus ($61.83 in chips) 
Seat 7: matiko09 ($100 in chips) 
Seat 8: solbi86 ($115.97 in chips) 
Seat 9: fr3314nc3 ($92.88 in chips) 
Vulturinus: posts small blind $0.50
TimStone: is sitting out 
matiko09: posts big blind $1
*** HOLE CARDS ***
Dealt to matiko09 [Jh 5d]
solbi86: raises $2 to $3
fr3314nc3: folds 
cap. marb: raises $5 to $8
rate8: folds 
Zeeshka: folds 
gkm0nk3y: folds 
Vulturinus: folds 
matiko09: folds 
solbi86: calls $5
*** FLOP *** [8c 2h 3s]
solbi86: checks 
cap. marb: checks 
*** TURN *** [8c 2h 3s] [4s]
solbi86: bets $11
cap. marb: calls $11
*** RIVER *** [8c 2h 3s 4s] [As]
solbi86: checks 
cap. marb: bets $41.72 and is all-in
solbi86: folds 
Uncalled bet ($41.72) returned to cap. marb
cap. marb collected $37.52 from pot
cap. marb: doesn't show hand 
*** SUMMARY ***
Total pot $39.50 | Rake $1.98 
Board [8c 2h 3s 4s As]
Seat 1: cap. marb collected ($37.52)
Seat 2: rate8 folded before Flop (didn't bet)
Seat 3: Zeeshka folded before Flop (didn't bet)
Seat 4: gkm0nk3y (button) folded before Flop (didn't bet)
Seat 5: Vulturinus (small blind) folded before Flop
Seat 7: matiko09 (big blind) folded before Flop
Seat 8: solbi86 folded on the River
Seat 9: fr3314nc3 folded before Flop (didn't bet)





PokerStars Hand #153507720010:  Hold'em No Limit ($0.50/$1.00 USD) - 2016/05/18 22:14:06 CET [2016/05/18 16:14:06 ET]
Table 'Tatjana III' 9-max Seat #7 is the button
Seat 1: cap. marb ($54.10 in chips) 
Seat 2: vanilica ($100 in chips) 
Seat 3: matiko09 ($183.90 in chips) 
Seat 4: Strikerman25 ($40 in chips) 
Seat 5: deadkiller1 ($108.43 in chips) 
Seat 6: maunzz ($100 in chips) 
Seat 7: rene1984tsv ($237.84 in chips) 
Seat 8: badmadrabbit ($107.29 in chips) 
Seat 9: Moszes360 ($107 in chips) 
badmadrabbit: posts small blind $0.50
Moszes360: posts big blind $1
*** HOLE CARDS ***
Dealt to matiko09 [Js 6d]
cap. marb has timed out
cap. marb: folds 
vanilica: folds 
matiko09: folds 
Strikerman25: folds 
deadkiller1: folds 
maunzz: folds 
rene1984tsv: raises $2 to $3
badmadrabbit: folds 
Moszes360: folds 
Uncalled bet ($2) returned to rene1984tsv
rene1984tsv collected $2.50 from pot
rene1984tsv: shows [3c Kc] (high card King)
*** SUMMARY ***
Total pot $2.50 | Rake $0 
Seat 1: cap. marb folded before Flop (didn't bet)
Seat 2: vanilica folded before Flop (didn't bet)
Seat 3: matiko09 folded before Flop (didn't bet)
Seat 4: Strikerman25 folded before Flop (didn't bet)
Seat 5: deadkiller1 folded before Flop (didn't bet)
Seat 6: maunzz folded before Flop (didn't bet)
Seat 7: rene1984tsv (button) collected ($2.50)
Seat 8: badmadrabbit (small blind) folded before Flop
Seat 9: Moszes360 (big blind) folded before Flop





PokerStars Hand #153507741274:  Hold'em No Limit ($0.50/$1.00 USD) - 2016/05/18 22:14:29 CET [2016/05/18 16:14:29 ET]
Table 'Samitchell II' 9-max Seat #7 is the button
Seat 1: cap. marb ($38.50 in chips) 
Seat 2: Cortine ($110.10 in chips) 
Seat 3: vanilica ($166.60 in chips) 
Seat 4: Zeeshka ($111.27 in chips) 
Seat 5: nuuaber ($61.85 in chips) 
Seat 6: Strikerman25 ($29.41 in chips) 
Seat 7: matiko09 ($119.15 in chips) 
Seat 8: rate8 ($104.02 in chips) 
Seat 9: janarr5 ($105 in chips) 
rate8: posts small blind $0.50
janarr5: posts big blind $1
*** HOLE CARDS ***
Dealt to matiko09 [8d 3s]
cap. marb: folds 
Cortine: raises $2 to $3
vanilica: folds 
Zeeshka: folds 
nuuaber: folds 
Strikerman25: raises $4.50 to $7.50
matiko09: folds 
rate8: folds 
janarr5: folds 
Cortine: folds 
Uncalled bet ($4.50) returned to Strikerman25
Strikerman25 collected $7.50 from pot
Strikerman25: doesn't show hand 
*** SUMMARY ***
Total pot $7.50 | Rake $0 
Seat 1: cap. marb folded before Flop (didn't bet)
Seat 2: Cortine folded before Flop
Seat 3: vanilica folded before Flop (didn't bet)
Seat 4: Zeeshka folded before Flop (didn't bet)
Seat 5: nuuaber folded before Flop (didn't bet)
Seat 6: Strikerman25 collected ($7.50)
Seat 7: matiko09 (button) folded before Flop (didn't bet)
Seat 8: rate8 (small blind) folded before Flop
Seat 9: janarr5 (big blind) folded before Flop





PokerStars Hand #153507756310:  Hold'em No Limit ($0.50/$1.00 USD) - 2016/05/18 22:14:46 CET [2016/05/18 16:14:46 ET]
Table 'Tatjana III' 9-max Seat #8 is the button
Seat 1: cap. marb ($54.10 in chips) 
Seat 2: vanilica ($100 in chips) 
Seat 3: matiko09 ($183.90 in chips) 
Seat 4: Strikerman25 ($40 in chips) 
Seat 5: deadkiller1 ($108.43 in chips) 
Seat 6: maunzz ($100 in chips) 
Seat 7: rene1984tsv ($239.34 in chips) 
Seat 8: badmadrabbit ($106.79 in chips) 
Seat 9: Moszes360 ($106 in chips) 
Moszes360: posts small blind $0.50
cap. marb: posts big blind $1
*** HOLE CARDS ***
Dealt to matiko09 [5s 3s]
vanilica: raises $2 to $3
matiko09: folds 
Strikerman25: folds 
deadkiller1: folds 
maunzz: folds 
rene1984tsv: calls $3
badmadrabbit: folds 
Moszes360: folds 
cap. marb: folds 
*** FLOP *** [3d 4s Ah]
vanilica: bets $4
rene1984tsv: calls $4
*** TURN *** [3d 4s Ah] [5d]
vanilica: checks 
rene1984tsv: checks 
*** RIVER *** [3d 4s Ah 5d] [8c]
vanilica: checks 
rene1984tsv: checks 
*** SHOW DOWN ***
vanilica: shows [Tc Td] (a pair of Tens)
rene1984tsv: mucks hand 
vanilica collected $14.72 from pot
*** SUMMARY ***
Total pot $15.50 | Rake $0.78 
Board [3d 4s Ah 5d 8c]
Seat 1: cap. marb (big blind) folded before Flop
Seat 2: vanilica showed [Tc Td] and won ($14.72) with a pair of Tens
Seat 3: matiko09 folded before Flop (didn't bet)
Seat 4: Strikerman25 folded before Flop (didn't bet)
Seat 5: deadkiller1 folded before Flop (didn't bet)
Seat 6: maunzz folded before Flop (didn't bet)
Seat 7: rene1984tsv mucked [Qc Kc]
Seat 8: badmadrabbit (button) folded before Flop (didn't bet)
Seat 9: Moszes360 (small blind) folded before Flop





PokerStars Hand #153507762714:  Hold'em No Limit ($0.50/$1.00 USD) - 2016/05/18 22:14:53 CET [2016/05/18 16:14:53 ET]
Table 'Abetti II' 9-max Seat #4 is the button
Seat 1: matiko09 ($151.28 in chips) 
Seat 2: Cortine ($100 in chips) 
Seat 3: cap. marb ($72.26 in chips) 
Seat 4: stepan0605 ($213.50 in chips) 
Seat 5: blufthenuts ($165.75 in chips) 
Seat 7: rate8 ($145.78 in chips) 
Seat 8: roadster683 ($19.54 in chips) 
Seat 9: vanilica ($143.11 in chips) 
blufthenuts: posts small blind $0.50
rate8: posts big blind $1
*** HOLE CARDS ***
Dealt to matiko09 [5d 3s]
roadster683: folds 
vanilica: folds 
matiko09: folds 
Cortine: folds 
cap. marb: folds 
stepan0605: raises $1 to $2
blufthenuts: calls $1.50
rate8: folds 
*** FLOP *** [4s 7s 9h]
blufthenuts: checks 
xHourglass joins the table at seat #6 
stepan0605: checks 
*** TURN *** [4s 7s 9h] [Qs]
blufthenuts: bets $4
stepan0605: calls $4
*** RIVER *** [4s 7s 9h Qs] [Ah]
blufthenuts: bets $8.64
stepan0605: calls $8.64
*** SHOW DOWN ***
blufthenuts: shows [7h Qh] (two pair, Queens and Sevens)
stepan0605: shows [Ad Qc] (two pair, Aces and Queens)
stepan0605 collected $28.77 from pot
*** SUMMARY ***
Total pot $30.28 | Rake $1.51 
Board [4s 7s 9h Qs Ah]
Seat 1: matiko09 folded before Flop (didn't bet)
Seat 2: Cortine folded before Flop (didn't bet)
Seat 3: cap. marb folded before Flop (didn't bet)
Seat 4: stepan0605 (button) showed [Ad Qc] and won ($28.77) with two pair, Aces and Queens
Seat 5: blufthenuts (small blind) showed [7h Qh] and lost with two pair, Queens and Sevens
Seat 7: rate8 (big blind) folded before Flop
Seat 8: roadster683 folded before Flop (didn't bet)
Seat 9: vanilica folded before Flop (didn't bet)





PokerStars Hand #153507786301:  Hold'em No Limit ($0.50/$1.00 USD) - 2016/05/18 22:15:19 CET [2016/05/18 16:15:19 ET]
Table 'Haedus' 9-max Seat #1 is the button
Seat 1: søren610 ($27.78 in chips) 
Seat 4: solbi86 ($100 in chips) 
Seat 5: matiko09 ($100 in chips) 
Seat 6: maunzz ($115.15 in chips) 
Seat 7: LadyMaCe86 ($101.50 in chips) 
Seat 8: Neetbom ($81.26 in chips) 
Seat 9: yurinho21 ($100 in chips) 
solbi86: posts small blind $0.50
matiko09: posts big blind $1
*** HOLE CARDS ***
Dealt to matiko09 [5h Qs]
maunzz: folds 
LadyMaCe86: folds 
Neetbom: calls $1
yurinho21: folds 
søren610: calls $1
solbi86: folds 
matiko09: checks 
*** FLOP *** [6d Ah Th]
matiko09: checks 
Neetbom: checks 
søren610: checks 
*** TURN *** [6d Ah Th] [Kh]
matiko09: checks 
Neetbom: checks 
søren610: bets $7
matiko09: folds 
Neetbom: folds 
Uncalled bet ($7) returned to søren610
søren610 collected $3.32 from pot
søren610: doesn't show hand 
*** SUMMARY ***
Total pot $3.50 | Rake $0.18 
Board [6d Ah Th Kh]
Seat 1: søren610 (button) collected ($3.32)
Seat 4: solbi86 (small blind) folded before Flop
Seat 5: matiko09 (big blind) folded on the Turn
Seat 6: maunzz folded before Flop (didn't bet)
Seat 7: LadyMaCe86 folded before Flop (didn't bet)
Seat 8: Neetbom folded on the Turn
Seat 9: yurinho21 folded before Flop (didn't bet)





PokerStars Hand #153507790917:  Hold'em No Limit ($0.50/$1.00 USD) - 2016/05/18 22:15:24 CET [2016/05/18 16:15:24 ET]
Table 'Samitchell II' 9-max Seat #8 is the button
Seat 1: cap. marb ($38.50 in chips) 
Seat 2: Cortine ($107.10 in chips) 
Seat 3: vanilica ($166.60 in chips) 
Seat 4: Zeeshka ($111.27 in chips) 
Seat 5: nuuaber ($61.85 in chips) 
Seat 6: Strikerman25 ($33.91 in chips) 
Seat 7: matiko09 ($119.15 in chips) 
Seat 8: rate8 ($103.52 in chips) 
Seat 9: janarr5 ($104 in chips) 
janarr5: posts small blind $0.50
cap. marb: posts big blind $1
*** HOLE CARDS ***
Dealt to matiko09 [6h 5c]
Cortine: folds 
vanilica: folds 
Zeeshka: raises $2 to $3
nuuaber: calls $3
Strikerman25: folds 
matiko09: folds 
rate8: folds 
janarr5: folds 
cap. marb: folds 
*** FLOP *** [2s Js Qs]
Zeeshka: checks 
nuuaber: checks 
*** TURN *** [2s Js Qs] [Kh]
Zeeshka: checks 
nuuaber: checks 
*** RIVER *** [2s Js Qs Kh] [Ts]
Zeeshka: checks 
nuuaber: checks 
*** SHOW DOWN ***
Zeeshka: shows [Ac Jd] (a straight, Ten to Ace)
nuuaber: mucks hand 
Zeeshka collected $7.12 from pot
*** SUMMARY ***
Total pot $7.50 | Rake $0.38 
Board [2s Js Qs Kh Ts]
Seat 1: cap. marb (big blind) folded before Flop
Seat 2: Cortine folded before Flop (didn't bet)
Seat 3: vanilica folded before Flop (didn't bet)
Seat 4: Zeeshka showed [Ac Jd] and won ($7.12) with a straight, Ten to Ace
Seat 5: nuuaber mucked [3h 3c]
Seat 6: Strikerman25 folded before Flop (didn't bet)
Seat 7: matiko09 folded before Flop (didn't bet)
Seat 8: rate8 (button) folded before Flop (didn't bet)
Seat 9: janarr5 (small blind) folded before Flop





PokerStars Hand #153507794739:  Hold'em No Limit ($0.50/$1.00 USD) - 2016/05/18 22:15:29 CET [2016/05/18 16:15:29 ET]
Table 'Tatjana III' 9-max Seat #9 is the button
Seat 1: cap. marb ($53.10 in chips) 
Seat 2: vanilica ($107.72 in chips) 
Seat 3: matiko09 ($183.90 in chips) 
Seat 4: Strikerman25 ($40 in chips) 
Seat 5: deadkiller1 ($108.43 in chips) 
Seat 6: maunzz ($100 in chips) 
Seat 7: rene1984tsv ($232.34 in chips) 
Seat 8: badmadrabbit ($106.79 in chips) 
Seat 9: Moszes360 ($105.50 in chips) 
cap. marb: posts small blind $0.50
vanilica: posts big blind $1
*** HOLE CARDS ***
Dealt to matiko09 [Js 4d]
matiko09: folds 
Strikerman25: folds 
deadkiller1: folds 
maunzz: folds 
rene1984tsv: raises $2 to $3
badmadrabbit: folds 
Moszes360: raises $6 to $9
cap. marb: folds 
vanilica: calls $8
rene1984tsv: folds 
*** FLOP *** [2d Ts 8d]
vanilica: checks 
Moszes360: checks 
*** TURN *** [2d Ts 8d] [3h]
vanilica: bets $12.25
Moszes360: folds 
Uncalled bet ($12.25) returned to vanilica
vanilica collected $20.42 from pot
vanilica: doesn't show hand 
*** SUMMARY ***
Total pot $21.50 | Rake $1.08 
Board [2d Ts 8d 3h]
Seat 1: cap. marb (small blind) folded before Flop
Seat 2: vanilica (big blind) collected ($20.42)
Seat 3: matiko09 folded before Flop (didn't bet)
Seat 4: Strikerman25 folded before Flop (didn't bet)
Seat 5: deadkiller1 folded before Flop (didn't bet)
Seat 6: maunzz folded before Flop (didn't bet)
Seat 7: rene1984tsv folded before Flop
Seat 8: badmadrabbit folded before Flop (didn't bet)
Seat 9: Moszes360 (button) folded on the Turn





PokerStars Hand #153507802854:  Hold'em No Limit ($0.50/$1.00 USD) - 2016/05/18 22:15:37 CET [2016/05/18 16:15:37 ET]
Table 'Brendelia II' 9-max Seat #5 is the button
Seat 1: cap. marb ($79.24 in chips) 
Seat 2: rate8 ($106.12 in chips) 
Seat 3: Zeeshka ($100 in chips) 
Seat 4: gkm0nk3y ($114.24 in chips) 
Seat 5: Vulturinus ($61.33 in chips) 
Seat 7: matiko09 ($100 in chips) 
Seat 8: solbi86 ($100 in chips) 
Seat 9: fr3314nc3 ($92.88 in chips) 
matiko09: posts small blind $0.50
solbi86: posts big blind $1
*** HOLE CARDS ***
Dealt to matiko09 [6s 9h]
fr3314nc3: folds 
cap. marb: raises $1.12 to $2.12
rate8: raises $5.38 to $7.50
Zeeshka: folds 
gkm0nk3y: folds 
Vulturinus: calls $7.50
matiko09: folds 
solbi86: folds 
cap. marb: calls $5.38
*** FLOP *** [7d Td Ks]
cap. marb: checks 
rate8: bets $13.50
Vulturinus: calls $13.50
cap. marb: folds 
*** TURN *** [7d Td Ks] [4d]
rate8: checks 
Vulturinus: checks 
*** RIVER *** [7d Td Ks 4d] [Qc]
rate8: bets $18
Vulturinus: calls $18
*** SHOW DOWN ***
rate8: shows [Ad As] (a pair of Aces)
Vulturinus: mucks hand 
rate8 collected $84.50 from pot
*** SUMMARY ***
Total pot $87 | Rake $2.50 
Board [7d Td Ks 4d Qc]
Seat 1: cap. marb folded on the Flop
Seat 2: rate8 showed [Ad As] and won ($84.50) with a pair of Aces
Seat 3: Zeeshka folded before Flop (didn't bet)
Seat 4: gkm0nk3y folded before Flop (didn't bet)
Seat 5: Vulturinus (button) mucked [Ac Kd]
Seat 7: matiko09 (small blind) folded before Flop
Seat 8: solbi86 (big blind) folded before Flop
Seat 9: fr3314nc3 folded before Flop (didn't bet)





PokerStars Hand #153507812142:  Hold'em No Limit (€0.50/€1.00 EUR) - 2016/05/18 22:15:47 CET [2016/05/18 16:15:47 ET]
Table 'Sarmiento III' 9-max Seat #5 is the button
Seat 5: rexalex2012 (€50 in chips) 
Seat 7: JACQUILF (€100 in chips) 
Seat 8: matiko09 (€100 in chips) 
Seat 9: vanilica (€100 in chips) 
JACQUILF: posts small blind €0.50
matiko09: posts big blind €1
*** HOLE CARDS ***
Dealt to matiko09 [Qc 8h]
vanilica: raises €1.85 to €2.85
AugderStarke joins the table at seat #4 
rexalex2012: calls €2.85
JACQUILF: folds 
matiko09: folds 
*** FLOP *** [8s 6s 9c]
LadyMaCe86 joins the table at seat #1 
vanilica: checks 
rexalex2012: bets €2
vanilica: folds 
Uncalled bet (€2) returned to rexalex2012
rexalex2012 collected €6.84 from pot
rexalex2012: doesn't show hand 
*** SUMMARY ***
Total pot €7.20 | Rake €0.36 
Board [8s 6s 9c]
Seat 5: rexalex2012 (button) collected (€6.84)
Seat 7: JACQUILF (small blind) folded before Flop
Seat 8: matiko09 (big blind) folded before Flop
Seat 9: vanilica folded on the Flop





PokerStars Hand #153507831459:  Hold'em No Limit ($0.50/$1.00 USD) - 2016/05/18 22:16:09 CET [2016/05/18 16:16:09 ET]
Table 'Haedus' 9-max Seat #4 is the button
Seat 1: søren610 ($30.10 in chips) 
Seat 4: solbi86 ($100 in chips) 
Seat 5: matiko09 ($100 in chips) 
Seat 6: maunzz ($115.15 in chips) 
Seat 7: LadyMaCe86 ($101.50 in chips) 
Seat 8: Neetbom ($80.26 in chips) 
Seat 9: yurinho21 ($100 in chips) 
matiko09: posts small blind $0.50
maunzz: posts big blind $1
*** HOLE CARDS ***
Dealt to matiko09 [Ad 9h]
LadyMaCe86: folds 
Neetbom: calls $1
yurinho21: folds 
søren610: calls $1
solbi86: folds 
matiko09: calls $0.50
maunzz: checks 
*** FLOP *** [Th Js Qd]
matiko09: checks 
maunzz: checks 
Neetbom: checks 
søren610: checks 
*** TURN *** [Th Js Qd] [3s]
matiko09: checks 
maunzz: bets $3
Neetbom: folds 
søren610: calls $3
matiko09: folds 
*** RIVER *** [Th Js Qd 3s] [6s]
maunzz: checks 
søren610: checks 
*** SHOW DOWN ***
maunzz: shows [Qh 7c] (a pair of Queens)
søren610: mucks hand 
maunzz collected $9.50 from pot
*** SUMMARY ***
Total pot $10 | Rake $0.50 
Board [Th Js Qd 3s 6s]
Seat 1: søren610 mucked [2h 3c]
Seat 4: solbi86 (button) folded before Flop (didn't bet)
Seat 5: matiko09 (small blind) folded on the Turn
Seat 6: maunzz (big blind) showed [Qh 7c] and won ($9.50) with a pair of Queens
Seat 7: LadyMaCe86 folded before Flop (didn't bet)
Seat 8: Neetbom folded on the Turn
Seat 9: yurinho21 folded before Flop (didn't bet)





PokerStars Hand #153507833534:  Hold'em No Limit ($0.50/$1.00 USD) - 2016/05/18 22:16:11 CET [2016/05/18 16:16:11 ET]
Table 'Tatjana III' 9-max Seat #1 is the button
Seat 1: cap. marb ($52.60 in chips) 
Seat 2: vanilica ($119.14 in chips) 
Seat 3: matiko09 ($183.90 in chips) 
Seat 4: Strikerman25 ($40 in chips) 
Seat 5: deadkiller1 ($108.43 in chips) 
Seat 6: maunzz ($100 in chips) 
Seat 7: rene1984tsv ($229.34 in chips) 
Seat 8: badmadrabbit ($106.79 in chips) 
Seat 9: Moszes360 ($100 in chips) 
vanilica: posts small blind $0.50
matiko09: posts big blind $1
*** HOLE CARDS ***
Dealt to matiko09 [4h Qh]
Strikerman25: folds 
deadkiller1: folds 
maunzz: folds 
rene1984tsv: calls $1
badmadrabbit: folds 
Moszes360: folds 
rene1984tsv said, "Q now"
rene1984tsv said, "AQ"
cap. marb: raises $3.50 to $4.50
vanilica: folds 
matiko09: folds 
rene1984tsv: calls $3.50
*** FLOP *** [Jc Qc Ac]
rene1984tsv: checks 
cap. marb: bets $5.50
rene1984tsv said, "i have AQ"
rene1984tsv: calls $5.50
*** TURN *** [Jc Qc Ac] [Tc]
rene1984tsv: checks 
cap. marb: checks 
*** RIVER *** [Jc Qc Ac Tc] [As]
rene1984tsv: bets $5
cap. marb: folds 
Uncalled bet ($5) returned to rene1984tsv
rene1984tsv collected $20.42 from pot
rene1984tsv: shows [8h 7c] (a flush, Ace high)
*** SUMMARY ***
Total pot $21.50 | Rake $1.08 
Board [Jc Qc Ac Tc As]
Seat 1: cap. marb (button) folded on the River
Seat 2: vanilica (small blind) folded before Flop
Seat 3: matiko09 (big blind) folded before Flop
Seat 4: Strikerman25 folded before Flop (didn't bet)
Seat 5: deadkiller1 folded before Flop (didn't bet)
Seat 6: maunzz folded before Flop (didn't bet)
Seat 7: rene1984tsv collected ($20.42)
Seat 8: badmadrabbit folded before Flop (didn't bet)
Seat 9: Moszes360 folded before Flop (didn't bet)





PokerStars Hand #153507839738:  Hold'em No Limit (€0.50/€1.00 EUR) - 2016/05/18 22:16:18 CET [2016/05/18 16:16:18 ET]
Table 'Sarmiento III' 9-max Seat #7 is the button
Seat 4: AugderStarke (€100 in chips) 
Seat 5: rexalex2012 (€53.99 in chips) 
Seat 7: JACQUILF (€100 in chips) 
Seat 8: matiko09 (€100 in chips) 
Seat 9: vanilica (€100 in chips) 
matiko09: posts small blind €0.50
vanilica: posts big blind €1
LadyMaCe86: sits out 
AugderStarke: posts big blind €1
*** HOLE CARDS ***
Dealt to matiko09 [7s 3h]
Kreuznagel joins the table at seat #2 
AugderStarke: checks 
Mashulia7777 joins the table at seat #3 
rexalex2012: raises €1 to €2
JACQUILF: folds 
matiko09: folds 
vanilica: calls €1
AugderStarke: folds 
*** FLOP *** [Td Ac 5d]
vanilica: checks 
rexalex2012: bets €2
vanilica: calls €2
*** TURN *** [Td Ac 5d] [Kc]
vanilica: checks 
rexalex2012: bets €2
vanilica: folds 
Uncalled bet (€2) returned to rexalex2012
rexalex2012 collected €9.02 from pot
rexalex2012: doesn't show hand 
*** SUMMARY ***
Total pot €9.50 | Rake €0.48 
Board [Td Ac 5d Kc]
Seat 4: AugderStarke folded before Flop
Seat 5: rexalex2012 collected (€9.02)
Seat 7: JACQUILF (button) folded before Flop (didn't bet)
Seat 8: matiko09 (small blind) folded before Flop
Seat 9: vanilica (big blind) folded on the Turn





PokerStars Hand #153507843483:  Hold'em No Limit ($0.50/$1.00 USD) - 2016/05/18 22:16:22 CET [2016/05/18 16:16:22 ET]
Table 'Samitchell II' 9-max Seat #9 is the button
Seat 1: cap. marb ($37.50 in chips) 
Seat 3: vanilica ($166.60 in chips) 
Seat 4: Zeeshka ($115.39 in chips) 
Seat 5: nuuaber ($58.85 in chips) 
Seat 6: Strikerman25 ($33.91 in chips) 
Seat 7: matiko09 ($119.15 in chips) 
Seat 8: rate8 ($103.52 in chips) 
Seat 9: janarr5 ($103.50 in chips) 
cap. marb: posts small blind $0.50
Cortine: is sitting out 
vanilica: posts big blind $1
*** HOLE CARDS ***
Dealt to matiko09 [7c Th]
Zeeshka: folds 
nuuaber: raises $2.50 to $3.50
Strikerman25: raises $13 to $16.50
matiko09: folds 
rate8: folds 
janarr5: folds 
cap. marb: folds 
vanilica: folds 
nuuaber: raises $42.35 to $58.85 and is all-in
Strikerman25: calls $17.41 and is all-in
Uncalled bet ($24.94) returned to nuuaber
*** FLOP *** [6h Qs 2h]
*** TURN *** [6h Qs 2h] [4s]
*** RIVER *** [6h Qs 2h 4s] [Jd]
*** SHOW DOWN ***
nuuaber: shows [Ts As] (high card Ace)
Strikerman25: shows [Ks Ac] (high card Ace - King kicker)
Strikerman25 collected $66.82 from pot
*** SUMMARY ***
Total pot $69.32 | Rake $2.50 
Board [6h Qs 2h 4s Jd]
Seat 1: cap. marb (small blind) folded before Flop
Seat 3: vanilica (big blind) folded before Flop
Seat 4: Zeeshka folded before Flop (didn't bet)
Seat 5: nuuaber showed [Ts As] and lost with high card Ace
Seat 6: Strikerman25 showed [Ks Ac] and won ($66.82) with high card Ace
Seat 7: matiko09 folded before Flop (didn't bet)
Seat 8: rate8 folded before Flop (didn't bet)
Seat 9: janarr5 (button) folded before Flop (didn't bet)





PokerStars Hand #153507859545:  Hold'em No Limit ($0.50/$1.00 USD) - 2016/05/18 22:16:39 CET [2016/05/18 16:16:39 ET]
Table 'Abetti II' 9-max Seat #5 is the button
Seat 1: matiko09 ($151.28 in chips) 
Seat 2: Cortine ($100 in chips) 
Seat 3: cap. marb ($72.26 in chips) 
Seat 4: stepan0605 ($227.63 in chips) 
Seat 5: blufthenuts ($151.11 in chips) 
Seat 7: rate8 ($144.78 in chips) 
Seat 8: roadster683 ($19.54 in chips) 
Seat 9: vanilica ($143.11 in chips) 
xHourglass will be allowed to play after the button
rate8: posts small blind $0.50
roadster683: posts big blind $1
*** HOLE CARDS ***
Dealt to matiko09 [4h 3d]
vanilica: raises $2 to $3
matiko09: folds 
Cortine: folds 
cap. marb: folds 
stepan0605: raises $6 to $9
blufthenuts: folds 
rate8: folds 
roadster683: raises $10.54 to $19.54 and is all-in
vanilica: folds 
stepan0605: calls $10.54
*** FLOP *** [6d 4s 5h]
*** TURN *** [6d 4s 5h] [3h]
*** RIVER *** [6d 4s 5h 3h] [7c]
*** SHOW DOWN ***
roadster683: shows [7h 4c] (a straight, Three to Seven)
stepan0605: shows [Jh Ks] (a straight, Three to Seven)
roadster683 collected $20.23 from pot
stepan0605 collected $20.22 from pot
*** SUMMARY ***
Total pot $42.58 | Rake $2.13 
Board [6d 4s 5h 3h 7c]
Seat 1: matiko09 folded before Flop (didn't bet)
Seat 2: Cortine folded before Flop (didn't bet)
Seat 3: cap. marb folded before Flop (didn't bet)
Seat 4: stepan0605 showed [Jh Ks] and won ($20.22) with a straight, Three to Seven
Seat 5: blufthenuts (button) folded before Flop (didn't bet)
Seat 7: rate8 (small blind) folded before Flop
Seat 8: roadster683 (big blind) showed [7h 4c] and won ($20.23) with a straight, Three to Seven
Seat 9: vanilica folded before Flop





PokerStars Hand #153507876504:  Hold'em No Limit (€0.50/€1.00 EUR) - 2016/05/18 22:16:58 CET [2016/05/18 16:16:58 ET]
Table 'Sarmiento III' 9-max Seat #8 is the button
Seat 1: LadyMaCe86 (€100 in chips) 
Seat 4: AugderStarke (€99 in chips) 
Seat 5: rexalex2012 (€59.01 in chips) 
Seat 7: JACQUILF (€100 in chips) 
Seat 8: matiko09 (€100 in chips) 
Seat 9: vanilica (€100 in chips) 
vanilica: posts small blind €0.50
LadyMaCe86: posts big blind €1
Kreuznagel: sits out 
Mashulia7777: sits out 
*** HOLE CARDS ***
Dealt to matiko09 [7d 6c]
AugderStarke: folds 
rexalex2012: calls €1
JACQUILF: folds 
matiko09: folds 
vanilica: calls €0.50
LadyMaCe86: raises €3.50 to €4.50
rexalex2012: calls €3.50
vanilica: folds 
*** FLOP *** [4d 3c 2d]
LadyMaCe86: bets €6.17
rexalex2012: calls €6.17
*** TURN *** [4d 3c 2d] [3s]
LadyMaCe86: bets €13.79
rexalex2012: calls €13.79
*** RIVER *** [4d 3c 2d 3s] [8h]
LadyMaCe86: checks 
rexalex2012: checks 
*** SHOW DOWN ***
LadyMaCe86: shows [Td Ts] (two pair, Tens and Threes)
rexalex2012: mucks hand 
LadyMaCe86 collected €47.67 from pot
*** SUMMARY ***
Total pot €49.92 | Rake €2.25 
Board [4d 3c 2d 3s 8h]
Seat 1: LadyMaCe86 (big blind) showed [Td Ts] and won (€47.67) with two pair, Tens and Threes
Seat 4: AugderStarke folded before Flop (didn't bet)
Seat 5: rexalex2012 mucked [5h 4h]
Seat 7: JACQUILF folded before Flop (didn't bet)
Seat 8: matiko09 (button) folded before Flop (didn't bet)
Seat 9: vanilica (small blind) folded before Flop





PokerStars Hand #153507889248:  Hold'em No Limit ($0.50/$1.00 USD) - 2016/05/18 22:17:12 CET [2016/05/18 16:17:12 ET]
Table 'Haedus' 9-max Seat #5 is the button
Seat 1: søren610 ($26.10 in chips) 
Seat 4: solbi86 ($100 in chips) 
Seat 5: matiko09 ($100 in chips) 
Seat 6: maunzz ($120.65 in chips) 
Seat 8: Neetbom ($79.26 in chips) 
Seat 9: yurinho21 ($100 in chips) 
maunzz: posts small blind $0.50
LadyMaCe86: is sitting out 
Neetbom: posts big blind $1
*** HOLE CARDS ***
Dealt to matiko09 [5s 7d]
LadyMaCe86 leaves the table
yurinho21: folds 
søren610: calls $1
solbi86: folds 
edidaz joins the table at seat #7 
edidaz leaves the table
Ty Nick 420 joins the table at seat #7 
matiko09: folds 
maunzz: folds 
Neetbom: checks 
*** FLOP *** [2d Ah Kh]
Neetbom: checks 
søren610: checks 
*** TURN *** [2d Ah Kh] [5c]
Neetbom: checks 
søren610: checks 
*** RIVER *** [2d Ah Kh 5c] [3h]
Neetbom: bets $2.38
søren610: folds 
Uncalled bet ($2.38) returned to Neetbom
Neetbom collected $2.38 from pot
Neetbom: doesn't show hand 
*** SUMMARY ***
Total pot $2.50 | Rake $0.12 
Board [2d Ah Kh 5c 3h]
Seat 1: søren610 folded on the River
Seat 4: solbi86 folded before Flop (didn't bet)
Seat 5: matiko09 (button) folded before Flop (didn't bet)
Seat 6: maunzz (small blind) folded before Flop
Seat 8: Neetbom (big blind) collected ($2.38)
Seat 9: yurinho21 folded before Flop (didn't bet)





PokerStars Hand #153507898068:  Hold'em No Limit ($0.50/$1.00 USD) - 2016/05/18 22:17:21 CET [2016/05/18 16:17:21 ET]
Table 'Samitchell II' 9-max Seat #1 is the button
Seat 1: cap. marb ($37 in chips) 
Seat 3: vanilica ($165.60 in chips) 
Seat 4: Zeeshka ($115.39 in chips) 
Seat 5: nuuaber ($24.94 in chips) 
Seat 6: Strikerman25 ($66.82 in chips) 
Seat 7: matiko09 ($119.15 in chips) 
Seat 8: rate8 ($103.52 in chips) 
Seat 9: janarr5 ($103.50 in chips) 
vanilica: posts small blind $0.50
Zeeshka: posts big blind $1
*** HOLE CARDS ***
Dealt to matiko09 [Td 9s]
nuuaber: raises $2 to $3
Strikerman25: folds 
matiko09: folds 
rate8: folds 
janarr5: folds 
cap. marb: folds 
vanilica: folds 
Zeeshka: folds 
Uncalled bet ($2) returned to nuuaber
nuuaber collected $2.50 from pot
nuuaber: doesn't show hand 
*** SUMMARY ***
Total pot $2.50 | Rake $0 
Seat 1: cap. marb (button) folded before Flop (didn't bet)
Seat 3: vanilica (small blind) folded before Flop
Seat 4: Zeeshka (big blind) folded before Flop
Seat 5: nuuaber collected ($2.50)
Seat 6: Strikerman25 folded before Flop (didn't bet)
Seat 7: matiko09 folded before Flop (didn't bet)
Seat 8: rate8 folded before Flop (didn't bet)
Seat 9: janarr5 folded before Flop (didn't bet)





PokerStars Hand #153507899817:  Hold'em No Limit ($0.50/$1.00 USD) - 2016/05/18 22:17:23 CET [2016/05/18 16:17:23 ET]
Table 'Tatjana III' 9-max Seat #2 is the button
Seat 1: cap. marb ($42.60 in chips) 
Seat 2: vanilica ($118.64 in chips) 
Seat 3: matiko09 ($182.90 in chips) 
Seat 4: Strikerman25 ($40 in chips) 
Seat 5: deadkiller1 ($108.43 in chips) 
Seat 6: maunzz ($100 in chips) 
Seat 7: rene1984tsv ($239.76 in chips) 
Seat 8: badmadrabbit ($106.79 in chips) 
Seat 9: Moszes360 ($100 in chips) 
matiko09: posts small blind $0.50
Strikerman25: posts big blind $1
*** HOLE CARDS ***
Dealt to matiko09 [4h 2h]
deadkiller1: folds 
maunzz: raises $2 to $3
rene1984tsv: calls $3
badmadrabbit: folds 
Moszes360: folds 
cap. marb: folds 
vanilica: calls $3
matiko09: folds 
Strikerman25: folds 
*** FLOP *** [Ad 4d Jc]
maunzz: checks 
rene1984tsv: checks 
vanilica: checks 
*** TURN *** [Ad 4d Jc] [Td]
maunzz: checks 
rene1984tsv: checks 
vanilica: checks 
*** RIVER *** [Ad 4d Jc Td] [Qd]
maunzz: checks 
rene1984tsv: bets $1
vanilica: calls $1
maunzz: folds 
*** SHOW DOWN ***
rene1984tsv: shows [6h Ks] (a straight, Ten to Ace)
vanilica: shows [9d 9c] (a flush, Ace high)
vanilica collected $11.88 from pot
*** SUMMARY ***
Total pot $12.50 | Rake $0.62 
Board [Ad 4d Jc Td Qd]
Seat 1: cap. marb folded before Flop (didn't bet)
Seat 2: vanilica (button) showed [9d 9c] and won ($11.88) with a flush, Ace high
Seat 3: matiko09 (small blind) folded before Flop
Seat 4: Strikerman25 (big blind) folded before Flop
Seat 5: deadkiller1 folded before Flop (didn't bet)
Seat 6: maunzz folded on the River
Seat 7: rene1984tsv showed [6h Ks] and lost with a straight, Ten to Ace
Seat 8: badmadrabbit folded before Flop (didn't bet)
Seat 9: Moszes360 folded before Flop (didn't bet)





PokerStars Hand #153507901336:  Hold'em No Limit ($0.50/$1.00 USD) - 2016/05/18 22:17:25 CET [2016/05/18 16:17:25 ET]
Table 'Zanaih II' 9-max Seat #5 is the button
Seat 5: sova77 ($60 in chips) 
Seat 7: matiko09 ($100 in chips) 
Seat 8: LadyMaCe86 ($100 in chips) 
maunzz joins the table at seat #9 
matiko09: posts small blind $0.50
LadyMaCe86: posts big blind $1
*** HOLE CARDS ***
Dealt to matiko09 [2s 7d]
sova77: raises $2 to $3
matiko09: folds 
LadyMaCe86: folds 
Uncalled bet ($2) returned to sova77
sova77 collected $2.50 from pot
sova77: doesn't show hand 
*** SUMMARY ***
Total pot $2.50 | Rake $0 
Seat 5: sova77 (button) collected ($2.50)
Seat 7: matiko09 (small blind) folded before Flop
Seat 8: LadyMaCe86 (big blind) folded before Flop





PokerStars Hand #153507913980:  Hold'em No Limit ($0.50/$1.00 USD) - 2016/05/18 22:17:39 CET [2016/05/18 16:17:39 ET]
Table 'Abetti II' 9-max Seat #7 is the button
Seat 1: matiko09 ($151.28 in chips) 
Seat 2: Cortine ($100 in chips) 
Seat 3: cap. marb ($72.26 in chips) 
Seat 4: stepan0605 ($228.31 in chips) 
Seat 5: blufthenuts ($151.11 in chips) 
Seat 7: rate8 ($144.28 in chips) 
Seat 8: roadster683 ($20.23 in chips) 
Seat 9: vanilica ($140.11 in chips) 
roadster683: posts small blind $0.50
vanilica: posts big blind $1
xHourglass: sits out 
*** HOLE CARDS ***
Dealt to matiko09 [4d Kd]
matiko09: folds 
Cortine: folds 
cap. marb: folds 
stepan0605: raises $2 to $3
blufthenuts: folds 
rate8: folds 
roadster683: raises $17.23 to $20.23 and is all-in
vanilica: folds 
stepan0605: calls $17.23
*** FLOP *** [Jc Qh 8d]
*** TURN *** [Jc Qh 8d] [6d]
*** RIVER *** [Jc Qh 8d 6d] [6c]
*** SHOW DOWN ***
roadster683: shows [Qc Ks] (two pair, Queens and Sixes)
stepan0605: shows [Ts Kh] (a pair of Sixes)
roadster683 collected $39.39 from pot
*** SUMMARY ***
Total pot $41.46 | Rake $2.07 
Board [Jc Qh 8d 6d 6c]
Seat 1: matiko09 folded before Flop (didn't bet)
Seat 2: Cortine folded before Flop (didn't bet)
Seat 3: cap. marb folded before Flop (didn't bet)
Seat 4: stepan0605 showed [Ts Kh] and lost with a pair of Sixes
Seat 5: blufthenuts folded before Flop (didn't bet)
Seat 7: rate8 (button) folded before Flop (didn't bet)
Seat 8: roadster683 (small blind) showed [Qc Ks] and won ($39.39) with two pair, Queens and Sixes
Seat 9: vanilica (big blind) folded before Flop





PokerStars Hand #153507922034:  Hold'em No Limit ($0.50/$1.00 USD) - 2016/05/18 22:17:47 CET [2016/05/18 16:17:47 ET]
Table 'Brendelia II' 9-max Seat #7 is the button
Seat 1: cap. marb ($71.74 in chips) 
Seat 2: rate8 ($151.62 in chips) 
Seat 3: Zeeshka ($100 in chips) 
Seat 4: gkm0nk3y ($114.24 in chips) 
Seat 5: Vulturinus ($22.33 in chips) 
Seat 7: matiko09 ($100 in chips) 
Seat 8: solbi86 ($100 in chips) 
Seat 9: fr3314nc3 ($92.88 in chips) 
solbi86: posts small blind $0.50
fr3314nc3: posts big blind $1
*** HOLE CARDS ***
Dealt to matiko09 [Jd 3h]
cap. marb: folds 
rate8: folds 
Zeeshka: folds 
gkm0nk3y: folds 
Vulturinus: folds 
matiko09: folds 
solbi86: raises $1.50 to $2.50
fr3314nc3: folds 
Uncalled bet ($1.50) returned to solbi86
solbi86 collected $2 from pot
solbi86: doesn't show hand 
*** SUMMARY ***
Total pot $2 | Rake $0 
Seat 1: cap. marb folded before Flop (didn't bet)
Seat 2: rate8 folded before Flop (didn't bet)
Seat 3: Zeeshka folded before Flop (didn't bet)
Seat 4: gkm0nk3y folded before Flop (didn't bet)
Seat 5: Vulturinus folded before Flop (didn't bet)
Seat 7: matiko09 (button) folded before Flop (didn't bet)
Seat 8: solbi86 (small blind) collected ($2)
Seat 9: fr3314nc3 (big blind) folded before Flop





PokerStars Hand #153507930197:  Hold'em No Limit ($0.50/$1.00 USD) - 2016/05/18 22:17:56 CET [2016/05/18 16:17:56 ET]
Table 'Samitchell II' 9-max Seat #3 is the button
Seat 1: cap. marb ($37 in chips) 
Seat 3: vanilica ($165.10 in chips) 
Seat 4: Zeeshka ($114.39 in chips) 
Seat 5: nuuaber ($26.44 in chips) 
Seat 6: Strikerman25 ($66.82 in chips) 
Seat 7: matiko09 ($119.15 in chips) 
Seat 8: rate8 ($103.52 in chips) 
Seat 9: janarr5 ($103.50 in chips) 
Zeeshka: posts small blind $0.50
nuuaber: posts big blind $1
*** HOLE CARDS ***
Dealt to matiko09 [4d 6s]
Strikerman25: folds 
matiko09: folds 
rate8: folds 
janarr5: folds 
cap. marb: folds 
vanilica: folds 
Zeeshka: raises $1.50 to $2.50
nuuaber: folds 
Uncalled bet ($1.50) returned to Zeeshka
Zeeshka collected $2 from pot
Zeeshka: doesn't show hand 
*** SUMMARY ***
Total pot $2 | Rake $0 
Seat 1: cap. marb folded before Flop (didn't bet)
Seat 3: vanilica (button) folded before Flop (didn't bet)
Seat 4: Zeeshka (small blind) collected ($2)
Seat 5: nuuaber (big blind) folded before Flop
Seat 6: Strikerman25 folded before Flop (didn't bet)
Seat 7: matiko09 folded before Flop (didn't bet)
Seat 8: rate8 folded before Flop (didn't bet)
Seat 9: janarr5 folded before Flop (didn't bet)





PokerStars Hand #153507932688:  Hold'em No Limit ($0.50/$1.00 USD) - 2016/05/18 22:17:59 CET [2016/05/18 16:17:59 ET]
Table 'Zanaih II' 9-max Seat #7 is the button
Seat 5: sova77 ($61.50 in chips) 
Seat 7: matiko09 ($100 in chips) 
Seat 8: LadyMaCe86 ($100 in chips) 
Seat 9: maunzz ($100 in chips) 
LadyMaCe86: posts small blind $0.50
maunzz: posts big blind $1
*** HOLE CARDS ***
Dealt to matiko09 [Js 9d]
sova77: raises $1 to $2
matiko09: folds 
LadyMaCe86: folds 
maunzz: calls $1
*** FLOP *** [5d 3d 2c]
maunzz: checks 
sova77: bets $3
maunzz: calls $3
*** TURN *** [5d 3d 2c] [7s]
maunzz: checks 
sova77: bets $6
maunzz: calls $6
*** RIVER *** [5d 3d 2c 7s] [Kd]
maunzz: checks 
sova77: checks 
*** SHOW DOWN ***
maunzz: shows [8s 8d] (a pair of Eights)
sova77: mucks hand 
maunzz collected $21.50 from pot
*** SUMMARY ***
Total pot $22.50 | Rake $1 
Board [5d 3d 2c 7s Kd]
Seat 5: sova77 mucked [6h 6s]
Seat 7: matiko09 (button) folded before Flop (didn't bet)
Seat 8: LadyMaCe86 (small blind) folded before Flop
Seat 9: maunzz (big blind) showed [8s 8d] and won ($21.50) with a pair of Eights





PokerStars Hand #153507933318:  Hold'em No Limit ($0.50/$1.00 USD) - 2016/05/18 22:17:59 CET [2016/05/18 16:17:59 ET]
Table 'Haedus' 9-max Seat #6 is the button
Seat 1: søren610 ($25.10 in chips) 
Seat 4: solbi86 ($100 in chips) 
Seat 5: matiko09 ($100 in chips) 
Seat 6: maunzz ($120.15 in chips) 
Seat 8: Neetbom ($80.64 in chips) 
Seat 9: yurinho21 ($100 in chips) 
Ty Nick 420 will be allowed to play after the button
Neetbom: posts small blind $0.50
yurinho21: posts big blind $1
*** HOLE CARDS ***
Dealt to matiko09 [8d Kc]
søren610: folds 
solbi86: folds 
matiko09: folds 
maunzz: raises $1 to $2
søren610 leaves the table
Neetbom: folds 
yurinho21: folds 
Uncalled bet ($1) returned to maunzz
maunzz collected $2.50 from pot
maunzz: doesn't show hand 
*** SUMMARY ***
Total pot $2.50 | Rake $0 
Seat 1: søren610 folded before Flop (didn't bet)
Seat 4: solbi86 folded before Flop (didn't bet)
Seat 5: matiko09 folded before Flop (didn't bet)
Seat 6: maunzz (button) collected ($2.50)
Seat 8: Neetbom (small blind) folded before Flop
Seat 9: yurinho21 (big blind) folded before Flop





PokerStars Hand #153507945345:  Hold'em No Limit ($0.50/$1.00 USD) - 2016/05/18 22:18:13 CET [2016/05/18 16:18:13 ET]
Table 'Tatjana III' 9-max Seat #3 is the button
Seat 1: cap. marb ($42.60 in chips) 
Seat 2: vanilica ($126.52 in chips) 
Seat 3: matiko09 ($182.40 in chips) 
Seat 4: Strikerman25 ($39 in chips) 
Seat 5: deadkiller1 ($108.43 in chips) 
Seat 6: maunzz ($100 in chips) 
Seat 7: rene1984tsv ($235.76 in chips) 
Seat 8: badmadrabbit ($106.79 in chips) 
Seat 9: Moszes360 ($100 in chips) 
Strikerman25: posts small blind $0.50
deadkiller1: posts big blind $1
*** HOLE CARDS ***
Dealt to matiko09 [Ks 6h]
maunzz: folds 
rene1984tsv: calls $1
badmadrabbit: folds 
Moszes360: folds 
cap. marb: folds 
vanilica: raises $2.59 to $3.59
matiko09: folds 
Strikerman25: folds 
deadkiller1: folds 
rene1984tsv: calls $2.59
*** FLOP *** [7s 5c 9s]
rene1984tsv: checks 
vanilica: bets $6.10
rene1984tsv: calls $6.10
*** TURN *** [7s 5c 9s] [Ts]
rene1984tsv: checks 
vanilica: bets $14.68
rene1984tsv: calls $14.68
*** RIVER *** [7s 5c 9s Ts] [3h]
rene1984tsv: bets $47.74
vanilica: calls $47.74
*** SHOW DOWN ***
rene1984tsv: shows [4c 6s] (a straight, Three to Seven)
vanilica: mucks hand 
rene1984tsv collected $143.22 from pot
*** SUMMARY ***
Total pot $145.72 | Rake $2.50 
Board [7s 5c 9s Ts 3h]
Seat 1: cap. marb folded before Flop (didn't bet)
Seat 2: vanilica mucked [Td 9c]
Seat 3: matiko09 (button) folded before Flop (didn't bet)
Seat 4: Strikerman25 (small blind) folded before Flop
Seat 5: deadkiller1 (big blind) folded before Flop
Seat 6: maunzz folded before Flop (didn't bet)
Seat 7: rene1984tsv showed [4c 6s] and won ($143.22) with a straight, Three to Seven
Seat 8: badmadrabbit folded before Flop (didn't bet)
Seat 9: Moszes360 folded before Flop (didn't bet)





PokerStars Hand #153507950296:  Hold'em No Limit (€0.50/€1.00 EUR) - 2016/05/18 22:18:18 CET [2016/05/18 16:18:18 ET]
Table 'Sarmiento III' 9-max Seat #9 is the button
Seat 1: LadyMaCe86 (€123.21 in chips) 
Seat 2: Kreuznagel (€100 in chips) 
Seat 4: AugderStarke (€99 in chips) 
Seat 5: rexalex2012 (€34.55 in chips) 
Seat 7: JACQUILF (€100 in chips) 
Seat 8: matiko09 (€100 in chips) 
Seat 9: vanilica (€100 in chips) 
LadyMaCe86: posts small blind €0.50
Kreuznagel: posts big blind €1
Mashulia7777: sits out 
*** HOLE CARDS ***
Dealt to matiko09 [Th Kc]
AugderStarke: folds 
rexalex2012: raises €1 to €2
JACQUILF: folds 
matiko09: folds 
vanilica: folds 
LadyMaCe86: raises €4 to €6
Kreuznagel: folds 
rexalex2012: raises €4 to €10
LadyMaCe86: raises €30 to €40
rexalex2012: calls €24.55 and is all-in
Uncalled bet (€5.45) returned to LadyMaCe86
*** FLOP *** [4c 8s 8c]
*** TURN *** [4c 8s 8c] [6h]
*** RIVER *** [4c 8s 8c 6h] [Td]
*** SHOW DOWN ***
LadyMaCe86: shows [Ah Jd] (a pair of Eights)
rexalex2012: shows [Jc Jh] (two pair, Jacks and Eights)
rexalex2012 collected €67.85 from pot
*** SUMMARY ***
Total pot €70.10 | Rake €2.25 
Board [4c 8s 8c 6h Td]
Seat 1: LadyMaCe86 (small blind) showed [Ah Jd] and lost with a pair of Eights
Seat 2: Kreuznagel (big blind) folded before Flop
Seat 4: AugderStarke folded before Flop (didn't bet)
Seat 5: rexalex2012 showed [Jc Jh] and won (€67.85) with two pair, Jacks and Eights
Seat 7: JACQUILF folded before Flop (didn't bet)
Seat 8: matiko09 folded before Flop (didn't bet)
Seat 9: vanilica (button) folded before Flop (didn't bet)





PokerStars Hand #153507958034:  Hold'em No Limit ($0.50/$1.00 USD) - 2016/05/18 22:18:27 CET [2016/05/18 16:18:27 ET]
Table 'Samitchell II' 9-max Seat #4 is the button
Seat 1: cap. marb ($37 in chips) 
Seat 3: vanilica ($165.10 in chips) 
Seat 4: Zeeshka ($115.39 in chips) 
Seat 5: nuuaber ($25.44 in chips) 
Seat 7: matiko09 ($119.15 in chips) 
Seat 8: rate8 ($103.52 in chips) 
Seat 9: janarr5 ($103.50 in chips) 
nuuaber: posts small blind $0.50
Strikerman25: is sitting out 
Strikerman25 leaves the table
matiko09: posts big blind $1
*** HOLE CARDS ***
Dealt to matiko09 [3c 5d]
rate8: folds 
janarr5: folds 
Moszes360 joins the table at seat #6 
Moszes360 leaves the table
cap. marb: folds 
vanilica: folds 
TimStone joins the table at seat #6 
Zeeshka: folds 
nuuaber: folds 
Uncalled bet ($0.50) returned to matiko09
matiko09 collected $1 from pot
matiko09: doesn't show hand 
*** SUMMARY ***
Total pot $1 | Rake $0 
Seat 1: cap. marb folded before Flop (didn't bet)
Seat 3: vanilica folded before Flop (didn't bet)
Seat 4: Zeeshka (button) folded before Flop (didn't bet)
Seat 5: nuuaber (small blind) folded before Flop
Seat 7: matiko09 (big blind) collected ($1)
Seat 8: rate8 folded before Flop (didn't bet)
Seat 9: janarr5 folded before Flop (didn't bet)





PokerStars Hand #153507966433:  Hold'em No Limit ($0.50/$1.00 USD) - 2016/05/18 22:18:35 CET [2016/05/18 16:18:35 ET]
Table 'Brendelia II' 9-max Seat #8 is the button
Seat 1: cap. marb ($71.74 in chips) 
Seat 2: rate8 ($151.62 in chips) 
Seat 3: Zeeshka ($100 in chips) 
Seat 4: gkm0nk3y ($114.24 in chips) 
Seat 5: Vulturinus ($22.33 in chips) 
Seat 7: matiko09 ($100 in chips) 
Seat 8: solbi86 ($101 in chips) 
Seat 9: fr3314nc3 ($91.88 in chips) 
fr3314nc3: posts small blind $0.50
cap. marb: posts big blind $1
*** HOLE CARDS ***
Dealt to matiko09 [7c 6c]
rate8: folds 
Zeeshka: folds 
gkm0nk3y: folds 
Vulturinus: folds 
matiko09: raises $1.50 to $2.50
solbi86: folds 
fr3314nc3: folds 
cap. marb: folds 
Uncalled bet ($1.50) returned to matiko09
matiko09 collected $2.50 from pot
matiko09: doesn't show hand 
*** SUMMARY ***
Total pot $2.50 | Rake $0 
Seat 1: cap. marb (big blind) folded before Flop
Seat 2: rate8 folded before Flop (didn't bet)
Seat 3: Zeeshka folded before Flop (didn't bet)
Seat 4: gkm0nk3y folded before Flop (didn't bet)
Seat 5: Vulturinus folded before Flop (didn't bet)
Seat 7: matiko09 collected ($2.50)
Seat 8: solbi86 (button) folded before Flop (didn't bet)
Seat 9: fr3314nc3 (small blind) folded before Flop





PokerStars Hand #153507974471:  Hold'em No Limit ($0.50/$1.00 USD) - 2016/05/18 22:18:44 CET [2016/05/18 16:18:44 ET]
Table 'Abetti II' 9-max Seat #8 is the button
Seat 1: matiko09 ($151.28 in chips) 
Seat 2: Cortine ($100 in chips) 
Seat 3: cap. marb ($72.26 in chips) 
Seat 4: stepan0605 ($208.08 in chips) 
Seat 5: blufthenuts ($151.11 in chips) 
Seat 7: rate8 ($144.28 in chips) 
Seat 8: roadster683 ($39.39 in chips) 
Seat 9: vanilica ($139.11 in chips) 
vanilica: posts small blind $0.50
matiko09: posts big blind $1
xHourglass: sits out 
*** HOLE CARDS ***
Dealt to matiko09 [2h Td]
Cortine: folds 
cap. marb: folds 
stepan0605: raises $2 to $3
blufthenuts: folds 
rate8: calls $3
roadster683: raises $36.39 to $39.39 and is all-in
vanilica: folds 
matiko09: folds 
stepan0605: calls $36.39
rate8: folds 
*** FLOP *** [6c 9s 6h]
*** TURN *** [6c 9s 6h] [9h]
*** RIVER *** [6c 9s 6h 9h] [3h]
*** SHOW DOWN ***
stepan0605: shows [As Ad] (two pair, Aces and Nines)
roadster683: shows [Qd Kh] (two pair, Nines and Sixes)
stepan0605 collected $80.78 from pot
*** SUMMARY ***
Total pot $83.28 | Rake $2.50 
Board [6c 9s 6h 9h 3h]
Seat 1: matiko09 (big blind) folded before Flop
Seat 2: Cortine folded before Flop (didn't bet)
Seat 3: cap. marb folded before Flop (didn't bet)
Seat 4: stepan0605 showed [As Ad] and won ($80.78) with two pair, Aces and Nines
Seat 5: blufthenuts folded before Flop (didn't bet)
Seat 7: rate8 folded before Flop
Seat 8: roadster683 (button) showed [Qd Kh] and lost with two pair, Nines and Sixes
Seat 9: vanilica (small blind) folded before Flop





PokerStars Hand #153507978068:  Hold'em No Limit ($0.50/$1.00 USD) - 2016/05/18 22:18:48 CET [2016/05/18 16:18:48 ET]
Table 'Zanaih II' 9-max Seat #8 is the button
Seat 5: sova77 ($50.50 in chips) 
Seat 7: matiko09 ($100 in chips) 
Seat 8: LadyMaCe86 ($100 in chips) 
Seat 9: maunzz ($110.50 in chips) 
maunzz: posts small blind $0.50
sova77: posts big blind $1
*** HOLE CARDS ***
Dealt to matiko09 [2h Tc]
matiko09: folds 
LadyMaCe86: raises $1.10 to $2.10
maunzz: folds 
sova77: folds 
Uncalled bet ($1.10) returned to LadyMaCe86
LadyMaCe86 collected $2.50 from pot
LadyMaCe86: doesn't show hand 
*** SUMMARY ***
Total pot $2.50 | Rake $0 
Seat 5: sova77 (big blind) folded before Flop
Seat 7: matiko09 folded before Flop (didn't bet)
Seat 8: LadyMaCe86 (button) collected ($2.50)
Seat 9: maunzz (small blind) folded before Flop





PokerStars Hand #153507980170:  Hold'em No Limit ($0.50/$1.00 USD) - 2016/05/18 22:18:50 CET [2016/05/18 16:18:50 ET]
Table 'Samitchell II' 9-max Seat #5 is the button
Seat 1: cap. marb ($37 in chips) 
Seat 3: vanilica ($165.10 in chips) 
Seat 4: Zeeshka ($115.39 in chips) 
Seat 5: nuuaber ($24.94 in chips) 
Seat 7: matiko09 ($119.65 in chips) 
Seat 8: rate8 ($103.52 in chips) 
Seat 9: janarr5 ($103.50 in chips) 
matiko09: posts small blind $0.50
rate8: posts big blind $1
*** HOLE CARDS ***
Dealt to matiko09 [9s Jc]
janarr5: folds 
cap. marb: folds 
vanilica: folds 
Zeeshka: raises $1.50 to $2.50
nuuaber: folds 
matiko09: folds 
rate8: calls $1.50
*** FLOP *** [6h 4c 3s]
rate8: checks 
Zeeshka: bets $3
rate8: calls $3
*** TURN *** [6h 4c 3s] [7h]
rate8: checks 
Zeeshka: checks 
*** RIVER *** [6h 4c 3s 7h] [8c]
rate8: bets $5.67
Zeeshka: folds 
Uncalled bet ($5.67) returned to rate8
rate8 collected $10.92 from pot
rate8: doesn't show hand 
*** SUMMARY ***
Total pot $11.50 | Rake $0.58 
Board [6h 4c 3s 7h 8c]
Seat 1: cap. marb folded before Flop (didn't bet)
Seat 3: vanilica folded before Flop (didn't bet)
Seat 4: Zeeshka folded on the River
Seat 5: nuuaber (button) folded before Flop (didn't bet)
Seat 7: matiko09 (small blind) folded before Flop
Seat 8: rate8 (big blind) collected ($10.92)
Seat 9: janarr5 folded before Flop (didn't bet)





PokerStars Hand #153507990089:  Hold'em No Limit ($0.50/$1.00 USD) - 2016/05/18 22:19:01 CET [2016/05/18 16:19:01 ET]
Table 'Tatjana III' 9-max Seat #4 is the button
Seat 1: cap. marb ($42.60 in chips) 
Seat 2: vanilica ($100 in chips) 
Seat 3: matiko09 ($182.40 in chips) 
Seat 4: Strikerman25 ($38.50 in chips) 
Seat 5: deadkiller1 ($107.43 in chips) 
Seat 6: maunzz ($100 in chips) 
Seat 7: rene1984tsv ($306.87 in chips) 
Seat 8: badmadrabbit ($106.79 in chips) 
Seat 9: Moszes360 ($100 in chips) 
deadkiller1: posts small blind $0.50
maunzz: posts big blind $1
*** HOLE CARDS ***
Dealt to matiko09 [Kh 5h]
rene1984tsv: folds 
badmadrabbit: folds 
Moszes360: folds 
cap. marb: folds 
vanilica: folds 
matiko09: folds 
Strikerman25: folds 
deadkiller1: folds 
Uncalled bet ($0.50) returned to maunzz
maunzz collected $1 from pot
maunzz: doesn't show hand 
*** SUMMARY ***
Total pot $1 | Rake $0 
Seat 1: cap. marb folded before Flop (didn't bet)
Seat 2: vanilica folded before Flop (didn't bet)
Seat 3: matiko09 folded before Flop (didn't bet)
Seat 4: Strikerman25 (button) folded before Flop (didn't bet)
Seat 5: deadkiller1 (small blind) folded before Flop
Seat 6: maunzz (big blind) collected ($1)
Seat 7: rene1984tsv folded before Flop (didn't bet)
Seat 8: badmadrabbit folded before Flop (didn't bet)
Seat 9: Moszes360 folded before Flop (didn't bet)





PokerStars Hand #153507992662:  Hold'em No Limit (€0.50/€1.00 EUR) - 2016/05/18 22:19:04 CET [2016/05/18 16:19:04 ET]
Table 'Sarmiento III' 9-max Seat #1 is the button
Seat 1: LadyMaCe86 (€100 in chips) 
Seat 2: Kreuznagel (€100 in chips) 
Seat 3: Mashulia7777 (€40 in chips) 
Seat 4: AugderStarke (€99 in chips) 
Seat 5: rexalex2012 (€67.85 in chips) 
Seat 7: JACQUILF (€100 in chips) 
Seat 8: matiko09 (€100 in chips) 
Seat 9: vanilica (€100 in chips) 
Kreuznagel: posts small blind €0.50
Mashulia7777: posts big blind €1
*** HOLE CARDS ***
Dealt to matiko09 [Kd 5h]
AugderStarke: folds 
rexalex2012: folds 
JACQUILF: folds 
matiko09: folds 
vanilica: folds 
LadyMaCe86: folds 
Kreuznagel: folds 
Uncalled bet (€0.50) returned to Mashulia7777
Mashulia7777 collected €1 from pot
Mashulia7777: doesn't show hand 
*** SUMMARY ***
Total pot €1 | Rake €0 
Seat 1: LadyMaCe86 (button) folded before Flop (didn't bet)
Seat 2: Kreuznagel (small blind) folded before Flop
Seat 3: Mashulia7777 (big blind) collected (€1)
Seat 4: AugderStarke folded before Flop (didn't bet)
Seat 5: rexalex2012 folded before Flop (didn't bet)
Seat 7: JACQUILF folded before Flop (didn't bet)
Seat 8: matiko09 folded before Flop (didn't bet)
Seat 9: vanilica folded before Flop (didn't bet)





PokerStars Hand #153507994112:  Hold'em No Limit ($0.50/$1.00 USD) - 2016/05/18 22:19:06 CET [2016/05/18 16:19:06 ET]
Table 'Brendelia II' 9-max Seat #9 is the button
Seat 1: cap. marb ($70.74 in chips) 
Seat 2: rate8 ($151.62 in chips) 
Seat 3: Zeeshka ($100 in chips) 
Seat 4: gkm0nk3y ($114.24 in chips) 
Seat 5: Vulturinus ($22.33 in chips) 
Seat 7: matiko09 ($101.50 in chips) 
Seat 8: solbi86 ($101 in chips) 
Seat 9: fr3314nc3 ($91.38 in chips) 
cap. marb: posts small blind $0.50
rate8: posts big blind $1
*** HOLE CARDS ***
Dealt to matiko09 [4c Tc]
Zeeshka: folds 
gkm0nk3y: folds 
Vulturinus: folds 
matiko09: folds 
solbi86: folds 
fr3314nc3: folds 
cap. marb: raises $1.50 to $2.50
rate8: folds 
Uncalled bet ($1.50) returned to cap. marb
cap. marb collected $2 from pot
cap. marb: doesn't show hand 
*** SUMMARY ***
Total pot $2 | Rake $0 
Seat 1: cap. marb (small blind) collected ($2)
Seat 2: rate8 (big blind) folded before Flop
Seat 3: Zeeshka folded before Flop (didn't bet)
Seat 4: gkm0nk3y folded before Flop (didn't bet)
Seat 5: Vulturinus folded before Flop (didn't bet)
Seat 7: matiko09 folded before Flop (didn't bet)
Seat 8: solbi86 folded before Flop (didn't bet)
Seat 9: fr3314nc3 (button) folded before Flop (didn't bet)





PokerStars Hand #153507998942:  Hold'em No Limit ($0.50/$1.00 USD) - 2016/05/18 22:19:11 CET [2016/05/18 16:19:11 ET]
Table 'Zanaih II' 9-max Seat #9 is the button
Seat 5: sova77 ($49.50 in chips) 
Seat 7: matiko09 ($100 in chips) 
Seat 8: LadyMaCe86 ($101.50 in chips) 
Seat 9: maunzz ($110 in chips) 
sova77: posts small blind $0.50
matiko09: posts big blind $1
*** HOLE CARDS ***
Dealt to matiko09 [3s 4h]
LadyMaCe86: folds 
maunzz: folds 
sova77: folds 
Uncalled bet ($0.50) returned to matiko09
matiko09 collected $1 from pot
matiko09: doesn't show hand 
*** SUMMARY ***
Total pot $1 | Rake $0 
Seat 5: sova77 (small blind) folded before Flop
Seat 7: matiko09 (big blind) collected ($1)
Seat 8: LadyMaCe86 folded before Flop (didn't bet)
Seat 9: maunzz (button) folded before Flop (didn't bet)





PokerStars Hand #153508007220:  Hold'em No Limit (€0.50/€1.00 EUR) - 2016/05/18 22:19:20 CET [2016/05/18 16:19:20 ET]
Table 'Sarmiento III' 9-max Seat #2 is the button
Seat 1: LadyMaCe86 (€100 in chips) 
Seat 2: Kreuznagel (€100 in chips) 
Seat 3: Mashulia7777 (€40.50 in chips) 
Seat 4: AugderStarke (€99 in chips) 
Seat 5: rexalex2012 (€67.85 in chips) 
Seat 7: JACQUILF (€100 in chips) 
Seat 8: matiko09 (€100 in chips) 
Seat 9: vanilica (€100 in chips) 
Mashulia7777: posts small blind €0.50
AugderStarke: posts big blind €1
*** HOLE CARDS ***
Dealt to matiko09 [Th Td]
rexalex2012: folds 
JACQUILF: folds 
matiko09: raises €2 to €3
vanilica: folds 
LadyMaCe86: folds 
Kreuznagel: folds 
Mashulia7777: raises €4.50 to €7.50
AugderStarke: folds 
matiko09: calls €4.50
*** FLOP *** [As Ah Ad]
Mashulia7777: bets €6.50
matiko09: calls €6.50
*** TURN *** [As Ah Ad] [Js]
Mashulia7777: checks 
matiko09: checks 
*** RIVER *** [As Ah Ad Js] [Kh]
Mashulia7777: checks 
matiko09: checks 
*** SHOW DOWN ***
Mashulia7777: shows [Qh Qd] (a full house, Aces full of Queens)
matiko09: mucks hand 
Mashulia7777 collected €27.55 from pot
*** SUMMARY ***
Total pot €29 | Rake €1.45 
Board [As Ah Ad Js Kh]
Seat 1: LadyMaCe86 folded before Flop (didn't bet)
Seat 2: Kreuznagel (button) folded before Flop (didn't bet)
Seat 3: Mashulia7777 (small blind) showed [Qh Qd] and won (€27.55) with a full house, Aces full of Queens
Seat 4: AugderStarke (big blind) folded before Flop
Seat 5: rexalex2012 folded before Flop (didn't bet)
Seat 7: JACQUILF folded before Flop (didn't bet)
Seat 8: matiko09 mucked [Th Td]
Seat 9: vanilica folded before Flop (didn't bet)





PokerStars Hand #153508008588:  Hold'em No Limit ($0.50/$1.00 USD) - 2016/05/18 22:19:22 CET [2016/05/18 16:19:22 ET]
Table 'Zanaih II' 9-max Seat #5 is the button
Seat 5: sova77 ($49 in chips) 
Seat 7: matiko09 ($100.50 in chips) 
Seat 8: LadyMaCe86 ($101.50 in chips) 
Seat 9: maunzz ($110 in chips) 
matiko09: posts small blind $0.50
LadyMaCe86: posts big blind $1
*** HOLE CARDS ***
Dealt to matiko09 [Th Ah]
maunzz: raises $1 to $2
sova77: calls $2
matiko09: calls $1.50
LadyMaCe86: calls $1
*** FLOP *** [Jc 8s 6s]
matiko09: checks 
LadyMaCe86: checks 
maunzz: checks 
sova77: checks 
*** TURN *** [Jc 8s 6s] [9c]
Chris pic77 joins the table at seat #1 
matiko09: checks 
LadyMaCe86: bets $5
JACQUILF joins the table at seat #2 
maunzz: folds 
sova77: calls $5
matiko09: calls $5
*** RIVER *** [Jc 8s 6s 9c] [5h]
matiko09: checks 
LadyMaCe86: checks 
sova77: bets $22
matiko09: folds 
LadyMaCe86: folds 
Uncalled bet ($22) returned to sova77
sova77 collected $22 from pot
sova77: doesn't show hand 
*** SUMMARY ***
Total pot $23 | Rake $1 
Board [Jc 8s 6s 9c 5h]
Seat 5: sova77 (button) collected ($22)
Seat 7: matiko09 (small blind) folded on the River
Seat 8: LadyMaCe86 (big blind) folded on the River
Seat 9: maunzz folded on the Turn





PokerStars Hand #153508008977:  Hold'em No Limit ($0.50/$1.00 USD) - 2016/05/18 22:19:22 CET [2016/05/18 16:19:22 ET]
Table 'Abetti II' 9-max Seat #9 is the button
Seat 1: matiko09 ($150.28 in chips) 
Seat 3: cap. marb ($72.26 in chips) 
Seat 4: stepan0605 ($249.47 in chips) 
Seat 5: blufthenuts ($151.11 in chips) 
Seat 7: rate8 ($141.28 in chips) 
Seat 9: vanilica ($138.61 in chips) 
matiko09: posts small blind $0.50
Cortine: is sitting out 
cap. marb: posts big blind $1
xHourglass: sits out 
*** HOLE CARDS ***
Dealt to matiko09 [Ac 3h]
stepan0605: folds 
blufthenuts: folds 
rate8: folds 
vanilica: folds 
matiko09: raises $2 to $3
cap. marb: calls $2
*** FLOP *** [Jh 4d 9d]
matiko09: checks 
cap. marb: bets $3.76
roadster683 is disconnected 
matiko09: folds 
Uncalled bet ($3.76) returned to cap. marb
cap. marb collected $5.70 from pot
cap. marb: doesn't show hand 
*** SUMMARY ***
Total pot $6 | Rake $0.30 
Board [Jh 4d 9d]
Seat 1: matiko09 (small blind) folded on the Flop
Seat 3: cap. marb (big blind) collected ($5.70)
Seat 4: stepan0605 folded before Flop (didn't bet)
Seat 5: blufthenuts folded before Flop (didn't bet)
Seat 7: rate8 folded before Flop (didn't bet)
Seat 9: vanilica (button) folded before Flop (didn't bet)





PokerStars Hand #153508016408:  Hold'em No Limit ($0.50/$1.00 USD) - 2016/05/18 22:19:30 CET [2016/05/18 16:19:30 ET]
Table 'Brendelia II' 9-max Seat #1 is the button
Seat 1: cap. marb ($71.74 in chips) 
Seat 2: rate8 ($150.62 in chips) 
Seat 3: Zeeshka ($100 in chips) 
Seat 4: gkm0nk3y ($114.24 in chips) 
Seat 5: Vulturinus ($22.33 in chips) 
Seat 7: matiko09 ($101.50 in chips) 
Seat 8: solbi86 ($101 in chips) 
Seat 9: fr3314nc3 ($91.38 in chips) 
rate8: posts small blind $0.50
Zeeshka: posts big blind $1
*** HOLE CARDS ***
Dealt to matiko09 [Qs As]
gkm0nk3y: folds 
Vulturinus: folds 
matiko09: raises $2 to $3
solbi86: calls $3
fr3314nc3: folds 
cap. marb: folds 
rate8: raises $10 to $13
Zeeshka: folds 
matiko09: calls $10
solbi86: folds 
*** FLOP *** [Td Qc 5c]
rate8: checks 
matiko09: checks 
*** TURN *** [Td Qc 5c] [7d]
rate8: bets $14.82
matiko09: calls $14.82
*** RIVER *** [Td Qc 5c 7d] [3s]
rate8: checks 
matiko09: bets $73.68 and is all-in
rate8: folds 
Uncalled bet ($73.68) returned to matiko09
matiko09 collected $57.14 from pot
matiko09: doesn't show hand 
*** SUMMARY ***
Total pot $59.64 | Rake $2.50 
Board [Td Qc 5c 7d 3s]
Seat 1: cap. marb (button) folded before Flop (didn't bet)
Seat 2: rate8 (small blind) folded on the River
Seat 3: Zeeshka (big blind) folded before Flop
Seat 4: gkm0nk3y folded before Flop (didn't bet)
Seat 5: Vulturinus folded before Flop (didn't bet)
Seat 7: matiko09 collected ($57.14)
Seat 8: solbi86 folded before Flop
Seat 9: fr3314nc3 folded before Flop (didn't bet)





PokerStars Hand #153508036712:  Hold'em No Limit ($0.50/$1.00 USD) - 2016/05/18 22:19:52 CET [2016/05/18 16:19:52 ET]
Table 'Tatjana III' 9-max Seat #5 is the button
Seat 1: cap. marb ($42.60 in chips) 
Seat 2: vanilica ($100 in chips) 
Seat 3: matiko09 ($182.40 in chips) 
Seat 4: Strikerman25 ($38.50 in chips) 
Seat 5: deadkiller1 ($106.93 in chips) 
Seat 6: maunzz ($100.50 in chips) 
Seat 7: rene1984tsv ($306.87 in chips) 
Seat 8: badmadrabbit ($106.79 in chips) 
Seat 9: Moszes360 ($100 in chips) 
maunzz: posts small blind $0.50
rene1984tsv: posts big blind $1
*** HOLE CARDS ***
Dealt to matiko09 [2h Kd]
badmadrabbit: folds 
Moszes360: raises $2.50 to $3.50
cap. marb: folds 
vanilica: calls $3.50
matiko09: folds 
Strikerman25: folds 
deadkiller1: folds 
maunzz: folds 
rene1984tsv: calls $2.50
*** FLOP *** [Td 5c Kh]
rene1984tsv: checks 
Moszes360: checks 
vanilica: checks 
*** TURN *** [Td 5c Kh] [7h]
rene1984tsv: bets $1
Moszes360: calls $1
vanilica: calls $1
*** RIVER *** [Td 5c Kh 7h] [9s]
rene1984tsv: checks 
Moszes360: checks 
vanilica: checks 
*** SHOW DOWN ***
rene1984tsv: shows [7s Jc] (a pair of Sevens)
Moszes360: mucks hand 
vanilica: shows [Jh Ts] (a pair of Tens)
vanilica collected $13.30 from pot
*** SUMMARY ***
Total pot $14 | Rake $0.70 
Board [Td 5c Kh 7h 9s]
Seat 1: cap. marb folded before Flop (didn't bet)
Seat 2: vanilica showed [Jh Ts] and won ($13.30) with a pair of Tens
Seat 3: matiko09 folded before Flop (didn't bet)
Seat 4: Strikerman25 folded before Flop (didn't bet)
Seat 5: deadkiller1 (button) folded before Flop (didn't bet)
Seat 6: maunzz (small blind) folded before Flop
Seat 7: rene1984tsv (big blind) showed [7s Jc] and lost with a pair of Sevens
Seat 8: badmadrabbit folded before Flop (didn't bet)
Seat 9: Moszes360 mucked [Jd Ah]





PokerStars Hand #153508049316:  Hold'em No Limit ($0.50/$1.00 USD) - 2016/05/18 22:20:06 CET [2016/05/18 16:20:06 ET]
Table 'Abetti II' 9-max Seat #1 is the button
Seat 1: matiko09 ($147.28 in chips) 
Seat 3: cap. marb ($74.96 in chips) 
Seat 5: blufthenuts ($151.11 in chips) 
Seat 7: rate8 ($141.28 in chips) 
Seat 9: vanilica ($138.61 in chips) 
cap. marb: posts small blind $0.50
stepan0605: is sitting out 
blufthenuts: posts big blind $1
stepan0605 leaves the table
xHourglass: sits out 
*** HOLE CARDS ***
Dealt to matiko09 [2c Ks]
rate8: folds 
vanilica: folds 
matiko09: folds 
cap. marb: raises $1.50 to $2.50
blufthenuts: calls $1.50
*** FLOP *** [Qc 7c 4s]
cap. marb: bets $3.13
blufthenuts: calls $3.13
*** TURN *** [Qc 7c 4s] [9c]
cap. marb: checks 
blufthenuts: bets $5.35
maunzz joins the table at seat #4 
maunzz leaves the table
edidaz joins the table at seat #4 
cap. marb: calls $5.35
*** RIVER *** [Qc 7c 4s 9c] [Kc]
edidaz leaves the table
cap. marb: checks 
blufthenuts: bets $18
cap. marb: calls $18
*** SHOW DOWN ***
blufthenuts: shows [7s Ac] (a flush, Ace high)
cap. marb: mucks hand 
blufthenuts collected $55.46 from pot
*** SUMMARY ***
Total pot $57.96 | Rake $2.50 
Board [Qc 7c 4s 9c Kc]
Seat 1: matiko09 (button) folded before Flop (didn't bet)
Seat 3: cap. marb (small blind) mucked [Kd Qd]
Seat 5: blufthenuts (big blind) showed [7s Ac] and won ($55.46) with a flush, Ace high
Seat 7: rate8 folded before Flop (didn't bet)
Seat 9: vanilica folded before Flop (didn't bet)





PokerStars Hand #153508052828:  Hold'em No Limit ($0.50/$1.00 USD) - 2016/05/18 22:20:10 CET [2016/05/18 16:20:10 ET]
Table 'Samitchell II' 9-max Seat #7 is the button
Seat 1: cap. marb ($37 in chips) 
Seat 3: vanilica ($165.10 in chips) 
Seat 4: Zeeshka ($109.89 in chips) 
Seat 5: nuuaber ($24.94 in chips) 
Seat 7: matiko09 ($119.15 in chips) 
Seat 8: rate8 ($108.94 in chips) 
Seat 9: janarr5 ($103.50 in chips) 
rate8: posts small blind $0.50
janarr5: posts big blind $1
*** HOLE CARDS ***
Dealt to matiko09 [Jc 5h]
cap. marb: folds 
vanilica: folds 
Zeeshka: folds 
nuuaber: folds 
matiko09: folds 
rate8: raises $1.50 to $2.50
janarr5: folds 
Uncalled bet ($1.50) returned to rate8
rate8 collected $2 from pot
rate8: doesn't show hand 
*** SUMMARY ***
Total pot $2 | Rake $0 
Seat 1: cap. marb folded before Flop (didn't bet)
Seat 3: vanilica folded before Flop (didn't bet)
Seat 4: Zeeshka folded before Flop (didn't bet)
Seat 5: nuuaber folded before Flop (didn't bet)
Seat 7: matiko09 (button) folded before Flop (didn't bet)
Seat 8: rate8 (small blind) collected ($2)
Seat 9: janarr5 (big blind) folded before Flop





PokerStars Hand #153508072079:  Hold'em No Limit ($0.50/$1.00 USD) - 2016/05/18 22:20:31 CET [2016/05/18 16:20:31 ET]
Table 'Samitchell II' 9-max Seat #8 is the button
Seat 1: cap. marb ($37 in chips) 
Seat 3: vanilica ($165.10 in chips) 
Seat 4: Zeeshka ($109.89 in chips) 
Seat 5: nuuaber ($24.94 in chips) 
Seat 7: matiko09 ($119.15 in chips) 
Seat 8: rate8 ($109.94 in chips) 
Seat 9: janarr5 ($102.50 in chips) 
janarr5: posts small blind $0.50
cap. marb: posts big blind $1
*** HOLE CARDS ***
Dealt to matiko09 [Jd Ts]
vanilica: folds 
Zeeshka: folds 
nuuaber: folds 
matiko09: folds 
rate8: folds 
janarr5: folds 
Uncalled bet ($0.50) returned to cap. marb
cap. marb collected $1 from pot
cap. marb: doesn't show hand 
*** SUMMARY ***
Total pot $1 | Rake $0 
Seat 1: cap. marb (big blind) collected ($1)
Seat 3: vanilica folded before Flop (didn't bet)
Seat 4: Zeeshka folded before Flop (didn't bet)
Seat 5: nuuaber folded before Flop (didn't bet)
Seat 7: matiko09 folded before Flop (didn't bet)
Seat 8: rate8 (button) folded before Flop (didn't bet)
Seat 9: janarr5 (small blind) folded before Flop





PokerStars Hand #153508076577:  Hold'em No Limit (€0.50/€1.00 EUR) - 2016/05/18 22:20:36 CET [2016/05/18 16:20:36 ET]
Table 'Sarmiento III' 9-max Seat #3 is the button
Seat 1: LadyMaCe86 (€100 in chips) 
Seat 2: Kreuznagel (€100 in chips) 
Seat 3: Mashulia7777 (€54.05 in chips) 
Seat 4: AugderStarke (€98 in chips) 
Seat 5: rexalex2012 (€67.85 in chips) 
Seat 7: JACQUILF (€100 in chips) 
Seat 8: matiko09 (€100 in chips) 
Seat 9: vanilica (€100 in chips) 
AugderStarke: posts small blind €0.50
rexalex2012: posts big blind €1
*** HOLE CARDS ***
Dealt to matiko09 [6d 7h]
JACQUILF: folds 
matiko09: folds 
vanilica: folds 
LadyMaCe86: raises €2 to €3
Kreuznagel: folds 
Mashulia7777: folds 
AugderStarke: calls €2.50
rexalex2012: calls €2
*** FLOP *** [5s As 6s]
AugderStarke: bets €4.27
rexalex2012: calls €4.27
LadyMaCe86: folds 
*** TURN *** [5s As 6s] [4c]
AugderStarke: checks 
rexalex2012: checks 
*** RIVER *** [5s As 6s 4c] [2h]
AugderStarke: bets €8.33
rexalex2012: calls €8.33
*** SHOW DOWN ***
AugderStarke: shows [8c 8s] (a pair of Eights)
rexalex2012: shows [Ah 6h] (two pair, Aces and Sixes)
rexalex2012 collected €32.49 from pot
*** SUMMARY ***
Total pot €34.20 | Rake €1.71 
Board [5s As 6s 4c 2h]
Seat 1: LadyMaCe86 folded on the Flop
Seat 2: Kreuznagel folded before Flop (didn't bet)
Seat 3: Mashulia7777 (button) folded before Flop (didn't bet)
Seat 4: AugderStarke (small blind) showed [8c 8s] and lost with a pair of Eights
Seat 5: rexalex2012 (big blind) showed [Ah 6h] and won (€32.49) with two pair, Aces and Sixes
Seat 7: JACQUILF folded before Flop (didn't bet)
Seat 8: matiko09 folded before Flop (didn't bet)
Seat 9: vanilica folded before Flop (didn't bet)





PokerStars Hand #153508095279:  Hold'em No Limit ($0.50/$1.00 USD) - 2016/05/18 22:20:56 CET [2016/05/18 16:20:56 ET]
Table 'Samitchell II' 9-max Seat #9 is the button
Seat 1: cap. marb ($37.50 in chips) 
Seat 4: Zeeshka ($109.89 in chips) 
Seat 5: nuuaber ($24.94 in chips) 
Seat 7: matiko09 ($119.15 in chips) 
Seat 8: rate8 ($109.94 in chips) 
Seat 9: janarr5 ($102 in chips) 
cap. marb: posts small blind $0.50
vanilica: is sitting out 
Zeeshka: posts big blind $1
*** HOLE CARDS ***
Dealt to matiko09 [2d 7c]
vanilica leaves the table
nuuaber: folds 
matiko09: folds 
rate8: folds 
janarr5: raises $1.50 to $2.50
cap. marb: folds 
Zeeshka: calls $1.50
*** FLOP *** [4h 7h Ah]
Cortine leaves the table
Zeeshka: checks 
janarr5: checks 
*** TURN *** [4h 7h Ah] [Kd]
Zeeshka: bets $3.49
janarr5: calls $3.49
*** RIVER *** [4h 7h Ah Kd] [9s]
Zeeshka: bets $14
janarr5: calls $14
*** SHOW DOWN ***
Zeeshka: shows [5h 5s] (a pair of Fives)
janarr5: shows [Jc Ad] (a pair of Aces)
janarr5 collected $38.46 from pot
*** SUMMARY ***
Total pot $40.48 | Rake $2.02 
Board [4h 7h Ah Kd 9s]
Seat 1: cap. marb (small blind) folded before Flop
Seat 4: Zeeshka (big blind) showed [5h 5s] and lost with a pair of Fives
Seat 5: nuuaber folded before Flop (didn't bet)
Seat 7: matiko09 folded before Flop (didn't bet)
Seat 8: rate8 folded before Flop (didn't bet)
Seat 9: janarr5 (button) showed [Jc Ad] and won ($38.46) with a pair of Aces





PokerStars Hand #153508096886:  Hold'em No Limit ($0.50/$1.00 USD) - 2016/05/18 22:20:58 CET [2016/05/18 16:20:58 ET]
Table 'Abetti II' 9-max Seat #3 is the button
Seat 1: matiko09 ($147.28 in chips) 
Seat 3: cap. marb ($45.98 in chips) 
Seat 5: blufthenuts ($177.59 in chips) 
Seat 6: xHourglass ($100 in chips) 
Seat 7: rate8 ($141.28 in chips) 
Seat 9: vanilica ($138.61 in chips) 
blufthenuts: posts small blind $0.50
xHourglass: posts big blind $1
*** HOLE CARDS ***
Dealt to matiko09 [2d 7s]
rate8: folds 
rate8 leaves the table
vanilica: folds 
matiko09: folds 
cap. marb: folds 
LadyMaCe86 joins the table at seat #4 
blufthenuts: calls $0.50
LadyMaCe86 leaves the table
xHourglass: raises $2 to $3
blufthenuts: folds 
Uncalled bet ($2) returned to xHourglass
xHourglass collected $2 from pot
xHourglass: doesn't show hand 
*** SUMMARY ***
Total pot $2 | Rake $0 
Seat 1: matiko09 folded before Flop (didn't bet)
Seat 3: cap. marb (button) folded before Flop (didn't bet)
Seat 5: blufthenuts (small blind) folded before Flop
Seat 6: xHourglass (big blind) collected ($2)
Seat 7: rate8 folded before Flop (didn't bet)
Seat 9: vanilica folded before Flop (didn't bet)





PokerStars Hand #153508102384:  Hold'em No Limit ($0.50/$1.00 USD) - 2016/05/18 22:21:04 CET [2016/05/18 16:21:04 ET]
Table 'Tatjana III' 9-max Seat #6 is the button
Seat 1: cap. marb ($42.60 in chips) 
Seat 2: vanilica ($108.80 in chips) 
Seat 3: matiko09 ($182.40 in chips) 
Seat 4: Strikerman25 ($38.50 in chips) 
Seat 5: deadkiller1 ($106.93 in chips) 
Seat 6: maunzz ($100 in chips) 
Seat 7: rene1984tsv ($302.37 in chips) 
Seat 8: badmadrabbit ($106.79 in chips) 
Seat 9: Moszes360 ($100 in chips) 
rene1984tsv: posts small blind $0.50
badmadrabbit: posts big blind $1
*** HOLE CARDS ***
Dealt to matiko09 [3s Js]
Moszes360: folds 
cap. marb: folds 
vanilica: folds 
matiko09: folds 
Strikerman25: folds 
deadkiller1: raises $1.50 to $2.50
maunzz: folds 
rene1984tsv: folds 
badmadrabbit: raises $7 to $9.50
deadkiller1: folds 
Uncalled bet ($7) returned to badmadrabbit
badmadrabbit collected $5.50 from pot
badmadrabbit: doesn't show hand 
*** SUMMARY ***
Total pot $5.50 | Rake $0 
Seat 1: cap. marb folded before Flop (didn't bet)
Seat 2: vanilica folded before Flop (didn't bet)
Seat 3: matiko09 folded before Flop (didn't bet)
Seat 4: Strikerman25 folded before Flop (didn't bet)
Seat 5: deadkiller1 folded before Flop
Seat 6: maunzz (button) folded before Flop (didn't bet)
Seat 7: rene1984tsv (small blind) folded before Flop
Seat 8: badmadrabbit (big blind) collected ($5.50)
Seat 9: Moszes360 folded before Flop (didn't bet)





PokerStars Hand #153508105975:  Hold'em No Limit ($0.50/$1.00 USD) - 2016/05/18 22:21:09 CET [2016/05/18 16:21:09 ET]
Table 'Zanaih II' 9-max Seat #7 is the button
Seat 1: Chris pic77 ($100 in chips) 
Seat 5: sova77 ($64 in chips) 
Seat 7: matiko09 ($100 in chips) 
Seat 8: LadyMaCe86 ($100 in chips) 
Seat 9: maunzz ($108 in chips) 
LadyMaCe86: posts small blind $0.50
maunzz: posts big blind $1
Chris pic77: posts big blind $1
JACQUILF: sits out 
*** HOLE CARDS ***
Dealt to matiko09 [9c Jh]
JediGaGa joins the table at seat #3 
Chris pic77: checks 
sova77: calls $1
matiko09: folds 
king-guru82 joins the table at seat #4 
LadyMaCe86: folds 
maunzz: checks 
*** FLOP *** [4s 2c 5h]
maunzz: checks 
Chris pic77: bets $1
sova77: folds 
maunzz: calls $1
*** TURN *** [4s 2c 5h] [Kd]
maunzz: checks 
Chris pic77: bets $2
maunzz: calls $2
*** RIVER *** [4s 2c 5h Kd] [3c]
maunzz: checks 
Chris pic77: checks 
*** SHOW DOWN ***
maunzz: shows [Ah 4h] (a straight, Ace to Five)
Chris pic77: shows [Ks 7d] (a pair of Kings)
maunzz collected $9.02 from pot
*** SUMMARY ***
Total pot $9.50 | Rake $0.48 
Board [4s 2c 5h Kd 3c]
Seat 1: Chris pic77 showed [Ks 7d] and lost with a pair of Kings
Seat 5: sova77 folded on the Flop
Seat 7: matiko09 (button) folded before Flop (didn't bet)
Seat 8: LadyMaCe86 (small blind) folded before Flop
Seat 9: maunzz (big blind) showed [Ah 4h] and won ($9.02) with a straight, Ace to Five





PokerStars Hand #153508122837:  Hold'em No Limit ($0.50/$1.00 USD) - 2016/05/18 22:21:27 CET [2016/05/18 16:21:27 ET]
Table 'Brendelia II' 9-max Seat #2 is the button
Seat 1: cap. marb ($71.74 in chips) 
Seat 2: rate8 ($122.80 in chips) 
Seat 3: Zeeshka ($100 in chips) 
Seat 4: gkm0nk3y ($114.24 in chips) 
Seat 5: Vulturinus ($22.33 in chips) 
Seat 7: matiko09 ($130.82 in chips) 
Seat 8: solbi86 ($100 in chips) 
Seat 9: fr3314nc3 ($91.38 in chips) 
Zeeshka: posts small blind $0.50
gkm0nk3y: posts big blind $1
TimStone: sits out 
*** HOLE CARDS ***
Dealt to matiko09 [Qd 9s]
Vulturinus: folds 
matiko09: folds 
solbi86: folds 
fr3314nc3: folds 
cap. marb: folds 
rate8: raises $1 to $2
Zeeshka: raises $7 to $9
gkm0nk3y: folds 
rate8: folds 
Uncalled bet ($7) returned to Zeeshka
Zeeshka collected $5 from pot
Zeeshka: doesn't show hand 
*** SUMMARY ***
Total pot $5 | Rake $0 
Seat 1: cap. marb folded before Flop (didn't bet)
Seat 2: rate8 (button) folded before Flop
Seat 3: Zeeshka (small blind) collected ($5)
Seat 4: gkm0nk3y (big blind) folded before Flop
Seat 5: Vulturinus folded before Flop (didn't bet)
Seat 7: matiko09 folded before Flop (didn't bet)
Seat 8: solbi86 folded before Flop (didn't bet)
Seat 9: fr3314nc3 folded before Flop (didn't bet)





PokerStars Hand #153508148897:  Hold'em No Limit (€0.50/€1.00 EUR) - 2016/05/18 22:21:56 CET [2016/05/18 16:21:56 ET]
Table 'Sarmiento III' 9-max Seat #4 is the button
Seat 1: LadyMaCe86 (€100 in chips) 
Seat 2: Kreuznagel (€100 in chips) 
Seat 3: Mashulia7777 (€54.05 in chips) 
Seat 4: AugderStarke (€82.40 in chips) 
Seat 5: rexalex2012 (€84.74 in chips) 
Seat 6: TimStone (€100 in chips) 
Seat 7: JACQUILF (€100 in chips) 
Seat 8: matiko09 (€100 in chips) 
Seat 9: vanilica (€100 in chips) 
rexalex2012: posts small blind €0.50
TimStone: posts big blind €1
*** HOLE CARDS ***
Dealt to matiko09 [3s Kc]
JACQUILF: raises €2 to €3
matiko09: folds 
vanilica: folds 
LadyMaCe86: folds 
Kreuznagel: raises €7 to €10
Mashulia7777: folds 
AugderStarke: folds 
rexalex2012: folds 
TimStone: folds 
JACQUILF: folds 
Uncalled bet (€7) returned to Kreuznagel
Kreuznagel collected €7.50 from pot
Kreuznagel: doesn't show hand 
*** SUMMARY ***
Total pot €7.50 | Rake €0 
Seat 1: LadyMaCe86 folded before Flop (didn't bet)
Seat 2: Kreuznagel collected (€7.50)
Seat 3: Mashulia7777 folded before Flop (didn't bet)
Seat 4: AugderStarke (button) folded before Flop (didn't bet)
Seat 5: rexalex2012 (small blind) folded before Flop
Seat 6: TimStone (big blind) folded before Flop
Seat 7: JACQUILF folded before Flop
Seat 8: matiko09 folded before Flop (didn't bet)
Seat 9: vanilica folded before Flop (didn't bet)





PokerStars Hand #153508157364:  Hold'em No Limit ($0.50/$1.00 USD) - 2016/05/18 22:22:05 CET [2016/05/18 16:22:05 ET]
Table 'Tatjana III' 9-max Seat #7 is the button
Seat 1: cap. marb ($42.60 in chips) 
Seat 2: vanilica ($108.80 in chips) 
Seat 3: matiko09 ($182.40 in chips) 
Seat 4: Strikerman25 ($38.50 in chips) 
Seat 5: deadkiller1 ($104.43 in chips) 
Seat 6: maunzz ($100 in chips) 
Seat 7: rene1984tsv ($301.87 in chips) 
Seat 8: badmadrabbit ($109.79 in chips) 
Seat 9: Moszes360 ($100 in chips) 
badmadrabbit: posts small blind $0.50
Moszes360: posts big blind $1
*** HOLE CARDS ***
Dealt to matiko09 [As 7c]
cap. marb: folds 
vanilica: folds 
matiko09: folds 
Strikerman25: folds 
deadkiller1: raises $2 to $3
maunzz: folds 
rene1984tsv: calls $3
badmadrabbit: folds 
Moszes360: calls $2
*** FLOP *** [4s 5c 8h]
Moszes360: checks 
deadkiller1: bets $5.95
rene1984tsv: folds 
Moszes360: raises $11.50 to $17.45
deadkiller1: folds 
Uncalled bet ($11.50) returned to Moszes360
Moszes360 collected $20.33 from pot
Moszes360: doesn't show hand 
*** SUMMARY ***
Total pot $21.40 | Rake $1.07 
Board [4s 5c 8h]
Seat 1: cap. marb folded before Flop (didn't bet)
Seat 2: vanilica folded before Flop (didn't bet)
Seat 3: matiko09 folded before Flop (didn't bet)
Seat 4: Strikerman25 folded before Flop (didn't bet)
Seat 5: deadkiller1 folded on the Flop
Seat 6: maunzz folded before Flop (didn't bet)
Seat 7: rene1984tsv (button) folded on the Flop
Seat 8: badmadrabbit (small blind) folded before Flop
Seat 9: Moszes360 (big blind) collected ($20.33)





PokerStars Hand #153508160732:  Hold'em No Limit ($0.50/$1.00 USD) - 2016/05/18 22:22:09 CET [2016/05/18 16:22:09 ET]
Table 'Zanaih II' 9-max Seat #8 is the button
Seat 1: Chris pic77 ($96 in chips) 
Seat 5: sova77 ($63 in chips) 
Seat 7: matiko09 ($100 in chips) 
Seat 8: LadyMaCe86 ($100 in chips) 
Seat 9: maunzz ($113.02 in chips) 
maunzz: posts small blind $0.50
Chris pic77: posts big blind $1
JACQUILF: sits out 
JediGaGa: sits out 
king-guru82: sits out 
TimStone: sits out 
*** HOLE CARDS ***
Dealt to matiko09 [2h 5h]
sova77: raises $2.50 to $3.50
matiko09: folds 
LadyMaCe86: folds 
maunzz: folds 
Chris pic77: calls $2.50
*** FLOP *** [9d Kc 4h]
Chris pic77: checks 
sova77: bets $5
Chris pic77: folds 
Uncalled bet ($5) returned to sova77
sova77 collected $7.12 from pot
sova77: doesn't show hand 
*** SUMMARY ***
Total pot $7.50 | Rake $0.38 
Board [9d Kc 4h]
Seat 1: Chris pic77 (big blind) folded on the Flop
Seat 5: sova77 collected ($7.12)
Seat 7: matiko09 folded before Flop (didn't bet)
Seat 8: LadyMaCe86 (button) folded before Flop (didn't bet)
Seat 9: maunzz (small blind) folded before Flop





PokerStars Hand #153508173050:  Hold'em No Limit ($0.50/$1.00 USD) - 2016/05/18 22:22:22 CET [2016/05/18 16:22:22 ET]
Table 'Brendelia II' 9-max Seat #3 is the button
Seat 1: cap. marb ($71.74 in chips) 
Seat 2: rate8 ($120.80 in chips) 
Seat 3: Zeeshka ($103 in chips) 
Seat 4: gkm0nk3y ($113.24 in chips) 
Seat 5: Vulturinus ($22.33 in chips) 
Seat 7: matiko09 ($130.82 in chips) 
Seat 8: solbi86 ($100 in chips) 
Seat 9: fr3314nc3 ($91.38 in chips) 
gkm0nk3y: posts small blind $0.50
Vulturinus: posts big blind $1
TimStone: sits out 
*** HOLE CARDS ***
Dealt to matiko09 [9s 2c]
matiko09: folds 
solbi86: folds 
fr3314nc3: raises $2 to $3
cap. marb: folds 
rate8: calls $3
Zeeshka: folds 
gkm0nk3y: folds 
Vulturinus: calls $2
*** FLOP *** [6c Ad 9d]
Vulturinus: bets $5
fr3314nc3: folds 
rate8: folds 
Uncalled bet ($5) returned to Vulturinus
Vulturinus collected $9.02 from pot
*** SUMMARY ***
Total pot $9.50 | Rake $0.48 
Board [6c Ad 9d]
Seat 1: cap. marb folded before Flop (didn't bet)
Seat 2: rate8 folded on the Flop
Seat 3: Zeeshka (button) folded before Flop (didn't bet)
Seat 4: gkm0nk3y (small blind) folded before Flop
Seat 5: Vulturinus (big blind) collected ($9.02)
Seat 7: matiko09 folded before Flop (didn't bet)
Seat 8: solbi86 folded before Flop (didn't bet)
Seat 9: fr3314nc3 folded on the Flop





PokerStars Hand #153508174152:  Hold'em No Limit ($0.50/$1.00 USD) - 2016/05/18 22:22:23 CET [2016/05/18 16:22:23 ET]
Table 'Samitchell II' 9-max Seat #1 is the button
Seat 1: cap. marb ($37 in chips) 
Seat 4: Zeeshka ($100 in chips) 
Seat 5: nuuaber ($24.94 in chips) 
Seat 7: matiko09 ($119.15 in chips) 
Seat 8: rate8 ($109.94 in chips) 
Seat 9: janarr5 ($120.47 in chips) 
Zeeshka: posts small blind $0.50
nuuaber: posts big blind $1
TimStone: sits out 
*** HOLE CARDS ***
Dealt to matiko09 [Jc Ac]
matiko09: raises $2 to $3
rate8: folds 
janarr5: raises $5 to $8
cap. marb: folds 
Zeeshka: folds 
nuuaber: folds 
matiko09: folds 
Uncalled bet ($5) returned to janarr5
janarr5 collected $7.50 from pot
janarr5: doesn't show hand 
*** SUMMARY ***
Total pot $7.50 | Rake $0 
Seat 1: cap. marb (button) folded before Flop (didn't bet)
Seat 4: Zeeshka (small blind) folded before Flop
Seat 5: nuuaber (big blind) folded before Flop
Seat 7: matiko09 folded before Flop
Seat 8: rate8 folded before Flop (didn't bet)
Seat 9: janarr5 collected ($7.50)





PokerStars Hand #153508198958:  Hold'em No Limit ($0.50/$1.00 USD) - 2016/05/18 22:22:50 CET [2016/05/18 16:22:50 ET]
Table 'Zanaih II' 9-max Seat #9 is the button
Seat 1: Chris pic77 ($92.50 in chips) 
Seat 2: JACQUILF ($100 in chips) 
Seat 5: sova77 ($66.62 in chips) 
Seat 7: matiko09 ($100 in chips) 
Seat 8: LadyMaCe86 ($100 in chips) 
Seat 9: maunzz ($112.52 in chips) 
Chris pic77: posts small blind $0.50
JACQUILF: posts big blind $1
JediGaGa: sits out 
king-guru82: sits out 
TimStone: sits out 
*** HOLE CARDS ***
Dealt to matiko09 [6s 5h]
sova77: raises $1 to $2
matiko09: folds 
LadyMaCe86: folds 
maunzz: raises $6 to $8
Chris pic77: folds 
JACQUILF: folds 
sova77: calls $6
*** FLOP *** [7s Qs 3c]
sova77: checks 
maunzz: bets $8.31
sova77: raises $9.31 to $17.62
maunzz: calls $9.31
*** TURN *** [7s Qs 3c] [9c]
sova77: bets $25
maunzz: raises $25 to $50
sova77: calls $16 and is all-in
Uncalled bet ($9) returned to maunzz
*** RIVER *** [7s Qs 3c 9c] [8h]
*** SHOW DOWN ***
sova77: shows [Jc Td] (a straight, Eight to Queen)
maunzz: mucks hand 
sova77 collected $132.24 from pot
*** SUMMARY ***
Total pot $134.74 | Rake $2.50 
Board [7s Qs 3c 9c 8h]
Seat 1: Chris pic77 (small blind) folded before Flop
Seat 2: JACQUILF (big blind) folded before Flop
Seat 5: sova77 showed [Jc Td] and won ($132.24) with a straight, Eight to Queen
Seat 7: matiko09 folded before Flop (didn't bet)
Seat 8: LadyMaCe86 folded before Flop (didn't bet)
Seat 9: maunzz (button) mucked [Th Qh]





PokerStars Hand #153508199820:  Hold'em No Limit (€0.50/€1.00 EUR) - 2016/05/18 22:22:51 CET [2016/05/18 16:22:51 ET]
Table 'Sarmiento III' 9-max Seat #5 is the button
Seat 1: LadyMaCe86 (€100 in chips) 
Seat 2: Kreuznagel (€104.50 in chips) 
Seat 3: Mashulia7777 (€54.05 in chips) 
Seat 5: rexalex2012 (€84.24 in chips) 
Seat 6: TimStone (€100 in chips) 
Seat 7: JACQUILF (€100 in chips) 
Seat 8: matiko09 (€100 in chips) 
Seat 9: vanilica (€100 in chips) 
TimStone: posts small blind €0.50
JACQUILF: posts big blind €1
*** HOLE CARDS ***
Dealt to matiko09 [4c 4h]
matiko09: folds 
vanilica: folds 
LadyMaCe86: folds 
Kreuznagel: folds 
Mashulia7777: folds 
rexalex2012: folds 
TimStone: raises €1.60 to €2.60
JACQUILF: calls €1.60
*** FLOP *** [Qc 3s 9c]
TimStone: checks 
JACQUILF: bets €3
TimStone: folds 
Uncalled bet (€3) returned to JACQUILF
JACQUILF collected €4.94 from pot
JACQUILF: doesn't show hand 
*** SUMMARY ***
Total pot €5.20 | Rake €0.26 
Board [Qc 3s 9c]
Seat 1: LadyMaCe86 folded before Flop (didn't bet)
Seat 2: Kreuznagel folded before Flop (didn't bet)
Seat 3: Mashulia7777 folded before Flop (didn't bet)
Seat 5: rexalex2012 (button) folded before Flop (didn't bet)
Seat 6: TimStone (small blind) folded on the Flop
Seat 7: JACQUILF (big blind) collected (€4.94)
Seat 8: matiko09 folded before Flop (didn't bet)
Seat 9: vanilica folded before Flop (didn't bet)





PokerStars Hand #153508208490:  Hold'em No Limit ($0.50/$1.00 USD) - 2016/05/18 22:23:01 CET [2016/05/18 16:23:01 ET]
Table 'Samitchell II' 9-max Seat #4 is the button
Seat 1: cap. marb ($37 in chips) 
Seat 4: Zeeshka ($100 in chips) 
Seat 5: nuuaber ($23.94 in chips) 
Seat 6: TimStone ($100 in chips) 
Seat 7: matiko09 ($116.15 in chips) 
Seat 8: rate8 ($109.94 in chips) 
Seat 9: janarr5 ($124.97 in chips) 
nuuaber: posts small blind $0.50
TimStone: posts big blind $1
*** HOLE CARDS ***
Dealt to matiko09 [9s 4d]
matiko09: folds 
rate8: raises $2 to $3
janarr5: folds 
janarr5 leaves the table
cap. marb: raises $4 to $7
Zeeshka: folds 
nuuaber: folds 
TimStone: folds 
rate8: folds 
Uncalled bet ($4) returned to cap. marb
cap. marb collected $7.50 from pot
cap. marb: doesn't show hand 
*** SUMMARY ***
Total pot $7.50 | Rake $0 
Seat 1: cap. marb collected ($7.50)
Seat 4: Zeeshka (button) folded before Flop (didn't bet)
Seat 5: nuuaber (small blind) folded before Flop
Seat 6: TimStone (big blind) folded before Flop
Seat 7: matiko09 folded before Flop (didn't bet)
Seat 8: rate8 folded before Flop
Seat 9: janarr5 folded before Flop (didn't bet)





PokerStars Hand #153508210954:  Hold'em No Limit ($0.50/$1.00 USD) - 2016/05/18 22:23:03 CET [2016/05/18 16:23:03 ET]
Table 'Tatjana III' 9-max Seat #8 is the button
Seat 1: cap. marb ($42.60 in chips) 
Seat 2: vanilica ($108.80 in chips) 
Seat 3: matiko09 ($182.40 in chips) 
Seat 4: Strikerman25 ($38.50 in chips) 
Seat 5: deadkiller1 ($100 in chips) 
Seat 6: maunzz ($100 in chips) 
Seat 7: rene1984tsv ($298.87 in chips) 
Seat 8: badmadrabbit ($109.29 in chips) 
Seat 9: Moszes360 ($111.38 in chips) 
Moszes360: posts small blind $0.50
cap. marb: posts big blind $1
*** HOLE CARDS ***
Dealt to matiko09 [9c 8c]
vanilica: folds 
matiko09: raises $2 to $3
Strikerman25: folds 
deadkiller1: folds 
maunzz: folds 
rene1984tsv: calls $3
badmadrabbit: folds 
Moszes360: folds 
cap. marb: folds 
*** FLOP *** [Ac Js Qh]
matiko09: checks 
rene1984tsv: bets $3.56
matiko09: folds 
Uncalled bet ($3.56) returned to rene1984tsv
rene1984tsv collected $7.12 from pot
rene1984tsv: doesn't show hand 
*** SUMMARY ***
Total pot $7.50 | Rake $0.38 
Board [Ac Js Qh]
Seat 1: cap. marb (big blind) folded before Flop
Seat 2: vanilica folded before Flop (didn't bet)
Seat 3: matiko09 folded on the Flop
Seat 4: Strikerman25 folded before Flop (didn't bet)
Seat 5: deadkiller1 folded before Flop (didn't bet)
Seat 6: maunzz folded before Flop (didn't bet)
Seat 7: rene1984tsv collected ($7.12)
Seat 8: badmadrabbit (button) folded before Flop (didn't bet)
Seat 9: Moszes360 (small blind) folded before Flop





PokerStars Hand #153508235441:  Hold'em No Limit ($0.50/$1.00 USD) - 2016/05/18 22:23:30 CET [2016/05/18 16:23:30 ET]
Table 'Brendelia II' 9-max Seat #4 is the button
Seat 1: cap. marb ($71.74 in chips) 
Seat 2: rate8 ($117.80 in chips) 
Seat 3: Zeeshka ($103 in chips) 
Seat 4: gkm0nk3y ($112.74 in chips) 
Seat 5: Vulturinus ($28.35 in chips) 
Seat 6: TimStone ($162.60 in chips) 
Seat 7: matiko09 ($130.82 in chips) 
Seat 8: solbi86 ($100 in chips) 
Seat 9: fr3314nc3 ($88.38 in chips) 
Vulturinus: posts small blind $0.50
TimStone: posts big blind $1
*** HOLE CARDS ***
Dealt to matiko09 [9c 3s]
matiko09: folds 
solbi86: raises $2 to $3
fr3314nc3: folds 
cap. marb: folds 
rate8: folds 
Zeeshka: folds 
gkm0nk3y: folds 
Vulturinus: folds 
TimStone: folds 
Uncalled bet ($2) returned to solbi86
solbi86 collected $2.50 from pot
solbi86: doesn't show hand 
*** SUMMARY ***
Total pot $2.50 | Rake $0 
Seat 1: cap. marb folded before Flop (didn't bet)
Seat 2: rate8 folded before Flop (didn't bet)
Seat 3: Zeeshka folded before Flop (didn't bet)
Seat 4: gkm0nk3y (button) folded before Flop (didn't bet)
Seat 5: Vulturinus (small blind) folded before Flop
Seat 6: TimStone (big blind) folded before Flop
Seat 7: matiko09 folded before Flop (didn't bet)
Seat 8: solbi86 collected ($2.50)
Seat 9: fr3314nc3 folded before Flop (didn't bet)





PokerStars Hand #153508240865:  Hold'em No Limit ($0.50/$1.00 USD) - 2016/05/18 22:23:36 CET [2016/05/18 16:23:36 ET]
Table 'Samitchell II' 9-max Seat #5 is the button
Seat 1: cap. marb ($41.50 in chips) 
Seat 4: Zeeshka ($100 in chips) 
Seat 5: nuuaber ($23.44 in chips) 
Seat 6: TimStone ($100 in chips) 
Seat 7: matiko09 ($116.15 in chips) 
Seat 8: rate8 ($106.94 in chips) 
TimStone: posts small blind $0.50
matiko09: posts big blind $1
*** HOLE CARDS ***
Dealt to matiko09 [Ks Td]
rate8: folds 
rate8 leaves the table
cap. marb: folds 
Zeeshka: folds 
nuuaber: calls $1
TimStone: folds 
matiko09: checks 
*** FLOP *** [7h 6c 4s]
matiko09: checks 
nuuaber: checks 
*** TURN *** [7h 6c 4s] [2d]
matiko09: checks 
nuuaber: checks 
*** RIVER *** [7h 6c 4s 2d] [5c]
matiko09: checks 
nuuaber: checks 
*** SHOW DOWN ***
matiko09: shows [Ks Td] (high card King)
nuuaber: mucks hand 
matiko09 collected $2.38 from pot
*** SUMMARY ***
Total pot $2.50 | Rake $0.12 
Board [7h 6c 4s 2d 5c]
Seat 1: cap. marb folded before Flop (didn't bet)
Seat 4: Zeeshka folded before Flop (didn't bet)
Seat 5: nuuaber (button) mucked [Jd Tc]
Seat 6: TimStone (small blind) folded before Flop
Seat 7: matiko09 (big blind) showed [Ks Td] and won ($2.38) with high card King
Seat 8: rate8 folded before Flop (didn't bet)





PokerStars Hand #153508244953:  Hold'em No Limit ($0.50/$1.00 USD) - 2016/05/18 22:23:40 CET [2016/05/18 16:23:40 ET]
Table 'Tatjana III' 9-max Seat #9 is the button
Seat 1: cap. marb ($41.60 in chips) 
Seat 2: vanilica ($108.80 in chips) 
Seat 3: matiko09 ($179.40 in chips) 
Seat 4: Strikerman25 ($38.50 in chips) 
Seat 5: deadkiller1 ($100 in chips) 
Seat 6: maunzz ($100 in chips) 
Seat 7: rene1984tsv ($302.99 in chips) 
Seat 8: badmadrabbit ($109.29 in chips) 
Seat 9: Moszes360 ($110.88 in chips) 
cap. marb: posts small blind $0.50
vanilica: posts big blind $1
*** HOLE CARDS ***
Dealt to matiko09 [Ks 6h]
matiko09: folds 
Strikerman25: folds 
deadkiller1: folds 
maunzz: folds 
rene1984tsv: raises $2 to $3
badmadrabbit: folds 
Moszes360: calls $3
cap. marb: folds 
vanilica: folds 
*** FLOP *** [Ts 4c Jh]
rene1984tsv: checks 
Moszes360: checks 
*** TURN *** [Ts 4c Jh] [Qc]
rene1984tsv: checks 
Moszes360: checks 
*** RIVER *** [Ts 4c Jh Qc] [Qd]
rene1984tsv: checks 
Moszes360: checks 
*** SHOW DOWN ***
rene1984tsv: shows [Th As] (two pair, Queens and Tens)
Moszes360: mucks hand 
rene1984tsv collected $7.12 from pot
*** SUMMARY ***
Total pot $7.50 | Rake $0.38 
Board [Ts 4c Jh Qc Qd]
Seat 1: cap. marb (small blind) folded before Flop
Seat 2: vanilica (big blind) folded before Flop
Seat 3: matiko09 folded before Flop (didn't bet)
Seat 4: Strikerman25 folded before Flop (didn't bet)
Seat 5: deadkiller1 folded before Flop (didn't bet)
Seat 6: maunzz folded before Flop (didn't bet)
Seat 7: rene1984tsv showed [Th As] and won ($7.12) with two pair, Queens and Tens
Seat 8: badmadrabbit folded before Flop (didn't bet)
Seat 9: Moszes360 (button) mucked [3h Ah]





PokerStars Hand #153508248191:  Hold'em No Limit (€0.50/€1.00 EUR) - 2016/05/18 22:23:44 CET [2016/05/18 16:23:44 ET]
Table 'Sarmiento III' 9-max Seat #6 is the button
Seat 1: LadyMaCe86 (€100 in chips) 
Seat 2: Kreuznagel (€104.50 in chips) 
Seat 3: Mashulia7777 (€54.05 in chips) 
Seat 5: rexalex2012 (€84.24 in chips) 
Seat 6: TimStone (€100 in chips) 
Seat 7: JACQUILF (€102.34 in chips) 
Seat 8: matiko09 (€100 in chips) 
Seat 9: vanilica (€100 in chips) 
JACQUILF: posts small blind €0.50
matiko09: posts big blind €1
*** HOLE CARDS ***
Dealt to matiko09 [8h Qc]
vanilica: folds 
LadyMaCe86: folds 
Kreuznagel: raises €1.39 to €2.39
Mashulia7777: folds 
rexalex2012: folds 
TimStone: folds 
JACQUILF: folds 
matiko09: folds 
Uncalled bet (€1.39) returned to Kreuznagel
Kreuznagel collected €2.50 from pot
Kreuznagel: doesn't show hand 
*** SUMMARY ***
Total pot €2.50 | Rake €0 
Seat 1: LadyMaCe86 folded before Flop (didn't bet)
Seat 2: Kreuznagel collected (€2.50)
Seat 3: Mashulia7777 folded before Flop (didn't bet)
Seat 5: rexalex2012 folded before Flop (didn't bet)
Seat 6: TimStone (button) folded before Flop (didn't bet)
Seat 7: JACQUILF (small blind) folded before Flop
Seat 8: matiko09 (big blind) folded before Flop
Seat 9: vanilica folded before Flop (didn't bet)





PokerStars Hand #153508269445:  Hold'em No Limit ($0.50/$1.00 USD) - 2016/05/18 22:24:06 CET [2016/05/18 16:24:06 ET]
Table 'Brendelia II' 9-max Seat #5 is the button
Seat 1: cap. marb ($71.74 in chips) 
Seat 2: rate8 ($117.80 in chips) 
Seat 3: Zeeshka ($103 in chips) 
Seat 4: gkm0nk3y ($112.74 in chips) 
Seat 5: Vulturinus ($27.85 in chips) 
Seat 6: TimStone ($161.60 in chips) 
Seat 7: matiko09 ($130.82 in chips) 
Seat 8: solbi86 ($101.50 in chips) 
Seat 9: fr3314nc3 ($88.38 in chips) 
TimStone: posts small blind $0.50
matiko09: posts big blind $1
*** HOLE CARDS ***
Dealt to matiko09 [3h 4c]
solbi86: folds 
fr3314nc3: folds 
cap. marb: raises $1.12 to $2.12
rate8: folds 
Zeeshka: folds 
gkm0nk3y: folds 
Vulturinus: folds 
TimStone: folds 
matiko09: folds 
Uncalled bet ($1.12) returned to cap. marb
cap. marb collected $2.50 from pot
cap. marb: doesn't show hand 
*** SUMMARY ***
Total pot $2.50 | Rake $0 
Seat 1: cap. marb collected ($2.50)
Seat 2: rate8 folded before Flop (didn't bet)
Seat 3: Zeeshka folded before Flop (didn't bet)
Seat 4: gkm0nk3y folded before Flop (didn't bet)
Seat 5: Vulturinus (button) folded before Flop (didn't bet)
Seat 6: TimStone (small blind) folded before Flop
Seat 7: matiko09 (big blind) folded before Flop
Seat 8: solbi86 folded before Flop (didn't bet)
Seat 9: fr3314nc3 folded before Flop (didn't bet)





PokerStars Hand #153508277183:  Hold'em No Limit ($0.50/$1.00 USD) - 2016/05/18 22:24:15 CET [2016/05/18 16:24:15 ET]
Table 'Tatjana III' 9-max Seat #1 is the button
Seat 1: cap. marb ($41.10 in chips) 
Seat 2: vanilica ($107.80 in chips) 
Seat 3: matiko09 ($179.40 in chips) 
Seat 4: Strikerman25 ($38.50 in chips) 
Seat 5: deadkiller1 ($100 in chips) 
Seat 6: maunzz ($100 in chips) 
Seat 7: rene1984tsv ($307.11 in chips) 
Seat 8: badmadrabbit ($109.29 in chips) 
Seat 9: Moszes360 ($107.88 in chips) 
vanilica: posts small blind $0.50
matiko09: posts big blind $1
*** HOLE CARDS ***
Dealt to matiko09 [Qd 5c]
Strikerman25: raises $2 to $3
deadkiller1: folds 
maunzz: folds 
rene1984tsv: calls $3
badmadrabbit: folds 
Moszes360: folds 
cap. marb: folds 
vanilica: folds 
matiko09: folds 
*** FLOP *** [5h 4s Jh]
Strikerman25: bets $4.09
rene1984tsv: folds 
Uncalled bet ($4.09) returned to Strikerman25
Strikerman25 collected $7.12 from pot
Strikerman25: doesn't show hand 
*** SUMMARY ***
Total pot $7.50 | Rake $0.38 
Board [5h 4s Jh]
Seat 1: cap. marb (button) folded before Flop (didn't bet)
Seat 2: vanilica (small blind) folded before Flop
Seat 3: matiko09 (big blind) folded before Flop
Seat 4: Strikerman25 collected ($7.12)
Seat 5: deadkiller1 folded before Flop (didn't bet)
Seat 6: maunzz folded before Flop (didn't bet)
Seat 7: rene1984tsv folded on the Flop
Seat 8: badmadrabbit folded before Flop (didn't bet)
Seat 9: Moszes360 folded before Flop (didn't bet)





PokerStars Hand #153508279814:  Hold'em No Limit ($0.50/$1.00 USD) - 2016/05/18 22:24:18 CET [2016/05/18 16:24:18 ET]
Table 'Zanaih II' 9-max Seat #1 is the button
Seat 1: Chris pic77 ($92 in chips) 
Seat 2: JACQUILF ($100 in chips) 
Seat 3: JediGaGa ($100 in chips) 
Seat 5: sova77 ($132.24 in chips) 
Seat 7: matiko09 ($100 in chips) 
Seat 8: LadyMaCe86 ($100 in chips) 
Seat 9: maunzz ($100 in chips) 
JACQUILF: posts small blind $0.50
JediGaGa: posts big blind $1
king-guru82: sits out 
TimStone: sits out 
*** HOLE CARDS ***
Dealt to matiko09 [8d 5d]
sova77: raises $2 to $3
matiko09: folds 
LadyMaCe86: calls $3
maunzz: folds 
Chris pic77: raises $4.55 to $7.55
JACQUILF: folds 
JediGaGa: folds 
sova77: calls $4.55
LadyMaCe86: calls $4.55
*** FLOP *** [7c As 8s]
sova77: checks 
LadyMaCe86: checks 
Chris pic77: bets $14.45
sova77: folds 
LadyMaCe86: folds 
Uncalled bet ($14.45) returned to Chris pic77
Chris pic77 collected $22.94 from pot
*** SUMMARY ***
Total pot $24.15 | Rake $1.21 
Board [7c As 8s]
Seat 1: Chris pic77 (button) collected ($22.94)
Seat 2: JACQUILF (small blind) folded before Flop
Seat 3: JediGaGa (big blind) folded before Flop
Seat 5: sova77 folded on the Flop
Seat 7: matiko09 folded before Flop (didn't bet)
Seat 8: LadyMaCe86 folded on the Flop
Seat 9: maunzz folded before Flop (didn't bet)





PokerStars Hand #153508280573:  Hold'em No Limit (€0.50/€1.00 EUR) - 2016/05/18 22:24:19 CET [2016/05/18 16:24:19 ET]
Table 'Sarmiento III' 9-max Seat #7 is the button
Seat 1: LadyMaCe86 (€100 in chips) 
Seat 2: Kreuznagel (€106 in chips) 
Seat 3: Mashulia7777 (€54.05 in chips) 
Seat 5: rexalex2012 (€84.24 in chips) 
Seat 6: TimStone (€100 in chips) 
Seat 7: JACQUILF (€101.84 in chips) 
Seat 8: matiko09 (€100 in chips) 
Seat 9: vanilica (€100 in chips) 
matiko09: posts small blind €0.50
vanilica: posts big blind €1
*** HOLE CARDS ***
Dealt to matiko09 [Jd Ah]
LadyMaCe86: folds 
Kreuznagel: folds 
Mashulia7777: folds 
rexalex2012: calls €1
TimStone: raises €3.90 to €4.90
JACQUILF: folds 
matiko09: calls €4.40
vanilica: folds 
rexalex2012: calls €3.90
*** FLOP *** [Th Ts 5s]
matiko09: checks 
rexalex2012: bets €2
TimStone: folds 
matiko09: calls €2
*** TURN *** [Th Ts 5s] [Qc]
matiko09: checks 
rexalex2012: bets €3
matiko09: calls €3
*** RIVER *** [Th Ts 5s Qc] [9c]
matiko09: checks 
rexalex2012: checks 
*** SHOW DOWN ***
matiko09: shows [Jd Ah] (a pair of Tens)
rexalex2012: shows [Qh Kh] (two pair, Queens and Tens)
rexalex2012 collected €24.42 from pot
*** SUMMARY ***
Total pot €25.70 | Rake €1.28 
Board [Th Ts 5s Qc 9c]
Seat 1: LadyMaCe86 folded before Flop (didn't bet)
Seat 2: Kreuznagel folded before Flop (didn't bet)
Seat 3: Mashulia7777 folded before Flop (didn't bet)
Seat 5: rexalex2012 showed [Qh Kh] and won (€24.42) with two pair, Queens and Tens
Seat 6: TimStone folded on the Flop
Seat 7: JACQUILF (button) folded before Flop (didn't bet)
Seat 8: matiko09 (small blind) showed [Jd Ah] and lost with a pair of Tens
Seat 9: vanilica (big blind) folded before Flop





PokerStars Hand #153508284597:  Hold'em No Limit ($0.50/$1.00 USD) - 2016/05/18 22:24:23 CET [2016/05/18 16:24:23 ET]
Table 'Samitchell II' 9-max Seat #6 is the button
Seat 1: cap. marb ($41.50 in chips) 
Seat 4: Zeeshka ($100 in chips) 
Seat 5: nuuaber ($22.44 in chips) 
Seat 6: TimStone ($100 in chips) 
Seat 7: matiko09 ($117.53 in chips) 
matiko09: posts small blind $0.50
cap. marb: posts big blind $1
*** HOLE CARDS ***
Dealt to matiko09 [9c 7c]
Zeeshka: folds 
nuuaber: folds 
TimStone: folds 
matiko09: raises $1.50 to $2.50
cap. marb: calls $1.50
*** FLOP *** [8s 9d 7d]
matiko09: checks 
cap. marb: checks 
*** TURN *** [8s 9d 7d] [8h]
matiko09: bets $3
cap. marb: folds 
Uncalled bet ($3) returned to matiko09
matiko09 collected $4.75 from pot
matiko09: doesn't show hand 
*** SUMMARY ***
Total pot $5 | Rake $0.25 
Board [8s 9d 7d 8h]
Seat 1: cap. marb (big blind) folded on the Turn
Seat 4: Zeeshka folded before Flop (didn't bet)
Seat 5: nuuaber folded before Flop (didn't bet)
Seat 6: TimStone (button) folded before Flop (didn't bet)
Seat 7: matiko09 (small blind) collected ($4.75)





PokerStars Hand #153508310596:  Hold'em No Limit ($0.50/$1.00 USD) - 2016/05/18 22:24:51 CET [2016/05/18 16:24:51 ET]
Table 'Brendelia II' 9-max Seat #6 is the button
Seat 1: cap. marb ($73.24 in chips) 
Seat 2: rate8 ($117.80 in chips) 
Seat 3: Zeeshka ($103 in chips) 
Seat 4: gkm0nk3y ($112.74 in chips) 
Seat 5: Vulturinus ($27.85 in chips) 
Seat 6: TimStone ($161.10 in chips) 
Seat 7: matiko09 ($129.82 in chips) 
Seat 8: solbi86 ($101.50 in chips) 
Seat 9: fr3314nc3 ($88.38 in chips) 
matiko09: posts small blind $0.50
solbi86: posts big blind $1
*** HOLE CARDS ***
Dealt to matiko09 [9d 7s]
fr3314nc3: folds 
cap. marb: folds 
rate8: folds 
Zeeshka: folds 
gkm0nk3y: raises $2 to $3
Vulturinus: folds 
TimStone: folds 
matiko09: folds 
solbi86: folds 
Uncalled bet ($2) returned to gkm0nk3y
gkm0nk3y collected $2.50 from pot
*** SUMMARY ***
Total pot $2.50 | Rake $0 
Seat 1: cap. marb folded before Flop (didn't bet)
Seat 2: rate8 folded before Flop (didn't bet)
Seat 3: Zeeshka folded before Flop (didn't bet)
Seat 4: gkm0nk3y collected ($2.50)
Seat 5: Vulturinus folded before Flop (didn't bet)
Seat 6: TimStone (button) folded before Flop (didn't bet)
Seat 7: matiko09 (small blind) folded before Flop
Seat 8: solbi86 (big blind) folded before Flop
Seat 9: fr3314nc3 folded before Flop (didn't bet)





PokerStars Hand #153508316090:  Hold'em No Limit ($0.50/$1.00 USD) - 2016/05/18 22:24:58 CET [2016/05/18 16:24:58 ET]
Table 'Tatjana III' 9-max Seat #2 is the button
Seat 1: cap. marb ($41.10 in chips) 
Seat 2: vanilica ($107.30 in chips) 
Seat 3: matiko09 ($178.40 in chips) 
Seat 4: Strikerman25 ($42.62 in chips) 
Seat 5: deadkiller1 ($100 in chips) 
Seat 6: maunzz ($100 in chips) 
Seat 7: rene1984tsv ($304.11 in chips) 
Seat 8: badmadrabbit ($109.29 in chips) 
Seat 9: Moszes360 ($107.88 in chips) 
matiko09: posts small blind $0.50
Strikerman25: posts big blind $1
*** HOLE CARDS ***
Dealt to matiko09 [Qc 6h]
deadkiller1: folds 
maunzz: folds 
rene1984tsv: raises $2 to $3
badmadrabbit: folds 
Moszes360: folds 
cap. marb: folds 
vanilica: folds 
matiko09: folds 
Strikerman25: folds 
Uncalled bet ($2) returned to rene1984tsv
rene1984tsv collected $2.50 from pot
rene1984tsv: doesn't show hand 
*** SUMMARY ***
Total pot $2.50 | Rake $0 
Seat 1: cap. marb folded before Flop (didn't bet)
Seat 2: vanilica (button) folded before Flop (didn't bet)
Seat 3: matiko09 (small blind) folded before Flop
Seat 4: Strikerman25 (big blind) folded before Flop
Seat 5: deadkiller1 folded before Flop (didn't bet)
Seat 6: maunzz folded before Flop (didn't bet)
Seat 7: rene1984tsv collected ($2.50)
Seat 8: badmadrabbit folded before Flop (didn't bet)
Seat 9: Moszes360 folded before Flop (didn't bet)





PokerStars Hand #153508332695:  Hold'em No Limit ($0.50/$1.00 USD) - 2016/05/18 22:25:16 CET [2016/05/18 16:25:16 ET]
Table 'Tatjana III' 9-max Seat #3 is the button
Seat 1: cap. marb ($41.10 in chips) 
Seat 2: vanilica ($107.30 in chips) 
Seat 3: matiko09 ($177.90 in chips) 
Seat 4: Strikerman25 ($41.62 in chips) 
Seat 5: deadkiller1 ($100 in chips) 
Seat 6: maunzz ($100 in chips) 
Seat 7: rene1984tsv ($305.61 in chips) 
Seat 8: badmadrabbit ($109.29 in chips) 
Seat 9: Moszes360 ($107.88 in chips) 
Strikerman25: posts small blind $0.50
deadkiller1: posts big blind $1
*** HOLE CARDS ***
Dealt to matiko09 [3h 4h]
maunzz: folds 
rene1984tsv: raises $1 to $2
badmadrabbit: calls $2
Moszes360: folds 
cap. marb: folds 
vanilica: calls $2
matiko09: calls $2
Strikerman25: folds 
deadkiller1: folds 
*** FLOP *** [2s 7d Qd]
rene1984tsv: checks 
badmadrabbit: bets $5.50
vanilica: folds 
matiko09: folds 
rene1984tsv: folds 
Uncalled bet ($5.50) returned to badmadrabbit
badmadrabbit collected $9.02 from pot
badmadrabbit: doesn't show hand 
*** SUMMARY ***
Total pot $9.50 | Rake $0.48 
Board [2s 7d Qd]
Seat 1: cap. marb folded before Flop (didn't bet)
Seat 2: vanilica folded on the Flop
Seat 3: matiko09 (button) folded on the Flop
Seat 4: Strikerman25 (small blind) folded before Flop
Seat 5: deadkiller1 (big blind) folded before Flop
Seat 6: maunzz folded before Flop (didn't bet)
Seat 7: rene1984tsv folded on the Flop
Seat 8: badmadrabbit collected ($9.02)
Seat 9: Moszes360 folded before Flop (didn't bet)





PokerStars Hand #153508338912:  Hold'em No Limit ($0.50/$1.00 USD) - 2016/05/18 22:25:23 CET [2016/05/18 16:25:23 ET]
Table 'Samitchell II' 9-max Seat #7 is the button
Seat 1: cap. marb ($39 in chips) 
Seat 4: Zeeshka ($100 in chips) 
Seat 5: nuuaber ($22.44 in chips) 
Seat 6: TimStone ($100 in chips) 
Seat 7: matiko09 ($119.78 in chips) 
cap. marb: posts small blind $0.50
Zeeshka: posts big blind $1
*** HOLE CARDS ***
Dealt to matiko09 [Tc 9c]
nuuaber: folds 
TimStone: folds 
matiko09: raises $1.27 to $2.27
cap. marb: raises $3.73 to $6
Zeeshka: folds 
matiko09: calls $3.73
*** FLOP *** [4s 5c 2h]
cap. marb: bets $7
matiko09: folds 
Uncalled bet ($7) returned to cap. marb
cap. marb collected $12.35 from pot
cap. marb: doesn't show hand 
*** SUMMARY ***
Total pot $13 | Rake $0.65 
Board [4s 5c 2h]
Seat 1: cap. marb (small blind) collected ($12.35)
Seat 4: Zeeshka (big blind) folded before Flop
Seat 5: nuuaber folded before Flop (didn't bet)
Seat 6: TimStone folded before Flop (didn't bet)
Seat 7: matiko09 (button) folded on the Flop





PokerStars Hand #153508341023:  Hold'em No Limit ($0.50/$1.00 USD) - 2016/05/18 22:25:25 CET [2016/05/18 16:25:25 ET]
Table 'Brendelia II' 9-max Seat #7 is the button
Seat 1: cap. marb ($73.24 in chips) 
Seat 2: rate8 ($117.80 in chips) 
Seat 3: Zeeshka ($103 in chips) 
Seat 4: gkm0nk3y ($114.24 in chips) 
Seat 5: Vulturinus ($27.85 in chips) 
Seat 6: TimStone ($161.10 in chips) 
Seat 7: matiko09 ($129.32 in chips) 
Seat 8: solbi86 ($100.50 in chips) 
Seat 9: fr3314nc3 ($88.38 in chips) 
solbi86: posts small blind $0.50
fr3314nc3: posts big blind $1
*** HOLE CARDS ***
Dealt to matiko09 [5c 4h]
cap. marb: folds 
rate8: folds 
Zeeshka: folds 
gkm0nk3y: folds 
Vulturinus: folds 
TimStone: raises $1.52 to $2.52
matiko09: folds 
solbi86: calls $2.02
fr3314nc3: folds 
*** FLOP *** [Kh 6h 6c]
solbi86: checks 
TimStone: bets $3.05
solbi86: calls $3.05
*** TURN *** [Kh 6h 6c] [3h]
solbi86: bets $7
TimStone: folds 
Uncalled bet ($7) returned to solbi86
solbi86 collected $11.53 from pot
solbi86: doesn't show hand 
*** SUMMARY ***
Total pot $12.14 | Rake $0.61 
Board [Kh 6h 6c 3h]
Seat 1: cap. marb folded before Flop (didn't bet)
Seat 2: rate8 folded before Flop (didn't bet)
Seat 3: Zeeshka folded before Flop (didn't bet)
Seat 4: gkm0nk3y folded before Flop (didn't bet)
Seat 5: Vulturinus folded before Flop (didn't bet)
Seat 6: TimStone folded on the Turn
Seat 7: matiko09 (button) folded before Flop (didn't bet)
Seat 8: solbi86 (small blind) collected ($11.53)
Seat 9: fr3314nc3 (big blind) folded before Flop





PokerStars Hand #153508349607:  Hold'em No Limit (€0.50/€1.00 EUR) - 2016/05/18 22:25:35 CET [2016/05/18 16:25:35 ET]
Table 'Sarmiento III' 9-max Seat #8 is the button
Seat 1: LadyMaCe86 (€100 in chips) 
Seat 2: Kreuznagel (€106 in chips) 
Seat 3: Mashulia7777 (€54.05 in chips) 
Seat 4: AugderStarke (€100 in chips) 
Seat 5: rexalex2012 (€98.76 in chips) 
Seat 6: TimStone (€100 in chips) 
Seat 7: JACQUILF (€101.84 in chips) 
Seat 8: matiko09 (€100 in chips) 
Seat 9: vanilica (€100 in chips) 
vanilica: posts small blind €0.50
LadyMaCe86: posts big blind €1
*** HOLE CARDS ***
Dealt to matiko09 [5h 4s]
Kreuznagel: raises €1.39 to €2.39
Mashulia7777: folds 
AugderStarke: calls €2.39
rexalex2012: folds 
TimStone: folds 
JACQUILF: folds 
matiko09: folds 
vanilica: folds 
LadyMaCe86: raises €9.56 to €11.95
Kreuznagel: folds 
AugderStarke: calls €9.56
*** FLOP *** [Ac Td 8d]
LadyMaCe86: bets €16.54
AugderStarke: calls €16.54
*** TURN *** [Ac Td 8d] [9d]
LadyMaCe86: checks 
AugderStarke: bets €16
LadyMaCe86: calls €16
*** RIVER *** [Ac Td 8d 9d] [6c]
LadyMaCe86: checks 
AugderStarke: checks 
*** SHOW DOWN ***
LadyMaCe86: shows [As Qc] (a pair of Aces)
AugderStarke: shows [Qs Ad] (a pair of Aces)
LadyMaCe86 collected €44.81 from pot
AugderStarke collected €44.81 from pot
*** SUMMARY ***
Total pot €91.87 | Rake €2.25 
Board [Ac Td 8d 9d 6c]
Seat 1: LadyMaCe86 (big blind) showed [As Qc] and won (€44.81) with a pair of Aces
Seat 2: Kreuznagel folded before Flop
Seat 3: Mashulia7777 folded before Flop (didn't bet)
Seat 4: AugderStarke showed [Qs Ad] and won (€44.81) with a pair of Aces
Seat 5: rexalex2012 folded before Flop (didn't bet)
Seat 6: TimStone folded before Flop (didn't bet)
Seat 7: JACQUILF folded before Flop (didn't bet)
Seat 8: matiko09 (button) folded before Flop (didn't bet)
Seat 9: vanilica (small blind) folded before Flop





PokerStars Hand #153508365294:  Hold'em No Limit ($0.50/$1.00 USD) - 2016/05/18 22:25:52 CET [2016/05/18 16:25:52 ET]
Table 'Zanaih II' 9-max Seat #2 is the button
Seat 1: Chris pic77 ($107.39 in chips) 
Seat 2: JACQUILF ($100 in chips) 
Seat 3: JediGaGa ($99 in chips) 
Seat 4: king-guru82 ($100 in chips) 
Seat 5: sova77 ($124.69 in chips) 
Seat 7: matiko09 ($100 in chips) 
Seat 8: LadyMaCe86 ($100 in chips) 
Seat 9: maunzz ($100 in chips) 
JediGaGa: posts small blind $0.50
king-guru82: posts big blind $1
TimStone: sits out 
*** HOLE CARDS ***
Dealt to matiko09 [As Ad]
sova77: folds 
matiko09: raises $2 to $3
sova77 leaves the table
LadyMaCe86: folds 
Ty Nick 420 joins the table at seat #5 
maunzz: folds 
Chris pic77: folds 
JACQUILF: folds 
JediGaGa: folds 
king-guru82: folds 
Uncalled bet ($2) returned to matiko09
matiko09 collected $2.50 from pot
matiko09: doesn't show hand 
*** SUMMARY ***
Total pot $2.50 | Rake $0 
Seat 1: Chris pic77 folded before Flop (didn't bet)
Seat 2: JACQUILF (button) folded before Flop (didn't bet)
Seat 3: JediGaGa (small blind) folded before Flop
Seat 4: king-guru82 (big blind) folded before Flop
Seat 5: sova77 folded before Flop (didn't bet)
Seat 7: matiko09 collected ($2.50)
Seat 8: LadyMaCe86 folded before Flop (didn't bet)
Seat 9: maunzz folded before Flop (didn't bet)





PokerStars Hand #153508368622:  Hold'em No Limit ($0.50/$1.00 USD) - 2016/05/18 22:25:56 CET [2016/05/18 16:25:56 ET]
Table 'Tatjana III' 9-max Seat #4 is the button
Seat 1: cap. marb ($41.10 in chips) 
Seat 2: vanilica ($105.30 in chips) 
Seat 3: matiko09 ($175.90 in chips) 
Seat 4: Strikerman25 ($41.12 in chips) 
Seat 5: deadkiller1 ($100 in chips) 
Seat 6: maunzz ($100 in chips) 
Seat 7: rene1984tsv ($303.61 in chips) 
Seat 8: badmadrabbit ($116.31 in chips) 
Seat 9: Moszes360 ($107.88 in chips) 
deadkiller1: posts small blind $0.50
maunzz: posts big blind $1
*** HOLE CARDS ***
Dealt to matiko09 [Ad 7c]
rene1984tsv: calls $1
badmadrabbit: folds 
Moszes360: folds 
cap. marb: folds 
vanilica: raises $2.50 to $3.50
matiko09: folds 
Strikerman25: folds 
deadkiller1: folds 
maunzz: folds 
rene1984tsv: calls $2.50
*** FLOP *** [Tc 8d Jc]
rene1984tsv: checks 
vanilica: bets $5.97
rene1984tsv: calls $5.97
*** TURN *** [Tc 8d Jc] [9d]
rene1984tsv: checks 
vanilica: bets $11.65
rene1984tsv: raises $21.36 to $33.01
vanilica: calls $21.36
*** RIVER *** [Tc 8d Jc 9d] [5d]
rene1984tsv: bets $261.13 and is all-in
vanilica: calls $62.82 and is all-in
Uncalled bet ($198.31) returned to rene1984tsv
*** SHOW DOWN ***
rene1984tsv: shows [Qd 6d] (a flush, Queen high)
vanilica: shows [Td Qc] (a straight, Eight to Queen)
rene1984tsv collected $209.60 from pot
*** SUMMARY ***
Total pot $212.10 | Rake $2.50 
Board [Tc 8d Jc 9d 5d]
Seat 1: cap. marb folded before Flop (didn't bet)
Seat 2: vanilica showed [Td Qc] and lost with a straight, Eight to Queen
Seat 3: matiko09 folded before Flop (didn't bet)
Seat 4: Strikerman25 (button) folded before Flop (didn't bet)
Seat 5: deadkiller1 (small blind) folded before Flop
Seat 6: maunzz (big blind) folded before Flop
Seat 7: rene1984tsv showed [Qd 6d] and won ($209.60) with a flush, Queen high
Seat 8: badmadrabbit folded before Flop (didn't bet)
Seat 9: Moszes360 folded before Flop (didn't bet)





PokerStars Hand #153508372703:  Hold'em No Limit ($0.50/$1.00 USD) - 2016/05/18 22:26:00 CET [2016/05/18 16:26:00 ET]
Table 'Samitchell II' 9-max Seat #1 is the button
Seat 1: cap. marb ($45.35 in chips) 
Seat 4: Zeeshka ($100 in chips) 
Seat 5: nuuaber ($22.44 in chips) 
Seat 6: TimStone ($100 in chips) 
Seat 7: matiko09 ($113.78 in chips) 
Zeeshka: posts small blind $0.50
nuuaber: posts big blind $1
*** HOLE CARDS ***
Dealt to matiko09 [5d 7h]
TimStone: raises $1.62 to $2.62
matiko09: folds 
cap. marb: raises $3.38 to $6
Zeeshka: folds 
nuuaber: folds 
Karusana joins the table at seat #8 
JACQUILF joins the table at seat #9 
TimStone: raises $94 to $100 and is all-in
cap. marb: calls $39.35 and is all-in
Uncalled bet ($54.65) returned to TimStone
*** FLOP *** [2h Jh 5c]
*** TURN *** [2h Jh 5c] [9h]
*** RIVER *** [2h Jh 5c 9h] [5s]
*** SHOW DOWN ***
TimStone: shows [Kc Ad] (a pair of Fives)
cap. marb: shows [Kd Ac] (a pair of Fives)
TimStone collected $44.85 from pot
cap. marb collected $44.85 from pot
*** SUMMARY ***
Total pot $92.20 | Rake $2.50 
Board [2h Jh 5c 9h 5s]
Seat 1: cap. marb (button) showed [Kd Ac] and won ($44.85) with a pair of Fives
Seat 4: Zeeshka (small blind) folded before Flop
Seat 5: nuuaber (big blind) folded before Flop
Seat 6: TimStone showed [Kc Ad] and won ($44.85) with a pair of Fives
Seat 7: matiko09 folded before Flop (didn't bet)





PokerStars Hand #153508399955:  Hold'em No Limit ($0.50/$1.00 USD) - 2016/05/18 22:26:30 CET [2016/05/18 16:26:30 ET]
Table 'Zanaih II' 9-max Seat #3 is the button
Seat 1: Chris pic77 ($107.39 in chips) 
Seat 2: JACQUILF ($100 in chips) 
Seat 3: JediGaGa ($98.50 in chips) 
Seat 4: king-guru82 ($99 in chips) 
Seat 5: Ty Nick 420 ($100 in chips) 
Seat 7: matiko09 ($101.50 in chips) 
Seat 8: LadyMaCe86 ($100 in chips) 
Seat 9: maunzz ($100 in chips) 
king-guru82: posts small blind $0.50
Ty Nick 420: posts big blind $1
TimStone: sits out 
*** HOLE CARDS ***
Dealt to matiko09 [2c 8c]
matiko09: folds 
LadyMaCe86: folds 
maunzz: folds 
Chris pic77: folds 
JACQUILF: folds 
JediGaGa: raises $1.05 to $2.05
king-guru82: folds 
Ty Nick 420: raises $4.95 to $7
JediGaGa: folds 
Uncalled bet ($4.95) returned to Ty Nick 420
Ty Nick 420 collected $4.60 from pot
*** SUMMARY ***
Total pot $4.60 | Rake $0 
Seat 1: Chris pic77 folded before Flop (didn't bet)
Seat 2: JACQUILF folded before Flop (didn't bet)
Seat 3: JediGaGa (button) folded before Flop
Seat 4: king-guru82 (small blind) folded before Flop
Seat 5: Ty Nick 420 (big blind) collected ($4.60)
Seat 7: matiko09 folded before Flop (didn't bet)
Seat 8: LadyMaCe86 folded before Flop (didn't bet)
Seat 9: maunzz folded before Flop (didn't bet)





PokerStars Hand #153508417290:  Hold'em No Limit ($0.50/$1.00 USD) - 2016/05/18 22:26:49 CET [2016/05/18 16:26:49 ET]
Table 'Luthera' 9-max Seat #5 is the button
Seat 5: sova77 ($60 in chips) 
Seat 6: TimStone ($100 in chips) 
Seat 7: matiko09 ($100 in chips) 
Seat 8: Cortine ($100 in chips) 
TimStone: posts small blind $0.50
rate8 joins the table at seat #9 
matiko09: posts big blind $1
*** HOLE CARDS ***
Dealt to matiko09 [2s 7d]
Cortine: folds 
sova77: raises $1 to $2
TimStone: calls $1.50
maunzz joins the table at seat #1 
matiko09: folds 
*** FLOP *** [6h Kc 3h]
vanilica joins the table at seat #2 
TimStone: checks 
sova77: checks 
*** TURN *** [6h Kc 3h] [4h]
TimStone: checks 
sova77: checks 
*** RIVER *** [6h Kc 3h 4h] [3s]
TimStone: checks 
sova77: checks 
*** SHOW DOWN ***
TimStone: shows [9s Qs] (a pair of Threes)
sova77: mucks hand 
TimStone collected $4.75 from pot
*** SUMMARY ***
Total pot $5 | Rake $0.25 
Board [6h Kc 3h 4h 3s]
Seat 5: sova77 (button) mucked [Js Tc]
Seat 6: TimStone (small blind) showed [9s Qs] and won ($4.75) with a pair of Threes
Seat 7: matiko09 (big blind) folded before Flop
Seat 8: Cortine folded before Flop (didn't bet)





PokerStars Hand #153508423508:  Hold'em No Limit ($0.50/$1.00 USD) - 2016/05/18 22:26:56 CET [2016/05/18 16:26:56 ET]
Table 'Tatjana III' 9-max Seat #5 is the button
Seat 1: cap. marb ($41.10 in chips) 
Seat 2: vanilica ($100 in chips) 
Seat 3: matiko09 ($175.90 in chips) 
Seat 4: Strikerman25 ($41.12 in chips) 
Seat 5: deadkiller1 ($100 in chips) 
Seat 6: maunzz ($100 in chips) 
Seat 7: rene1984tsv ($407.91 in chips) 
Seat 8: badmadrabbit ($116.31 in chips) 
Seat 9: Moszes360 ($107.88 in chips) 
maunzz: posts small blind $0.50
rene1984tsv: posts big blind $1
*** HOLE CARDS ***
Dealt to matiko09 [2h 3h]
badmadrabbit: folds 
Moszes360: raises $2 to $3
cap. marb: folds 
vanilica: calls $3
matiko09: folds 
Strikerman25: folds 
deadkiller1: folds 
maunzz: calls $2.50
rene1984tsv: calls $2
*** FLOP *** [Ts 3s Ks]
maunzz: checks 
rene1984tsv: checks 
Moszes360: checks 
vanilica: bets $6.84
maunzz: folds 
rene1984tsv: calls $6.84
Moszes360: folds 
*** TURN *** [Ts 3s Ks] [6d]
rene1984tsv: checks 
vanilica: bets $33
rene1984tsv: folds 
Uncalled bet ($33) returned to vanilica
vanilica collected $24.40 from pot
*** SUMMARY ***
Total pot $25.68 | Rake $1.28 
Board [Ts 3s Ks 6d]
Seat 1: cap. marb folded before Flop (didn't bet)
Seat 2: vanilica collected ($24.40)
Seat 3: matiko09 folded before Flop (didn't bet)
Seat 4: Strikerman25 folded before Flop (didn't bet)
Seat 5: deadkiller1 (button) folded before Flop (didn't bet)
Seat 6: maunzz (small blind) folded on the Flop
Seat 7: rene1984tsv (big blind) folded on the Turn
Seat 8: badmadrabbit folded before Flop (didn't bet)
Seat 9: Moszes360 folded on the Flop





PokerStars Hand #153508425835:  Hold'em No Limit ($0.50/$1.00 USD) - 2016/05/18 22:26:58 CET [2016/05/18 16:26:58 ET]
Table 'Brendelia II' 9-max Seat #8 is the button
Seat 1: cap. marb ($73.24 in chips) 
Seat 2: rate8 ($117.80 in chips) 
Seat 3: Zeeshka ($103 in chips) 
Seat 4: gkm0nk3y ($114.24 in chips) 
Seat 5: Vulturinus ($27.85 in chips) 
Seat 6: TimStone ($155.53 in chips) 
Seat 7: matiko09 ($129.32 in chips) 
Seat 8: solbi86 ($106.46 in chips) 
Seat 9: fr3314nc3 ($87.38 in chips) 
fr3314nc3: posts small blind $0.50
cap. marb: posts big blind $1
*** HOLE CARDS ***
Dealt to matiko09 [9c 4d]
rate8: folds 
Zeeshka: folds 
gkm0nk3y: folds 
Vulturinus: folds 
TimStone: folds 
matiko09: folds 
solbi86: raises $1.50 to $2.50
fr3314nc3: folds 
cap. marb: folds 
Uncalled bet ($1.50) returned to solbi86
solbi86 collected $2.50 from pot
solbi86: doesn't show hand 
*** SUMMARY ***
Total pot $2.50 | Rake $0 
Seat 1: cap. marb (big blind) folded before Flop
Seat 2: rate8 folded before Flop (didn't bet)
Seat 3: Zeeshka folded before Flop (didn't bet)
Seat 4: gkm0nk3y folded before Flop (didn't bet)
Seat 5: Vulturinus folded before Flop (didn't bet)
Seat 6: TimStone folded before Flop (didn't bet)
Seat 7: matiko09 folded before Flop (didn't bet)
Seat 8: solbi86 (button) collected ($2.50)
Seat 9: fr3314nc3 (small blind) folded before Flop





PokerStars Hand #153508436476:  Hold'em No Limit ($0.50/$1.00 USD) - 2016/05/18 22:27:11 CET [2016/05/18 16:27:11 ET]
Table 'Zanaih II' 9-max Seat #4 is the button
Seat 1: Chris pic77 ($107.39 in chips) 
Seat 2: JACQUILF ($100 in chips) 
Seat 3: JediGaGa ($96.45 in chips) 
Seat 4: king-guru82 ($98.50 in chips) 
Seat 5: Ty Nick 420 ($102.55 in chips) 
Seat 6: TimStone ($100 in chips) 
Seat 7: matiko09 ($101.50 in chips) 
Seat 8: LadyMaCe86 ($100 in chips) 
Seat 9: maunzz ($100 in chips) 
Ty Nick 420: posts small blind $0.50
TimStone: posts big blind $1
*** HOLE CARDS ***
Dealt to matiko09 [8s Ah]
matiko09: folds 
LadyMaCe86: raises $2 to $3
maunzz: folds 
Chris pic77: raises $4.95 to $7.95
JACQUILF: folds 
JediGaGa: folds 
king-guru82: folds 
Ty Nick 420: folds 
TimStone: folds 
LadyMaCe86: folds 
Uncalled bet ($4.95) returned to Chris pic77
Chris pic77 collected $7.50 from pot
*** SUMMARY ***
Total pot $7.50 | Rake $0 
Seat 1: Chris pic77 collected ($7.50)
Seat 2: JACQUILF folded before Flop (didn't bet)
Seat 3: JediGaGa folded before Flop (didn't bet)
Seat 4: king-guru82 (button) folded before Flop (didn't bet)
Seat 5: Ty Nick 420 (small blind) folded before Flop
Seat 6: TimStone (big blind) folded before Flop
Seat 7: matiko09 folded before Flop (didn't bet)
Seat 8: LadyMaCe86 folded before Flop
Seat 9: maunzz folded before Flop (didn't bet)





PokerStars Hand #153508440110:  Hold'em No Limit ($0.50/$1.00 USD) - 2016/05/18 22:27:15 CET [2016/05/18 16:27:15 ET]
Table 'Samitchell II' 9-max Seat #4 is the button
Seat 1: cap. marb ($44.85 in chips) 
Seat 4: Zeeshka ($100 in chips) 
Seat 5: nuuaber ($21.44 in chips) 
Seat 6: TimStone ($100 in chips) 
Seat 7: matiko09 ($113.78 in chips) 
Seat 8: Karusana ($80 in chips) 
nuuaber: posts small blind $0.50
TimStone: posts big blind $1
Karusana: posts big blind $1
maunzz joins the table at seat #2 
JACQUILF: sits out 
*** HOLE CARDS ***
Dealt to matiko09 [2c 2d]
matiko09: folds 
Karusana: checks 
solbi86 joins the table at seat #3 
cap. marb: raises $3.50 to $4.50
Zeeshka: folds 
nuuaber: folds 
TimStone: folds 
Karusana: folds 
Uncalled bet ($3.50) returned to cap. marb
cap. marb collected $3.50 from pot
cap. marb: doesn't show hand 
*** SUMMARY ***
Total pot $3.50 | Rake $0 
Seat 1: cap. marb collected ($3.50)
Seat 4: Zeeshka (button) folded before Flop (didn't bet)
Seat 5: nuuaber (small blind) folded before Flop
Seat 6: TimStone (big blind) folded before Flop
Seat 7: matiko09 folded before Flop (didn't bet)
Seat 8: Karusana folded before Flop





PokerStars Hand #153508472675:  Hold'em No Limit ($0.50/$1.00 USD) - 2016/05/18 22:27:51 CET [2016/05/18 16:27:51 ET]
Table 'Luthera' 9-max Seat #6 is the button
Seat 5: sova77 ($58 in chips) 
Seat 6: TimStone ($102.75 in chips) 
Seat 7: matiko09 ($100 in chips) 
Seat 8: Cortine ($100 in chips) 
matiko09: posts small blind $0.50
Cortine: posts big blind $1
rate8: sits out 
maunzz: sits out 
vanilica: sits out 
*** HOLE CARDS ***
Dealt to matiko09 [4c Qs]
sova77: calls $1
TimStone: folds 
matiko09: folds 
Cortine: checks 
*** FLOP *** [5h 9c 3s]
Cortine: checks 
sova77: bets $2
Cortine: folds 
Uncalled bet ($2) returned to sova77
sova77 collected $2.38 from pot
sova77: doesn't show hand 
*** SUMMARY ***
Total pot $2.50 | Rake $0.12 
Board [5h 9c 3s]
Seat 5: sova77 collected ($2.38)
Seat 6: TimStone (button) folded before Flop (didn't bet)
Seat 7: matiko09 (small blind) folded before Flop
Seat 8: Cortine (big blind) folded on the Flop





PokerStars Hand #153508474616:  Hold'em No Limit ($0.50/$1.00 USD) - 2016/05/18 22:27:53 CET [2016/05/18 16:27:53 ET]
Table 'Brendelia II' 9-max Seat #9 is the button
Seat 1: cap. marb ($72.24 in chips) 
Seat 2: rate8 ($117.80 in chips) 
Seat 3: Zeeshka ($103 in chips) 
Seat 4: gkm0nk3y ($114.24 in chips) 
Seat 5: Vulturinus ($27.85 in chips) 
Seat 6: TimStone ($155.53 in chips) 
Seat 7: matiko09 ($129.32 in chips) 
Seat 8: solbi86 ($107.96 in chips) 
Seat 9: fr3314nc3 ($86.88 in chips) 
cap. marb: posts small blind $0.50
rate8: posts big blind $1
*** HOLE CARDS ***
Dealt to matiko09 [5h 3c]
Zeeshka: folds 
gkm0nk3y: folds 
Vulturinus: raises $2 to $3
TimStone: raises $9.50 to $12.50
matiko09: folds 
solbi86: folds 
fr3314nc3: folds 
cap. marb: folds 
rate8: folds 
Vulturinus: raises $15.35 to $27.85 and is all-in
TimStone: calls $15.35
*** FLOP *** [Kc 5d 6h]
*** TURN *** [Kc 5d 6h] [6c]
*** RIVER *** [Kc 5d 6h 6c] [8s]
*** SHOW DOWN ***
Vulturinus: shows [Jd Jc] (two pair, Jacks and Sixes)
TimStone: shows [As Qh] (a pair of Sixes)
Vulturinus collected $54.70 from pot
*** SUMMARY ***
Total pot $57.20 | Rake $2.50 
Board [Kc 5d 6h 6c 8s]
Seat 1: cap. marb (small blind) folded before Flop
Seat 2: rate8 (big blind) folded before Flop
Seat 3: Zeeshka folded before Flop (didn't bet)
Seat 4: gkm0nk3y folded before Flop (didn't bet)
Seat 5: Vulturinus showed [Jd Jc] and won ($54.70) with two pair, Jacks and Sixes
Seat 6: TimStone showed [As Qh] and lost with a pair of Sixes
Seat 7: matiko09 folded before Flop (didn't bet)
Seat 8: solbi86 folded before Flop (didn't bet)
Seat 9: fr3314nc3 (button) folded before Flop (didn't bet)





PokerStars Hand #153508475719:  Hold'em No Limit ($0.50/$1.00 USD) - 2016/05/18 22:27:54 CET [2016/05/18 16:27:54 ET]
Table 'Samitchell II' 9-max Seat #5 is the button
Seat 1: cap. marb ($47.35 in chips) 
Seat 4: Zeeshka ($100 in chips) 
Seat 5: nuuaber ($20.94 in chips) 
Seat 6: TimStone ($100 in chips) 
Seat 7: matiko09 ($113.78 in chips) 
Seat 8: Karusana ($79 in chips) 
TimStone: posts small blind $0.50
matiko09: posts big blind $1
JACQUILF: sits out 
maunzz: sits out 
solbi86: sits out 
*** HOLE CARDS ***
Dealt to matiko09 [7h Td]
Karusana: folds 
cap. marb: folds 
Zeeshka: folds 
nuuaber: calls $1
TimStone: folds 
matiko09: checks 
*** FLOP *** [Qh 4c Ts]
matiko09: checks 
nuuaber: checks 
*** TURN *** [Qh 4c Ts] [2c]
matiko09: bets $1.55
nuuaber: folds 
Uncalled bet ($1.55) returned to matiko09
matiko09 collected $2.38 from pot
matiko09: doesn't show hand 
*** SUMMARY ***
Total pot $2.50 | Rake $0.12 
Board [Qh 4c Ts 2c]
Seat 1: cap. marb folded before Flop (didn't bet)
Seat 4: Zeeshka folded before Flop (didn't bet)
Seat 5: nuuaber (button) folded on the Turn
Seat 6: TimStone (small blind) folded before Flop
Seat 7: matiko09 (big blind) collected ($2.38)
Seat 8: Karusana folded before Flop (didn't bet)





PokerStars Hand #153508483502:  Hold'em No Limit ($0.50/$1.00 USD) - 2016/05/18 22:28:02 CET [2016/05/18 16:28:02 ET]
Table 'Tatjana III' 9-max Seat #6 is the button
Seat 1: cap. marb ($41.10 in chips) 
Seat 2: vanilica ($114.56 in chips) 
Seat 3: matiko09 ($175.90 in chips) 
Seat 4: Strikerman25 ($41.12 in chips) 
Seat 5: deadkiller1 ($100 in chips) 
Seat 6: maunzz ($100 in chips) 
Seat 7: rene1984tsv ($398.07 in chips) 
Seat 8: badmadrabbit ($116.31 in chips) 
Seat 9: Moszes360 ($104.88 in chips) 
rene1984tsv: posts small blind $0.50
badmadrabbit: posts big blind $1
*** HOLE CARDS ***
Dealt to matiko09 [6c 3c]
Moszes360: folds 
cap. marb: folds 
vanilica: folds 
matiko09: folds 
Strikerman25: folds 
deadkiller1: folds 
maunzz: raises $1 to $2
rene1984tsv: calls $1.50
badmadrabbit: folds 
*** FLOP *** [2h 4s Qs]
rene1984tsv: checks 
maunzz: checks 
*** TURN *** [2h 4s Qs] [3s]
rene1984tsv: bets $2.37
maunzz: folds 
Uncalled bet ($2.37) returned to rene1984tsv
rene1984tsv collected $4.75 from pot
rene1984tsv: shows [7s 5d] (high card Queen)
*** SUMMARY ***
Total pot $5 | Rake $0.25 
Board [2h 4s Qs 3s]
Seat 1: cap. marb folded before Flop (didn't bet)
Seat 2: vanilica folded before Flop (didn't bet)
Seat 3: matiko09 folded before Flop (didn't bet)
Seat 4: Strikerman25 folded before Flop (didn't bet)
Seat 5: deadkiller1 folded before Flop (didn't bet)
Seat 6: maunzz (button) folded on the Turn
Seat 7: rene1984tsv (small blind) collected ($4.75)
Seat 8: badmadrabbit (big blind) folded before Flop
Seat 9: Moszes360 folded before Flop (didn't bet)





PokerStars Hand #153508486135:  Hold'em No Limit (€0.50/€1.00 EUR) - 2016/05/18 22:28:06 CET [2016/05/18 16:28:06 ET]
Table 'Sarmiento III' 9-max Seat #9 is the button
Seat 1: LadyMaCe86 (€100.32 in chips) 
Seat 2: Kreuznagel (€103.61 in chips) 
Seat 3: Mashulia7777 (€54.05 in chips) 
Seat 4: AugderStarke (€100.32 in chips) 
Seat 5: rexalex2012 (€98.76 in chips) 
Seat 6: TimStone (€100 in chips) 
Seat 7: JACQUILF (€101.84 in chips) 
Seat 8: matiko09 (€100 in chips) 
Seat 9: vanilica (€100 in chips) 
LadyMaCe86: posts small blind €0.50
Kreuznagel: posts big blind €1
*** HOLE CARDS ***
Dealt to matiko09 [Kh 5s]
Mashulia7777: folds 
AugderStarke: folds 
rexalex2012: calls €1
TimStone: folds 
JACQUILF: raises €3 to €4
matiko09: folds 
vanilica: calls €4
LadyMaCe86: folds 
Kreuznagel: calls €3
rexalex2012: calls €3
*** FLOP *** [5c 7s 4h]
Kreuznagel: checks 
rexalex2012: bets €2
JACQUILF: folds 
vanilica: folds 
Kreuznagel: calls €2
*** TURN *** [5c 7s 4h] [7h]
Kreuznagel: checks 
rexalex2012: bets €5
Kreuznagel: folds 
Uncalled bet (€5) returned to rexalex2012
rexalex2012 collected €19.48 from pot
rexalex2012: doesn't show hand 
*** SUMMARY ***
Total pot €20.50 | Rake €1.02 
Board [5c 7s 4h 7h]
Seat 1: LadyMaCe86 (small blind) folded before Flop
Seat 2: Kreuznagel (big blind) folded on the Turn
Seat 3: Mashulia7777 folded before Flop (didn't bet)
Seat 4: AugderStarke folded before Flop (didn't bet)
Seat 5: rexalex2012 collected (€19.48)
Seat 6: TimStone folded before Flop (didn't bet)
Seat 7: JACQUILF folded on the Flop
Seat 8: matiko09 folded before Flop (didn't bet)
Seat 9: vanilica (button) folded on the Flop





PokerStars Hand #153508490647:  Hold'em No Limit ($0.50/$1.00 USD) - 2016/05/18 22:28:11 CET [2016/05/18 16:28:11 ET]
Table 'Zanaih II' 9-max Seat #5 is the button
Seat 1: Chris pic77 ($111.89 in chips) 
Seat 2: JACQUILF ($100 in chips) 
Seat 3: JediGaGa ($96.45 in chips) 
Seat 4: king-guru82 ($98.50 in chips) 
Seat 5: Ty Nick 420 ($102.05 in chips) 
Seat 6: TimStone ($100 in chips) 
Seat 7: matiko09 ($101.50 in chips) 
Seat 8: LadyMaCe86 ($100 in chips) 
Seat 9: maunzz ($100 in chips) 
TimStone: posts small blind $0.50
matiko09: posts big blind $1
*** HOLE CARDS ***
Dealt to matiko09 [9h 4c]
LadyMaCe86: folds 
maunzz: folds 
Chris pic77: folds 
JACQUILF: folds 
JediGaGa: folds 
king-guru82: folds 
Ty Nick 420: raises $1 to $2
TimStone: folds 
matiko09: folds 
Uncalled bet ($1) returned to Ty Nick 420
Ty Nick 420 collected $2.50 from pot
*** SUMMARY ***
Total pot $2.50 | Rake $0 
Seat 1: Chris pic77 folded before Flop (didn't bet)
Seat 2: JACQUILF folded before Flop (didn't bet)
Seat 3: JediGaGa folded before Flop (didn't bet)
Seat 4: king-guru82 folded before Flop (didn't bet)
Seat 5: Ty Nick 420 (button) collected ($2.50)
Seat 6: TimStone (small blind) folded before Flop
Seat 7: matiko09 (big blind) folded before Flop
Seat 8: LadyMaCe86 folded before Flop (didn't bet)
Seat 9: maunzz folded before Flop (didn't bet)





PokerStars Hand #153508516896:  Hold'em No Limit ($0.50/$1.00 USD) - 2016/05/18 22:28:40 CET [2016/05/18 16:28:40 ET]
Table 'Samitchell II' 9-max Seat #6 is the button
Seat 1: cap. marb ($47.35 in chips) 
Seat 4: Zeeshka ($100 in chips) 
Seat 5: nuuaber ($19.94 in chips) 
Seat 6: TimStone ($100 in chips) 
Seat 7: matiko09 ($115.16 in chips) 
Seat 8: Karusana ($79 in chips) 
matiko09: posts small blind $0.50
Karusana: posts big blind $1
JACQUILF: sits out 
maunzz: sits out 
solbi86: sits out 
*** HOLE CARDS ***
Dealt to matiko09 [6d Qd]
cap. marb: folds 
Zeeshka: folds 
nuuaber: raises $2 to $3
TimStone: folds 
matiko09: folds 
Karusana: folds 
Uncalled bet ($2) returned to nuuaber
nuuaber collected $2.50 from pot
nuuaber: doesn't show hand 
*** SUMMARY ***
Total pot $2.50 | Rake $0 
Seat 1: cap. marb folded before Flop (didn't bet)
Seat 4: Zeeshka folded before Flop (didn't bet)
Seat 5: nuuaber collected ($2.50)
Seat 6: TimStone (button) folded before Flop (didn't bet)
Seat 7: matiko09 (small blind) folded before Flop
Seat 8: Karusana (big blind) folded before Flop





PokerStars Hand #153508522266:  Hold'em No Limit ($0.50/$1.00 USD) - 2016/05/18 22:28:45 CET [2016/05/18 16:28:45 ET]
Table 'Luthera' 9-max Seat #7 is the button
Seat 5: sova77 ($59.38 in chips) 
Seat 6: TimStone ($102.75 in chips) 
Seat 7: matiko09 ($100 in chips) 
Seat 8: Cortine ($100 in chips) 
Seat 9: rate8 ($100 in chips) 
Cortine: posts small blind $0.50
rate8: posts big blind $1
maunzz: sits out 
vanilica: sits out 
*** HOLE CARDS ***
Dealt to matiko09 [9d Qc]
sova77: folds 
TimStone: raises $1.52 to $2.52
matiko09: folds 
Cortine: folds 
rate8: folds 
Uncalled bet ($1.52) returned to TimStone
TimStone collected $2.50 from pot
TimStone: doesn't show hand 
*** SUMMARY ***
Total pot $2.50 | Rake $0 
Seat 5: sova77 folded before Flop (didn't bet)
Seat 6: TimStone collected ($2.50)
Seat 7: matiko09 (button) folded before Flop (didn't bet)
Seat 8: Cortine (small blind) folded before Flop
Seat 9: rate8 (big blind) folded before Flop





PokerStars Hand #153508522272:  Hold'em No Limit ($0.50/$1.00 USD) - 2016/05/18 22:28:45 CET [2016/05/18 16:28:45 ET]
Table 'Tatjana III' 9-max Seat #7 is the button
Seat 1: cap. marb ($41.10 in chips) 
Seat 2: vanilica ($114.56 in chips) 
Seat 3: matiko09 ($175.90 in chips) 
Seat 4: Strikerman25 ($41.12 in chips) 
Seat 5: deadkiller1 ($100 in chips) 
Seat 6: maunzz ($100 in chips) 
Seat 7: rene1984tsv ($400.82 in chips) 
Seat 8: badmadrabbit ($115.31 in chips) 
Seat 9: Moszes360 ($104.88 in chips) 
badmadrabbit: posts small blind $0.50
Moszes360: posts big blind $1
*** HOLE CARDS ***
Dealt to matiko09 [Qs Ks]
cap. marb: folds 
vanilica: folds 
matiko09: raises $2 to $3
Strikerman25: folds 
deadkiller1: folds 
maunzz: folds 
rene1984tsv: calls $3
badmadrabbit: folds 
Moszes360: folds 
*** FLOP *** [Kc Td 7s]
matiko09: bets $4.63
rene1984tsv: folds 
Uncalled bet ($4.63) returned to matiko09
matiko09 collected $7.12 from pot
matiko09: doesn't show hand 
*** SUMMARY ***
Total pot $7.50 | Rake $0.38 
Board [Kc Td 7s]
Seat 1: cap. marb folded before Flop (didn't bet)
Seat 2: vanilica folded before Flop (didn't bet)
Seat 3: matiko09 collected ($7.12)
Seat 4: Strikerman25 folded before Flop (didn't bet)
Seat 5: deadkiller1 folded before Flop (didn't bet)
Seat 6: maunzz folded before Flop (didn't bet)
Seat 7: rene1984tsv (button) folded on the Flop
Seat 8: badmadrabbit (small blind) folded before Flop
Seat 9: Moszes360 (big blind) folded before Flop





PokerStars Hand #153508526254:  Hold'em No Limit ($0.50/$1.00 USD) - 2016/05/18 22:28:50 CET [2016/05/18 16:28:50 ET]
Table 'Zanaih II' 9-max Seat #6 is the button
Seat 1: Chris pic77 ($111.89 in chips) 
Seat 2: JACQUILF ($100 in chips) 
Seat 3: JediGaGa ($96.45 in chips) 
Seat 4: king-guru82 ($98.50 in chips) 
Seat 5: Ty Nick 420 ($103.55 in chips) 
Seat 6: TimStone ($100 in chips) 
Seat 7: matiko09 ($100.50 in chips) 
Seat 9: maunzz ($100 in chips) 
matiko09: posts small blind $0.50
LadyMaCe86: is sitting out 
maunzz: posts big blind $1
*** HOLE CARDS ***
Dealt to matiko09 [2c Kd]
LadyMaCe86 leaves the table
Chris pic77: folds 
JACQUILF: folds 
JediGaGa: folds 
king-guru82: calls $1
Ty Nick 420: folds 
TimStone: folds 
matiko09: folds 
maunzz: checks 
*** FLOP *** [4s 7h Kc]
maunzz: checks 
xHourglass joins the table at seat #8 
king-guru82: checks 
*** TURN *** [4s 7h Kc] [Jd]
maunzz: checks 
king-guru82: checks 
*** RIVER *** [4s 7h Kc Jd] [As]
maunzz: checks 
king-guru82: checks 
*** SHOW DOWN ***
maunzz: shows [7c Th] (a pair of Sevens)
king-guru82: mucks hand 
maunzz collected $2.38 from pot
*** SUMMARY ***
Total pot $2.50 | Rake $0.12 
Board [4s 7h Kc Jd As]
Seat 1: Chris pic77 folded before Flop (didn't bet)
Seat 2: JACQUILF folded before Flop (didn't bet)
Seat 3: JediGaGa folded before Flop (didn't bet)
Seat 4: king-guru82 mucked [5d 6d]
Seat 5: Ty Nick 420 folded before Flop (didn't bet)
Seat 6: TimStone (button) folded before Flop (didn't bet)
Seat 7: matiko09 (small blind) folded before Flop
Seat 9: maunzz (big blind) showed [7c Th] and won ($2.38) with a pair of Sevens





PokerStars Hand #153508544579:  Hold'em No Limit ($0.50/$1.00 USD) - 2016/05/18 22:29:11 CET [2016/05/18 16:29:11 ET]
Table 'Brendelia II' 9-max Seat #1 is the button
Seat 1: cap. marb ($71.74 in chips) 
Seat 2: rate8 ($116.80 in chips) 
Seat 3: Zeeshka ($103 in chips) 
Seat 4: gkm0nk3y ($114.24 in chips) 
Seat 5: Vulturinus ($54.70 in chips) 
Seat 6: TimStone ($127.68 in chips) 
Seat 7: matiko09 ($129.32 in chips) 
Seat 8: solbi86 ($107.96 in chips) 
Seat 9: fr3314nc3 ($86.88 in chips) 
rate8: posts small blind $0.50
Zeeshka: posts big blind $1
*** HOLE CARDS ***
Dealt to matiko09 [2c 6h]
gkm0nk3y: raises $2 to $3
Vulturinus: folds 
TimStone: folds 
matiko09: folds 
solbi86: folds 
fr3314nc3: folds 
cap. marb: folds 
rate8: folds 
Zeeshka: folds 
Uncalled bet ($2) returned to gkm0nk3y
gkm0nk3y collected $2.50 from pot
*** SUMMARY ***
Total pot $2.50 | Rake $0 
Seat 1: cap. marb (button) folded before Flop (didn't bet)
Seat 2: rate8 (small blind) folded before Flop
Seat 3: Zeeshka (big blind) folded before Flop
Seat 4: gkm0nk3y collected ($2.50)
Seat 5: Vulturinus folded before Flop (didn't bet)
Seat 6: TimStone folded before Flop (didn't bet)
Seat 7: matiko09 folded before Flop (didn't bet)
Seat 8: solbi86 folded before Flop (didn't bet)
Seat 9: fr3314nc3 folded before Flop (didn't bet)





PokerStars Hand #153508547825:  Hold'em No Limit (€0.50/€1.00 EUR) - 2016/05/18 22:29:15 CET [2016/05/18 16:29:15 ET]
Table 'Sarmiento III' 9-max Seat #1 is the button
Seat 1: LadyMaCe86 (€100 in chips) 
Seat 2: Kreuznagel (€100 in chips) 
Seat 3: Mashulia7777 (€54.05 in chips) 
Seat 4: AugderStarke (€100.32 in chips) 
Seat 5: rexalex2012 (€112.24 in chips) 
Seat 6: TimStone (€100 in chips) 
Seat 7: JACQUILF (€100 in chips) 
Seat 8: matiko09 (€100 in chips) 
Seat 9: vanilica (€100 in chips) 
Kreuznagel: posts small blind €0.50
Mashulia7777: posts big blind €1
*** HOLE CARDS ***
Dealt to matiko09 [7c 2c]
AugderStarke: folds 
rexalex2012: calls €1
TimStone: folds 
JACQUILF: folds 
matiko09: folds 
vanilica: folds 
LadyMaCe86: folds 
Kreuznagel: folds 
Mashulia7777: checks 
*** FLOP *** [7h Ah Qd]
Mashulia7777: checks 
rexalex2012: bets €1
Mashulia7777: folds 
Uncalled bet (€1) returned to rexalex2012
rexalex2012 collected €2.38 from pot
rexalex2012: doesn't show hand 
*** SUMMARY ***
Total pot €2.50 | Rake €0.12 
Board [7h Ah Qd]
Seat 1: LadyMaCe86 (button) folded before Flop (didn't bet)
Seat 2: Kreuznagel (small blind) folded before Flop
Seat 3: Mashulia7777 (big blind) folded on the Flop
Seat 4: AugderStarke folded before Flop (didn't bet)
Seat 5: rexalex2012 collected (€2.38)
Seat 6: TimStone folded before Flop (didn't bet)
Seat 7: JACQUILF folded before Flop (didn't bet)
Seat 8: matiko09 folded before Flop (didn't bet)
Seat 9: vanilica folded before Flop (didn't bet)





PokerStars Hand #153508550231:  Hold'em No Limit ($0.50/$1.00 USD) - 2016/05/18 22:29:18 CET [2016/05/18 16:29:18 ET]
Table 'Samitchell II' 9-max Seat #7 is the button
Seat 1: cap. marb ($47.35 in chips) 
Seat 4: Zeeshka ($100 in chips) 
Seat 5: nuuaber ($21.44 in chips) 
Seat 6: TimStone ($100 in chips) 
Seat 7: matiko09 ($114.66 in chips) 
Seat 8: Karusana ($78 in chips) 
Seat 9: JACQUILF ($115.81 in chips) 
Karusana: posts small blind $0.50
JACQUILF: posts big blind $1
maunzz: sits out 
solbi86: sits out 
*** HOLE CARDS ***
Dealt to matiko09 [5c Ks]
cap. marb has timed out
cap. marb: folds 
Zeeshka: folds 
nuuaber: calls $1
TimStone: folds 
matiko09: folds 
Karusana: calls $0.50
JACQUILF: checks 
*** FLOP *** [3s Th 9s]
Karusana: checks 
JACQUILF: checks 
nuuaber: checks 
*** TURN *** [3s Th 9s] [9c]
Karusana: bets $4
JACQUILF: folds 
nuuaber: folds 
Uncalled bet ($4) returned to Karusana
Karusana collected $2.85 from pot
Karusana: doesn't show hand 
*** SUMMARY ***
Total pot $3 | Rake $0.15 
Board [3s Th 9s 9c]
Seat 1: cap. marb folded before Flop (didn't bet)
Seat 4: Zeeshka folded before Flop (didn't bet)
Seat 5: nuuaber folded on the Turn
Seat 6: TimStone folded before Flop (didn't bet)
Seat 7: matiko09 (button) folded before Flop (didn't bet)
Seat 8: Karusana (small blind) collected ($2.85)
Seat 9: JACQUILF (big blind) folded on the Turn





PokerStars Hand #153508551424:  Hold'em No Limit ($0.50/$1.00 USD) - 2016/05/18 22:29:19 CET [2016/05/18 16:29:19 ET]
Table 'Luthera' 9-max Seat #8 is the button
Seat 1: maunzz ($100 in chips) 
Seat 5: sova77 ($59.38 in chips) 
Seat 6: TimStone ($104.25 in chips) 
Seat 7: matiko09 ($100 in chips) 
Seat 8: Cortine ($100 in chips) 
Seat 9: rate8 ($100 in chips) 
rate8: posts small blind $0.50
maunzz: posts big blind $1
vanilica: sits out 
*** HOLE CARDS ***
Dealt to matiko09 [Ah 5s]
Mashulia7777 joins the table at seat #3 
sova77: raises $2 to $3
TimStone: folds 
matiko09: folds 
Cortine: folds 
rate8: calls $2.50
maunzz: calls $2
*** FLOP *** [Ad 8h 3s]
rate8: checks 
maunzz: checks 
sova77: checks 
*** TURN *** [Ad 8h 3s] [Tc]
rate8: checks 
Mashulia7777 leaves the table
maunzz: checks 
sova77: checks 
*** RIVER *** [Ad 8h 3s Tc] [8c]
rate8: checks 
maunzz: checks 
sova77: checks 
*** SHOW DOWN ***
rate8: shows [7h 7d] (two pair, Eights and Sevens)
maunzz: mucks hand 
sova77: mucks hand 
rate8 collected $8.55 from pot
*** SUMMARY ***
Total pot $9 | Rake $0.45 
Board [Ad 8h 3s Tc 8c]
Seat 1: maunzz (big blind) mucked [Qh 9h]
Seat 5: sova77 mucked [Kc Qc]
Seat 6: TimStone folded before Flop (didn't bet)
Seat 7: matiko09 folded before Flop (didn't bet)
Seat 8: Cortine (button) folded before Flop (didn't bet)
Seat 9: rate8 (small blind) showed [7h 7d] and won ($8.55) with two pair, Eights and Sevens





PokerStars Hand #153508554083:  Hold'em No Limit ($0.50/$1.00 USD) - 2016/05/18 22:29:22 CET [2016/05/18 16:29:22 ET]
Table 'Tatjana III' 9-max Seat #8 is the button
Seat 1: cap. marb ($41.10 in chips) 
Seat 2: vanilica ($114.56 in chips) 
Seat 3: matiko09 ($180.02 in chips) 
Seat 4: Strikerman25 ($41.12 in chips) 
Seat 5: deadkiller1 ($100 in chips) 
Seat 6: maunzz ($100 in chips) 
Seat 7: rene1984tsv ($397.82 in chips) 
Seat 8: badmadrabbit ($114.81 in chips) 
Seat 9: Moszes360 ($103.88 in chips) 
Moszes360: posts small blind $0.50
cap. marb: posts big blind $1
*** HOLE CARDS ***
Dealt to matiko09 [3s Td]
vanilica: raises $2 to $3
matiko09: folds 
Strikerman25: folds 
deadkiller1: folds 
maunzz: folds 
rene1984tsv: calls $3
badmadrabbit: folds 
Moszes360: folds 
cap. marb: folds 
*** FLOP *** [8d 6s 5s]
vanilica: checks 
rene1984tsv: bets $3.56
vanilica: folds 
Uncalled bet ($3.56) returned to rene1984tsv
rene1984tsv collected $7.12 from pot
rene1984tsv: shows [Qc 3c] (high card Queen)
*** SUMMARY ***
Total pot $7.50 | Rake $0.38 
Board [8d 6s 5s]
Seat 1: cap. marb (big blind) folded before Flop
Seat 2: vanilica folded on the Flop
Seat 3: matiko09 folded before Flop (didn't bet)
Seat 4: Strikerman25 folded before Flop (didn't bet)
Seat 5: deadkiller1 folded before Flop (didn't bet)
Seat 6: maunzz folded before Flop (didn't bet)
Seat 7: rene1984tsv collected ($7.12)
Seat 8: badmadrabbit (button) folded before Flop (didn't bet)
Seat 9: Moszes360 (small blind) folded before Flop





PokerStars Hand #153508580554:  Hold'em No Limit ($0.50/$1.00 USD) - 2016/05/18 22:29:51 CET [2016/05/18 16:29:51 ET]
Table 'Malva' 9-max Seat #9 is the button
Seat 1: stepan0605 ($100 in chips) 
Seat 2: matiko09 ($100 in chips) 
Seat 3: Cortine ($100 in chips) 
Seat 4: alex0953 ($100 in chips) 
Seat 8: TRABBI 81 ($144.02 in chips) 
Seat 9: Ty Nick 420 ($104.78 in chips) 
stepan0605: posts small blind $0.50
matiko09: posts big blind $1
alex0953: posts big blind $1
Gonzalo10/87: sits out 
*** HOLE CARDS ***
Dealt to matiko09 [3c 8d]
Cortine: folds 
alex0953: checks 
TRABBI 81: folds 
Ty Nick 420: folds 
stepan0605: raises $3.50 to $4.50
matiko09: folds 
alex0953 is disconnected 
alex0953 is connected 
alex0953: folds 
Uncalled bet ($3.50) returned to stepan0605
stepan0605 collected $3 from pot
stepan0605: doesn't show hand 
*** SUMMARY ***
Total pot $3 | Rake $0 
Seat 1: stepan0605 (small blind) collected ($3)
Seat 2: matiko09 (big blind) folded before Flop
Seat 3: Cortine folded before Flop (didn't bet)
Seat 4: alex0953 folded before Flop
Seat 8: TRABBI 81 folded before Flop (didn't bet)
Seat 9: Ty Nick 420 (button) folded before Flop (didn't bet)





PokerStars Hand #153508591936:  Hold'em No Limit ($0.50/$1.00 USD) - 2016/05/18 22:30:03 CET [2016/05/18 16:30:03 ET]
Table 'Tatjana III' 9-max Seat #9 is the button
Seat 1: cap. marb ($40.10 in chips) 
Seat 2: vanilica ($111.56 in chips) 
Seat 3: matiko09 ($180.02 in chips) 
Seat 4: Strikerman25 ($41.12 in chips) 
Seat 5: deadkiller1 ($100 in chips) 
Seat 6: maunzz ($100 in chips) 
Seat 7: rene1984tsv ($401.94 in chips) 
Seat 8: badmadrabbit ($114.81 in chips) 
Seat 9: Moszes360 ($103.38 in chips) 
cap. marb: posts small blind $0.50
vanilica: posts big blind $1
*** HOLE CARDS ***
Dealt to matiko09 [Qc Kh]
matiko09: raises $2 to $3
Strikerman25: folds 
deadkiller1: folds 
maunzz: folds 
rene1984tsv: calls $3
badmadrabbit: folds 
Moszes360: folds 
cap. marb: folds 
vanilica: folds 
*** FLOP *** [8s Th 8d]
matiko09: checks 
rene1984tsv: checks 
*** TURN *** [8s Th 8d] [Tc]
matiko09: checks 
rene1984tsv: bets $7.12
matiko09: folds 
Uncalled bet ($7.12) returned to rene1984tsv
rene1984tsv collected $7.12 from pot
rene1984tsv: shows [Qs 9h] (two pair, Tens and Eights)
*** SUMMARY ***
Total pot $7.50 | Rake $0.38 
Board [8s Th 8d Tc]
Seat 1: cap. marb (small blind) folded before Flop
Seat 2: vanilica (big blind) folded before Flop
Seat 3: matiko09 folded on the Turn
Seat 4: Strikerman25 folded before Flop (didn't bet)
Seat 5: deadkiller1 folded before Flop (didn't bet)
Seat 6: maunzz folded before Flop (didn't bet)
Seat 7: rene1984tsv collected ($7.12)
Seat 8: badmadrabbit folded before Flop (didn't bet)
Seat 9: Moszes360 (button) folded before Flop (didn't bet)





PokerStars Hand #153508594020:  Hold'em No Limit ($0.50/$1.00 USD) - 2016/05/18 22:30:06 CET [2016/05/18 16:30:06 ET]
Table 'Brendelia II' 9-max Seat #2 is the button
Seat 1: cap. marb ($71.74 in chips) 
Seat 2: rate8 ($116.30 in chips) 
Seat 3: Zeeshka ($102 in chips) 
Seat 4: gkm0nk3y ($115.74 in chips) 
Seat 5: Vulturinus ($54.70 in chips) 
Seat 6: TimStone ($127.68 in chips) 
Seat 7: matiko09 ($129.32 in chips) 
Seat 8: solbi86 ($107.96 in chips) 
Seat 9: fr3314nc3 ($86.88 in chips) 
Zeeshka: posts small blind $0.50
gkm0nk3y: posts big blind $1
*** HOLE CARDS ***
Dealt to matiko09 [3s 7d]
Vulturinus: raises $2 to $3
TimStone: folds 
matiko09: folds 
solbi86: folds 
fr3314nc3: folds 
cap. marb: folds 
rate8: folds 
Zeeshka: folds 
gkm0nk3y: calls $2
*** FLOP *** [6s 9h Ts]
gkm0nk3y: checks 
Vulturinus: bets $4
gkm0nk3y: folds 
Uncalled bet ($4) returned to Vulturinus
Vulturinus collected $6.18 from pot
*** SUMMARY ***
Total pot $6.50 | Rake $0.32 
Board [6s 9h Ts]
Seat 1: cap. marb folded before Flop (didn't bet)
Seat 2: rate8 (button) folded before Flop (didn't bet)
Seat 3: Zeeshka (small blind) folded before Flop
Seat 4: gkm0nk3y (big blind) folded on the Flop
Seat 5: Vulturinus collected ($6.18)
Seat 6: TimStone folded before Flop (didn't bet)
Seat 7: matiko09 folded before Flop (didn't bet)
Seat 8: solbi86 folded before Flop (didn't bet)
Seat 9: fr3314nc3 folded before Flop (didn't bet)





PokerStars Hand #153508603324:  Hold'em No Limit ($0.50/$1.00 USD) - 2016/05/18 22:30:16 CET [2016/05/18 16:30:16 ET]
Table 'Zanaih II' 9-max Seat #7 is the button
Seat 1: Chris pic77 ($111.89 in chips) 
Seat 2: JACQUILF ($100 in chips) 
Seat 3: JediGaGa ($96.45 in chips) 
Seat 4: king-guru82 ($97.50 in chips) 
Seat 5: Ty Nick 420 ($103.55 in chips) 
Seat 6: TimStone ($100 in chips) 
Seat 7: matiko09 ($100 in chips) 
Seat 9: maunzz ($101.38 in chips) 
xHourglass will be allowed to play after the button
maunzz: posts small blind $0.50
Chris pic77: posts big blind $1
*** HOLE CARDS ***
Dealt to matiko09 [8h 6h]
JACQUILF: folds 
JediGaGa: folds 
king-guru82: folds 
Ty Nick 420: folds 
TimStone: raises $1.52 to $2.52
matiko09: folds 
maunzz: folds 
Chris pic77: calls $1.52
*** FLOP *** [Kd 9c Ks]
Chris pic77: checks 
TimStone: bets $2.72
Chris pic77: calls $2.72
*** TURN *** [Kd 9c Ks] [Th]
Chris pic77: checks 
TimStone: checks 
*** RIVER *** [Kd 9c Ks Th] [2c]
Chris pic77: bets $5.21
TimStone: folds 
Uncalled bet ($5.21) returned to Chris pic77
Chris pic77 collected $10.43 from pot
*** SUMMARY ***
Total pot $10.98 | Rake $0.55 
Board [Kd 9c Ks Th 2c]
Seat 1: Chris pic77 (big blind) collected ($10.43)
Seat 2: JACQUILF folded before Flop (didn't bet)
Seat 3: JediGaGa folded before Flop (didn't bet)
Seat 4: king-guru82 folded before Flop (didn't bet)
Seat 5: Ty Nick 420 folded before Flop (didn't bet)
Seat 6: TimStone folded on the River
Seat 7: matiko09 (button) folded before Flop (didn't bet)
Seat 9: maunzz (small blind) folded before Flop





PokerStars Hand #153508606473:  Hold'em No Limit (€0.50/€1.00 EUR) - 2016/05/18 22:30:20 CET [2016/05/18 16:30:20 ET]
Table 'Sarmiento III' 9-max Seat #2 is the button
Seat 1: LadyMaCe86 (€100 in chips) 
Seat 2: Kreuznagel (€100 in chips) 
Seat 3: Mashulia7777 (€53.05 in chips) 
Seat 4: AugderStarke (€100.32 in chips) 
Seat 5: rexalex2012 (€113.62 in chips) 
Seat 6: TimStone (€100 in chips) 
Seat 7: JACQUILF (€100 in chips) 
Seat 8: matiko09 (€100 in chips) 
Seat 9: vanilica (€100 in chips) 
Mashulia7777: posts small blind €0.50
AugderStarke: posts big blind €1
*** HOLE CARDS ***
Dealt to matiko09 [Ah 8h]
rexalex2012: raises €1 to €2
TimStone: folds 
JACQUILF: folds 
matiko09: folds 
vanilica: folds 
LadyMaCe86: folds 
Kreuznagel: folds 
Mashulia7777: folds 
AugderStarke: folds 
Uncalled bet (€1) returned to rexalex2012
rexalex2012 collected €2.50 from pot
rexalex2012: doesn't show hand 
*** SUMMARY ***
Total pot €2.50 | Rake €0 
Seat 1: LadyMaCe86 folded before Flop (didn't bet)
Seat 2: Kreuznagel (button) folded before Flop (didn't bet)
Seat 3: Mashulia7777 (small blind) folded before Flop
Seat 4: AugderStarke (big blind) folded before Flop
Seat 5: rexalex2012 collected (€2.50)
Seat 6: TimStone folded before Flop (didn't bet)
Seat 7: JACQUILF folded before Flop (didn't bet)
Seat 8: matiko09 folded before Flop (didn't bet)
Seat 9: vanilica folded before Flop (didn't bet)





PokerStars Hand #153508613836:  Hold'em No Limit ($0.50/$1.00 USD) - 2016/05/18 22:30:28 CET [2016/05/18 16:30:28 ET]
Table 'Samitchell II' 9-max Seat #8 is the button
Seat 1: cap. marb ($47.35 in chips) 
Seat 4: Zeeshka ($100 in chips) 
Seat 5: nuuaber ($20.44 in chips) 
Seat 6: TimStone ($100 in chips) 
Seat 7: matiko09 ($114.66 in chips) 
Seat 8: Karusana ($79.85 in chips) 
Seat 9: JACQUILF ($114.81 in chips) 
JACQUILF: posts small blind $0.50
cap. marb: posts big blind $1
maunzz: sits out 
solbi86: sits out 
*** HOLE CARDS ***
Dealt to matiko09 [6d Tc]
Zeeshka: folds 
nuuaber: folds 
TimStone: raises $1.62 to $2.62
matiko09: folds 
Karusana: folds 
JACQUILF: folds 
cap. marb: folds 
Uncalled bet ($1.62) returned to TimStone
TimStone collected $2.50 from pot
TimStone: doesn't show hand 
*** SUMMARY ***
Total pot $2.50 | Rake $0 
Seat 1: cap. marb (big blind) folded before Flop
Seat 4: Zeeshka folded before Flop (didn't bet)
Seat 5: nuuaber folded before Flop (didn't bet)
Seat 6: TimStone collected ($2.50)
Seat 7: matiko09 folded before Flop (didn't bet)
Seat 8: Karusana (button) folded before Flop (didn't bet)
Seat 9: JACQUILF (small blind) folded before Flop





PokerStars Hand #153508622988:  Hold'em No Limit ($0.50/$1.00 USD) - 2016/05/18 22:30:38 CET [2016/05/18 16:30:38 ET]
Table 'Luthera' 9-max Seat #9 is the button
Seat 1: maunzz ($100 in chips) 
Seat 2: vanilica ($100 in chips) 
Seat 5: sova77 ($56.38 in chips) 
Seat 6: TimStone ($104.25 in chips) 
Seat 7: matiko09 ($100 in chips) 
Seat 8: Cortine ($100 in chips) 
Seat 9: rate8 ($105.55 in chips) 
maunzz: posts small blind $0.50
vanilica: posts big blind $1
*** HOLE CARDS ***
Dealt to matiko09 [7h 5d]
sova77: calls $1
TimStone: raises $3.90 to $4.90
matiko09: folds 
Cortine: folds 
rate8: folds 
maunzz: folds 
vanilica: folds 
sova77: folds 
Uncalled bet ($3.90) returned to TimStone
TimStone collected $3.50 from pot
TimStone: doesn't show hand 
*** SUMMARY ***
Total pot $3.50 | Rake $0 
Seat 1: maunzz (small blind) folded before Flop
Seat 2: vanilica (big blind) folded before Flop
Seat 5: sova77 folded before Flop
Seat 6: TimStone collected ($3.50)
Seat 7: matiko09 folded before Flop (didn't bet)
Seat 8: Cortine folded before Flop (didn't bet)
Seat 9: rate8 (button) folded before Flop (didn't bet)





PokerStars Hand #153508624402:  Hold'em No Limit ($0.50/$1.00 USD) - 2016/05/18 22:30:40 CET [2016/05/18 16:30:40 ET]
Table 'Malva' 9-max Seat #1 is the button
Seat 1: stepan0605 ($102 in chips) 
Seat 2: matiko09 ($100 in chips) 
Seat 4: alex0953 ($99 in chips) 
Seat 6: cap. marb ($40.11 in chips) 
Seat 8: TRABBI 81 ($144.02 in chips) 
Seat 9: Ty Nick 420 ($104.78 in chips) 
matiko09: posts small blind $0.50
Cortine: is sitting out 
Cortine leaves the table
alex0953: posts big blind $1
Gonzalo10/87: sits out 
*** HOLE CARDS ***
Dealt to matiko09 [6s Qh]
cap. marb: folds 
TRABBI 81: folds 
Ty Nick 420: raises $1.50 to $2.50
stepan0605: folds 
matiko09: folds 
alex0953 is disconnected 
alex0953 has timed out while disconnected
alex0953: folds 
Uncalled bet ($1.50) returned to Ty Nick 420
Ty Nick 420 collected $2.50 from pot
*** SUMMARY ***
Total pot $2.50 | Rake $0 
Seat 1: stepan0605 (button) folded before Flop (didn't bet)
Seat 2: matiko09 (small blind) folded before Flop
Seat 4: alex0953 (big blind) folded before Flop
Seat 6: cap. marb folded before Flop (didn't bet)
Seat 8: TRABBI 81 folded before Flop (didn't bet)
Seat 9: Ty Nick 420 collected ($2.50)





PokerStars Hand #153508628611:  Hold'em No Limit ($0.50/$1.00 USD) - 2016/05/18 22:30:44 CET [2016/05/18 16:30:44 ET]
Table 'Tatjana III' 9-max Seat #1 is the button
Seat 1: cap. marb ($39.60 in chips) 
Seat 2: vanilica ($110.56 in chips) 
Seat 3: matiko09 ($177.02 in chips) 
Seat 4: Strikerman25 ($41.12 in chips) 
Seat 5: deadkiller1 ($100 in chips) 
Seat 6: maunzz ($100 in chips) 
Seat 7: rene1984tsv ($406.06 in chips) 
Seat 8: badmadrabbit ($114.81 in chips) 
Seat 9: Moszes360 ($103.38 in chips) 
vanilica: posts small blind $0.50
matiko09: posts big blind $1
*** HOLE CARDS ***
Dealt to matiko09 [As Ad]
Strikerman25: raises $2 to $3
deadkiller1: folds 
maunzz: folds 
rene1984tsv: calls $3
badmadrabbit: folds 
Moszes360: folds 
cap. marb: folds 
vanilica: folds 
matiko09: raises $13 to $16
Strikerman25: folds 
rene1984tsv: calls $13
*** FLOP *** [5c 2d Js]
matiko09: bets $23
rene1984tsv: folds 
Uncalled bet ($23) returned to matiko09
matiko09 collected $33.72 from pot
matiko09: doesn't show hand 
*** SUMMARY ***
Total pot $35.50 | Rake $1.78 
Board [5c 2d Js]
Seat 1: cap. marb (button) folded before Flop (didn't bet)
Seat 2: vanilica (small blind) folded before Flop
Seat 3: matiko09 (big blind) collected ($33.72)
Seat 4: Strikerman25 folded before Flop
Seat 5: deadkiller1 folded before Flop (didn't bet)
Seat 6: maunzz folded before Flop (didn't bet)
Seat 7: rene1984tsv folded on the Flop
Seat 8: badmadrabbit folded before Flop (didn't bet)
Seat 9: Moszes360 folded before Flop (didn't bet)





PokerStars Hand #153508640884:  Hold'em No Limit ($0.50/$1.00 USD) - 2016/05/18 22:30:58 CET [2016/05/18 16:30:58 ET]
Table 'Luthera' 9-max Seat #1 is the button
Seat 1: maunzz ($100 in chips) 
Seat 2: vanilica ($100 in chips) 
Seat 5: sova77 ($55.38 in chips) 
Seat 6: TimStone ($106.75 in chips) 
Seat 7: matiko09 ($100 in chips) 
Seat 8: Cortine ($100 in chips) 
Seat 9: rate8 ($105.55 in chips) 
vanilica: posts small blind $0.50
sova77: posts big blind $1
*** HOLE CARDS ***
Dealt to matiko09 [9h 3h]
TimStone: raises $1.62 to $2.62
matiko09: folds 
Cortine: folds 
rate8: folds 
maunzz: folds 
vanilica: folds 
sova77: folds 
Uncalled bet ($1.62) returned to TimStone
TimStone collected $2.50 from pot
TimStone: doesn't show hand 
*** SUMMARY ***
Total pot $2.50 | Rake $0 
Seat 1: maunzz (button) folded before Flop (didn't bet)
Seat 2: vanilica (small blind) folded before Flop
Seat 5: sova77 (big blind) folded before Flop
Seat 6: TimStone collected ($2.50)
Seat 7: matiko09 folded before Flop (didn't bet)
Seat 8: Cortine folded before Flop (didn't bet)
Seat 9: rate8 folded before Flop (didn't bet)





PokerStars Hand #153508643284:  Hold'em No Limit ($0.50/$1.00 USD) - 2016/05/18 22:31:00 CET [2016/05/18 16:31:00 ET]
Table 'Samitchell II' 9-max Seat #9 is the button
Seat 1: cap. marb ($46.35 in chips) 
Seat 2: maunzz ($100 in chips) 
Seat 4: Zeeshka ($100 in chips) 
Seat 5: nuuaber ($20.44 in chips) 
Seat 6: TimStone ($101.50 in chips) 
Seat 7: matiko09 ($114.66 in chips) 
Seat 8: Karusana ($79.85 in chips) 
Seat 9: JACQUILF ($114.31 in chips) 
cap. marb: posts small blind $0.50
maunzz: posts big blind $1
solbi86: sits out 
*** HOLE CARDS ***
Dealt to matiko09 [2c Qs]
Zeeshka: folds 
nuuaber: raises $2.50 to $3.50
TimStone: folds 
matiko09: folds 
Karusana: folds 
JACQUILF: folds 
cap. marb: folds 
maunzz: folds 
Uncalled bet ($2.50) returned to nuuaber
nuuaber collected $2.50 from pot
nuuaber: doesn't show hand 
*** SUMMARY ***
Total pot $2.50 | Rake $0 
Seat 1: cap. marb (small blind) folded before Flop
Seat 2: maunzz (big blind) folded before Flop
Seat 4: Zeeshka folded before Flop (didn't bet)
Seat 5: nuuaber collected ($2.50)
Seat 6: TimStone folded before Flop (didn't bet)
Seat 7: matiko09 folded before Flop (didn't bet)
Seat 8: Karusana folded before Flop (didn't bet)
Seat 9: JACQUILF (button) folded before Flop (didn't bet)





PokerStars Hand #153508646368:  Hold'em No Limit (€0.50/€1.00 EUR) - 2016/05/18 22:31:04 CET [2016/05/18 16:31:04 ET]
Table 'Lamberta IV' 9-max Seat #6 is the button
Seat 1: vanilica (€107.04 in chips) 
Seat 4: Ouga Buga (€100 in chips) 
Seat 5: tomma585 (€149.92 in chips) 
Seat 6: JACQUILF (€100.27 in chips) 
Seat 7: TimStone (€105.19 in chips) 
Seat 8: matiko09 (€100 in chips) 
Seat 9: maunzz (€123.59 in chips) 
TimStone: posts small blind €0.50
matiko09: posts big blind €1
stepan0605: sits out 
Mashulia7777: sits out 
*** HOLE CARDS ***
Dealt to matiko09 [3h Ah]
maunzz: folds 
vanilica: raises €2 to €3
Ouga Buga: folds 
tomma585: calls €3
JACQUILF: folds 
TimStone: folds 
matiko09: folds 
*** FLOP *** [Ad Th 4s]
vanilica: bets €5.34
tomma585: folds 
Uncalled bet (€5.34) returned to vanilica
vanilica collected €7.12 from pot
vanilica: doesn't show hand 
*** SUMMARY ***
Total pot €7.50 | Rake €0.38 
Board [Ad Th 4s]
Seat 1: vanilica collected (€7.12)
Seat 4: Ouga Buga folded before Flop (didn't bet)
Seat 5: tomma585 folded on the Flop
Seat 6: JACQUILF (button) folded before Flop (didn't bet)
Seat 7: TimStone (small blind) folded before Flop
Seat 8: matiko09 (big blind) folded before Flop
Seat 9: maunzz folded before Flop (didn't bet)





PokerStars Hand #153508650510:  Hold'em No Limit ($0.50/$1.00 USD) - 2016/05/18 22:31:08 CET [2016/05/18 16:31:08 ET]
Table 'Brendelia II' 9-max Seat #3 is the button
Seat 1: cap. marb ($71.74 in chips) 
Seat 2: rate8 ($116.30 in chips) 
Seat 3: Zeeshka ($101.50 in chips) 
Seat 4: gkm0nk3y ($112.74 in chips) 
Seat 5: Vulturinus ($57.88 in chips) 
Seat 6: TimStone ($127.68 in chips) 
Seat 7: matiko09 ($129.32 in chips) 
Seat 8: solbi86 ($107.96 in chips) 
Seat 9: fr3314nc3 ($86.88 in chips) 
gkm0nk3y: posts small blind $0.50
Vulturinus: posts big blind $1
*** HOLE CARDS ***
Dealt to matiko09 [Jc 5c]
TimStone: folds 
matiko09: folds 
solbi86: folds 
fr3314nc3: raises $2 to $3
cap. marb: folds 
rate8: raises $6 to $9
Zeeshka: folds 
gkm0nk3y: folds 
Vulturinus: folds 
fr3314nc3: folds 
Uncalled bet ($6) returned to rate8
rate8 collected $7.50 from pot
rate8: doesn't show hand 
*** SUMMARY ***
Total pot $7.50 | Rake $0 
Seat 1: cap. marb folded before Flop (didn't bet)
Seat 2: rate8 collected ($7.50)
Seat 3: Zeeshka (button) folded before Flop (didn't bet)
Seat 4: gkm0nk3y (small blind) folded before Flop
Seat 5: Vulturinus (big blind) folded before Flop
Seat 6: TimStone folded before Flop (didn't bet)
Seat 7: matiko09 folded before Flop (didn't bet)
Seat 8: solbi86 folded before Flop (didn't bet)
Seat 9: fr3314nc3 folded before Flop





PokerStars Hand #153508656380:  Hold'em No Limit (€0.50/€1.00 EUR) - 2016/05/18 22:31:15 CET [2016/05/18 16:31:15 ET]
Table 'Sarmiento III' 9-max Seat #3 is the button
Seat 1: LadyMaCe86 (€100 in chips) 
Seat 2: Kreuznagel (€100 in chips) 
Seat 3: Mashulia7777 (€52.55 in chips) 
Seat 4: AugderStarke (€99.32 in chips) 
Seat 5: rexalex2012 (€115.12 in chips) 
Seat 6: TimStone (€100 in chips) 
Seat 7: JACQUILF (€100 in chips) 
Seat 8: matiko09 (€100 in chips) 
Seat 9: vanilica (€100 in chips) 
AugderStarke: posts small blind €0.50
rexalex2012: posts big blind €1
*** HOLE CARDS ***
Dealt to matiko09 [2d 3h]
TimStone: folds 
JACQUILF: folds 
matiko09: folds 
vanilica: folds 
LadyMaCe86: folds 
Kreuznagel: folds 
Mashulia7777: raises €2 to €3
AugderStarke: folds 
rexalex2012: calls €2
*** FLOP *** [9d Ks 2h]
rexalex2012: bets €3
Mashulia7777: calls €3
*** TURN *** [9d Ks 2h] [Th]
rexalex2012: bets €5
Mashulia7777: calls €5
*** RIVER *** [9d Ks 2h Th] [4c]
rexalex2012: bets €21.38
Mashulia7777: calls €21.38
*** SHOW DOWN ***
rexalex2012: shows [Qs Kc] (a pair of Kings)
Mashulia7777: shows [Td 9c] (two pair, Tens and Nines)
Mashulia7777 collected €63.01 from pot
*** SUMMARY ***
Total pot €65.26 | Rake €2.25 
Board [9d Ks 2h Th 4c]
Seat 1: LadyMaCe86 folded before Flop (didn't bet)
Seat 2: Kreuznagel folded before Flop (didn't bet)
Seat 3: Mashulia7777 (button) showed [Td 9c] and won (€63.01) with two pair, Tens and Nines
Seat 4: AugderStarke (small blind) folded before Flop
Seat 5: rexalex2012 (big blind) showed [Qs Kc] and lost with a pair of Kings
Seat 6: TimStone folded before Flop (didn't bet)
Seat 7: JACQUILF folded before Flop (didn't bet)
Seat 8: matiko09 folded before Flop (didn't bet)
Seat 9: vanilica folded before Flop (didn't bet)





PokerStars Hand #153508660291:  Hold'em No Limit ($0.50/$1.00 USD) - 2016/05/18 22:31:19 CET [2016/05/18 16:31:19 ET]
Table 'Luthera' 9-max Seat #2 is the button
Seat 1: maunzz ($100 in chips) 
Seat 2: vanilica ($100 in chips) 
Seat 5: sova77 ($54.38 in chips) 
Seat 6: TimStone ($108.25 in chips) 
Seat 7: matiko09 ($100 in chips) 
Seat 8: Cortine ($100 in chips) 
Seat 9: rate8 ($105.55 in chips) 
sova77: posts small blind $0.50
TimStone: posts big blind $1
*** HOLE CARDS ***
Dealt to matiko09 [5c Ad]
matiko09: folds 
antohka123 joins the table at seat #4 
Cortine: folds 
rate8: raises $2 to $3
maunzz: folds 
vanilica: folds 
sova77: folds 
TimStone: folds 
Uncalled bet ($2) returned to rate8
rate8 collected $2.50 from pot
*** SUMMARY ***
Total pot $2.50 | Rake $0 
Seat 1: maunzz folded before Flop (didn't bet)
Seat 2: vanilica (button) folded before Flop (didn't bet)
Seat 5: sova77 (small blind) folded before Flop
Seat 6: TimStone (big blind) folded before Flop
Seat 7: matiko09 folded before Flop (didn't bet)
Seat 8: Cortine folded before Flop (didn't bet)
Seat 9: rate8 collected ($2.50)





PokerStars Hand #153508671725:  Hold'em No Limit ($0.50/$1.00 USD) - 2016/05/18 22:31:32 CET [2016/05/18 16:31:32 ET]
Table 'Malva' 9-max Seat #2 is the button
Seat 1: stepan0605 ($102 in chips) 
Seat 2: matiko09 ($100 in chips) 
Seat 6: cap. marb ($40.11 in chips) 
Seat 7: Gonzalo10/87 ($100 in chips) 
Seat 8: TRABBI 81 ($144.02 in chips) 
Seat 9: Ty Nick 420 ($106.28 in chips) 
cap. marb: posts small blind $0.50
Gonzalo10/87: posts big blind $1
*** HOLE CARDS ***
Dealt to matiko09 [Kh Js]
TRABBI 81: folds 
Ty Nick 420: folds 
stepan0605: raises $1.50 to $2.50
matiko09: raises $6.50 to $9
cap. marb: folds 
Gonzalo10/87: folds 
stepan0605: folds 
Uncalled bet ($6.50) returned to matiko09
matiko09 collected $6.50 from pot
matiko09: doesn't show hand 
*** SUMMARY ***
Total pot $6.50 | Rake $0 
Seat 1: stepan0605 folded before Flop
Seat 2: matiko09 (button) collected ($6.50)
Seat 6: cap. marb (small blind) folded before Flop
Seat 7: Gonzalo10/87 (big blind) folded before Flop
Seat 8: TRABBI 81 folded before Flop (didn't bet)
Seat 9: Ty Nick 420 folded before Flop (didn't bet)





PokerStars Hand #153508677914:  Hold'em No Limit ($0.50/$1.00 USD) - 2016/05/18 22:31:39 CET [2016/05/18 16:31:39 ET]
Table 'Luthera' 9-max Seat #5 is the button
Seat 1: maunzz ($100 in chips) 
Seat 2: vanilica ($100 in chips) 
Seat 5: sova77 ($53.88 in chips) 
Seat 6: TimStone ($107.25 in chips) 
Seat 7: matiko09 ($100 in chips) 
Seat 8: Cortine ($100 in chips) 
Seat 9: rate8 ($107.05 in chips) 
TimStone: posts small blind $0.50
matiko09: posts big blind $1
antohka123: sits out 
*** HOLE CARDS ***
Dealt to matiko09 [2d 3c]
Cortine: folds 
rate8: folds 
maunzz: folds 
vanilica: folds 
sova77: raises $2 to $3
TimStone: folds 
matiko09: folds 
Uncalled bet ($2) returned to sova77
sova77 collected $2.50 from pot
sova77: doesn't show hand 
*** SUMMARY ***
Total pot $2.50 | Rake $0 
Seat 1: maunzz folded before Flop (didn't bet)
Seat 2: vanilica folded before Flop (didn't bet)
Seat 5: sova77 (button) collected ($2.50)
Seat 6: TimStone (small blind) folded before Flop
Seat 7: matiko09 (big blind) folded before Flop
Seat 8: Cortine folded before Flop (didn't bet)
Seat 9: rate8 folded before Flop (didn't bet)





PokerStars Hand #153508681298:  Hold'em No Limit ($0.50/$1.00 USD) - 2016/05/18 22:31:43 CET [2016/05/18 16:31:43 ET]
Table 'Tatjana III' 9-max Seat #2 is the button
Seat 1: cap. marb ($39.60 in chips) 
Seat 2: vanilica ($110.06 in chips) 
Seat 3: matiko09 ($194.74 in chips) 
Seat 4: Strikerman25 ($38.12 in chips) 
Seat 5: deadkiller1 ($100 in chips) 
Seat 6: maunzz ($100 in chips) 
Seat 7: rene1984tsv ($390.06 in chips) 
Seat 8: badmadrabbit ($114.81 in chips) 
Seat 9: Moszes360 ($103.38 in chips) 
matiko09: posts small blind $0.50
Strikerman25: posts big blind $1
*** HOLE CARDS ***
Dealt to matiko09 [9s Kd]
deadkiller1: folds 
maunzz: folds 
rene1984tsv: calls $1
badmadrabbit: raises $2 to $3
Moszes360: folds 
cap. marb: folds 
vanilica: folds 
matiko09: folds 
Strikerman25: folds 
rene1984tsv: calls $2
*** FLOP *** [Qh Th Ah]
rene1984tsv: checks 
badmadrabbit: bets $3.77
rene1984tsv: calls $3.77
*** TURN *** [Qh Th Ah] [9c]
rene1984tsv: checks 
badmadrabbit: checks 
*** RIVER *** [Qh Th Ah 9c] [2s]
rene1984tsv: checks 
badmadrabbit: checks 
*** SHOW DOWN ***
rene1984tsv: shows [Ts Jc] (a pair of Tens)
badmadrabbit: mucks hand 
rene1984tsv collected $14.29 from pot
*** SUMMARY ***
Total pot $15.04 | Rake $0.75 
Board [Qh Th Ah 9c 2s]
Seat 1: cap. marb folded before Flop (didn't bet)
Seat 2: vanilica (button) folded before Flop (didn't bet)
Seat 3: matiko09 (small blind) folded before Flop
Seat 4: Strikerman25 (big blind) folded before Flop
Seat 5: deadkiller1 folded before Flop (didn't bet)
Seat 6: maunzz folded before Flop (didn't bet)
Seat 7: rene1984tsv showed [Ts Jc] and won ($14.29) with a pair of Tens
Seat 8: badmadrabbit mucked [5d 5s]
Seat 9: Moszes360 folded before Flop (didn't bet)





