PokerStars Hand #148210352955:  Hold'em No Limit (€0.10/€0.25 EUR) - 2016/02/04 11:10:31 CET [2016/02/04 5:10:31 ET]
Table 'Lilaea III' 6-max Seat #3 is the button
Seat 1: matiko09 (€27.10 in chips) 
Seat 2: Newbie1990 (€27.63 in chips) 
Seat 3: uzzy20 (€25.45 in chips) 
Seat 4: Wwwasian (€26.15 in chips) 
Seat 5: Depti4 (€28.91 in chips) 
Seat 6: BaaroRai (€28.47 in chips) 
Wwwasian: posts small blind €0.10
Depti4: posts big blind €0.25
*** HOLE CARDS ***
Dealt to matiko09 [8s Qc]
BaaroRai: calls €0.25
matiko09: folds 
Newbie1990: folds 
uzzy20: folds 
Wwwasian: folds 
Depti4: checks 
*** FLOP *** [6c 4c 3s]
Depti4: bets €0.50
BaaroRai: folds 
Uncalled bet (€0.50) returned to Depti4
Depti4 collected €0.57 from pot
Depti4: doesn't show hand 
*** SUMMARY ***
Total pot €0.60 | Rake €0.03 
Board [6c 4c 3s]
Seat 1: matiko09 folded before Flop (didn't bet)
Seat 2: Newbie1990 folded before Flop (didn't bet)
Seat 3: uzzy20 (button) folded before Flop (didn't bet)
Seat 4: Wwwasian (small blind) folded before Flop
Seat 5: Depti4 (big blind) collected (€0.57)
Seat 6: BaaroRai folded on the Flop





PokerStars Hand #148210358571:  Hold'em No Limit ($0.10/$0.25 USD) - 2016/02/04 11:10:43 CET [2016/02/04 5:10:43 ET]
Table 'Aquarius II' 6-max Seat #1 is the button
Seat 1: Ciudvdvno ($31.90 in chips) 
Seat 2: ex3Lero86 ($35.39 in chips) 
Seat 3: MyBestPokeR ($31.81 in chips) 
Seat 4: RasmusB79 ($14.28 in chips) 
Seat 5: TroyPoker17 ($25 in chips) 
Seat 6: matiko09 ($25 in chips) 
ex3Lero86: posts small blind $0.10
MyBestPokeR: posts big blind $0.25
*** HOLE CARDS ***
Dealt to matiko09 [Jc 4d]
RasmusB79: folds 
TroyPoker17: folds 
matiko09: folds 
Ciudvdvno: raises $0.25 to $0.50
ex3Lero86: folds 
MyBestPokeR: folds 
Uncalled bet ($0.25) returned to Ciudvdvno
Ciudvdvno collected $0.60 from pot
*** SUMMARY ***
Total pot $0.60 | Rake $0 
Seat 1: Ciudvdvno (button) collected ($0.60)
Seat 2: ex3Lero86 (small blind) folded before Flop
Seat 3: MyBestPokeR (big blind) folded before Flop
Seat 4: RasmusB79 folded before Flop (didn't bet)
Seat 5: TroyPoker17 folded before Flop (didn't bet)
Seat 6: matiko09 folded before Flop (didn't bet)





PokerStars Hand #148210365273:  Hold'em No Limit ($0.10/$0.25 USD) - 2016/02/04 11:10:57 CET [2016/02/04 5:10:57 ET]
Table 'Lilliana' 6-max Seat #1 is the button
Seat 1: Emaljo123 ($25.47 in chips) 
Seat 2: mr.djlondon ($34.61 in chips) 
Seat 3: matiko09 ($25 in chips) 
Seat 4: marchuchok ($37.74 in chips) 
Seat 6: raketkasix ($29.17 in chips) 
mr.djlondon: posts small blind $0.10
matiko09: posts big blind $0.25
*** HOLE CARDS ***
Dealt to matiko09 [7c 8c]
marchuchok: raises $0.50 to $0.75
raketkasix: folds 
Emaljo123: folds 
mr.djlondon: calls $0.65
matiko09: calls $0.50
*** FLOP *** [8h 8s 2c]
mr.djlondon: checks 
matiko09: checks 
endeavoor joins the table at seat #5 
marchuchok: checks 
*** TURN *** [8h 8s 2c] [4h]
mr.djlondon: checks 
matiko09: bets $1.40
marchuchok: folds 
mr.djlondon: calls $1.40
*** RIVER *** [8h 8s 2c 4h] [9h]
mr.djlondon: checks 
matiko09: bets $2.75
mr.djlondon: folds 
Uncalled bet ($2.75) returned to matiko09
matiko09 collected $4.82 from pot
matiko09: doesn't show hand 
*** SUMMARY ***
Total pot $5.05 | Rake $0.23 
Board [8h 8s 2c 4h 9h]
Seat 1: Emaljo123 (button) folded before Flop (didn't bet)
Seat 2: mr.djlondon (small blind) folded on the River
Seat 3: matiko09 (big blind) collected ($4.82)
Seat 4: marchuchok folded on the Turn
Seat 6: raketkasix folded before Flop (didn't bet)





PokerStars Hand #148210365625:  Hold'em No Limit ($0.10/$0.25 USD) - 2016/02/04 11:10:58 CET [2016/02/04 5:10:58 ET]
Table 'Werdandi II' 6-max Seat #2 is the button
Seat 1: ChuDiK3 ($25 in chips) 
Seat 2: Kadyrgulov ($48.25 in chips) 
Seat 3: KBF_83 ($12.50 in chips) 
Seat 4: matiko09 ($25 in chips) 
Seat 5: dredysmile ($25 in chips) 
Seat 6: mizzlwizzl ($25 in chips) 
KBF_83: posts small blind $0.10
matiko09: posts big blind $0.25
dredysmile: posts big blind $0.25
*** HOLE CARDS ***
Dealt to matiko09 [9h 3c]
dredysmile: checks 
mizzlwizzl: folds 
mizzlwizzl leaves the table
ChuDiK3: folds 
Kadyrgulov: calls $0.25
KBF_83: folds 
matiko09: checks 
*** FLOP *** [Kd Th Ks]
zhuroff8 joins the table at seat #6 
matiko09: checks 
dredysmile: checks 
Kadyrgulov: checks 
*** TURN *** [Kd Th Ks] [2s]
matiko09: checks 
dredysmile: checks 
Kadyrgulov: checks 
*** RIVER *** [Kd Th Ks 2s] [5c]
matiko09: checks 
dredysmile: checks 
Kadyrgulov: checks 
*** SHOW DOWN ***
matiko09: shows [9h 3c] (a pair of Kings)
dredysmile: shows [Jc 9d] (a pair of Kings - Jack kicker)
Kadyrgulov: shows [6c 6s] (two pair, Kings and Sixes)
Kadyrgulov collected $0.81 from pot
*** SUMMARY ***
Total pot $0.85 | Rake $0.04 
Board [Kd Th Ks 2s 5c]
Seat 1: ChuDiK3 folded before Flop (didn't bet)
Seat 2: Kadyrgulov (button) showed [6c 6s] and won ($0.81) with two pair, Kings and Sixes
Seat 3: KBF_83 (small blind) folded before Flop
Seat 4: matiko09 (big blind) showed [9h 3c] and lost with a pair of Kings
Seat 5: dredysmile showed [Jc 9d] and lost with a pair of Kings
Seat 6: mizzlwizzl folded before Flop (didn't bet)





PokerStars Hand #148210368352:  Hold'em No Limit (€0.10/€0.25 EUR) - 2016/02/04 11:11:03 CET [2016/02/04 5:11:03 ET]
Table 'Lilaea III' 6-max Seat #4 is the button
Seat 1: matiko09 (€27.10 in chips) 
Seat 2: Newbie1990 (€27.63 in chips) 
Seat 3: uzzy20 (€25.45 in chips) 
Seat 4: Wwwasian (€26.05 in chips) 
Seat 5: Depti4 (€29.23 in chips) 
Seat 6: BaaroRai (€28.22 in chips) 
Depti4: posts small blind €0.10
BaaroRai: posts big blind €0.25
*** HOLE CARDS ***
Dealt to matiko09 [Jc Qs]
matiko09: raises €0.50 to €0.75
Newbie1990: folds 
uzzy20: folds 
Wwwasian: calls €0.75
Depti4: calls €0.65
BaaroRai: folds 
*** FLOP *** [Ah Tc 4c]
Depti4: checks 
matiko09: checks 
Wwwasian: checks 
*** TURN *** [Ah Tc 4c] [4s]
Depti4: checks 
matiko09: checks 
Wwwasian: bets €1.79
Depti4: folds 
matiko09: folds 
Uncalled bet (€1.79) returned to Wwwasian
Wwwasian collected €2.39 from pot
Wwwasian: doesn't show hand 
*** SUMMARY ***
Total pot €2.50 | Rake €0.11 
Board [Ah Tc 4c 4s]
Seat 1: matiko09 folded on the Turn
Seat 2: Newbie1990 folded before Flop (didn't bet)
Seat 3: uzzy20 folded before Flop (didn't bet)
Seat 4: Wwwasian (button) collected (€2.39)
Seat 5: Depti4 (small blind) folded on the Turn
Seat 6: BaaroRai (big blind) folded before Flop





PokerStars Hand #148210369695:  Hold'em No Limit ($0.10/$0.25 USD) - 2016/02/04 11:11:06 CET [2016/02/04 5:11:06 ET]
Table 'Aquarius II' 6-max Seat #2 is the button
Seat 1: Ciudvdvno ($32.25 in chips) 
Seat 2: ex3Lero86 ($35.29 in chips) 
Seat 3: MyBestPokeR ($31.56 in chips) 
Seat 4: RasmusB79 ($14.28 in chips) 
Seat 5: TroyPoker17 ($25 in chips) 
Seat 6: matiko09 ($25 in chips) 
MyBestPokeR: posts small blind $0.10
RasmusB79: posts big blind $0.25
*** HOLE CARDS ***
Dealt to matiko09 [6c 6s]
TroyPoker17: folds 
matiko09: raises $0.50 to $0.75
Ciudvdvno: folds 
ex3Lero86: folds 
MyBestPokeR: folds 
RasmusB79: raises $0.50 to $1.25
matiko09: calls $0.50
*** FLOP *** [Ah 9c 5h]
RasmusB79: checks 
matiko09: checks 
*** TURN *** [Ah 9c 5h] [2d]
RasmusB79: bets $1.25
matiko09: folds 
Uncalled bet ($1.25) returned to RasmusB79
RasmusB79 collected $2.48 from pot
*** SUMMARY ***
Total pot $2.60 | Rake $0.12 
Board [Ah 9c 5h 2d]
Seat 1: Ciudvdvno folded before Flop (didn't bet)
Seat 2: ex3Lero86 (button) folded before Flop (didn't bet)
Seat 3: MyBestPokeR (small blind) folded before Flop
Seat 4: RasmusB79 (big blind) collected ($2.48)
Seat 5: TroyPoker17 folded before Flop (didn't bet)
Seat 6: matiko09 folded on the Turn





PokerStars Hand #148210379588:  Hold'em No Limit ($0.10/$0.25 USD) - 2016/02/04 11:11:27 CET [2016/02/04 5:11:27 ET]
Table 'Euphemia II' 6-max Seat #5 is the button
Seat 1: endeavoor ($25 in chips) 
Seat 2: transfed ($10.32 in chips) 
Seat 3: sebodrobil ($2.49 in chips) 
Seat 4: k4rloos ($38.07 in chips) 
Seat 5: DeeXeeD ($25 in chips) 
Seat 6: matiko09 ($25 in chips) 
matiko09: posts small blind $0.10
endeavoor: posts big blind $0.25
*** HOLE CARDS ***
Dealt to matiko09 [Qh 7d]
transfed: folds 
sebodrobil: raises $2.24 to $2.49 and is all-in
k4rloos: folds 
DeeXeeD: folds 
matiko09: folds 
endeavoor: folds 
Uncalled bet ($2.24) returned to sebodrobil
sebodrobil collected $0.60 from pot
*** SUMMARY ***
Total pot $0.60 | Rake $0 
Seat 1: endeavoor (big blind) folded before Flop
Seat 2: transfed folded before Flop (didn't bet)
Seat 3: sebodrobil collected ($0.60)
Seat 4: k4rloos folded before Flop (didn't bet)
Seat 5: DeeXeeD (button) folded before Flop (didn't bet)
Seat 6: matiko09 (small blind) folded before Flop





PokerStars Hand #148210387154:  Hold'em No Limit (€0.10/€0.25 EUR) - 2016/02/04 11:11:42 CET [2016/02/04 5:11:42 ET]
Table 'Zvezdara' 6-max Seat #4 is the button
Seat 1: MaurerXL82 (€14.34 in chips) 
Seat 2: matiko09 (€32.13 in chips) 
Seat 3: Yegoriy (€29.01 in chips) 
Seat 4: kAfRiNiUs (€32 in chips) 
Seat 5: Depti4 (€33.04 in chips) 
Seat 6: marchuchok (€34.85 in chips) 
Depti4: posts small blind €0.10
marchuchok: posts big blind €0.25
*** HOLE CARDS ***
Dealt to matiko09 [3d 2s]
MaurerXL82: calls €0.25
matiko09: folds 
Yegoriy: folds 
kAfRiNiUs: folds 
Depti4: folds 
marchuchok: checks 
*** FLOP *** [8d 4h 7d]
marchuchok: checks 
MaurerXL82: checks 
*** TURN *** [8d 4h 7d] [7s]
marchuchok: checks 
MaurerXL82: bets €0.25
marchuchok: folds 
Uncalled bet (€0.25) returned to MaurerXL82
MaurerXL82 collected €0.57 from pot
MaurerXL82: doesn't show hand 
*** SUMMARY ***
Total pot €0.60 | Rake €0.03 
Board [8d 4h 7d 7s]
Seat 1: MaurerXL82 collected (€0.57)
Seat 2: matiko09 folded before Flop (didn't bet)
Seat 3: Yegoriy folded before Flop (didn't bet)
Seat 4: kAfRiNiUs (button) folded before Flop (didn't bet)
Seat 5: Depti4 (small blind) folded before Flop
Seat 6: marchuchok (big blind) folded on the Turn





PokerStars Hand #148210388137:  Hold'em No Limit ($0.10/$0.25 USD) - 2016/02/04 11:11:44 CET [2016/02/04 5:11:44 ET]
Table 'Euphemia II' 6-max Seat #6 is the button
Seat 1: endeavoor ($25 in chips) 
Seat 2: transfed ($10.32 in chips) 
Seat 3: sebodrobil ($2.84 in chips) 
Seat 4: k4rloos ($38.07 in chips) 
Seat 5: DeeXeeD ($25 in chips) 
Seat 6: matiko09 ($25 in chips) 
endeavoor: posts small blind $0.10
transfed: posts big blind $0.25
*** HOLE CARDS ***
Dealt to matiko09 [6d 4h]
sebodrobil: raises $2.59 to $2.84 and is all-in
k4rloos: folds 
DeeXeeD: folds 
matiko09: folds 
endeavoor: folds 
transfed: folds 
Uncalled bet ($2.59) returned to sebodrobil
sebodrobil collected $0.60 from pot
*** SUMMARY ***
Total pot $0.60 | Rake $0 
Seat 1: endeavoor (small blind) folded before Flop
Seat 2: transfed (big blind) folded before Flop
Seat 3: sebodrobil collected ($0.60)
Seat 4: k4rloos folded before Flop (didn't bet)
Seat 5: DeeXeeD folded before Flop (didn't bet)
Seat 6: matiko09 (button) folded before Flop (didn't bet)





PokerStars Hand #148210389789:  Hold'em No Limit ($0.10/$0.25 USD) - 2016/02/04 11:11:48 CET [2016/02/04 5:11:48 ET]
Table 'Werdandi II' 6-max Seat #3 is the button
Seat 1: ChuDiK3 ($25 in chips) 
Seat 2: Kadyrgulov ($48.81 in chips) 
Seat 3: KBF_83 ($12.50 in chips) 
Seat 4: matiko09 ($25 in chips) 
Seat 5: dredysmile ($25 in chips) 
Seat 6: zhuroff8 ($20 in chips) 
matiko09: posts small blind $0.10
dredysmile: posts big blind $0.25
zhuroff8: posts big blind $0.25
*** HOLE CARDS ***
Dealt to matiko09 [Kh Ah]
zhuroff8: checks 
ChuDiK3: folds 
Kadyrgulov: folds 
Kadyrgulov leaves the table
KBF_83: folds 
kot75757 joins the table at seat #2 
matiko09: raises $1 to $1.25
dredysmile: folds 
zhuroff8: folds 
Uncalled bet ($1) returned to matiko09
matiko09 collected $0.75 from pot
matiko09: doesn't show hand 
*** SUMMARY ***
Total pot $0.75 | Rake $0 
Seat 1: ChuDiK3 folded before Flop (didn't bet)
Seat 2: Kadyrgulov folded before Flop (didn't bet)
Seat 3: KBF_83 (button) folded before Flop (didn't bet)
Seat 4: matiko09 (small blind) collected ($0.75)
Seat 5: dredysmile (big blind) folded before Flop
Seat 6: zhuroff8 folded before Flop





PokerStars Hand #148210395845:  Hold'em No Limit ($0.10/$0.25 USD) - 2016/02/04 11:12:00 CET [2016/02/04 5:12:00 ET]
Table 'Euphemia II' 6-max Seat #1 is the button
Seat 1: endeavoor ($25 in chips) 
Seat 2: transfed ($10.07 in chips) 
Seat 3: sebodrobil ($3.19 in chips) 
Seat 4: k4rloos ($38.07 in chips) 
Seat 5: DeeXeeD ($25 in chips) 
Seat 6: matiko09 ($25 in chips) 
transfed: posts small blind $0.10
sebodrobil: posts big blind $0.25
*** HOLE CARDS ***
Dealt to matiko09 [5c Jh]
k4rloos: folds 
DeeXeeD: folds 
matiko09: folds 
endeavoor: calls $0.25
transfed: calls $0.15
sebodrobil: checks 
*** FLOP *** [5h 4h Ah]
transfed: checks 
sebodrobil: bets $0.50
endeavoor: folds 
transfed: calls $0.50
*** TURN *** [5h 4h Ah] [6c]
transfed: checks 
sebodrobil: bets $0.25
transfed: raises $2.17 to $2.42
sebodrobil: calls $2.17
*** RIVER *** [5h 4h Ah 6c] [Tc]
transfed: checks 
sebodrobil: bets $0.02 and is all-in
transfed: calls $0.02
*** SHOW DOWN ***
sebodrobil: shows [2h 6s] (a pair of Sixes)
transfed: shows [Ac Kh] (a pair of Aces)
transfed collected $6.33 from pot
*** SUMMARY ***
Total pot $6.63 | Rake $0.30 
Board [5h 4h Ah 6c Tc]
Seat 1: endeavoor (button) folded on the Flop
Seat 2: transfed (small blind) showed [Ac Kh] and won ($6.33) with a pair of Aces
Seat 3: sebodrobil (big blind) showed [2h 6s] and lost with a pair of Sixes
Seat 4: k4rloos folded before Flop (didn't bet)
Seat 5: DeeXeeD folded before Flop (didn't bet)
Seat 6: matiko09 folded before Flop (didn't bet)





PokerStars Hand #148210396841:  Hold'em No Limit ($0.10/$0.25 USD) - 2016/02/04 11:12:02 CET [2016/02/04 5:12:02 ET]
Table 'Aquarius II' 6-max Seat #3 is the button
Seat 1: Ciudvdvno ($32.25 in chips) 
Seat 2: ex3Lero86 ($35.29 in chips) 
Seat 3: MyBestPokeR ($31.46 in chips) 
Seat 4: RasmusB79 ($15.51 in chips) 
Seat 5: TroyPoker17 ($25 in chips) 
Seat 6: matiko09 ($25 in chips) 
RasmusB79: posts small blind $0.10
TroyPoker17: posts big blind $0.25
*** HOLE CARDS ***
Dealt to matiko09 [Ad 8s]
matiko09: folds 
Ciudvdvno: folds 
ex3Lero86: folds 
MyBestPokeR: raises $0.37 to $0.62
RasmusB79: raises $0.37 to $0.99
TroyPoker17: folds 
MyBestPokeR: calls $0.37
*** FLOP *** [6s Ah Kd]
RasmusB79: checks 
MyBestPokeR: bets $1.25
RasmusB79: calls $1.25
*** TURN *** [6s Ah Kd] [Kh]
RasmusB79: bets $1
MyBestPokeR: folds 
Uncalled bet ($1) returned to RasmusB79
RasmusB79 collected $4.52 from pot
*** SUMMARY ***
Total pot $4.73 | Rake $0.21 
Board [6s Ah Kd Kh]
Seat 1: Ciudvdvno folded before Flop (didn't bet)
Seat 2: ex3Lero86 folded before Flop (didn't bet)
Seat 3: MyBestPokeR (button) folded on the Turn
Seat 4: RasmusB79 (small blind) collected ($4.52)
Seat 5: TroyPoker17 (big blind) folded before Flop
Seat 6: matiko09 folded before Flop (didn't bet)





PokerStars Hand #148210402719:  Hold'em No Limit ($0.10/$0.25 USD) - 2016/02/04 11:12:15 CET [2016/02/04 5:12:15 ET]
Table 'Werdandi II' 6-max Seat #4 is the button
Seat 1: ChuDiK3 ($25 in chips) 
Seat 3: KBF_83 ($12.50 in chips) 
Seat 4: matiko09 ($25.50 in chips) 
Seat 5: dredysmile ($25 in chips) 
Seat 6: zhuroff8 ($19.75 in chips) 
dredysmile: posts small blind $0.10
zhuroff8: posts big blind $0.25
kot75757: sits out 
*** HOLE CARDS ***
Dealt to matiko09 [5h Kh]
ChuDiK3: folds 
KBF_83: folds 
matiko09: raises $0.37 to $0.62
dredysmile: folds 
zhuroff8: calls $0.37
*** FLOP *** [Qs Kc Jd]
zhuroff8: bets $0.25
matiko09: calls $0.25
*** TURN *** [Qs Kc Jd] [4h]
zhuroff8: bets $0.50
matiko09: calls $0.50
*** RIVER *** [Qs Kc Jd 4h] [4c]
zhuroff8: bets $1
matiko09: calls $1
*** SHOW DOWN ***
zhuroff8: shows [Jc Qh] (two pair, Queens and Jacks)
matiko09: shows [5h Kh] (two pair, Kings and Fours)
matiko09 collected $4.62 from pot
*** SUMMARY ***
Total pot $4.84 | Rake $0.22 
Board [Qs Kc Jd 4h 4c]
Seat 1: ChuDiK3 folded before Flop (didn't bet)
Seat 3: KBF_83 folded before Flop (didn't bet)
Seat 4: matiko09 (button) showed [5h Kh] and won ($4.62) with two pair, Kings and Fours
Seat 5: dredysmile (small blind) folded before Flop
Seat 6: zhuroff8 (big blind) showed [Jc Qh] and lost with two pair, Queens and Jacks





PokerStars Hand #148210404011:  Hold'em No Limit (€0.10/€0.25 EUR) - 2016/02/04 11:12:17 CET [2016/02/04 5:12:17 ET]
Table 'Lilaea III' 6-max Seat #5 is the button
Seat 1: matiko09 (€26.35 in chips) 
Seat 2: Newbie1990 (€27.63 in chips) 
Seat 3: uzzy20 (€25.45 in chips) 
Seat 4: Wwwasian (€27.69 in chips) 
Seat 5: Depti4 (€28.48 in chips) 
Seat 6: BaaroRai (€27.97 in chips) 
BaaroRai: posts small blind €0.10
matiko09: posts big blind €0.25
*** HOLE CARDS ***
Dealt to matiko09 [8d 9h]
Newbie1990: folds 
uzzy20: raises €0.50 to €0.75
Wwwasian: folds 
Depti4: folds 
BaaroRai: folds 
matiko09: folds 
Uncalled bet (€0.50) returned to uzzy20
uzzy20 collected €0.60 from pot
*** SUMMARY ***
Total pot €0.60 | Rake €0 
Seat 1: matiko09 (big blind) folded before Flop
Seat 2: Newbie1990 folded before Flop (didn't bet)
Seat 3: uzzy20 collected (€0.60)
Seat 4: Wwwasian folded before Flop (didn't bet)
Seat 5: Depti4 (button) folded before Flop (didn't bet)
Seat 6: BaaroRai (small blind) folded before Flop





PokerStars Hand #148210411951:  Hold'em No Limit (€0.10/€0.25 EUR) - 2016/02/04 11:12:34 CET [2016/02/04 5:12:34 ET]
Table 'Lilaea III' 6-max Seat #6 is the button
Seat 1: matiko09 (€26.10 in chips) 
Seat 2: Newbie1990 (€27.63 in chips) 
Seat 3: uzzy20 (€25.80 in chips) 
Seat 4: Wwwasian (€27.69 in chips) 
Seat 5: Depti4 (€28.48 in chips) 
Seat 6: BaaroRai (€27.87 in chips) 
matiko09: posts small blind €0.10
Newbie1990: posts big blind €0.25
*** HOLE CARDS ***
Dealt to matiko09 [8d 4s]
uzzy20: folds 
Wwwasian: folds 
Depti4: raises €0.50 to €0.75
BaaroRai: folds 
matiko09: folds 
Newbie1990: folds 
Uncalled bet (€0.50) returned to Depti4
Depti4 collected €0.60 from pot
Depti4: doesn't show hand 
*** SUMMARY ***
Total pot €0.60 | Rake €0 
Seat 1: matiko09 (small blind) folded before Flop
Seat 2: Newbie1990 (big blind) folded before Flop
Seat 3: uzzy20 folded before Flop (didn't bet)
Seat 4: Wwwasian folded before Flop (didn't bet)
Seat 5: Depti4 collected (€0.60)
Seat 6: BaaroRai (button) folded before Flop (didn't bet)





PokerStars Hand #148210412383:  Hold'em No Limit (€0.10/€0.25 EUR) - 2016/02/04 11:12:35 CET [2016/02/04 5:12:35 ET]
Table 'Zvezdara' 6-max Seat #5 is the button
Seat 1: MaurerXL82 (€14.66 in chips) 
Seat 2: matiko09 (€32.13 in chips) 
Seat 3: Yegoriy (€29.01 in chips) 
Seat 4: kAfRiNiUs (€32 in chips) 
Seat 5: Depti4 (€32.94 in chips) 
Seat 6: marchuchok (€34.60 in chips) 
marchuchok: posts small blind €0.10
MaurerXL82: posts big blind €0.25
*** HOLE CARDS ***
Dealt to matiko09 [Qs Jh]
matiko09: raises €0.50 to €0.75
Yegoriy: folds 
kAfRiNiUs: folds 
Depti4: folds 
marchuchok: folds 
MaurerXL82: calls €0.50
*** FLOP *** [Ac 7c 8h]
MaurerXL82: checks 
matiko09: checks 
*** TURN *** [Ac 7c 8h] [7h]
MaurerXL82: checks 
matiko09: checks 
*** RIVER *** [Ac 7c 8h 7h] [8c]
MaurerXL82: checks 
matiko09: checks 
*** SHOW DOWN ***
MaurerXL82: shows [Qh 4d] (two pair, Eights and Sevens)
matiko09: shows [Qs Jh] (two pair, Eights and Sevens)
MaurerXL82 collected €0.77 from pot
matiko09 collected €0.76 from pot
*** SUMMARY ***
Total pot €1.60 | Rake €0.07 
Board [Ac 7c 8h 7h 8c]
Seat 1: MaurerXL82 (big blind) showed [Qh 4d] and won (€0.77) with two pair, Eights and Sevens
Seat 2: matiko09 showed [Qs Jh] and won (€0.76) with two pair, Eights and Sevens
Seat 3: Yegoriy folded before Flop (didn't bet)
Seat 4: kAfRiNiUs folded before Flop (didn't bet)
Seat 5: Depti4 (button) folded before Flop (didn't bet)
Seat 6: marchuchok (small blind) folded before Flop





PokerStars Hand #148210413560:  Hold'em No Limit ($0.10/$0.25 USD) - 2016/02/04 11:12:37 CET [2016/02/04 5:12:37 ET]
Table 'Lilliana' 6-max Seat #2 is the button
Seat 1: Emaljo123 ($25.47 in chips) 
Seat 2: mr.djlondon ($32.46 in chips) 
Seat 3: matiko09 ($27.67 in chips) 
Seat 4: marchuchok ($36.99 in chips) 
Seat 6: raketkasix ($29.17 in chips) 
matiko09: posts small blind $0.10
marchuchok: posts big blind $0.25
endeavoor: sits out 
*** HOLE CARDS ***
Dealt to matiko09 [Tc Qd]
raketkasix: folds 
Emaljo123: raises $0.25 to $0.50
mr.djlondon: folds 
matiko09: folds 
marchuchok: folds 
Uncalled bet ($0.25) returned to Emaljo123
Emaljo123 collected $0.60 from pot
Emaljo123: doesn't show hand 
*** SUMMARY ***
Total pot $0.60 | Rake $0 
Seat 1: Emaljo123 collected ($0.60)
Seat 2: mr.djlondon (button) folded before Flop (didn't bet)
Seat 3: matiko09 (small blind) folded before Flop
Seat 4: marchuchok (big blind) folded before Flop
Seat 6: raketkasix folded before Flop (didn't bet)





PokerStars Hand #148210417113:  Hold'em No Limit ($0.10/$0.25 USD) - 2016/02/04 11:12:44 CET [2016/02/04 5:12:44 ET]
Table 'Euphemia II' 6-max Seat #2 is the button
Seat 1: endeavoor ($25 in chips) 
Seat 2: transfed ($13.21 in chips) 
Seat 4: k4rloos ($38.07 in chips) 
Seat 5: DeeXeeD ($25 in chips) 
Seat 6: matiko09 ($25 in chips) 
k4rloos: posts small blind $0.10
DeeXeeD: posts big blind $0.25
*** HOLE CARDS ***
Dealt to matiko09 [Td 9s]
matiko09: folds 
endeavoor: folds 
transfed: calls $0.25
sebodrobil leaves the table
ex3Lero86 joins the table at seat #3 
k4rloos: folds 
DeeXeeD: checks 
*** FLOP *** [Ac 8c 7c]
DeeXeeD: checks 
transfed: bets $0.25
DeeXeeD: folds 
Uncalled bet ($0.25) returned to transfed
transfed collected $0.57 from pot
transfed: doesn't show hand 
*** SUMMARY ***
Total pot $0.60 | Rake $0.03 
Board [Ac 8c 7c]
Seat 1: endeavoor folded before Flop (didn't bet)
Seat 2: transfed (button) collected ($0.57)
Seat 4: k4rloos (small blind) folded before Flop
Seat 5: DeeXeeD (big blind) folded on the Flop
Seat 6: matiko09 folded before Flop (didn't bet)





PokerStars Hand #148210420907:  Hold'em No Limit ($0.10/$0.25 USD) - 2016/02/04 11:12:52 CET [2016/02/04 5:12:52 ET]
Table 'Werdandi II' 6-max Seat #5 is the button
Seat 1: ChuDiK3 ($25 in chips) 
Seat 3: KBF_83 ($12.50 in chips) 
Seat 4: matiko09 ($27.75 in chips) 
Seat 5: dredysmile ($25 in chips) 
Seat 6: zhuroff8 ($17.38 in chips) 
zhuroff8: posts small blind $0.10
ChuDiK3: posts big blind $0.25
*** HOLE CARDS ***
Dealt to matiko09 [Ac 9d]
KBF_83: folds 
matiko09: folds 
dredysmile: folds 
zhuroff8: folds 
Uncalled bet ($0.15) returned to ChuDiK3
ChuDiK3 collected $0.20 from pot
ChuDiK3: doesn't show hand 
*** SUMMARY ***
Total pot $0.20 | Rake $0 
Seat 1: ChuDiK3 (big blind) collected ($0.20)
Seat 3: KBF_83 folded before Flop (didn't bet)
Seat 4: matiko09 folded before Flop (didn't bet)
Seat 5: dredysmile (button) folded before Flop (didn't bet)
Seat 6: zhuroff8 (small blind) folded before Flop





PokerStars Hand #148210420792:  Hold'em No Limit (€0.10/€0.25 EUR) - 2016/02/04 11:12:52 CET [2016/02/04 5:12:52 ET]
Table 'Lilaea III' 6-max Seat #1 is the button
Seat 1: matiko09 (€26 in chips) 
Seat 2: Newbie1990 (€27.38 in chips) 
Seat 3: uzzy20 (€25.80 in chips) 
Seat 4: Wwwasian (€27.69 in chips) 
Seat 5: Depti4 (€28.83 in chips) 
Seat 6: BaaroRai (€27.87 in chips) 
Newbie1990: posts small blind €0.10
uzzy20: posts big blind €0.25
*** HOLE CARDS ***
Dealt to matiko09 [Kh 3s]
Wwwasian: folds 
Depti4: folds 
BaaroRai: folds 
matiko09: folds 
Newbie1990: folds 
Uncalled bet (€0.15) returned to uzzy20
uzzy20 collected €0.20 from pot
*** SUMMARY ***
Total pot €0.20 | Rake €0 
Seat 1: matiko09 (button) folded before Flop (didn't bet)
Seat 2: Newbie1990 (small blind) folded before Flop
Seat 3: uzzy20 (big blind) collected (€0.20)
Seat 4: Wwwasian folded before Flop (didn't bet)
Seat 5: Depti4 folded before Flop (didn't bet)
Seat 6: BaaroRai folded before Flop (didn't bet)





PokerStars Hand #148210421497:  Hold'em No Limit ($0.10/$0.25 USD) - 2016/02/04 11:12:54 CET [2016/02/04 5:12:54 ET]
Table 'Lilliana' 6-max Seat #3 is the button
Seat 1: Emaljo123 ($25.82 in chips) 
Seat 2: mr.djlondon ($32.46 in chips) 
Seat 3: matiko09 ($27.57 in chips) 
Seat 4: marchuchok ($36.74 in chips) 
Seat 5: endeavoor ($25 in chips) 
Seat 6: raketkasix ($29.17 in chips) 
marchuchok: posts small blind $0.10
endeavoor: posts big blind $0.25
*** HOLE CARDS ***
Dealt to matiko09 [Ts Ks]
raketkasix: raises $0.50 to $0.75
Emaljo123: folds 
mr.djlondon: folds 
matiko09: raises $1.50 to $2.25
marchuchok: folds 
endeavoor: folds 
raketkasix: folds 
Uncalled bet ($1.50) returned to matiko09
matiko09 collected $1.85 from pot
matiko09: doesn't show hand 
*** SUMMARY ***
Total pot $1.85 | Rake $0 
Seat 1: Emaljo123 folded before Flop (didn't bet)
Seat 2: mr.djlondon folded before Flop (didn't bet)
Seat 3: matiko09 (button) collected ($1.85)
Seat 4: marchuchok (small blind) folded before Flop
Seat 5: endeavoor (big blind) folded before Flop
Seat 6: raketkasix folded before Flop





PokerStars Hand #148210429879:  Hold'em No Limit ($0.10/$0.25 USD) - 2016/02/04 11:13:11 CET [2016/02/04 5:13:11 ET]
Table 'Euphemia II' 6-max Seat #4 is the button
Seat 1: endeavoor ($25 in chips) 
Seat 2: transfed ($13.53 in chips) 
Seat 4: k4rloos ($37.97 in chips) 
Seat 5: DeeXeeD ($25 in chips) 
Seat 6: matiko09 ($25 in chips) 
DeeXeeD: posts small blind $0.10
matiko09: posts big blind $0.25
ex3Lero86: sits out 
*** HOLE CARDS ***
Dealt to matiko09 [2s Ac]
endeavoor: folds 
transfed: calls $0.25
k4rloos: raises $0.75 to $1
DeeXeeD: folds 
matiko09: folds 
transfed: calls $0.75
*** FLOP *** [9d 8h Tc]
transfed: checks 
k4rloos: bets $1.70
transfed: raises $1.70 to $3.40
k4rloos: raises $3.85 to $7.25
transfed: raises $3.85 to $11.10
k4rloos: raises $13.13 to $24.23
transfed: calls $1.43 and is all-in
Uncalled bet ($11.70) returned to k4rloos
*** TURN *** [9d 8h Tc] [6s]
*** RIVER *** [9d 8h Tc 6s] [2c]
*** SHOW DOWN ***
transfed: shows [9c 9s] (three of a kind, Nines)
k4rloos: shows [Td Th] (three of a kind, Tens)
k4rloos collected $26.18 from pot
*** SUMMARY ***
Total pot $27.41 | Rake $1.23 
Board [9d 8h Tc 6s 2c]
Seat 1: endeavoor folded before Flop (didn't bet)
Seat 2: transfed showed [9c 9s] and lost with three of a kind, Nines
Seat 4: k4rloos (button) showed [Td Th] and won ($26.18) with three of a kind, Tens
Seat 5: DeeXeeD (small blind) folded before Flop
Seat 6: matiko09 (big blind) folded before Flop





PokerStars Hand #148210433027:  Hold'em No Limit (€0.10/€0.25 EUR) - 2016/02/04 11:13:18 CET [2016/02/04 5:13:18 ET]
Table 'Lilaea III' 6-max Seat #2 is the button
Seat 1: matiko09 (€26 in chips) 
Seat 2: Newbie1990 (€27.28 in chips) 
Seat 3: uzzy20 (€25.90 in chips) 
Seat 4: Wwwasian (€27.69 in chips) 
Seat 5: Depti4 (€28.83 in chips) 
Seat 6: BaaroRai (€27.87 in chips) 
uzzy20: posts small blind €0.10
Wwwasian: posts big blind €0.25
*** HOLE CARDS ***
Dealt to matiko09 [6h 3c]
Depti4: folds 
BaaroRai: calls €0.25
matiko09: folds 
Newbie1990: folds 
uzzy20: folds 
Wwwasian: checks 
*** FLOP *** [4h 7c 6s]
Wwwasian: checks 
BaaroRai: checks 
*** TURN *** [4h 7c 6s] [9c]
Wwwasian: bets €0.75
BaaroRai: calls €0.75
*** RIVER *** [4h 7c 6s 9c] [2c]
Wwwasian: bets €1.50
BaaroRai: calls €1.50
*** SHOW DOWN ***
Wwwasian: shows [5h 3h] (a straight, Three to Seven)
BaaroRai: mucks hand 
Wwwasian collected €4.87 from pot
*** SUMMARY ***
Total pot €5.10 | Rake €0.23 
Board [4h 7c 6s 9c 2c]
Seat 1: matiko09 folded before Flop (didn't bet)
Seat 2: Newbie1990 (button) folded before Flop (didn't bet)
Seat 3: uzzy20 (small blind) folded before Flop
Seat 4: Wwwasian (big blind) showed [5h 3h] and won (€4.87) with a straight, Three to Seven
Seat 5: Depti4 folded before Flop (didn't bet)
Seat 6: BaaroRai mucked [Qd Qs]





PokerStars Hand #148210433593:  Hold'em No Limit ($0.10/$0.25 USD) - 2016/02/04 11:13:19 CET [2016/02/04 5:13:19 ET]
Table 'Aquarius II' 6-max Seat #4 is the button
Seat 1: Ciudvdvno ($32.25 in chips) 
Seat 2: ex3Lero86 ($35.29 in chips) 
Seat 3: MyBestPokeR ($29.22 in chips) 
Seat 4: RasmusB79 ($17.79 in chips) 
Seat 5: TroyPoker17 ($25 in chips) 
Seat 6: matiko09 ($25 in chips) 
TroyPoker17: posts small blind $0.10
matiko09: posts big blind $0.25
*** HOLE CARDS ***
Dealt to matiko09 [8s 4s]
Ciudvdvno: folds 
ex3Lero86: folds 
MyBestPokeR: raises $0.50 to $0.75
RasmusB79: folds 
TroyPoker17: raises $1.50 to $2.25
matiko09: folds 
MyBestPokeR: folds 
Uncalled bet ($1.50) returned to TroyPoker17
TroyPoker17 collected $1.75 from pot
TroyPoker17: doesn't show hand 
*** SUMMARY ***
Total pot $1.75 | Rake $0 
Seat 1: Ciudvdvno folded before Flop (didn't bet)
Seat 2: ex3Lero86 folded before Flop (didn't bet)
Seat 3: MyBestPokeR folded before Flop
Seat 4: RasmusB79 (button) folded before Flop (didn't bet)
Seat 5: TroyPoker17 (small blind) collected ($1.75)
Seat 6: matiko09 (big blind) folded before Flop





PokerStars Hand #148210436919:  Hold'em No Limit (€0.10/€0.25 EUR) - 2016/02/04 11:13:26 CET [2016/02/04 5:13:26 ET]
Table 'Zvezdara' 6-max Seat #6 is the button
Seat 1: MaurerXL82 (€14.68 in chips) 
Seat 2: matiko09 (€32.14 in chips) 
Seat 3: Yegoriy (€29.01 in chips) 
Seat 4: kAfRiNiUs (€32 in chips) 
Seat 5: Depti4 (€32.94 in chips) 
Seat 6: marchuchok (€34.50 in chips) 
MaurerXL82: posts small blind €0.10
matiko09: posts big blind €0.25
*** HOLE CARDS ***
Dealt to matiko09 [6c 3s]
Yegoriy: raises €0.50 to €0.75
kAfRiNiUs: calls €0.75
Depti4: folds 
marchuchok: folds 
MaurerXL82: calls €0.65
matiko09: folds 
*** FLOP *** [3c 9h 7d]
MaurerXL82: bets €1.19
Yegoriy: folds 
kAfRiNiUs: calls €1.19
*** TURN *** [3c 9h 7d] [Qc]
MaurerXL82: bets €2.33
kAfRiNiUs: raises €5.67 to €8
MaurerXL82: folds 
Uncalled bet (€5.67) returned to kAfRiNiUs
kAfRiNiUs collected €9.11 from pot
kAfRiNiUs: doesn't show hand 
*** SUMMARY ***
Total pot €9.54 | Rake €0.43 
Board [3c 9h 7d Qc]
Seat 1: MaurerXL82 (small blind) folded on the Turn
Seat 2: matiko09 (big blind) folded before Flop
Seat 3: Yegoriy folded on the Flop
Seat 4: kAfRiNiUs collected (€9.11)
Seat 5: Depti4 folded before Flop (didn't bet)
Seat 6: marchuchok (button) folded before Flop (didn't bet)





PokerStars Hand #148210445393:  Hold'em No Limit ($0.10/$0.25 USD) - 2016/02/04 11:13:44 CET [2016/02/04 5:13:44 ET]
Table 'Lilliana' 6-max Seat #4 is the button
Seat 1: Emaljo123 ($25.82 in chips) 
Seat 2: mr.djlondon ($32.46 in chips) 
Seat 3: matiko09 ($28.67 in chips) 
Seat 4: marchuchok ($36.64 in chips) 
Seat 5: endeavoor ($25 in chips) 
Seat 6: raketkasix ($28.42 in chips) 
endeavoor: posts small blind $0.10
raketkasix: posts big blind $0.25
*** HOLE CARDS ***
Dealt to matiko09 [2d 2h]
Emaljo123: folds 
mr.djlondon: folds 
matiko09: raises $0.50 to $0.75
marchuchok: raises $1.50 to $2.25
endeavoor: folds 
raketkasix: folds 
matiko09: folds 
Uncalled bet ($1.50) returned to marchuchok
marchuchok collected $1.85 from pot
marchuchok: doesn't show hand 
*** SUMMARY ***
Total pot $1.85 | Rake $0 
Seat 1: Emaljo123 folded before Flop (didn't bet)
Seat 2: mr.djlondon folded before Flop (didn't bet)
Seat 3: matiko09 folded before Flop
Seat 4: marchuchok (button) collected ($1.85)
Seat 5: endeavoor (small blind) folded before Flop
Seat 6: raketkasix (big blind) folded before Flop





PokerStars Hand #148210450842:  Hold'em No Limit ($0.10/$0.25 USD) - 2016/02/04 11:13:55 CET [2016/02/04 5:13:55 ET]
Table 'Aquarius II' 6-max Seat #5 is the button
Seat 1: Ciudvdvno ($32.25 in chips) 
Seat 2: ex3Lero86 ($35.29 in chips) 
Seat 3: MyBestPokeR ($28.47 in chips) 
Seat 4: RasmusB79 ($17.79 in chips) 
Seat 5: TroyPoker17 ($26 in chips) 
Seat 6: matiko09 ($25 in chips) 
matiko09: posts small blind $0.10
Ciudvdvno: posts big blind $0.25
*** HOLE CARDS ***
Dealt to matiko09 [5c 3c]
ex3Lero86: folds 
MyBestPokeR: raises $0.50 to $0.75
RasmusB79: folds 
TroyPoker17: folds 
matiko09: folds 
Ciudvdvno: folds 
Uncalled bet ($0.50) returned to MyBestPokeR
MyBestPokeR collected $0.60 from pot
*** SUMMARY ***
Total pot $0.60 | Rake $0 
Seat 1: Ciudvdvno (big blind) folded before Flop
Seat 2: ex3Lero86 folded before Flop (didn't bet)
Seat 3: MyBestPokeR collected ($0.60)
Seat 4: RasmusB79 folded before Flop (didn't bet)
Seat 5: TroyPoker17 (button) folded before Flop (didn't bet)
Seat 6: matiko09 (small blind) folded before Flop





PokerStars Hand #148210454399:  Hold'em No Limit ($0.10/$0.25 USD) - 2016/02/04 11:14:02 CET [2016/02/04 5:14:02 ET]
Table 'Euphemia II' 6-max Seat #5 is the button
Seat 1: endeavoor ($25 in chips) 
Seat 4: k4rloos ($50.62 in chips) 
Seat 5: DeeXeeD ($25 in chips) 
Seat 6: matiko09 ($25 in chips) 
matiko09: posts small blind $0.10
endeavoor: posts big blind $0.25
ex3Lero86: sits out 
*** HOLE CARDS ***
Dealt to matiko09 [Th 7c]
k4rloos: folds 
DeeXeeD: raises $0.25 to $0.50
transfed leaves the table
matiko09: folds 
endeavoor: folds 
Uncalled bet ($0.25) returned to DeeXeeD
DeeXeeD collected $0.60 from pot
DeeXeeD: doesn't show hand 
*** SUMMARY ***
Total pot $0.60 | Rake $0 
Seat 1: endeavoor (big blind) folded before Flop
Seat 4: k4rloos folded before Flop (didn't bet)
Seat 5: DeeXeeD (button) collected ($0.60)
Seat 6: matiko09 (small blind) folded before Flop





PokerStars Hand #148210455968:  Hold'em No Limit (€0.10/€0.25 EUR) - 2016/02/04 11:14:06 CET [2016/02/04 5:14:06 ET]
Table 'Lilaea III' 6-max Seat #3 is the button
Seat 1: matiko09 (€26 in chips) 
Seat 2: Newbie1990 (€27.28 in chips) 
Seat 3: uzzy20 (€25.80 in chips) 
Seat 4: Wwwasian (€30.06 in chips) 
Seat 5: Depti4 (€28.83 in chips) 
Seat 6: BaaroRai (€25.37 in chips) 
Wwwasian: posts small blind €0.10
Depti4: posts big blind €0.25
*** HOLE CARDS ***
Dealt to matiko09 [Jc 5h]
BaaroRai: calls €0.25
matiko09: folds 
Newbie1990: calls €0.25
uzzy20: folds 
Wwwasian: folds 
Depti4: checks 
*** FLOP *** [8c Ad Kh]
Depti4: checks 
BaaroRai: checks 
Newbie1990: checks 
*** TURN *** [8c Ad Kh] [2d]
Depti4: checks 
BaaroRai: checks 
Newbie1990: bets €1
Depti4: folds 
BaaroRai: calls €1
*** RIVER *** [8c Ad Kh 2d] [9h]
BaaroRai: bets €0.25
Newbie1990: raises €2.25 to €2.50
BaaroRai: folds 
Uncalled bet (€2.25) returned to Newbie1990
Newbie1990 collected €3.20 from pot
Newbie1990: doesn't show hand 
*** SUMMARY ***
Total pot €3.35 | Rake €0.15 
Board [8c Ad Kh 2d 9h]
Seat 1: matiko09 folded before Flop (didn't bet)
Seat 2: Newbie1990 collected (€3.20)
Seat 3: uzzy20 (button) folded before Flop (didn't bet)
Seat 4: Wwwasian (small blind) folded before Flop
Seat 5: Depti4 (big blind) folded on the Turn
Seat 6: BaaroRai folded on the River





PokerStars Hand #148210465367:  Hold'em No Limit (€0.10/€0.25 EUR) - 2016/02/04 11:14:25 CET [2016/02/04 5:14:25 ET]
Table 'Zvezdara' 6-max Seat #1 is the button
Seat 1: MaurerXL82 (€10.41 in chips) 
Seat 2: matiko09 (€31.89 in chips) 
Seat 3: Yegoriy (€28.26 in chips) 
Seat 4: kAfRiNiUs (€36.84 in chips) 
Seat 5: Depti4 (€32.94 in chips) 
Seat 6: marchuchok (€34.50 in chips) 
matiko09: posts small blind €0.10
Yegoriy: posts big blind €0.25
*** HOLE CARDS ***
Dealt to matiko09 [Qc 7d]
kAfRiNiUs: folds 
Depti4: folds 
marchuchok: folds 
MaurerXL82: folds 
matiko09: folds 
Uncalled bet (€0.15) returned to Yegoriy
Yegoriy collected €0.20 from pot
Yegoriy: doesn't show hand 
*** SUMMARY ***
Total pot €0.20 | Rake €0 
Seat 1: MaurerXL82 (button) folded before Flop (didn't bet)
Seat 2: matiko09 (small blind) folded before Flop
Seat 3: Yegoriy (big blind) collected (€0.20)
Seat 4: kAfRiNiUs folded before Flop (didn't bet)
Seat 5: Depti4 folded before Flop (didn't bet)
Seat 6: marchuchok folded before Flop (didn't bet)





PokerStars Hand #148210465897:  Hold'em No Limit ($0.10/$0.25 USD) - 2016/02/04 11:14:26 CET [2016/02/04 5:14:26 ET]
Table 'Euphemia II' 6-max Seat #6 is the button
Seat 1: endeavoor ($25 in chips) 
Seat 3: ex3Lero86 ($25 in chips) 
Seat 4: k4rloos ($50.62 in chips) 
Seat 5: DeeXeeD ($25.35 in chips) 
Seat 6: matiko09 ($25 in chips) 
endeavoor: posts small blind $0.10
ex3Lero86: posts big blind $0.25
*** HOLE CARDS ***
Dealt to matiko09 [2s 7s]
k4rloos: folds 
DeeXeeD: folds 
PotgrabberAA joins the table at seat #2 
PotgrabberAA leaves the table
matiko09: folds 
AlexKalugin joins the table at seat #2 
endeavoor: raises $0.50 to $0.75
ex3Lero86: raises $1.50 to $2.25
endeavoor: folds 
Uncalled bet ($1.50) returned to ex3Lero86
ex3Lero86 collected $1.50 from pot
ex3Lero86: doesn't show hand 
*** SUMMARY ***
Total pot $1.50 | Rake $0 
Seat 1: endeavoor (small blind) folded before Flop
Seat 3: ex3Lero86 (big blind) collected ($1.50)
Seat 4: k4rloos folded before Flop (didn't bet)
Seat 5: DeeXeeD folded before Flop (didn't bet)
Seat 6: matiko09 (button) folded before Flop (didn't bet)





PokerStars Hand #148210467053:  Hold'em No Limit ($0.10/$0.25 USD) - 2016/02/04 11:14:29 CET [2016/02/04 5:14:29 ET]
Table 'Aquarius II' 6-max Seat #6 is the button
Seat 1: Ciudvdvno ($32 in chips) 
Seat 2: ex3Lero86 ($35.29 in chips) 
Seat 3: MyBestPokeR ($28.82 in chips) 
Seat 4: RasmusB79 ($17.79 in chips) 
Seat 5: TroyPoker17 ($26 in chips) 
Seat 6: matiko09 ($25 in chips) 
Ciudvdvno: posts small blind $0.10
ex3Lero86: posts big blind $0.25
*** HOLE CARDS ***
Dealt to matiko09 [6d Jc]
MyBestPokeR: folds 
RasmusB79: raises $0.25 to $0.50
TroyPoker17: folds 
matiko09: folds 
Ciudvdvno: folds 
ex3Lero86: calls $0.25
*** FLOP *** [Th Tc 2d]
ex3Lero86: checks 
RasmusB79: checks 
*** TURN *** [Th Tc 2d] [6s]
ex3Lero86: checks 
RasmusB79: bets $0.75
ex3Lero86: folds 
Uncalled bet ($0.75) returned to RasmusB79
RasmusB79 collected $1.05 from pot
*** SUMMARY ***
Total pot $1.10 | Rake $0.05 
Board [Th Tc 2d 6s]
Seat 1: Ciudvdvno (small blind) folded before Flop
Seat 2: ex3Lero86 (big blind) folded on the Turn
Seat 3: MyBestPokeR folded before Flop (didn't bet)
Seat 4: RasmusB79 collected ($1.05)
Seat 5: TroyPoker17 folded before Flop (didn't bet)
Seat 6: matiko09 (button) folded before Flop (didn't bet)





PokerStars Hand #148210470864:  Hold'em No Limit ($0.10/$0.25 USD) - 2016/02/04 11:14:37 CET [2016/02/04 5:14:37 ET]
Table 'Lilliana' 6-max Seat #5 is the button
Seat 1: Emaljo123 ($25.82 in chips) 
Seat 2: mr.djlondon ($32.46 in chips) 
Seat 3: matiko09 ($27.92 in chips) 
Seat 4: marchuchok ($37.74 in chips) 
Seat 5: endeavoor ($25 in chips) 
Seat 6: raketkasix ($28.17 in chips) 
raketkasix: posts small blind $0.10
Emaljo123: posts big blind $0.25
*** HOLE CARDS ***
Dealt to matiko09 [9h 9c]
mr.djlondon: raises $0.50 to $0.75
matiko09: calls $0.75
marchuchok: folds 
endeavoor: folds 
raketkasix: folds 
Emaljo123: calls $0.50
*** FLOP *** [8h 2d 9d]
Emaljo123: checks 
mr.djlondon: checks 
matiko09: bets $1.46
Emaljo123: raises $1.46 to $2.92
mr.djlondon: folds 
matiko09: raises $3.83 to $6.75
Emaljo123: raises $3.83 to $10.58
matiko09: raises $16.59 to $27.17 and is all-in
Emaljo123: calls $14.49 and is all-in
Uncalled bet ($2.10) returned to matiko09
*** TURN *** [8h 2d 9d] [9s]
*** RIVER *** [8h 2d 9d 9s] [4h]
*** SHOW DOWN ***
Emaljo123: shows [Kh Kc] (two pair, Kings and Nines)
matiko09: shows [9h 9c] (four of a kind, Nines)
matiko09 collected $50.49 from pot
*** SUMMARY ***
Total pot $52.49 | Rake $2 
Board [8h 2d 9d 9s 4h]
Seat 1: Emaljo123 (big blind) showed [Kh Kc] and lost with two pair, Kings and Nines
Seat 2: mr.djlondon folded on the Flop
Seat 3: matiko09 showed [9h 9c] and won ($50.49) with four of a kind, Nines
Seat 4: marchuchok folded before Flop (didn't bet)
Seat 5: endeavoor (button) folded before Flop (didn't bet)
Seat 6: raketkasix (small blind) folded before Flop





PokerStars Hand #148210476055:  Hold'em No Limit (€0.10/€0.25 EUR) - 2016/02/04 11:14:48 CET [2016/02/04 5:14:48 ET]
Table 'Zvezdara' 6-max Seat #2 is the button
Seat 1: MaurerXL82 (€10.41 in chips) 
Seat 2: matiko09 (€31.79 in chips) 
Seat 3: Yegoriy (€28.36 in chips) 
Seat 4: kAfRiNiUs (€36.84 in chips) 
Seat 5: Depti4 (€32.94 in chips) 
Seat 6: marchuchok (€34.50 in chips) 
Yegoriy: posts small blind €0.10
kAfRiNiUs: posts big blind €0.25
*** HOLE CARDS ***
Dealt to matiko09 [4c 7c]
Depti4: raises €0.50 to €0.75
marchuchok: folds 
MaurerXL82: folds 
matiko09: folds 
Yegoriy: folds 
kAfRiNiUs: calls €0.50
*** FLOP *** [9d 8c Tc]
kAfRiNiUs: checks 
Depti4: bets €1.01
kAfRiNiUs: folds 
Uncalled bet (€1.01) returned to Depti4
Depti4 collected €1.53 from pot
Depti4: doesn't show hand 
*** SUMMARY ***
Total pot €1.60 | Rake €0.07 
Board [9d 8c Tc]
Seat 1: MaurerXL82 folded before Flop (didn't bet)
Seat 2: matiko09 (button) folded before Flop (didn't bet)
Seat 3: Yegoriy (small blind) folded before Flop
Seat 4: kAfRiNiUs (big blind) folded on the Flop
Seat 5: Depti4 collected (€1.53)
Seat 6: marchuchok folded before Flop (didn't bet)





PokerStars Hand #148210479080:  Hold'em No Limit (€0.10/€0.25 EUR) - 2016/02/04 11:14:54 CET [2016/02/04 5:14:54 ET]
Table 'Lilaea III' 6-max Seat #4 is the button
Seat 1: matiko09 (€26 in chips) 
Seat 2: Newbie1990 (€28.98 in chips) 
Seat 3: uzzy20 (€25.80 in chips) 
Seat 4: Wwwasian (€29.96 in chips) 
Seat 5: Depti4 (€28.58 in chips) 
Seat 6: BaaroRai (€23.87 in chips) 
Depti4: posts small blind €0.10
BaaroRai: posts big blind €0.25
*** HOLE CARDS ***
Dealt to matiko09 [Qs 6s]
matiko09: folds 
Newbie1990: folds 
uzzy20: folds 
Wwwasian: folds 
Depti4: folds 
Uncalled bet (€0.15) returned to BaaroRai
BaaroRai collected €0.20 from pot
*** SUMMARY ***
Total pot €0.20 | Rake €0 
Seat 1: matiko09 folded before Flop (didn't bet)
Seat 2: Newbie1990 folded before Flop (didn't bet)
Seat 3: uzzy20 folded before Flop (didn't bet)
Seat 4: Wwwasian (button) folded before Flop (didn't bet)
Seat 5: Depti4 (small blind) folded before Flop
Seat 6: BaaroRai (big blind) collected (€0.20)





PokerStars Hand #148210485845:  Hold'em No Limit ($0.10/$0.25 USD) - 2016/02/04 11:15:08 CET [2016/02/04 5:15:08 ET]
Table 'Aquarius II' 6-max Seat #1 is the button
Seat 1: Ciudvdvno ($31.90 in chips) 
Seat 2: ex3Lero86 ($34.79 in chips) 
Seat 3: MyBestPokeR ($28.82 in chips) 
Seat 4: RasmusB79 ($18.34 in chips) 
Seat 5: TroyPoker17 ($26 in chips) 
Seat 6: matiko09 ($25 in chips) 
ex3Lero86: posts small blind $0.10
MyBestPokeR: posts big blind $0.25
*** HOLE CARDS ***
Dealt to matiko09 [4h Ah]
RasmusB79: raises $0.25 to $0.50
TroyPoker17: folds 
matiko09: folds 
Ciudvdvno: folds 
ex3Lero86: folds 
MyBestPokeR: raises $1.50 to $2
RasmusB79: calls $1.50
*** FLOP *** [5d Ks 5h]
MyBestPokeR: bets $2.75
RasmusB79: folds 
Uncalled bet ($2.75) returned to MyBestPokeR
MyBestPokeR collected $3.92 from pot
*** SUMMARY ***
Total pot $4.10 | Rake $0.18 
Board [5d Ks 5h]
Seat 1: Ciudvdvno (button) folded before Flop (didn't bet)
Seat 2: ex3Lero86 (small blind) folded before Flop
Seat 3: MyBestPokeR (big blind) collected ($3.92)
Seat 4: RasmusB79 folded on the Flop
Seat 5: TroyPoker17 folded before Flop (didn't bet)
Seat 6: matiko09 folded before Flop (didn't bet)





PokerStars Hand #148210488529:  Hold'em No Limit ($0.10/$0.25 USD) - 2016/02/04 11:15:14 CET [2016/02/04 5:15:14 ET]
Table 'Euphemia II' 6-max Seat #1 is the button
Seat 1: endeavoor ($25 in chips) 
Seat 3: ex3Lero86 ($25.75 in chips) 
Seat 4: k4rloos ($50.62 in chips) 
Seat 5: DeeXeeD ($25.35 in chips) 
Seat 6: matiko09 ($25 in chips) 
AlexKalugin will be allowed to play after the button
ex3Lero86: posts small blind $0.10
k4rloos: posts big blind $0.25
*** HOLE CARDS ***
Dealt to matiko09 [6h 8c]
DeeXeeD: folds 
matiko09: folds 
endeavoor: raises $0.25 to $0.50
ex3Lero86: folds 
k4rloos: folds 
Uncalled bet ($0.25) returned to endeavoor
endeavoor collected $0.60 from pot
endeavoor: doesn't show hand 
*** SUMMARY ***
Total pot $0.60 | Rake $0 
Seat 1: endeavoor (button) collected ($0.60)
Seat 3: ex3Lero86 (small blind) folded before Flop
Seat 4: k4rloos (big blind) folded before Flop
Seat 5: DeeXeeD folded before Flop (didn't bet)
Seat 6: matiko09 folded before Flop (didn't bet)





PokerStars Hand #148210490629:  Hold'em No Limit (€0.10/€0.25 EUR) - 2016/02/04 11:15:18 CET [2016/02/04 5:15:18 ET]
Table 'Lilaea III' 6-max Seat #5 is the button
Seat 1: matiko09 (€26 in chips) 
Seat 2: Newbie1990 (€28.98 in chips) 
Seat 3: uzzy20 (€25.80 in chips) 
Seat 4: Wwwasian (€29.96 in chips) 
Seat 5: Depti4 (€28.48 in chips) 
Seat 6: BaaroRai (€23.97 in chips) 
BaaroRai: posts small blind €0.10
matiko09: posts big blind €0.25
*** HOLE CARDS ***
Dealt to matiko09 [7c 6s]
Newbie1990: raises €0.60 to €0.85
uzzy20: folds 
Wwwasian: folds 
Depti4: folds 
BaaroRai: folds 
matiko09: folds 
Uncalled bet (€0.60) returned to Newbie1990
Newbie1990 collected €0.60 from pot
Newbie1990: doesn't show hand 
*** SUMMARY ***
Total pot €0.60 | Rake €0 
Seat 1: matiko09 (big blind) folded before Flop
Seat 2: Newbie1990 collected (€0.60)
Seat 3: uzzy20 folded before Flop (didn't bet)
Seat 4: Wwwasian folded before Flop (didn't bet)
Seat 5: Depti4 (button) folded before Flop (didn't bet)
Seat 6: BaaroRai (small blind) folded before Flop





PokerStars Hand #148210497204:  Hold'em No Limit (€0.10/€0.25 EUR) - 2016/02/04 11:15:31 CET [2016/02/04 5:15:31 ET]
Table 'Zvezdara' 6-max Seat #3 is the button
Seat 1: MaurerXL82 (€10.41 in chips) 
Seat 2: matiko09 (€31.79 in chips) 
Seat 3: Yegoriy (€28.26 in chips) 
Seat 4: kAfRiNiUs (€36.09 in chips) 
Seat 5: Depti4 (€33.72 in chips) 
Seat 6: marchuchok (€34.50 in chips) 
kAfRiNiUs: posts small blind €0.10
Depti4: posts big blind €0.25
*** HOLE CARDS ***
Dealt to matiko09 [3s Kh]
marchuchok: folds 
MaurerXL82: calls €0.25
matiko09: folds 
Yegoriy: folds 
kAfRiNiUs: folds 
Depti4: checks 
*** FLOP *** [As 4s 8s]
Depti4: bets €0.50
MaurerXL82: calls €0.50
*** TURN *** [As 4s 8s] [Qh]
Depti4: bets €1.50
MaurerXL82: calls €1.50
*** RIVER *** [As 4s 8s Qh] [8c]
Depti4: bets €4
MaurerXL82: calls €4
*** SHOW DOWN ***
Depti4: shows [Ks 2s] (a flush, Ace high)
MaurerXL82: mucks hand 
Depti4 collected €12.03 from pot
*** SUMMARY ***
Total pot €12.60 | Rake €0.57 
Board [As 4s 8s Qh 8c]
Seat 1: MaurerXL82 mucked [2c Ad]
Seat 2: matiko09 folded before Flop (didn't bet)
Seat 3: Yegoriy (button) folded before Flop (didn't bet)
Seat 4: kAfRiNiUs (small blind) folded before Flop
Seat 5: Depti4 (big blind) showed [Ks 2s] and won (€12.03) with a flush, Ace high
Seat 6: marchuchok folded before Flop (didn't bet)





PokerStars Hand #148210499524:  Hold'em No Limit ($0.10/$0.25 USD) - 2016/02/04 11:15:36 CET [2016/02/04 5:15:36 ET]
Table 'Euphemia II' 6-max Seat #3 is the button
Seat 1: endeavoor ($25.35 in chips) 
Seat 3: ex3Lero86 ($25.65 in chips) 
Seat 4: k4rloos ($50.37 in chips) 
Seat 5: DeeXeeD ($25.35 in chips) 
Seat 6: matiko09 ($25 in chips) 
k4rloos: posts small blind $0.10
DeeXeeD: posts big blind $0.25
AlexKalugin: sits out 
*** HOLE CARDS ***
Dealt to matiko09 [Ts 5c]
matiko09: folds 
endeavoor: folds 
ex3Lero86: raises $0.32 to $0.57
k4rloos: folds 
DeeXeeD: folds 
Uncalled bet ($0.32) returned to ex3Lero86
ex3Lero86 collected $0.60 from pot
ex3Lero86: doesn't show hand 
*** SUMMARY ***
Total pot $0.60 | Rake $0 
Seat 1: endeavoor folded before Flop (didn't bet)
Seat 3: ex3Lero86 (button) collected ($0.60)
Seat 4: k4rloos (small blind) folded before Flop
Seat 5: DeeXeeD (big blind) folded before Flop
Seat 6: matiko09 folded before Flop (didn't bet)





PokerStars Hand #148210503038:  Hold'em No Limit (€0.10/€0.25 EUR) - 2016/02/04 11:15:43 CET [2016/02/04 5:15:43 ET]
Table 'Lilaea III' 6-max Seat #6 is the button
Seat 1: matiko09 (€25.75 in chips) 
Seat 2: Newbie1990 (€29.33 in chips) 
Seat 3: uzzy20 (€25.80 in chips) 
Seat 4: Wwwasian (€29.96 in chips) 
Seat 5: Depti4 (€28.48 in chips) 
Seat 6: BaaroRai (€23.87 in chips) 
matiko09: posts small blind €0.10
Newbie1990: posts big blind €0.25
*** HOLE CARDS ***
Dealt to matiko09 [3s 5s]
uzzy20: folds 
Wwwasian: folds 
Depti4: folds 
BaaroRai: calls €0.25
matiko09: folds 
Newbie1990: checks 
*** FLOP *** [Qh 9h Th]
Newbie1990: checks 
BaaroRai: checks 
*** TURN *** [Qh 9h Th] [Jc]
Newbie1990: checks 
BaaroRai: checks 
*** RIVER *** [Qh 9h Th Jc] [8s]
Newbie1990: checks 
BaaroRai: bets €0.25
Newbie1990: folds 
Uncalled bet (€0.25) returned to BaaroRai
BaaroRai collected €0.57 from pot
BaaroRai: doesn't show hand 
*** SUMMARY ***
Total pot €0.60 | Rake €0.03 
Board [Qh 9h Th Jc 8s]
Seat 1: matiko09 (small blind) folded before Flop
Seat 2: Newbie1990 (big blind) folded on the River
Seat 3: uzzy20 folded before Flop (didn't bet)
Seat 4: Wwwasian folded before Flop (didn't bet)
Seat 5: Depti4 folded before Flop (didn't bet)
Seat 6: BaaroRai (button) collected (€0.57)





PokerStars Hand #148210503813:  Hold'em No Limit ($0.10/$0.25 USD) - 2016/02/04 11:15:45 CET [2016/02/04 5:15:45 ET]
Table 'Aquarius II' 6-max Seat #2 is the button
Seat 1: Ciudvdvno ($31.90 in chips) 
Seat 2: ex3Lero86 ($34.69 in chips) 
Seat 3: MyBestPokeR ($30.74 in chips) 
Seat 4: RasmusB79 ($16.34 in chips) 
Seat 5: TroyPoker17 ($26 in chips) 
Seat 6: matiko09 ($25 in chips) 
MyBestPokeR: posts small blind $0.10
RasmusB79: posts big blind $0.25
*** HOLE CARDS ***
Dealt to matiko09 [As Ac]
TroyPoker17: folds 
matiko09: raises $0.50 to $0.75
Ciudvdvno: folds 
ex3Lero86: folds 
MyBestPokeR: folds 
RasmusB79: folds 
Uncalled bet ($0.50) returned to matiko09
matiko09 collected $0.60 from pot
matiko09: doesn't show hand 
*** SUMMARY ***
Total pot $0.60 | Rake $0 
Seat 1: Ciudvdvno folded before Flop (didn't bet)
Seat 2: ex3Lero86 (button) folded before Flop (didn't bet)
Seat 3: MyBestPokeR (small blind) folded before Flop
Seat 4: RasmusB79 (big blind) folded before Flop
Seat 5: TroyPoker17 folded before Flop (didn't bet)
Seat 6: matiko09 collected ($0.60)





PokerStars Hand #148210506732:  Hold'em No Limit ($0.10/$0.25 USD) - 2016/02/04 11:15:51 CET [2016/02/04 5:15:51 ET]
Table 'Lilliana' 6-max Seat #6 is the button
Seat 2: mr.djlondon ($31.71 in chips) 
Seat 3: matiko09 ($52.59 in chips) 
Seat 4: marchuchok ($37.74 in chips) 
Seat 5: endeavoor ($25 in chips) 
Seat 6: raketkasix ($28.07 in chips) 
mr.djlondon: posts small blind $0.10
matiko09: posts big blind $0.25
*** HOLE CARDS ***
Dealt to matiko09 [7c 4s]
marchuchok: folds 
endeavoor: raises $0.35 to $0.60
Emaljo123 leaves the table
raketkasix: folds 
PotgrabberAA joins the table at seat #1 
mr.djlondon: folds 
matiko09: folds 
Uncalled bet ($0.35) returned to endeavoor
endeavoor collected $0.60 from pot
endeavoor: doesn't show hand 
*** SUMMARY ***
Total pot $0.60 | Rake $0 
Seat 2: mr.djlondon (small blind) folded before Flop
Seat 3: matiko09 (big blind) folded before Flop
Seat 4: marchuchok folded before Flop (didn't bet)
Seat 5: endeavoor collected ($0.60)
Seat 6: raketkasix (button) folded before Flop (didn't bet)





PokerStars Hand #148210514188:  Hold'em No Limit ($0.10/$0.25 USD) - 2016/02/04 11:16:06 CET [2016/02/04 5:16:06 ET]
Table 'Aquarius II' 6-max Seat #3 is the button
Seat 1: Ciudvdvno ($31.90 in chips) 
Seat 2: ex3Lero86 ($34.69 in chips) 
Seat 3: MyBestPokeR ($30.64 in chips) 
Seat 4: RasmusB79 ($16.09 in chips) 
Seat 5: TroyPoker17 ($26 in chips) 
Seat 6: matiko09 ($25.35 in chips) 
RasmusB79: posts small blind $0.10
TroyPoker17: posts big blind $0.25
*** HOLE CARDS ***
Dealt to matiko09 [2h 8s]
matiko09: folds 
Ciudvdvno: raises $0.50 to $0.75
ex3Lero86: folds 
MyBestPokeR: folds 
RasmusB79: folds 
TroyPoker17: folds 
Uncalled bet ($0.50) returned to Ciudvdvno
Ciudvdvno collected $0.60 from pot
*** SUMMARY ***
Total pot $0.60 | Rake $0 
Seat 1: Ciudvdvno collected ($0.60)
Seat 2: ex3Lero86 folded before Flop (didn't bet)
Seat 3: MyBestPokeR (button) folded before Flop (didn't bet)
Seat 4: RasmusB79 (small blind) folded before Flop
Seat 5: TroyPoker17 (big blind) folded before Flop
Seat 6: matiko09 folded before Flop (didn't bet)





PokerStars Hand #148210515414:  Hold'em No Limit (€0.10/€0.25 EUR) - 2016/02/04 11:16:09 CET [2016/02/04 5:16:09 ET]
Table 'Zvezdara' 6-max Seat #4 is the button
Seat 1: MaurerXL82 (€4.16 in chips) 
Seat 2: matiko09 (€31.79 in chips) 
Seat 3: Yegoriy (€28.26 in chips) 
Seat 4: kAfRiNiUs (€35.99 in chips) 
Seat 5: Depti4 (€39.50 in chips) 
Seat 6: marchuchok (€34.50 in chips) 
Depti4: posts small blind €0.10
marchuchok: posts big blind €0.25
*** HOLE CARDS ***
Dealt to matiko09 [2s 5d]
MaurerXL82: calls €0.25
matiko09: folds 
Yegoriy: folds 
kAfRiNiUs: folds 
Depti4: folds 
marchuchok: checks 
*** FLOP *** [Tc Qd 7h]
marchuchok: checks 
MaurerXL82: checks 
*** TURN *** [Tc Qd 7h] [Ac]
marchuchok: checks 
MaurerXL82: checks 
*** RIVER *** [Tc Qd 7h Ac] [8s]
marchuchok: checks 
MaurerXL82: checks 
*** SHOW DOWN ***
marchuchok: shows [Kd 4c] (high card Ace)
MaurerXL82: mucks hand 
marchuchok collected €0.57 from pot
*** SUMMARY ***
Total pot €0.60 | Rake €0.03 
Board [Tc Qd 7h Ac 8s]
Seat 1: MaurerXL82 mucked [6s 4d]
Seat 2: matiko09 folded before Flop (didn't bet)
Seat 3: Yegoriy folded before Flop (didn't bet)
Seat 4: kAfRiNiUs (button) folded before Flop (didn't bet)
Seat 5: Depti4 (small blind) folded before Flop
Seat 6: marchuchok (big blind) showed [Kd 4c] and won (€0.57) with high card Ace





PokerStars Hand #148210515709:  Hold'em No Limit ($0.10/$0.25 USD) - 2016/02/04 11:16:09 CET [2016/02/04 5:16:09 ET]
Table 'Euphemia II' 6-max Seat #4 is the button
Seat 1: endeavoor ($25.35 in chips) 
Seat 3: ex3Lero86 ($26 in chips) 
Seat 4: k4rloos ($50.27 in chips) 
Seat 5: DeeXeeD ($25.10 in chips) 
Seat 6: matiko09 ($25 in chips) 
DeeXeeD: posts small blind $0.10
matiko09: posts big blind $0.25
AlexKalugin: sits out 
*** HOLE CARDS ***
Dealt to matiko09 [2h 2c]
endeavoor: folds 
endeavoor leaves the table
ex3Lero86: raises $0.37 to $0.62
k4rloos: folds 
DeeXeeD: raises $1.48 to $2.10
matiko09: folds 
ex3Lero86: calls $1.48
*** FLOP *** [Jd 5h Kd]
DeeXeeD: checks 
ex3Lero86: checks 
*** TURN *** [Jd 5h Kd] [5s]
DeeXeeD: checks 
ex3Lero86: bets $2.21
DeeXeeD: calls $2.21
*** RIVER *** [Jd 5h Kd 5s] [Td]
DeeXeeD: checks 
ex3Lero86: checks 
*** SHOW DOWN ***
DeeXeeD: shows [Qd Qs] (two pair, Queens and Fives)
ex3Lero86: mucks hand 
DeeXeeD collected $8.47 from pot
*** SUMMARY ***
Total pot $8.87 | Rake $0.40 
Board [Jd 5h Kd 5s Td]
Seat 1: endeavoor folded before Flop (didn't bet)
Seat 3: ex3Lero86 mucked [Jc Th]
Seat 4: k4rloos (button) folded before Flop (didn't bet)
Seat 5: DeeXeeD (small blind) showed [Qd Qs] and won ($8.47) with two pair, Queens and Fives
Seat 6: matiko09 (big blind) folded before Flop





PokerStars Hand #148210515675:  Hold'em No Limit ($0.10/$0.25 USD) - 2016/02/04 11:16:09 CET [2016/02/04 5:16:09 ET]
Table 'Lilliana' 6-max Seat #2 is the button
Seat 2: mr.djlondon ($31.61 in chips) 
Seat 3: matiko09 ($52.34 in chips) 
Seat 4: marchuchok ($37.74 in chips) 
Seat 5: endeavoor ($25.35 in chips) 
Seat 6: raketkasix ($28.07 in chips) 
matiko09: posts small blind $0.10
marchuchok: posts big blind $0.25
PotgrabberAA: sits out 
*** HOLE CARDS ***
Dealt to matiko09 [Jd Qh]
endeavoor: folds 
PotgrabberAA leaves the table
raketkasix: folds 
mr.djlondon: folds 
matiko09: raises $0.50 to $0.75
marchuchok: folds 
Uncalled bet ($0.50) returned to matiko09
matiko09 collected $0.50 from pot
matiko09: doesn't show hand 
*** SUMMARY ***
Total pot $0.50 | Rake $0 
Seat 2: mr.djlondon (button) folded before Flop (didn't bet)
Seat 3: matiko09 (small blind) collected ($0.50)
Seat 4: marchuchok (big blind) folded before Flop
Seat 5: endeavoor folded before Flop (didn't bet)
Seat 6: raketkasix folded before Flop (didn't bet)





PokerStars Hand #148210520504:  Hold'em No Limit ($0.10/$0.25 USD) - 2016/02/04 11:16:19 CET [2016/02/04 5:16:19 ET]
Table 'Aquarius II' 6-max Seat #4 is the button
Seat 1: Ciudvdvno ($32.25 in chips) 
Seat 2: ex3Lero86 ($34.69 in chips) 
Seat 3: MyBestPokeR ($30.64 in chips) 
Seat 4: RasmusB79 ($15.99 in chips) 
Seat 5: TroyPoker17 ($25.75 in chips) 
Seat 6: matiko09 ($25.35 in chips) 
TroyPoker17: posts small blind $0.10
matiko09: posts big blind $0.25
*** HOLE CARDS ***
Dealt to matiko09 [Jc 3c]
Ciudvdvno: folds 
ex3Lero86: folds 
MyBestPokeR: folds 
RasmusB79: raises $0.25 to $0.50
TroyPoker17: folds 
matiko09: folds 
Uncalled bet ($0.25) returned to RasmusB79
RasmusB79 collected $0.60 from pot
*** SUMMARY ***
Total pot $0.60 | Rake $0 
Seat 1: Ciudvdvno folded before Flop (didn't bet)
Seat 2: ex3Lero86 folded before Flop (didn't bet)
Seat 3: MyBestPokeR folded before Flop (didn't bet)
Seat 4: RasmusB79 (button) collected ($0.60)
Seat 5: TroyPoker17 (small blind) folded before Flop
Seat 6: matiko09 (big blind) folded before Flop





PokerStars Hand #148210525146:  Hold'em No Limit ($0.10/$0.25 USD) - 2016/02/04 11:16:29 CET [2016/02/04 5:16:29 ET]
Table 'Lilliana' 6-max Seat #3 is the button
Seat 2: mr.djlondon ($31.61 in chips) 
Seat 3: matiko09 ($52.59 in chips) 
Seat 4: marchuchok ($37.49 in chips) 
marchuchok: posts small blind $0.10
endeavoor: is sitting out 
raketkasix: is sitting out 
mr.djlondon: posts big blind $0.25
*** HOLE CARDS ***
Dealt to matiko09 [5c 5s]
raketkasix leaves the table
matiko09: raises $0.37 to $0.62
marchuchok: folds 
mr.djlondon: folds 
Uncalled bet ($0.37) returned to matiko09
matiko09 collected $0.60 from pot
matiko09: doesn't show hand 
*** SUMMARY ***
Total pot $0.60 | Rake $0 
Seat 2: mr.djlondon (big blind) folded before Flop
Seat 3: matiko09 (button) collected ($0.60)
Seat 4: marchuchok (small blind) folded before Flop





PokerStars Hand #148210530487:  Hold'em No Limit ($0.10/$0.25 USD) - 2016/02/04 11:16:40 CET [2016/02/04 5:16:40 ET]
Table 'Aquarius II' 6-max Seat #5 is the button
Seat 1: Ciudvdvno ($32.25 in chips) 
Seat 2: ex3Lero86 ($34.69 in chips) 
Seat 3: MyBestPokeR ($30.64 in chips) 
Seat 4: RasmusB79 ($16.34 in chips) 
Seat 5: TroyPoker17 ($25.65 in chips) 
Seat 6: matiko09 ($25.10 in chips) 
matiko09: posts small blind $0.10
Ciudvdvno: posts big blind $0.25
*** HOLE CARDS ***
Dealt to matiko09 [6s Kc]
ex3Lero86: folds 
MyBestPokeR: folds 
RasmusB79: calls $0.25
TroyPoker17 is disconnected 
TroyPoker17 is connected 
TroyPoker17 has timed out
TroyPoker17: folds 
matiko09: folds 
Ciudvdvno: checks 
*** FLOP *** [3s Qd Qs]
Ciudvdvno: checks 
RasmusB79: checks 
*** TURN *** [3s Qd Qs] [4d]
Ciudvdvno: checks 
RasmusB79: bets $0.25
Ciudvdvno: calls $0.25
*** RIVER *** [3s Qd Qs 4d] [Ks]
Ciudvdvno: checks 
RasmusB79: bets $1.50
Ciudvdvno: calls $1.50
*** SHOW DOWN ***
RasmusB79: shows [Qh 7h] (three of a kind, Queens)
Ciudvdvno: mucks hand 
RasmusB79 collected $3.92 from pot
*** SUMMARY ***
Total pot $4.10 | Rake $0.18 
Board [3s Qd Qs 4d Ks]
Seat 1: Ciudvdvno (big blind) mucked [4s Td]
Seat 2: ex3Lero86 folded before Flop (didn't bet)
Seat 3: MyBestPokeR folded before Flop (didn't bet)
Seat 4: RasmusB79 showed [Qh 7h] and won ($3.92) with three of a kind, Queens
Seat 5: TroyPoker17 (button) folded before Flop (didn't bet)
Seat 6: matiko09 (small blind) folded before Flop





PokerStars Hand #148210531733:  Hold'em No Limit (€0.10/€0.25 EUR) - 2016/02/04 11:16:42 CET [2016/02/04 5:16:42 ET]
Table 'Lilaea III' 6-max Seat #1 is the button
Seat 1: matiko09 (€25.65 in chips) 
Seat 2: Newbie1990 (€29.08 in chips) 
Seat 3: uzzy20 (€25.80 in chips) 
Seat 4: Wwwasian (€29.96 in chips) 
Seat 5: Depti4 (€28.48 in chips) 
Seat 6: BaaroRai (€24.19 in chips) 
Newbie1990: posts small blind €0.10
uzzy20: posts big blind €0.25
*** HOLE CARDS ***
Dealt to matiko09 [9h Js]
Wwwasian: folds 
Depti4: folds 
BaaroRai: calls €0.25
matiko09: raises €0.75 to €1
Newbie1990: folds 
uzzy20: calls €0.75
BaaroRai: calls €0.75
*** FLOP *** [Jh 4c Qh]
uzzy20: checks 
BaaroRai: checks 
matiko09: checks 
*** TURN *** [Jh 4c Qh] [Qc]
uzzy20: bets €1.45
BaaroRai: calls €1.45
matiko09: calls €1.45
*** RIVER *** [Jh 4c Qh Qc] [7h]
uzzy20: checks 
BaaroRai: bets €2
matiko09: folds 
uzzy20: calls €2
*** SHOW DOWN ***
BaaroRai: shows [4h 5h] (a flush, Queen high)
uzzy20: mucks hand 
BaaroRai collected €10.93 from pot
*** SUMMARY ***
Total pot €11.45 | Rake €0.52 
Board [Jh 4c Qh Qc 7h]
Seat 1: matiko09 (button) folded on the River
Seat 2: Newbie1990 (small blind) folded before Flop
Seat 3: uzzy20 (big blind) mucked [Ad Jc]
Seat 4: Wwwasian folded before Flop (didn't bet)
Seat 5: Depti4 folded before Flop (didn't bet)
Seat 6: BaaroRai showed [4h 5h] and won (€10.93) with a flush, Queen high





PokerStars Hand #148210543486:  Hold'em No Limit (€0.10/€0.25 EUR) - 2016/02/04 11:17:06 CET [2016/02/04 5:17:06 ET]
Table 'Zvezdara' 6-max Seat #5 is the button
Seat 1: MaurerXL82 (€13.28 in chips) 
Seat 2: matiko09 (€31.79 in chips) 
Seat 3: Yegoriy (€28.26 in chips) 
Seat 4: kAfRiNiUs (€35.99 in chips) 
Seat 5: Depti4 (€39.40 in chips) 
Seat 6: marchuchok (€34.82 in chips) 
marchuchok: posts small blind €0.10
MaurerXL82: posts big blind €0.25
*** HOLE CARDS ***
Dealt to matiko09 [2s 7h]
matiko09: folds 
Yegoriy: folds 
kAfRiNiUs: folds 
Depti4: raises €0.50 to €0.75
marchuchok: calls €0.65
MaurerXL82: calls €0.50
*** FLOP *** [As Ah Ad]
marchuchok: checks 
MaurerXL82: checks 
Depti4: checks 
*** TURN *** [As Ah Ad] [4d]
marchuchok: bets €1.31
MaurerXL82: calls €1.31
Depti4: folds 
*** RIVER *** [As Ah Ad 4d] [6d]
marchuchok: bets €3.34
MaurerXL82: folds 
Uncalled bet (€3.34) returned to marchuchok
marchuchok collected €4.65 from pot
marchuchok: doesn't show hand 
*** SUMMARY ***
Total pot €4.87 | Rake €0.22 
Board [As Ah Ad 4d 6d]
Seat 1: MaurerXL82 (big blind) folded on the River
Seat 2: matiko09 folded before Flop (didn't bet)
Seat 3: Yegoriy folded before Flop (didn't bet)
Seat 4: kAfRiNiUs folded before Flop (didn't bet)
Seat 5: Depti4 (button) folded on the Turn
Seat 6: marchuchok (small blind) collected (€4.65)





PokerStars Hand #148210551786:  Hold'em No Limit ($0.10/$0.25 USD) - 2016/02/04 11:17:24 CET [2016/02/04 5:17:24 ET]
Table 'Euphemia II' 6-max Seat #5 is the button
Seat 2: AlexKalugin ($25 in chips) 
Seat 3: ex3Lero86 ($25 in chips) 
Seat 4: k4rloos ($50.27 in chips) 
Seat 5: DeeXeeD ($29.26 in chips) 
Seat 6: matiko09 ($25 in chips) 
matiko09: posts small blind $0.10
AlexKalugin: posts big blind $0.25
*** HOLE CARDS ***
Dealt to matiko09 [Tc 5d]
ex3Lero86: folds 
Celticsthug joins the table at seat #1 
k4rloos: raises $0.50 to $0.75
DeeXeeD: folds 
matiko09: folds 
AlexKalugin: folds 
Uncalled bet ($0.50) returned to k4rloos
k4rloos collected $0.60 from pot
k4rloos: doesn't show hand 
*** SUMMARY ***
Total pot $0.60 | Rake $0 
Seat 2: AlexKalugin (big blind) folded before Flop
Seat 3: ex3Lero86 folded before Flop (didn't bet)
Seat 4: k4rloos collected ($0.60)
Seat 5: DeeXeeD (button) folded before Flop (didn't bet)
Seat 6: matiko09 (small blind) folded before Flop





PokerStars Hand #148210562321:  Hold'em No Limit (€0.10/€0.25 EUR) - 2016/02/04 11:17:45 CET [2016/02/04 5:17:45 ET]
Table 'Lilaea III' 6-max Seat #2 is the button
Seat 1: matiko09 (€25 in chips) 
Seat 2: Newbie1990 (€28.98 in chips) 
Seat 3: uzzy20 (€25 in chips) 
Seat 4: Wwwasian (€29.96 in chips) 
Seat 5: Depti4 (€28.48 in chips) 
Seat 6: BaaroRai (€30.67 in chips) 
uzzy20: posts small blind €0.10
Wwwasian: posts big blind €0.25
*** HOLE CARDS ***
Dealt to matiko09 [3s Qd]
Depti4: raises €0.50 to €0.75
BaaroRai: folds 
matiko09: folds 
Newbie1990: folds 
uzzy20: folds 
Wwwasian: folds 
Uncalled bet (€0.50) returned to Depti4
Depti4 collected €0.60 from pot
Depti4: doesn't show hand 
*** SUMMARY ***
Total pot €0.60 | Rake €0 
Seat 1: matiko09 folded before Flop (didn't bet)
Seat 2: Newbie1990 (button) folded before Flop (didn't bet)
Seat 3: uzzy20 (small blind) folded before Flop
Seat 4: Wwwasian (big blind) folded before Flop
Seat 5: Depti4 collected (€0.60)
Seat 6: BaaroRai folded before Flop (didn't bet)





PokerStars Hand #148210563599:  Hold'em No Limit ($0.10/$0.25 USD) - 2016/02/04 11:17:48 CET [2016/02/04 5:17:48 ET]
Table 'Euphemia II' 6-max Seat #6 is the button
Seat 2: AlexKalugin ($25 in chips) 
Seat 4: k4rloos ($50.62 in chips) 
Seat 5: DeeXeeD ($29.26 in chips) 
Seat 6: matiko09 ($25 in chips) 
Celticsthug will be allowed to play after the button
AlexKalugin: posts small blind $0.10
ex3Lero86: is sitting out 
k4rloos: posts big blind $0.25
*** HOLE CARDS ***
Dealt to matiko09 [7s Qd]
ex3Lero86 leaves the table
DeeXeeD: folds 
matiko09: folds 
AlexKalugin: raises $0.45 to $0.70
k4rloos: calls $0.45
*** FLOP *** [Kd 8d Td]
AlexKalugin: checks 
k4rloos: bets $1
AlexKalugin: folds 
Uncalled bet ($1) returned to k4rloos
k4rloos collected $1.34 from pot
k4rloos: doesn't show hand 
*** SUMMARY ***
Total pot $1.40 | Rake $0.06 
Board [Kd 8d Td]
Seat 2: AlexKalugin (small blind) folded on the Flop
Seat 4: k4rloos (big blind) collected ($1.34)
Seat 5: DeeXeeD folded before Flop (didn't bet)
Seat 6: matiko09 (button) folded before Flop (didn't bet)





PokerStars Hand #148210575261:  Hold'em No Limit (€0.10/€0.25 EUR) - 2016/02/04 11:18:12 CET [2016/02/04 5:18:12 ET]
Table 'Lilaea III' 6-max Seat #3 is the button
Seat 1: matiko09 (€25 in chips) 
Seat 2: Newbie1990 (€28.98 in chips) 
Seat 3: uzzy20 (€25 in chips) 
Seat 4: Wwwasian (€29.71 in chips) 
Seat 5: Depti4 (€28.83 in chips) 
Seat 6: BaaroRai (€30.67 in chips) 
Wwwasian: posts small blind €0.10
Depti4: posts big blind €0.25
*** HOLE CARDS ***
Dealt to matiko09 [2h 8h]
BaaroRai: folds 
matiko09: folds 
Newbie1990: folds 
uzzy20: folds 
Wwwasian: folds 
Uncalled bet (€0.15) returned to Depti4
Depti4 collected €0.20 from pot
Depti4: doesn't show hand 
*** SUMMARY ***
Total pot €0.20 | Rake €0 
Seat 1: matiko09 folded before Flop (didn't bet)
Seat 2: Newbie1990 folded before Flop (didn't bet)
Seat 3: uzzy20 (button) folded before Flop (didn't bet)
Seat 4: Wwwasian (small blind) folded before Flop
Seat 5: Depti4 (big blind) collected (€0.20)
Seat 6: BaaroRai folded before Flop (didn't bet)





PokerStars Hand #148210575601:  Hold'em No Limit ($0.10/$0.25 USD) - 2016/02/04 11:18:13 CET [2016/02/04 5:18:13 ET]
Table 'Aquarius II' 6-max Seat #6 is the button
Seat 1: Ciudvdvno ($30.25 in chips) 
Seat 2: ex3Lero86 ($34.69 in chips) 
Seat 3: MyBestPokeR ($30.64 in chips) 
Seat 4: RasmusB79 ($18.26 in chips) 
Seat 5: TroyPoker17 ($25.65 in chips) 
Seat 6: matiko09 ($25 in chips) 
Ciudvdvno: posts small blind $0.10
ex3Lero86: posts big blind $0.25
*** HOLE CARDS ***
Dealt to matiko09 [Kd Jd]
MyBestPokeR: folds 
RasmusB79: calls $0.25
TroyPoker17: folds 
matiko09: raises $0.75 to $1
Ciudvdvno: folds 
ex3Lero86: folds 
RasmusB79: folds 
Uncalled bet ($0.75) returned to matiko09
matiko09 collected $0.85 from pot
matiko09: doesn't show hand 
*** SUMMARY ***
Total pot $0.85 | Rake $0 
Seat 1: Ciudvdvno (small blind) folded before Flop
Seat 2: ex3Lero86 (big blind) folded before Flop
Seat 3: MyBestPokeR folded before Flop (didn't bet)
Seat 4: RasmusB79 folded before Flop
Seat 5: TroyPoker17 folded before Flop (didn't bet)
Seat 6: matiko09 (button) collected ($0.85)





PokerStars Hand #148210576272:  Hold'em No Limit (€0.10/€0.25 EUR) - 2016/02/04 11:18:14 CET [2016/02/04 5:18:14 ET]
Table 'Zvezdara' 6-max Seat #6 is the button
Seat 1: MaurerXL82 (€11.22 in chips) 
Seat 2: matiko09 (€31.79 in chips) 
Seat 3: Yegoriy (€28.26 in chips) 
Seat 4: kAfRiNiUs (€35.99 in chips) 
Seat 5: Depti4 (€38.65 in chips) 
Seat 6: marchuchok (€37.41 in chips) 
MaurerXL82: posts small blind €0.10
matiko09: posts big blind €0.25
*** HOLE CARDS ***
Dealt to matiko09 [5d 7c]
Yegoriy: folds 
kAfRiNiUs: folds 
Depti4: folds 
marchuchok: raises €0.50 to €0.75
MaurerXL82: calls €0.65
matiko09: folds 
*** FLOP *** [Qd 3h 2c]
MaurerXL82: checks 
marchuchok: checks 
*** TURN *** [Qd 3h 2c] [Qh]
MaurerXL82: checks 
marchuchok: bets €1.01
MaurerXL82: folds 
Uncalled bet (€1.01) returned to marchuchok
marchuchok collected €1.67 from pot
marchuchok: doesn't show hand 
*** SUMMARY ***
Total pot €1.75 | Rake €0.08 
Board [Qd 3h 2c Qh]
Seat 1: MaurerXL82 (small blind) folded on the Turn
Seat 2: matiko09 (big blind) folded before Flop
Seat 3: Yegoriy folded before Flop (didn't bet)
Seat 4: kAfRiNiUs folded before Flop (didn't bet)
Seat 5: Depti4 folded before Flop (didn't bet)
Seat 6: marchuchok (button) collected (€1.67)





PokerStars Hand #148210583169:  Hold'em No Limit (€0.10/€0.25 EUR) - 2016/02/04 11:18:28 CET [2016/02/04 5:18:28 ET]
Table 'Lilaea III' 6-max Seat #4 is the button
Seat 1: matiko09 (€25 in chips) 
Seat 2: Newbie1990 (€28.98 in chips) 
Seat 3: uzzy20 (€25 in chips) 
Seat 4: Wwwasian (€29.61 in chips) 
Seat 5: Depti4 (€28.93 in chips) 
Seat 6: BaaroRai (€30.67 in chips) 
Depti4: posts small blind €0.10
BaaroRai: posts big blind €0.25
*** HOLE CARDS ***
Dealt to matiko09 [Jc Ad]
matiko09: raises €0.50 to €0.75
Newbie1990: folds 
uzzy20: folds 
Wwwasian: calls €0.75
Depti4: folds 
BaaroRai: folds 
*** FLOP *** [As Jh 3d]
matiko09: bets €1.15
Wwwasian: folds 
Uncalled bet (€1.15) returned to matiko09
matiko09 collected €1.77 from pot
matiko09: doesn't show hand 
*** SUMMARY ***
Total pot €1.85 | Rake €0.08 
Board [As Jh 3d]
Seat 1: matiko09 collected (€1.77)
Seat 2: Newbie1990 folded before Flop (didn't bet)
Seat 3: uzzy20 folded before Flop (didn't bet)
Seat 4: Wwwasian (button) folded on the Flop
Seat 5: Depti4 (small blind) folded before Flop
Seat 6: BaaroRai (big blind) folded before Flop





PokerStars Hand #148210592789:  Hold'em No Limit ($0.10/$0.25 USD) - 2016/02/04 11:18:48 CET [2016/02/04 5:18:48 ET]
Table 'Aquarius II' 6-max Seat #1 is the button
Seat 1: Ciudvdvno ($30.15 in chips) 
Seat 2: ex3Lero86 ($34.44 in chips) 
Seat 3: MyBestPokeR ($30.64 in chips) 
Seat 4: RasmusB79 ($18.01 in chips) 
Seat 5: TroyPoker17 ($25.65 in chips) 
Seat 6: matiko09 ($25.60 in chips) 
ex3Lero86: posts small blind $0.10
MyBestPokeR: posts big blind $0.25
*** HOLE CARDS ***
Dealt to matiko09 [2h 3d]
RasmusB79: folds 
TroyPoker17: raises $0.50 to $0.75
matiko09: folds 
Ciudvdvno: folds 
ex3Lero86: folds 
MyBestPokeR: folds 
Uncalled bet ($0.50) returned to TroyPoker17
TroyPoker17 collected $0.60 from pot
TroyPoker17: doesn't show hand 
*** SUMMARY ***
Total pot $0.60 | Rake $0 
Seat 1: Ciudvdvno (button) folded before Flop (didn't bet)
Seat 2: ex3Lero86 (small blind) folded before Flop
Seat 3: MyBestPokeR (big blind) folded before Flop
Seat 4: RasmusB79 folded before Flop (didn't bet)
Seat 5: TroyPoker17 collected ($0.60)
Seat 6: matiko09 folded before Flop (didn't bet)





PokerStars Hand #148210596275:  Hold'em No Limit (€0.10/€0.25 EUR) - 2016/02/04 11:18:55 CET [2016/02/04 5:18:55 ET]
Table 'Lilaea III' 6-max Seat #5 is the button
Seat 1: matiko09 (€26.02 in chips) 
Seat 2: Newbie1990 (€28.98 in chips) 
Seat 3: uzzy20 (€25 in chips) 
Seat 4: Wwwasian (€28.86 in chips) 
Seat 5: Depti4 (€28.83 in chips) 
Seat 6: BaaroRai (€30.42 in chips) 
BaaroRai: posts small blind €0.10
matiko09: posts big blind €0.25
*** HOLE CARDS ***
Dealt to matiko09 [Ad Kc]
Newbie1990: folds 
uzzy20: folds 
Wwwasian: folds 
Depti4: folds 
BaaroRai: calls €0.15
matiko09: raises €0.75 to €1
BaaroRai: folds 
Uncalled bet (€0.75) returned to matiko09
matiko09 collected €0.50 from pot
matiko09: doesn't show hand 
*** SUMMARY ***
Total pot €0.50 | Rake €0 
Seat 1: matiko09 (big blind) collected (€0.50)
Seat 2: Newbie1990 folded before Flop (didn't bet)
Seat 3: uzzy20 folded before Flop (didn't bet)
Seat 4: Wwwasian folded before Flop (didn't bet)
Seat 5: Depti4 (button) folded before Flop (didn't bet)
Seat 6: BaaroRai (small blind) folded before Flop





PokerStars Hand #148210598382:  Hold'em No Limit (€0.10/€0.25 EUR) - 2016/02/04 11:18:59 CET [2016/02/04 5:18:59 ET]
Table 'Zvezdara' 6-max Seat #1 is the button
Seat 1: MaurerXL82 (€10.47 in chips) 
Seat 2: matiko09 (€31.54 in chips) 
Seat 3: Yegoriy (€28.26 in chips) 
Seat 4: kAfRiNiUs (€35.99 in chips) 
Seat 5: Depti4 (€38.65 in chips) 
Seat 6: marchuchok (€38.33 in chips) 
matiko09: posts small blind €0.10
Yegoriy: posts big blind €0.25
*** HOLE CARDS ***
Dealt to matiko09 [Ad Kd]
kAfRiNiUs: folds 
Depti4: folds 
marchuchok: folds 
MaurerXL82: folds 
matiko09: raises €0.50 to €0.75
Yegoriy: calls €0.50
*** FLOP *** [4c 8h 9c]
matiko09: checks 
Yegoriy: bets €0.80
matiko09: folds 
Uncalled bet (€0.80) returned to Yegoriy
Yegoriy collected €1.43 from pot
*** SUMMARY ***
Total pot €1.50 | Rake €0.07 
Board [4c 8h 9c]
Seat 1: MaurerXL82 (button) folded before Flop (didn't bet)
Seat 2: matiko09 (small blind) folded on the Flop
Seat 3: Yegoriy (big blind) collected (€1.43)
Seat 4: kAfRiNiUs folded before Flop (didn't bet)
Seat 5: Depti4 folded before Flop (didn't bet)
Seat 6: marchuchok folded before Flop (didn't bet)





PokerStars Hand #148210607440:  Hold'em No Limit (€0.10/€0.25 EUR) - 2016/02/04 11:19:18 CET [2016/02/04 5:19:18 ET]
Table 'Lilaea III' 6-max Seat #6 is the button
Seat 1: matiko09 (€26.27 in chips) 
Seat 2: Newbie1990 (€28.98 in chips) 
Seat 3: uzzy20 (€25 in chips) 
Seat 4: Wwwasian (€28.86 in chips) 
Seat 5: Depti4 (€28.83 in chips) 
Seat 6: BaaroRai (€30.17 in chips) 
matiko09: posts small blind €0.10
Newbie1990: posts big blind €0.25
*** HOLE CARDS ***
Dealt to matiko09 [Qh 5s]
uzzy20: folds 
Wwwasian: raises €0.45 to €0.70
Depti4: folds 
BaaroRai: folds 
matiko09: folds 
Newbie1990: folds 
Uncalled bet (€0.45) returned to Wwwasian
Wwwasian collected €0.60 from pot
Wwwasian: doesn't show hand 
*** SUMMARY ***
Total pot €0.60 | Rake €0 
Seat 1: matiko09 (small blind) folded before Flop
Seat 2: Newbie1990 (big blind) folded before Flop
Seat 3: uzzy20 folded before Flop (didn't bet)
Seat 4: Wwwasian collected (€0.60)
Seat 5: Depti4 folded before Flop (didn't bet)
Seat 6: BaaroRai (button) folded before Flop (didn't bet)





PokerStars Hand #148210608629:  Hold'em No Limit ($0.10/$0.25 USD) - 2016/02/04 11:19:20 CET [2016/02/04 5:19:20 ET]
Table 'Aquarius II' 6-max Seat #2 is the button
Seat 1: Ciudvdvno ($30.15 in chips) 
Seat 2: ex3Lero86 ($34.34 in chips) 
Seat 3: MyBestPokeR ($30.39 in chips) 
Seat 4: RasmusB79 ($18.01 in chips) 
Seat 5: TroyPoker17 ($26 in chips) 
Seat 6: matiko09 ($25.60 in chips) 
MyBestPokeR: posts small blind $0.10
RasmusB79: posts big blind $0.25
*** HOLE CARDS ***
Dealt to matiko09 [Th 2h]
TroyPoker17: folds 
matiko09: folds 
Ciudvdvno: raises $0.50 to $0.75
ex3Lero86: calls $0.75
MyBestPokeR: folds 
RasmusB79: calls $0.50
*** FLOP *** [7h 9c 6s]
RasmusB79: checks 
Ciudvdvno: checks 
ex3Lero86: checks 
*** TURN *** [7h 9c 6s] [4d]
RasmusB79: checks 
Ciudvdvno: bets $1
ex3Lero86: calls $1
RasmusB79: calls $1
*** RIVER *** [7h 9c 6s 4d] [5s]
RasmusB79: bets $16.26 and is all-in
Ciudvdvno: folds 
ex3Lero86: folds 
Uncalled bet ($16.26) returned to RasmusB79
RasmusB79 collected $5.11 from pot
*** SUMMARY ***
Total pot $5.35 | Rake $0.24 
Board [7h 9c 6s 4d 5s]
Seat 1: Ciudvdvno folded on the River
Seat 2: ex3Lero86 (button) folded on the River
Seat 3: MyBestPokeR (small blind) folded before Flop
Seat 4: RasmusB79 (big blind) collected ($5.11)
Seat 5: TroyPoker17 folded before Flop (didn't bet)
Seat 6: matiko09 folded before Flop (didn't bet)





PokerStars Hand #148210611083:  Hold'em No Limit (€0.10/€0.25 EUR) - 2016/02/04 11:19:25 CET [2016/02/04 5:19:25 ET]
Table 'Zvezdara' 6-max Seat #2 is the button
Seat 1: MaurerXL82 (€10.47 in chips) 
Seat 2: matiko09 (€30.79 in chips) 
Seat 3: Yegoriy (€28.94 in chips) 
Seat 4: kAfRiNiUs (€35.99 in chips) 
Seat 5: Depti4 (€38.65 in chips) 
Seat 6: marchuchok (€38.33 in chips) 
Yegoriy: posts small blind €0.10
kAfRiNiUs: posts big blind €0.25
*** HOLE CARDS ***
Dealt to matiko09 [Qd 2d]
Depti4: folds 
marchuchok: folds 
MaurerXL82: folds 
matiko09: folds 
Yegoriy: folds 
Uncalled bet (€0.15) returned to kAfRiNiUs
kAfRiNiUs collected €0.20 from pot
kAfRiNiUs: doesn't show hand 
*** SUMMARY ***
Total pot €0.20 | Rake €0 
Seat 1: MaurerXL82 folded before Flop (didn't bet)
Seat 2: matiko09 (button) folded before Flop (didn't bet)
Seat 3: Yegoriy (small blind) folded before Flop
Seat 4: kAfRiNiUs (big blind) collected (€0.20)
Seat 5: Depti4 folded before Flop (didn't bet)
Seat 6: marchuchok folded before Flop (didn't bet)





PokerStars Hand #148210617326:  Hold'em No Limit (€0.10/€0.25 EUR) - 2016/02/04 11:19:38 CET [2016/02/04 5:19:38 ET]
Table 'Lilaea III' 6-max Seat #1 is the button
Seat 1: matiko09 (€26.17 in chips) 
Seat 2: Newbie1990 (€28.73 in chips) 
Seat 3: uzzy20 (€25 in chips) 
Seat 4: Wwwasian (€29.21 in chips) 
Seat 5: Depti4 (€28.83 in chips) 
Seat 6: BaaroRai (€30.17 in chips) 
Newbie1990: posts small blind €0.10
uzzy20: posts big blind €0.25
*** HOLE CARDS ***
Dealt to matiko09 [4d Kd]
Wwwasian: folds 
Depti4: folds 
BaaroRai: folds 
matiko09: raises €0.37 to €0.62
Newbie1990: folds 
uzzy20: folds 
Uncalled bet (€0.37) returned to matiko09
matiko09 collected €0.60 from pot
matiko09: doesn't show hand 
*** SUMMARY ***
Total pot €0.60 | Rake €0 
Seat 1: matiko09 (button) collected (€0.60)
Seat 2: Newbie1990 (small blind) folded before Flop
Seat 3: uzzy20 (big blind) folded before Flop
Seat 4: Wwwasian folded before Flop (didn't bet)
Seat 5: Depti4 folded before Flop (didn't bet)
Seat 6: BaaroRai folded before Flop (didn't bet)





PokerStars Hand #148210617818:  Hold'em No Limit ($0.10/$0.25 USD) - 2016/02/04 11:19:39 CET [2016/02/04 5:19:39 ET]
Table 'Golson' 6-max Seat #2 is the button
Seat 1: Ciudvdvno ($25 in chips) 
Seat 2: nnVinokurov ($32.14 in chips) 
Seat 3: Mirking2708 ($20.62 in chips) 
Seat 4: matiko09 ($25 in chips) 
Seat 5: Newbie1990 ($26.76 in chips) 
Seat 6: Wwwasian ($26.32 in chips) 
Mirking2708: posts small blind $0.10
matiko09: posts big blind $0.25
*** HOLE CARDS ***
Dealt to matiko09 [7h 3h]
Newbie1990: folds 
Wwwasian: folds 
Ciudvdvno: folds 
nnVinokurov: raises $0.37 to $0.62
Mirking2708: folds 
matiko09: folds 
Uncalled bet ($0.37) returned to nnVinokurov
nnVinokurov collected $0.60 from pot
nnVinokurov: doesn't show hand 
*** SUMMARY ***
Total pot $0.60 | Rake $0 
Seat 1: Ciudvdvno folded before Flop (didn't bet)
Seat 2: nnVinokurov (button) collected ($0.60)
Seat 3: Mirking2708 (small blind) folded before Flop
Seat 4: matiko09 (big blind) folded before Flop
Seat 5: Newbie1990 folded before Flop (didn't bet)
Seat 6: Wwwasian folded before Flop (didn't bet)





PokerStars Hand #148210618337:  Hold'em No Limit (€0.10/€0.25 EUR) - 2016/02/04 11:19:40 CET [2016/02/04 5:19:40 ET]
Table 'Zvezdara' 6-max Seat #3 is the button
Seat 1: MaurerXL82 (€10.47 in chips) 
Seat 2: matiko09 (€30.79 in chips) 
Seat 3: Yegoriy (€28.84 in chips) 
Seat 4: kAfRiNiUs (€36.09 in chips) 
Seat 5: Depti4 (€38.65 in chips) 
Seat 6: marchuchok (€38.33 in chips) 
kAfRiNiUs: posts small blind €0.10
Depti4: posts big blind €0.25
*** HOLE CARDS ***
Dealt to matiko09 [2c 8h]
marchuchok: folds 
MaurerXL82: calls €0.25
matiko09: folds 
Yegoriy: folds 
kAfRiNiUs: raises €1 to €1.25
Depti4: folds 
MaurerXL82: calls €1
*** FLOP *** [2h 7d 6c]
kAfRiNiUs: bets €1.52
MaurerXL82: folds 
Uncalled bet (€1.52) returned to kAfRiNiUs
kAfRiNiUs collected €2.63 from pot
kAfRiNiUs: doesn't show hand 
*** SUMMARY ***
Total pot €2.75 | Rake €0.12 
Board [2h 7d 6c]
Seat 1: MaurerXL82 folded on the Flop
Seat 2: matiko09 folded before Flop (didn't bet)
Seat 3: Yegoriy (button) folded before Flop (didn't bet)
Seat 4: kAfRiNiUs (small blind) collected (€2.63)
Seat 5: Depti4 (big blind) folded before Flop
Seat 6: marchuchok folded before Flop (didn't bet)





PokerStars Hand #148210626743:  Hold'em No Limit (€0.10/€0.25 EUR) - 2016/02/04 11:19:57 CET [2016/02/04 5:19:57 ET]
Table 'Lilaea III' 6-max Seat #2 is the button
Seat 1: matiko09 (€26.52 in chips) 
Seat 2: Newbie1990 (€28.63 in chips) 
Seat 3: uzzy20 (€25 in chips) 
Seat 4: Wwwasian (€29.21 in chips) 
Seat 5: Depti4 (€28.83 in chips) 
Seat 6: BaaroRai (€30.17 in chips) 
uzzy20: posts small blind €0.10
Wwwasian: posts big blind €0.25
*** HOLE CARDS ***
Dealt to matiko09 [9c Tc]
Depti4: folds 
BaaroRai: calls €0.25
matiko09: raises €0.75 to €1
Newbie1990: folds 
uzzy20: folds 
Wwwasian: folds 
BaaroRai: calls €0.75
*** FLOP *** [2h 9h 6c]
BaaroRai: bets €0.25
matiko09: raises €1.50 to €1.75
BaaroRai: folds 
Uncalled bet (€1.50) returned to matiko09
matiko09 collected €2.72 from pot
matiko09: doesn't show hand 
*** SUMMARY ***
Total pot €2.85 | Rake €0.13 
Board [2h 9h 6c]
Seat 1: matiko09 collected (€2.72)
Seat 2: Newbie1990 (button) folded before Flop (didn't bet)
Seat 3: uzzy20 (small blind) folded before Flop
Seat 4: Wwwasian (big blind) folded before Flop
Seat 5: Depti4 folded before Flop (didn't bet)
Seat 6: BaaroRai folded on the Flop





PokerStars Hand #148210630653:  Hold'em No Limit ($0.10/$0.25 USD) - 2016/02/04 11:20:05 CET [2016/02/04 5:20:05 ET]
Table 'Golson' 6-max Seat #3 is the button
Seat 1: Ciudvdvno ($25 in chips) 
Seat 2: nnVinokurov ($32.49 in chips) 
Seat 3: Mirking2708 ($20.52 in chips) 
Seat 4: matiko09 ($25 in chips) 
Seat 5: Newbie1990 ($26.76 in chips) 
Seat 6: Wwwasian ($26.32 in chips) 
matiko09: posts small blind $0.10
Newbie1990: posts big blind $0.25
*** HOLE CARDS ***
Dealt to matiko09 [8d Th]
Wwwasian: folds 
Ciudvdvno: folds 
nnVinokurov: folds 
Mirking2708: folds 
matiko09: folds 
Uncalled bet ($0.15) returned to Newbie1990
Newbie1990 collected $0.20 from pot
Newbie1990: doesn't show hand 
*** SUMMARY ***
Total pot $0.20 | Rake $0 
Seat 1: Ciudvdvno folded before Flop (didn't bet)
Seat 2: nnVinokurov folded before Flop (didn't bet)
Seat 3: Mirking2708 (button) folded before Flop (didn't bet)
Seat 4: matiko09 (small blind) folded before Flop
Seat 5: Newbie1990 (big blind) collected ($0.20)
Seat 6: Wwwasian folded before Flop (didn't bet)





PokerStars Hand #148210632337:  Hold'em No Limit (€0.10/€0.25 EUR) - 2016/02/04 11:20:08 CET [2016/02/04 5:20:08 ET]
Table 'Zvezdara' 6-max Seat #4 is the button
Seat 1: MaurerXL82 (€9.22 in chips) 
Seat 2: matiko09 (€30.79 in chips) 
Seat 3: Yegoriy (€28.84 in chips) 
Seat 4: kAfRiNiUs (€37.47 in chips) 
Seat 5: Depti4 (€38.40 in chips) 
Seat 6: marchuchok (€38.33 in chips) 
Depti4: posts small blind €0.10
marchuchok: posts big blind €0.25
*** HOLE CARDS ***
Dealt to matiko09 [8c 4s]
MaurerXL82: calls €0.25
matiko09: folds 
Yegoriy: folds 
kAfRiNiUs: folds 
Depti4: folds 
marchuchok: checks 
*** FLOP *** [2c Td Th]
marchuchok: checks 
MaurerXL82: checks 
*** TURN *** [2c Td Th] [Kh]
marchuchok: checks 
MaurerXL82: checks 
*** RIVER *** [2c Td Th Kh] [2h]
marchuchok: checks 
MaurerXL82: checks 
*** SHOW DOWN ***
marchuchok: shows [Qd 8h] (two pair, Tens and Deuces)
MaurerXL82: shows [6s 5s] (two pair, Tens and Deuces)
marchuchok collected €0.29 from pot
MaurerXL82 collected €0.28 from pot
*** SUMMARY ***
Total pot €0.60 | Rake €0.03 
Board [2c Td Th Kh 2h]
Seat 1: MaurerXL82 showed [6s 5s] and won (€0.28) with two pair, Tens and Deuces
Seat 2: matiko09 folded before Flop (didn't bet)
Seat 3: Yegoriy folded before Flop (didn't bet)
Seat 4: kAfRiNiUs (button) folded before Flop (didn't bet)
Seat 5: Depti4 (small blind) folded before Flop
Seat 6: marchuchok (big blind) showed [Qd 8h] and won (€0.29) with two pair, Tens and Deuces





PokerStars Hand #148210644166:  Hold'em No Limit ($0.10/$0.25 USD) - 2016/02/04 11:20:33 CET [2016/02/04 5:20:33 ET]
Table 'Golson' 6-max Seat #4 is the button
Seat 1: Ciudvdvno ($25 in chips) 
Seat 2: nnVinokurov ($32.49 in chips) 
Seat 3: Mirking2708 ($20.52 in chips) 
Seat 4: matiko09 ($25 in chips) 
Seat 5: Newbie1990 ($26.86 in chips) 
Seat 6: Wwwasian ($26.32 in chips) 
Newbie1990: posts small blind $0.10
Wwwasian: posts big blind $0.25
*** HOLE CARDS ***
Dealt to matiko09 [6c Js]
Ciudvdvno: folds 
nnVinokurov: folds 
Mirking2708: folds 
matiko09: folds 
Newbie1990: raises $0.37 to $0.62
Wwwasian: folds 
Uncalled bet ($0.37) returned to Newbie1990
Newbie1990 collected $0.50 from pot
Newbie1990: doesn't show hand 
*** SUMMARY ***
Total pot $0.50 | Rake $0 
Seat 1: Ciudvdvno folded before Flop (didn't bet)
Seat 2: nnVinokurov folded before Flop (didn't bet)
Seat 3: Mirking2708 folded before Flop (didn't bet)
Seat 4: matiko09 (button) folded before Flop (didn't bet)
Seat 5: Newbie1990 (small blind) collected ($0.50)
Seat 6: Wwwasian (big blind) folded before Flop





PokerStars Hand #148210645048:  Hold'em No Limit (€0.10/€0.25 EUR) - 2016/02/04 11:20:34 CET [2016/02/04 5:20:34 ET]
Table 'Lilaea III' 6-max Seat #3 is the button
Seat 1: matiko09 (€27.99 in chips) 
Seat 2: Newbie1990 (€28.63 in chips) 
Seat 3: uzzy20 (€25 in chips) 
Seat 4: Wwwasian (€28.96 in chips) 
Seat 5: Depti4 (€28.83 in chips) 
Seat 6: BaaroRai (€28.92 in chips) 
Wwwasian: posts small blind €0.10
Depti4: posts big blind €0.25
*** HOLE CARDS ***
Dealt to matiko09 [6d Qh]
BaaroRai: folds 
matiko09: folds 
Newbie1990: raises €0.37 to €0.62
uzzy20: folds 
Wwwasian: folds 
Depti4: folds 
Uncalled bet (€0.37) returned to Newbie1990
Newbie1990 collected €0.60 from pot
Newbie1990: doesn't show hand 
*** SUMMARY ***
Total pot €0.60 | Rake €0 
Seat 1: matiko09 folded before Flop (didn't bet)
Seat 2: Newbie1990 collected (€0.60)
Seat 3: uzzy20 (button) folded before Flop (didn't bet)
Seat 4: Wwwasian (small blind) folded before Flop
Seat 5: Depti4 (big blind) folded before Flop
Seat 6: BaaroRai folded before Flop (didn't bet)





PokerStars Hand #148210648719:  Hold'em No Limit ($0.10/$0.25 USD) - 2016/02/04 11:20:42 CET [2016/02/04 5:20:42 ET]
Table 'Aquarius II' 6-max Seat #3 is the button
Seat 1: Ciudvdvno ($28.40 in chips) 
Seat 2: ex3Lero86 ($32.59 in chips) 
Seat 3: MyBestPokeR ($30.29 in chips) 
Seat 4: RasmusB79 ($21.37 in chips) 
Seat 5: TroyPoker17 ($26 in chips) 
Seat 6: matiko09 ($25.60 in chips) 
RasmusB79: posts small blind $0.10
TroyPoker17: posts big blind $0.25
*** HOLE CARDS ***
Dealt to matiko09 [7s 2d]
matiko09: folds 
Ciudvdvno: folds 
ex3Lero86: folds 
MyBestPokeR: raises $0.37 to $0.62
RasmusB79: folds 
TroyPoker17: calls $0.37
*** FLOP *** [6d As 6h]
TroyPoker17: checks 
MyBestPokeR: checks 
*** TURN *** [6d As 6h] [7c]
TroyPoker17: checks 
MyBestPokeR: bets $0.75
TroyPoker17: calls $0.75
*** RIVER *** [6d As 6h 7c] [2s]
TroyPoker17: checks 
MyBestPokeR: checks 
*** SHOW DOWN ***
TroyPoker17: shows [Ac 4h] (two pair, Aces and Sixes)
MyBestPokeR: mucks hand 
TroyPoker17 collected $2.71 from pot
*** SUMMARY ***
Total pot $2.84 | Rake $0.13 
Board [6d As 6h 7c 2s]
Seat 1: Ciudvdvno folded before Flop (didn't bet)
Seat 2: ex3Lero86 folded before Flop (didn't bet)
Seat 3: MyBestPokeR (button) mucked [Jd Qh]
Seat 4: RasmusB79 (small blind) folded before Flop
Seat 5: TroyPoker17 (big blind) showed [Ac 4h] and won ($2.71) with two pair, Aces and Sixes
Seat 6: matiko09 folded before Flop (didn't bet)





PokerStars Hand #148210651309:  Hold'em No Limit (€0.10/€0.25 EUR) - 2016/02/04 11:20:47 CET [2016/02/04 5:20:47 ET]
Table 'Zvezdara' 6-max Seat #5 is the button
Seat 1: MaurerXL82 (€9.25 in chips) 
Seat 2: matiko09 (€30.79 in chips) 
Seat 3: Yegoriy (€28.84 in chips) 
Seat 4: kAfRiNiUs (€37.47 in chips) 
Seat 5: Depti4 (€38.30 in chips) 
Seat 6: marchuchok (€38.37 in chips) 
marchuchok: posts small blind €0.10
MaurerXL82: posts big blind €0.25
*** HOLE CARDS ***
Dealt to matiko09 [4s 2d]
matiko09: folds 
Yegoriy: folds 
kAfRiNiUs: folds 
Depti4: folds 
marchuchok: folds 
Uncalled bet (€0.15) returned to MaurerXL82
MaurerXL82 collected €0.20 from pot
MaurerXL82: doesn't show hand 
*** SUMMARY ***
Total pot €0.20 | Rake €0 
Seat 1: MaurerXL82 (big blind) collected (€0.20)
Seat 2: matiko09 folded before Flop (didn't bet)
Seat 3: Yegoriy folded before Flop (didn't bet)
Seat 4: kAfRiNiUs folded before Flop (didn't bet)
Seat 5: Depti4 (button) folded before Flop (didn't bet)
Seat 6: marchuchok (small blind) folded before Flop





PokerStars Hand #148210652986:  Hold'em No Limit (€0.10/€0.25 EUR) - 2016/02/04 11:20:50 CET [2016/02/04 5:20:50 ET]
Table 'Lilaea III' 6-max Seat #4 is the button
Seat 1: matiko09 (€27.99 in chips) 
Seat 2: Newbie1990 (€28.98 in chips) 
Seat 3: uzzy20 (€25 in chips) 
Seat 4: Wwwasian (€28.86 in chips) 
Seat 5: Depti4 (€28.58 in chips) 
Seat 6: BaaroRai (€28.92 in chips) 
Depti4: posts small blind €0.10
BaaroRai: posts big blind €0.25
*** HOLE CARDS ***
Dealt to matiko09 [As 7s]
matiko09: folds 
Newbie1990: folds 
uzzy20: folds 
Wwwasian: raises €0.45 to €0.70
Depti4: calls €0.60
BaaroRai: folds 
*** FLOP *** [Jh Ks 9d]
Depti4: checks 
Wwwasian: checks 
*** TURN *** [Jh Ks 9d] [5h]
Depti4: checks 
Wwwasian: bets €1
Depti4: folds 
Uncalled bet (€1) returned to Wwwasian
Wwwasian collected €1.58 from pot
Wwwasian: doesn't show hand 
*** SUMMARY ***
Total pot €1.65 | Rake €0.07 
Board [Jh Ks 9d 5h]
Seat 1: matiko09 folded before Flop (didn't bet)
Seat 2: Newbie1990 folded before Flop (didn't bet)
Seat 3: uzzy20 folded before Flop (didn't bet)
Seat 4: Wwwasian (button) collected (€1.58)
Seat 5: Depti4 (small blind) folded on the Turn
Seat 6: BaaroRai (big blind) folded before Flop





PokerStars Hand #148210656353:  Hold'em No Limit ($0.10/$0.25 USD) - 2016/02/04 11:20:57 CET [2016/02/04 5:20:57 ET]
Table 'Golson' 6-max Seat #5 is the button
Seat 1: Ciudvdvno ($25 in chips) 
Seat 2: nnVinokurov ($32.49 in chips) 
Seat 3: Mirking2708 ($20.52 in chips) 
Seat 4: matiko09 ($25 in chips) 
Seat 5: Newbie1990 ($27.11 in chips) 
Seat 6: Wwwasian ($26.07 in chips) 
Wwwasian: posts small blind $0.10
Ciudvdvno: posts big blind $0.25
*** HOLE CARDS ***
Dealt to matiko09 [3d As]
nnVinokurov: raises $0.50 to $0.75
Mirking2708: folds 
matiko09: folds 
Newbie1990: folds 
Wwwasian: folds 
Ciudvdvno: folds 
Uncalled bet ($0.50) returned to nnVinokurov
nnVinokurov collected $0.60 from pot
nnVinokurov: doesn't show hand 
*** SUMMARY ***
Total pot $0.60 | Rake $0 
Seat 1: Ciudvdvno (big blind) folded before Flop
Seat 2: nnVinokurov collected ($0.60)
Seat 3: Mirking2708 folded before Flop (didn't bet)
Seat 4: matiko09 folded before Flop (didn't bet)
Seat 5: Newbie1990 (button) folded before Flop (didn't bet)
Seat 6: Wwwasian (small blind) folded before Flop





PokerStars Hand #148210666911:  Hold'em No Limit ($0.10/$0.25 USD) - 2016/02/04 11:21:19 CET [2016/02/04 5:21:19 ET]
Table 'Golson' 6-max Seat #6 is the button
Seat 1: Ciudvdvno ($25 in chips) 
Seat 2: nnVinokurov ($32.84 in chips) 
Seat 3: Mirking2708 ($20.52 in chips) 
Seat 4: matiko09 ($25 in chips) 
Seat 5: Newbie1990 ($27.11 in chips) 
Seat 6: Wwwasian ($25.97 in chips) 
Ciudvdvno: posts small blind $0.10
nnVinokurov: posts big blind $0.25
*** HOLE CARDS ***
Dealt to matiko09 [7s 8c]
Mirking2708: calls $0.25
matiko09: folds 
Newbie1990: raises $0.75 to $1
Wwwasian: calls $1
Ciudvdvno: raises $3.25 to $4.25
nnVinokurov: folds 
Mirking2708: folds 
Newbie1990: folds 
Wwwasian: folds 
Uncalled bet ($3.25) returned to Ciudvdvno
Ciudvdvno collected $3.50 from pot
*** SUMMARY ***
Total pot $3.50 | Rake $0 
Seat 1: Ciudvdvno (small blind) collected ($3.50)
Seat 2: nnVinokurov (big blind) folded before Flop
Seat 3: Mirking2708 folded before Flop
Seat 4: matiko09 folded before Flop (didn't bet)
Seat 5: Newbie1990 folded before Flop
Seat 6: Wwwasian (button) folded before Flop





PokerStars Hand #148210667858:  Hold'em No Limit (€0.10/€0.25 EUR) - 2016/02/04 11:21:21 CET [2016/02/04 5:21:21 ET]
Table 'Zvezdara' 6-max Seat #6 is the button
Seat 1: MaurerXL82 (€9.35 in chips) 
Seat 2: matiko09 (€30.79 in chips) 
Seat 3: Yegoriy (€28.84 in chips) 
Seat 4: kAfRiNiUs (€37.47 in chips) 
Seat 5: Depti4 (€38.30 in chips) 
Seat 6: marchuchok (€38.27 in chips) 
MaurerXL82: posts small blind €0.10
matiko09: posts big blind €0.25
*** HOLE CARDS ***
Dealt to matiko09 [Td Ac]
Yegoriy: folds 
kAfRiNiUs: raises €0.50 to €0.75
Depti4: folds 
marchuchok: folds 
MaurerXL82: calls €0.65
matiko09: raises €2.25 to €3
kAfRiNiUs: folds 
MaurerXL82: calls €2.25
*** FLOP *** [Kh 6c Tc]
MaurerXL82: bets €6.35 and is all-in
matiko09: calls €6.35
*** TURN *** [Kh 6c Tc] [Ah]
*** RIVER *** [Kh 6c Tc Ah] [9s]
*** SHOW DOWN ***
MaurerXL82: shows [7d 7s] (a pair of Sevens)
matiko09: shows [Td Ac] (two pair, Aces and Tens)
matiko09 collected €18.57 from pot
*** SUMMARY ***
Total pot €19.45 | Rake €0.88 
Board [Kh 6c Tc Ah 9s]
Seat 1: MaurerXL82 (small blind) showed [7d 7s] and lost with a pair of Sevens
Seat 2: matiko09 (big blind) showed [Td Ac] and won (€18.57) with two pair, Aces and Tens
Seat 3: Yegoriy folded before Flop (didn't bet)
Seat 4: kAfRiNiUs folded before Flop
Seat 5: Depti4 folded before Flop (didn't bet)
Seat 6: marchuchok (button) folded before Flop (didn't bet)





PokerStars Hand #148210673512:  Hold'em No Limit (€0.10/€0.25 EUR) - 2016/02/04 11:21:32 CET [2016/02/04 5:21:32 ET]
Table 'Lilaea III' 6-max Seat #5 is the button
Seat 1: matiko09 (€27.99 in chips) 
Seat 2: Newbie1990 (€28.98 in chips) 
Seat 3: uzzy20 (€25 in chips) 
Seat 4: Wwwasian (€29.74 in chips) 
Seat 5: Depti4 (€27.88 in chips) 
Seat 6: BaaroRai (€28.67 in chips) 
BaaroRai: posts small blind €0.10
matiko09: posts big blind €0.25
*** HOLE CARDS ***
Dealt to matiko09 [8h Jd]
Newbie1990: folds 
uzzy20: folds 
Wwwasian: folds 
Depti4: raises €0.50 to €0.75
BaaroRai: folds 
matiko09: folds 
Uncalled bet (€0.50) returned to Depti4
Depti4 collected €0.60 from pot
Depti4: doesn't show hand 
*** SUMMARY ***
Total pot €0.60 | Rake €0 
Seat 1: matiko09 (big blind) folded before Flop
Seat 2: Newbie1990 folded before Flop (didn't bet)
Seat 3: uzzy20 folded before Flop (didn't bet)
Seat 4: Wwwasian folded before Flop (didn't bet)
Seat 5: Depti4 (button) collected (€0.60)
Seat 6: BaaroRai (small blind) folded before Flop





PokerStars Hand #148210682947:  Hold'em No Limit (€0.10/€0.25 EUR) - 2016/02/04 11:21:52 CET [2016/02/04 5:21:52 ET]
Table 'Lilaea III' 6-max Seat #6 is the button
Seat 1: matiko09 (€27.74 in chips) 
Seat 2: Newbie1990 (€28.98 in chips) 
Seat 3: uzzy20 (€25 in chips) 
Seat 4: Wwwasian (€29.74 in chips) 
Seat 5: Depti4 (€28.23 in chips) 
Seat 6: BaaroRai (€28.57 in chips) 
matiko09: posts small blind €0.10
Newbie1990: posts big blind €0.25
*** HOLE CARDS ***
Dealt to matiko09 [Kh 9c]
uzzy20: folds 
Wwwasian: folds 
Depti4: folds 
BaaroRai: folds 
matiko09: raises €0.50 to €0.75
Newbie1990: calls €0.50
*** FLOP *** [3s 5c 9h]
matiko09: bets €0.93
Newbie1990: calls €0.93
*** TURN *** [3s 5c 9h] [9d]
matiko09: checks 
Newbie1990: bets €2.13
matiko09: calls €2.13
*** RIVER *** [3s 5c 9h 9d] [6h]
matiko09: checks 
Newbie1990: bets €4.85
matiko09: calls €4.85
*** SHOW DOWN ***
Newbie1990: shows [As 9s] (three of a kind, Nines)
matiko09: mucks hand 
Newbie1990 collected €16.54 from pot
*** SUMMARY ***
Total pot €17.32 | Rake €0.78 
Board [3s 5c 9h 9d 6h]
Seat 1: matiko09 (small blind) mucked [Kh 9c]
Seat 2: Newbie1990 (big blind) showed [As 9s] and won (€16.54) with three of a kind, Nines
Seat 3: uzzy20 folded before Flop (didn't bet)
Seat 4: Wwwasian folded before Flop (didn't bet)
Seat 5: Depti4 folded before Flop (didn't bet)
Seat 6: BaaroRai (button) folded before Flop (didn't bet)





PokerStars Hand #148210685400:  Hold'em No Limit ($0.10/$0.25 USD) - 2016/02/04 11:21:57 CET [2016/02/04 5:21:57 ET]
Table 'Aquarius II' 6-max Seat #4 is the button
Seat 1: Ciudvdvno ($28.40 in chips) 
Seat 2: ex3Lero86 ($32.59 in chips) 
Seat 3: MyBestPokeR ($28.92 in chips) 
Seat 4: RasmusB79 ($21.27 in chips) 
Seat 5: TroyPoker17 ($27.34 in chips) 
Seat 6: matiko09 ($25.60 in chips) 
TroyPoker17: posts small blind $0.10
matiko09: posts big blind $0.25
*** HOLE CARDS ***
Dealt to matiko09 [4h 2d]
Ciudvdvno: folds 
ex3Lero86: folds 
MyBestPokeR: raises $0.50 to $0.75
RasmusB79: folds 
TroyPoker17 is disconnected 
TroyPoker17 has timed out while disconnected
TroyPoker17: folds 
matiko09: folds 
Uncalled bet ($0.50) returned to MyBestPokeR
MyBestPokeR collected $0.60 from pot
*** SUMMARY ***
Total pot $0.60 | Rake $0 
Seat 1: Ciudvdvno folded before Flop (didn't bet)
Seat 2: ex3Lero86 folded before Flop (didn't bet)
Seat 3: MyBestPokeR collected ($0.60)
Seat 4: RasmusB79 (button) folded before Flop (didn't bet)
Seat 5: TroyPoker17 (small blind) folded before Flop
Seat 6: matiko09 (big blind) folded before Flop





PokerStars Hand #148210691371:  Hold'em No Limit ($0.10/$0.25 USD) - 2016/02/04 11:22:08 CET [2016/02/04 5:22:08 ET]
Table 'Golson' 6-max Seat #1 is the button
Seat 1: Ciudvdvno ($27.50 in chips) 
Seat 2: nnVinokurov ($32.59 in chips) 
Seat 3: Mirking2708 ($20.27 in chips) 
Seat 4: matiko09 ($25 in chips) 
Seat 5: Newbie1990 ($26.11 in chips) 
Seat 6: Wwwasian ($25 in chips) 
nnVinokurov: posts small blind $0.10
Mirking2708: posts big blind $0.25
*** HOLE CARDS ***
Dealt to matiko09 [As 9d]
matiko09: folds 
Newbie1990: folds 
Wwwasian: folds 
Ciudvdvno: folds 
nnVinokurov: folds 
Uncalled bet ($0.15) returned to Mirking2708
Mirking2708 collected $0.20 from pot
Mirking2708: doesn't show hand 
*** SUMMARY ***
Total pot $0.20 | Rake $0 
Seat 1: Ciudvdvno (button) folded before Flop (didn't bet)
Seat 2: nnVinokurov (small blind) folded before Flop
Seat 3: Mirking2708 (big blind) collected ($0.20)
Seat 4: matiko09 folded before Flop (didn't bet)
Seat 5: Newbie1990 folded before Flop (didn't bet)
Seat 6: Wwwasian folded before Flop (didn't bet)





PokerStars Hand #148210696665:  Hold'em No Limit (€0.10/€0.25 EUR) - 2016/02/04 11:22:19 CET [2016/02/04 5:22:19 ET]
Table 'Zvezdara' 6-max Seat #2 is the button
Seat 2: matiko09 (€40.01 in chips) 
Seat 3: Yegoriy (€28.84 in chips) 
Seat 4: kAfRiNiUs (€36.72 in chips) 
Seat 5: Depti4 (€38.30 in chips) 
Seat 6: marchuchok (€38.27 in chips) 
Yegoriy: posts small blind €0.10
kAfRiNiUs: posts big blind €0.25
*** HOLE CARDS ***
Dealt to matiko09 [3c Qh]
Depti4: folds 
Depti4 leaves the table
marchuchok: folds 
matiko09: folds 
Yegoriy: raises €0.50 to €0.75
kAfRiNiUs: folds 
Uncalled bet (€0.50) returned to Yegoriy
Yegoriy collected €0.50 from pot
Yegoriy: doesn't show hand 
*** SUMMARY ***
Total pot €0.50 | Rake €0 
Seat 2: matiko09 (button) folded before Flop (didn't bet)
Seat 3: Yegoriy (small blind) collected (€0.50)
Seat 4: kAfRiNiUs (big blind) folded before Flop
Seat 5: Depti4 folded before Flop (didn't bet)
Seat 6: marchuchok folded before Flop (didn't bet)





PokerStars Hand #148210697883:  Hold'em No Limit ($0.10/$0.25 USD) - 2016/02/04 11:22:21 CET [2016/02/04 5:22:21 ET]
Table 'Golson' 6-max Seat #2 is the button
Seat 1: Ciudvdvno ($27.50 in chips) 
Seat 2: nnVinokurov ($32.49 in chips) 
Seat 3: Mirking2708 ($20.37 in chips) 
Seat 4: matiko09 ($25 in chips) 
Seat 5: Newbie1990 ($26.11 in chips) 
Seat 6: Wwwasian ($25 in chips) 
Mirking2708: posts small blind $0.10
matiko09: posts big blind $0.25
*** HOLE CARDS ***
Dealt to matiko09 [3s 2d]
Newbie1990: folds 
Wwwasian: folds 
Ciudvdvno: folds 
nnVinokurov: raises $0.25 to $0.50
Mirking2708: calls $0.40
matiko09: folds 
*** FLOP *** [As 6h Kc]
Mirking2708: checks 
nnVinokurov: bets $0.75
Mirking2708: calls $0.75
*** TURN *** [As 6h Kc] [Qd]
Mirking2708: checks 
nnVinokurov: bets $1.75
Mirking2708: calls $1.75
*** RIVER *** [As 6h Kc Qd] [2c]
Mirking2708: bets $1.50
nnVinokurov: raises $27.99 to $29.49 and is all-in
Mirking2708: folds 
Uncalled bet ($27.99) returned to nnVinokurov
nnVinokurov collected $8.83 from pot
nnVinokurov: doesn't show hand 
*** SUMMARY ***
Total pot $9.25 | Rake $0.42 
Board [As 6h Kc Qd 2c]
Seat 1: Ciudvdvno folded before Flop (didn't bet)
Seat 2: nnVinokurov (button) collected ($8.83)
Seat 3: Mirking2708 (small blind) folded on the River
Seat 4: matiko09 (big blind) folded before Flop
Seat 5: Newbie1990 folded before Flop (didn't bet)
Seat 6: Wwwasian folded before Flop (didn't bet)





PokerStars Hand #148210710452:  Hold'em No Limit (€0.10/€0.25 EUR) - 2016/02/04 11:22:47 CET [2016/02/04 5:22:47 ET]
Table 'Zvezdara' 6-max Seat #3 is the button
Seat 2: matiko09 (€40.01 in chips) 
Seat 3: Yegoriy (€29.09 in chips) 
Seat 4: kAfRiNiUs (€36.47 in chips) 
Seat 6: marchuchok (€38.27 in chips) 
kAfRiNiUs: posts small blind €0.10
marchuchok: posts big blind €0.25
*** HOLE CARDS ***
Dealt to matiko09 [Tc 5d]
matiko09: folds 
Yegoriy: raises €0.35 to €0.60
kAfRiNiUs: folds 
marchuchok: folds 
Uncalled bet (€0.35) returned to Yegoriy
Yegoriy collected €0.60 from pot
*** SUMMARY ***
Total pot €0.60 | Rake €0 
Seat 2: matiko09 folded before Flop (didn't bet)
Seat 3: Yegoriy (button) collected (€0.60)
Seat 4: kAfRiNiUs (small blind) folded before Flop
Seat 6: marchuchok (big blind) folded before Flop





PokerStars Hand #148210715274:  Hold'em No Limit ($0.10/$0.25 USD) - 2016/02/04 11:22:57 CET [2016/02/04 5:22:57 ET]
Table 'Aquarius II' 6-max Seat #6 is the button
Seat 1: Ciudvdvno ($28.40 in chips) 
Seat 2: ex3Lero86 ($32.59 in chips) 
Seat 3: MyBestPokeR ($29.27 in chips) 
Seat 4: RasmusB79 ($21.27 in chips) 
Seat 6: matiko09 ($25.35 in chips) 
Ciudvdvno: posts small blind $0.10
ex3Lero86: posts big blind $0.25
*** HOLE CARDS ***
Dealt to matiko09 [Ts 8d]
MyBestPokeR: raises $0.50 to $0.75
RasmusB79: folds 
matiko09: folds 
Ciudvdvno: folds 
ex3Lero86: folds 
Uncalled bet ($0.50) returned to MyBestPokeR
MyBestPokeR collected $0.60 from pot
*** SUMMARY ***
Total pot $0.60 | Rake $0 
Seat 1: Ciudvdvno (small blind) folded before Flop
Seat 2: ex3Lero86 (big blind) folded before Flop
Seat 3: MyBestPokeR collected ($0.60)
Seat 4: RasmusB79 folded before Flop (didn't bet)
Seat 6: matiko09 (button) folded before Flop (didn't bet)





PokerStars Hand #148210717462:  Hold'em No Limit (€0.10/€0.25 EUR) - 2016/02/04 11:23:01 CET [2016/02/04 5:23:01 ET]
Table 'Zvezdara' 6-max Seat #4 is the button
Seat 2: matiko09 (€40.01 in chips) 
Seat 3: Yegoriy (€29.44 in chips) 
Seat 4: kAfRiNiUs (€36.37 in chips) 
Seat 6: marchuchok (€38.02 in chips) 
marchuchok: posts small blind €0.10
matiko09: posts big blind €0.25
*** HOLE CARDS ***
Dealt to matiko09 [8d Ac]
Yegoriy: folds 
kAfRiNiUs: raises €0.25 to €0.50
marchuchok: folds 
matiko09: calls €0.25
*** FLOP *** [7c 6c 5c]
endeavoor joins the table at seat #5 
matiko09: checks 
kAfRiNiUs: checks 
*** TURN *** [7c 6c 5c] [Qc]
matiko09: bets €0.68
kAfRiNiUs: folds 
Uncalled bet (€0.68) returned to matiko09
matiko09 collected €1.05 from pot
matiko09: doesn't show hand 
*** SUMMARY ***
Total pot €1.10 | Rake €0.05 
Board [7c 6c 5c Qc]
Seat 2: matiko09 (big blind) collected (€1.05)
Seat 3: Yegoriy folded before Flop (didn't bet)
Seat 4: kAfRiNiUs (button) folded on the Turn
Seat 6: marchuchok (small blind) folded before Flop





PokerStars Hand #148210720348:  Hold'em No Limit (€0.10/€0.25 EUR) - 2016/02/04 11:23:07 CET [2016/02/04 5:23:07 ET]
Table 'Lilaea III' 6-max Seat #1 is the button
Seat 1: matiko09 (€25 in chips) 
Seat 2: Newbie1990 (€36.86 in chips) 
Seat 3: uzzy20 (€25 in chips) 
Seat 4: Wwwasian (€29.74 in chips) 
Seat 5: Depti4 (€28.23 in chips) 
Seat 6: BaaroRai (€28.57 in chips) 
Newbie1990: posts small blind €0.10
uzzy20: posts big blind €0.25
*** HOLE CARDS ***
Dealt to matiko09 [7d Kh]
Wwwasian: folds 
Depti4: folds 
BaaroRai: folds 
matiko09: folds 
Newbie1990: raises €0.37 to €0.62
uzzy20: raises €1.38 to €2
Newbie1990: folds 
Uncalled bet (€1.38) returned to uzzy20
uzzy20 collected €1.24 from pot
*** SUMMARY ***
Total pot €1.24 | Rake €0 
Seat 1: matiko09 (button) folded before Flop (didn't bet)
Seat 2: Newbie1990 (small blind) folded before Flop
Seat 3: uzzy20 (big blind) collected (€1.24)
Seat 4: Wwwasian folded before Flop (didn't bet)
Seat 5: Depti4 folded before Flop (didn't bet)
Seat 6: BaaroRai folded before Flop (didn't bet)





PokerStars Hand #148210727627:  Hold'em No Limit ($0.10/$0.25 USD) - 2016/02/04 11:23:22 CET [2016/02/04 5:23:22 ET]
Table 'Aquarius II' 6-max Seat #1 is the button
Seat 1: Ciudvdvno ($28.30 in chips) 
Seat 2: ex3Lero86 ($32.34 in chips) 
Seat 3: MyBestPokeR ($29.62 in chips) 
Seat 4: RasmusB79 ($21.27 in chips) 
Seat 6: matiko09 ($25.35 in chips) 
ex3Lero86: posts small blind $0.10
MyBestPokeR: posts big blind $0.25
*** HOLE CARDS ***
Dealt to matiko09 [2s 9h]
RasmusB79: calls $0.25
matiko09: folds 
Ciudvdvno: raises $1 to $1.25
ex3Lero86: folds 
MyBestPokeR: folds 
RasmusB79: calls $1
*** FLOP *** [2d 4s 8c]
RasmusB79: checks 
Ciudvdvno: bets $1.36
RasmusB79: folds 
Uncalled bet ($1.36) returned to Ciudvdvno
Ciudvdvno collected $2.72 from pot
*** SUMMARY ***
Total pot $2.85 | Rake $0.13 
Board [2d 4s 8c]
Seat 1: Ciudvdvno (button) collected ($2.72)
Seat 2: ex3Lero86 (small blind) folded before Flop
Seat 3: MyBestPokeR (big blind) folded before Flop
Seat 4: RasmusB79 folded on the Flop
Seat 6: matiko09 folded before Flop (didn't bet)





PokerStars Hand #148210732596:  Hold'em No Limit (€0.10/€0.25 EUR) - 2016/02/04 11:23:32 CET [2016/02/04 5:23:32 ET]
Table 'Zvezdara' 6-max Seat #6 is the button
Seat 2: matiko09 (€40.56 in chips) 
Seat 4: kAfRiNiUs (€35.87 in chips) 
Seat 6: marchuchok (€37.92 in chips) 
matiko09: posts small blind €0.10
Yegoriy: is sitting out 
kAfRiNiUs: posts big blind €0.25
*** HOLE CARDS ***
Dealt to matiko09 [Kc 7s]
marchuchok: folds 
matiko09: folds 
Uncalled bet (€0.15) returned to kAfRiNiUs
kAfRiNiUs collected €0.20 from pot
kAfRiNiUs: doesn't show hand 
*** SUMMARY ***
Total pot €0.20 | Rake €0 
Seat 2: matiko09 (small blind) folded before Flop
Seat 4: kAfRiNiUs (big blind) collected (€0.20)
Seat 6: marchuchok (button) folded before Flop (didn't bet)





PokerStars Hand #148210733382:  Hold'em No Limit (€0.10/€0.25 EUR) - 2016/02/04 11:23:33 CET [2016/02/04 5:23:33 ET]
Table 'Lilaea III' 6-max Seat #2 is the button
Seat 1: matiko09 (€25 in chips) 
Seat 2: Newbie1990 (€36.24 in chips) 
Seat 3: uzzy20 (€25.62 in chips) 
Seat 4: Wwwasian (€29.74 in chips) 
Seat 5: Depti4 (€28.23 in chips) 
Seat 6: BaaroRai (€28.57 in chips) 
uzzy20: posts small blind €0.10
Wwwasian: posts big blind €0.25
*** HOLE CARDS ***
Dealt to matiko09 [Qs Qc]
Depti4: folds 
BaaroRai: calls €0.25
Depti4 leaves the table
matiko09: raises €0.75 to €1
Newbie1990: folds 
uzzy20: folds 
Wwwasian: folds 
BaaroRai: calls €0.75
*** FLOP *** [4d Tc Th]
BaaroRai: checks 
matiko09: bets €1.25
BaaroRai: calls €1.25
*** TURN *** [4d Tc Th] [8s]
BaaroRai: checks 
matiko09: checks 
*** RIVER *** [4d Tc Th 8s] [2d]
BaaroRai: bets €3.75
matiko09: calls €3.75
*** SHOW DOWN ***
BaaroRai: shows [Ac Ad] (two pair, Aces and Tens)
matiko09: mucks hand 
BaaroRai collected €11.79 from pot
*** SUMMARY ***
Total pot €12.35 | Rake €0.56 
Board [4d Tc Th 8s 2d]
Seat 1: matiko09 mucked [Qs Qc]
Seat 2: Newbie1990 (button) folded before Flop (didn't bet)
Seat 3: uzzy20 (small blind) folded before Flop
Seat 4: Wwwasian (big blind) folded before Flop
Seat 5: Depti4 folded before Flop (didn't bet)
Seat 6: BaaroRai showed [Ac Ad] and won (€11.79) with two pair, Aces and Tens





PokerStars Hand #148210733448:  Hold'em No Limit ($0.10/$0.25 USD) - 2016/02/04 11:23:33 CET [2016/02/04 5:23:33 ET]
Table 'Golson' 6-max Seat #3 is the button
Seat 1: Ciudvdvno ($27.50 in chips) 
Seat 2: nnVinokurov ($36.82 in chips) 
Seat 3: Mirking2708 ($15.87 in chips) 
Seat 4: matiko09 ($25 in chips) 
Seat 6: Wwwasian ($25 in chips) 
matiko09: posts small blind $0.10
Newbie1990: is sitting out 
Wwwasian: posts big blind $0.25
*** HOLE CARDS ***
Dealt to matiko09 [4h 8s]
Ciudvdvno: folds 
nnVinokurov: folds 
Mirking2708: folds 
Newbie1990 leaves the table
matiko09: folds 
Uncalled bet ($0.15) returned to Wwwasian
Wwwasian collected $0.20 from pot
Wwwasian: doesn't show hand 
*** SUMMARY ***
Total pot $0.20 | Rake $0 
Seat 1: Ciudvdvno folded before Flop (didn't bet)
Seat 2: nnVinokurov folded before Flop (didn't bet)
Seat 3: Mirking2708 (button) folded before Flop (didn't bet)
Seat 4: matiko09 (small blind) folded before Flop
Seat 6: Wwwasian (big blind) collected ($0.20)





PokerStars Hand #148210736448:  Hold'em No Limit (€0.10/€0.25 EUR) - 2016/02/04 11:23:39 CET [2016/02/04 5:23:39 ET]
Table 'Zvezdara' 6-max Seat #2 is the button
Seat 2: matiko09 (€40.46 in chips) 
Seat 4: kAfRiNiUs (€35.97 in chips) 
Seat 6: marchuchok (€37.92 in chips) 
kAfRiNiUs: posts small blind €0.10
marchuchok: posts big blind €0.25
*** HOLE CARDS ***
Dealt to matiko09 [Kh Js]
Yegoriy leaves the table
matiko09: raises €0.37 to €0.62
kAfRiNiUs: folds 
marchuchok: folds 
Uncalled bet (€0.37) returned to matiko09
matiko09 collected €0.60 from pot
matiko09: doesn't show hand 
*** SUMMARY ***
Total pot €0.60 | Rake €0 
Seat 2: matiko09 (button) collected (€0.60)
Seat 4: kAfRiNiUs (small blind) folded before Flop
Seat 6: marchuchok (big blind) folded before Flop





PokerStars Hand #148210738827:  Hold'em No Limit ($0.10/$0.25 USD) - 2016/02/04 11:23:44 CET [2016/02/04 5:23:44 ET]
Table 'Golson' 6-max Seat #4 is the button
Seat 1: Ciudvdvno ($27.50 in chips) 
Seat 2: nnVinokurov ($36.82 in chips) 
Seat 3: Mirking2708 ($15.87 in chips) 
Seat 4: matiko09 ($25 in chips) 
Seat 6: Wwwasian ($25.10 in chips) 
Wwwasian: posts small blind $0.10
Ciudvdvno: posts big blind $0.25
*** HOLE CARDS ***
Dealt to matiko09 [7d 5h]
nnVinokurov: folds 
Mirking2708: folds 
matiko09: folds 
getaca joins the table at seat #5 
Wwwasian: folds 
Uncalled bet ($0.15) returned to Ciudvdvno
Ciudvdvno collected $0.20 from pot
*** SUMMARY ***
Total pot $0.20 | Rake $0 
Seat 1: Ciudvdvno (big blind) collected ($0.20)
Seat 2: nnVinokurov folded before Flop (didn't bet)
Seat 3: Mirking2708 folded before Flop (didn't bet)
Seat 4: matiko09 (button) folded before Flop (didn't bet)
Seat 6: Wwwasian (small blind) folded before Flop





PokerStars Hand #148210742250:  Hold'em No Limit (€0.10/€0.25 EUR) - 2016/02/04 11:23:51 CET [2016/02/04 5:23:51 ET]
Table 'Zvezdara' 6-max Seat #4 is the button
Seat 2: matiko09 (€40.81 in chips) 
Seat 4: kAfRiNiUs (€35.87 in chips) 
Seat 6: marchuchok (€37.67 in chips) 
marchuchok: posts small blind €0.10
matiko09: posts big blind €0.25
*** HOLE CARDS ***
Dealt to matiko09 [Jh Tc]
kAfRiNiUs: folds 
PotgrabberAA joins the table at seat #3 
PotgrabberAA leaves the table
marchuchok: folds 
Uncalled bet (€0.15) returned to matiko09
matiko09 collected €0.20 from pot
matiko09: doesn't show hand 
*** SUMMARY ***
Total pot €0.20 | Rake €0 
Seat 2: matiko09 (big blind) collected (€0.20)
Seat 4: kAfRiNiUs (button) folded before Flop (didn't bet)
Seat 6: marchuchok (small blind) folded before Flop





PokerStars Hand #148210748989:  Hold'em No Limit (€0.10/€0.25 EUR) - 2016/02/04 11:24:04 CET [2016/02/04 5:24:04 ET]
Table 'Zvezdara' 6-max Seat #6 is the button
Seat 2: matiko09 (€40.91 in chips) 
Seat 4: kAfRiNiUs (€35.87 in chips) 
Seat 6: marchuchok (€37.57 in chips) 
matiko09: posts small blind €0.10
kAfRiNiUs: posts big blind €0.25
*** HOLE CARDS ***
Dealt to matiko09 [2d 7c]
marchuchok: folds 
matiko09: folds 
Uncalled bet (€0.15) returned to kAfRiNiUs
kAfRiNiUs collected €0.20 from pot
kAfRiNiUs: doesn't show hand 
*** SUMMARY ***
Total pot €0.20 | Rake €0 
Seat 2: matiko09 (small blind) folded before Flop
Seat 4: kAfRiNiUs (big blind) collected (€0.20)
Seat 6: marchuchok (button) folded before Flop (didn't bet)





PokerStars Hand #148210749809:  Hold'em No Limit ($0.10/$0.25 USD) - 2016/02/04 11:24:06 CET [2016/02/04 5:24:06 ET]
Table 'Golson' 6-max Seat #6 is the button
Seat 1: Ciudvdvno ($27.60 in chips) 
Seat 2: nnVinokurov ($36.82 in chips) 
Seat 3: Mirking2708 ($15.87 in chips) 
Seat 4: matiko09 ($25 in chips) 
Seat 6: Wwwasian ($25 in chips) 
Ciudvdvno: posts small blind $0.10
nnVinokurov: posts big blind $0.25
getaca: sits out 
*** HOLE CARDS ***
Dealt to matiko09 [Tc Ks]
Mirking2708: folds 
matiko09: raises $0.37 to $0.62
Wwwasian: folds 
Ciudvdvno: folds 
nnVinokurov: folds 
Uncalled bet ($0.37) returned to matiko09
matiko09 collected $0.60 from pot
matiko09: doesn't show hand 
*** SUMMARY ***
Total pot $0.60 | Rake $0 
Seat 1: Ciudvdvno (small blind) folded before Flop
Seat 2: nnVinokurov (big blind) folded before Flop
Seat 3: Mirking2708 folded before Flop (didn't bet)
Seat 4: matiko09 collected ($0.60)
Seat 6: Wwwasian (button) folded before Flop (didn't bet)





PokerStars Hand #148210754801:  Hold'em No Limit ($0.10/$0.25 USD) - 2016/02/04 11:24:16 CET [2016/02/04 5:24:16 ET]
Table 'Hippasos' 6-max Seat #3 is the button
Seat 2: Samerald ($36.89 in chips) 
Seat 3: Fank0_ ($33.97 in chips) 
Seat 4: endeavoor ($25 in chips) 
Seat 6: matiko09 ($25 in chips) 
endeavoor: posts small blind $0.10
matiko09: posts big blind $0.25
mr.djlondon: sits out 
*** HOLE CARDS ***
Dealt to matiko09 [6d Kc]
Samerald: folds 
Fank0_: raises $0.37 to $0.62
endeavoor: folds 
matiko09: folds 
Uncalled bet ($0.37) returned to Fank0_
Fank0_ collected $0.60 from pot
Fank0_: doesn't show hand 
*** SUMMARY ***
Total pot $0.60 | Rake $0 
Seat 2: Samerald folded before Flop (didn't bet)
Seat 3: Fank0_ (button) collected ($0.60)
Seat 4: endeavoor (small blind) folded before Flop
Seat 6: matiko09 (big blind) folded before Flop





PokerStars Hand #148210756767:  Hold'em No Limit (€0.10/€0.25 EUR) - 2016/02/04 11:24:20 CET [2016/02/04 5:24:20 ET]
Table 'Zvezdara' 6-max Seat #2 is the button
Seat 2: matiko09 (€40.81 in chips) 
Seat 4: kAfRiNiUs (€35.97 in chips) 
Seat 6: marchuchok (€37.57 in chips) 
kAfRiNiUs: posts small blind €0.10
marchuchok: posts big blind €0.25
*** HOLE CARDS ***
Dealt to matiko09 [3h 8s]
matiko09: folds 
kAfRiNiUs: folds 
Uncalled bet (€0.15) returned to marchuchok
matiko09 leaves the table
marchuchok collected €0.20 from pot
marchuchok: doesn't show hand 
*** SUMMARY ***
Total pot €0.20 | Rake €0 
Seat 2: matiko09 (button) folded before Flop (didn't bet)
Seat 4: kAfRiNiUs (small blind) folded before Flop
Seat 6: marchuchok (big blind) collected (€0.20)





PokerStars Hand #148210759395:  Hold'em No Limit (€0.10/€0.25 EUR) - 2016/02/04 11:24:26 CET [2016/02/04 5:24:26 ET]
Table 'Lilaea III' 6-max Seat #3 is the button
Seat 1: matiko09 (€25 in chips) 
Seat 2: Newbie1990 (€36.24 in chips) 
Seat 3: uzzy20 (€25.52 in chips) 
Seat 4: Wwwasian (€29.49 in chips) 
Seat 6: BaaroRai (€34.36 in chips) 
Wwwasian: posts small blind €0.10
BaaroRai: posts big blind €0.25
*** HOLE CARDS ***
Dealt to matiko09 [Qh Kd]
matiko09: raises €0.50 to €0.75
angrypaca joins the table at seat #5 
Newbie1990: raises €1.75 to €2.50
uzzy20: folds 
Wwwasian: folds 
BaaroRai: folds 
matiko09: folds 
Uncalled bet (€1.75) returned to Newbie1990
Newbie1990 collected €1.85 from pot
Newbie1990: doesn't show hand 
*** SUMMARY ***
Total pot €1.85 | Rake €0 
Seat 1: matiko09 folded before Flop
Seat 2: Newbie1990 collected (€1.85)
Seat 3: uzzy20 (button) folded before Flop (didn't bet)
Seat 4: Wwwasian (small blind) folded before Flop
Seat 6: BaaroRai (big blind) folded before Flop





PokerStars Hand #148210764851:  Hold'em No Limit ($0.10/$0.25 USD) - 2016/02/04 11:24:37 CET [2016/02/04 5:24:37 ET]
Table 'Hippasos' 6-max Seat #4 is the button
Seat 1: mr.djlondon ($63.03 in chips) 
Seat 2: Samerald ($36.89 in chips) 
Seat 3: Fank0_ ($34.32 in chips) 
Seat 4: endeavoor ($25 in chips) 
Seat 6: matiko09 ($25 in chips) 
matiko09: posts small blind $0.10
mr.djlondon: posts big blind $0.25
*** HOLE CARDS ***
Dealt to matiko09 [5s Jh]
Samerald: folds 
Fank0_: folds 
endeavoor: raises $0.25 to $0.50
matiko09: folds 
mr.djlondon: folds 
Uncalled bet ($0.25) returned to endeavoor
endeavoor collected $0.60 from pot
endeavoor: doesn't show hand 
*** SUMMARY ***
Total pot $0.60 | Rake $0 
Seat 1: mr.djlondon (big blind) folded before Flop
Seat 2: Samerald folded before Flop (didn't bet)
Seat 3: Fank0_ folded before Flop (didn't bet)
Seat 4: endeavoor (button) collected ($0.60)
Seat 6: matiko09 (small blind) folded before Flop





PokerStars Hand #148210765412:  Hold'em No Limit ($0.10/$0.25 USD) - 2016/02/04 11:24:38 CET [2016/02/04 5:24:38 ET]
Table 'Aquarius II' 6-max Seat #2 is the button
Seat 1: Ciudvdvno ($29.77 in chips) 
Seat 2: ex3Lero86 ($32.24 in chips) 
Seat 3: MyBestPokeR ($29.37 in chips) 
Seat 4: RasmusB79 ($20.02 in chips) 
Seat 5: TroyPoker17 ($27.24 in chips) 
Seat 6: matiko09 ($25.35 in chips) 
MyBestPokeR: posts small blind $0.10
RasmusB79: posts big blind $0.25
*** HOLE CARDS ***
Dealt to matiko09 [Td Ad]
TroyPoker17: folds 
matiko09: raises $0.50 to $0.75
Ciudvdvno: calls $0.75
ex3Lero86: folds 
MyBestPokeR: folds 
RasmusB79: folds 
*** FLOP *** [7d Kd Jd]
matiko09: bets $1.15
Ciudvdvno: folds 
Uncalled bet ($1.15) returned to matiko09
matiko09 collected $1.77 from pot
matiko09: doesn't show hand 
*** SUMMARY ***
Total pot $1.85 | Rake $0.08 
Board [7d Kd Jd]
Seat 1: Ciudvdvno folded on the Flop
Seat 2: ex3Lero86 (button) folded before Flop (didn't bet)
Seat 3: MyBestPokeR (small blind) folded before Flop
Seat 4: RasmusB79 (big blind) folded before Flop
Seat 5: TroyPoker17 folded before Flop (didn't bet)
Seat 6: matiko09 collected ($1.77)





PokerStars Hand #148210772208:  Hold'em No Limit (€0.10/€0.25 EUR) - 2016/02/04 11:24:51 CET [2016/02/04 5:24:51 ET]
Table 'Lilaea III' 6-max Seat #4 is the button
Seat 1: matiko09 (€25 in chips) 
Seat 2: Newbie1990 (€37.34 in chips) 
Seat 3: uzzy20 (€25.52 in chips) 
Seat 4: Wwwasian (€29.39 in chips) 
Seat 6: BaaroRai (€34.11 in chips) 
angrypaca will be allowed to play after the button
BaaroRai: posts small blind €0.10
matiko09: posts big blind €0.25
*** HOLE CARDS ***
Dealt to matiko09 [6s 8c]
Newbie1990: raises €0.45 to €0.70
uzzy20: folds 
Wwwasian: folds 
BaaroRai: calls €0.60
matiko09: folds 
*** FLOP *** [Ks 5d Js]
BaaroRai: checks 
Newbie1990: bets €0.75
BaaroRai: folds 
Uncalled bet (€0.75) returned to Newbie1990
Newbie1990 collected €1.58 from pot
Newbie1990: doesn't show hand 
*** SUMMARY ***
Total pot €1.65 | Rake €0.07 
Board [Ks 5d Js]
Seat 1: matiko09 (big blind) folded before Flop
Seat 2: Newbie1990 collected (€1.58)
Seat 3: uzzy20 folded before Flop (didn't bet)
Seat 4: Wwwasian (button) folded before Flop (didn't bet)
Seat 6: BaaroRai (small blind) folded on the Flop





PokerStars Hand #148210774598:  Hold'em No Limit ($0.10/$0.25 USD) - 2016/02/04 11:24:56 CET [2016/02/04 5:24:56 ET]
Table 'Golson' 6-max Seat #1 is the button
Seat 1: Ciudvdvno ($27.50 in chips) 
Seat 2: nnVinokurov ($36.57 in chips) 
Seat 3: Mirking2708 ($15.87 in chips) 
Seat 4: matiko09 ($25.35 in chips) 
Seat 6: Wwwasian ($25 in chips) 
nnVinokurov: posts small blind $0.10
Mirking2708: posts big blind $0.25
getaca: sits out 
*** HOLE CARDS ***
Dealt to matiko09 [Ks Kc]
matiko09: raises $0.50 to $0.75
Wwwasian: folds 
Ciudvdvno: folds 
nnVinokurov: folds 
Mirking2708: folds 
Uncalled bet ($0.50) returned to matiko09
matiko09 collected $0.60 from pot
matiko09: doesn't show hand 
*** SUMMARY ***
Total pot $0.60 | Rake $0 
Seat 1: Ciudvdvno (button) folded before Flop (didn't bet)
Seat 2: nnVinokurov (small blind) folded before Flop
Seat 3: Mirking2708 (big blind) folded before Flop
Seat 4: matiko09 collected ($0.60)
Seat 6: Wwwasian folded before Flop (didn't bet)





PokerStars Hand #148210775203:  Hold'em No Limit ($0.10/$0.25 USD) - 2016/02/04 11:24:57 CET [2016/02/04 5:24:57 ET]
Table 'Hippasos' 6-max Seat #6 is the button
Seat 1: mr.djlondon ($62.78 in chips) 
Seat 2: Samerald ($36.89 in chips) 
Seat 3: Fank0_ ($34.32 in chips) 
Seat 4: endeavoor ($25.35 in chips) 
Seat 6: matiko09 ($25 in chips) 
mr.djlondon: posts small blind $0.10
Samerald: posts big blind $0.25
*** HOLE CARDS ***
Dealt to matiko09 [9c 5d]
Fank0_: folds 
endeavoor: folds 
matiko09: folds 
mr.djlondon: folds 
Uncalled bet ($0.15) returned to Samerald
Samerald collected $0.20 from pot
*** SUMMARY ***
Total pot $0.20 | Rake $0 
Seat 1: mr.djlondon (small blind) folded before Flop
Seat 2: Samerald (big blind) collected ($0.20)
Seat 3: Fank0_ folded before Flop (didn't bet)
Seat 4: endeavoor folded before Flop (didn't bet)
Seat 6: matiko09 (button) folded before Flop (didn't bet)





PokerStars Hand #148210780533:  Hold'em No Limit ($0.10/$0.25 USD) - 2016/02/04 11:25:08 CET [2016/02/04 5:25:08 ET]
Table 'Aquarius II' 6-max Seat #3 is the button
Seat 1: Ciudvdvno ($29.02 in chips) 
Seat 2: ex3Lero86 ($32.24 in chips) 
Seat 3: MyBestPokeR ($29.27 in chips) 
Seat 4: RasmusB79 ($19.77 in chips) 
Seat 5: TroyPoker17 ($27.24 in chips) 
Seat 6: matiko09 ($26.37 in chips) 
RasmusB79: posts small blind $0.10
TroyPoker17: posts big blind $0.25
*** HOLE CARDS ***
Dealt to matiko09 [Ks 4d]
matiko09: folds 
Ciudvdvno: folds 
ex3Lero86: folds 
MyBestPokeR: raises $0.37 to $0.62
RasmusB79: calls $0.52
TroyPoker17: raises $1.88 to $2.50
MyBestPokeR: folds 
RasmusB79: calls $1.88
*** FLOP *** [Qh Td 7h]
RasmusB79: checks 
TroyPoker17: bets $2.68
RasmusB79: folds 
Uncalled bet ($2.68) returned to TroyPoker17
TroyPoker17 collected $5.37 from pot
TroyPoker17: doesn't show hand 
*** SUMMARY ***
Total pot $5.62 | Rake $0.25 
Board [Qh Td 7h]
Seat 1: Ciudvdvno folded before Flop (didn't bet)
Seat 2: ex3Lero86 folded before Flop (didn't bet)
Seat 3: MyBestPokeR (button) folded before Flop
Seat 4: RasmusB79 (small blind) folded on the Flop
Seat 5: TroyPoker17 (big blind) collected ($5.37)
Seat 6: matiko09 folded before Flop (didn't bet)





PokerStars Hand #148210784910:  Hold'em No Limit ($0.10/$0.25 USD) - 2016/02/04 11:25:17 CET [2016/02/04 5:25:17 ET]
Table 'Golson' 6-max Seat #2 is the button
Seat 1: Ciudvdvno ($27.50 in chips) 
Seat 2: nnVinokurov ($36.47 in chips) 
Seat 3: Mirking2708 ($15.62 in chips) 
Seat 4: matiko09 ($25.70 in chips) 
Seat 6: Wwwasian ($25 in chips) 
Mirking2708: posts small blind $0.10
matiko09: posts big blind $0.25
getaca: sits out 
*** HOLE CARDS ***
Dealt to matiko09 [Ts 3h]
Wwwasian: raises $0.45 to $0.70
Ciudvdvno: folds 
nnVinokurov: folds 
Mirking2708: folds 
matiko09: folds 
Uncalled bet ($0.45) returned to Wwwasian
Wwwasian collected $0.60 from pot
Wwwasian: doesn't show hand 
*** SUMMARY ***
Total pot $0.60 | Rake $0 
Seat 1: Ciudvdvno folded before Flop (didn't bet)
Seat 2: nnVinokurov (button) folded before Flop (didn't bet)
Seat 3: Mirking2708 (small blind) folded before Flop
Seat 4: matiko09 (big blind) folded before Flop
Seat 6: Wwwasian collected ($0.60)





PokerStars Hand #148210785666:  Hold'em No Limit ($0.10/$0.25 USD) - 2016/02/04 11:25:18 CET [2016/02/04 5:25:18 ET]
Table 'Hippasos' 6-max Seat #2 is the button
Seat 2: Samerald ($36.99 in chips) 
Seat 3: Fank0_ ($34.32 in chips) 
Seat 4: endeavoor ($25.35 in chips) 
Seat 6: matiko09 ($25 in chips) 
Fank0_: posts small blind $0.10
endeavoor: posts big blind $0.25
*** HOLE CARDS ***
Dealt to matiko09 [6d 8d]
matiko09: folds 
Samerald: folds 
Fank0_: folds 
Uncalled bet ($0.15) returned to endeavoor
endeavoor collected $0.20 from pot
endeavoor: doesn't show hand 
*** SUMMARY ***
Total pot $0.20 | Rake $0 
Seat 2: Samerald (button) folded before Flop (didn't bet)
Seat 3: Fank0_ (small blind) folded before Flop
Seat 4: endeavoor (big blind) collected ($0.20)
Seat 6: matiko09 folded before Flop (didn't bet)





PokerStars Hand #148210790208:  Hold'em No Limit ($0.10/$0.25 USD) - 2016/02/04 11:25:28 CET [2016/02/04 5:25:28 ET]
Table 'Hippasos' 6-max Seat #3 is the button
Seat 2: Samerald ($36.99 in chips) 
Seat 3: Fank0_ ($34.22 in chips) 
Seat 4: endeavoor ($25.45 in chips) 
Seat 6: matiko09 ($25 in chips) 
endeavoor: posts small blind $0.10
matiko09: posts big blind $0.25
*** HOLE CARDS ***
Dealt to matiko09 [Th 3s]
Samerald: folds 
Fank0_: folds 
endeavoor: raises $0.50 to $0.75
matiko09: folds 
Uncalled bet ($0.50) returned to endeavoor
endeavoor collected $0.50 from pot
endeavoor: doesn't show hand 
*** SUMMARY ***
Total pot $0.50 | Rake $0 
Seat 2: Samerald folded before Flop (didn't bet)
Seat 3: Fank0_ (button) folded before Flop (didn't bet)
Seat 4: endeavoor (small blind) collected ($0.50)
Seat 6: matiko09 (big blind) folded before Flop





PokerStars Hand #148210797092:  Hold'em No Limit (€0.10/€0.25 EUR) - 2016/02/04 11:25:41 CET [2016/02/04 5:25:41 ET]
Table 'Lilaea III' 6-max Seat #6 is the button
Seat 1: matiko09 (€25 in chips) 
Seat 2: Newbie1990 (€38.22 in chips) 
Seat 3: uzzy20 (€25.52 in chips) 
Seat 4: Wwwasian (€29.39 in chips) 
Seat 6: BaaroRai (€33.41 in chips) 
matiko09: posts small blind €0.10
Newbie1990: posts big blind €0.25
angrypaca: sits out 
*** HOLE CARDS ***
Dealt to matiko09 [3h 3c]
uzzy20: folds 
Wwwasian: folds 
BaaroRai: folds 
matiko09: raises €0.50 to €0.75
Newbie1990: raises €1.50 to €2.25
matiko09: folds 
Uncalled bet (€1.50) returned to Newbie1990
Newbie1990 collected €1.50 from pot
Newbie1990: doesn't show hand 
*** SUMMARY ***
Total pot €1.50 | Rake €0 
Seat 1: matiko09 (small blind) folded before Flop
Seat 2: Newbie1990 (big blind) collected (€1.50)
Seat 3: uzzy20 folded before Flop (didn't bet)
Seat 4: Wwwasian folded before Flop (didn't bet)
Seat 6: BaaroRai (button) folded before Flop (didn't bet)





PokerStars Hand #148210798154:  Hold'em No Limit ($0.10/$0.25 USD) - 2016/02/04 11:25:44 CET [2016/02/04 5:25:44 ET]
Table 'Golson' 6-max Seat #3 is the button
Seat 1: Ciudvdvno ($27.50 in chips) 
Seat 2: nnVinokurov ($36.47 in chips) 
Seat 3: Mirking2708 ($15.52 in chips) 
Seat 4: matiko09 ($25.45 in chips) 
Seat 5: getaca ($25.60 in chips) 
Seat 6: Wwwasian ($25.35 in chips) 
matiko09: posts small blind $0.10
getaca: posts big blind $0.25
*** HOLE CARDS ***
Dealt to matiko09 [Kh 4h]
Wwwasian: folds 
Ciudvdvno: folds 
nnVinokurov: folds 
Mirking2708: calls $0.25
matiko09: folds 
getaca: checks 
*** FLOP *** [3s Kd Td]
getaca: checks 
Mirking2708: checks 
*** TURN *** [3s Kd Td] [2h]
getaca: checks 
Mirking2708: bets $0.25
getaca: folds 
Uncalled bet ($0.25) returned to Mirking2708
Mirking2708 collected $0.57 from pot
Mirking2708: doesn't show hand 
*** SUMMARY ***
Total pot $0.60 | Rake $0.03 
Board [3s Kd Td 2h]
Seat 1: Ciudvdvno folded before Flop (didn't bet)
Seat 2: nnVinokurov folded before Flop (didn't bet)
Seat 3: Mirking2708 (button) collected ($0.57)
Seat 4: matiko09 (small blind) folded before Flop
Seat 5: getaca (big blind) folded on the Turn
Seat 6: Wwwasian folded before Flop (didn't bet)





PokerStars Hand #148210798906:  Hold'em No Limit ($0.10/$0.25 USD) - 2016/02/04 11:25:45 CET [2016/02/04 5:25:45 ET]
Table 'Hippasos' 6-max Seat #4 is the button
Seat 2: Samerald ($36.99 in chips) 
Seat 3: Fank0_ ($34.22 in chips) 
Seat 4: endeavoor ($25.70 in chips) 
Seat 6: matiko09 ($25 in chips) 
matiko09: posts small blind $0.10
Samerald: posts big blind $0.25
*** HOLE CARDS ***
Dealt to matiko09 [Ad Ts]
Fank0_: folds 
endeavoor: raises $0.25 to $0.50
mr.djlondon leaves the table
VreDnYY joins the table at seat #1 
matiko09: raises $1.15 to $1.65
Samerald: folds 
endeavoor: folds 
Uncalled bet ($1.15) returned to matiko09
matiko09 collected $1.25 from pot
matiko09: doesn't show hand 
*** SUMMARY ***
Total pot $1.25 | Rake $0 
Seat 2: Samerald (big blind) folded before Flop
Seat 3: Fank0_ folded before Flop (didn't bet)
Seat 4: endeavoor (button) folded before Flop
Seat 6: matiko09 (small blind) collected ($1.25)





PokerStars Hand #148210803983:  Hold'em No Limit ($0.10/$0.25 USD) - 2016/02/04 11:25:55 CET [2016/02/04 5:25:55 ET]
Table 'Aquarius II' 6-max Seat #4 is the button
Seat 1: Ciudvdvno ($29.02 in chips) 
Seat 2: ex3Lero86 ($32.24 in chips) 
Seat 3: MyBestPokeR ($28.65 in chips) 
Seat 4: RasmusB79 ($17.27 in chips) 
Seat 5: TroyPoker17 ($30.11 in chips) 
Seat 6: matiko09 ($26.37 in chips) 
TroyPoker17: posts small blind $0.10
matiko09: posts big blind $0.25
*** HOLE CARDS ***
Dealt to matiko09 [7h 2h]
Ciudvdvno: raises $0.50 to $0.75
ex3Lero86: folds 
MyBestPokeR: folds 
RasmusB79: folds 
TroyPoker17: folds 
matiko09: folds 
Uncalled bet ($0.50) returned to Ciudvdvno
Ciudvdvno collected $0.60 from pot
*** SUMMARY ***
Total pot $0.60 | Rake $0 
Seat 1: Ciudvdvno collected ($0.60)
Seat 2: ex3Lero86 folded before Flop (didn't bet)
Seat 3: MyBestPokeR folded before Flop (didn't bet)
Seat 4: RasmusB79 (button) folded before Flop (didn't bet)
Seat 5: TroyPoker17 (small blind) folded before Flop
Seat 6: matiko09 (big blind) folded before Flop





PokerStars Hand #148210805194:  Hold'em No Limit ($0.10/$0.25 USD) - 2016/02/04 11:25:58 CET [2016/02/04 5:25:58 ET]
Table 'Thora II' 6-max Seat #2 is the button
Seat 2: schatun774 ($12.09 in chips) 
Seat 3: Odmincheg ($25.56 in chips) 
Seat 4: matiko09 ($25 in chips) 
Seat 6: $243.31 ($20 in chips) 
Odmincheg: posts small blind $0.10
matiko09: posts big blind $0.25
A_priori_xD: sits out 
$243.31: posts big blind $0.25
*** HOLE CARDS ***
Dealt to matiko09 [2c 2s]
$243.31: raises $0.75 to $1
schatun774: calls $1
Odmincheg: folds 
matiko09: calls $0.75
*** FLOP *** [5d 6s Th]
matiko09: checks 
$243.31: bets $1.48
schatun774: folds 
matiko09: folds 
Uncalled bet ($1.48) returned to $243.31
$243.31 collected $2.96 from pot
$243.31: doesn't show hand 
*** SUMMARY ***
Total pot $3.10 | Rake $0.14 
Board [5d 6s Th]
Seat 2: schatun774 (button) folded on the Flop
Seat 3: Odmincheg (small blind) folded before Flop
Seat 4: matiko09 (big blind) folded on the Flop
Seat 6: $243.31 collected ($2.96)





PokerStars Hand #148210812932:  Hold'em No Limit (€0.10/€0.25 EUR) - 2016/02/04 11:26:13 CET [2016/02/04 5:26:13 ET]
Table 'Lilaea III' 6-max Seat #1 is the button
Seat 1: matiko09 (€25 in chips) 
Seat 2: Newbie1990 (€38.97 in chips) 
Seat 3: uzzy20 (€25.52 in chips) 
Seat 4: Wwwasian (€29.39 in chips) 
Seat 6: BaaroRai (€33.41 in chips) 
Newbie1990: posts small blind €0.10
uzzy20: posts big blind €0.25
*** HOLE CARDS ***
Dealt to matiko09 [Qc Jh]
Wwwasian: folds 
BaaroRai: folds 
matiko09: raises €0.37 to €0.62
Newbie1990: folds 
uzzy20: folds 
Uncalled bet (€0.37) returned to matiko09
matiko09 collected €0.60 from pot
matiko09: doesn't show hand 
*** SUMMARY ***
Total pot €0.60 | Rake €0 
Seat 1: matiko09 (button) collected (€0.60)
Seat 2: Newbie1990 (small blind) folded before Flop
Seat 3: uzzy20 (big blind) folded before Flop
Seat 4: Wwwasian folded before Flop (didn't bet)
Seat 6: BaaroRai folded before Flop (didn't bet)





PokerStars Hand #148210814840:  Hold'em No Limit ($0.10/$0.25 USD) - 2016/02/04 11:26:17 CET [2016/02/04 5:26:17 ET]
Table 'Golson' 6-max Seat #4 is the button
Seat 1: Ciudvdvno ($27.50 in chips) 
Seat 2: nnVinokurov ($36.47 in chips) 
Seat 3: Mirking2708 ($15.84 in chips) 
Seat 4: matiko09 ($25.35 in chips) 
Seat 5: getaca ($25.35 in chips) 
Seat 6: Wwwasian ($25.35 in chips) 
getaca: posts small blind $0.10
Wwwasian: posts big blind $0.25
*** HOLE CARDS ***
Dealt to matiko09 [3h 6s]
Ciudvdvno: folds 
nnVinokurov: folds 
Mirking2708: folds 
matiko09: folds 
getaca: folds 
Uncalled bet ($0.15) returned to Wwwasian
Wwwasian collected $0.20 from pot
Wwwasian: doesn't show hand 
*** SUMMARY ***
Total pot $0.20 | Rake $0 
Seat 1: Ciudvdvno folded before Flop (didn't bet)
Seat 2: nnVinokurov folded before Flop (didn't bet)
Seat 3: Mirking2708 folded before Flop (didn't bet)
Seat 4: matiko09 (button) folded before Flop (didn't bet)
Seat 5: getaca (small blind) folded before Flop
Seat 6: Wwwasian (big blind) collected ($0.20)





PokerStars Hand #148210818211:  Hold'em No Limit ($0.10/$0.25 USD) - 2016/02/04 11:26:24 CET [2016/02/04 5:26:24 ET]
Table 'Hippasos' 6-max Seat #6 is the button
Seat 2: Samerald ($36.74 in chips) 
Seat 3: Fank0_ ($34.22 in chips) 
Seat 4: endeavoor ($25.20 in chips) 
Seat 6: matiko09 ($25.75 in chips) 
VreDnYY will be allowed to play after the button
Samerald: posts small blind $0.10
Fank0_: posts big blind $0.25
popis1P3: sits out 
*** HOLE CARDS ***
Dealt to matiko09 [6c 2s]
endeavoor: raises $0.35 to $0.60
matiko09: folds 
Samerald: folds 
Fank0_: folds 
Uncalled bet ($0.35) returned to endeavoor
endeavoor collected $0.60 from pot
endeavoor: doesn't show hand 
*** SUMMARY ***
Total pot $0.60 | Rake $0 
Seat 2: Samerald (small blind) folded before Flop
Seat 3: Fank0_ (big blind) folded before Flop
Seat 4: endeavoor collected ($0.60)
Seat 6: matiko09 (button) folded before Flop (didn't bet)





PokerStars Hand #148210821096:  Hold'em No Limit ($0.10/$0.25 USD) - 2016/02/04 11:26:30 CET [2016/02/04 5:26:30 ET]
Table 'Aquarius II' 6-max Seat #5 is the button
Seat 1: Ciudvdvno ($29.37 in chips) 
Seat 2: ex3Lero86 ($32.24 in chips) 
Seat 3: MyBestPokeR ($28.65 in chips) 
Seat 4: RasmusB79 ($17.27 in chips) 
Seat 5: TroyPoker17 ($30.01 in chips) 
Seat 6: matiko09 ($26.12 in chips) 
matiko09: posts small blind $0.10
Ciudvdvno: posts big blind $0.25
*** HOLE CARDS ***
Dealt to matiko09 [3h 6c]
ex3Lero86: folds 
MyBestPokeR: folds 
RasmusB79: calls $0.25
TroyPoker17: folds 
matiko09: folds 
Ciudvdvno: checks 
*** FLOP *** [8h Td Kc]
Ciudvdvno: bets $0.37
RasmusB79: calls $0.37
*** TURN *** [8h Td Kc] [8d]
Ciudvdvno: bets $1
RasmusB79: raises $1 to $2
Ciudvdvno: calls $1
*** RIVER *** [8h Td Kc 8d] [As]
Ciudvdvno: checks 
RasmusB79: bets $2
Ciudvdvno: calls $2
*** SHOW DOWN ***
RasmusB79: shows [9c Th] (two pair, Tens and Eights)
Ciudvdvno: shows [8s 4c] (three of a kind, Eights)
Ciudvdvno collected $8.92 from pot
*** SUMMARY ***
Total pot $9.34 | Rake $0.42 
Board [8h Td Kc 8d As]
Seat 1: Ciudvdvno (big blind) showed [8s 4c] and won ($8.92) with three of a kind, Eights
Seat 2: ex3Lero86 folded before Flop (didn't bet)
Seat 3: MyBestPokeR folded before Flop (didn't bet)
Seat 4: RasmusB79 showed [9c Th] and lost with two pair, Tens and Eights
Seat 5: TroyPoker17 (button) folded before Flop (didn't bet)
Seat 6: matiko09 (small blind) folded before Flop





PokerStars Hand #148210823938:  Hold'em No Limit ($0.10/$0.25 USD) - 2016/02/04 11:26:36 CET [2016/02/04 5:26:36 ET]
Table 'Hippasos' 6-max Seat #2 is the button
Seat 2: Samerald ($36.64 in chips) 
Seat 3: Fank0_ ($33.97 in chips) 
Seat 4: endeavoor ($25.55 in chips) 
Seat 6: matiko09 ($25.75 in chips) 
Fank0_: posts small blind $0.10
endeavoor: posts big blind $0.25
popis1P3: sits out 
VreDnYY: sits out 
*** HOLE CARDS ***
Dealt to matiko09 [6s Kd]
matiko09: folds 
Samerald: raises $0.50 to $0.75
Fank0_: folds 
endeavoor: folds 
Uncalled bet ($0.50) returned to Samerald
Samerald collected $0.60 from pot
*** SUMMARY ***
Total pot $0.60 | Rake $0 
Seat 2: Samerald (button) collected ($0.60)
Seat 3: Fank0_ (small blind) folded before Flop
Seat 4: endeavoor (big blind) folded before Flop
Seat 6: matiko09 folded before Flop (didn't bet)





PokerStars Hand #148210824939:  Hold'em No Limit ($0.10/$0.25 USD) - 2016/02/04 11:26:38 CET [2016/02/04 5:26:38 ET]
Table 'Golson' 6-max Seat #5 is the button
Seat 1: Ciudvdvno ($27.50 in chips) 
Seat 2: nnVinokurov ($36.47 in chips) 
Seat 3: Mirking2708 ($15.84 in chips) 
Seat 4: matiko09 ($25.35 in chips) 
Seat 5: getaca ($25.25 in chips) 
Seat 6: Wwwasian ($25.45 in chips) 
Wwwasian: posts small blind $0.10
Ciudvdvno: posts big blind $0.25
*** HOLE CARDS ***
Dealt to matiko09 [3h 2c]
nnVinokurov: folds 
Mirking2708: folds 
matiko09: folds 
getaca: folds 
Wwwasian: folds 
Uncalled bet ($0.15) returned to Ciudvdvno
Ciudvdvno collected $0.20 from pot
*** SUMMARY ***
Total pot $0.20 | Rake $0 
Seat 1: Ciudvdvno (big blind) collected ($0.20)
Seat 2: nnVinokurov folded before Flop (didn't bet)
Seat 3: Mirking2708 folded before Flop (didn't bet)
Seat 4: matiko09 folded before Flop (didn't bet)
Seat 5: getaca (button) folded before Flop (didn't bet)
Seat 6: Wwwasian (small blind) folded before Flop





PokerStars Hand #148210828314:  Hold'em No Limit (€0.10/€0.25 EUR) - 2016/02/04 11:26:44 CET [2016/02/04 5:26:44 ET]
Table 'Lilaea III' 6-max Seat #2 is the button
Seat 1: matiko09 (€25.35 in chips) 
Seat 2: Newbie1990 (€38.87 in chips) 
Seat 3: uzzy20 (€25.27 in chips) 
Seat 4: Wwwasian (€29.39 in chips) 
Seat 6: BaaroRai (€33.41 in chips) 
uzzy20: posts small blind €0.10
Wwwasian: posts big blind €0.25
*** HOLE CARDS ***
Dealt to matiko09 [6s Jc]
BaaroRai: calls €0.25
matiko09: folds 
Newbie1990: raises €0.75 to €1
uzzy20: raises €2.50 to €3.50
Wwwasian: folds 
BaaroRai: folds 
Newbie1990: folds 
Uncalled bet (€2.50) returned to uzzy20
uzzy20 collected €2.50 from pot
*** SUMMARY ***
Total pot €2.50 | Rake €0 
Seat 1: matiko09 folded before Flop (didn't bet)
Seat 2: Newbie1990 (button) folded before Flop
Seat 3: uzzy20 (small blind) collected (€2.50)
Seat 4: Wwwasian (big blind) folded before Flop
Seat 6: BaaroRai folded before Flop





PokerStars Hand #148210829968:  Hold'em No Limit ($0.10/$0.25 USD) - 2016/02/04 11:26:48 CET [2016/02/04 5:26:48 ET]
Table 'Thora II' 6-max Seat #3 is the button
Seat 2: schatun774 ($11.09 in chips) 
Seat 3: Odmincheg ($25.46 in chips) 
Seat 4: matiko09 ($25 in chips) 
Seat 5: A_priori_xD ($25 in chips) 
Seat 6: $243.31 ($21.96 in chips) 
matiko09: posts small blind $0.10
A_priori_xD: posts big blind $0.25
*** HOLE CARDS ***
Dealt to matiko09 [3s 5c]
$243.31: folds 
schatun774: calls $0.25
Odmincheg: folds 
$243.31 leaves the table
Gkirya joins the table at seat #6 
matiko09: folds 
A_priori_xD: checks 
*** FLOP *** [Qh 5h Jc]
Gkirya leaves the table
cost983 joins the table at seat #6 
A_priori_xD: checks 
schatun774: checks 
*** TURN *** [Qh 5h Jc] [5d]
A_priori_xD: checks 
schatun774: checks 
*** RIVER *** [Qh 5h Jc 5d] [Tc]
A_priori_xD: checks 
schatun774: checks 
*** SHOW DOWN ***
A_priori_xD: shows [2s 8d] (a pair of Fives)
schatun774: shows [Ah 8h] (a pair of Fives - Ace kicker)
schatun774 collected $0.57 from pot
*** SUMMARY ***
Total pot $0.60 | Rake $0.03 
Board [Qh 5h Jc 5d Tc]
Seat 2: schatun774 showed [Ah 8h] and won ($0.57) with a pair of Fives
Seat 3: Odmincheg (button) folded before Flop (didn't bet)
Seat 4: matiko09 (small blind) folded before Flop
Seat 5: A_priori_xD (big blind) showed [2s 8d] and lost with a pair of Fives
Seat 6: $243.31 folded before Flop (didn't bet)





PokerStars Hand #148210836139:  Hold'em No Limit ($0.10/$0.25 USD) - 2016/02/04 11:27:00 CET [2016/02/04 5:27:00 ET]
Table 'Golson' 6-max Seat #6 is the button
Seat 1: Ciudvdvno ($27.60 in chips) 
Seat 2: nnVinokurov ($36.47 in chips) 
Seat 3: Mirking2708 ($15.84 in chips) 
Seat 4: matiko09 ($25.35 in chips) 
Seat 5: getaca ($25.25 in chips) 
Seat 6: Wwwasian ($25.35 in chips) 
Ciudvdvno: posts small blind $0.10
nnVinokurov: posts big blind $0.25
*** HOLE CARDS ***
Dealt to matiko09 [Kd Qh]
Mirking2708: folds 
matiko09: raises $0.50 to $0.75
getaca: folds 
Wwwasian: folds 
Ciudvdvno: folds 
nnVinokurov: folds 
Uncalled bet ($0.50) returned to matiko09
matiko09 collected $0.60 from pot
matiko09: doesn't show hand 
*** SUMMARY ***
Total pot $0.60 | Rake $0 
Seat 1: Ciudvdvno (small blind) folded before Flop
Seat 2: nnVinokurov (big blind) folded before Flop
Seat 3: Mirking2708 folded before Flop (didn't bet)
Seat 4: matiko09 collected ($0.60)
Seat 5: getaca folded before Flop (didn't bet)
Seat 6: Wwwasian (button) folded before Flop (didn't bet)





PokerStars Hand #148210835999:  Hold'em No Limit ($0.10/$0.25 USD) - 2016/02/04 11:27:00 CET [2016/02/04 5:27:00 ET]
Table 'Hippasos' 6-max Seat #3 is the button
Seat 2: Samerald ($36.99 in chips) 
Seat 3: Fank0_ ($33.87 in chips) 
Seat 4: endeavoor ($25.30 in chips) 
Seat 5: popis1P3 ($17.09 in chips) 
Seat 6: matiko09 ($25.75 in chips) 
endeavoor: posts small blind $0.10
popis1P3: posts big blind $0.25
VreDnYY: sits out 
*** HOLE CARDS ***
Dealt to matiko09 [3s Qs]
matiko09: folds 
Samerald: folds 
Fank0_: raises $0.37 to $0.62
endeavoor: calls $0.52
popis1P3 has timed out
popis1P3: folds 
*** FLOP *** [5s Qc Td]
endeavoor: checks 
Fank0_: bets $0.85
endeavoor: calls $0.85
*** TURN *** [5s Qc Td] [9c]
endeavoor: checks 
Fank0_: checks 
*** RIVER *** [5s Qc Td 9c] [Ts]
endeavoor: bets $3
Fank0_: folds 
Uncalled bet ($3) returned to endeavoor
endeavoor collected $3.05 from pot
endeavoor: doesn't show hand 
*** SUMMARY ***
Total pot $3.19 | Rake $0.14 
Board [5s Qc Td 9c Ts]
Seat 2: Samerald folded before Flop (didn't bet)
Seat 3: Fank0_ (button) folded on the River
Seat 4: endeavoor (small blind) collected ($3.05)
Seat 5: popis1P3 (big blind) folded before Flop
Seat 6: matiko09 folded before Flop (didn't bet)





PokerStars Hand #148210848046:  Hold'em No Limit (€0.10/€0.25 EUR) - 2016/02/04 11:27:24 CET [2016/02/04 5:27:24 ET]
Table 'Lilaea III' 6-max Seat #3 is the button
Seat 1: matiko09 (€25.35 in chips) 
Seat 2: Newbie1990 (€37.87 in chips) 
Seat 3: uzzy20 (€26.77 in chips) 
Seat 4: Wwwasian (€29.14 in chips) 
Seat 6: BaaroRai (€33.16 in chips) 
Wwwasian: posts small blind €0.10
BaaroRai: posts big blind €0.25
*** HOLE CARDS ***
Dealt to matiko09 [As Ts]
matiko09: raises €0.50 to €0.75
Newbie1990: folds 
uzzy20: folds 
angrypaca leaves the table
Wwwasian: folds 
marchuchok joins the table at seat #5 
BaaroRai: calls €0.50
*** FLOP *** [6c Qs Qc]
BaaroRai: checks 
matiko09: bets €1
BaaroRai: calls €1
*** TURN *** [6c Qs Qc] [5c]
BaaroRai: checks 
matiko09: checks 
*** RIVER *** [6c Qs Qc 5c] [8c]
BaaroRai: bets €1
matiko09: folds 
Uncalled bet (€1) returned to BaaroRai
BaaroRai collected €3.44 from pot
BaaroRai: doesn't show hand 
*** SUMMARY ***
Total pot €3.60 | Rake €0.16 
Board [6c Qs Qc 5c 8c]
Seat 1: matiko09 folded on the River
Seat 2: Newbie1990 folded before Flop (didn't bet)
Seat 3: uzzy20 (button) folded before Flop (didn't bet)
Seat 4: Wwwasian (small blind) folded before Flop
Seat 6: BaaroRai (big blind) collected (€3.44)





PokerStars Hand #148210852660:  Hold'em No Limit ($0.10/$0.25 USD) - 2016/02/04 11:27:33 CET [2016/02/04 5:27:33 ET]
Table 'Thora II' 6-max Seat #4 is the button
Seat 2: schatun774 ($11.41 in chips) 
Seat 3: Odmincheg ($25.46 in chips) 
Seat 4: matiko09 ($25 in chips) 
Seat 5: A_priori_xD ($25 in chips) 
Seat 6: cost983 ($25 in chips) 
A_priori_xD: posts small blind $0.10
cost983: posts big blind $0.25
*** HOLE CARDS ***
Dealt to matiko09 [2c 5h]
schatun774: calls $0.25
Odmincheg: folds 
matiko09: folds 
A_priori_xD: folds 
cost983: checks 
*** FLOP *** [2d 7c 8h]
cost983: checks 
schatun774: checks 
*** TURN *** [2d 7c 8h] [4s]
cost983: bets $0.25
schatun774: calls $0.25
*** RIVER *** [2d 7c 8h 4s] [3s]
cost983: bets $0.25
schatun774: calls $0.25
*** SHOW DOWN ***
cost983: shows [8s Ks] (a pair of Eights)
schatun774: shows [Tc Th] (a pair of Tens)
schatun774 collected $1.53 from pot
*** SUMMARY ***
Total pot $1.60 | Rake $0.07 
Board [2d 7c 8h 4s 3s]
Seat 2: schatun774 showed [Tc Th] and won ($1.53) with a pair of Tens
Seat 3: Odmincheg folded before Flop (didn't bet)
Seat 4: matiko09 (button) folded before Flop (didn't bet)
Seat 5: A_priori_xD (small blind) folded before Flop
Seat 6: cost983 (big blind) showed [8s Ks] and lost with a pair of Eights





PokerStars Hand #148210857702:  Hold'em No Limit ($0.10/$0.25 USD) - 2016/02/04 11:27:43 CET [2016/02/04 5:27:43 ET]
Table 'Aquarius II' 6-max Seat #6 is the button
Seat 1: Ciudvdvno ($33.67 in chips) 
Seat 2: ex3Lero86 ($32.24 in chips) 
Seat 3: MyBestPokeR ($28.65 in chips) 
Seat 4: RasmusB79 ($12.65 in chips) 
Seat 5: TroyPoker17 ($30.01 in chips) 
Seat 6: matiko09 ($26.02 in chips) 
Ciudvdvno: posts small blind $0.10
ex3Lero86: posts big blind $0.25
*** HOLE CARDS ***
Dealt to matiko09 [Th 5s]
MyBestPokeR: folds 
RasmusB79: raises $0.25 to $0.50
TroyPoker17: folds 
matiko09: folds 
Ciudvdvno: raises $2.25 to $2.75
ex3Lero86: folds 
RasmusB79: calls $2.25
*** FLOP *** [4h Tc 7h]
Ciudvdvno: bets $3.65
RasmusB79: raises $6.25 to $9.90 and is all-in
Ciudvdvno: calls $6.25
*** TURN *** [4h Tc 7h] [3d]
*** RIVER *** [4h Tc 7h 3d] [Js]
*** SHOW DOWN ***
Ciudvdvno: shows [Kh Ah] (high card Ace)
RasmusB79: shows [9h 9d] (a pair of Nines)
RasmusB79 collected $24.40 from pot
*** SUMMARY ***
Total pot $25.55 | Rake $1.15 
Board [4h Tc 7h 3d Js]
Seat 1: Ciudvdvno (small blind) showed [Kh Ah] and lost with high card Ace
Seat 2: ex3Lero86 (big blind) folded before Flop
Seat 3: MyBestPokeR folded before Flop (didn't bet)
Seat 4: RasmusB79 showed [9h 9d] and won ($24.40) with a pair of Nines
Seat 5: TroyPoker17 folded before Flop (didn't bet)
Seat 6: matiko09 (button) folded before Flop (didn't bet)





PokerStars Hand #148210858084:  Hold'em No Limit ($0.10/$0.25 USD) - 2016/02/04 11:27:44 CET [2016/02/04 5:27:44 ET]
Table 'Golson' 6-max Seat #1 is the button
Seat 1: Ciudvdvno ($27.50 in chips) 
Seat 2: nnVinokurov ($36.22 in chips) 
Seat 3: Mirking2708 ($15.84 in chips) 
Seat 4: matiko09 ($25.70 in chips) 
Seat 5: getaca ($25.25 in chips) 
Seat 6: Wwwasian ($25.35 in chips) 
nnVinokurov: posts small blind $0.10
Mirking2708: posts big blind $0.25
*** HOLE CARDS ***
Dealt to matiko09 [3d Kd]
matiko09: folds 
getaca: raises $0.50 to $0.75
Wwwasian: folds 
Ciudvdvno: raises $1.50 to $2.25
nnVinokurov: folds 
Mirking2708: folds 
getaca: folds 
Uncalled bet ($1.50) returned to Ciudvdvno
Ciudvdvno collected $1.85 from pot
*** SUMMARY ***
Total pot $1.85 | Rake $0 
Seat 1: Ciudvdvno (button) collected ($1.85)
Seat 2: nnVinokurov (small blind) folded before Flop
Seat 3: Mirking2708 (big blind) folded before Flop
Seat 4: matiko09 folded before Flop (didn't bet)
Seat 5: getaca folded before Flop
Seat 6: Wwwasian folded before Flop (didn't bet)





PokerStars Hand #148210870542:  Hold'em No Limit ($0.10/$0.25 USD) - 2016/02/04 11:28:09 CET [2016/02/04 5:28:09 ET]
Table 'Thora II' 6-max Seat #5 is the button
Seat 2: schatun774 ($12.19 in chips) 
Seat 3: Odmincheg ($25.46 in chips) 
Seat 4: matiko09 ($25 in chips) 
Seat 5: A_priori_xD ($25 in chips) 
Seat 6: cost983 ($25 in chips) 
cost983: posts small blind $0.10
schatun774: posts big blind $0.25
*** HOLE CARDS ***
Dealt to matiko09 [Ah Js]
Odmincheg: folds 
matiko09: raises $0.50 to $0.75
A_priori_xD: folds 
cost983: folds 
schatun774: folds 
Uncalled bet ($0.50) returned to matiko09
matiko09 collected $0.60 from pot
matiko09: doesn't show hand 
*** SUMMARY ***
Total pot $0.60 | Rake $0 
Seat 2: schatun774 (big blind) folded before Flop
Seat 3: Odmincheg folded before Flop (didn't bet)
Seat 4: matiko09 collected ($0.60)
Seat 5: A_priori_xD (button) folded before Flop (didn't bet)
Seat 6: cost983 (small blind) folded before Flop





PokerStars Hand #148210870402:  Hold'em No Limit (€0.10/€0.25 EUR) - 2016/02/04 11:28:09 CET [2016/02/04 5:28:09 ET]
Table 'Lilaea III' 6-max Seat #4 is the button
Seat 1: matiko09 (€25 in chips) 
Seat 2: Newbie1990 (€37.87 in chips) 
Seat 3: uzzy20 (€26.77 in chips) 
Seat 4: Wwwasian (€29.04 in chips) 
Seat 6: BaaroRai (€34.85 in chips) 
marchuchok will be allowed to play after the button
BaaroRai: posts small blind €0.10
matiko09: posts big blind €0.25
*** HOLE CARDS ***
Dealt to matiko09 [Ac 3s]
Newbie1990: folds 
uzzy20: folds 
Wwwasian: folds 
BaaroRai: calls €0.15
matiko09: checks 
*** FLOP *** [4c Tc Ks]
BaaroRai: checks 
matiko09: checks 
*** TURN *** [4c Tc Ks] [Ts]
BaaroRai: bets €0.25
matiko09: folds 
Uncalled bet (€0.25) returned to BaaroRai
BaaroRai collected €0.48 from pot
BaaroRai: doesn't show hand 
*** SUMMARY ***
Total pot €0.50 | Rake €0.02 
Board [4c Tc Ks Ts]
Seat 1: matiko09 (big blind) folded on the Turn
Seat 2: Newbie1990 folded before Flop (didn't bet)
Seat 3: uzzy20 folded before Flop (didn't bet)
Seat 4: Wwwasian (button) folded before Flop (didn't bet)
Seat 6: BaaroRai (small blind) collected (€0.48)





PokerStars Hand #148210878148:  Hold'em No Limit ($0.10/$0.25 USD) - 2016/02/04 11:28:24 CET [2016/02/04 5:28:24 ET]
Table 'Golson' 6-max Seat #2 is the button
Seat 1: Ciudvdvno ($28.60 in chips) 
Seat 2: nnVinokurov ($36.12 in chips) 
Seat 3: Mirking2708 ($15.59 in chips) 
Seat 4: matiko09 ($25.70 in chips) 
Seat 5: getaca ($25 in chips) 
Seat 6: Wwwasian ($25.35 in chips) 
Mirking2708: posts small blind $0.10
matiko09: posts big blind $0.25
*** HOLE CARDS ***
Dealt to matiko09 [Jc 5h]
getaca: folds 
Wwwasian: folds 
Ciudvdvno: folds 
nnVinokurov: raises $0.37 to $0.62
Mirking2708: folds 
matiko09: folds 
Uncalled bet ($0.37) returned to nnVinokurov
nnVinokurov collected $0.60 from pot
nnVinokurov: doesn't show hand 
*** SUMMARY ***
Total pot $0.60 | Rake $0 
Seat 1: Ciudvdvno folded before Flop (didn't bet)
Seat 2: nnVinokurov (button) collected ($0.60)
Seat 3: Mirking2708 (small blind) folded before Flop
Seat 4: matiko09 (big blind) folded before Flop
Seat 5: getaca folded before Flop (didn't bet)
Seat 6: Wwwasian folded before Flop (didn't bet)





PokerStars Hand #148210879823:  Hold'em No Limit ($0.10/$0.25 USD) - 2016/02/04 11:28:28 CET [2016/02/04 5:28:28 ET]
Table 'Thora II' 6-max Seat #6 is the button
Seat 2: schatun774 ($11.94 in chips) 
Seat 3: Odmincheg ($25.46 in chips) 
Seat 4: matiko09 ($25.35 in chips) 
Seat 5: A_priori_xD ($25 in chips) 
Seat 6: cost983 ($25 in chips) 
schatun774: posts small blind $0.10
Odmincheg: posts big blind $0.25
*** HOLE CARDS ***
Dealt to matiko09 [9s Td]
matiko09: folds 
A_priori_xD: folds 
cost983: raises $0.37 to $0.62
schatun774: folds 
Odmincheg: folds 
Uncalled bet ($0.37) returned to cost983
cost983 collected $0.60 from pot
cost983: doesn't show hand 
*** SUMMARY ***
Total pot $0.60 | Rake $0 
Seat 2: schatun774 (small blind) folded before Flop
Seat 3: Odmincheg (big blind) folded before Flop
Seat 4: matiko09 folded before Flop (didn't bet)
Seat 5: A_priori_xD folded before Flop (didn't bet)
Seat 6: cost983 (button) collected ($0.60)





PokerStars Hand #148210885889:  Hold'em No Limit ($0.10/$0.25 USD) - 2016/02/04 11:28:40 CET [2016/02/04 5:28:40 ET]
Table 'Thora II' 6-max Seat #2 is the button
Seat 2: schatun774 ($11.84 in chips) 
Seat 3: Odmincheg ($25.21 in chips) 
Seat 4: matiko09 ($25.35 in chips) 
Seat 5: A_priori_xD ($25 in chips) 
Seat 6: cost983 ($25.35 in chips) 
Odmincheg: posts small blind $0.10
matiko09: posts big blind $0.25
*** HOLE CARDS ***
Dealt to matiko09 [7d 2h]
A_priori_xD: folds 
cost983: folds 
schatun774: folds 
Odmincheg: folds 
Uncalled bet ($0.15) returned to matiko09
matiko09 collected $0.20 from pot
matiko09: doesn't show hand 
*** SUMMARY ***
Total pot $0.20 | Rake $0 
Seat 2: schatun774 (button) folded before Flop (didn't bet)
Seat 3: Odmincheg (small blind) folded before Flop
Seat 4: matiko09 (big blind) collected ($0.20)
Seat 5: A_priori_xD folded before Flop (didn't bet)
Seat 6: cost983 folded before Flop (didn't bet)





PokerStars Hand #148210887455:  Hold'em No Limit (€0.10/€0.25 EUR) - 2016/02/04 11:28:43 CET [2016/02/04 5:28:43 ET]
Table 'Lilaea III' 6-max Seat #6 is the button
Seat 1: matiko09 (€25 in chips) 
Seat 2: Newbie1990 (€37.87 in chips) 
Seat 3: uzzy20 (€26.77 in chips) 
Seat 4: Wwwasian (€29.04 in chips) 
Seat 6: BaaroRai (€35.08 in chips) 
matiko09: posts small blind €0.10
Newbie1990: posts big blind €0.25
marchuchok: sits out 
*** HOLE CARDS ***
Dealt to matiko09 [Qd 8h]
uzzy20: raises €0.50 to €0.75
Wwwasian: folds 
BaaroRai: folds 
matiko09: folds 
Newbie1990: raises €1.75 to €2.50
uzzy20: folds 
Uncalled bet (€1.75) returned to Newbie1990
Newbie1990 collected €1.60 from pot
Newbie1990: doesn't show hand 
*** SUMMARY ***
Total pot €1.60 | Rake €0 
Seat 1: matiko09 (small blind) folded before Flop
Seat 2: Newbie1990 (big blind) collected (€1.60)
Seat 3: uzzy20 folded before Flop
Seat 4: Wwwasian folded before Flop (didn't bet)
Seat 6: BaaroRai (button) folded before Flop (didn't bet)





PokerStars Hand #148210890014:  Hold'em No Limit ($0.10/$0.25 USD) - 2016/02/04 11:28:48 CET [2016/02/04 5:28:48 ET]
Table 'Thora II' 6-max Seat #3 is the button
Seat 2: schatun774 ($11.84 in chips) 
Seat 3: Odmincheg ($25.11 in chips) 
Seat 4: matiko09 ($25.45 in chips) 
Seat 6: cost983 ($25.35 in chips) 
matiko09: posts small blind $0.10
A_priori_xD: is sitting out 
cost983: posts big blind $0.25
*** HOLE CARDS ***
Dealt to matiko09 [8c Jh]
A_priori_xD leaves the table
schatun774: calls $0.25
Odmincheg: folds 
matiko09: folds 
cost983: checks 
*** FLOP *** [4s 7s 6c]
cost983: checks 
schatun774: checks 
*** TURN *** [4s 7s 6c] [As]
cost983: checks 
schatun774: bets $0.25
cost983: folds 
Uncalled bet ($0.25) returned to schatun774
schatun774 collected $0.57 from pot
schatun774: doesn't show hand 
*** SUMMARY ***
Total pot $0.60 | Rake $0.03 
Board [4s 7s 6c As]
Seat 2: schatun774 collected ($0.57)
Seat 3: Odmincheg (button) folded before Flop (didn't bet)
Seat 4: matiko09 (small blind) folded before Flop
Seat 6: cost983 (big blind) folded on the Turn





PokerStars Hand #148210890889:  Hold'em No Limit ($0.10/$0.25 USD) - 2016/02/04 11:28:50 CET [2016/02/04 5:28:50 ET]
Table 'Hippasos' 6-max Seat #4 is the button
Seat 1: VreDnYY ($25 in chips) 
Seat 2: Samerald ($36.99 in chips) 
Seat 3: Fank0_ ($32.40 in chips) 
Seat 4: endeavoor ($26.88 in chips) 
Seat 6: matiko09 ($25.75 in chips) 
matiko09: posts small blind $0.10
VreDnYY: posts big blind $0.25
*** HOLE CARDS ***
Dealt to matiko09 [4h 2h]
Samerald: folds 
Fank0_: folds 
endeavoor: folds 
matiko09: folds 
Uncalled bet ($0.15) returned to VreDnYY
VreDnYY collected $0.20 from pot
VreDnYY: doesn't show hand 
*** SUMMARY ***
Total pot $0.20 | Rake $0 
Seat 1: VreDnYY (big blind) collected ($0.20)
Seat 2: Samerald folded before Flop (didn't bet)
Seat 3: Fank0_ folded before Flop (didn't bet)
Seat 4: endeavoor (button) folded before Flop (didn't bet)
Seat 6: matiko09 (small blind) folded before Flop





PokerStars Hand #148210891685:  Hold'em No Limit ($0.10/$0.25 USD) - 2016/02/04 11:28:51 CET [2016/02/04 5:28:51 ET]
Table 'Golson' 6-max Seat #3 is the button
Seat 1: Ciudvdvno ($28.60 in chips) 
Seat 2: nnVinokurov ($36.47 in chips) 
Seat 3: Mirking2708 ($15.49 in chips) 
Seat 4: matiko09 ($25.45 in chips) 
Seat 5: getaca ($25 in chips) 
Seat 6: Wwwasian ($25.35 in chips) 
matiko09: posts small blind $0.10
getaca: posts big blind $0.25
*** HOLE CARDS ***
Dealt to matiko09 [Td Kc]
Wwwasian: folds 
Ciudvdvno: raises $0.50 to $0.75
nnVinokurov: folds 
Mirking2708: folds 
matiko09: folds 
getaca: folds 
Uncalled bet ($0.50) returned to Ciudvdvno
Ciudvdvno collected $0.60 from pot
*** SUMMARY ***
Total pot $0.60 | Rake $0 
Seat 1: Ciudvdvno collected ($0.60)
Seat 2: nnVinokurov folded before Flop (didn't bet)
Seat 3: Mirking2708 (button) folded before Flop (didn't bet)
Seat 4: matiko09 (small blind) folded before Flop
Seat 5: getaca (big blind) folded before Flop
Seat 6: Wwwasian folded before Flop (didn't bet)





PokerStars Hand #148210895975:  Hold'em No Limit ($0.10/$0.25 USD) - 2016/02/04 11:29:00 CET [2016/02/04 5:29:00 ET]
Table 'Aquarius II' 6-max Seat #1 is the button
Seat 1: Ciudvdvno ($25 in chips) 
Seat 2: ex3Lero86 ($31.99 in chips) 
Seat 3: MyBestPokeR ($28.65 in chips) 
Seat 4: RasmusB79 ($24.40 in chips) 
Seat 5: TroyPoker17 ($30.01 in chips) 
Seat 6: matiko09 ($26.02 in chips) 
ex3Lero86: posts small blind $0.10
MyBestPokeR: posts big blind $0.25
*** HOLE CARDS ***
Dealt to matiko09 [2d 8h]
RasmusB79: calls $0.25
TroyPoker17: folds 
matiko09: folds 
Ciudvdvno: folds 
ex3Lero86: calls $0.15
MyBestPokeR: checks 
*** FLOP *** [Qs Js 7s]
ex3Lero86: checks 
MyBestPokeR: checks 
RasmusB79: bets $0.25
ex3Lero86: folds 
MyBestPokeR: folds 
Uncalled bet ($0.25) returned to RasmusB79
RasmusB79 collected $0.72 from pot
*** SUMMARY ***
Total pot $0.75 | Rake $0.03 
Board [Qs Js 7s]
Seat 1: Ciudvdvno (button) folded before Flop (didn't bet)
Seat 2: ex3Lero86 (small blind) folded on the Flop
Seat 3: MyBestPokeR (big blind) folded on the Flop
Seat 4: RasmusB79 collected ($0.72)
Seat 5: TroyPoker17 folded before Flop (didn't bet)
Seat 6: matiko09 folded before Flop (didn't bet)





PokerStars Hand #148210902599:  Hold'em No Limit ($0.10/$0.25 USD) - 2016/02/04 11:29:13 CET [2016/02/04 5:29:13 ET]
Table 'Thora II' 6-max Seat #4 is the button
Seat 2: schatun774 ($12.16 in chips) 
Seat 3: Odmincheg ($25.11 in chips) 
Seat 4: matiko09 ($25.35 in chips) 
Seat 6: cost983 ($25.10 in chips) 
cost983: posts small blind $0.10
milkov613 was removed from the table for failing to post
schatun774: posts big blind $0.25
*** HOLE CARDS ***
Dealt to matiko09 [2c Jh]
Odmincheg: folds 
matiko09: folds 
cost983: folds 
Uncalled bet ($0.15) returned to schatun774
schatun774 collected $0.20 from pot
schatun774: doesn't show hand 
*** SUMMARY ***
Total pot $0.20 | Rake $0 
Seat 2: schatun774 (big blind) collected ($0.20)
Seat 3: Odmincheg folded before Flop (didn't bet)
Seat 4: matiko09 (button) folded before Flop (didn't bet)
Seat 6: cost983 (small blind) folded before Flop





PokerStars Hand #148210903533:  Hold'em No Limit (€0.10/€0.25 EUR) - 2016/02/04 11:29:15 CET [2016/02/04 5:29:15 ET]
Table 'Lilaea III' 6-max Seat #1 is the button
Seat 1: matiko09 (€25 in chips) 
Seat 2: Newbie1990 (€38.72 in chips) 
Seat 3: uzzy20 (€26.02 in chips) 
Seat 4: Wwwasian (€29.04 in chips) 
Seat 6: BaaroRai (€35.08 in chips) 
Newbie1990: posts small blind €0.10
uzzy20: posts big blind €0.25
marchuchok: sits out 
*** HOLE CARDS ***
Dealt to matiko09 [9h 6s]
Wwwasian: folds 
BaaroRai: calls €0.25
matiko09: folds 
Newbie1990: folds 
uzzy20: checks 
*** FLOP *** [Kc 4c 6c]
uzzy20: checks 
BaaroRai: bets €0.25
uzzy20: folds 
Uncalled bet (€0.25) returned to BaaroRai
BaaroRai collected €0.57 from pot
BaaroRai: doesn't show hand 
*** SUMMARY ***
Total pot €0.60 | Rake €0.03 
Board [Kc 4c 6c]
Seat 1: matiko09 (button) folded before Flop (didn't bet)
Seat 2: Newbie1990 (small blind) folded before Flop
Seat 3: uzzy20 (big blind) folded on the Flop
Seat 4: Wwwasian folded before Flop (didn't bet)
Seat 6: BaaroRai collected (€0.57)





PokerStars Hand #148210904948:  Hold'em No Limit ($0.10/$0.25 USD) - 2016/02/04 11:29:18 CET [2016/02/04 5:29:18 ET]
Table 'Hippasos' 6-max Seat #6 is the button
Seat 1: VreDnYY ($25.10 in chips) 
Seat 2: Samerald ($36.99 in chips) 
Seat 3: Fank0_ ($32.40 in chips) 
Seat 4: endeavoor ($26.88 in chips) 
Seat 6: matiko09 ($25.65 in chips) 
VreDnYY: posts small blind $0.10
Samerald: posts big blind $0.25
*** HOLE CARDS ***
Dealt to matiko09 [3s 7c]
Fank0_: folds 
endeavoor: folds 
matiko09: folds 
VreDnYY: raises $0.37 to $0.62
Samerald: folds 
Uncalled bet ($0.37) returned to VreDnYY
VreDnYY collected $0.50 from pot
VreDnYY: doesn't show hand 
*** SUMMARY ***
Total pot $0.50 | Rake $0 
Seat 1: VreDnYY (small blind) collected ($0.50)
Seat 2: Samerald (big blind) folded before Flop
Seat 3: Fank0_ folded before Flop (didn't bet)
Seat 4: endeavoor folded before Flop (didn't bet)
Seat 6: matiko09 (button) folded before Flop (didn't bet)





PokerStars Hand #148210906636:  Hold'em No Limit ($0.10/$0.25 USD) - 2016/02/04 11:29:21 CET [2016/02/04 5:29:21 ET]
Table 'Thora II' 6-max Seat #6 is the button
Seat 2: schatun774 ($12.26 in chips) 
Seat 3: Odmincheg ($25.11 in chips) 
Seat 4: matiko09 ($25.35 in chips) 
Seat 6: cost983 ($25 in chips) 
schatun774: posts small blind $0.10
Odmincheg: posts big blind $0.25
*** HOLE CARDS ***
Dealt to matiko09 [7d Js]
matiko09: folds 
cost983: raises $0.37 to $0.62
schatun774: folds 
Odmincheg: folds 
Uncalled bet ($0.37) returned to cost983
cost983 collected $0.60 from pot
cost983: doesn't show hand 
*** SUMMARY ***
Total pot $0.60 | Rake $0 
Seat 2: schatun774 (small blind) folded before Flop
Seat 3: Odmincheg (big blind) folded before Flop
Seat 4: matiko09 folded before Flop (didn't bet)
Seat 6: cost983 (button) collected ($0.60)





PokerStars Hand #148210913009:  Hold'em No Limit ($0.10/$0.25 USD) - 2016/02/04 11:29:34 CET [2016/02/04 5:29:34 ET]
Table 'Golson' 6-max Seat #4 is the button
Seat 1: Ciudvdvno ($28.95 in chips) 
Seat 2: nnVinokurov ($36.47 in chips) 
Seat 3: Mirking2708 ($15.49 in chips) 
Seat 4: matiko09 ($25.35 in chips) 
Seat 5: getaca ($25 in chips) 
Seat 6: Wwwasian ($25.35 in chips) 
getaca: posts small blind $0.10
Wwwasian: posts big blind $0.25
*** HOLE CARDS ***
Dealt to matiko09 [9c 6h]
Ciudvdvno: folds 
nnVinokurov: folds 
Mirking2708: folds 
matiko09: folds 
getaca: raises $0.50 to $0.75
Wwwasian: calls $0.50
*** FLOP *** [Kd As 4d]
getaca: bets $1
Wwwasian: raises $2 to $3
getaca: folds 
Uncalled bet ($2) returned to Wwwasian
Wwwasian collected $3.34 from pot
Wwwasian: doesn't show hand 
*** SUMMARY ***
Total pot $3.50 | Rake $0.16 
Board [Kd As 4d]
Seat 1: Ciudvdvno folded before Flop (didn't bet)
Seat 2: nnVinokurov folded before Flop (didn't bet)
Seat 3: Mirking2708 folded before Flop (didn't bet)
Seat 4: matiko09 (button) folded before Flop (didn't bet)
Seat 5: getaca (small blind) folded on the Flop
Seat 6: Wwwasian (big blind) collected ($3.34)





PokerStars Hand #148210914424:  Hold'em No Limit ($0.10/$0.25 USD) - 2016/02/04 11:29:37 CET [2016/02/04 5:29:37 ET]
Table 'Hippasos' 6-max Seat #1 is the button
Seat 1: VreDnYY ($25.35 in chips) 
Seat 2: Samerald ($36.74 in chips) 
Seat 3: Fank0_ ($32.40 in chips) 
Seat 4: endeavoor ($26.88 in chips) 
Seat 6: matiko09 ($25.65 in chips) 
Samerald: posts small blind $0.10
Fank0_: posts big blind $0.25
*** HOLE CARDS ***
Dealt to matiko09 [6s 8d]
endeavoor: raises $0.45 to $0.70
matiko09: folds 
VreDnYY: folds 
Samerald: folds 
Fank0_: folds 
Uncalled bet ($0.45) returned to endeavoor
endeavoor collected $0.60 from pot
endeavoor: doesn't show hand 
*** SUMMARY ***
Total pot $0.60 | Rake $0 
Seat 1: VreDnYY (button) folded before Flop (didn't bet)
Seat 2: Samerald (small blind) folded before Flop
Seat 3: Fank0_ (big blind) folded before Flop
Seat 4: endeavoor collected ($0.60)
Seat 6: matiko09 folded before Flop (didn't bet)





PokerStars Hand #148210915643:  Hold'em No Limit ($0.10/$0.25 USD) - 2016/02/04 11:29:39 CET [2016/02/04 5:29:39 ET]
Table 'Thora II' 6-max Seat #2 is the button
Seat 2: schatun774 ($12.16 in chips) 
Seat 3: Odmincheg ($25 in chips) 
Seat 4: matiko09 ($25.35 in chips) 
Seat 6: cost983 ($25.35 in chips) 
Odmincheg: posts small blind $0.10
matiko09: posts big blind $0.25
*** HOLE CARDS ***
Dealt to matiko09 [Qh Ah]
cost983: folds 
schatun774: folds 
PotgrabberAA joins the table at seat #5 
Odmincheg: folds 
Uncalled bet ($0.15) returned to matiko09
matiko09 collected $0.20 from pot
matiko09: doesn't show hand 
*** SUMMARY ***
Total pot $0.20 | Rake $0 
Seat 2: schatun774 (button) folded before Flop (didn't bet)
Seat 3: Odmincheg (small blind) folded before Flop
Seat 4: matiko09 (big blind) collected ($0.20)
Seat 6: cost983 folded before Flop (didn't bet)





PokerStars Hand #148210915870:  Hold'em No Limit ($0.10/$0.25 USD) - 2016/02/04 11:29:40 CET [2016/02/04 5:29:40 ET]
Table 'Hungaria II' 6-max Seat #2 is the button
Seat 2: MaurerXL82 ($21.01 in chips) 
Seat 3: MAO_DZEDYN_S ($25 in chips) 
Seat 4: matiko09 ($25 in chips) 
Seat 5: A_priori_xD ($25 in chips) 
Seat 6: droog2 ($37.36 in chips) 
MAO_DZEDYN_S: posts small blind $0.10
matiko09: posts big blind $0.25
angrypaca: sits out 
*** HOLE CARDS ***
Dealt to matiko09 [6c 4s]
A_priori_xD: folds 
droog2: folds 
MaurerXL82: folds 
A_priori_xD leaves the table
MAO_DZEDYN_S: folds 
Uncalled bet ($0.15) returned to matiko09
matiko09 collected $0.20 from pot
matiko09: doesn't show hand 
nnVinokurov joins the table at seat #5 
*** SUMMARY ***
Total pot $0.20 | Rake $0 
Seat 2: MaurerXL82 (button) folded before Flop (didn't bet)
Seat 3: MAO_DZEDYN_S (small blind) folded before Flop
Seat 4: matiko09 (big blind) collected ($0.20)
Seat 5: A_priori_xD folded before Flop (didn't bet)
Seat 6: droog2 folded before Flop (didn't bet)





PokerStars Hand #148210918474:  Hold'em No Limit (€0.10/€0.25 EUR) - 2016/02/04 11:29:45 CET [2016/02/04 5:29:45 ET]
Table 'Lilaea III' 6-max Seat #2 is the button
Seat 1: matiko09 (€25 in chips) 
Seat 2: Newbie1990 (€38.62 in chips) 
Seat 3: uzzy20 (€25.77 in chips) 
Seat 4: Wwwasian (€29.04 in chips) 
Seat 6: BaaroRai (€35.40 in chips) 
uzzy20: posts small blind €0.10
Wwwasian: posts big blind €0.25
marchuchok: sits out 
*** HOLE CARDS ***
Dealt to matiko09 [Th Ac]
BaaroRai: folds 
matiko09: raises €0.50 to €0.75
Newbie1990: folds 
uzzy20: folds 
Wwwasian: folds 
Uncalled bet (€0.50) returned to matiko09
matiko09 collected €0.60 from pot
matiko09: doesn't show hand 
*** SUMMARY ***
Total pot €0.60 | Rake €0 
Seat 1: matiko09 collected (€0.60)
Seat 2: Newbie1990 (button) folded before Flop (didn't bet)
Seat 3: uzzy20 (small blind) folded before Flop
Seat 4: Wwwasian (big blind) folded before Flop
Seat 6: BaaroRai folded before Flop (didn't bet)





PokerStars Hand #148210919748:  Hold'em No Limit ($0.10/$0.25 USD) - 2016/02/04 11:29:47 CET [2016/02/04 5:29:47 ET]
Table 'Thora II' 6-max Seat #3 is the button
Seat 2: schatun774 ($12.16 in chips) 
Seat 3: Odmincheg ($25 in chips) 
Seat 4: matiko09 ($25.45 in chips) 
Seat 5: PotgrabberAA ($25 in chips) 
Seat 6: cost983 ($25.35 in chips) 
matiko09: posts small blind $0.10
PotgrabberAA: posts big blind $0.25
*** HOLE CARDS ***
Dealt to matiko09 [Qd 5d]
cost983: folds 
schatun774: folds 
Odmincheg: folds 
matiko09: raises $0.50 to $0.75
PotgrabberAA: calls $0.50
*** FLOP *** [2c As 4h]
matiko09: bets $0.93
PotgrabberAA: folds 
Uncalled bet ($0.93) returned to matiko09
matiko09 collected $1.43 from pot
matiko09: doesn't show hand 
*** SUMMARY ***
Total pot $1.50 | Rake $0.07 
Board [2c As 4h]
Seat 2: schatun774 folded before Flop (didn't bet)
Seat 3: Odmincheg (button) folded before Flop (didn't bet)
Seat 4: matiko09 (small blind) collected ($1.43)
Seat 5: PotgrabberAA (big blind) folded on the Flop
Seat 6: cost983 folded before Flop (didn't bet)





PokerStars Hand #148210919909:  Hold'em No Limit ($0.10/$0.25 USD) - 2016/02/04 11:29:48 CET [2016/02/04 5:29:48 ET]
Table 'Aquarius II' 6-max Seat #2 is the button
Seat 1: Ciudvdvno ($25 in chips) 
Seat 2: ex3Lero86 ($31.74 in chips) 
Seat 3: MyBestPokeR ($28.40 in chips) 
Seat 4: RasmusB79 ($24.87 in chips) 
Seat 5: TroyPoker17 ($30.01 in chips) 
Seat 6: matiko09 ($26.02 in chips) 
MyBestPokeR: posts small blind $0.10
RasmusB79: posts big blind $0.25
*** HOLE CARDS ***
Dealt to matiko09 [9h Qs]
TroyPoker17: folds 
matiko09: folds 
Ciudvdvno: folds 
ex3Lero86: folds 
MyBestPokeR: calls $0.15
RasmusB79: checks 
*** FLOP *** [As 7h 6c]
MyBestPokeR: checks 
RasmusB79: checks 
*** TURN *** [As 7h 6c] [Ah]
MyBestPokeR: checks 
RasmusB79: checks 
*** RIVER *** [As 7h 6c Ah] [4s]
MyBestPokeR: checks 
RasmusB79: bets $0.75
MyBestPokeR: calls $0.75
*** SHOW DOWN ***
RasmusB79: shows [Jc 7d] (two pair, Aces and Sevens)
MyBestPokeR: mucks hand 
RasmusB79 collected $1.91 from pot
*** SUMMARY ***
Total pot $2 | Rake $0.09 
Board [As 7h 6c Ah 4s]
Seat 1: Ciudvdvno folded before Flop (didn't bet)
Seat 2: ex3Lero86 (button) folded before Flop (didn't bet)
Seat 3: MyBestPokeR (small blind) mucked [3c 3d]
Seat 4: RasmusB79 (big blind) showed [Jc 7d] and won ($1.91) with two pair, Aces and Sevens
Seat 5: TroyPoker17 folded before Flop (didn't bet)
Seat 6: matiko09 folded before Flop (didn't bet)





PokerStars Hand #148210923394:  Hold'em No Limit ($0.10/$0.25 USD) - 2016/02/04 11:29:55 CET [2016/02/04 5:29:55 ET]
Table 'Hungaria II' 6-max Seat #3 is the button
Seat 2: MaurerXL82 ($21.01 in chips) 
Seat 3: MAO_DZEDYN_S ($25 in chips) 
Seat 4: matiko09 ($25.10 in chips) 
Seat 5: nnVinokurov ($25 in chips) 
Seat 6: droog2 ($37.36 in chips) 
matiko09: posts small blind $0.10
nnVinokurov: posts big blind $0.25
angrypaca: sits out 
*** HOLE CARDS ***
Dealt to matiko09 [Ah 3s]
droog2: folds 
MaurerXL82: calls $0.25
MAO_DZEDYN_S: raises $0.75 to $1
matiko09: folds 
nnVinokurov: folds 
MaurerXL82: calls $0.75
*** FLOP *** [As Kc 4c]
MaurerXL82: bets $0.25
MAO_DZEDYN_S: calls $0.25
*** TURN *** [As Kc 4c] [Qh]
MaurerXL82: bets $0.25
MAO_DZEDYN_S: calls $0.25
*** RIVER *** [As Kc 4c Qh] [5d]
MaurerXL82: bets $0.25
MAO_DZEDYN_S: calls $0.25
*** SHOW DOWN ***
MaurerXL82: shows [2h Ad] (a pair of Aces)
MAO_DZEDYN_S: mucks hand 
MaurerXL82 collected $3.68 from pot
*** SUMMARY ***
Total pot $3.85 | Rake $0.17 
Board [As Kc 4c Qh 5d]
Seat 2: MaurerXL82 showed [2h Ad] and won ($3.68) with a pair of Aces
Seat 3: MAO_DZEDYN_S (button) mucked [Ts Th]
Seat 4: matiko09 (small blind) folded before Flop
Seat 5: nnVinokurov (big blind) folded before Flop
Seat 6: droog2 folded before Flop (didn't bet)





PokerStars Hand #148210924711:  Hold'em No Limit ($0.10/$0.25 USD) - 2016/02/04 11:29:57 CET [2016/02/04 5:29:57 ET]
Table 'Hippasos' 6-max Seat #2 is the button
Seat 1: VreDnYY ($25.35 in chips) 
Seat 2: Samerald ($36.64 in chips) 
Seat 3: Fank0_ ($32.15 in chips) 
Seat 4: endeavoor ($27.23 in chips) 
Seat 6: matiko09 ($25.65 in chips) 
Fank0_: posts small blind $0.10
endeavoor: posts big blind $0.25
*** HOLE CARDS ***
Dealt to matiko09 [6s 7s]
matiko09: folds 
VreDnYY: folds 
Samerald: raises $0.50 to $0.75
Fank0_: raises $1.75 to $2.50
endeavoor: raises $2.95 to $5.45
Samerald: folds 
Fank0_: folds 
Uncalled bet ($2.95) returned to endeavoor
endeavoor collected $5.75 from pot
endeavoor: doesn't show hand 
*** SUMMARY ***
Total pot $5.75 | Rake $0 
Seat 1: VreDnYY folded before Flop (didn't bet)
Seat 2: Samerald (button) folded before Flop
Seat 3: Fank0_ (small blind) folded before Flop
Seat 4: endeavoor (big blind) collected ($5.75)
Seat 6: matiko09 folded before Flop (didn't bet)





PokerStars Hand #148210926025:  Hold'em No Limit (€0.10/€0.25 EUR) - 2016/02/04 11:30:00 CET [2016/02/04 5:30:00 ET]
Table 'Lilaea III' 6-max Seat #3 is the button
Seat 1: matiko09 (€25.35 in chips) 
Seat 2: Newbie1990 (€38.62 in chips) 
Seat 3: uzzy20 (€25.67 in chips) 
Seat 4: Wwwasian (€28.79 in chips) 
Seat 5: marchuchok (€25 in chips) 
Seat 6: BaaroRai (€35.40 in chips) 
Wwwasian: posts small blind €0.10
marchuchok: posts big blind €0.25
*** HOLE CARDS ***
Dealt to matiko09 [3d 7s]
BaaroRai: folds 
matiko09: folds 
Newbie1990: folds 
uzzy20: folds 
Wwwasian: raises €0.45 to €0.70
marchuchok: folds 
Uncalled bet (€0.45) returned to Wwwasian
Wwwasian collected €0.50 from pot
Wwwasian: doesn't show hand 
*** SUMMARY ***
Total pot €0.50 | Rake €0 
Seat 1: matiko09 folded before Flop (didn't bet)
Seat 2: Newbie1990 folded before Flop (didn't bet)
Seat 3: uzzy20 (button) folded before Flop (didn't bet)
Seat 4: Wwwasian (small blind) collected (€0.50)
Seat 5: marchuchok (big blind) folded before Flop
Seat 6: BaaroRai folded before Flop (didn't bet)





PokerStars Hand #148210929625:  Hold'em No Limit (£0.10/£0.25 GBP) - 2016/02/04 11:30:07 CET [2016/02/04 5:30:07 ET]
Table 'Libra II' 6-max Seat #6 is the button
Seat 1: k4rloos (£25.23 in chips) 
Seat 2: matiko09 (£25 in chips) 
Seat 3: namex11 (£25.46 in chips) 
Seat 6: pescador1522 (£15.14 in chips) 
k4rloos: posts small blind £0.10
matiko09: posts big blind £0.25
Vedmegatko: sits out 
*** HOLE CARDS ***
Dealt to matiko09 [Ks 3h]
namex11: folds 
pescador1522: calls £0.25
k4rloos: folds 
matiko09: checks 
*** FLOP *** [Ad Jh 8h]
matiko09: checks 
pescador1522: checks 
*** TURN *** [Ad Jh 8h] [Ah]
matiko09: checks 
pescador1522: checks 
*** RIVER *** [Ad Jh 8h Ah] [Ac]
matiko09: checks 
pescador1522: checks 
*** SHOW DOWN ***
matiko09: shows [Ks 3h] (three of a kind, Aces)
pescador1522: mucks hand 
matiko09 collected £0.57 from pot
*** SUMMARY ***
Total pot £0.60 | Rake £0.03 
Board [Ad Jh 8h Ah Ac]
Seat 1: k4rloos (small blind) folded before Flop
Seat 2: matiko09 (big blind) showed [Ks 3h] and won (£0.57) with three of a kind, Aces
Seat 3: namex11 folded before Flop (didn't bet)
Seat 6: pescador1522 (button) mucked [6s Qs]





PokerStars Hand #148210934634:  Hold'em No Limit ($0.10/$0.25 USD) - 2016/02/04 11:30:17 CET [2016/02/04 5:30:17 ET]
Table 'Thora II' 6-max Seat #4 is the button
Seat 2: schatun774 ($12.16 in chips) 
Seat 3: Odmincheg ($25 in chips) 
Seat 4: matiko09 ($26.13 in chips) 
Seat 5: PotgrabberAA ($25 in chips) 
Seat 6: cost983 ($25.35 in chips) 
PotgrabberAA: posts small blind $0.10
cost983: posts big blind $0.25
*** HOLE CARDS ***
Dealt to matiko09 [3c 2h]
schatun774: calls $0.25
Odmincheg: folds 
S1cker_0ne joins the table at seat #1 
matiko09: folds 
PotgrabberAA: calls $0.15
cost983: checks 
*** FLOP *** [Kd Js Qh]
PotgrabberAA: bets $0.50
cost983: calls $0.50
schatun774: calls $0.50
*** TURN *** [Kd Js Qh] [As]
PotgrabberAA: bets $1.50
cost983: raises $5.15 to $6.65
schatun774: folds 
PotgrabberAA: calls $5.15
*** RIVER *** [Kd Js Qh As] [4h]
PotgrabberAA: checks 
cost983: bets $7.42
PotgrabberAA: calls $7.42
*** SHOW DOWN ***
cost983: shows [Td Qc] (a straight, Ten to Ace)
PotgrabberAA: shows [Kh Ts] (a straight, Ten to Ace)
PotgrabberAA collected $14.51 from pot
cost983 collected $14.51 from pot
*** SUMMARY ***
Total pot $30.39 | Rake $1.37 
Board [Kd Js Qh As 4h]
Seat 2: schatun774 folded on the Turn
Seat 3: Odmincheg folded before Flop (didn't bet)
Seat 4: matiko09 (button) folded before Flop (didn't bet)
Seat 5: PotgrabberAA (small blind) showed [Kh Ts] and won ($14.51) with a straight, Ten to Ace
Seat 6: cost983 (big blind) showed [Td Qc] and won ($14.51) with a straight, Ten to Ace





PokerStars Hand #148210940382:  Hold'em No Limit ($0.10/$0.25 USD) - 2016/02/04 11:30:29 CET [2016/02/04 5:30:29 ET]
Table 'Golson' 6-max Seat #5 is the button
Seat 1: Ciudvdvno ($28.95 in chips) 
Seat 2: nnVinokurov ($36.47 in chips) 
Seat 3: Mirking2708 ($15.49 in chips) 
Seat 4: matiko09 ($25.35 in chips) 
Seat 5: getaca ($25 in chips) 
Seat 6: Wwwasian ($26.94 in chips) 
Wwwasian: posts small blind $0.10
Ciudvdvno: posts big blind $0.25
*** HOLE CARDS ***
Dealt to matiko09 [As Tc]
nnVinokurov: folds 
Mirking2708: folds 
matiko09: raises $0.50 to $0.75
getaca has timed out
getaca: folds 
Wwwasian: folds 
Ciudvdvno: folds 
Uncalled bet ($0.50) returned to matiko09
matiko09 collected $0.60 from pot
matiko09: doesn't show hand 
*** SUMMARY ***
Total pot $0.60 | Rake $0 
Seat 1: Ciudvdvno (big blind) folded before Flop
Seat 2: nnVinokurov folded before Flop (didn't bet)
Seat 3: Mirking2708 folded before Flop (didn't bet)
Seat 4: matiko09 collected ($0.60)
Seat 5: getaca (button) folded before Flop (didn't bet)
Seat 6: Wwwasian (small blind) folded before Flop





PokerStars Hand #148210947294:  Hold'em No Limit ($0.10/$0.25 USD) - 2016/02/04 11:30:42 CET [2016/02/04 5:30:42 ET]
Table 'Hippasos' 6-max Seat #3 is the button
Seat 1: VreDnYY ($25.35 in chips) 
Seat 2: Samerald ($35.89 in chips) 
Seat 3: Fank0_ ($29.65 in chips) 
Seat 4: endeavoor ($30.48 in chips) 
Seat 6: matiko09 ($25.65 in chips) 
endeavoor: posts small blind $0.10
matiko09: posts big blind $0.25
*** HOLE CARDS ***
Dealt to matiko09 [7s 6h]
VreDnYY: raises $0.50 to $0.75
Samerald: folds 
Fank0_: folds 
endeavoor: folds 
matiko09: folds 
Uncalled bet ($0.50) returned to VreDnYY
VreDnYY collected $0.60 from pot
VreDnYY: doesn't show hand 
*** SUMMARY ***
Total pot $0.60 | Rake $0 
Seat 1: VreDnYY collected ($0.60)
Seat 2: Samerald folded before Flop (didn't bet)
Seat 3: Fank0_ (button) folded before Flop (didn't bet)
Seat 4: endeavoor (small blind) folded before Flop
Seat 6: matiko09 (big blind) folded before Flop





PokerStars Hand #148210948772:  Hold'em No Limit ($0.10/$0.25 USD) - 2016/02/04 11:30:45 CET [2016/02/04 5:30:45 ET]
Table 'Aquarius II' 6-max Seat #3 is the button
Seat 1: Ciudvdvno ($25 in chips) 
Seat 2: ex3Lero86 ($31.74 in chips) 
Seat 3: MyBestPokeR ($27.40 in chips) 
Seat 4: RasmusB79 ($25.78 in chips) 
Seat 5: TroyPoker17 ($30.01 in chips) 
Seat 6: matiko09 ($26.02 in chips) 
RasmusB79: posts small blind $0.10
TroyPoker17: posts big blind $0.25
*** HOLE CARDS ***
Dealt to matiko09 [8h 7s]
matiko09: folds 
Ciudvdvno: folds 
ex3Lero86: raises $0.37 to $0.62
MyBestPokeR: folds 
RasmusB79: folds 
TroyPoker17: folds 
Uncalled bet ($0.37) returned to ex3Lero86
ex3Lero86 collected $0.60 from pot
ex3Lero86: doesn't show hand 
*** SUMMARY ***
Total pot $0.60 | Rake $0 
Seat 1: Ciudvdvno folded before Flop (didn't bet)
Seat 2: ex3Lero86 collected ($0.60)
Seat 3: MyBestPokeR (button) folded before Flop (didn't bet)
Seat 4: RasmusB79 (small blind) folded before Flop
Seat 5: TroyPoker17 (big blind) folded before Flop
Seat 6: matiko09 folded before Flop (didn't bet)





PokerStars Hand #148210949056:  Hold'em No Limit (£0.10/£0.25 GBP) - 2016/02/04 11:30:46 CET [2016/02/04 5:30:46 ET]
Table 'Libra II' 6-max Seat #1 is the button
Seat 1: k4rloos (£25.13 in chips) 
Seat 2: matiko09 (£25.32 in chips) 
Seat 3: namex11 (£25.46 in chips) 
Seat 6: pescador1522 (£14.89 in chips) 
matiko09: posts small blind £0.10
namex11: posts big blind £0.25
Vedmegatko: sits out 
*** HOLE CARDS ***
Dealt to matiko09 [Ts 3h]
pescador1522: calls £0.25
k4rloos: folds 
matiko09: folds 
namex11: checks 
*** FLOP *** [7d 7s Kh]
namex11: checks 
pescador1522: checks 
*** TURN *** [7d 7s Kh] [6c]
namex11: checks 
pescador1522: checks 
*** RIVER *** [7d 7s Kh 6c] [9s]
namex11: checks 
pescador1522: checks 
*** SHOW DOWN ***
namex11: shows [Qc 5c] (a pair of Sevens)
pescador1522: shows [Jc Jd] (two pair, Jacks and Sevens)
pescador1522 collected £0.57 from pot
*** SUMMARY ***
Total pot £0.60 | Rake £0.03 
Board [7d 7s Kh 6c 9s]
Seat 1: k4rloos (button) folded before Flop (didn't bet)
Seat 2: matiko09 (small blind) folded before Flop
Seat 3: namex11 (big blind) showed [Qc 5c] and lost with a pair of Sevens
Seat 6: pescador1522 showed [Jc Jd] and won (£0.57) with two pair, Jacks and Sevens





PokerStars Hand #148210949257:  Hold'em No Limit ($0.10/$0.25 USD) - 2016/02/04 11:30:46 CET [2016/02/04 5:30:46 ET]
Table 'Hungaria II' 6-max Seat #4 is the button
Seat 2: MaurerXL82 ($22.94 in chips) 
Seat 3: MAO_DZEDYN_S ($25 in chips) 
Seat 4: matiko09 ($25 in chips) 
Seat 5: nnVinokurov ($25 in chips) 
Seat 6: droog2 ($37.36 in chips) 
nnVinokurov: posts small blind $0.10
droog2: posts big blind $0.25
angrypaca: sits out 
*** HOLE CARDS ***
Dealt to matiko09 [Kd 6h]
MaurerXL82: folds 
MAO_DZEDYN_S: folds 
matiko09: folds 
nnVinokurov: folds 
Uncalled bet ($0.15) returned to droog2
droog2 collected $0.20 from pot
droog2: doesn't show hand 
*** SUMMARY ***
Total pot $0.20 | Rake $0 
Seat 2: MaurerXL82 folded before Flop (didn't bet)
Seat 3: MAO_DZEDYN_S folded before Flop (didn't bet)
Seat 4: matiko09 (button) folded before Flop (didn't bet)
Seat 5: nnVinokurov (small blind) folded before Flop
Seat 6: droog2 (big blind) collected ($0.20)





PokerStars Hand #148210949535:  Hold'em No Limit (€0.10/€0.25 EUR) - 2016/02/04 11:30:47 CET [2016/02/04 5:30:47 ET]
Table 'Lilaea III' 6-max Seat #4 is the button
Seat 1: matiko09 (€25.35 in chips) 
Seat 2: Newbie1990 (€38.62 in chips) 
Seat 3: uzzy20 (€25.67 in chips) 
Seat 4: Wwwasian (€29.04 in chips) 
Seat 5: marchuchok (€25 in chips) 
Seat 6: BaaroRai (€35.40 in chips) 
marchuchok: posts small blind €0.10
BaaroRai: posts big blind €0.25
*** HOLE CARDS ***
Dealt to matiko09 [2d 5s]
matiko09: folds 
Newbie1990: folds 
uzzy20: raises €0.31 to €0.56
Wwwasian: calls €0.56
marchuchok: calls €0.46
BaaroRai: calls €0.31
*** FLOP *** [7s As Qd]
marchuchok: checks 
BaaroRai: checks 
uzzy20: checks 
Wwwasian: bets €1.90
marchuchok: folds 
BaaroRai: folds 
uzzy20: folds 
Uncalled bet (€1.90) returned to Wwwasian
Wwwasian collected €2.14 from pot
Wwwasian: doesn't show hand 
*** SUMMARY ***
Total pot €2.24 | Rake €0.10 
Board [7s As Qd]
Seat 1: matiko09 folded before Flop (didn't bet)
Seat 2: Newbie1990 folded before Flop (didn't bet)
Seat 3: uzzy20 folded on the Flop
Seat 4: Wwwasian (button) collected (€2.14)
Seat 5: marchuchok (small blind) folded on the Flop
Seat 6: BaaroRai (big blind) folded on the Flop





PokerStars Hand #148210956053:  Hold'em No Limit ($0.10/$0.25 USD) - 2016/02/04 11:31:00 CET [2016/02/04 5:31:00 ET]
Table 'Hungaria II' 6-max Seat #5 is the button
Seat 1: angrypaca ($25 in chips) 
Seat 2: MaurerXL82 ($22.94 in chips) 
Seat 3: MAO_DZEDYN_S ($25 in chips) 
Seat 4: matiko09 ($25 in chips) 
Seat 5: nnVinokurov ($25 in chips) 
Seat 6: droog2 ($37.46 in chips) 
droog2: posts small blind $0.10
angrypaca: posts big blind $0.25
*** HOLE CARDS ***
Dealt to matiko09 [4c 9c]
MaurerXL82: folds 
MAO_DZEDYN_S: folds 
matiko09: folds 
nnVinokurov: raises $0.37 to $0.62
droog2: folds 
angrypaca: folds 
Uncalled bet ($0.37) returned to nnVinokurov
nnVinokurov collected $0.60 from pot
nnVinokurov: doesn't show hand 
*** SUMMARY ***
Total pot $0.60 | Rake $0 
Seat 1: angrypaca (big blind) folded before Flop
Seat 2: MaurerXL82 folded before Flop (didn't bet)
Seat 3: MAO_DZEDYN_S folded before Flop (didn't bet)
Seat 4: matiko09 folded before Flop (didn't bet)
Seat 5: nnVinokurov (button) collected ($0.60)
Seat 6: droog2 (small blind) folded before Flop





PokerStars Hand #148210959152:  Hold'em No Limit ($0.10/$0.25 USD) - 2016/02/04 11:31:06 CET [2016/02/04 5:31:06 ET]
Table 'Aquarius II' 6-max Seat #4 is the button
Seat 1: Ciudvdvno ($25 in chips) 
Seat 2: ex3Lero86 ($32.09 in chips) 
Seat 3: MyBestPokeR ($27.40 in chips) 
Seat 4: RasmusB79 ($25.68 in chips) 
Seat 5: TroyPoker17 ($29.76 in chips) 
Seat 6: matiko09 ($26.02 in chips) 
TroyPoker17: posts small blind $0.10
matiko09: posts big blind $0.25
*** HOLE CARDS ***
Dealt to matiko09 [7c 3h]
Ciudvdvno: folds 
ex3Lero86: folds 
MyBestPokeR: folds 
RasmusB79: raises $0.25 to $0.50
TroyPoker17: folds 
matiko09: folds 
Uncalled bet ($0.25) returned to RasmusB79
RasmusB79 collected $0.60 from pot
*** SUMMARY ***
Total pot $0.60 | Rake $0 
Seat 1: Ciudvdvno folded before Flop (didn't bet)
Seat 2: ex3Lero86 folded before Flop (didn't bet)
Seat 3: MyBestPokeR folded before Flop (didn't bet)
Seat 4: RasmusB79 (button) collected ($0.60)
Seat 5: TroyPoker17 (small blind) folded before Flop
Seat 6: matiko09 (big blind) folded before Flop





PokerStars Hand #148210961237:  Hold'em No Limit ($0.10/$0.25 USD) - 2016/02/04 11:31:10 CET [2016/02/04 5:31:10 ET]
Table 'Hippasos' 6-max Seat #4 is the button
Seat 1: VreDnYY ($25.70 in chips) 
Seat 2: Samerald ($35.89 in chips) 
Seat 3: Fank0_ ($29.65 in chips) 
Seat 4: endeavoor ($30.38 in chips) 
Seat 6: matiko09 ($25.40 in chips) 
matiko09: posts small blind $0.10
VreDnYY: posts big blind $0.25
*** HOLE CARDS ***
Dealt to matiko09 [5s 8h]
Samerald: folds 
Fank0_: raises $0.50 to $0.75
endeavoor: raises $1.50 to $2.25
matiko09: folds 
VreDnYY: folds 
Fank0_: calls $1.50
*** FLOP *** [Qh Js Ac]
Fank0_: checks 
endeavoor: bets $3
Fank0_: folds 
Uncalled bet ($3) returned to endeavoor
endeavoor collected $4.63 from pot
endeavoor: doesn't show hand 
*** SUMMARY ***
Total pot $4.85 | Rake $0.22 
Board [Qh Js Ac]
Seat 1: VreDnYY (big blind) folded before Flop
Seat 2: Samerald folded before Flop (didn't bet)
Seat 3: Fank0_ folded on the Flop
Seat 4: endeavoor (button) collected ($4.63)
Seat 6: matiko09 (small blind) folded before Flop





PokerStars Hand #148210968181:  Hold'em No Limit ($0.10/$0.25 USD) - 2016/02/04 11:31:24 CET [2016/02/04 5:31:24 ET]
Table 'Golson' 6-max Seat #6 is the button
Seat 1: Ciudvdvno ($28.70 in chips) 
Seat 2: nnVinokurov ($36.47 in chips) 
Seat 3: Mirking2708 ($15.49 in chips) 
Seat 4: matiko09 ($25.70 in chips) 
Seat 6: Wwwasian ($26.84 in chips) 
Ciudvdvno: posts small blind $0.10
nnVinokurov: posts big blind $0.25
*** HOLE CARDS ***
Dealt to matiko09 [Ah Jh]
Mirking2708: folds 
matiko09: raises $0.50 to $0.75
Wwwasian: calls $0.75
Ciudvdvno: folds 
nnVinokurov: folds 
*** FLOP *** [Kc 5d 5s]
matiko09: checks 
Wwwasian: bets $1
matiko09: folds 
Uncalled bet ($1) returned to Wwwasian
Wwwasian collected $1.77 from pot
Wwwasian: doesn't show hand 
*** SUMMARY ***
Total pot $1.85 | Rake $0.08 
Board [Kc 5d 5s]
Seat 1: Ciudvdvno (small blind) folded before Flop
Seat 2: nnVinokurov (big blind) folded before Flop
Seat 3: Mirking2708 folded before Flop (didn't bet)
Seat 4: matiko09 folded on the Flop
Seat 6: Wwwasian (button) collected ($1.77)





PokerStars Hand #148210968504:  Hold'em No Limit ($0.10/$0.25 USD) - 2016/02/04 11:31:24 CET [2016/02/04 5:31:24 ET]
Table 'Hungaria II' 6-max Seat #6 is the button
Seat 1: angrypaca ($25 in chips) 
Seat 2: MaurerXL82 ($22.94 in chips) 
Seat 3: MAO_DZEDYN_S ($25 in chips) 
Seat 4: matiko09 ($25 in chips) 
Seat 5: nnVinokurov ($25.35 in chips) 
Seat 6: droog2 ($37.36 in chips) 
angrypaca: posts small blind $0.10
MaurerXL82: posts big blind $0.25
*** HOLE CARDS ***
Dealt to matiko09 [Jc 6h]
MAO_DZEDYN_S: folds 
matiko09: folds 
nnVinokurov: folds 
droog2: folds 
angrypaca: folds 
Uncalled bet ($0.15) returned to MaurerXL82
MaurerXL82 collected $0.20 from pot
MaurerXL82: doesn't show hand 
*** SUMMARY ***
Total pot $0.20 | Rake $0 
Seat 1: angrypaca (small blind) folded before Flop
Seat 2: MaurerXL82 (big blind) collected ($0.20)
Seat 3: MAO_DZEDYN_S folded before Flop (didn't bet)
Seat 4: matiko09 folded before Flop (didn't bet)
Seat 5: nnVinokurov folded before Flop (didn't bet)
Seat 6: droog2 (button) folded before Flop (didn't bet)





PokerStars Hand #148210972379:  Hold'em No Limit ($0.10/$0.25 USD) - 2016/02/04 11:31:32 CET [2016/02/04 5:31:32 ET]
Table 'Aquarius II' 6-max Seat #5 is the button
Seat 1: Ciudvdvno ($25 in chips) 
Seat 2: ex3Lero86 ($32.09 in chips) 
Seat 3: MyBestPokeR ($27.40 in chips) 
Seat 4: RasmusB79 ($26.03 in chips) 
Seat 5: TroyPoker17 ($29.66 in chips) 
Seat 6: matiko09 ($25.77 in chips) 
matiko09: posts small blind $0.10
Ciudvdvno: posts big blind $0.25
*** HOLE CARDS ***
Dealt to matiko09 [9s Tc]
ex3Lero86: folds 
MyBestPokeR: folds 
RasmusB79: folds 
TroyPoker17: raises $0.25 to $0.50
matiko09: folds 
Ciudvdvno: calls $0.25
*** FLOP *** [4h Js Jc]
Ciudvdvno: checks 
TroyPoker17: checks 
*** TURN *** [4h Js Jc] [8h]
Ciudvdvno: checks 
TroyPoker17: checks 
*** RIVER *** [4h Js Jc 8h] [Qd]
Ciudvdvno: checks 
TroyPoker17: bets $0.69
Ciudvdvno: calls $0.69
*** SHOW DOWN ***
TroyPoker17: shows [Qs Ad] (two pair, Queens and Jacks)
Ciudvdvno: mucks hand 
TroyPoker17 collected $2.37 from pot
*** SUMMARY ***
Total pot $2.48 | Rake $0.11 
Board [4h Js Jc 8h Qd]
Seat 1: Ciudvdvno (big blind) mucked [5c 4d]
Seat 2: ex3Lero86 folded before Flop (didn't bet)
Seat 3: MyBestPokeR folded before Flop (didn't bet)
Seat 4: RasmusB79 folded before Flop (didn't bet)
Seat 5: TroyPoker17 (button) showed [Qs Ad] and won ($2.37) with two pair, Queens and Jacks
Seat 6: matiko09 (small blind) folded before Flop





PokerStars Hand #148210976960:  Hold'em No Limit (£0.10/£0.25 GBP) - 2016/02/04 11:31:41 CET [2016/02/04 5:31:41 ET]
Table 'Libra II' 6-max Seat #2 is the button
Seat 2: matiko09 (£25.22 in chips) 
Seat 3: namex11 (£25.21 in chips) 
Seat 5: Vedmegatko (£25 in chips) 
Seat 6: pescador1522 (£15.21 in chips) 
namex11: posts small blind £0.10
Vedmegatko: posts big blind £0.25
*** HOLE CARDS ***
Dealt to matiko09 [2h Ah]
pescador1522: calls £0.25
matiko09: raises £0.75 to £1
namex11: folds 
Vedmegatko: folds 
pescador1522: raises £14.21 to £15.21 and is all-in
matiko09: folds 
Uncalled bet (£14.21) returned to pescador1522
pescador1522 collected £2.35 from pot
pescador1522: doesn't show hand 
*** SUMMARY ***
Total pot £2.35 | Rake £0 
Seat 2: matiko09 (button) folded before Flop
Seat 3: namex11 (small blind) folded before Flop
Seat 5: Vedmegatko (big blind) folded before Flop
Seat 6: pescador1522 collected (£2.35)





PokerStars Hand #148210978826:  Hold'em No Limit ($0.10/$0.25 USD) - 2016/02/04 11:31:45 CET [2016/02/04 5:31:45 ET]
Table 'Hungaria II' 6-max Seat #1 is the button
Seat 1: angrypaca ($25 in chips) 
Seat 2: MaurerXL82 ($23.04 in chips) 
Seat 3: MAO_DZEDYN_S ($25 in chips) 
Seat 4: matiko09 ($25 in chips) 
Seat 5: nnVinokurov ($25.35 in chips) 
Seat 6: droog2 ($37.36 in chips) 
MaurerXL82: posts small blind $0.10
MAO_DZEDYN_S: posts big blind $0.25
*** HOLE CARDS ***
Dealt to matiko09 [8h 9d]
matiko09: folds 
nnVinokurov: folds 
droog2: folds 
angrypaca: raises $0.50 to $0.75
MaurerXL82: calls $0.65
MAO_DZEDYN_S: folds 
*** FLOP *** [4c 4h 6s]
MaurerXL82: bets $0.25
angrypaca: calls $0.25
*** TURN *** [4c 4h 6s] [4s]
MaurerXL82: bets $0.25
angrypaca: calls $0.25
*** RIVER *** [4c 4h 6s 4s] [Tc]
MaurerXL82: bets $0.25
angrypaca: calls $0.25
*** SHOW DOWN ***
MaurerXL82: shows [8s 8c] (a full house, Fours full of Eights)
angrypaca: mucks hand 
MaurerXL82 collected $3.10 from pot
*** SUMMARY ***
Total pot $3.25 | Rake $0.15 
Board [4c 4h 6s 4s Tc]
Seat 1: angrypaca (button) mucked [Ah 9c]
Seat 2: MaurerXL82 (small blind) showed [8s 8c] and won ($3.10) with a full house, Fours full of Eights
Seat 3: MAO_DZEDYN_S (big blind) folded before Flop
Seat 4: matiko09 folded before Flop (didn't bet)
Seat 5: nnVinokurov folded before Flop (didn't bet)
Seat 6: droog2 folded before Flop (didn't bet)





PokerStars Hand #148210981719:  Hold'em No Limit ($0.10/$0.25 USD) - 2016/02/04 11:31:51 CET [2016/02/04 5:31:51 ET]
Table 'Thora II' 6-max Seat #5 is the button
Seat 1: S1cker_0ne ($25 in chips) 
Seat 2: schatun774 ($11.41 in chips) 
Seat 3: Odmincheg ($25 in chips) 
Seat 4: matiko09 ($26.13 in chips) 
Seat 5: PotgrabberAA ($25 in chips) 
Seat 6: cost983 ($25.04 in chips) 
cost983: posts small blind $0.10
S1cker_0ne: posts big blind $0.25
*** HOLE CARDS ***
Dealt to matiko09 [8s 5d]
schatun774: calls $0.25
Odmincheg: folds 
matiko09: folds 
PotgrabberAA has timed out
PotgrabberAA: folds 
cost983: folds 
S1cker_0ne: checks 
*** FLOP *** [8c 4s 9d]
S1cker_0ne: checks 
schatun774: checks 
*** TURN *** [8c 4s 9d] [4d]
S1cker_0ne: bets $0.31
schatun774: calls $0.31
*** RIVER *** [8c 4s 9d 4d] [Qh]
S1cker_0ne: bets $0.49
schatun774: calls $0.49
*** SHOW DOWN ***
S1cker_0ne: shows [Td 6s] (a pair of Fours)
schatun774: shows [Kd 8h] (two pair, Eights and Fours)
schatun774 collected $2.10 from pot
*** SUMMARY ***
Total pot $2.20 | Rake $0.10 
Board [8c 4s 9d 4d Qh]
Seat 1: S1cker_0ne (big blind) showed [Td 6s] and lost with a pair of Fours
Seat 2: schatun774 showed [Kd 8h] and won ($2.10) with two pair, Eights and Fours
Seat 3: Odmincheg folded before Flop (didn't bet)
Seat 4: matiko09 folded before Flop (didn't bet)
Seat 5: PotgrabberAA (button) folded before Flop (didn't bet)
Seat 6: cost983 (small blind) folded before Flop





PokerStars Hand #148210984574:  Hold'em No Limit (€0.10/€0.25 EUR) - 2016/02/04 11:31:57 CET [2016/02/04 5:31:57 ET]
Table 'Lilaea III' 6-max Seat #5 is the button
Seat 1: matiko09 (€25.35 in chips) 
Seat 2: Newbie1990 (€38.62 in chips) 
Seat 3: uzzy20 (€25.11 in chips) 
Seat 4: Wwwasian (€30.62 in chips) 
Seat 5: marchuchok (€25 in chips) 
Seat 6: BaaroRai (€34.84 in chips) 
BaaroRai: posts small blind €0.10
matiko09: posts big blind €0.25
*** HOLE CARDS ***
Dealt to matiko09 [Kd 4h]
Newbie1990: folds 
uzzy20: folds 
Wwwasian: raises €0.45 to €0.70
marchuchok: folds 
BaaroRai: calls €0.60
matiko09: folds 
*** FLOP *** [Ad Ts Js]
BaaroRai: checks 
Wwwasian: checks 
*** TURN *** [Ad Ts Js] [Ac]
BaaroRai: checks 
Wwwasian: checks 
*** RIVER *** [Ad Ts Js Ac] [9d]
BaaroRai: bets €1.25
Wwwasian: raises €3.25 to €4.50
BaaroRai: folds 
Uncalled bet (€3.25) returned to Wwwasian
Wwwasian collected €3.96 from pot
Wwwasian: doesn't show hand 
*** SUMMARY ***
Total pot €4.15 | Rake €0.19 
Board [Ad Ts Js Ac 9d]
Seat 1: matiko09 (big blind) folded before Flop
Seat 2: Newbie1990 folded before Flop (didn't bet)
Seat 3: uzzy20 folded before Flop (didn't bet)
Seat 4: Wwwasian collected (€3.96)
Seat 5: marchuchok (button) folded before Flop (didn't bet)
Seat 6: BaaroRai (small blind) folded on the River





PokerStars Hand #148210988359:  Hold'em No Limit ($0.10/$0.25 USD) - 2016/02/04 11:32:04 CET [2016/02/04 5:32:04 ET]
Table 'Hippasos' 6-max Seat #6 is the button
Seat 1: VreDnYY ($25.45 in chips) 
Seat 2: Samerald ($35.89 in chips) 
Seat 3: Fank0_ ($27.40 in chips) 
Seat 4: endeavoor ($32.76 in chips) 
Seat 6: matiko09 ($25.30 in chips) 
VreDnYY: posts small blind $0.10
Samerald: posts big blind $0.25
*** HOLE CARDS ***
Dealt to matiko09 [7h 4c]
Fank0_: folds 
endeavoor: folds 
matiko09: folds 
VreDnYY: raises $0.37 to $0.62
Samerald: folds 
Uncalled bet ($0.37) returned to VreDnYY
VreDnYY collected $0.50 from pot
VreDnYY: doesn't show hand 
*** SUMMARY ***
Total pot $0.50 | Rake $0 
Seat 1: VreDnYY (small blind) collected ($0.50)
Seat 2: Samerald (big blind) folded before Flop
Seat 3: Fank0_ folded before Flop (didn't bet)
Seat 4: endeavoor folded before Flop (didn't bet)
Seat 6: matiko09 (button) folded before Flop (didn't bet)





PokerStars Hand #148210988154:  Hold'em No Limit (£0.10/£0.25 GBP) - 2016/02/04 11:32:04 CET [2016/02/04 5:32:04 ET]
Table 'Libra II' 6-max Seat #3 is the button
Seat 2: matiko09 (£25 in chips) 
Seat 3: namex11 (£25.11 in chips) 
Seat 5: Vedmegatko (£25 in chips) 
Seat 6: pescador1522 (£16.56 in chips) 
Vedmegatko: posts small blind £0.10
pescador1522: posts big blind £0.25
*** HOLE CARDS ***
Dealt to matiko09 [Th 7h]
matiko09: raises £0.50 to £0.75
namex11: folds 
Vedmegatko: folds 
pescador1522: calls £0.50
*** FLOP *** [Kd 8c 3s]
pescador1522: checks 
matiko09: bets £0.79
pescador1522: calls £0.79
*** TURN *** [Kd 8c 3s] [4d]
pescador1522: checks 
matiko09: checks 
*** RIVER *** [Kd 8c 3s 4d] [Ad]
pescador1522: checks 
matiko09: checks 
*** SHOW DOWN ***
pescador1522: shows [Tc Ks] (a pair of Kings)
matiko09: mucks hand 
pescador1522 collected £3.04 from pot
*** SUMMARY ***
Total pot £3.18 | Rake £0.14 
Board [Kd 8c 3s 4d Ad]
Seat 2: matiko09 mucked [Th 7h]
Seat 3: namex11 (button) folded before Flop (didn't bet)
Seat 5: Vedmegatko (small blind) folded before Flop
Seat 6: pescador1522 (big blind) showed [Tc Ks] and won (£3.04) with a pair of Kings





PokerStars Hand #148210997929:  Hold'em No Limit ($0.10/$0.25 USD) - 2016/02/04 11:32:23 CET [2016/02/04 5:32:23 ET]
Table 'Golson' 6-max Seat #1 is the button
Seat 1: Ciudvdvno ($28.60 in chips) 
Seat 2: nnVinokurov ($36.22 in chips) 
Seat 3: Mirking2708 ($15.49 in chips) 
Seat 4: matiko09 ($25 in chips) 
Seat 5: getaca ($25 in chips) 
Seat 6: Wwwasian ($27.86 in chips) 
nnVinokurov: posts small blind $0.10
Mirking2708: posts big blind $0.25
*** HOLE CARDS ***
Dealt to matiko09 [2c 3c]
matiko09: folds 
getaca: folds 
Wwwasian: folds 
Ciudvdvno: raises $0.25 to $0.50
nnVinokurov: folds 
Mirking2708: calls $0.25
*** FLOP *** [4s Td Ks]
Mirking2708: bets $0.50
Ciudvdvno: calls $0.50
*** TURN *** [4s Td Ks] [3h]
Mirking2708: bets $0.75
Ciudvdvno: folds 
Uncalled bet ($0.75) returned to Mirking2708
Mirking2708 collected $2.01 from pot
Mirking2708: doesn't show hand 
*** SUMMARY ***
Total pot $2.10 | Rake $0.09 
Board [4s Td Ks 3h]
Seat 1: Ciudvdvno (button) folded on the Turn
Seat 2: nnVinokurov (small blind) folded before Flop
Seat 3: Mirking2708 (big blind) collected ($2.01)
Seat 4: matiko09 folded before Flop (didn't bet)
Seat 5: getaca folded before Flop (didn't bet)
Seat 6: Wwwasian folded before Flop (didn't bet)





PokerStars Hand #148210998270:  Hold'em No Limit ($0.10/$0.25 USD) - 2016/02/04 11:32:24 CET [2016/02/04 5:32:24 ET]
Table 'Hippasos' 6-max Seat #1 is the button
Seat 1: VreDnYY ($25.70 in chips) 
Seat 2: Samerald ($35.64 in chips) 
Seat 3: Fank0_ ($27.40 in chips) 
Seat 4: endeavoor ($32.76 in chips) 
Seat 6: matiko09 ($25.30 in chips) 
Samerald: posts small blind $0.10
Fank0_: posts big blind $0.25
*** HOLE CARDS ***
Dealt to matiko09 [Jd 4d]
endeavoor: folds 
matiko09: folds 
VreDnYY: raises $0.25 to $0.50
Samerald: folds 
Fank0_: calls $0.25
*** FLOP *** [8s Jh Qc]
Fank0_: checks 
VreDnYY: checks 
*** TURN *** [8s Jh Qc] [3h]
Fank0_: bets $0.75
VreDnYY: folds 
Uncalled bet ($0.75) returned to Fank0_
Fank0_ collected $1.05 from pot
Fank0_: doesn't show hand 
*** SUMMARY ***
Total pot $1.10 | Rake $0.05 
Board [8s Jh Qc 3h]
Seat 1: VreDnYY (button) folded on the Turn
Seat 2: Samerald (small blind) folded before Flop
Seat 3: Fank0_ (big blind) collected ($1.05)
Seat 4: endeavoor folded before Flop (didn't bet)
Seat 6: matiko09 folded before Flop (didn't bet)





PokerStars Hand #148211002833:  Hold'em No Limit ($0.10/$0.25 USD) - 2016/02/04 11:32:33 CET [2016/02/04 5:32:33 ET]
Table 'Aquarius II' 6-max Seat #6 is the button
Seat 1: Ciudvdvno ($25 in chips) 
Seat 3: MyBestPokeR ($27.40 in chips) 
Seat 4: RasmusB79 ($26.03 in chips) 
Seat 5: TroyPoker17 ($30.84 in chips) 
Seat 6: matiko09 ($25.67 in chips) 
Ciudvdvno: posts small blind $0.10
ex3Lero86: is sitting out 
ex3Lero86 leaves the table
MyBestPokeR: posts big blind $0.25
*** HOLE CARDS ***
Dealt to matiko09 [Qc 5h]
RasmusB79: folds 
pokernet88 joins the table at seat #2 
TroyPoker17 is disconnected 
TroyPoker17 has timed out while disconnected
TroyPoker17: folds 
matiko09: folds 
Ciudvdvno: raises $0.50 to $0.75
MyBestPokeR: folds 
Uncalled bet ($0.50) returned to Ciudvdvno
Ciudvdvno collected $0.50 from pot
*** SUMMARY ***
Total pot $0.50 | Rake $0 
Seat 1: Ciudvdvno (small blind) collected ($0.50)
Seat 3: MyBestPokeR (big blind) folded before Flop
Seat 4: RasmusB79 folded before Flop (didn't bet)
Seat 5: TroyPoker17 folded before Flop (didn't bet)
Seat 6: matiko09 (button) folded before Flop (didn't bet)





PokerStars Hand #148211004520:  Hold'em No Limit (£0.10/£0.25 GBP) - 2016/02/04 11:32:36 CET [2016/02/04 5:32:36 ET]
Table 'Libra II' 6-max Seat #5 is the button
Seat 2: matiko09 (£25 in chips) 
Seat 3: namex11 (£25.11 in chips) 
Seat 5: Vedmegatko (£25 in chips) 
Seat 6: pescador1522 (£18.06 in chips) 
pescador1522: posts small blind £0.10
matiko09: posts big blind £0.25
*** HOLE CARDS ***
Dealt to matiko09 [4s 5d]
namex11: folds 
Vedmegatko: raises £0.37 to £0.62
pescador1522: folds 
matiko09: folds 
Uncalled bet (£0.37) returned to Vedmegatko
Vedmegatko collected £0.60 from pot
Vedmegatko: doesn't show hand 
*** SUMMARY ***
Total pot £0.60 | Rake £0 
Seat 2: matiko09 (big blind) folded before Flop
Seat 3: namex11 folded before Flop (didn't bet)
Seat 5: Vedmegatko (button) collected (£0.60)
Seat 6: pescador1522 (small blind) folded before Flop





PokerStars Hand #148211006379:  Hold'em No Limit ($0.10/$0.25 USD) - 2016/02/04 11:32:40 CET [2016/02/04 5:32:40 ET]
Table 'Thora II' 6-max Seat #6 is the button
Seat 1: S1cker_0ne ($25 in chips) 
Seat 2: schatun774 ($12.46 in chips) 
Seat 3: Odmincheg ($25 in chips) 
Seat 4: matiko09 ($26.13 in chips) 
Seat 6: cost983 ($25 in chips) 
S1cker_0ne: posts small blind $0.10
schatun774: posts big blind $0.25
*** HOLE CARDS ***
Dealt to matiko09 [5c Js]
Odmincheg: folds 
matiko09: folds 
cost983: raises $0.37 to $0.62
S1cker_0ne: raises $1.49 to $2.11
schatun774: folds 
cost983: raises $2.79 to $4.90
S1cker_0ne: raises $20.10 to $25 and is all-in
cost983: calls $20.10 and is all-in
*** FIRST FLOP *** [4s 9c 7d]
*** FIRST TURN *** [4s 9c 7d] [Kd]
*** FIRST RIVER *** [4s 9c 7d Kd] [2c]
*** SECOND FLOP *** [Kh Ks Jh]
*** SECOND TURN *** [Kh Ks Jh] [Ac]
*** SECOND RIVER *** [Kh Ks Jh Ac] [2s]
*** FIRST SHOW DOWN ***
S1cker_0ne: shows [Ad Kc] (a pair of Kings)
cost983: shows [Qc Qs] (a pair of Queens)
S1cker_0ne collected $24.13 from pot
*** SECOND SHOW DOWN ***
S1cker_0ne: shows [Ad Kc] (a full house, Kings full of Aces)
cost983: shows [Qc Qs] (two pair, Kings and Queens)
S1cker_0ne collected $24.12 from pot
*** SUMMARY ***
Total pot $50.25 | Rake $2 
Hand was run twice
FIRST Board [4s 9c 7d Kd 2c]
SECOND Board [Kh Ks Jh Ac 2s]
Seat 1: S1cker_0ne (small blind) showed [Ad Kc] and won ($24.13) with a pair of Kings, and won ($24.12) with a full house, Kings full of Aces
Seat 2: schatun774 (big blind) folded before Flop
Seat 3: Odmincheg folded before Flop (didn't bet)
Seat 4: matiko09 folded before Flop (didn't bet)
Seat 6: cost983 (button) showed [Qc Qs] and lost with a pair of Queens, and lost with two pair, Kings and Queens





PokerStars Hand #148211010162:  Hold'em No Limit (£0.10/£0.25 GBP) - 2016/02/04 11:32:47 CET [2016/02/04 5:32:47 ET]
Table 'Libra II' 6-max Seat #6 is the button
Seat 2: matiko09 (£25 in chips) 
Seat 3: namex11 (£25.11 in chips) 
Seat 5: Vedmegatko (£25.35 in chips) 
Seat 6: pescador1522 (£17.96 in chips) 
matiko09: posts small blind £0.10
namex11: posts big blind £0.25
*** HOLE CARDS ***
Dealt to matiko09 [3c 3h]
Vedmegatko: folds 
pescador1522: folds 
matiko09: raises £0.50 to £0.75
namex11: folds 
Uncalled bet (£0.50) returned to matiko09
matiko09 collected £0.50 from pot
matiko09: doesn't show hand 
*** SUMMARY ***
Total pot £0.50 | Rake £0 
Seat 2: matiko09 (small blind) collected (£0.50)
Seat 3: namex11 (big blind) folded before Flop
Seat 5: Vedmegatko folded before Flop (didn't bet)
Seat 6: pescador1522 (button) folded before Flop (didn't bet)





PokerStars Hand #148211011913:  Hold'em No Limit ($0.10/$0.25 USD) - 2016/02/04 11:32:51 CET [2016/02/04 5:32:51 ET]
Table 'Hungaria II' 6-max Seat #2 is the button
Seat 1: angrypaca ($25 in chips) 
Seat 2: MaurerXL82 ($24.64 in chips) 
Seat 3: MAO_DZEDYN_S ($25 in chips) 
Seat 4: matiko09 ($25 in chips) 
Seat 5: nnVinokurov ($25.35 in chips) 
Seat 6: droog2 ($37.36 in chips) 
MAO_DZEDYN_S: posts small blind $0.10
matiko09: posts big blind $0.25
*** HOLE CARDS ***
Dealt to matiko09 [7s Kc]
nnVinokurov: folds 
droog2: raises $0.50 to $0.75
angrypaca: folds 
MaurerXL82: calls $0.75
MAO_DZEDYN_S: folds 
matiko09: folds 
*** FLOP *** [2c Ac Td]
droog2: bets $1.23
MaurerXL82: folds 
Uncalled bet ($1.23) returned to droog2
droog2 collected $1.77 from pot
droog2: doesn't show hand 
*** SUMMARY ***
Total pot $1.85 | Rake $0.08 
Board [2c Ac Td]
Seat 1: angrypaca folded before Flop (didn't bet)
Seat 2: MaurerXL82 (button) folded on the Flop
Seat 3: MAO_DZEDYN_S (small blind) folded before Flop
Seat 4: matiko09 (big blind) folded before Flop
Seat 5: nnVinokurov folded before Flop (didn't bet)
Seat 6: droog2 collected ($1.77)





PokerStars Hand #148211013041:  Hold'em No Limit ($0.10/$0.25 USD) - 2016/02/04 11:32:53 CET [2016/02/04 5:32:53 ET]
Table 'Hippasos' 6-max Seat #2 is the button
Seat 1: VreDnYY ($25.20 in chips) 
Seat 2: Samerald ($35.54 in chips) 
Seat 3: Fank0_ ($27.95 in chips) 
Seat 4: endeavoor ($32.76 in chips) 
Seat 6: matiko09 ($25.30 in chips) 
Fank0_: posts small blind $0.10
endeavoor: posts big blind $0.25
*** HOLE CARDS ***
Dealt to matiko09 [Kh Jh]
matiko09: raises $0.50 to $0.75
VreDnYY: folds 
Samerald: folds 
Fank0_: folds 
endeavoor: folds 
Uncalled bet ($0.50) returned to matiko09
matiko09 collected $0.60 from pot
matiko09: doesn't show hand 
*** SUMMARY ***
Total pot $0.60 | Rake $0 
Seat 1: VreDnYY folded before Flop (didn't bet)
Seat 2: Samerald (button) folded before Flop (didn't bet)
Seat 3: Fank0_ (small blind) folded before Flop
Seat 4: endeavoor (big blind) folded before Flop
Seat 6: matiko09 collected ($0.60)





PokerStars Hand #148211014882:  Hold'em No Limit (£0.10/£0.25 GBP) - 2016/02/04 11:32:57 CET [2016/02/04 5:32:57 ET]
Table 'Libra II' 6-max Seat #2 is the button
Seat 2: matiko09 (£25.25 in chips) 
Seat 3: namex11 (£25 in chips) 
Seat 5: Vedmegatko (£25.35 in chips) 
namex11: posts small blind £0.10
Vedmegatko: posts big blind £0.25
*** HOLE CARDS ***
Dealt to matiko09 [Qd 8c]
matiko09: folds 
namex11: raises £0.50 to £0.75
Vedmegatko: folds 
Uncalled bet (£0.50) returned to namex11
namex11 collected £0.50 from pot
namex11: doesn't show hand 
*** SUMMARY ***
Total pot £0.50 | Rake £0 
Seat 2: matiko09 (button) folded before Flop (didn't bet)
Seat 3: namex11 (small blind) collected (£0.50)
Seat 5: Vedmegatko (big blind) folded before Flop





PokerStars Hand #148211020139:  Hold'em No Limit (€0.10/€0.25 EUR) - 2016/02/04 11:33:07 CET [2016/02/04 5:33:07 ET]
Table 'Lilaea III' 6-max Seat #6 is the button
Seat 1: matiko09 (€25.10 in chips) 
Seat 2: Newbie1990 (€38.62 in chips) 
Seat 3: uzzy20 (€25.11 in chips) 
Seat 4: Wwwasian (€32.63 in chips) 
Seat 5: marchuchok (€25 in chips) 
Seat 6: BaaroRai (€32.89 in chips) 
matiko09: posts small blind €0.10
Newbie1990: posts big blind €0.25
*** HOLE CARDS ***
Dealt to matiko09 [2h Qd]
uzzy20: folds 
Wwwasian: folds 
marchuchok: raises €0.50 to €0.75
BaaroRai: folds 
matiko09: folds 
Newbie1990: raises €1.75 to €2.50
marchuchok: folds 
Uncalled bet (€1.75) returned to Newbie1990
Newbie1990 collected €1.60 from pot
Newbie1990: doesn't show hand 
*** SUMMARY ***
Total pot €1.60 | Rake €0 
Seat 1: matiko09 (small blind) folded before Flop
Seat 2: Newbie1990 (big blind) collected (€1.60)
Seat 3: uzzy20 folded before Flop (didn't bet)
Seat 4: Wwwasian folded before Flop (didn't bet)
Seat 5: marchuchok folded before Flop
Seat 6: BaaroRai (button) folded before Flop (didn't bet)





PokerStars Hand #148211020080:  Hold'em No Limit ($0.10/$0.25 USD) - 2016/02/04 11:33:07 CET [2016/02/04 5:33:07 ET]
Table 'Hippasos' 6-max Seat #3 is the button
Seat 1: VreDnYY ($25.20 in chips) 
Seat 2: Samerald ($35.54 in chips) 
Seat 3: Fank0_ ($27.85 in chips) 
Seat 4: endeavoor ($32.51 in chips) 
Seat 6: matiko09 ($25.65 in chips) 
endeavoor: posts small blind $0.10
matiko09: posts big blind $0.25
*** HOLE CARDS ***
Dealt to matiko09 [Qc 4s]
VreDnYY: folds 
Samerald: folds 
Fank0_: folds 
endeavoor: raises $0.50 to $0.75
matiko09: folds 
Uncalled bet ($0.50) returned to endeavoor
endeavoor collected $0.50 from pot
endeavoor: doesn't show hand 
*** SUMMARY ***
Total pot $0.50 | Rake $0 
Seat 1: VreDnYY folded before Flop (didn't bet)
Seat 2: Samerald folded before Flop (didn't bet)
Seat 3: Fank0_ (button) folded before Flop (didn't bet)
Seat 4: endeavoor (small blind) collected ($0.50)
Seat 6: matiko09 (big blind) folded before Flop





PokerStars Hand #148211023096:  Hold'em No Limit (£0.10/£0.25 GBP) - 2016/02/04 11:33:13 CET [2016/02/04 5:33:13 ET]
Table 'Libra II' 6-max Seat #3 is the button
Seat 2: matiko09 (£25.25 in chips) 
Seat 3: namex11 (£25.25 in chips) 
Seat 5: Vedmegatko (£25.10 in chips) 
Seat 6: pescador1522 (£17.96 in chips) 
Vedmegatko: posts small blind £0.10
pescador1522: posts big blind £0.25
*** HOLE CARDS ***
Dealt to matiko09 [8s 7c]
matiko09: folds 
namex11: folds 
Vedmegatko: folds 
Uncalled bet (£0.15) returned to pescador1522
pescador1522 collected £0.20 from pot
pescador1522: doesn't show hand 
*** SUMMARY ***
Total pot £0.20 | Rake £0 
Seat 2: matiko09 folded before Flop (didn't bet)
Seat 3: namex11 (button) folded before Flop (didn't bet)
Seat 5: Vedmegatko (small blind) folded before Flop
Seat 6: pescador1522 (big blind) collected (£0.20)





PokerStars Hand #148211030564:  Hold'em No Limit ($0.10/$0.25 USD) - 2016/02/04 11:33:28 CET [2016/02/04 5:33:28 ET]
Table 'Hungaria II' 6-max Seat #3 is the button
Seat 1: angrypaca ($25 in chips) 
Seat 2: MaurerXL82 ($23.89 in chips) 
Seat 3: MAO_DZEDYN_S ($25 in chips) 
Seat 4: matiko09 ($25 in chips) 
Seat 5: nnVinokurov ($25.35 in chips) 
Seat 6: droog2 ($38.38 in chips) 
matiko09: posts small blind $0.10
nnVinokurov: posts big blind $0.25
*** HOLE CARDS ***
Dealt to matiko09 [6h 8s]
droog2: folds 
angrypaca: folds 
MaurerXL82: folds 
MAO_DZEDYN_S: raises $0.27 to $0.52
matiko09: folds 
nnVinokurov: folds 
Uncalled bet ($0.27) returned to MAO_DZEDYN_S
MAO_DZEDYN_S collected $0.60 from pot
MAO_DZEDYN_S: doesn't show hand 
*** SUMMARY ***
Total pot $0.60 | Rake $0 
Seat 1: angrypaca folded before Flop (didn't bet)
Seat 2: MaurerXL82 folded before Flop (didn't bet)
Seat 3: MAO_DZEDYN_S (button) collected ($0.60)
Seat 4: matiko09 (small blind) folded before Flop
Seat 5: nnVinokurov (big blind) folded before Flop
Seat 6: droog2 folded before Flop (didn't bet)





PokerStars Hand #148211032481:  Hold'em No Limit (£0.10/£0.25 GBP) - 2016/02/04 11:33:32 CET [2016/02/04 5:33:32 ET]
Table 'Libra II' 6-max Seat #5 is the button
Seat 2: matiko09 (£25.25 in chips) 
Seat 3: namex11 (£25.25 in chips) 
Seat 5: Vedmegatko (£25 in chips) 
Seat 6: pescador1522 (£18.06 in chips) 
pescador1522: posts small blind £0.10
matiko09: posts big blind £0.25
*** HOLE CARDS ***
Dealt to matiko09 [Qd 9h]
namex11: folds 
Vedmegatko: raises £0.37 to £0.62
pescador1522: folds 
matiko09: calls £0.37
*** FLOP *** [Kh 9c Kc]
matiko09: checks 
Vedmegatko: checks 
*** TURN *** [Kh 9c Kc] [7h]
matiko09: bets £0.83
Vedmegatko: folds 
Uncalled bet (£0.83) returned to matiko09
matiko09 collected £1.28 from pot
matiko09: doesn't show hand 
*** SUMMARY ***
Total pot £1.34 | Rake £0.06 
Board [Kh 9c Kc 7h]
Seat 2: matiko09 (big blind) collected (£1.28)
Seat 3: namex11 folded before Flop (didn't bet)
Seat 5: Vedmegatko (button) folded on the Turn
Seat 6: pescador1522 (small blind) folded before Flop





PokerStars Hand #148211033832:  Hold'em No Limit ($0.10/$0.25 USD) - 2016/02/04 11:33:34 CET [2016/02/04 5:33:34 ET]
Table 'Aquarius II' 6-max Seat #1 is the button
Seat 1: Ciudvdvno ($25.25 in chips) 
Seat 3: MyBestPokeR ($27.15 in chips) 
Seat 4: RasmusB79 ($26.03 in chips) 
Seat 5: TroyPoker17 ($30.84 in chips) 
Seat 6: matiko09 ($25.67 in chips) 
pokernet88 will be allowed to play after the button
MyBestPokeR: posts small blind $0.10
RasmusB79: posts big blind $0.25
*** HOLE CARDS ***
Dealt to matiko09 [5d Ah]
TroyPoker17: calls $0.25
matiko09: folds 
Ciudvdvno: folds 
MyBestPokeR: folds 
RasmusB79: checks 
*** FLOP *** [Ac 9c Ad]
RasmusB79: checks 
TroyPoker17: bets $0.37
RasmusB79: folds 
Uncalled bet ($0.37) returned to TroyPoker17
TroyPoker17 collected $0.57 from pot
TroyPoker17: doesn't show hand 
*** SUMMARY ***
Total pot $0.60 | Rake $0.03 
Board [Ac 9c Ad]
Seat 1: Ciudvdvno (button) folded before Flop (didn't bet)
Seat 3: MyBestPokeR (small blind) folded before Flop
Seat 4: RasmusB79 (big blind) folded on the Flop
Seat 5: TroyPoker17 collected ($0.57)
Seat 6: matiko09 folded before Flop (didn't bet)





PokerStars Hand #148211033962:  Hold'em No Limit ($0.10/$0.25 USD) - 2016/02/04 11:33:35 CET [2016/02/04 5:33:35 ET]
Table 'Hippasos' 6-max Seat #4 is the button
Seat 1: VreDnYY ($25.20 in chips) 
Seat 2: Samerald ($35.54 in chips) 
Seat 3: Fank0_ ($27.85 in chips) 
Seat 4: endeavoor ($32.76 in chips) 
Seat 6: matiko09 ($25.40 in chips) 
matiko09: posts small blind $0.10
VreDnYY: posts big blind $0.25
*** HOLE CARDS ***
Dealt to matiko09 [5s Ts]
Samerald: folds 
Fank0_: folds 
endeavoor: raises $0.25 to $0.50
matiko09: folds 
VreDnYY: folds 
Uncalled bet ($0.25) returned to endeavoor
endeavoor collected $0.60 from pot
endeavoor: doesn't show hand 
*** SUMMARY ***
Total pot $0.60 | Rake $0 
Seat 1: VreDnYY (big blind) folded before Flop
Seat 2: Samerald folded before Flop (didn't bet)
Seat 3: Fank0_ folded before Flop (didn't bet)
Seat 4: endeavoor (button) collected ($0.60)
Seat 6: matiko09 (small blind) folded before Flop





PokerStars Hand #148211041571:  Hold'em No Limit (€0.10/€0.25 EUR) - 2016/02/04 11:33:50 CET [2016/02/04 5:33:50 ET]
Table 'Lilaea III' 6-max Seat #1 is the button
Seat 1: matiko09 (€25 in chips) 
Seat 2: Newbie1990 (€39.47 in chips) 
Seat 3: uzzy20 (€25.11 in chips) 
Seat 4: Wwwasian (€32.63 in chips) 
Seat 5: marchuchok (€25 in chips) 
Seat 6: BaaroRai (€32.89 in chips) 
Newbie1990: posts small blind €0.10
uzzy20: posts big blind €0.25
*** HOLE CARDS ***
Dealt to matiko09 [6h 2d]
Wwwasian: raises €0.45 to €0.70
marchuchok: folds 
BaaroRai: calls €0.70
matiko09: folds 
Newbie1990: folds 
uzzy20: folds 
*** FLOP *** [Kh 4s 9c]
Wwwasian: bets €1
BaaroRai: calls €1
*** TURN *** [Kh 4s 9c] [8c]
Wwwasian: bets €2.25
BaaroRai: folds 
Uncalled bet (€2.25) returned to Wwwasian
Wwwasian collected €3.58 from pot
Wwwasian: doesn't show hand 
*** SUMMARY ***
Total pot €3.75 | Rake €0.17 
Board [Kh 4s 9c 8c]
Seat 1: matiko09 (button) folded before Flop (didn't bet)
Seat 2: Newbie1990 (small blind) folded before Flop
Seat 3: uzzy20 (big blind) folded before Flop
Seat 4: Wwwasian collected (€3.58)
Seat 5: marchuchok folded before Flop (didn't bet)
Seat 6: BaaroRai folded on the Turn





PokerStars Hand #148211042487:  Hold'em No Limit ($0.10/$0.25 USD) - 2016/02/04 11:33:52 CET [2016/02/04 5:33:52 ET]
Table 'Hungaria II' 6-max Seat #4 is the button
Seat 1: angrypaca ($25 in chips) 
Seat 2: MaurerXL82 ($23.89 in chips) 
Seat 3: MAO_DZEDYN_S ($25.35 in chips) 
Seat 4: matiko09 ($25 in chips) 
Seat 5: nnVinokurov ($25.10 in chips) 
Seat 6: droog2 ($38.38 in chips) 
nnVinokurov: posts small blind $0.10
droog2: posts big blind $0.25
*** HOLE CARDS ***
Dealt to matiko09 [4c Js]
angrypaca: folds 
MaurerXL82: calls $0.25
MAO_DZEDYN_S: folds 
matiko09: folds 
nnVinokurov: folds 
droog2: raises $0.75 to $1
MaurerXL82: calls $0.75
*** FLOP *** [Ac 8h 7h]
droog2: bets $1.40
MaurerXL82: calls $1.40
*** TURN *** [Ac 8h 7h] [Jd]
droog2: checks 
MaurerXL82: bets $4.68
droog2: folds 
Uncalled bet ($4.68) returned to MaurerXL82
MaurerXL82 collected $4.68 from pot
MaurerXL82: doesn't show hand 
*** SUMMARY ***
Total pot $4.90 | Rake $0.22 
Board [Ac 8h 7h Jd]
Seat 1: angrypaca folded before Flop (didn't bet)
Seat 2: MaurerXL82 collected ($4.68)
Seat 3: MAO_DZEDYN_S folded before Flop (didn't bet)
Seat 4: matiko09 (button) folded before Flop (didn't bet)
Seat 5: nnVinokurov (small blind) folded before Flop
Seat 6: droog2 (big blind) folded on the Turn





PokerStars Hand #148211045365:  Hold'em No Limit ($0.10/$0.25 USD) - 2016/02/04 11:33:57 CET [2016/02/04 5:33:57 ET]
Table 'Thora II' 6-max Seat #1 is the button
Seat 1: S1cker_0ne ($48.25 in chips) 
Seat 2: schatun774 ($12.21 in chips) 
Seat 3: Odmincheg ($25 in chips) 
Seat 4: matiko09 ($26.13 in chips) 
Seat 6: cost983 ($25 in chips) 
schatun774: posts small blind $0.10
Odmincheg: posts big blind $0.25
*** HOLE CARDS ***
Dealt to matiko09 [Ah 9h]
matiko09: raises $0.50 to $0.75
cost983: folds 
S1cker_0ne: folds 
schatun774: calls $0.65
Odmincheg: folds 
*** FLOP *** [7d Ks 6c]
schatun774: bets $0.25
matiko09: folds 
Uncalled bet ($0.25) returned to schatun774
schatun774 collected $1.67 from pot
schatun774: doesn't show hand 
*** SUMMARY ***
Total pot $1.75 | Rake $0.08 
Board [7d Ks 6c]
Seat 1: S1cker_0ne (button) folded before Flop (didn't bet)
Seat 2: schatun774 (small blind) collected ($1.67)
Seat 3: Odmincheg (big blind) folded before Flop
Seat 4: matiko09 folded on the Flop
Seat 6: cost983 folded before Flop (didn't bet)





PokerStars Hand #148211046449:  Hold'em No Limit (£0.10/£0.25 GBP) - 2016/02/04 11:33:59 CET [2016/02/04 5:33:59 ET]
Table 'Libra II' 6-max Seat #6 is the button
Seat 2: matiko09 (£25.91 in chips) 
Seat 3: namex11 (£25.25 in chips) 
Seat 5: Vedmegatko (£25 in chips) 
Seat 6: pescador1522 (£17.96 in chips) 
matiko09: posts small blind £0.10
namex11: posts big blind £0.25
*** HOLE CARDS ***
Dealt to matiko09 [8h Td]
Vedmegatko: folds 
pescador1522: calls £0.25
matiko09: folds 
namex11: raises £0.75 to £1
pescador1522: calls £0.75
*** FLOP *** [5h As Ts]
namex11: bets £1.33
pescador1522: folds 
Uncalled bet (£1.33) returned to namex11
namex11 collected £2.01 from pot
namex11: doesn't show hand 
*** SUMMARY ***
Total pot £2.10 | Rake £0.09 
Board [5h As Ts]
Seat 2: matiko09 (small blind) folded before Flop
Seat 3: namex11 (big blind) collected (£2.01)
Seat 5: Vedmegatko folded before Flop (didn't bet)
Seat 6: pescador1522 (button) folded on the Flop





PokerStars Hand #148211046737:  Hold'em No Limit ($0.10/$0.25 USD) - 2016/02/04 11:34:00 CET [2016/02/04 5:34:00 ET]
Table 'Hippasos' 6-max Seat #6 is the button
Seat 1: VreDnYY ($25 in chips) 
Seat 3: Fank0_ ($27.85 in chips) 
Seat 4: endeavoor ($33.11 in chips) 
Seat 6: matiko09 ($25.30 in chips) 
VreDnYY: posts small blind $0.10
Samerald: is sitting out 
Fank0_: posts big blind $0.25
*** HOLE CARDS ***
Dealt to matiko09 [8s Ad]
endeavoor: folds 
Samerald leaves the table
matiko09: raises $0.37 to $0.62
VreDnYY: folds 
Fank0_: folds 
Uncalled bet ($0.37) returned to matiko09
matiko09 collected $0.60 from pot
matiko09: doesn't show hand 
*** SUMMARY ***
Total pot $0.60 | Rake $0 
Seat 1: VreDnYY (small blind) folded before Flop
Seat 3: Fank0_ (big blind) folded before Flop
Seat 4: endeavoor folded before Flop (didn't bet)
Seat 6: matiko09 (button) collected ($0.60)





PokerStars Hand #148211050993:  Hold'em No Limit ($0.10/$0.25 USD) - 2016/02/04 11:34:09 CET [2016/02/04 5:34:09 ET]
Table 'Aquarius II' 6-max Seat #3 is the button
Seat 1: Ciudvdvno ($25.25 in chips) 
Seat 3: MyBestPokeR ($27.05 in chips) 
Seat 4: RasmusB79 ($25.78 in chips) 
Seat 5: TroyPoker17 ($31.16 in chips) 
Seat 6: matiko09 ($25.67 in chips) 
RasmusB79: posts small blind $0.10
TroyPoker17: posts big blind $0.25
pokernet88: sits out 
*** HOLE CARDS ***
Dealt to matiko09 [8d 3c]
matiko09: folds 
Ciudvdvno: raises $0.50 to $0.75
MyBestPokeR: folds 
RasmusB79: folds 
TroyPoker17: folds 
Uncalled bet ($0.50) returned to Ciudvdvno
RasmusB79 leaves the table
Ciudvdvno collected $0.60 from pot
*** SUMMARY ***
Total pot $0.60 | Rake $0 
Seat 1: Ciudvdvno collected ($0.60)
Seat 3: MyBestPokeR (button) folded before Flop (didn't bet)
Seat 4: RasmusB79 (small blind) folded before Flop
Seat 5: TroyPoker17 (big blind) folded before Flop
Seat 6: matiko09 folded before Flop (didn't bet)





PokerStars Hand #148211060854:  Hold'em No Limit ($0.10/$0.25 USD) - 2016/02/04 11:34:28 CET [2016/02/04 5:34:28 ET]
Table 'Aquarius II' 6-max Seat #5 is the button
Seat 1: Ciudvdvno ($25.60 in chips) 
Seat 3: MyBestPokeR ($27.05 in chips) 
Seat 5: TroyPoker17 ($30.91 in chips) 
Seat 6: matiko09 ($25.67 in chips) 
matiko09: posts small blind $0.10
Ciudvdvno: posts big blind $0.25
pokernet88: sits out 
*** HOLE CARDS ***
Dealt to matiko09 [5d Ad]
MyBestPokeR: raises $0.50 to $0.75
TroyPoker17: folds 
matiko09: folds 
Ciudvdvno: folds 
Uncalled bet ($0.50) returned to MyBestPokeR
MyBestPokeR collected $0.60 from pot
*** SUMMARY ***
Total pot $0.60 | Rake $0 
Seat 1: Ciudvdvno (big blind) folded before Flop
Seat 3: MyBestPokeR collected ($0.60)
Seat 5: TroyPoker17 (button) folded before Flop (didn't bet)
Seat 6: matiko09 (small blind) folded before Flop





PokerStars Hand #148211061389:  Hold'em No Limit (£0.10/£0.25 GBP) - 2016/02/04 11:34:29 CET [2016/02/04 5:34:29 ET]
Table 'Libra II' 6-max Seat #2 is the button
Seat 2: matiko09 (£25.81 in chips) 
Seat 3: namex11 (£26.26 in chips) 
Seat 5: Vedmegatko (£25 in chips) 
Seat 6: pescador1522 (£16.96 in chips) 
namex11: posts small blind £0.10
Vedmegatko: posts big blind £0.25
*** HOLE CARDS ***
Dealt to matiko09 [Td 8c]
pescador1522: calls £0.25
matiko09: folds 
namex11: calls £0.15
Vedmegatko: checks 
*** FLOP *** [Qs 4s As]
namex11: checks 
Vedmegatko: checks 
pescador1522: checks 
*** TURN *** [Qs 4s As] [Jc]
namex11: checks 
Vedmegatko: checks 
pescador1522: checks 
*** RIVER *** [Qs 4s As Jc] [Th]
namex11: checks 
Vedmegatko: checks 
pescador1522: checks 
*** SHOW DOWN ***
namex11: shows [6h 7h] (high card Ace)
Vedmegatko: mucks hand 
pescador1522: shows [6d Jh] (a pair of Jacks)
pescador1522 collected £0.72 from pot
*** SUMMARY ***
Total pot £0.75 | Rake £0.03 
Board [Qs 4s As Jc Th]
Seat 2: matiko09 (button) folded before Flop (didn't bet)
Seat 3: namex11 (small blind) showed [6h 7h] and lost with high card Ace
Seat 5: Vedmegatko (big blind) mucked [3c 2d]
Seat 6: pescador1522 showed [6d Jh] and won (£0.72) with a pair of Jacks





PokerStars Hand #148211064207:  Hold'em No Limit ($0.10/$0.25 USD) - 2016/02/04 11:34:35 CET [2016/02/04 5:34:35 ET]
Table 'Thora II' 6-max Seat #2 is the button
Seat 1: S1cker_0ne ($48.25 in chips) 
Seat 2: schatun774 ($13.13 in chips) 
Seat 3: Odmincheg ($25 in chips) 
Seat 4: matiko09 ($25.38 in chips) 
Seat 6: cost983 ($25 in chips) 
Odmincheg: posts small blind $0.10
matiko09: posts big blind $0.25
*** HOLE CARDS ***
Dealt to matiko09 [9d Ks]
cost983: folds 
S1cker_0ne: folds 
schatun774: calls $0.25
Odmincheg: folds 
matiko09: checks 
*** FLOP *** [2c 9s Jc]
matiko09: bets $0.37
schatun774: folds 
Uncalled bet ($0.37) returned to matiko09
matiko09 collected $0.57 from pot
matiko09: doesn't show hand 
*** SUMMARY ***
Total pot $0.60 | Rake $0.03 
Board [2c 9s Jc]
Seat 1: S1cker_0ne folded before Flop (didn't bet)
Seat 2: schatun774 (button) folded on the Flop
Seat 3: Odmincheg (small blind) folded before Flop
Seat 4: matiko09 (big blind) collected ($0.57)
Seat 6: cost983 folded before Flop (didn't bet)





PokerStars Hand #148211066432:  Hold'em No Limit (€0.10/€0.25 EUR) - 2016/02/04 11:34:39 CET [2016/02/04 5:34:39 ET]
Table 'Lilaea III' 6-max Seat #2 is the button
Seat 1: matiko09 (€25 in chips) 
Seat 2: Newbie1990 (€39.37 in chips) 
Seat 3: uzzy20 (€25 in chips) 
Seat 4: Wwwasian (€34.51 in chips) 
Seat 5: marchuchok (€25 in chips) 
Seat 6: BaaroRai (€31.19 in chips) 
uzzy20: posts small blind €0.10
Wwwasian: posts big blind €0.25
*** HOLE CARDS ***
Dealt to matiko09 [4s Qs]
marchuchok: folds 
BaaroRai: calls €0.25
matiko09: folds 
Newbie1990: folds 
uzzy20: folds 
Wwwasian: checks 
*** FLOP *** [Jd 2h 4c]
Wwwasian: checks 
BaaroRai: checks 
*** TURN *** [Jd 2h 4c] [2d]
Wwwasian: checks 
BaaroRai: checks 
*** RIVER *** [Jd 2h 4c 2d] [4h]
Wwwasian: checks 
BaaroRai: checks 
*** SHOW DOWN ***
Wwwasian: shows [Kc 7h] (two pair, Fours and Deuces)
BaaroRai: mucks hand 
Wwwasian collected €0.57 from pot
*** SUMMARY ***
Total pot €0.60 | Rake €0.03 
Board [Jd 2h 4c 2d 4h]
Seat 1: matiko09 folded before Flop (didn't bet)
Seat 2: Newbie1990 (button) folded before Flop (didn't bet)
Seat 3: uzzy20 (small blind) folded before Flop
Seat 4: Wwwasian (big blind) showed [Kc 7h] and won (€0.57) with two pair, Fours and Deuces
Seat 5: marchuchok folded before Flop (didn't bet)
Seat 6: BaaroRai mucked [Tc Qc]





PokerStars Hand #148211071185:  Hold'em No Limit ($0.10/$0.25 USD) - 2016/02/04 11:34:48 CET [2016/02/04 5:34:48 ET]
Table 'Hungaria II' 6-max Seat #5 is the button
Seat 2: MaurerXL82 ($26.17 in chips) 
Seat 3: MAO_DZEDYN_S ($25.35 in chips) 
Seat 4: matiko09 ($25 in chips) 
Seat 5: nnVinokurov ($25 in chips) 
Seat 6: droog2 ($35.98 in chips) 
droog2: posts small blind $0.10
angrypaca: is sitting out 
MaurerXL82: posts big blind $0.25
*** HOLE CARDS ***
Dealt to matiko09 [3d 6d]
MAO_DZEDYN_S: folds 
angrypaca leaves the table
Jo_Medici joins the table at seat #1 
matiko09: folds 
nnVinokurov: folds 
droog2: raises $0.50 to $0.75
MaurerXL82: calls $0.50
*** FLOP *** [2d 4h Kd]
droog2: bets $1
MaurerXL82: folds 
Uncalled bet ($1) returned to droog2
droog2 collected $1.43 from pot
droog2: doesn't show hand 
*** SUMMARY ***
Total pot $1.50 | Rake $0.07 
Board [2d 4h Kd]
Seat 2: MaurerXL82 (big blind) folded on the Flop
Seat 3: MAO_DZEDYN_S folded before Flop (didn't bet)
Seat 4: matiko09 folded before Flop (didn't bet)
Seat 5: nnVinokurov (button) folded before Flop (didn't bet)
Seat 6: droog2 (small blind) collected ($1.43)





PokerStars Hand #148211073140:  Hold'em No Limit ($0.10/$0.25 USD) - 2016/02/04 11:34:52 CET [2016/02/04 5:34:52 ET]
Table 'Aquarius II' 6-max Seat #6 is the button
Seat 1: Ciudvdvno ($25.35 in chips) 
Seat 2: pokernet88 ($25 in chips) 
Seat 3: MyBestPokeR ($27.40 in chips) 
Seat 5: TroyPoker17 ($30.91 in chips) 
Seat 6: matiko09 ($25.57 in chips) 
Ciudvdvno: posts small blind $0.10
pokernet88: posts big blind $0.25
*** HOLE CARDS ***
Dealt to matiko09 [7h 9s]
MyBestPokeR: raises $0.50 to $0.75
TroyPoker17: folds 
V1p13 joins the table at seat #4 
matiko09: folds 
Ciudvdvno: folds 
pokernet88: folds 
Uncalled bet ($0.50) returned to MyBestPokeR
MyBestPokeR collected $0.60 from pot
*** SUMMARY ***
Total pot $0.60 | Rake $0 
Seat 1: Ciudvdvno (small blind) folded before Flop
Seat 2: pokernet88 (big blind) folded before Flop
Seat 3: MyBestPokeR collected ($0.60)
Seat 5: TroyPoker17 folded before Flop (didn't bet)
Seat 6: matiko09 (button) folded before Flop (didn't bet)





PokerStars Hand #148211079393:  Hold'em No Limit ($0.10/$0.25 USD) - 2016/02/04 11:35:05 CET [2016/02/04 5:35:05 ET]
Table 'Thora II' 6-max Seat #3 is the button
Seat 1: S1cker_0ne ($48.25 in chips) 
Seat 2: schatun774 ($12.88 in chips) 
Seat 3: Odmincheg ($25 in chips) 
Seat 4: matiko09 ($25.70 in chips) 
matiko09: posts small blind $0.10
cost983: is sitting out 
S1cker_0ne: posts big blind $0.25
*** HOLE CARDS ***
Dealt to matiko09 [7h Kh]
schatun774: calls $0.25
Odmincheg: folds 
matiko09: calls $0.15
S1cker_0ne: checks 
*** FLOP *** [Kd 5d 4s]
matiko09: bets $0.47
S1cker_0ne: folds 
schatun774: calls $0.47
*** TURN *** [Kd 5d 4s] [7d]
matiko09: bets $1.05
schatun774: folds 
Uncalled bet ($1.05) returned to matiko09
matiko09 collected $1.61 from pot
matiko09: doesn't show hand 
*** SUMMARY ***
Total pot $1.69 | Rake $0.08 
Board [Kd 5d 4s 7d]
Seat 1: S1cker_0ne (big blind) folded on the Flop
Seat 2: schatun774 folded on the Turn
Seat 3: Odmincheg (button) folded before Flop (didn't bet)
Seat 4: matiko09 (small blind) collected ($1.61)





PokerStars Hand #148211083459:  Hold'em No Limit (£0.10/£0.25 GBP) - 2016/02/04 11:35:13 CET [2016/02/04 5:35:13 ET]
Table 'Libra II' 6-max Seat #3 is the button
Seat 2: matiko09 (£25.81 in chips) 
Seat 3: namex11 (£26.01 in chips) 
Seat 5: Vedmegatko (£25 in chips) 
Seat 6: pescador1522 (£17.43 in chips) 
Vedmegatko: posts small blind £0.10
pescador1522: posts big blind £0.25
k4rloos: sits out 
*** HOLE CARDS ***
Dealt to matiko09 [4c 3s]
matiko09: folds 
namex11: folds 
Vedmegatko: raises £0.50 to £0.75
pescador1522: calls £0.50
*** FLOP *** [8s 2d Ks]
Vedmegatko: bets £1.02
pescador1522: calls £1.02
*** TURN *** [8s 2d Ks] [8c]
Vedmegatko: checks 
pescador1522: checks 
*** RIVER *** [8s 2d Ks 8c] [4s]
Vedmegatko: checks 
pescador1522: bets £0.25
Vedmegatko: calls £0.25
*** SHOW DOWN ***
pescador1522: shows [Kh Ad] (two pair, Kings and Eights)
Vedmegatko: mucks hand 
pescador1522 collected £3.86 from pot
*** SUMMARY ***
Total pot £4.04 | Rake £0.18 
Board [8s 2d Ks 8c 4s]
Seat 2: matiko09 folded before Flop (didn't bet)
Seat 3: namex11 (button) folded before Flop (didn't bet)
Seat 5: Vedmegatko (small blind) mucked [Ts Jd]
Seat 6: pescador1522 (big blind) showed [Kh Ad] and won (£3.86) with two pair, Kings and Eights





PokerStars Hand #148211091372:  Hold'em No Limit ($0.10/$0.25 USD) - 2016/02/04 11:35:29 CET [2016/02/04 5:35:29 ET]
Table 'Aquarius II' 6-max Seat #1 is the button
Seat 1: Ciudvdvno ($25.25 in chips) 
Seat 2: pokernet88 ($25 in chips) 
Seat 3: MyBestPokeR ($27.75 in chips) 
Seat 5: TroyPoker17 ($30.91 in chips) 
Seat 6: matiko09 ($25.57 in chips) 
pokernet88: posts small blind $0.10
MyBestPokeR: posts big blind $0.25
V1p13: sits out 
*** HOLE CARDS ***
Dealt to matiko09 [9c Ts]
TroyPoker17: folds 
matiko09: folds 
V1p13 leaves the table
Ciudvdvno: folds 
pokernet88: folds 
Uncalled bet ($0.15) returned to MyBestPokeR
MyBestPokeR collected $0.20 from pot
*** SUMMARY ***
Total pot $0.20 | Rake $0 
Seat 1: Ciudvdvno (button) folded before Flop (didn't bet)
Seat 2: pokernet88 (small blind) folded before Flop
Seat 3: MyBestPokeR (big blind) collected ($0.20)
Seat 5: TroyPoker17 folded before Flop (didn't bet)
Seat 6: matiko09 folded before Flop (didn't bet)





PokerStars Hand #148211091679:  Hold'em No Limit ($0.10/$0.25 USD) - 2016/02/04 11:35:29 CET [2016/02/04 5:35:29 ET]
Table 'Thora II' 6-max Seat #4 is the button
Seat 1: S1cker_0ne ($48 in chips) 
Seat 2: schatun774 ($12.16 in chips) 
Seat 3: Odmincheg ($25 in chips) 
Seat 4: matiko09 ($26.59 in chips) 
S1cker_0ne: posts small blind $0.10
schatun774: posts big blind $0.25
*** HOLE CARDS ***
Dealt to matiko09 [3h 6h]
Odmincheg: raises $0.50 to $0.75
matiko09: folds 
S1cker_0ne: folds 
schatun774: folds 
Uncalled bet ($0.50) returned to Odmincheg
Odmincheg collected $0.60 from pot
*** SUMMARY ***
Total pot $0.60 | Rake $0 
Seat 1: S1cker_0ne (small blind) folded before Flop
Seat 2: schatun774 (big blind) folded before Flop
Seat 3: Odmincheg collected ($0.60)
Seat 4: matiko09 (button) folded before Flop (didn't bet)





PokerStars Hand #148211092675:  Hold'em No Limit ($0.10/$0.25 USD) - 2016/02/04 11:35:31 CET [2016/02/04 5:35:31 ET]
Table 'Hungaria II' 6-max Seat #6 is the button
Seat 2: MaurerXL82 ($25.42 in chips) 
Seat 3: MAO_DZEDYN_S ($25.35 in chips) 
Seat 4: matiko09 ($25 in chips) 
Seat 5: nnVinokurov ($25 in chips) 
Seat 6: droog2 ($36.66 in chips) 
Jo_Medici will be allowed to play after the button
MaurerXL82: posts small blind $0.10
MAO_DZEDYN_S: posts big blind $0.25
*** HOLE CARDS ***
Dealt to matiko09 [Td Jc]
matiko09: folds 
nnVinokurov: raises $0.50 to $0.75
droog2: folds 
MaurerXL82: calls $0.65
MAO_DZEDYN_S: folds 
*** FLOP *** [5d 8s Ad]
MaurerXL82: bets $0.25
nnVinokurov: calls $0.25
*** TURN *** [5d 8s Ad] [6c]
MaurerXL82: bets $0.25
nnVinokurov: calls $0.25
*** RIVER *** [5d 8s Ad 6c] [9h]
MaurerXL82: bets $0.25
nnVinokurov: calls $0.25
*** SHOW DOWN ***
MaurerXL82: shows [Ac 2h] (a pair of Aces)
nnVinokurov: mucks hand 
MaurerXL82 collected $3.10 from pot
*** SUMMARY ***
Total pot $3.25 | Rake $0.15 
Board [5d 8s Ad 6c 9h]
Seat 2: MaurerXL82 (small blind) showed [Ac 2h] and won ($3.10) with a pair of Aces
Seat 3: MAO_DZEDYN_S (big blind) folded before Flop
Seat 4: matiko09 folded before Flop (didn't bet)
Seat 5: nnVinokurov mucked [Jd Kh]
Seat 6: droog2 (button) folded before Flop (didn't bet)





PokerStars Hand #148211094902:  Hold'em No Limit (€0.10/€0.25 EUR) - 2016/02/04 11:35:36 CET [2016/02/04 5:35:36 ET]
Table 'Lilaea III' 6-max Seat #3 is the button
Seat 1: matiko09 (€25 in chips) 
Seat 2: Newbie1990 (€39.37 in chips) 
Seat 3: uzzy20 (€25 in chips) 
Seat 4: Wwwasian (€34.83 in chips) 
Seat 5: marchuchok (€25 in chips) 
Seat 6: BaaroRai (€30.94 in chips) 
Wwwasian: posts small blind €0.10
marchuchok: posts big blind €0.25
*** HOLE CARDS ***
Dealt to matiko09 [Ah 9d]
BaaroRai: calls €0.25
matiko09: folds 
Newbie1990: folds 
uzzy20: folds 
Wwwasian: folds 
marchuchok: raises €0.75 to €1
BaaroRai: calls €0.75
*** FLOP *** [9s 2d Tc]
marchuchok: checks 
BaaroRai: checks 
*** TURN *** [9s 2d Tc] [2s]
marchuchok: bets €1
BaaroRai: folds 
Uncalled bet (€1) returned to marchuchok
marchuchok collected €2.01 from pot
marchuchok: doesn't show hand 
*** SUMMARY ***
Total pot €2.10 | Rake €0.09 
Board [9s 2d Tc 2s]
Seat 1: matiko09 folded before Flop (didn't bet)
Seat 2: Newbie1990 folded before Flop (didn't bet)
Seat 3: uzzy20 (button) folded before Flop (didn't bet)
Seat 4: Wwwasian (small blind) folded before Flop
Seat 5: marchuchok (big blind) collected (€2.01)
Seat 6: BaaroRai folded on the Turn





PokerStars Hand #148211096625:  Hold'em No Limit ($0.10/$0.25 USD) - 2016/02/04 11:35:39 CET [2016/02/04 5:35:39 ET]
Table 'Thora II' 6-max Seat #1 is the button
Seat 1: S1cker_0ne ($47.90 in chips) 
Seat 2: schatun774 ($11.91 in chips) 
Seat 3: Odmincheg ($25.35 in chips) 
Seat 4: matiko09 ($26.59 in chips) 
schatun774: posts small blind $0.10
Odmincheg: posts big blind $0.25
*** HOLE CARDS ***
Dealt to matiko09 [8h 8c]
matiko09: raises $0.50 to $0.75
S1cker_0ne: folds 
schatun774: folds 
Odmincheg: folds 
Uncalled bet ($0.50) returned to matiko09
matiko09 collected $0.60 from pot
matiko09: doesn't show hand 
*** SUMMARY ***
Total pot $0.60 | Rake $0 
Seat 1: S1cker_0ne (button) folded before Flop (didn't bet)
Seat 2: schatun774 (small blind) folded before Flop
Seat 3: Odmincheg (big blind) folded before Flop
Seat 4: matiko09 collected ($0.60)





PokerStars Hand #148211097948:  Hold'em No Limit (£0.10/£0.25 GBP) - 2016/02/04 11:35:42 CET [2016/02/04 5:35:42 ET]
Table 'Libra II' 6-max Seat #5 is the button
Seat 1: k4rloos (£25.13 in chips) 
Seat 2: matiko09 (£25.81 in chips) 
Seat 3: namex11 (£26.01 in chips) 
Seat 5: Vedmegatko (£25 in chips) 
Seat 6: pescador1522 (£19.27 in chips) 
pescador1522: posts small blind £0.10
k4rloos: posts big blind £0.25
*** HOLE CARDS ***
Dealt to matiko09 [Kd Jd]
matiko09: raises £0.50 to £0.75
namex11: folds 
Vedmegatko: folds 
pescador1522: calls £0.65
k4rloos: folds 
*** FLOP *** [2d Qh 9d]
pescador1522: checks 
matiko09: bets £1.25
pescador1522: folds 
Uncalled bet (£1.25) returned to matiko09
matiko09 collected £1.67 from pot
matiko09: doesn't show hand 
*** SUMMARY ***
Total pot £1.75 | Rake £0.08 
Board [2d Qh 9d]
Seat 1: k4rloos (big blind) folded before Flop
Seat 2: matiko09 collected (£1.67)
Seat 3: namex11 folded before Flop (didn't bet)
Seat 5: Vedmegatko (button) folded before Flop (didn't bet)
Seat 6: pescador1522 (small blind) folded on the Flop





PokerStars Hand #148211104289:  Hold'em No Limit ($0.10/$0.25 USD) - 2016/02/04 11:35:54 CET [2016/02/04 5:35:54 ET]
Table 'Aquarius II' 6-max Seat #2 is the button
Seat 1: Ciudvdvno ($25.25 in chips) 
Seat 2: pokernet88 ($25 in chips) 
Seat 3: MyBestPokeR ($27.85 in chips) 
Seat 5: TroyPoker17 ($30.91 in chips) 
Seat 6: matiko09 ($25.57 in chips) 
MyBestPokeR: posts small blind $0.10
TroyPoker17: posts big blind $0.25
*** HOLE CARDS ***
Dealt to matiko09 [6s Kc]
matiko09: folds 
opavelkus joins the table at seat #4 
Ciudvdvno: folds 
pokernet88: raises $0.33 to $0.58
MyBestPokeR: folds 
TroyPoker17: folds 
Uncalled bet ($0.33) returned to pokernet88
pokernet88 collected $0.60 from pot
*** SUMMARY ***
Total pot $0.60 | Rake $0 
Seat 1: Ciudvdvno folded before Flop (didn't bet)
Seat 2: pokernet88 (button) collected ($0.60)
Seat 3: MyBestPokeR (small blind) folded before Flop
Seat 5: TroyPoker17 (big blind) folded before Flop
Seat 6: matiko09 folded before Flop (didn't bet)





PokerStars Hand #148211104516:  Hold'em No Limit ($0.10/$0.25 USD) - 2016/02/04 11:35:55 CET [2016/02/04 5:35:55 ET]
Table 'Thora II' 6-max Seat #2 is the button
Seat 1: S1cker_0ne ($47.90 in chips) 
Seat 2: schatun774 ($11.81 in chips) 
Seat 3: Odmincheg ($25.10 in chips) 
Seat 4: matiko09 ($26.94 in chips) 
Odmincheg: posts small blind $0.10
matiko09: posts big blind $0.25
cost983: sits out 
*** HOLE CARDS ***
Dealt to matiko09 [2d 8c]
S1cker_0ne: folds 
schatun774: calls $0.25
Odmincheg: calls $0.15
matiko09: checks 
*** FLOP *** [Ac 7h Th]
Odmincheg: checks 
matiko09: checks 
schatun774: checks 
*** TURN *** [Ac 7h Th] [Ks]
Odmincheg: checks 
matiko09: checks 
schatun774: checks 
*** RIVER *** [Ac 7h Th Ks] [4c]
Odmincheg: checks 
matiko09: checks 
schatun774: checks 
*** SHOW DOWN ***
Odmincheg: shows [7d 6d] (a pair of Sevens)
matiko09: mucks hand 
schatun774: shows [Ts 9s] (a pair of Tens)
schatun774 collected $0.72 from pot
*** SUMMARY ***
Total pot $0.75 | Rake $0.03 
Board [Ac 7h Th Ks 4c]
Seat 1: S1cker_0ne folded before Flop (didn't bet)
Seat 2: schatun774 (button) showed [Ts 9s] and won ($0.72) with a pair of Tens
Seat 3: Odmincheg (small blind) showed [7d 6d] and lost with a pair of Sevens
Seat 4: matiko09 (big blind) mucked [2d 8c]





PokerStars Hand #148211112620:  Hold'em No Limit ($0.10/$0.25 USD) - 2016/02/04 11:36:11 CET [2016/02/04 5:36:11 ET]
Table 'Hungaria II' 6-max Seat #2 is the button
Seat 2: MaurerXL82 ($27.02 in chips) 
Seat 3: MAO_DZEDYN_S ($25.10 in chips) 
Seat 4: matiko09 ($25 in chips) 
Seat 5: nnVinokurov ($25 in chips) 
Seat 6: droog2 ($36.66 in chips) 
MAO_DZEDYN_S: posts small blind $0.10
matiko09: posts big blind $0.25
Jo_Medici: sits out 
*** HOLE CARDS ***
Dealt to matiko09 [7d 4h]
nnVinokurov: folds 
droog2: folds 
MaurerXL82: calls $0.25
MAO_DZEDYN_S: raises $0.95 to $1.20
matiko09: folds 
MaurerXL82: calls $0.95
*** FLOP *** [3c 9h Ad]
MAO_DZEDYN_S: checks 
MaurerXL82: checks 
*** TURN *** [3c 9h Ad] [9s]
MAO_DZEDYN_S: bets $1.30
MaurerXL82: folds 
Uncalled bet ($1.30) returned to MAO_DZEDYN_S
MAO_DZEDYN_S collected $2.53 from pot
MAO_DZEDYN_S: doesn't show hand 
*** SUMMARY ***
Total pot $2.65 | Rake $0.12 
Board [3c 9h Ad 9s]
Seat 2: MaurerXL82 (button) folded on the Turn
Seat 3: MAO_DZEDYN_S (small blind) collected ($2.53)
Seat 4: matiko09 (big blind) folded before Flop
Seat 5: nnVinokurov folded before Flop (didn't bet)
Seat 6: droog2 folded before Flop (didn't bet)





PokerStars Hand #148211117473:  Hold'em No Limit (£0.10/£0.25 GBP) - 2016/02/04 11:36:20 CET [2016/02/04 5:36:20 ET]
Table 'Libra II' 6-max Seat #6 is the button
Seat 1: k4rloos (£25 in chips) 
Seat 2: matiko09 (£26.73 in chips) 
Seat 3: namex11 (£26.01 in chips) 
Seat 5: Vedmegatko (£25 in chips) 
Seat 6: pescador1522 (£18.52 in chips) 
k4rloos: posts small blind £0.10
matiko09: posts big blind £0.25
*** HOLE CARDS ***
Dealt to matiko09 [9c Kc]
namex11: folds 
Vedmegatko: raises £0.50 to £0.75
pescador1522: calls £0.75
k4rloos: folds 
matiko09: calls £0.50
*** FLOP *** [3h 9d 8d]
matiko09: bets £1.46
Vedmegatko: folds 
pescador1522: folds 
Uncalled bet (£1.46) returned to matiko09
matiko09 collected £2.24 from pot
matiko09: doesn't show hand 
*** SUMMARY ***
Total pot £2.35 | Rake £0.11 
Board [3h 9d 8d]
Seat 1: k4rloos (small blind) folded before Flop
Seat 2: matiko09 (big blind) collected (£2.24)
Seat 3: namex11 folded before Flop (didn't bet)
Seat 5: Vedmegatko folded on the Flop
Seat 6: pescador1522 (button) folded on the Flop





PokerStars Hand #148211128593:  Hold'em No Limit (€0.10/€0.25 EUR) - 2016/02/04 11:36:42 CET [2016/02/04 5:36:42 ET]
Table 'Lilaea III' 6-max Seat #4 is the button
Seat 1: matiko09 (€25 in chips) 
Seat 2: Newbie1990 (€39.37 in chips) 
Seat 3: uzzy20 (€25 in chips) 
Seat 4: Wwwasian (€34.73 in chips) 
Seat 5: marchuchok (€26.01 in chips) 
Seat 6: BaaroRai (€29.94 in chips) 
marchuchok: posts small blind €0.10
BaaroRai: posts big blind €0.25
*** HOLE CARDS ***
Dealt to matiko09 [Ac 2h]
matiko09: folds 
Newbie1990: folds 
uzzy20: folds 
Wwwasian: folds 
marchuchok: raises €0.50 to €0.75
BaaroRai: folds 
Uncalled bet (€0.50) returned to marchuchok
marchuchok collected €0.50 from pot
marchuchok: doesn't show hand 
*** SUMMARY ***
Total pot €0.50 | Rake €0 
Seat 1: matiko09 folded before Flop (didn't bet)
Seat 2: Newbie1990 folded before Flop (didn't bet)
Seat 3: uzzy20 folded before Flop (didn't bet)
Seat 4: Wwwasian (button) folded before Flop (didn't bet)
Seat 5: marchuchok (small blind) collected (€0.50)
Seat 6: BaaroRai (big blind) folded before Flop





PokerStars Hand #148211131097:  Hold'em No Limit (£0.10/£0.25 GBP) - 2016/02/04 11:36:47 CET [2016/02/04 5:36:47 ET]
Table 'Libra II' 6-max Seat #1 is the button
Seat 1: k4rloos (£25 in chips) 
Seat 2: matiko09 (£28.22 in chips) 
Seat 3: namex11 (£26.01 in chips) 
Seat 5: Vedmegatko (£25 in chips) 
Seat 6: pescador1522 (£17.77 in chips) 
matiko09: posts small blind £0.10
namex11: posts big blind £0.25
*** HOLE CARDS ***
Dealt to matiko09 [9d Tc]
Vedmegatko: folds 
pescador1522: raises £1 to £1.25
k4rloos: folds 
matiko09: folds 
namex11: folds 
Uncalled bet (£1) returned to pescador1522
pescador1522 collected £0.60 from pot
pescador1522: doesn't show hand 
*** SUMMARY ***
Total pot £0.60 | Rake £0 
Seat 1: k4rloos (button) folded before Flop (didn't bet)
Seat 2: matiko09 (small blind) folded before Flop
Seat 3: namex11 (big blind) folded before Flop
Seat 5: Vedmegatko folded before Flop (didn't bet)
Seat 6: pescador1522 collected (£0.60)





PokerStars Hand #148211137296:  Hold'em No Limit (€0.10/€0.25 EUR) - 2016/02/04 11:37:00 CET [2016/02/04 5:37:00 ET]
Table 'Lilaea III' 6-max Seat #5 is the button
Seat 1: matiko09 (€25 in chips) 
Seat 2: Newbie1990 (€39.37 in chips) 
Seat 3: uzzy20 (€25 in chips) 
Seat 4: Wwwasian (€34.73 in chips) 
Seat 5: marchuchok (€26.26 in chips) 
Seat 6: BaaroRai (€29.69 in chips) 
BaaroRai: posts small blind €0.10
matiko09: posts big blind €0.25
*** HOLE CARDS ***
Dealt to matiko09 [8d Th]
Newbie1990: folds 
uzzy20: raises €0.50 to €0.75
Wwwasian: folds 
marchuchok: folds 
BaaroRai: calls €0.65
matiko09: folds 
*** FLOP *** [Jh 2c 4c]
BaaroRai: bets €0.25
uzzy20: folds 
Uncalled bet (€0.25) returned to BaaroRai
BaaroRai collected €1.67 from pot
BaaroRai: doesn't show hand 
*** SUMMARY ***
Total pot €1.75 | Rake €0.08 
Board [Jh 2c 4c]
Seat 1: matiko09 (big blind) folded before Flop
Seat 2: Newbie1990 folded before Flop (didn't bet)
Seat 3: uzzy20 folded on the Flop
Seat 4: Wwwasian folded before Flop (didn't bet)
Seat 5: marchuchok (button) folded before Flop (didn't bet)
Seat 6: BaaroRai (small blind) collected (€1.67)





PokerStars Hand #148211142235:  Hold'em No Limit (£0.10/£0.25 GBP) - 2016/02/04 11:37:10 CET [2016/02/04 5:37:10 ET]
Table 'Libra II' 6-max Seat #2 is the button
Seat 1: k4rloos (£25 in chips) 
Seat 2: matiko09 (£28.12 in chips) 
Seat 3: namex11 (£25.76 in chips) 
Seat 5: Vedmegatko (£25 in chips) 
Seat 6: pescador1522 (£18.12 in chips) 
namex11: posts small blind £0.10
Vedmegatko: posts big blind £0.25
*** HOLE CARDS ***
Dealt to matiko09 [5h Kc]
pescador1522: raises £0.25 to £0.50
k4rloos: folds 
matiko09: folds 
namex11: folds 
Vedmegatko: folds 
Uncalled bet (£0.25) returned to pescador1522
pescador1522 collected £0.60 from pot
pescador1522: doesn't show hand 
*** SUMMARY ***
Total pot £0.60 | Rake £0 
Seat 1: k4rloos folded before Flop (didn't bet)
Seat 2: matiko09 (button) folded before Flop (didn't bet)
Seat 3: namex11 (small blind) folded before Flop
Seat 5: Vedmegatko (big blind) folded before Flop
Seat 6: pescador1522 collected (£0.60)





PokerStars Hand #148211146000:  Hold'em No Limit ($0.10/$0.25 USD) - 2016/02/04 11:37:17 CET [2016/02/04 5:37:17 ET]
Table 'Hungaria II' 6-max Seat #3 is the button
Seat 2: MaurerXL82 ($25.82 in chips) 
Seat 3: MAO_DZEDYN_S ($26.43 in chips) 
Seat 4: matiko09 ($25 in chips) 
Seat 5: nnVinokurov ($25 in chips) 
Seat 6: droog2 ($36.66 in chips) 
matiko09: posts small blind $0.10
nnVinokurov: posts big blind $0.25
Jo_Medici: sits out 
*** HOLE CARDS ***
Dealt to matiko09 [7s 6c]
droog2: folds 
MaurerXL82: folds 
MAO_DZEDYN_S: raises $0.27 to $0.52
matiko09: folds 
nnVinokurov: raises $1.73 to $2.25
MAO_DZEDYN_S: raises $2.85 to $5.10
nnVinokurov: raises $19.90 to $25 and is all-in
MAO_DZEDYN_S: folds 
Uncalled bet ($19.90) returned to nnVinokurov
nnVinokurov collected $10.30 from pot
nnVinokurov: doesn't show hand 
*** SUMMARY ***
Total pot $10.30 | Rake $0 
Seat 2: MaurerXL82 folded before Flop (didn't bet)
Seat 3: MAO_DZEDYN_S (button) folded before Flop
Seat 4: matiko09 (small blind) folded before Flop
Seat 5: nnVinokurov (big blind) collected ($10.30)
Seat 6: droog2 folded before Flop (didn't bet)





PokerStars Hand #148211149973:  Hold'em No Limit (£0.10/£0.25 GBP) - 2016/02/04 11:37:25 CET [2016/02/04 5:37:25 ET]
Table 'Libra II' 6-max Seat #3 is the button
Seat 1: k4rloos (£25 in chips) 
Seat 2: matiko09 (£28.12 in chips) 
Seat 3: namex11 (£25.66 in chips) 
Seat 5: Vedmegatko (£25 in chips) 
Seat 6: pescador1522 (£18.47 in chips) 
Vedmegatko: posts small blind £0.10
pescador1522: posts big blind £0.25
*** HOLE CARDS ***
Dealt to matiko09 [9h As]
k4rloos: folds 
matiko09: raises £0.50 to £0.75
namex11: folds 
Vedmegatko: folds 
pescador1522: folds 
Uncalled bet (£0.50) returned to matiko09
matiko09 collected £0.60 from pot
matiko09: doesn't show hand 
*** SUMMARY ***
Total pot £0.60 | Rake £0 
Seat 1: k4rloos folded before Flop (didn't bet)
Seat 2: matiko09 collected (£0.60)
Seat 3: namex11 (button) folded before Flop (didn't bet)
Seat 5: Vedmegatko (small blind) folded before Flop
Seat 6: pescador1522 (big blind) folded before Flop





PokerStars Hand #148211150438:  Hold'em No Limit ($0.10/$0.25 USD) - 2016/02/04 11:37:26 CET [2016/02/04 5:37:26 ET]
Table 'Thora II' 6-max Seat #3 is the button
Seat 1: S1cker_0ne ($47.90 in chips) 
Seat 2: schatun774 ($12.28 in chips) 
Seat 3: Odmincheg ($25 in chips) 
Seat 4: matiko09 ($26.69 in chips) 
Seat 6: cost983 ($25 in chips) 
matiko09: posts small blind $0.10
cost983: posts big blind $0.25
*** HOLE CARDS ***
Dealt to matiko09 [Ks As]
S1cker_0ne: folds 
schatun774: folds 
Odmincheg: folds 
matiko09: raises $0.50 to $0.75
cost983: folds 
Uncalled bet ($0.50) returned to matiko09
matiko09 collected $0.50 from pot
matiko09: doesn't show hand 
*** SUMMARY ***
Total pot $0.50 | Rake $0 
Seat 1: S1cker_0ne folded before Flop (didn't bet)
Seat 2: schatun774 folded before Flop (didn't bet)
Seat 3: Odmincheg (button) folded before Flop (didn't bet)
Seat 4: matiko09 (small blind) collected ($0.50)
Seat 6: cost983 (big blind) folded before Flop





PokerStars Hand #148211152755:  Hold'em No Limit (€0.10/€0.25 EUR) - 2016/02/04 11:37:30 CET [2016/02/04 5:37:30 ET]
Table 'Lilaea III' 6-max Seat #6 is the button
Seat 1: matiko09 (€25 in chips) 
Seat 3: uzzy20 (€25 in chips) 
Seat 4: Wwwasian (€34.73 in chips) 
Seat 5: marchuchok (€26.26 in chips) 
Seat 6: BaaroRai (€30.61 in chips) 
matiko09: posts small blind €0.10
Newbie1990: is sitting out 
uzzy20: posts big blind €0.25
*** HOLE CARDS ***
Dealt to matiko09 [Jh 4h]
Newbie1990 leaves the table
Wwwasian: raises €0.45 to €0.70
marchuchok: folds 
BaaroRai: folds 
matiko09: folds 
uzzy20: folds 
Uncalled bet (€0.45) returned to Wwwasian
Wwwasian collected €0.60 from pot
Wwwasian: doesn't show hand 
*** SUMMARY ***
Total pot €0.60 | Rake €0 
Seat 1: matiko09 (small blind) folded before Flop
Seat 3: uzzy20 (big blind) folded before Flop
Seat 4: Wwwasian collected (€0.60)
Seat 5: marchuchok folded before Flop (didn't bet)
Seat 6: BaaroRai (button) folded before Flop (didn't bet)





PokerStars Hand #148211156694:  Hold'em No Limit (£0.10/£0.25 GBP) - 2016/02/04 11:37:38 CET [2016/02/04 5:37:38 ET]
Table 'Libra II' 6-max Seat #5 is the button
Seat 1: k4rloos (£25 in chips) 
Seat 2: matiko09 (£28.47 in chips) 
Seat 3: namex11 (£25.66 in chips) 
Seat 5: Vedmegatko (£25 in chips) 
Seat 6: pescador1522 (£18.22 in chips) 
pescador1522: posts small blind £0.10
k4rloos: posts big blind £0.25
*** HOLE CARDS ***
Dealt to matiko09 [Ah 6c]
matiko09: folds 
namex11: folds 
Vedmegatko: raises £0.37 to £0.62
pescador1522: folds 
k4rloos: folds 
Uncalled bet (£0.37) returned to Vedmegatko
Vedmegatko collected £0.60 from pot
Vedmegatko: doesn't show hand 
*** SUMMARY ***
Total pot £0.60 | Rake £0 
Seat 1: k4rloos (big blind) folded before Flop
Seat 2: matiko09 folded before Flop (didn't bet)
Seat 3: namex11 folded before Flop (didn't bet)
Seat 5: Vedmegatko (button) collected (£0.60)
Seat 6: pescador1522 (small blind) folded before Flop





PokerStars Hand #148211157096:  Hold'em No Limit ($0.10/$0.25 USD) - 2016/02/04 11:37:39 CET [2016/02/04 5:37:39 ET]
Table 'Thora II' 6-max Seat #4 is the button
Seat 1: S1cker_0ne ($47.90 in chips) 
Seat 2: schatun774 ($12.28 in chips) 
Seat 3: Odmincheg ($25 in chips) 
Seat 4: matiko09 ($26.94 in chips) 
Seat 6: cost983 ($25 in chips) 
cost983: posts small blind $0.10
S1cker_0ne: posts big blind $0.25
*** HOLE CARDS ***
Dealt to matiko09 [7h 9d]
schatun774: folds 
Odmincheg: raises $0.50 to $0.75
matiko09: folds 
cost983: folds 
S1cker_0ne: folds 
Uncalled bet ($0.50) returned to Odmincheg
Odmincheg collected $0.60 from pot
*** SUMMARY ***
Total pot $0.60 | Rake $0 
Seat 1: S1cker_0ne (big blind) folded before Flop
Seat 2: schatun774 folded before Flop (didn't bet)
Seat 3: Odmincheg collected ($0.60)
Seat 4: matiko09 (button) folded before Flop (didn't bet)
Seat 6: cost983 (small blind) folded before Flop





PokerStars Hand #148211160298:  Hold'em No Limit (€0.10/€0.25 EUR) - 2016/02/04 11:37:45 CET [2016/02/04 5:37:45 ET]
Table 'Lilaea III' 6-max Seat #1 is the button
Seat 1: matiko09 (€25 in chips) 
Seat 3: uzzy20 (€25 in chips) 
Seat 4: Wwwasian (€35.08 in chips) 
Seat 5: marchuchok (€26.26 in chips) 
Seat 6: BaaroRai (€30.61 in chips) 
uzzy20: posts small blind €0.10
Wwwasian: posts big blind €0.25
*** HOLE CARDS ***
Dealt to matiko09 [Ad Kd]
Yegoriy joins the table at seat #2 
marchuchok: folds 
BaaroRai: folds 
matiko09: raises €0.37 to €0.62
uzzy20: folds 
Wwwasian: folds 
Uncalled bet (€0.37) returned to matiko09
matiko09 collected €0.60 from pot
matiko09: doesn't show hand 
*** SUMMARY ***
Total pot €0.60 | Rake €0 
Seat 1: matiko09 (button) collected (€0.60)
Seat 3: uzzy20 (small blind) folded before Flop
Seat 4: Wwwasian (big blind) folded before Flop
Seat 5: marchuchok folded before Flop (didn't bet)
Seat 6: BaaroRai folded before Flop (didn't bet)





PokerStars Hand #148211163529:  Hold'em No Limit (£0.10/£0.25 GBP) - 2016/02/04 11:37:52 CET [2016/02/04 5:37:52 ET]
Table 'Libra II' 6-max Seat #6 is the button
Seat 1: k4rloos (£25 in chips) 
Seat 2: matiko09 (£28.47 in chips) 
Seat 3: namex11 (£25.66 in chips) 
Seat 5: Vedmegatko (£25.35 in chips) 
Seat 6: pescador1522 (£18.12 in chips) 
k4rloos: posts small blind £0.10
matiko09: posts big blind £0.25
*** HOLE CARDS ***
Dealt to matiko09 [4s Th]
namex11: folds 
Vedmegatko: raises £0.50 to £0.75
pescador1522: folds 
k4rloos: folds 
matiko09: folds 
Uncalled bet (£0.50) returned to Vedmegatko
Vedmegatko collected £0.60 from pot
Vedmegatko: doesn't show hand 
*** SUMMARY ***
Total pot £0.60 | Rake £0 
Seat 1: k4rloos (small blind) folded before Flop
Seat 2: matiko09 (big blind) folded before Flop
Seat 3: namex11 folded before Flop (didn't bet)
Seat 5: Vedmegatko collected (£0.60)
Seat 6: pescador1522 (button) folded before Flop (didn't bet)





PokerStars Hand #148211166215:  Hold'em No Limit ($0.10/$0.25 USD) - 2016/02/04 11:37:57 CET [2016/02/04 5:37:57 ET]
Table 'Thora II' 6-max Seat #6 is the button
Seat 1: S1cker_0ne ($47.65 in chips) 
Seat 2: schatun774 ($12.28 in chips) 
Seat 3: Odmincheg ($25.35 in chips) 
Seat 4: matiko09 ($26.94 in chips) 
Seat 6: cost983 ($25 in chips) 
S1cker_0ne: posts small blind $0.10
schatun774: posts big blind $0.25
*** HOLE CARDS ***
Dealt to matiko09 [4c 2d]
Odmincheg: folds 
matiko09: folds 
cost983: folds 
S1cker_0ne: raises $0.39 to $0.64
schatun774: calls $0.39
*** FLOP *** [Ac 8s 7d]
S1cker_0ne: bets $0.68
schatun774: calls $0.68
*** TURN *** [Ac 8s 7d] [8d]
S1cker_0ne: bets $1.05
schatun774: calls $1.05
*** RIVER *** [Ac 8s 7d 8d] [9h]
S1cker_0ne: checks 
schatun774: bets $1.75
S1cker_0ne: folds 
Uncalled bet ($1.75) returned to schatun774
schatun774 collected $4.53 from pot
schatun774: doesn't show hand 
*** SUMMARY ***
Total pot $4.74 | Rake $0.21 
Board [Ac 8s 7d 8d 9h]
Seat 1: S1cker_0ne (small blind) folded on the River
Seat 2: schatun774 (big blind) collected ($4.53)
Seat 3: Odmincheg folded before Flop (didn't bet)
Seat 4: matiko09 folded before Flop (didn't bet)
Seat 6: cost983 (button) folded before Flop (didn't bet)





PokerStars Hand #148211170789:  Hold'em No Limit (€0.10/€0.25 EUR) - 2016/02/04 11:38:06 CET [2016/02/04 5:38:06 ET]
Table 'Lilaea III' 6-max Seat #3 is the button
Seat 1: matiko09 (€25.35 in chips) 
Seat 3: uzzy20 (€25 in chips) 
Seat 4: Wwwasian (€34.83 in chips) 
Seat 5: marchuchok (€26.26 in chips) 
Seat 6: BaaroRai (€30.61 in chips) 
Wwwasian: posts small blind €0.10
marchuchok: posts big blind €0.25
Yegoriy: sits out 
*** HOLE CARDS ***
Dealt to matiko09 [8h Ks]
BaaroRai: calls €0.25
matiko09: folds 
uzzy20: raises €1 to €1.25
Wwwasian: folds 
marchuchok: folds 
BaaroRai: calls €1
*** FLOP *** [7s 2c Qs]
BaaroRai: bets €0.25
uzzy20: raises €2.12 to €2.37
BaaroRai: folds 
Uncalled bet (€2.12) returned to uzzy20
uzzy20 collected €3.20 from pot
*** SUMMARY ***
Total pot €3.35 | Rake €0.15 
Board [7s 2c Qs]
Seat 1: matiko09 folded before Flop (didn't bet)
Seat 3: uzzy20 (button) collected (€3.20)
Seat 4: Wwwasian (small blind) folded before Flop
Seat 5: marchuchok (big blind) folded before Flop
Seat 6: BaaroRai folded on the Flop





PokerStars Hand #148211171831:  Hold'em No Limit (£0.10/£0.25 GBP) - 2016/02/04 11:38:08 CET [2016/02/04 5:38:08 ET]
Table 'Libra II' 6-max Seat #1 is the button
Seat 1: k4rloos (£25 in chips) 
Seat 2: matiko09 (£28.22 in chips) 
Seat 3: namex11 (£25.66 in chips) 
Seat 5: Vedmegatko (£25.70 in chips) 
Seat 6: pescador1522 (£18.12 in chips) 
matiko09: posts small blind £0.10
namex11: posts big blind £0.25
*** HOLE CARDS ***
Dealt to matiko09 [4c 3h]
Vedmegatko: folds 
pescador1522: folds 
k4rloos: folds 
matiko09: folds 
Uncalled bet (£0.15) returned to namex11
namex11 collected £0.20 from pot
namex11: doesn't show hand 
*** SUMMARY ***
Total pot £0.20 | Rake £0 
Seat 1: k4rloos (button) folded before Flop (didn't bet)
Seat 2: matiko09 (small blind) folded before Flop
Seat 3: namex11 (big blind) collected (£0.20)
Seat 5: Vedmegatko folded before Flop (didn't bet)
Seat 6: pescador1522 folded before Flop (didn't bet)





PokerStars Hand #148211181365:  Hold'em No Limit (£0.10/£0.25 GBP) - 2016/02/04 11:38:27 CET [2016/02/04 5:38:27 ET]
Table 'Libra II' 6-max Seat #2 is the button
Seat 1: k4rloos (£25 in chips) 
Seat 2: matiko09 (£28.12 in chips) 
Seat 3: namex11 (£25.76 in chips) 
Seat 5: Vedmegatko (£25.70 in chips) 
Seat 6: pescador1522 (£18.12 in chips) 
namex11: posts small blind £0.10
Wwwasian was removed from the table for failing to post
Vedmegatko: posts big blind £0.25
*** HOLE CARDS ***
Dealt to matiko09 [5h 9h]
pescador1522: folds 
k4rloos: folds 
matiko09: folds 
sagiga87 joins the table at seat #4 
namex11: raises £0.50 to £0.75
Vedmegatko: calls £0.50
*** FLOP *** [7h 6h 2s]
namex11: checks 
Vedmegatko: bets £1.02
namex11: calls £1.02
*** TURN *** [7h 6h 2s] [Jd]
namex11: checks 
Vedmegatko: checks 
*** RIVER *** [7h 6h 2s Jd] [Qs]
namex11: checks 
Vedmegatko: checks 
*** SHOW DOWN ***
namex11: shows [7d Td] (a pair of Sevens)
Vedmegatko: mucks hand 
namex11 collected £3.38 from pot
*** SUMMARY ***
Total pot £3.54 | Rake £0.16 
Board [7h 6h 2s Jd Qs]
Seat 1: k4rloos folded before Flop (didn't bet)
Seat 2: matiko09 (button) folded before Flop (didn't bet)
Seat 3: namex11 (small blind) showed [7d Td] and won (£3.38) with a pair of Sevens
Seat 5: Vedmegatko (big blind) mucked [Th 9s]
Seat 6: pescador1522 folded before Flop (didn't bet)





PokerStars Hand #148211186425:  Hold'em No Limit ($0.10/$0.25 USD) - 2016/02/04 11:38:38 CET [2016/02/04 5:38:38 ET]
Table 'Thora II' 6-max Seat #1 is the button
Seat 1: S1cker_0ne ($45.28 in chips) 
Seat 2: schatun774 ($14.44 in chips) 
Seat 4: matiko09 ($26.94 in chips) 
Seat 6: cost983 ($25 in chips) 
schatun774: posts small blind $0.10
Odmincheg: is sitting out 
matiko09: posts big blind $0.25
*** HOLE CARDS ***
Dealt to matiko09 [2c Qc]
cost983: folds 
S1cker_0ne: raises $0.39 to $0.64
schatun774: calls $0.54
matiko09: folds 
*** FLOP *** [6d Ac Td]
schatun774: checks 
S1cker_0ne: checks 
*** TURN *** [6d Ac Td] [9s]
schatun774: bets $0.25
S1cker_0ne: calls $0.25
*** RIVER *** [6d Ac Td 9s] [7h]
schatun774: bets $0.75
S1cker_0ne: calls $0.75
*** SHOW DOWN ***
schatun774: shows [8c Qh] (a straight, Six to Ten)
S1cker_0ne: mucks hand 
schatun774 collected $3.37 from pot
*** SUMMARY ***
Total pot $3.53 | Rake $0.16 
Board [6d Ac Td 9s 7h]
Seat 1: S1cker_0ne (button) mucked [Kc Tc]
Seat 2: schatun774 (small blind) showed [8c Qh] and won ($3.37) with a straight, Six to Ten
Seat 4: matiko09 (big blind) folded before Flop
Seat 6: cost983 folded before Flop (didn't bet)





PokerStars Hand #148211194334:  Hold'em No Limit (€0.10/€0.25 EUR) - 2016/02/04 11:38:53 CET [2016/02/04 5:38:53 ET]
Table 'Lilaea III' 6-max Seat #4 is the button
Seat 1: matiko09 (€25.35 in chips) 
Seat 3: uzzy20 (€26.70 in chips) 
Seat 4: Wwwasian (€34.73 in chips) 
Seat 5: marchuchok (€26.01 in chips) 
Seat 6: BaaroRai (€29.11 in chips) 
marchuchok: posts small blind €0.10
BaaroRai: posts big blind €0.25
Yegoriy: sits out 
*** HOLE CARDS ***
Dealt to matiko09 [8h 7s]
matiko09: folds 
uzzy20: raises €0.31 to €0.56
Wwwasian: folds 
marchuchok: folds 
BaaroRai: calls €0.31
*** FLOP *** [Ks 6s Qh]
BaaroRai: checks 
uzzy20: checks 
*** TURN *** [Ks 6s Qh] [3s]
BaaroRai: checks 
uzzy20: checks 
*** RIVER *** [Ks 6s Qh 3s] [4c]
BaaroRai: checks 
uzzy20: checks 
*** SHOW DOWN ***
BaaroRai: shows [2h Ad] (high card Ace)
uzzy20: shows [8s 8c] (a pair of Eights)
uzzy20 collected €1.17 from pot
*** SUMMARY ***
Total pot €1.22 | Rake €0.05 
Board [Ks 6s Qh 3s 4c]
Seat 1: matiko09 folded before Flop (didn't bet)
Seat 3: uzzy20 showed [8s 8c] and won (€1.17) with a pair of Eights
Seat 4: Wwwasian (button) folded before Flop (didn't bet)
Seat 5: marchuchok (small blind) folded before Flop
Seat 6: BaaroRai (big blind) showed [2h Ad] and lost with high card Ace





PokerStars Hand #148211196244:  Hold'em No Limit ($0.10/$0.25 USD) - 2016/02/04 11:38:57 CET [2016/02/04 5:38:57 ET]
Table 'Hungaria II' 6-max Seat #4 is the button
Seat 2: MaurerXL82 ($25.82 in chips) 
Seat 3: MAO_DZEDYN_S ($25 in chips) 
Seat 4: matiko09 ($25 in chips) 
Seat 5: nnVinokurov ($30.20 in chips) 
Seat 6: droog2 ($36.66 in chips) 
nnVinokurov: posts small blind $0.10
droog2: posts big blind $0.25
Jo_Medici: sits out 
*** HOLE CARDS ***
Dealt to matiko09 [6d 5c]
MaurerXL82: calls $0.25
MAO_DZEDYN_S: folds 
matiko09: folds 
nnVinokurov: folds 
droog2: checks 
*** FLOP *** [9s 5d Ah]
droog2: checks 
MaurerXL82: checks 
*** TURN *** [9s 5d Ah] [Qd]
droog2: checks 
MaurerXL82: bets $0.25
droog2: folds 
Uncalled bet ($0.25) returned to MaurerXL82
MaurerXL82 collected $0.57 from pot
MaurerXL82: doesn't show hand 
*** SUMMARY ***
Total pot $0.60 | Rake $0.03 
Board [9s 5d Ah Qd]
Seat 2: MaurerXL82 collected ($0.57)
Seat 3: MAO_DZEDYN_S folded before Flop (didn't bet)
Seat 4: matiko09 (button) folded before Flop (didn't bet)
Seat 5: nnVinokurov (small blind) folded before Flop
Seat 6: droog2 (big blind) folded on the Turn





PokerStars Hand #148211205521:  Hold'em No Limit ($0.10/$0.25 USD) - 2016/02/04 11:39:15 CET [2016/02/04 5:39:15 ET]
Table 'Hungaria II' 6-max Seat #5 is the button
Seat 1: Jo_Medici ($25 in chips) 
Seat 2: MaurerXL82 ($26.14 in chips) 
Seat 3: MAO_DZEDYN_S ($25 in chips) 
Seat 4: matiko09 ($25 in chips) 
Seat 5: nnVinokurov ($30.10 in chips) 
Seat 6: droog2 ($36.41 in chips) 
droog2: posts small blind $0.10
Jo_Medici: posts big blind $0.25
*** HOLE CARDS ***
Dealt to matiko09 [7c Qc]
MaurerXL82: folds 
MAO_DZEDYN_S: raises $0.50 to $0.75
matiko09: folds 
nnVinokurov: folds 
droog2: folds 
Jo_Medici: folds 
Uncalled bet ($0.50) returned to MAO_DZEDYN_S
MAO_DZEDYN_S collected $0.60 from pot
MAO_DZEDYN_S: doesn't show hand 
*** SUMMARY ***
Total pot $0.60 | Rake $0 
Seat 1: Jo_Medici (big blind) folded before Flop
Seat 2: MaurerXL82 folded before Flop (didn't bet)
Seat 3: MAO_DZEDYN_S collected ($0.60)
Seat 4: matiko09 folded before Flop (didn't bet)
Seat 5: nnVinokurov (button) folded before Flop (didn't bet)
Seat 6: droog2 (small blind) folded before Flop





PokerStars Hand #148211206851:  Hold'em No Limit ($0.10/$0.25 USD) - 2016/02/04 11:39:18 CET [2016/02/04 5:39:18 ET]
Table 'Thora II' 6-max Seat #2 is the button
Seat 1: S1cker_0ne ($43.64 in chips) 
Seat 2: schatun774 ($16.17 in chips) 
Seat 4: matiko09 ($26.69 in chips) 
matiko09: posts small blind $0.10
cost983: is sitting out 
S1cker_0ne: posts big blind $0.25
*** HOLE CARDS ***
Dealt to matiko09 [Qh Ad]
schatun774: calls $0.25
matiko09: raises $1 to $1.25
S1cker_0ne: folds 
schatun774: folds 
Uncalled bet ($1) returned to matiko09
matiko09 collected $0.75 from pot
matiko09: doesn't show hand 
*** SUMMARY ***
Total pot $0.75 | Rake $0 
Seat 1: S1cker_0ne (big blind) folded before Flop
Seat 2: schatun774 (button) folded before Flop
Seat 4: matiko09 (small blind) collected ($0.75)





PokerStars Hand #148211212989:  Hold'em No Limit (€0.10/€0.25 EUR) - 2016/02/04 11:39:30 CET [2016/02/04 5:39:30 ET]
Table 'Lilaea III' 6-max Seat #5 is the button
Seat 1: matiko09 (€25.35 in chips) 
Seat 3: uzzy20 (€27.31 in chips) 
Seat 4: Wwwasian (€34.73 in chips) 
Seat 5: marchuchok (€25.91 in chips) 
Seat 6: BaaroRai (€28.55 in chips) 
BaaroRai: posts small blind €0.10
matiko09: posts big blind €0.25
Yegoriy: sits out 
*** HOLE CARDS ***
Dealt to matiko09 [4c Kh]
uzzy20: raises €0.50 to €0.75
Wwwasian: folds 
marchuchok: calls €0.75
BaaroRai: folds 
matiko09: folds 
*** FLOP *** [Ks 3c 2c]
uzzy20: checks 
marchuchok: bets €1.07
uzzy20: calls €1.07
*** TURN *** [Ks 3c 2c] [2h]
uzzy20: checks 
marchuchok: bets €2.32
uzzy20: calls €2.32
*** RIVER *** [Ks 3c 2c 2h] [6h]
uzzy20: checks 
marchuchok: bets €5.93
uzzy20: calls €5.93
*** SHOW DOWN ***
marchuchok: shows [7c 7h] (two pair, Sevens and Deuces)
uzzy20: shows [Qc Qs] (two pair, Queens and Deuces)
uzzy20 collected €19.57 from pot
*** SUMMARY ***
Total pot €20.49 | Rake €0.92 
Board [Ks 3c 2c 2h 6h]
Seat 1: matiko09 (big blind) folded before Flop
Seat 3: uzzy20 showed [Qc Qs] and won (€19.57) with two pair, Queens and Deuces
Seat 4: Wwwasian folded before Flop (didn't bet)
Seat 5: marchuchok (button) showed [7c 7h] and lost with two pair, Sevens and Deuces
Seat 6: BaaroRai (small blind) folded before Flop





PokerStars Hand #148211214153:  Hold'em No Limit ($0.10/$0.25 USD) - 2016/02/04 11:39:32 CET [2016/02/04 5:39:32 ET]
Table 'Thora II' 6-max Seat #4 is the button
Seat 1: S1cker_0ne ($43.39 in chips) 
Seat 2: schatun774 ($15.92 in chips) 
Seat 4: matiko09 ($27.19 in chips) 
S1cker_0ne: posts small blind $0.10
schatun774: posts big blind $0.25
*** HOLE CARDS ***
Dealt to matiko09 [2c 5c]
matiko09: folds 
S1cker_0ne: raises $0.39 to $0.64
schatun774: folds 
Uncalled bet ($0.39) returned to S1cker_0ne
S1cker_0ne collected $0.50 from pot
S1cker_0ne: doesn't show hand 
*** SUMMARY ***
Total pot $0.50 | Rake $0 
Seat 1: S1cker_0ne (small blind) collected ($0.50)
Seat 2: schatun774 (big blind) folded before Flop
Seat 4: matiko09 (button) folded before Flop (didn't bet)





PokerStars Hand #148211217687:  Hold'em No Limit (£0.10/£0.25 GBP) - 2016/02/04 11:39:39 CET [2016/02/04 5:39:39 ET]
Table 'Libra II' 6-max Seat #3 is the button
Seat 1: k4rloos (£25 in chips) 
Seat 2: matiko09 (£28.12 in chips) 
Seat 3: namex11 (£27.37 in chips) 
Seat 5: Vedmegatko (£25 in chips) 
Seat 6: pescador1522 (£18.12 in chips) 
sagiga87 will be allowed to play after the button
Vedmegatko: posts small blind £0.10
pescador1522: posts big blind £0.25
*** HOLE CARDS ***
Dealt to matiko09 [Jh 8c]
k4rloos: folds 
matiko09: folds 
namex11: folds 
Vedmegatko: folds 
Uncalled bet (£0.15) returned to pescador1522
pescador1522 collected £0.20 from pot
pescador1522: doesn't show hand 
*** SUMMARY ***
Total pot £0.20 | Rake £0 
Seat 1: k4rloos folded before Flop (didn't bet)
Seat 2: matiko09 folded before Flop (didn't bet)
Seat 3: namex11 (button) folded before Flop (didn't bet)
Seat 5: Vedmegatko (small blind) folded before Flop
Seat 6: pescador1522 (big blind) collected (£0.20)





PokerStars Hand #148211219208:  Hold'em No Limit ($0.10/$0.25 USD) - 2016/02/04 11:39:42 CET [2016/02/04 5:39:42 ET]
Table 'Thora II' 6-max Seat #1 is the button
Seat 1: S1cker_0ne ($43.64 in chips) 
Seat 2: schatun774 ($15.67 in chips) 
Seat 4: matiko09 ($27.19 in chips) 
schatun774: posts small blind $0.10
matiko09: posts big blind $0.25
cost983: sits out 
*** HOLE CARDS ***
Dealt to matiko09 [9d Ah]
S1cker_0ne: folds 
schatun774: calls $0.15
matiko09: raises $0.75 to $1
schatun774: folds 
Uncalled bet ($0.75) returned to matiko09
matiko09 collected $0.50 from pot
matiko09: doesn't show hand 
*** SUMMARY ***
Total pot $0.50 | Rake $0 
Seat 1: S1cker_0ne (button) folded before Flop (didn't bet)
Seat 2: schatun774 (small blind) folded before Flop
Seat 4: matiko09 (big blind) collected ($0.50)





PokerStars Hand #148211221148:  Hold'em No Limit ($0.10/$0.25 USD) - 2016/02/04 11:39:46 CET [2016/02/04 5:39:46 ET]
Table 'Hungaria II' 6-max Seat #6 is the button
Seat 1: Jo_Medici ($25 in chips) 
Seat 2: MaurerXL82 ($26.14 in chips) 
Seat 3: MAO_DZEDYN_S ($25.35 in chips) 
Seat 4: matiko09 ($25 in chips) 
Seat 5: nnVinokurov ($30.10 in chips) 
Seat 6: droog2 ($36.31 in chips) 
Jo_Medici: posts small blind $0.10
MaurerXL82: posts big blind $0.25
*** HOLE CARDS ***
Dealt to matiko09 [As 7h]
MAO_DZEDYN_S: folds 
matiko09: folds 
nnVinokurov: folds 
droog2: raises $0.50 to $0.75
Jo_Medici: folds 
MaurerXL82: folds 
Uncalled bet ($0.50) returned to droog2
droog2 collected $0.60 from pot
droog2: doesn't show hand 
*** SUMMARY ***
Total pot $0.60 | Rake $0 
Seat 1: Jo_Medici (small blind) folded before Flop
Seat 2: MaurerXL82 (big blind) folded before Flop
Seat 3: MAO_DZEDYN_S folded before Flop (didn't bet)
Seat 4: matiko09 folded before Flop (didn't bet)
Seat 5: nnVinokurov folded before Flop (didn't bet)
Seat 6: droog2 (button) collected ($0.60)





PokerStars Hand #148211225987:  Hold'em No Limit (£0.10/£0.25 GBP) - 2016/02/04 11:39:55 CET [2016/02/04 5:39:55 ET]
Table 'Libra II' 6-max Seat #5 is the button
Seat 1: k4rloos (£25 in chips) 
Seat 2: matiko09 (£28.12 in chips) 
Seat 3: namex11 (£27.37 in chips) 
Seat 5: Vedmegatko (£25 in chips) 
Seat 6: pescador1522 (£18.22 in chips) 
pescador1522: posts small blind £0.10
k4rloos: posts big blind £0.25
sagiga87: sits out 
*** HOLE CARDS ***
Dealt to matiko09 [Qc Js]
matiko09: raises £0.50 to £0.75
namex11: folds 
Vedmegatko: folds 
pescador1522: calls £0.65
k4rloos: folds 
*** FLOP *** [7s Ac 6d]
pescador1522: checks 
matiko09: checks 
*** TURN *** [7s Ac 6d] [4d]
pescador1522: bets £0.25
matiko09: folds 
Uncalled bet (£0.25) returned to pescador1522
pescador1522 collected £1.67 from pot
pescador1522: doesn't show hand 
*** SUMMARY ***
Total pot £1.75 | Rake £0.08 
Board [7s Ac 6d 4d]
Seat 1: k4rloos (big blind) folded before Flop
Seat 2: matiko09 folded on the Turn
Seat 3: namex11 folded before Flop (didn't bet)
Seat 5: Vedmegatko (button) folded before Flop (didn't bet)
Seat 6: pescador1522 (small blind) collected (£1.67)





PokerStars Hand #148211227008:  Hold'em No Limit ($0.10/$0.25 USD) - 2016/02/04 11:39:57 CET [2016/02/04 5:39:57 ET]
Table 'Thora II' 6-max Seat #2 is the button
Seat 1: S1cker_0ne ($43.64 in chips) 
Seat 2: schatun774 ($15.42 in chips) 
Seat 4: matiko09 ($27.44 in chips) 
Seat 6: cost983 ($25 in chips) 
matiko09: posts small blind $0.10
cost983: posts big blind $0.25
*** HOLE CARDS ***
Dealt to matiko09 [5s 6d]
S1cker_0ne: folds 
schatun774: folds 
matiko09: folds 
Uncalled bet ($0.15) returned to cost983
cost983 collected $0.20 from pot
cost983: doesn't show hand 
*** SUMMARY ***
Total pot $0.20 | Rake $0 
Seat 1: S1cker_0ne folded before Flop (didn't bet)
Seat 2: schatun774 (button) folded before Flop (didn't bet)
Seat 4: matiko09 (small blind) folded before Flop
Seat 6: cost983 (big blind) collected ($0.20)





PokerStars Hand #148211230895:  Hold'em No Limit ($0.10/$0.25 USD) - 2016/02/04 11:40:05 CET [2016/02/04 5:40:05 ET]
Table 'Thora II' 6-max Seat #4 is the button
Seat 1: S1cker_0ne ($43.64 in chips) 
Seat 2: schatun774 ($15.42 in chips) 
Seat 4: matiko09 ($27.34 in chips) 
Seat 6: cost983 ($25.10 in chips) 
cost983: posts small blind $0.10
S1cker_0ne: posts big blind $0.25
*** HOLE CARDS ***
Dealt to matiko09 [Qc Ad]
schatun774: folds 
matiko09: raises $0.37 to $0.62
cost983: folds 
S1cker_0ne: folds 
Uncalled bet ($0.37) returned to matiko09
matiko09 collected $0.60 from pot
matiko09: doesn't show hand 
*** SUMMARY ***
Total pot $0.60 | Rake $0 
Seat 1: S1cker_0ne (big blind) folded before Flop
Seat 2: schatun774 folded before Flop (didn't bet)
Seat 4: matiko09 (button) collected ($0.60)
Seat 6: cost983 (small blind) folded before Flop





PokerStars Hand #148211236534:  Hold'em No Limit ($0.10/$0.25 USD) - 2016/02/04 11:40:16 CET [2016/02/04 5:40:16 ET]
Table 'Hungaria II' 6-max Seat #1 is the button
Seat 1: Jo_Medici ($25 in chips) 
Seat 2: MaurerXL82 ($25.89 in chips) 
Seat 3: MAO_DZEDYN_S ($25.35 in chips) 
Seat 4: matiko09 ($25 in chips) 
Seat 5: nnVinokurov ($30.10 in chips) 
Seat 6: droog2 ($36.66 in chips) 
MaurerXL82: posts small blind $0.10
MAO_DZEDYN_S: posts big blind $0.25
*** HOLE CARDS ***
Dealt to matiko09 [Kh Kc]
matiko09: raises $0.50 to $0.75
nnVinokurov: folds 
droog2: folds 
Jo_Medici: folds 
MaurerXL82: folds 
MAO_DZEDYN_S: calls $0.50
*** FLOP *** [Qd Th 7c]
MAO_DZEDYN_S: checks 
matiko09: bets $1
MAO_DZEDYN_S: folds 
Uncalled bet ($1) returned to matiko09
matiko09 collected $1.53 from pot
matiko09: doesn't show hand 
*** SUMMARY ***
Total pot $1.60 | Rake $0.07 
Board [Qd Th 7c]
Seat 1: Jo_Medici (button) folded before Flop (didn't bet)
Seat 2: MaurerXL82 (small blind) folded before Flop
Seat 3: MAO_DZEDYN_S (big blind) folded on the Flop
Seat 4: matiko09 collected ($1.53)
Seat 5: nnVinokurov folded before Flop (didn't bet)
Seat 6: droog2 folded before Flop (didn't bet)





PokerStars Hand #148211238684:  Hold'em No Limit (£0.10/£0.25 GBP) - 2016/02/04 11:40:20 CET [2016/02/04 5:40:20 ET]
Table 'Libra II' 6-max Seat #6 is the button
Seat 1: k4rloos (£25 in chips) 
Seat 2: matiko09 (£27.37 in chips) 
Seat 3: namex11 (£27.37 in chips) 
Seat 5: Vedmegatko (£25 in chips) 
Seat 6: pescador1522 (£19.14 in chips) 
k4rloos: posts small blind £0.10
matiko09: posts big blind £0.25
sagiga87: sits out 
*** HOLE CARDS ***
Dealt to matiko09 [2h Ts]
namex11: folds 
Vedmegatko: folds 
pescador1522: folds 
k4rloos: raises £0.50 to £0.75
matiko09: folds 
Uncalled bet (£0.50) returned to k4rloos
k4rloos collected £0.50 from pot
k4rloos: doesn't show hand 
*** SUMMARY ***
Total pot £0.50 | Rake £0 
Seat 1: k4rloos (small blind) collected (£0.50)
Seat 2: matiko09 (big blind) folded before Flop
Seat 3: namex11 folded before Flop (didn't bet)
Seat 5: Vedmegatko folded before Flop (didn't bet)
Seat 6: pescador1522 (button) folded before Flop (didn't bet)





PokerStars Hand #148211241854:  Hold'em No Limit ($0.10/$0.25 USD) - 2016/02/04 11:40:26 CET [2016/02/04 5:40:26 ET]
Table 'Thora II' 6-max Seat #6 is the button
Seat 1: S1cker_0ne ($43.39 in chips) 
Seat 2: schatun774 ($15.42 in chips) 
Seat 4: matiko09 ($27.69 in chips) 
Seat 6: cost983 ($25 in chips) 
S1cker_0ne: posts small blind $0.10
schatun774: posts big blind $0.25
*** HOLE CARDS ***
Dealt to matiko09 [6c Jd]
matiko09: folds 
cost983: raises $0.37 to $0.62
S1cker_0ne: calls $0.52
schatun774: calls $0.37
*** FLOP *** [3c Ks 8c]
S1cker_0ne: checks 
schatun774: checks 
cost983: bets $1.33
S1cker_0ne: folds 
schatun774: folds 
Uncalled bet ($1.33) returned to cost983
cost983 collected $1.78 from pot
cost983: doesn't show hand 
*** SUMMARY ***
Total pot $1.86 | Rake $0.08 
Board [3c Ks 8c]
Seat 1: S1cker_0ne (small blind) folded on the Flop
Seat 2: schatun774 (big blind) folded on the Flop
Seat 4: matiko09 folded before Flop (didn't bet)
Seat 6: cost983 (button) collected ($1.78)





PokerStars Hand #148211243681:  Hold'em No Limit (€0.10/€0.25 EUR) - 2016/02/04 11:40:30 CET [2016/02/04 5:40:30 ET]
Table 'Lilaea III' 6-max Seat #6 is the button
Seat 1: matiko09 (€25.10 in chips) 
Seat 2: Yegoriy (€25 in chips) 
Seat 4: Wwwasian (€34.73 in chips) 
Seat 5: marchuchok (€25 in chips) 
Seat 6: BaaroRai (€28.45 in chips) 
matiko09: posts small blind €0.10
Yegoriy: posts big blind €0.25
*** HOLE CARDS ***
Dealt to matiko09 [8s Ah]
marchuchok said, "ebat olen"
Wwwasian: folds 
marchuchok: folds 
BaaroRai: folds 
matiko09: raises €0.50 to €0.75
Yegoriy: folds 
Uncalled bet (€0.50) returned to matiko09
matiko09 collected €0.50 from pot
matiko09: doesn't show hand 
*** SUMMARY ***
Total pot €0.50 | Rake €0 
Seat 1: matiko09 (small blind) collected (€0.50)
Seat 2: Yegoriy (big blind) folded before Flop
Seat 4: Wwwasian folded before Flop (didn't bet)
Seat 5: marchuchok folded before Flop (didn't bet)
Seat 6: BaaroRai (button) folded before Flop (didn't bet)





PokerStars Hand #148211244858:  Hold'em No Limit (£0.10/£0.25 GBP) - 2016/02/04 11:40:32 CET [2016/02/04 5:40:32 ET]
Table 'Libra II' 6-max Seat #1 is the button
Seat 1: k4rloos (£25.25 in chips) 
Seat 2: matiko09 (£27.12 in chips) 
Seat 3: namex11 (£27.37 in chips) 
Seat 5: Vedmegatko (£25 in chips) 
Seat 6: pescador1522 (£19.14 in chips) 
matiko09: posts small blind £0.10
namex11: posts big blind £0.25
sagiga87: sits out 
*** HOLE CARDS ***
Dealt to matiko09 [4h 2c]
Vedmegatko: raises £0.50 to £0.75
pescador1522: folds 
k4rloos: folds 
matiko09: folds 
namex11: calls £0.50
*** FLOP *** [Ks Js 8s]
namex11: checks 
Vedmegatko: bets £1.25
namex11: folds 
Uncalled bet (£1.25) returned to Vedmegatko
Vedmegatko collected £1.53 from pot
Vedmegatko: doesn't show hand 
*** SUMMARY ***
Total pot £1.60 | Rake £0.07 
Board [Ks Js 8s]
Seat 1: k4rloos (button) folded before Flop (didn't bet)
Seat 2: matiko09 (small blind) folded before Flop
Seat 3: namex11 (big blind) folded on the Flop
Seat 5: Vedmegatko collected (£1.53)
Seat 6: pescador1522 folded before Flop (didn't bet)





PokerStars Hand #148211259634:  Hold'em No Limit (€0.10/€0.25 EUR) - 2016/02/04 11:41:02 CET [2016/02/04 5:41:02 ET]
Table 'Lilaea III' 6-max Seat #1 is the button
Seat 1: matiko09 (€25.35 in chips) 
Seat 2: Yegoriy (€25 in chips) 
Seat 4: Wwwasian (€34.73 in chips) 
Seat 5: marchuchok (€25 in chips) 
Seat 6: BaaroRai (€28.45 in chips) 
Yegoriy: posts small blind €0.10
Wwwasian: posts big blind €0.25
*** HOLE CARDS ***
Dealt to matiko09 [9c 5s]
marchuchok: folds 
BaaroRai: folds 
matiko09: folds 
Yegoriy: raises €0.50 to €0.75
Wwwasian: folds 
Uncalled bet (€0.50) returned to Yegoriy
Yegoriy collected €0.50 from pot
*** SUMMARY ***
Total pot €0.50 | Rake €0 
Seat 1: matiko09 (button) folded before Flop (didn't bet)
Seat 2: Yegoriy (small blind) collected (€0.50)
Seat 4: Wwwasian (big blind) folded before Flop
Seat 5: marchuchok folded before Flop (didn't bet)
Seat 6: BaaroRai folded before Flop (didn't bet)





PokerStars Hand #148211260588:  Hold'em No Limit (£0.10/£0.25 GBP) - 2016/02/04 11:41:04 CET [2016/02/04 5:41:04 ET]
Table 'Libra II' 6-max Seat #2 is the button
Seat 1: k4rloos (£25.25 in chips) 
Seat 2: matiko09 (£27.02 in chips) 
Seat 3: namex11 (£26.62 in chips) 
Seat 4: sagiga87 (£20 in chips) 
Seat 5: Vedmegatko (£25.78 in chips) 
Seat 6: pescador1522 (£19.14 in chips) 
namex11: posts small blind £0.10
sagiga87: posts big blind £0.25
*** HOLE CARDS ***
Dealt to matiko09 [7s Kd]
Vedmegatko: folds 
pescador1522: calls £0.25
k4rloos: folds 
matiko09: folds 
namex11: folds 
sagiga87: checks 
*** FLOP *** [5h Td 6s]
sagiga87: checks 
pescador1522: checks 
*** TURN *** [5h Td 6s] [8h]
sagiga87: checks 
pescador1522: checks 
*** RIVER *** [5h Td 6s 8h] [3h]
sagiga87: bets £0.25
pescador1522: folds 
Uncalled bet (£0.25) returned to sagiga87
sagiga87 collected £0.57 from pot
sagiga87: doesn't show hand 
*** SUMMARY ***
Total pot £0.60 | Rake £0.03 
Board [5h Td 6s 8h 3h]
Seat 1: k4rloos folded before Flop (didn't bet)
Seat 2: matiko09 (button) folded before Flop (didn't bet)
Seat 3: namex11 (small blind) folded before Flop
Seat 4: sagiga87 (big blind) collected (£0.57)
Seat 5: Vedmegatko folded before Flop (didn't bet)
Seat 6: pescador1522 folded on the River





PokerStars Hand #148211260999:  Hold'em No Limit ($0.10/$0.25 USD) - 2016/02/04 11:41:05 CET [2016/02/04 5:41:05 ET]
Table 'Thora II' 6-max Seat #1 is the button
Seat 1: S1cker_0ne ($42.77 in chips) 
Seat 2: schatun774 ($14.80 in chips) 
Seat 4: matiko09 ($27.69 in chips) 
Seat 6: cost983 ($26.16 in chips) 
schatun774: posts small blind $0.10
matiko09: posts big blind $0.25
*** HOLE CARDS ***
Dealt to matiko09 [4d Qc]
cost983: raises $0.37 to $0.62
S1cker_0ne: folds 
schatun774: folds 
matiko09: folds 
Uncalled bet ($0.37) returned to cost983
cost983 collected $0.60 from pot
cost983: doesn't show hand 
*** SUMMARY ***
Total pot $0.60 | Rake $0 
Seat 1: S1cker_0ne (button) folded before Flop (didn't bet)
Seat 2: schatun774 (small blind) folded before Flop
Seat 4: matiko09 (big blind) folded before Flop
Seat 6: cost983 collected ($0.60)





PokerStars Hand #148211266832:  Hold'em No Limit ($0.10/$0.25 USD) - 2016/02/04 11:41:16 CET [2016/02/04 5:41:16 ET]
Table 'Thora II' 6-max Seat #2 is the button
Seat 1: S1cker_0ne ($42.77 in chips) 
Seat 2: schatun774 ($14.70 in chips) 
Seat 4: matiko09 ($27.44 in chips) 
Seat 6: cost983 ($26.51 in chips) 
matiko09: posts small blind $0.10
cost983: posts big blind $0.25
*** HOLE CARDS ***
Dealt to matiko09 [Th 2c]
S1cker_0ne: folds 
schatun774: calls $0.25
matiko09: folds 
cost983: checks 
*** FLOP *** [Kc Jd Qd]
cost983: checks 
schatun774: bets $0.50
cost983: calls $0.50
*** TURN *** [Kc Jd Qd] [Jh]
cost983: checks 
schatun774: bets $0.50
cost983: folds 
Uncalled bet ($0.50) returned to schatun774
schatun774 collected $1.53 from pot
schatun774: doesn't show hand 
*** SUMMARY ***
Total pot $1.60 | Rake $0.07 
Board [Kc Jd Qd Jh]
Seat 1: S1cker_0ne folded before Flop (didn't bet)
Seat 2: schatun774 (button) collected ($1.53)
Seat 4: matiko09 (small blind) folded before Flop
Seat 6: cost983 (big blind) folded on the Turn





PokerStars Hand #148211269844:  Hold'em No Limit ($0.10/$0.25 USD) - 2016/02/04 11:41:22 CET [2016/02/04 5:41:22 ET]
Table 'Hungaria II' 6-max Seat #2 is the button
Seat 1: Jo_Medici ($25 in chips) 
Seat 2: MaurerXL82 ($25.79 in chips) 
Seat 3: MAO_DZEDYN_S ($25 in chips) 
Seat 4: matiko09 ($25.78 in chips) 
Seat 5: nnVinokurov ($30.10 in chips) 
Seat 6: droog2 ($36.66 in chips) 
MAO_DZEDYN_S: posts small blind $0.10
matiko09: posts big blind $0.25
*** HOLE CARDS ***
Dealt to matiko09 [3d Ac]
nnVinokurov: folds 
droog2: folds 
Jo_Medici: folds 
MaurerXL82: folds 
MAO_DZEDYN_S: folds 
Uncalled bet ($0.15) returned to matiko09
matiko09 collected $0.20 from pot
matiko09: doesn't show hand 
*** SUMMARY ***
Total pot $0.20 | Rake $0 
Seat 1: Jo_Medici folded before Flop (didn't bet)
Seat 2: MaurerXL82 (button) folded before Flop (didn't bet)
Seat 3: MAO_DZEDYN_S (small blind) folded before Flop
Seat 4: matiko09 (big blind) collected ($0.20)
Seat 5: nnVinokurov folded before Flop (didn't bet)
Seat 6: droog2 folded before Flop (didn't bet)





PokerStars Hand #148211273080:  Hold'em No Limit (€0.10/€0.25 EUR) - 2016/02/04 11:41:29 CET [2016/02/04 5:41:29 ET]
Table 'Lilaea III' 6-max Seat #2 is the button
Seat 1: matiko09 (€25.35 in chips) 
Seat 2: Yegoriy (€25.25 in chips) 
Seat 4: Wwwasian (€34.48 in chips) 
Seat 5: marchuchok (€25 in chips) 
Seat 6: BaaroRai (€28.45 in chips) 
Wwwasian: posts small blind €0.10
marchuchok: posts big blind €0.25
*** HOLE CARDS ***
Dealt to matiko09 [7s 3s]
BaaroRai: calls €0.25
matiko09: folds 
Yegoriy: folds 
Wwwasian: folds 
marchuchok: checks 
*** FLOP *** [7h Tc 9d]
marchuchok: checks 
BaaroRai: checks 
*** TURN *** [7h Tc 9d] [7d]
marchuchok: checks 
BaaroRai: checks 
*** RIVER *** [7h Tc 9d 7d] [5h]
marchuchok: checks 
BaaroRai: bets €1.25
marchuchok: folds 
Uncalled bet (€1.25) returned to BaaroRai
BaaroRai collected €0.57 from pot
BaaroRai: doesn't show hand 
*** SUMMARY ***
Total pot €0.60 | Rake €0.03 
Board [7h Tc 9d 7d 5h]
Seat 1: matiko09 folded before Flop (didn't bet)
Seat 2: Yegoriy (button) folded before Flop (didn't bet)
Seat 4: Wwwasian (small blind) folded before Flop
Seat 5: marchuchok (big blind) folded on the River
Seat 6: BaaroRai collected (€0.57)





PokerStars Hand #148211282269:  Hold'em No Limit ($0.10/$0.25 USD) - 2016/02/04 11:41:47 CET [2016/02/04 5:41:47 ET]
Table 'Thora II' 6-max Seat #4 is the button
Seat 1: S1cker_0ne ($42.77 in chips) 
Seat 2: schatun774 ($15.48 in chips) 
Seat 4: matiko09 ($27.34 in chips) 
Seat 6: cost983 ($25.76 in chips) 
cost983: posts small blind $0.10
S1cker_0ne: posts big blind $0.25
*** HOLE CARDS ***
Dealt to matiko09 [8c 6h]
schatun774: calls $0.25
matiko09: folds 
cost983: folds 
S1cker_0ne: checks 
*** FLOP *** [2c 3d 3h]
S1cker_0ne: checks 
schatun774: checks 
*** TURN *** [2c 3d 3h] [Qd]
S1cker_0ne: checks 
schatun774: checks 
*** RIVER *** [2c 3d 3h Qd] [Kh]
S1cker_0ne: checks 
schatun774: checks 
*** SHOW DOWN ***
S1cker_0ne: shows [7d Ad] (a pair of Threes)
schatun774: shows [5d 5c] (two pair, Fives and Threes)
schatun774 collected $0.57 from pot
*** SUMMARY ***
Total pot $0.60 | Rake $0.03 
Board [2c 3d 3h Qd Kh]
Seat 1: S1cker_0ne (big blind) showed [7d Ad] and lost with a pair of Threes
Seat 2: schatun774 showed [5d 5c] and won ($0.57) with two pair, Fives and Threes
Seat 4: matiko09 (button) folded before Flop (didn't bet)
Seat 6: cost983 (small blind) folded before Flop





PokerStars Hand #148211282413:  Hold'em No Limit (£0.10/£0.25 GBP) - 2016/02/04 11:41:47 CET [2016/02/04 5:41:47 ET]
Table 'Libra II' 6-max Seat #3 is the button
Seat 1: k4rloos (£25.25 in chips) 
Seat 2: matiko09 (£27.02 in chips) 
Seat 3: namex11 (£26.52 in chips) 
Seat 4: sagiga87 (£20.32 in chips) 
Seat 5: Vedmegatko (£25.78 in chips) 
Seat 6: pescador1522 (£18.89 in chips) 
sagiga87: posts small blind £0.10
Vedmegatko: posts big blind £0.25
*** HOLE CARDS ***
Dealt to matiko09 [3h Qc]
pescador1522: folds 
k4rloos: folds 
matiko09: folds 
namex11: raises £0.25 to £0.50
sagiga87: folds 
Vedmegatko: folds 
Uncalled bet (£0.25) returned to namex11
namex11 collected £0.60 from pot
namex11: doesn't show hand 
*** SUMMARY ***
Total pot £0.60 | Rake £0 
Seat 1: k4rloos folded before Flop (didn't bet)
Seat 2: matiko09 folded before Flop (didn't bet)
Seat 3: namex11 (button) collected (£0.60)
Seat 4: sagiga87 (small blind) folded before Flop
Seat 5: Vedmegatko (big blind) folded before Flop
Seat 6: pescador1522 folded before Flop (didn't bet)





PokerStars Hand #148211286882:  Hold'em No Limit ($0.10/$0.25 USD) - 2016/02/04 11:41:56 CET [2016/02/04 5:41:56 ET]
Table 'Hungaria II' 6-max Seat #3 is the button
Seat 1: Jo_Medici ($25 in chips) 
Seat 2: MaurerXL82 ($25.79 in chips) 
Seat 3: MAO_DZEDYN_S ($25 in chips) 
Seat 4: matiko09 ($25.88 in chips) 
Seat 5: nnVinokurov ($30.10 in chips) 
Seat 6: droog2 ($36.66 in chips) 
matiko09: posts small blind $0.10
nnVinokurov: posts big blind $0.25
*** HOLE CARDS ***
Dealt to matiko09 [6c 9s]
droog2: folds 
Jo_Medici: folds 
MaurerXL82: calls $0.25
MAO_DZEDYN_S: folds 
matiko09: folds 
nnVinokurov: checks 
*** FLOP *** [Qh Kh Td]
nnVinokurov: checks 
MaurerXL82: bets $0.25
nnVinokurov: calls $0.25
*** TURN *** [Qh Kh Td] [8d]
nnVinokurov: checks 
MaurerXL82: bets $0.25
nnVinokurov: calls $0.25
*** RIVER *** [Qh Kh Td 8d] [2c]
nnVinokurov: checks 
MaurerXL82: bets $0.25
nnVinokurov: calls $0.25
*** SHOW DOWN ***
MaurerXL82: shows [Kc Qd] (two pair, Kings and Queens)
nnVinokurov: mucks hand 
MaurerXL82 collected $2.01 from pot
*** SUMMARY ***
Total pot $2.10 | Rake $0.09 
Board [Qh Kh Td 8d 2c]
Seat 1: Jo_Medici folded before Flop (didn't bet)
Seat 2: MaurerXL82 showed [Kc Qd] and won ($2.01) with two pair, Kings and Queens
Seat 3: MAO_DZEDYN_S (button) folded before Flop (didn't bet)
Seat 4: matiko09 (small blind) folded before Flop
Seat 5: nnVinokurov (big blind) mucked [Th 9d]
Seat 6: droog2 folded before Flop (didn't bet)





PokerStars Hand #148211293668:  Hold'em No Limit (£0.10/£0.25 GBP) - 2016/02/04 11:42:10 CET [2016/02/04 5:42:10 ET]
Table 'Libra II' 6-max Seat #4 is the button
Seat 1: k4rloos (£25.25 in chips) 
Seat 2: matiko09 (£27.02 in chips) 
Seat 3: namex11 (£26.87 in chips) 
Seat 4: sagiga87 (£20.22 in chips) 
Seat 5: Vedmegatko (£25.53 in chips) 
Vedmegatko: posts small blind £0.10
k4rloos: posts big blind £0.25
*** HOLE CARDS ***
Dealt to matiko09 [4h Jc]
matiko09: folds 
pescador1522 is disconnected 
namex11 has timed out
namex11: folds 
sagiga87: folds 
Vedmegatko: folds 
Uncalled bet (£0.15) returned to k4rloos
k4rloos collected £0.20 from pot
k4rloos: doesn't show hand 
*** SUMMARY ***
Total pot £0.20 | Rake £0 
Seat 1: k4rloos (big blind) collected (£0.20)
Seat 2: matiko09 folded before Flop (didn't bet)
Seat 3: namex11 folded before Flop (didn't bet)
Seat 4: sagiga87 (button) folded before Flop (didn't bet)
Seat 5: Vedmegatko (small blind) folded before Flop





PokerStars Hand #148211298048:  Hold'em No Limit ($0.10/$0.25 USD) - 2016/02/04 11:42:18 CET [2016/02/04 5:42:18 ET]
Table 'Thora II' 6-max Seat #6 is the button
Seat 1: S1cker_0ne ($42.52 in chips) 
Seat 2: schatun774 ($15.80 in chips) 
Seat 4: matiko09 ($27.34 in chips) 
Seat 6: cost983 ($25.66 in chips) 
S1cker_0ne: posts small blind $0.10
schatun774: posts big blind $0.25
*** HOLE CARDS ***
Dealt to matiko09 [Qd Qs]
matiko09: raises $0.50 to $0.75
cost983: folds 
S1cker_0ne: folds 
schatun774: calls $0.50
*** FLOP *** [9s 8h 9c]
schatun774: bets $0.25
matiko09: raises $1.05 to $1.30
schatun774: calls $1.05
*** TURN *** [9s 8h 9c] [4d]
schatun774: bets $0.25
matiko09: raises $2.34 to $2.59
schatun774: calls $2.34
*** RIVER *** [9s 8h 9c 4d] [Kd]
schatun774: checks 
matiko09: checks 
*** SHOW DOWN ***
schatun774: shows [Td Jc] (a pair of Nines)
matiko09: shows [Qd Qs] (two pair, Queens and Nines)
matiko09 collected $8.96 from pot
*** SUMMARY ***
Total pot $9.38 | Rake $0.42 
Board [9s 8h 9c 4d Kd]
Seat 1: S1cker_0ne (small blind) folded before Flop
Seat 2: schatun774 (big blind) showed [Td Jc] and lost with a pair of Nines
Seat 4: matiko09 showed [Qd Qs] and won ($8.96) with two pair, Queens and Nines
Seat 6: cost983 (button) folded before Flop (didn't bet)





PokerStars Hand #148211304350:  Hold'em No Limit (€0.10/€0.25 EUR) - 2016/02/04 11:42:31 CET [2016/02/04 5:42:31 ET]
Table 'Lilaea III' 6-max Seat #4 is the button
Seat 1: matiko09 (€25.35 in chips) 
Seat 2: Yegoriy (€25.25 in chips) 
Seat 4: Wwwasian (€34.38 in chips) 
Seat 5: marchuchok (€25 in chips) 
Seat 6: BaaroRai (€28.77 in chips) 
marchuchok: posts small blind €0.10
BaaroRai: posts big blind €0.25
*** HOLE CARDS ***
Dealt to matiko09 [6h Ts]
matiko09: folds 
Yegoriy: folds 
Wwwasian: folds 
marchuchok: raises €0.37 to €0.62
BaaroRai: folds 
Uncalled bet (€0.37) returned to marchuchok
marchuchok collected €0.50 from pot
marchuchok: doesn't show hand 
*** SUMMARY ***
Total pot €0.50 | Rake €0 
Seat 1: matiko09 folded before Flop (didn't bet)
Seat 2: Yegoriy folded before Flop (didn't bet)
Seat 4: Wwwasian (button) folded before Flop (didn't bet)
Seat 5: marchuchok (small blind) collected (€0.50)
Seat 6: BaaroRai (big blind) folded before Flop





PokerStars Hand #148211306050:  Hold'em No Limit ($0.10/$0.25 USD) - 2016/02/04 11:42:34 CET [2016/02/04 5:42:34 ET]
Table 'Hungaria II' 6-max Seat #4 is the button
Seat 1: Jo_Medici ($25 in chips) 
Seat 2: MaurerXL82 ($26.80 in chips) 
Seat 3: MAO_DZEDYN_S ($25 in chips) 
Seat 4: matiko09 ($25.78 in chips) 
Seat 5: nnVinokurov ($29.10 in chips) 
Seat 6: droog2 ($36.66 in chips) 
nnVinokurov: posts small blind $0.10
droog2: posts big blind $0.25
*** HOLE CARDS ***
Dealt to matiko09 [Ac Kh]
Jo_Medici: folds 
MaurerXL82: calls $0.25
MAO_DZEDYN_S: folds 
matiko09: raises $0.75 to $1
nnVinokurov: folds 
droog2: folds 
MaurerXL82: folds 
Uncalled bet ($0.75) returned to matiko09
matiko09 collected $0.85 from pot
matiko09: doesn't show hand 
*** SUMMARY ***
Total pot $0.85 | Rake $0 
Seat 1: Jo_Medici folded before Flop (didn't bet)
Seat 2: MaurerXL82 folded before Flop
Seat 3: MAO_DZEDYN_S folded before Flop (didn't bet)
Seat 4: matiko09 (button) collected ($0.85)
Seat 5: nnVinokurov (small blind) folded before Flop
Seat 6: droog2 (big blind) folded before Flop





PokerStars Hand #148211308019:  Hold'em No Limit (£0.10/£0.25 GBP) - 2016/02/04 11:42:38 CET [2016/02/04 5:42:38 ET]
Table 'Libra II' 6-max Seat #5 is the button
Seat 1: k4rloos (£25.35 in chips) 
Seat 2: matiko09 (£27.02 in chips) 
Seat 3: namex11 (£26.87 in chips) 
Seat 4: sagiga87 (£20.22 in chips) 
Seat 5: Vedmegatko (£25.43 in chips) 
k4rloos: posts small blind £0.10
matiko09: posts big blind £0.25
*** HOLE CARDS ***
Dealt to matiko09 [8c Kd]
namex11: folds 
sagiga87: calls £0.25
Vedmegatko: raises £0.75 to £1
k4rloos: folds 
matiko09: folds 
sagiga87: calls £0.75
*** FLOP *** [2s 6c 7c]
sagiga87: bets £0.25
Vedmegatko: raises £1.75 to £2
sagiga87: raises £17.22 to £19.22 and is all-in
Vedmegatko: calls £17.22
*** TURN *** [2s 6c 7c] [5c]
*** RIVER *** [2s 6c 7c 5c] [9d]
*** SHOW DOWN ***
sagiga87: shows [Kc 7h] (a pair of Sevens)
Vedmegatko: shows [Ts Th] (a pair of Tens)
Vedmegatko collected £39.54 from pot
*** SUMMARY ***
Total pot £40.79 | Rake £1.25 
Board [2s 6c 7c 5c 9d]
Seat 1: k4rloos (small blind) folded before Flop
Seat 2: matiko09 (big blind) folded before Flop
Seat 3: namex11 folded before Flop (didn't bet)
Seat 4: sagiga87 showed [Kc 7h] and lost with a pair of Sevens
Seat 5: Vedmegatko (button) showed [Ts Th] and won (£39.54) with a pair of Tens





PokerStars Hand #148211317905:  Hold'em No Limit ($0.10/$0.25 USD) - 2016/02/04 11:42:58 CET [2016/02/04 5:42:58 ET]
Table 'Hungaria II' 6-max Seat #5 is the button
Seat 1: Jo_Medici ($25 in chips) 
Seat 2: MaurerXL82 ($26.55 in chips) 
Seat 3: MAO_DZEDYN_S ($25 in chips) 
Seat 4: matiko09 ($26.38 in chips) 
Seat 5: nnVinokurov ($29 in chips) 
Seat 6: droog2 ($36.41 in chips) 
droog2: posts small blind $0.10
Jo_Medici: posts big blind $0.25
*** HOLE CARDS ***
Dealt to matiko09 [As 7h]
MaurerXL82: calls $0.25
MAO_DZEDYN_S: folds 
matiko09: raises $0.75 to $1
nnVinokurov: folds 
droog2: folds 
Jo_Medici: folds 
MaurerXL82: calls $0.75
*** FLOP *** [5c Kc 3c]
MaurerXL82: bets $0.25
matiko09: folds 
Uncalled bet ($0.25) returned to MaurerXL82
MaurerXL82 collected $2.24 from pot
MaurerXL82: doesn't show hand 
*** SUMMARY ***
Total pot $2.35 | Rake $0.11 
Board [5c Kc 3c]
Seat 1: Jo_Medici (big blind) folded before Flop
Seat 2: MaurerXL82 collected ($2.24)
Seat 3: MAO_DZEDYN_S folded before Flop (didn't bet)
Seat 4: matiko09 folded on the Flop
Seat 5: nnVinokurov (button) folded before Flop (didn't bet)
Seat 6: droog2 (small blind) folded before Flop





PokerStars Hand #148211324696:  Hold'em No Limit (€0.10/€0.25 EUR) - 2016/02/04 11:43:11 CET [2016/02/04 5:43:11 ET]
Table 'Lilaea III' 6-max Seat #5 is the button
Seat 1: matiko09 (€25.35 in chips) 
Seat 2: Yegoriy (€25.25 in chips) 
Seat 4: Wwwasian (€34.38 in chips) 
Seat 5: marchuchok (€25.25 in chips) 
Seat 6: BaaroRai (€28.52 in chips) 
BaaroRai: posts small blind €0.10
matiko09: posts big blind €0.25
*** HOLE CARDS ***
Dealt to matiko09 [8h 8c]
Yegoriy: folds 
Wwwasian: folds 
marchuchok: folds 
BaaroRai: calls €0.15
matiko09: raises €0.75 to €1
BaaroRai: calls €0.75
*** FLOP *** [Td 5h Qc]
BaaroRai: bets €0.25
matiko09: calls €0.25
*** TURN *** [Td 5h Qc] [9d]
BaaroRai: bets €0.75
matiko09: folds 
Uncalled bet (€0.75) returned to BaaroRai
BaaroRai collected €2.39 from pot
BaaroRai: doesn't show hand 
*** SUMMARY ***
Total pot €2.50 | Rake €0.11 
Board [Td 5h Qc 9d]
Seat 1: matiko09 (big blind) folded on the Turn
Seat 2: Yegoriy folded before Flop (didn't bet)
Seat 4: Wwwasian folded before Flop (didn't bet)
Seat 5: marchuchok (button) folded before Flop (didn't bet)
Seat 6: BaaroRai (small blind) collected (€2.39)





PokerStars Hand #148211330801:  Hold'em No Limit (£0.10/£0.25 GBP) - 2016/02/04 11:43:23 CET [2016/02/04 5:43:23 ET]
Table 'Libra II' 6-max Seat #1 is the button
Seat 1: k4rloos (£25.25 in chips) 
Seat 2: matiko09 (£26.77 in chips) 
Seat 3: namex11 (£26.87 in chips) 
Seat 5: Vedmegatko (£44.75 in chips) 
matiko09: posts small blind £0.10
namex11: posts big blind £0.25
*** HOLE CARDS ***
Dealt to matiko09 [4c Ad]
Vedmegatko: folds 
k4rloos: folds 
matiko09: folds 
Uncalled bet (£0.15) returned to namex11
namex11 collected £0.20 from pot
namex11: doesn't show hand 
*** SUMMARY ***
Total pot £0.20 | Rake £0 
Seat 1: k4rloos (button) folded before Flop (didn't bet)
Seat 2: matiko09 (small blind) folded before Flop
Seat 3: namex11 (big blind) collected (£0.20)
Seat 5: Vedmegatko folded before Flop (didn't bet)





PokerStars Hand #148211334939:  Hold'em No Limit ($0.10/$0.25 USD) - 2016/02/04 11:43:31 CET [2016/02/04 5:43:31 ET]
Table 'Thora II' 6-max Seat #1 is the button
Seat 1: S1cker_0ne ($42.42 in chips) 
Seat 2: schatun774 ($11.16 in chips) 
Seat 4: matiko09 ($31.66 in chips) 
Seat 6: cost983 ($25.66 in chips) 
schatun774: posts small blind $0.10
matiko09: posts big blind $0.25
*** HOLE CARDS ***
Dealt to matiko09 [6d 5d]
cost983: folds 
S1cker_0ne: folds 
schatun774: calls $0.15
matiko09: checks 
*** FLOP *** [7s 3s 8c]
schatun774: checks 
matiko09: bets $0.31
schatun774: folds 
Uncalled bet ($0.31) returned to matiko09
matiko09 collected $0.48 from pot
matiko09: doesn't show hand 
*** SUMMARY ***
Total pot $0.50 | Rake $0.02 
Board [7s 3s 8c]
Seat 1: S1cker_0ne (button) folded before Flop (didn't bet)
Seat 2: schatun774 (small blind) folded on the Flop
Seat 4: matiko09 (big blind) collected ($0.48)
Seat 6: cost983 folded before Flop (didn't bet)





PokerStars Hand #148211338354:  Hold'em No Limit (£0.10/£0.25 GBP) - 2016/02/04 11:43:38 CET [2016/02/04 5:43:38 ET]
Table 'Libra II' 6-max Seat #2 is the button
Seat 1: k4rloos (£25.25 in chips) 
Seat 2: matiko09 (£26.67 in chips) 
Seat 3: namex11 (£26.97 in chips) 
Seat 4: sagiga87 (£25 in chips) 
Seat 5: Vedmegatko (£44.75 in chips) 
namex11: posts small blind £0.10
sagiga87: posts big blind £0.25
*** HOLE CARDS ***
Dealt to matiko09 [2s 4h]
Vedmegatko: raises £0.50 to £0.75
k4rloos: folds 
matiko09: folds 
namex11: folds 
sagiga87: folds 
Uncalled bet (£0.50) returned to Vedmegatko
Vedmegatko collected £0.60 from pot
Vedmegatko: doesn't show hand 
*** SUMMARY ***
Total pot £0.60 | Rake £0 
Seat 1: k4rloos folded before Flop (didn't bet)
Seat 2: matiko09 (button) folded before Flop (didn't bet)
Seat 3: namex11 (small blind) folded before Flop
Seat 4: sagiga87 (big blind) folded before Flop
Seat 5: Vedmegatko collected (£0.60)





PokerStars Hand #148211343924:  Hold'em No Limit (€0.10/€0.25 EUR) - 2016/02/04 11:43:49 CET [2016/02/04 5:43:49 ET]
Table 'Lilaea III' 6-max Seat #6 is the button
Seat 1: matiko09 (€25 in chips) 
Seat 2: Yegoriy (€25.25 in chips) 
Seat 4: Wwwasian (€34.38 in chips) 
Seat 5: marchuchok (€25.25 in chips) 
Seat 6: BaaroRai (€29.66 in chips) 
matiko09: posts small blind €0.10
Yegoriy: posts big blind €0.25
uzzy20: sits out 
*** HOLE CARDS ***
Dealt to matiko09 [Jd 2h]
Wwwasian: folds 
marchuchok: folds 
BaaroRai: folds 
matiko09: folds 
Uncalled bet (€0.15) returned to Yegoriy
Yegoriy collected €0.20 from pot
*** SUMMARY ***
Total pot €0.20 | Rake €0 
Seat 1: matiko09 (small blind) folded before Flop
Seat 2: Yegoriy (big blind) collected (€0.20)
Seat 4: Wwwasian folded before Flop (didn't bet)
Seat 5: marchuchok folded before Flop (didn't bet)
Seat 6: BaaroRai (button) folded before Flop (didn't bet)





PokerStars Hand #148211346557:  Hold'em No Limit ($0.10/$0.25 USD) - 2016/02/04 11:43:54 CET [2016/02/04 5:43:54 ET]
Table 'Hungaria II' 6-max Seat #6 is the button
Seat 1: Jo_Medici ($25 in chips) 
Seat 2: MaurerXL82 ($27.79 in chips) 
Seat 3: MAO_DZEDYN_S ($25 in chips) 
Seat 4: matiko09 ($25.38 in chips) 
Seat 5: nnVinokurov ($29 in chips) 
Seat 6: droog2 ($36.31 in chips) 
Jo_Medici: posts small blind $0.10
MaurerXL82: posts big blind $0.25
*** HOLE CARDS ***
Dealt to matiko09 [5d 3d]
MAO_DZEDYN_S: folds 
matiko09: folds 
nnVinokurov: folds 
droog2: folds 
Jo_Medici: raises $0.35 to $0.60
MaurerXL82: calls $0.35
*** FLOP *** [7h Kc Ks]
Jo_Medici: checks 
MaurerXL82: bets $0.25
Jo_Medici: folds 
Uncalled bet ($0.25) returned to MaurerXL82
MaurerXL82 collected $1.15 from pot
MaurerXL82: doesn't show hand 
*** SUMMARY ***
Total pot $1.20 | Rake $0.05 
Board [7h Kc Ks]
Seat 1: Jo_Medici (small blind) folded on the Flop
Seat 2: MaurerXL82 (big blind) collected ($1.15)
Seat 3: MAO_DZEDYN_S folded before Flop (didn't bet)
Seat 4: matiko09 folded before Flop (didn't bet)
Seat 5: nnVinokurov folded before Flop (didn't bet)
Seat 6: droog2 (button) folded before Flop (didn't bet)





PokerStars Hand #148211346519:  Hold'em No Limit ($0.10/$0.25 USD) - 2016/02/04 11:43:54 CET [2016/02/04 5:43:54 ET]
Table 'Thora II' 6-max Seat #2 is the button
Seat 1: S1cker_0ne ($42.42 in chips) 
Seat 2: schatun774 ($10.91 in chips) 
Seat 4: matiko09 ($31.89 in chips) 
Seat 6: cost983 ($25.66 in chips) 
matiko09: posts small blind $0.10
PotgrabberAA was removed from the table for failing to post
cost983: posts big blind $0.25
*** HOLE CARDS ***
Dealt to matiko09 [7h Jh]
PoMa3aH joins the table at seat #5 
S1cker_0ne: raises $0.39 to $0.64
schatun774: folds 
matiko09: folds 
cost983: folds 
Uncalled bet ($0.39) returned to S1cker_0ne
S1cker_0ne collected $0.60 from pot
S1cker_0ne: doesn't show hand 
*** SUMMARY ***
Total pot $0.60 | Rake $0 
Seat 1: S1cker_0ne collected ($0.60)
Seat 2: schatun774 (button) folded before Flop (didn't bet)
Seat 4: matiko09 (small blind) folded before Flop
Seat 6: cost983 (big blind) folded before Flop





PokerStars Hand #148211346945:  Hold'em No Limit (£0.10/£0.25 GBP) - 2016/02/04 11:43:55 CET [2016/02/04 5:43:55 ET]
Table 'Libra II' 6-max Seat #3 is the button
Seat 1: k4rloos (£25.25 in chips) 
Seat 2: matiko09 (£26.67 in chips) 
Seat 3: namex11 (£26.87 in chips) 
Seat 4: sagiga87 (£24.75 in chips) 
Seat 5: Vedmegatko (£45.10 in chips) 
sagiga87: posts small blind £0.10
Vedmegatko: posts big blind £0.25
*** HOLE CARDS ***
Dealt to matiko09 [Qc Ks]
k4rloos: folds 
matiko09: raises £0.50 to £0.75
namex11: folds 
sagiga87: folds 
Vedmegatko: folds 
Uncalled bet (£0.50) returned to matiko09
matiko09 collected £0.60 from pot
matiko09: doesn't show hand 
*** SUMMARY ***
Total pot £0.60 | Rake £0 
Seat 1: k4rloos folded before Flop (didn't bet)
Seat 2: matiko09 collected (£0.60)
Seat 3: namex11 (button) folded before Flop (didn't bet)
Seat 4: sagiga87 (small blind) folded before Flop
Seat 5: Vedmegatko (big blind) folded before Flop





PokerStars Hand #148211353091:  Hold'em No Limit (€0.10/€0.25 EUR) - 2016/02/04 11:44:07 CET [2016/02/04 5:44:07 ET]
Table 'Lilaea III' 6-max Seat #1 is the button
Seat 1: matiko09 (€25 in chips) 
Seat 2: Yegoriy (€25.35 in chips) 
Seat 3: uzzy20 (€36.81 in chips) 
Seat 4: Wwwasian (€34.38 in chips) 
Seat 5: marchuchok (€25.25 in chips) 
Seat 6: BaaroRai (€29.66 in chips) 
Yegoriy: posts small blind €0.10
uzzy20: posts big blind €0.25
*** HOLE CARDS ***
Dealt to matiko09 [9d Td]
Wwwasian: folds 
marchuchok: folds 
BaaroRai: folds 
matiko09: raises €0.37 to €0.62
Yegoriy: folds 
uzzy20: folds 
Uncalled bet (€0.37) returned to matiko09
matiko09 collected €0.60 from pot
matiko09: doesn't show hand 
*** SUMMARY ***
Total pot €0.60 | Rake €0 
Seat 1: matiko09 (button) collected (€0.60)
Seat 2: Yegoriy (small blind) folded before Flop
Seat 3: uzzy20 (big blind) folded before Flop
Seat 4: Wwwasian folded before Flop (didn't bet)
Seat 5: marchuchok folded before Flop (didn't bet)
Seat 6: BaaroRai folded before Flop (didn't bet)





PokerStars Hand #148211352904:  Hold'em No Limit (£0.10/£0.25 GBP) - 2016/02/04 11:44:07 CET [2016/02/04 5:44:07 ET]
Table 'Libra II' 6-max Seat #4 is the button
Seat 1: k4rloos (£25.25 in chips) 
Seat 2: matiko09 (£27.02 in chips) 
Seat 3: namex11 (£26.87 in chips) 
Seat 4: sagiga87 (£24.65 in chips) 
Seat 5: Vedmegatko (£44.85 in chips) 
Vedmegatko: posts small blind £0.10
k4rloos: posts big blind £0.25
*** HOLE CARDS ***
Dealt to matiko09 [9s 4h]
matiko09: folds 
namex11: folds 
sagiga87: calls £0.25
Vedmegatko: folds 
k4rloos: checks 
*** FLOP *** [3d Js Qd]
k4rloos: checks 
sagiga87: bets £0.50
k4rloos: folds 
Uncalled bet (£0.50) returned to sagiga87
sagiga87 collected £0.57 from pot
sagiga87: doesn't show hand 
*** SUMMARY ***
Total pot £0.60 | Rake £0.03 
Board [3d Js Qd]
Seat 1: k4rloos (big blind) folded on the Flop
Seat 2: matiko09 folded before Flop (didn't bet)
Seat 3: namex11 folded before Flop (didn't bet)
Seat 4: sagiga87 (button) collected (£0.57)
Seat 5: Vedmegatko (small blind) folded before Flop





PokerStars Hand #148211353257:  Hold'em No Limit ($0.10/$0.25 USD) - 2016/02/04 11:44:08 CET [2016/02/04 5:44:08 ET]
Table 'Thora II' 6-max Seat #4 is the button
Seat 1: S1cker_0ne ($42.77 in chips) 
Seat 2: schatun774 ($10.91 in chips) 
Seat 4: matiko09 ($31.79 in chips) 
Seat 6: cost983 ($25.41 in chips) 
PoMa3aH will be allowed to play after the button
cost983: posts small blind $0.10
S1cker_0ne: posts big blind $0.25
*** HOLE CARDS ***
Dealt to matiko09 [9d 7h]
schatun774: folds 
matiko09: folds 
cost983: folds 
Uncalled bet ($0.15) returned to S1cker_0ne
S1cker_0ne collected $0.20 from pot
S1cker_0ne: doesn't show hand 
*** SUMMARY ***
Total pot $0.20 | Rake $0 
Seat 1: S1cker_0ne (big blind) collected ($0.20)
Seat 2: schatun774 folded before Flop (didn't bet)
Seat 4: matiko09 (button) folded before Flop (didn't bet)
Seat 6: cost983 (small blind) folded before Flop





PokerStars Hand #148211357627:  Hold'em No Limit ($0.10/$0.25 USD) - 2016/02/04 11:44:17 CET [2016/02/04 5:44:17 ET]
Table 'Thora II' 6-max Seat #6 is the button
Seat 1: S1cker_0ne ($42.87 in chips) 
Seat 2: schatun774 ($10.91 in chips) 
Seat 4: matiko09 ($31.79 in chips) 
Seat 6: cost983 ($25.31 in chips) 
S1cker_0ne: posts small blind $0.10
schatun774: posts big blind $0.25
PoMa3aH: sits out 
*** HOLE CARDS ***
Dealt to matiko09 [7h 6d]
matiko09: folds 
cost983: folds 
S1cker_0ne: folds 
Uncalled bet ($0.15) returned to schatun774
schatun774 collected $0.20 from pot
schatun774: doesn't show hand 
*** SUMMARY ***
Total pot $0.20 | Rake $0 
Seat 1: S1cker_0ne (small blind) folded before Flop
Seat 2: schatun774 (big blind) collected ($0.20)
Seat 4: matiko09 folded before Flop (didn't bet)
Seat 6: cost983 (button) folded before Flop (didn't bet)





PokerStars Hand #148211362863:  Hold'em No Limit (€0.10/€0.25 EUR) - 2016/02/04 11:44:27 CET [2016/02/04 5:44:27 ET]
Table 'Lilaea III' 6-max Seat #2 is the button
Seat 1: matiko09 (€25.35 in chips) 
Seat 2: Yegoriy (€25.25 in chips) 
Seat 3: uzzy20 (€36.56 in chips) 
Seat 4: Wwwasian (€34.38 in chips) 
Seat 5: marchuchok (€25.25 in chips) 
Seat 6: BaaroRai (€29.66 in chips) 
uzzy20: posts small blind €0.10
Wwwasian: posts big blind €0.25
*** HOLE CARDS ***
Dealt to matiko09 [Jc 7d]
marchuchok: raises €0.50 to €0.75
BaaroRai: calls €0.75
matiko09: folds 
Yegoriy: folds 
uzzy20: folds 
Wwwasian: folds 
*** FLOP *** [2s 6h 8d]
marchuchok: checks 
BaaroRai: bets €0.25
marchuchok: calls €0.25
*** TURN *** [2s 6h 8d] [9h]
marchuchok: bets €0.25
BaaroRai: calls €0.25
*** RIVER *** [2s 6h 8d 9h] [4c]
marchuchok: checks 
BaaroRai: checks 
*** SHOW DOWN ***
marchuchok: shows [Tc Kc] (high card King)
BaaroRai: shows [7s As] (high card Ace)
BaaroRai collected €2.72 from pot
*** SUMMARY ***
Total pot €2.85 | Rake €0.13 
Board [2s 6h 8d 9h 4c]
Seat 1: matiko09 folded before Flop (didn't bet)
Seat 2: Yegoriy (button) folded before Flop (didn't bet)
Seat 3: uzzy20 (small blind) folded before Flop
Seat 4: Wwwasian (big blind) folded before Flop
Seat 5: marchuchok showed [Tc Kc] and lost with high card King
Seat 6: BaaroRai showed [7s As] and won (€2.72) with high card Ace





PokerStars Hand #148211366200:  Hold'em No Limit ($0.10/$0.25 USD) - 2016/02/04 11:44:34 CET [2016/02/04 5:44:34 ET]
Table 'Thora II' 6-max Seat #1 is the button
Seat 1: S1cker_0ne ($42.77 in chips) 
Seat 2: schatun774 ($11.01 in chips) 
Seat 4: matiko09 ($31.79 in chips) 
Seat 6: cost983 ($25.31 in chips) 
schatun774: posts small blind $0.10
matiko09: posts big blind $0.25
PoMa3aH: sits out 
*** HOLE CARDS ***
Dealt to matiko09 [Ac Ah]
cost983: folds 
S1cker_0ne: raises $0.27 to $0.52
schatun774: folds 
matiko09: raises $1.48 to $2
S1cker_0ne: folds 
Uncalled bet ($1.48) returned to matiko09
matiko09 collected $1.14 from pot
matiko09: doesn't show hand 
*** SUMMARY ***
Total pot $1.14 | Rake $0 
Seat 1: S1cker_0ne (button) folded before Flop
Seat 2: schatun774 (small blind) folded before Flop
Seat 4: matiko09 (big blind) collected ($1.14)
Seat 6: cost983 folded before Flop (didn't bet)





PokerStars Hand #148211369801:  Hold'em No Limit (£0.10/£0.25 GBP) - 2016/02/04 11:44:41 CET [2016/02/04 5:44:41 ET]
Table 'Libra II' 6-max Seat #5 is the button
Seat 1: k4rloos (£25 in chips) 
Seat 2: matiko09 (£27.02 in chips) 
Seat 3: namex11 (£26.87 in chips) 
Seat 4: sagiga87 (£24.97 in chips) 
Seat 5: Vedmegatko (£44.75 in chips) 
k4rloos: posts small blind £0.10
matiko09: posts big blind £0.25
*** HOLE CARDS ***
Dealt to matiko09 [Jc Td]
namex11: folds 
sagiga87: raises £0.25 to £0.50
Vedmegatko: folds 
k4rloos: folds 
matiko09: folds 
Uncalled bet (£0.25) returned to sagiga87
sagiga87 collected £0.60 from pot
sagiga87: doesn't show hand 
*** SUMMARY ***
Total pot £0.60 | Rake £0 
Seat 1: k4rloos (small blind) folded before Flop
Seat 2: matiko09 (big blind) folded before Flop
Seat 3: namex11 folded before Flop (didn't bet)
Seat 4: sagiga87 collected (£0.60)
Seat 5: Vedmegatko (button) folded before Flop (didn't bet)





PokerStars Hand #148211370840:  Hold'em No Limit ($0.10/$0.25 USD) - 2016/02/04 11:44:43 CET [2016/02/04 5:44:43 ET]
Table 'Hungaria II' 6-max Seat #1 is the button
Seat 1: Jo_Medici ($25 in chips) 
Seat 2: MaurerXL82 ($28.34 in chips) 
Seat 3: MAO_DZEDYN_S ($25 in chips) 
Seat 4: matiko09 ($25.38 in chips) 
Seat 5: nnVinokurov ($29 in chips) 
Seat 6: droog2 ($36.31 in chips) 
MaurerXL82: posts small blind $0.10
MAO_DZEDYN_S: posts big blind $0.25
*** HOLE CARDS ***
Dealt to matiko09 [3s 7c]
matiko09: folds 
nnVinokurov: folds 
droog2: raises $0.50 to $0.75
Jo_Medici: folds 
MaurerXL82: calls $0.65
MAO_DZEDYN_S: folds 
*** FLOP *** [Ac Jc 3c]
MaurerXL82: checks 
droog2: checks 
*** TURN *** [Ac Jc 3c] [3h]
MaurerXL82: checks 
droog2: bets $1.16
MaurerXL82: folds 
Uncalled bet ($1.16) returned to droog2
droog2 collected $1.67 from pot
droog2: doesn't show hand 
*** SUMMARY ***
Total pot $1.75 | Rake $0.08 
Board [Ac Jc 3c 3h]
Seat 1: Jo_Medici (button) folded before Flop (didn't bet)
Seat 2: MaurerXL82 (small blind) folded on the Turn
Seat 3: MAO_DZEDYN_S (big blind) folded before Flop
Seat 4: matiko09 folded before Flop (didn't bet)
Seat 5: nnVinokurov folded before Flop (didn't bet)
Seat 6: droog2 collected ($1.67)





PokerStars Hand #148211377737:  Hold'em No Limit ($0.10/$0.25 USD) - 2016/02/04 11:44:57 CET [2016/02/04 5:44:57 ET]
Table 'Thora II' 6-max Seat #2 is the button
Seat 1: S1cker_0ne ($42.25 in chips) 
Seat 2: schatun774 ($10.91 in chips) 
Seat 4: matiko09 ($32.41 in chips) 
Seat 5: PoMa3aH ($25 in chips) 
Seat 6: cost983 ($25.31 in chips) 
matiko09: posts small blind $0.10
PoMa3aH: posts big blind $0.25
*** HOLE CARDS ***
Dealt to matiko09 [Th 6d]
cost983: folds 
S1cker_0ne: raises $0.39 to $0.64
schatun774: folds 
matiko09: folds 
PoMa3aH: calls $0.39
*** FLOP *** [9h 5h 3d]
PoMa3aH: checks 
S1cker_0ne: checks 
*** TURN *** [9h 5h 3d] [9s]
PoMa3aH: bets $0.99
S1cker_0ne: calls $0.99
*** RIVER *** [9h 5h 3d 9s] [6s]
PoMa3aH: checks 
S1cker_0ne: checks 
*** SHOW DOWN ***
PoMa3aH: shows [4c 4h] (two pair, Nines and Fours)
S1cker_0ne: mucks hand 
PoMa3aH collected $3.21 from pot
*** SUMMARY ***
Total pot $3.36 | Rake $0.15 
Board [9h 5h 3d 9s 6s]
Seat 1: S1cker_0ne mucked [Qc As]
Seat 2: schatun774 (button) folded before Flop (didn't bet)
Seat 4: matiko09 (small blind) folded before Flop
Seat 5: PoMa3aH (big blind) showed [4c 4h] and won ($3.21) with two pair, Nines and Fours
Seat 6: cost983 folded before Flop (didn't bet)





PokerStars Hand #148211381026:  Hold'em No Limit (£0.10/£0.25 GBP) - 2016/02/04 11:45:03 CET [2016/02/04 5:45:03 ET]
Table 'Libra II' 6-max Seat #1 is the button
Seat 1: k4rloos (£25 in chips) 
Seat 2: matiko09 (£26.77 in chips) 
Seat 3: namex11 (£26.87 in chips) 
Seat 4: sagiga87 (£25.32 in chips) 
Seat 5: Vedmegatko (£44.75 in chips) 
matiko09: posts small blind £0.10
namex11: posts big blind £0.25
*** HOLE CARDS ***
Dealt to matiko09 [8d 4d]
sagiga87: folds 
Vedmegatko: folds 
k4rloos: raises £0.50 to £0.75
matiko09: folds 
namex11: folds 
Uncalled bet (£0.50) returned to k4rloos
k4rloos collected £0.60 from pot
k4rloos: doesn't show hand 
*** SUMMARY ***
Total pot £0.60 | Rake £0 
Seat 1: k4rloos (button) collected (£0.60)
Seat 2: matiko09 (small blind) folded before Flop
Seat 3: namex11 (big blind) folded before Flop
Seat 4: sagiga87 folded before Flop (didn't bet)
Seat 5: Vedmegatko folded before Flop (didn't bet)





PokerStars Hand #148211393459:  Hold'em No Limit (£0.10/£0.25 GBP) - 2016/02/04 11:45:28 CET [2016/02/04 5:45:28 ET]
Table 'Libra II' 6-max Seat #2 is the button
Seat 1: k4rloos (£25.35 in chips) 
Seat 2: matiko09 (£26.67 in chips) 
Seat 3: namex11 (£26.62 in chips) 
Seat 4: sagiga87 (£25.32 in chips) 
Seat 5: Vedmegatko (£44.75 in chips) 
namex11: posts small blind £0.10
sagiga87: posts big blind £0.25
*** HOLE CARDS ***
Dealt to matiko09 [Jd 2d]
Vedmegatko: folds 
k4rloos: folds 
matiko09: folds 
namex11: raises £0.50 to £0.75
sagiga87: raises £0.50 to £1.25
namex11: calls £0.50
*** FLOP *** [2c As 3c]
namex11: checks 
sagiga87: bets £1.25
namex11: calls £1.25
*** TURN *** [2c As 3c] [2h]
namex11: checks 
sagiga87: bets £22.82 and is all-in
namex11: folds 
Uncalled bet (£22.82) returned to sagiga87
sagiga87 collected £4.78 from pot
sagiga87: doesn't show hand 
*** SUMMARY ***
Total pot £5 | Rake £0.22 
Board [2c As 3c 2h]
Seat 1: k4rloos folded before Flop (didn't bet)
Seat 2: matiko09 (button) folded before Flop (didn't bet)
Seat 3: namex11 (small blind) folded on the Turn
Seat 4: sagiga87 (big blind) collected (£4.78)
Seat 5: Vedmegatko folded before Flop (didn't bet)





PokerStars Hand #148211394647:  Hold'em No Limit (€0.10/€0.25 EUR) - 2016/02/04 11:45:30 CET [2016/02/04 5:45:30 ET]
Table 'Lilaea III' 6-max Seat #3 is the button
Seat 1: matiko09 (€25.35 in chips) 
Seat 2: Yegoriy (€25.25 in chips) 
Seat 3: uzzy20 (€36.46 in chips) 
Seat 4: Wwwasian (€34.13 in chips) 
Seat 5: marchuchok (€25 in chips) 
Seat 6: BaaroRai (€31.13 in chips) 
Wwwasian: posts small blind €0.10
marchuchok: posts big blind €0.25
*** HOLE CARDS ***
Dealt to matiko09 [Qh As]
BaaroRai: calls €0.25
matiko09: raises €0.75 to €1
Yegoriy: folds 
uzzy20: folds 
Wwwasian: folds 
marchuchok: folds 
BaaroRai: calls €0.75
*** FLOP *** [4h 7d Js]
BaaroRai: checks 
matiko09: bets €1.25
BaaroRai: folds 
Uncalled bet (€1.25) returned to matiko09
matiko09 collected €2.24 from pot
matiko09: doesn't show hand 
*** SUMMARY ***
Total pot €2.35 | Rake €0.11 
Board [4h 7d Js]
Seat 1: matiko09 collected (€2.24)
Seat 2: Yegoriy folded before Flop (didn't bet)
Seat 3: uzzy20 (button) folded before Flop (didn't bet)
Seat 4: Wwwasian (small blind) folded before Flop
Seat 5: marchuchok (big blind) folded before Flop
Seat 6: BaaroRai folded on the Flop





PokerStars Hand #148211399450:  Hold'em No Limit ($0.10/$0.25 USD) - 2016/02/04 11:45:40 CET [2016/02/04 5:45:40 ET]
Table 'Hungaria II' 6-max Seat #2 is the button
Seat 1: Jo_Medici ($25 in chips) 
Seat 2: MaurerXL82 ($27.59 in chips) 
Seat 3: MAO_DZEDYN_S ($25 in chips) 
Seat 4: matiko09 ($25.38 in chips) 
Seat 5: nnVinokurov ($29 in chips) 
Seat 6: droog2 ($37.23 in chips) 
MAO_DZEDYN_S: posts small blind $0.10
matiko09: posts big blind $0.25
*** HOLE CARDS ***
Dealt to matiko09 [3s 8c]
nnVinokurov: folds 
droog2: folds 
Jo_Medici: folds 
MaurerXL82: calls $0.25
MAO_DZEDYN_S: folds 
matiko09: checks 
*** FLOP *** [9h 5d 8d]
matiko09: checks 
MaurerXL82: checks 
*** TURN *** [9h 5d 8d] [3d]
matiko09: bets $0.75
MaurerXL82: calls $0.75
*** RIVER *** [9h 5d 8d 3d] [Qs]
matiko09: bets $1.50
MaurerXL82: folds 
Uncalled bet ($1.50) returned to matiko09
matiko09 collected $2.01 from pot
matiko09: doesn't show hand 
*** SUMMARY ***
Total pot $2.10 | Rake $0.09 
Board [9h 5d 8d 3d Qs]
Seat 1: Jo_Medici folded before Flop (didn't bet)
Seat 2: MaurerXL82 (button) folded on the River
Seat 3: MAO_DZEDYN_S (small blind) folded before Flop
Seat 4: matiko09 (big blind) collected ($2.01)
Seat 5: nnVinokurov folded before Flop (didn't bet)
Seat 6: droog2 folded before Flop (didn't bet)





PokerStars Hand #148211401016:  Hold'em No Limit ($0.10/$0.25 USD) - 2016/02/04 11:45:43 CET [2016/02/04 5:45:43 ET]
Table 'Thora II' 6-max Seat #4 is the button
Seat 1: S1cker_0ne ($40.62 in chips) 
Seat 2: schatun774 ($10.91 in chips) 
Seat 4: matiko09 ($32.31 in chips) 
Seat 5: PoMa3aH ($26.58 in chips) 
Seat 6: cost983 ($25.31 in chips) 
PoMa3aH: posts small blind $0.10
cost983: posts big blind $0.25
*** HOLE CARDS ***
Dealt to matiko09 [5s 5d]
S1cker_0ne: folds 
schatun774: calls $0.25
matiko09: raises $0.50 to $0.75
PoMa3aH: folds 
cost983: calls $0.50
schatun774: calls $0.50
*** FLOP *** [8s Kc 4s]
cost983: checks 
schatun774: bets $0.25
matiko09: calls $0.25
cost983: calls $0.25
*** TURN *** [8s Kc 4s] [Ah]
cost983: checks 
schatun774: bets $0.25
matiko09: folds 
cost983: folds 
Uncalled bet ($0.25) returned to schatun774
schatun774 collected $2.96 from pot
schatun774: doesn't show hand 
*** SUMMARY ***
Total pot $3.10 | Rake $0.14 
Board [8s Kc 4s Ah]
Seat 1: S1cker_0ne folded before Flop (didn't bet)
Seat 2: schatun774 collected ($2.96)
Seat 4: matiko09 (button) folded on the Turn
Seat 5: PoMa3aH (small blind) folded before Flop
Seat 6: cost983 (big blind) folded on the Turn





PokerStars Hand #148211409971:  Hold'em No Limit (€0.10/€0.25 EUR) - 2016/02/04 11:46:00 CET [2016/02/04 5:46:00 ET]
Table 'Lilaea III' 6-max Seat #4 is the button
Seat 1: matiko09 (€26.59 in chips) 
Seat 2: Yegoriy (€25.25 in chips) 
Seat 3: uzzy20 (€36.46 in chips) 
Seat 4: Wwwasian (€34.03 in chips) 
Seat 5: marchuchok (€25 in chips) 
Seat 6: BaaroRai (€30.13 in chips) 
marchuchok: posts small blind €0.10
BaaroRai: posts big blind €0.25
*** HOLE CARDS ***
Dealt to matiko09 [Qd 4c]
matiko09: folds 
Yegoriy: folds 
uzzy20: raises €0.31 to €0.56
Wwwasian: folds 
marchuchok: folds 
BaaroRai: calls €0.31
*** FLOP *** [Td 7c Jh]
BaaroRai: checks 
uzzy20: bets €0.77
BaaroRai: calls €0.77
*** TURN *** [Td 7c Jh] [Kd]
BaaroRai: checks 
uzzy20: bets €1.29
BaaroRai: calls €1.29
*** RIVER *** [Td 7c Jh Kd] [8h]
BaaroRai: bets €0.75
uzzy20: calls €0.75
*** SHOW DOWN ***
BaaroRai: shows [Jd Kc] (two pair, Kings and Jacks)
uzzy20: mucks hand 
BaaroRai collected €6.53 from pot
*** SUMMARY ***
Total pot €6.84 | Rake €0.31 
Board [Td 7c Jh Kd 8h]
Seat 1: matiko09 folded before Flop (didn't bet)
Seat 2: Yegoriy folded before Flop (didn't bet)
Seat 3: uzzy20 mucked [Qc Qs]
Seat 4: Wwwasian (button) folded before Flop (didn't bet)
Seat 5: marchuchok (small blind) folded before Flop
Seat 6: BaaroRai (big blind) showed [Jd Kc] and won (€6.53) with two pair, Kings and Jacks





PokerStars Hand #148211415372:  Hold'em No Limit (£0.10/£0.25 GBP) - 2016/02/04 11:46:11 CET [2016/02/04 5:46:11 ET]
Table 'Libra II' 6-max Seat #3 is the button
Seat 1: k4rloos (£25.35 in chips) 
Seat 2: matiko09 (£26.67 in chips) 
Seat 3: namex11 (£25 in chips) 
Seat 4: sagiga87 (£27.60 in chips) 
Seat 5: Vedmegatko (£44.75 in chips) 
sagiga87: posts small blind £0.10
Vedmegatko: posts big blind £0.25
*** HOLE CARDS ***
Dealt to matiko09 [Ts 9c]
k4rloos: folds 
matiko09: folds 
namex11: raises £0.25 to £0.50
sagiga87: folds 
Vedmegatko: folds 
Uncalled bet (£0.25) returned to namex11
namex11 collected £0.60 from pot
namex11: doesn't show hand 
*** SUMMARY ***
Total pot £0.60 | Rake £0 
Seat 1: k4rloos folded before Flop (didn't bet)
Seat 2: matiko09 folded before Flop (didn't bet)
Seat 3: namex11 (button) collected (£0.60)
Seat 4: sagiga87 (small blind) folded before Flop
Seat 5: Vedmegatko (big blind) folded before Flop





PokerStars Hand #148211419000:  Hold'em No Limit ($0.10/$0.25 USD) - 2016/02/04 11:46:18 CET [2016/02/04 5:46:18 ET]
Table 'Hungaria II' 6-max Seat #3 is the button
Seat 1: Jo_Medici ($25 in chips) 
Seat 2: MaurerXL82 ($26.59 in chips) 
Seat 3: MAO_DZEDYN_S ($25 in chips) 
Seat 4: matiko09 ($26.39 in chips) 
Seat 6: droog2 ($37.23 in chips) 
matiko09: posts small blind $0.10
nnVinokurov: is sitting out 
droog2: posts big blind $0.25
*** HOLE CARDS ***
Dealt to matiko09 [8h 6d]
Jo_Medici: folds 
MaurerXL82: folds 
MAO_DZEDYN_S: folds 
matiko09: folds 
Uncalled bet ($0.15) returned to droog2
droog2 collected $0.20 from pot
droog2: doesn't show hand 
*** SUMMARY ***
Total pot $0.20 | Rake $0 
Seat 1: Jo_Medici folded before Flop (didn't bet)
Seat 2: MaurerXL82 folded before Flop (didn't bet)
Seat 3: MAO_DZEDYN_S (button) folded before Flop (didn't bet)
Seat 4: matiko09 (small blind) folded before Flop
Seat 6: droog2 (big blind) collected ($0.20)





PokerStars Hand #148211426436:  Hold'em No Limit ($0.10/$0.25 USD) - 2016/02/04 11:46:33 CET [2016/02/04 5:46:33 ET]
Table 'Thora II' 6-max Seat #5 is the button
Seat 1: S1cker_0ne ($40.62 in chips) 
Seat 2: schatun774 ($12.87 in chips) 
Seat 4: matiko09 ($31.31 in chips) 
Seat 5: PoMa3aH ($26.48 in chips) 
Seat 6: cost983 ($25 in chips) 
cost983: posts small blind $0.10
S1cker_0ne: posts big blind $0.25
Odmincheg: sits out 
*** HOLE CARDS ***
Dealt to matiko09 [9d 4s]
schatun774: calls $0.25
matiko09: folds 
PoMa3aH: raises $0.75 to $1
cost983: folds 
S1cker_0ne: folds 
schatun774: folds 
Uncalled bet ($0.75) returned to PoMa3aH
PoMa3aH collected $0.85 from pot
PoMa3aH: doesn't show hand 
*** SUMMARY ***
Total pot $0.85 | Rake $0 
Seat 1: S1cker_0ne (big blind) folded before Flop
Seat 2: schatun774 folded before Flop
Seat 4: matiko09 folded before Flop (didn't bet)
Seat 5: PoMa3aH (button) collected ($0.85)
Seat 6: cost983 (small blind) folded before Flop





PokerStars Hand #148211428140:  Hold'em No Limit ($0.10/$0.25 USD) - 2016/02/04 11:46:36 CET [2016/02/04 5:46:36 ET]
Table 'Hungaria II' 6-max Seat #4 is the button
Seat 1: Jo_Medici ($25 in chips) 
Seat 2: MaurerXL82 ($26.59 in chips) 
Seat 3: MAO_DZEDYN_S ($25 in chips) 
Seat 4: matiko09 ($26.29 in chips) 
Seat 6: droog2 ($37.33 in chips) 
droog2: posts small blind $0.10
Jo_Medici: posts big blind $0.25
*** HOLE CARDS ***
Dealt to matiko09 [9h 8d]
MaurerXL82: folds 
MAO_DZEDYN_S: folds 
matiko09: folds 
droog2: folds 
Uncalled bet ($0.15) returned to Jo_Medici
Jo_Medici collected $0.20 from pot
Jo_Medici: doesn't show hand 
*** SUMMARY ***
Total pot $0.20 | Rake $0 
Seat 1: Jo_Medici (big blind) collected ($0.20)
Seat 2: MaurerXL82 folded before Flop (didn't bet)
Seat 3: MAO_DZEDYN_S folded before Flop (didn't bet)
Seat 4: matiko09 (button) folded before Flop (didn't bet)
Seat 6: droog2 (small blind) folded before Flop





PokerStars Hand #148211429217:  Hold'em No Limit (£0.10/£0.25 GBP) - 2016/02/04 11:46:38 CET [2016/02/04 5:46:38 ET]
Table 'Libra II' 6-max Seat #4 is the button
Seat 1: k4rloos (£25.35 in chips) 
Seat 2: matiko09 (£26.67 in chips) 
Seat 3: namex11 (£25.35 in chips) 
Seat 4: sagiga87 (£27.50 in chips) 
Seat 5: Vedmegatko (£44.50 in chips) 
Vedmegatko: posts small blind £0.10
k4rloos: posts big blind £0.25
*** HOLE CARDS ***
Dealt to matiko09 [2h 8s]
matiko09: folds 
namex11: raises £0.37 to £0.62
sagiga87: calls £0.62
Vedmegatko: folds 
k4rloos: folds 
*** FLOP *** [4c 9c 9d]
namex11: checks 
sagiga87: bets £0.50
namex11: calls £0.50
*** TURN *** [4c 9c 9d] [Qd]
namex11: checks 
sagiga87: checks 
*** RIVER *** [4c 9c 9d Qd] [Ah]
namex11: checks 
sagiga87: checks 
*** SHOW DOWN ***
namex11: shows [Kd Jc] (a pair of Nines)
sagiga87: shows [2c 2s] (two pair, Nines and Deuces)
sagiga87 collected £2.47 from pot
*** SUMMARY ***
Total pot £2.59 | Rake £0.12 
Board [4c 9c 9d Qd Ah]
Seat 1: k4rloos (big blind) folded before Flop
Seat 2: matiko09 folded before Flop (didn't bet)
Seat 3: namex11 showed [Kd Jc] and lost with a pair of Nines
Seat 4: sagiga87 (button) showed [2c 2s] and won (£2.47) with two pair, Nines and Deuces
Seat 5: Vedmegatko (small blind) folded before Flop





PokerStars Hand #148211433278:  Hold'em No Limit ($0.10/$0.25 USD) - 2016/02/04 11:46:46 CET [2016/02/04 5:46:46 ET]
Table 'Hungaria II' 6-max Seat #6 is the button
Seat 1: Jo_Medici ($25.10 in chips) 
Seat 2: MaurerXL82 ($26.59 in chips) 
Seat 3: MAO_DZEDYN_S ($25 in chips) 
Seat 4: matiko09 ($26.29 in chips) 
Seat 6: droog2 ($37.23 in chips) 
Jo_Medici: posts small blind $0.10
MaurerXL82: posts big blind $0.25
*** HOLE CARDS ***
Dealt to matiko09 [Qc Qh]
MAO_DZEDYN_S: folds 
matiko09: raises $0.50 to $0.75
droog2: folds 
Jo_Medici: folds 
MaurerXL82: folds 
Uncalled bet ($0.50) returned to matiko09
matiko09 collected $0.60 from pot
matiko09: doesn't show hand 
*** SUMMARY ***
Total pot $0.60 | Rake $0 
Seat 1: Jo_Medici (small blind) folded before Flop
Seat 2: MaurerXL82 (big blind) folded before Flop
Seat 3: MAO_DZEDYN_S folded before Flop (didn't bet)
Seat 4: matiko09 collected ($0.60)
Seat 6: droog2 (button) folded before Flop (didn't bet)





PokerStars Hand #148211440130:  Hold'em No Limit (€0.10/€0.25 EUR) - 2016/02/04 11:47:00 CET [2016/02/04 5:47:00 ET]
Table 'Lilaea III' 6-max Seat #5 is the button
Seat 1: matiko09 (€26.59 in chips) 
Seat 2: Yegoriy (€25.25 in chips) 
Seat 3: uzzy20 (€33.09 in chips) 
Seat 4: Wwwasian (€34.03 in chips) 
Seat 5: marchuchok (€25 in chips) 
Seat 6: BaaroRai (€33.29 in chips) 
BaaroRai: posts small blind €0.10
matiko09: posts big blind €0.25
*** HOLE CARDS ***
Dealt to matiko09 [6d 7d]
Yegoriy: raises €0.50 to €0.75
uzzy20: folds 
Wwwasian: folds 
marchuchok: folds 
BaaroRai: folds 
matiko09: folds 
Uncalled bet (€0.50) returned to Yegoriy
Yegoriy collected €0.60 from pot
*** SUMMARY ***
Total pot €0.60 | Rake €0 
Seat 1: matiko09 (big blind) folded before Flop
Seat 2: Yegoriy collected (€0.60)
Seat 3: uzzy20 folded before Flop (didn't bet)
Seat 4: Wwwasian folded before Flop (didn't bet)
Seat 5: marchuchok (button) folded before Flop (didn't bet)
Seat 6: BaaroRai (small blind) folded before Flop





PokerStars Hand #148211445388:  Hold'em No Limit ($0.10/$0.25 USD) - 2016/02/04 11:47:10 CET [2016/02/04 5:47:10 ET]
Table 'Thora II' 6-max Seat #6 is the button
Seat 1: S1cker_0ne ($40.37 in chips) 
Seat 2: schatun774 ($12.62 in chips) 
Seat 4: matiko09 ($31.31 in chips) 
Seat 5: PoMa3aH ($27.08 in chips) 
Seat 6: cost983 ($25 in chips) 
S1cker_0ne: posts small blind $0.10
schatun774: posts big blind $0.25
Odmincheg: sits out 
*** HOLE CARDS ***
Dealt to matiko09 [4s 8s]
matiko09: folds 
PoMa3aH: folds 
cost983: raises $0.37 to $0.62
S1cker_0ne: folds 
schatun774: calls $0.37
*** FLOP *** [8d Jd 7d]
schatun774: checks 
cost983: bets $0.70
schatun774: calls $0.70
*** TURN *** [8d Jd 7d] [Qs]
schatun774: checks 
cost983: bets $1.50
schatun774: calls $1.50
*** RIVER *** [8d Jd 7d Qs] [5h]
schatun774: bets $0.25
cost983: calls $0.25
*** SHOW DOWN ***
schatun774: shows [Qd 2c] (a pair of Queens)
cost983: mucks hand 
schatun774 collected $5.96 from pot
*** SUMMARY ***
Total pot $6.24 | Rake $0.28 
Board [8d Jd 7d Qs 5h]
Seat 1: S1cker_0ne (small blind) folded before Flop
Seat 2: schatun774 (big blind) showed [Qd 2c] and won ($5.96) with a pair of Queens
Seat 4: matiko09 folded before Flop (didn't bet)
Seat 5: PoMa3aH folded before Flop (didn't bet)
Seat 6: cost983 (button) mucked [Th Tc]





PokerStars Hand #148211446295:  Hold'em No Limit ($0.10/$0.25 USD) - 2016/02/04 11:47:12 CET [2016/02/04 5:47:12 ET]
Table 'Hungaria II' 6-max Seat #1 is the button
Seat 1: Jo_Medici ($25 in chips) 
Seat 2: MaurerXL82 ($26.34 in chips) 
Seat 3: MAO_DZEDYN_S ($25 in chips) 
Seat 4: matiko09 ($26.64 in chips) 
Seat 6: droog2 ($37.23 in chips) 
MaurerXL82: posts small blind $0.10
MAO_DZEDYN_S: posts big blind $0.25
*** HOLE CARDS ***
Dealt to matiko09 [2s 2c]
matiko09: raises $0.50 to $0.75
droog2: folds 
Jo_Medici: folds 
MaurerXL82: calls $0.65
MAO_DZEDYN_S: folds 
*** FLOP *** [3c 9c 9d]
MaurerXL82: bets $0.25
matiko09: calls $0.25
*** TURN *** [3c 9c 9d] [Jc]
MaurerXL82: bets $0.25
matiko09: calls $0.25
*** RIVER *** [3c 9c 9d Jc] [4h]
MaurerXL82: bets $2.63
matiko09: folds 
Uncalled bet ($2.63) returned to MaurerXL82
MaurerXL82 collected $2.63 from pot
MaurerXL82: doesn't show hand 
*** SUMMARY ***
Total pot $2.75 | Rake $0.12 
Board [3c 9c 9d Jc 4h]
Seat 1: Jo_Medici (button) folded before Flop (didn't bet)
Seat 2: MaurerXL82 (small blind) collected ($2.63)
Seat 3: MAO_DZEDYN_S (big blind) folded before Flop
Seat 4: matiko09 folded on the River
Seat 6: droog2 folded before Flop (didn't bet)





PokerStars Hand #148211448378:  Hold'em No Limit (£0.10/£0.25 GBP) - 2016/02/04 11:47:16 CET [2016/02/04 5:47:16 ET]
Table 'Libra II' 6-max Seat #5 is the button
Seat 1: k4rloos (£25.10 in chips) 
Seat 2: matiko09 (£26.67 in chips) 
Seat 3: namex11 (£25 in chips) 
Seat 4: sagiga87 (£28.85 in chips) 
Seat 5: Vedmegatko (£44.40 in chips) 
k4rloos: posts small blind £0.10
matiko09: posts big blind £0.25
*** HOLE CARDS ***
Dealt to matiko09 [2h 3d]
namex11: raises £0.50 to £0.75
sagiga87: folds 
Vedmegatko: folds 
k4rloos: folds 
matiko09: folds 
Uncalled bet (£0.50) returned to namex11
namex11 collected £0.60 from pot
namex11: doesn't show hand 
*** SUMMARY ***
Total pot £0.60 | Rake £0 
Seat 1: k4rloos (small blind) folded before Flop
Seat 2: matiko09 (big blind) folded before Flop
Seat 3: namex11 collected (£0.60)
Seat 4: sagiga87 folded before Flop (didn't bet)
Seat 5: Vedmegatko (button) folded before Flop (didn't bet)





PokerStars Hand #148211450820:  Hold'em No Limit (€0.10/€0.25 EUR) - 2016/02/04 11:47:21 CET [2016/02/04 5:47:21 ET]
Table 'Lilaea III' 6-max Seat #6 is the button
Seat 1: matiko09 (€26.34 in chips) 
Seat 2: Yegoriy (€25.60 in chips) 
Seat 3: uzzy20 (€33.09 in chips) 
Seat 4: Wwwasian (€34.03 in chips) 
Seat 5: marchuchok (€25 in chips) 
Seat 6: BaaroRai (€33.19 in chips) 
matiko09: posts small blind €0.10
Yegoriy: posts big blind €0.25
*** HOLE CARDS ***
Dealt to matiko09 [3h Jh]
uzzy20: folds 
Wwwasian: raises €0.45 to €0.70
marchuchok: folds 
BaaroRai: calls €0.70
matiko09: folds 
Yegoriy: folds 
*** FLOP *** [Ah 4h 9s]
Wwwasian: checks 
BaaroRai: checks 
*** TURN *** [Ah 4h 9s] [5c]
Wwwasian: checks 
BaaroRai: checks 
*** RIVER *** [Ah 4h 9s 5c] [Tc]
Wwwasian: bets €1.50
BaaroRai: folds 
Uncalled bet (€1.50) returned to Wwwasian
Wwwasian collected €1.67 from pot
Wwwasian: doesn't show hand 
*** SUMMARY ***
Total pot €1.75 | Rake €0.08 
Board [Ah 4h 9s 5c Tc]
Seat 1: matiko09 (small blind) folded before Flop
Seat 2: Yegoriy (big blind) folded before Flop
Seat 3: uzzy20 folded before Flop (didn't bet)
Seat 4: Wwwasian collected (€1.67)
Seat 5: marchuchok folded before Flop (didn't bet)
Seat 6: BaaroRai (button) folded on the River





PokerStars Hand #148211468435:  Hold'em No Limit (£0.10/£0.25 GBP) - 2016/02/04 11:47:56 CET [2016/02/04 5:47:56 ET]
Table 'Libra II' 6-max Seat #1 is the button
Seat 1: k4rloos (£25 in chips) 
Seat 2: matiko09 (£26.42 in chips) 
Seat 3: namex11 (£25.35 in chips) 
Seat 4: sagiga87 (£28.85 in chips) 
Seat 5: Vedmegatko (£44.40 in chips) 
matiko09: posts small blind £0.10
namex11: posts big blind £0.25
*** HOLE CARDS ***
Dealt to matiko09 [3d 3c]
sagiga87: calls £0.25
Vedmegatko: folds 
k4rloos: raises £0.75 to £1
matiko09: calls £0.90
namex11: folds 
sagiga87: folds 
*** FLOP *** [Td 4d 7c]
matiko09: checks 
k4rloos: bets £1.46
matiko09: folds 
Uncalled bet (£1.46) returned to k4rloos
k4rloos collected £2.39 from pot
k4rloos: doesn't show hand 
*** SUMMARY ***
Total pot £2.50 | Rake £0.11 
Board [Td 4d 7c]
Seat 1: k4rloos (button) collected (£2.39)
Seat 2: matiko09 (small blind) folded on the Flop
Seat 3: namex11 (big blind) folded before Flop
Seat 4: sagiga87 folded before Flop
Seat 5: Vedmegatko folded before Flop (didn't bet)





PokerStars Hand #148211481617:  Hold'em No Limit (€0.10/€0.25 EUR) - 2016/02/04 11:48:21 CET [2016/02/04 5:48:21 ET]
Table 'Lilaea III' 6-max Seat #1 is the button
Seat 1: matiko09 (€26.24 in chips) 
Seat 2: Yegoriy (€25.35 in chips) 
Seat 3: uzzy20 (€33.09 in chips) 
Seat 4: Wwwasian (€35 in chips) 
Seat 5: marchuchok (€25 in chips) 
Seat 6: BaaroRai (€32.49 in chips) 
Yegoriy: posts small blind €0.10
uzzy20: posts big blind €0.25
*** HOLE CARDS ***
Dealt to matiko09 [Ts Kc]
Wwwasian: folds 
marchuchok: folds 
BaaroRai: calls €0.25
matiko09: raises €0.75 to €1
Yegoriy: folds 
uzzy20: calls €0.75
BaaroRai: calls €0.75
*** FLOP *** [Kd Td 9h]
uzzy20: checks 
BaaroRai: checks 
matiko09: bets €2.39
uzzy20: calls €2.39
BaaroRai: folds 
*** TURN *** [Kd Td 9h] [3c]
uzzy20: checks 
matiko09: bets €5.25
uzzy20: folds 
Uncalled bet (€5.25) returned to matiko09
matiko09 collected €7.53 from pot
matiko09: doesn't show hand 
*** SUMMARY ***
Total pot €7.88 | Rake €0.35 
Board [Kd Td 9h 3c]
Seat 1: matiko09 (button) collected (€7.53)
Seat 2: Yegoriy (small blind) folded before Flop
Seat 3: uzzy20 (big blind) folded on the Turn
Seat 4: Wwwasian folded before Flop (didn't bet)
Seat 5: marchuchok folded before Flop (didn't bet)
Seat 6: BaaroRai folded on the Flop





PokerStars Hand #148211483161:  Hold'em No Limit ($0.10/$0.25 USD) - 2016/02/04 11:48:24 CET [2016/02/04 5:48:24 ET]
Table 'Thora II' 6-max Seat #1 is the button
Seat 1: S1cker_0ne ($40.27 in chips) 
Seat 2: schatun774 ($15.51 in chips) 
Seat 3: Odmincheg ($25.35 in chips) 
Seat 4: matiko09 ($31.31 in chips) 
Seat 5: PoMa3aH ($27.08 in chips) 
Seat 6: cost983 ($25 in chips) 
schatun774: posts small blind $0.10
Odmincheg: posts big blind $0.25
*** HOLE CARDS ***
Dealt to matiko09 [Tc 5s]
matiko09: folds 
PoMa3aH: folds 
cost983: folds 
S1cker_0ne: folds 
schatun774: folds 
Uncalled bet ($0.15) returned to Odmincheg
Odmincheg collected $0.20 from pot
*** SUMMARY ***
Total pot $0.20 | Rake $0 
Seat 1: S1cker_0ne (button) folded before Flop (didn't bet)
Seat 2: schatun774 (small blind) folded before Flop
Seat 3: Odmincheg (big blind) collected ($0.20)
Seat 4: matiko09 folded before Flop (didn't bet)
Seat 5: PoMa3aH folded before Flop (didn't bet)
Seat 6: cost983 folded before Flop (didn't bet)





PokerStars Hand #148211484921:  Hold'em No Limit (£0.10/£0.25 GBP) - 2016/02/04 11:48:28 CET [2016/02/04 5:48:28 ET]
Table 'Libra II' 6-max Seat #2 is the button
Seat 1: k4rloos (£26.39 in chips) 
Seat 2: matiko09 (£25.42 in chips) 
Seat 3: namex11 (£25.10 in chips) 
Seat 4: sagiga87 (£28.60 in chips) 
Seat 5: Vedmegatko (£44.40 in chips) 
namex11: posts small blind £0.10
sagiga87: posts big blind £0.25
*** HOLE CARDS ***
Dealt to matiko09 [3c 9c]
Vedmegatko: folds 
k4rloos: folds 
matiko09: folds 
namex11: folds 
Uncalled bet (£0.15) returned to sagiga87
sagiga87 collected £0.20 from pot
sagiga87: doesn't show hand 
*** SUMMARY ***
Total pot £0.20 | Rake £0 
Seat 1: k4rloos folded before Flop (didn't bet)
Seat 2: matiko09 (button) folded before Flop (didn't bet)
Seat 3: namex11 (small blind) folded before Flop
Seat 4: sagiga87 (big blind) collected (£0.20)
Seat 5: Vedmegatko folded before Flop (didn't bet)





PokerStars Hand #148211487561:  Hold'em No Limit ($0.10/$0.25 USD) - 2016/02/04 11:48:33 CET [2016/02/04 5:48:33 ET]
Table 'Thora II' 6-max Seat #2 is the button
Seat 1: S1cker_0ne ($40.27 in chips) 
Seat 2: schatun774 ($15.41 in chips) 
Seat 3: Odmincheg ($25.45 in chips) 
Seat 4: matiko09 ($31.31 in chips) 
Seat 5: PoMa3aH ($27.08 in chips) 
Seat 6: cost983 ($25 in chips) 
Odmincheg: posts small blind $0.10
matiko09: posts big blind $0.25
*** HOLE CARDS ***
Dealt to matiko09 [Tc Qs]
PoMa3aH: folds 
cost983: folds 
S1cker_0ne: folds 
schatun774: calls $0.25
Odmincheg: folds 
matiko09: raises $1 to $1.25
schatun774: folds 
Uncalled bet ($1) returned to matiko09
matiko09 collected $0.60 from pot
matiko09: doesn't show hand 
*** SUMMARY ***
Total pot $0.60 | Rake $0 
Seat 1: S1cker_0ne folded before Flop (didn't bet)
Seat 2: schatun774 (button) folded before Flop
Seat 3: Odmincheg (small blind) folded before Flop
Seat 4: matiko09 (big blind) collected ($0.60)
Seat 5: PoMa3aH folded before Flop (didn't bet)
Seat 6: cost983 folded before Flop (didn't bet)





PokerStars Hand #148211489360:  Hold'em No Limit ($0.10/$0.25 USD) - 2016/02/04 11:48:37 CET [2016/02/04 5:48:37 ET]
Table 'Hungaria II' 6-max Seat #2 is the button
Seat 1: Jo_Medici ($25 in chips) 
Seat 2: MaurerXL82 ($27.72 in chips) 
Seat 3: MAO_DZEDYN_S ($25 in chips) 
Seat 4: matiko09 ($25.39 in chips) 
Seat 6: droog2 ($37.23 in chips) 
MAO_DZEDYN_S: posts small blind $0.10
matiko09: posts big blind $0.25
*** HOLE CARDS ***
Dealt to matiko09 [Ad 6h]
droog2: folds 
Jo_Medici: folds 
MaurerXL82: calls $0.25
MAO_DZEDYN_S: folds 
matiko09: checks 
*** FLOP *** [Ah 8h 2c]
matiko09: bets $0.37
MaurerXL82: calls $0.37
*** TURN *** [Ah 8h 2c] [6s]
matiko09: bets $2.25
MaurerXL82: folds 
Uncalled bet ($2.25) returned to matiko09
matiko09 collected $1.28 from pot
matiko09: doesn't show hand 
*** SUMMARY ***
Total pot $1.34 | Rake $0.06 
Board [Ah 8h 2c 6s]
Seat 1: Jo_Medici folded before Flop (didn't bet)
Seat 2: MaurerXL82 (button) folded on the Turn
Seat 3: MAO_DZEDYN_S (small blind) folded before Flop
Seat 4: matiko09 (big blind) collected ($1.28)
Seat 6: droog2 folded before Flop (didn't bet)





PokerStars Hand #148211491976:  Hold'em No Limit (£0.10/£0.25 GBP) - 2016/02/04 11:48:42 CET [2016/02/04 5:48:42 ET]
Table 'Libra II' 6-max Seat #3 is the button
Seat 1: k4rloos (£26.39 in chips) 
Seat 2: matiko09 (£25.42 in chips) 
Seat 3: namex11 (£25 in chips) 
Seat 4: sagiga87 (£28.70 in chips) 
Seat 5: Vedmegatko (£44.40 in chips) 
sagiga87: posts small blind £0.10
Vedmegatko: posts big blind £0.25
*** HOLE CARDS ***
Dealt to matiko09 [4d Qs]
k4rloos: folds 
matiko09: folds 
namex11: raises £0.25 to £0.50
sagiga87: folds 
Vedmegatko: folds 
Uncalled bet (£0.25) returned to namex11
namex11 collected £0.60 from pot
namex11: doesn't show hand 
*** SUMMARY ***
Total pot £0.60 | Rake £0 
Seat 1: k4rloos folded before Flop (didn't bet)
Seat 2: matiko09 folded before Flop (didn't bet)
Seat 3: namex11 (button) collected (£0.60)
Seat 4: sagiga87 (small blind) folded before Flop
Seat 5: Vedmegatko (big blind) folded before Flop





PokerStars Hand #148211493660:  Hold'em No Limit ($0.10/$0.25 USD) - 2016/02/04 11:48:45 CET [2016/02/04 5:48:45 ET]
Table 'Procyon III' 6-max Seat #1 is the button
Seat 1: S1cker_0ne ($25 in chips) 
Seat 3: sebodrobil ($12.01 in chips) 
Seat 4: Wwwasian ($25 in chips) 
Seat 5: kAfRiNiUs ($25 in chips) 
Seat 6: matiko09 ($25 in chips) 
sebodrobil: posts small blind $0.10
Wwwasian: posts big blind $0.25
*** HOLE CARDS ***
Dealt to matiko09 [8h 9s]
kAfRiNiUs: folds 
matiko09: folds 
S1cker_0ne: raises $0.27 to $0.52
k4rloos joins the table at seat #2 
sebodrobil: raises $1.29 to $1.81
Wwwasian: folds 
S1cker_0ne: folds 
Uncalled bet ($1.29) returned to sebodrobil
sebodrobil collected $1.29 from pot
sebodrobil: shows [Ad Ah] (a pair of Aces)
*** SUMMARY ***
Total pot $1.29 | Rake $0 
Seat 1: S1cker_0ne (button) folded before Flop
Seat 3: sebodrobil (small blind) collected ($1.29)
Seat 4: Wwwasian (big blind) folded before Flop
Seat 5: kAfRiNiUs folded before Flop (didn't bet)
Seat 6: matiko09 folded before Flop (didn't bet)





PokerStars Hand #148211503237:  Hold'em No Limit (£0.10/£0.25 GBP) - 2016/02/04 11:49:04 CET [2016/02/04 5:49:04 ET]
Table 'Libra II' 6-max Seat #4 is the button
Seat 1: k4rloos (£26.39 in chips) 
Seat 2: matiko09 (£25.42 in chips) 
Seat 3: namex11 (£25.35 in chips) 
Seat 4: sagiga87 (£28.60 in chips) 
Seat 5: Vedmegatko (£44.15 in chips) 
Vedmegatko: posts small blind £0.10
k4rloos: posts big blind £0.25
*** HOLE CARDS ***
Dealt to matiko09 [2h 9d]
matiko09: folds 
namex11: folds 
sagiga87: raises £0.25 to £0.50
Vedmegatko: folds 
k4rloos: folds 
Uncalled bet (£0.25) returned to sagiga87
sagiga87 collected £0.60 from pot
sagiga87: doesn't show hand 
*** SUMMARY ***
Total pot £0.60 | Rake £0 
Seat 1: k4rloos (big blind) folded before Flop
Seat 2: matiko09 folded before Flop (didn't bet)
Seat 3: namex11 folded before Flop (didn't bet)
Seat 4: sagiga87 (button) collected (£0.60)
Seat 5: Vedmegatko (small blind) folded before Flop





PokerStars Hand #148211505214:  Hold'em No Limit ($0.10/$0.25 USD) - 2016/02/04 11:49:08 CET [2016/02/04 5:49:08 ET]
Table 'Thora II' 6-max Seat #3 is the button
Seat 1: S1cker_0ne ($40.27 in chips) 
Seat 2: schatun774 ($15.16 in chips) 
Seat 3: Odmincheg ($25.35 in chips) 
Seat 4: matiko09 ($31.66 in chips) 
Seat 5: PoMa3aH ($27.08 in chips) 
Seat 6: cost983 ($25 in chips) 
matiko09: posts small blind $0.10
PoMa3aH: posts big blind $0.25
*** HOLE CARDS ***
Dealt to matiko09 [Kc Jh]
cost983: folds 
S1cker_0ne: folds 
schatun774: raises $0.25 to $0.50
Odmincheg: folds 
matiko09: folds 
PoMa3aH: folds 
Uncalled bet ($0.25) returned to schatun774
schatun774 collected $0.60 from pot
schatun774: doesn't show hand 
*** SUMMARY ***
Total pot $0.60 | Rake $0 
Seat 1: S1cker_0ne folded before Flop (didn't bet)
Seat 2: schatun774 collected ($0.60)
Seat 3: Odmincheg (button) folded before Flop (didn't bet)
Seat 4: matiko09 (small blind) folded before Flop
Seat 5: PoMa3aH (big blind) folded before Flop
Seat 6: cost983 folded before Flop (didn't bet)





PokerStars Hand #148211506298:  Hold'em No Limit (€0.10/€0.25 EUR) - 2016/02/04 11:49:10 CET [2016/02/04 5:49:10 ET]
Table 'Lilaea III' 6-max Seat #2 is the button
Seat 1: matiko09 (€30.38 in chips) 
Seat 2: Yegoriy (€25.25 in chips) 
Seat 3: uzzy20 (€29.70 in chips) 
Seat 4: Wwwasian (€35 in chips) 
Seat 5: marchuchok (€25 in chips) 
Seat 6: BaaroRai (€31.49 in chips) 
uzzy20: posts small blind €0.10
Wwwasian: posts big blind €0.25
*** HOLE CARDS ***
Dealt to matiko09 [Ah 9d]
marchuchok: folds 
BaaroRai: folds 
matiko09: folds 
Yegoriy: folds 
uzzy20: folds 
Uncalled bet (€0.15) returned to Wwwasian
Wwwasian collected €0.20 from pot
Wwwasian: doesn't show hand 
*** SUMMARY ***
Total pot €0.20 | Rake €0 
Seat 1: matiko09 folded before Flop (didn't bet)
Seat 2: Yegoriy (button) folded before Flop (didn't bet)
Seat 3: uzzy20 (small blind) folded before Flop
Seat 4: Wwwasian (big blind) collected (€0.20)
Seat 5: marchuchok folded before Flop (didn't bet)
Seat 6: BaaroRai folded before Flop (didn't bet)





PokerStars Hand #148211506528:  Hold'em No Limit ($0.10/$0.25 USD) - 2016/02/04 11:49:10 CET [2016/02/04 5:49:10 ET]
Table 'Procyon III' 6-max Seat #3 is the button
Seat 1: S1cker_0ne ($25 in chips) 
Seat 3: sebodrobil ($12.78 in chips) 
Seat 4: Wwwasian ($25 in chips) 
Seat 5: kAfRiNiUs ($25 in chips) 
Seat 6: matiko09 ($25 in chips) 
Wwwasian: posts small blind $0.10
kAfRiNiUs: posts big blind $0.25
k4rloos: sits out 
*** HOLE CARDS ***
Dealt to matiko09 [Kc Th]
matiko09: folds 
S1cker_0ne: folds 
sebodrobil: calls $0.25
Wwwasian: folds 
kAfRiNiUs: raises $1 to $1.25
sebodrobil: calls $1
*** FLOP *** [4c 2c 5h]
kAfRiNiUs: checks 
sebodrobil: checks 
*** TURN *** [4c 2c 5h] [5s]
kAfRiNiUs: checks 
sebodrobil: checks 
*** RIVER *** [4c 2c 5h 5s] [7h]
kAfRiNiUs: checks 
sebodrobil: checks 
*** SHOW DOWN ***
kAfRiNiUs: shows [8s 7d] (two pair, Sevens and Fives)
sebodrobil: mucks hand 
kAfRiNiUs collected $2.48 from pot
*** SUMMARY ***
Total pot $2.60 | Rake $0.12 
Board [4c 2c 5h 5s 7h]
Seat 1: S1cker_0ne folded before Flop (didn't bet)
Seat 3: sebodrobil (button) mucked [Jh 9c]
Seat 4: Wwwasian (small blind) folded before Flop
Seat 5: kAfRiNiUs (big blind) showed [8s 7d] and won ($2.48) with two pair, Sevens and Fives
Seat 6: matiko09 folded before Flop (didn't bet)





PokerStars Hand #148211511154:  Hold'em No Limit (£0.10/£0.25 GBP) - 2016/02/04 11:49:19 CET [2016/02/04 5:49:19 ET]
Table 'Libra II' 6-max Seat #5 is the button
Seat 1: k4rloos (£26.14 in chips) 
Seat 2: matiko09 (£25.42 in chips) 
Seat 3: namex11 (£25.35 in chips) 
Seat 4: sagiga87 (£28.95 in chips) 
Seat 5: Vedmegatko (£44.05 in chips) 
pescador1522 will be allowed to play after the button
k4rloos: posts small blind £0.10
matiko09: posts big blind £0.25
*** HOLE CARDS ***
Dealt to matiko09 [6h Th]
namex11: folds 
sagiga87: folds 
Vedmegatko: raises £0.37 to £0.62
k4rloos: folds 
matiko09: folds 
Uncalled bet (£0.37) returned to Vedmegatko
Vedmegatko collected £0.60 from pot
Vedmegatko: doesn't show hand 
*** SUMMARY ***
Total pot £0.60 | Rake £0 
Seat 1: k4rloos (small blind) folded before Flop
Seat 2: matiko09 (big blind) folded before Flop
Seat 3: namex11 folded before Flop (didn't bet)
Seat 4: sagiga87 folded before Flop (didn't bet)
Seat 5: Vedmegatko (button) collected (£0.60)





PokerStars Hand #148211514838:  Hold'em No Limit ($0.10/$0.25 USD) - 2016/02/04 11:49:26 CET [2016/02/04 5:49:26 ET]
Table 'Hungaria II' 6-max Seat #3 is the button
Seat 1: Jo_Medici ($25 in chips) 
Seat 2: MaurerXL82 ($27.10 in chips) 
Seat 3: MAO_DZEDYN_S ($25 in chips) 
Seat 4: matiko09 ($26.05 in chips) 
Seat 6: droog2 ($37.23 in chips) 
matiko09: posts small blind $0.10
droog2: posts big blind $0.25
*** HOLE CARDS ***
Dealt to matiko09 [Ks 4h]
Jo_Medici: folds 
MaurerXL82: folds 
MAO_DZEDYN_S: folds 
matiko09: folds 
Uncalled bet ($0.15) returned to droog2
droog2 collected $0.20 from pot
droog2: doesn't show hand 
*** SUMMARY ***
Total pot $0.20 | Rake $0 
Seat 1: Jo_Medici folded before Flop (didn't bet)
Seat 2: MaurerXL82 folded before Flop (didn't bet)
Seat 3: MAO_DZEDYN_S (button) folded before Flop (didn't bet)
Seat 4: matiko09 (small blind) folded before Flop
Seat 6: droog2 (big blind) collected ($0.20)





PokerStars Hand #148211515589:  Hold'em No Limit (€0.10/€0.25 EUR) - 2016/02/04 11:49:28 CET [2016/02/04 5:49:28 ET]
Table 'Lilaea III' 6-max Seat #3 is the button
Seat 1: matiko09 (€30.38 in chips) 
Seat 2: Yegoriy (€25.25 in chips) 
Seat 3: uzzy20 (€29.60 in chips) 
Seat 4: Wwwasian (€35.10 in chips) 
Seat 5: marchuchok (€25 in chips) 
Seat 6: BaaroRai (€31.49 in chips) 
Wwwasian: posts small blind €0.10
marchuchok: posts big blind €0.25
*** HOLE CARDS ***
Dealt to matiko09 [Ad Ac]
BaaroRai: calls €0.25
matiko09: raises €0.75 to €1
Yegoriy: folds 
uzzy20: folds 
Wwwasian: folds 
marchuchok: folds 
BaaroRai: calls €0.75
*** FLOP *** [Jh 4s Qd]
BaaroRai: checks 
matiko09: bets €1.46
BaaroRai: folds 
Uncalled bet (€1.46) returned to matiko09
BaaroRai leaves the table
matiko09 collected €2.24 from pot
matiko09: doesn't show hand 
*** SUMMARY ***
Total pot €2.35 | Rake €0.11 
Board [Jh 4s Qd]
Seat 1: matiko09 collected (€2.24)
Seat 2: Yegoriy folded before Flop (didn't bet)
Seat 3: uzzy20 (button) folded before Flop (didn't bet)
Seat 4: Wwwasian (small blind) folded before Flop
Seat 5: marchuchok (big blind) folded before Flop
Seat 6: BaaroRai folded on the Flop





PokerStars Hand #148211518273:  Hold'em No Limit (£0.10/£0.25 GBP) - 2016/02/04 11:49:33 CET [2016/02/04 5:49:33 ET]
Table 'Libra II' 6-max Seat #1 is the button
Seat 1: k4rloos (£26.04 in chips) 
Seat 2: matiko09 (£25.17 in chips) 
Seat 3: namex11 (£25.35 in chips) 
Seat 4: sagiga87 (£28.95 in chips) 
Seat 5: Vedmegatko (£44.40 in chips) 
Seat 6: pescador1522 (£18.89 in chips) 
matiko09: posts small blind £0.10
namex11: posts big blind £0.25
pescador1522: posts small & big blinds £0.35
*** HOLE CARDS ***
Dealt to matiko09 [9h Ad]
sagiga87: folds 
Vedmegatko: folds 
pescador1522: checks 
k4rloos: folds 
matiko09: calls £0.15
namex11 has timed out
namex11: checks 
*** FLOP *** [Td Kh As]
matiko09: bets £0.53
namex11: folds 
pescador1522: folds 
Uncalled bet (£0.53) returned to matiko09
matiko09 collected £0.81 from pot
matiko09: doesn't show hand 
*** SUMMARY ***
Total pot £0.85 | Rake £0.04 
Board [Td Kh As]
Seat 1: k4rloos (button) folded before Flop (didn't bet)
Seat 2: matiko09 (small blind) collected (£0.81)
Seat 3: namex11 (big blind) folded on the Flop
Seat 4: sagiga87 folded before Flop (didn't bet)
Seat 5: Vedmegatko folded before Flop (didn't bet)
Seat 6: pescador1522 folded on the Flop





PokerStars Hand #148211521121:  Hold'em No Limit ($0.10/$0.25 USD) - 2016/02/04 11:49:39 CET [2016/02/04 5:49:39 ET]
Table 'Hungaria II' 6-max Seat #4 is the button
Seat 1: Jo_Medici ($25 in chips) 
Seat 2: MaurerXL82 ($27.10 in chips) 
Seat 3: MAO_DZEDYN_S ($25 in chips) 
Seat 4: matiko09 ($25.95 in chips) 
Seat 6: droog2 ($37.33 in chips) 
droog2: posts small blind $0.10
Jo_Medici: posts big blind $0.25
*** HOLE CARDS ***
Dealt to matiko09 [2s 8c]
MaurerXL82: calls $0.25
MAO_DZEDYN_S: folds 
matiko09: folds 
droog2: folds 
Jo_Medici: checks 
*** FLOP *** [Kh Ts 4s]
Jo_Medici: checks 
MaurerXL82: checks 
*** TURN *** [Kh Ts 4s] [Qs]
Jo_Medici: checks 
MaurerXL82: checks 
*** RIVER *** [Kh Ts 4s Qs] [Jd]
Jo_Medici: bets $0.28
MaurerXL82: raises $0.28 to $0.56
Jo_Medici: calls $0.28
*** SHOW DOWN ***
MaurerXL82: shows [9h 5h] (a straight, Nine to King)
Jo_Medici: shows [6h Ah] (a straight, Ten to Ace)
Jo_Medici collected $1.64 from pot
*** SUMMARY ***
Total pot $1.72 | Rake $0.08 
Board [Kh Ts 4s Qs Jd]
Seat 1: Jo_Medici (big blind) showed [6h Ah] and won ($1.64) with a straight, Ten to Ace
Seat 2: MaurerXL82 showed [9h 5h] and lost with a straight, Nine to King
Seat 3: MAO_DZEDYN_S folded before Flop (didn't bet)
Seat 4: matiko09 (button) folded before Flop (didn't bet)
Seat 6: droog2 (small blind) folded before Flop





PokerStars Hand #148211526690:  Hold'em No Limit ($0.10/$0.25 USD) - 2016/02/04 11:49:50 CET [2016/02/04 5:49:50 ET]
Table 'Procyon III' 6-max Seat #4 is the button
Seat 1: S1cker_0ne ($25 in chips) 
Seat 3: sebodrobil ($11.53 in chips) 
Seat 4: Wwwasian ($25 in chips) 
Seat 5: kAfRiNiUs ($26.23 in chips) 
Seat 6: matiko09 ($25 in chips) 
kAfRiNiUs: posts small blind $0.10
matiko09: posts big blind $0.25
k4rloos: sits out 
*** HOLE CARDS ***
Dealt to matiko09 [7d Js]
S1cker_0ne: folds 
sebodrobil: folds 
Wwwasian: folds 
kAfRiNiUs: folds 
Uncalled bet ($0.15) returned to matiko09
matiko09 collected $0.20 from pot
matiko09: doesn't show hand 
*** SUMMARY ***
Total pot $0.20 | Rake $0 
Seat 1: S1cker_0ne folded before Flop (didn't bet)
Seat 3: sebodrobil folded before Flop (didn't bet)
Seat 4: Wwwasian (button) folded before Flop (didn't bet)
Seat 5: kAfRiNiUs (small blind) folded before Flop
Seat 6: matiko09 (big blind) collected ($0.20)





PokerStars Hand #148211531847:  Hold'em No Limit ($0.10/$0.25 USD) - 2016/02/04 11:50:00 CET [2016/02/04 5:50:00 ET]
Table 'Procyon III' 6-max Seat #5 is the button
Seat 1: S1cker_0ne ($25 in chips) 
Seat 3: sebodrobil ($11.53 in chips) 
Seat 4: Wwwasian ($25 in chips) 
Seat 5: kAfRiNiUs ($26.13 in chips) 
Seat 6: matiko09 ($25.10 in chips) 
matiko09: posts small blind $0.10
S1cker_0ne: posts big blind $0.25
k4rloos: sits out 
*** HOLE CARDS ***
Dealt to matiko09 [Qd 9h]
sebodrobil: raises $0.25 to $0.50
Wwwasian: folds 
kAfRiNiUs: folds 
matiko09: folds 
S1cker_0ne: folds 
Uncalled bet ($0.25) returned to sebodrobil
sebodrobil collected $0.60 from pot
*** SUMMARY ***
Total pot $0.60 | Rake $0 
Seat 1: S1cker_0ne (big blind) folded before Flop
Seat 3: sebodrobil collected ($0.60)
Seat 4: Wwwasian folded before Flop (didn't bet)
Seat 5: kAfRiNiUs (button) folded before Flop (didn't bet)
Seat 6: matiko09 (small blind) folded before Flop





PokerStars Hand #148211534236:  Hold'em No Limit ($0.10/$0.25 USD) - 2016/02/04 11:50:04 CET [2016/02/04 5:50:04 ET]
Table 'Thora II' 6-max Seat #4 is the button
Seat 1: S1cker_0ne ($40.27 in chips) 
Seat 2: schatun774 ($15.51 in chips) 
Seat 3: Odmincheg ($25.35 in chips) 
Seat 4: matiko09 ($31.56 in chips) 
Seat 5: PoMa3aH ($26.83 in chips) 
PoMa3aH: posts small blind $0.10
cost983: is sitting out 
S1cker_0ne: posts big blind $0.25
*** HOLE CARDS ***
Dealt to matiko09 [4s As]
schatun774: folds 
cost983 leaves the table
Odmincheg: folds 
matiko09: raises $0.37 to $0.62
PoMa3aH: raises $1.44 to $2.06
S1cker_0ne: folds 
matiko09: folds 
Uncalled bet ($1.44) returned to PoMa3aH
PoMa3aH collected $1.49 from pot
PoMa3aH: doesn't show hand 
*** SUMMARY ***
Total pot $1.49 | Rake $0 
Seat 1: S1cker_0ne (big blind) folded before Flop
Seat 2: schatun774 folded before Flop (didn't bet)
Seat 3: Odmincheg folded before Flop (didn't bet)
Seat 4: matiko09 (button) folded before Flop
Seat 5: PoMa3aH (small blind) collected ($1.49)





PokerStars Hand #148211535103:  Hold'em No Limit (€0.10/€0.25 EUR) - 2016/02/04 11:50:06 CET [2016/02/04 5:50:06 ET]
Table 'Lilaea III' 6-max Seat #4 is the button
Seat 1: matiko09 (€31.62 in chips) 
Seat 2: Yegoriy (€25.25 in chips) 
Seat 3: uzzy20 (€29.60 in chips) 
Seat 4: Wwwasian (€35 in chips) 
Seat 5: marchuchok (€25 in chips) 
marchuchok: posts small blind €0.10
matiko09: posts big blind €0.25
*** HOLE CARDS ***
Dealt to matiko09 [Ts 6h]
Yegoriy: folds 
uzzy20: raises €0.31 to €0.56
Wwwasian: folds 
marchuchok: calls €0.46
matiko09: folds 
*** FLOP *** [6s 6c 4c]
marchuchok: checks 
uzzy20: checks 
*** TURN *** [6s 6c 4c] [2s]
angrypaca joins the table at seat #6 
marchuchok: checks 
uzzy20: checks 
*** RIVER *** [6s 6c 4c 2s] [5c]
marchuchok: checks 
angrypaca leaves the table
spid3rix joins the table at seat #6 
uzzy20: bets €0.86
marchuchok: folds 
Uncalled bet (€0.86) returned to uzzy20
uzzy20 collected €1.31 from pot
*** SUMMARY ***
Total pot €1.37 | Rake €0.06 
Board [6s 6c 4c 2s 5c]
Seat 1: matiko09 (big blind) folded before Flop
Seat 2: Yegoriy folded before Flop (didn't bet)
Seat 3: uzzy20 collected (€1.31)
Seat 4: Wwwasian (button) folded before Flop (didn't bet)
Seat 5: marchuchok (small blind) folded on the River





PokerStars Hand #148211538755:  Hold'em No Limit ($0.10/$0.25 USD) - 2016/02/04 11:50:13 CET [2016/02/04 5:50:13 ET]
Table 'Procyon III' 6-max Seat #6 is the button
Seat 1: S1cker_0ne ($25 in chips) 
Seat 2: k4rloos ($25 in chips) 
Seat 3: sebodrobil ($11.88 in chips) 
Seat 4: Wwwasian ($25 in chips) 
Seat 5: kAfRiNiUs ($26.13 in chips) 
Seat 6: matiko09 ($25 in chips) 
S1cker_0ne: posts small blind $0.10
k4rloos: posts big blind $0.25
*** HOLE CARDS ***
Dealt to matiko09 [Jh 6s]
sebodrobil: folds 
Wwwasian: raises $0.45 to $0.70
kAfRiNiUs: folds 
matiko09: folds 
S1cker_0ne: folds 
k4rloos: folds 
Uncalled bet ($0.45) returned to Wwwasian
Wwwasian collected $0.60 from pot
Wwwasian: doesn't show hand 
*** SUMMARY ***
Total pot $0.60 | Rake $0 
Seat 1: S1cker_0ne (small blind) folded before Flop
Seat 2: k4rloos (big blind) folded before Flop
Seat 3: sebodrobil folded before Flop (didn't bet)
Seat 4: Wwwasian collected ($0.60)
Seat 5: kAfRiNiUs folded before Flop (didn't bet)
Seat 6: matiko09 (button) folded before Flop (didn't bet)





PokerStars Hand #148211547667:  Hold'em No Limit ($0.10/$0.25 USD) - 2016/02/04 11:50:30 CET [2016/02/04 5:50:30 ET]
Table 'Thora II' 6-max Seat #5 is the button
Seat 1: S1cker_0ne ($40.02 in chips) 
Seat 2: schatun774 ($15.51 in chips) 
Seat 3: Odmincheg ($25.35 in chips) 
Seat 4: matiko09 ($30.94 in chips) 
Seat 5: PoMa3aH ($27.70 in chips) 
S1cker_0ne: posts small blind $0.10
schatun774: posts big blind $0.25
*** HOLE CARDS ***
Dealt to matiko09 [8d Jh]
Odmincheg: folds 
matiko09: folds 
PoMa3aH: raises $0.36 to $0.61
S1cker_0ne: folds 
schatun774: calls $0.36
*** FLOP *** [2d 7d Jd]
schatun774: checks 
PoMa3aH: bets $0.90
schatun774: folds 
Uncalled bet ($0.90) returned to PoMa3aH
PoMa3aH collected $1.26 from pot
PoMa3aH: doesn't show hand 
*** SUMMARY ***
Total pot $1.32 | Rake $0.06 
Board [2d 7d Jd]
Seat 1: S1cker_0ne (small blind) folded before Flop
Seat 2: schatun774 (big blind) folded on the Flop
Seat 3: Odmincheg folded before Flop (didn't bet)
Seat 4: matiko09 folded before Flop (didn't bet)
Seat 5: PoMa3aH (button) collected ($1.26)





PokerStars Hand #148211549389:  Hold'em No Limit (£0.10/£0.25 GBP) - 2016/02/04 11:50:34 CET [2016/02/04 5:50:34 ET]
Table 'Libra II' 6-max Seat #2 is the button
Seat 1: k4rloos (£26.04 in chips) 
Seat 2: matiko09 (£25.73 in chips) 
Seat 3: namex11 (£25.10 in chips) 
Seat 4: sagiga87 (£28.95 in chips) 
Seat 5: Vedmegatko (£44.40 in chips) 
Seat 6: pescador1522 (£18.54 in chips) 
namex11: posts small blind £0.10
sagiga87: posts big blind £0.25
*** HOLE CARDS ***
Dealt to matiko09 [5d 9d]
Vedmegatko: folds 
pescador1522: calls £0.25
k4rloos: folds 
matiko09: folds 
namex11 has timed out
namex11: folds 
sagiga87: checks 
*** FLOP *** [4h 6s 2c]
sagiga87: checks 
pescador1522: bets £0.25
sagiga87: folds 
Uncalled bet (£0.25) returned to pescador1522
pescador1522 collected £0.57 from pot
pescador1522: doesn't show hand 
*** SUMMARY ***
Total pot £0.60 | Rake £0.03 
Board [4h 6s 2c]
Seat 1: k4rloos folded before Flop (didn't bet)
Seat 2: matiko09 (button) folded before Flop (didn't bet)
Seat 3: namex11 (small blind) folded before Flop
Seat 4: sagiga87 (big blind) folded on the Flop
Seat 5: Vedmegatko folded before Flop (didn't bet)
Seat 6: pescador1522 collected (£0.57)





PokerStars Hand #148211552527:  Hold'em No Limit ($0.10/$0.25 USD) - 2016/02/04 11:50:40 CET [2016/02/04 5:50:40 ET]
Table 'Hungaria II' 6-max Seat #6 is the button
Seat 1: Jo_Medici ($25.83 in chips) 
Seat 2: MaurerXL82 ($26.29 in chips) 
Seat 3: MAO_DZEDYN_S ($25 in chips) 
Seat 4: matiko09 ($25.95 in chips) 
Seat 6: droog2 ($37.23 in chips) 
Jo_Medici: posts small blind $0.10
MaurerXL82: posts big blind $0.25
*** HOLE CARDS ***
Dealt to matiko09 [3d 2s]
MAO_DZEDYN_S: folds 
matiko09: folds 
droog2: folds 
Jo_Medici: folds 
Uncalled bet ($0.15) returned to MaurerXL82
MaurerXL82 collected $0.20 from pot
MaurerXL82: doesn't show hand 
*** SUMMARY ***
Total pot $0.20 | Rake $0 
Seat 1: Jo_Medici (small blind) folded before Flop
Seat 2: MaurerXL82 (big blind) collected ($0.20)
Seat 3: MAO_DZEDYN_S folded before Flop (didn't bet)
Seat 4: matiko09 folded before Flop (didn't bet)
Seat 6: droog2 (button) folded before Flop (didn't bet)





PokerStars Hand #148211556551:  Hold'em No Limit ($0.10/$0.25 USD) - 2016/02/04 11:50:48 CET [2016/02/04 5:50:48 ET]
Table 'Thora II' 6-max Seat #1 is the button
Seat 1: S1cker_0ne ($39.92 in chips) 
Seat 2: schatun774 ($14.90 in chips) 
Seat 3: Odmincheg ($25.35 in chips) 
Seat 4: matiko09 ($30.94 in chips) 
Seat 5: PoMa3aH ($28.35 in chips) 
schatun774: posts small blind $0.10
Odmincheg: posts big blind $0.25
*** HOLE CARDS ***
Dealt to matiko09 [9c 5h]
matiko09: folds 
PoMa3aH: raises $0.51 to $0.76
S1cker_0ne: folds 
schatun774: folds 
Odmincheg: folds 
Uncalled bet ($0.51) returned to PoMa3aH
PoMa3aH collected $0.60 from pot
PoMa3aH: doesn't show hand 
*** SUMMARY ***
Total pot $0.60 | Rake $0 
Seat 1: S1cker_0ne (button) folded before Flop (didn't bet)
Seat 2: schatun774 (small blind) folded before Flop
Seat 3: Odmincheg (big blind) folded before Flop
Seat 4: matiko09 folded before Flop (didn't bet)
Seat 5: PoMa3aH collected ($0.60)





PokerStars Hand #148211560207:  Hold'em No Limit ($0.10/$0.25 USD) - 2016/02/04 11:50:55 CET [2016/02/04 5:50:55 ET]
Table 'Procyon III' 6-max Seat #1 is the button
Seat 1: S1cker_0ne ($25 in chips) 
Seat 2: k4rloos ($25 in chips) 
Seat 3: sebodrobil ($11.88 in chips) 
Seat 4: Wwwasian ($25.35 in chips) 
Seat 5: kAfRiNiUs ($26.13 in chips) 
Seat 6: matiko09 ($25 in chips) 
k4rloos: posts small blind $0.10
sebodrobil: posts big blind $0.25
*** HOLE CARDS ***
Dealt to matiko09 [Qs Kh]
Wwwasian: folds 
kAfRiNiUs: folds 
matiko09: raises $0.50 to $0.75
S1cker_0ne: folds 
k4rloos: folds 
sebodrobil: calls $0.50
*** FLOP *** [Td 3s 7d]
sebodrobil: checks 
matiko09: checks 
*** TURN *** [Td 3s 7d] [8h]
sebodrobil: bets $0.50
matiko09: folds 
Uncalled bet ($0.50) returned to sebodrobil
sebodrobil collected $1.53 from pot
*** SUMMARY ***
Total pot $1.60 | Rake $0.07 
Board [Td 3s 7d 8h]
Seat 1: S1cker_0ne (button) folded before Flop (didn't bet)
Seat 2: k4rloos (small blind) folded before Flop
Seat 3: sebodrobil (big blind) collected ($1.53)
Seat 4: Wwwasian folded before Flop (didn't bet)
Seat 5: kAfRiNiUs folded before Flop (didn't bet)
Seat 6: matiko09 folded on the Turn





PokerStars Hand #148211562507:  Hold'em No Limit ($0.10/$0.25 USD) - 2016/02/04 11:50:59 CET [2016/02/04 5:50:59 ET]
Table 'Thora II' 6-max Seat #2 is the button
Seat 1: S1cker_0ne ($39.92 in chips) 
Seat 2: schatun774 ($14.80 in chips) 
Seat 3: Odmincheg ($25.10 in chips) 
Seat 4: matiko09 ($30.94 in chips) 
Seat 5: PoMa3aH ($28.70 in chips) 
ELPAYAS0 joins the table at seat #6 
Odmincheg: posts small blind $0.10
matiko09: posts big blind $0.25
*** HOLE CARDS ***
Dealt to matiko09 [5h 8c]
PoMa3aH: folds 
S1cker_0ne: folds 
schatun774: calls $0.25
Odmincheg: raises $1 to $1.25
matiko09: folds 
schatun774: calls $1
*** FLOP *** [As 2d 3h]
Odmincheg: bets $1.31
schatun774: calls $1.31
*** TURN *** [As 2d 3h] [7s]
Odmincheg: checks 
schatun774: bets $1
Odmincheg: folds 
Uncalled bet ($1) returned to schatun774
schatun774 collected $5.13 from pot
schatun774: doesn't show hand 
*** SUMMARY ***
Total pot $5.37 | Rake $0.24 
Board [As 2d 3h 7s]
Seat 1: S1cker_0ne folded before Flop (didn't bet)
Seat 2: schatun774 (button) collected ($5.13)
Seat 3: Odmincheg (small blind) folded on the Turn
Seat 4: matiko09 (big blind) folded before Flop
Seat 5: PoMa3aH folded before Flop (didn't bet)





PokerStars Hand #148211562645:  Hold'em No Limit (€0.10/€0.25 EUR) - 2016/02/04 11:51:00 CET [2016/02/04 5:51:00 ET]
Table 'Lilaea III' 6-max Seat #5 is the button
Seat 1: matiko09 (€31.37 in chips) 
Seat 3: uzzy20 (€30.35 in chips) 
Seat 4: Wwwasian (€35 in chips) 
Seat 5: marchuchok (€25 in chips) 
spid3rix will be allowed to play after the button
matiko09: posts small blind €0.10
Yegoriy: is sitting out 
uzzy20: posts big blind €0.25
*** HOLE CARDS ***
Dealt to matiko09 [9s Td]
Wwwasian: raises €0.45 to €0.70
marchuchok: folds 
matiko09: folds 
Yegoriy leaves the table
uzzy20: folds 
Uncalled bet (€0.45) returned to Wwwasian
Wwwasian collected €0.60 from pot
Wwwasian: doesn't show hand 
*** SUMMARY ***
Total pot €0.60 | Rake €0 
Seat 1: matiko09 (small blind) folded before Flop
Seat 3: uzzy20 (big blind) folded before Flop
Seat 4: Wwwasian collected (€0.60)
Seat 5: marchuchok (button) folded before Flop (didn't bet)





PokerStars Hand #148211569210:  Hold'em No Limit ($0.10/$0.25 USD) - 2016/02/04 11:51:12 CET [2016/02/04 5:51:12 ET]
Table 'Hungaria II' 6-max Seat #1 is the button
Seat 1: Jo_Medici ($25.73 in chips) 
Seat 2: MaurerXL82 ($26.39 in chips) 
Seat 3: MAO_DZEDYN_S ($25 in chips) 
Seat 4: matiko09 ($25.95 in chips) 
Seat 6: droog2 ($37.23 in chips) 
MaurerXL82: posts small blind $0.10
MAO_DZEDYN_S: posts big blind $0.25
*** HOLE CARDS ***
Dealt to matiko09 [Ts 4c]
matiko09: folds 
droog2: raises $0.50 to $0.75
Jo_Medici: calls $0.75
MaurerXL82: raises $0.50 to $1.25
MAO_DZEDYN_S: folds 
droog2: calls $0.50
Jo_Medici: calls $0.50
*** FLOP *** [Jd Qc 6h]
MaurerXL82: bets $3.82
droog2: calls $3.82
Jo_Medici: folds 
*** TURN *** [Jd Qc 6h] [4d]
MaurerXL82: bets $11.12
droog2: raises $11.12 to $22.24
MaurerXL82: calls $10.20 and is all-in
Uncalled bet ($0.92) returned to droog2
*** RIVER *** [Jd Qc 6h 4d] [4h]
*** SHOW DOWN ***
MaurerXL82: shows [Tc Th] (two pair, Tens and Fours)
droog2: shows [Qh Ad] (two pair, Queens and Fours)
droog2 collected $52.28 from pot
*** SUMMARY ***
Total pot $54.28 | Rake $2 
Board [Jd Qc 6h 4d 4h]
Seat 1: Jo_Medici (button) folded on the Flop
Seat 2: MaurerXL82 (small blind) showed [Tc Th] and lost with two pair, Tens and Fours
Seat 3: MAO_DZEDYN_S (big blind) folded before Flop
Seat 4: matiko09 folded before Flop (didn't bet)
Seat 6: droog2 showed [Qh Ad] and won ($52.28) with two pair, Queens and Fours





PokerStars Hand #148211574002:  Hold'em No Limit (£0.10/£0.25 GBP) - 2016/02/04 11:51:22 CET [2016/02/04 5:51:22 ET]
Table 'Libra II' 6-max Seat #3 is the button
Seat 1: k4rloos (£26.04 in chips) 
Seat 2: matiko09 (£25.73 in chips) 
Seat 3: namex11 (£25 in chips) 
Seat 4: sagiga87 (£28.70 in chips) 
Seat 5: Vedmegatko (£44.40 in chips) 
Seat 6: pescador1522 (£18.86 in chips) 
sagiga87: posts small blind £0.10
Vedmegatko: posts big blind £0.25
*** HOLE CARDS ***
Dealt to matiko09 [6c 4c]
pescador1522: calls £0.25
k4rloos: folds 
matiko09: folds 
namex11: folds 
sagiga87: calls £0.15
Vedmegatko: checks 
*** FLOP *** [Ah Td 2s]
sagiga87: checks 
Vedmegatko: checks 
pescador1522: checks 
*** TURN *** [Ah Td 2s] [9d]
sagiga87: bets £0.25
Vedmegatko: folds 
pescador1522: calls £0.25
*** RIVER *** [Ah Td 2s 9d] [Tc]
sagiga87: bets £0.25
pescador1522: calls £0.25
*** SHOW DOWN ***
sagiga87: shows [9c Kh] (two pair, Tens and Nines)
pescador1522: shows [Qs 9s] (two pair, Tens and Nines)
sagiga87 collected £0.84 from pot
pescador1522 collected £0.83 from pot
*** SUMMARY ***
Total pot £1.75 | Rake £0.08 
Board [Ah Td 2s 9d Tc]
Seat 1: k4rloos folded before Flop (didn't bet)
Seat 2: matiko09 folded before Flop (didn't bet)
Seat 3: namex11 (button) folded before Flop (didn't bet)
Seat 4: sagiga87 (small blind) showed [9c Kh] and won (£0.84) with two pair, Tens and Nines
Seat 5: Vedmegatko (big blind) folded on the Turn
Seat 6: pescador1522 showed [Qs 9s] and won (£0.83) with two pair, Tens and Nines





PokerStars Hand #148211581037:  Hold'em No Limit ($0.10/$0.25 USD) - 2016/02/04 11:51:36 CET [2016/02/04 5:51:36 ET]
Table 'Procyon III' 6-max Seat #2 is the button
Seat 1: S1cker_0ne ($25 in chips) 
Seat 2: k4rloos ($25 in chips) 
Seat 3: sebodrobil ($12.66 in chips) 
Seat 4: Wwwasian ($25.35 in chips) 
Seat 5: kAfRiNiUs ($26.13 in chips) 
Seat 6: matiko09 ($25 in chips) 
sebodrobil: posts small blind $0.10
Wwwasian: posts big blind $0.25
*** HOLE CARDS ***
Dealt to matiko09 [Qs 3c]
kAfRiNiUs: folds 
matiko09: folds 
S1cker_0ne: raises $0.39 to $0.64
k4rloos: folds 
sebodrobil: folds 
Wwwasian: folds 
Uncalled bet ($0.39) returned to S1cker_0ne
S1cker_0ne collected $0.60 from pot
S1cker_0ne: doesn't show hand 
*** SUMMARY ***
Total pot $0.60 | Rake $0 
Seat 1: S1cker_0ne collected ($0.60)
Seat 2: k4rloos (button) folded before Flop (didn't bet)
Seat 3: sebodrobil (small blind) folded before Flop
Seat 4: Wwwasian (big blind) folded before Flop
Seat 5: kAfRiNiUs folded before Flop (didn't bet)
Seat 6: matiko09 folded before Flop (didn't bet)





PokerStars Hand #148211589677:  Hold'em No Limit ($0.10/$0.25 USD) - 2016/02/04 11:51:53 CET [2016/02/04 5:51:53 ET]
Table 'Thora II' 6-max Seat #3 is the button
Seat 1: S1cker_0ne ($39.92 in chips) 
Seat 2: schatun774 ($17.37 in chips) 
Seat 3: Odmincheg ($25 in chips) 
Seat 4: matiko09 ($30.69 in chips) 
Seat 5: PoMa3aH ($28.70 in chips) 
matiko09: posts small blind $0.10
PoMa3aH: posts big blind $0.25
ELPAYAS0: sits out 
*** HOLE CARDS ***
Dealt to matiko09 [4c As]
S1cker_0ne: folds 
schatun774: calls $0.25
Odmincheg: folds 
matiko09: folds 
PoMa3aH: checks 
*** FLOP *** [Jc 8c 2h]
PoMa3aH: checks 
schatun774: checks 
*** TURN *** [Jc 8c 2h] [9s]
PoMa3aH: bets $0.44
schatun774: calls $0.44
*** RIVER *** [Jc 8c 2h 9s] [2s]
PoMa3aH: bets $1.06
schatun774: calls $1.06
*** SHOW DOWN ***
PoMa3aH: shows [2c 4h] (three of a kind, Deuces)
schatun774: mucks hand 
PoMa3aH collected $3.44 from pot
*** SUMMARY ***
Total pot $3.60 | Rake $0.16 
Board [Jc 8c 2h 9s 2s]
Seat 1: S1cker_0ne folded before Flop (didn't bet)
Seat 2: schatun774 mucked [Ac 8h]
Seat 3: Odmincheg (button) folded before Flop (didn't bet)
Seat 4: matiko09 (small blind) folded before Flop
Seat 5: PoMa3aH (big blind) showed [2c 4h] and won ($3.44) with three of a kind, Deuces





PokerStars Hand #148211590105:  Hold'em No Limit (£0.10/£0.25 GBP) - 2016/02/04 11:51:54 CET [2016/02/04 5:51:54 ET]
Table 'Libra II' 6-max Seat #4 is the button
Seat 1: k4rloos (£26.04 in chips) 
Seat 2: matiko09 (£25.73 in chips) 
Seat 3: namex11 (£25 in chips) 
Seat 4: sagiga87 (£28.79 in chips) 
Seat 5: Vedmegatko (£44.15 in chips) 
Seat 6: pescador1522 (£18.94 in chips) 
Vedmegatko: posts small blind £0.10
pescador1522: posts big blind £0.25
*** HOLE CARDS ***
Dealt to matiko09 [5d Ks]
k4rloos: folds 
matiko09: folds 
namex11: folds 
sagiga87: folds 
Vedmegatko: raises £0.50 to £0.75
pescador1522: calls £0.50
*** FLOP *** [4s 4h 5s]
Vedmegatko: checks 
pescador1522: checks 
*** TURN *** [4s 4h 5s] [Ad]
Vedmegatko: checks 
pescador1522: checks 
*** RIVER *** [4s 4h 5s Ad] [Jc]
Vedmegatko: checks 
pescador1522: bets £0.25
Vedmegatko: folds 
Uncalled bet (£0.25) returned to pescador1522
pescador1522 collected £1.43 from pot
pescador1522: doesn't show hand 
*** SUMMARY ***
Total pot £1.50 | Rake £0.07 
Board [4s 4h 5s Ad Jc]
Seat 1: k4rloos folded before Flop (didn't bet)
Seat 2: matiko09 folded before Flop (didn't bet)
Seat 3: namex11 folded before Flop (didn't bet)
Seat 4: sagiga87 (button) folded before Flop (didn't bet)
Seat 5: Vedmegatko (small blind) folded on the River
Seat 6: pescador1522 (big blind) collected (£1.43)





PokerStars Hand #148211589833:  Hold'em No Limit ($0.10/$0.25 USD) - 2016/02/04 11:51:54 CET [2016/02/04 5:51:54 ET]
Table 'Procyon III' 6-max Seat #3 is the button
Seat 1: S1cker_0ne ($25.35 in chips) 
Seat 2: k4rloos ($25 in chips) 
Seat 3: sebodrobil ($12.56 in chips) 
Seat 4: Wwwasian ($25.10 in chips) 
Seat 5: kAfRiNiUs ($26.13 in chips) 
Seat 6: matiko09 ($25 in chips) 
Wwwasian: posts small blind $0.10
kAfRiNiUs: posts big blind $0.25
*** HOLE CARDS ***
Dealt to matiko09 [8s 9d]
matiko09: folds 
S1cker_0ne: folds 
k4rloos: raises $0.50 to $0.75
sebodrobil: folds 
Wwwasian: raises $1.75 to $2.50
kAfRiNiUs: folds 
k4rloos: calls $1.75
*** FLOP *** [2c 6d Ts]
Wwwasian: checks 
k4rloos: bets $3
Wwwasian: folds 
Uncalled bet ($3) returned to k4rloos
k4rloos collected $5.01 from pot
k4rloos: doesn't show hand 
*** SUMMARY ***
Total pot $5.25 | Rake $0.24 
Board [2c 6d Ts]
Seat 1: S1cker_0ne folded before Flop (didn't bet)
Seat 2: k4rloos collected ($5.01)
Seat 3: sebodrobil (button) folded before Flop (didn't bet)
Seat 4: Wwwasian (small blind) folded on the Flop
Seat 5: kAfRiNiUs (big blind) folded before Flop
Seat 6: matiko09 folded before Flop (didn't bet)





PokerStars Hand #148211607058:  Hold'em No Limit ($0.10/$0.25 USD) - 2016/02/04 11:52:27 CET [2016/02/04 5:52:27 ET]
Table 'Thora II' 6-max Seat #4 is the button
Seat 1: S1cker_0ne ($39.92 in chips) 
Seat 2: schatun774 ($15.62 in chips) 
Seat 3: Odmincheg ($25 in chips) 
Seat 4: matiko09 ($30.59 in chips) 
Seat 5: PoMa3aH ($30.39 in chips) 
Seat 6: ELPAYAS0 ($25 in chips) 
PoMa3aH: posts small blind $0.10
ELPAYAS0: posts big blind $0.25
*** HOLE CARDS ***
Dealt to matiko09 [Ts 5s]
S1cker_0ne: folds 
schatun774: folds 
Odmincheg: raises $0.50 to $0.75
matiko09: folds 
PoMa3aH: folds 
ELPAYAS0: calls $0.50
*** FLOP *** [3h Kd 2s]
ELPAYAS0: checks 
Odmincheg: bets $0.76
ELPAYAS0: folds 
Uncalled bet ($0.76) returned to Odmincheg
Odmincheg collected $1.53 from pot
*** SUMMARY ***
Total pot $1.60 | Rake $0.07 
Board [3h Kd 2s]
Seat 1: S1cker_0ne folded before Flop (didn't bet)
Seat 2: schatun774 folded before Flop (didn't bet)
Seat 3: Odmincheg collected ($1.53)
Seat 4: matiko09 (button) folded before Flop (didn't bet)
Seat 5: PoMa3aH (small blind) folded before Flop
Seat 6: ELPAYAS0 (big blind) folded on the Flop





PokerStars Hand #148211606763:  Hold'em No Limit ($0.10/$0.25 USD) - 2016/02/04 11:52:27 CET [2016/02/04 5:52:27 ET]
Table 'Hungaria II' 6-max Seat #3 is the button
Seat 1: Jo_Medici ($25 in chips) 
Seat 3: MAO_DZEDYN_S ($25 in chips) 
Seat 4: matiko09 ($25.95 in chips) 
Seat 6: droog2 ($63.12 in chips) 
matiko09: posts small blind $0.10
droog2: posts big blind $0.25
*** HOLE CARDS ***
Dealt to matiko09 [Jh Qs]
Jo_Medici: folds 
MAO_DZEDYN_S: folds 
matiko09: raises $0.50 to $0.75
droog2: folds 
Uncalled bet ($0.50) returned to matiko09
matiko09 collected $0.50 from pot
matiko09: doesn't show hand 
*** SUMMARY ***
Total pot $0.50 | Rake $0 
Seat 1: Jo_Medici folded before Flop (didn't bet)
Seat 3: MAO_DZEDYN_S (button) folded before Flop (didn't bet)
Seat 4: matiko09 (small blind) collected ($0.50)
Seat 6: droog2 (big blind) folded before Flop





PokerStars Hand #148211614381:  Hold'em No Limit ($0.10/$0.25 USD) - 2016/02/04 11:52:42 CET [2016/02/04 5:52:42 ET]
Table 'Hungaria II' 6-max Seat #4 is the button
Seat 1: Jo_Medici ($25 in chips) 
Seat 2: MaurerXL82 ($12.64 in chips) 
Seat 3: MAO_DZEDYN_S ($25 in chips) 
Seat 4: matiko09 ($26.20 in chips) 
Seat 6: droog2 ($62.87 in chips) 
droog2: posts small blind $0.10
Jo_Medici: posts big blind $0.25
*** HOLE CARDS ***
Dealt to matiko09 [7h Ah]
MaurerXL82: raises $0.25 to $0.50
MAO_DZEDYN_S: calls $0.50
matiko09: folds 
droog2: folds 
Jo_Medici: folds 
*** FLOP *** [Td Th 7d]
MaurerXL82: bets $0.25
MAO_DZEDYN_S: raises $0.72 to $0.97
MaurerXL82: folds 
Uncalled bet ($0.72) returned to MAO_DZEDYN_S
MAO_DZEDYN_S collected $1.77 from pot
MAO_DZEDYN_S: doesn't show hand 
*** SUMMARY ***
Total pot $1.85 | Rake $0.08 
Board [Td Th 7d]
Seat 1: Jo_Medici (big blind) folded before Flop
Seat 2: MaurerXL82 folded on the Flop
Seat 3: MAO_DZEDYN_S collected ($1.77)
Seat 4: matiko09 (button) folded before Flop (didn't bet)
Seat 6: droog2 (small blind) folded before Flop





PokerStars Hand #148211636679:  Hold'em No Limit ($0.10/$0.25 USD) - 2016/02/04 11:53:25 CET [2016/02/04 5:53:25 ET]
Table 'Thora II' 6-max Seat #5 is the button
Seat 1: S1cker_0ne ($39.92 in chips) 
Seat 2: schatun774 ($15.62 in chips) 
Seat 3: Odmincheg ($25.78 in chips) 
Seat 4: matiko09 ($30.59 in chips) 
Seat 5: PoMa3aH ($30.29 in chips) 
Seat 6: ELPAYAS0 ($25 in chips) 
ELPAYAS0: posts small blind $0.10
S1cker_0ne: posts big blind $0.25
*** HOLE CARDS ***
Dealt to matiko09 [6c Qd]
schatun774: calls $0.25
Odmincheg: folds 
matiko09: folds 
PoMa3aH: folds 
ELPAYAS0: folds 
S1cker_0ne: checks 
*** FLOP *** [Kh 7c Ts]
S1cker_0ne: checks 
schatun774: checks 
*** TURN *** [Kh 7c Ts] [2s]
S1cker_0ne: bets $0.30
schatun774: calls $0.30
*** RIVER *** [Kh 7c Ts 2s] [Ks]
S1cker_0ne: checks 
schatun774: checks 
*** SHOW DOWN ***
S1cker_0ne: shows [Tc 6s] (two pair, Kings and Tens)
schatun774: mucks hand 
S1cker_0ne collected $1.15 from pot
*** SUMMARY ***
Total pot $1.20 | Rake $0.05 
Board [Kh 7c Ts 2s Ks]
Seat 1: S1cker_0ne (big blind) showed [Tc 6s] and won ($1.15) with two pair, Kings and Tens
Seat 2: schatun774 mucked [8d Qc]
Seat 3: Odmincheg folded before Flop (didn't bet)
Seat 4: matiko09 folded before Flop (didn't bet)
Seat 5: PoMa3aH (button) folded before Flop (didn't bet)
Seat 6: ELPAYAS0 (small blind) folded before Flop





PokerStars Hand #148211644417:  Hold'em No Limit ($0.10/$0.25 USD) - 2016/02/04 11:53:40 CET [2016/02/04 5:53:40 ET]
Table 'Hungaria II' 6-max Seat #6 is the button
Seat 1: Jo_Medici ($25 in chips) 
Seat 2: MaurerXL82 ($11.89 in chips) 
Seat 3: MAO_DZEDYN_S ($26.02 in chips) 
Seat 4: matiko09 ($26.20 in chips) 
Seat 6: droog2 ($62.77 in chips) 
Jo_Medici: posts small blind $0.10
MaurerXL82: posts big blind $0.25
*** HOLE CARDS ***
Dealt to matiko09 [As Ah]
MAO_DZEDYN_S: folds 
matiko09: raises $0.50 to $0.75
droog2: folds 
Jo_Medici: folds 
MaurerXL82: calls $0.50
*** FLOP *** [4s Td 7h]
MaurerXL82: checks 
matiko09: bets $1.25
MaurerXL82: calls $1.25
*** TURN *** [4s Td 7h] [9s]
MaurerXL82: bets $3.92
matiko09: raises $7.64 to $11.56
MaurerXL82: folds 
Uncalled bet ($7.64) returned to matiko09
matiko09 collected $11.40 from pot
matiko09: doesn't show hand 
*** SUMMARY ***
Total pot $11.94 | Rake $0.54 
Board [4s Td 7h 9s]
Seat 1: Jo_Medici (small blind) folded before Flop
Seat 2: MaurerXL82 (big blind) folded on the Turn
Seat 3: MAO_DZEDYN_S folded before Flop (didn't bet)
Seat 4: matiko09 collected ($11.40)
Seat 6: droog2 (button) folded before Flop (didn't bet)





PokerStars Hand #148211649613:  Hold'em No Limit ($0.10/$0.25 USD) - 2016/02/04 11:53:50 CET [2016/02/04 5:53:50 ET]
Table 'Thora II' 6-max Seat #6 is the button
Seat 1: S1cker_0ne ($40.52 in chips) 
Seat 2: schatun774 ($15.07 in chips) 
Seat 3: Odmincheg ($25.78 in chips) 
Seat 4: matiko09 ($30.59 in chips) 
Seat 5: PoMa3aH ($30.29 in chips) 
Seat 6: ELPAYAS0 ($25 in chips) 
S1cker_0ne: posts small blind $0.10
schatun774: posts big blind $0.25
*** HOLE CARDS ***
Dealt to matiko09 [Kc 3d]
Odmincheg: folds 
matiko09: folds 
PoMa3aH: raises $0.51 to $0.76
ELPAYAS0: folds 
S1cker_0ne: folds 
schatun774: calls $0.51
*** FLOP *** [9s 8d Qc]
schatun774: bets $0.25
PoMa3aH: calls $0.25
*** TURN *** [9s 8d Qc] [4d]
schatun774: bets $0.25
PoMa3aH: calls $0.25
*** RIVER *** [9s 8d Qc 4d] [As]
schatun774: bets $0.25
PoMa3aH: folds 
Uncalled bet ($0.25) returned to schatun774
schatun774 collected $2.50 from pot
schatun774: doesn't show hand 
*** SUMMARY ***
Total pot $2.62 | Rake $0.12 
Board [9s 8d Qc 4d As]
Seat 1: S1cker_0ne (small blind) folded before Flop
Seat 2: schatun774 (big blind) collected ($2.50)
Seat 3: Odmincheg folded before Flop (didn't bet)
Seat 4: matiko09 folded before Flop (didn't bet)
Seat 5: PoMa3aH folded on the River
Seat 6: ELPAYAS0 (button) folded before Flop (didn't bet)





PokerStars Hand #148211668004:  Hold'em No Limit ($0.10/$0.25 USD) - 2016/02/04 11:54:26 CET [2016/02/04 5:54:26 ET]
Table 'Thora II' 6-max Seat #1 is the button
Seat 1: S1cker_0ne ($40.42 in chips) 
Seat 2: schatun774 ($16.31 in chips) 
Seat 3: Odmincheg ($25.78 in chips) 
Seat 4: matiko09 ($30.59 in chips) 
Seat 5: PoMa3aH ($29.03 in chips) 
Seat 6: ELPAYAS0 ($25 in chips) 
schatun774: posts small blind $0.10
Odmincheg: posts big blind $0.25
*** HOLE CARDS ***
Dealt to matiko09 [5c 8d]
matiko09: folds 
PoMa3aH: folds 
ELPAYAS0: raises $0.37 to $0.62
S1cker_0ne: folds 
schatun774: calls $0.52
Odmincheg: folds 
*** FLOP *** [7c Ks 9c]
schatun774: checks 
ELPAYAS0: bets $0.95
schatun774: folds 
Uncalled bet ($0.95) returned to ELPAYAS0
ELPAYAS0 collected $1.42 from pot
ELPAYAS0: doesn't show hand 
*** SUMMARY ***
Total pot $1.49 | Rake $0.07 
Board [7c Ks 9c]
Seat 1: S1cker_0ne (button) folded before Flop (didn't bet)
Seat 2: schatun774 (small blind) folded on the Flop
Seat 3: Odmincheg (big blind) folded before Flop
Seat 4: matiko09 folded before Flop (didn't bet)
Seat 5: PoMa3aH folded before Flop (didn't bet)
Seat 6: ELPAYAS0 collected ($1.42)





PokerStars Hand #148211673917:  Hold'em No Limit ($0.10/$0.25 USD) - 2016/02/04 11:54:38 CET [2016/02/04 5:54:38 ET]
Table 'Hungaria II' 6-max Seat #1 is the button
Seat 1: Jo_Medici ($25 in chips) 
Seat 2: MaurerXL82 ($5.97 in chips) 
Seat 3: MAO_DZEDYN_S ($26.02 in chips) 
Seat 4: matiko09 ($31.68 in chips) 
Seat 6: droog2 ($62.77 in chips) 
MaurerXL82: posts small blind $0.10
MAO_DZEDYN_S: posts big blind $0.25
nnVinokurov: sits out 
*** HOLE CARDS ***
Dealt to matiko09 [As Qd]
matiko09: raises $0.50 to $0.75
droog2: calls $0.75
Jo_Medici: calls $0.75
MaurerXL82: calls $0.65
MAO_DZEDYN_S: folds 
*** FLOP *** [6s 2d 3h]
MaurerXL82: bets $3.10
matiko09: folds 
droog2: raises $3.10 to $6.20
Jo_Medici: folds 
MaurerXL82: calls $2.12 and is all-in
Uncalled bet ($0.98) returned to droog2
*** TURN *** [6s 2d 3h] [6c]
*** RIVER *** [6s 2d 3h 6c] [3d]
*** SHOW DOWN ***
MaurerXL82: shows [Qh Qs] (two pair, Queens and Sixes)
droog2: shows [Jh Jd] (two pair, Jacks and Sixes)
MaurerXL82 collected $13.07 from pot
*** SUMMARY ***
Total pot $13.69 | Rake $0.62 
Board [6s 2d 3h 6c 3d]
Seat 1: Jo_Medici (button) folded on the Flop
Seat 2: MaurerXL82 (small blind) showed [Qh Qs] and won ($13.07) with two pair, Queens and Sixes
Seat 3: MAO_DZEDYN_S (big blind) folded before Flop
Seat 4: matiko09 folded on the Flop
Seat 6: droog2 showed [Jh Jd] and lost with two pair, Jacks and Sixes





PokerStars Hand #148216741005:  Hold'em No Limit ($0.50/$1.00 USD) - 2016/02/04 14:21:32 CET [2016/02/04 8:21:32 ET]
Table 'Arneb II' 9-max Seat #7 is the button
Seat 1: matiko09 ($100 in chips) 
Seat 2: sanpidk ($100 in chips) 
Seat 3: brille-390 ($100 in chips) 
Seat 4: Venomous100% ($100 in chips) 
Seat 5: lixiangli ($100 in chips) 
Seat 6: Sweden_Pound ($100 in chips) 
Seat 7: melitakas ($100 in chips) 
Seat 8: tedbadger9 ($80 in chips) 
Seat 9: tipner ($100 in chips) 
tedbadger9: posts small blind $0.50
tipner: posts big blind $1
*** HOLE CARDS ***
Dealt to matiko09 [7h 3h]
matiko09: folds 
sanpidk: folds 
brille-390: folds 
Venomous100%: folds 
lixiangli has timed out
lixiangli: folds 
Sweden_Pound: raises $1 to $2
melitakas: folds 
tedbadger9: folds 
tipner: folds 
Uncalled bet ($1) returned to Sweden_Pound
Sweden_Pound collected $2.50 from pot
Sweden_Pound: doesn't show hand 
*** SUMMARY ***
Total pot $2.50 | Rake $0 
Seat 1: matiko09 folded before Flop (didn't bet)
Seat 2: sanpidk folded before Flop (didn't bet)
Seat 3: brille-390 folded before Flop (didn't bet)
Seat 4: Venomous100% folded before Flop (didn't bet)
Seat 5: lixiangli folded before Flop (didn't bet)
Seat 6: Sweden_Pound collected ($2.50)
Seat 7: melitakas (button) folded before Flop (didn't bet)
Seat 8: tedbadger9 (small blind) folded before Flop
Seat 9: tipner (big blind) folded before Flop





PokerStars Hand #148216818009:  Hold'em No Limit ($0.50/$1.00 USD) - 2016/02/04 14:23:32 CET [2016/02/04 8:23:32 ET]
Table 'Arneb II' 9-max Seat #8 is the button
Seat 1: matiko09 ($100 in chips) 
Seat 2: sanpidk ($100 in chips) 
Seat 3: brille-390 ($100 in chips) 
Seat 4: Venomous100% ($100 in chips) 
Seat 5: lixiangli ($100 in chips) 
Seat 6: Sweden_Pound ($101.50 in chips) 
Seat 7: melitakas ($100 in chips) 
Seat 8: tedbadger9 ($79.50 in chips) 
Seat 9: tipner ($100 in chips) 
tipner: posts small blind $0.50
matiko09: posts big blind $1
*** HOLE CARDS ***
Dealt to matiko09 [8c Ac]
sanpidk: folds 
brille-390: raises $1.25 to $2.25
Venomous100%: folds 
lixiangli: folds 
Sweden_Pound: folds 
melitakas: folds 
tedbadger9: calls $2.25
tipner: folds 
matiko09: folds 
*** FLOP *** [Ks Jh 9s]
brille-390: checks 
tedbadger9: checks 
*** TURN *** [Ks Jh 9s] [6h]
brille-390: bets $2.50
tedbadger9: calls $2.50
*** RIVER *** [Ks Jh 9s 6h] [6d]
brille-390: bets $2.50
tedbadger9: folds 
Uncalled bet ($2.50) returned to brille-390
brille-390 collected $10.50 from pot
brille-390: doesn't show hand 
*** SUMMARY ***
Total pot $11 | Rake $0.50 
Board [Ks Jh 9s 6h 6d]
Seat 1: matiko09 (big blind) folded before Flop
Seat 2: sanpidk folded before Flop (didn't bet)
Seat 3: brille-390 collected ($10.50)
Seat 4: Venomous100% folded before Flop (didn't bet)
Seat 5: lixiangli folded before Flop (didn't bet)
Seat 6: Sweden_Pound folded before Flop (didn't bet)
Seat 7: melitakas folded before Flop (didn't bet)
Seat 8: tedbadger9 (button) folded on the River
Seat 9: tipner (small blind) folded before Flop





PokerStars Hand #148216864485:  Hold'em No Limit ($0.50/$1.00 USD) - 2016/02/04 14:24:43 CET [2016/02/04 8:24:43 ET]
Table 'Arneb II' 9-max Seat #9 is the button
Seat 1: matiko09 ($100 in chips) 
Seat 2: sanpidk ($100 in chips) 
Seat 3: brille-390 ($105.75 in chips) 
Seat 4: Venomous100% ($100 in chips) 
Seat 5: lixiangli ($100 in chips) 
Seat 6: Sweden_Pound ($101.50 in chips) 
Seat 7: melitakas ($100 in chips) 
Seat 8: tedbadger9 ($74.75 in chips) 
Seat 9: tipner ($100 in chips) 
matiko09: posts small blind $0.50
sanpidk: posts big blind $1
*** HOLE CARDS ***
Dealt to matiko09 [Th Kh]
brille-390: folds 
Venomous100%: folds 
lixiangli: folds 
Sweden_Pound: folds 
melitakas: folds 
tedbadger9: folds 
tipner: raises $1.50 to $2.50
matiko09: raises $6.50 to $9
sanpidk: folds 
tipner: folds 
Uncalled bet ($6.50) returned to matiko09
matiko09 collected $6 from pot
matiko09: doesn't show hand 
*** SUMMARY ***
Total pot $6 | Rake $0 
Seat 1: matiko09 (small blind) collected ($6)
Seat 2: sanpidk (big blind) folded before Flop
Seat 3: brille-390 folded before Flop (didn't bet)
Seat 4: Venomous100% folded before Flop (didn't bet)
Seat 5: lixiangli folded before Flop (didn't bet)
Seat 6: Sweden_Pound folded before Flop (didn't bet)
Seat 7: melitakas folded before Flop (didn't bet)
Seat 8: tedbadger9 folded before Flop (didn't bet)
Seat 9: tipner (button) folded before Flop





PokerStars Hand #148216904660:  Hold'em No Limit ($0.50/$1.00 USD) - 2016/02/04 14:25:45 CET [2016/02/04 8:25:45 ET]
Table 'Arneb II' 9-max Seat #1 is the button
Seat 1: matiko09 ($103.50 in chips) 
Seat 2: sanpidk ($100 in chips) 
Seat 3: brille-390 ($105.75 in chips) 
Seat 4: Venomous100% ($100 in chips) 
Seat 5: lixiangli ($100 in chips) 
Seat 6: Sweden_Pound ($101.50 in chips) 
Seat 7: melitakas ($100 in chips) 
Seat 8: tedbadger9 ($74.75 in chips) 
Seat 9: tipner ($100 in chips) 
sanpidk: posts small blind $0.50
brille-390: posts big blind $1
*** HOLE CARDS ***
Dealt to matiko09 [5h Js]
Venomous100%: folds 
lixiangli: folds 
Sweden_Pound: raises $2 to $3
melitakas: calls $3
tedbadger9: folds 
tipner: folds 
matiko09: folds 
sanpidk: folds 
brille-390: folds 
*** FLOP *** [As 6s 8d]
Sweden_Pound: bets $4.65
melitakas: calls $4.65
*** TURN *** [As 6s 8d] [8h]
Sweden_Pound: bets $10.43
melitakas: calls $10.43
*** RIVER *** [As 6s 8d 8h] [9s]
Sweden_Pound: bets $20.50
melitakas: calls $20.50
*** SHOW DOWN ***
Sweden_Pound: shows [Ac Kh] (two pair, Aces and Eights)
melitakas: mucks hand 
Sweden_Pound collected $75.86 from pot
*** SUMMARY ***
Total pot $78.66 | Rake $2.80 
Board [As 6s 8d 8h 9s]
Seat 1: matiko09 (button) folded before Flop (didn't bet)
Seat 2: sanpidk (small blind) folded before Flop
Seat 3: brille-390 (big blind) folded before Flop
Seat 4: Venomous100% folded before Flop (didn't bet)
Seat 5: lixiangli folded before Flop (didn't bet)
Seat 6: Sweden_Pound showed [Ac Kh] and won ($75.86) with two pair, Aces and Eights
Seat 7: melitakas mucked [Ad 4d]
Seat 8: tedbadger9 folded before Flop (didn't bet)
Seat 9: tipner folded before Flop (didn't bet)





PokerStars Hand #148216953959:  Hold'em No Limit ($0.50/$1.00 USD) - 2016/02/04 14:27:02 CET [2016/02/04 8:27:02 ET]
Table 'Arneb II' 9-max Seat #2 is the button
Seat 1: matiko09 ($103.50 in chips) 
Seat 2: sanpidk ($100 in chips) 
Seat 3: brille-390 ($104.75 in chips) 
Seat 4: Venomous100% ($100 in chips) 
Seat 5: lixiangli ($100 in chips) 
Seat 6: Sweden_Pound ($138.78 in chips) 
Seat 7: melitakas ($100 in chips) 
Seat 8: tedbadger9 ($74.75 in chips) 
Seat 9: tipner ($100 in chips) 
brille-390: posts small blind $0.50
Venomous100%: posts big blind $1
*** HOLE CARDS ***
Dealt to matiko09 [Jc Qc]
lixiangli: folds 
Sweden_Pound: folds 
melitakas: raises $1 to $2
tedbadger9: raises $5 to $7
tipner: raises $10 to $17
matiko09: folds 
sanpidk: folds 
brille-390: folds 
Venomous100%: folds 
melitakas: folds 
tedbadger9: folds 
Uncalled bet ($10) returned to tipner
tipner collected $17.50 from pot
tipner: doesn't show hand 
*** SUMMARY ***
Total pot $17.50 | Rake $0 
Seat 1: matiko09 folded before Flop (didn't bet)
Seat 2: sanpidk (button) folded before Flop (didn't bet)
Seat 3: brille-390 (small blind) folded before Flop
Seat 4: Venomous100% (big blind) folded before Flop
Seat 5: lixiangli folded before Flop (didn't bet)
Seat 6: Sweden_Pound folded before Flop (didn't bet)
Seat 7: melitakas folded before Flop
Seat 8: tedbadger9 folded before Flop
Seat 9: tipner collected ($17.50)





PokerStars Hand #148216992542:  Hold'em No Limit ($0.50/$1.00 USD) - 2016/02/04 14:28:01 CET [2016/02/04 8:28:01 ET]
Table 'Arneb II' 9-max Seat #3 is the button
Seat 1: matiko09 ($103.50 in chips) 
Seat 2: sanpidk ($100 in chips) 
Seat 3: brille-390 ($104.25 in chips) 
Seat 4: Venomous100% ($100 in chips) 
Seat 5: lixiangli ($100 in chips) 
Seat 6: Sweden_Pound ($138.78 in chips) 
Seat 7: melitakas ($100 in chips) 
Seat 8: tedbadger9 ($67.75 in chips) 
Seat 9: tipner ($110.50 in chips) 
Venomous100%: posts small blind $0.50
lixiangli: posts big blind $1
*** HOLE CARDS ***
Dealt to matiko09 [5s Tc]
Sweden_Pound: raises $2 to $3
melitakas: folds 
tedbadger9: folds 
tipner: folds 
matiko09: folds 
sanpidk: folds 
brille-390: folds 
Venomous100%: folds 
lixiangli: folds 
Uncalled bet ($2) returned to Sweden_Pound
Sweden_Pound collected $2.50 from pot
Sweden_Pound: doesn't show hand 
*** SUMMARY ***
Total pot $2.50 | Rake $0 
Seat 1: matiko09 folded before Flop (didn't bet)
Seat 2: sanpidk folded before Flop (didn't bet)
Seat 3: brille-390 (button) folded before Flop (didn't bet)
Seat 4: Venomous100% (small blind) folded before Flop
Seat 5: lixiangli (big blind) folded before Flop
Seat 6: Sweden_Pound collected ($2.50)
Seat 7: melitakas folded before Flop (didn't bet)
Seat 8: tedbadger9 folded before Flop (didn't bet)
Seat 9: tipner folded before Flop (didn't bet)





PokerStars Hand #148217014103:  Hold'em No Limit ($0.50/$1.00 USD) - 2016/02/04 14:28:34 CET [2016/02/04 8:28:34 ET]
Table 'Arneb II' 9-max Seat #4 is the button
Seat 1: matiko09 ($103.50 in chips) 
Seat 2: sanpidk ($100 in chips) 
Seat 3: brille-390 ($104.25 in chips) 
Seat 4: Venomous100% ($100 in chips) 
Seat 5: lixiangli ($99 in chips) 
Seat 6: Sweden_Pound ($140.28 in chips) 
Seat 7: melitakas ($100 in chips) 
Seat 8: tedbadger9 ($67.75 in chips) 
Seat 9: tipner ($110.50 in chips) 
lixiangli: posts small blind $0.50
Sweden_Pound: posts big blind $1
*** HOLE CARDS ***
Dealt to matiko09 [Ad 4h]
melitakas: raises $1 to $2
tedbadger9: folds 
tipner: folds 
matiko09: folds 
sanpidk: folds 
brille-390: folds 
Venomous100%: folds 
lixiangli: calls $1.50
Sweden_Pound: folds 
*** FLOP *** [Jd Qh Jh]
lixiangli: checks 
melitakas: bets $2
lixiangli: calls $2
*** TURN *** [Jd Qh Jh] [Ac]
lixiangli: checks 
melitakas: bets $4
lixiangli: folds 
Uncalled bet ($4) returned to melitakas
melitakas collected $8.60 from pot
*** SUMMARY ***
Total pot $9 | Rake $0.40 
Board [Jd Qh Jh Ac]
Seat 1: matiko09 folded before Flop (didn't bet)
Seat 2: sanpidk folded before Flop (didn't bet)
Seat 3: brille-390 folded before Flop (didn't bet)
Seat 4: Venomous100% (button) folded before Flop (didn't bet)
Seat 5: lixiangli (small blind) folded on the Turn
Seat 6: Sweden_Pound (big blind) folded before Flop
Seat 7: melitakas collected ($8.60)
Seat 8: tedbadger9 folded before Flop (didn't bet)
Seat 9: tipner folded before Flop (didn't bet)





PokerStars Hand #148217049382:  Hold'em No Limit ($0.50/$1.00 USD) - 2016/02/04 14:29:28 CET [2016/02/04 8:29:28 ET]
Table 'Arneb II' 9-max Seat #5 is the button
Seat 1: matiko09 ($103.50 in chips) 
Seat 2: sanpidk ($100 in chips) 
Seat 3: brille-390 ($104.25 in chips) 
Seat 4: Venomous100% ($100 in chips) 
Seat 5: lixiangli ($95 in chips) 
Seat 6: Sweden_Pound ($139.28 in chips) 
Seat 7: melitakas ($104.60 in chips) 
Seat 8: tedbadger9 ($67.75 in chips) 
Seat 9: tipner ($110.50 in chips) 
Sweden_Pound: posts small blind $0.50
melitakas: posts big blind $1
*** HOLE CARDS ***
Dealt to matiko09 [8s 6s]
tedbadger9: folds 
tipner: folds 
matiko09: folds 
sanpidk: folds 
brille-390: folds 
Venomous100%: folds 
lixiangli: folds 
Sweden_Pound: folds 
Uncalled bet ($0.50) returned to melitakas
melitakas collected $1 from pot
*** SUMMARY ***
Total pot $1 | Rake $0 
Seat 1: matiko09 folded before Flop (didn't bet)
Seat 2: sanpidk folded before Flop (didn't bet)
Seat 3: brille-390 folded before Flop (didn't bet)
Seat 4: Venomous100% folded before Flop (didn't bet)
Seat 5: lixiangli (button) folded before Flop (didn't bet)
Seat 6: Sweden_Pound (small blind) folded before Flop
Seat 7: melitakas (big blind) collected ($1)
Seat 8: tedbadger9 folded before Flop (didn't bet)
Seat 9: tipner folded before Flop (didn't bet)





PokerStars Hand #148217070501:  Hold'em No Limit ($0.50/$1.00 USD) - 2016/02/04 14:30:01 CET [2016/02/04 8:30:01 ET]
Table 'Arneb II' 9-max Seat #6 is the button
Seat 1: matiko09 ($103.50 in chips) 
Seat 2: sanpidk ($100 in chips) 
Seat 3: brille-390 ($104.25 in chips) 
Seat 4: Venomous100% ($100 in chips) 
Seat 5: lixiangli ($95 in chips) 
Seat 6: Sweden_Pound ($138.78 in chips) 
Seat 7: melitakas ($105.10 in chips) 
Seat 8: tedbadger9 ($67.75 in chips) 
Seat 9: tipner ($110.50 in chips) 
melitakas: posts small blind $0.50
tedbadger9: posts big blind $1
*** HOLE CARDS ***
Dealt to matiko09 [7s 9h]
tipner: raises $2 to $3
matiko09: folds 
sanpidk: folds 
brille-390: calls $3
Venomous100%: folds 
lixiangli: folds 
Sweden_Pound: calls $3
melitakas: folds 
tedbadger9: calls $2
*** FLOP *** [3s 4h Js]
tedbadger9: checks 
tipner: checks 
brille-390: checks 
Sweden_Pound: bets $7.76
tedbadger9: folds 
tipner: folds 
brille-390: folds 
Uncalled bet ($7.76) returned to Sweden_Pound
Sweden_Pound collected $11.94 from pot
Sweden_Pound: doesn't show hand 
*** SUMMARY ***
Total pot $12.50 | Rake $0.56 
Board [3s 4h Js]
Seat 1: matiko09 folded before Flop (didn't bet)
Seat 2: sanpidk folded before Flop (didn't bet)
Seat 3: brille-390 folded on the Flop
Seat 4: Venomous100% folded before Flop (didn't bet)
Seat 5: lixiangli folded before Flop (didn't bet)
Seat 6: Sweden_Pound (button) collected ($11.94)
Seat 7: melitakas (small blind) folded before Flop
Seat 8: tedbadger9 (big blind) folded on the Flop
Seat 9: tipner folded on the Flop





PokerStars Hand #148217089631:  Hold'em No Limit ($0.50/$1.00 USD) - 2016/02/04 14:30:29 CET [2016/02/04 8:30:29 ET]
Table 'Sodankyla' 9-max Seat #6 is the button
Seat 1: sanpidk ($100 in chips) 
Seat 2: Sweden_Pound ($100 in chips) 
Seat 3: lumen21 ($100 in chips) 
Seat 4: tipner ($100 in chips) 
Seat 5: matiko09 ($100 in chips) 
Seat 6: 9lKBXKTT6 ($100 in chips) 
Seat 7: RoadtoNepal ($100 in chips) 
Seat 8: Arunas71 ($60 in chips) 
Seat 9: TheDoctor635 ($66.39 in chips) 
RoadtoNepal: posts small blind $0.50
Arunas71: posts big blind $1
*** HOLE CARDS ***
Dealt to matiko09 [Jh Kc]
TheDoctor635: folds 
sanpidk: folds 
Sweden_Pound: raises $2 to $3
lumen21: folds 
tipner: folds 
matiko09: folds 
9lKBXKTT6: folds 
RoadtoNepal: folds 
Arunas71: folds 
Uncalled bet ($2) returned to Sweden_Pound
Sweden_Pound collected $2.50 from pot
Sweden_Pound: doesn't show hand 
*** SUMMARY ***
Total pot $2.50 | Rake $0 
Seat 1: sanpidk folded before Flop (didn't bet)
Seat 2: Sweden_Pound collected ($2.50)
Seat 3: lumen21 folded before Flop (didn't bet)
Seat 4: tipner folded before Flop (didn't bet)
Seat 5: matiko09 folded before Flop (didn't bet)
Seat 6: 9lKBXKTT6 (button) folded before Flop (didn't bet)
Seat 7: RoadtoNepal (small blind) folded before Flop
Seat 8: Arunas71 (big blind) folded before Flop
Seat 9: TheDoctor635 folded before Flop (didn't bet)





PokerStars Hand #148217119360:  Hold'em No Limit (€0.50/€1.00 EUR) - 2016/02/04 14:31:14 CET [2016/02/04 8:31:14 ET]
Table 'Ostenia' 9-max Seat #5 is the button
Seat 1: matiko09 (€100 in chips) 
Seat 2: tipner (€100 in chips) 
Seat 3: sanpidk (€100 in chips) 
Seat 4: er13to (€100 in chips) 
Seat 5: Sweden_Pound (€100 in chips) 
Seat 6: melitakas (€100 in chips) 
Seat 7: RoadtoNepal (€100 in chips) 
Seat 8: Venomous100% (€100 in chips) 
Seat 9: Dachish (€70 in chips) 
melitakas: posts small blind €0.50
RoadtoNepal: posts big blind €1
*** HOLE CARDS ***
Dealt to matiko09 [9s 2c]
Venomous100%: folds 
Dachish: folds 
matiko09: folds 
tipner: folds 
sanpidk: folds 
er13to: raises €1.50 to €2.50
Sweden_Pound: folds 
melitakas: calls €2
RoadtoNepal: folds 
*** FLOP *** [7d 3h Qc]
melitakas: checks 
er13to: bets €3.78
melitakas: calls €3.78
*** TURN *** [7d 3h Qc] [Qd]
melitakas: checks 
er13to: checks 
*** RIVER *** [7d 3h Qc Qd] [7s]
melitakas: bets €7
er13to: folds 
Uncalled bet (€7) returned to melitakas
melitakas collected €12.95 from pot
*** SUMMARY ***
Total pot €13.56 | Rake €0.61 
Board [7d 3h Qc Qd 7s]
Seat 1: matiko09 folded before Flop (didn't bet)
Seat 2: tipner folded before Flop (didn't bet)
Seat 3: sanpidk folded before Flop (didn't bet)
Seat 4: er13to folded on the River
Seat 5: Sweden_Pound (button) folded before Flop (didn't bet)
Seat 6: melitakas (small blind) collected (€12.95)
Seat 7: RoadtoNepal (big blind) folded before Flop
Seat 8: Venomous100% folded before Flop (didn't bet)
Seat 9: Dachish folded before Flop (didn't bet)





PokerStars Hand #148217133206:  Hold'em No Limit ($0.50/$1.00 USD) - 2016/02/04 14:31:35 CET [2016/02/04 8:31:35 ET]
Table 'Arneb II' 9-max Seat #7 is the button
Seat 1: matiko09 ($103.50 in chips) 
Seat 2: sanpidk ($100 in chips) 
Seat 3: brille-390 ($101.25 in chips) 
Seat 4: Venomous100% ($100 in chips) 
Seat 5: lixiangli ($95 in chips) 
Seat 6: Sweden_Pound ($147.72 in chips) 
Seat 7: melitakas ($104.60 in chips) 
Seat 8: tedbadger9 ($64.75 in chips) 
Seat 9: tipner ($107.50 in chips) 
tedbadger9: posts small blind $0.50
tipner: posts big blind $1
*** HOLE CARDS ***
Dealt to matiko09 [7d 5d]
matiko09: folds 
sanpidk: folds 
brille-390: raises $1.25 to $2.25
Venomous100%: folds 
lixiangli: folds 
Sweden_Pound: folds 
melitakas: folds 
tedbadger9: calls $1.75
tipner: calls $1.25
*** FLOP *** [2d 7c 2h]
tedbadger9: checks 
tipner: checks 
brille-390: bets $3
tedbadger9: folds 
tipner: folds 
Uncalled bet ($3) returned to brille-390
brille-390 collected $6.45 from pot
brille-390: doesn't show hand 
*** SUMMARY ***
Total pot $6.75 | Rake $0.30 
Board [2d 7c 2h]
Seat 1: matiko09 folded before Flop (didn't bet)
Seat 2: sanpidk folded before Flop (didn't bet)
Seat 3: brille-390 collected ($6.45)
Seat 4: Venomous100% folded before Flop (didn't bet)
Seat 5: lixiangli folded before Flop (didn't bet)
Seat 6: Sweden_Pound folded before Flop (didn't bet)
Seat 7: melitakas (button) folded before Flop (didn't bet)
Seat 8: tedbadger9 (small blind) folded on the Flop
Seat 9: tipner (big blind) folded on the Flop





PokerStars Hand #148217148058:  Hold'em No Limit ($0.50/$1.00 USD) - 2016/02/04 14:31:58 CET [2016/02/04 8:31:58 ET]
Table 'Sodankyla' 9-max Seat #7 is the button
Seat 1: sanpidk ($100 in chips) 
Seat 2: Sweden_Pound ($101.50 in chips) 
Seat 3: lumen21 ($100 in chips) 
Seat 4: tipner ($100 in chips) 
Seat 5: matiko09 ($100 in chips) 
Seat 6: 9lKBXKTT6 ($100 in chips) 
Seat 7: RoadtoNepal ($100 in chips) 
Seat 8: Arunas71 ($59 in chips) 
Seat 9: TheDoctor635 ($66.39 in chips) 
Arunas71: posts small blind $0.50
TheDoctor635: posts big blind $1
*** HOLE CARDS ***
Dealt to matiko09 [2d 4d]
sanpidk: raises $2 to $3
Sweden_Pound: folds 
lumen21: folds 
tipner: folds 
matiko09: folds 
9lKBXKTT6: folds 
RoadtoNepal: calls $3
Arunas71: folds 
TheDoctor635: folds 
*** FLOP *** [6h Jd Td]
sanpidk: bets $5
RoadtoNepal: folds 
Uncalled bet ($5) returned to sanpidk
sanpidk collected $7.16 from pot
sanpidk: doesn't show hand 
*** SUMMARY ***
Total pot $7.50 | Rake $0.34 
Board [6h Jd Td]
Seat 1: sanpidk collected ($7.16)
Seat 2: Sweden_Pound folded before Flop (didn't bet)
Seat 3: lumen21 folded before Flop (didn't bet)
Seat 4: tipner folded before Flop (didn't bet)
Seat 5: matiko09 folded before Flop (didn't bet)
Seat 6: 9lKBXKTT6 folded before Flop (didn't bet)
Seat 7: RoadtoNepal (button) folded on the Flop
Seat 8: Arunas71 (small blind) folded before Flop
Seat 9: TheDoctor635 (big blind) folded before Flop





PokerStars Hand #148217167455:  Hold'em No Limit ($0.50/$1.00 USD) - 2016/02/04 14:32:27 CET [2016/02/04 8:32:27 ET]
Table 'Arneb II' 9-max Seat #8 is the button
Seat 1: matiko09 ($103.50 in chips) 
Seat 2: sanpidk ($100 in chips) 
Seat 3: brille-390 ($105.45 in chips) 
Seat 4: Venomous100% ($100 in chips) 
Seat 5: lixiangli ($95 in chips) 
Seat 6: Sweden_Pound ($147.72 in chips) 
Seat 7: melitakas ($104.60 in chips) 
Seat 8: tedbadger9 ($62.50 in chips) 
Seat 9: tipner ($105.25 in chips) 
tipner: posts small blind $0.50
matiko09: posts big blind $1
*** HOLE CARDS ***
Dealt to matiko09 [9d 6c]
sanpidk: folds 
brille-390: raises $1.25 to $2.25
Venomous100%: folds 
lixiangli: calls $2.25
Sweden_Pound: folds 
melitakas: folds 
tedbadger9: calls $2.25
tipner: folds 
matiko09: folds 
*** FLOP *** [Td Kh 5d]
brille-390: checks 
lixiangli: bets $5
tedbadger9: folds 
brille-390: calls $5
*** TURN *** [Td Kh 5d] [4s]
brille-390: checks 
lixiangli: bets $11
brille-390: folds 
Uncalled bet ($11) returned to lixiangli
lixiangli collected $17.43 from pot
lixiangli: doesn't show hand 
*** SUMMARY ***
Total pot $18.25 | Rake $0.82 
Board [Td Kh 5d 4s]
Seat 1: matiko09 (big blind) folded before Flop
Seat 2: sanpidk folded before Flop (didn't bet)
Seat 3: brille-390 folded on the Turn
Seat 4: Venomous100% folded before Flop (didn't bet)
Seat 5: lixiangli collected ($17.43)
Seat 6: Sweden_Pound folded before Flop (didn't bet)
Seat 7: melitakas folded before Flop (didn't bet)
Seat 8: tedbadger9 (button) folded on the Flop
Seat 9: tipner (small blind) folded before Flop





PokerStars Hand #148217178010:  Hold'em No Limit ($0.50/$1.00 USD) - 2016/02/04 14:32:43 CET [2016/02/04 8:32:43 ET]
Table 'Sodankyla' 9-max Seat #8 is the button
Seat 1: sanpidk ($104.16 in chips) 
Seat 2: Sweden_Pound ($101.50 in chips) 
Seat 3: lumen21 ($100 in chips) 
Seat 4: tipner ($100 in chips) 
Seat 5: matiko09 ($100 in chips) 
Seat 6: 9lKBXKTT6 ($100 in chips) 
Seat 7: RoadtoNepal ($100 in chips) 
Seat 8: Arunas71 ($58.50 in chips) 
Seat 9: TheDoctor635 ($65.39 in chips) 
TheDoctor635: posts small blind $0.50
sanpidk: posts big blind $1
*** HOLE CARDS ***
Dealt to matiko09 [3d Ts]
Sweden_Pound: folds 
lumen21: folds 
tipner: folds 
matiko09: folds 
9lKBXKTT6: folds 
RoadtoNepal: raises $1.50 to $2.50
Arunas71: folds 
TheDoctor635: folds 
sanpidk: folds 
Uncalled bet ($1.50) returned to RoadtoNepal
RoadtoNepal collected $2.50 from pot
RoadtoNepal: doesn't show hand 
*** SUMMARY ***
Total pot $2.50 | Rake $0 
Seat 1: sanpidk (big blind) folded before Flop
Seat 2: Sweden_Pound folded before Flop (didn't bet)
Seat 3: lumen21 folded before Flop (didn't bet)
Seat 4: tipner folded before Flop (didn't bet)
Seat 5: matiko09 folded before Flop (didn't bet)
Seat 6: 9lKBXKTT6 folded before Flop (didn't bet)
Seat 7: RoadtoNepal collected ($2.50)
Seat 8: Arunas71 (button) folded before Flop (didn't bet)
Seat 9: TheDoctor635 (small blind) folded before Flop





PokerStars Hand #148217210358:  Hold'em No Limit ($0.50/$1.00 USD) - 2016/02/04 14:33:31 CET [2016/02/04 8:33:31 ET]
Table 'Sodankyla' 9-max Seat #9 is the button
Seat 1: sanpidk ($103.16 in chips) 
Seat 2: Sweden_Pound ($101.50 in chips) 
Seat 3: lumen21 ($100 in chips) 
Seat 4: tipner ($100 in chips) 
Seat 5: matiko09 ($100 in chips) 
Seat 6: 9lKBXKTT6 ($100 in chips) 
Seat 7: RoadtoNepal ($101.50 in chips) 
Seat 8: Arunas71 ($58.50 in chips) 
Seat 9: TheDoctor635 ($64.89 in chips) 
sanpidk: posts small blind $0.50
Sweden_Pound: posts big blind $1
*** HOLE CARDS ***
Dealt to matiko09 [Td 4s]
lumen21: folds 
tipner: folds 
matiko09: folds 
9lKBXKTT6: folds 
RoadtoNepal: folds 
Arunas71: folds 
TheDoctor635: raises $2 to $3
sanpidk: raises $6.50 to $9.50
Sweden_Pound: folds 
TheDoctor635: calls $6.50
*** FLOP *** [Kh 8d 9d]
sanpidk: bets $10
TheDoctor635: raises $25 to $35
sanpidk: folds 
Uncalled bet ($25) returned to TheDoctor635
TheDoctor635 collected $38.20 from pot
TheDoctor635: doesn't show hand 
*** SUMMARY ***
Total pot $40 | Rake $1.80 
Board [Kh 8d 9d]
Seat 1: sanpidk (small blind) folded on the Flop
Seat 2: Sweden_Pound (big blind) folded before Flop
Seat 3: lumen21 folded before Flop (didn't bet)
Seat 4: tipner folded before Flop (didn't bet)
Seat 5: matiko09 folded before Flop (didn't bet)
Seat 6: 9lKBXKTT6 folded before Flop (didn't bet)
Seat 7: RoadtoNepal folded before Flop (didn't bet)
Seat 8: Arunas71 folded before Flop (didn't bet)
Seat 9: TheDoctor635 (button) collected ($38.20)





PokerStars Hand #148217215305:  Hold'em No Limit (€0.50/€1.00 EUR) - 2016/02/04 14:33:39 CET [2016/02/04 8:33:39 ET]
Table 'Ostenia' 9-max Seat #6 is the button
Seat 1: matiko09 (€100 in chips) 
Seat 2: tipner (€100 in chips) 
Seat 3: sanpidk (€100 in chips) 
Seat 4: er13to (€100 in chips) 
Seat 5: Sweden_Pound (€100 in chips) 
Seat 6: melitakas (€106.67 in chips) 
Seat 7: RoadtoNepal (€100 in chips) 
Seat 8: Venomous100% (€100 in chips) 
Seat 9: Dachish (€70 in chips) 
RoadtoNepal: posts small blind €0.50
Venomous100%: posts big blind €1
*** HOLE CARDS ***
Dealt to matiko09 [5c Ah]
Dachish: folds 
matiko09: folds 
tipner: folds 
sanpidk: folds 
er13to: folds 
Sweden_Pound: folds 
melitakas: raises €1 to €2
RoadtoNepal: raises €6 to €8
Venomous100%: folds 
melitakas: calls €6
*** FLOP *** [Td 8c Ad]
RoadtoNepal: checks 
melitakas: checks 
*** TURN *** [Td 8c Ad] [6c]
RoadtoNepal: checks 
melitakas: checks 
*** RIVER *** [Td 8c Ad 6c] [Ks]
RoadtoNepal: checks 
melitakas: bets €8.12
RoadtoNepal: folds 
Uncalled bet (€8.12) returned to melitakas
melitakas collected €16.24 from pot
*** SUMMARY ***
Total pot €17 | Rake €0.76 
Board [Td 8c Ad 6c Ks]
Seat 1: matiko09 folded before Flop (didn't bet)
Seat 2: tipner folded before Flop (didn't bet)
Seat 3: sanpidk folded before Flop (didn't bet)
Seat 4: er13to folded before Flop (didn't bet)
Seat 5: Sweden_Pound folded before Flop (didn't bet)
Seat 6: melitakas (button) collected (€16.24)
Seat 7: RoadtoNepal (small blind) folded on the River
Seat 8: Venomous100% (big blind) folded before Flop
Seat 9: Dachish folded before Flop (didn't bet)





PokerStars Hand #148217222429:  Hold'em No Limit ($0.50/$1.00 USD) - 2016/02/04 14:33:50 CET [2016/02/04 8:33:50 ET]
Table 'Arneb II' 9-max Seat #9 is the button
Seat 1: matiko09 ($102.50 in chips) 
Seat 2: sanpidk ($100 in chips) 
Seat 3: brille-390 ($100 in chips) 
Seat 4: Venomous100% ($100 in chips) 
Seat 5: lixiangli ($105.18 in chips) 
Seat 6: Sweden_Pound ($147.72 in chips) 
Seat 7: melitakas ($104.60 in chips) 
Seat 8: tedbadger9 ($60.25 in chips) 
Seat 9: tipner ($104.75 in chips) 
matiko09: posts small blind $0.50
sanpidk: posts big blind $1
*** HOLE CARDS ***
Dealt to matiko09 [8s Jd]
brille-390: folds 
Venomous100%: folds 
lixiangli: folds 
Sweden_Pound: folds 
melitakas: raises $1 to $2
tedbadger9: folds 
tipner: calls $2
matiko09: folds 
sanpidk: folds 
*** FLOP *** [Ac 3h 8d]
melitakas: bets $3
tipner: folds 
Uncalled bet ($3) returned to melitakas
melitakas collected $5.25 from pot
*** SUMMARY ***
Total pot $5.50 | Rake $0.25 
Board [Ac 3h 8d]
Seat 1: matiko09 (small blind) folded before Flop
Seat 2: sanpidk (big blind) folded before Flop
Seat 3: brille-390 folded before Flop (didn't bet)
Seat 4: Venomous100% folded before Flop (didn't bet)
Seat 5: lixiangli folded before Flop (didn't bet)
Seat 6: Sweden_Pound folded before Flop (didn't bet)
Seat 7: melitakas collected ($5.25)
Seat 8: tedbadger9 folded before Flop (didn't bet)
Seat 9: tipner (button) folded on the Flop





PokerStars Hand #148217223833:  Hold'em No Limit ($0.50/$1.00 USD) - 2016/02/04 14:33:52 CET [2016/02/04 8:33:52 ET]
Table 'Asios III' 9-max Seat #3 is the button
Seat 3: Igor DoUrden ($100 in chips) 
Seat 5: ilaviiitech ($100 in chips) 
Seat 6: matiko09 ($100 in chips) 
Seat 7: nickreason17 ($167.48 in chips) 
TimStone will be allowed to play after the button
ilaviiitech: posts small blind $0.50
matiko09: posts big blind $1
Sweden_Pound: sits out 
ARTVOR640: sits out 
*** HOLE CARDS ***
Dealt to matiko09 [Ts Qc]
nickreason17: folds 
Igor DoUrden: raises $1.09 to $2.09
ilaviiitech: folds 
ARTVOR640 leaves the table
matiko09: calls $1.09
*** FLOP *** [8d 4s 2s]
matiko09: checks 
Igor DoUrden: checks 
*** TURN *** [8d 4s 2s] [Qd]
Vikulja1993 joins the table at seat #9 
matiko09: bets $2.91
Igor DoUrden: calls $2.91
*** RIVER *** [8d 4s 2s Qd] [Tc]
matiko09: bets $7
Igor DoUrden: folds 
Uncalled bet ($7) returned to matiko09
matiko09 collected $10.03 from pot
matiko09: doesn't show hand 
*** SUMMARY ***
Total pot $10.50 | Rake $0.47 
Board [8d 4s 2s Qd Tc]
Seat 3: Igor DoUrden (button) folded on the River
Seat 5: ilaviiitech (small blind) folded before Flop
Seat 6: matiko09 (big blind) collected ($10.03)
Seat 7: nickreason17 folded before Flop (didn't bet)





PokerStars Hand #148217255811:  Hold'em No Limit (€0.50/€1.00 EUR) - 2016/02/04 14:34:41 CET [2016/02/04 8:34:41 ET]
Table 'Ostenia' 9-max Seat #7 is the button
Seat 1: matiko09 (€100 in chips) 
Seat 2: tipner (€100 in chips) 
Seat 3: sanpidk (€100 in chips) 
Seat 4: er13to (€100 in chips) 
Seat 5: Sweden_Pound (€100 in chips) 
Seat 6: melitakas (€114.91 in chips) 
Seat 7: RoadtoNepal (€100 in chips) 
Seat 8: Venomous100% (€100 in chips) 
Venomous100%: posts small blind €0.50
matiko09: posts big blind €1
*** HOLE CARDS ***
Dealt to matiko09 [Qs 5c]
tipner: folds 
sanpidk: folds 
er13to: folds 
Sweden_Pound: folds 
melitakas: raises €1 to €2
RoadtoNepal: calls €2
Venomous100%: folds 
matiko09: folds 
*** FLOP *** [2d 4d 7s]
melitakas: bets €2.62
RoadtoNepal: calls €2.62
*** TURN *** [2d 4d 7s] [9h]
melitakas: checks 
RoadtoNepal: bets €5.13
melitakas: folds 
Uncalled bet (€5.13) returned to RoadtoNepal
RoadtoNepal collected €10.26 from pot
RoadtoNepal: doesn't show hand 
*** SUMMARY ***
Total pot €10.74 | Rake €0.48 
Board [2d 4d 7s 9h]
Seat 1: matiko09 (big blind) folded before Flop
Seat 2: tipner folded before Flop (didn't bet)
Seat 3: sanpidk folded before Flop (didn't bet)
Seat 4: er13to folded before Flop (didn't bet)
Seat 5: Sweden_Pound folded before Flop (didn't bet)
Seat 6: melitakas folded on the Turn
Seat 7: RoadtoNepal (button) collected (€10.26)
Seat 8: Venomous100% (small blind) folded before Flop





PokerStars Hand #148217256343:  Hold'em No Limit ($0.50/$1.00 USD) - 2016/02/04 14:34:42 CET [2016/02/04 8:34:42 ET]
Table 'Arneb II' 9-max Seat #1 is the button
Seat 1: matiko09 ($102 in chips) 
Seat 2: sanpidk ($100 in chips) 
Seat 3: brille-390 ($100 in chips) 
Seat 4: Venomous100% ($100 in chips) 
Seat 5: lixiangli ($105.18 in chips) 
Seat 6: Sweden_Pound ($147.72 in chips) 
Seat 7: melitakas ($107.85 in chips) 
Seat 8: tedbadger9 ($60.25 in chips) 
Seat 9: tipner ($102.75 in chips) 
sanpidk: posts small blind $0.50
brille-390: posts big blind $1
*** HOLE CARDS ***
Dealt to matiko09 [Kc Ac]
Venomous100%: folds 
lixiangli: folds 
Sweden_Pound: folds 
melitakas: raises $1 to $2
tedbadger9: calls $2
tipner: raises $9 to $11
matiko09: calls $11
sanpidk: folds 
brille-390: folds 
melitakas: raises $19 to $30
tedbadger9: folds 
tipner: folds 
matiko09: raises $72 to $102 and is all-in
melitakas: calls $72
*** FLOP *** [Ks 7d 6d]
*** TURN *** [Ks 7d 6d] [Qc]
*** RIVER *** [Ks 7d 6d Qc] [Kd]
*** SHOW DOWN ***
melitakas: shows [Qd Qs] (a full house, Queens full of Kings)
matiko09: mucks hand 
melitakas collected $215.70 from pot
*** SUMMARY ***
Total pot $218.50 | Rake $2.80 
Board [Ks 7d 6d Qc Kd]
Seat 1: matiko09 (button) mucked [Kc Ac]
Seat 2: sanpidk (small blind) folded before Flop
Seat 3: brille-390 (big blind) folded before Flop
Seat 4: Venomous100% folded before Flop (didn't bet)
Seat 5: lixiangli folded before Flop (didn't bet)
Seat 6: Sweden_Pound folded before Flop (didn't bet)
Seat 7: melitakas showed [Qd Qs] and won ($215.70) with a full house, Queens full of Kings
Seat 8: tedbadger9 folded before Flop
Seat 9: tipner folded before Flop





PokerStars Hand #148217266784:  Hold'em No Limit ($0.50/$1.00 USD) - 2016/02/04 14:34:57 CET [2016/02/04 8:34:57 ET]
Table 'Asios III' 9-max Seat #5 is the button
Seat 3: Igor DoUrden ($100 in chips) 
Seat 5: ilaviiitech ($100 in chips) 
Seat 6: matiko09 ($105.03 in chips) 
Seat 7: nickreason17 ($167.48 in chips) 
matiko09: posts small blind $0.50
nickreason17: posts big blind $1
Sweden_Pound: sits out 
Vikulja1993: sits out 
TimStone: sits out 
*** HOLE CARDS ***
Dealt to matiko09 [Qc 6c]
Igor DoUrden: folds 
ilaviiitech: folds 
matiko09: raises $1.50 to $2.50
nickreason17: raises $6 to $8.50
matiko09: folds 
Uncalled bet ($6) returned to nickreason17
nickreason17 collected $5 from pot
*** SUMMARY ***
Total pot $5 | Rake $0 
Seat 3: Igor DoUrden folded before Flop (didn't bet)
Seat 5: ilaviiitech (button) folded before Flop (didn't bet)
Seat 6: matiko09 (small blind) folded before Flop
Seat 7: nickreason17 (big blind) collected ($5)





PokerStars Hand #148217270929:  Hold'em No Limit ($0.50/$1.00 USD) - 2016/02/04 14:35:04 CET [2016/02/04 8:35:04 ET]
Table 'Sodankyla' 9-max Seat #1 is the button
Seat 1: sanpidk ($100 in chips) 
Seat 2: Sweden_Pound ($100.50 in chips) 
Seat 4: tipner ($100 in chips) 
Seat 5: matiko09 ($100 in chips) 
Seat 6: 9lKBXKTT6 ($100 in chips) 
Seat 7: RoadtoNepal ($101.50 in chips) 
Seat 8: Arunas71 ($58.50 in chips) 
Seat 9: TheDoctor635 ($83.59 in chips) 
Sweden_Pound: posts small blind $0.50
lumen21: is sitting out 
tipner: posts big blind $1
*** HOLE CARDS ***
Dealt to matiko09 [7c 4h]
lumen21 leaves the table
matiko09: folds 
yourpro joins the table at seat #3 
9lKBXKTT6: folds 
RoadtoNepal: folds 
Arunas71: folds 
TheDoctor635: raises $2 to $3
sanpidk: folds 
Sweden_Pound: folds 
tipner: folds 
Uncalled bet ($2) returned to TheDoctor635
TheDoctor635 collected $2.50 from pot
TheDoctor635: doesn't show hand 
*** SUMMARY ***
Total pot $2.50 | Rake $0 
Seat 1: sanpidk (button) folded before Flop (didn't bet)
Seat 2: Sweden_Pound (small blind) folded before Flop
Seat 4: tipner (big blind) folded before Flop
Seat 5: matiko09 folded before Flop (didn't bet)
Seat 6: 9lKBXKTT6 folded before Flop (didn't bet)
Seat 7: RoadtoNepal folded before Flop (didn't bet)
Seat 8: Arunas71 folded before Flop (didn't bet)
Seat 9: TheDoctor635 collected ($2.50)





PokerStars Hand #148217292280:  Hold'em No Limit ($0.50/$1.00 USD) - 2016/02/04 14:35:35 CET [2016/02/04 8:35:35 ET]
Table 'Asios III' 9-max Seat #6 is the button
Seat 3: Igor DoUrden ($100 in chips) 
Seat 5: ilaviiitech ($100 in chips) 
Seat 6: matiko09 ($102.53 in chips) 
Seat 7: nickreason17 ($169.98 in chips) 
Seat 8: Sweden_Pound ($100 in chips) 
nickreason17: posts small blind $0.50
Sweden_Pound: posts big blind $1
Vikulja1993: sits out 
TimStone: sits out 
*** HOLE CARDS ***
Dealt to matiko09 [2h Ts]
Igor DoUrden: folds 
ilaviiitech: folds 
matiko09: folds 
nickreason17: folds 
Uncalled bet ($0.50) returned to Sweden_Pound
Sweden_Pound collected $1 from pot
Sweden_Pound: doesn't show hand 
*** SUMMARY ***
Total pot $1 | Rake $0 
Seat 3: Igor DoUrden folded before Flop (didn't bet)
Seat 5: ilaviiitech folded before Flop (didn't bet)
Seat 6: matiko09 (button) folded before Flop (didn't bet)
Seat 7: nickreason17 (small blind) folded before Flop
Seat 8: Sweden_Pound (big blind) collected ($1)





PokerStars Hand #148217294763:  Hold'em No Limit ($0.50/$1.00 USD) - 2016/02/04 14:35:39 CET [2016/02/04 8:35:39 ET]
Table 'Sodankyla' 9-max Seat #2 is the button
Seat 1: sanpidk ($100 in chips) 
Seat 2: Sweden_Pound ($100 in chips) 
Seat 4: tipner ($100 in chips) 
Seat 5: matiko09 ($100 in chips) 
Seat 6: 9lKBXKTT6 ($100 in chips) 
Seat 7: RoadtoNepal ($101.50 in chips) 
Seat 8: Arunas71 ($58.50 in chips) 
Seat 9: TheDoctor635 ($85.09 in chips) 
yourpro will be allowed to play after the button
tipner: posts small blind $0.50
matiko09: posts big blind $1
*** HOLE CARDS ***
Dealt to matiko09 [Qd 2s]
9lKBXKTT6: folds 
RoadtoNepal: folds 
Arunas71: folds 
TheDoctor635: raises $2 to $3
sanpidk: folds 
Sweden_Pound: folds 
tipner: folds 
matiko09: folds 
Uncalled bet ($2) returned to TheDoctor635
TheDoctor635 collected $2.50 from pot
TheDoctor635: doesn't show hand 
*** SUMMARY ***
Total pot $2.50 | Rake $0 
Seat 1: sanpidk folded before Flop (didn't bet)
Seat 2: Sweden_Pound (button) folded before Flop (didn't bet)
Seat 4: tipner (small blind) folded before Flop
Seat 5: matiko09 (big blind) folded before Flop
Seat 6: 9lKBXKTT6 folded before Flop (didn't bet)
Seat 7: RoadtoNepal folded before Flop (didn't bet)
Seat 8: Arunas71 folded before Flop (didn't bet)
Seat 9: TheDoctor635 collected ($2.50)





PokerStars Hand #148217305467:  Hold'em No Limit ($0.50/$1.00 USD) - 2016/02/04 14:35:55 CET [2016/02/04 8:35:55 ET]
Table 'Asios III' 9-max Seat #7 is the button
Seat 3: Igor DoUrden ($100 in chips) 
Seat 5: ilaviiitech ($100 in chips) 
Seat 6: matiko09 ($102.53 in chips) 
Seat 7: nickreason17 ($169.48 in chips) 
Seat 8: Sweden_Pound ($100.50 in chips) 
Seat 9: Vikulja1993 ($100 in chips) 
Sweden_Pound: posts small blind $0.50
Vikulja1993: posts big blind $1
TimStone: sits out 
*** HOLE CARDS ***
Dealt to matiko09 [Td 2s]
Igor DoUrden: folds 
ilaviiitech: folds 
matiko09: folds 
nickreason17: raises $1.04 to $2.04
Sweden_Pound: raises $5.96 to $8
Vikulja1993: raises $9 to $17
nickreason17: folds 
Sweden_Pound: raises $83.50 to $100.50 and is all-in
Vikulja1993: calls $83 and is all-in
Uncalled bet ($0.50) returned to Sweden_Pound
*** FIRST FLOP *** [Qh 5d 5h]
*** FIRST TURN *** [Qh 5d 5h] [Kh]
*** FIRST RIVER *** [Qh 5d 5h Kh] [5c]
*** SECOND FLOP *** [9h 3h 6d]
*** SECOND TURN *** [9h 3h 6d] [4c]
*** SECOND RIVER *** [9h 3h 6d 4c] [6s]
*** FIRST SHOW DOWN ***
Sweden_Pound: shows [Kc Ah] (a full house, Fives full of Kings)
Vikulja1993: shows [As Ac] (a full house, Fives full of Aces)
Vikulja1993 collected $99.62 from pot
*** SECOND SHOW DOWN ***
Sweden_Pound: shows [Kc Ah] (a pair of Sixes)
Vikulja1993: shows [As Ac] (two pair, Aces and Sixes)
Vikulja1993 collected $99.62 from pot
*** SUMMARY ***
Total pot $202.04 | Rake $2.80 
Hand was run twice
FIRST Board [Qh 5d 5h Kh 5c]
SECOND Board [9h 3h 6d 4c 6s]
Seat 3: Igor DoUrden folded before Flop (didn't bet)
Seat 5: ilaviiitech folded before Flop (didn't bet)
Seat 6: matiko09 folded before Flop (didn't bet)
Seat 7: nickreason17 (button) folded before Flop
Seat 8: Sweden_Pound (small blind) showed [Kc Ah] and lost with a full house, Fives full of Kings, and lost with a pair of Sixes
Seat 9: Vikulja1993 (big blind) showed [As Ac] and won ($99.62) with a full house, Fives full of Aces, and won ($99.62) with two pair, Aces and Sixes





PokerStars Hand #148217320612:  Hold'em No Limit (€0.50/€1.00 EUR) - 2016/02/04 14:36:18 CET [2016/02/04 8:36:18 ET]
Table 'Ostenia' 9-max Seat #8 is the button
Seat 1: matiko09 (€100 in chips) 
Seat 2: tipner (€100 in chips) 
Seat 3: sanpidk (€100 in chips) 
Seat 4: er13to (€100 in chips) 
Seat 5: Sweden_Pound (€100 in chips) 
Seat 6: melitakas (€110.29 in chips) 
Seat 7: RoadtoNepal (€105.64 in chips) 
Seat 8: Venomous100% (€100 in chips) 
matiko09: posts small blind €0.50
tipner: posts big blind €1
*** HOLE CARDS ***
Dealt to matiko09 [Qd 7h]
sanpidk: raises €2 to €3
er13to: folds 
Sweden_Pound: folds 
melitakas: folds 
RoadtoNepal: folds 
Venomous100%: folds 
matiko09: folds 
tipner: folds 
Uncalled bet (€2) returned to sanpidk
sanpidk collected €2.50 from pot
sanpidk: doesn't show hand 
*** SUMMARY ***
Total pot €2.50 | Rake €0 
Seat 1: matiko09 (small blind) folded before Flop
Seat 2: tipner (big blind) folded before Flop
Seat 3: sanpidk collected (€2.50)
Seat 4: er13to folded before Flop (didn't bet)
Seat 5: Sweden_Pound folded before Flop (didn't bet)
Seat 6: melitakas folded before Flop (didn't bet)
Seat 7: RoadtoNepal folded before Flop (didn't bet)
Seat 8: Venomous100% (button) folded before Flop (didn't bet)





PokerStars Hand #148217321927:  Hold'em No Limit ($0.50/$1.00 USD) - 2016/02/04 14:36:20 CET [2016/02/04 8:36:20 ET]
Table 'Sodankyla' 9-max Seat #4 is the button
Seat 1: sanpidk ($100 in chips) 
Seat 2: Sweden_Pound ($100 in chips) 
Seat 4: tipner ($100 in chips) 
Seat 5: matiko09 ($100 in chips) 
Seat 6: 9lKBXKTT6 ($100 in chips) 
Seat 7: RoadtoNepal ($101.50 in chips) 
Seat 8: Arunas71 ($58.50 in chips) 
Seat 9: TheDoctor635 ($86.59 in chips) 
matiko09: posts small blind $0.50
9lKBXKTT6: posts big blind $1
yourpro: sits out 
*** HOLE CARDS ***
Dealt to matiko09 [9h 3c]
RoadtoNepal: folds 
Arunas71: folds 
TheDoctor635: folds 
sanpidk: raises $2 to $3
Sweden_Pound: folds 
tipner: folds 
matiko09: folds 
9lKBXKTT6: folds 
Uncalled bet ($2) returned to sanpidk
sanpidk collected $2.50 from pot
sanpidk: doesn't show hand 
*** SUMMARY ***
Total pot $2.50 | Rake $0 
Seat 1: sanpidk collected ($2.50)
Seat 2: Sweden_Pound folded before Flop (didn't bet)
Seat 4: tipner (button) folded before Flop (didn't bet)
Seat 5: matiko09 (small blind) folded before Flop
Seat 6: 9lKBXKTT6 (big blind) folded before Flop
Seat 7: RoadtoNepal folded before Flop (didn't bet)
Seat 8: Arunas71 folded before Flop (didn't bet)
Seat 9: TheDoctor635 folded before Flop (didn't bet)





PokerStars Hand #148217325562:  Hold'em No Limit ($0.50/$1.00 USD) - 2016/02/04 14:36:25 CET [2016/02/04 8:36:25 ET]
Table 'Arneb II' 9-max Seat #2 is the button
Seat 1: matiko09 ($100 in chips) 
Seat 2: sanpidk ($100 in chips) 
Seat 3: brille-390 ($100 in chips) 
Seat 4: Venomous100% ($100 in chips) 
Seat 5: lixiangli ($105.18 in chips) 
Seat 6: Sweden_Pound ($147.72 in chips) 
Seat 7: melitakas ($221.55 in chips) 
Seat 8: tedbadger9 ($58.25 in chips) 
Seat 9: tipner ($100 in chips) 
brille-390: posts small blind $0.50
Venomous100%: posts big blind $1
*** HOLE CARDS ***
Dealt to matiko09 [9s 6d]
lixiangli: raises $1.50 to $2.50
Sweden_Pound: folds 
melitakas: calls $2.50
tedbadger9: folds 
tipner: folds 
matiko09: folds 
sanpidk: folds 
brille-390: folds 
Venomous100%: folds 
*** FLOP *** [3c 9d Qd]
lixiangli: checks 
melitakas: checks 
*** TURN *** [3c 9d Qd] [Qc]
lixiangli: bets $5
melitakas: calls $5
*** RIVER *** [3c 9d Qd Qc] [Ks]
lixiangli: checks 
melitakas: bets $8
lixiangli: folds 
Uncalled bet ($8) returned to melitakas
melitakas collected $15.76 from pot
*** SUMMARY ***
Total pot $16.50 | Rake $0.74 
Board [3c 9d Qd Qc Ks]
Seat 1: matiko09 folded before Flop (didn't bet)
Seat 2: sanpidk (button) folded before Flop (didn't bet)
Seat 3: brille-390 (small blind) folded before Flop
Seat 4: Venomous100% (big blind) folded before Flop
Seat 5: lixiangli folded on the River
Seat 6: Sweden_Pound folded before Flop (didn't bet)
Seat 7: melitakas collected ($15.76)
Seat 8: tedbadger9 folded before Flop (didn't bet)
Seat 9: tipner folded before Flop (didn't bet)





PokerStars Hand #148217338493:  Hold'em No Limit ($0.50/$1.00 USD) - 2016/02/04 14:36:45 CET [2016/02/04 8:36:45 ET]
Table 'Asios III' 9-max Seat #8 is the button
Seat 2: crime8783 ($54.66 in chips) 
Seat 3: Igor DoUrden ($100 in chips) 
Seat 5: ilaviiitech ($100 in chips) 
Seat 6: matiko09 ($102.53 in chips) 
Seat 7: nickreason17 ($167.44 in chips) 
Seat 8: Sweden_Pound ($100 in chips) 
Seat 9: Vikulja1993 ($199.24 in chips) 
Vikulja1993: posts small blind $0.50
crime8783: posts big blind $1
TimStone: sits out 
*** HOLE CARDS ***
Dealt to matiko09 [Ks 3c]
Igor DoUrden: folds 
ilaviiitech: folds 
matiko09: folds 
nickreason17: folds 
Sweden_Pound: folds 
Vikulja1993: raises $2 to $3
crime8783: calls $2
*** FLOP *** [5d Qd Kc]
Vikulja1993: checks 
crime8783: checks 
*** TURN *** [5d Qd Kc] [Ad]
Vikulja1993: bets $3
crime8783: folds 
Uncalled bet ($3) returned to Vikulja1993
Vikulja1993 collected $5.73 from pot
Vikulja1993: doesn't show hand 
*** SUMMARY ***
Total pot $6 | Rake $0.27 
Board [5d Qd Kc Ad]
Seat 2: crime8783 (big blind) folded on the Turn
Seat 3: Igor DoUrden folded before Flop (didn't bet)
Seat 5: ilaviiitech folded before Flop (didn't bet)
Seat 6: matiko09 folded before Flop (didn't bet)
Seat 7: nickreason17 folded before Flop (didn't bet)
Seat 8: Sweden_Pound (button) folded before Flop (didn't bet)
Seat 9: Vikulja1993 (small blind) collected ($5.73)





PokerStars Hand #148217346774:  Hold'em No Limit (€0.50/€1.00 EUR) - 2016/02/04 14:36:57 CET [2016/02/04 8:36:57 ET]
Table 'Ostenia' 9-max Seat #1 is the button
Seat 1: matiko09 (€100 in chips) 
Seat 2: tipner (€100 in chips) 
Seat 3: sanpidk (€101.50 in chips) 
Seat 4: er13to (€100 in chips) 
Seat 5: Sweden_Pound (€100 in chips) 
Seat 6: melitakas (€110.29 in chips) 
Seat 7: RoadtoNepal (€105.64 in chips) 
Seat 8: Venomous100% (€100 in chips) 
tipner: posts small blind €0.50
sanpidk: posts big blind €1
*** HOLE CARDS ***
Dealt to matiko09 [3d 9c]
er13to: folds 
Sweden_Pound: folds 
melitakas: folds 
RoadtoNepal: folds 
Venomous100%: folds 
matiko09: folds 
tipner: folds 
Uncalled bet (€0.50) returned to sanpidk
sanpidk collected €1 from pot
sanpidk: doesn't show hand 
*** SUMMARY ***
Total pot €1 | Rake €0 
Seat 1: matiko09 (button) folded before Flop (didn't bet)
Seat 2: tipner (small blind) folded before Flop
Seat 3: sanpidk (big blind) collected (€1)
Seat 4: er13to folded before Flop (didn't bet)
Seat 5: Sweden_Pound folded before Flop (didn't bet)
Seat 6: melitakas folded before Flop (didn't bet)
Seat 7: RoadtoNepal folded before Flop (didn't bet)
Seat 8: Venomous100% folded before Flop (didn't bet)





PokerStars Hand #148217349102:  Hold'em No Limit ($0.50/$1.00 USD) - 2016/02/04 14:37:00 CET [2016/02/04 8:37:00 ET]
Table 'Sodankyla' 9-max Seat #5 is the button
Seat 1: sanpidk ($101.50 in chips) 
Seat 2: Sweden_Pound ($100 in chips) 
Seat 4: tipner ($100 in chips) 
Seat 5: matiko09 ($100 in chips) 
Seat 6: 9lKBXKTT6 ($100 in chips) 
Seat 7: RoadtoNepal ($101.50 in chips) 
Seat 8: Arunas71 ($58.50 in chips) 
Seat 9: TheDoctor635 ($86.59 in chips) 
9lKBXKTT6: posts small blind $0.50
RoadtoNepal: posts big blind $1
yourpro: sits out 
*** HOLE CARDS ***
Dealt to matiko09 [4d 7c]
Arunas71: folds 
TheDoctor635: folds 
sanpidk: folds 
Sweden_Pound: folds 
tipner: folds 
matiko09: folds 
9lKBXKTT6: folds 
Uncalled bet ($0.50) returned to RoadtoNepal
RoadtoNepal collected $1 from pot
RoadtoNepal: doesn't show hand 
*** SUMMARY ***
Total pot $1 | Rake $0 
Seat 1: sanpidk folded before Flop (didn't bet)
Seat 2: Sweden_Pound folded before Flop (didn't bet)
Seat 4: tipner folded before Flop (didn't bet)
Seat 5: matiko09 (button) folded before Flop (didn't bet)
Seat 6: 9lKBXKTT6 (small blind) folded before Flop
Seat 7: RoadtoNepal (big blind) collected ($1)
Seat 8: Arunas71 folded before Flop (didn't bet)
Seat 9: TheDoctor635 folded before Flop (didn't bet)





PokerStars Hand #148217365816:  Hold'em No Limit ($0.50/$1.00 USD) - 2016/02/04 14:37:26 CET [2016/02/04 8:37:26 ET]
Table 'Sodankyla' 9-max Seat #6 is the button
Seat 1: sanpidk ($101.50 in chips) 
Seat 2: Sweden_Pound ($100 in chips) 
Seat 4: tipner ($100 in chips) 
Seat 5: matiko09 ($100 in chips) 
Seat 6: 9lKBXKTT6 ($100 in chips) 
Seat 7: RoadtoNepal ($102 in chips) 
Seat 8: Arunas71 ($58.50 in chips) 
Seat 9: TheDoctor635 ($86.59 in chips) 
RoadtoNepal: posts small blind $0.50
Arunas71: posts big blind $1
yourpro: sits out 
*** HOLE CARDS ***
Dealt to matiko09 [2c 9d]
TheDoctor635: folds 
sanpidk: folds 
Sweden_Pound: folds 
tipner: folds 
matiko09: folds 
9lKBXKTT6: folds 
RoadtoNepal: raises $2 to $3
Arunas71: folds 
Uncalled bet ($2) returned to RoadtoNepal
RoadtoNepal collected $2 from pot
RoadtoNepal: doesn't show hand 
*** SUMMARY ***
Total pot $2 | Rake $0 
Seat 1: sanpidk folded before Flop (didn't bet)
Seat 2: Sweden_Pound folded before Flop (didn't bet)
Seat 4: tipner folded before Flop (didn't bet)
Seat 5: matiko09 folded before Flop (didn't bet)
Seat 6: 9lKBXKTT6 (button) folded before Flop (didn't bet)
Seat 7: RoadtoNepal (small blind) collected ($2)
Seat 8: Arunas71 (big blind) folded before Flop
Seat 9: TheDoctor635 folded before Flop (didn't bet)





PokerStars Hand #148217370106:  Hold'em No Limit (€0.50/€1.00 EUR) - 2016/02/04 14:37:32 CET [2016/02/04 8:37:32 ET]
Table 'Ostenia' 9-max Seat #2 is the button
Seat 1: matiko09 (€100 in chips) 
Seat 2: tipner (€100 in chips) 
Seat 3: sanpidk (€102 in chips) 
Seat 4: er13to (€100 in chips) 
Seat 5: Sweden_Pound (€100 in chips) 
Seat 6: melitakas (€110.29 in chips) 
Seat 7: RoadtoNepal (€105.64 in chips) 
Seat 8: Venomous100% (€100 in chips) 
sanpidk: posts small blind €0.50
er13to: posts big blind €1
*** HOLE CARDS ***
Dealt to matiko09 [Kc 2c]
Sweden_Pound: folds 
melitakas: folds 
RoadtoNepal: folds 
Venomous100%: folds 
matiko09: folds 
tipner: raises €1.50 to €2.50
sanpidk: raises €6 to €8.50
er13to: folds 
tipner: folds 
Uncalled bet (€6) returned to sanpidk
sanpidk collected €6 from pot
sanpidk: doesn't show hand 
*** SUMMARY ***
Total pot €6 | Rake €0 
Seat 1: matiko09 folded before Flop (didn't bet)
Seat 2: tipner (button) folded before Flop
Seat 3: sanpidk (small blind) collected (€6)
Seat 4: er13to (big blind) folded before Flop
Seat 5: Sweden_Pound folded before Flop (didn't bet)
Seat 6: melitakas folded before Flop (didn't bet)
Seat 7: RoadtoNepal folded before Flop (didn't bet)
Seat 8: Venomous100% folded before Flop (didn't bet)





PokerStars Hand #148217380199:  Hold'em No Limit ($0.50/$1.00 USD) - 2016/02/04 14:37:47 CET [2016/02/04 8:37:47 ET]
Table 'Arneb III' 9-max Seat #1 is the button
Seat 1: goblind4777 ($80 in chips) 
Seat 2: JeanLima93 ($100 in chips) 
Seat 3: matiko09 ($100 in chips) 
Seat 4: Igor DoUrden ($100 in chips) 
Seat 6: nickreason17 ($100 in chips) 
Seat 7: Spid1 ($100 in chips) 
JeanLima93: posts small blind $0.50
matiko09: posts big blind $1
*** HOLE CARDS ***
Dealt to matiko09 [Kh 9s]
ARTVOR640 joins the table at seat #9 
Igor DoUrden: folds 
nickreason17: raises $2 to $3
Spid1: folds 
tipner joins the table at seat #5 
goblind4777: folds 
volwebni4ek joins the table at seat #8 
JeanLima93: folds 
matiko09: folds 
Uncalled bet ($2) returned to nickreason17
nickreason17 collected $2.50 from pot
*** SUMMARY ***
Total pot $2.50 | Rake $0 
Seat 1: goblind4777 (button) folded before Flop (didn't bet)
Seat 2: JeanLima93 (small blind) folded before Flop
Seat 3: matiko09 (big blind) folded before Flop
Seat 4: Igor DoUrden folded before Flop (didn't bet)
Seat 6: nickreason17 collected ($2.50)
Seat 7: Spid1 folded before Flop (didn't bet)





PokerStars Hand #148217385682:  Hold'em No Limit ($0.50/$1.00 USD) - 2016/02/04 14:37:56 CET [2016/02/04 8:37:56 ET]
Table 'Asios III' 9-max Seat #9 is the button
Seat 2: crime8783 ($51.66 in chips) 
Seat 3: Igor DoUrden ($100 in chips) 
Seat 5: ilaviiitech ($100 in chips) 
Seat 6: matiko09 ($102.53 in chips) 
Seat 7: nickreason17 ($167.44 in chips) 
Seat 8: Sweden_Pound ($100 in chips) 
Seat 9: Vikulja1993 ($201.97 in chips) 
crime8783: posts small blind $0.50
Igor DoUrden: posts big blind $1
TimStone: sits out 
*** HOLE CARDS ***
Dealt to matiko09 [5h 5c]
ilaviiitech: folds 
matiko09: raises $2 to $3
nickreason17: calls $3
Sweden_Pound: folds 
Vikulja1993: folds 
crime8783: calls $2.50
ilaviiitech is disconnected 
Igor DoUrden: folds 
*** FLOP *** [3c Qs 3s]
crime8783: bets $3
matiko09: calls $3
nickreason17: calls $3
*** TURN *** [3c Qs 3s] [9s]
crime8783: bets $6
matiko09: folds 
nickreason17: calls $6
*** RIVER *** [3c Qs 3s 9s] [8h]
crime8783: bets $12
I The King I leaves the table
nickreason17: raises $143.44 to $155.44 and is all-in
yourpro joins the table at seat #1 
crime8783 has timed out
crime8783: folds 
Uncalled bet ($143.44) returned to nickreason17
nickreason17 collected $52.52 from pot
*** SUMMARY ***
Total pot $55 | Rake $2.48 
Board [3c Qs 3s 9s 8h]
Seat 2: crime8783 (small blind) folded on the River
Seat 3: Igor DoUrden (big blind) folded before Flop
Seat 5: ilaviiitech folded before Flop (didn't bet)
Seat 6: matiko09 folded on the Turn
Seat 7: nickreason17 collected ($52.52)
Seat 8: Sweden_Pound folded before Flop (didn't bet)
Seat 9: Vikulja1993 (button) folded before Flop (didn't bet)





PokerStars Hand #148217388850:  Hold'em No Limit ($0.50/$1.00 USD) - 2016/02/04 14:38:00 CET [2016/02/04 8:38:00 ET]
Table 'Arneb II' 9-max Seat #3 is the button
Seat 1: matiko09 ($100 in chips) 
Seat 2: sanpidk ($100 in chips) 
Seat 3: brille-390 ($100 in chips) 
Seat 4: Venomous100% ($100 in chips) 
Seat 5: lixiangli ($97.68 in chips) 
Seat 6: Sweden_Pound ($147.72 in chips) 
Seat 7: melitakas ($229.81 in chips) 
Seat 8: tedbadger9 ($58.25 in chips) 
Seat 9: tipner ($100 in chips) 
Venomous100%: posts small blind $0.50
lixiangli: posts big blind $1
*** HOLE CARDS ***
Dealt to matiko09 [7d Js]
Sweden_Pound: raises $2 to $3
melitakas: folds 
tedbadger9: folds 
tipner: folds 
matiko09: folds 
sanpidk: folds 
brille-390: folds 
Venomous100%: folds 
lixiangli: folds 
Uncalled bet ($2) returned to Sweden_Pound
Sweden_Pound collected $2.50 from pot
Sweden_Pound: doesn't show hand 
*** SUMMARY ***
Total pot $2.50 | Rake $0 
Seat 1: matiko09 folded before Flop (didn't bet)
Seat 2: sanpidk folded before Flop (didn't bet)
Seat 3: brille-390 (button) folded before Flop (didn't bet)
Seat 4: Venomous100% (small blind) folded before Flop
Seat 5: lixiangli (big blind) folded before Flop
Seat 6: Sweden_Pound collected ($2.50)
Seat 7: melitakas folded before Flop (didn't bet)
Seat 8: tedbadger9 folded before Flop (didn't bet)
Seat 9: tipner folded before Flop (didn't bet)





PokerStars Hand #148217393014:  Hold'em No Limit ($0.50/$1.00 USD) - 2016/02/04 14:38:07 CET [2016/02/04 8:38:07 ET]
Table 'Arneb III' 9-max Seat #2 is the button
Seat 1: goblind4777 ($80 in chips) 
Seat 2: JeanLima93 ($99.50 in chips) 
Seat 3: matiko09 ($100 in chips) 
Seat 4: Igor DoUrden ($100 in chips) 
Seat 6: nickreason17 ($101.50 in chips) 
Seat 7: Spid1 ($100 in chips) 
matiko09: posts small blind $0.50
Igor DoUrden: posts big blind $1
tipner: sits out 
volwebni4ek: sits out 
ARTVOR640: sits out 
*** HOLE CARDS ***
Dealt to matiko09 [9h 9d]
nickreason17: folds 
Spid1: folds 
goblind4777: folds 
goblind4777 leaves the table
JeanLima93: folds 
matiko09: raises $1.50 to $2.50
Igor DoUrden: calls $1.50
*** FLOP *** [8d 4c Ad]
matiko09: bets $3.11
Igor DoUrden: calls $3.11
*** TURN *** [8d 4c Ad] [5c]
matiko09: checks 
Igor DoUrden: checks 
*** RIVER *** [8d 4c Ad 5c] [Kh]
matiko09: checks 
Igor DoUrden: bets $7.50
matiko09: folds 
Uncalled bet ($7.50) returned to Igor DoUrden
Igor DoUrden collected $10.72 from pot
Igor DoUrden: doesn't show hand 
*** SUMMARY ***
Total pot $11.22 | Rake $0.50 
Board [8d 4c Ad 5c Kh]
Seat 1: goblind4777 folded before Flop (didn't bet)
Seat 2: JeanLima93 (button) folded before Flop (didn't bet)
Seat 3: matiko09 (small blind) folded on the River
Seat 4: Igor DoUrden (big blind) collected ($10.72)
Seat 6: nickreason17 folded before Flop (didn't bet)
Seat 7: Spid1 folded before Flop (didn't bet)





PokerStars Hand #148217393576:  Hold'em No Limit ($0.50/$1.00 USD) - 2016/02/04 14:38:07 CET [2016/02/04 8:38:07 ET]
Table 'Sodankyla' 9-max Seat #7 is the button
Seat 1: sanpidk ($101.50 in chips) 
Seat 2: Sweden_Pound ($100 in chips) 
Seat 4: tipner ($100 in chips) 
Seat 5: matiko09 ($100 in chips) 
Seat 6: 9lKBXKTT6 ($100 in chips) 
Seat 7: RoadtoNepal ($103 in chips) 
Seat 8: Arunas71 ($57.50 in chips) 
Seat 9: TheDoctor635 ($86.59 in chips) 
Arunas71: posts small blind $0.50
TheDoctor635: posts big blind $1
yourpro: sits out 
*** HOLE CARDS ***
Dealt to matiko09 [Js Jc]
sanpidk: folds 
Sweden_Pound: folds 
tipner: folds 
matiko09: raises $2 to $3
9lKBXKTT6: folds 
RoadtoNepal: folds 
Arunas71: folds 
TheDoctor635: folds 
Uncalled bet ($2) returned to matiko09
matiko09 collected $2.50 from pot
matiko09: doesn't show hand 
*** SUMMARY ***
Total pot $2.50 | Rake $0 
Seat 1: sanpidk folded before Flop (didn't bet)
Seat 2: Sweden_Pound folded before Flop (didn't bet)
Seat 4: tipner folded before Flop (didn't bet)
Seat 5: matiko09 collected ($2.50)
Seat 6: 9lKBXKTT6 folded before Flop (didn't bet)
Seat 7: RoadtoNepal (button) folded before Flop (didn't bet)
Seat 8: Arunas71 (small blind) folded before Flop
Seat 9: TheDoctor635 (big blind) folded before Flop





PokerStars Hand #148217412042:  Hold'em No Limit (€0.50/€1.00 EUR) - 2016/02/04 14:38:35 CET [2016/02/04 8:38:35 ET]
Table 'Ostenia' 9-max Seat #3 is the button
Seat 1: matiko09 (€100 in chips) 
Seat 2: tipner (€100 in chips) 
Seat 3: sanpidk (€105.50 in chips) 
Seat 4: er13to (€100 in chips) 
Seat 5: Sweden_Pound (€100 in chips) 
Seat 6: melitakas (€110.29 in chips) 
Seat 7: RoadtoNepal (€105.64 in chips) 
Seat 8: Venomous100% (€100 in chips) 
er13to: posts small blind €0.50
Sweden_Pound: posts big blind €1
*** HOLE CARDS ***
Dealt to matiko09 [Jh 7s]
melitakas: folds 
RoadtoNepal: folds 
Venomous100%: folds 
matiko09: folds 
tipner: folds 
sanpidk: folds 
er13to: raises €1.50 to €2.50
Sweden_Pound: raises €5.50 to €8
er13to: folds 
Uncalled bet (€5.50) returned to Sweden_Pound
Sweden_Pound collected €5 from pot
Sweden_Pound: doesn't show hand 
*** SUMMARY ***
Total pot €5 | Rake €0 
Seat 1: matiko09 folded before Flop (didn't bet)
Seat 2: tipner folded before Flop (didn't bet)
Seat 3: sanpidk (button) folded before Flop (didn't bet)
Seat 4: er13to (small blind) folded before Flop
Seat 5: Sweden_Pound (big blind) collected (€5)
Seat 6: melitakas folded before Flop (didn't bet)
Seat 7: RoadtoNepal folded before Flop (didn't bet)
Seat 8: Venomous100% folded before Flop (didn't bet)





PokerStars Hand #148217423316:  Hold'em No Limit ($0.50/$1.00 USD) - 2016/02/04 14:38:52 CET [2016/02/04 8:38:52 ET]
Table 'Arneb III' 9-max Seat #3 is the button
Seat 2: JeanLima93 ($99.50 in chips) 
Seat 3: matiko09 ($100 in chips) 
Seat 4: Igor DoUrden ($105.11 in chips) 
Seat 5: tipner ($100 in chips) 
Seat 6: nickreason17 ($101.50 in chips) 
Seat 7: Spid1 ($100 in chips) 
Igor DoUrden: posts small blind $0.50
tipner: posts big blind $1
volwebni4ek: sits out 
ARTVOR640: sits out 
*** HOLE CARDS ***
Dealt to matiko09 [4c 8h]
nickreason17: folds 
Spid1: folds 
JeanLima93: folds 
matiko09: folds 
Igor DoUrden: folds 
Uncalled bet ($0.50) returned to tipner
tipner collected $1 from pot
tipner: doesn't show hand 
*** SUMMARY ***
Total pot $1 | Rake $0 
Seat 2: JeanLima93 folded before Flop (didn't bet)
Seat 3: matiko09 (button) folded before Flop (didn't bet)
Seat 4: Igor DoUrden (small blind) folded before Flop
Seat 5: tipner (big blind) collected ($1)
Seat 6: nickreason17 folded before Flop (didn't bet)
Seat 7: Spid1 folded before Flop (didn't bet)





PokerStars Hand #148217424035:  Hold'em No Limit ($0.50/$1.00 USD) - 2016/02/04 14:38:53 CET [2016/02/04 8:38:53 ET]
Table 'Sodankyla' 9-max Seat #8 is the button
Seat 1: sanpidk ($101.50 in chips) 
Seat 2: Sweden_Pound ($100 in chips) 
Seat 4: tipner ($100 in chips) 
Seat 5: matiko09 ($101.50 in chips) 
Seat 6: 9lKBXKTT6 ($100 in chips) 
Seat 7: RoadtoNepal ($103 in chips) 
Seat 8: Arunas71 ($57 in chips) 
Seat 9: TheDoctor635 ($85.59 in chips) 
TheDoctor635: posts small blind $0.50
sanpidk: posts big blind $1
yourpro: sits out 
*** HOLE CARDS ***
Dealt to matiko09 [4s Qh]
Sweden_Pound: folds 
tipner: folds 
matiko09: folds 
9lKBXKTT6: folds 
RoadtoNepal: folds 
Arunas71: raises $2 to $3
TheDoctor635: folds 
sanpidk: folds 
Uncalled bet ($2) returned to Arunas71
Arunas71 collected $2.50 from pot
*** SUMMARY ***
Total pot $2.50 | Rake $0 
Seat 1: sanpidk (big blind) folded before Flop
Seat 2: Sweden_Pound folded before Flop (didn't bet)
Seat 4: tipner folded before Flop (didn't bet)
Seat 5: matiko09 folded before Flop (didn't bet)
Seat 6: 9lKBXKTT6 folded before Flop (didn't bet)
Seat 7: RoadtoNepal folded before Flop (didn't bet)
Seat 8: Arunas71 (button) collected ($2.50)
Seat 9: TheDoctor635 (small blind) folded before Flop





PokerStars Hand #148217425996:  Hold'em No Limit ($0.50/$1.00 USD) - 2016/02/04 14:38:56 CET [2016/02/04 8:38:56 ET]
Table 'Arneb II' 9-max Seat #4 is the button
Seat 1: matiko09 ($100 in chips) 
Seat 2: sanpidk ($100 in chips) 
Seat 3: brille-390 ($100 in chips) 
Seat 4: Venomous100% ($100 in chips) 
Seat 5: lixiangli ($96.68 in chips) 
Seat 6: Sweden_Pound ($149.22 in chips) 
Seat 7: melitakas ($229.81 in chips) 
Seat 8: tedbadger9 ($58.25 in chips) 
Seat 9: tipner ($100 in chips) 
lixiangli: posts small blind $0.50
Sweden_Pound: posts big blind $1
*** HOLE CARDS ***
Dealt to matiko09 [5h 8s]
melitakas: raises $1 to $2
tedbadger9: folds 
tipner: folds 
matiko09: folds 
sanpidk: folds 
brille-390: folds 
Venomous100%: folds 
lixiangli: folds 
Sweden_Pound: folds 
Uncalled bet ($1) returned to melitakas
melitakas collected $2.50 from pot
*** SUMMARY ***
Total pot $2.50 | Rake $0 
Seat 1: matiko09 folded before Flop (didn't bet)
Seat 2: sanpidk folded before Flop (didn't bet)
Seat 3: brille-390 folded before Flop (didn't bet)
Seat 4: Venomous100% (button) folded before Flop (didn't bet)
Seat 5: lixiangli (small blind) folded before Flop
Seat 6: Sweden_Pound (big blind) folded before Flop
Seat 7: melitakas collected ($2.50)
Seat 8: tedbadger9 folded before Flop (didn't bet)
Seat 9: tipner folded before Flop (didn't bet)





PokerStars Hand #148217434532:  Hold'em No Limit ($0.50/$1.00 USD) - 2016/02/04 14:39:09 CET [2016/02/04 8:39:09 ET]
Table 'Arneb III' 9-max Seat #4 is the button
Seat 2: JeanLima93 ($99.50 in chips) 
Seat 3: matiko09 ($100 in chips) 
Seat 4: Igor DoUrden ($104.61 in chips) 
Seat 5: tipner ($100.50 in chips) 
Seat 6: nickreason17 ($101.50 in chips) 
Seat 7: Spid1 ($100 in chips) 
tipner: posts small blind $0.50
nickreason17: posts big blind $1
volwebni4ek: sits out 
ARTVOR640: sits out 
*** HOLE CARDS ***
Dealt to matiko09 [2s 2c]
Spid1: folds 
Vikulja1993 joins the table at seat #1 
JeanLima93: folds 
matiko09: raises $1.50 to $2.50
Igor DoUrden: folds 
tipner: folds 
nickreason17: folds 
Uncalled bet ($1.50) returned to matiko09
matiko09 collected $2.50 from pot
matiko09: doesn't show hand 
*** SUMMARY ***
Total pot $2.50 | Rake $0 
Seat 2: JeanLima93 folded before Flop (didn't bet)
Seat 3: matiko09 collected ($2.50)
Seat 4: Igor DoUrden (button) folded before Flop (didn't bet)
Seat 5: tipner (small blind) folded before Flop
Seat 6: nickreason17 (big blind) folded before Flop
Seat 7: Spid1 folded before Flop (didn't bet)





PokerStars Hand #148217449532:  Hold'em No Limit ($0.50/$1.00 USD) - 2016/02/04 14:39:32 CET [2016/02/04 8:39:32 ET]
Table 'Arneb III' 9-max Seat #5 is the button
Seat 2: JeanLima93 ($99.50 in chips) 
Seat 3: matiko09 ($101.50 in chips) 
Seat 4: Igor DoUrden ($104.61 in chips) 
Seat 5: tipner ($100 in chips) 
Seat 6: nickreason17 ($100.50 in chips) 
Seat 7: Spid1 ($100 in chips) 
nickreason17: posts small blind $0.50
Spid1: posts big blind $1
volwebni4ek: sits out 
ARTVOR640: sits out 
Vikulja1993: sits out 
*** HOLE CARDS ***
Dealt to matiko09 [7d Ah]
JeanLima93: folds 
matiko09: folds 
Igor DoUrden: folds 
tipner: folds 
nickreason17: raises $1.04 to $2.04
Spid1: folds 
Uncalled bet ($1.04) returned to nickreason17
nickreason17 collected $2 from pot
*** SUMMARY ***
Total pot $2 | Rake $0 
Seat 2: JeanLima93 folded before Flop (didn't bet)
Seat 3: matiko09 folded before Flop (didn't bet)
Seat 4: Igor DoUrden folded before Flop (didn't bet)
Seat 5: tipner (button) folded before Flop (didn't bet)
Seat 6: nickreason17 (small blind) collected ($2)
Seat 7: Spid1 (big blind) folded before Flop





PokerStars Hand #148217463223:  Hold'em No Limit ($0.50/$1.00 USD) - 2016/02/04 14:39:52 CET [2016/02/04 8:39:52 ET]
Table 'Arneb II' 9-max Seat #5 is the button
Seat 1: matiko09 ($100 in chips) 
Seat 2: sanpidk ($100 in chips) 
Seat 3: brille-390 ($100 in chips) 
Seat 4: Venomous100% ($100 in chips) 
Seat 5: lixiangli ($96.18 in chips) 
Seat 6: Sweden_Pound ($148.22 in chips) 
Seat 7: melitakas ($231.31 in chips) 
Seat 8: tedbadger9 ($58.25 in chips) 
Seat 9: tipner ($100 in chips) 
Sweden_Pound: posts small blind $0.50
melitakas: posts big blind $1
*** HOLE CARDS ***
Dealt to matiko09 [Jc Js]
tedbadger9: folds 
tipner: folds 
matiko09: raises $2 to $3
sanpidk: folds 
brille-390: folds 
Venomous100%: folds 
lixiangli: folds 
Sweden_Pound: folds 
melitakas: folds 
Uncalled bet ($2) returned to matiko09
matiko09 collected $2.50 from pot
matiko09: doesn't show hand 
*** SUMMARY ***
Total pot $2.50 | Rake $0 
Seat 1: matiko09 collected ($2.50)
Seat 2: sanpidk folded before Flop (didn't bet)
Seat 3: brille-390 folded before Flop (didn't bet)
Seat 4: Venomous100% folded before Flop (didn't bet)
Seat 5: lixiangli (button) folded before Flop (didn't bet)
Seat 6: Sweden_Pound (small blind) folded before Flop
Seat 7: melitakas (big blind) folded before Flop
Seat 8: tedbadger9 folded before Flop (didn't bet)
Seat 9: tipner folded before Flop (didn't bet)





PokerStars Hand #148217464925:  Hold'em No Limit (€0.50/€1.00 EUR) - 2016/02/04 14:39:55 CET [2016/02/04 8:39:55 ET]
Table 'Ostenia' 9-max Seat #4 is the button
Seat 1: matiko09 (€100 in chips) 
Seat 2: tipner (€100 in chips) 
Seat 3: sanpidk (€105.50 in chips) 
Seat 4: er13to (€100 in chips) 
Seat 5: Sweden_Pound (€102.50 in chips) 
Seat 6: melitakas (€110.29 in chips) 
Seat 7: RoadtoNepal (€105.64 in chips) 
Seat 8: Venomous100% (€100 in chips) 
Sweden_Pound: posts small blind €0.50
melitakas: posts big blind €1
*** HOLE CARDS ***
Dealt to matiko09 [7s Tc]
RoadtoNepal: folds 
Venomous100%: raises €2 to €3
matiko09: folds 
tipner: folds 
sanpidk: folds 
er13to: folds 
Sweden_Pound: folds 
melitakas: folds 
Uncalled bet (€2) returned to Venomous100%
Venomous100% collected €2.50 from pot
Venomous100%: doesn't show hand 
*** SUMMARY ***
Total pot €2.50 | Rake €0 
Seat 1: matiko09 folded before Flop (didn't bet)
Seat 2: tipner folded before Flop (didn't bet)
Seat 3: sanpidk folded before Flop (didn't bet)
Seat 4: er13to (button) folded before Flop (didn't bet)
Seat 5: Sweden_Pound (small blind) folded before Flop
Seat 6: melitakas (big blind) folded before Flop
Seat 7: RoadtoNepal folded before Flop (didn't bet)
Seat 8: Venomous100% collected (€2.50)





PokerStars Hand #148217466315:  Hold'em No Limit ($0.50/$1.00 USD) - 2016/02/04 14:39:57 CET [2016/02/04 8:39:57 ET]
Table 'Arneb III' 9-max Seat #6 is the button
Seat 2: JeanLima93 ($99.50 in chips) 
Seat 3: matiko09 ($101.50 in chips) 
Seat 4: Igor DoUrden ($104.61 in chips) 
Seat 5: tipner ($100 in chips) 
Seat 6: nickreason17 ($101.50 in chips) 
Seat 7: Spid1 ($100 in chips) 
Seat 8: volwebni4ek ($57.98 in chips) 
Spid1: posts small blind $0.50
volwebni4ek: posts big blind $1
ARTVOR640: sits out 
Vikulja1993: sits out 
*** HOLE CARDS ***
Dealt to matiko09 [9h Ah]
JeanLima93: folds 
matiko09: folds 
Igor DoUrden: folds 
tipner: raises $2 to $3
nickreason17: folds 
Spid1: folds 
volwebni4ek: folds 
Uncalled bet ($2) returned to tipner
tipner collected $2.50 from pot
tipner: doesn't show hand 
*** SUMMARY ***
Total pot $2.50 | Rake $0 
Seat 2: JeanLima93 folded before Flop (didn't bet)
Seat 3: matiko09 folded before Flop (didn't bet)
Seat 4: Igor DoUrden folded before Flop (didn't bet)
Seat 5: tipner collected ($2.50)
Seat 6: nickreason17 (button) folded before Flop (didn't bet)
Seat 7: Spid1 (small blind) folded before Flop
Seat 8: volwebni4ek (big blind) folded before Flop





PokerStars Hand #148217473206:  Hold'em No Limit ($0.50/$1.00 USD) - 2016/02/04 14:40:08 CET [2016/02/04 8:40:08 ET]
Table 'Sargas' 9-max Seat #5 is the button
Seat 1: Sweden_Pound ($100 in chips) 
Seat 2: chaps1988 ($100 in chips) 
Seat 3: sanpidk ($100 in chips) 
Seat 4: nickreason17 ($100 in chips) 
Seat 5: matiko09 ($100 in chips) 
Seat 6: buttonlife ($40 in chips) 
Seat 8: ozone2003 ($100 in chips) 
Seat 9: tompi-tomp ($80 in chips) 
buttonlife: posts small blind $0.50
ozone2003: posts big blind $1
*** HOLE CARDS ***
Dealt to matiko09 [4d 3d]
Spid1 joins the table at seat #7 
tompi-tomp: folds 
Sweden_Pound: folds 
chaps1988: folds 
sanpidk: folds 
nickreason17: folds 
matiko09: folds 
buttonlife: folds 
Uncalled bet ($0.50) returned to ozone2003
ozone2003 collected $1 from pot
ozone2003: doesn't show hand 
*** SUMMARY ***
Total pot $1 | Rake $0 
Seat 1: Sweden_Pound folded before Flop (didn't bet)
Seat 2: chaps1988 folded before Flop (didn't bet)
Seat 3: sanpidk folded before Flop (didn't bet)
Seat 4: nickreason17 folded before Flop (didn't bet)
Seat 5: matiko09 (button) folded before Flop (didn't bet)
Seat 6: buttonlife (small blind) folded before Flop
Seat 8: ozone2003 (big blind) collected ($1)
Seat 9: tompi-tomp folded before Flop (didn't bet)





PokerStars Hand #148217473384:  Hold'em No Limit ($0.50/$1.00 USD) - 2016/02/04 14:40:08 CET [2016/02/04 8:40:08 ET]
Table 'Sodankyla' 9-max Seat #9 is the button
Seat 1: sanpidk ($100.50 in chips) 
Seat 2: Sweden_Pound ($100 in chips) 
Seat 4: tipner ($100 in chips) 
Seat 5: matiko09 ($101.50 in chips) 
Seat 6: 9lKBXKTT6 ($100 in chips) 
Seat 7: RoadtoNepal ($103 in chips) 
Seat 8: Arunas71 ($58.50 in chips) 
Seat 9: TheDoctor635 ($85.09 in chips) 
sanpidk: posts small blind $0.50
Sweden_Pound: posts big blind $1
yourpro: sits out 
*** HOLE CARDS ***
Dealt to matiko09 [4h Ts]
tipner: folds 
matiko09: folds 
9lKBXKTT6: folds 
RoadtoNepal: folds 
Arunas71: folds 
TheDoctor635: folds 
sanpidk: raises $1.24 to $2.24
Sweden_Pound: folds 
Uncalled bet ($1.24) returned to sanpidk
sanpidk collected $2 from pot
sanpidk: doesn't show hand 
*** SUMMARY ***
Total pot $2 | Rake $0 
Seat 1: sanpidk (small blind) collected ($2)
Seat 2: Sweden_Pound (big blind) folded before Flop
Seat 4: tipner folded before Flop (didn't bet)
Seat 5: matiko09 folded before Flop (didn't bet)
Seat 6: 9lKBXKTT6 folded before Flop (didn't bet)
Seat 7: RoadtoNepal folded before Flop (didn't bet)
Seat 8: Arunas71 folded before Flop (didn't bet)
Seat 9: TheDoctor635 (button) folded before Flop (didn't bet)





PokerStars Hand #148217481337:  Hold'em No Limit ($0.50/$1.00 USD) - 2016/02/04 14:40:20 CET [2016/02/04 8:40:20 ET]
Table 'Asios III' 9-max Seat #3 is the button
Seat 3: Igor DoUrden ($100 in chips) 
Seat 5: ilaviiitech ($100 in chips) 
Seat 6: matiko09 ($100 in chips) 
Seat 7: nickreason17 ($195.96 in chips) 
Seat 8: Sweden_Pound ($100 in chips) 
Seat 9: Vikulja1993 ($201.97 in chips) 
ilaviiitech: posts small blind $0.50
matiko09: posts big blind $1
yourpro: sits out 
*** HOLE CARDS ***
Dealt to matiko09 [3c 7c]
nickreason17: folds 
Sweden_Pound: raises $2 to $3
Vikulja1993: folds 
Igor DoUrden: folds 
ilaviiitech: folds 
matiko09: folds 
Uncalled bet ($2) returned to Sweden_Pound
Sweden_Pound collected $2.50 from pot
Sweden_Pound: doesn't show hand 
*** SUMMARY ***
Total pot $2.50 | Rake $0 
Seat 3: Igor DoUrden (button) folded before Flop (didn't bet)
Seat 5: ilaviiitech (small blind) folded before Flop
Seat 6: matiko09 (big blind) folded before Flop
Seat 7: nickreason17 folded before Flop (didn't bet)
Seat 8: Sweden_Pound collected ($2.50)
Seat 9: Vikulja1993 folded before Flop (didn't bet)





PokerStars Hand #148217484868:  Hold'em No Limit ($0.50/$1.00 USD) - 2016/02/04 14:40:26 CET [2016/02/04 8:40:26 ET]
Table 'Arneb II' 9-max Seat #6 is the button
Seat 1: matiko09 ($101.50 in chips) 
Seat 2: sanpidk ($100 in chips) 
Seat 3: brille-390 ($100 in chips) 
Seat 4: Venomous100% ($100 in chips) 
Seat 5: lixiangli ($96.18 in chips) 
Seat 6: Sweden_Pound ($147.72 in chips) 
Seat 7: melitakas ($230.31 in chips) 
Seat 8: tedbadger9 ($58.25 in chips) 
Seat 9: tipner ($100 in chips) 
melitakas: posts small blind $0.50
tedbadger9: posts big blind $1
*** HOLE CARDS ***
Dealt to matiko09 [3d 2h]
tipner: folds 
matiko09: folds 
sanpidk: folds 
brille-390 has timed out
brille-390: folds 
Venomous100%: raises $2 to $3
lixiangli: folds 
Sweden_Pound: folds 
melitakas: folds 
tedbadger9: calls $2
*** FLOP *** [3s 3h Qc]
tedbadger9: checks 
Venomous100%: bets $4.10
tedbadger9: calls $4.10
*** TURN *** [3s 3h Qc] [7s]
tedbadger9: checks 
Venomous100%: bets $9
tedbadger9: raises $13 to $22
Venomous100%: folds 
Uncalled bet ($13) returned to tedbadger9
tedbadger9 collected $31.23 from pot
*** SUMMARY ***
Total pot $32.70 | Rake $1.47 
Board [3s 3h Qc 7s]
Seat 1: matiko09 folded before Flop (didn't bet)
Seat 2: sanpidk folded before Flop (didn't bet)
Seat 3: brille-390 folded before Flop (didn't bet)
Seat 4: Venomous100% folded on the Turn
Seat 5: lixiangli folded before Flop (didn't bet)
Seat 6: Sweden_Pound (button) folded before Flop (didn't bet)
Seat 7: melitakas (small blind) folded before Flop
Seat 8: tedbadger9 (big blind) collected ($31.23)
Seat 9: tipner folded before Flop (didn't bet)





PokerStars Hand #148217486790:  Hold'em No Limit ($0.50/$1.00 USD) - 2016/02/04 14:40:29 CET [2016/02/04 8:40:29 ET]
Table 'Sargas' 9-max Seat #6 is the button
Seat 1: Sweden_Pound ($100 in chips) 
Seat 2: chaps1988 ($100 in chips) 
Seat 3: sanpidk ($100 in chips) 
Seat 4: nickreason17 ($100 in chips) 
Seat 5: matiko09 ($100 in chips) 
Seat 6: buttonlife ($46.50 in chips) 
Seat 8: ozone2003 ($100.50 in chips) 
Seat 9: tompi-tomp ($80 in chips) 
Spid1 will be allowed to play after the button
ozone2003: posts small blind $0.50
tompi-tomp: posts big blind $1
*** HOLE CARDS ***
Dealt to matiko09 [8s Ks]
Sweden_Pound: folds 
Spid1 leaves the table
chaps1988: folds 
sanpidk: folds 
nickreason17: folds 
matiko09: raises $1.50 to $2.50
buttonlife: folds 
ozone2003: folds 
tompi-tomp: calls $1.50
*** FLOP *** [4d 9d Td]
tompi-tomp: checks 
matiko09: checks 
*** TURN *** [4d 9d Td] [5d]
tompi-tomp: bets $3
I The King I joins the table at seat #7 
I The King I leaves the table
matiko09: folds 
Uncalled bet ($3) returned to tompi-tomp
xxxZeka joins the table at seat #7 
tompi-tomp collected $5.25 from pot
tompi-tomp: doesn't show hand 
*** SUMMARY ***
Total pot $5.50 | Rake $0.25 
Board [4d 9d Td 5d]
Seat 1: Sweden_Pound folded before Flop (didn't bet)
Seat 2: chaps1988 folded before Flop (didn't bet)
Seat 3: sanpidk folded before Flop (didn't bet)
Seat 4: nickreason17 folded before Flop (didn't bet)
Seat 5: matiko09 folded on the Turn
Seat 6: buttonlife (button) folded before Flop (didn't bet)
Seat 8: ozone2003 (small blind) folded before Flop
Seat 9: tompi-tomp (big blind) collected ($5.25)





PokerStars Hand #148217491342:  Hold'em No Limit ($0.50/$1.00 USD) - 2016/02/04 14:40:36 CET [2016/02/04 8:40:36 ET]
Table 'Asios III' 9-max Seat #5 is the button
Seat 3: Igor DoUrden ($100 in chips) 
Seat 5: ilaviiitech ($100 in chips) 
Seat 6: matiko09 ($100 in chips) 
Seat 7: nickreason17 ($195.96 in chips) 
Seat 8: Sweden_Pound ($101.50 in chips) 
Seat 9: Vikulja1993 ($201.97 in chips) 
matiko09: posts small blind $0.50
nickreason17: posts big blind $1
yourpro: sits out 
*** HOLE CARDS ***
Dealt to matiko09 [4c Qh]
Sweden_Pound: folds 
Vikulja1993: folds 
Igor DoUrden: folds 
ilaviiitech: folds 
matiko09: folds 
Uncalled bet ($0.50) returned to nickreason17
nickreason17 collected $1 from pot
*** SUMMARY ***
Total pot $1 | Rake $0 
Seat 3: Igor DoUrden folded before Flop (didn't bet)
Seat 5: ilaviiitech (button) folded before Flop (didn't bet)
Seat 6: matiko09 (small blind) folded before Flop
Seat 7: nickreason17 (big blind) collected ($1)
Seat 8: Sweden_Pound folded before Flop (didn't bet)
Seat 9: Vikulja1993 folded before Flop (didn't bet)





PokerStars Hand #148217501014:  Hold'em No Limit (€0.50/€1.00 EUR) - 2016/02/04 14:40:50 CET [2016/02/04 8:40:50 ET]
Table 'Ostenia' 9-max Seat #5 is the button
Seat 1: matiko09 (€100 in chips) 
Seat 2: tipner (€100 in chips) 
Seat 3: sanpidk (€105.50 in chips) 
Seat 4: er13to (€100 in chips) 
Seat 5: Sweden_Pound (€102 in chips) 
Seat 6: melitakas (€109.29 in chips) 
Seat 7: RoadtoNepal (€105.64 in chips) 
Seat 8: Venomous100% (€101.50 in chips) 
melitakas: posts small blind €0.50
RoadtoNepal: posts big blind €1
*** HOLE CARDS ***
Dealt to matiko09 [Qh 8d]
Venomous100%: folds 
matiko09: folds 
tipner: folds 
sanpidk: folds 
er13to: folds 
Sweden_Pound: raises €1 to €2
melitakas: folds 
RoadtoNepal: raises €6 to €8
Sweden_Pound: folds 
Uncalled bet (€6) returned to RoadtoNepal
RoadtoNepal collected €4.50 from pot
RoadtoNepal: doesn't show hand 
*** SUMMARY ***
Total pot €4.50 | Rake €0 
Seat 1: matiko09 folded before Flop (didn't bet)
Seat 2: tipner folded before Flop (didn't bet)
Seat 3: sanpidk folded before Flop (didn't bet)
Seat 4: er13to folded before Flop (didn't bet)
Seat 5: Sweden_Pound (button) folded before Flop
Seat 6: melitakas (small blind) folded before Flop
Seat 7: RoadtoNepal (big blind) collected (€4.50)
Seat 8: Venomous100% folded before Flop (didn't bet)





PokerStars Hand #148217502386:  Hold'em No Limit ($0.50/$1.00 USD) - 2016/02/04 14:40:52 CET [2016/02/04 8:40:52 ET]
Table 'Arneb III' 9-max Seat #7 is the button
Seat 2: JeanLima93 ($99.50 in chips) 
Seat 3: matiko09 ($101.50 in chips) 
Seat 4: Igor DoUrden ($104.61 in chips) 
Seat 5: tipner ($101.50 in chips) 
Seat 6: nickreason17 ($101.50 in chips) 
Seat 7: Spid1 ($100 in chips) 
Seat 8: volwebni4ek ($56.98 in chips) 
Seat 9: ARTVOR640 ($100 in chips) 
volwebni4ek: posts small blind $0.50
ARTVOR640: posts big blind $1
Vikulja1993: sits out 
*** HOLE CARDS ***
Dealt to matiko09 [Kd Jd]
JeanLima93: raises $2 to $3
matiko09: calls $3
Igor DoUrden: raises $9 to $12
tipner: folds 
nickreason17: folds 
Spid1: calls $12
volwebni4ek: folds 
ARTVOR640: folds 
JeanLima93: calls $9
matiko09: calls $9
*** FLOP *** [5s Jh 5h]
JeanLima93: checks 
matiko09: checks 
Igor DoUrden: bets $15
Spid1: calls $15
JeanLima93: folds 
matiko09: folds 
*** TURN *** [5s Jh 5h] [9c]
Igor DoUrden: checks 
Spid1: bets $73 and is all-in
Igor DoUrden: calls $73
*** RIVER *** [5s Jh 5h 9c] [2c]
*** SHOW DOWN ***
Igor DoUrden: shows [Ac Ah] (two pair, Aces and Fives)
Spid1: shows [Qc Qd] (two pair, Queens and Fives)
Igor DoUrden collected $222.70 from pot
*** SUMMARY ***
Total pot $225.50 | Rake $2.80 
Board [5s Jh 5h 9c 2c]
Seat 2: JeanLima93 folded on the Flop
Seat 3: matiko09 folded on the Flop
Seat 4: Igor DoUrden showed [Ac Ah] and won ($222.70) with two pair, Aces and Fives
Seat 5: tipner folded before Flop (didn't bet)
Seat 6: nickreason17 folded before Flop (didn't bet)
Seat 7: Spid1 (button) showed [Qc Qd] and lost with two pair, Queens and Fives
Seat 8: volwebni4ek (small blind) folded before Flop
Seat 9: ARTVOR640 (big blind) folded before Flop





PokerStars Hand #148217503112:  Hold'em No Limit ($0.50/$1.00 USD) - 2016/02/04 14:40:53 CET [2016/02/04 8:40:53 ET]
Table 'Sodankyla' 9-max Seat #1 is the button
Seat 1: sanpidk ($101.50 in chips) 
Seat 2: Sweden_Pound ($100 in chips) 
Seat 3: yourpro ($100 in chips) 
Seat 4: tipner ($100 in chips) 
Seat 5: matiko09 ($101.50 in chips) 
Seat 6: 9lKBXKTT6 ($100 in chips) 
Seat 7: RoadtoNepal ($103 in chips) 
Seat 8: Arunas71 ($58.50 in chips) 
Seat 9: TheDoctor635 ($85.09 in chips) 
Sweden_Pound: posts small blind $0.50
yourpro: posts big blind $1
*** HOLE CARDS ***
Dealt to matiko09 [6c 8s]
tipner: folds 
matiko09: folds 
9lKBXKTT6: folds 
RoadtoNepal: folds 
Arunas71: folds 
TheDoctor635: raises $2 to $3
sanpidk: folds 
Sweden_Pound: folds 
yourpro: folds 
Uncalled bet ($2) returned to TheDoctor635
TheDoctor635 collected $2.50 from pot
TheDoctor635: doesn't show hand 
*** SUMMARY ***
Total pot $2.50 | Rake $0 
Seat 1: sanpidk (button) folded before Flop (didn't bet)
Seat 2: Sweden_Pound (small blind) folded before Flop
Seat 3: yourpro (big blind) folded before Flop
Seat 4: tipner folded before Flop (didn't bet)
Seat 5: matiko09 folded before Flop (didn't bet)
Seat 6: 9lKBXKTT6 folded before Flop (didn't bet)
Seat 7: RoadtoNepal folded before Flop (didn't bet)
Seat 8: Arunas71 folded before Flop (didn't bet)
Seat 9: TheDoctor635 collected ($2.50)





PokerStars Hand #148217505935:  Hold'em No Limit ($0.50/$1.00 USD) - 2016/02/04 14:40:58 CET [2016/02/04 8:40:58 ET]
Table 'Asios III' 9-max Seat #6 is the button
Seat 2: crime8783 ($27.66 in chips) 
Seat 3: Igor DoUrden ($100 in chips) 
Seat 5: ilaviiitech ($100 in chips) 
Seat 6: matiko09 ($100 in chips) 
Seat 7: nickreason17 ($196.46 in chips) 
Seat 8: Sweden_Pound ($101.50 in chips) 
Seat 9: Vikulja1993 ($201.97 in chips) 
nickreason17: posts small blind $0.50
Sweden_Pound: posts big blind $1
yourpro: sits out 
*** HOLE CARDS ***
Dealt to matiko09 [Kd Kc]
Vikulja1993: raises $2 to $3
crime8783: calls $3
Igor DoUrden: folds 
ilaviiitech: folds 
matiko09: raises $7 to $10
nickreason17: folds 
Sweden_Pound: folds 
ilaviiitech is disconnected 
Vikulja1993: raises $12 to $22
crime8783: folds 
matiko09: raises $78 to $100 and is all-in
Vikulja1993: folds 
Uncalled bet ($78) returned to matiko09
matiko09 collected $48.50 from pot
matiko09: doesn't show hand 
*** SUMMARY ***
Total pot $48.50 | Rake $0 
Seat 2: crime8783 folded before Flop
Seat 3: Igor DoUrden folded before Flop (didn't bet)
Seat 5: ilaviiitech folded before Flop (didn't bet)
Seat 6: matiko09 (button) collected ($48.50)
Seat 7: nickreason17 (small blind) folded before Flop
Seat 8: Sweden_Pound (big blind) folded before Flop
Seat 9: Vikulja1993 folded before Flop





PokerStars Hand #148217521858:  Hold'em No Limit ($0.50/$1.00 USD) - 2016/02/04 14:41:21 CET [2016/02/04 8:41:21 ET]
Table 'Sargas' 9-max Seat #8 is the button
Seat 1: Sweden_Pound ($100 in chips) 
Seat 2: chaps1988 ($100 in chips) 
Seat 3: sanpidk ($100 in chips) 
Seat 4: nickreason17 ($100 in chips) 
Seat 5: matiko09 ($100 in chips) 
Seat 6: buttonlife ($46.50 in chips) 
Seat 8: ozone2003 ($100 in chips) 
Seat 9: tompi-tomp ($82.75 in chips) 
tompi-tomp: posts small blind $0.50
Sweden_Pound: posts big blind $1
*** HOLE CARDS ***
Dealt to matiko09 [3d Qh]
chaps1988: folds 
xxxZeka leaves the table
sanpidk: folds 
nickreason17: folds 
matiko09: folds 
buttonlife: folds 
ozone2003: folds 
tompi-tomp: raises $2 to $3
Sweden_Pound: calls $2
*** FLOP *** [7d 7c 4h]
tompi-tomp: bets $4
Sweden_Pound: folds 
Uncalled bet ($4) returned to tompi-tomp
tompi-tomp collected $5.73 from pot
tompi-tomp: doesn't show hand 
*** SUMMARY ***
Total pot $6 | Rake $0.27 
Board [7d 7c 4h]
Seat 1: Sweden_Pound (big blind) folded on the Flop
Seat 2: chaps1988 folded before Flop (didn't bet)
Seat 3: sanpidk folded before Flop (didn't bet)
Seat 4: nickreason17 folded before Flop (didn't bet)
Seat 5: matiko09 folded before Flop (didn't bet)
Seat 6: buttonlife folded before Flop (didn't bet)
Seat 8: ozone2003 (button) folded before Flop (didn't bet)
Seat 9: tompi-tomp (small blind) collected ($5.73)





PokerStars Hand #148217539126:  Hold'em No Limit (€0.50/€1.00 EUR) - 2016/02/04 14:41:47 CET [2016/02/04 8:41:47 ET]
Table 'Ostenia' 9-max Seat #6 is the button
Seat 1: matiko09 (€100 in chips) 
Seat 2: tipner (€100 in chips) 
Seat 3: sanpidk (€105.50 in chips) 
Seat 4: er13to (€100 in chips) 
Seat 5: Sweden_Pound (€100 in chips) 
Seat 6: melitakas (€108.79 in chips) 
Seat 7: RoadtoNepal (€108.14 in chips) 
Seat 8: Venomous100% (€101.50 in chips) 
RoadtoNepal: posts small blind €0.50
Venomous100%: posts big blind €1
*** HOLE CARDS ***
Dealt to matiko09 [5c 8h]
matiko09: folds 
tipner: folds 
sanpidk: folds 
er13to: folds 
Sweden_Pound: folds 
melitakas: raises €1 to €2
RoadtoNepal: folds 
Venomous100%: folds 
Uncalled bet (€1) returned to melitakas
melitakas collected €2.50 from pot
*** SUMMARY ***
Total pot €2.50 | Rake €0 
Seat 1: matiko09 folded before Flop (didn't bet)
Seat 2: tipner folded before Flop (didn't bet)
Seat 3: sanpidk folded before Flop (didn't bet)
Seat 4: er13to folded before Flop (didn't bet)
Seat 5: Sweden_Pound folded before Flop (didn't bet)
Seat 6: melitakas (button) collected (€2.50)
Seat 7: RoadtoNepal (small blind) folded before Flop
Seat 8: Venomous100% (big blind) folded before Flop





PokerStars Hand #148217544346:  Hold'em No Limit ($0.50/$1.00 USD) - 2016/02/04 14:41:55 CET [2016/02/04 8:41:55 ET]
Table 'Sodankyla' 9-max Seat #2 is the button
Seat 1: sanpidk ($101.50 in chips) 
Seat 2: Sweden_Pound ($100 in chips) 
Seat 3: yourpro ($100 in chips) 
Seat 5: matiko09 ($101.50 in chips) 
Seat 6: 9lKBXKTT6 ($100 in chips) 
Seat 7: RoadtoNepal ($103 in chips) 
Seat 8: Arunas71 ($58.50 in chips) 
Seat 9: TheDoctor635 ($86.59 in chips) 
yourpro: posts small blind $0.50
tipner: is sitting out 
matiko09: posts big blind $1
*** HOLE CARDS ***
Dealt to matiko09 [3c Th]
tipner leaves the table
9lKBXKTT6: folds 
RoadtoNepal: folds 
Arunas71: folds 
TheDoctor635: folds 
sanpidk: folds 
Sweden_Pound: raises $1 to $2
yourpro: folds 
9lKBXKTT6 leaves the table
nickreason17 joins the table at seat #6 
matiko09: folds 
Uncalled bet ($1) returned to Sweden_Pound
Sweden_Pound collected $2.50 from pot
Sweden_Pound: doesn't show hand 
*** SUMMARY ***
Total pot $2.50 | Rake $0 
Seat 1: sanpidk folded before Flop (didn't bet)
Seat 2: Sweden_Pound (button) collected ($2.50)
Seat 3: yourpro (small blind) folded before Flop
Seat 5: matiko09 (big blind) folded before Flop
Seat 6: 9lKBXKTT6 folded before Flop (didn't bet)
Seat 7: RoadtoNepal folded before Flop (didn't bet)
Seat 8: Arunas71 folded before Flop (didn't bet)
Seat 9: TheDoctor635 folded before Flop (didn't bet)





PokerStars Hand #148217547074:  Hold'em No Limit ($0.50/$1.00 USD) - 2016/02/04 14:41:59 CET [2016/02/04 8:41:59 ET]
Table 'Sargas' 9-max Seat #9 is the button
Seat 1: Sweden_Pound ($100 in chips) 
Seat 2: chaps1988 ($100 in chips) 
Seat 3: sanpidk ($100 in chips) 
Seat 4: nickreason17 ($100 in chips) 
Seat 5: matiko09 ($100 in chips) 
Seat 6: buttonlife ($46.50 in chips) 
Seat 8: ozone2003 ($100 in chips) 
Seat 9: tompi-tomp ($85.48 in chips) 
Sweden_Pound: posts small blind $0.50
chaps1988: posts big blind $1
*** HOLE CARDS ***
Dealt to matiko09 [Js Kh]
sanpidk: folds 
nickreason17: raises $2 to $3
matiko09: folds 
buttonlife: folds 
ozone2003: folds 
tompi-tomp: folds 
Sweden_Pound: folds 
chaps1988: folds 
Uncalled bet ($2) returned to nickreason17
nickreason17 collected $2.50 from pot
*** SUMMARY ***
Total pot $2.50 | Rake $0 
Seat 1: Sweden_Pound (small blind) folded before Flop
Seat 2: chaps1988 (big blind) folded before Flop
Seat 3: sanpidk folded before Flop (didn't bet)
Seat 4: nickreason17 collected ($2.50)
Seat 5: matiko09 folded before Flop (didn't bet)
Seat 6: buttonlife folded before Flop (didn't bet)
Seat 8: ozone2003 folded before Flop (didn't bet)
Seat 9: tompi-tomp (button) folded before Flop (didn't bet)





PokerStars Hand #148217552205:  Hold'em No Limit ($0.50/$1.00 USD) - 2016/02/04 14:42:04 CET [2016/02/04 8:42:04 ET]
Table 'Arneb II' 9-max Seat #7 is the button
Seat 1: matiko09 ($101.50 in chips) 
Seat 2: sanpidk ($100 in chips) 
Seat 3: brille-390 ($100 in chips) 
Seat 4: Venomous100% ($100 in chips) 
Seat 5: lixiangli ($96.18 in chips) 
Seat 6: Sweden_Pound ($147.72 in chips) 
Seat 7: melitakas ($229.81 in chips) 
Seat 8: tedbadger9 ($73.38 in chips) 
Seat 9: tipner ($100 in chips) 
tedbadger9: posts small blind $0.50
tipner: posts big blind $1
*** HOLE CARDS ***
Dealt to matiko09 [Jc 4h]
matiko09: folds 
sanpidk: folds 
brille-390: folds 
Venomous100%: folds 
lixiangli: folds 
Sweden_Pound: raises $1.50 to $2.50
melitakas: folds 
tedbadger9: calls $2
tipner: folds 
*** FLOP *** [Kd Qd 8d]
tedbadger9: checks 
Sweden_Pound: bets $3.72
tedbadger9: calls $3.72
*** TURN *** [Kd Qd 8d] [4d]
tedbadger9: checks 
Sweden_Pound: checks 
*** RIVER *** [Kd Qd 8d 4d] [3h]
tedbadger9: bets $6.42
Sweden_Pound: folds 
Uncalled bet ($6.42) returned to tedbadger9
tedbadger9 collected $12.84 from pot
*** SUMMARY ***
Total pot $13.44 | Rake $0.60 
Board [Kd Qd 8d 4d 3h]
Seat 1: matiko09 folded before Flop (didn't bet)
Seat 2: sanpidk folded before Flop (didn't bet)
Seat 3: brille-390 folded before Flop (didn't bet)
Seat 4: Venomous100% folded before Flop (didn't bet)
Seat 5: lixiangli folded before Flop (didn't bet)
Seat 6: Sweden_Pound folded on the River
Seat 7: melitakas (button) folded before Flop (didn't bet)
Seat 8: tedbadger9 (small blind) collected ($12.84)
Seat 9: tipner (big blind) folded before Flop





PokerStars Hand #148217563973:  Hold'em No Limit ($0.50/$1.00 USD) - 2016/02/04 14:42:22 CET [2016/02/04 8:42:22 ET]
Table 'Sargas' 9-max Seat #1 is the button
Seat 1: Sweden_Pound ($100 in chips) 
Seat 2: chaps1988 ($100 in chips) 
Seat 3: sanpidk ($100 in chips) 
Seat 4: nickreason17 ($101.50 in chips) 
Seat 5: matiko09 ($100 in chips) 
Seat 6: buttonlife ($46.50 in chips) 
Seat 8: ozone2003 ($100 in chips) 
Seat 9: tompi-tomp ($85.48 in chips) 
chaps1988: posts small blind $0.50
sanpidk: posts big blind $1
*** HOLE CARDS ***
Dealt to matiko09 [7d 7c]
nickreason17: folds 
matiko09: raises $2 to $3
buttonlife: folds 
ozone2003: folds 
tompi-tomp: folds 
Sweden_Pound: folds 
chaps1988: folds 
I The King I joins the table at seat #7 
I The King I leaves the table
sanpidk: folds 
Uncalled bet ($2) returned to matiko09
matiko09 collected $2.50 from pot
matiko09: doesn't show hand 
*** SUMMARY ***
Total pot $2.50 | Rake $0 
Seat 1: Sweden_Pound (button) folded before Flop (didn't bet)
Seat 2: chaps1988 (small blind) folded before Flop
Seat 3: sanpidk (big blind) folded before Flop
Seat 4: nickreason17 folded before Flop (didn't bet)
Seat 5: matiko09 collected ($2.50)
Seat 6: buttonlife folded before Flop (didn't bet)
Seat 8: ozone2003 folded before Flop (didn't bet)
Seat 9: tompi-tomp folded before Flop (didn't bet)





PokerStars Hand #148217564784:  Hold'em No Limit ($0.50/$1.00 USD) - 2016/02/04 14:42:23 CET [2016/02/04 8:42:23 ET]
Table 'Asios III' 9-max Seat #7 is the button
Seat 2: crime8783 ($24.66 in chips) 
Seat 3: Igor DoUrden ($100 in chips) 
Seat 5: ilaviiitech ($100 in chips) 
Seat 6: matiko09 ($126.50 in chips) 
Seat 7: nickreason17 ($195.96 in chips) 
Seat 8: Sweden_Pound ($100.50 in chips) 
Seat 9: Vikulja1993 ($179.97 in chips) 
Sweden_Pound: posts small blind $0.50
Vikulja1993: posts big blind $1
yourpro: sits out 
*** HOLE CARDS ***
Dealt to matiko09 [2h Js]
crime8783: raises $1 to $2
Igor DoUrden: folds 
ilaviiitech: calls $2
matiko09: folds 
nickreason17: folds 
Sweden_Pound: calls $1.50
Vikulja1993: raises $8 to $10
crime8783: raises $14.66 to $24.66 and is all-in
ilaviiitech: folds 
Sweden_Pound: folds 
Vikulja1993: calls $14.66
*** FLOP *** [4h Jh 3c]
*** TURN *** [4h Jh 3c] [6h]
*** RIVER *** [4h Jh 3c 6h] [5c]
*** SHOW DOWN ***
Vikulja1993: shows [Kc Kh] (a pair of Kings)
crime8783: shows [3s 3d] (three of a kind, Threes)
crime8783 collected $50.92 from pot
*** SUMMARY ***
Total pot $53.32 | Rake $2.40 
Board [4h Jh 3c 6h 5c]
Seat 2: crime8783 showed [3s 3d] and won ($50.92) with three of a kind, Threes
Seat 3: Igor DoUrden folded before Flop (didn't bet)
Seat 5: ilaviiitech folded before Flop
Seat 6: matiko09 folded before Flop (didn't bet)
Seat 7: nickreason17 (button) folded before Flop (didn't bet)
Seat 8: Sweden_Pound (small blind) folded before Flop
Seat 9: Vikulja1993 (big blind) showed [Kc Kh] and lost with a pair of Kings





PokerStars Hand #148217566431:  Hold'em No Limit (€0.50/€1.00 EUR) - 2016/02/04 14:42:25 CET [2016/02/04 8:42:25 ET]
Table 'Ostenia' 9-max Seat #7 is the button
Seat 1: matiko09 (€100 in chips) 
Seat 2: tipner (€100 in chips) 
Seat 3: sanpidk (€105.50 in chips) 
Seat 4: er13to (€100 in chips) 
Seat 5: Sweden_Pound (€100 in chips) 
Seat 6: melitakas (€110.29 in chips) 
Seat 7: RoadtoNepal (€107.64 in chips) 
Seat 8: Venomous100% (€100.50 in chips) 
Venomous100%: posts small blind €0.50
matiko09: posts big blind €1
*** HOLE CARDS ***
Dealt to matiko09 [7d 2d]
tipner: folds 
sanpidk: folds 
er13to: folds 
Sweden_Pound: folds 
melitakas: folds 
RoadtoNepal: raises €1 to €2
Venomous100%: folds 
matiko09: folds 
Uncalled bet (€1) returned to RoadtoNepal
RoadtoNepal collected €2.50 from pot
RoadtoNepal: doesn't show hand 
*** SUMMARY ***
Total pot €2.50 | Rake €0 
Seat 1: matiko09 (big blind) folded before Flop
Seat 2: tipner folded before Flop (didn't bet)
Seat 3: sanpidk folded before Flop (didn't bet)
Seat 4: er13to folded before Flop (didn't bet)
Seat 5: Sweden_Pound folded before Flop (didn't bet)
Seat 6: melitakas folded before Flop (didn't bet)
Seat 7: RoadtoNepal (button) collected (€2.50)
Seat 8: Venomous100% (small blind) folded before Flop





PokerStars Hand #148217577472:  Hold'em No Limit ($0.50/$1.00 USD) - 2016/02/04 14:42:41 CET [2016/02/04 8:42:41 ET]
Table 'Sodankyla' 9-max Seat #3 is the button
Seat 1: sanpidk ($101.50 in chips) 
Seat 2: Sweden_Pound ($101.50 in chips) 
Seat 3: yourpro ($100 in chips) 
Seat 5: matiko09 ($100.50 in chips) 
Seat 6: nickreason17 ($100 in chips) 
Seat 7: RoadtoNepal ($103 in chips) 
Seat 8: Arunas71 ($58.50 in chips) 
Seat 9: TheDoctor635 ($86.59 in chips) 
matiko09: posts small blind $0.50
nickreason17: posts big blind $1
*** HOLE CARDS ***
Dealt to matiko09 [4d 7h]
RoadtoNepal: folds 
Arunas71: folds 
TheDoctor635: folds 
sanpidk: folds 
Sweden_Pound: raises $1.50 to $2.50
yourpro: folds 
matiko09: folds 
nickreason17: folds 
Uncalled bet ($1.50) returned to Sweden_Pound
Sweden_Pound collected $2.50 from pot
Sweden_Pound: doesn't show hand 
*** SUMMARY ***
Total pot $2.50 | Rake $0 
Seat 1: sanpidk folded before Flop (didn't bet)
Seat 2: Sweden_Pound collected ($2.50)
Seat 3: yourpro (button) folded before Flop (didn't bet)
Seat 5: matiko09 (small blind) folded before Flop
Seat 6: nickreason17 (big blind) folded before Flop
Seat 7: RoadtoNepal folded before Flop (didn't bet)
Seat 8: Arunas71 folded before Flop (didn't bet)
Seat 9: TheDoctor635 folded before Flop (didn't bet)





PokerStars Hand #148217585399:  Hold'em No Limit ($0.50/$1.00 USD) - 2016/02/04 14:42:53 CET [2016/02/04 8:42:53 ET]
Table 'Sargas' 9-max Seat #2 is the button
Seat 1: Sweden_Pound ($100 in chips) 
Seat 2: chaps1988 ($100 in chips) 
Seat 3: sanpidk ($100 in chips) 
Seat 4: nickreason17 ($101.50 in chips) 
Seat 5: matiko09 ($101.50 in chips) 
Seat 6: buttonlife ($46.50 in chips) 
Seat 8: ozone2003 ($100 in chips) 
Seat 9: tompi-tomp ($85.48 in chips) 
sanpidk: posts small blind $0.50
nickreason17: posts big blind $1
*** HOLE CARDS ***
Dealt to matiko09 [Tc Qd]
matiko09: folds 
buttonlife: folds 
ozone2003: folds 
tompi-tomp: folds 
Sweden_Pound: raises $1.50 to $2.50
chaps1988: folds 
sanpidk: raises $6 to $8.50
nickreason17: folds 
Sweden_Pound: calls $6
*** FLOP *** [Js 6d Kc]
DENG1118 joins the table at seat #7 
sanpidk: bets $10
Sweden_Pound: folds 
Uncalled bet ($10) returned to sanpidk
sanpidk collected $17.19 from pot
sanpidk: doesn't show hand 
*** SUMMARY ***
Total pot $18 | Rake $0.81 
Board [Js 6d Kc]
Seat 1: Sweden_Pound folded on the Flop
Seat 2: chaps1988 (button) folded before Flop (didn't bet)
Seat 3: sanpidk (small blind) collected ($17.19)
Seat 4: nickreason17 (big blind) folded before Flop
Seat 5: matiko09 folded before Flop (didn't bet)
Seat 6: buttonlife folded before Flop (didn't bet)
Seat 8: ozone2003 folded before Flop (didn't bet)
Seat 9: tompi-tomp folded before Flop (didn't bet)





PokerStars Hand #148217592220:  Hold'em No Limit ($0.50/$1.00 USD) - 2016/02/04 14:43:02 CET [2016/02/04 8:43:02 ET]
Table 'Arneb III' 9-max Seat #8 is the button
Seat 1: Vikulja1993 ($100 in chips) 
Seat 2: JeanLima93 ($87.50 in chips) 
Seat 3: matiko09 ($100 in chips) 
Seat 4: Igor DoUrden ($227.31 in chips) 
Seat 5: tipner ($101.50 in chips) 
Seat 6: nickreason17 ($101.50 in chips) 
Seat 7: Spid1 ($100 in chips) 
Seat 8: volwebni4ek ($56.48 in chips) 
Seat 9: ARTVOR640 ($100 in chips) 
ARTVOR640: posts small blind $0.50
Vikulja1993: posts big blind $1
*** HOLE CARDS ***
Dealt to matiko09 [6d 2d]
JeanLima93: raises $3 to $4
matiko09: folds 
Igor DoUrden: folds 
tipner: folds 
nickreason17: folds 
Spid1: folds 
volwebni4ek: folds 
ARTVOR640: folds 
Vikulja1993: calls $3
*** FLOP *** [7h Jh 7c]
Vikulja1993: checks 
JeanLima93: bets $4.06
Vikulja1993: folds 
Uncalled bet ($4.06) returned to JeanLima93
JeanLima93 collected $8.12 from pot
JeanLima93: doesn't show hand 
*** SUMMARY ***
Total pot $8.50 | Rake $0.38 
Board [7h Jh 7c]
Seat 1: Vikulja1993 (big blind) folded on the Flop
Seat 2: JeanLima93 collected ($8.12)
Seat 3: matiko09 folded before Flop (didn't bet)
Seat 4: Igor DoUrden folded before Flop (didn't bet)
Seat 5: tipner folded before Flop (didn't bet)
Seat 6: nickreason17 folded before Flop (didn't bet)
Seat 7: Spid1 folded before Flop (didn't bet)
Seat 8: volwebni4ek (button) folded before Flop (didn't bet)
Seat 9: ARTVOR640 (small blind) folded before Flop





PokerStars Hand #148217593068:  Hold'em No Limit (€0.50/€1.00 EUR) - 2016/02/04 14:43:04 CET [2016/02/04 8:43:04 ET]
Table 'Ostenia' 9-max Seat #8 is the button
Seat 1: matiko09 (€100 in chips) 
Seat 2: tipner (€100 in chips) 
Seat 3: sanpidk (€105.50 in chips) 
Seat 4: er13to (€100 in chips) 
Seat 5: Sweden_Pound (€100 in chips) 
Seat 6: melitakas (€110.29 in chips) 
Seat 7: RoadtoNepal (€109.14 in chips) 
Seat 8: Venomous100% (€100 in chips) 
matiko09: posts small blind €0.50
tipner: posts big blind €1
*** HOLE CARDS ***
Dealt to matiko09 [8s 4s]
sanpidk: folds 
er13to: raises €2 to €3
Sweden_Pound: folds 
melitakas: folds 
RoadtoNepal: folds 
Venomous100%: folds 
matiko09: folds 
tipner: folds 
Uncalled bet (€2) returned to er13to
er13to collected €2.50 from pot
*** SUMMARY ***
Total pot €2.50 | Rake €0 
Seat 1: matiko09 (small blind) folded before Flop
Seat 2: tipner (big blind) folded before Flop
Seat 3: sanpidk folded before Flop (didn't bet)
Seat 4: er13to collected (€2.50)
Seat 5: Sweden_Pound folded before Flop (didn't bet)
Seat 6: melitakas folded before Flop (didn't bet)
Seat 7: RoadtoNepal folded before Flop (didn't bet)
Seat 8: Venomous100% (button) folded before Flop (didn't bet)





PokerStars Hand #148217600806:  Hold'em No Limit ($0.50/$1.00 USD) - 2016/02/04 14:43:14 CET [2016/02/04 8:43:14 ET]
Table 'Sodankyla' 9-max Seat #5 is the button
Seat 1: sanpidk ($101.50 in chips) 
Seat 2: Sweden_Pound ($103 in chips) 
Seat 3: yourpro ($100 in chips) 
Seat 5: matiko09 ($100 in chips) 
Seat 6: nickreason17 ($100 in chips) 
Seat 7: RoadtoNepal ($103 in chips) 
Seat 8: Arunas71 ($58.50 in chips) 
Seat 9: TheDoctor635 ($86.59 in chips) 
nickreason17: posts small blind $0.50
RoadtoNepal: posts big blind $1
*** HOLE CARDS ***
Dealt to matiko09 [3h 5d]
Arunas71: folds 
xxxZeka joins the table at seat #4 
TheDoctor635: folds 
sanpidk: folds 
Sweden_Pound: folds 
yourpro: raises $1.41 to $2.41
matiko09: folds 
nickreason17: folds 
RoadtoNepal: calls $1.41
*** FLOP *** [Qc 6d 8s]
RoadtoNepal: bets $3.38
yourpro: raises $7.12 to $10.50
RoadtoNepal: calls $7.12
*** TURN *** [Qc 6d 8s] [Qs]
RoadtoNepal: checks 
yourpro: checks 
*** RIVER *** [Qc 6d 8s Qs] [Ac]
RoadtoNepal: checks 
yourpro: checks 
*** SHOW DOWN ***
RoadtoNepal: shows [6c 6h] (a full house, Sixes full of Queens)
yourpro: mucks hand 
RoadtoNepal collected $25.14 from pot
*** SUMMARY ***
Total pot $26.32 | Rake $1.18 
Board [Qc 6d 8s Qs Ac]
Seat 1: sanpidk folded before Flop (didn't bet)
Seat 2: Sweden_Pound folded before Flop (didn't bet)
Seat 3: yourpro mucked [Td 9d]
Seat 5: matiko09 (button) folded before Flop (didn't bet)
Seat 6: nickreason17 (small blind) folded before Flop
Seat 7: RoadtoNepal (big blind) showed [6c 6h] and won ($25.14) with a full house, Sixes full of Queens
Seat 8: Arunas71 folded before Flop (didn't bet)
Seat 9: TheDoctor635 folded before Flop (didn't bet)





PokerStars Hand #148217617361:  Hold'em No Limit ($0.50/$1.00 USD) - 2016/02/04 14:43:38 CET [2016/02/04 8:43:38 ET]
Table 'Asios III' 9-max Seat #8 is the button
Seat 1: yourpro ($100 in chips) 
Seat 2: crime8783 ($50.92 in chips) 
Seat 3: Igor DoUrden ($100 in chips) 
Seat 5: ilaviiitech ($100 in chips) 
Seat 6: matiko09 ($126.50 in chips) 
Seat 7: nickreason17 ($195.96 in chips) 
Seat 8: Sweden_Pound ($100 in chips) 
Seat 9: Vikulja1993 ($155.31 in chips) 
Vikulja1993: posts small blind $0.50
yourpro: posts big blind $1
*** HOLE CARDS ***
Dealt to matiko09 [2d 5d]
crime8783: raises $1 to $2
Igor DoUrden: folds 
ilaviiitech: folds 
matiko09: folds 
nickreason17: folds 
Sweden_Pound: folds 
Vikulja1993: folds 
yourpro: folds 
Uncalled bet ($1) returned to crime8783
crime8783 collected $2.50 from pot
crime8783: doesn't show hand 
*** SUMMARY ***
Total pot $2.50 | Rake $0 
Seat 1: yourpro (big blind) folded before Flop
Seat 2: crime8783 collected ($2.50)
Seat 3: Igor DoUrden folded before Flop (didn't bet)
Seat 5: ilaviiitech folded before Flop (didn't bet)
Seat 6: matiko09 folded before Flop (didn't bet)
Seat 7: nickreason17 folded before Flop (didn't bet)
Seat 8: Sweden_Pound (button) folded before Flop (didn't bet)
Seat 9: Vikulja1993 (small blind) folded before Flop





PokerStars Hand #148217619692:  Hold'em No Limit ($0.50/$1.00 USD) - 2016/02/04 14:43:41 CET [2016/02/04 8:43:41 ET]
Table 'Arneb II' 9-max Seat #8 is the button
Seat 1: matiko09 ($101.50 in chips) 
Seat 2: sanpidk ($100 in chips) 
Seat 3: brille-390 ($100 in chips) 
Seat 4: Venomous100% ($100 in chips) 
Seat 5: lixiangli ($96.18 in chips) 
Seat 6: Sweden_Pound ($141.50 in chips) 
Seat 7: melitakas ($229.81 in chips) 
Seat 8: tedbadger9 ($80 in chips) 
Seat 9: tipner ($100 in chips) 
tipner: posts small blind $0.50
matiko09: posts big blind $1
*** HOLE CARDS ***
Dealt to matiko09 [Ks 9c]
sanpidk: raises $2 to $3
brille-390: raises $6 to $9
Venomous100%: folds 
lixiangli: folds 
Sweden_Pound: folds 
melitakas: folds 
tedbadger9: folds 
tipner: folds 
matiko09: folds 
sanpidk: folds 
Uncalled bet ($6) returned to brille-390
brille-390 collected $7.50 from pot
brille-390: doesn't show hand 
*** SUMMARY ***
Total pot $7.50 | Rake $0 
Seat 1: matiko09 (big blind) folded before Flop
Seat 2: sanpidk folded before Flop
Seat 3: brille-390 collected ($7.50)
Seat 4: Venomous100% folded before Flop (didn't bet)
Seat 5: lixiangli folded before Flop (didn't bet)
Seat 6: Sweden_Pound folded before Flop (didn't bet)
Seat 7: melitakas folded before Flop (didn't bet)
Seat 8: tedbadger9 (button) folded before Flop (didn't bet)
Seat 9: tipner (small blind) folded before Flop





PokerStars Hand #148217625010:  Hold'em No Limit ($0.50/$1.00 USD) - 2016/02/04 14:43:49 CET [2016/02/04 8:43:49 ET]
Table 'Arneb III' 9-max Seat #9 is the button
Seat 1: Vikulja1993 ($100 in chips) 
Seat 2: JeanLima93 ($91.62 in chips) 
Seat 3: matiko09 ($100 in chips) 
Seat 4: Igor DoUrden ($227.31 in chips) 
Seat 5: tipner ($101.50 in chips) 
Seat 6: nickreason17 ($101.50 in chips) 
Seat 7: Spid1 ($100 in chips) 
Seat 8: volwebni4ek ($56.48 in chips) 
Seat 9: ARTVOR640 ($100 in chips) 
Vikulja1993: posts small blind $0.50
JeanLima93: posts big blind $1
*** HOLE CARDS ***
Dealt to matiko09 [Qs 4c]
matiko09: folds 
Igor DoUrden: folds 
tipner: folds 
nickreason17: folds 
Spid1: folds 
volwebni4ek: folds 
ARTVOR640: folds 
Vikulja1993: folds 
Uncalled bet ($0.50) returned to JeanLima93
JeanLima93 collected $1 from pot
JeanLima93: doesn't show hand 
*** SUMMARY ***
Total pot $1 | Rake $0 
Seat 1: Vikulja1993 (small blind) folded before Flop
Seat 2: JeanLima93 (big blind) collected ($1)
Seat 3: matiko09 folded before Flop (didn't bet)
Seat 4: Igor DoUrden folded before Flop (didn't bet)
Seat 5: tipner folded before Flop (didn't bet)
Seat 6: nickreason17 folded before Flop (didn't bet)
Seat 7: Spid1 folded before Flop (didn't bet)
Seat 8: volwebni4ek folded before Flop (didn't bet)
Seat 9: ARTVOR640 (button) folded before Flop (didn't bet)





PokerStars Hand #148217627518:  Hold'em No Limit (€0.50/€1.00 EUR) - 2016/02/04 14:43:52 CET [2016/02/04 8:43:52 ET]
Table 'Ostenia' 9-max Seat #1 is the button
Seat 1: matiko09 (€100 in chips) 
Seat 2: tipner (€100 in chips) 
Seat 4: er13to (€101.50 in chips) 
Seat 5: Sweden_Pound (€100 in chips) 
Seat 6: melitakas (€110.29 in chips) 
Seat 7: RoadtoNepal (€109.14 in chips) 
Seat 8: Venomous100% (€100 in chips) 
tipner: posts small blind €0.50
sanpidk: is sitting out 
er13to: posts big blind €1
*** HOLE CARDS ***
Dealt to matiko09 [Ts 8s]
sanpidk leaves the table
Sweden_Pound: folds 
melitakas: folds 
RoadtoNepal: raises €2 to €3
Venomous100%: folds 
matiko09: folds 
tipner: folds 
er13to: folds 
Uncalled bet (€2) returned to RoadtoNepal
Vikulja1993 joins the table at seat #3 
Vikulja1993 leaves the table
RoadtoNepal collected €2.50 from pot
*** SUMMARY ***
Total pot €2.50 | Rake €0 
Seat 1: matiko09 (button) folded before Flop (didn't bet)
Seat 2: tipner (small blind) folded before Flop
Seat 4: er13to (big blind) folded before Flop
Seat 5: Sweden_Pound folded before Flop (didn't bet)
Seat 6: melitakas folded before Flop (didn't bet)
Seat 7: RoadtoNepal collected (€2.50)
Seat 8: Venomous100% folded before Flop (didn't bet)





PokerStars Hand #148217635162:  Hold'em No Limit ($0.50/$1.00 USD) - 2016/02/04 14:44:03 CET [2016/02/04 8:44:03 ET]
Table 'Sargas' 9-max Seat #3 is the button
Seat 1: Sweden_Pound ($100 in chips) 
Seat 2: chaps1988 ($100 in chips) 
Seat 3: sanpidk ($108.69 in chips) 
Seat 4: nickreason17 ($100.50 in chips) 
Seat 5: matiko09 ($101.50 in chips) 
Seat 6: buttonlife ($46.50 in chips) 
Seat 8: ozone2003 ($100 in chips) 
Seat 9: tompi-tomp ($85.48 in chips) 
nickreason17: posts small blind $0.50
matiko09: posts big blind $1
DENG1118: sits out 
*** HOLE CARDS ***
Dealt to matiko09 [4s 2s]
buttonlife: raises $1.50 to $2.50
ozone2003: folds 
tompi-tomp: folds 
Sweden_Pound: folds 
chaps1988: folds 
sanpidk: folds 
nickreason17: folds 
matiko09: folds 
Uncalled bet ($1.50) returned to buttonlife
buttonlife collected $2.50 from pot
buttonlife: doesn't show hand 
*** SUMMARY ***
Total pot $2.50 | Rake $0 
Seat 1: Sweden_Pound folded before Flop (didn't bet)
Seat 2: chaps1988 folded before Flop (didn't bet)
Seat 3: sanpidk (button) folded before Flop (didn't bet)
Seat 4: nickreason17 (small blind) folded before Flop
Seat 5: matiko09 (big blind) folded before Flop
Seat 6: buttonlife collected ($2.50)
Seat 8: ozone2003 folded before Flop (didn't bet)
Seat 9: tompi-tomp folded before Flop (didn't bet)





PokerStars Hand #148217648980:  Hold'em No Limit ($0.50/$1.00 USD) - 2016/02/04 14:44:22 CET [2016/02/04 8:44:22 ET]
Table 'Asios III' 9-max Seat #9 is the button
Seat 1: yourpro ($100 in chips) 
Seat 2: crime8783 ($52.42 in chips) 
Seat 3: Igor DoUrden ($100 in chips) 
Seat 5: ilaviiitech ($100 in chips) 
Seat 6: matiko09 ($126.50 in chips) 
Seat 7: nickreason17 ($195.96 in chips) 
Seat 8: Sweden_Pound ($100 in chips) 
Seat 9: Vikulja1993 ($154.81 in chips) 
yourpro: posts small blind $0.50
crime8783: posts big blind $1
TimStone: sits out 
*** HOLE CARDS ***
Dealt to matiko09 [6h 4h]
Igor DoUrden: folds 
ilaviiitech: folds 
matiko09: folds 
nickreason17: folds 
Sweden_Pound: raises $1.50 to $2.50
Vikulja1993: folds 
yourpro: folds 
crime8783: calls $1.50
*** FLOP *** [3d Jh 9h]
crime8783: checks 
Sweden_Pound: bets $4
crime8783: calls $4
*** TURN *** [3d Jh 9h] [As]
crime8783: checks 
Sweden_Pound: bets $9
crime8783: folds 
Uncalled bet ($9) returned to Sweden_Pound
Sweden_Pound collected $12.89 from pot
Sweden_Pound: doesn't show hand 
*** SUMMARY ***
Total pot $13.50 | Rake $0.61 
Board [3d Jh 9h As]
Seat 1: yourpro (small blind) folded before Flop
Seat 2: crime8783 (big blind) folded on the Turn
Seat 3: Igor DoUrden folded before Flop (didn't bet)
Seat 5: ilaviiitech folded before Flop (didn't bet)
Seat 6: matiko09 folded before Flop (didn't bet)
Seat 7: nickreason17 folded before Flop (didn't bet)
Seat 8: Sweden_Pound collected ($12.89)
Seat 9: Vikulja1993 (button) folded before Flop (didn't bet)





PokerStars Hand #148217651712:  Hold'em No Limit (€0.50/€1.00 EUR) - 2016/02/04 14:44:26 CET [2016/02/04 8:44:26 ET]
Table 'Ostenia' 9-max Seat #2 is the button
Seat 1: matiko09 (€100 in chips) 
Seat 2: tipner (€100 in chips) 
Seat 4: er13to (€100.50 in chips) 
Seat 5: Sweden_Pound (€100 in chips) 
Seat 6: melitakas (€110.29 in chips) 
Seat 7: RoadtoNepal (€110.64 in chips) 
Seat 8: Venomous100% (€100 in chips) 
er13to: posts small blind €0.50
Sweden_Pound: posts big blind €1
*** HOLE CARDS ***
Dealt to matiko09 [3c Qc]
melitakas: folds 
RoadtoNepal: folds 
Venomous100%: folds 
matiko09: folds 
9lKBXKTT6 joins the table at seat #3 
tipner: folds 
er13to: folds 
Uncalled bet (€0.50) returned to Sweden_Pound
Sweden_Pound collected €1 from pot
Sweden_Pound: doesn't show hand 
*** SUMMARY ***
Total pot €1 | Rake €0 
Seat 1: matiko09 folded before Flop (didn't bet)
Seat 2: tipner (button) folded before Flop (didn't bet)
Seat 4: er13to (small blind) folded before Flop
Seat 5: Sweden_Pound (big blind) collected (€1)
Seat 6: melitakas folded before Flop (didn't bet)
Seat 7: RoadtoNepal folded before Flop (didn't bet)
Seat 8: Venomous100% folded before Flop (didn't bet)





PokerStars Hand #148217651436:  Hold'em No Limit ($0.50/$1.00 USD) - 2016/02/04 14:44:26 CET [2016/02/04 8:44:26 ET]
Table 'Arneb III' 9-max Seat #1 is the button
Seat 1: Vikulja1993 ($100 in chips) 
Seat 2: JeanLima93 ($92.12 in chips) 
Seat 3: matiko09 ($100 in chips) 
Seat 4: Igor DoUrden ($227.31 in chips) 
Seat 5: tipner ($101.50 in chips) 
Seat 6: nickreason17 ($101.50 in chips) 
Seat 7: Spid1 ($100 in chips) 
Seat 8: volwebni4ek ($56.48 in chips) 
Seat 9: ARTVOR640 ($100 in chips) 
JeanLima93: posts small blind $0.50
matiko09: posts big blind $1
*** HOLE CARDS ***
Dealt to matiko09 [2h 5c]
Igor DoUrden: folds 
tipner: folds 
nickreason17: folds 
Spid1: folds 
volwebni4ek: raises $1.50 to $2.50
ARTVOR640: folds 
Vikulja1993: folds 
JeanLima93: raises $3.50 to $6
matiko09: folds 
volwebni4ek: calls $3.50
*** FLOP *** [8c 7c Qc]
JeanLima93: bets $12.42
volwebni4ek: calls $12.42
*** TURN *** [8c 7c Qc] [Ad]
JeanLima93: checks 
volwebni4ek: checks 
*** RIVER *** [8c 7c Qc Ad] [6h]
JeanLima93: bets $73.70 and is all-in
volwebni4ek: folds 
Uncalled bet ($73.70) returned to JeanLima93
JeanLima93 collected $36.14 from pot
JeanLima93: doesn't show hand 
*** SUMMARY ***
Total pot $37.84 | Rake $1.70 
Board [8c 7c Qc Ad 6h]
Seat 1: Vikulja1993 (button) folded before Flop (didn't bet)
Seat 2: JeanLima93 (small blind) collected ($36.14)
Seat 3: matiko09 (big blind) folded before Flop
Seat 4: Igor DoUrden folded before Flop (didn't bet)
Seat 5: tipner folded before Flop (didn't bet)
Seat 6: nickreason17 folded before Flop (didn't bet)
Seat 7: Spid1 folded before Flop (didn't bet)
Seat 8: volwebni4ek folded on the River
Seat 9: ARTVOR640 folded before Flop (didn't bet)





PokerStars Hand #148217657959:  Hold'em No Limit ($0.50/$1.00 USD) - 2016/02/04 14:44:35 CET [2016/02/04 8:44:35 ET]
Table 'Sargas' 9-max Seat #4 is the button
Seat 1: Sweden_Pound ($100 in chips) 
Seat 2: chaps1988 ($100 in chips) 
Seat 3: sanpidk ($108.69 in chips) 
Seat 4: nickreason17 ($100 in chips) 
Seat 5: matiko09 ($100.50 in chips) 
Seat 6: buttonlife ($48 in chips) 
Seat 8: ozone2003 ($100 in chips) 
Seat 9: tompi-tomp ($85.48 in chips) 
matiko09: posts small blind $0.50
buttonlife: posts big blind $1
DENG1118: sits out 
*** HOLE CARDS ***
Dealt to matiko09 [9s Qh]
ozone2003: folds 
tompi-tomp: folds 
Sweden_Pound: folds 
chaps1988: folds 
sanpidk: raises $1.50 to $2.50
nickreason17: folds 
matiko09: folds 
buttonlife: folds 
Uncalled bet ($1.50) returned to sanpidk
sanpidk collected $2.50 from pot
sanpidk: doesn't show hand 
*** SUMMARY ***
Total pot $2.50 | Rake $0 
Seat 1: Sweden_Pound folded before Flop (didn't bet)
Seat 2: chaps1988 folded before Flop (didn't bet)
Seat 3: sanpidk collected ($2.50)
Seat 4: nickreason17 (button) folded before Flop (didn't bet)
Seat 5: matiko09 (small blind) folded before Flop
Seat 6: buttonlife (big blind) folded before Flop
Seat 8: ozone2003 folded before Flop (didn't bet)
Seat 9: tompi-tomp folded before Flop (didn't bet)





PokerStars Hand #148217663449:  Hold'em No Limit ($0.50/$1.00 USD) - 2016/02/04 14:44:42 CET [2016/02/04 8:44:42 ET]
Table 'Arneb II' 9-max Seat #9 is the button
Seat 1: matiko09 ($100.50 in chips) 
Seat 2: sanpidk ($100 in chips) 
Seat 3: brille-390 ($104.50 in chips) 
Seat 4: Venomous100% ($100 in chips) 
Seat 5: lixiangli ($96.18 in chips) 
Seat 6: Sweden_Pound ($141.50 in chips) 
Seat 7: melitakas ($229.81 in chips) 
Seat 8: tedbadger9 ($80 in chips) 
Seat 9: tipner ($100 in chips) 
matiko09: posts small blind $0.50
sanpidk: posts big blind $1
*** HOLE CARDS ***
Dealt to matiko09 [As 4c]
brille-390: raises $1 to $2
Venomous100%: folds 
lixiangli: folds 
Sweden_Pound: folds 
melitakas: folds 
tedbadger9: folds 
tipner: folds 
matiko09: folds 
sanpidk: folds 
Uncalled bet ($1) returned to brille-390
brille-390 collected $2.50 from pot
brille-390: doesn't show hand 
*** SUMMARY ***
Total pot $2.50 | Rake $0 
Seat 1: matiko09 (small blind) folded before Flop
Seat 2: sanpidk (big blind) folded before Flop
Seat 3: brille-390 collected ($2.50)
Seat 4: Venomous100% folded before Flop (didn't bet)
Seat 5: lixiangli folded before Flop (didn't bet)
Seat 6: Sweden_Pound folded before Flop (didn't bet)
Seat 7: melitakas folded before Flop (didn't bet)
Seat 8: tedbadger9 folded before Flop (didn't bet)
Seat 9: tipner (button) folded before Flop (didn't bet)





PokerStars Hand #148217673450:  Hold'em No Limit (€0.50/€1.00 EUR) - 2016/02/04 14:44:56 CET [2016/02/04 8:44:56 ET]
Table 'Ostenia' 9-max Seat #4 is the button
Seat 1: matiko09 (€100 in chips) 
Seat 2: tipner (€100 in chips) 
Seat 4: er13to (€100 in chips) 
Seat 5: Sweden_Pound (€100.50 in chips) 
Seat 6: melitakas (€110.29 in chips) 
Seat 7: RoadtoNepal (€110.64 in chips) 
Seat 8: Venomous100% (€100 in chips) 
Sweden_Pound: posts small blind €0.50
melitakas: posts big blind €1
9lKBXKTT6: sits out 
*** HOLE CARDS ***
Dealt to matiko09 [8d Js]
RoadtoNepal: folds 
Venomous100%: raises €2 to €3
matiko09: folds 
tipner: folds 
9lKBXKTT6 leaves the table
er13to: folds 
Sweden_Pound: folds 
melitakas: folds 
Uncalled bet (€2) returned to Venomous100%
Venomous100% collected €2.50 from pot
Venomous100%: doesn't show hand 
*** SUMMARY ***
Total pot €2.50 | Rake €0 
Seat 1: matiko09 folded before Flop (didn't bet)
Seat 2: tipner folded before Flop (didn't bet)
Seat 4: er13to (button) folded before Flop (didn't bet)
Seat 5: Sweden_Pound (small blind) folded before Flop
Seat 6: melitakas (big blind) folded before Flop
Seat 7: RoadtoNepal folded before Flop (didn't bet)
Seat 8: Venomous100% collected (€2.50)





PokerStars Hand #148217675663:  Hold'em No Limit ($0.50/$1.00 USD) - 2016/02/04 14:45:00 CET [2016/02/04 8:45:00 ET]
Table 'Sargas' 9-max Seat #5 is the button
Seat 1: Sweden_Pound ($100 in chips) 
Seat 2: chaps1988 ($100 in chips) 
Seat 3: sanpidk ($110.19 in chips) 
Seat 4: nickreason17 ($100 in chips) 
Seat 5: matiko09 ($100 in chips) 
Seat 6: buttonlife ($47 in chips) 
Seat 7: DENG1118 ($80 in chips) 
Seat 8: ozone2003 ($100 in chips) 
Seat 9: tompi-tomp ($85.48 in chips) 
buttonlife: posts small blind $0.50
DENG1118: posts big blind $1
*** HOLE CARDS ***
Dealt to matiko09 [3h 7s]
ozone2003: folds 
tompi-tomp: folds 
Sweden_Pound: folds 
chaps1988: folds 
sanpidk: raises $1.50 to $2.50
nickreason17: folds 
matiko09: folds 
buttonlife: folds 
DENG1118: folds 
Uncalled bet ($1.50) returned to sanpidk
sanpidk collected $2.50 from pot
sanpidk: doesn't show hand 
*** SUMMARY ***
Total pot $2.50 | Rake $0 
Seat 1: Sweden_Pound folded before Flop (didn't bet)
Seat 2: chaps1988 folded before Flop (didn't bet)
Seat 3: sanpidk collected ($2.50)
Seat 4: nickreason17 folded before Flop (didn't bet)
Seat 5: matiko09 (button) folded before Flop (didn't bet)
Seat 6: buttonlife (small blind) folded before Flop
Seat 7: DENG1118 (big blind) folded before Flop
Seat 8: ozone2003 folded before Flop (didn't bet)
Seat 9: tompi-tomp folded before Flop (didn't bet)





PokerStars Hand #148217677154:  Hold'em No Limit ($0.50/$1.00 USD) - 2016/02/04 14:45:02 CET [2016/02/04 8:45:02 ET]
Table 'Sodankyla' 9-max Seat #6 is the button
Seat 1: sanpidk ($101.50 in chips) 
Seat 2: Sweden_Pound ($103 in chips) 
Seat 3: yourpro ($100 in chips) 
Seat 5: matiko09 ($100 in chips) 
Seat 6: nickreason17 ($100 in chips) 
Seat 7: RoadtoNepal ($115.23 in chips) 
Seat 8: Arunas71 ($58.50 in chips) 
Seat 9: TheDoctor635 ($86.59 in chips) 
RoadtoNepal: posts small blind $0.50
Arunas71: posts big blind $1
xxxZeka: sits out 
*** HOLE CARDS ***
Dealt to matiko09 [Qd Js]
TheDoctor635: folds 
sanpidk: folds 
Sweden_Pound: folds 
yourpro: folds 
matiko09: raises $1.50 to $2.50
nickreason17: folds 
RoadtoNepal: raises $6.50 to $9
Arunas71: folds 
matiko09: folds 
Uncalled bet ($6.50) returned to RoadtoNepal
RoadtoNepal collected $6 from pot
RoadtoNepal: doesn't show hand 
*** SUMMARY ***
Total pot $6 | Rake $0 
Seat 1: sanpidk folded before Flop (didn't bet)
Seat 2: Sweden_Pound folded before Flop (didn't bet)
Seat 3: yourpro folded before Flop (didn't bet)
Seat 5: matiko09 folded before Flop
Seat 6: nickreason17 (button) folded before Flop (didn't bet)
Seat 7: RoadtoNepal (small blind) collected ($6)
Seat 8: Arunas71 (big blind) folded before Flop
Seat 9: TheDoctor635 folded before Flop (didn't bet)





PokerStars Hand #148217687292:  Hold'em No Limit ($0.50/$1.00 USD) - 2016/02/04 14:45:15 CET [2016/02/04 8:45:15 ET]
Table 'Alkaid II' 9-max Seat #4 is the button
Seat 1: Sweden_Pound ($124.94 in chips) 
Seat 2: Venomous100% ($143.76 in chips) 
Seat 3: 1557PSS ($58.13 in chips) 
Seat 4: sanpidk ($101.21 in chips) 
Seat 5: I The King I ($100 in chips) 
Seat 6: matiko09 ($100 in chips) 
Seat 7: vicdroopy ($136.32 in chips) 
Seat 8: yourpro ($103 in chips) 
Seat 9: tjl290 ($54.08 in chips) 
I The King I: posts small blind $0.50
matiko09: posts big blind $1
*** HOLE CARDS ***
Dealt to matiko09 [6d Kd]
vicdroopy: raises $2 to $3
yourpro: calls $3
tjl290: folds 
Sweden_Pound: folds 
Venomous100%: folds 
1557PSS: folds 
sanpidk: raises $10 to $13
I The King I: folds 
matiko09: folds 
vicdroopy: folds 
yourpro: calls $10
*** FLOP *** [Kh 6s 2d]
yourpro: checks 
sanpidk: bets $13.50
yourpro: folds 
Uncalled bet ($13.50) returned to sanpidk
sanpidk collected $29.13 from pot
sanpidk: doesn't show hand 
*** SUMMARY ***
Total pot $30.50 | Rake $1.37 
Board [Kh 6s 2d]
Seat 1: Sweden_Pound folded before Flop (didn't bet)
Seat 2: Venomous100% folded before Flop (didn't bet)
Seat 3: 1557PSS folded before Flop (didn't bet)
Seat 4: sanpidk (button) collected ($29.13)
Seat 5: I The King I (small blind) folded before Flop
Seat 6: matiko09 (big blind) folded before Flop
Seat 7: vicdroopy folded before Flop
Seat 8: yourpro folded on the Flop
Seat 9: tjl290 folded before Flop (didn't bet)





PokerStars Hand #148217689953:  Hold'em No Limit ($0.50/$1.00 USD) - 2016/02/04 14:45:19 CET [2016/02/04 8:45:19 ET]
Table 'Arneb II' 9-max Seat #1 is the button
Seat 1: matiko09 ($100 in chips) 
Seat 2: sanpidk ($100 in chips) 
Seat 3: brille-390 ($106 in chips) 
Seat 4: Venomous100% ($100 in chips) 
Seat 5: lixiangli ($96.18 in chips) 
Seat 6: Sweden_Pound ($141.50 in chips) 
Seat 7: melitakas ($229.81 in chips) 
Seat 8: tedbadger9 ($80 in chips) 
Seat 9: tipner ($100 in chips) 
sanpidk: posts small blind $0.50
brille-390: posts big blind $1
*** HOLE CARDS ***
Dealt to matiko09 [Ad 9d]
Venomous100%: folds 
lixiangli: raises $2 to $3
Sweden_Pound: folds 
melitakas: folds 
tedbadger9: folds 
tipner: folds 
matiko09: raises $6.50 to $9.50
sanpidk: calls $9
brille-390: folds 
lixiangli: folds 
*** FLOP *** [Jd 8s 2d]
sanpidk: bets $12.63
matiko09: raises $23.37 to $36
sanpidk: raises $54.50 to $90.50 and is all-in
matiko09: calls $54.50 and is all-in
*** TURN *** [Jd 8s 2d] [6s]
*** RIVER *** [Jd 8s 2d 6s] [Tc]
*** SHOW DOWN ***
sanpidk: shows [Kd Kh] (a pair of Kings)
matiko09: mucks hand 
sanpidk collected $201.20 from pot
*** SUMMARY ***
Total pot $204 | Rake $2.80 
Board [Jd 8s 2d 6s Tc]
Seat 1: matiko09 (button) mucked [Ad 9d]
Seat 2: sanpidk (small blind) showed [Kd Kh] and won ($201.20) with a pair of Kings
Seat 3: brille-390 (big blind) folded before Flop
Seat 4: Venomous100% folded before Flop (didn't bet)
Seat 5: lixiangli folded before Flop
Seat 6: Sweden_Pound folded before Flop (didn't bet)
Seat 7: melitakas folded before Flop (didn't bet)
Seat 8: tedbadger9 folded before Flop (didn't bet)
Seat 9: tipner folded before Flop (didn't bet)





PokerStars Hand #148217698209:  Hold'em No Limit (€0.50/€1.00 EUR) - 2016/02/04 14:45:31 CET [2016/02/04 8:45:31 ET]
Table 'Ostenia' 9-max Seat #5 is the button
Seat 1: matiko09 (€100 in chips) 
Seat 2: tipner (€100 in chips) 
Seat 4: er13to (€100 in chips) 
Seat 5: Sweden_Pound (€100 in chips) 
Seat 6: melitakas (€109.29 in chips) 
Seat 8: Venomous100% (€101.50 in chips) 
melitakas: posts small blind €0.50
RoadtoNepal: is sitting out 
Venomous100%: posts big blind €1
*** HOLE CARDS ***
Dealt to matiko09 [Qd 5s]
matiko09: folds 
tipner: folds 
er13to: folds 
Sweden_Pound: folds 
melitakas: raises €1 to €2
Venomous100%: calls €1
*** FLOP *** [9h Tc Ts]
melitakas: bets €2
Venomous100%: calls €2
*** TURN *** [9h Tc Ts] [5h]
melitakas: checks 
Venomous100%: bets €5.73
melitakas: calls €5.73
*** RIVER *** [9h Tc Ts 5h] [6d]
melitakas: checks 
ozone2003 joins the table at seat #3 
Venomous100%: bets €12.38
melitakas: folds 
Uncalled bet (€12.38) returned to Venomous100%
Venomous100% collected €18.58 from pot
Venomous100%: doesn't show hand 
*** SUMMARY ***
Total pot €19.46 | Rake €0.88 
Board [9h Tc Ts 5h 6d]
Seat 1: matiko09 folded before Flop (didn't bet)
Seat 2: tipner folded before Flop (didn't bet)
Seat 4: er13to folded before Flop (didn't bet)
Seat 5: Sweden_Pound (button) folded before Flop (didn't bet)
Seat 6: melitakas (small blind) folded on the River
Seat 8: Venomous100% (big blind) collected (€18.58)





PokerStars Hand #148217700509:  Hold'em No Limit ($0.50/$1.00 USD) - 2016/02/04 14:45:34 CET [2016/02/04 8:45:34 ET]
Table 'Sargas' 9-max Seat #6 is the button
Seat 1: Sweden_Pound ($100 in chips) 
Seat 2: chaps1988 ($100 in chips) 
Seat 3: sanpidk ($111.69 in chips) 
Seat 4: nickreason17 ($100 in chips) 
Seat 5: matiko09 ($100 in chips) 
Seat 6: buttonlife ($46.50 in chips) 
Seat 7: DENG1118 ($79 in chips) 
Seat 8: ozone2003 ($100 in chips) 
Seat 9: tompi-tomp ($85.48 in chips) 
DENG1118: posts small blind $0.50
ozone2003: posts big blind $1
*** HOLE CARDS ***
Dealt to matiko09 [Jd Th]
tompi-tomp: folds 
Sweden_Pound: folds 
chaps1988: folds 
sanpidk: folds 
nickreason17: folds 
matiko09: folds 
buttonlife: folds 
DENG1118: raises $2 to $3
ozone2003: calls $2
*** FLOP *** [Ac 8s Js]
DENG1118: bets $5.73
ozone2003: folds 
Uncalled bet ($5.73) returned to DENG1118
DENG1118 collected $5.73 from pot
DENG1118: doesn't show hand 
*** SUMMARY ***
Total pot $6 | Rake $0.27 
Board [Ac 8s Js]
Seat 1: Sweden_Pound folded before Flop (didn't bet)
Seat 2: chaps1988 folded before Flop (didn't bet)
Seat 3: sanpidk folded before Flop (didn't bet)
Seat 4: nickreason17 folded before Flop (didn't bet)
Seat 5: matiko09 folded before Flop (didn't bet)
Seat 6: buttonlife (button) folded before Flop (didn't bet)
Seat 7: DENG1118 (small blind) collected ($5.73)
Seat 8: ozone2003 (big blind) folded on the Flop
Seat 9: tompi-tomp folded before Flop (didn't bet)





PokerStars Hand #148217713755:  Hold'em No Limit ($0.50/$1.00 USD) - 2016/02/04 14:45:52 CET [2016/02/04 8:45:52 ET]
Table 'Asios III' 9-max Seat #1 is the button
Seat 1: yourpro ($100 in chips) 
Seat 2: crime8783 ($45.92 in chips) 
Seat 3: Igor DoUrden ($100 in chips) 
Seat 5: ilaviiitech ($100 in chips) 
Seat 6: matiko09 ($126.50 in chips) 
Seat 7: nickreason17 ($195.96 in chips) 
Seat 8: Sweden_Pound ($106.39 in chips) 
Seat 9: Vikulja1993 ($154.81 in chips) 
crime8783: posts small blind $0.50
Igor DoUrden: posts big blind $1
TimStone: sits out 
*** HOLE CARDS ***
Dealt to matiko09 [9h 6h]
ilaviiitech: folds 
matiko09: folds 
nickreason17: folds 
Sweden_Pound: raises $2 to $3
Vikulja1993: folds 
yourpro: folds 
crime8783: calls $2.50
Igor DoUrden: folds 
*** FLOP *** [Ah 9s Ad]
crime8783: checks 
Sweden_Pound: bets $4
crime8783: folds 
Uncalled bet ($4) returned to Sweden_Pound
Sweden_Pound collected $6.68 from pot
Sweden_Pound: doesn't show hand 
*** SUMMARY ***
Total pot $7 | Rake $0.32 
Board [Ah 9s Ad]
Seat 1: yourpro (button) folded before Flop (didn't bet)
Seat 2: crime8783 (small blind) folded on the Flop
Seat 3: Igor DoUrden (big blind) folded before Flop
Seat 5: ilaviiitech folded before Flop (didn't bet)
Seat 6: matiko09 folded before Flop (didn't bet)
Seat 7: nickreason17 folded before Flop (didn't bet)
Seat 8: Sweden_Pound collected ($6.68)
Seat 9: Vikulja1993 folded before Flop (didn't bet)





PokerStars Hand #148217714788:  Hold'em No Limit ($0.50/$1.00 USD) - 2016/02/04 14:45:54 CET [2016/02/04 8:45:54 ET]
Table 'Sodankyla' 9-max Seat #7 is the button
Seat 1: sanpidk ($101.50 in chips) 
Seat 2: Sweden_Pound ($103 in chips) 
Seat 3: yourpro ($100 in chips) 
Seat 5: matiko09 ($100 in chips) 
Seat 6: nickreason17 ($100 in chips) 
Seat 7: RoadtoNepal ($118.73 in chips) 
Seat 8: Arunas71 ($57.50 in chips) 
Seat 9: TheDoctor635 ($86.59 in chips) 
Arunas71: posts small blind $0.50
TheDoctor635: posts big blind $1
xxxZeka: sits out 
*** HOLE CARDS ***
Dealt to matiko09 [6h 2d]
sanpidk: raises $2 to $3
Sweden_Pound: folds 
yourpro: folds 
matiko09: folds 
nickreason17: calls $3
RoadtoNepal: folds 
Arunas71: folds 
TheDoctor635: calls $2
*** FLOP *** [Kd 6d 9h]
TheDoctor635: checks 
sanpidk: checks 
nickreason17: checks 
*** TURN *** [Kd 6d 9h] [5s]
TheDoctor635: checks 
sanpidk: bets $5.50
nickreason17: folds 
TheDoctor635: folds 
Uncalled bet ($5.50) returned to sanpidk
sanpidk collected $9.07 from pot
sanpidk: doesn't show hand 
*** SUMMARY ***
Total pot $9.50 | Rake $0.43 
Board [Kd 6d 9h 5s]
Seat 1: sanpidk collected ($9.07)
Seat 2: Sweden_Pound folded before Flop (didn't bet)
Seat 3: yourpro folded before Flop (didn't bet)
Seat 5: matiko09 folded before Flop (didn't bet)
Seat 6: nickreason17 folded on the Turn
Seat 7: RoadtoNepal (button) folded before Flop (didn't bet)
Seat 8: Arunas71 (small blind) folded before Flop
Seat 9: TheDoctor635 (big blind) folded on the Turn





PokerStars Hand #148217718938:  Hold'em No Limit ($0.50/$1.00 USD) - 2016/02/04 14:46:00 CET [2016/02/04 8:46:00 ET]
Table 'Arneb III' 9-max Seat #2 is the button
Seat 1: Vikulja1993 ($100 in chips) 
Seat 2: JeanLima93 ($109.84 in chips) 
Seat 3: matiko09 ($100 in chips) 
Seat 4: Igor DoUrden ($227.31 in chips) 
Seat 5: tipner ($101.50 in chips) 
Seat 6: nickreason17 ($101.50 in chips) 
Seat 7: Spid1 ($100 in chips) 
Seat 8: volwebni4ek ($40 in chips) 
Seat 9: ARTVOR640 ($100 in chips) 
matiko09: posts small blind $0.50
Igor DoUrden: posts big blind $1
*** HOLE CARDS ***
Dealt to matiko09 [2d 9h]
tipner: folds 
nickreason17: folds 
Spid1: folds 
volwebni4ek: folds 
ARTVOR640: folds 
Vikulja1993: folds 
JeanLima93: folds 
matiko09: folds 
Uncalled bet ($0.50) returned to Igor DoUrden
Igor DoUrden collected $1 from pot
Igor DoUrden: doesn't show hand 
*** SUMMARY ***
Total pot $1 | Rake $0 
Seat 1: Vikulja1993 folded before Flop (didn't bet)
Seat 2: JeanLima93 (button) folded before Flop (didn't bet)
Seat 3: matiko09 (small blind) folded before Flop
Seat 4: Igor DoUrden (big blind) collected ($1)
Seat 5: tipner folded before Flop (didn't bet)
Seat 6: nickreason17 folded before Flop (didn't bet)
Seat 7: Spid1 folded before Flop (didn't bet)
Seat 8: volwebni4ek folded before Flop (didn't bet)
Seat 9: ARTVOR640 folded before Flop (didn't bet)





PokerStars Hand #148217725927:  Hold'em No Limit ($0.50/$1.00 USD) - 2016/02/04 14:46:09 CET [2016/02/04 8:46:09 ET]
Table 'Sargas' 9-max Seat #7 is the button
Seat 1: Sweden_Pound ($100 in chips) 
Seat 2: chaps1988 ($100 in chips) 
Seat 3: sanpidk ($111.69 in chips) 
Seat 4: nickreason17 ($100 in chips) 
Seat 5: matiko09 ($100 in chips) 
Seat 6: buttonlife ($46.50 in chips) 
Seat 7: DENG1118 ($81.73 in chips) 
Seat 8: ozone2003 ($100 in chips) 
Seat 9: tompi-tomp ($85.48 in chips) 
ozone2003: posts small blind $0.50
tompi-tomp: posts big blind $1
*** HOLE CARDS ***
Dealt to matiko09 [Ad 7c]
Sweden_Pound: folds 
chaps1988: folds 
sanpidk: folds 
nickreason17: raises $2 to $3
matiko09: folds 
buttonlife: folds 
DENG1118: raises $7.50 to $10.50
ozone2003: folds 
tompi-tomp: folds 
nickreason17: raises $15 to $25.50
DENG1118: calls $15
*** FLOP *** [Kc 2h Qh]
nickreason17: checks 
DENG1118: bets $25.07
nickreason17: raises $49.43 to $74.50 and is all-in
DENG1118: calls $31.16 and is all-in
Uncalled bet ($18.27) returned to nickreason17
*** TURN *** [Kc 2h Qh] [Tc]
*** RIVER *** [Kc 2h Qh Tc] [Qd]
*** SHOW DOWN ***
nickreason17: shows [Ac As] (two pair, Aces and Queens)
DENG1118: shows [Kh Ah] (two pair, Kings and Queens)
nickreason17 collected $162.16 from pot
*** SUMMARY ***
Total pot $164.96 | Rake $2.80 
Board [Kc 2h Qh Tc Qd]
Seat 1: Sweden_Pound folded before Flop (didn't bet)
Seat 2: chaps1988 folded before Flop (didn't bet)
Seat 3: sanpidk folded before Flop (didn't bet)
Seat 4: nickreason17 showed [Ac As] and won ($162.16) with two pair, Aces and Queens
Seat 5: matiko09 folded before Flop (didn't bet)
Seat 6: buttonlife folded before Flop (didn't bet)
Seat 7: DENG1118 (button) showed [Kh Ah] and lost with two pair, Kings and Queens
Seat 8: ozone2003 (small blind) folded before Flop
Seat 9: tompi-tomp (big blind) folded before Flop





PokerStars Hand #148217738831:  Hold'em No Limit (€0.50/€1.00 EUR) - 2016/02/04 14:46:27 CET [2016/02/04 8:46:27 ET]
Table 'Ostenia' 9-max Seat #6 is the button
Seat 1: matiko09 (€100 in chips) 
Seat 2: tipner (€100 in chips) 
Seat 4: er13to (€100 in chips) 
Seat 5: Sweden_Pound (€100 in chips) 
Seat 6: melitakas (€100 in chips) 
Seat 8: Venomous100% (€110.35 in chips) 
Venomous100%: posts small blind €0.50
matiko09: posts big blind €1
ozone2003: sits out 
*** HOLE CARDS ***
Dealt to matiko09 [4s 3s]
tipner: folds 
er13to: raises €1.50 to €2.50
Sweden_Pound: folds 
melitakas: folds 
Venomous100%: folds 
matiko09: folds 
Uncalled bet (€1.50) returned to er13to
er13to collected €2.50 from pot
*** SUMMARY ***
Total pot €2.50 | Rake €0 
Seat 1: matiko09 (big blind) folded before Flop
Seat 2: tipner folded before Flop (didn't bet)
Seat 4: er13to collected (€2.50)
Seat 5: Sweden_Pound folded before Flop (didn't bet)
Seat 6: melitakas (button) folded before Flop (didn't bet)
Seat 8: Venomous100% (small blind) folded before Flop





PokerStars Hand #148217740775:  Hold'em No Limit ($0.50/$1.00 USD) - 2016/02/04 14:46:30 CET [2016/02/04 8:46:30 ET]
Table 'Arneb III' 9-max Seat #3 is the button
Seat 1: Vikulja1993 ($100 in chips) 
Seat 2: JeanLima93 ($109.84 in chips) 
Seat 3: matiko09 ($100 in chips) 
Seat 4: Igor DoUrden ($227.81 in chips) 
Seat 5: tipner ($101.50 in chips) 
Seat 6: nickreason17 ($101.50 in chips) 
Seat 7: Spid1 ($100 in chips) 
Seat 8: volwebni4ek ($40 in chips) 
Seat 9: ARTVOR640 ($100 in chips) 
Igor DoUrden: posts small blind $0.50
tipner: posts big blind $1
*** HOLE CARDS ***
Dealt to matiko09 [8c 3d]
nickreason17: folds 
Spid1: folds 
volwebni4ek: folds 
ARTVOR640: folds 
Vikulja1993: folds 
JeanLima93: folds 
matiko09: folds 
Igor DoUrden: raises $2.09 to $3.09
tipner: folds 
Uncalled bet ($2.09) returned to Igor DoUrden
Igor DoUrden collected $2 from pot
Igor DoUrden: doesn't show hand 
*** SUMMARY ***
Total pot $2 | Rake $0 
Seat 1: Vikulja1993 folded before Flop (didn't bet)
Seat 2: JeanLima93 folded before Flop (didn't bet)
Seat 3: matiko09 (button) folded before Flop (didn't bet)
Seat 4: Igor DoUrden (small blind) collected ($2)
Seat 5: tipner (big blind) folded before Flop
Seat 6: nickreason17 folded before Flop (didn't bet)
Seat 7: Spid1 folded before Flop (didn't bet)
Seat 8: volwebni4ek folded before Flop (didn't bet)
Seat 9: ARTVOR640 folded before Flop (didn't bet)





PokerStars Hand #148217754126:  Hold'em No Limit ($0.50/$1.00 USD) - 2016/02/04 14:46:49 CET [2016/02/04 8:46:49 ET]
Table 'Asios III' 9-max Seat #2 is the button
Seat 1: yourpro ($100 in chips) 
Seat 2: crime8783 ($42.92 in chips) 
Seat 3: Igor DoUrden ($100 in chips) 
Seat 4: TimStone ($100 in chips) 
Seat 5: ilaviiitech ($100 in chips) 
Seat 6: matiko09 ($126.50 in chips) 
Seat 7: nickreason17 ($195.96 in chips) 
Seat 8: Sweden_Pound ($110.07 in chips) 
Seat 9: Vikulja1993 ($154.81 in chips) 
Igor DoUrden: posts small blind $0.50
TimStone: posts big blind $1
*** HOLE CARDS ***
Dealt to matiko09 [Tc Ad]
ilaviiitech: folds 
matiko09: folds 
nickreason17: folds 
Sweden_Pound: folds 
Vikulja1993: folds 
yourpro: folds 
crime8783: calls $1
Igor DoUrden: folds 
TimStone: checks 
*** FLOP *** [5s 9h 7s]
TimStone: bets $1.83
crime8783: calls $1.83
*** TURN *** [5s 9h 7s] [Jh]
TimStone: checks 
crime8783: checks 
*** RIVER *** [5s 9h 7s Jh] [Td]
TimStone: checks 
crime8783: bets $10
TimStone: folds 
Uncalled bet ($10) returned to crime8783
crime8783 collected $5.88 from pot
crime8783: doesn't show hand 
*** SUMMARY ***
Total pot $6.16 | Rake $0.28 
Board [5s 9h 7s Jh Td]
Seat 1: yourpro folded before Flop (didn't bet)
Seat 2: crime8783 (button) collected ($5.88)
Seat 3: Igor DoUrden (small blind) folded before Flop
Seat 4: TimStone (big blind) folded on the River
Seat 5: ilaviiitech folded before Flop (didn't bet)
Seat 6: matiko09 folded before Flop (didn't bet)
Seat 7: nickreason17 folded before Flop (didn't bet)
Seat 8: Sweden_Pound folded before Flop (didn't bet)
Seat 9: Vikulja1993 folded before Flop (didn't bet)





PokerStars Hand #148217758736:  Hold'em No Limit ($0.50/$1.00 USD) - 2016/02/04 14:46:55 CET [2016/02/04 8:46:55 ET]
Table 'Arneb III' 9-max Seat #4 is the button
Seat 1: Vikulja1993 ($100 in chips) 
Seat 2: JeanLima93 ($109.84 in chips) 
Seat 3: matiko09 ($100 in chips) 
Seat 4: Igor DoUrden ($228.81 in chips) 
Seat 5: tipner ($100.50 in chips) 
Seat 6: nickreason17 ($101.50 in chips) 
Seat 7: Spid1 ($100 in chips) 
Seat 8: volwebni4ek ($40 in chips) 
Seat 9: ARTVOR640 ($100 in chips) 
tipner: posts small blind $0.50
nickreason17: posts big blind $1
*** HOLE CARDS ***
Dealt to matiko09 [4c Jd]
Spid1: raises $2 to $3
volwebni4ek: folds 
ARTVOR640: folds 
Vikulja1993: raises $6 to $9
JeanLima93: calls $9
matiko09: folds 
Igor DoUrden: folds 
tipner: folds 
nickreason17: folds 
Spid1: calls $6
*** FLOP *** [7s Js 7d]
Spid1: checks 
Vikulja1993: bets $9.50
JeanLima93: raises $23.11 to $32.61
Spid1: folds 
Vikulja1993: raises $57.39 to $90
JeanLima93: raises $10.84 to $100.84 and is all-in
Vikulja1993: calls $1 and is all-in
Uncalled bet ($9.84) returned to JeanLima93
*** TURN *** [7s Js 7d] [5s]
*** RIVER *** [7s Js 7d 5s] [Qs]
*** SHOW DOWN ***
Vikulja1993: shows [Ac Ad] (two pair, Aces and Sevens)
JeanLima93: shows [9d 9s] (a flush, Queen high)
JeanLima93 collected $207.70 from pot
*** SUMMARY ***
Total pot $210.50 | Rake $2.80 
Board [7s Js 7d 5s Qs]
Seat 1: Vikulja1993 showed [Ac Ad] and lost with two pair, Aces and Sevens
Seat 2: JeanLima93 showed [9d 9s] and won ($207.70) with a flush, Queen high
Seat 3: matiko09 folded before Flop (didn't bet)
Seat 4: Igor DoUrden (button) folded before Flop (didn't bet)
Seat 5: tipner (small blind) folded before Flop
Seat 6: nickreason17 (big blind) folded before Flop
Seat 7: Spid1 folded on the Flop
Seat 8: volwebni4ek folded before Flop (didn't bet)
Seat 9: ARTVOR640 folded before Flop (didn't bet)





PokerStars Hand #148217760872:  Hold'em No Limit ($0.50/$1.00 USD) - 2016/02/04 14:46:58 CET [2016/02/04 8:46:58 ET]
Table 'Arneb II' 9-max Seat #2 is the button
Seat 1: matiko09 ($100 in chips) 
Seat 2: sanpidk ($201.20 in chips) 
Seat 3: brille-390 ($105 in chips) 
Seat 4: Venomous100% ($100 in chips) 
Seat 5: lixiangli ($93.18 in chips) 
Seat 6: Sweden_Pound ($141.50 in chips) 
Seat 7: melitakas ($229.81 in chips) 
Seat 8: tedbadger9 ($80 in chips) 
Seat 9: tipner ($100 in chips) 
brille-390: posts small blind $0.50
Venomous100%: posts big blind $1
*** HOLE CARDS ***
Dealt to matiko09 [Jd Kd]
lixiangli has timed out
lixiangli: folds 
Sweden_Pound: folds 
melitakas: folds 
tedbadger9: folds 
tipner: folds 
matiko09: raises $1.50 to $2.50
sanpidk: folds 
brille-390: folds 
Venomous100%: folds 
Uncalled bet ($1.50) returned to matiko09
matiko09 collected $2.50 from pot
matiko09: doesn't show hand 
*** SUMMARY ***
Total pot $2.50 | Rake $0 
Seat 1: matiko09 collected ($2.50)
Seat 2: sanpidk (button) folded before Flop (didn't bet)
Seat 3: brille-390 (small blind) folded before Flop
Seat 4: Venomous100% (big blind) folded before Flop
Seat 5: lixiangli folded before Flop (didn't bet)
Seat 6: Sweden_Pound folded before Flop (didn't bet)
Seat 7: melitakas folded before Flop (didn't bet)
Seat 8: tedbadger9 folded before Flop (didn't bet)
Seat 9: tipner folded before Flop (didn't bet)





PokerStars Hand #148217762292:  Hold'em No Limit (€0.50/€1.00 EUR) - 2016/02/04 14:47:00 CET [2016/02/04 8:47:00 ET]
Table 'Ostenia' 9-max Seat #8 is the button
Seat 1: matiko09 (€100 in chips) 
Seat 2: tipner (€100 in chips) 
Seat 4: er13to (€101.50 in chips) 
Seat 5: Sweden_Pound (€100 in chips) 
Seat 6: melitakas (€100 in chips) 
Seat 8: Venomous100% (€109.85 in chips) 
matiko09: posts small blind €0.50
tipner: posts big blind €1
ozone2003: sits out 
*** HOLE CARDS ***
Dealt to matiko09 [9h Ah]
er13to: raises €1.50 to €2.50
ozone2003 leaves the table
Sweden_Pound: folds 
melitakas: folds 
Venomous100%: folds 
matiko09: folds 
tipner: folds 
Uncalled bet (€1.50) returned to er13to
er13to collected €2.50 from pot
*** SUMMARY ***
Total pot €2.50 | Rake €0 
Seat 1: matiko09 (small blind) folded before Flop
Seat 2: tipner (big blind) folded before Flop
Seat 4: er13to collected (€2.50)
Seat 5: Sweden_Pound folded before Flop (didn't bet)
Seat 6: melitakas folded before Flop (didn't bet)
Seat 8: Venomous100% (button) folded before Flop (didn't bet)





PokerStars Hand #148217772257:  Hold'em No Limit ($0.50/$1.00 USD) - 2016/02/04 14:47:14 CET [2016/02/04 8:47:14 ET]
Table 'Alkaid II' 9-max Seat #5 is the button
Seat 1: Sweden_Pound ($124.94 in chips) 
Seat 2: Venomous100% ($143.76 in chips) 
Seat 3: 1557PSS ($58.13 in chips) 
Seat 4: sanpidk ($117.34 in chips) 
Seat 5: I The King I ($100 in chips) 
Seat 6: matiko09 ($100 in chips) 
Seat 8: yourpro ($100 in chips) 
Seat 9: tjl290 ($54.08 in chips) 
matiko09: posts small blind $0.50
vicdroopy: is sitting out 
yourpro: posts big blind $1
*** HOLE CARDS ***
Dealt to matiko09 [9s Td]
vicdroopy leaves the table
chaps1988 joins the table at seat #7 
tjl290: folds 
Sweden_Pound: raises $2 to $3
Venomous100%: folds 
1557PSS: folds 
sanpidk: folds 
I The King I: calls $3
matiko09: folds 
yourpro: folds 
*** FLOP *** [Qh Jc Qd]
Sweden_Pound: bets $4.65
I The King I: calls $4.65
*** TURN *** [Qh Jc Qd] [6d]
Sweden_Pound: bets $10.43
I The King I: calls $10.43
*** RIVER *** [Qh Jc Qd 6d] [7h]
Sweden_Pound: checks 
I The King I: checks 
*** SHOW DOWN ***
Sweden_Pound: shows [5d 5h] (two pair, Queens and Fives)
I The King I: shows [Jd 9d] (two pair, Queens and Jacks)
I The King I collected $35.97 from pot
*** SUMMARY ***
Total pot $37.66 | Rake $1.69 
Board [Qh Jc Qd 6d 7h]
Seat 1: Sweden_Pound showed [5d 5h] and lost with two pair, Queens and Fives
Seat 2: Venomous100% folded before Flop (didn't bet)
Seat 3: 1557PSS folded before Flop (didn't bet)
Seat 4: sanpidk folded before Flop (didn't bet)
Seat 5: I The King I (button) showed [Jd 9d] and won ($35.97) with two pair, Queens and Jacks
Seat 6: matiko09 (small blind) folded before Flop
Seat 8: yourpro (big blind) folded before Flop
Seat 9: tjl290 folded before Flop (didn't bet)





PokerStars Hand #148217775857:  Hold'em No Limit ($0.50/$1.00 USD) - 2016/02/04 14:47:19 CET [2016/02/04 8:47:19 ET]
Table 'Sargas' 9-max Seat #8 is the button
Seat 1: Sweden_Pound ($100 in chips) 
Seat 2: chaps1988 ($100 in chips) 
Seat 3: sanpidk ($111.69 in chips) 
Seat 4: nickreason17 ($180.43 in chips) 
Seat 5: matiko09 ($100 in chips) 
Seat 6: buttonlife ($46.50 in chips) 
Seat 8: ozone2003 ($100 in chips) 
Seat 9: tompi-tomp ($84.48 in chips) 
tompi-tomp: posts small blind $0.50
Sweden_Pound: posts big blind $1
*** HOLE CARDS ***
Dealt to matiko09 [5c 7s]
chaps1988: folds 
sanpidk: raises $2 to $3
nickreason17: folds 
matiko09: folds 
buttonlife: folds 
ozone2003: folds 
tompi-tomp: folds 
Sweden_Pound: folds 
Uncalled bet ($2) returned to sanpidk
sanpidk collected $2.50 from pot
sanpidk: doesn't show hand 
*** SUMMARY ***
Total pot $2.50 | Rake $0 
Seat 1: Sweden_Pound (big blind) folded before Flop
Seat 2: chaps1988 folded before Flop (didn't bet)
Seat 3: sanpidk collected ($2.50)
Seat 4: nickreason17 folded before Flop (didn't bet)
Seat 5: matiko09 folded before Flop (didn't bet)
Seat 6: buttonlife folded before Flop (didn't bet)
Seat 8: ozone2003 (button) folded before Flop (didn't bet)
Seat 9: tompi-tomp (small blind) folded before Flop





PokerStars Hand #148217776889:  Hold'em No Limit ($0.50/$1.00 USD) - 2016/02/04 14:47:21 CET [2016/02/04 8:47:21 ET]
Table 'Sodankyla' 9-max Seat #8 is the button
Seat 1: sanpidk ($107.57 in chips) 
Seat 2: Sweden_Pound ($103 in chips) 
Seat 3: yourpro ($100 in chips) 
Seat 5: matiko09 ($100 in chips) 
Seat 6: nickreason17 ($100 in chips) 
Seat 7: RoadtoNepal ($118.73 in chips) 
Seat 8: Arunas71 ($57 in chips) 
Seat 9: TheDoctor635 ($83.59 in chips) 
TheDoctor635: posts small blind $0.50
sanpidk: posts big blind $1
xxxZeka: sits out 
*** HOLE CARDS ***
Dealt to matiko09 [9s 8c]
Sweden_Pound: folds 
yourpro: folds 
matiko09: folds 
nickreason17: raises $2 to $3
RoadtoNepal: folds 
Arunas71: calls $3
TheDoctor635: folds 
sanpidk: folds 
*** FLOP *** [5h 3d 3s]
nickreason17: checks 
Arunas71: checks 
*** TURN *** [5h 3d 3s] [8h]
nickreason17: checks 
Arunas71: checks 
*** RIVER *** [5h 3d 3s 8h] [Tc]
nickreason17: bets $4
Arunas71: calls $4
*** SHOW DOWN ***
nickreason17: shows [Jc Ks] (a pair of Threes)
Arunas71: shows [4s As] (a pair of Threes - Ace kicker)
Arunas71 collected $14.80 from pot
*** SUMMARY ***
Total pot $15.50 | Rake $0.70 
Board [5h 3d 3s 8h Tc]
Seat 1: sanpidk (big blind) folded before Flop
Seat 2: Sweden_Pound folded before Flop (didn't bet)
Seat 3: yourpro folded before Flop (didn't bet)
Seat 5: matiko09 folded before Flop (didn't bet)
Seat 6: nickreason17 showed [Jc Ks] and lost with a pair of Threes
Seat 7: RoadtoNepal folded before Flop (didn't bet)
Seat 8: Arunas71 (button) showed [4s As] and won ($14.80) with a pair of Threes
Seat 9: TheDoctor635 (small blind) folded before Flop





PokerStars Hand #148217779485:  Hold'em No Limit (€0.50/€1.00 EUR) - 2016/02/04 14:47:24 CET [2016/02/04 8:47:24 ET]
Table 'Ostenia' 9-max Seat #1 is the button
Seat 1: matiko09 (€100 in chips) 
Seat 2: tipner (€100 in chips) 
Seat 4: er13to (€103 in chips) 
Seat 5: Sweden_Pound (€100 in chips) 
Seat 6: melitakas (€100 in chips) 
Seat 8: Venomous100% (€109.85 in chips) 
tipner: posts small blind €0.50
er13to: posts big blind €1
*** HOLE CARDS ***
Dealt to matiko09 [Ad 3h]
Sweden_Pound: folds 
melitakas: folds 
Venomous100%: folds 
matiko09: raises €1.27 to €2.27
tipner: folds 
er13to: calls €1.27
*** FLOP *** [4s 6c Qc]
er13to: checks 
matiko09: checks 
*** TURN *** [4s 6c Qc] [8s]
er13to: bets €3.13
matiko09: folds 
Uncalled bet (€3.13) returned to er13to
er13to collected €4.81 from pot
*** SUMMARY ***
Total pot €5.04 | Rake €0.23 
Board [4s 6c Qc 8s]
Seat 1: matiko09 (button) folded on the Turn
Seat 2: tipner (small blind) folded before Flop
Seat 4: er13to (big blind) collected (€4.81)
Seat 5: Sweden_Pound folded before Flop (didn't bet)
Seat 6: melitakas folded before Flop (didn't bet)
Seat 8: Venomous100% folded before Flop (didn't bet)





PokerStars Hand #148217796382:  Hold'em No Limit ($0.50/$1.00 USD) - 2016/02/04 14:47:48 CET [2016/02/04 8:47:48 ET]
Table 'Sargas' 9-max Seat #9 is the button
Seat 1: Sweden_Pound ($100 in chips) 
Seat 2: chaps1988 ($100 in chips) 
Seat 3: sanpidk ($113.19 in chips) 
Seat 4: nickreason17 ($180.43 in chips) 
Seat 5: matiko09 ($100 in chips) 
Seat 6: buttonlife ($46.50 in chips) 
Seat 7: DENG1118 ($100 in chips) 
Seat 8: ozone2003 ($100 in chips) 
Seat 9: tompi-tomp ($83.98 in chips) 
Sweden_Pound: posts small blind $0.50
chaps1988: posts big blind $1
*** HOLE CARDS ***
Dealt to matiko09 [7h 3h]
sanpidk: raises $2 to $3
nickreason17: folds 
matiko09: folds 
buttonlife: folds 
DENG1118: folds 
ozone2003: folds 
tompi-tomp: folds 
Sweden_Pound: folds 
chaps1988: folds 
Uncalled bet ($2) returned to sanpidk
sanpidk collected $2.50 from pot
sanpidk: doesn't show hand 
*** SUMMARY ***
Total pot $2.50 | Rake $0 
Seat 1: Sweden_Pound (small blind) folded before Flop
Seat 2: chaps1988 (big blind) folded before Flop
Seat 3: sanpidk collected ($2.50)
Seat 4: nickreason17 folded before Flop (didn't bet)
Seat 5: matiko09 folded before Flop (didn't bet)
Seat 6: buttonlife folded before Flop (didn't bet)
Seat 7: DENG1118 folded before Flop (didn't bet)
Seat 8: ozone2003 folded before Flop (didn't bet)
Seat 9: tompi-tomp (button) folded before Flop (didn't bet)





PokerStars Hand #148217801606:  Hold'em No Limit ($0.50/$1.00 USD) - 2016/02/04 14:47:55 CET [2016/02/04 8:47:55 ET]
Table 'Arneb II' 9-max Seat #3 is the button
Seat 1: matiko09 ($101.50 in chips) 
Seat 2: sanpidk ($201.20 in chips) 
Seat 3: brille-390 ($104.50 in chips) 
Seat 4: Venomous100% ($100 in chips) 
Seat 5: lixiangli ($93.18 in chips) 
Seat 6: Sweden_Pound ($141.50 in chips) 
Seat 7: melitakas ($229.81 in chips) 
Seat 8: tedbadger9 ($80 in chips) 
Seat 9: tipner ($100 in chips) 
Venomous100%: posts small blind $0.50
lixiangli: posts big blind $1
*** HOLE CARDS ***
Dealt to matiko09 [7h 8s]
Sweden_Pound: folds 
melitakas: raises $1 to $2
tedbadger9: folds 
tipner: raises $6 to $8
matiko09: folds 
sanpidk: folds 
brille-390: folds 
Venomous100%: folds 
lixiangli: folds 
melitakas: calls $6
*** FLOP *** [Qh Jh Ac]
melitakas: checks 
tipner: bets $9
melitakas: calls $9
*** TURN *** [Qh Jh Ac] [7d]
melitakas: checks 
tipner: bets $18
melitakas: raises $24 to $42
tipner: folds 
Uncalled bet ($24) returned to melitakas
melitakas collected $68.70 from pot
*** SUMMARY ***
Total pot $71.50 | Rake $2.80 
Board [Qh Jh Ac 7d]
Seat 1: matiko09 folded before Flop (didn't bet)
Seat 2: sanpidk folded before Flop (didn't bet)
Seat 3: brille-390 (button) folded before Flop (didn't bet)
Seat 4: Venomous100% (small blind) folded before Flop
Seat 5: lixiangli (big blind) folded before Flop
Seat 6: Sweden_Pound folded before Flop (didn't bet)
Seat 7: melitakas collected ($68.70)
Seat 8: tedbadger9 folded before Flop (didn't bet)
Seat 9: tipner folded on the Turn





PokerStars Hand #148217808647:  Hold'em No Limit ($0.50/$1.00 USD) - 2016/02/04 14:48:05 CET [2016/02/04 8:48:05 ET]
Table 'Asios III' 9-max Seat #3 is the button
Seat 1: yourpro ($100 in chips) 
Seat 2: crime8783 ($45.97 in chips) 
Seat 3: Igor DoUrden ($100 in chips) 
Seat 4: TimStone ($100 in chips) 
Seat 5: ilaviiitech ($100 in chips) 
Seat 6: matiko09 ($126.50 in chips) 
Seat 7: nickreason17 ($195.96 in chips) 
Seat 8: Sweden_Pound ($110.07 in chips) 
Seat 9: Vikulja1993 ($154.81 in chips) 
TimStone: posts small blind $0.50
ilaviiitech: posts big blind $1
*** HOLE CARDS ***
Dealt to matiko09 [Qs 7h]
matiko09: folds 
nickreason17: folds 
Sweden_Pound: raises $2 to $3
Vikulja1993: calls $3
yourpro: folds 
crime8783: folds 
Igor DoUrden: folds 
TimStone: folds 
ilaviiitech: folds 
*** FLOP *** [8d 5h 2c]
Sweden_Pound: bets $4.65
Vikulja1993: raises $10.35 to $15
Sweden_Pound: folds 
Uncalled bet ($10.35) returned to Vikulja1993
Vikulja1993 collected $16.04 from pot
Vikulja1993: doesn't show hand 
*** SUMMARY ***
Total pot $16.80 | Rake $0.76 
Board [8d 5h 2c]
Seat 1: yourpro folded before Flop (didn't bet)
Seat 2: crime8783 folded before Flop (didn't bet)
Seat 3: Igor DoUrden (button) folded before Flop (didn't bet)
Seat 4: TimStone (small blind) folded before Flop
Seat 5: ilaviiitech (big blind) folded before Flop
Seat 6: matiko09 folded before Flop (didn't bet)
Seat 7: nickreason17 folded before Flop (didn't bet)
Seat 8: Sweden_Pound folded on the Flop
Seat 9: Vikulja1993 collected ($16.04)





PokerStars Hand #148217814329:  Hold'em No Limit (€0.50/€1.00 EUR) - 2016/02/04 14:48:12 CET [2016/02/04 8:48:12 ET]
Table 'Ostenia' 9-max Seat #2 is the button
Seat 1: matiko09 (€100 in chips) 
Seat 2: tipner (€100 in chips) 
Seat 4: er13to (€105.54 in chips) 
Seat 5: Sweden_Pound (€100 in chips) 
Seat 6: melitakas (€100 in chips) 
Seat 8: Venomous100% (€109.85 in chips) 
er13to: posts small blind €0.50
Sweden_Pound: posts big blind €1
*** HOLE CARDS ***
Dealt to matiko09 [6s 6c]
melitakas: folds 
Venomous100%: folds 
matiko09: raises €1.50 to €2.50
tipner: folds 
er13to: folds 
Sweden_Pound: folds 
Uncalled bet (€1.50) returned to matiko09
matiko09 collected €2.50 from pot
matiko09: doesn't show hand 
*** SUMMARY ***
Total pot €2.50 | Rake €0 
Seat 1: matiko09 collected (€2.50)
Seat 2: tipner (button) folded before Flop (didn't bet)
Seat 4: er13to (small blind) folded before Flop
Seat 5: Sweden_Pound (big blind) folded before Flop
Seat 6: melitakas folded before Flop (didn't bet)
Seat 8: Venomous100% folded before Flop (didn't bet)





PokerStars Hand #148217818445:  Hold'em No Limit ($0.50/$1.00 USD) - 2016/02/04 14:48:18 CET [2016/02/04 8:48:18 ET]
Table 'Alkaid II' 9-max Seat #6 is the button
Seat 1: Sweden_Pound ($106.86 in chips) 
Seat 2: Venomous100% ($143.76 in chips) 
Seat 3: 1557PSS ($58.13 in chips) 
Seat 4: sanpidk ($117.34 in chips) 
Seat 5: I The King I ($117.89 in chips) 
Seat 6: matiko09 ($100 in chips) 
Seat 8: yourpro ($100 in chips) 
Seat 9: tjl290 ($54.08 in chips) 
chaps1988 will be allowed to play after the button
yourpro: posts small blind $0.50
tjl290: posts big blind $1
*** HOLE CARDS ***
Dealt to matiko09 [Jd Js]
Sweden_Pound: raises $2 to $3
Venomous100%: folds 
1557PSS: folds 
sanpidk: folds 
I The King I: folds 
matiko09: calls $3
yourpro: folds 
tjl290: folds 
*** FLOP *** [7d 6s Qh]
Sweden_Pound: bets $4.65
matiko09: calls $4.65
*** TURN *** [7d 6s Qh] [2s]
Sweden_Pound: checks 
matiko09: checks 
*** RIVER *** [7d 6s Qh 2s] [Kh]
Sweden_Pound: bets $10.43
matiko09: folds 
Uncalled bet ($10.43) returned to Sweden_Pound
Sweden_Pound collected $16.04 from pot
Sweden_Pound: doesn't show hand 
*** SUMMARY ***
Total pot $16.80 | Rake $0.76 
Board [7d 6s Qh 2s Kh]
Seat 1: Sweden_Pound collected ($16.04)
Seat 2: Venomous100% folded before Flop (didn't bet)
Seat 3: 1557PSS folded before Flop (didn't bet)
Seat 4: sanpidk folded before Flop (didn't bet)
Seat 5: I The King I folded before Flop (didn't bet)
Seat 6: matiko09 (button) folded on the River
Seat 8: yourpro (small blind) folded before Flop
Seat 9: tjl290 (big blind) folded before Flop





PokerStars Hand #148217821940:  Hold'em No Limit ($0.50/$1.00 USD) - 2016/02/04 14:48:23 CET [2016/02/04 8:48:23 ET]
Table 'Sargas' 9-max Seat #1 is the button
Seat 1: Sweden_Pound ($100 in chips) 
Seat 2: chaps1988 ($100 in chips) 
Seat 3: sanpidk ($114.69 in chips) 
Seat 4: nickreason17 ($180.43 in chips) 
Seat 5: matiko09 ($100 in chips) 
Seat 6: buttonlife ($46.50 in chips) 
Seat 7: DENG1118 ($100 in chips) 
Seat 8: ozone2003 ($100 in chips) 
Seat 9: tompi-tomp ($83.98 in chips) 
chaps1988: posts small blind $0.50
sanpidk: posts big blind $1
*** HOLE CARDS ***
Dealt to matiko09 [5c As]
nickreason17: folds 
matiko09: folds 
buttonlife: folds 
DENG1118: folds 
ozone2003: folds 
tompi-tomp: folds 
Sweden_Pound: raises $1 to $2
chaps1988: raises $5 to $7
sanpidk: folds 
Sweden_Pound: folds 
Uncalled bet ($5) returned to chaps1988
chaps1988 collected $5 from pot
*** SUMMARY ***
Total pot $5 | Rake $0 
Seat 1: Sweden_Pound (button) folded before Flop
Seat 2: chaps1988 (small blind) collected ($5)
Seat 3: sanpidk (big blind) folded before Flop
Seat 4: nickreason17 folded before Flop (didn't bet)
Seat 5: matiko09 folded before Flop (didn't bet)
Seat 6: buttonlife folded before Flop (didn't bet)
Seat 7: DENG1118 folded before Flop (didn't bet)
Seat 8: ozone2003 folded before Flop (didn't bet)
Seat 9: tompi-tomp folded before Flop (didn't bet)





PokerStars Hand #148217824326:  Hold'em No Limit ($0.50/$1.00 USD) - 2016/02/04 14:48:26 CET [2016/02/04 8:48:26 ET]
Table 'Sodankyla' 9-max Seat #9 is the button
Seat 1: sanpidk ($106.57 in chips) 
Seat 2: Sweden_Pound ($103 in chips) 
Seat 3: yourpro ($100 in chips) 
Seat 5: matiko09 ($100 in chips) 
Seat 6: nickreason17 ($100 in chips) 
Seat 7: RoadtoNepal ($118.73 in chips) 
Seat 8: Arunas71 ($64.80 in chips) 
Seat 9: TheDoctor635 ($83.09 in chips) 
sanpidk: posts small blind $0.50
Sweden_Pound: posts big blind $1
xxxZeka: sits out 
*** HOLE CARDS ***
Dealt to matiko09 [5d 3c]
yourpro: raises $1.87 to $2.87
matiko09: folds 
nickreason17: folds 
RoadtoNepal: folds 
Arunas71: folds 
TheDoctor635: calls $2.87
sanpidk: folds 
Sweden_Pound: raises $8.13 to $11
yourpro: calls $8.13
TheDoctor635: folds 
*** FLOP *** [Kc Ad 4h]
Sweden_Pound: bets $15
yourpro: folds 
Uncalled bet ($15) returned to Sweden_Pound
Sweden_Pound collected $24.23 from pot
Sweden_Pound: doesn't show hand 
*** SUMMARY ***
Total pot $25.37 | Rake $1.14 
Board [Kc Ad 4h]
Seat 1: sanpidk (small blind) folded before Flop
Seat 2: Sweden_Pound (big blind) collected ($24.23)
Seat 3: yourpro folded on the Flop
Seat 5: matiko09 folded before Flop (didn't bet)
Seat 6: nickreason17 folded before Flop (didn't bet)
Seat 7: RoadtoNepal folded before Flop (didn't bet)
Seat 8: Arunas71 folded before Flop (didn't bet)
Seat 9: TheDoctor635 (button) folded before Flop





PokerStars Hand #148217828223:  Hold'em No Limit (€0.50/€1.00 EUR) - 2016/02/04 14:48:32 CET [2016/02/04 8:48:32 ET]
Table 'Ostenia' 9-max Seat #4 is the button
Seat 1: matiko09 (€101.50 in chips) 
Seat 2: tipner (€100 in chips) 
Seat 4: er13to (€105.04 in chips) 
Seat 5: Sweden_Pound (€100 in chips) 
Seat 6: melitakas (€100 in chips) 
Seat 8: Venomous100% (€109.85 in chips) 
Sweden_Pound: posts small blind €0.50
melitakas: posts big blind €1
*** HOLE CARDS ***
Dealt to matiko09 [5d 6s]
Venomous100%: folds 
matiko09: folds 
maxxmeister joins the table at seat #3 
tipner: folds 
er13to: raises €1.50 to €2.50
Sweden_Pound: raises €7.50 to €10
melitakas: folds 
er13to: folds 
Uncalled bet (€7.50) returned to Sweden_Pound
Sweden_Pound collected €6 from pot
Sweden_Pound: doesn't show hand 
*** SUMMARY ***
Total pot €6 | Rake €0 
Seat 1: matiko09 folded before Flop (didn't bet)
Seat 2: tipner folded before Flop (didn't bet)
Seat 4: er13to (button) folded before Flop
Seat 5: Sweden_Pound (small blind) collected (€6)
Seat 6: melitakas (big blind) folded before Flop
Seat 8: Venomous100% folded before Flop (didn't bet)





PokerStars Hand #148217838379:  Hold'em No Limit ($0.50/$1.00 USD) - 2016/02/04 14:48:46 CET [2016/02/04 8:48:46 ET]
Table 'Arneb III' 9-max Seat #5 is the button
Seat 1: Vikulja1993 ($100 in chips) 
Seat 2: JeanLima93 ($217.54 in chips) 
Seat 3: matiko09 ($100 in chips) 
Seat 4: Igor DoUrden ($228.81 in chips) 
Seat 5: tipner ($100 in chips) 
Seat 6: nickreason17 ($100.50 in chips) 
Seat 7: Spid1 ($100 in chips) 
Seat 8: volwebni4ek ($40 in chips) 
Seat 9: ARTVOR640 ($100 in chips) 
nickreason17: posts small blind $0.50
Spid1: posts big blind $1
*** HOLE CARDS ***
Dealt to matiko09 [Ac 7h]
volwebni4ek: folds 
ARTVOR640: folds 
Vikulja1993: folds 
JeanLima93: folds 
matiko09: folds 
Igor DoUrden: folds 
tipner: folds 
nickreason17: folds 
Uncalled bet ($0.50) returned to Spid1
Spid1 collected $1 from pot
Spid1: doesn't show hand 
*** SUMMARY ***
Total pot $1 | Rake $0 
Seat 1: Vikulja1993 folded before Flop (didn't bet)
Seat 2: JeanLima93 folded before Flop (didn't bet)
Seat 3: matiko09 folded before Flop (didn't bet)
Seat 4: Igor DoUrden folded before Flop (didn't bet)
Seat 5: tipner (button) folded before Flop (didn't bet)
Seat 6: nickreason17 (small blind) folded before Flop
Seat 7: Spid1 (big blind) collected ($1)
Seat 8: volwebni4ek folded before Flop (didn't bet)
Seat 9: ARTVOR640 folded before Flop (didn't bet)





PokerStars Hand #148217842316:  Hold'em No Limit ($0.50/$1.00 USD) - 2016/02/04 14:48:51 CET [2016/02/04 8:48:51 ET]
Table 'Edburga II' 9-max Seat #8 is the button
Seat 1: matiko09 ($100 in chips) 
Seat 3: maxxmeister ($101.50 in chips) 
Seat 4: geoffreyjo ($119.36 in chips) 
Seat 5: TimStone ($100 in chips) 
Seat 6: Igor DoUrden ($100 in chips) 
Seat 7: tipner ($103.94 in chips) 
Seat 8: muppetheid63 ($44.50 in chips) 
Seat 9: nickreason17 ($132.50 in chips) 
nickreason17: posts small blind $0.50
matiko09: posts big blind $1
Vikulja1993: sits out 
*** HOLE CARDS ***
Dealt to matiko09 [As Ac]
maxxmeister: folds 
geoffreyjo: folds 
TimStone: folds 
Igor DoUrden: folds 
tipner: folds 
muppetheid63: raises $5 to $6
nickreason17: folds 
matiko09: raises $6 to $12
muppetheid63: calls $6
*** FLOP *** [8c 9d 3c]
matiko09: bets $8
muppetheid63: calls $8
*** TURN *** [8c 9d 3c] [Tc]
matiko09: bets $25.14
muppetheid63: calls $24.50 and is all-in
Uncalled bet ($0.64) returned to matiko09
*** RIVER *** [8c 9d 3c Tc] [6c]
*** SHOW DOWN ***
matiko09: shows [As Ac] (a flush, Ace high)
muppetheid63: mucks hand 
matiko09 collected $86.70 from pot
*** SUMMARY ***
Total pot $89.50 | Rake $2.80 
Board [8c 9d 3c Tc 6c]
Seat 1: matiko09 (big blind) showed [As Ac] and won ($86.70) with a flush, Ace high
Seat 3: maxxmeister folded before Flop (didn't bet)
Seat 4: geoffreyjo folded before Flop (didn't bet)
Seat 5: TimStone folded before Flop (didn't bet)
Seat 6: Igor DoUrden folded before Flop (didn't bet)
Seat 7: tipner folded before Flop (didn't bet)
Seat 8: muppetheid63 (button) mucked [8s Kc]
Seat 9: nickreason17 (small blind) folded before Flop





PokerStars Hand #148217848675:  Hold'em No Limit ($0.50/$1.00 USD) - 2016/02/04 14:49:00 CET [2016/02/04 8:49:00 ET]
Table 'Sargas' 9-max Seat #2 is the button
Seat 1: Sweden_Pound ($100 in chips) 
Seat 2: chaps1988 ($103 in chips) 
Seat 3: sanpidk ($113.69 in chips) 
Seat 4: nickreason17 ($180.43 in chips) 
Seat 5: matiko09 ($100 in chips) 
Seat 6: buttonlife ($46.50 in chips) 
Seat 7: DENG1118 ($100 in chips) 
Seat 8: ozone2003 ($100 in chips) 
Seat 9: tompi-tomp ($83.98 in chips) 
sanpidk: posts small blind $0.50
nickreason17: posts big blind $1
*** HOLE CARDS ***
Dealt to matiko09 [9s 6h]
matiko09: folds 
buttonlife: folds 
DENG1118: folds 
ozone2003: folds 
tompi-tomp: raises $2 to $3
Sweden_Pound: folds 
chaps1988: calls $3
sanpidk: calls $2.50
nickreason17: folds 
*** FLOP *** [7d Th 4s]
sanpidk: checks 
tompi-tomp: bets $5
chaps1988: raises $10 to $15
sanpidk: folds 
tompi-tomp: folds 
Uncalled bet ($10) returned to chaps1988
chaps1988 collected $19.10 from pot
chaps1988: doesn't show hand 
*** SUMMARY ***
Total pot $20 | Rake $0.90 
Board [7d Th 4s]
Seat 1: Sweden_Pound folded before Flop (didn't bet)
Seat 2: chaps1988 (button) collected ($19.10)
Seat 3: sanpidk (small blind) folded on the Flop
Seat 4: nickreason17 (big blind) folded before Flop
Seat 5: matiko09 folded before Flop (didn't bet)
Seat 6: buttonlife folded before Flop (didn't bet)
Seat 7: DENG1118 folded before Flop (didn't bet)
Seat 8: ozone2003 folded before Flop (didn't bet)
Seat 9: tompi-tomp folded on the Flop





PokerStars Hand #148217853949:  Hold'em No Limit (€0.50/€1.00 EUR) - 2016/02/04 14:49:07 CET [2016/02/04 8:49:07 ET]
Table 'Ostenia' 9-max Seat #5 is the button
Seat 1: matiko09 (€101.50 in chips) 
Seat 2: tipner (€100 in chips) 
Seat 4: er13to (€102.54 in chips) 
Seat 5: Sweden_Pound (€103.50 in chips) 
Seat 6: melitakas (€100 in chips) 
Seat 8: Venomous100% (€109.85 in chips) 
melitakas: posts small blind €0.50
Venomous100%: posts big blind €1
*** HOLE CARDS ***
Dealt to matiko09 [Ad 2d]
matiko09: folds 
tipner: folds 
er13to: raises €1.50 to €2.50
Sweden_Pound: folds 
melitakas: folds 
Venomous100%: folds 
Uncalled bet (€1.50) returned to er13to
er13to collected €2.50 from pot
*** SUMMARY ***
Total pot €2.50 | Rake €0 
Seat 1: matiko09 folded before Flop (didn't bet)
Seat 2: tipner folded before Flop (didn't bet)
Seat 4: er13to collected (€2.50)
Seat 5: Sweden_Pound (button) folded before Flop (didn't bet)
Seat 6: melitakas (small blind) folded before Flop
Seat 8: Venomous100% (big blind) folded before Flop





PokerStars Hand #148217854025:  Hold'em No Limit ($0.50/$1.00 USD) - 2016/02/04 14:49:07 CET [2016/02/04 8:49:07 ET]
Table 'Arneb III' 9-max Seat #6 is the button
Seat 1: Vikulja1993 ($100 in chips) 
Seat 2: JeanLima93 ($217.54 in chips) 
Seat 3: matiko09 ($100 in chips) 
Seat 4: Igor DoUrden ($228.81 in chips) 
Seat 5: tipner ($100 in chips) 
Seat 6: nickreason17 ($100 in chips) 
Seat 7: Spid1 ($100.50 in chips) 
Seat 8: volwebni4ek ($40 in chips) 
Seat 9: ARTVOR640 ($100 in chips) 
Spid1: posts small blind $0.50
volwebni4ek: posts big blind $1
*** HOLE CARDS ***
Dealt to matiko09 [Js Th]
ARTVOR640: folds 
Vikulja1993: folds 
JeanLima93: folds 
matiko09: folds 
Igor DoUrden: folds 
tipner: raises $2 to $3
nickreason17: calls $3
Spid1: folds 
volwebni4ek: folds 
*** FLOP *** [4d 3c 2s]
tipner: checks 
nickreason17: checks 
*** TURN *** [4d 3c 2s] [2h]
tipner: checks 
nickreason17: bets $4.50
tipner: folds 
Uncalled bet ($4.50) returned to nickreason17
nickreason17 collected $7.16 from pot
*** SUMMARY ***
Total pot $7.50 | Rake $0.34 
Board [4d 3c 2s 2h]
Seat 1: Vikulja1993 folded before Flop (didn't bet)
Seat 2: JeanLima93 folded before Flop (didn't bet)
Seat 3: matiko09 folded before Flop (didn't bet)
Seat 4: Igor DoUrden folded before Flop (didn't bet)
Seat 5: tipner folded on the Turn
Seat 6: nickreason17 (button) collected ($7.16)
Seat 7: Spid1 (small blind) folded before Flop
Seat 8: volwebni4ek (big blind) folded before Flop
Seat 9: ARTVOR640 folded before Flop (didn't bet)





PokerStars Hand #148217859937:  Hold'em No Limit ($0.50/$1.00 USD) - 2016/02/04 14:49:16 CET [2016/02/04 8:49:16 ET]
Table 'Siarnaq' 9-max Seat #1 is the button
Seat 1: taraisai ($95 in chips) 
Seat 2: matiko09 ($100 in chips) 
Seat 3: nickreason17 ($100 in chips) 
Seat 6: I The King I ($100 in chips) 
matiko09: posts small blind $0.50
nickreason17: posts big blind $1
*** HOLE CARDS ***
Dealt to matiko09 [3h 9s]
I The King I: raises $2 to $3
taraisai: folds 
sanpidk joins the table at seat #4 
goblind4777 joins the table at seat #9 
Igor DoUrden joins the table at seat #5 
matiko09: folds 
nickreason17: folds 
Uncalled bet ($2) returned to I The King I
I The King I collected $2.50 from pot
I The King I: doesn't show hand 
*** SUMMARY ***
Total pot $2.50 | Rake $0 
Seat 1: taraisai (button) folded before Flop (didn't bet)
Seat 2: matiko09 (small blind) folded before Flop
Seat 3: nickreason17 (big blind) folded before Flop
Seat 6: I The King I collected ($2.50)





PokerStars Hand #148217866110:  Hold'em No Limit ($0.50/$1.00 USD) - 2016/02/04 14:49:24 CET [2016/02/04 8:49:24 ET]
Table 'Arneb II' 9-max Seat #4 is the button
Seat 1: matiko09 ($101.50 in chips) 
Seat 2: sanpidk ($201.20 in chips) 
Seat 3: brille-390 ($104.50 in chips) 
Seat 4: Venomous100% ($100 in chips) 
Seat 5: lixiangli ($92.18 in chips) 
Seat 6: Sweden_Pound ($141.50 in chips) 
Seat 7: melitakas ($263.51 in chips) 
Seat 8: tedbadger9 ($80 in chips) 
Seat 9: tipner ($100 in chips) 
lixiangli: posts small blind $0.50
Sweden_Pound: posts big blind $1
*** HOLE CARDS ***
Dealt to matiko09 [Js Jc]
melitakas: folds 
tedbadger9: folds 
tipner: raises $2 to $3
matiko09: calls $3
sanpidk: folds 
brille-390: calls $3
Venomous100%: folds 
lixiangli: folds 
Sweden_Pound: folds 
*** FLOP *** [3c Ac As]
tipner: bets $6
matiko09: calls $6
brille-390: folds 
*** TURN *** [3c Ac As] [5d]
tipner: checks 
matiko09: checks 
*** RIVER *** [3c Ac As 5d] [Ts]
tipner: checks 
matiko09: checks 
*** SHOW DOWN ***
tipner: shows [Ks Kd] (two pair, Aces and Kings)
matiko09: mucks hand 
tipner collected $21.49 from pot
*** SUMMARY ***
Total pot $22.50 | Rake $1.01 
Board [3c Ac As 5d Ts]
Seat 1: matiko09 mucked [Js Jc]
Seat 2: sanpidk folded before Flop (didn't bet)
Seat 3: brille-390 folded on the Flop
Seat 4: Venomous100% (button) folded before Flop (didn't bet)
Seat 5: lixiangli (small blind) folded before Flop
Seat 6: Sweden_Pound (big blind) folded before Flop
Seat 7: melitakas folded before Flop (didn't bet)
Seat 8: tedbadger9 folded before Flop (didn't bet)
Seat 9: tipner showed [Ks Kd] and won ($21.49) with two pair, Aces and Kings





PokerStars Hand #148217868666:  Hold'em No Limit ($0.50/$1.00 USD) - 2016/02/04 14:49:28 CET [2016/02/04 8:49:28 ET]
Table 'Alkaid II' 9-max Seat #8 is the button
Seat 1: Sweden_Pound ($115.25 in chips) 
Seat 2: Venomous100% ($143.76 in chips) 
Seat 3: 1557PSS ($58.13 in chips) 
Seat 4: sanpidk ($117.34 in chips) 
Seat 5: I The King I ($117.89 in chips) 
Seat 6: matiko09 ($100 in chips) 
Seat 8: yourpro ($100 in chips) 
Seat 9: tjl290 ($53.08 in chips) 
tjl290: posts small blind $0.50
Sweden_Pound: posts big blind $1
chaps1988: sits out 
*** HOLE CARDS ***
Dealt to matiko09 [6d 2c]
Venomous100%: folds 
1557PSS: folds 
sanpidk: folds 
I The King I: folds 
Venomous100% leaves the table
matiko09: folds 
yourpro: raises $1 to $2
tjl290: calls $1.50
Sweden_Pound: calls $1
*** FLOP *** [2d 9h Js]
tjl290: checks 
Sweden_Pound: bets $3.72
yourpro: folds 
tjl290: folds 
Uncalled bet ($3.72) returned to Sweden_Pound
Sweden_Pound collected $5.73 from pot
Sweden_Pound: doesn't show hand 
*** SUMMARY ***
Total pot $6 | Rake $0.27 
Board [2d 9h Js]
Seat 1: Sweden_Pound (big blind) collected ($5.73)
Seat 2: Venomous100% folded before Flop (didn't bet)
Seat 3: 1557PSS folded before Flop (didn't bet)
Seat 4: sanpidk folded before Flop (didn't bet)
Seat 5: I The King I folded before Flop (didn't bet)
Seat 6: matiko09 folded before Flop (didn't bet)
Seat 8: yourpro (button) folded on the Flop
Seat 9: tjl290 (small blind) folded on the Flop





PokerStars Hand #148217870070:  Hold'em No Limit ($0.50/$1.00 USD) - 2016/02/04 14:49:30 CET [2016/02/04 8:49:30 ET]
Table 'Asios III' 9-max Seat #4 is the button
Seat 1: yourpro ($100 in chips) 
Seat 2: crime8783 ($45.97 in chips) 
Seat 3: Igor DoUrden ($100 in chips) 
Seat 4: TimStone ($100 in chips) 
Seat 5: ilaviiitech ($100 in chips) 
Seat 6: matiko09 ($126.50 in chips) 
Seat 7: nickreason17 ($195.96 in chips) 
Seat 8: Sweden_Pound ($102.42 in chips) 
Seat 9: Vikulja1993 ($163.20 in chips) 
ilaviiitech: posts small blind $0.50
matiko09: posts big blind $1
*** HOLE CARDS ***
Dealt to matiko09 [Ad 7h]
nickreason17: folds 
Sweden_Pound: folds 
Vikulja1993: raises $2 to $3
yourpro: folds 
crime8783: calls $3
Igor DoUrden: calls $3
TimStone: folds 
ilaviiitech: folds 
matiko09: folds 
*** FLOP *** [9h Kc 2h]
Vikulja1993: checks 
crime8783: checks 
Igor DoUrden: bets $7.50
Vikulja1993: folds 
crime8783: folds 
Uncalled bet ($7.50) returned to Igor DoUrden
Igor DoUrden collected $10.03 from pot
Igor DoUrden: doesn't show hand 
*** SUMMARY ***
Total pot $10.50 | Rake $0.47 
Board [9h Kc 2h]
Seat 1: yourpro folded before Flop (didn't bet)
Seat 2: crime8783 folded on the Flop
Seat 3: Igor DoUrden collected ($10.03)
Seat 4: TimStone (button) folded before Flop (didn't bet)
Seat 5: ilaviiitech (small blind) folded before Flop
Seat 6: matiko09 (big blind) folded before Flop
Seat 7: nickreason17 folded before Flop (didn't bet)
Seat 8: Sweden_Pound folded before Flop (didn't bet)
Seat 9: Vikulja1993 folded on the Flop





PokerStars Hand #148217871342:  Hold'em No Limit ($0.50/$1.00 USD) - 2016/02/04 14:49:31 CET [2016/02/04 8:49:31 ET]
Table 'Sodankyla' 9-max Seat #1 is the button
Seat 1: sanpidk ($106.07 in chips) 
Seat 2: Sweden_Pound ($116.23 in chips) 
Seat 3: yourpro ($100 in chips) 
Seat 5: matiko09 ($100 in chips) 
Seat 6: nickreason17 ($100 in chips) 
Seat 7: RoadtoNepal ($118.73 in chips) 
Seat 8: Arunas71 ($64.80 in chips) 
Seat 9: TheDoctor635 ($80.22 in chips) 
Sweden_Pound: posts small blind $0.50
yourpro: posts big blind $1
xxxZeka: sits out 
*** HOLE CARDS ***
Dealt to matiko09 [3h Ac]
matiko09: folds 
nickreason17: folds 
RoadtoNepal: folds 
Arunas71: calls $1
TheDoctor635: folds 
sanpidk: folds 
Sweden_Pound: folds 
yourpro: checks 
*** FLOP *** [5h 7h 7d]
yourpro: checks 
Arunas71: bets $1
yourpro: calls $1
*** TURN *** [5h 7h 7d] [Js]
yourpro: checks 
Arunas71: checks 
*** RIVER *** [5h 7h 7d Js] [Td]
yourpro: bets $3
Arunas71: folds 
Uncalled bet ($3) returned to yourpro
yourpro collected $4.30 from pot
yourpro: doesn't show hand 
*** SUMMARY ***
Total pot $4.50 | Rake $0.20 
Board [5h 7h 7d Js Td]
Seat 1: sanpidk (button) folded before Flop (didn't bet)
Seat 2: Sweden_Pound (small blind) folded before Flop
Seat 3: yourpro (big blind) collected ($4.30)
Seat 5: matiko09 folded before Flop (didn't bet)
Seat 6: nickreason17 folded before Flop (didn't bet)
Seat 7: RoadtoNepal folded before Flop (didn't bet)
Seat 8: Arunas71 folded on the River
Seat 9: TheDoctor635 folded before Flop (didn't bet)





PokerStars Hand #148217876585:  Hold'em No Limit ($0.50/$1.00 USD) - 2016/02/04 14:49:39 CET [2016/02/04 8:49:39 ET]
Table 'Siarnaq' 9-max Seat #2 is the button
Seat 1: taraisai ($100 in chips) 
Seat 2: matiko09 ($100 in chips) 
Seat 3: nickreason17 ($100 in chips) 
Seat 4: sanpidk ($100 in chips) 
Seat 6: I The King I ($101.50 in chips) 
Seat 9: goblind4777 ($80 in chips) 
nickreason17: posts small blind $0.50
sanpidk: posts big blind $1
Igor DoUrden: sits out 
goblind4777: posts big blind $1
*** HOLE CARDS ***
Dealt to matiko09 [9s Ts]
I The King I: folds 
goblind4777: checks 
taraisai: calls $1
matiko09: raises $4 to $5
nickreason17: folds 
sanpidk: folds 
goblind4777: calls $4
taraisai: folds 
*** FLOP *** [Ac 4c 7h]
maxxmeister joins the table at seat #8 
goblind4777: checks 
matiko09: bets $6
goblind4777: calls $6
*** TURN *** [Ac 4c 7h] [Qs]
goblind4777: checks 
matiko09: checks 
*** RIVER *** [Ac 4c 7h Qs] [Jd]
goblind4777: checks 
matiko09: checks 
*** SHOW DOWN ***
goblind4777: shows [5s 7s] (a pair of Sevens)
matiko09: mucks hand 
goblind4777 collected $23.40 from pot
*** SUMMARY ***
Total pot $24.50 | Rake $1.10 
Board [Ac 4c 7h Qs Jd]
Seat 1: taraisai folded before Flop
Seat 2: matiko09 (button) mucked [9s Ts]
Seat 3: nickreason17 (small blind) folded before Flop
Seat 4: sanpidk (big blind) folded before Flop
Seat 6: I The King I folded before Flop (didn't bet)
Seat 9: goblind4777 showed [5s 7s] and won ($23.40) with a pair of Sevens





PokerStars Hand #148217904735:  Hold'em No Limit ($0.50/$1.00 USD) - 2016/02/04 14:50:19 CET [2016/02/04 8:50:19 ET]
Table 'Alkaid II' 9-max Seat #9 is the button
Seat 1: Sweden_Pound ($118.98 in chips) 
Seat 3: 1557PSS ($58.13 in chips) 
Seat 4: sanpidk ($117.34 in chips) 
Seat 5: I The King I ($117.89 in chips) 
Seat 6: matiko09 ($100 in chips) 
Seat 8: yourpro ($100 in chips) 
Seat 9: tjl290 ($51.08 in chips) 
Sweden_Pound: posts small blind $0.50
1557PSS: posts big blind $1
chaps1988: sits out 
*** HOLE CARDS ***
Dealt to matiko09 [9c Kd]
sanpidk: folds 
I The King I: folds 
matiko09: folds 
yourpro: folds 
tjl290: folds 
Sweden_Pound: raises $2 to $3
1557PSS: folds 
Uncalled bet ($2) returned to Sweden_Pound
xxxZeka joins the table at seat #2 
Sweden_Pound collected $2 from pot
Sweden_Pound: doesn't show hand 
*** SUMMARY ***
Total pot $2 | Rake $0 
Seat 1: Sweden_Pound (small blind) collected ($2)
Seat 3: 1557PSS (big blind) folded before Flop
Seat 4: sanpidk folded before Flop (didn't bet)
Seat 5: I The King I folded before Flop (didn't bet)
Seat 6: matiko09 folded before Flop (didn't bet)
Seat 8: yourpro folded before Flop (didn't bet)
Seat 9: tjl290 (button) folded before Flop (didn't bet)





PokerStars Hand #148217905502:  Hold'em No Limit ($0.50/$1.00 USD) - 2016/02/04 14:50:20 CET [2016/02/04 8:50:20 ET]
Table 'Arneb III' 9-max Seat #7 is the button
Seat 1: Vikulja1993 ($100 in chips) 
Seat 2: JeanLima93 ($217.54 in chips) 
Seat 3: matiko09 ($100 in chips) 
Seat 4: Igor DoUrden ($228.81 in chips) 
Seat 5: tipner ($100 in chips) 
Seat 6: nickreason17 ($104.16 in chips) 
Seat 7: Spid1 ($100 in chips) 
Seat 8: volwebni4ek ($40 in chips) 
Seat 9: ARTVOR640 ($100 in chips) 
volwebni4ek: posts small blind $0.50
ARTVOR640: posts big blind $1
*** HOLE CARDS ***
Dealt to matiko09 [4h 3d]
Vikulja1993: folds 
JeanLima93: raises $3 to $4
matiko09: folds 
Igor DoUrden: folds 
tipner: folds 
nickreason17: folds 
Spid1: folds 
volwebni4ek: folds 
ARTVOR640: folds 
Uncalled bet ($3) returned to JeanLima93
JeanLima93 collected $2.50 from pot
JeanLima93: doesn't show hand 
*** SUMMARY ***
Total pot $2.50 | Rake $0 
Seat 1: Vikulja1993 folded before Flop (didn't bet)
Seat 2: JeanLima93 collected ($2.50)
Seat 3: matiko09 folded before Flop (didn't bet)
Seat 4: Igor DoUrden folded before Flop (didn't bet)
Seat 5: tipner folded before Flop (didn't bet)
Seat 6: nickreason17 folded before Flop (didn't bet)
Seat 7: Spid1 (button) folded before Flop (didn't bet)
Seat 8: volwebni4ek (small blind) folded before Flop
Seat 9: ARTVOR640 (big blind) folded before Flop





PokerStars Hand #148217907044:  Hold'em No Limit ($0.50/$1.00 USD) - 2016/02/04 14:50:22 CET [2016/02/04 8:50:22 ET]
Table 'Edburga II' 9-max Seat #9 is the button
Seat 1: matiko09 ($142.20 in chips) 
Seat 2: Vikulja1993 ($101.50 in chips) 
Seat 3: maxxmeister ($101.50 in chips) 
Seat 4: geoffreyjo ($119.36 in chips) 
Seat 5: TimStone ($100 in chips) 
Seat 6: Igor DoUrden ($100 in chips) 
Seat 7: tipner ($103.94 in chips) 
Seat 9: nickreason17 ($132 in chips) 
matiko09: posts small blind $0.50
Vikulja1993: posts big blind $1
*** HOLE CARDS ***
Dealt to matiko09 [Ac 2d]
maxxmeister: folds 
maxxmeister leaves the table
9lKBXKTT6 joins the table at seat #3 
geoffreyjo: folds 
muppetheid63 leaves the table
volwebni4ek joins the table at seat #8 
TimStone: raises $2.01 to $3.01
9lKBXKTT6 leaves the table
Igor DoUrden: folds 
volwebni4ek leaves the table
tipner: folds 
nickreason17: folds 
matiko09: folds 
pandalapa joins the table at seat #3 
Vikulja1993: folds 
Uncalled bet ($2.01) returned to TimStone
TimStone collected $2.50 from pot
TimStone: doesn't show hand 
*** SUMMARY ***
Total pot $2.50 | Rake $0 
Seat 1: matiko09 (small blind) folded before Flop
Seat 2: Vikulja1993 (big blind) folded before Flop
Seat 3: maxxmeister folded before Flop (didn't bet)
Seat 4: geoffreyjo folded before Flop (didn't bet)
Seat 5: TimStone collected ($2.50)
Seat 6: Igor DoUrden folded before Flop (didn't bet)
Seat 7: tipner folded before Flop (didn't bet)
Seat 9: nickreason17 (button) folded before Flop (didn't bet)





PokerStars Hand #148217908031:  Hold'em No Limit ($0.50/$1.00 USD) - 2016/02/04 14:50:23 CET [2016/02/04 8:50:23 ET]
Table 'Sodankyla' 9-max Seat #2 is the button
Seat 1: sanpidk ($106.07 in chips) 
Seat 2: Sweden_Pound ($115.73 in chips) 
Seat 3: yourpro ($102.30 in chips) 
Seat 4: xxxZeka ($100 in chips) 
Seat 5: matiko09 ($100 in chips) 
Seat 6: nickreason17 ($100 in chips) 
Seat 7: RoadtoNepal ($118.73 in chips) 
Seat 8: Arunas71 ($62.80 in chips) 
Seat 9: TheDoctor635 ($80.22 in chips) 
yourpro: posts small blind $0.50
xxxZeka: posts big blind $1
*** HOLE CARDS ***
Dealt to matiko09 [6d 4h]
matiko09: folds 
nickreason17: folds 
RoadtoNepal: raises $2 to $3
Arunas71: folds 
TheDoctor635: folds 
sanpidk: folds 
Sweden_Pound: calls $3
yourpro: folds 
xxxZeka: folds 
*** FLOP *** [Th 9h As]
RoadtoNepal: checks 
Sweden_Pound: checks 
*** TURN *** [Th 9h As] [5h]
RoadtoNepal: checks 
Sweden_Pound: checks 
*** RIVER *** [Th 9h As 5h] [Ah]
RoadtoNepal: checks 
Sweden_Pound: checks 
*** SHOW DOWN ***
RoadtoNepal: shows [2s 2h] (a flush, Ace high)
Sweden_Pound: mucks hand 
RoadtoNepal collected $7.16 from pot
*** SUMMARY ***
Total pot $7.50 | Rake $0.34 
Board [Th 9h As 5h Ah]
Seat 1: sanpidk folded before Flop (didn't bet)
Seat 2: Sweden_Pound (button) mucked [7c 7d]
Seat 3: yourpro (small blind) folded before Flop
Seat 4: xxxZeka (big blind) folded before Flop
Seat 5: matiko09 folded before Flop (didn't bet)
Seat 6: nickreason17 folded before Flop (didn't bet)
Seat 7: RoadtoNepal showed [2s 2h] and won ($7.16) with a flush, Ace high
Seat 8: Arunas71 folded before Flop (didn't bet)
Seat 9: TheDoctor635 folded before Flop (didn't bet)





PokerStars Hand #148217919114:  Hold'em No Limit ($0.50/$1.00 USD) - 2016/02/04 14:50:39 CET [2016/02/04 8:50:39 ET]
Table 'Sargas' 9-max Seat #3 is the button
Seat 1: Sweden_Pound ($100 in chips) 
Seat 2: chaps1988 ($114.10 in chips) 
Seat 3: sanpidk ($110.69 in chips) 
Seat 4: nickreason17 ($179.43 in chips) 
Seat 5: matiko09 ($100 in chips) 
Seat 6: buttonlife ($46.50 in chips) 
Seat 7: DENG1118 ($100 in chips) 
Seat 8: ozone2003 ($100 in chips) 
Seat 9: tompi-tomp ($75.98 in chips) 
nickreason17: posts small blind $0.50
matiko09: posts big blind $1
*** HOLE CARDS ***
Dealt to matiko09 [Qc Kd]
buttonlife: folds 
DENG1118: folds 
ozone2003: folds 
tompi-tomp: raises $2 to $3
Sweden_Pound: folds 
chaps1988: folds 
sanpidk: folds 
nickreason17: folds 
matiko09: folds 
Uncalled bet ($2) returned to tompi-tomp
tompi-tomp collected $2.50 from pot
tompi-tomp: doesn't show hand 
*** SUMMARY ***
Total pot $2.50 | Rake $0 
Seat 1: Sweden_Pound folded before Flop (didn't bet)
Seat 2: chaps1988 folded before Flop (didn't bet)
Seat 3: sanpidk (button) folded before Flop (didn't bet)
Seat 4: nickreason17 (small blind) folded before Flop
Seat 5: matiko09 (big blind) folded before Flop
Seat 6: buttonlife folded before Flop (didn't bet)
Seat 7: DENG1118 folded before Flop (didn't bet)
Seat 8: ozone2003 folded before Flop (didn't bet)
Seat 9: tompi-tomp collected ($2.50)





PokerStars Hand #148217920713:  Hold'em No Limit ($0.50/$1.00 USD) - 2016/02/04 14:50:41 CET [2016/02/04 8:50:41 ET]
Table 'Siarnaq' 9-max Seat #3 is the button
Seat 1: taraisai ($99 in chips) 
Seat 2: matiko09 ($100 in chips) 
Seat 3: nickreason17 ($100 in chips) 
Seat 4: sanpidk ($100 in chips) 
Seat 5: Igor DoUrden ($100 in chips) 
Seat 6: I The King I ($101.50 in chips) 
Seat 9: goblind4777 ($92.40 in chips) 
sanpidk: posts small blind $0.50
Igor DoUrden: posts big blind $1
*** HOLE CARDS ***
Dealt to matiko09 [6d 6c]
Sesamesnap joins the table at seat #7 
I The King I: raises $2 to $3
goblind4777: folds 
taraisai: folds 
matiko09: calls $3
nickreason17: calls $3
sanpidk: folds 
Igor DoUrden: calls $2
*** FLOP *** [5s 2c 5c]
Igor DoUrden: bets $7.50
I The King I: folds 
matiko09: calls $7.50
nickreason17: folds 
*** TURN *** [5s 2c 5c] [Jc]
Igor DoUrden: checks 
matiko09: checks 
*** RIVER *** [5s 2c 5c Jc] [Qd]
Igor DoUrden: checks 
matiko09: checks 
*** SHOW DOWN ***
Igor DoUrden: shows [7s 7d] (two pair, Sevens and Fives)
matiko09: mucks hand 
Igor DoUrden collected $26.26 from pot
*** SUMMARY ***
Total pot $27.50 | Rake $1.24 
Board [5s 2c 5c Jc Qd]
Seat 1: taraisai folded before Flop (didn't bet)
Seat 2: matiko09 mucked [6d 6c]
Seat 3: nickreason17 (button) folded on the Flop
Seat 4: sanpidk (small blind) folded before Flop
Seat 5: Igor DoUrden (big blind) showed [7s 7d] and won ($26.26) with two pair, Sevens and Fives
Seat 6: I The King I folded on the Flop
Seat 9: goblind4777 folded before Flop (didn't bet)





PokerStars Hand #148217923556:  Hold'em No Limit ($0.50/$1.00 USD) - 2016/02/04 14:50:45 CET [2016/02/04 8:50:45 ET]
Table 'Alkaid II' 9-max Seat #1 is the button
Seat 1: Sweden_Pound ($119.98 in chips) 
Seat 3: 1557PSS ($57.13 in chips) 
Seat 4: sanpidk ($117.34 in chips) 
Seat 5: I The King I ($117.89 in chips) 
Seat 6: matiko09 ($100 in chips) 
Seat 8: yourpro ($100 in chips) 
Seat 9: tjl290 ($51.08 in chips) 
xxxZeka will be allowed to play after the button
1557PSS: posts small blind $0.50
sanpidk: posts big blind $1
chaps1988: sits out 
*** HOLE CARDS ***
Dealt to matiko09 [2c 9s]
I The King I: folds 
matiko09: folds 
yourpro: raises $1.87 to $2.87
tjl290: folds 
Sweden_Pound: folds 
1557PSS: folds 
sanpidk: folds 
Uncalled bet ($1.87) returned to yourpro
yourpro collected $2.50 from pot
yourpro: doesn't show hand 
*** SUMMARY ***
Total pot $2.50 | Rake $0 
Seat 1: Sweden_Pound (button) folded before Flop (didn't bet)
Seat 3: 1557PSS (small blind) folded before Flop
Seat 4: sanpidk (big blind) folded before Flop
Seat 5: I The King I folded before Flop (didn't bet)
Seat 6: matiko09 folded before Flop (didn't bet)
Seat 8: yourpro collected ($2.50)
Seat 9: tjl290 folded before Flop (didn't bet)





PokerStars Hand #148217931364:  Hold'em No Limit ($0.50/$1.00 USD) - 2016/02/04 14:50:56 CET [2016/02/04 8:50:56 ET]
Table 'Arneb II' 9-max Seat #5 is the button
Seat 1: matiko09 ($100 in chips) 
Seat 2: sanpidk ($201.20 in chips) 
Seat 3: brille-390 ($101.50 in chips) 
Seat 4: Venomous100% ($100 in chips) 
Seat 5: lixiangli ($91.68 in chips) 
Seat 6: Sweden_Pound ($140.50 in chips) 
Seat 7: melitakas ($263.51 in chips) 
Seat 8: tedbadger9 ($80 in chips) 
Seat 9: tipner ($112.49 in chips) 
Sweden_Pound: posts small blind $0.50
melitakas: posts big blind $1
*** HOLE CARDS ***
Dealt to matiko09 [6d 8s]
tedbadger9: folds 
tipner: raises $2 to $3
matiko09: folds 
sanpidk: folds 
brille-390: folds 
Venomous100%: folds 
lixiangli: folds 
Sweden_Pound: folds 
melitakas: folds 
Uncalled bet ($2) returned to tipner
tipner collected $2.50 from pot
tipner: doesn't show hand 
*** SUMMARY ***
Total pot $2.50 | Rake $0 
Seat 1: matiko09 folded before Flop (didn't bet)
Seat 2: sanpidk folded before Flop (didn't bet)
Seat 3: brille-390 folded before Flop (didn't bet)
Seat 4: Venomous100% folded before Flop (didn't bet)
Seat 5: lixiangli (button) folded before Flop (didn't bet)
Seat 6: Sweden_Pound (small blind) folded before Flop
Seat 7: melitakas (big blind) folded before Flop
Seat 8: tedbadger9 folded before Flop (didn't bet)
Seat 9: tipner collected ($2.50)





PokerStars Hand #148217936042:  Hold'em No Limit ($0.50/$1.00 USD) - 2016/02/04 14:51:02 CET [2016/02/04 8:51:02 ET]
Table 'Arneb III' 9-max Seat #8 is the button
Seat 1: Vikulja1993 ($100 in chips) 
Seat 2: JeanLima93 ($219.04 in chips) 
Seat 3: matiko09 ($100 in chips) 
Seat 4: Igor DoUrden ($228.81 in chips) 
Seat 5: tipner ($100 in chips) 
Seat 6: nickreason17 ($104.16 in chips) 
Seat 7: Spid1 ($100 in chips) 
Seat 8: volwebni4ek ($40 in chips) 
Seat 9: ARTVOR640 ($100 in chips) 
ARTVOR640: posts small blind $0.50
Vikulja1993: posts big blind $1
*** HOLE CARDS ***
Dealt to matiko09 [3d 5s]
JeanLima93: folds 
matiko09: folds 
Igor DoUrden: folds 
tipner: folds 
nickreason17: raises $2 to $3
Spid1: folds 
volwebni4ek: folds 
ARTVOR640: folds 
Vikulja1993: folds 
Uncalled bet ($2) returned to nickreason17
nickreason17 collected $2.50 from pot
*** SUMMARY ***
Total pot $2.50 | Rake $0 
Seat 1: Vikulja1993 (big blind) folded before Flop
Seat 2: JeanLima93 folded before Flop (didn't bet)
Seat 3: matiko09 folded before Flop (didn't bet)
Seat 4: Igor DoUrden folded before Flop (didn't bet)
Seat 5: tipner folded before Flop (didn't bet)
Seat 6: nickreason17 collected ($2.50)
Seat 7: Spid1 folded before Flop (didn't bet)
Seat 8: volwebni4ek (button) folded before Flop (didn't bet)
Seat 9: ARTVOR640 (small blind) folded before Flop





PokerStars Hand #148217941804:  Hold'em No Limit ($0.50/$1.00 USD) - 2016/02/04 14:51:10 CET [2016/02/04 8:51:10 ET]
Table 'Sargas' 9-max Seat #4 is the button
Seat 1: Sweden_Pound ($100 in chips) 
Seat 2: chaps1988 ($114.10 in chips) 
Seat 3: sanpidk ($110.69 in chips) 
Seat 4: nickreason17 ($178.93 in chips) 
Seat 5: matiko09 ($100 in chips) 
Seat 6: buttonlife ($46.50 in chips) 
Seat 7: DENG1118 ($100 in chips) 
Seat 8: ozone2003 ($100 in chips) 
Seat 9: tompi-tomp ($77.48 in chips) 
matiko09: posts small blind $0.50
buttonlife: posts big blind $1
*** HOLE CARDS ***
Dealt to matiko09 [4s 5h]
DENG1118: folds 
ozone2003: folds 
tompi-tomp: folds 
Sweden_Pound: raises $2 to $3
chaps1988: raises $7 to $10
sanpidk: folds 
nickreason17: folds 
matiko09: folds 
buttonlife: folds 
Sweden_Pound: raises $14 to $24
chaps1988: calls $14
*** FLOP *** [9c Qc 5d]
Sweden_Pound: checks 
chaps1988: bets $16.50
Sweden_Pound: folds 
Uncalled bet ($16.50) returned to chaps1988
chaps1988 collected $47.27 from pot
chaps1988: doesn't show hand 
*** SUMMARY ***
Total pot $49.50 | Rake $2.23 
Board [9c Qc 5d]
Seat 1: Sweden_Pound folded on the Flop
Seat 2: chaps1988 collected ($47.27)
Seat 3: sanpidk folded before Flop (didn't bet)
Seat 4: nickreason17 (button) folded before Flop (didn't bet)
Seat 5: matiko09 (small blind) folded before Flop
Seat 6: buttonlife (big blind) folded before Flop
Seat 7: DENG1118 folded before Flop (didn't bet)
Seat 8: ozone2003 folded before Flop (didn't bet)
Seat 9: tompi-tomp folded before Flop (didn't bet)





PokerStars Hand #148217949565:  Hold'em No Limit ($0.50/$1.00 USD) - 2016/02/04 14:51:21 CET [2016/02/04 8:51:21 ET]
Table 'Alkaid II' 9-max Seat #3 is the button
Seat 1: Sweden_Pound ($119.98 in chips) 
Seat 3: 1557PSS ($56.63 in chips) 
Seat 4: sanpidk ($116.34 in chips) 
Seat 5: I The King I ($117.89 in chips) 
Seat 6: matiko09 ($100 in chips) 
Seat 8: yourpro ($101.50 in chips) 
Seat 9: tjl290 ($51.08 in chips) 
sanpidk: posts small blind $0.50
I The King I: posts big blind $1
chaps1988: sits out 
xxxZeka: sits out 
*** HOLE CARDS ***
Dealt to matiko09 [8d Ad]
matiko09: folds 
yourpro: folds 
tjl290: folds 
Sweden_Pound: raises $1.50 to $2.50
1557PSS: calls $2.50
sanpidk: folds 
I The King I: calls $1.50
*** FLOP *** [9s 8s 5h]
I The King I: checks 
Sweden_Pound: checks 
1557PSS: checks 
*** TURN *** [9s 8s 5h] [8h]
I The King I: bets $4
Sweden_Pound: folds 
1557PSS: calls $4
*** RIVER *** [9s 8s 5h 8h] [9d]
I The King I: checks 
1557PSS: bets $10
I The King I: calls $10
*** SHOW DOWN ***
1557PSS: shows [Qs Js] (two pair, Nines and Eights)
I The King I: shows [Ac 7c] (two pair, Nines and Eights - Ace kicker)
I The King I collected $34.38 from pot
*** SUMMARY ***
Total pot $36 | Rake $1.62 
Board [9s 8s 5h 8h 9d]
Seat 1: Sweden_Pound folded on the Turn
Seat 3: 1557PSS (button) showed [Qs Js] and lost with two pair, Nines and Eights
Seat 4: sanpidk (small blind) folded before Flop
Seat 5: I The King I (big blind) showed [Ac 7c] and won ($34.38) with two pair, Nines and Eights
Seat 6: matiko09 folded before Flop (didn't bet)
Seat 8: yourpro folded before Flop (didn't bet)
Seat 9: tjl290 folded before Flop (didn't bet)





PokerStars Hand #148217952523:  Hold'em No Limit ($0.50/$1.00 USD) - 2016/02/04 14:51:25 CET [2016/02/04 8:51:25 ET]
Table 'Edburga II' 9-max Seat #1 is the button
Seat 1: matiko09 ($141.70 in chips) 
Seat 2: Vikulja1993 ($100.50 in chips) 
Seat 3: pandalapa ($100 in chips) 
Seat 4: geoffreyjo ($119.36 in chips) 
Seat 5: TimStone ($101.50 in chips) 
Seat 6: Igor DoUrden ($100 in chips) 
Seat 7: tipner ($103.94 in chips) 
Seat 9: nickreason17 ($132 in chips) 
Vikulja1993: posts small blind $0.50
pandalapa: posts big blind $1
*** HOLE CARDS ***
Dealt to matiko09 [Qd Jh]
geoffreyjo: folds 
TimStone: folds 
Igor DoUrden: folds 
tipner: raises $2 to $3
nickreason17: folds 
matiko09: folds 
Vikulja1993: folds 
pandalapa: folds 
Uncalled bet ($2) returned to tipner
tipner collected $2.50 from pot
tipner: doesn't show hand 
*** SUMMARY ***
Total pot $2.50 | Rake $0 
Seat 1: matiko09 (button) folded before Flop (didn't bet)
Seat 2: Vikulja1993 (small blind) folded before Flop
Seat 3: pandalapa (big blind) folded before Flop
Seat 4: geoffreyjo folded before Flop (didn't bet)
Seat 5: TimStone folded before Flop (didn't bet)
Seat 6: Igor DoUrden folded before Flop (didn't bet)
Seat 7: tipner collected ($2.50)
Seat 9: nickreason17 folded before Flop (didn't bet)





PokerStars Hand #148217955837:  Hold'em No Limit ($0.50/$1.00 USD) - 2016/02/04 14:51:30 CET [2016/02/04 8:51:30 ET]
Table 'Arneb II' 9-max Seat #6 is the button
Seat 1: matiko09 ($100 in chips) 
Seat 2: sanpidk ($201.20 in chips) 
Seat 3: brille-390 ($101.50 in chips) 
Seat 4: Venomous100% ($100 in chips) 
Seat 5: lixiangli ($91.68 in chips) 
Seat 6: Sweden_Pound ($140 in chips) 
Seat 7: melitakas ($262.51 in chips) 
Seat 8: tedbadger9 ($80 in chips) 
Seat 9: tipner ($113.99 in chips) 
melitakas: posts small blind $0.50
tedbadger9: posts big blind $1
*** HOLE CARDS ***
Dealt to matiko09 [7c 9h]
tipner: raises $2 to $3
matiko09: folds 
sanpidk: folds 
brille-390: folds 
Venomous100%: calls $3
lixiangli: folds 
Sweden_Pound: folds 
melitakas: folds 
tedbadger9: calls $2
*** FLOP *** [8c Ad 5c]
tedbadger9: checks 
tipner: checks 
Venomous100%: bets $6.80
tedbadger9: folds 
tipner: folds 
Uncalled bet ($6.80) returned to Venomous100%
Venomous100% collected $9.07 from pot
Venomous100%: doesn't show hand 
*** SUMMARY ***
Total pot $9.50 | Rake $0.43 
Board [8c Ad 5c]
Seat 1: matiko09 folded before Flop (didn't bet)
Seat 2: sanpidk folded before Flop (didn't bet)
Seat 3: brille-390 folded before Flop (didn't bet)
Seat 4: Venomous100% collected ($9.07)
Seat 5: lixiangli folded before Flop (didn't bet)
Seat 6: Sweden_Pound (button) folded before Flop (didn't bet)
Seat 7: melitakas (small blind) folded before Flop
Seat 8: tedbadger9 (big blind) folded on the Flop
Seat 9: tipner folded on the Flop





PokerStars Hand #148217964806:  Hold'em No Limit ($0.50/$1.00 USD) - 2016/02/04 14:51:42 CET [2016/02/04 8:51:42 ET]
Table 'Asios III' 9-max Seat #5 is the button
Seat 1: yourpro ($100 in chips) 
Seat 2: crime8783 ($42.97 in chips) 
Seat 3: Igor DoUrden ($107.03 in chips) 
Seat 4: TimStone ($100 in chips) 
Seat 5: ilaviiitech ($100 in chips) 
Seat 6: matiko09 ($125.50 in chips) 
Seat 7: nickreason17 ($195.96 in chips) 
Seat 8: Sweden_Pound ($102.42 in chips) 
Seat 9: Vikulja1993 ($160.20 in chips) 
matiko09: posts small blind $0.50
nickreason17: posts big blind $1
*** HOLE CARDS ***
Dealt to matiko09 [2s 7h]
Sweden_Pound: folds 
Vikulja1993: folds 
yourpro: folds 
crime8783: calls $1
Igor DoUrden: folds 
TimStone: folds 
ilaviiitech: folds 
matiko09: folds 
nickreason17: raises $3 to $4
crime8783: calls $3
*** FLOP *** [6d 4c 5c]
nickreason17: checks 
crime8783: checks 
*** TURN *** [6d 4c 5c] [9h]
nickreason17: checks 
crime8783: checks 
*** RIVER *** [6d 4c 5c 9h] [3d]
nickreason17: checks 
crime8783: checks 
*** SHOW DOWN ***
nickreason17: shows [Th Ad] (high card Ace)
crime8783: shows [3s Kc] (a pair of Threes)
crime8783 collected $8.12 from pot
*** SUMMARY ***
Total pot $8.50 | Rake $0.38 
Board [6d 4c 5c 9h 3d]
Seat 1: yourpro folded before Flop (didn't bet)
Seat 2: crime8783 showed [3s Kc] and won ($8.12) with a pair of Threes
Seat 3: Igor DoUrden folded before Flop (didn't bet)
Seat 4: TimStone folded before Flop (didn't bet)
Seat 5: ilaviiitech (button) folded before Flop (didn't bet)
Seat 6: matiko09 (small blind) folded before Flop
Seat 7: nickreason17 (big blind) showed [Th Ad] and lost with high card Ace
Seat 8: Sweden_Pound folded before Flop (didn't bet)
Seat 9: Vikulja1993 folded before Flop (didn't bet)





PokerStars Hand #148217972923:  Hold'em No Limit ($0.50/$1.00 USD) - 2016/02/04 14:51:54 CET [2016/02/04 8:51:54 ET]
Table 'Edburga II' 9-max Seat #2 is the button
Seat 1: matiko09 ($141.70 in chips) 
Seat 2: Vikulja1993 ($100 in chips) 
Seat 3: pandalapa ($100 in chips) 
Seat 4: geoffreyjo ($119.36 in chips) 
Seat 5: TimStone ($101.50 in chips) 
Seat 6: Igor DoUrden ($100 in chips) 
Seat 7: tipner ($105.44 in chips) 
Seat 9: nickreason17 ($132 in chips) 
pandalapa: posts small blind $0.50
geoffreyjo: posts big blind $1
*** HOLE CARDS ***
Dealt to matiko09 [2h 5c]
TimStone: folds 
Igor DoUrden: folds 
RICKA16 joins the table at seat #8 
tipner: raises $1 to $2
nickreason17: folds 
matiko09: folds 
Vikulja1993: folds 
pandalapa: folds 
geoffreyjo: calls $1
*** FLOP *** [Kh 5d Ts]
geoffreyjo: checks 
tipner: checks 
*** TURN *** [Kh 5d Ts] [2d]
geoffreyjo: bets $2
tipner: folds 
Uncalled bet ($2) returned to geoffreyjo
geoffreyjo collected $4.30 from pot
geoffreyjo: doesn't show hand 
*** SUMMARY ***
Total pot $4.50 | Rake $0.20 
Board [Kh 5d Ts 2d]
Seat 1: matiko09 folded before Flop (didn't bet)
Seat 2: Vikulja1993 (button) folded before Flop (didn't bet)
Seat 3: pandalapa (small blind) folded before Flop
Seat 4: geoffreyjo (big blind) collected ($4.30)
Seat 5: TimStone folded before Flop (didn't bet)
Seat 6: Igor DoUrden folded before Flop (didn't bet)
Seat 7: tipner folded on the Turn
Seat 9: nickreason17 folded before Flop (didn't bet)





PokerStars Hand #148217973863:  Hold'em No Limit ($0.50/$1.00 USD) - 2016/02/04 14:51:55 CET [2016/02/04 8:51:55 ET]
Table 'Siarnaq' 9-max Seat #4 is the button
Seat 1: taraisai ($99 in chips) 
Seat 2: matiko09 ($100 in chips) 
Seat 3: nickreason17 ($100 in chips) 
Seat 4: sanpidk ($100 in chips) 
Seat 5: Igor DoUrden ($115.76 in chips) 
Seat 6: I The King I ($100 in chips) 
Seat 9: goblind4777 ($92.40 in chips) 
Igor DoUrden: posts small blind $0.50
I The King I: posts big blind $1
Sesamesnap: sits out 
*** HOLE CARDS ***
Dealt to matiko09 [Ad 8h]
goblind4777: calls $1
taraisai: folds 
matiko09: folds 
nickreason17: folds 
sanpidk: folds 
Igor DoUrden: folds 
I The King I: checks 
*** FLOP *** [Qc 2h 3h]
I The King I: checks 
goblind4777: bets $2
I The King I: folds 
Uncalled bet ($2) returned to goblind4777
goblind4777 collected $2.39 from pot
goblind4777: doesn't show hand 
*** SUMMARY ***
Total pot $2.50 | Rake $0.11 
Board [Qc 2h 3h]
Seat 1: taraisai folded before Flop (didn't bet)
Seat 2: matiko09 folded before Flop (didn't bet)
Seat 3: nickreason17 folded before Flop (didn't bet)
Seat 4: sanpidk (button) folded before Flop (didn't bet)
Seat 5: Igor DoUrden (small blind) folded before Flop
Seat 6: I The King I (big blind) folded on the Flop
Seat 9: goblind4777 collected ($2.39)





PokerStars Hand #148217979954:  Hold'em No Limit ($0.50/$1.00 USD) - 2016/02/04 14:52:04 CET [2016/02/04 8:52:04 ET]
Table 'Arneb III' 9-max Seat #9 is the button
Seat 1: Vikulja1993 ($100 in chips) 
Seat 2: JeanLima93 ($219.04 in chips) 
Seat 3: matiko09 ($100 in chips) 
Seat 4: Igor DoUrden ($228.81 in chips) 
Seat 5: tipner ($100 in chips) 
Seat 6: nickreason17 ($105.66 in chips) 
Seat 7: Spid1 ($100 in chips) 
Seat 8: volwebni4ek ($40 in chips) 
Seat 9: ARTVOR640 ($100 in chips) 
Vikulja1993: posts small blind $0.50
JeanLima93: posts big blind $1
*** HOLE CARDS ***
Dealt to matiko09 [8h Jh]
matiko09: folds 
Igor DoUrden: folds 
tipner: folds 
nickreason17: raises $2 to $3
Spid1: folds 
volwebni4ek: folds 
ARTVOR640: folds 
Vikulja1993: folds 
JeanLima93: calls $2
*** FLOP *** [7h 8s Ks]
JeanLima93: checks 
nickreason17: bets $4.65
JeanLima93: calls $4.65
*** TURN *** [7h 8s Ks] [6c]
JeanLima93: checks 
nickreason17: checks 
*** RIVER *** [7h 8s Ks 6c] [As]
JeanLima93: checks 
nickreason17: checks 
*** SHOW DOWN ***
JeanLima93: shows [5c 6s] (a pair of Sixes)
nickreason17: shows [Kh Qd] (a pair of Kings)
nickreason17 collected $15.09 from pot
*** SUMMARY ***
Total pot $15.80 | Rake $0.71 
Board [7h 8s Ks 6c As]
Seat 1: Vikulja1993 (small blind) folded before Flop
Seat 2: JeanLima93 (big blind) showed [5c 6s] and lost with a pair of Sixes
Seat 3: matiko09 folded before Flop (didn't bet)
Seat 4: Igor DoUrden folded before Flop (didn't bet)
Seat 5: tipner folded before Flop (didn't bet)
Seat 6: nickreason17 showed [Kh Qd] and won ($15.09) with a pair of Kings
Seat 7: Spid1 folded before Flop (didn't bet)
Seat 8: volwebni4ek folded before Flop (didn't bet)
Seat 9: ARTVOR640 (button) folded before Flop (didn't bet)





PokerStars Hand #148217999197:  Hold'em No Limit ($0.50/$1.00 USD) - 2016/02/04 14:52:31 CET [2016/02/04 8:52:31 ET]
Table 'Alkaid II' 9-max Seat #4 is the button
Seat 1: Sweden_Pound ($117.48 in chips) 
Seat 3: 1557PSS ($40.13 in chips) 
Seat 4: sanpidk ($115.84 in chips) 
Seat 5: I The King I ($135.77 in chips) 
Seat 6: matiko09 ($100 in chips) 
Seat 8: yourpro ($101.50 in chips) 
Seat 9: tjl290 ($51.08 in chips) 
I The King I: posts small blind $0.50
matiko09: posts big blind $1
chaps1988: sits out 
xxxZeka: sits out 
*** HOLE CARDS ***
Dealt to matiko09 [Ah Td]
yourpro: folds 
tjl290: folds 
Sweden_Pound: folds 
1557PSS: folds 
sanpidk: folds 
I The King I: folds 
Uncalled bet ($0.50) returned to matiko09
matiko09 collected $1 from pot
matiko09: doesn't show hand 
*** SUMMARY ***
Total pot $1 | Rake $0 
Seat 1: Sweden_Pound folded before Flop (didn't bet)
Seat 3: 1557PSS folded before Flop (didn't bet)
Seat 4: sanpidk (button) folded before Flop (didn't bet)
Seat 5: I The King I (small blind) folded before Flop
Seat 6: matiko09 (big blind) collected ($1)
Seat 8: yourpro folded before Flop (didn't bet)
Seat 9: tjl290 folded before Flop (didn't bet)





PokerStars Hand #148218006762:  Hold'em No Limit ($0.50/$1.00 USD) - 2016/02/04 14:52:41 CET [2016/02/04 8:52:41 ET]
Table 'Sargas' 9-max Seat #5 is the button
Seat 1: Sweden_Pound ($100 in chips) 
Seat 2: chaps1988 ($137.37 in chips) 
Seat 3: sanpidk ($110.69 in chips) 
Seat 4: nickreason17 ($178.93 in chips) 
Seat 5: matiko09 ($100 in chips) 
Seat 6: buttonlife ($45.50 in chips) 
Seat 7: DENG1118 ($100 in chips) 
Seat 8: ozone2003 ($100 in chips) 
Seat 9: tompi-tomp ($77.48 in chips) 
buttonlife: posts small blind $0.50
DENG1118: posts big blind $1
*** HOLE CARDS ***
Dealt to matiko09 [7c Ts]
ozone2003: folds 
tompi-tomp: raises $2 to $3
Sweden_Pound: folds 
chaps1988: folds 
sanpidk: folds 
nickreason17: folds 
matiko09: folds 
buttonlife: folds 
DENG1118: folds 
Uncalled bet ($2) returned to tompi-tomp
tompi-tomp collected $2.50 from pot
tompi-tomp: doesn't show hand 
*** SUMMARY ***
Total pot $2.50 | Rake $0 
Seat 1: Sweden_Pound folded before Flop (didn't bet)
Seat 2: chaps1988 folded before Flop (didn't bet)
Seat 3: sanpidk folded before Flop (didn't bet)
Seat 4: nickreason17 folded before Flop (didn't bet)
Seat 5: matiko09 (button) folded before Flop (didn't bet)
Seat 6: buttonlife (small blind) folded before Flop
Seat 7: DENG1118 (big blind) folded before Flop
Seat 8: ozone2003 folded before Flop (didn't bet)
Seat 9: tompi-tomp collected ($2.50)





PokerStars Hand #148218010066:  Hold'em No Limit ($0.50/$1.00 USD) - 2016/02/04 14:52:46 CET [2016/02/04 8:52:46 ET]
Table 'Siarnaq' 9-max Seat #5 is the button
Seat 1: taraisai ($99 in chips) 
Seat 2: matiko09 ($100 in chips) 
Seat 3: nickreason17 ($100 in chips) 
Seat 4: sanpidk ($100 in chips) 
Seat 5: Igor DoUrden ($115.26 in chips) 
Seat 6: I The King I ($100 in chips) 
Seat 7: Sesamesnap ($60.27 in chips) 
Seat 9: goblind4777 ($93.79 in chips) 
I The King I: posts small blind $0.50
Sesamesnap: posts big blind $1
maxxmeister: sits out 
*** HOLE CARDS ***
Dealt to matiko09 [4d 2h]
goblind4777: folds 
taraisai: folds 
matiko09: folds 
nickreason17: folds 
sanpidk: folds 
Igor DoUrden: raises $1.09 to $2.09
I The King I: folds 
Sesamesnap: folds 
Uncalled bet ($1.09) returned to Igor DoUrden
Igor DoUrden collected $2.50 from pot
Igor DoUrden: doesn't show hand 
*** SUMMARY ***
Total pot $2.50 | Rake $0 
Seat 1: taraisai folded before Flop (didn't bet)
Seat 2: matiko09 folded before Flop (didn't bet)
Seat 3: nickreason17 folded before Flop (didn't bet)
Seat 4: sanpidk folded before Flop (didn't bet)
Seat 5: Igor DoUrden (button) collected ($2.50)
Seat 6: I The King I (small blind) folded before Flop
Seat 7: Sesamesnap (big blind) folded before Flop
Seat 9: goblind4777 folded before Flop (didn't bet)





PokerStars Hand #148218012804:  Hold'em No Limit ($0.50/$1.00 USD) - 2016/02/04 14:52:50 CET [2016/02/04 8:52:50 ET]
Table 'Arneb II' 9-max Seat #7 is the button
Seat 1: matiko09 ($100 in chips) 
Seat 2: sanpidk ($201.20 in chips) 
Seat 3: brille-390 ($101.50 in chips) 
Seat 4: Venomous100% ($106.07 in chips) 
Seat 5: lixiangli ($91.68 in chips) 
Seat 6: Sweden_Pound ($140 in chips) 
Seat 7: melitakas ($262.01 in chips) 
Seat 8: tedbadger9 ($77 in chips) 
Seat 9: tipner ($110.99 in chips) 
tedbadger9: posts small blind $0.50
tipner: posts big blind $1
*** HOLE CARDS ***
Dealt to matiko09 [2c 3c]
matiko09: folds 
sanpidk: folds 
brille-390: folds 
Venomous100%: raises $2 to $3
lixiangli: calls $3
Sweden_Pound: folds 
melitakas: folds 
tedbadger9: calls $2.50
tipner: folds 
*** FLOP *** [Qc Td 9d]
tedbadger9: checks 
Venomous100%: bets $7.16
lixiangli: calls $7.16
tedbadger9: folds 
*** TURN *** [Qc Td 9d] [6d]
Venomous100%: bets $15.48
lixiangli: folds 
Uncalled bet ($15.48) returned to Venomous100%
Venomous100% collected $23.23 from pot
Venomous100%: doesn't show hand 
*** SUMMARY ***
Total pot $24.32 | Rake $1.09 
Board [Qc Td 9d 6d]
Seat 1: matiko09 folded before Flop (didn't bet)
Seat 2: sanpidk folded before Flop (didn't bet)
Seat 3: brille-390 folded before Flop (didn't bet)
Seat 4: Venomous100% collected ($23.23)
Seat 5: lixiangli folded on the Turn
Seat 6: Sweden_Pound folded before Flop (didn't bet)
Seat 7: melitakas (button) folded before Flop (didn't bet)
Seat 8: tedbadger9 (small blind) folded on the Flop
Seat 9: tipner (big blind) folded before Flop





PokerStars Hand #148218014972:  Hold'em No Limit ($0.50/$1.00 USD) - 2016/02/04 14:52:53 CET [2016/02/04 8:52:53 ET]
Table 'Edburga II' 9-max Seat #3 is the button
Seat 1: matiko09 ($141.70 in chips) 
Seat 2: Vikulja1993 ($100 in chips) 
Seat 3: pandalapa ($100 in chips) 
Seat 4: geoffreyjo ($121.66 in chips) 
Seat 5: TimStone ($101.50 in chips) 
Seat 6: Igor DoUrden ($100 in chips) 
Seat 7: tipner ($103.44 in chips) 
Seat 9: nickreason17 ($132 in chips) 
geoffreyjo: posts small blind $0.50
TimStone: posts big blind $1
RICKA16: sits out 
*** HOLE CARDS ***
Dealt to matiko09 [8h 8s]
Igor DoUrden: folds 
tipner: folds 
nickreason17: folds 
matiko09: raises $2 to $3
Vikulja1993: calls $3
pandalapa: raises $9 to $12
geoffreyjo: folds 
TimStone: folds 
matiko09: folds 
Vikulja1993: folds 
Uncalled bet ($9) returned to pandalapa
pandalapa collected $10.50 from pot
pandalapa: doesn't show hand 
*** SUMMARY ***
Total pot $10.50 | Rake $0 
Seat 1: matiko09 folded before Flop
Seat 2: Vikulja1993 folded before Flop
Seat 3: pandalapa (button) collected ($10.50)
Seat 4: geoffreyjo (small blind) folded before Flop
Seat 5: TimStone (big blind) folded before Flop
Seat 6: Igor DoUrden folded before Flop (didn't bet)
Seat 7: tipner folded before Flop (didn't bet)
Seat 9: nickreason17 folded before Flop (didn't bet)





PokerStars Hand #148218014982:  Hold'em No Limit ($0.50/$1.00 USD) - 2016/02/04 14:52:53 CET [2016/02/04 8:52:53 ET]
Table 'Asios III' 9-max Seat #6 is the button
Seat 1: yourpro ($100 in chips) 
Seat 2: crime8783 ($47.09 in chips) 
Seat 3: Igor DoUrden ($107.03 in chips) 
Seat 4: TimStone ($100 in chips) 
Seat 5: ilaviiitech ($100 in chips) 
Seat 6: matiko09 ($125 in chips) 
Seat 7: nickreason17 ($191.96 in chips) 
Seat 9: Vikulja1993 ($160.20 in chips) 
nickreason17: posts small blind $0.50
Sweden_Pound: is sitting out 
Vikulja1993: posts big blind $1
*** HOLE CARDS ***
Dealt to matiko09 [Qs Qc]
yourpro: folds 
crime8783: calls $1
Igor DoUrden: folds 
TimStone: folds 
ilaviiitech: raises $3 to $4
matiko09: calls $4
nickreason17: folds 
Vikulja1993: folds 
crime8783: calls $3
*** FLOP *** [2d Ac Ts]
crime8783: bets $3
ilaviiitech: raises $7.50 to $10.50
matiko09: folds 
crime8783: calls $7.50
*** TURN *** [2d Ac Ts] [4c]
crime8783: bets $10
ilaviiitech: raises $37.06 to $47.06
crime8783: calls $22.59 and is all-in
Uncalled bet ($14.47) returned to ilaviiitech
*** RIVER *** [2d Ac Ts 4c] [Jh]
*** SHOW DOWN ***
crime8783: shows [Th 5d] (a pair of Tens)
ilaviiitech: shows [Ah Tc] (two pair, Aces and Tens)
ilaviiitech collected $96.88 from pot
*** SUMMARY ***
Total pot $99.68 | Rake $2.80 
Board [2d Ac Ts 4c Jh]
Seat 1: yourpro folded before Flop (didn't bet)
Seat 2: crime8783 showed [Th 5d] and lost with a pair of Tens
Seat 3: Igor DoUrden folded before Flop (didn't bet)
Seat 4: TimStone folded before Flop (didn't bet)
Seat 5: ilaviiitech showed [Ah Tc] and won ($96.88) with two pair, Aces and Tens
Seat 6: matiko09 (button) folded on the Flop
Seat 7: nickreason17 (small blind) folded before Flop
Seat 9: Vikulja1993 (big blind) folded before Flop





PokerStars Hand #148218016171:  Hold'em No Limit ($0.50/$1.00 USD) - 2016/02/04 14:52:55 CET [2016/02/04 8:52:55 ET]
Table 'Alkaid II' 9-max Seat #5 is the button
Seat 1: Sweden_Pound ($117.48 in chips) 
Seat 3: 1557PSS ($40.13 in chips) 
Seat 4: sanpidk ($115.84 in chips) 
Seat 5: I The King I ($135.27 in chips) 
Seat 6: matiko09 ($100.50 in chips) 
Seat 7: chaps1988 ($100 in chips) 
Seat 8: yourpro ($101.50 in chips) 
Seat 9: tjl290 ($51.08 in chips) 
matiko09: posts small blind $0.50
chaps1988: posts big blind $1
xxxZeka: sits out 
*** HOLE CARDS ***
Dealt to matiko09 [3h 9d]
yourpro: folds 
tjl290: folds 
Sweden_Pound: folds 
1557PSS: folds 
sanpidk: folds 
I The King I: folds 
matiko09: folds 
Uncalled bet ($0.50) returned to chaps1988
chaps1988 collected $1 from pot
chaps1988: doesn't show hand 
*** SUMMARY ***
Total pot $1 | Rake $0 
Seat 1: Sweden_Pound folded before Flop (didn't bet)
Seat 3: 1557PSS folded before Flop (didn't bet)
Seat 4: sanpidk folded before Flop (didn't bet)
Seat 5: I The King I (button) folded before Flop (didn't bet)
Seat 6: matiko09 (small blind) folded before Flop
Seat 7: chaps1988 (big blind) collected ($1)
Seat 8: yourpro folded before Flop (didn't bet)
Seat 9: tjl290 folded before Flop (didn't bet)





PokerStars Hand #148218018887:  Hold'em No Limit ($0.50/$1.00 USD) - 2016/02/04 14:52:58 CET [2016/02/04 8:52:58 ET]
Table 'Arneb III' 9-max Seat #1 is the button
Seat 1: Vikulja1993 ($100 in chips) 
Seat 2: JeanLima93 ($211.39 in chips) 
Seat 3: matiko09 ($100 in chips) 
Seat 4: Igor DoUrden ($228.81 in chips) 
Seat 5: tipner ($100 in chips) 
Seat 6: nickreason17 ($113.10 in chips) 
Seat 7: Spid1 ($100 in chips) 
Seat 8: volwebni4ek ($40 in chips) 
Seat 9: ARTVOR640 ($100 in chips) 
JeanLima93: posts small blind $0.50
matiko09: posts big blind $1
*** HOLE CARDS ***
Dealt to matiko09 [3d Tc]
Igor DoUrden: folds 
tipner: folds 
nickreason17: raises $2 to $3
Spid1: folds 
volwebni4ek: calls $3
ARTVOR640: folds 
Vikulja1993: folds 
JeanLima93: folds 
matiko09: folds 
*** FLOP *** [Ad Jc 6s]
nickreason17: checks 
volwebni4ek: checks 
*** TURN *** [Ad Jc 6s] [5d]
nickreason17: bets $4.50
volwebni4ek: calls $4.50
*** RIVER *** [Ad Jc 6s 5d] [8h]
nickreason17: bets $9
volwebni4ek: folds 
Uncalled bet ($9) returned to nickreason17
nickreason17 collected $15.76 from pot
*** SUMMARY ***
Total pot $16.50 | Rake $0.74 
Board [Ad Jc 6s 5d 8h]
Seat 1: Vikulja1993 (button) folded before Flop (didn't bet)
Seat 2: JeanLima93 (small blind) folded before Flop
Seat 3: matiko09 (big blind) folded before Flop
Seat 4: Igor DoUrden folded before Flop (didn't bet)
Seat 5: tipner folded before Flop (didn't bet)
Seat 6: nickreason17 collected ($15.76)
Seat 7: Spid1 folded before Flop (didn't bet)
Seat 8: volwebni4ek folded on the River
Seat 9: ARTVOR640 folded before Flop (didn't bet)





PokerStars Hand #148218026051:  Hold'em No Limit ($0.50/$1.00 USD) - 2016/02/04 14:53:08 CET [2016/02/04 8:53:08 ET]
Table 'Siarnaq' 9-max Seat #6 is the button
Seat 1: taraisai ($99 in chips) 
Seat 2: matiko09 ($100 in chips) 
Seat 3: nickreason17 ($100 in chips) 
Seat 4: sanpidk ($100 in chips) 
Seat 5: Igor DoUrden ($116.76 in chips) 
Seat 6: I The King I ($100 in chips) 
Seat 7: Sesamesnap ($59.27 in chips) 
Seat 8: maxxmeister ($100 in chips) 
Seat 9: goblind4777 ($93.79 in chips) 
Sesamesnap: posts small blind $0.50
maxxmeister: posts big blind $1
*** HOLE CARDS ***
Dealt to matiko09 [5s 4d]
goblind4777: raises $3 to $4
taraisai: folds 
matiko09: folds 
nickreason17: folds 
sanpidk: folds 
Igor DoUrden: folds 
I The King I: folds 
Sesamesnap: folds 
maxxmeister: folds 
Uncalled bet ($3) returned to goblind4777
goblind4777 collected $2.50 from pot
goblind4777: doesn't show hand 
*** SUMMARY ***
Total pot $2.50 | Rake $0 
Seat 1: taraisai folded before Flop (didn't bet)
Seat 2: matiko09 folded before Flop (didn't bet)
Seat 3: nickreason17 folded before Flop (didn't bet)
Seat 4: sanpidk folded before Flop (didn't bet)
Seat 5: Igor DoUrden folded before Flop (didn't bet)
Seat 6: I The King I (button) folded before Flop (didn't bet)
Seat 7: Sesamesnap (small blind) folded before Flop
Seat 8: maxxmeister (big blind) folded before Flop
Seat 9: goblind4777 collected ($2.50)





PokerStars Hand #148218026371:  Hold'em No Limit ($0.50/$1.00 USD) - 2016/02/04 14:53:09 CET [2016/02/04 8:53:09 ET]
Table 'Sargas' 9-max Seat #6 is the button
Seat 1: Sweden_Pound ($100 in chips) 
Seat 2: chaps1988 ($137.37 in chips) 
Seat 3: sanpidk ($110.69 in chips) 
Seat 4: nickreason17 ($178.93 in chips) 
Seat 5: matiko09 ($100 in chips) 
Seat 6: buttonlife ($45 in chips) 
Seat 7: DENG1118 ($99 in chips) 
Seat 8: ozone2003 ($100 in chips) 
Seat 9: tompi-tomp ($78.98 in chips) 
DENG1118: posts small blind $0.50
ozone2003: posts big blind $1
*** HOLE CARDS ***
Dealt to matiko09 [8s Ts]
tompi-tomp: raises $2 to $3
Sweden_Pound: folds 
chaps1988: folds 
sanpidk: folds 
nickreason17: folds 
matiko09: folds 
buttonlife: folds 
DENG1118: folds 
ozone2003: folds 
Uncalled bet ($2) returned to tompi-tomp
tompi-tomp collected $2.50 from pot
tompi-tomp: doesn't show hand 
*** SUMMARY ***
Total pot $2.50 | Rake $0 
Seat 1: Sweden_Pound folded before Flop (didn't bet)
Seat 2: chaps1988 folded before Flop (didn't bet)
Seat 3: sanpidk folded before Flop (didn't bet)
Seat 4: nickreason17 folded before Flop (didn't bet)
Seat 5: matiko09 folded before Flop (didn't bet)
Seat 6: buttonlife (button) folded before Flop (didn't bet)
Seat 7: DENG1118 (small blind) folded before Flop
Seat 8: ozone2003 (big blind) folded before Flop
Seat 9: tompi-tomp collected ($2.50)





PokerStars Hand #148218040270:  Hold'em No Limit ($0.50/$1.00 USD) - 2016/02/04 14:53:28 CET [2016/02/04 8:53:28 ET]
Table 'Alkaid II' 9-max Seat #6 is the button
Seat 1: Sweden_Pound ($117.48 in chips) 
Seat 3: 1557PSS ($40.13 in chips) 
Seat 4: sanpidk ($115.84 in chips) 
Seat 5: I The King I ($135.27 in chips) 
Seat 6: matiko09 ($100 in chips) 
Seat 7: chaps1988 ($100.50 in chips) 
Seat 8: yourpro ($101.50 in chips) 
Seat 9: tjl290 ($51.08 in chips) 
chaps1988: posts small blind $0.50
yourpro: posts big blind $1
xxxZeka: sits out 
*** HOLE CARDS ***
Dealt to matiko09 [7s 2h]
tjl290: folds 
Sweden_Pound: folds 
1557PSS: folds 
sanpidk: folds 
I The King I: raises $1.50 to $2.50
matiko09: folds 
chaps1988: folds 
yourpro: calls $1.50
*** FLOP *** [Kc 9d 9s]
yourpro: checks 
I The King I: checks 
*** TURN *** [Kc 9d 9s] [Th]
yourpro: checks 
I The King I: checks 
*** RIVER *** [Kc 9d 9s Th] [6s]
yourpro: checks 
I The King I: checks 
*** SHOW DOWN ***
yourpro: shows [Ac Js] (a pair of Nines)
I The King I: shows [3c 3d] (two pair, Nines and Threes)
I The King I collected $5.25 from pot
*** SUMMARY ***
Total pot $5.50 | Rake $0.25 
Board [Kc 9d 9s Th 6s]
Seat 1: Sweden_Pound folded before Flop (didn't bet)
Seat 3: 1557PSS folded before Flop (didn't bet)
Seat 4: sanpidk folded before Flop (didn't bet)
Seat 5: I The King I showed [3c 3d] and won ($5.25) with two pair, Nines and Threes
Seat 6: matiko09 (button) folded before Flop (didn't bet)
Seat 7: chaps1988 (small blind) folded before Flop
Seat 8: yourpro (big blind) showed [Ac Js] and lost with a pair of Nines
Seat 9: tjl290 folded before Flop (didn't bet)





PokerStars Hand #148218045579:  Hold'em No Limit ($0.50/$1.00 USD) - 2016/02/04 14:53:36 CET [2016/02/04 8:53:36 ET]
Table 'Edburga II' 9-max Seat #4 is the button
Seat 1: matiko09 ($138.70 in chips) 
Seat 2: Vikulja1993 ($100 in chips) 
Seat 3: pandalapa ($107.50 in chips) 
Seat 4: geoffreyjo ($121.16 in chips) 
Seat 5: TimStone ($100.50 in chips) 
Seat 6: Igor DoUrden ($100 in chips) 
Seat 7: tipner ($103.44 in chips) 
Seat 9: nickreason17 ($132 in chips) 
TimStone: posts small blind $0.50
Igor DoUrden: posts big blind $1
RICKA16: sits out 
*** HOLE CARDS ***
Dealt to matiko09 [2d 9d]
tipner: folds 
nickreason17: folds 
matiko09: folds 
Vikulja1993: folds 
pandalapa: folds 
geoffreyjo: raises $2 to $3
TimStone: folds 
Igor DoUrden: raises $7 to $10
geoffreyjo: calls $7
*** FLOP *** [9s Ah 2h]
Igor DoUrden: checks 
geoffreyjo: bets $13
Igor DoUrden: folds 
Uncalled bet ($13) returned to geoffreyjo
geoffreyjo collected $19.58 from pot
geoffreyjo: doesn't show hand 
*** SUMMARY ***
Total pot $20.50 | Rake $0.92 
Board [9s Ah 2h]
Seat 1: matiko09 folded before Flop (didn't bet)
Seat 2: Vikulja1993 folded before Flop (didn't bet)
Seat 3: pandalapa folded before Flop (didn't bet)
Seat 4: geoffreyjo (button) collected ($19.58)
Seat 5: TimStone (small blind) folded before Flop
Seat 6: Igor DoUrden (big blind) folded on the Flop
Seat 7: tipner folded before Flop (didn't bet)
Seat 9: nickreason17 folded before Flop (didn't bet)





PokerStars Hand #148218053571:  Hold'em No Limit ($0.50/$1.00 USD) - 2016/02/04 14:53:47 CET [2016/02/04 8:53:47 ET]
Table 'Siarnaq' 9-max Seat #7 is the button
Seat 1: taraisai ($99 in chips) 
Seat 2: matiko09 ($100 in chips) 
Seat 3: nickreason17 ($100 in chips) 
Seat 4: sanpidk ($100 in chips) 
Seat 5: Igor DoUrden ($116.76 in chips) 
Seat 6: I The King I ($100 in chips) 
Seat 7: Sesamesnap ($58.77 in chips) 
Seat 8: maxxmeister ($100 in chips) 
Seat 9: goblind4777 ($95.29 in chips) 
maxxmeister: posts small blind $0.50
goblind4777: posts big blind $1
*** HOLE CARDS ***
Dealt to matiko09 [2c Js]
taraisai: folds 
matiko09: folds 
nickreason17: folds 
sanpidk: raises $2 to $3
Igor DoUrden: folds 
I The King I: folds 
Sesamesnap: folds 
maxxmeister: folds 
goblind4777: folds 
Uncalled bet ($2) returned to sanpidk
sanpidk collected $2.50 from pot
sanpidk: doesn't show hand 
*** SUMMARY ***
Total pot $2.50 | Rake $0 
Seat 1: taraisai folded before Flop (didn't bet)
Seat 2: matiko09 folded before Flop (didn't bet)
Seat 3: nickreason17 folded before Flop (didn't bet)
Seat 4: sanpidk collected ($2.50)
Seat 5: Igor DoUrden folded before Flop (didn't bet)
Seat 6: I The King I folded before Flop (didn't bet)
Seat 7: Sesamesnap (button) folded before Flop (didn't bet)
Seat 8: maxxmeister (small blind) folded before Flop
Seat 9: goblind4777 (big blind) folded before Flop





PokerStars Hand #148218053583:  Hold'em No Limit ($0.50/$1.00 USD) - 2016/02/04 14:53:47 CET [2016/02/04 8:53:47 ET]
Table 'Sargas' 9-max Seat #7 is the button
Seat 1: Sweden_Pound ($100 in chips) 
Seat 2: chaps1988 ($137.37 in chips) 
Seat 3: sanpidk ($110.69 in chips) 
Seat 4: nickreason17 ($178.93 in chips) 
Seat 5: matiko09 ($100 in chips) 
Seat 6: buttonlife ($45 in chips) 
Seat 7: DENG1118 ($98.50 in chips) 
Seat 8: ozone2003 ($100 in chips) 
Seat 9: tompi-tomp ($80.48 in chips) 
ozone2003: posts small blind $0.50
tompi-tomp: posts big blind $1
*** HOLE CARDS ***
Dealt to matiko09 [9d Kh]
Sweden_Pound: folds 
chaps1988: folds 
sanpidk: folds 
nickreason17: raises $2 to $3
matiko09: folds 
buttonlife: folds 
DENG1118: folds 
ozone2003: folds 
tompi-tomp: calls $2
*** FLOP *** [4h 2s 9h]
tompi-tomp: checks 
nickreason17: checks 
*** TURN *** [4h 2s 9h] [8d]
tompi-tomp: bets $4
nickreason17: folds 
Uncalled bet ($4) returned to tompi-tomp
tompi-tomp collected $6.21 from pot
tompi-tomp: doesn't show hand 
*** SUMMARY ***
Total pot $6.50 | Rake $0.29 
Board [4h 2s 9h 8d]
Seat 1: Sweden_Pound folded before Flop (didn't bet)
Seat 2: chaps1988 folded before Flop (didn't bet)
Seat 3: sanpidk folded before Flop (didn't bet)
Seat 4: nickreason17 folded on the Turn
Seat 5: matiko09 folded before Flop (didn't bet)
Seat 6: buttonlife folded before Flop (didn't bet)
Seat 7: DENG1118 (button) folded before Flop (didn't bet)
Seat 8: ozone2003 (small blind) folded before Flop
Seat 9: tompi-tomp (big blind) collected ($6.21)





PokerStars Hand #148218072272:  Hold'em No Limit ($0.50/$1.00 USD) - 2016/02/04 14:54:13 CET [2016/02/04 8:54:13 ET]
Table 'Arneb II' 9-max Seat #8 is the button
Seat 1: matiko09 ($100 in chips) 
Seat 2: sanpidk ($201.20 in chips) 
Seat 3: brille-390 ($101.50 in chips) 
Seat 4: Venomous100% ($119.14 in chips) 
Seat 5: lixiangli ($81.52 in chips) 
Seat 6: Sweden_Pound ($140 in chips) 
Seat 7: melitakas ($262.01 in chips) 
Seat 8: tedbadger9 ($74 in chips) 
Seat 9: tipner ($109.99 in chips) 
tipner: posts small blind $0.50
matiko09: posts big blind $1
*** HOLE CARDS ***
Dealt to matiko09 [Jc 4c]
sanpidk: folds 
brille-390: folds 
Venomous100%: folds 
lixiangli: folds 
Sweden_Pound: raises $2 to $3
melitakas: folds 
tedbadger9: folds 
tipner: folds 
matiko09: folds 
Uncalled bet ($2) returned to Sweden_Pound
Sweden_Pound collected $2.50 from pot
Sweden_Pound: doesn't show hand 
*** SUMMARY ***
Total pot $2.50 | Rake $0 
Seat 1: matiko09 (big blind) folded before Flop
Seat 2: sanpidk folded before Flop (didn't bet)
Seat 3: brille-390 folded before Flop (didn't bet)
Seat 4: Venomous100% folded before Flop (didn't bet)
Seat 5: lixiangli folded before Flop (didn't bet)
Seat 6: Sweden_Pound collected ($2.50)
Seat 7: melitakas folded before Flop (didn't bet)
Seat 8: tedbadger9 (button) folded before Flop (didn't bet)
Seat 9: tipner (small blind) folded before Flop





PokerStars Hand #148218079129:  Hold'em No Limit ($0.50/$1.00 USD) - 2016/02/04 14:54:22 CET [2016/02/04 8:54:22 ET]
Table 'Siarnaq' 9-max Seat #8 is the button
Seat 1: taraisai ($99 in chips) 
Seat 2: matiko09 ($100 in chips) 
Seat 3: nickreason17 ($100 in chips) 
Seat 4: sanpidk ($101.50 in chips) 
Seat 5: Igor DoUrden ($116.76 in chips) 
Seat 6: I The King I ($100 in chips) 
Seat 7: Sesamesnap ($58.77 in chips) 
Seat 8: maxxmeister ($100 in chips) 
Seat 9: goblind4777 ($94.29 in chips) 
goblind4777: posts small blind $0.50
taraisai: posts big blind $1
*** HOLE CARDS ***
Dealt to matiko09 [2h Qc]
matiko09: folds 
nickreason17: folds 
sanpidk: folds 
Igor DoUrden: folds 
I The King I: folds 
Sesamesnap: folds 
maxxmeister: raises $2.50 to $3.50
goblind4777: folds 
taraisai: folds 
Uncalled bet ($2.50) returned to maxxmeister
maxxmeister collected $2.50 from pot
maxxmeister: doesn't show hand 
*** SUMMARY ***
Total pot $2.50 | Rake $0 
Seat 1: taraisai (big blind) folded before Flop
Seat 2: matiko09 folded before Flop (didn't bet)
Seat 3: nickreason17 folded before Flop (didn't bet)
Seat 4: sanpidk folded before Flop (didn't bet)
Seat 5: Igor DoUrden folded before Flop (didn't bet)
Seat 6: I The King I folded before Flop (didn't bet)
Seat 7: Sesamesnap folded before Flop (didn't bet)
Seat 8: maxxmeister (button) collected ($2.50)
Seat 9: goblind4777 (small blind) folded before Flop





PokerStars Hand #148218081444:  Hold'em No Limit ($0.50/$1.00 USD) - 2016/02/04 14:54:26 CET [2016/02/04 8:54:26 ET]
Table 'Sargas' 9-max Seat #8 is the button
Seat 2: chaps1988 ($137.37 in chips) 
Seat 3: sanpidk ($110.69 in chips) 
Seat 4: nickreason17 ($175.93 in chips) 
Seat 5: matiko09 ($100 in chips) 
Seat 6: buttonlife ($45 in chips) 
Seat 7: DENG1118 ($98.50 in chips) 
Seat 8: ozone2003 ($100 in chips) 
Seat 9: tompi-tomp ($83.69 in chips) 
tompi-tomp: posts small blind $0.50
Sweden_Pound: is sitting out 
chaps1988: posts big blind $1
*** HOLE CARDS ***
Dealt to matiko09 [4c Ac]
sanpidk: folds 
nickreason17: folds 
matiko09: folds 
buttonlife: folds 
DENG1118: folds 
ozone2003: raises $1.20 to $2.20
tompi-tomp: calls $1.70
chaps1988: calls $1.20
*** FLOP *** [4s 2s Kd]
tompi-tomp: bets $3
chaps1988: calls $3
ozone2003: folds 
*** TURN *** [4s 2s Kd] [7c]
tompi-tomp: bets $6
chaps1988: calls $6
*** RIVER *** [4s 2s Kd 7c] [Ts]
tompi-tomp: checks 
chaps1988: bets $15.25
tompi-tomp: calls $15.25
*** SHOW DOWN ***
chaps1988: shows [Th Kh] (two pair, Kings and Tens)
tompi-tomp: mucks hand 
chaps1988 collected $52.62 from pot
*** SUMMARY ***
Total pot $55.10 | Rake $2.48 
Board [4s 2s Kd 7c Ts]
Seat 2: chaps1988 (big blind) showed [Th Kh] and won ($52.62) with two pair, Kings and Tens
Seat 3: sanpidk folded before Flop (didn't bet)
Seat 4: nickreason17 folded before Flop (didn't bet)
Seat 5: matiko09 folded before Flop (didn't bet)
Seat 6: buttonlife folded before Flop (didn't bet)
Seat 7: DENG1118 folded before Flop (didn't bet)
Seat 8: ozone2003 (button) folded on the Flop
Seat 9: tompi-tomp (small blind) mucked [Kc Qd]





PokerStars Hand #148218089740:  Hold'em No Limit ($0.50/$1.00 USD) - 2016/02/04 14:54:37 CET [2016/02/04 8:54:37 ET]
Table 'Edburga II' 9-max Seat #5 is the button
Seat 1: matiko09 ($138.70 in chips) 
Seat 2: Vikulja1993 ($100 in chips) 
Seat 3: pandalapa ($107.50 in chips) 
Seat 4: geoffreyjo ($130.74 in chips) 
Seat 5: TimStone ($100 in chips) 
Seat 6: Igor DoUrden ($100 in chips) 
Seat 7: tipner ($103.44 in chips) 
Seat 9: nickreason17 ($132 in chips) 
Igor DoUrden: posts small blind $0.50
tipner: posts big blind $1
RICKA16: sits out 
*** HOLE CARDS ***
Dealt to matiko09 [8d 9c]
nickreason17: folds 
matiko09: folds 
Vikulja1993: folds 
pandalapa: folds 
geoffreyjo: raises $2 to $3
TimStone: folds 
Igor DoUrden: folds 
tipner: folds 
Uncalled bet ($2) returned to geoffreyjo
geoffreyjo collected $2.50 from pot
geoffreyjo: doesn't show hand 
*** SUMMARY ***
Total pot $2.50 | Rake $0 
Seat 1: matiko09 folded before Flop (didn't bet)
Seat 2: Vikulja1993 folded before Flop (didn't bet)
Seat 3: pandalapa folded before Flop (didn't bet)
Seat 4: geoffreyjo collected ($2.50)
Seat 5: TimStone (button) folded before Flop (didn't bet)
Seat 6: Igor DoUrden (small blind) folded before Flop
Seat 7: tipner (big blind) folded before Flop
Seat 9: nickreason17 folded before Flop (didn't bet)





PokerStars Hand #148218091262:  Hold'em No Limit ($0.50/$1.00 USD) - 2016/02/04 14:54:40 CET [2016/02/04 8:54:40 ET]
Table 'Arneb II' 9-max Seat #9 is the button
Seat 1: matiko09 ($100 in chips) 
Seat 2: sanpidk ($201.20 in chips) 
Seat 3: brille-390 ($101.50 in chips) 
Seat 4: Venomous100% ($119.14 in chips) 
Seat 5: lixiangli ($81.52 in chips) 
Seat 6: Sweden_Pound ($141.50 in chips) 
Seat 7: melitakas ($262.01 in chips) 
Seat 8: tedbadger9 ($74 in chips) 
Seat 9: tipner ($109.49 in chips) 
matiko09: posts small blind $0.50
sanpidk: posts big blind $1
*** HOLE CARDS ***
Dealt to matiko09 [Ts 8d]
brille-390: folds 
Venomous100%: folds 
lixiangli: folds 
Sweden_Pound: folds 
melitakas: folds 
tedbadger9: folds 
tipner: raises $1.50 to $2.50
matiko09: folds 
sanpidk: calls $1.50
*** FLOP *** [9h Jd 5c]
sanpidk: checks 
tipner: bets $3
sanpidk: folds 
Uncalled bet ($3) returned to tipner
tipner collected $5.25 from pot
tipner: doesn't show hand 
*** SUMMARY ***
Total pot $5.50 | Rake $0.25 
Board [9h Jd 5c]
Seat 1: matiko09 (small blind) folded before Flop
Seat 2: sanpidk (big blind) folded on the Flop
Seat 3: brille-390 folded before Flop (didn't bet)
Seat 4: Venomous100% folded before Flop (didn't bet)
Seat 5: lixiangli folded before Flop (didn't bet)
Seat 6: Sweden_Pound folded before Flop (didn't bet)
Seat 7: melitakas folded before Flop (didn't bet)
Seat 8: tedbadger9 folded before Flop (didn't bet)
Seat 9: tipner (button) collected ($5.25)





PokerStars Hand #148218093205:  Hold'em No Limit ($0.50/$1.00 USD) - 2016/02/04 14:54:42 CET [2016/02/04 8:54:42 ET]
Table 'Arneb III' 9-max Seat #2 is the button
Seat 1: Vikulja1993 ($100 in chips) 
Seat 2: JeanLima93 ($210.89 in chips) 
Seat 3: matiko09 ($100 in chips) 
Seat 4: Igor DoUrden ($228.81 in chips) 
Seat 5: tipner ($100 in chips) 
Seat 6: nickreason17 ($121.36 in chips) 
Seat 7: Spid1 ($100 in chips) 
Seat 8: volwebni4ek ($40 in chips) 
Seat 9: ARTVOR640 ($100 in chips) 
matiko09: posts small blind $0.50
Igor DoUrden: posts big blind $1
*** HOLE CARDS ***
Dealt to matiko09 [Ah 5s]
tipner: folds 
nickreason17: folds 
Spid1: folds 
volwebni4ek: folds 
ARTVOR640: folds 
Vikulja1993: folds 
JeanLima93: calls $1
matiko09: calls $0.50
Igor DoUrden: checks 
*** FLOP *** [4c Qh 4s]
matiko09: bets $1.48
Igor DoUrden: folds 
JeanLima93: calls $1.48
*** TURN *** [4c Qh 4s] [2d]
matiko09: checks 
JeanLima93: checks 
*** RIVER *** [4c Qh 4s 2d] [9h]
matiko09: checks 
JeanLima93: bets $5.69
matiko09: folds 
Uncalled bet ($5.69) returned to JeanLima93
JeanLima93 collected $5.69 from pot
JeanLima93: doesn't show hand 
*** SUMMARY ***
Total pot $5.96 | Rake $0.27 
Board [4c Qh 4s 2d 9h]
Seat 1: Vikulja1993 folded before Flop (didn't bet)
Seat 2: JeanLima93 (button) collected ($5.69)
Seat 3: matiko09 (small blind) folded on the River
Seat 4: Igor DoUrden (big blind) folded on the Flop
Seat 5: tipner folded before Flop (didn't bet)
Seat 6: nickreason17 folded before Flop (didn't bet)
Seat 7: Spid1 folded before Flop (didn't bet)
Seat 8: volwebni4ek folded before Flop (didn't bet)
Seat 9: ARTVOR640 folded before Flop (didn't bet)





PokerStars Hand #148218095428:  Hold'em No Limit ($0.50/$1.00 USD) - 2016/02/04 14:54:45 CET [2016/02/04 8:54:45 ET]
Table 'Alkaid II' 9-max Seat #7 is the button
Seat 1: Sweden_Pound ($117.48 in chips) 
Seat 3: 1557PSS ($40.13 in chips) 
Seat 4: sanpidk ($115.84 in chips) 
Seat 5: I The King I ($138.02 in chips) 
Seat 6: matiko09 ($100 in chips) 
Seat 7: chaps1988 ($100 in chips) 
Seat 8: yourpro ($100 in chips) 
Seat 9: tjl290 ($51.08 in chips) 
yourpro: posts small blind $0.50
tjl290: posts big blind $1
xxxZeka: sits out 
*** HOLE CARDS ***
Dealt to matiko09 [Kc 9s]
Sweden_Pound: raises $2 to $3
1557PSS: folds 
sanpidk: folds 
I The King I: folds 
matiko09: folds 
chaps1988: folds 
yourpro: raises $6 to $9
tjl290: folds 
Sweden_Pound: folds 
Uncalled bet ($6) returned to yourpro
yourpro collected $7 from pot
yourpro: doesn't show hand 
*** SUMMARY ***
Total pot $7 | Rake $0 
Seat 1: Sweden_Pound folded before Flop
Seat 3: 1557PSS folded before Flop (didn't bet)
Seat 4: sanpidk folded before Flop (didn't bet)
Seat 5: I The King I folded before Flop (didn't bet)
Seat 6: matiko09 folded before Flop (didn't bet)
Seat 7: chaps1988 (button) folded before Flop (didn't bet)
Seat 8: yourpro (small blind) collected ($7)
Seat 9: tjl290 (big blind) folded before Flop





PokerStars Hand #148218097441:  Hold'em No Limit ($0.50/$1.00 USD) - 2016/02/04 14:54:48 CET [2016/02/04 8:54:48 ET]
Table 'Siarnaq' 9-max Seat #9 is the button
Seat 1: taraisai ($98 in chips) 
Seat 2: matiko09 ($100 in chips) 
Seat 3: nickreason17 ($100 in chips) 
Seat 4: sanpidk ($101.50 in chips) 
Seat 5: Igor DoUrden ($116.76 in chips) 
Seat 6: I The King I ($100 in chips) 
Seat 7: Sesamesnap ($58.77 in chips) 
Seat 8: maxxmeister ($101.50 in chips) 
Seat 9: goblind4777 ($93.79 in chips) 
taraisai: posts small blind $0.50
matiko09: posts big blind $1
*** HOLE CARDS ***
Dealt to matiko09 [9d 4c]
nickreason17: folds 
sanpidk: folds 
Igor DoUrden: folds 
I The King I: folds 
Sesamesnap: folds 
maxxmeister: folds 
goblind4777: folds 
taraisai: raises $2 to $3
matiko09: folds 
Uncalled bet ($2) returned to taraisai
taraisai collected $2 from pot
taraisai: doesn't show hand 
*** SUMMARY ***
Total pot $2 | Rake $0 
Seat 1: taraisai (small blind) collected ($2)
Seat 2: matiko09 (big blind) folded before Flop
Seat 3: nickreason17 folded before Flop (didn't bet)
Seat 4: sanpidk folded before Flop (didn't bet)
Seat 5: Igor DoUrden folded before Flop (didn't bet)
Seat 6: I The King I folded before Flop (didn't bet)
Seat 7: Sesamesnap folded before Flop (didn't bet)
Seat 8: maxxmeister folded before Flop (didn't bet)
Seat 9: goblind4777 (button) folded before Flop (didn't bet)





PokerStars Hand #148218108817:  Hold'em No Limit ($0.50/$1.00 USD) - 2016/02/04 14:55:04 CET [2016/02/04 8:55:04 ET]
Table 'Asios III' 9-max Seat #7 is the button
Seat 1: yourpro ($100 in chips) 
Seat 3: Igor DoUrden ($107.03 in chips) 
Seat 4: TimStone ($100 in chips) 
Seat 5: ilaviiitech ($149.79 in chips) 
Seat 6: matiko09 ($121 in chips) 
Seat 7: nickreason17 ($191.46 in chips) 
Seat 9: Vikulja1993 ($159.20 in chips) 
Vikulja1993: posts small blind $0.50
yourpro: posts big blind $1
*** HOLE CARDS ***
Dealt to matiko09 [Qc 5s]
Igor DoUrden: folds 
TimStone: folds 
ilaviiitech: folds 
matiko09: folds 
nickreason17: raises $1.04 to $2.04
Vikulja1993: folds 
yourpro: raises $4.96 to $7
nickreason17: calls $4.96
*** FLOP *** [7d 5c Js]
yourpro: checks 
nickreason17: checks 
*** TURN *** [7d 5c Js] [3d]
yourpro: bets $10.94
nickreason17: calls $10.94
*** RIVER *** [7d 5c Js 3d] [9h]
yourpro: bets $23.27
nickreason17: calls $23.27
*** SHOW DOWN ***
yourpro: shows [Ah Jh] (a pair of Jacks)
nickreason17: mucks hand 
yourpro collected $80.12 from pot
*** SUMMARY ***
Total pot $82.92 | Rake $2.80 
Board [7d 5c Js 3d 9h]
Seat 1: yourpro (big blind) showed [Ah Jh] and won ($80.12) with a pair of Jacks
Seat 3: Igor DoUrden folded before Flop (didn't bet)
Seat 4: TimStone folded before Flop (didn't bet)
Seat 5: ilaviiitech folded before Flop (didn't bet)
Seat 6: matiko09 folded before Flop (didn't bet)
Seat 7: nickreason17 (button) mucked [Td Jd]
Seat 9: Vikulja1993 (small blind) folded before Flop





PokerStars Hand #148218111253:  Hold'em No Limit ($0.50/$1.00 USD) - 2016/02/04 14:55:08 CET [2016/02/04 8:55:08 ET]
Table 'Edburga II' 9-max Seat #6 is the button
Seat 1: matiko09 ($138.70 in chips) 
Seat 2: Vikulja1993 ($100 in chips) 
Seat 3: pandalapa ($107.50 in chips) 
Seat 4: geoffreyjo ($132.24 in chips) 
Seat 5: TimStone ($100 in chips) 
Seat 6: Igor DoUrden ($100 in chips) 
Seat 7: tipner ($102.44 in chips) 
Seat 8: RICKA16 ($100 in chips) 
Seat 9: nickreason17 ($132 in chips) 
tipner: posts small blind $0.50
RICKA16: posts big blind $1
*** HOLE CARDS ***
Dealt to matiko09 [4d 7c]
nickreason17: raises $2 to $3
matiko09: folds 
Vikulja1993: folds 
pandalapa: folds 
geoffreyjo: calls $3
TimStone: calls $3
Igor DoUrden: folds 
tipner: folds 
RICKA16: folds 
*** FLOP *** [5d 4h Ac]
nickreason17: bets $5
geoffreyjo: calls $5
TimStone: folds 
*** TURN *** [5d 4h Ac] [6c]
nickreason17: bets $6
geoffreyjo: calls $6
*** RIVER *** [5d 4h Ac 6c] [3s]
nickreason17: checks 
geoffreyjo: bets $23
nickreason17: folds 
Uncalled bet ($23) returned to geoffreyjo
geoffreyjo collected $31.04 from pot
geoffreyjo: doesn't show hand 
*** SUMMARY ***
Total pot $32.50 | Rake $1.46 
Board [5d 4h Ac 6c 3s]
Seat 1: matiko09 folded before Flop (didn't bet)
Seat 2: Vikulja1993 folded before Flop (didn't bet)
Seat 3: pandalapa folded before Flop (didn't bet)
Seat 4: geoffreyjo collected ($31.04)
Seat 5: TimStone folded on the Flop
Seat 6: Igor DoUrden (button) folded before Flop (didn't bet)
Seat 7: tipner (small blind) folded before Flop
Seat 8: RICKA16 (big blind) folded before Flop
Seat 9: nickreason17 folded on the River





PokerStars Hand #148218118783:  Hold'em No Limit ($0.50/$1.00 USD) - 2016/02/04 14:55:21 CET [2016/02/04 8:55:21 ET]
Table 'Alkaid II' 9-max Seat #8 is the button
Seat 2: xxxZeka ($100 in chips) 
Seat 3: 1557PSS ($40.13 in chips) 
Seat 4: sanpidk ($115.84 in chips) 
Seat 5: I The King I ($138.02 in chips) 
Seat 6: matiko09 ($100 in chips) 
Seat 7: chaps1988 ($100 in chips) 
Seat 8: yourpro ($104 in chips) 
Seat 9: tjl290 ($50.08 in chips) 
tjl290: posts small blind $0.50
Sweden_Pound: is sitting out 
xxxZeka: posts big blind $1
*** HOLE CARDS ***
Dealt to matiko09 [2h Qd]
1557PSS: folds 
sanpidk: folds 
I The King I: folds 
matiko09: folds 
chaps1988: folds 
yourpro: raises $1 to $2
tjl290: folds 
xxxZeka: raises $6 to $8
yourpro: folds 
Uncalled bet ($6) returned to xxxZeka
xxxZeka collected $4.50 from pot
*** SUMMARY ***
Total pot $4.50 | Rake $0 
Seat 2: xxxZeka (big blind) collected ($4.50)
Seat 3: 1557PSS folded before Flop (didn't bet)
Seat 4: sanpidk folded before Flop (didn't bet)
Seat 5: I The King I folded before Flop (didn't bet)
Seat 6: matiko09 folded before Flop (didn't bet)
Seat 7: chaps1988 folded before Flop (didn't bet)
Seat 8: yourpro (button) folded before Flop
Seat 9: tjl290 (small blind) folded before Flop





PokerStars Hand #148218122436:  Hold'em No Limit ($0.50/$1.00 USD) - 2016/02/04 14:55:27 CET [2016/02/04 8:55:27 ET]
Table 'Siarnaq' 9-max Seat #1 is the button
Seat 1: taraisai ($99 in chips) 
Seat 2: matiko09 ($100 in chips) 
Seat 3: nickreason17 ($100 in chips) 
Seat 4: sanpidk ($101.50 in chips) 
Seat 5: Igor DoUrden ($116.76 in chips) 
Seat 6: I The King I ($100 in chips) 
Seat 7: Sesamesnap ($58.77 in chips) 
Seat 8: maxxmeister ($101.50 in chips) 
Seat 9: goblind4777 ($93.79 in chips) 
matiko09: posts small blind $0.50
nickreason17: posts big blind $1
*** HOLE CARDS ***
Dealt to matiko09 [5h Th]
sanpidk: folds 
Igor DoUrden: folds 
I The King I: folds 
Sesamesnap: raises $3 to $4
maxxmeister: folds 
goblind4777: folds 
taraisai: folds 
matiko09: folds 
nickreason17: folds 
Uncalled bet ($3) returned to Sesamesnap
Sesamesnap collected $2.50 from pot
Sesamesnap: doesn't show hand 
*** SUMMARY ***
Total pot $2.50 | Rake $0 
Seat 1: taraisai (button) folded before Flop (didn't bet)
Seat 2: matiko09 (small blind) folded before Flop
Seat 3: nickreason17 (big blind) folded before Flop
Seat 4: sanpidk folded before Flop (didn't bet)
Seat 5: Igor DoUrden folded before Flop (didn't bet)
Seat 6: I The King I folded before Flop (didn't bet)
Seat 7: Sesamesnap collected ($2.50)
Seat 8: maxxmeister folded before Flop (didn't bet)
Seat 9: goblind4777 folded before Flop (didn't bet)





PokerStars Hand #148218127087:  Hold'em No Limit ($0.50/$1.00 USD) - 2016/02/04 14:55:35 CET [2016/02/04 8:55:35 ET]
Table 'Arneb II' 9-max Seat #1 is the button
Seat 1: matiko09 ($100 in chips) 
Seat 2: sanpidk ($198.70 in chips) 
Seat 3: brille-390 ($101.50 in chips) 
Seat 4: Venomous100% ($119.14 in chips) 
Seat 5: lixiangli ($81.52 in chips) 
Seat 6: Sweden_Pound ($141.50 in chips) 
Seat 7: melitakas ($262.01 in chips) 
Seat 8: tedbadger9 ($74 in chips) 
Seat 9: tipner ($112.24 in chips) 
sanpidk: posts small blind $0.50
brille-390: posts big blind $1
*** HOLE CARDS ***
Dealt to matiko09 [8s 5h]
Venomous100%: folds 
lixiangli: raises $1.50 to $2.50
Sweden_Pound: folds 
melitakas: folds 
tedbadger9: folds 
tipner: folds 
matiko09: folds 
sanpidk: folds 
brille-390: folds 
Uncalled bet ($1.50) returned to lixiangli
lixiangli collected $2.50 from pot
lixiangli: doesn't show hand 
*** SUMMARY ***
Total pot $2.50 | Rake $0 
Seat 1: matiko09 (button) folded before Flop (didn't bet)
Seat 2: sanpidk (small blind) folded before Flop
Seat 3: brille-390 (big blind) folded before Flop
Seat 4: Venomous100% folded before Flop (didn't bet)
Seat 5: lixiangli collected ($2.50)
Seat 6: Sweden_Pound folded before Flop (didn't bet)
Seat 7: melitakas folded before Flop (didn't bet)
Seat 8: tedbadger9 folded before Flop (didn't bet)
Seat 9: tipner folded before Flop (didn't bet)





PokerStars Hand #148218135443:  Hold'em No Limit ($0.50/$1.00 USD) - 2016/02/04 14:55:49 CET [2016/02/04 8:55:49 ET]
Table 'Sargas' 9-max Seat #9 is the button
Seat 2: chaps1988 ($163.54 in chips) 
Seat 3: sanpidk ($110.69 in chips) 
Seat 4: nickreason17 ($175.93 in chips) 
Seat 5: matiko09 ($100 in chips) 
Seat 6: buttonlife ($45 in chips) 
Seat 7: DENG1118 ($98.50 in chips) 
Seat 8: ozone2003 ($100 in chips) 
Seat 9: tompi-tomp ($57.24 in chips) 
chaps1988: posts small blind $0.50
sanpidk: posts big blind $1
*** HOLE CARDS ***
Dealt to matiko09 [7d Jh]
nickreason17: raises $2 to $3
matiko09: folds 
buttonlife: folds 
DENG1118: calls $3
ozone2003: calls $3
tompi-tomp: folds 
chaps1988: folds 
sanpidk: folds 
*** FLOP *** [As 6c Qs]
nickreason17: checks 
DENG1118: checks 
ozone2003: bets $8.50
nickreason17: folds 
DENG1118: folds 
Uncalled bet ($8.50) returned to ozone2003
ozone2003 collected $10.03 from pot
ozone2003: doesn't show hand 
*** SUMMARY ***
Total pot $10.50 | Rake $0.47 
Board [As 6c Qs]
Seat 2: chaps1988 (small blind) folded before Flop
Seat 3: sanpidk (big blind) folded before Flop
Seat 4: nickreason17 folded on the Flop
Seat 5: matiko09 folded before Flop (didn't bet)
Seat 6: buttonlife folded before Flop (didn't bet)
Seat 7: DENG1118 folded on the Flop
Seat 8: ozone2003 collected ($10.03)
Seat 9: tompi-tomp (button) folded before Flop (didn't bet)





PokerStars Hand #148218141541:  Hold'em No Limit ($0.50/$1.00 USD) - 2016/02/04 14:56:00 CET [2016/02/04 8:56:00 ET]
Table 'Siarnaq' 9-max Seat #2 is the button
Seat 1: taraisai ($99 in chips) 
Seat 2: matiko09 ($100 in chips) 
Seat 3: nickreason17 ($100 in chips) 
Seat 4: sanpidk ($101.50 in chips) 
Seat 5: Igor DoUrden ($116.76 in chips) 
Seat 6: I The King I ($100 in chips) 
Seat 7: Sesamesnap ($60.27 in chips) 
Seat 8: maxxmeister ($101.50 in chips) 
Seat 9: goblind4777 ($93.79 in chips) 
nickreason17: posts small blind $0.50
sanpidk: posts big blind $1
*** HOLE CARDS ***
Dealt to matiko09 [Qd 3d]
Igor DoUrden: folds 
I The King I: raises $2 to $3
Sesamesnap: folds 
maxxmeister: folds 
goblind4777: calls $3
taraisai: calls $3
matiko09: folds 
nickreason17: calls $2.50
sanpidk: folds 
*** FLOP *** [Th 5c Kc]
nickreason17: checks 
I The King I: checks 
goblind4777: checks 
taraisai: bets $6.21
nickreason17: folds 
I The King I: folds 
goblind4777: calls $6.21
*** TURN *** [Th 5c Kc] [3s]
goblind4777: checks 
taraisai: checks 
*** RIVER *** [Th 5c Kc 3s] [3h]
goblind4777: checks 
taraisai: checks 
*** SHOW DOWN ***
goblind4777: shows [Ah Qh] (a pair of Threes)
taraisai: shows [9d 9c] (two pair, Nines and Threes)
taraisai collected $24.28 from pot
*** SUMMARY ***
Total pot $25.42 | Rake $1.14 
Board [Th 5c Kc 3s 3h]
Seat 1: taraisai showed [9d 9c] and won ($24.28) with two pair, Nines and Threes
Seat 2: matiko09 (button) folded before Flop (didn't bet)
Seat 3: nickreason17 (small blind) folded on the Flop
Seat 4: sanpidk (big blind) folded before Flop
Seat 5: Igor DoUrden folded before Flop (didn't bet)
Seat 6: I The King I folded on the Flop
Seat 7: Sesamesnap folded before Flop (didn't bet)
Seat 8: maxxmeister folded before Flop (didn't bet)
Seat 9: goblind4777 showed [Ah Qh] and lost with a pair of Threes





PokerStars Hand #148218146190:  Hold'em No Limit ($0.50/$1.00 USD) - 2016/02/04 14:56:07 CET [2016/02/04 8:56:07 ET]
Table 'Alkaid II' 9-max Seat #9 is the button
Seat 2: xxxZeka ($102.50 in chips) 
Seat 3: 1557PSS ($40.13 in chips) 
Seat 4: sanpidk ($115.84 in chips) 
Seat 5: I The King I ($138.02 in chips) 
Seat 6: matiko09 ($100 in chips) 
Seat 7: chaps1988 ($100 in chips) 
Seat 8: yourpro ($102 in chips) 
Seat 9: tjl290 ($49.58 in chips) 
xxxZeka: posts small blind $0.50
1557PSS: posts big blind $1
*** HOLE CARDS ***
Dealt to matiko09 [5d 6s]
sanpidk: folds 
I The King I: folds 
matiko09: folds 
chaps1988: folds 
yourpro: folds 
tjl290: folds 
xxxZeka: raises $1.50 to $2.50
1557PSS: calls $1.50
*** FLOP *** [4c Jh Kh]
xxxZeka: checks 
1557PSS: checks 
*** TURN *** [4c Jh Kh] [Jd]
xxxZeka: bets $3.18
1557PSS: folds 
Uncalled bet ($3.18) returned to xxxZeka
xxxZeka collected $4.78 from pot
*** SUMMARY ***
Total pot $5 | Rake $0.22 
Board [4c Jh Kh Jd]
Seat 2: xxxZeka (small blind) collected ($4.78)
Seat 3: 1557PSS (big blind) folded on the Turn
Seat 4: sanpidk folded before Flop (didn't bet)
Seat 5: I The King I folded before Flop (didn't bet)
Seat 6: matiko09 folded before Flop (didn't bet)
Seat 7: chaps1988 folded before Flop (didn't bet)
Seat 8: yourpro folded before Flop (didn't bet)
Seat 9: tjl290 (button) folded before Flop (didn't bet)





PokerStars Hand #148218151504:  Hold'em No Limit ($0.50/$1.00 USD) - 2016/02/04 14:56:16 CET [2016/02/04 8:56:16 ET]
Table 'Arneb III' 9-max Seat #3 is the button
Seat 1: Vikulja1993 ($100 in chips) 
Seat 2: JeanLima93 ($214.10 in chips) 
Seat 3: matiko09 ($100 in chips) 
Seat 4: Igor DoUrden ($227.81 in chips) 
Seat 5: tipner ($100 in chips) 
Seat 6: nickreason17 ($121.36 in chips) 
Seat 7: Spid1 ($100 in chips) 
Seat 8: volwebni4ek ($40 in chips) 
Seat 9: ARTVOR640 ($100 in chips) 
Igor DoUrden: posts small blind $0.50
tipner: posts big blind $1
*** HOLE CARDS ***
Dealt to matiko09 [Qh 8c]
nickreason17: folds 
Spid1: folds 
volwebni4ek: raises $2 to $3
ARTVOR640: folds 
Vikulja1993: folds 
JeanLima93: folds 
matiko09: folds 
Igor DoUrden: folds 
tipner: folds 
Uncalled bet ($2) returned to volwebni4ek
volwebni4ek collected $2.50 from pot
volwebni4ek: doesn't show hand 
*** SUMMARY ***
Total pot $2.50 | Rake $0 
Seat 1: Vikulja1993 folded before Flop (didn't bet)
Seat 2: JeanLima93 folded before Flop (didn't bet)
Seat 3: matiko09 (button) folded before Flop (didn't bet)
Seat 4: Igor DoUrden (small blind) folded before Flop
Seat 5: tipner (big blind) folded before Flop
Seat 6: nickreason17 folded before Flop (didn't bet)
Seat 7: Spid1 folded before Flop (didn't bet)
Seat 8: volwebni4ek collected ($2.50)
Seat 9: ARTVOR640 folded before Flop (didn't bet)





PokerStars Hand #148218160218:  Hold'em No Limit ($0.50/$1.00 USD) - 2016/02/04 14:56:31 CET [2016/02/04 8:56:31 ET]
Table 'Arneb II' 9-max Seat #2 is the button
Seat 1: matiko09 ($100 in chips) 
Seat 2: sanpidk ($198.20 in chips) 
Seat 3: brille-390 ($100.50 in chips) 
Seat 4: Venomous100% ($119.14 in chips) 
Seat 5: lixiangli ($83.02 in chips) 
Seat 6: Sweden_Pound ($141.50 in chips) 
Seat 7: melitakas ($262.01 in chips) 
Seat 8: tedbadger9 ($74 in chips) 
Seat 9: tipner ($112.24 in chips) 
brille-390: posts small blind $0.50
Venomous100%: posts big blind $1
*** HOLE CARDS ***
Dealt to matiko09 [8d Ah]
lixiangli: folds 
Sweden_Pound: folds 
melitakas: raises $1 to $2
tedbadger9: folds 
tipner: folds 
matiko09: folds 
sanpidk: folds 
brille-390: folds 
Venomous100%: folds 
Uncalled bet ($1) returned to melitakas
melitakas collected $2.50 from pot
*** SUMMARY ***
Total pot $2.50 | Rake $0 
Seat 1: matiko09 folded before Flop (didn't bet)
Seat 2: sanpidk (button) folded before Flop (didn't bet)
Seat 3: brille-390 (small blind) folded before Flop
Seat 4: Venomous100% (big blind) folded before Flop
Seat 5: lixiangli folded before Flop (didn't bet)
Seat 6: Sweden_Pound folded before Flop (didn't bet)
Seat 7: melitakas collected ($2.50)
Seat 8: tedbadger9 folded before Flop (didn't bet)
Seat 9: tipner folded before Flop (didn't bet)





PokerStars Hand #148218164489:  Hold'em No Limit ($0.50/$1.00 USD) - 2016/02/04 14:56:38 CET [2016/02/04 8:56:38 ET]
Table 'Edburga II' 9-max Seat #7 is the button
Seat 1: matiko09 ($138.70 in chips) 
Seat 2: Vikulja1993 ($100 in chips) 
Seat 3: pandalapa ($107.50 in chips) 
Seat 4: geoffreyjo ($149.28 in chips) 
Seat 5: TimStone ($100 in chips) 
Seat 6: Igor DoUrden ($100 in chips) 
Seat 7: tipner ($101.94 in chips) 
Seat 8: RICKA16 ($99 in chips) 
Seat 9: nickreason17 ($118 in chips) 
RICKA16: posts small blind $0.50
nickreason17: posts big blind $1
*** HOLE CARDS ***
Dealt to matiko09 [7c Jh]
matiko09: folds 
Vikulja1993 has timed out
Vikulja1993: folds 
pandalapa: folds 
geoffreyjo: raises $2 to $3
TimStone: folds 
Igor DoUrden: folds 
tipner: folds 
RICKA16: folds 
nickreason17: folds 
Uncalled bet ($2) returned to geoffreyjo
geoffreyjo collected $2.50 from pot
geoffreyjo: doesn't show hand 
*** SUMMARY ***
Total pot $2.50 | Rake $0 
Seat 1: matiko09 folded before Flop (didn't bet)
Seat 2: Vikulja1993 folded before Flop (didn't bet)
Seat 3: pandalapa folded before Flop (didn't bet)
Seat 4: geoffreyjo collected ($2.50)
Seat 5: TimStone folded before Flop (didn't bet)
Seat 6: Igor DoUrden folded before Flop (didn't bet)
Seat 7: tipner (button) folded before Flop (didn't bet)
Seat 8: RICKA16 (small blind) folded before Flop
Seat 9: nickreason17 (big blind) folded before Flop





PokerStars Hand #148218166321:  Hold'em No Limit ($0.50/$1.00 USD) - 2016/02/04 14:56:41 CET [2016/02/04 8:56:41 ET]
Table 'Asios III' 9-max Seat #9 is the button
Seat 1: yourpro ($138.91 in chips) 
Seat 2: crime8783 ($43.75 in chips) 
Seat 3: Igor DoUrden ($107.03 in chips) 
Seat 4: TimStone ($100 in chips) 
Seat 5: ilaviiitech ($149.79 in chips) 
Seat 6: matiko09 ($121 in chips) 
Seat 7: nickreason17 ($150.25 in chips) 
Seat 9: Vikulja1993 ($158.70 in chips) 
yourpro: posts small blind $0.50
crime8783: posts big blind $1
*** HOLE CARDS ***
Dealt to matiko09 [2c 8c]
Igor DoUrden: folds 
TimStone: raises $2.01 to $3.01
ilaviiitech: folds 
matiko09: folds 
nickreason17: folds 
Vikulja1993 has timed out
Vikulja1993: folds 
yourpro: folds 
crime8783: folds 
Uncalled bet ($2.01) returned to TimStone
TimStone collected $2.50 from pot
TimStone: doesn't show hand 
*** SUMMARY ***
Total pot $2.50 | Rake $0 
Seat 1: yourpro (small blind) folded before Flop
Seat 2: crime8783 (big blind) folded before Flop
Seat 3: Igor DoUrden folded before Flop (didn't bet)
Seat 4: TimStone collected ($2.50)
Seat 5: ilaviiitech folded before Flop (didn't bet)
Seat 6: matiko09 folded before Flop (didn't bet)
Seat 7: nickreason17 folded before Flop (didn't bet)
Seat 9: Vikulja1993 (button) folded before Flop (didn't bet)





PokerStars Hand #148218167905:  Hold'em No Limit ($0.50/$1.00 USD) - 2016/02/04 14:56:44 CET [2016/02/04 8:56:44 ET]
Table 'Sargas' 9-max Seat #2 is the button
Seat 2: chaps1988 ($163.04 in chips) 
Seat 3: sanpidk ($109.69 in chips) 
Seat 5: matiko09 ($100 in chips) 
Seat 6: buttonlife ($45 in chips) 
Seat 7: DENG1118 ($95.50 in chips) 
Seat 8: ozone2003 ($107.03 in chips) 
Seat 9: tompi-tomp ($57.24 in chips) 
sanpidk: posts small blind $0.50
nickreason17: is sitting out 
matiko09: posts big blind $1
*** HOLE CARDS ***
Dealt to matiko09 [8c 4d]
nickreason17 leaves the table
buttonlife: folds 
yourpro joins the table at seat #4 
DENG1118: folds 
ozone2003: folds 
tompi-tomp: folds 
chaps1988: folds 
sanpidk: folds 
Uncalled bet ($0.50) returned to matiko09
matiko09 collected $1 from pot
matiko09: doesn't show hand 
*** SUMMARY ***
Total pot $1 | Rake $0 
Seat 2: chaps1988 (button) folded before Flop (didn't bet)
Seat 3: sanpidk (small blind) folded before Flop
Seat 5: matiko09 (big blind) collected ($1)
Seat 6: buttonlife folded before Flop (didn't bet)
Seat 7: DENG1118 folded before Flop (didn't bet)
Seat 8: ozone2003 folded before Flop (didn't bet)
Seat 9: tompi-tomp folded before Flop (didn't bet)





PokerStars Hand #148218175734:  Hold'em No Limit ($0.50/$1.00 USD) - 2016/02/04 14:56:57 CET [2016/02/04 8:56:57 ET]
Table 'Arneb II' 9-max Seat #3 is the button
Seat 1: matiko09 ($100 in chips) 
Seat 2: sanpidk ($198.20 in chips) 
Seat 3: brille-390 ($100 in chips) 
Seat 4: Venomous100% ($118.14 in chips) 
Seat 5: lixiangli ($83.02 in chips) 
Seat 7: melitakas ($263.51 in chips) 
Seat 8: tedbadger9 ($74 in chips) 
Seat 9: tipner ($112.24 in chips) 
Venomous100%: posts small blind $0.50
lixiangli: posts big blind $1
*** HOLE CARDS ***
Dealt to matiko09 [Kd As]
melitakas: folds 
tedbadger9: folds 
tipner: folds 
matiko09: raises $2 to $3
sanpidk: folds 
brille-390: folds 
Venomous100%: folds 
lixiangli: folds 
Uncalled bet ($2) returned to matiko09
matiko09 collected $2.50 from pot
matiko09: doesn't show hand 
*** SUMMARY ***
Total pot $2.50 | Rake $0 
Seat 1: matiko09 collected ($2.50)
Seat 2: sanpidk folded before Flop (didn't bet)
Seat 3: brille-390 (button) folded before Flop (didn't bet)
Seat 4: Venomous100% (small blind) folded before Flop
Seat 5: lixiangli (big blind) folded before Flop
Seat 7: melitakas folded before Flop (didn't bet)
Seat 8: tedbadger9 folded before Flop (didn't bet)
Seat 9: tipner folded before Flop (didn't bet)





PokerStars Hand #148218180448:  Hold'em No Limit ($0.50/$1.00 USD) - 2016/02/04 14:57:05 CET [2016/02/04 8:57:05 ET]
Table 'Sargas' 9-max Seat #3 is the button
Seat 2: chaps1988 ($163.04 in chips) 
Seat 3: sanpidk ($109.19 in chips) 
Seat 5: matiko09 ($100.50 in chips) 
Seat 6: buttonlife ($45 in chips) 
Seat 7: DENG1118 ($95.50 in chips) 
Seat 8: ozone2003 ($107.03 in chips) 
Seat 9: tompi-tomp ($57.24 in chips) 
yourpro will be allowed to play after the button
matiko09: posts small blind $0.50
buttonlife: posts big blind $1
*** HOLE CARDS ***
Dealt to matiko09 [6c Jc]
DENG1118: folds 
ozone2003: folds 
tompi-tomp: raises $2 to $3
chaps1988: folds 
sanpidk: folds 
matiko09: folds 
buttonlife: raises $7 to $10
tompi-tomp: calls $7
*** FLOP *** [Js 2d 9d]
buttonlife: bets $11.74
tompi-tomp: calls $11.74
*** TURN *** [Js 2d 9d] [3s]
buttonlife: bets $23.26 and is all-in
tompi-tomp: calls $23.26
*** RIVER *** [Js 2d 9d 3s] [Ah]
*** SHOW DOWN ***
buttonlife: shows [As Ks] (a pair of Aces)
tompi-tomp: shows [Kh Jd] (a pair of Jacks)
buttonlife collected $87.70 from pot
*** SUMMARY ***
Total pot $90.50 | Rake $2.80 
Board [Js 2d 9d 3s Ah]
Seat 2: chaps1988 folded before Flop (didn't bet)
Seat 3: sanpidk (button) folded before Flop (didn't bet)
Seat 5: matiko09 (small blind) folded before Flop
Seat 6: buttonlife (big blind) showed [As Ks] and won ($87.70) with a pair of Aces
Seat 7: DENG1118 folded before Flop (didn't bet)
Seat 8: ozone2003 folded before Flop (didn't bet)
Seat 9: tompi-tomp showed [Kh Jd] and lost with a pair of Jacks





PokerStars Hand #148218181125:  Hold'em No Limit ($0.50/$1.00 USD) - 2016/02/04 14:57:06 CET [2016/02/04 8:57:06 ET]
Table 'Arneb III' 9-max Seat #4 is the button
Seat 1: Vikulja1993 ($100 in chips) 
Seat 2: JeanLima93 ($214.10 in chips) 
Seat 3: matiko09 ($100 in chips) 
Seat 4: Igor DoUrden ($227.31 in chips) 
Seat 5: tipner ($100 in chips) 
Seat 6: nickreason17 ($121.36 in chips) 
Seat 7: Spid1 ($100 in chips) 
Seat 8: volwebni4ek ($41.50 in chips) 
Seat 9: ARTVOR640 ($100 in chips) 
tipner: posts small blind $0.50
nickreason17: posts big blind $1
*** HOLE CARDS ***
Dealt to matiko09 [Kc 4d]
Spid1: folds 
volwebni4ek: folds 
ARTVOR640: folds 
Vikulja1993: folds 
JeanLima93: folds 
matiko09: folds 
Igor DoUrden: raises $1.09 to $2.09
tipner: folds 
nickreason17: folds 
Uncalled bet ($1.09) returned to Igor DoUrden
Igor DoUrden collected $2.50 from pot
Igor DoUrden: doesn't show hand 
*** SUMMARY ***
Total pot $2.50 | Rake $0 
Seat 1: Vikulja1993 folded before Flop (didn't bet)
Seat 2: JeanLima93 folded before Flop (didn't bet)
Seat 3: matiko09 folded before Flop (didn't bet)
Seat 4: Igor DoUrden (button) collected ($2.50)
Seat 5: tipner (small blind) folded before Flop
Seat 6: nickreason17 (big blind) folded before Flop
Seat 7: Spid1 folded before Flop (didn't bet)
Seat 8: volwebni4ek folded before Flop (didn't bet)
Seat 9: ARTVOR640 folded before Flop (didn't bet)





PokerStars Hand #148218183612:  Hold'em No Limit ($0.50/$1.00 USD) - 2016/02/04 14:57:11 CET [2016/02/04 8:57:11 ET]
Table 'Alkaid II' 9-max Seat #2 is the button
Seat 2: xxxZeka ($104.78 in chips) 
Seat 3: 1557PSS ($37.63 in chips) 
Seat 4: sanpidk ($115.84 in chips) 
Seat 5: I The King I ($138.02 in chips) 
Seat 6: matiko09 ($100 in chips) 
Seat 7: chaps1988 ($100 in chips) 
Seat 8: yourpro ($102 in chips) 
Seat 9: tjl290 ($49.58 in chips) 
1557PSS: posts small blind $0.50
sanpidk: posts big blind $1
*** HOLE CARDS ***
Dealt to matiko09 [Qh 8s]
I The King I: raises $2 to $3
matiko09: folds 
chaps1988: folds 
chaps1988 leaves the table
yourpro: folds 
tjl290: folds 
xxxZeka: folds 
1557PSS: folds 
tipner joins the table at seat #7 
sanpidk: folds 
Uncalled bet ($2) returned to I The King I
I The King I collected $2.50 from pot
I The King I: doesn't show hand 
*** SUMMARY ***
Total pot $2.50 | Rake $0 
Seat 2: xxxZeka (button) folded before Flop (didn't bet)
Seat 3: 1557PSS (small blind) folded before Flop
Seat 4: sanpidk (big blind) folded before Flop
Seat 5: I The King I collected ($2.50)
Seat 6: matiko09 folded before Flop (didn't bet)
Seat 7: chaps1988 folded before Flop (didn't bet)
Seat 8: yourpro folded before Flop (didn't bet)
Seat 9: tjl290 folded before Flop (didn't bet)





PokerStars Hand #148218188645:  Hold'em No Limit ($0.50/$1.00 USD) - 2016/02/04 14:57:19 CET [2016/02/04 8:57:19 ET]
Table 'Arneb II' 9-max Seat #4 is the button
Seat 1: matiko09 ($101.50 in chips) 
Seat 2: sanpidk ($198.20 in chips) 
Seat 3: brille-390 ($100 in chips) 
Seat 4: Venomous100% ($117.64 in chips) 
Seat 5: lixiangli ($82.02 in chips) 
Seat 7: melitakas ($263.51 in chips) 
Seat 8: tedbadger9 ($74 in chips) 
Seat 9: tipner ($112.24 in chips) 
lixiangli: posts small blind $0.50
melitakas: posts big blind $1
*** HOLE CARDS ***
Dealt to matiko09 [2c Kc]
tedbadger9: raises $2 to $3
tipner: folds 
matiko09: folds 
sanpidk: folds 
brille-390: folds 
Venomous100%: folds 
lixiangli: folds 
melitakas: folds 
Uncalled bet ($2) returned to tedbadger9
tedbadger9 collected $2.50 from pot
*** SUMMARY ***
Total pot $2.50 | Rake $0 
Seat 1: matiko09 folded before Flop (didn't bet)
Seat 2: sanpidk folded before Flop (didn't bet)
Seat 3: brille-390 folded before Flop (didn't bet)
Seat 4: Venomous100% (button) folded before Flop (didn't bet)
Seat 5: lixiangli (small blind) folded before Flop
Seat 7: melitakas (big blind) folded before Flop
Seat 8: tedbadger9 collected ($2.50)
Seat 9: tipner folded before Flop (didn't bet)





PokerStars Hand #148218188367:  Hold'em No Limit ($0.50/$1.00 USD) - 2016/02/04 14:57:19 CET [2016/02/04 8:57:19 ET]
Table 'Siarnaq' 9-max Seat #3 is the button
Seat 1: taraisai ($114.07 in chips) 
Seat 2: matiko09 ($100 in chips) 
Seat 3: nickreason17 ($100 in chips) 
Seat 4: sanpidk ($100.50 in chips) 
Seat 5: Igor DoUrden ($116.76 in chips) 
Seat 6: I The King I ($100 in chips) 
Seat 7: Sesamesnap ($60.27 in chips) 
Seat 8: maxxmeister ($101.50 in chips) 
Seat 9: goblind4777 ($84.58 in chips) 
sanpidk: posts small blind $0.50
Igor DoUrden: posts big blind $1
*** HOLE CARDS ***
Dealt to matiko09 [8c 9d]
I The King I: folds 
Sesamesnap: folds 
maxxmeister: raises $2.50 to $3.50
goblind4777: calls $3.50
taraisai: folds 
matiko09: folds 
nickreason17: folds 
sanpidk: folds 
Igor DoUrden: folds 
*** FLOP *** [9c 7h 2s]
maxxmeister: bets $4.75
goblind4777: calls $4.75
*** TURN *** [9c 7h 2s] [3s]
maxxmeister: checks 
goblind4777: bets $9.66
maxxmeister: folds 
Uncalled bet ($9.66) returned to goblind4777
goblind4777 collected $17.19 from pot
goblind4777: doesn't show hand 
*** SUMMARY ***
Total pot $18 | Rake $0.81 
Board [9c 7h 2s 3s]
Seat 1: taraisai folded before Flop (didn't bet)
Seat 2: matiko09 folded before Flop (didn't bet)
Seat 3: nickreason17 (button) folded before Flop (didn't bet)
Seat 4: sanpidk (small blind) folded before Flop
Seat 5: Igor DoUrden (big blind) folded before Flop
Seat 6: I The King I folded before Flop (didn't bet)
Seat 7: Sesamesnap folded before Flop (didn't bet)
Seat 8: maxxmeister folded on the Turn
Seat 9: goblind4777 collected ($17.19)





PokerStars Hand #148218204030:  Hold'em No Limit ($0.50/$1.00 USD) - 2016/02/04 14:57:45 CET [2016/02/04 8:57:45 ET]
Table 'Alkaid II' 9-max Seat #3 is the button
Seat 2: xxxZeka ($104.78 in chips) 
Seat 3: 1557PSS ($37.13 in chips) 
Seat 4: sanpidk ($114.84 in chips) 
Seat 5: I The King I ($139.52 in chips) 
Seat 6: matiko09 ($100 in chips) 
Seat 8: yourpro ($102 in chips) 
Seat 9: tjl290 ($49.58 in chips) 
sanpidk: posts small blind $0.50
I The King I: posts big blind $1
tipner: sits out 
*** HOLE CARDS ***
Dealt to matiko09 [2d 2h]
matiko09: folds 
yourpro: folds 
tjl290: folds 
xxxZeka: raises $2 to $3
1557PSS: folds 
sanpidk: folds 
I The King I: folds 
Uncalled bet ($2) returned to xxxZeka
xxxZeka collected $2.50 from pot
*** SUMMARY ***
Total pot $2.50 | Rake $0 
Seat 2: xxxZeka collected ($2.50)
Seat 3: 1557PSS (button) folded before Flop (didn't bet)
Seat 4: sanpidk (small blind) folded before Flop
Seat 5: I The King I (big blind) folded before Flop
Seat 6: matiko09 folded before Flop (didn't bet)
Seat 8: yourpro folded before Flop (didn't bet)
Seat 9: tjl290 folded before Flop (didn't bet)





PokerStars Hand #148218205102:  Hold'em No Limit ($0.50/$1.00 USD) - 2016/02/04 14:57:47 CET [2016/02/04 8:57:47 ET]
Table 'Asios III' 9-max Seat #1 is the button
Seat 1: yourpro ($138.41 in chips) 
Seat 2: crime8783 ($42.75 in chips) 
Seat 3: Igor DoUrden ($107.03 in chips) 
Seat 4: TimStone ($101.50 in chips) 
Seat 5: ilaviiitech ($149.79 in chips) 
Seat 6: matiko09 ($121 in chips) 
Seat 7: nickreason17 ($150.25 in chips) 
Seat 9: Vikulja1993 ($158.70 in chips) 
crime8783: posts small blind $0.50
Igor DoUrden: posts big blind $1
*** HOLE CARDS ***
Dealt to matiko09 [6h 4c]
TimStone: folds 
ilaviiitech: folds 
matiko09: folds 
nickreason17: folds 
Vikulja1993: folds 
yourpro: folds 
crime8783: calls $0.50
Igor DoUrden: checks 
*** FLOP *** [6c Ad 4s]
crime8783: checks 
Igor DoUrden: checks 
*** TURN *** [6c Ad 4s] [Ah]
crime8783: bets $4
Igor DoUrden: folds 
Uncalled bet ($4) returned to crime8783
crime8783 collected $1.91 from pot
crime8783: doesn't show hand 
*** SUMMARY ***
Total pot $2 | Rake $0.09 
Board [6c Ad 4s Ah]
Seat 1: yourpro (button) folded before Flop (didn't bet)
Seat 2: crime8783 (small blind) collected ($1.91)
Seat 3: Igor DoUrden (big blind) folded on the Turn
Seat 4: TimStone folded before Flop (didn't bet)
Seat 5: ilaviiitech folded before Flop (didn't bet)
Seat 6: matiko09 folded before Flop (didn't bet)
Seat 7: nickreason17 folded before Flop (didn't bet)
Seat 9: Vikulja1993 folded before Flop (didn't bet)





PokerStars Hand #148218207146:  Hold'em No Limit ($0.50/$1.00 USD) - 2016/02/04 14:57:50 CET [2016/02/04 8:57:50 ET]
Table 'Sargas' 9-max Seat #5 is the button
Seat 2: chaps1988 ($163.04 in chips) 
Seat 3: sanpidk ($109.19 in chips) 
Seat 5: matiko09 ($100 in chips) 
Seat 6: buttonlife ($87.70 in chips) 
Seat 7: DENG1118 ($95.50 in chips) 
Seat 8: ozone2003 ($107.03 in chips) 
Seat 9: tompi-tomp ($12.24 in chips) 
buttonlife: posts small blind $0.50
DENG1118: posts big blind $1
yourpro: sits out 
*** HOLE CARDS ***
Dealt to matiko09 [3d 6h]
ozone2003: folds 
tompi-tomp: folds 
chaps1988: raises $1.50 to $2.50
sanpidk: raises $5.50 to $8
matiko09: folds 
buttonlife: folds 
DENG1118: folds 
tompi-tomp leaves the table
chaps1988: folds 
Uncalled bet ($5.50) returned to sanpidk
sanpidk collected $6.50 from pot
*** SUMMARY ***
Total pot $6.50 | Rake $0 
Seat 2: chaps1988 folded before Flop
Seat 3: sanpidk collected ($6.50)
Seat 5: matiko09 (button) folded before Flop (didn't bet)
Seat 6: buttonlife (small blind) folded before Flop
Seat 7: DENG1118 (big blind) folded before Flop
Seat 8: ozone2003 folded before Flop (didn't bet)
Seat 9: tompi-tomp folded before Flop (didn't bet)





PokerStars Hand #148218209022:  Hold'em No Limit ($0.50/$1.00 USD) - 2016/02/04 14:57:53 CET [2016/02/04 8:57:53 ET]
Table 'Arneb II' 9-max Seat #5 is the button
Seat 1: matiko09 ($101.50 in chips) 
Seat 2: sanpidk ($198.20 in chips) 
Seat 3: brille-390 ($100 in chips) 
Seat 4: Venomous100% ($117.64 in chips) 
Seat 5: lixiangli ($81.52 in chips) 
Seat 7: melitakas ($262.51 in chips) 
Seat 8: tedbadger9 ($75.50 in chips) 
Seat 9: tipner ($112.24 in chips) 
melitakas: posts small blind $0.50
tedbadger9: posts big blind $1
*** HOLE CARDS ***
Dealt to matiko09 [7c 3d]
tipner: folds 
matiko09: folds 
sanpidk: raises $2 to $3
brille-390: folds 
Venomous100%: folds 
lixiangli: folds 
melitakas: folds 
tedbadger9: folds 
Uncalled bet ($2) returned to sanpidk
sanpidk collected $2.50 from pot
*** SUMMARY ***
Total pot $2.50 | Rake $0 
Seat 1: matiko09 folded before Flop (didn't bet)
Seat 2: sanpidk collected ($2.50)
Seat 3: brille-390 folded before Flop (didn't bet)
Seat 4: Venomous100% folded before Flop (didn't bet)
Seat 5: lixiangli (button) folded before Flop (didn't bet)
Seat 7: melitakas (small blind) folded before Flop
Seat 8: tedbadger9 (big blind) folded before Flop
Seat 9: tipner folded before Flop (didn't bet)





PokerStars Hand #148218220326:  Hold'em No Limit ($0.50/$1.00 USD) - 2016/02/04 14:58:05 CET [2016/02/04 8:58:05 ET]
Table 'Edburga II' 9-max Seat #8 is the button
Seat 1: matiko09 ($138.70 in chips) 
Seat 2: Vikulja1993 ($100 in chips) 
Seat 3: pandalapa ($107.50 in chips) 
Seat 4: geoffreyjo ($150.78 in chips) 
Seat 5: TimStone ($100 in chips) 
Seat 6: Igor DoUrden ($100 in chips) 
Seat 7: tipner ($101.94 in chips) 
Seat 8: RICKA16 ($98.50 in chips) 
Seat 9: nickreason17 ($117 in chips) 
nickreason17: posts small blind $0.50
matiko09: posts big blind $1
*** HOLE CARDS ***
Dealt to matiko09 [Qh Ks]
Vikulja1993: folds 
pandalapa: folds 
geoffreyjo: folds 
TimStone: folds 
Igor DoUrden: raises $1.50 to $2.50
tipner: folds 
RICKA16: folds 
nickreason17: folds 
matiko09: folds 
Uncalled bet ($1.50) returned to Igor DoUrden
Igor DoUrden collected $2.50 from pot
Igor DoUrden: doesn't show hand 
*** SUMMARY ***
Total pot $2.50 | Rake $0 
Seat 1: matiko09 (big blind) folded before Flop
Seat 2: Vikulja1993 folded before Flop (didn't bet)
Seat 3: pandalapa folded before Flop (didn't bet)
Seat 4: geoffreyjo folded before Flop (didn't bet)
Seat 5: TimStone folded before Flop (didn't bet)
Seat 6: Igor DoUrden collected ($2.50)
Seat 7: tipner folded before Flop (didn't bet)
Seat 8: RICKA16 (button) folded before Flop (didn't bet)
Seat 9: nickreason17 (small blind) folded before Flop





PokerStars Hand #148218222833:  Hold'em No Limit ($0.50/$1.00 USD) - 2016/02/04 14:58:10 CET [2016/02/04 8:58:10 ET]
Table 'Arneb III' 9-max Seat #5 is the button
Seat 1: Vikulja1993 ($100 in chips) 
Seat 2: JeanLima93 ($214.10 in chips) 
Seat 3: matiko09 ($100 in chips) 
Seat 4: Igor DoUrden ($228.81 in chips) 
Seat 5: tipner ($100 in chips) 
Seat 6: nickreason17 ($120.36 in chips) 
Seat 7: Spid1 ($100 in chips) 
Seat 8: volwebni4ek ($41.50 in chips) 
Seat 9: ARTVOR640 ($100 in chips) 
nickreason17: posts small blind $0.50
Spid1: posts big blind $1
*** HOLE CARDS ***
Dealt to matiko09 [6d Ah]
volwebni4ek: folds 
ARTVOR640: folds 
Vikulja1993: folds 
JeanLima93: folds 
matiko09: folds 
Igor DoUrden: folds 
tipner: folds 
nickreason17: folds 
Uncalled bet ($0.50) returned to Spid1
Spid1 collected $1 from pot
Spid1: doesn't show hand 
*** SUMMARY ***
Total pot $1 | Rake $0 
Seat 1: Vikulja1993 folded before Flop (didn't bet)
Seat 2: JeanLima93 folded before Flop (didn't bet)
Seat 3: matiko09 folded before Flop (didn't bet)
Seat 4: Igor DoUrden folded before Flop (didn't bet)
Seat 5: tipner (button) folded before Flop (didn't bet)
Seat 6: nickreason17 (small blind) folded before Flop
Seat 7: Spid1 (big blind) collected ($1)
Seat 8: volwebni4ek folded before Flop (didn't bet)
Seat 9: ARTVOR640 folded before Flop (didn't bet)





PokerStars Hand #148218235656:  Hold'em No Limit ($0.50/$1.00 USD) - 2016/02/04 14:58:25 CET [2016/02/04 8:58:25 ET]
Table 'Alkaid II' 9-max Seat #4 is the button
Seat 2: xxxZeka ($106.28 in chips) 
Seat 3: 1557PSS ($37.13 in chips) 
Seat 4: sanpidk ($114.34 in chips) 
Seat 5: I The King I ($138.52 in chips) 
Seat 6: matiko09 ($100 in chips) 
Seat 8: yourpro ($102 in chips) 
Seat 9: tjl290 ($49.58 in chips) 
I The King I: posts small blind $0.50
matiko09: posts big blind $1
tipner: sits out 
*** HOLE CARDS ***
Dealt to matiko09 [Qc 4s]
yourpro: folds 
tjl290: folds 
xxxZeka: folds 
1557PSS: raises $2 to $3
sanpidk: folds 
I The King I: folds 
matiko09: folds 
Uncalled bet ($2) returned to 1557PSS
1557PSS collected $2.50 from pot
1557PSS: doesn't show hand 
*** SUMMARY ***
Total pot $2.50 | Rake $0 
Seat 2: xxxZeka folded before Flop (didn't bet)
Seat 3: 1557PSS collected ($2.50)
Seat 4: sanpidk (button) folded before Flop (didn't bet)
Seat 5: I The King I (small blind) folded before Flop
Seat 6: matiko09 (big blind) folded before Flop
Seat 8: yourpro folded before Flop (didn't bet)
Seat 9: tjl290 folded before Flop (didn't bet)





PokerStars Hand #148218235546:  Hold'em No Limit ($0.50/$1.00 USD) - 2016/02/04 14:58:25 CET [2016/02/04 8:58:25 ET]
Table 'Sargas' 9-max Seat #6 is the button
Seat 2: chaps1988 ($160.54 in chips) 
Seat 3: sanpidk ($113.19 in chips) 
Seat 5: matiko09 ($100 in chips) 
Seat 6: buttonlife ($87.20 in chips) 
Seat 7: DENG1118 ($94.50 in chips) 
Seat 8: ozone2003 ($107.03 in chips) 
DENG1118: posts small blind $0.50
ozone2003: posts big blind $1
yourpro: sits out 
*** HOLE CARDS ***
Dealt to matiko09 [5h 6s]
chaps1988: folds 
sanpidk: folds 
matiko09: folds 
buttonlife: folds 
DENG1118: folds 
Uncalled bet ($0.50) returned to ozone2003
ozone2003 collected $1 from pot
ozone2003: doesn't show hand 
*** SUMMARY ***
Total pot $1 | Rake $0 
Seat 2: chaps1988 folded before Flop (didn't bet)
Seat 3: sanpidk folded before Flop (didn't bet)
Seat 5: matiko09 folded before Flop (didn't bet)
Seat 6: buttonlife (button) folded before Flop (didn't bet)
Seat 7: DENG1118 (small blind) folded before Flop
Seat 8: ozone2003 (big blind) collected ($1)





PokerStars Hand #148218242684:  Hold'em No Limit ($0.50/$1.00 USD) - 2016/02/04 14:58:31 CET [2016/02/04 8:58:31 ET]
Table 'Asios III' 9-max Seat #2 is the button
Seat 1: yourpro ($138.41 in chips) 
Seat 2: crime8783 ($43.66 in chips) 
Seat 3: Igor DoUrden ($106.03 in chips) 
Seat 4: TimStone ($101.50 in chips) 
Seat 5: ilaviiitech ($149.79 in chips) 
Seat 6: matiko09 ($121 in chips) 
Seat 7: nickreason17 ($150.25 in chips) 
Seat 9: Vikulja1993 ($158.70 in chips) 
Igor DoUrden: posts small blind $0.50
TimStone: posts big blind $1
*** HOLE CARDS ***
Dealt to matiko09 [Ts 3h]
ilaviiitech: folds 
matiko09: folds 
nickreason17: raises $2 to $3
Vikulja1993: folds 
yourpro: folds 
crime8783: folds 
Igor DoUrden: folds 
TimStone: folds 
Uncalled bet ($2) returned to nickreason17
nickreason17 collected $2.50 from pot
*** SUMMARY ***
Total pot $2.50 | Rake $0 
Seat 1: yourpro folded before Flop (didn't bet)
Seat 2: crime8783 (button) folded before Flop (didn't bet)
Seat 3: Igor DoUrden (small blind) folded before Flop
Seat 4: TimStone (big blind) folded before Flop
Seat 5: ilaviiitech folded before Flop (didn't bet)
Seat 6: matiko09 folded before Flop (didn't bet)
Seat 7: nickreason17 collected ($2.50)
Seat 9: Vikulja1993 folded before Flop (didn't bet)





PokerStars Hand #148218243428:  Hold'em No Limit ($0.50/$1.00 USD) - 2016/02/04 14:58:32 CET [2016/02/04 8:58:32 ET]
Table 'Arneb III' 9-max Seat #6 is the button
Seat 1: Vikulja1993 ($100 in chips) 
Seat 2: JeanLima93 ($214.10 in chips) 
Seat 3: matiko09 ($100 in chips) 
Seat 4: Igor DoUrden ($228.81 in chips) 
Seat 5: tipner ($100 in chips) 
Seat 6: nickreason17 ($119.86 in chips) 
Seat 7: Spid1 ($100.50 in chips) 
Seat 8: volwebni4ek ($41.50 in chips) 
Seat 9: ARTVOR640 ($100 in chips) 
Spid1: posts small blind $0.50
volwebni4ek: posts big blind $1
*** HOLE CARDS ***
Dealt to matiko09 [Ac 9d]
ARTVOR640: folds 
Vikulja1993: folds 
JeanLima93: folds 
matiko09: folds 
Igor DoUrden: folds 
tipner: folds 
nickreason17: raises $1.04 to $2.04
Spid1: raises $6.46 to $8.50
volwebni4ek: folds 
nickreason17: folds 
Uncalled bet ($6.46) returned to Spid1
Spid1 collected $5.08 from pot
Spid1: doesn't show hand 
*** SUMMARY ***
Total pot $5.08 | Rake $0 
Seat 1: Vikulja1993 folded before Flop (didn't bet)
Seat 2: JeanLima93 folded before Flop (didn't bet)
Seat 3: matiko09 folded before Flop (didn't bet)
Seat 4: Igor DoUrden folded before Flop (didn't bet)
Seat 5: tipner folded before Flop (didn't bet)
Seat 6: nickreason17 (button) folded before Flop
Seat 7: Spid1 (small blind) collected ($5.08)
Seat 8: volwebni4ek (big blind) folded before Flop
Seat 9: ARTVOR640 folded before Flop (didn't bet)





PokerStars Hand #148218245809:  Hold'em No Limit ($0.50/$1.00 USD) - 2016/02/04 14:58:36 CET [2016/02/04 8:58:36 ET]
Table 'Arneb II' 9-max Seat #7 is the button
Seat 1: matiko09 ($101.50 in chips) 
Seat 2: sanpidk ($199.70 in chips) 
Seat 3: brille-390 ($100 in chips) 
Seat 4: Venomous100% ($117.64 in chips) 
Seat 5: lixiangli ($81.52 in chips) 
Seat 7: melitakas ($262.01 in chips) 
Seat 8: tedbadger9 ($74.50 in chips) 
Seat 9: tipner ($112.24 in chips) 
tedbadger9: posts small blind $0.50
tipner: posts big blind $1
*** HOLE CARDS ***
Dealt to matiko09 [9c Tc]
matiko09: raises $2 to $3
sanpidk: folds 
brille-390: folds 
Venomous100%: calls $3
lixiangli: folds 
melitakas: folds 
tedbadger9: folds 
tipner: folds 
*** FLOP *** [2d Ts 3h]
matiko09: bets $4.65
Venomous100%: calls $4.65
*** TURN *** [2d Ts 3h] [6d]
matiko09: checks 
Venomous100%: bets $10.69
matiko09: folds 
Uncalled bet ($10.69) returned to Venomous100%
Venomous100% collected $16.04 from pot
Venomous100%: doesn't show hand 
*** SUMMARY ***
Total pot $16.80 | Rake $0.76 
Board [2d Ts 3h 6d]
Seat 1: matiko09 folded on the Turn
Seat 2: sanpidk folded before Flop (didn't bet)
Seat 3: brille-390 folded before Flop (didn't bet)
Seat 4: Venomous100% collected ($16.04)
Seat 5: lixiangli folded before Flop (didn't bet)
Seat 7: melitakas (button) folded before Flop (didn't bet)
Seat 8: tedbadger9 (small blind) folded before Flop
Seat 9: tipner (big blind) folded before Flop





PokerStars Hand #148218250559:  Hold'em No Limit ($0.50/$1.00 USD) - 2016/02/04 14:58:41 CET [2016/02/04 8:58:41 ET]
Table 'Edburga II' 9-max Seat #9 is the button
Seat 1: matiko09 ($137.70 in chips) 
Seat 2: Vikulja1993 ($100 in chips) 
Seat 3: pandalapa ($107.50 in chips) 
Seat 4: geoffreyjo ($150.78 in chips) 
Seat 5: TimStone ($100 in chips) 
Seat 6: Igor DoUrden ($101.50 in chips) 
Seat 7: tipner ($101.94 in chips) 
Seat 8: RICKA16 ($100 in chips) 
Seat 9: nickreason17 ($116.50 in chips) 
matiko09: posts small blind $0.50
Vikulja1993: posts big blind $1
*** HOLE CARDS ***
Dealt to matiko09 [Ah Jc]
pandalapa: folds 
geoffreyjo: folds 
TimStone: raises $2.01 to $3.01
geoffreyjo leaves the table
Igor DoUrden: folds 
tipner: folds 
RICKA16: folds 
nickreason17: folds 
DanishWiking joins the table at seat #4 
matiko09: folds 
Vikulja1993: folds 
Uncalled bet ($2.01) returned to TimStone
TimStone collected $2.50 from pot
TimStone: doesn't show hand 
*** SUMMARY ***
Total pot $2.50 | Rake $0 
Seat 1: matiko09 (small blind) folded before Flop
Seat 2: Vikulja1993 (big blind) folded before Flop
Seat 3: pandalapa folded before Flop (didn't bet)
Seat 4: geoffreyjo folded before Flop (didn't bet)
Seat 5: TimStone collected ($2.50)
Seat 6: Igor DoUrden folded before Flop (didn't bet)
Seat 7: tipner folded before Flop (didn't bet)
Seat 8: RICKA16 folded before Flop (didn't bet)
Seat 9: nickreason17 (button) folded before Flop (didn't bet)





PokerStars Hand #148218251557:  Hold'em No Limit ($0.50/$1.00 USD) - 2016/02/04 14:58:43 CET [2016/02/04 8:58:43 ET]
Table 'Siarnaq' 9-max Seat #4 is the button
Seat 1: taraisai ($114.07 in chips) 
Seat 2: matiko09 ($100 in chips) 
Seat 3: nickreason17 ($100 in chips) 
Seat 4: sanpidk ($100 in chips) 
Seat 5: Igor DoUrden ($115.76 in chips) 
Seat 6: I The King I ($100 in chips) 
Seat 7: Sesamesnap ($60.27 in chips) 
Seat 8: maxxmeister ($100 in chips) 
Seat 9: goblind4777 ($93.52 in chips) 
Igor DoUrden: posts small blind $0.50
I The King I: posts big blind $1
*** HOLE CARDS ***
Dealt to matiko09 [6h 3s]
Sesamesnap: folds 
maxxmeister: folds 
goblind4777: folds 
taraisai: folds 
matiko09: folds 
nickreason17: raises $1.50 to $2.50
sanpidk: folds 
Igor DoUrden: folds 
I The King I: folds 
Uncalled bet ($1.50) returned to nickreason17
nickreason17 collected $2.50 from pot
*** SUMMARY ***
Total pot $2.50 | Rake $0 
Seat 1: taraisai folded before Flop (didn't bet)
Seat 2: matiko09 folded before Flop (didn't bet)
Seat 3: nickreason17 collected ($2.50)
Seat 4: sanpidk (button) folded before Flop (didn't bet)
Seat 5: Igor DoUrden (small blind) folded before Flop
Seat 6: I The King I (big blind) folded before Flop
Seat 7: Sesamesnap folded before Flop (didn't bet)
Seat 8: maxxmeister folded before Flop (didn't bet)
Seat 9: goblind4777 folded before Flop (didn't bet)





PokerStars Hand #148218252189:  Hold'em No Limit ($0.50/$1.00 USD) - 2016/02/04 14:58:44 CET [2016/02/04 8:58:44 ET]
Table 'Sargas' 9-max Seat #7 is the button
Seat 2: chaps1988 ($160.54 in chips) 
Seat 3: sanpidk ($113.19 in chips) 
Seat 5: matiko09 ($100 in chips) 
Seat 6: buttonlife ($87.20 in chips) 
Seat 7: DENG1118 ($94 in chips) 
Seat 8: ozone2003 ($107.53 in chips) 
ozone2003: posts small blind $0.50
chaps1988: posts big blind $1
yourpro: sits out 
*** HOLE CARDS ***
Dealt to matiko09 [6c 5d]
sanpidk: folds 
sanpidk leaves the table
matiko09: folds 
buttonlife: folds 
DENG1118: raises $2 to $3
ozone2003: folds 
chaps1988: folds 
Uncalled bet ($2) returned to DENG1118
DENG1118 collected $2.50 from pot
DENG1118: doesn't show hand 
*** SUMMARY ***
Total pot $2.50 | Rake $0 
Seat 2: chaps1988 (big blind) folded before Flop
Seat 3: sanpidk folded before Flop (didn't bet)
Seat 5: matiko09 folded before Flop (didn't bet)
Seat 6: buttonlife folded before Flop (didn't bet)
Seat 7: DENG1118 (button) collected ($2.50)
Seat 8: ozone2003 (small blind) folded before Flop





PokerStars Hand #148218264387:  Hold'em No Limit ($0.50/$1.00 USD) - 2016/02/04 14:59:02 CET [2016/02/04 8:59:02 ET]
Table 'Alkaid II' 9-max Seat #5 is the button
Seat 2: xxxZeka ($106.28 in chips) 
Seat 3: 1557PSS ($38.63 in chips) 
Seat 4: sanpidk ($114.34 in chips) 
Seat 5: I The King I ($138.02 in chips) 
Seat 6: matiko09 ($100 in chips) 
Seat 7: tipner ($100 in chips) 
Seat 8: yourpro ($102 in chips) 
Seat 9: tjl290 ($49.58 in chips) 
matiko09: posts small blind $0.50
tipner: posts big blind $1
*** HOLE CARDS ***
Dealt to matiko09 [4s Qh]
yourpro: folds 
tjl290: folds 
xxxZeka: folds 
1557PSS: folds 
sanpidk: raises $1.50 to $2.50
I The King I: raises $4.96 to $7.46
matiko09: folds 
tipner: folds 
sanpidk: calls $4.96
*** FLOP *** [2h 5s Th]
sanpidk: checks 
I The King I: bets $10
sanpidk: folds 
Uncalled bet ($10) returned to I The King I
I The King I collected $15.68 from pot
I The King I: doesn't show hand 
*** SUMMARY ***
Total pot $16.42 | Rake $0.74 
Board [2h 5s Th]
Seat 2: xxxZeka folded before Flop (didn't bet)
Seat 3: 1557PSS folded before Flop (didn't bet)
Seat 4: sanpidk folded on the Flop
Seat 5: I The King I (button) collected ($15.68)
Seat 6: matiko09 (small blind) folded before Flop
Seat 7: tipner (big blind) folded before Flop
Seat 8: yourpro folded before Flop (didn't bet)
Seat 9: tjl290 folded before Flop (didn't bet)





PokerStars Hand #148218271412:  Hold'em No Limit ($0.50/$1.00 USD) - 2016/02/04 14:59:14 CET [2016/02/04 8:59:14 ET]
Table 'Sargas' 9-max Seat #8 is the button
Seat 2: chaps1988 ($159.54 in chips) 
Seat 4: yourpro ($100 in chips) 
Seat 5: matiko09 ($100 in chips) 
Seat 6: buttonlife ($87.20 in chips) 
Seat 7: DENG1118 ($95.50 in chips) 
Seat 8: ozone2003 ($107.03 in chips) 
chaps1988: posts small blind $0.50
yourpro: posts big blind $1
*** HOLE CARDS ***
Dealt to matiko09 [Th 9h]
pandalapa joins the table at seat #9 
matiko09: raises $2 to $3
buttonlife: folds 
DENG1118: folds 
ozone2003: folds 
chaps1988: folds 
DanishWiking joins the table at seat #3 
yourpro: folds 
Uncalled bet ($2) returned to matiko09
matiko09 collected $2.50 from pot
matiko09: doesn't show hand 
*** SUMMARY ***
Total pot $2.50 | Rake $0 
Seat 2: chaps1988 (small blind) folded before Flop
Seat 4: yourpro (big blind) folded before Flop
Seat 5: matiko09 collected ($2.50)
Seat 6: buttonlife folded before Flop (didn't bet)
Seat 7: DENG1118 folded before Flop (didn't bet)
Seat 8: ozone2003 (button) folded before Flop (didn't bet)





PokerStars Hand #148218275850:  Hold'em No Limit ($0.50/$1.00 USD) - 2016/02/04 14:59:21 CET [2016/02/04 8:59:21 ET]
Table 'Edburga II' 9-max Seat #1 is the button
Seat 1: matiko09 ($137.20 in chips) 
Seat 2: Vikulja1993 ($100 in chips) 
Seat 3: pandalapa ($107.50 in chips) 
Seat 5: TimStone ($101.50 in chips) 
Seat 6: Igor DoUrden ($101.50 in chips) 
Seat 7: tipner ($101.94 in chips) 
Seat 8: RICKA16 ($100 in chips) 
Seat 9: nickreason17 ($116.50 in chips) 
Vikulja1993: posts small blind $0.50
pandalapa: posts big blind $1
DanishWiking: sits out 
*** HOLE CARDS ***
Dealt to matiko09 [5d Jh]
TimStone: folds 
Igor DoUrden: folds 
tipner: folds 
RICKA16: folds 
nickreason17: folds 
matiko09: folds 
Vikulja1993: raises $1.50 to $2.50
pandalapa: folds 
Uncalled bet ($1.50) returned to Vikulja1993
Vikulja1993 collected $2 from pot
Vikulja1993: doesn't show hand 
*** SUMMARY ***
Total pot $2 | Rake $0 
Seat 1: matiko09 (button) folded before Flop (didn't bet)
Seat 2: Vikulja1993 (small blind) collected ($2)
Seat 3: pandalapa (big blind) folded before Flop
Seat 5: TimStone folded before Flop (didn't bet)
Seat 6: Igor DoUrden folded before Flop (didn't bet)
Seat 7: tipner folded before Flop (didn't bet)
Seat 8: RICKA16 folded before Flop (didn't bet)
Seat 9: nickreason17 folded before Flop (didn't bet)





PokerStars Hand #148218279066:  Hold'em No Limit ($0.50/$1.00 USD) - 2016/02/04 14:59:26 CET [2016/02/04 8:59:26 ET]
Table 'Siarnaq' 9-max Seat #5 is the button
Seat 1: taraisai ($114.07 in chips) 
Seat 2: matiko09 ($100 in chips) 
Seat 3: nickreason17 ($101.50 in chips) 
Seat 4: sanpidk ($100 in chips) 
Seat 5: Igor DoUrden ($115.26 in chips) 
Seat 6: I The King I ($100 in chips) 
Seat 7: Sesamesnap ($60.27 in chips) 
Seat 8: maxxmeister ($100 in chips) 
Seat 9: goblind4777 ($93.52 in chips) 
I The King I: posts small blind $0.50
Sesamesnap: posts big blind $1
*** HOLE CARDS ***
Dealt to matiko09 [9h Kh]
maxxmeister: folds 
goblind4777: folds 
taraisai: folds 
matiko09: folds 
nickreason17: folds 
sanpidk: folds 
Igor DoUrden: raises $1.09 to $2.09
I The King I: folds 
Sesamesnap: folds 
Uncalled bet ($1.09) returned to Igor DoUrden
Igor DoUrden collected $2.50 from pot
Igor DoUrden: doesn't show hand 
*** SUMMARY ***
Total pot $2.50 | Rake $0 
Seat 1: taraisai folded before Flop (didn't bet)
Seat 2: matiko09 folded before Flop (didn't bet)
Seat 3: nickreason17 folded before Flop (didn't bet)
Seat 4: sanpidk folded before Flop (didn't bet)
Seat 5: Igor DoUrden (button) collected ($2.50)
Seat 6: I The King I (small blind) folded before Flop
Seat 7: Sesamesnap (big blind) folded before Flop
Seat 8: maxxmeister folded before Flop (didn't bet)
Seat 9: goblind4777 folded before Flop (didn't bet)





PokerStars Hand #148218280033:  Hold'em No Limit ($0.50/$1.00 USD) - 2016/02/04 14:59:28 CET [2016/02/04 8:59:28 ET]
Table 'Arneb III' 9-max Seat #7 is the button
Seat 1: Vikulja1993 ($100 in chips) 
Seat 2: JeanLima93 ($214.10 in chips) 
Seat 3: matiko09 ($100 in chips) 
Seat 4: Igor DoUrden ($228.81 in chips) 
Seat 5: tipner ($100 in chips) 
Seat 6: nickreason17 ($117.82 in chips) 
Seat 7: Spid1 ($103.54 in chips) 
Seat 8: volwebni4ek ($40.50 in chips) 
Seat 9: ARTVOR640 ($100 in chips) 
volwebni4ek: posts small blind $0.50
ARTVOR640: posts big blind $1
*** HOLE CARDS ***
Dealt to matiko09 [9h 3d]
Vikulja1993: folds 
JeanLima93: folds 
matiko09: folds 
Igor DoUrden: folds 
tipner: folds 
nickreason17: raises $1.50 to $2.50
Spid1: folds 
volwebni4ek: folds 
ARTVOR640: folds 
Uncalled bet ($1.50) returned to nickreason17
nickreason17 collected $2.50 from pot
*** SUMMARY ***
Total pot $2.50 | Rake $0 
Seat 1: Vikulja1993 folded before Flop (didn't bet)
Seat 2: JeanLima93 folded before Flop (didn't bet)
Seat 3: matiko09 folded before Flop (didn't bet)
Seat 4: Igor DoUrden folded before Flop (didn't bet)
Seat 5: tipner folded before Flop (didn't bet)
Seat 6: nickreason17 collected ($2.50)
Seat 7: Spid1 (button) folded before Flop (didn't bet)
Seat 8: volwebni4ek (small blind) folded before Flop
Seat 9: ARTVOR640 (big blind) folded before Flop





PokerStars Hand #148218280575:  Hold'em No Limit ($0.50/$1.00 USD) - 2016/02/04 14:59:29 CET [2016/02/04 8:59:29 ET]
Table 'Asios III' 9-max Seat #3 is the button
Seat 1: yourpro ($138.41 in chips) 
Seat 2: crime8783 ($43.66 in chips) 
Seat 3: Igor DoUrden ($105.53 in chips) 
Seat 4: TimStone ($100.50 in chips) 
Seat 5: ilaviiitech ($149.79 in chips) 
Seat 6: matiko09 ($121 in chips) 
Seat 7: nickreason17 ($151.75 in chips) 
Seat 9: Vikulja1993 ($158.70 in chips) 
TimStone: posts small blind $0.50
ilaviiitech: posts big blind $1
*** HOLE CARDS ***
Dealt to matiko09 [Th Qc]
matiko09: folds 
nickreason17: folds 
Vikulja1993: folds 
yourpro: folds 
crime8783: calls $1
Igor DoUrden: folds 
TimStone: calls $0.50
ilaviiitech: checks 
*** FLOP *** [3h Qs 3c]
TimStone: checks 
ilaviiitech: checks 
crime8783: checks 
*** TURN *** [3h Qs 3c] [8h]
TimStone: bets $1.64
ilaviiitech: calls $1.64
crime8783: folds 
*** RIVER *** [3h Qs 3c 8h] [6d]
TimStone: checks 
ilaviiitech: bets $4.80
TimStone: folds 
Uncalled bet ($4.80) returned to ilaviiitech
ilaviiitech collected $6 from pot
ilaviiitech: doesn't show hand 
*** SUMMARY ***
Total pot $6.28 | Rake $0.28 
Board [3h Qs 3c 8h 6d]
Seat 1: yourpro folded before Flop (didn't bet)
Seat 2: crime8783 folded on the Turn
Seat 3: Igor DoUrden (button) folded before Flop (didn't bet)
Seat 4: TimStone (small blind) folded on the River
Seat 5: ilaviiitech (big blind) collected ($6)
Seat 6: matiko09 folded before Flop (didn't bet)
Seat 7: nickreason17 folded before Flop (didn't bet)
Seat 9: Vikulja1993 folded before Flop (didn't bet)





PokerStars Hand #148218284631:  Hold'em No Limit ($0.50/$1.00 USD) - 2016/02/04 14:59:36 CET [2016/02/04 8:59:36 ET]
Table 'Arneb II' 9-max Seat #9 is the button
Seat 1: matiko09 ($100 in chips) 
Seat 2: sanpidk ($199.70 in chips) 
Seat 3: brille-390 ($100 in chips) 
Seat 4: Venomous100% ($126.03 in chips) 
Seat 5: lixiangli ($81.52 in chips) 
Seat 7: melitakas ($262.01 in chips) 
Seat 9: tipner ($111.24 in chips) 
matiko09: posts small blind $0.50
sanpidk: posts big blind $1
*** HOLE CARDS ***
Dealt to matiko09 [3d Qc]
brille-390: raises $1.25 to $2.25
Venomous100%: folds 
lixiangli: calls $2.25
melitakas: folds 
tipner: raises $8.75 to $11
matiko09: folds 
sanpidk: folds 
brille-390: folds 
lixiangli: folds 
Uncalled bet ($8.75) returned to tipner
tipner collected $8.25 from pot
tipner: doesn't show hand 
*** SUMMARY ***
Total pot $8.25 | Rake $0 
Seat 1: matiko09 (small blind) folded before Flop
Seat 2: sanpidk (big blind) folded before Flop
Seat 3: brille-390 folded before Flop
Seat 4: Venomous100% folded before Flop (didn't bet)
Seat 5: lixiangli folded before Flop
Seat 7: melitakas folded before Flop (didn't bet)
Seat 9: tipner (button) collected ($8.25)





PokerStars Hand #148218300329:  Hold'em No Limit ($0.50/$1.00 USD) - 2016/02/04 15:00:02 CET [2016/02/04 9:00:02 ET]
Table 'Siarnaq' 9-max Seat #6 is the button
Seat 1: taraisai ($114.07 in chips) 
Seat 2: matiko09 ($100 in chips) 
Seat 3: nickreason17 ($101.50 in chips) 
Seat 4: sanpidk ($100 in chips) 
Seat 5: Igor DoUrden ($116.76 in chips) 
Seat 6: I The King I ($100 in chips) 
Seat 7: Sesamesnap ($59.27 in chips) 
Seat 8: maxxmeister ($100 in chips) 
Seat 9: goblind4777 ($93.52 in chips) 
Sesamesnap: posts small blind $0.50
maxxmeister: posts big blind $1
*** HOLE CARDS ***
Dealt to matiko09 [3c 6h]
goblind4777: raises $2.55 to $3.55
taraisai: folds 
matiko09: folds 
nickreason17: folds 
sanpidk: folds 
Igor DoUrden: calls $3.55
I The King I: folds 
Sesamesnap: folds 
maxxmeister: folds 
*** FLOP *** [Kc 7c Jc]
goblind4777: bets $4.67
Igor DoUrden: calls $4.67
*** TURN *** [Kc 7c Jc] [8h]
goblind4777: bets $9.79
Igor DoUrden: folds 
Uncalled bet ($9.79) returned to goblind4777
goblind4777 collected $17.13 from pot
*** SUMMARY ***
Total pot $17.94 | Rake $0.81 
Board [Kc 7c Jc 8h]
Seat 1: taraisai folded before Flop (didn't bet)
Seat 2: matiko09 folded before Flop (didn't bet)
Seat 3: nickreason17 folded before Flop (didn't bet)
Seat 4: sanpidk folded before Flop (didn't bet)
Seat 5: Igor DoUrden folded on the Turn
Seat 6: I The King I (button) folded before Flop (didn't bet)
Seat 7: Sesamesnap (small blind) folded before Flop
Seat 8: maxxmeister (big blind) folded before Flop
Seat 9: goblind4777 collected ($17.13)





PokerStars Hand #148218304149:  Hold'em No Limit ($0.50/$1.00 USD) - 2016/02/04 15:00:08 CET [2016/02/04 9:00:08 ET]
Table 'Edburga II' 9-max Seat #2 is the button
Seat 1: matiko09 ($137.20 in chips) 
Seat 2: Vikulja1993 ($101 in chips) 
Seat 3: pandalapa ($106.50 in chips) 
Seat 4: DanishWiking ($100 in chips) 
Seat 5: TimStone ($101.50 in chips) 
Seat 6: Igor DoUrden ($101.50 in chips) 
Seat 7: tipner ($101.94 in chips) 
Seat 8: RICKA16 ($100 in chips) 
Seat 9: nickreason17 ($116.50 in chips) 
pandalapa: posts small blind $0.50
DanishWiking: posts big blind $1
*** HOLE CARDS ***
Dealt to matiko09 [3s 2h]
TimStone: folds 
Igor DoUrden: folds 
tipner: raises $2 to $3
RICKA16: folds 
nickreason17: folds 
matiko09: folds 
Vikulja1993 has timed out
Vikulja1993: folds 
pandalapa: calls $2.50
DanishWiking: folds 
*** FLOP *** [Qh 2c Th]
pandalapa: checks 
tipner: checks 
*** TURN *** [Qh 2c Th] [Jc]
pandalapa: checks 
tipner: checks 
*** RIVER *** [Qh 2c Th Jc] [3c]
pandalapa: checks 
tipner: bets $4
pandalapa: folds 
Uncalled bet ($4) returned to tipner
tipner collected $6.68 from pot
*** SUMMARY ***
Total pot $7 | Rake $0.32 
Board [Qh 2c Th Jc 3c]
Seat 1: matiko09 folded before Flop (didn't bet)
Seat 2: Vikulja1993 (button) folded before Flop (didn't bet)
Seat 3: pandalapa (small blind) folded on the River
Seat 4: DanishWiking (big blind) folded before Flop
Seat 5: TimStone folded before Flop (didn't bet)
Seat 6: Igor DoUrden folded before Flop (didn't bet)
Seat 7: tipner collected ($6.68)
Seat 8: RICKA16 folded before Flop (didn't bet)
Seat 9: nickreason17 folded before Flop (didn't bet)





PokerStars Hand #148218305733:  Hold'em No Limit ($0.50/$1.00 USD) - 2016/02/04 15:00:11 CET [2016/02/04 9:00:11 ET]
Table 'Alkaid II' 9-max Seat #6 is the button
Seat 2: xxxZeka ($106.28 in chips) 
Seat 3: 1557PSS ($38.63 in chips) 
Seat 4: sanpidk ($106.88 in chips) 
Seat 5: I The King I ($146.24 in chips) 
Seat 6: matiko09 ($100 in chips) 
Seat 7: tipner ($100 in chips) 
Seat 8: yourpro ($102 in chips) 
Seat 9: tjl290 ($49.58 in chips) 
tipner: posts small blind $0.50
yourpro: posts big blind $1
*** HOLE CARDS ***
Dealt to matiko09 [8c 7s]
tjl290: folds 
xxxZeka: folds 
1557PSS: folds 
sanpidk: folds 
I The King I: folds 
matiko09: folds 
tipner: raises $2 to $3
yourpro: raises $6 to $9
tipner: calls $6
*** FLOP *** [Qs 5s 9d]
tipner: checks 
yourpro: bets $11.51
tipner: calls $11.51
*** TURN *** [Qs 5s 9d] [4s]
tipner: checks 
yourpro: bets $28.24
tipner: folds 
Uncalled bet ($28.24) returned to yourpro
yourpro collected $39.17 from pot
yourpro: doesn't show hand 
*** SUMMARY ***
Total pot $41.02 | Rake $1.85 
Board [Qs 5s 9d 4s]
Seat 2: xxxZeka folded before Flop (didn't bet)
Seat 3: 1557PSS folded before Flop (didn't bet)
Seat 4: sanpidk folded before Flop (didn't bet)
Seat 5: I The King I folded before Flop (didn't bet)
Seat 6: matiko09 (button) folded before Flop (didn't bet)
Seat 7: tipner (small blind) folded on the Turn
Seat 8: yourpro (big blind) collected ($39.17)
Seat 9: tjl290 folded before Flop (didn't bet)





PokerStars Hand #148218308936:  Hold'em No Limit ($0.50/$1.00 USD) - 2016/02/04 15:00:16 CET [2016/02/04 9:00:16 ET]
Table 'Arneb II' 9-max Seat #1 is the button
Seat 1: matiko09 ($100 in chips) 
Seat 2: sanpidk ($198.70 in chips) 
Seat 3: brille-390 ($100 in chips) 
Seat 4: Venomous100% ($126.03 in chips) 
Seat 5: lixiangli ($79.27 in chips) 
Seat 7: melitakas ($262.01 in chips) 
Seat 9: tipner ($117.24 in chips) 
sanpidk: posts small blind $0.50
brille-390: posts big blind $1
*** HOLE CARDS ***
Dealt to matiko09 [9d 3h]
Venomous100%: folds 
lixiangli: folds 
melitakas: folds 
tipner: raises $2 to $3
matiko09: folds 
sanpidk: folds 
brille-390: folds 
Uncalled bet ($2) returned to tipner
tipner collected $2.50 from pot
tipner: doesn't show hand 
*** SUMMARY ***
Total pot $2.50 | Rake $0 
Seat 1: matiko09 (button) folded before Flop (didn't bet)
Seat 2: sanpidk (small blind) folded before Flop
Seat 3: brille-390 (big blind) folded before Flop
Seat 4: Venomous100% folded before Flop (didn't bet)
Seat 5: lixiangli folded before Flop (didn't bet)
Seat 7: melitakas folded before Flop (didn't bet)
Seat 9: tipner collected ($2.50)





PokerStars Hand #148218318784:  Hold'em No Limit ($0.50/$1.00 USD) - 2016/02/04 15:00:32 CET [2016/02/04 9:00:32 ET]
Table 'Arneb III' 9-max Seat #8 is the button
Seat 1: Vikulja1993 ($100 in chips) 
Seat 2: JeanLima93 ($214.10 in chips) 
Seat 3: matiko09 ($100 in chips) 
Seat 4: Igor DoUrden ($228.81 in chips) 
Seat 5: tipner ($100 in chips) 
Seat 6: nickreason17 ($119.32 in chips) 
Seat 7: Spid1 ($103.54 in chips) 
Seat 8: volwebni4ek ($40 in chips) 
Seat 9: ARTVOR640 ($100 in chips) 
ARTVOR640: posts small blind $0.50
Vikulja1993: posts big blind $1
*** HOLE CARDS ***
Dealt to matiko09 [9c 6h]
JeanLima93: raises $2 to $3
matiko09: folds 
Igor DoUrden: folds 
tipner: folds 
nickreason17: folds 
Spid1: folds 
volwebni4ek: folds 
ARTVOR640: folds 
Vikulja1993: folds 
Uncalled bet ($2) returned to JeanLima93
JeanLima93 collected $2.50 from pot
JeanLima93: doesn't show hand 
*** SUMMARY ***
Total pot $2.50 | Rake $0 
Seat 1: Vikulja1993 (big blind) folded before Flop
Seat 2: JeanLima93 collected ($2.50)
Seat 3: matiko09 folded before Flop (didn't bet)
Seat 4: Igor DoUrden folded before Flop (didn't bet)
Seat 5: tipner folded before Flop (didn't bet)
Seat 6: nickreason17 folded before Flop (didn't bet)
Seat 7: Spid1 folded before Flop (didn't bet)
Seat 8: volwebni4ek (button) folded before Flop (didn't bet)
Seat 9: ARTVOR640 (small blind) folded before Flop





PokerStars Hand #148218321964:  Hold'em No Limit ($0.50/$1.00 USD) - 2016/02/04 15:00:37 CET [2016/02/04 9:00:37 ET]
Table 'Arneb II' 9-max Seat #2 is the button
Seat 1: matiko09 ($100 in chips) 
Seat 2: sanpidk ($198.20 in chips) 
Seat 3: brille-390 ($100 in chips) 
Seat 4: Venomous100% ($126.03 in chips) 
Seat 5: lixiangli ($79.27 in chips) 
Seat 7: melitakas ($262.01 in chips) 
Seat 9: tipner ($118.74 in chips) 
brille-390: posts small blind $0.50
Venomous100%: posts big blind $1
*** HOLE CARDS ***
Dealt to matiko09 [Js 9c]
lixiangli: folds 
melitakas: folds 
tipner: folds 
matiko09: folds 
sanpidk: raises $1.24 to $2.24
brille-390: folds 
Venomous100%: calls $1.24
*** FLOP *** [As 5h 2s]
Venomous100%: checks 
sanpidk: checks 
*** TURN *** [As 5h 2s] [Qs]
Venomous100%: bets $3.14
sanpidk: folds 
Uncalled bet ($3.14) returned to Venomous100%
Venomous100% collected $4.76 from pot
Venomous100%: doesn't show hand 
*** SUMMARY ***
Total pot $4.98 | Rake $0.22 
Board [As 5h 2s Qs]
Seat 1: matiko09 folded before Flop (didn't bet)
Seat 2: sanpidk (button) folded on the Turn
Seat 3: brille-390 (small blind) folded before Flop
Seat 4: Venomous100% (big blind) collected ($4.76)
Seat 5: lixiangli folded before Flop (didn't bet)
Seat 7: melitakas folded before Flop (didn't bet)
Seat 9: tipner folded before Flop (didn't bet)





PokerStars Hand #148218332724:  Hold'em No Limit ($0.50/$1.00 USD) - 2016/02/04 15:00:55 CET [2016/02/04 9:00:55 ET]
Table 'Asios III' 9-max Seat #4 is the button
Seat 1: yourpro ($138.41 in chips) 
Seat 2: crime8783 ($42.66 in chips) 
Seat 3: Igor DoUrden ($105.53 in chips) 
Seat 4: TimStone ($100 in chips) 
Seat 5: ilaviiitech ($153.15 in chips) 
Seat 6: matiko09 ($121 in chips) 
Seat 7: nickreason17 ($151.75 in chips) 
Seat 9: Vikulja1993 ($158.70 in chips) 
ilaviiitech: posts small blind $0.50
matiko09: posts big blind $1
*** HOLE CARDS ***
Dealt to matiko09 [3d 8c]
nickreason17: raises $2 to $3
Vikulja1993: folds 
yourpro: folds 
crime8783: folds 
Igor DoUrden: folds 
TimStone: folds 
ilaviiitech: folds 
matiko09: folds 
Uncalled bet ($2) returned to nickreason17
nickreason17 collected $2.50 from pot
*** SUMMARY ***
Total pot $2.50 | Rake $0 
Seat 1: yourpro folded before Flop (didn't bet)
Seat 2: crime8783 folded before Flop (didn't bet)
Seat 3: Igor DoUrden folded before Flop (didn't bet)
Seat 4: TimStone (button) folded before Flop (didn't bet)
Seat 5: ilaviiitech (small blind) folded before Flop
Seat 6: matiko09 (big blind) folded before Flop
Seat 7: nickreason17 collected ($2.50)
Seat 9: Vikulja1993 folded before Flop (didn't bet)





PokerStars Hand #148218340747:  Hold'em No Limit ($0.50/$1.00 USD) - 2016/02/04 15:01:07 CET [2016/02/04 9:01:07 ET]
Table 'Arneb III' 9-max Seat #9 is the button
Seat 1: Vikulja1993 ($100 in chips) 
Seat 2: JeanLima93 ($215.60 in chips) 
Seat 3: matiko09 ($100 in chips) 
Seat 4: Igor DoUrden ($228.81 in chips) 
Seat 5: tipner ($100 in chips) 
Seat 6: nickreason17 ($119.32 in chips) 
Seat 7: Spid1 ($103.54 in chips) 
Seat 8: volwebni4ek ($40 in chips) 
Seat 9: ARTVOR640 ($100 in chips) 
Vikulja1993: posts small blind $0.50
JeanLima93: posts big blind $1
*** HOLE CARDS ***
Dealt to matiko09 [5d 9h]
matiko09: folds 
Igor DoUrden: folds 
tipner: folds 
nickreason17: folds 
Spid1: folds 
volwebni4ek: folds 
ARTVOR640: folds 
Vikulja1993: folds 
Uncalled bet ($0.50) returned to JeanLima93
JeanLima93 collected $1 from pot
JeanLima93: doesn't show hand 
*** SUMMARY ***
Total pot $1 | Rake $0 
Seat 1: Vikulja1993 (small blind) folded before Flop
Seat 2: JeanLima93 (big blind) collected ($1)
Seat 3: matiko09 folded before Flop (didn't bet)
Seat 4: Igor DoUrden folded before Flop (didn't bet)
Seat 5: tipner folded before Flop (didn't bet)
Seat 6: nickreason17 folded before Flop (didn't bet)
Seat 7: Spid1 folded before Flop (didn't bet)
Seat 8: volwebni4ek folded before Flop (didn't bet)
Seat 9: ARTVOR640 (button) folded before Flop (didn't bet)





PokerStars Hand #148218352256:  Hold'em No Limit ($0.50/$1.00 USD) - 2016/02/04 15:01:24 CET [2016/02/04 9:01:24 ET]
Table 'Siarnaq' 9-max Seat #7 is the button
Seat 1: taraisai ($114.07 in chips) 
Seat 2: matiko09 ($100 in chips) 
Seat 3: nickreason17 ($101.50 in chips) 
Seat 4: sanpidk ($100 in chips) 
Seat 5: Igor DoUrden ($108.54 in chips) 
Seat 6: I The King I ($100 in chips) 
Seat 7: Sesamesnap ($58.77 in chips) 
Seat 8: maxxmeister ($100 in chips) 
Seat 9: goblind4777 ($102.43 in chips) 
maxxmeister: posts small blind $0.50
goblind4777: posts big blind $1
*** HOLE CARDS ***
Dealt to matiko09 [7h 4s]
taraisai: folds 
matiko09: folds 
nickreason17: folds 
taraisai leaves the table
sanpidk: raises $2 to $3
Igor DoUrden: folds 
I The King I: folds 
Sesamesnap: folds 
maxxmeister: folds 
goblind4777: calls $2
*** FLOP *** [Js As 6h]
goblind4777: bets $4.21
sanpidk: raises $9.79 to $14
Spid1 joins the table at seat #1 
Spid1 leaves the table
goblind4777: calls $9.79
*** TURN *** [Js As 6h] [9h]
Vikulja1993 joins the table at seat #1 
goblind4777: checks 
Vikulja1993 leaves the table
xxxZeka joins the table at seat #1 
sanpidk: bets $23.90
goblind4777: calls $23.90
*** RIVER *** [Js As 6h 9h] [Qd]
goblind4777: bets $61.53 and is all-in
sanpidk: calls $59.10 and is all-in
Uncalled bet ($2.43) returned to goblind4777
*** SHOW DOWN ***
goblind4777: shows [Ah Tc] (a pair of Aces)
sanpidk: shows [Ac Jc] (two pair, Aces and Jacks)
sanpidk collected $197.70 from pot
*** SUMMARY ***
Total pot $200.50 | Rake $2.80 
Board [Js As 6h 9h Qd]
Seat 1: taraisai folded before Flop (didn't bet)
Seat 2: matiko09 folded before Flop (didn't bet)
Seat 3: nickreason17 folded before Flop (didn't bet)
Seat 4: sanpidk showed [Ac Jc] and won ($197.70) with two pair, Aces and Jacks
Seat 5: Igor DoUrden folded before Flop (didn't bet)
Seat 6: I The King I folded before Flop (didn't bet)
Seat 7: Sesamesnap (button) folded before Flop (didn't bet)
Seat 8: maxxmeister (small blind) folded before Flop
Seat 9: goblind4777 (big blind) showed [Ah Tc] and lost with a pair of Aces





PokerStars Hand #148218356301:  Hold'em No Limit ($0.50/$1.00 USD) - 2016/02/04 15:01:30 CET [2016/02/04 9:01:30 ET]
Table 'Arneb II' 9-max Seat #3 is the button
Seat 1: matiko09 ($100 in chips) 
Seat 2: sanpidk ($195.96 in chips) 
Seat 3: brille-390 ($100 in chips) 
Seat 4: Venomous100% ($128.55 in chips) 
Seat 5: lixiangli ($79.27 in chips) 
Seat 7: melitakas ($262.01 in chips) 
Seat 9: tipner ($118.74 in chips) 
Venomous100%: posts small blind $0.50
lixiangli: posts big blind $1
*** HOLE CARDS ***
Dealt to matiko09 [6d 8d]
melitakas: folds 
tipner: folds 
matiko09: folds 
sanpidk: raises $1.50 to $2.50
brille-390: folds 
Venomous100%: folds 
lixiangli: folds 
Uncalled bet ($1.50) returned to sanpidk
sanpidk collected $2.50 from pot
sanpidk: doesn't show hand 
*** SUMMARY ***
Total pot $2.50 | Rake $0 
Seat 1: matiko09 folded before Flop (didn't bet)
Seat 2: sanpidk collected ($2.50)
Seat 3: brille-390 (button) folded before Flop (didn't bet)
Seat 4: Venomous100% (small blind) folded before Flop
Seat 5: lixiangli (big blind) folded before Flop
Seat 7: melitakas folded before Flop (didn't bet)
Seat 9: tipner folded before Flop (didn't bet)





PokerStars Hand #148218360817:  Hold'em No Limit ($0.50/$1.00 USD) - 2016/02/04 15:01:37 CET [2016/02/04 9:01:37 ET]
Table 'Alkaid II' 9-max Seat #7 is the button
Seat 2: xxxZeka ($106.28 in chips) 
Seat 3: 1557PSS ($38.63 in chips) 
Seat 4: sanpidk ($106.88 in chips) 
Seat 5: I The King I ($146.24 in chips) 
Seat 6: matiko09 ($100 in chips) 
Seat 7: tipner ($100 in chips) 
Seat 8: yourpro ($120.66 in chips) 
Seat 9: tjl290 ($49.58 in chips) 
yourpro: posts small blind $0.50
tjl290: posts big blind $1
*** HOLE CARDS ***
Dealt to matiko09 [7h 3h]
xxxZeka: folds 
1557PSS: folds 
sanpidk: folds 
I The King I: raises $2 to $3
matiko09: folds 
tipner: folds 
yourpro: folds 
tjl290: folds 
Uncalled bet ($2) returned to I The King I
I The King I collected $2.50 from pot
I The King I: doesn't show hand 
*** SUMMARY ***
Total pot $2.50 | Rake $0 
Seat 2: xxxZeka folded before Flop (didn't bet)
Seat 3: 1557PSS folded before Flop (didn't bet)
Seat 4: sanpidk folded before Flop (didn't bet)
Seat 5: I The King I collected ($2.50)
Seat 6: matiko09 folded before Flop (didn't bet)
Seat 7: tipner (button) folded before Flop (didn't bet)
Seat 8: yourpro (small blind) folded before Flop
Seat 9: tjl290 (big blind) folded before Flop





PokerStars Hand #148218366449:  Hold'em No Limit ($0.50/$1.00 USD) - 2016/02/04 15:01:46 CET [2016/02/04 9:01:46 ET]
Table 'Asios III' 9-max Seat #5 is the button
Seat 1: yourpro ($138.41 in chips) 
Seat 2: crime8783 ($42.66 in chips) 
Seat 3: Igor DoUrden ($105.53 in chips) 
Seat 4: TimStone ($100 in chips) 
Seat 5: ilaviiitech ($152.65 in chips) 
Seat 6: matiko09 ($120 in chips) 
Seat 7: nickreason17 ($153.25 in chips) 
Seat 9: Vikulja1993 ($158.70 in chips) 
matiko09: posts small blind $0.50
nickreason17: posts big blind $1
*** HOLE CARDS ***
Dealt to matiko09 [2d 5s]
Vikulja1993: folds 
yourpro: raises $1.87 to $2.87
crime8783: folds 
Igor DoUrden: folds 
TimStone: folds 
ilaviiitech: folds 
matiko09: folds 
nickreason17: folds 
Uncalled bet ($1.87) returned to yourpro
yourpro collected $2.50 from pot
yourpro: doesn't show hand 
*** SUMMARY ***
Total pot $2.50 | Rake $0 
Seat 1: yourpro collected ($2.50)
Seat 2: crime8783 folded before Flop (didn't bet)
Seat 3: Igor DoUrden folded before Flop (didn't bet)
Seat 4: TimStone folded before Flop (didn't bet)
Seat 5: ilaviiitech (button) folded before Flop (didn't bet)
Seat 6: matiko09 (small blind) folded before Flop
Seat 7: nickreason17 (big blind) folded before Flop
Seat 9: Vikulja1993 folded before Flop (didn't bet)





PokerStars Hand #148218368624:  Hold'em No Limit ($0.50/$1.00 USD) - 2016/02/04 15:01:49 CET [2016/02/04 9:01:49 ET]
Table 'Arneb III' 9-max Seat #1 is the button
Seat 1: Vikulja1993 ($100 in chips) 
Seat 2: JeanLima93 ($216.10 in chips) 
Seat 3: matiko09 ($100 in chips) 
Seat 4: Igor DoUrden ($228.81 in chips) 
Seat 5: tipner ($100 in chips) 
Seat 6: nickreason17 ($119.32 in chips) 
Seat 7: Spid1 ($103.54 in chips) 
Seat 8: volwebni4ek ($40 in chips) 
Seat 9: ARTVOR640 ($100 in chips) 
JeanLima93: posts small blind $0.50
matiko09: posts big blind $1
*** HOLE CARDS ***
Dealt to matiko09 [2c 3s]
Igor DoUrden: folds 
tipner: folds 
nickreason17: folds 
Spid1: raises $2 to $3
volwebni4ek: folds 
ARTVOR640: folds 
Vikulja1993: folds 
JeanLima93: calls $2.50
matiko09: folds 
*** FLOP *** [2h 8c 4s]
JeanLima93: checks 
Spid1: bets $5.50
JeanLima93: folds 
Uncalled bet ($5.50) returned to Spid1
Spid1 collected $6.68 from pot
Spid1: doesn't show hand 
*** SUMMARY ***
Total pot $7 | Rake $0.32 
Board [2h 8c 4s]
Seat 1: Vikulja1993 (button) folded before Flop (didn't bet)
Seat 2: JeanLima93 (small blind) folded on the Flop
Seat 3: matiko09 (big blind) folded before Flop
Seat 4: Igor DoUrden folded before Flop (didn't bet)
Seat 5: tipner folded before Flop (didn't bet)
Seat 6: nickreason17 folded before Flop (didn't bet)
Seat 7: Spid1 collected ($6.68)
Seat 8: volwebni4ek folded before Flop (didn't bet)
Seat 9: ARTVOR640 folded before Flop (didn't bet)





PokerStars Hand #148218377101:  Hold'em No Limit ($0.50/$1.00 USD) - 2016/02/04 15:02:02 CET [2016/02/04 9:02:02 ET]
Table 'Arneb II' 9-max Seat #4 is the button
Seat 1: matiko09 ($100 in chips) 
Seat 2: sanpidk ($197.46 in chips) 
Seat 3: brille-390 ($100 in chips) 
Seat 4: Venomous100% ($128.05 in chips) 
Seat 5: lixiangli ($78.27 in chips) 
Seat 7: melitakas ($262.01 in chips) 
Seat 9: tipner ($118.74 in chips) 
lixiangli: posts small blind $0.50
melitakas: posts big blind $1
*** HOLE CARDS ***
Dealt to matiko09 [8d Th]
tipner: folds 
matiko09: folds 
sanpidk: raises $1.50 to $2.50
brille-390: calls $2.50
Venomous100%: folds 
lixiangli: folds 
melitakas: raises $3.50 to $6
sanpidk: raises $11 to $17
brille-390: folds 
melitakas: calls $11
*** FLOP *** [4h 6s 7s]
melitakas: checks 
sanpidk: bets $25.05
melitakas: folds 
Uncalled bet ($25.05) returned to sanpidk
sanpidk collected $35.34 from pot
sanpidk: doesn't show hand 
*** SUMMARY ***
Total pot $37 | Rake $1.66 
Board [4h 6s 7s]
Seat 1: matiko09 folded before Flop (didn't bet)
Seat 2: sanpidk collected ($35.34)
Seat 3: brille-390 folded before Flop
Seat 4: Venomous100% (button) folded before Flop (didn't bet)
Seat 5: lixiangli (small blind) folded before Flop
Seat 7: melitakas (big blind) folded on the Flop
Seat 9: tipner folded before Flop (didn't bet)





PokerStars Hand #148218385520:  Hold'em No Limit ($0.50/$1.00 USD) - 2016/02/04 15:02:14 CET [2016/02/04 9:02:14 ET]
Table 'Alkaid II' 9-max Seat #8 is the button
Seat 2: xxxZeka ($106.28 in chips) 
Seat 3: 1557PSS ($38.63 in chips) 
Seat 4: sanpidk ($106.88 in chips) 
Seat 5: I The King I ($147.74 in chips) 
Seat 6: matiko09 ($100 in chips) 
Seat 7: tipner ($100 in chips) 
Seat 8: yourpro ($120.16 in chips) 
Seat 9: tjl290 ($48.58 in chips) 
tjl290: posts small blind $0.50
xxxZeka: posts big blind $1
*** HOLE CARDS ***
Dealt to matiko09 [3s Td]
1557PSS: folds 
sanpidk: folds 
I The King I: folds 
matiko09: folds 
tipner: folds 
yourpro: folds 
tjl290: calls $0.50
xxxZeka: checks 
*** FLOP *** [Jc Jd As]
tjl290: checks 
xxxZeka: checks 
*** TURN *** [Jc Jd As] [8c]
tjl290: bets $2
xxxZeka: folds 
Uncalled bet ($2) returned to tjl290
tjl290 collected $1.91 from pot
*** SUMMARY ***
Total pot $2 | Rake $0.09 
Board [Jc Jd As 8c]
Seat 2: xxxZeka (big blind) folded on the Turn
Seat 3: 1557PSS folded before Flop (didn't bet)
Seat 4: sanpidk folded before Flop (didn't bet)
Seat 5: I The King I folded before Flop (didn't bet)
Seat 6: matiko09 folded before Flop (didn't bet)
Seat 7: tipner folded before Flop (didn't bet)
Seat 8: yourpro (button) folded before Flop (didn't bet)
Seat 9: tjl290 (small blind) collected ($1.91)





PokerStars Hand #148218403475:  Hold'em No Limit ($0.50/$1.00 USD) - 2016/02/04 15:02:40 CET [2016/02/04 9:02:40 ET]
Table 'Asios III' 9-max Seat #6 is the button
Seat 1: yourpro ($139.91 in chips) 
Seat 2: crime8783 ($42.66 in chips) 
Seat 3: Igor DoUrden ($105.53 in chips) 
Seat 4: TimStone ($100 in chips) 
Seat 5: ilaviiitech ($152.65 in chips) 
Seat 6: matiko09 ($119.50 in chips) 
Seat 7: nickreason17 ($152.25 in chips) 
Seat 9: Vikulja1993 ($158.70 in chips) 
nickreason17: posts small blind $0.50
Vikulja1993: posts big blind $1
*** HOLE CARDS ***
Dealt to matiko09 [9c 5h]
yourpro: folds 
crime8783: calls $1
Igor DoUrden: folds 
TimStone: folds 
ilaviiitech: folds 
matiko09: folds 
nickreason17: calls $0.50
Vikulja1993: checks 
*** FLOP *** [Ac 9d 5d]
nickreason17: checks 
Vikulja1993: checks 
crime8783: checks 
*** TURN *** [Ac 9d 5d] [7c]
nickreason17: bets $2
Vikulja1993: folds 
crime8783: folds 
Uncalled bet ($2) returned to nickreason17
nickreason17 collected $2.86 from pot
*** SUMMARY ***
Total pot $3 | Rake $0.14 
Board [Ac 9d 5d 7c]
Seat 1: yourpro folded before Flop (didn't bet)
Seat 2: crime8783 folded on the Turn
Seat 3: Igor DoUrden folded before Flop (didn't bet)
Seat 4: TimStone folded before Flop (didn't bet)
Seat 5: ilaviiitech folded before Flop (didn't bet)
Seat 6: matiko09 (button) folded before Flop (didn't bet)
Seat 7: nickreason17 (small blind) collected ($2.86)
Seat 9: Vikulja1993 (big blind) folded on the Turn





PokerStars Hand #148218413520:  Hold'em No Limit ($0.50/$1.00 USD) - 2016/02/04 15:02:53 CET [2016/02/04 9:02:53 ET]
Table 'Arneb III' 9-max Seat #2 is the button
Seat 1: Vikulja1993 ($100 in chips) 
Seat 2: JeanLima93 ($213.10 in chips) 
Seat 3: matiko09 ($100 in chips) 
Seat 4: Igor DoUrden ($228.81 in chips) 
Seat 5: tipner ($100 in chips) 
Seat 6: nickreason17 ($119.32 in chips) 
Seat 7: Spid1 ($107.22 in chips) 
Seat 8: volwebni4ek ($40 in chips) 
Seat 9: ARTVOR640 ($100 in chips) 
matiko09: posts small blind $0.50
Igor DoUrden: posts big blind $1
*** HOLE CARDS ***
Dealt to matiko09 [Qd 6c]
tipner: folds 
nickreason17: folds 
Spid1: folds 
volwebni4ek: folds 
ARTVOR640: folds 
Vikulja1993: folds 
JeanLima93: folds 
matiko09: folds 
Uncalled bet ($0.50) returned to Igor DoUrden
Igor DoUrden collected $1 from pot
Igor DoUrden: doesn't show hand 
*** SUMMARY ***
Total pot $1 | Rake $0 
Seat 1: Vikulja1993 folded before Flop (didn't bet)
Seat 2: JeanLima93 (button) folded before Flop (didn't bet)
Seat 3: matiko09 (small blind) folded before Flop
Seat 4: Igor DoUrden (big blind) collected ($1)
Seat 5: tipner folded before Flop (didn't bet)
Seat 6: nickreason17 folded before Flop (didn't bet)
Seat 7: Spid1 folded before Flop (didn't bet)
Seat 8: volwebni4ek folded before Flop (didn't bet)
Seat 9: ARTVOR640 folded before Flop (didn't bet)





PokerStars Hand #148218422882:  Hold'em No Limit ($0.50/$1.00 USD) - 2016/02/04 15:03:07 CET [2016/02/04 9:03:07 ET]
Table 'Arneb III' 9-max Seat #3 is the button
Seat 1: Vikulja1993 ($100 in chips) 
Seat 3: matiko09 ($100 in chips) 
Seat 4: Igor DoUrden ($229.31 in chips) 
Seat 5: tipner ($100 in chips) 
Seat 6: nickreason17 ($119.32 in chips) 
Seat 7: Spid1 ($107.22 in chips) 
Seat 8: volwebni4ek ($40 in chips) 
Seat 9: ARTVOR640 ($100 in chips) 
Igor DoUrden: posts small blind $0.50
tipner: posts big blind $1
*** HOLE CARDS ***
Dealt to matiko09 [5d 2s]
nickreason17: folds 
Spid1: folds 
volwebni4ek: folds 
ARTVOR640: folds 
Vikulja1993: folds 
matiko09: folds 
Igor DoUrden: raises $2.09 to $3.09
tipner: calls $2.09
*** FLOP *** [Jh Ad 7s]
Igor DoUrden: checks 
tipner: bets $3
Igor DoUrden: calls $3
*** TURN *** [Jh Ad 7s] [5h]
Igor DoUrden: checks 
tipner: bets $6
Igor DoUrden: raises $22 to $28
tipner: folds 
Uncalled bet ($22) returned to Igor DoUrden
Igor DoUrden collected $23.09 from pot
Igor DoUrden: doesn't show hand 
*** SUMMARY ***
Total pot $24.18 | Rake $1.09 
Board [Jh Ad 7s 5h]
Seat 1: Vikulja1993 folded before Flop (didn't bet)
Seat 3: matiko09 (button) folded before Flop (didn't bet)
Seat 4: Igor DoUrden (small blind) collected ($23.09)
Seat 5: tipner (big blind) folded on the Turn
Seat 6: nickreason17 folded before Flop (didn't bet)
Seat 7: Spid1 folded before Flop (didn't bet)
Seat 8: volwebni4ek folded before Flop (didn't bet)
Seat 9: ARTVOR640 folded before Flop (didn't bet)





PokerStars Hand #148218423384:  Hold'em No Limit ($0.50/$1.00 USD) - 2016/02/04 15:03:08 CET [2016/02/04 9:03:08 ET]
Table 'Alkaid II' 9-max Seat #9 is the button
Seat 2: xxxZeka ($105.28 in chips) 
Seat 3: 1557PSS ($38.63 in chips) 
Seat 4: sanpidk ($106.88 in chips) 
Seat 5: I The King I ($147.74 in chips) 
Seat 6: matiko09 ($100 in chips) 
Seat 7: tipner ($100 in chips) 
Seat 8: yourpro ($120.16 in chips) 
Seat 9: tjl290 ($49.49 in chips) 
xxxZeka: posts small blind $0.50
1557PSS: posts big blind $1
*** HOLE CARDS ***
Dealt to matiko09 [2c Jd]
sanpidk: folds 
I The King I: folds 
matiko09: folds 
tipner: folds 
yourpro: raises $1.41 to $2.41
tjl290: folds 
xxxZeka: folds 
1557PSS: calls $1.41
*** FLOP *** [Ah 5c Jh]
1557PSS: checks 
yourpro: bets $3.40
1557PSS: folds 
Uncalled bet ($3.40) returned to yourpro
yourpro collected $5.08 from pot
yourpro: doesn't show hand 
*** SUMMARY ***
Total pot $5.32 | Rake $0.24 
Board [Ah 5c Jh]
Seat 2: xxxZeka (small blind) folded before Flop
Seat 3: 1557PSS (big blind) folded on the Flop
Seat 4: sanpidk folded before Flop (didn't bet)
Seat 5: I The King I folded before Flop (didn't bet)
Seat 6: matiko09 folded before Flop (didn't bet)
Seat 7: tipner folded before Flop (didn't bet)
Seat 8: yourpro collected ($5.08)
Seat 9: tjl290 (button) folded before Flop (didn't bet)





PokerStars Hand #148218442072:  Hold'em No Limit ($0.50/$1.00 USD) - 2016/02/04 15:03:34 CET [2016/02/04 9:03:34 ET]
Table 'Asios III' 9-max Seat #7 is the button
Seat 1: yourpro ($139.91 in chips) 
Seat 2: crime8783 ($41.66 in chips) 
Seat 3: Igor DoUrden ($105.53 in chips) 
Seat 4: TimStone ($100 in chips) 
Seat 5: ilaviiitech ($152.65 in chips) 
Seat 6: matiko09 ($119.50 in chips) 
Seat 7: nickreason17 ($154.11 in chips) 
Seat 9: Vikulja1993 ($157.70 in chips) 
Vikulja1993: posts small blind $0.50
yourpro: posts big blind $1
*** HOLE CARDS ***
Dealt to matiko09 [3h 4h]
crime8783: folds 
Igor DoUrden: folds 
TimStone: folds 
ilaviiitech: folds 
matiko09: folds 
nickreason17: folds 
Vikulja1993: raises $1.50 to $2.50
yourpro: folds 
Uncalled bet ($1.50) returned to Vikulja1993
Vikulja1993 collected $2 from pot
Vikulja1993: doesn't show hand 
*** SUMMARY ***
Total pot $2 | Rake $0 
Seat 1: yourpro (big blind) folded before Flop
Seat 2: crime8783 folded before Flop (didn't bet)
Seat 3: Igor DoUrden folded before Flop (didn't bet)
Seat 4: TimStone folded before Flop (didn't bet)
Seat 5: ilaviiitech folded before Flop (didn't bet)
Seat 6: matiko09 folded before Flop (didn't bet)
Seat 7: nickreason17 (button) folded before Flop (didn't bet)
Seat 9: Vikulja1993 (small blind) collected ($2)





PokerStars Hand #148218444582:  Hold'em No Limit ($0.50/$1.00 USD) - 2016/02/04 15:03:38 CET [2016/02/04 9:03:38 ET]
Table 'Arneb II' 9-max Seat #5 is the button
Seat 1: matiko09 ($100 in chips) 
Seat 2: sanpidk ($215.80 in chips) 
Seat 3: brille-390 ($100 in chips) 
Seat 4: Venomous100% ($128.05 in chips) 
Seat 5: lixiangli ($77.77 in chips) 
Seat 7: melitakas ($245.01 in chips) 
Seat 9: tipner ($118.74 in chips) 
melitakas: posts small blind $0.50
tipner: posts big blind $1
*** HOLE CARDS ***
Dealt to matiko09 [9d Qd]
matiko09: folds 
sanpidk: folds 
brille-390: raises $1.25 to $2.25
Venomous100%: folds 
lixiangli: folds 
melitakas: folds 
tipner: folds 
Uncalled bet ($1.25) returned to brille-390
brille-390 collected $2.50 from pot
brille-390: doesn't show hand 
*** SUMMARY ***
Total pot $2.50 | Rake $0 
Seat 1: matiko09 folded before Flop (didn't bet)
Seat 2: sanpidk folded before Flop (didn't bet)
Seat 3: brille-390 collected ($2.50)
Seat 4: Venomous100% folded before Flop (didn't bet)
Seat 5: lixiangli (button) folded before Flop (didn't bet)
Seat 7: melitakas (small blind) folded before Flop
Seat 9: tipner (big blind) folded before Flop





PokerStars Hand #148218453516:  Hold'em No Limit ($0.50/$1.00 USD) - 2016/02/04 15:03:50 CET [2016/02/04 9:03:50 ET]
Table 'Siarnaq' 9-max Seat #8 is the button
Seat 2: matiko09 ($100 in chips) 
Seat 3: nickreason17 ($101.50 in chips) 
Seat 4: sanpidk ($197.70 in chips) 
Seat 5: Igor DoUrden ($108.54 in chips) 
Seat 6: I The King I ($100 in chips) 
Seat 7: Sesamesnap ($58.77 in chips) 
Seat 8: maxxmeister ($100 in chips) 
Seat 9: goblind4777 ($2.43 in chips) 
goblind4777: posts small blind $0.50
matiko09: posts big blind $1
*** HOLE CARDS ***
Dealt to matiko09 [9s 4c]
nickreason17: folds 
sanpidk: folds 
Igor DoUrden: folds 
I The King I: raises $2 to $3
Sesamesnap: folds 
maxxmeister: folds 
goblind4777: folds 
matiko09: folds 
Uncalled bet ($2) returned to I The King I
goblind4777 leaves the table
I The King I collected $2.50 from pot
I The King I: doesn't show hand 
*** SUMMARY ***
Total pot $2.50 | Rake $0 
Seat 2: matiko09 (big blind) folded before Flop
Seat 3: nickreason17 folded before Flop (didn't bet)
Seat 4: sanpidk folded before Flop (didn't bet)
Seat 5: Igor DoUrden folded before Flop (didn't bet)
Seat 6: I The King I collected ($2.50)
Seat 7: Sesamesnap folded before Flop (didn't bet)
Seat 8: maxxmeister (button) folded before Flop (didn't bet)
Seat 9: goblind4777 (small blind) folded before Flop





PokerStars Hand #148218462788:  Hold'em No Limit ($0.50/$1.00 USD) - 2016/02/04 15:04:03 CET [2016/02/04 9:04:03 ET]
Table 'Arneb II' 9-max Seat #7 is the button
Seat 1: matiko09 ($100 in chips) 
Seat 2: sanpidk ($215.80 in chips) 
Seat 3: brille-390 ($101.50 in chips) 
Seat 4: Venomous100% ($128.05 in chips) 
Seat 5: lixiangli ($77.77 in chips) 
Seat 7: melitakas ($244.51 in chips) 
Seat 9: tipner ($117.74 in chips) 
tipner: posts small blind $0.50
matiko09: posts big blind $1
*** HOLE CARDS ***
Dealt to matiko09 [Tc Qd]
sanpidk: folds 
brille-390: folds 
Venomous100%: folds 
lixiangli: folds 
melitakas: folds 
tipner: folds 
Uncalled bet ($0.50) returned to matiko09
matiko09 collected $1 from pot
matiko09: doesn't show hand 
*** SUMMARY ***
Total pot $1 | Rake $0 
Seat 1: matiko09 (big blind) collected ($1)
Seat 2: sanpidk folded before Flop (didn't bet)
Seat 3: brille-390 folded before Flop (didn't bet)
Seat 4: Venomous100% folded before Flop (didn't bet)
Seat 5: lixiangli folded before Flop (didn't bet)
Seat 7: melitakas (button) folded before Flop (didn't bet)
Seat 9: tipner (small blind) folded before Flop





PokerStars Hand #148218465973:  Hold'em No Limit ($0.50/$1.00 USD) - 2016/02/04 15:04:08 CET [2016/02/04 9:04:08 ET]
Table 'Alkaid II' 9-max Seat #2 is the button
Seat 2: xxxZeka ($104.78 in chips) 
Seat 3: 1557PSS ($36.22 in chips) 
Seat 4: sanpidk ($106.88 in chips) 
Seat 5: I The King I ($147.74 in chips) 
Seat 6: matiko09 ($100 in chips) 
Seat 7: tipner ($100 in chips) 
Seat 8: yourpro ($122.83 in chips) 
Seat 9: tjl290 ($49.49 in chips) 
1557PSS: posts small blind $0.50
sanpidk: posts big blind $1
*** HOLE CARDS ***
Dealt to matiko09 [Ah Kd]
I The King I: folds 
matiko09: raises $2 to $3
tipner: folds 
yourpro: folds 
tjl290: folds 
xxxZeka: folds 
1557PSS: calls $2.50
sanpidk: folds 
*** FLOP *** [9h 3s 2h]
1557PSS: checks 
matiko09: bets $4.34
1557PSS: folds 
Uncalled bet ($4.34) returned to matiko09
matiko09 collected $6.68 from pot
matiko09: doesn't show hand 
*** SUMMARY ***
Total pot $7 | Rake $0.32 
Board [9h 3s 2h]
Seat 2: xxxZeka (button) folded before Flop (didn't bet)
Seat 3: 1557PSS (small blind) folded on the Flop
Seat 4: sanpidk (big blind) folded before Flop
Seat 5: I The King I folded before Flop (didn't bet)
Seat 6: matiko09 collected ($6.68)
Seat 7: tipner folded before Flop (didn't bet)
Seat 8: yourpro folded before Flop (didn't bet)
Seat 9: tjl290 folded before Flop (didn't bet)





PokerStars Hand #148218468163:  Hold'em No Limit ($0.50/$1.00 USD) - 2016/02/04 15:04:11 CET [2016/02/04 9:04:11 ET]
Table 'Asios III' 9-max Seat #9 is the button
Seat 1: yourpro ($138.91 in chips) 
Seat 2: crime8783 ($41.66 in chips) 
Seat 3: Igor DoUrden ($105.53 in chips) 
Seat 4: TimStone ($100 in chips) 
Seat 5: ilaviiitech ($152.65 in chips) 
Seat 6: matiko09 ($119.50 in chips) 
Seat 7: nickreason17 ($154.11 in chips) 
Seat 9: Vikulja1993 ($158.70 in chips) 
yourpro: posts small blind $0.50
crime8783: posts big blind $1
*** HOLE CARDS ***
Dealt to matiko09 [7c Ts]
Igor DoUrden: folds 
TimStone: folds 
ilaviiitech: folds 
matiko09: folds 
nickreason17: folds 
Vikulja1993: folds 
yourpro: raises $1.41 to $2.41
crime8783: calls $1.41
*** FLOP *** [6c Qs 4c]
yourpro: checks 
crime8783: checks 
*** TURN *** [6c Qs 4c] [3s]
yourpro: checks 
crime8783: checks 
*** RIVER *** [6c Qs 4c 3s] [2s]
yourpro: checks 
crime8783: checks 
*** SHOW DOWN ***
yourpro: shows [Tc Kd] (high card King)
crime8783: shows [Js 3h] (a pair of Threes)
crime8783 collected $4.60 from pot
*** SUMMARY ***
Total pot $4.82 | Rake $0.22 
Board [6c Qs 4c 3s 2s]
Seat 1: yourpro (small blind) showed [Tc Kd] and lost with high card King
Seat 2: crime8783 (big blind) showed [Js 3h] and won ($4.60) with a pair of Threes
Seat 3: Igor DoUrden folded before Flop (didn't bet)
Seat 4: TimStone folded before Flop (didn't bet)
Seat 5: ilaviiitech folded before Flop (didn't bet)
Seat 6: matiko09 folded before Flop (didn't bet)
Seat 7: nickreason17 folded before Flop (didn't bet)
Seat 9: Vikulja1993 (button) folded before Flop (didn't bet)





PokerStars Hand #148218479856:  Hold'em No Limit ($0.50/$1.00 USD) - 2016/02/04 15:04:27 CET [2016/02/04 9:04:27 ET]
Table 'Arneb III' 9-max Seat #4 is the button
Seat 1: Vikulja1993 ($100 in chips) 
Seat 3: matiko09 ($100 in chips) 
Seat 4: Igor DoUrden ($240.31 in chips) 
Seat 5: tipner ($100 in chips) 
Seat 6: nickreason17 ($119.32 in chips) 
Seat 7: Spid1 ($107.22 in chips) 
Seat 8: volwebni4ek ($40 in chips) 
Seat 9: ARTVOR640 ($100 in chips) 
tipner: posts small blind $0.50
nickreason17: posts big blind $1
*** HOLE CARDS ***
Dealt to matiko09 [3h 2c]
Spid1: folds 
volwebni4ek: folds 
ARTVOR640: folds 
Vikulja1993: folds 
matiko09: folds 
Igor DoUrden: folds 
tipner: raises $2 to $3
nickreason17: folds 
Uncalled bet ($2) returned to tipner
tipner collected $2 from pot
tipner: doesn't show hand 
*** SUMMARY ***
Total pot $2 | Rake $0 
Seat 1: Vikulja1993 folded before Flop (didn't bet)
Seat 3: matiko09 folded before Flop (didn't bet)
Seat 4: Igor DoUrden (button) folded before Flop (didn't bet)
Seat 5: tipner (small blind) collected ($2)
Seat 6: nickreason17 (big blind) folded before Flop
Seat 7: Spid1 folded before Flop (didn't bet)
Seat 8: volwebni4ek folded before Flop (didn't bet)
Seat 9: ARTVOR640 folded before Flop (didn't bet)





PokerStars Hand #148218483472:  Hold'em No Limit ($0.50/$1.00 USD) - 2016/02/04 15:04:32 CET [2016/02/04 9:04:32 ET]
Table 'Siarnaq' 9-max Seat #2 is the button
Seat 2: matiko09 ($100 in chips) 
Seat 3: nickreason17 ($101.50 in chips) 
Seat 4: sanpidk ($197.70 in chips) 
Seat 5: Igor DoUrden ($108.54 in chips) 
Seat 6: I The King I ($101.50 in chips) 
Seat 7: Sesamesnap ($58.77 in chips) 
Seat 8: maxxmeister ($100 in chips) 
vicdroopy joins the table at seat #9 
nickreason17: posts small blind $0.50
sanpidk: posts big blind $1
*** HOLE CARDS ***
Dealt to matiko09 [As 5d]
Igor DoUrden: folds 
I The King I: folds 
Sesamesnap: raises $2 to $3
maxxmeister: folds 
matiko09: folds 
nickreason17: folds 
sanpidk: folds 
Uncalled bet ($2) returned to Sesamesnap
Sesamesnap collected $2.50 from pot
Sesamesnap: doesn't show hand 
*** SUMMARY ***
Total pot $2.50 | Rake $0 
Seat 2: matiko09 (button) folded before Flop (didn't bet)
Seat 3: nickreason17 (small blind) folded before Flop
Seat 4: sanpidk (big blind) folded before Flop
Seat 5: Igor DoUrden folded before Flop (didn't bet)
Seat 6: I The King I folded before Flop (didn't bet)
Seat 7: Sesamesnap collected ($2.50)
Seat 8: maxxmeister folded before Flop (didn't bet)





PokerStars Hand #148218487263:  Hold'em No Limit ($0.50/$1.00 USD) - 2016/02/04 15:04:37 CET [2016/02/04 9:04:37 ET]
Table 'Arneb II' 9-max Seat #9 is the button
Seat 1: matiko09 ($100.50 in chips) 
Seat 2: sanpidk ($215.80 in chips) 
Seat 3: brille-390 ($101.50 in chips) 
Seat 4: Venomous100% ($128.05 in chips) 
Seat 5: lixiangli ($77.77 in chips) 
Seat 7: melitakas ($244.51 in chips) 
Seat 9: tipner ($117.24 in chips) 
matiko09: posts small blind $0.50
sanpidk: posts big blind $1
*** HOLE CARDS ***
Dealt to matiko09 [Ac Qd]
brille-390: folds 
Venomous100%: folds 
lixiangli: folds 
melitakas: raises $1 to $2
tipner: folds 
matiko09: raises $6 to $8
sanpidk: folds 
melitakas: raises $10 to $18
matiko09: folds 
Uncalled bet ($10) returned to melitakas
melitakas collected $17 from pot
*** SUMMARY ***
Total pot $17 | Rake $0 
Seat 1: matiko09 (small blind) folded before Flop
Seat 2: sanpidk (big blind) folded before Flop
Seat 3: brille-390 folded before Flop (didn't bet)
Seat 4: Venomous100% folded before Flop (didn't bet)
Seat 5: lixiangli folded before Flop (didn't bet)
Seat 7: melitakas collected ($17)
Seat 9: tipner (button) folded before Flop (didn't bet)





PokerStars Hand #148218499223:  Hold'em No Limit ($0.50/$1.00 USD) - 2016/02/04 15:04:54 CET [2016/02/04 9:04:54 ET]
Table 'Siarnaq' 9-max Seat #3 is the button
Seat 2: matiko09 ($100 in chips) 
Seat 3: nickreason17 ($101 in chips) 
Seat 4: sanpidk ($196.70 in chips) 
Seat 5: Igor DoUrden ($108.54 in chips) 
Seat 6: I The King I ($101.50 in chips) 
Seat 7: Sesamesnap ($60.27 in chips) 
Seat 8: maxxmeister ($100 in chips) 
sanpidk: posts small blind $0.50
Igor DoUrden: posts big blind $1
vicdroopy: sits out 
*** HOLE CARDS ***
Dealt to matiko09 [9c 4s]
I The King I: folds 
I The King I leaves the table
Sesamesnap: raises $2 to $3
maxxmeister: folds 
yourpro joins the table at seat #6 
matiko09: folds 
nickreason17: folds 
sanpidk: folds 
Igor DoUrden: calls $2
*** FLOP *** [4c 9h 2s]
Igor DoUrden: checks 
Sesamesnap: checks 
*** TURN *** [4c 9h 2s] [6h]
Igor DoUrden: checks 
Sesamesnap: bets $4.14
Igor DoUrden: folds 
Uncalled bet ($4.14) returned to Sesamesnap
Sesamesnap collected $6.21 from pot
Sesamesnap: doesn't show hand 
*** SUMMARY ***
Total pot $6.50 | Rake $0.29 
Board [4c 9h 2s 6h]
Seat 2: matiko09 folded before Flop (didn't bet)
Seat 3: nickreason17 (button) folded before Flop (didn't bet)
Seat 4: sanpidk (small blind) folded before Flop
Seat 5: Igor DoUrden (big blind) folded on the Turn
Seat 6: I The King I folded before Flop (didn't bet)
Seat 7: Sesamesnap collected ($6.21)
Seat 8: maxxmeister folded before Flop (didn't bet)





PokerStars Hand #148218504565:  Hold'em No Limit ($0.50/$1.00 USD) - 2016/02/04 15:05:01 CET [2016/02/04 9:05:01 ET]
Table 'Arneb III' 9-max Seat #5 is the button
Seat 1: Vikulja1993 ($100 in chips) 
Seat 2: JeanLima93 ($213.10 in chips) 
Seat 3: matiko09 ($100 in chips) 
Seat 4: Igor DoUrden ($240.31 in chips) 
Seat 5: tipner ($101 in chips) 
Seat 6: nickreason17 ($118.32 in chips) 
Seat 7: Spid1 ($107.22 in chips) 
Seat 8: volwebni4ek ($40 in chips) 
Seat 9: ARTVOR640 ($100 in chips) 
nickreason17: posts small blind $0.50
Spid1: posts big blind $1
*** HOLE CARDS ***
Dealt to matiko09 [Kc Qh]
volwebni4ek: folds 
ARTVOR640: folds 
Vikulja1993: folds 
JeanLima93: calls $1
matiko09: raises $3 to $4
Igor DoUrden: folds 
tipner: folds 
nickreason17: folds 
Spid1: calls $3
JeanLima93: calls $3
*** FLOP *** [2d Ks Jh]
Spid1: checks 
JeanLima93: checks 
matiko09: bets $7.76
Spid1: folds 
JeanLima93: folds 
Uncalled bet ($7.76) returned to matiko09
matiko09 collected $11.94 from pot
matiko09: doesn't show hand 
*** SUMMARY ***
Total pot $12.50 | Rake $0.56 
Board [2d Ks Jh]
Seat 1: Vikulja1993 folded before Flop (didn't bet)
Seat 2: JeanLima93 folded on the Flop
Seat 3: matiko09 collected ($11.94)
Seat 4: Igor DoUrden folded before Flop (didn't bet)
Seat 5: tipner (button) folded before Flop (didn't bet)
Seat 6: nickreason17 (small blind) folded before Flop
Seat 7: Spid1 (big blind) folded on the Flop
Seat 8: volwebni4ek folded before Flop (didn't bet)
Seat 9: ARTVOR640 folded before Flop (didn't bet)





PokerStars Hand #148218507886:  Hold'em No Limit ($0.50/$1.00 USD) - 2016/02/04 15:05:06 CET [2016/02/04 9:05:06 ET]
Table 'Alkaid II' 9-max Seat #3 is the button
Seat 3: 1557PSS ($33.22 in chips) 
Seat 4: sanpidk ($105.88 in chips) 
Seat 5: I The King I ($147.74 in chips) 
Seat 6: matiko09 ($103.68 in chips) 
Seat 7: tipner ($100 in chips) 
Seat 8: yourpro ($122.83 in chips) 
Seat 9: tjl290 ($49.49 in chips) 
sanpidk: posts small blind $0.50
I The King I: posts big blind $1
*** HOLE CARDS ***
Dealt to matiko09 [2h 6c]
matiko09: folds 
tipner: folds 
yourpro: folds 
tjl290: raises $2 to $3
1557PSS: raises $6 to $9
sanpidk: folds 
I The King I: folds 
tjl290: calls $6
*** FLOP *** [3d 6h 5s]
tjl290: checks 
1557PSS: bets $11
tjl290: raises $29.49 to $40.49 and is all-in
1557PSS: calls $13.22 and is all-in
Uncalled bet ($16.27) returned to tjl290
*** TURN *** [3d 6h 5s] [3h]
*** RIVER *** [3d 6h 5s 3h] [Th]
*** SHOW DOWN ***
tjl290: shows [Jh Js] (two pair, Jacks and Threes)
1557PSS: shows [Qc Ks] (a pair of Threes)
tjl290 collected $65.14 from pot
*** SUMMARY ***
Total pot $67.94 | Rake $2.80 
Board [3d 6h 5s 3h Th]
Seat 3: 1557PSS (button) showed [Qc Ks] and lost with a pair of Threes
Seat 4: sanpidk (small blind) folded before Flop
Seat 5: I The King I (big blind) folded before Flop
Seat 6: matiko09 folded before Flop (didn't bet)
Seat 7: tipner folded before Flop (didn't bet)
Seat 8: yourpro folded before Flop (didn't bet)
Seat 9: tjl290 showed [Jh Js] and won ($65.14) with two pair, Jacks and Threes





PokerStars Hand #148218519422:  Hold'em No Limit ($0.50/$1.00 USD) - 2016/02/04 15:05:20 CET [2016/02/04 9:05:20 ET]
Table 'Arneb II' 9-max Seat #1 is the button
Seat 1: matiko09 ($100 in chips) 
Seat 2: sanpidk ($214.80 in chips) 
Seat 3: brille-390 ($101.50 in chips) 
Seat 4: Venomous100% ($128.05 in chips) 
Seat 5: lixiangli ($77.77 in chips) 
Seat 7: melitakas ($253.51 in chips) 
Seat 9: tipner ($117.24 in chips) 
sanpidk: posts small blind $0.50
brille-390: posts big blind $1
*** HOLE CARDS ***
Dealt to matiko09 [9s 7d]
Venomous100%: folds 
lixiangli: folds 
melitakas: folds 
tipner: raises $2 to $3
matiko09: folds 
sanpidk: folds 
brille-390: calls $2
*** FLOP *** [As Ts Th]
brille-390: checks 
tipner: bets $4
brille-390: folds 
Uncalled bet ($4) returned to tipner
tipner collected $6.21 from pot
tipner: doesn't show hand 
*** SUMMARY ***
Total pot $6.50 | Rake $0.29 
Board [As Ts Th]
Seat 1: matiko09 (button) folded before Flop (didn't bet)
Seat 2: sanpidk (small blind) folded before Flop
Seat 3: brille-390 (big blind) folded on the Flop
Seat 4: Venomous100% folded before Flop (didn't bet)
Seat 5: lixiangli folded before Flop (didn't bet)
Seat 7: melitakas folded before Flop (didn't bet)
Seat 9: tipner collected ($6.21)





PokerStars Hand #148218524669:  Hold'em No Limit ($0.50/$1.00 USD) - 2016/02/04 15:05:28 CET [2016/02/04 9:05:28 ET]
Table 'Asios III' 9-max Seat #1 is the button
Seat 1: yourpro ($136.50 in chips) 
Seat 2: crime8783 ($43.85 in chips) 
Seat 3: Igor DoUrden ($105.53 in chips) 
Seat 4: TimStone ($100 in chips) 
Seat 5: ilaviiitech ($152.65 in chips) 
Seat 6: matiko09 ($119.50 in chips) 
Seat 7: nickreason17 ($154.11 in chips) 
Seat 9: Vikulja1993 ($158.70 in chips) 
crime8783: posts small blind $0.50
Igor DoUrden: posts big blind $1
*** HOLE CARDS ***
Dealt to matiko09 [8d Jd]
TimStone: folds 
ilaviiitech: folds 
matiko09: folds 
nickreason17: raises $2 to $3
Vikulja1993: folds 
yourpro: folds 
crime8783: raises $2 to $5
Igor DoUrden: folds 
nickreason17: calls $2
*** FLOP *** [5h 9h 3d]
crime8783: bets $5.25
nickreason17: folds 
Uncalled bet ($5.25) returned to crime8783
crime8783 collected $10.50 from pot
crime8783: doesn't show hand 
*** SUMMARY ***
Total pot $11 | Rake $0.50 
Board [5h 9h 3d]
Seat 1: yourpro (button) folded before Flop (didn't bet)
Seat 2: crime8783 (small blind) collected ($10.50)
Seat 3: Igor DoUrden (big blind) folded before Flop
Seat 4: TimStone folded before Flop (didn't bet)
Seat 5: ilaviiitech folded before Flop (didn't bet)
Seat 6: matiko09 folded before Flop (didn't bet)
Seat 7: nickreason17 folded on the Flop
Seat 9: Vikulja1993 folded before Flop (didn't bet)





PokerStars Hand #148218542945:  Hold'em No Limit ($0.50/$1.00 USD) - 2016/02/04 15:05:53 CET [2016/02/04 9:05:53 ET]
Table 'Arneb III' 9-max Seat #6 is the button
Seat 1: Vikulja1993 ($100 in chips) 
Seat 2: JeanLima93 ($209.10 in chips) 
Seat 3: matiko09 ($107.94 in chips) 
Seat 4: Igor DoUrden ($240.31 in chips) 
Seat 5: tipner ($101 in chips) 
Seat 6: nickreason17 ($117.82 in chips) 
Seat 7: Spid1 ($103.22 in chips) 
Seat 9: ARTVOR640 ($100 in chips) 
Spid1: posts small blind $0.50
volwebni4ek: is sitting out 
ARTVOR640: posts big blind $1
*** HOLE CARDS ***
Dealt to matiko09 [2s 7s]
Vikulja1993: raises $2 to $3
JeanLima93: folds 
matiko09: folds 
Igor DoUrden: folds 
tipner: folds 
nickreason17: folds 
Spid1: folds 
ARTVOR640: folds 
Uncalled bet ($2) returned to Vikulja1993
Vikulja1993 collected $2.50 from pot
Vikulja1993: doesn't show hand 
*** SUMMARY ***
Total pot $2.50 | Rake $0 
Seat 1: Vikulja1993 collected ($2.50)
Seat 2: JeanLima93 folded before Flop (didn't bet)
Seat 3: matiko09 folded before Flop (didn't bet)
Seat 4: Igor DoUrden folded before Flop (didn't bet)
Seat 5: tipner folded before Flop (didn't bet)
Seat 6: nickreason17 (button) folded before Flop (didn't bet)
Seat 7: Spid1 (small blind) folded before Flop
Seat 9: ARTVOR640 (big blind) folded before Flop





PokerStars Hand #148218546703:  Hold'em No Limit ($0.50/$1.00 USD) - 2016/02/04 15:05:58 CET [2016/02/04 9:05:58 ET]
Table 'Cepheus III' 9-max Seat #4 is the button
Seat 1: PeterBassett ($95.67 in chips) 
Seat 2: TimStone ($105.76 in chips) 
Seat 3: pandalapa ($100 in chips) 
Seat 4: lukeylund ($49.50 in chips) 
Seat 5: ARTVOR640 ($144.43 in chips) 
Seat 6: matiko09 ($100 in chips) 
Seat 7: Igor DoUrden ($100 in chips) 
Seat 8: nickreason17 ($106.07 in chips) 
ARTVOR640: posts small blind $0.50
matiko09: posts big blind $1
*** HOLE CARDS ***
Dealt to matiko09 [7d Kd]
Igor DoUrden: folds 
nickreason17: folds 
PeterBassett: folds 
TimStone: folds 
pandalapa: folds 
lukeylund: raises $1 to $2
ARTVOR640: folds 
matiko09: calls $1
*** FLOP *** [Th Tc 7h]
matiko09: checks 
lukeylund: checks 
*** TURN *** [Th Tc 7h] [Td]
matiko09: bets $2.80
lukeylund: calls $2.80
*** RIVER *** [Th Tc 7h Td] [Ts]
matiko09: checks 
lukeylund: checks 
*** SHOW DOWN ***
matiko09: shows [7d Kd] (four of a kind, Tens)
lukeylund: shows [Kc Jc] (four of a kind, Tens)
matiko09 collected $4.83 from pot
lukeylund collected $4.82 from pot
*** SUMMARY ***
Total pot $10.10 | Rake $0.45 
Board [Th Tc 7h Td Ts]
Seat 1: PeterBassett folded before Flop (didn't bet)
Seat 2: TimStone folded before Flop (didn't bet)
Seat 3: pandalapa folded before Flop (didn't bet)
Seat 4: lukeylund (button) showed [Kc Jc] and won ($4.82) with four of a kind, Tens
Seat 5: ARTVOR640 (small blind) folded before Flop
Seat 6: matiko09 (big blind) showed [7d Kd] and won ($4.83) with four of a kind, Tens
Seat 7: Igor DoUrden folded before Flop (didn't bet)
Seat 8: nickreason17 folded before Flop (didn't bet)





PokerStars Hand #148218558465:  Hold'em No Limit ($0.50/$1.00 USD) - 2016/02/04 15:06:15 CET [2016/02/04 9:06:15 ET]
Table 'Siarnaq' 9-max Seat #4 is the button
Seat 2: matiko09 ($100 in chips) 
Seat 3: nickreason17 ($101 in chips) 
Seat 4: sanpidk ($196.20 in chips) 
Seat 5: Igor DoUrden ($105.54 in chips) 
Seat 6: yourpro ($100 in chips) 
Seat 7: Sesamesnap ($63.48 in chips) 
Seat 8: maxxmeister ($100 in chips) 
Igor DoUrden: posts small blind $0.50
yourpro: posts big blind $1
vicdroopy: sits out 
*** HOLE CARDS ***
Dealt to matiko09 [3s Qs]
Sesamesnap: folds 
maxxmeister: folds 
matiko09: folds 
nickreason17: folds 
sanpidk: raises $1.24 to $2.24
Igor DoUrden: folds 
yourpro: folds 
Uncalled bet ($1.24) returned to sanpidk
sanpidk collected $2.50 from pot
sanpidk: doesn't show hand 
*** SUMMARY ***
Total pot $2.50 | Rake $0 
Seat 2: matiko09 folded before Flop (didn't bet)
Seat 3: nickreason17 folded before Flop (didn't bet)
Seat 4: sanpidk (button) collected ($2.50)
Seat 5: Igor DoUrden (small blind) folded before Flop
Seat 6: yourpro (big blind) folded before Flop
Seat 7: Sesamesnap folded before Flop (didn't bet)
Seat 8: maxxmeister folded before Flop (didn't bet)





PokerStars Hand #148218559603:  Hold'em No Limit ($0.50/$1.00 USD) - 2016/02/04 15:06:16 CET [2016/02/04 9:06:16 ET]
Table 'Arneb III' 9-max Seat #7 is the button
Seat 1: Vikulja1993 ($101.50 in chips) 
Seat 2: JeanLima93 ($209.10 in chips) 
Seat 3: matiko09 ($107.94 in chips) 
Seat 4: Igor DoUrden ($240.31 in chips) 
Seat 5: tipner ($101 in chips) 
Seat 6: nickreason17 ($117.82 in chips) 
Seat 7: Spid1 ($102.72 in chips) 
Seat 9: ARTVOR640 ($100 in chips) 
ARTVOR640: posts small blind $0.50
Vikulja1993: posts big blind $1
*** HOLE CARDS ***
Dealt to matiko09 [Th 2d]
JeanLima93: raises $2 to $3
matiko09: folds 
Igor DoUrden: folds 
tipner: folds 
nickreason17: folds 
Spid1: folds 
ARTVOR640: folds 
Vikulja1993: folds 
Uncalled bet ($2) returned to JeanLima93
JeanLima93 collected $2.50 from pot
JeanLima93: doesn't show hand 
*** SUMMARY ***
Total pot $2.50 | Rake $0 
Seat 1: Vikulja1993 (big blind) folded before Flop
Seat 2: JeanLima93 collected ($2.50)
Seat 3: matiko09 folded before Flop (didn't bet)
Seat 4: Igor DoUrden folded before Flop (didn't bet)
Seat 5: tipner folded before Flop (didn't bet)
Seat 6: nickreason17 folded before Flop (didn't bet)
Seat 7: Spid1 (button) folded before Flop (didn't bet)
Seat 9: ARTVOR640 (small blind) folded before Flop





PokerStars Hand #148218562435:  Hold'em No Limit ($0.50/$1.00 USD) - 2016/02/04 15:06:20 CET [2016/02/04 9:06:20 ET]
Table 'Arneb II' 9-max Seat #2 is the button
Seat 1: matiko09 ($100 in chips) 
Seat 2: sanpidk ($214.30 in chips) 
Seat 4: Venomous100% ($128.05 in chips) 
Seat 5: lixiangli ($77.77 in chips) 
Seat 7: melitakas ($253.51 in chips) 
Seat 9: tipner ($120.45 in chips) 
Venomous100%: posts small blind $0.50
lixiangli: posts big blind $1
*** HOLE CARDS ***
Dealt to matiko09 [6c 5h]
melitakas: folds 
tipner: folds 
matiko09: folds 
sanpidk: folds 
Venomous100%: folds 
Uncalled bet ($0.50) returned to lixiangli
lixiangli collected $1 from pot
lixiangli: doesn't show hand 
*** SUMMARY ***
Total pot $1 | Rake $0 
Seat 1: matiko09 folded before Flop (didn't bet)
Seat 2: sanpidk (button) folded before Flop (didn't bet)
Seat 4: Venomous100% (small blind) folded before Flop
Seat 5: lixiangli (big blind) collected ($1)
Seat 7: melitakas folded before Flop (didn't bet)
Seat 9: tipner folded before Flop (didn't bet)





PokerStars Hand #148218562377:  Hold'em No Limit ($0.50/$1.00 USD) - 2016/02/04 15:06:20 CET [2016/02/04 9:06:20 ET]
Table 'Asios III' 9-max Seat #2 is the button
Seat 1: yourpro ($136.50 in chips) 
Seat 2: crime8783 ($49.35 in chips) 
Seat 3: Igor DoUrden ($104.53 in chips) 
Seat 4: TimStone ($100 in chips) 
Seat 5: ilaviiitech ($152.65 in chips) 
Seat 6: matiko09 ($119.50 in chips) 
Seat 7: nickreason17 ($149.11 in chips) 
Seat 9: Vikulja1993 ($158.70 in chips) 
Igor DoUrden: posts small blind $0.50
TimStone: posts big blind $1
*** HOLE CARDS ***
Dealt to matiko09 [Th Jh]
ilaviiitech: folds 
matiko09: raises $2 to $3
nickreason17: folds 
Vikulja1993: folds 
yourpro: folds 
crime8783: folds 
Igor DoUrden: folds 
TimStone: folds 
Uncalled bet ($2) returned to matiko09
matiko09 collected $2.50 from pot
matiko09: doesn't show hand 
*** SUMMARY ***
Total pot $2.50 | Rake $0 
Seat 1: yourpro folded before Flop (didn't bet)
Seat 2: crime8783 (button) folded before Flop (didn't bet)
Seat 3: Igor DoUrden (small blind) folded before Flop
Seat 4: TimStone (big blind) folded before Flop
Seat 5: ilaviiitech folded before Flop (didn't bet)
Seat 6: matiko09 collected ($2.50)
Seat 7: nickreason17 folded before Flop (didn't bet)
Seat 9: Vikulja1993 folded before Flop (didn't bet)





PokerStars Hand #148218573142:  Hold'em No Limit ($0.50/$1.00 USD) - 2016/02/04 15:06:34 CET [2016/02/04 9:06:34 ET]
Table 'Siarnaq' 9-max Seat #5 is the button
Seat 2: matiko09 ($100 in chips) 
Seat 3: nickreason17 ($101 in chips) 
Seat 4: sanpidk ($197.70 in chips) 
Seat 5: Igor DoUrden ($105.04 in chips) 
Seat 6: yourpro ($100 in chips) 
Seat 7: Sesamesnap ($63.48 in chips) 
Seat 8: maxxmeister ($100 in chips) 
yourpro: posts small blind $0.50
Sesamesnap: posts big blind $1
vicdroopy: sits out 
*** HOLE CARDS ***
Dealt to matiko09 [4c Qc]
maxxmeister: folds 
matiko09: folds 
nickreason17: folds 
sanpidk: raises $1.50 to $2.50
Igor DoUrden: folds 
yourpro: folds 
Sesamesnap: folds 
Uncalled bet ($1.50) returned to sanpidk
sanpidk collected $2.50 from pot
sanpidk: doesn't show hand 
*** SUMMARY ***
Total pot $2.50 | Rake $0 
Seat 2: matiko09 folded before Flop (didn't bet)
Seat 3: nickreason17 folded before Flop (didn't bet)
Seat 4: sanpidk collected ($2.50)
Seat 5: Igor DoUrden (button) folded before Flop (didn't bet)
Seat 6: yourpro (small blind) folded before Flop
Seat 7: Sesamesnap (big blind) folded before Flop
Seat 8: maxxmeister folded before Flop (didn't bet)





PokerStars Hand #148218573914:  Hold'em No Limit ($0.50/$1.00 USD) - 2016/02/04 15:06:35 CET [2016/02/04 9:06:35 ET]
Table 'Alkaid II' 9-max Seat #4 is the button
Seat 4: sanpidk ($105.38 in chips) 
Seat 5: I The King I ($146.74 in chips) 
Seat 6: matiko09 ($103.68 in chips) 
Seat 7: tipner ($100 in chips) 
Seat 8: yourpro ($122.83 in chips) 
Seat 9: tjl290 ($81.41 in chips) 
I The King I: posts small blind $0.50
matiko09: posts big blind $1
*** HOLE CARDS ***
Dealt to matiko09 [2h Jh]
tipner: folds 
1557PSS leaves the table
yourpro: folds 
tjl290: folds 
sanpidk: raises $1.24 to $2.24
I The King I: folds 
matiko09: folds 
Uncalled bet ($1.24) returned to sanpidk
sanpidk collected $2.50 from pot
sanpidk: doesn't show hand 
*** SUMMARY ***
Total pot $2.50 | Rake $0 
Seat 4: sanpidk (button) collected ($2.50)
Seat 5: I The King I (small blind) folded before Flop
Seat 6: matiko09 (big blind) folded before Flop
Seat 7: tipner folded before Flop (didn't bet)
Seat 8: yourpro folded before Flop (didn't bet)
Seat 9: tjl290 folded before Flop (didn't bet)





PokerStars Hand #148218574569:  Hold'em No Limit ($0.50/$1.00 USD) - 2016/02/04 15:06:36 CET [2016/02/04 9:06:36 ET]
Table 'Arneb II' 9-max Seat #4 is the button
Seat 1: matiko09 ($100 in chips) 
Seat 2: sanpidk ($214.30 in chips) 
Seat 4: Venomous100% ($127.55 in chips) 
Seat 5: lixiangli ($78.27 in chips) 
Seat 7: melitakas ($253.51 in chips) 
Seat 9: tipner ($120.45 in chips) 
lixiangli: posts small blind $0.50
melitakas: posts big blind $1
*** HOLE CARDS ***
Dealt to matiko09 [Ac 8d]
tipner: folds 
matiko09: folds 
sanpidk: raises $1.50 to $2.50
Venomous100%: folds 
lixiangli: folds 
melitakas: calls $1.50
*** FLOP *** [Ad 8s 4d]
melitakas: checks 
sanpidk: bets $3
melitakas: calls $3
*** TURN *** [Ad 8s 4d] [4c]
melitakas: checks 
sanpidk: checks 
*** RIVER *** [Ad 8s 4d 4c] [Ah]
melitakas: bets $5.49
sanpidk: folds 
Uncalled bet ($5.49) returned to melitakas
melitakas collected $10.98 from pot
*** SUMMARY ***
Total pot $11.50 | Rake $0.52 
Board [Ad 8s 4d 4c Ah]
Seat 1: matiko09 folded before Flop (didn't bet)
Seat 2: sanpidk folded on the River
Seat 4: Venomous100% (button) folded before Flop (didn't bet)
Seat 5: lixiangli (small blind) folded before Flop
Seat 7: melitakas (big blind) collected ($10.98)
Seat 9: tipner folded before Flop (didn't bet)





PokerStars Hand #148218575845:  Hold'em No Limit ($0.50/$1.00 USD) - 2016/02/04 15:06:38 CET [2016/02/04 9:06:38 ET]
Table 'Cepheus III' 9-max Seat #5 is the button
Seat 1: PeterBassett ($95.67 in chips) 
Seat 2: TimStone ($105.76 in chips) 
Seat 3: pandalapa ($100 in chips) 
Seat 4: lukeylund ($49.52 in chips) 
Seat 5: ARTVOR640 ($143.93 in chips) 
Seat 6: matiko09 ($100.03 in chips) 
Seat 7: Igor DoUrden ($100 in chips) 
Seat 8: nickreason17 ($106.07 in chips) 
matiko09: posts small blind $0.50
Igor DoUrden: posts big blind $1
*** HOLE CARDS ***
Dealt to matiko09 [Ac 8d]
nickreason17: folds 
PeterBassett: folds 
TimStone: folds 
pandalapa: folds 
lukeylund: folds 
ARTVOR640: raises $1.50 to $2.50
matiko09: folds 
Igor DoUrden: folds 
Uncalled bet ($1.50) returned to ARTVOR640
ARTVOR640 collected $2.50 from pot
ARTVOR640: doesn't show hand 
*** SUMMARY ***
Total pot $2.50 | Rake $0 
Seat 1: PeterBassett folded before Flop (didn't bet)
Seat 2: TimStone folded before Flop (didn't bet)
Seat 3: pandalapa folded before Flop (didn't bet)
Seat 4: lukeylund folded before Flop (didn't bet)
Seat 5: ARTVOR640 (button) collected ($2.50)
Seat 6: matiko09 (small blind) folded before Flop
Seat 7: Igor DoUrden (big blind) folded before Flop
Seat 8: nickreason17 folded before Flop (didn't bet)





PokerStars Hand #148218588727:  Hold'em No Limit ($0.50/$1.00 USD) - 2016/02/04 15:06:55 CET [2016/02/04 9:06:55 ET]
Table 'Arneb III' 9-max Seat #9 is the button
Seat 1: Vikulja1993 ($100.50 in chips) 
Seat 2: JeanLima93 ($210.60 in chips) 
Seat 3: matiko09 ($107.94 in chips) 
Seat 4: Igor DoUrden ($240.31 in chips) 
Seat 5: tipner ($101 in chips) 
Seat 6: nickreason17 ($117.82 in chips) 
Seat 7: Spid1 ($102.72 in chips) 
Seat 9: ARTVOR640 ($100 in chips) 
Vikulja1993: posts small blind $0.50
JeanLima93: posts big blind $1
volwebni4ek: sits out 
*** HOLE CARDS ***
Dealt to matiko09 [Kh 8d]
matiko09: folds 
Igor DoUrden: folds 
tipner: folds 
nickreason17: folds 
Spid1: raises $1.50 to $2.50
ARTVOR640: folds 
Vikulja1993: folds 
JeanLima93: folds 
Uncalled bet ($1.50) returned to Spid1
Spid1 collected $2.50 from pot
Spid1: doesn't show hand 
*** SUMMARY ***
Total pot $2.50 | Rake $0 
Seat 1: Vikulja1993 (small blind) folded before Flop
Seat 2: JeanLima93 (big blind) folded before Flop
Seat 3: matiko09 folded before Flop (didn't bet)
Seat 4: Igor DoUrden folded before Flop (didn't bet)
Seat 5: tipner folded before Flop (didn't bet)
Seat 6: nickreason17 folded before Flop (didn't bet)
Seat 7: Spid1 collected ($2.50)
Seat 9: ARTVOR640 (button) folded before Flop (didn't bet)





PokerStars Hand #148218589711:  Hold'em No Limit ($0.50/$1.00 USD) - 2016/02/04 15:06:57 CET [2016/02/04 9:06:57 ET]
Table 'Cepheus III' 9-max Seat #6 is the button
Seat 1: PeterBassett ($95.67 in chips) 
Seat 2: TimStone ($105.76 in chips) 
Seat 3: pandalapa ($100 in chips) 
Seat 4: lukeylund ($49.52 in chips) 
Seat 5: ARTVOR640 ($145.43 in chips) 
Seat 6: matiko09 ($100 in chips) 
Seat 7: Igor DoUrden ($100 in chips) 
Seat 8: nickreason17 ($106.07 in chips) 
Igor DoUrden: posts small blind $0.50
nickreason17: posts big blind $1
*** HOLE CARDS ***
Dealt to matiko09 [9c 4h]
PeterBassett: folds 
TimStone: folds 
pandalapa: folds 
lukeylund: folds 
ARTVOR640: folds 
matiko09: folds 
Igor DoUrden: raises $2.09 to $3.09
nickreason17: raises $5.91 to $9
Igor DoUrden: folds 
Uncalled bet ($5.91) returned to nickreason17
nickreason17 collected $6.18 from pot
*** SUMMARY ***
Total pot $6.18 | Rake $0 
Seat 1: PeterBassett folded before Flop (didn't bet)
Seat 2: TimStone folded before Flop (didn't bet)
Seat 3: pandalapa folded before Flop (didn't bet)
Seat 4: lukeylund folded before Flop (didn't bet)
Seat 5: ARTVOR640 folded before Flop (didn't bet)
Seat 6: matiko09 (button) folded before Flop (didn't bet)
Seat 7: Igor DoUrden (small blind) folded before Flop
Seat 8: nickreason17 (big blind) collected ($6.18)





PokerStars Hand #148218594383:  Hold'em No Limit ($0.50/$1.00 USD) - 2016/02/04 15:07:03 CET [2016/02/04 9:07:03 ET]
Table 'Alkaid II' 9-max Seat #5 is the button
Seat 4: sanpidk ($106.88 in chips) 
Seat 5: I The King I ($146.24 in chips) 
Seat 6: matiko09 ($102.68 in chips) 
Seat 9: tjl290 ($81.41 in chips) 
matiko09: posts small blind $0.50
tipner: is sitting out 
yourpro: is sitting out 
tjl290: posts big blind $1
*** HOLE CARDS ***
Dealt to matiko09 [2s Qs]
tipner leaves the table
Vikulja1993 joins the table at seat #3 
sanpidk: raises $1.50 to $2.50
I The King I: folds 
yourpro leaves the table
Vikulja1993 leaves the table
matiko09: folds 
pandalapa joins the table at seat #3 
tjl290: calls $1.50
*** FLOP *** [2h 8d 7s]
tjl290: checks 
Rafaello18 joins the table at seat #7 
sanpidk: bets $3.50
tjl290: folds 
Uncalled bet ($3.50) returned to sanpidk
sanpidk collected $5.25 from pot
sanpidk: doesn't show hand 
*** SUMMARY ***
Total pot $5.50 | Rake $0.25 
Board [2h 8d 7s]
Seat 4: sanpidk collected ($5.25)
Seat 5: I The King I (button) folded before Flop (didn't bet)
Seat 6: matiko09 (small blind) folded before Flop
Seat 9: tjl290 (big blind) folded on the Flop





PokerStars Hand #148218602800:  Hold'em No Limit ($0.50/$1.00 USD) - 2016/02/04 15:07:14 CET [2016/02/04 9:07:14 ET]
Table 'Siarnaq' 9-max Seat #6 is the button
Seat 2: matiko09 ($100 in chips) 
Seat 3: nickreason17 ($101 in chips) 
Seat 4: sanpidk ($199.20 in chips) 
Seat 5: Igor DoUrden ($105.04 in chips) 
Seat 6: yourpro ($100 in chips) 
Seat 7: Sesamesnap ($62.48 in chips) 
Seat 8: maxxmeister ($100 in chips) 
Sesamesnap: posts small blind $0.50
maxxmeister: posts big blind $1
vicdroopy: sits out 
*** HOLE CARDS ***
Dealt to matiko09 [9s 6c]
matiko09: folds 
nickreason17: folds 
sanpidk: folds 
Igor DoUrden: folds 
yourpro: folds 
Sesamesnap: raises $2 to $3
maxxmeister: folds 
Uncalled bet ($2) returned to Sesamesnap
Sesamesnap collected $2 from pot
Sesamesnap: doesn't show hand 
*** SUMMARY ***
Total pot $2 | Rake $0 
Seat 2: matiko09 folded before Flop (didn't bet)
Seat 3: nickreason17 folded before Flop (didn't bet)
Seat 4: sanpidk folded before Flop (didn't bet)
Seat 5: Igor DoUrden folded before Flop (didn't bet)
Seat 6: yourpro (button) folded before Flop (didn't bet)
Seat 7: Sesamesnap (small blind) collected ($2)
Seat 8: maxxmeister (big blind) folded before Flop





PokerStars Hand #148218607990:  Hold'em No Limit ($0.50/$1.00 USD) - 2016/02/04 15:07:22 CET [2016/02/04 9:07:22 ET]
Table 'Cepheus III' 9-max Seat #7 is the button
Seat 1: PeterBassett ($95.67 in chips) 
Seat 2: TimStone ($105.76 in chips) 
Seat 3: pandalapa ($100 in chips) 
Seat 4: lukeylund ($49.52 in chips) 
Seat 5: ARTVOR640 ($145.43 in chips) 
Seat 6: matiko09 ($100 in chips) 
Seat 7: Igor DoUrden ($100 in chips) 
Seat 8: nickreason17 ($109.16 in chips) 
Seat 9: xxxZeka ($107.42 in chips) 
nickreason17: posts small blind $0.50
xxxZeka: posts big blind $1
*** HOLE CARDS ***
Dealt to matiko09 [3s 2h]
PeterBassett: folds 
TimStone: folds 
pandalapa: folds 
lukeylund: folds 
ARTVOR640: folds 
matiko09: folds 
Igor DoUrden: folds 
nickreason17: folds 
Uncalled bet ($0.50) returned to xxxZeka
xxxZeka collected $1 from pot
*** SUMMARY ***
Total pot $1 | Rake $0 
Seat 1: PeterBassett folded before Flop (didn't bet)
Seat 2: TimStone folded before Flop (didn't bet)
Seat 3: pandalapa folded before Flop (didn't bet)
Seat 4: lukeylund folded before Flop (didn't bet)
Seat 5: ARTVOR640 folded before Flop (didn't bet)
Seat 6: matiko09 folded before Flop (didn't bet)
Seat 7: Igor DoUrden (button) folded before Flop (didn't bet)
Seat 8: nickreason17 (small blind) folded before Flop
Seat 9: xxxZeka (big blind) collected ($1)





PokerStars Hand #148218608442:  Hold'em No Limit ($0.50/$1.00 USD) - 2016/02/04 15:07:22 CET [2016/02/04 9:07:22 ET]
Table 'Asios III' 9-max Seat #3 is the button
Seat 1: yourpro ($136.50 in chips) 
Seat 2: crime8783 ($49.35 in chips) 
Seat 3: Igor DoUrden ($104.03 in chips) 
Seat 4: TimStone ($100 in chips) 
Seat 6: matiko09 ($121 in chips) 
Seat 7: nickreason17 ($149.11 in chips) 
Seat 9: Vikulja1993 ($158.70 in chips) 
TimStone: posts small blind $0.50
matiko09: posts big blind $1
*** HOLE CARDS ***
Dealt to matiko09 [Qc 5d]
nickreason17: folds 
Vikulja1993: folds 
yourpro: folds 
crime8783: calls $1
Igor DoUrden: folds 
TimStone: folds 
matiko09: checks 
*** FLOP *** [4d 5h 6d]
matiko09: checks 
crime8783: checks 
*** TURN *** [4d 5h 6d] [Kc]
matiko09: checks 
crime8783: checks 
*** RIVER *** [4d 5h 6d Kc] [Qs]
matiko09: bets $2
crime8783: raises $2 to $4
matiko09: raises $12 to $16
crime8783: calls $12
*** SHOW DOWN ***
matiko09: shows [Qc 5d] (two pair, Queens and Fives)
crime8783: mucks hand 
matiko09 collected $32.95 from pot
*** SUMMARY ***
Total pot $34.50 | Rake $1.55 
Board [4d 5h 6d Kc Qs]
Seat 1: yourpro folded before Flop (didn't bet)
Seat 2: crime8783 mucked [Qh 9d]
Seat 3: Igor DoUrden (button) folded before Flop (didn't bet)
Seat 4: TimStone (small blind) folded before Flop
Seat 6: matiko09 (big blind) showed [Qc 5d] and won ($32.95) with two pair, Queens and Fives
Seat 7: nickreason17 folded before Flop (didn't bet)
Seat 9: Vikulja1993 folded before Flop (didn't bet)





PokerStars Hand #148218608184:  Hold'em No Limit ($0.50/$1.00 USD) - 2016/02/04 15:07:22 CET [2016/02/04 9:07:22 ET]
Table 'Arneb III' 9-max Seat #1 is the button
Seat 1: Vikulja1993 ($100 in chips) 
Seat 2: JeanLima93 ($209.60 in chips) 
Seat 3: matiko09 ($107.94 in chips) 
Seat 4: Igor DoUrden ($240.31 in chips) 
Seat 5: tipner ($101 in chips) 
Seat 6: nickreason17 ($117.82 in chips) 
Seat 7: Spid1 ($104.22 in chips) 
Seat 9: ARTVOR640 ($100 in chips) 
JeanLima93: posts small blind $0.50
matiko09: posts big blind $1
volwebni4ek: sits out 
*** HOLE CARDS ***
Dealt to matiko09 [3d Kd]
Igor DoUrden: folds 
tipner: folds 
nickreason17: raises $2 to $3
Spid1: folds 
ARTVOR640: folds 
Vikulja1993: calls $3
JeanLima93: calls $2.50
matiko09: folds 
*** FLOP *** [Td Jh Th]
JeanLima93: checks 
nickreason17: checks 
Vikulja1993: bets $5
JeanLima93: calls $5
nickreason17: calls $5
*** TURN *** [Td Jh Th] [4c]
JeanLima93: checks 
nickreason17: checks 
Vikulja1993: checks 
*** RIVER *** [Td Jh Th 4c] [8c]
JeanLima93: checks 
nickreason17: checks 
Vikulja1993: checks 
*** SHOW DOWN ***
JeanLima93: shows [3c 3h] (two pair, Tens and Threes)
nickreason17: shows [Jc As] (two pair, Jacks and Tens)
Vikulja1993: mucks hand 
nickreason17 collected $23.88 from pot
*** SUMMARY ***
Total pot $25 | Rake $1.12 
Board [Td Jh Th 4c 8c]
Seat 1: Vikulja1993 (button) mucked [Ah Qh]
Seat 2: JeanLima93 (small blind) showed [3c 3h] and lost with two pair, Tens and Threes
Seat 3: matiko09 (big blind) folded before Flop
Seat 4: Igor DoUrden folded before Flop (didn't bet)
Seat 5: tipner folded before Flop (didn't bet)
Seat 6: nickreason17 showed [Jc As] and won ($23.88) with two pair, Jacks and Tens
Seat 7: Spid1 folded before Flop (didn't bet)
Seat 9: ARTVOR640 folded before Flop (didn't bet)





PokerStars Hand #148218614444:  Hold'em No Limit ($0.50/$1.00 USD) - 2016/02/04 15:07:30 CET [2016/02/04 9:07:30 ET]
Table 'Arneb II' 9-max Seat #5 is the button
Seat 1: matiko09 ($100 in chips) 
Seat 2: sanpidk ($208.80 in chips) 
Seat 4: Venomous100% ($127.55 in chips) 
Seat 5: lixiangli ($77.77 in chips) 
Seat 7: melitakas ($258.99 in chips) 
Seat 8: tedbadger9 ($74 in chips) 
Seat 9: tipner ($120.45 in chips) 
melitakas: posts small blind $0.50
tedbadger9: posts big blind $1
*** HOLE CARDS ***
Dealt to matiko09 [Jd Kh]
tipner: folds 
matiko09: raises $2 to $3
sanpidk: folds 
Venomous100%: folds 
lixiangli: folds 
melitakas: calls $2.50
tedbadger9: folds 
*** FLOP *** [Ah 4c 3c]
melitakas: checks 
matiko09: checks 
*** TURN *** [Ah 4c 3c] [9h]
melitakas: checks 
matiko09: checks 
*** RIVER *** [Ah 4c 3c 9h] [6h]
melitakas: checks 
matiko09: checks 
*** SHOW DOWN ***
melitakas: shows [As Td] (a pair of Aces)
matiko09: mucks hand 
melitakas collected $6.68 from pot
*** SUMMARY ***
Total pot $7 | Rake $0.32 
Board [Ah 4c 3c 9h 6h]
Seat 1: matiko09 mucked [Jd Kh]
Seat 2: sanpidk folded before Flop (didn't bet)
Seat 4: Venomous100% folded before Flop (didn't bet)
Seat 5: lixiangli (button) folded before Flop (didn't bet)
Seat 7: melitakas (small blind) showed [As Td] and won ($6.68) with a pair of Aces
Seat 8: tedbadger9 (big blind) folded before Flop
Seat 9: tipner folded before Flop (didn't bet)





PokerStars Hand #148218620628:  Hold'em No Limit ($0.50/$1.00 USD) - 2016/02/04 15:07:39 CET [2016/02/04 9:07:39 ET]
Table 'Alkaid II' 9-max Seat #6 is the button
Seat 2: xxxZeka ($104.78 in chips) 
Seat 4: sanpidk ($109.63 in chips) 
Seat 5: I The King I ($146.24 in chips) 
Seat 6: matiko09 ($102.18 in chips) 
Seat 9: tjl290 ($78.91 in chips) 
Rafaello18 will be allowed to play after the button
tjl290: posts small blind $0.50
xxxZeka: posts big blind $1
pandalapa: sits out 
*** HOLE CARDS ***
Dealt to matiko09 [Th 6s]
Düss2411 joins the table at seat #8 
sanpidk: folds 
I The King I: raises $1.50 to $2.50
matiko09: folds 
Düss2411 leaves the table
tjl290: folds 
xxxZeka: folds 
Uncalled bet ($1.50) returned to I The King I
I The King I collected $2.50 from pot
I The King I: doesn't show hand 
*** SUMMARY ***
Total pot $2.50 | Rake $0 
Seat 2: xxxZeka (big blind) folded before Flop
Seat 4: sanpidk folded before Flop (didn't bet)
Seat 5: I The King I collected ($2.50)
Seat 6: matiko09 (button) folded before Flop (didn't bet)
Seat 9: tjl290 (small blind) folded before Flop





PokerStars Hand #148218627056:  Hold'em No Limit ($0.50/$1.00 USD) - 2016/02/04 15:07:47 CET [2016/02/04 9:07:47 ET]
Table 'Cepheus III' 9-max Seat #8 is the button
Seat 1: PeterBassett ($95.67 in chips) 
Seat 2: TimStone ($105.76 in chips) 
Seat 3: pandalapa ($100 in chips) 
Seat 4: lukeylund ($49.52 in chips) 
Seat 5: ARTVOR640 ($145.43 in chips) 
Seat 6: matiko09 ($100 in chips) 
Seat 7: Igor DoUrden ($100 in chips) 
Seat 8: nickreason17 ($108.66 in chips) 
Seat 9: xxxZeka ($107.92 in chips) 
xxxZeka: posts small blind $0.50
PeterBassett: posts big blind $1
*** HOLE CARDS ***
Dealt to matiko09 [Qc Ks]
TimStone: folds 
pandalapa: folds 
lukeylund has timed out
lukeylund: folds 
ARTVOR640: folds 
matiko09: raises $2 to $3
Igor DoUrden: folds 
nickreason17: raises $6 to $9
xxxZeka: folds 
PeterBassett: folds 
matiko09: folds 
Uncalled bet ($6) returned to nickreason17
nickreason17 collected $7.50 from pot
*** SUMMARY ***
Total pot $7.50 | Rake $0 
Seat 1: PeterBassett (big blind) folded before Flop
Seat 2: TimStone folded before Flop (didn't bet)
Seat 3: pandalapa folded before Flop (didn't bet)
Seat 4: lukeylund folded before Flop (didn't bet)
Seat 5: ARTVOR640 folded before Flop (didn't bet)
Seat 6: matiko09 folded before Flop
Seat 7: Igor DoUrden folded before Flop (didn't bet)
Seat 8: nickreason17 (button) collected ($7.50)
Seat 9: xxxZeka (small blind) folded before Flop





PokerStars Hand #148218631151:  Hold'em No Limit ($0.50/$1.00 USD) - 2016/02/04 15:07:53 CET [2016/02/04 9:07:53 ET]
Table 'Siarnaq' 9-max Seat #7 is the button
Seat 2: matiko09 ($100 in chips) 
Seat 3: nickreason17 ($101 in chips) 
Seat 4: sanpidk ($199.20 in chips) 
Seat 5: Igor DoUrden ($105.04 in chips) 
Seat 6: yourpro ($100 in chips) 
Seat 7: Sesamesnap ($63.48 in chips) 
Seat 8: maxxmeister ($100 in chips) 
Seat 9: vicdroopy ($100 in chips) 
maxxmeister: posts small blind $0.50
vicdroopy: posts big blind $1
xxxZeka: sits out 
*** HOLE CARDS ***
Dealt to matiko09 [Td 7d]
matiko09: folds 
nickreason17: folds 
sanpidk: raises $2 to $3
Igor DoUrden: folds 
yourpro: folds 
Sesamesnap: folds 
maxxmeister: folds 
vicdroopy: folds 
Uncalled bet ($2) returned to sanpidk
sanpidk collected $2.50 from pot
sanpidk: doesn't show hand 
*** SUMMARY ***
Total pot $2.50 | Rake $0 
Seat 2: matiko09 folded before Flop (didn't bet)
Seat 3: nickreason17 folded before Flop (didn't bet)
Seat 4: sanpidk collected ($2.50)
Seat 5: Igor DoUrden folded before Flop (didn't bet)
Seat 6: yourpro folded before Flop (didn't bet)
Seat 7: Sesamesnap (button) folded before Flop (didn't bet)
Seat 8: maxxmeister (small blind) folded before Flop
Seat 9: vicdroopy (big blind) folded before Flop





PokerStars Hand #148218632888:  Hold'em No Limit ($0.50/$1.00 USD) - 2016/02/04 15:07:55 CET [2016/02/04 9:07:55 ET]
Table 'Alkaid II' 9-max Seat #9 is the button
Seat 2: xxxZeka ($103.78 in chips) 
Seat 3: pandalapa ($100 in chips) 
Seat 4: sanpidk ($109.63 in chips) 
Seat 5: I The King I ($147.74 in chips) 
Seat 6: matiko09 ($102.18 in chips) 
Seat 9: tjl290 ($78.41 in chips) 
xxxZeka: posts small blind $0.50
pandalapa: posts big blind $1
Rafaello18: sits out 
*** HOLE CARDS ***
Dealt to matiko09 [3h Jd]
sanpidk: raises $2 to $3
I The King I: folds 
matiko09: folds 
tjl290: folds 
xxxZeka: folds 
pandalapa: folds 
Uncalled bet ($2) returned to sanpidk
sanpidk collected $2.50 from pot
sanpidk: doesn't show hand 
*** SUMMARY ***
Total pot $2.50 | Rake $0 
Seat 2: xxxZeka (small blind) folded before Flop
Seat 3: pandalapa (big blind) folded before Flop
Seat 4: sanpidk collected ($2.50)
Seat 5: I The King I folded before Flop (didn't bet)
Seat 6: matiko09 folded before Flop (didn't bet)
Seat 9: tjl290 (button) folded before Flop (didn't bet)





PokerStars Hand #148218650683:  Hold'em No Limit ($0.50/$1.00 USD) - 2016/02/04 15:08:20 CET [2016/02/04 9:08:20 ET]
Table 'Alkaid II' 9-max Seat #2 is the button
Seat 2: xxxZeka ($103.28 in chips) 
Seat 3: pandalapa ($100 in chips) 
Seat 4: sanpidk ($111.13 in chips) 
Seat 5: I The King I ($147.74 in chips) 
Seat 6: matiko09 ($102.18 in chips) 
Seat 9: tjl290 ($78.41 in chips) 
pandalapa: posts small blind $0.50
sanpidk: posts big blind $1
Rafaello18: sits out 
*** HOLE CARDS ***
Dealt to matiko09 [Td Qd]
I The King I: folds 
I The King I leaves the table
matiko09: raises $2 to $3
tjl290: folds 
xxxZeka: folds 
pandalapa: folds 
sanpidk: raises $7 to $10
matiko09: folds 
Uncalled bet ($7) returned to sanpidk
sanpidk collected $6.50 from pot
sanpidk: doesn't show hand 
*** SUMMARY ***
Total pot $6.50 | Rake $0 
Seat 2: xxxZeka (button) folded before Flop (didn't bet)
Seat 3: pandalapa (small blind) folded before Flop
Seat 4: sanpidk (big blind) collected ($6.50)
Seat 5: I The King I folded before Flop (didn't bet)
Seat 6: matiko09 folded before Flop
Seat 9: tjl290 folded before Flop (didn't bet)





PokerStars Hand #148218650971:  Hold'em No Limit ($0.50/$1.00 USD) - 2016/02/04 15:08:20 CET [2016/02/04 9:08:20 ET]
Table 'Siarnaq' 9-max Seat #8 is the button
Seat 1: xxxZeka ($100 in chips) 
Seat 2: matiko09 ($100 in chips) 
Seat 3: nickreason17 ($101 in chips) 
Seat 4: sanpidk ($200.70 in chips) 
Seat 5: Igor DoUrden ($105.04 in chips) 
Seat 6: yourpro ($100 in chips) 
Seat 7: Sesamesnap ($63.48 in chips) 
Seat 8: maxxmeister ($100 in chips) 
Seat 9: vicdroopy ($100 in chips) 
vicdroopy: posts small blind $0.50
xxxZeka: posts big blind $1
*** HOLE CARDS ***
Dealt to matiko09 [Ks 4h]
matiko09: folds 
nickreason17: folds 
sanpidk: folds 
Igor DoUrden: raises $1.50 to $2.50
yourpro: raises $5.50 to $8
Sesamesnap: folds 
maxxmeister: folds 
vicdroopy: folds 
xxxZeka: folds 
Igor DoUrden: folds 
Uncalled bet ($5.50) returned to yourpro
yourpro collected $6.50 from pot
yourpro: doesn't show hand 
*** SUMMARY ***
Total pot $6.50 | Rake $0 
Seat 1: xxxZeka (big blind) folded before Flop
Seat 2: matiko09 folded before Flop (didn't bet)
Seat 3: nickreason17 folded before Flop (didn't bet)
Seat 4: sanpidk folded before Flop (didn't bet)
Seat 5: Igor DoUrden folded before Flop
Seat 6: yourpro collected ($6.50)
Seat 7: Sesamesnap folded before Flop (didn't bet)
Seat 8: maxxmeister (button) folded before Flop (didn't bet)
Seat 9: vicdroopy (small blind) folded before Flop





PokerStars Hand #148218651996:  Hold'em No Limit ($0.50/$1.00 USD) - 2016/02/04 15:08:21 CET [2016/02/04 9:08:21 ET]
Table 'Arneb II' 9-max Seat #7 is the button
Seat 1: matiko09 ($100 in chips) 
Seat 2: sanpidk ($208.80 in chips) 
Seat 4: Venomous100% ($127.55 in chips) 
Seat 5: lixiangli ($77.77 in chips) 
Seat 7: melitakas ($262.67 in chips) 
Seat 8: tedbadger9 ($73 in chips) 
Seat 9: tipner ($120.45 in chips) 
tedbadger9: posts small blind $0.50
tipner: posts big blind $1
*** HOLE CARDS ***
Dealt to matiko09 [3c 4h]
matiko09: folds 
sanpidk: folds 
Venomous100%: folds 
lixiangli: folds 
melitakas: folds 
tedbadger9: raises $1 to $2
tipner: calls $1
*** FLOP *** [5d Ac 4s]
tedbadger9: checks 
tipner: bets $2
tedbadger9: calls $2
*** TURN *** [5d Ac 4s] [5c]
tedbadger9: checks 
tipner: bets $4
tedbadger9: calls $4
*** RIVER *** [5d Ac 4s 5c] [Kd]
tedbadger9: bets $15.28
tipner: calls $15.28
*** SHOW DOWN ***
tedbadger9: shows [4d 4c] (a full house, Fours full of Fives)
tipner: mucks hand 
tedbadger9 collected $44.46 from pot
*** SUMMARY ***
Total pot $46.56 | Rake $2.10 
Board [5d Ac 4s 5c Kd]
Seat 1: matiko09 folded before Flop (didn't bet)
Seat 2: sanpidk folded before Flop (didn't bet)
Seat 4: Venomous100% folded before Flop (didn't bet)
Seat 5: lixiangli folded before Flop (didn't bet)
Seat 7: melitakas (button) folded before Flop (didn't bet)
Seat 8: tedbadger9 (small blind) showed [4d 4c] and won ($44.46) with a full house, Fours full of Fives
Seat 9: tipner (big blind) mucked [5s Ts]





PokerStars Hand #148218659191:  Hold'em No Limit ($0.50/$1.00 USD) - 2016/02/04 15:08:31 CET [2016/02/04 9:08:31 ET]
Table 'Cepheus III' 9-max Seat #9 is the button
Seat 1: PeterBassett ($94.67 in chips) 
Seat 3: pandalapa ($100 in chips) 
Seat 5: ARTVOR640 ($145.43 in chips) 
Seat 6: matiko09 ($100 in chips) 
Seat 7: Igor DoUrden ($100 in chips) 
Seat 8: nickreason17 ($113.16 in chips) 
Seat 9: xxxZeka ($107.42 in chips) 
PeterBassett: posts small blind $0.50
TimStone: is sitting out 
pandalapa: posts big blind $1
*** HOLE CARDS ***
Dealt to matiko09 [8h 4h]
TimStone leaves the table
Vikulja1993 joins the table at seat #2 
ARTVOR640: folds 
matiko09: folds 
Igor DoUrden: raises $1.50 to $2.50
nickreason17: folds 
xxxZeka: calls $2.50
PeterBassett: folds 
pandalapa: raises $7.50 to $10
Igor DoUrden: folds 
xxxZeka: folds 
Uncalled bet ($7.50) returned to pandalapa
pandalapa collected $8 from pot
pandalapa: doesn't show hand 
*** SUMMARY ***
Total pot $8 | Rake $0 
Seat 1: PeterBassett (small blind) folded before Flop
Seat 3: pandalapa (big blind) collected ($8)
Seat 5: ARTVOR640 folded before Flop (didn't bet)
Seat 6: matiko09 folded before Flop (didn't bet)
Seat 7: Igor DoUrden folded before Flop
Seat 8: nickreason17 folded before Flop (didn't bet)
Seat 9: xxxZeka (button) folded before Flop





PokerStars Hand #148218668043:  Hold'em No Limit ($0.50/$1.00 USD) - 2016/02/04 15:08:43 CET [2016/02/04 9:08:43 ET]
Table 'Arneb III' 9-max Seat #2 is the button
Seat 1: Vikulja1993 ($100 in chips) 
Seat 2: JeanLima93 ($201.60 in chips) 
Seat 3: matiko09 ($106.94 in chips) 
Seat 4: Igor DoUrden ($240.31 in chips) 
Seat 5: tipner ($101 in chips) 
Seat 6: nickreason17 ($133.70 in chips) 
Seat 7: Spid1 ($104.22 in chips) 
Seat 9: ARTVOR640 ($100 in chips) 
matiko09: posts small blind $0.50
Igor DoUrden: posts big blind $1
volwebni4ek: sits out 
*** HOLE CARDS ***
Dealt to matiko09 [As 5h]
tipner: folds 
nickreason17: raises $2 to $3
Spid1: folds 
ARTVOR640: folds 
Vikulja1993: folds 
JeanLima93: folds 
matiko09: folds 
Igor DoUrden: folds 
Uncalled bet ($2) returned to nickreason17
nickreason17 collected $2.50 from pot
*** SUMMARY ***
Total pot $2.50 | Rake $0 
Seat 1: Vikulja1993 folded before Flop (didn't bet)
Seat 2: JeanLima93 (button) folded before Flop (didn't bet)
Seat 3: matiko09 (small blind) folded before Flop
Seat 4: Igor DoUrden (big blind) folded before Flop
Seat 5: tipner folded before Flop (didn't bet)
Seat 6: nickreason17 collected ($2.50)
Seat 7: Spid1 folded before Flop (didn't bet)
Seat 9: ARTVOR640 folded before Flop (didn't bet)





PokerStars Hand #148218675602:  Hold'em No Limit ($0.50/$1.00 USD) - 2016/02/04 15:08:53 CET [2016/02/04 9:08:53 ET]
Table 'Asios III' 9-max Seat #4 is the button
Seat 1: yourpro ($136.50 in chips) 
Seat 2: crime8783 ($32.35 in chips) 
Seat 3: Igor DoUrden ($104.03 in chips) 
Seat 4: TimStone ($100 in chips) 
Seat 6: matiko09 ($136.95 in chips) 
Seat 7: nickreason17 ($149.11 in chips) 
Seat 9: Vikulja1993 ($158.70 in chips) 
matiko09: posts small blind $0.50
nickreason17: posts big blind $1
*** HOLE CARDS ***
Dealt to matiko09 [8c 9s]
Vikulja1993: folds 
yourpro: raises $1.87 to $2.87
crime8783: calls $2.87
Igor DoUrden: folds 
TimStone: folds 
matiko09: folds 
nickreason17: folds 
*** FLOP *** [2s Ks Js]
yourpro: bets $4.62
crime8783: calls $4.62
*** TURN *** [2s Ks Js] [Qc]
yourpro: checks 
crime8783: checks 
*** RIVER *** [2s Ks Js Qc] [4c]
yourpro: checks 
crime8783: checks 
*** SHOW DOWN ***
yourpro: shows [Qd Ah] (a pair of Queens)
crime8783: mucks hand 
yourpro collected $15.74 from pot
*** SUMMARY ***
Total pot $16.48 | Rake $0.74 
Board [2s Ks Js Qc 4c]
Seat 1: yourpro showed [Qd Ah] and won ($15.74) with a pair of Queens
Seat 2: crime8783 mucked [3s 3d]
Seat 3: Igor DoUrden folded before Flop (didn't bet)
Seat 4: TimStone (button) folded before Flop (didn't bet)
Seat 6: matiko09 (small blind) folded before Flop
Seat 7: nickreason17 (big blind) folded before Flop
Seat 9: Vikulja1993 folded before Flop (didn't bet)





PokerStars Hand #148218691334:  Hold'em No Limit ($0.50/$1.00 USD) - 2016/02/04 15:09:15 CET [2016/02/04 9:09:15 ET]
Table 'Arneb III' 9-max Seat #3 is the button
Seat 1: Vikulja1993 ($100 in chips) 
Seat 2: JeanLima93 ($201.60 in chips) 
Seat 3: matiko09 ($106.44 in chips) 
Seat 4: Igor DoUrden ($239.31 in chips) 
Seat 5: tipner ($101 in chips) 
Seat 6: nickreason17 ($135.20 in chips) 
Seat 7: Spid1 ($104.22 in chips) 
Seat 9: ARTVOR640 ($100 in chips) 
Igor DoUrden: posts small blind $0.50
tipner: posts big blind $1
volwebni4ek: sits out 
*** HOLE CARDS ***
Dealt to matiko09 [9c Jd]
nickreason17: raises $2 to $3
Spid1: folds 
ARTVOR640: folds 
Vikulja1993: calls $3
JeanLima93: folds 
matiko09: folds 
Igor DoUrden: folds 
tipner: raises $10 to $13
nickreason17: folds 
Vikulja1993: raises $12 to $25
tipner: folds 
Uncalled bet ($12) returned to Vikulja1993
Vikulja1993 collected $29.50 from pot
Vikulja1993: doesn't show hand 
*** SUMMARY ***
Total pot $29.50 | Rake $0 
Seat 1: Vikulja1993 collected ($29.50)
Seat 2: JeanLima93 folded before Flop (didn't bet)
Seat 3: matiko09 (button) folded before Flop (didn't bet)
Seat 4: Igor DoUrden (small blind) folded before Flop
Seat 5: tipner (big blind) folded before Flop
Seat 6: nickreason17 folded before Flop
Seat 7: Spid1 folded before Flop (didn't bet)
Seat 9: ARTVOR640 folded before Flop (didn't bet)





PokerStars Hand #148218694427:  Hold'em No Limit ($0.50/$1.00 USD) - 2016/02/04 15:09:19 CET [2016/02/04 9:09:19 ET]
Table 'Cepheus III' 9-max Seat #1 is the button
Seat 1: PeterBassett ($94.17 in chips) 
Seat 3: pandalapa ($105.50 in chips) 
Seat 4: lukeylund ($49.52 in chips) 
Seat 5: ARTVOR640 ($145.43 in chips) 
Seat 6: matiko09 ($100 in chips) 
Seat 7: Igor DoUrden ($100 in chips) 
Seat 8: nickreason17 ($113.16 in chips) 
Seat 9: xxxZeka ($104.92 in chips) 
Vikulja1993 will be allowed to play after the button
pandalapa: posts small blind $0.50
lukeylund: posts big blind $1
*** HOLE CARDS ***
Dealt to matiko09 [5h 2d]
ARTVOR640: folds 
matiko09: folds 
Igor DoUrden: folds 
nickreason17: raises $2 to $3
xxxZeka: folds 
PeterBassett: calls $3
pandalapa: folds 
lukeylund: folds 
*** FLOP *** [7d 2h 9c]
nickreason17: checks 
PeterBassett: checks 
*** TURN *** [7d 2h 9c] [Qs]
nickreason17: checks 
PeterBassett: bets $4
nickreason17: calls $4
*** RIVER *** [7d 2h 9c Qs] [7s]
nickreason17: checks 
PeterBassett: checks 
*** SHOW DOWN ***
nickreason17: shows [9d 8d] (two pair, Nines and Sevens)
PeterBassett: mucks hand 
nickreason17 collected $14.80 from pot
*** SUMMARY ***
Total pot $15.50 | Rake $0.70 
Board [7d 2h 9c Qs 7s]
Seat 1: PeterBassett (button) mucked [Js Kh]
Seat 3: pandalapa (small blind) folded before Flop
Seat 4: lukeylund (big blind) folded before Flop
Seat 5: ARTVOR640 folded before Flop (didn't bet)
Seat 6: matiko09 folded before Flop (didn't bet)
Seat 7: Igor DoUrden folded before Flop (didn't bet)
Seat 8: nickreason17 showed [9d 8d] and won ($14.80) with two pair, Nines and Sevens
Seat 9: xxxZeka folded before Flop (didn't bet)





PokerStars Hand #148218716533:  Hold'em No Limit ($0.50/$1.00 USD) - 2016/02/04 15:09:50 CET [2016/02/04 9:09:50 ET]
Table 'Arneb II' 9-max Seat #8 is the button
Seat 1: matiko09 ($100 in chips) 
Seat 2: sanpidk ($208.80 in chips) 
Seat 4: Venomous100% ($127.55 in chips) 
Seat 5: lixiangli ($77.77 in chips) 
Seat 7: melitakas ($262.67 in chips) 
Seat 8: tedbadger9 ($94.18 in chips) 
Seat 9: tipner ($100 in chips) 
tipner: posts small blind $0.50
matiko09: posts big blind $1
brille-390: sits out 
*** HOLE CARDS ***
Dealt to matiko09 [Js 4c]
sanpidk: folds 
Venomous100%: folds 
lixiangli: folds 
melitakas: folds 
tedbadger9: raises $2 to $3
tipner: folds 
matiko09: folds 
Uncalled bet ($2) returned to tedbadger9
tedbadger9 collected $2.50 from pot
*** SUMMARY ***
Total pot $2.50 | Rake $0 
Seat 1: matiko09 (big blind) folded before Flop
Seat 2: sanpidk folded before Flop (didn't bet)
Seat 4: Venomous100% folded before Flop (didn't bet)
Seat 5: lixiangli folded before Flop (didn't bet)
Seat 7: melitakas folded before Flop (didn't bet)
Seat 8: tedbadger9 (button) collected ($2.50)
Seat 9: tipner (small blind) folded before Flop





PokerStars Hand #148218727784:  Hold'em No Limit ($0.50/$1.00 USD) - 2016/02/04 15:10:05 CET [2016/02/04 9:10:05 ET]
Table 'Asios III' 9-max Seat #6 is the button
Seat 1: yourpro ($144.75 in chips) 
Seat 2: crime8783 ($24.86 in chips) 
Seat 3: Igor DoUrden ($104.03 in chips) 
Seat 4: TimStone ($100 in chips) 
Seat 6: matiko09 ($136.45 in chips) 
Seat 7: nickreason17 ($148.11 in chips) 
Seat 9: Vikulja1993 ($158.70 in chips) 
nickreason17: posts small blind $0.50
Vikulja1993: posts big blind $1
*** HOLE CARDS ***
Dealt to matiko09 [7s 5h]
yourpro: raises $1.87 to $2.87
crime8783: folds 
Igor DoUrden: folds 
TimStone: folds 
matiko09: folds 
nickreason17: folds 
Vikulja1993: folds 
Uncalled bet ($1.87) returned to yourpro
yourpro collected $2.50 from pot
yourpro: doesn't show hand 
*** SUMMARY ***
Total pot $2.50 | Rake $0 
Seat 1: yourpro collected ($2.50)
Seat 2: crime8783 folded before Flop (didn't bet)
Seat 3: Igor DoUrden folded before Flop (didn't bet)
Seat 4: TimStone folded before Flop (didn't bet)
Seat 6: matiko09 (button) folded before Flop (didn't bet)
Seat 7: nickreason17 (small blind) folded before Flop
Seat 9: Vikulja1993 (big blind) folded before Flop





PokerStars Hand #148218734696:  Hold'em No Limit ($0.50/$1.00 USD) - 2016/02/04 15:10:15 CET [2016/02/04 9:10:15 ET]
Table 'Cepheus III' 9-max Seat #3 is the button
Seat 1: PeterBassett ($87.17 in chips) 
Seat 3: pandalapa ($105 in chips) 
Seat 4: lukeylund ($48.52 in chips) 
Seat 5: ARTVOR640 ($145.43 in chips) 
Seat 6: matiko09 ($100 in chips) 
Seat 7: Igor DoUrden ($100 in chips) 
Seat 8: nickreason17 ($120.96 in chips) 
Seat 9: xxxZeka ($104.92 in chips) 
lukeylund: posts small blind $0.50
ARTVOR640: posts big blind $1
Vikulja1993: sits out 
*** HOLE CARDS ***
Dealt to matiko09 [Ah Kc]
matiko09: raises $2 to $3
Igor DoUrden: folds 
nickreason17: folds 
xxxZeka: raises $5 to $8
PeterBassett: folds 
pandalapa: folds 
lukeylund: folds 
ARTVOR640: folds 
matiko09: calls $5
*** FLOP *** [9c Kd 6c]
matiko09: checks 
xxxZeka: checks 
*** TURN *** [9c Kd 6c] [3c]
matiko09: bets $8.68
PeterBassett leaves the table
ozone2003 joins the table at seat #1 
xxxZeka: folds 
Uncalled bet ($8.68) returned to matiko09
matiko09 collected $16.71 from pot
matiko09: doesn't show hand 
*** SUMMARY ***
Total pot $17.50 | Rake $0.79 
Board [9c Kd 6c 3c]
Seat 1: PeterBassett folded before Flop (didn't bet)
Seat 3: pandalapa (button) folded before Flop (didn't bet)
Seat 4: lukeylund (small blind) folded before Flop
Seat 5: ARTVOR640 (big blind) folded before Flop
Seat 6: matiko09 collected ($16.71)
Seat 7: Igor DoUrden folded before Flop (didn't bet)
Seat 8: nickreason17 folded before Flop (didn't bet)
Seat 9: xxxZeka folded on the Turn





PokerStars Hand #148218738404:  Hold'em No Limit ($0.50/$1.00 USD) - 2016/02/04 15:10:20 CET [2016/02/04 9:10:20 ET]
Table 'Arneb III' 9-max Seat #4 is the button
Seat 1: Vikulja1993 ($116.50 in chips) 
Seat 2: JeanLima93 ($201.60 in chips) 
Seat 3: matiko09 ($106.44 in chips) 
Seat 4: Igor DoUrden ($238.81 in chips) 
Seat 5: tipner ($100 in chips) 
Seat 6: nickreason17 ($132.20 in chips) 
Seat 7: Spid1 ($104.22 in chips) 
Seat 9: ARTVOR640 ($100 in chips) 
tipner: posts small blind $0.50
nickreason17: posts big blind $1
volwebni4ek: sits out 
*** HOLE CARDS ***
Dealt to matiko09 [Ah 9s]
Spid1: folds 
ARTVOR640: folds 
Vikulja1993: folds 
JeanLima93: folds 
matiko09: folds 
Igor DoUrden: raises $1.09 to $2.09
tipner: folds 
nickreason17: folds 
Uncalled bet ($1.09) returned to Igor DoUrden
Igor DoUrden collected $2.50 from pot
Igor DoUrden: doesn't show hand 
*** SUMMARY ***
Total pot $2.50 | Rake $0 
Seat 1: Vikulja1993 folded before Flop (didn't bet)
Seat 2: JeanLima93 folded before Flop (didn't bet)
Seat 3: matiko09 folded before Flop (didn't bet)
Seat 4: Igor DoUrden (button) collected ($2.50)
Seat 5: tipner (small blind) folded before Flop
Seat 6: nickreason17 (big blind) folded before Flop
Seat 7: Spid1 folded before Flop (didn't bet)
Seat 9: ARTVOR640 folded before Flop (didn't bet)





PokerStars Hand #148218739909:  Hold'em No Limit ($0.50/$1.00 USD) - 2016/02/04 15:10:22 CET [2016/02/04 9:10:22 ET]
Table 'Arneb II' 9-max Seat #9 is the button
Seat 1: matiko09 ($100 in chips) 
Seat 2: sanpidk ($208.80 in chips) 
Seat 4: Venomous100% ($127.55 in chips) 
Seat 5: lixiangli ($77.77 in chips) 
Seat 7: melitakas ($262.67 in chips) 
Seat 8: tedbadger9 ($95.68 in chips) 
Seat 9: tipner ($100 in chips) 
matiko09: posts small blind $0.50
sanpidk: posts big blind $1
brille-390: sits out 
*** HOLE CARDS ***
Dealt to matiko09 [7s 4d]
Venomous100%: folds 
lixiangli: folds 
melitakas: folds 
tedbadger9: folds 
tipner: raises $1.50 to $2.50
matiko09: folds 
sanpidk: calls $1.50
*** FLOP *** [Th Kd Jd]
sanpidk: bets $4
tipner: calls $4
*** TURN *** [Th Kd Jd] [5d]
sanpidk: bets $8
tipner: calls $8
*** RIVER *** [Th Kd Jd 5d] [Ah]
sanpidk: checks 
tipner: checks 
*** SHOW DOWN ***
sanpidk: shows [Ks Jh] (two pair, Kings and Jacks)
tipner: shows [Qd Kc] (a straight, Ten to Ace)
tipner collected $28.17 from pot
*** SUMMARY ***
Total pot $29.50 | Rake $1.33 
Board [Th Kd Jd 5d Ah]
Seat 1: matiko09 (small blind) folded before Flop
Seat 2: sanpidk (big blind) showed [Ks Jh] and lost with two pair, Kings and Jacks
Seat 4: Venomous100% folded before Flop (didn't bet)
Seat 5: lixiangli folded before Flop (didn't bet)
Seat 7: melitakas folded before Flop (didn't bet)
Seat 8: tedbadger9 folded before Flop (didn't bet)
Seat 9: tipner (button) showed [Qd Kc] and won ($28.17) with a straight, Ten to Ace





PokerStars Hand #148218754248:  Hold'em No Limit ($0.50/$1.00 USD) - 2016/02/04 15:10:42 CET [2016/02/04 9:10:42 ET]
Table 'Arneb III' 9-max Seat #5 is the button
Seat 1: Vikulja1993 ($116.50 in chips) 
Seat 2: JeanLima93 ($201.60 in chips) 
Seat 3: matiko09 ($106.44 in chips) 
Seat 4: Igor DoUrden ($240.31 in chips) 
Seat 5: tipner ($100 in chips) 
Seat 6: nickreason17 ($131.20 in chips) 
Seat 7: Spid1 ($104.22 in chips) 
Seat 9: ARTVOR640 ($100 in chips) 
nickreason17: posts small blind $0.50
Spid1: posts big blind $1
volwebni4ek: sits out 
*** HOLE CARDS ***
Dealt to matiko09 [Qd 6s]
ARTVOR640: raises $1.50 to $2.50
Vikulja1993 has timed out
Vikulja1993: folds 
JeanLima93: calls $2.50
matiko09: folds 
Igor DoUrden: folds 
tipner: raises $9.50 to $12
nickreason17: folds 
Spid1: folds 
ARTVOR640: folds 
JeanLima93: calls $9.50
*** FLOP *** [Qh 7d Kd]
JeanLima93: bets $13.37
tipner: raises $15.63 to $29
JeanLima93: calls $15.63
*** TURN *** [Qh 7d Kd] [4d]
JeanLima93: checks 
tipner: bets $59 and is all-in
JeanLima93: folds 
Uncalled bet ($59) returned to tipner
tipner collected $83.20 from pot
tipner: doesn't show hand 
*** SUMMARY ***
Total pot $86 | Rake $2.80 
Board [Qh 7d Kd 4d]
Seat 1: Vikulja1993 folded before Flop (didn't bet)
Seat 2: JeanLima93 folded on the Turn
Seat 3: matiko09 folded before Flop (didn't bet)
Seat 4: Igor DoUrden folded before Flop (didn't bet)
Seat 5: tipner (button) collected ($83.20)
Seat 6: nickreason17 (small blind) folded before Flop
Seat 7: Spid1 (big blind) folded before Flop
Seat 9: ARTVOR640 folded before Flop





PokerStars Hand #148218762629:  Hold'em No Limit ($0.50/$1.00 USD) - 2016/02/04 15:10:53 CET [2016/02/04 9:10:53 ET]
Table 'Asios III' 9-max Seat #7 is the button
Seat 1: yourpro ($146.25 in chips) 
Seat 2: crime8783 ($24.86 in chips) 
Seat 3: Igor DoUrden ($104.03 in chips) 
Seat 4: TimStone ($100 in chips) 
Seat 6: matiko09 ($136.45 in chips) 
Seat 7: nickreason17 ($147.61 in chips) 
Seat 9: Vikulja1993 ($157.70 in chips) 
Vikulja1993: posts small blind $0.50
yourpro: posts big blind $1
*** HOLE CARDS ***
Dealt to matiko09 [Kc Jh]
crime8783: raises $2 to $3
Igor DoUrden: folds 
TimStone: folds 
matiko09: folds 
nickreason17: raises $6 to $9
Vikulja1993: folds 
yourpro: folds 
crime8783: calls $6
*** FLOP *** [6h 7s As]
crime8783: checks 
nickreason17: checks 
*** TURN *** [6h 7s As] [9s]
crime8783: checks 
nickreason17: checks 
*** RIVER *** [6h 7s As 9s] [2d]
crime8783: bets $9.31
nickreason17: calls $9.31
*** SHOW DOWN ***
crime8783: shows [Kh Js] (high card Ace)
nickreason17: shows [Qh Qd] (a pair of Queens)
nickreason17 collected $36.40 from pot
*** SUMMARY ***
Total pot $38.12 | Rake $1.72 
Board [6h 7s As 9s 2d]
Seat 1: yourpro (big blind) folded before Flop
Seat 2: crime8783 showed [Kh Js] and lost with high card Ace
Seat 3: Igor DoUrden folded before Flop (didn't bet)
Seat 4: TimStone folded before Flop (didn't bet)
Seat 6: matiko09 folded before Flop (didn't bet)
Seat 7: nickreason17 (button) showed [Qh Qd] and won ($36.40) with a pair of Queens
Seat 9: Vikulja1993 (small blind) folded before Flop





PokerStars Hand #148218783337:  Hold'em No Limit ($0.50/$1.00 USD) - 2016/02/04 15:11:21 CET [2016/02/04 9:11:21 ET]
Table 'Arneb II' 9-max Seat #1 is the button
Seat 1: matiko09 ($100 in chips) 
Seat 2: sanpidk ($194.30 in chips) 
Seat 3: brille-390 ($100 in chips) 
Seat 4: Venomous100% ($127.55 in chips) 
Seat 5: lixiangli ($77.77 in chips) 
Seat 7: melitakas ($262.67 in chips) 
Seat 8: tedbadger9 ($95.68 in chips) 
Seat 9: tipner ($113.67 in chips) 
sanpidk: posts small blind $0.50
brille-390: posts big blind $1
*** HOLE CARDS ***
Dealt to matiko09 [7h 8d]
Venomous100%: raises $2 to $3
lixiangli: folds 
melitakas: folds 
tedbadger9: calls $3
tipner: folds 
matiko09: folds 
sanpidk: calls $2.50
brille-390: folds 
*** FLOP *** [5s 6c 6s]
sanpidk: bets $6.50
Venomous100%: calls $6.50
tedbadger9: folds 
*** TURN *** [5s 6c 6s] [Kd]
sanpidk: bets $14.50
Venomous100%: calls $14.50
*** RIVER *** [5s 6c 6s Kd] [2c]
sanpidk: bets $28.83
Venomous100%: folds 
Uncalled bet ($28.83) returned to sanpidk
sanpidk collected $49.66 from pot
sanpidk: doesn't show hand 
*** SUMMARY ***
Total pot $52 | Rake $2.34 
Board [5s 6c 6s Kd 2c]
Seat 1: matiko09 (button) folded before Flop (didn't bet)
Seat 2: sanpidk (small blind) collected ($49.66)
Seat 3: brille-390 (big blind) folded before Flop
Seat 4: Venomous100% folded on the River
Seat 5: lixiangli folded before Flop (didn't bet)
Seat 7: melitakas folded before Flop (didn't bet)
Seat 8: tedbadger9 folded on the Flop
Seat 9: tipner folded before Flop (didn't bet)





PokerStars Hand #148218803560:  Hold'em No Limit ($0.50/$1.00 USD) - 2016/02/04 15:11:49 CET [2016/02/04 9:11:49 ET]
Table 'Cepheus III' 9-max Seat #4 is the button
Seat 3: pandalapa ($105 in chips) 
Seat 4: lukeylund ($48.02 in chips) 
Seat 5: ARTVOR640 ($144.43 in chips) 
Seat 6: matiko09 ($108.71 in chips) 
Seat 7: Igor DoUrden ($100 in chips) 
Seat 8: nickreason17 ($120.96 in chips) 
Seat 9: xxxZeka ($100 in chips) 
ARTVOR640: posts small blind $0.50
matiko09: posts big blind $1
ozone2003: sits out 
Vikulja1993: sits out 
*** HOLE CARDS ***
Dealt to matiko09 [Js As]
Igor DoUrden: folds 
nickreason17: folds 
xxxZeka: folds 
pandalapa: folds 
lukeylund: folds 
ARTVOR640: folds 
Uncalled bet ($0.50) returned to matiko09
matiko09 collected $1 from pot
matiko09: doesn't show hand 
*** SUMMARY ***
Total pot $1 | Rake $0 
Seat 3: pandalapa folded before Flop (didn't bet)
Seat 4: lukeylund (button) folded before Flop (didn't bet)
Seat 5: ARTVOR640 (small blind) folded before Flop
Seat 6: matiko09 (big blind) collected ($1)
Seat 7: Igor DoUrden folded before Flop (didn't bet)
Seat 8: nickreason17 folded before Flop (didn't bet)
Seat 9: xxxZeka folded before Flop (didn't bet)





PokerStars Hand #148218807717:  Hold'em No Limit ($0.50/$1.00 USD) - 2016/02/04 15:11:55 CET [2016/02/04 9:11:55 ET]
Table 'Asios III' 9-max Seat #9 is the button
Seat 1: yourpro ($145.25 in chips) 
Seat 2: crime8783 ($6.55 in chips) 
Seat 3: Igor DoUrden ($104.03 in chips) 
Seat 4: TimStone ($100 in chips) 
Seat 6: matiko09 ($136.45 in chips) 
Seat 7: nickreason17 ($165.70 in chips) 
Seat 9: Vikulja1993 ($157.20 in chips) 
yourpro: posts small blind $0.50
crime8783: posts big blind $1
*** HOLE CARDS ***
Dealt to matiko09 [Th Kd]
Igor DoUrden: folds 
TimStone: folds 
matiko09: folds 
nickreason17: folds 
Vikulja1993: folds 
yourpro: raises $1.41 to $2.41
crime8783: raises $4.14 to $6.55 and is all-in
yourpro: calls $4.14
*** FLOP *** [6c Kc 4s]
*** TURN *** [6c Kc 4s] [6d]
*** RIVER *** [6c Kc 4s 6d] [Qd]
*** SHOW DOWN ***
yourpro: shows [6s As] (three of a kind, Sixes)
crime8783: shows [Qs 7s] (two pair, Queens and Sixes)
yourpro collected $12.51 from pot
*** SUMMARY ***
Total pot $13.10 | Rake $0.59 
Board [6c Kc 4s 6d Qd]
Seat 1: yourpro (small blind) showed [6s As] and won ($12.51) with three of a kind, Sixes
Seat 2: crime8783 (big blind) showed [Qs 7s] and lost with two pair, Queens and Sixes
Seat 3: Igor DoUrden folded before Flop (didn't bet)
Seat 4: TimStone folded before Flop (didn't bet)
Seat 6: matiko09 folded before Flop (didn't bet)
Seat 7: nickreason17 folded before Flop (didn't bet)
Seat 9: Vikulja1993 (button) folded before Flop (didn't bet)





PokerStars Hand #148218815670:  Hold'em No Limit ($0.50/$1.00 USD) - 2016/02/04 15:12:06 CET [2016/02/04 9:12:06 ET]
Table 'Cepheus III' 9-max Seat #5 is the button
Seat 3: pandalapa ($105 in chips) 
Seat 4: lukeylund ($48.02 in chips) 
Seat 5: ARTVOR640 ($143.93 in chips) 
Seat 6: matiko09 ($109.21 in chips) 
Seat 7: Igor DoUrden ($100 in chips) 
Seat 8: nickreason17 ($120.96 in chips) 
Seat 9: xxxZeka ($100 in chips) 
matiko09: posts small blind $0.50
Igor DoUrden: posts big blind $1
ozone2003: sits out 
Vikulja1993: sits out 
*** HOLE CARDS ***
Dealt to matiko09 [6s 9d]
nickreason17: folds 
xxxZeka: folds 
pandalapa: folds 
lukeylund: folds 
ARTVOR640: folds 
nickreason17 leaves the table
matiko09: folds 
Uncalled bet ($0.50) returned to Igor DoUrden
Igor DoUrden collected $1 from pot
Igor DoUrden: doesn't show hand 
*** SUMMARY ***
Total pot $1 | Rake $0 
Seat 3: pandalapa folded before Flop (didn't bet)
Seat 4: lukeylund folded before Flop (didn't bet)
Seat 5: ARTVOR640 (button) folded before Flop (didn't bet)
Seat 6: matiko09 (small blind) folded before Flop
Seat 7: Igor DoUrden (big blind) collected ($1)
Seat 8: nickreason17 folded before Flop (didn't bet)
Seat 9: xxxZeka folded before Flop (didn't bet)





PokerStars Hand #148218823925:  Hold'em No Limit ($0.50/$1.00 USD) - 2016/02/04 15:12:17 CET [2016/02/04 9:12:17 ET]
Table 'Cepheus III' 9-max Seat #6 is the button
Seat 3: pandalapa ($105 in chips) 
Seat 4: lukeylund ($48.02 in chips) 
Seat 5: ARTVOR640 ($143.93 in chips) 
Seat 6: matiko09 ($108.71 in chips) 
Seat 7: Igor DoUrden ($100.50 in chips) 
Seat 9: xxxZeka ($100 in chips) 
Igor DoUrden: posts small blind $0.50
xxxZeka: posts big blind $1
ozone2003: sits out 
Vikulja1993: sits out 
*** HOLE CARDS ***
Dealt to matiko09 [Jd 7s]
pandalapa: folds 
lukeylund: raises $1 to $2
ARTVOR640: folds 
matiko09: folds 
omorfadramou joins the table at seat #8 
Igor DoUrden: folds 
xxxZeka: folds 
Uncalled bet ($1) returned to lukeylund
lukeylund collected $2.50 from pot
lukeylund: doesn't show hand 
*** SUMMARY ***
Total pot $2.50 | Rake $0 
Seat 3: pandalapa folded before Flop (didn't bet)
Seat 4: lukeylund collected ($2.50)
Seat 5: ARTVOR640 folded before Flop (didn't bet)
Seat 6: matiko09 (button) folded before Flop (didn't bet)
Seat 7: Igor DoUrden (small blind) folded before Flop
Seat 9: xxxZeka (big blind) folded before Flop





PokerStars Hand #148218830909:  Hold'em No Limit ($0.50/$1.00 USD) - 2016/02/04 15:12:26 CET [2016/02/04 9:12:26 ET]
Table 'Arneb III' 9-max Seat #6 is the button
Seat 1: Vikulja1993 ($116.50 in chips) 
Seat 2: JeanLima93 ($160.60 in chips) 
Seat 3: matiko09 ($106.44 in chips) 
Seat 4: Igor DoUrden ($240.31 in chips) 
Seat 5: tipner ($142.20 in chips) 
Seat 6: nickreason17 ($130.70 in chips) 
Seat 7: Spid1 ($103.22 in chips) 
Seat 8: volwebni4ek ($40 in chips) 
Seat 9: ARTVOR640 ($100 in chips) 
Spid1: posts small blind $0.50
volwebni4ek: posts big blind $1
*** HOLE CARDS ***
Dealt to matiko09 [7s 8s]
ARTVOR640: folds 
Vikulja1993: folds 
JeanLima93: folds 
matiko09: raises $2 to $3
Igor DoUrden: folds 
tipner: folds 
nickreason17: folds 
Spid1: folds 
volwebni4ek: folds 
Uncalled bet ($2) returned to matiko09
matiko09 collected $2.50 from pot
matiko09: doesn't show hand 
*** SUMMARY ***
Total pot $2.50 | Rake $0 
Seat 1: Vikulja1993 folded before Flop (didn't bet)
Seat 2: JeanLima93 folded before Flop (didn't bet)
Seat 3: matiko09 collected ($2.50)
Seat 4: Igor DoUrden folded before Flop (didn't bet)
Seat 5: tipner folded before Flop (didn't bet)
Seat 6: nickreason17 (button) folded before Flop (didn't bet)
Seat 7: Spid1 (small blind) folded before Flop
Seat 8: volwebni4ek (big blind) folded before Flop
Seat 9: ARTVOR640 folded before Flop (didn't bet)





PokerStars Hand #148218849575:  Hold'em No Limit ($0.50/$1.00 USD) - 2016/02/04 15:12:52 CET [2016/02/04 9:12:52 ET]
Table 'Cepheus III' 9-max Seat #7 is the button
Seat 1: ozone2003 ($100 in chips) 
Seat 3: pandalapa ($105 in chips) 
Seat 4: lukeylund ($49.52 in chips) 
Seat 5: ARTVOR640 ($143.93 in chips) 
Seat 6: matiko09 ($108.71 in chips) 
Seat 7: Igor DoUrden ($100 in chips) 
Seat 9: xxxZeka ($100 in chips) 
omorfadramou will be allowed to play after the button
xxxZeka: posts small blind $0.50
ozone2003: posts big blind $1
Vikulja1993: sits out 
*** HOLE CARDS ***
Dealt to matiko09 [Kd Js]
pandalapa: folds 
lukeylund: folds 
ARTVOR640: folds 
matiko09: raises $1.50 to $2.50
Igor DoUrden: folds 
xxxZeka: folds 
ozone2003: folds 
Uncalled bet ($1.50) returned to matiko09
matiko09 collected $2.50 from pot
matiko09: doesn't show hand 
*** SUMMARY ***
Total pot $2.50 | Rake $0 
Seat 1: ozone2003 (big blind) folded before Flop
Seat 3: pandalapa folded before Flop (didn't bet)
Seat 4: lukeylund folded before Flop (didn't bet)
Seat 5: ARTVOR640 folded before Flop (didn't bet)
Seat 6: matiko09 collected ($2.50)
Seat 7: Igor DoUrden (button) folded before Flop (didn't bet)
Seat 9: xxxZeka (small blind) folded before Flop





PokerStars Hand #148218859755:  Hold'em No Limit ($0.50/$1.00 USD) - 2016/02/04 15:13:06 CET [2016/02/04 9:13:06 ET]
Table 'Arneb III' 9-max Seat #7 is the button
Seat 1: Vikulja1993 ($116.50 in chips) 
Seat 2: JeanLima93 ($160.60 in chips) 
Seat 3: matiko09 ($107.94 in chips) 
Seat 4: Igor DoUrden ($240.31 in chips) 
Seat 5: tipner ($142.20 in chips) 
Seat 6: nickreason17 ($130.70 in chips) 
Seat 7: Spid1 ($102.72 in chips) 
Seat 8: volwebni4ek ($40 in chips) 
Seat 9: ARTVOR640 ($100 in chips) 
volwebni4ek: posts small blind $0.50
ARTVOR640: posts big blind $1
*** HOLE CARDS ***
Dealt to matiko09 [2h 3d]
Vikulja1993 has timed out
Vikulja1993: folds 
JeanLima93: folds 
matiko09: folds 
Igor DoUrden: raises $1.50 to $2.50
tipner: folds 
nickreason17: folds 
Spid1: folds 
volwebni4ek: folds 
ARTVOR640: folds 
Uncalled bet ($1.50) returned to Igor DoUrden
Igor DoUrden collected $2.50 from pot
Igor DoUrden: doesn't show hand 
*** SUMMARY ***
Total pot $2.50 | Rake $0 
Seat 1: Vikulja1993 folded before Flop (didn't bet)
Seat 2: JeanLima93 folded before Flop (didn't bet)
Seat 3: matiko09 folded before Flop (didn't bet)
Seat 4: Igor DoUrden collected ($2.50)
Seat 5: tipner folded before Flop (didn't bet)
Seat 6: nickreason17 folded before Flop (didn't bet)
Seat 7: Spid1 (button) folded before Flop (didn't bet)
Seat 8: volwebni4ek (small blind) folded before Flop
Seat 9: ARTVOR640 (big blind) folded before Flop





PokerStars Hand #148218871919:  Hold'em No Limit ($0.50/$1.00 USD) - 2016/02/04 15:13:23 CET [2016/02/04 9:13:23 ET]
Table 'Cepheus III' 9-max Seat #9 is the button
Seat 1: ozone2003 ($100 in chips) 
Seat 2: Vikulja1993 ($100 in chips) 
Seat 3: pandalapa ($105 in chips) 
Seat 4: lukeylund ($49.52 in chips) 
Seat 5: ARTVOR640 ($143.93 in chips) 
Seat 6: matiko09 ($110.21 in chips) 
Seat 7: Igor DoUrden ($100 in chips) 
Seat 9: xxxZeka ($100 in chips) 
ozone2003: posts small blind $0.50
Vikulja1993: posts big blind $1
omorfadramou: sits out 
*** HOLE CARDS ***
Dealt to matiko09 [7c Ad]
pandalapa: folds 
lukeylund: calls $1
ARTVOR640: folds 
matiko09: folds 
Igor DoUrden: folds 
xxxZeka: folds 
ozone2003: folds 
Vikulja1993: raises $3 to $4
lukeylund: calls $3
*** FLOP *** [7d 4s 5s]
Vikulja1993: checks 
lukeylund: checks 
*** TURN *** [7d 4s 5s] [9s]
Vikulja1993: checks 
lukeylund: checks 
*** RIVER *** [7d 4s 5s 9s] [5h]
Vikulja1993: checks 
lukeylund: checks 
*** SHOW DOWN ***
Vikulja1993: shows [8d Qd] (a pair of Fives)
lukeylund: mucks hand 
Vikulja1993 collected $8.12 from pot
*** SUMMARY ***
Total pot $8.50 | Rake $0.38 
Board [7d 4s 5s 9s 5h]
Seat 1: ozone2003 (small blind) folded before Flop
Seat 2: Vikulja1993 (big blind) showed [8d Qd] and won ($8.12) with a pair of Fives
Seat 3: pandalapa folded before Flop (didn't bet)
Seat 4: lukeylund mucked [Jh Ts]
Seat 5: ARTVOR640 folded before Flop (didn't bet)
Seat 6: matiko09 folded before Flop (didn't bet)
Seat 7: Igor DoUrden folded before Flop (didn't bet)
Seat 9: xxxZeka (button) folded before Flop (didn't bet)





PokerStars Hand #148218883728:  Hold'em No Limit ($0.50/$1.00 USD) - 2016/02/04 15:13:39 CET [2016/02/04 9:13:39 ET]
Table 'Asios III' 9-max Seat #1 is the button
Seat 1: yourpro ($151.21 in chips) 
Seat 3: Igor DoUrden ($104.03 in chips) 
Seat 4: TimStone ($100 in chips) 
Seat 6: matiko09 ($136.45 in chips) 
Seat 7: nickreason17 ($165.70 in chips) 
Seat 9: Vikulja1993 ($157.20 in chips) 
Igor DoUrden: posts small blind $0.50
TimStone: posts big blind $1
*** HOLE CARDS ***
Dealt to matiko09 [8s 9c]
matiko09: folds 
nickreason17: folds 
Vikulja1993: raises $1.50 to $2.50
yourpro: folds 
Igor DoUrden: folds 
TimStone: folds 
Uncalled bet ($1.50) returned to Vikulja1993
Vikulja1993 collected $2.50 from pot
Vikulja1993: doesn't show hand 
*** SUMMARY ***
Total pot $2.50 | Rake $0 
Seat 1: yourpro (button) folded before Flop (didn't bet)
Seat 3: Igor DoUrden (small blind) folded before Flop
Seat 4: TimStone (big blind) folded before Flop
Seat 6: matiko09 folded before Flop (didn't bet)
Seat 7: nickreason17 folded before Flop (didn't bet)
Seat 9: Vikulja1993 collected ($2.50)





PokerStars Hand #148218901535:  Hold'em No Limit ($0.50/$1.00 USD) - 2016/02/04 15:14:04 CET [2016/02/04 9:14:04 ET]
Table 'Arneb III' 9-max Seat #8 is the button
Seat 1: Vikulja1993 ($116.50 in chips) 
Seat 2: JeanLima93 ($160.60 in chips) 
Seat 3: matiko09 ($107.94 in chips) 
Seat 4: Igor DoUrden ($241.81 in chips) 
Seat 5: tipner ($142.20 in chips) 
Seat 6: nickreason17 ($130.70 in chips) 
Seat 7: Spid1 ($102.72 in chips) 
Seat 8: volwebni4ek ($40 in chips) 
Seat 9: ARTVOR640 ($100 in chips) 
ARTVOR640: posts small blind $0.50
Vikulja1993: posts big blind $1
*** HOLE CARDS ***
Dealt to matiko09 [8d As]
JeanLima93: folds 
matiko09: folds 
Igor DoUrden: folds 
tipner: raises $2 to $3
nickreason17: folds 
Spid1: folds 
volwebni4ek: folds 
ARTVOR640: folds 
Vikulja1993: folds 
Uncalled bet ($2) returned to tipner
tipner collected $2.50 from pot
tipner: doesn't show hand 
*** SUMMARY ***
Total pot $2.50 | Rake $0 
Seat 1: Vikulja1993 (big blind) folded before Flop
Seat 2: JeanLima93 folded before Flop (didn't bet)
Seat 3: matiko09 folded before Flop (didn't bet)
Seat 4: Igor DoUrden folded before Flop (didn't bet)
Seat 5: tipner collected ($2.50)
Seat 6: nickreason17 folded before Flop (didn't bet)
Seat 7: Spid1 folded before Flop (didn't bet)
Seat 8: volwebni4ek (button) folded before Flop (didn't bet)
Seat 9: ARTVOR640 (small blind) folded before Flop





PokerStars Hand #148218902458:  Hold'em No Limit ($0.50/$1.00 USD) - 2016/02/04 15:14:05 CET [2016/02/04 9:14:05 ET]
Table 'Arneb II' 9-max Seat #2 is the button
Seat 1: matiko09 ($100 in chips) 
Seat 2: sanpidk ($219.96 in chips) 
Seat 3: brille-390 ($100 in chips) 
Seat 4: Venomous100% ($103.55 in chips) 
Seat 5: lixiangli ($77.77 in chips) 
Seat 7: melitakas ($262.67 in chips) 
Seat 8: tedbadger9 ($92.68 in chips) 
Seat 9: tipner ($113.67 in chips) 
brille-390: posts small blind $0.50
Venomous100%: posts big blind $1
*** HOLE CARDS ***
Dealt to matiko09 [Jh Ac]
lixiangli: folds 
melitakas: folds 
tedbadger9: folds 
tipner: folds 
matiko09: raises $1.50 to $2.50
sanpidk: folds 
brille-390: folds 
Venomous100%: folds 
Uncalled bet ($1.50) returned to matiko09
matiko09 collected $2.50 from pot
matiko09: doesn't show hand 
*** SUMMARY ***
Total pot $2.50 | Rake $0 
Seat 1: matiko09 collected ($2.50)
Seat 2: sanpidk (button) folded before Flop (didn't bet)
Seat 3: brille-390 (small blind) folded before Flop
Seat 4: Venomous100% (big blind) folded before Flop
Seat 5: lixiangli folded before Flop (didn't bet)
Seat 7: melitakas folded before Flop (didn't bet)
Seat 8: tedbadger9 folded before Flop (didn't bet)
Seat 9: tipner folded before Flop (didn't bet)





PokerStars Hand #148218914555:  Hold'em No Limit ($0.50/$1.00 USD) - 2016/02/04 15:14:22 CET [2016/02/04 9:14:22 ET]
Table 'Asios III' 9-max Seat #3 is the button
Seat 1: yourpro ($151.21 in chips) 
Seat 3: Igor DoUrden ($103.53 in chips) 
Seat 4: TimStone ($100 in chips) 
Seat 6: matiko09 ($136.45 in chips) 
Seat 7: nickreason17 ($165.70 in chips) 
Seat 9: Vikulja1993 ($158.70 in chips) 
TimStone: posts small blind $0.50
matiko09: posts big blind $1
*** HOLE CARDS ***
Dealt to matiko09 [Kd 3d]
nickreason17: folds 
Vikulja1993: raises $2 to $3
yourpro: raises $8 to $11
Igor DoUrden: folds 
TimStone: folds 
matiko09: folds 
Vikulja1993: folds 
Uncalled bet ($8) returned to yourpro
yourpro collected $7.50 from pot
yourpro: doesn't show hand 
*** SUMMARY ***
Total pot $7.50 | Rake $0 
Seat 1: yourpro collected ($7.50)
Seat 3: Igor DoUrden (button) folded before Flop (didn't bet)
Seat 4: TimStone (small blind) folded before Flop
Seat 6: matiko09 (big blind) folded before Flop
Seat 7: nickreason17 folded before Flop (didn't bet)
Seat 9: Vikulja1993 folded before Flop





PokerStars Hand #148218923191:  Hold'em No Limit ($0.50/$1.00 USD) - 2016/02/04 15:14:34 CET [2016/02/04 9:14:34 ET]
Table 'Arneb III' 9-max Seat #9 is the button
Seat 1: Vikulja1993 ($115.50 in chips) 
Seat 2: JeanLima93 ($160.60 in chips) 
Seat 3: matiko09 ($107.94 in chips) 
Seat 4: Igor DoUrden ($241.81 in chips) 
Seat 5: tipner ($143.70 in chips) 
Seat 6: nickreason17 ($130.70 in chips) 
Seat 7: Spid1 ($102.72 in chips) 
Seat 8: volwebni4ek ($40 in chips) 
Seat 9: ARTVOR640 ($100 in chips) 
Vikulja1993: posts small blind $0.50
JeanLima93: posts big blind $1
*** HOLE CARDS ***
Dealt to matiko09 [Kd 5d]
matiko09: folds 
Igor DoUrden: folds 
tipner: folds 
nickreason17: folds 
Spid1: raises $2 to $3
volwebni4ek: folds 
ARTVOR640: folds 
Vikulja1993: folds 
JeanLima93: folds 
Uncalled bet ($2) returned to Spid1
Spid1 collected $2.50 from pot
Spid1: doesn't show hand 
*** SUMMARY ***
Total pot $2.50 | Rake $0 
Seat 1: Vikulja1993 (small blind) folded before Flop
Seat 2: JeanLima93 (big blind) folded before Flop
Seat 3: matiko09 folded before Flop (didn't bet)
Seat 4: Igor DoUrden folded before Flop (didn't bet)
Seat 5: tipner folded before Flop (didn't bet)
Seat 6: nickreason17 folded before Flop (didn't bet)
Seat 7: Spid1 collected ($2.50)
Seat 8: volwebni4ek folded before Flop (didn't bet)
Seat 9: ARTVOR640 (button) folded before Flop (didn't bet)





PokerStars Hand #148218928886:  Hold'em No Limit ($0.50/$1.00 USD) - 2016/02/04 15:14:42 CET [2016/02/04 9:14:42 ET]
Table 'Arneb II' 9-max Seat #3 is the button
Seat 1: matiko09 ($101.50 in chips) 
Seat 2: sanpidk ($219.96 in chips) 
Seat 3: brille-390 ($100 in chips) 
Seat 4: Venomous100% ($102.55 in chips) 
Seat 5: lixiangli ($77.77 in chips) 
Seat 7: melitakas ($262.67 in chips) 
Seat 8: tedbadger9 ($92.68 in chips) 
Seat 9: tipner ($113.67 in chips) 
Venomous100%: posts small blind $0.50
lixiangli: posts big blind $1
*** HOLE CARDS ***
Dealt to matiko09 [3d 8c]
melitakas: raises $1 to $2
tedbadger9: folds 
tipner: folds 
matiko09: folds 
sanpidk: folds 
brille-390: folds 
Venomous100%: folds 
lixiangli: calls $1
*** FLOP *** [9d 9h 4d]
lixiangli: checks 
melitakas: bets $2
lixiangli: folds 
Uncalled bet ($2) returned to melitakas
melitakas collected $4.30 from pot
*** SUMMARY ***
Total pot $4.50 | Rake $0.20 
Board [9d 9h 4d]
Seat 1: matiko09 folded before Flop (didn't bet)
Seat 2: sanpidk folded before Flop (didn't bet)
Seat 3: brille-390 (button) folded before Flop (didn't bet)
Seat 4: Venomous100% (small blind) folded before Flop
Seat 5: lixiangli (big blind) folded on the Flop
Seat 7: melitakas collected ($4.30)
Seat 8: tedbadger9 folded before Flop (didn't bet)
Seat 9: tipner folded before Flop (didn't bet)





PokerStars Hand #148218941305:  Hold'em No Limit ($0.50/$1.00 USD) - 2016/02/04 15:14:59 CET [2016/02/04 9:14:59 ET]
Table 'Cepheus III' 9-max Seat #1 is the button
Seat 1: ozone2003 ($100 in chips) 
Seat 2: Vikulja1993 ($104.12 in chips) 
Seat 3: pandalapa ($105 in chips) 
Seat 4: lukeylund ($45.52 in chips) 
Seat 5: ARTVOR640 ($143.93 in chips) 
Seat 6: matiko09 ($110.21 in chips) 
Seat 7: Igor DoUrden ($100 in chips) 
Seat 9: xxxZeka ($100 in chips) 
Vikulja1993: posts small blind $0.50
pandalapa: posts big blind $1
omorfadramou: sits out 
*** HOLE CARDS ***
Dealt to matiko09 [4h 7d]
lukeylund: folds 
ARTVOR640: folds 
matiko09: folds 
Igor DoUrden: folds 
xxxZeka: folds 
ozone2003: raises $1.20 to $2.20
Vikulja1993: folds 
pandalapa: raises $4.80 to $7
ozone2003: raises $12 to $19
pandalapa: raises $86 to $105 and is all-in
ozone2003: calls $81 and is all-in
Uncalled bet ($5) returned to pandalapa
*** FLOP *** [Jd Td 6c]
*** TURN *** [Jd Td 6c] [8c]
*** RIVER *** [Jd Td 6c 8c] [5c]
*** SHOW DOWN ***
pandalapa: shows [As Ah] (a pair of Aces)
ozone2003: shows [Kd Kc] (a pair of Kings)
pandalapa collected $197.70 from pot
*** SUMMARY ***
Total pot $200.50 | Rake $2.80 
Board [Jd Td 6c 8c 5c]
Seat 1: ozone2003 (button) showed [Kd Kc] and lost with a pair of Kings
Seat 2: Vikulja1993 (small blind) folded before Flop
Seat 3: pandalapa (big blind) showed [As Ah] and won ($197.70) with a pair of Aces
Seat 4: lukeylund folded before Flop (didn't bet)
Seat 5: ARTVOR640 folded before Flop (didn't bet)
Seat 6: matiko09 folded before Flop (didn't bet)
Seat 7: Igor DoUrden folded before Flop (didn't bet)
Seat 9: xxxZeka folded before Flop (didn't bet)





PokerStars Hand #148218952520:  Hold'em No Limit ($0.50/$1.00 USD) - 2016/02/04 15:15:14 CET [2016/02/04 9:15:14 ET]
Table 'Asios III' 9-max Seat #4 is the button
Seat 1: yourpro ($155.71 in chips) 
Seat 3: Igor DoUrden ($103.53 in chips) 
Seat 4: TimStone ($100 in chips) 
Seat 6: matiko09 ($135.45 in chips) 
Seat 7: nickreason17 ($165.70 in chips) 
Seat 9: Vikulja1993 ($155.70 in chips) 
matiko09: posts small blind $0.50
nickreason17: posts big blind $1
*** HOLE CARDS ***
Dealt to matiko09 [7s Jh]
Vikulja1993: folds 
yourpro: folds 
Igor DoUrden: folds 
TimStone: raises $1.22 to $2.22
matiko09: folds 
nickreason17: calls $1.22
*** FLOP *** [Kd 7c As]
nickreason17: checks 
TimStone: checks 
*** TURN *** [Kd 7c As] [6c]
nickreason17: checks 
TimStone: bets $1.55
nickreason17: calls $1.55
*** RIVER *** [Kd 7c As 6c] [8d]
nickreason17: checks 
TimStone: bets $5.04
nickreason17: folds 
Uncalled bet ($5.04) returned to TimStone
TimStone collected $7.68 from pot
TimStone: doesn't show hand 
*** SUMMARY ***
Total pot $8.04 | Rake $0.36 
Board [Kd 7c As 6c 8d]
Seat 1: yourpro folded before Flop (didn't bet)
Seat 3: Igor DoUrden folded before Flop (didn't bet)
Seat 4: TimStone (button) collected ($7.68)
Seat 6: matiko09 (small blind) folded before Flop
Seat 7: nickreason17 (big blind) folded on the River
Seat 9: Vikulja1993 folded before Flop (didn't bet)





PokerStars Hand #148218953881:  Hold'em No Limit ($0.50/$1.00 USD) - 2016/02/04 15:15:16 CET [2016/02/04 9:15:16 ET]
Table 'Arneb III' 9-max Seat #1 is the button
Seat 1: Vikulja1993 ($115 in chips) 
Seat 2: JeanLima93 ($159.60 in chips) 
Seat 3: matiko09 ($107.94 in chips) 
Seat 4: Igor DoUrden ($241.81 in chips) 
Seat 5: tipner ($143.70 in chips) 
Seat 6: nickreason17 ($130.70 in chips) 
Seat 7: Spid1 ($104.22 in chips) 
Seat 8: volwebni4ek ($40 in chips) 
Seat 9: ARTVOR640 ($100 in chips) 
JeanLima93: posts small blind $0.50
matiko09: posts big blind $1
*** HOLE CARDS ***
Dealt to matiko09 [2c 5h]
Igor DoUrden: folds 
tipner: folds 
nickreason17: folds 
Spid1: raises $2 to $3
volwebni4ek: folds 
ARTVOR640: folds 
Vikulja1993: folds 
JeanLima93: folds 
matiko09: folds 
Uncalled bet ($2) returned to Spid1
Spid1 collected $2.50 from pot
Spid1: doesn't show hand 
*** SUMMARY ***
Total pot $2.50 | Rake $0 
Seat 1: Vikulja1993 (button) folded before Flop (didn't bet)
Seat 2: JeanLima93 (small blind) folded before Flop
Seat 3: matiko09 (big blind) folded before Flop
Seat 4: Igor DoUrden folded before Flop (didn't bet)
Seat 5: tipner folded before Flop (didn't bet)
Seat 6: nickreason17 folded before Flop (didn't bet)
Seat 7: Spid1 collected ($2.50)
Seat 8: volwebni4ek folded before Flop (didn't bet)
Seat 9: ARTVOR640 folded before Flop (didn't bet)





PokerStars Hand #148218961235:  Hold'em No Limit (€0.50/€1.00 EUR) - 2016/02/04 15:15:26 CET [2016/02/04 9:15:26 ET]
Table 'Ostenia' 9-max Seat #3 is the button
Seat 3: maxxmeister (€104.14 in chips) 
Seat 4: MagicKid777 (€123.59 in chips) 
Seat 5: matiko09 (€101.50 in chips) 
Seat 6: melitakas (€109.85 in chips) 
Seat 7: TimStone (€107.84 in chips) 
Seat 8: Venomous100% (€103.15 in chips) 
Seat 9: sanpidk (€100 in chips) 
MagicKid777: posts small blind €0.50
matiko09: posts big blind €1
*** HOLE CARDS ***
Dealt to matiko09 [6h Ts]
melitakas: folds 
TimStone: folds 
Venomous100%: folds 
sanpidk: folds 
maxxmeister: raises €2 to €3
MagicKid777: folds 
matiko09: folds 
Uncalled bet (€2) returned to maxxmeister
Dante63s joins the table at seat #2 
maxxmeister collected €2.50 from pot
maxxmeister: doesn't show hand 
*** SUMMARY ***
Total pot €2.50 | Rake €0 
Seat 3: maxxmeister (button) collected (€2.50)
Seat 4: MagicKid777 (small blind) folded before Flop
Seat 5: matiko09 (big blind) folded before Flop
Seat 6: melitakas folded before Flop (didn't bet)
Seat 7: TimStone folded before Flop (didn't bet)
Seat 8: Venomous100% folded before Flop (didn't bet)
Seat 9: sanpidk folded before Flop (didn't bet)





PokerStars Hand #148218966363:  Hold'em No Limit ($0.50/$1.00 USD) - 2016/02/04 15:15:33 CET [2016/02/04 9:15:33 ET]
Table 'Arneb II' 9-max Seat #4 is the button
Seat 1: matiko09 ($101.50 in chips) 
Seat 2: sanpidk ($219.96 in chips) 
Seat 3: brille-390 ($100 in chips) 
Seat 4: Venomous100% ($102.05 in chips) 
Seat 5: lixiangli ($75.77 in chips) 
Seat 7: melitakas ($264.97 in chips) 
Seat 8: tedbadger9 ($92.68 in chips) 
Seat 9: tipner ($113.67 in chips) 
lixiangli: posts small blind $0.50
melitakas: posts big blind $1
*** HOLE CARDS ***
Dealt to matiko09 [2s Qh]
tedbadger9: folds 
tipner: folds 
matiko09: folds 
sanpidk: folds 
brille-390: folds 
Venomous100%: raises $1 to $2
lixiangli: folds 
melitakas: folds 
Uncalled bet ($1) returned to Venomous100%
Venomous100% collected $2.50 from pot
Venomous100%: doesn't show hand 
*** SUMMARY ***
Total pot $2.50 | Rake $0 
Seat 1: matiko09 folded before Flop (didn't bet)
Seat 2: sanpidk folded before Flop (didn't bet)
Seat 3: brille-390 folded before Flop (didn't bet)
Seat 4: Venomous100% (button) collected ($2.50)
Seat 5: lixiangli (small blind) folded before Flop
Seat 7: melitakas (big blind) folded before Flop
Seat 8: tedbadger9 folded before Flop (didn't bet)
Seat 9: tipner folded before Flop (didn't bet)





PokerStars Hand #148218976921:  Hold'em No Limit ($0.50/$1.00 USD) - 2016/02/04 15:15:48 CET [2016/02/04 9:15:48 ET]
Table 'Arneb III' 9-max Seat #2 is the button
Seat 1: Vikulja1993 ($115 in chips) 
Seat 2: JeanLima93 ($159.10 in chips) 
Seat 3: matiko09 ($106.94 in chips) 
Seat 4: Igor DoUrden ($241.81 in chips) 
Seat 5: tipner ($143.70 in chips) 
Seat 6: nickreason17 ($130.70 in chips) 
Seat 7: Spid1 ($105.72 in chips) 
Seat 8: volwebni4ek ($40 in chips) 
Seat 9: ARTVOR640 ($100 in chips) 
matiko09: posts small blind $0.50
Igor DoUrden: posts big blind $1
*** HOLE CARDS ***
Dealt to matiko09 [3h Kd]
tipner: folds 
nickreason17: folds 
Spid1: folds 
volwebni4ek: folds 
ARTVOR640: folds 
Vikulja1993: raises $1.50 to $2.50
JeanLima93: calls $2.50
matiko09: folds 
Igor DoUrden: calls $1.50
*** FLOP *** [9h 3c 5d]
Igor DoUrden: checks 
Vikulja1993: checks 
JeanLima93: checks 
*** TURN *** [9h 3c 5d] [2d]
Igor DoUrden: checks 
Vikulja1993: checks 
JeanLima93: checks 
*** RIVER *** [9h 3c 5d 2d] [Qs]
Igor DoUrden: checks 
Vikulja1993: checks 
JeanLima93: bets $3.82
Igor DoUrden: folds 
Vikulja1993: folds 
Uncalled bet ($3.82) returned to JeanLima93
JeanLima93 collected $7.64 from pot
JeanLima93: doesn't show hand 
*** SUMMARY ***
Total pot $8 | Rake $0.36 
Board [9h 3c 5d 2d Qs]
Seat 1: Vikulja1993 folded on the River
Seat 2: JeanLima93 (button) collected ($7.64)
Seat 3: matiko09 (small blind) folded before Flop
Seat 4: Igor DoUrden (big blind) folded on the River
Seat 5: tipner folded before Flop (didn't bet)
Seat 6: nickreason17 folded before Flop (didn't bet)
Seat 7: Spid1 folded before Flop (didn't bet)
Seat 8: volwebni4ek folded before Flop (didn't bet)
Seat 9: ARTVOR640 folded before Flop (didn't bet)





PokerStars Hand #148218992028:  Hold'em No Limit (€0.50/€1.00 EUR) - 2016/02/04 15:16:09 CET [2016/02/04 9:16:09 ET]
Table 'Ostenia' 9-max Seat #4 is the button
Seat 3: maxxmeister (€105.64 in chips) 
Seat 4: MagicKid777 (€123.09 in chips) 
Seat 5: matiko09 (€100.50 in chips) 
Seat 6: melitakas (€109.85 in chips) 
Seat 7: TimStone (€107.84 in chips) 
Seat 8: Venomous100% (€103.15 in chips) 
Seat 9: sanpidk (€100 in chips) 
matiko09: posts small blind €0.50
melitakas: posts big blind €1
*** HOLE CARDS ***
Dealt to matiko09 [3s Qs]
TimStone: raises €2.01 to €3.01
Venomous100%: folds 
sanpidk: folds 
maxxmeister: folds 
MagicKid777: folds 
matiko09: folds 
melitakas: folds 
Uncalled bet (€2.01) returned to TimStone
TimStone collected €2.50 from pot
TimStone: doesn't show hand 
*** SUMMARY ***
Total pot €2.50 | Rake €0 
Seat 3: maxxmeister folded before Flop (didn't bet)
Seat 4: MagicKid777 (button) folded before Flop (didn't bet)
Seat 5: matiko09 (small blind) folded before Flop
Seat 6: melitakas (big blind) folded before Flop
Seat 7: TimStone collected (€2.50)
Seat 8: Venomous100% folded before Flop (didn't bet)
Seat 9: sanpidk folded before Flop (didn't bet)





PokerStars Hand #148218995906:  Hold'em No Limit ($0.50/$1.00 USD) - 2016/02/04 15:16:14 CET [2016/02/04 9:16:14 ET]
Table 'Cepheus III' 9-max Seat #2 is the button
Seat 1: ozone2003 ($100 in chips) 
Seat 2: Vikulja1993 ($103.62 in chips) 
Seat 3: pandalapa ($202.70 in chips) 
Seat 4: lukeylund ($45.52 in chips) 
Seat 5: ARTVOR640 ($143.93 in chips) 
Seat 6: matiko09 ($110.21 in chips) 
Seat 7: Igor DoUrden ($100 in chips) 
Seat 9: xxxZeka ($100 in chips) 
pandalapa: posts small blind $0.50
lukeylund: posts big blind $1
omorfadramou: sits out 
*** HOLE CARDS ***
Dealt to matiko09 [As 8h]
ARTVOR640: folds 
matiko09: folds 
Igor DoUrden: folds 
xxxZeka: folds 
ozone2003: folds 
Vikulja1993: raises $1 to $2
pandalapa: folds 
lukeylund: calls $1
*** FLOP *** [Ah Kd Jd]
lukeylund: checks 
Vikulja1993: checks 
*** TURN *** [Ah Kd Jd] [Tc]
lukeylund: checks 
Vikulja1993: checks 
*** RIVER *** [Ah Kd Jd Tc] [4c]
lukeylund: checks 
Vikulja1993: checks 
*** SHOW DOWN ***
lukeylund: shows [7s 9s] (high card Ace)
Vikulja1993: shows [3c 3d] (a pair of Threes)
Vikulja1993 collected $4.30 from pot
*** SUMMARY ***
Total pot $4.50 | Rake $0.20 
Board [Ah Kd Jd Tc 4c]
Seat 1: ozone2003 folded before Flop (didn't bet)
Seat 2: Vikulja1993 (button) showed [3c 3d] and won ($4.30) with a pair of Threes
Seat 3: pandalapa (small blind) folded before Flop
Seat 4: lukeylund (big blind) showed [7s 9s] and lost with high card Ace
Seat 5: ARTVOR640 folded before Flop (didn't bet)
Seat 6: matiko09 folded before Flop (didn't bet)
Seat 7: Igor DoUrden folded before Flop (didn't bet)
Seat 9: xxxZeka folded before Flop (didn't bet)





PokerStars Hand #148218998288:  Hold'em No Limit ($0.50/$1.00 USD) - 2016/02/04 15:16:17 CET [2016/02/04 9:16:17 ET]
Table 'Arneb II' 9-max Seat #5 is the button
Seat 1: matiko09 ($101.50 in chips) 
Seat 2: sanpidk ($219.96 in chips) 
Seat 3: brille-390 ($100 in chips) 
Seat 4: Venomous100% ($103.55 in chips) 
Seat 5: lixiangli ($75.27 in chips) 
Seat 7: melitakas ($263.97 in chips) 
Seat 8: tedbadger9 ($92.68 in chips) 
Seat 9: tipner ($113.67 in chips) 
melitakas: posts small blind $0.50
tedbadger9: posts big blind $1
*** HOLE CARDS ***
Dealt to matiko09 [2c 2h]
tipner: folds 
matiko09: raises $2 to $3
sanpidk: folds 
brille-390: folds 
Venomous100%: folds 
lixiangli: folds 
melitakas: folds 
tedbadger9: folds 
Uncalled bet ($2) returned to matiko09
matiko09 collected $2.50 from pot
matiko09: doesn't show hand 
*** SUMMARY ***
Total pot $2.50 | Rake $0 
Seat 1: matiko09 collected ($2.50)
Seat 2: sanpidk folded before Flop (didn't bet)
Seat 3: brille-390 folded before Flop (didn't bet)
Seat 4: Venomous100% folded before Flop (didn't bet)
Seat 5: lixiangli (button) folded before Flop (didn't bet)
Seat 7: melitakas (small blind) folded before Flop
Seat 8: tedbadger9 (big blind) folded before Flop
Seat 9: tipner folded before Flop (didn't bet)





PokerStars Hand #148219015181:  Hold'em No Limit ($0.50/$1.00 USD) - 2016/02/04 15:16:41 CET [2016/02/04 9:16:41 ET]
Table 'Asios III' 9-max Seat #6 is the button
Seat 1: yourpro ($155.71 in chips) 
Seat 3: Igor DoUrden ($103.53 in chips) 
Seat 4: TimStone ($103.91 in chips) 
Seat 6: matiko09 ($134.95 in chips) 
Seat 7: nickreason17 ($161.93 in chips) 
Seat 9: Vikulja1993 ($155.70 in chips) 
nickreason17: posts small blind $0.50
Vikulja1993: posts big blind $1
*** HOLE CARDS ***
Dealt to matiko09 [4s 9h]
yourpro: folds 
Igor DoUrden: folds 
crime8783 leaves the table
TimStone: folds 
matiko09: folds 
nickreason17: raises $1.50 to $2.50
Vikulja1993: folds 
Uncalled bet ($1.50) returned to nickreason17
nickreason17 collected $2 from pot
*** SUMMARY ***
Total pot $2 | Rake $0 
Seat 1: yourpro folded before Flop (didn't bet)
Seat 3: Igor DoUrden folded before Flop (didn't bet)
Seat 4: TimStone folded before Flop (didn't bet)
Seat 6: matiko09 (button) folded before Flop (didn't bet)
Seat 7: nickreason17 (small blind) collected ($2)
Seat 9: Vikulja1993 (big blind) folded before Flop





PokerStars Hand #148219016462:  Hold'em No Limit (€0.50/€1.00 EUR) - 2016/02/04 15:16:42 CET [2016/02/04 9:16:42 ET]
Table 'Ostenia' 9-max Seat #5 is the button
Seat 3: maxxmeister (€105.64 in chips) 
Seat 4: MagicKid777 (€123.09 in chips) 
Seat 5: matiko09 (€100 in chips) 
Seat 6: melitakas (€108.85 in chips) 
Seat 8: Venomous100% (€103.15 in chips) 
Seat 9: sanpidk (€100 in chips) 
melitakas: posts small blind €0.50
TimStone: is sitting out 
Venomous100%: posts big blind €1
*** HOLE CARDS ***
Dealt to matiko09 [Tc 9s]
TimStone leaves the table
sanpidk: folds 
maxxmeister: folds 
tipner joins the table at seat #7 
MagicKid777: calls €1
matiko09: raises €3 to €4
melitakas: calls €3.50
Venomous100%: raises €12 to €16
MagicKid777: folds 
matiko09: folds 
melitakas: folds 
Uncalled bet (€12) returned to Venomous100%
Venomous100% collected €13 from pot
Venomous100%: doesn't show hand 
*** SUMMARY ***
Total pot €13 | Rake €0 
Seat 3: maxxmeister folded before Flop (didn't bet)
Seat 4: MagicKid777 folded before Flop
Seat 5: matiko09 (button) folded before Flop
Seat 6: melitakas (small blind) folded before Flop
Seat 8: Venomous100% (big blind) collected (€13)
Seat 9: sanpidk folded before Flop (didn't bet)





PokerStars Hand #148219019541:  Hold'em No Limit ($0.50/$1.00 USD) - 2016/02/04 15:16:47 CET [2016/02/04 9:16:47 ET]
Table 'Arneb II' 9-max Seat #7 is the button
Seat 1: matiko09 ($103 in chips) 
Seat 2: sanpidk ($219.96 in chips) 
Seat 3: brille-390 ($100 in chips) 
Seat 4: Venomous100% ($103.55 in chips) 
Seat 5: lixiangli ($75.27 in chips) 
Seat 7: melitakas ($263.47 in chips) 
Seat 8: tedbadger9 ($91.68 in chips) 
Seat 9: tipner ($113.67 in chips) 
tedbadger9: posts small blind $0.50
tipner: posts big blind $1
*** HOLE CARDS ***
Dealt to matiko09 [7c Jh]
matiko09: folds 
sanpidk: folds 
brille-390: folds 
Venomous100%: folds 
lixiangli: folds 
melitakas: raises $1 to $2
tedbadger9: folds 
tipner: folds 
Uncalled bet ($1) returned to melitakas
melitakas collected $2.50 from pot
*** SUMMARY ***
Total pot $2.50 | Rake $0 
Seat 1: matiko09 folded before Flop (didn't bet)
Seat 2: sanpidk folded before Flop (didn't bet)
Seat 3: brille-390 folded before Flop (didn't bet)
Seat 4: Venomous100% folded before Flop (didn't bet)
Seat 5: lixiangli folded before Flop (didn't bet)
Seat 7: melitakas (button) collected ($2.50)
Seat 8: tedbadger9 (small blind) folded before Flop
Seat 9: tipner (big blind) folded before Flop





PokerStars Hand #148219037447:  Hold'em No Limit ($0.50/$1.00 USD) - 2016/02/04 15:17:11 CET [2016/02/04 9:17:11 ET]
Table 'Arneb II' 9-max Seat #8 is the button
Seat 1: matiko09 ($103 in chips) 
Seat 2: sanpidk ($219.96 in chips) 
Seat 3: brille-390 ($100 in chips) 
Seat 4: Venomous100% ($103.55 in chips) 
Seat 5: lixiangli ($75.27 in chips) 
Seat 7: melitakas ($264.97 in chips) 
Seat 8: tedbadger9 ($91.18 in chips) 
Seat 9: tipner ($112.67 in chips) 
tipner: posts small blind $0.50
matiko09: posts big blind $1
*** HOLE CARDS ***
Dealt to matiko09 [8d 9h]
sanpidk: folds 
brille-390: folds 
Venomous100%: folds 
lixiangli: folds 
melitakas: folds 
tedbadger9: folds 
tipner: raises $2 to $3
matiko09: folds 
Uncalled bet ($2) returned to tipner
tipner collected $2 from pot
tipner: doesn't show hand 
*** SUMMARY ***
Total pot $2 | Rake $0 
Seat 1: matiko09 (big blind) folded before Flop
Seat 2: sanpidk folded before Flop (didn't bet)
Seat 3: brille-390 folded before Flop (didn't bet)
Seat 4: Venomous100% folded before Flop (didn't bet)
Seat 5: lixiangli folded before Flop (didn't bet)
Seat 7: melitakas folded before Flop (didn't bet)
Seat 8: tedbadger9 (button) folded before Flop (didn't bet)
Seat 9: tipner (small blind) collected ($2)





PokerStars Hand #148219038200:  Hold'em No Limit ($0.50/$1.00 USD) - 2016/02/04 15:17:12 CET [2016/02/04 9:17:12 ET]
Table 'Asios III' 9-max Seat #7 is the button
Seat 1: yourpro ($155.71 in chips) 
Seat 3: Igor DoUrden ($103.53 in chips) 
Seat 4: TimStone ($103.91 in chips) 
Seat 6: matiko09 ($134.95 in chips) 
Seat 7: nickreason17 ($162.93 in chips) 
Seat 9: Vikulja1993 ($154.70 in chips) 
Vikulja1993: posts small blind $0.50
yourpro: posts big blind $1
*** HOLE CARDS ***
Dealt to matiko09 [As 8h]
Igor DoUrden: folds 
TimStone: folds 
matiko09: folds 
nickreason17: folds 
Vikulja1993: folds 
Uncalled bet ($0.50) returned to yourpro
yourpro collected $1 from pot
yourpro: doesn't show hand 
*** SUMMARY ***
Total pot $1 | Rake $0 
Seat 1: yourpro (big blind) collected ($1)
Seat 3: Igor DoUrden folded before Flop (didn't bet)
Seat 4: TimStone folded before Flop (didn't bet)
Seat 6: matiko09 folded before Flop (didn't bet)
Seat 7: nickreason17 (button) folded before Flop (didn't bet)
Seat 9: Vikulja1993 (small blind) folded before Flop





PokerStars Hand #148219040380:  Hold'em No Limit ($0.50/$1.00 USD) - 2016/02/04 15:17:15 CET [2016/02/04 9:17:15 ET]
Table 'Cepheus III' 9-max Seat #3 is the button
Seat 1: ozone2003 ($100 in chips) 
Seat 2: Vikulja1993 ($105.92 in chips) 
Seat 3: pandalapa ($202.20 in chips) 
Seat 4: lukeylund ($43.52 in chips) 
Seat 5: ARTVOR640 ($143.93 in chips) 
Seat 6: matiko09 ($110.21 in chips) 
Seat 7: Igor DoUrden ($100 in chips) 
Seat 9: xxxZeka ($100 in chips) 
lukeylund: posts small blind $0.50
ARTVOR640: posts big blind $1
omorfadramou: sits out 
*** HOLE CARDS ***
Dealt to matiko09 [Js 4c]
matiko09: folds 
Igor DoUrden: folds 
xxxZeka: folds 
ozone2003: folds 
Vikulja1993: folds 
pandalapa: folds 
lukeylund: calls $0.50
ARTVOR640: checks 
*** FLOP *** [Kd 5d Kc]
lukeylund: checks 
ARTVOR640: checks 
*** TURN *** [Kd 5d Kc] [Qc]
lukeylund: checks 
ARTVOR640: checks 
*** RIVER *** [Kd 5d Kc Qc] [3s]
lukeylund: bets $3
ARTVOR640: folds [3c]
Uncalled bet ($3) returned to lukeylund
lukeylund collected $1.91 from pot
lukeylund: doesn't show hand 
*** SUMMARY ***
Total pot $2 | Rake $0.09 
Board [Kd 5d Kc Qc 3s]
Seat 1: ozone2003 folded before Flop (didn't bet)
Seat 2: Vikulja1993 folded before Flop (didn't bet)
Seat 3: pandalapa (button) folded before Flop (didn't bet)
Seat 4: lukeylund (small blind) collected ($1.91)
Seat 5: ARTVOR640 (big blind) folded on the River
Seat 6: matiko09 folded before Flop (didn't bet)
Seat 7: Igor DoUrden folded before Flop (didn't bet)
Seat 9: xxxZeka folded before Flop (didn't bet)





PokerStars Hand #148219045291:  Hold'em No Limit ($0.50/$1.00 USD) - 2016/02/04 15:17:22 CET [2016/02/04 9:17:22 ET]
Table 'Arneb III' 9-max Seat #3 is the button
Seat 1: Vikulja1993 ($112.50 in chips) 
Seat 2: JeanLima93 ($164.24 in chips) 
Seat 3: matiko09 ($106.44 in chips) 
Seat 4: Igor DoUrden ($239.31 in chips) 
Seat 5: tipner ($143.70 in chips) 
Seat 6: nickreason17 ($130.70 in chips) 
Seat 7: Spid1 ($105.72 in chips) 
Seat 8: volwebni4ek ($40 in chips) 
Seat 9: ARTVOR640 ($100 in chips) 
Igor DoUrden: posts small blind $0.50
tipner: posts big blind $1
*** HOLE CARDS ***
Dealt to matiko09 [3d 4c]
nickreason17: folds 
Spid1: folds 
volwebni4ek: folds 
ARTVOR640: folds 
Vikulja1993: folds 
JeanLima93: folds 
matiko09: folds 
Igor DoUrden: folds 
Uncalled bet ($0.50) returned to tipner
tipner collected $1 from pot
tipner: doesn't show hand 
*** SUMMARY ***
Total pot $1 | Rake $0 
Seat 1: Vikulja1993 folded before Flop (didn't bet)
Seat 2: JeanLima93 folded before Flop (didn't bet)
Seat 3: matiko09 (button) folded before Flop (didn't bet)
Seat 4: Igor DoUrden (small blind) folded before Flop
Seat 5: tipner (big blind) collected ($1)
Seat 6: nickreason17 folded before Flop (didn't bet)
Seat 7: Spid1 folded before Flop (didn't bet)
Seat 8: volwebni4ek folded before Flop (didn't bet)
Seat 9: ARTVOR640 folded before Flop (didn't bet)





PokerStars Hand #148219045417:  Hold'em No Limit ($0.50/$1.00 USD) - 2016/02/04 15:17:22 CET [2016/02/04 9:17:22 ET]
Table 'Dejan' 9-max Seat #8 is the button
Seat 1: matiko09 ($100 in chips) 
Seat 2: xxxZeka ($104.50 in chips) 
Seat 3: lumen21 ($101.50 in chips) 
Seat 5: PeterBassett ($101.50 in chips) 
Seat 6: nickreason17 ($100 in chips) 
Seat 7: mycka86 ($124.13 in chips) 
Seat 8: s26s ($102.71 in chips) 
Seat 9: I The King I ($130.85 in chips) 
I The King I: posts small blind $0.50
matiko09: posts big blind $1
yourpro: sits out 
*** HOLE CARDS ***
Dealt to matiko09 [7c 4c]
xxxZeka: folds 
lumen21: folds 
PeterBassett: calls $1
nickreason17: folds 
mycka86: folds 
s26s: folds 
I The King I: raises $4 to $5
matiko09: folds 
PeterBassett: folds 
Uncalled bet ($4) returned to I The King I
I The King I collected $3 from pot
I The King I: doesn't show hand 
*** SUMMARY ***
Total pot $3 | Rake $0 
Seat 1: matiko09 (big blind) folded before Flop
Seat 2: xxxZeka folded before Flop (didn't bet)
Seat 3: lumen21 folded before Flop (didn't bet)
Seat 5: PeterBassett folded before Flop
Seat 6: nickreason17 folded before Flop (didn't bet)
Seat 7: mycka86 folded before Flop (didn't bet)
Seat 8: s26s (button) folded before Flop (didn't bet)
Seat 9: I The King I (small blind) collected ($3)





PokerStars Hand #148219047959:  Hold'em No Limit ($0.50/$1.00 USD) - 2016/02/04 15:17:25 CET [2016/02/04 9:17:25 ET]
Table 'Asios III' 9-max Seat #9 is the button
Seat 1: yourpro ($156.21 in chips) 
Seat 6: matiko09 ($134.95 in chips) 
Seat 7: nickreason17 ($162.93 in chips) 
Seat 9: Vikulja1993 ($154.20 in chips) 
yourpro: posts small blind $0.50
Igor DoUrden: is sitting out 
Igor DoUrden leaves the table
TimStone: is sitting out 
matiko09: posts big blind $1
*** HOLE CARDS ***
Dealt to matiko09 [Qd Ac]
TimStone leaves the table
nickreason17: folds 
xxxZeka joins the table at seat #2 
nickreason17 leaves the table
xxxZeka leaves the table
Vikulja1993: raises $1 to $2
yourpro: folds 
9lKBXKTT6 joins the table at seat #7 
matiko09: calls $1
*** FLOP *** [Jc 4h 9d]
I The King I joins the table at seat #2 
matiko09: checks 
9lKBXKTT6 leaves the table
Rafaello18 joins the table at seat #3 
I The King I leaves the table
Vikulja1993: bets $2
matiko09: calls $2
*** TURN *** [Jc 4h 9d] [5d]
matiko09: checks 
Vikulja1993: bets $6
matiko09: folds 
Uncalled bet ($6) returned to Vikulja1993
Vikulja1993 collected $8.12 from pot
Vikulja1993: doesn't show hand 
*** SUMMARY ***
Total pot $8.50 | Rake $0.38 
Board [Jc 4h 9d 5d]
Seat 1: yourpro (small blind) folded before Flop
Seat 6: matiko09 (big blind) folded on the Turn
Seat 7: nickreason17 folded before Flop (didn't bet)
Seat 9: Vikulja1993 (button) collected ($8.12)





PokerStars Hand #148219063997:  Hold'em No Limit ($0.50/$1.00 USD) - 2016/02/04 15:17:48 CET [2016/02/04 9:17:48 ET]
Table 'Arneb III' 9-max Seat #4 is the button
Seat 1: Vikulja1993 ($112.50 in chips) 
Seat 2: JeanLima93 ($164.24 in chips) 
Seat 3: matiko09 ($106.44 in chips) 
Seat 4: Igor DoUrden ($238.81 in chips) 
Seat 5: tipner ($144.20 in chips) 
Seat 6: nickreason17 ($130.70 in chips) 
Seat 7: Spid1 ($105.72 in chips) 
Seat 8: volwebni4ek ($40 in chips) 
Seat 9: ARTVOR640 ($100 in chips) 
tipner: posts small blind $0.50
nickreason17: posts big blind $1
*** HOLE CARDS ***
Dealt to matiko09 [8c 6d]
Spid1: folds 
volwebni4ek: folds 
ARTVOR640: folds 
Vikulja1993 has timed out
Vikulja1993: folds 
JeanLima93: folds 
matiko09: folds 
Igor DoUrden: folds 
tipner: folds 
Uncalled bet ($0.50) returned to nickreason17
nickreason17 collected $1 from pot
*** SUMMARY ***
Total pot $1 | Rake $0 
Seat 1: Vikulja1993 folded before Flop (didn't bet)
Seat 2: JeanLima93 folded before Flop (didn't bet)
Seat 3: matiko09 folded before Flop (didn't bet)
Seat 4: Igor DoUrden (button) folded before Flop (didn't bet)
Seat 5: tipner (small blind) folded before Flop
Seat 6: nickreason17 (big blind) collected ($1)
Seat 7: Spid1 folded before Flop (didn't bet)
Seat 8: volwebni4ek folded before Flop (didn't bet)
Seat 9: ARTVOR640 folded before Flop (didn't bet)





PokerStars Hand #148219069585:  Hold'em No Limit ($0.50/$1.00 USD) - 2016/02/04 15:17:55 CET [2016/02/04 9:17:55 ET]
Table 'Cepheus III' 9-max Seat #4 is the button
Seat 1: ozone2003 ($100 in chips) 
Seat 2: Vikulja1993 ($105.92 in chips) 
Seat 3: pandalapa ($202.20 in chips) 
Seat 4: lukeylund ($44.43 in chips) 
Seat 5: ARTVOR640 ($142.93 in chips) 
Seat 6: matiko09 ($110.21 in chips) 
Seat 7: Igor DoUrden ($100 in chips) 
Seat 9: xxxZeka ($100 in chips) 
ARTVOR640: posts small blind $0.50
matiko09: posts big blind $1
omorfadramou: sits out 
*** HOLE CARDS ***
Dealt to matiko09 [Ac 3s]
Igor DoUrden: folds 
xxxZeka: folds 
ozone2003: folds 
Vikulja1993: folds 
pandalapa: folds 
lukeylund: folds 
ARTVOR640: folds 
Uncalled bet ($0.50) returned to matiko09
matiko09 collected $1 from pot
matiko09: doesn't show hand 
*** SUMMARY ***
Total pot $1 | Rake $0 
Seat 1: ozone2003 folded before Flop (didn't bet)
Seat 2: Vikulja1993 folded before Flop (didn't bet)
Seat 3: pandalapa folded before Flop (didn't bet)
Seat 4: lukeylund (button) folded before Flop (didn't bet)
Seat 5: ARTVOR640 (small blind) folded before Flop
Seat 6: matiko09 (big blind) collected ($1)
Seat 7: Igor DoUrden folded before Flop (didn't bet)
Seat 9: xxxZeka folded before Flop (didn't bet)





PokerStars Hand #148219070118:  Hold'em No Limit (€0.50/€1.00 EUR) - 2016/02/04 15:17:56 CET [2016/02/04 9:17:56 ET]
Table 'Ostenia' 9-max Seat #6 is the button
Seat 3: maxxmeister (€105.64 in chips) 
Seat 4: MagicKid777 (€122.09 in chips) 
Seat 5: matiko09 (€100 in chips) 
Seat 6: melitakas (€104.85 in chips) 
Seat 8: Venomous100% (€112.15 in chips) 
Seat 9: sanpidk (€100 in chips) 
tipner will be allowed to play after the button
Venomous100%: posts small blind €0.50
sanpidk: posts big blind €1
*** HOLE CARDS ***
Dealt to matiko09 [2d Kd]
maxxmeister: folds 
MagicKid777: folds 
matiko09: folds 
melitakas: folds 
Venomous100%: folds 
Uncalled bet (€0.50) returned to sanpidk
sanpidk collected €1 from pot
sanpidk: doesn't show hand 
*** SUMMARY ***
Total pot €1 | Rake €0 
Seat 3: maxxmeister folded before Flop (didn't bet)
Seat 4: MagicKid777 folded before Flop (didn't bet)
Seat 5: matiko09 folded before Flop (didn't bet)
Seat 6: melitakas (button) folded before Flop (didn't bet)
Seat 8: Venomous100% (small blind) folded before Flop
Seat 9: sanpidk (big blind) collected (€1)





PokerStars Hand #148219073309:  Hold'em No Limit ($0.50/$1.00 USD) - 2016/02/04 15:18:00 CET [2016/02/04 9:18:00 ET]
Table 'Dejan' 9-max Seat #9 is the button
Seat 1: matiko09 ($100 in chips) 
Seat 2: xxxZeka ($104.50 in chips) 
Seat 3: lumen21 ($101.50 in chips) 
Seat 5: PeterBassett ($100.50 in chips) 
Seat 6: nickreason17 ($100 in chips) 
Seat 7: mycka86 ($124.13 in chips) 
Seat 8: s26s ($102.71 in chips) 
Seat 9: I The King I ($132.85 in chips) 
matiko09: posts small blind $0.50
xxxZeka: posts big blind $1
yourpro: sits out 
*** HOLE CARDS ***
Dealt to matiko09 [Tc 5h]
lumen21: folds 
PeterBassett: folds 
nickreason17: folds 
mycka86: folds 
s26s: folds 
I The King I: folds 
matiko09: folds 
Uncalled bet ($0.50) returned to xxxZeka
xxxZeka collected $1 from pot
*** SUMMARY ***
Total pot $1 | Rake $0 
Seat 1: matiko09 (small blind) folded before Flop
Seat 2: xxxZeka (big blind) collected ($1)
Seat 3: lumen21 folded before Flop (didn't bet)
Seat 5: PeterBassett folded before Flop (didn't bet)
Seat 6: nickreason17 folded before Flop (didn't bet)
Seat 7: mycka86 folded before Flop (didn't bet)
Seat 8: s26s folded before Flop (didn't bet)
Seat 9: I The King I (button) folded before Flop (didn't bet)





PokerStars Hand #148219072908:  Hold'em No Limit ($0.50/$1.00 USD) - 2016/02/04 15:18:00 CET [2016/02/04 9:18:00 ET]
Table 'Arneb II' 9-max Seat #9 is the button
Seat 1: matiko09 ($102 in chips) 
Seat 2: sanpidk ($219.96 in chips) 
Seat 3: brille-390 ($100 in chips) 
Seat 4: Venomous100% ($103.55 in chips) 
Seat 5: lixiangli ($75.27 in chips) 
Seat 7: melitakas ($264.97 in chips) 
Seat 8: tedbadger9 ($91.18 in chips) 
Seat 9: tipner ($113.67 in chips) 
matiko09: posts small blind $0.50
sanpidk: posts big blind $1
*** HOLE CARDS ***
Dealt to matiko09 [Qc 8s]
brille-390: folds 
Venomous100%: folds 
lixiangli: raises $1.50 to $2.50
melitakas: folds 
tedbadger9: folds 
tipner: folds 
matiko09: folds 
sanpidk: folds 
Uncalled bet ($1.50) returned to lixiangli
lixiangli collected $2.50 from pot
lixiangli: doesn't show hand 
*** SUMMARY ***
Total pot $2.50 | Rake $0 
Seat 1: matiko09 (small blind) folded before Flop
Seat 2: sanpidk (big blind) folded before Flop
Seat 3: brille-390 folded before Flop (didn't bet)
Seat 4: Venomous100% folded before Flop (didn't bet)
Seat 5: lixiangli collected ($2.50)
Seat 7: melitakas folded before Flop (didn't bet)
Seat 8: tedbadger9 folded before Flop (didn't bet)
Seat 9: tipner (button) folded before Flop (didn't bet)





PokerStars Hand #148219082324:  Hold'em No Limit (€0.50/€1.00 EUR) - 2016/02/04 15:18:13 CET [2016/02/04 9:18:13 ET]
Table 'Ostenia' 9-max Seat #8 is the button
Seat 3: maxxmeister (€105.64 in chips) 
Seat 4: MagicKid777 (€122.09 in chips) 
Seat 5: matiko09 (€100 in chips) 
Seat 6: melitakas (€104.85 in chips) 
Seat 8: Venomous100% (€111.65 in chips) 
Seat 9: sanpidk (€100.50 in chips) 
sanpidk: posts small blind €0.50
maxxmeister: posts big blind €1
tipner: sits out 
*** HOLE CARDS ***
Dealt to matiko09 [Qd 3s]
MagicKid777: folds 
matiko09: folds 
melitakas: folds 
Venomous100%: folds 
sanpidk: folds 
Uncalled bet (€0.50) returned to maxxmeister
maxxmeister collected €1 from pot
maxxmeister: doesn't show hand 
*** SUMMARY ***
Total pot €1 | Rake €0 
Seat 3: maxxmeister (big blind) collected (€1)
Seat 4: MagicKid777 folded before Flop (didn't bet)
Seat 5: matiko09 folded before Flop (didn't bet)
Seat 6: melitakas folded before Flop (didn't bet)
Seat 8: Venomous100% (button) folded before Flop (didn't bet)
Seat 9: sanpidk (small blind) folded before Flop





PokerStars Hand #148219091871:  Hold'em No Limit ($0.50/$1.00 USD) - 2016/02/04 15:18:26 CET [2016/02/04 9:18:26 ET]
Table 'Dejan' 9-max Seat #1 is the button
Seat 1: matiko09 ($100 in chips) 
Seat 2: xxxZeka ($105 in chips) 
Seat 3: lumen21 ($101.50 in chips) 
Seat 5: PeterBassett ($100.50 in chips) 
Seat 6: nickreason17 ($100 in chips) 
Seat 7: mycka86 ($124.13 in chips) 
Seat 8: s26s ($102.71 in chips) 
Seat 9: I The King I ($132.85 in chips) 
xxxZeka: posts small blind $0.50
lumen21: posts big blind $1
yourpro: sits out 
*** HOLE CARDS ***
Dealt to matiko09 [Qs Qd]
PeterBassett: folds 
nickreason17: folds 
mycka86: folds 
s26s: folds 
I The King I: raises $1.50 to $2.50
matiko09: raises $6 to $8.50
xxxZeka: folds 
lumen21: folds 
I The King I: folds 
Uncalled bet ($6) returned to matiko09
matiko09 collected $6.50 from pot
matiko09: doesn't show hand 
*** SUMMARY ***
Total pot $6.50 | Rake $0 
Seat 1: matiko09 (button) collected ($6.50)
Seat 2: xxxZeka (small blind) folded before Flop
Seat 3: lumen21 (big blind) folded before Flop
Seat 5: PeterBassett folded before Flop (didn't bet)
Seat 6: nickreason17 folded before Flop (didn't bet)
Seat 7: mycka86 folded before Flop (didn't bet)
Seat 8: s26s folded before Flop (didn't bet)
Seat 9: I The King I folded before Flop





PokerStars Hand #148219093473:  Hold'em No Limit (€0.50/€1.00 EUR) - 2016/02/04 15:18:28 CET [2016/02/04 9:18:28 ET]
Table 'Ostenia' 9-max Seat #9 is the button
Seat 3: maxxmeister (€106.14 in chips) 
Seat 4: MagicKid777 (€122.09 in chips) 
Seat 5: matiko09 (€100 in chips) 
Seat 6: melitakas (€104.85 in chips) 
Seat 8: Venomous100% (€111.65 in chips) 
Seat 9: sanpidk (€100 in chips) 
maxxmeister: posts small blind €0.50
MagicKid777: posts big blind €1
tipner: sits out 
*** HOLE CARDS ***
Dealt to matiko09 [Jh Th]
matiko09: raises €2 to €3
melitakas: folds 
Venomous100%: folds 
sanpidk: folds 
maxxmeister: folds 
MagicKid777: folds 
Uncalled bet (€2) returned to matiko09
matiko09 collected €2.50 from pot
matiko09: doesn't show hand 
*** SUMMARY ***
Total pot €2.50 | Rake €0 
Seat 3: maxxmeister (small blind) folded before Flop
Seat 4: MagicKid777 (big blind) folded before Flop
Seat 5: matiko09 collected (€2.50)
Seat 6: melitakas folded before Flop (didn't bet)
Seat 8: Venomous100% folded before Flop (didn't bet)
Seat 9: sanpidk (button) folded before Flop (didn't bet)





PokerStars Hand #148219094621:  Hold'em No Limit ($0.50/$1.00 USD) - 2016/02/04 15:18:30 CET [2016/02/04 9:18:30 ET]
Table 'Cepheus III' 9-max Seat #5 is the button
Seat 1: ozone2003 ($100 in chips) 
Seat 2: Vikulja1993 ($105.92 in chips) 
Seat 3: pandalapa ($202.20 in chips) 
Seat 4: lukeylund ($44.43 in chips) 
Seat 5: ARTVOR640 ($142.43 in chips) 
Seat 6: matiko09 ($110.71 in chips) 
Seat 7: Igor DoUrden ($100 in chips) 
Seat 9: xxxZeka ($100 in chips) 
matiko09: posts small blind $0.50
Igor DoUrden: posts big blind $1
omorfadramou: sits out 
*** HOLE CARDS ***
Dealt to matiko09 [Qc Jd]
xxxZeka: raises $2 to $3
ozone2003: folds 
Vikulja1993: folds 
pandalapa: folds 
lukeylund: folds 
ARTVOR640: folds 
matiko09: folds 
Igor DoUrden: calls $2
*** FLOP *** [7s Kh 4d]
Igor DoUrden: checks 
xxxZeka: bets $3.10
Igor DoUrden: calls $3.10
*** TURN *** [7s Kh 4d] [2c]
Igor DoUrden: checks 
xxxZeka: bets $7
Igor DoUrden: folds 
Uncalled bet ($7) returned to xxxZeka
xxxZeka collected $12.13 from pot
*** SUMMARY ***
Total pot $12.70 | Rake $0.57 
Board [7s Kh 4d 2c]
Seat 1: ozone2003 folded before Flop (didn't bet)
Seat 2: Vikulja1993 folded before Flop (didn't bet)
Seat 3: pandalapa folded before Flop (didn't bet)
Seat 4: lukeylund folded before Flop (didn't bet)
Seat 5: ARTVOR640 (button) folded before Flop (didn't bet)
Seat 6: matiko09 (small blind) folded before Flop
Seat 7: Igor DoUrden (big blind) folded on the Turn
Seat 9: xxxZeka collected ($12.13)





PokerStars Hand #148219097948:  Hold'em No Limit ($0.50/$1.00 USD) - 2016/02/04 15:18:35 CET [2016/02/04 9:18:35 ET]
Table 'Arneb II' 9-max Seat #1 is the button
Seat 1: matiko09 ($101.50 in chips) 
Seat 2: sanpidk ($218.96 in chips) 
Seat 3: brille-390 ($100 in chips) 
Seat 4: Venomous100% ($103.55 in chips) 
Seat 5: lixiangli ($76.77 in chips) 
Seat 7: melitakas ($264.97 in chips) 
Seat 8: tedbadger9 ($91.18 in chips) 
Seat 9: tipner ($113.67 in chips) 
sanpidk: posts small blind $0.50
brille-390: posts big blind $1
*** HOLE CARDS ***
Dealt to matiko09 [Qs Ah]
Venomous100%: folds 
lixiangli: folds 
melitakas: folds 
tedbadger9: folds 
tipner: folds 
matiko09: raises $1.27 to $2.27
sanpidk: folds 
brille-390: folds 
Uncalled bet ($1.27) returned to matiko09
matiko09 collected $2.50 from pot
matiko09: doesn't show hand 
*** SUMMARY ***
Total pot $2.50 | Rake $0 
Seat 1: matiko09 (button) collected ($2.50)
Seat 2: sanpidk (small blind) folded before Flop
Seat 3: brille-390 (big blind) folded before Flop
Seat 4: Venomous100% folded before Flop (didn't bet)
Seat 5: lixiangli folded before Flop (didn't bet)
Seat 7: melitakas folded before Flop (didn't bet)
Seat 8: tedbadger9 folded before Flop (didn't bet)
Seat 9: tipner folded before Flop (didn't bet)





PokerStars Hand #148219098345:  Hold'em No Limit ($0.50/$1.00 USD) - 2016/02/04 15:18:35 CET [2016/02/04 9:18:35 ET]
Table 'Arneb III' 9-max Seat #5 is the button
Seat 1: Vikulja1993 ($112.50 in chips) 
Seat 2: JeanLima93 ($164.24 in chips) 
Seat 3: matiko09 ($106.44 in chips) 
Seat 4: Igor DoUrden ($238.81 in chips) 
Seat 5: tipner ($143.70 in chips) 
Seat 6: nickreason17 ($131.20 in chips) 
Seat 8: volwebni4ek ($40 in chips) 
Seat 9: ARTVOR640 ($100 in chips) 
nickreason17: posts small blind $0.50
Spid1: is sitting out 
volwebni4ek: posts big blind $1
*** HOLE CARDS ***
Dealt to matiko09 [Ad 9h]
Spid1 leaves the table
ARTVOR640: folds 
Vikulja1993: folds 
JeanLima93: folds 
matiko09: folds 
Igor DoUrden: raises $1.50 to $2.50
tipner: folds 
nickreason17: raises $7 to $9.50
volwebni4ek: folds 
xxxZeka joins the table at seat #7 
Igor DoUrden: calls $7
*** FLOP *** [2d Ts Qc]
nickreason17: checks 
Igor DoUrden: checks 
*** TURN *** [2d Ts Qc] [3s]
nickreason17: checks 
Igor DoUrden: bets $10
nickreason17: calls $10
*** RIVER *** [2d Ts Qc 3s] [3h]
nickreason17: checks 
Igor DoUrden: checks 
*** SHOW DOWN ***
nickreason17: shows [Ah Ks] (a pair of Threes)
Igor DoUrden: shows [Js Jh] (two pair, Jacks and Threes)
Igor DoUrden collected $38.20 from pot
*** SUMMARY ***
Total pot $40 | Rake $1.80 
Board [2d Ts Qc 3s 3h]
Seat 1: Vikulja1993 folded before Flop (didn't bet)
Seat 2: JeanLima93 folded before Flop (didn't bet)
Seat 3: matiko09 folded before Flop (didn't bet)
Seat 4: Igor DoUrden showed [Js Jh] and won ($38.20) with two pair, Jacks and Threes
Seat 5: tipner (button) folded before Flop (didn't bet)
Seat 6: nickreason17 (small blind) showed [Ah Ks] and lost with a pair of Threes
Seat 8: volwebni4ek (big blind) folded before Flop
Seat 9: ARTVOR640 folded before Flop (didn't bet)





PokerStars Hand #148219106784:  Hold'em No Limit (€0.50/€1.00 EUR) - 2016/02/04 15:18:47 CET [2016/02/04 9:18:47 ET]
Table 'Ostenia' 9-max Seat #3 is the button
Seat 3: maxxmeister (€105.64 in chips) 
Seat 4: MagicKid777 (€121.09 in chips) 
Seat 5: matiko09 (€101.50 in chips) 
Seat 6: melitakas (€104.85 in chips) 
Seat 8: Venomous100% (€111.65 in chips) 
Seat 9: sanpidk (€100 in chips) 
MagicKid777: posts small blind €0.50
matiko09: posts big blind €1
tipner: sits out 
*** HOLE CARDS ***
Dealt to matiko09 [9s 8d]
melitakas: folds 
Venomous100%: folds 
sanpidk: folds 
maxxmeister: raises €2 to €3
MagicKid777: folds 
matiko09: raises €7 to €10
maxxmeister: folds 
Uncalled bet (€7) returned to matiko09
fastlife61 joins the table at seat #1 
matiko09 collected €6.50 from pot
matiko09: doesn't show hand 
*** SUMMARY ***
Total pot €6.50 | Rake €0 
Seat 3: maxxmeister (button) folded before Flop
Seat 4: MagicKid777 (small blind) folded before Flop
Seat 5: matiko09 (big blind) collected (€6.50)
Seat 6: melitakas folded before Flop (didn't bet)
Seat 8: Venomous100% folded before Flop (didn't bet)
Seat 9: sanpidk folded before Flop (didn't bet)





PokerStars Hand #148219120332:  Hold'em No Limit ($0.50/$1.00 USD) - 2016/02/04 15:19:05 CET [2016/02/04 9:19:05 ET]
Table 'Dejan' 9-max Seat #2 is the button
Seat 1: matiko09 ($104 in chips) 
Seat 2: xxxZeka ($104.50 in chips) 
Seat 3: lumen21 ($100.50 in chips) 
Seat 4: yourpro ($149.25 in chips) 
Seat 5: PeterBassett ($100.50 in chips) 
Seat 6: nickreason17 ($100 in chips) 
Seat 7: mycka86 ($124.13 in chips) 
Seat 8: s26s ($102.71 in chips) 
Seat 9: I The King I ($130.35 in chips) 
lumen21: posts small blind $0.50
yourpro: posts big blind $1
*** HOLE CARDS ***
Dealt to matiko09 [4d 6d]
PeterBassett: raises $1 to $2
nickreason17: folds 
mycka86: folds 
s26s: folds 
I The King I: folds 
matiko09: folds 
xxxZeka: calls $2
lumen21: folds 
yourpro: folds 
*** FLOP *** [4s Ac 3h]
PeterBassett: checks 
xxxZeka: checks 
*** TURN *** [4s Ac 3h] [8c]
PeterBassett: checks 
xxxZeka: bets $3.49
PeterBassett: folds 
Uncalled bet ($3.49) returned to xxxZeka
xxxZeka collected $5.25 from pot
*** SUMMARY ***
Total pot $5.50 | Rake $0.25 
Board [4s Ac 3h 8c]
Seat 1: matiko09 folded before Flop (didn't bet)
Seat 2: xxxZeka (button) collected ($5.25)
Seat 3: lumen21 (small blind) folded before Flop
Seat 4: yourpro (big blind) folded before Flop
Seat 5: PeterBassett folded on the Turn
Seat 6: nickreason17 folded before Flop (didn't bet)
Seat 7: mycka86 folded before Flop (didn't bet)
Seat 8: s26s folded before Flop (didn't bet)
Seat 9: I The King I folded before Flop (didn't bet)





PokerStars Hand #148219127234:  Hold'em No Limit ($0.50/$1.00 USD) - 2016/02/04 15:19:15 CET [2016/02/04 9:19:15 ET]
Table 'Arneb II' 9-max Seat #2 is the button
Seat 1: matiko09 ($103 in chips) 
Seat 2: sanpidk ($218.46 in chips) 
Seat 3: brille-390 ($100 in chips) 
Seat 4: Venomous100% ($103.55 in chips) 
Seat 5: lixiangli ($76.77 in chips) 
Seat 7: melitakas ($264.97 in chips) 
Seat 8: tedbadger9 ($91.18 in chips) 
Seat 9: tipner ($113.67 in chips) 
brille-390: posts small blind $0.50
Venomous100%: posts big blind $1
*** HOLE CARDS ***
Dealt to matiko09 [2d 4d]
lixiangli: folds 
melitakas: raises $1 to $2
tedbadger9: calls $2
tipner: folds 
matiko09: folds 
sanpidk: folds 
brille-390: folds 
Venomous100%: folds 
*** FLOP *** [Kd Qd Ac]
melitakas: bets $2.62
tedbadger9: calls $2.62
*** TURN *** [Kd Qd Ac] [Jh]
melitakas: checks 
tedbadger9: checks 
*** RIVER *** [Kd Qd Ac Jh] [7c]
melitakas: checks 
tedbadger9: checks 
*** SHOW DOWN ***
melitakas: shows [2h 2s] (a pair of Deuces)
tedbadger9: shows [5s Ah] (a pair of Aces)
tedbadger9 collected $10.26 from pot
*** SUMMARY ***
Total pot $10.74 | Rake $0.48 
Board [Kd Qd Ac Jh 7c]
Seat 1: matiko09 folded before Flop (didn't bet)
Seat 2: sanpidk (button) folded before Flop (didn't bet)
Seat 3: brille-390 (small blind) folded before Flop
Seat 4: Venomous100% (big blind) folded before Flop
Seat 5: lixiangli folded before Flop (didn't bet)
Seat 7: melitakas showed [2h 2s] and lost with a pair of Deuces
Seat 8: tedbadger9 showed [5s Ah] and won ($10.26) with a pair of Aces
Seat 9: tipner folded before Flop (didn't bet)





PokerStars Hand #148219133560:  Hold'em No Limit (€0.50/€1.00 EUR) - 2016/02/04 15:19:24 CET [2016/02/04 9:19:24 ET]
Table 'Ostenia' 9-max Seat #4 is the button
Seat 3: maxxmeister (€102.64 in chips) 
Seat 4: MagicKid777 (€120.59 in chips) 
Seat 5: matiko09 (€105 in chips) 
Seat 6: melitakas (€104.85 in chips) 
Seat 8: Venomous100% (€111.65 in chips) 
Seat 9: sanpidk (€100 in chips) 
matiko09: posts small blind €0.50
melitakas: posts big blind €1
tipner: sits out 
fastlife61: sits out 
*** HOLE CARDS ***
Dealt to matiko09 [9h Kd]
Venomous100%: folds 
sanpidk: folds 
maxxmeister: folds 
MagicKid777: folds 
matiko09: raises €1.50 to €2.50
melitakas: folds 
Uncalled bet (€1.50) returned to matiko09
matiko09 collected €2 from pot
matiko09: doesn't show hand 
*** SUMMARY ***
Total pot €2 | Rake €0 
Seat 3: maxxmeister folded before Flop (didn't bet)
Seat 4: MagicKid777 (button) folded before Flop (didn't bet)
Seat 5: matiko09 (small blind) collected (€2)
Seat 6: melitakas (big blind) folded before Flop
Seat 8: Venomous100% folded before Flop (didn't bet)
Seat 9: sanpidk folded before Flop (didn't bet)





PokerStars Hand #148219147177:  Hold'em No Limit ($0.50/$1.00 USD) - 2016/02/04 15:19:42 CET [2016/02/04 9:19:42 ET]
Table 'Arneb III' 9-max Seat #6 is the button
Seat 1: Vikulja1993 ($112.50 in chips) 
Seat 2: JeanLima93 ($164.24 in chips) 
Seat 3: matiko09 ($106.44 in chips) 
Seat 4: Igor DoUrden ($257.51 in chips) 
Seat 5: tipner ($143.70 in chips) 
Seat 6: nickreason17 ($111.70 in chips) 
Seat 8: volwebni4ek ($40 in chips) 
Seat 9: ARTVOR640 ($100 in chips) 
xxxZeka will be allowed to play after the button
volwebni4ek: posts small blind $0.50
ARTVOR640: posts big blind $1
*** HOLE CARDS ***
Dealt to matiko09 [9c 2h]
Vikulja1993: raises $2 to $3
JeanLima93: folds 
matiko09: folds 
Igor DoUrden: folds 
tipner: folds 
nickreason17: folds 
volwebni4ek: folds 
ARTVOR640: folds 
Uncalled bet ($2) returned to Vikulja1993
Vikulja1993 collected $2.50 from pot
Vikulja1993: doesn't show hand 
*** SUMMARY ***
Total pot $2.50 | Rake $0 
Seat 1: Vikulja1993 collected ($2.50)
Seat 2: JeanLima93 folded before Flop (didn't bet)
Seat 3: matiko09 folded before Flop (didn't bet)
Seat 4: Igor DoUrden folded before Flop (didn't bet)
Seat 5: tipner folded before Flop (didn't bet)
Seat 6: nickreason17 (button) folded before Flop (didn't bet)
Seat 8: volwebni4ek (small blind) folded before Flop
Seat 9: ARTVOR640 (big blind) folded before Flop





PokerStars Hand #148219148743:  Hold'em No Limit (€0.50/€1.00 EUR) - 2016/02/04 15:19:44 CET [2016/02/04 9:19:44 ET]
Table 'Ostenia' 9-max Seat #5 is the button
Seat 1: fastlife61 (€40 in chips) 
Seat 3: maxxmeister (€102.64 in chips) 
Seat 4: MagicKid777 (€120.59 in chips) 
Seat 5: matiko09 (€106 in chips) 
Seat 6: melitakas (€103.85 in chips) 
Seat 7: tipner (€106.96 in chips) 
Seat 8: Venomous100% (€111.65 in chips) 
Seat 9: sanpidk (€100 in chips) 
melitakas: posts small blind €0.50
tipner: posts big blind €1
fastlife61: posts big blind €1
Dante63s: sits out 
*** HOLE CARDS ***
Dealt to matiko09 [5c 9s]
Venomous100%: folds 
sanpidk: folds 
fastlife61: checks 
maxxmeister: folds 
MagicKid777: folds 
matiko09: folds 
melitakas: folds 
tipner: checks 
*** FLOP *** [7h 4s Td]
tipner: bets €2
fastlife61: calls €2
*** TURN *** [7h 4s Td] [Ac]
tipner: checks 
fastlife61: bets €3
tipner: calls €3
*** RIVER *** [7h 4s Td Ac] [3c]
tipner: checks 
fastlife61: checks 
*** SHOW DOWN ***
tipner: shows [7d Ts] (two pair, Tens and Sevens)
fastlife61: mucks hand 
tipner collected €11.94 from pot
*** SUMMARY ***
Total pot €12.50 | Rake €0.56 
Board [7h 4s Td Ac 3c]
Seat 1: fastlife61 mucked [5d 7s]
Seat 3: maxxmeister folded before Flop (didn't bet)
Seat 4: MagicKid777 folded before Flop (didn't bet)
Seat 5: matiko09 (button) folded before Flop (didn't bet)
Seat 6: melitakas (small blind) folded before Flop
Seat 7: tipner (big blind) showed [7d Ts] and won (€11.94) with two pair, Tens and Sevens
Seat 8: Venomous100% folded before Flop (didn't bet)
Seat 9: sanpidk folded before Flop (didn't bet)





PokerStars Hand #148219153036:  Hold'em No Limit ($0.50/$1.00 USD) - 2016/02/04 15:19:50 CET [2016/02/04 9:19:50 ET]
Table 'Cepheus III' 9-max Seat #6 is the button
Seat 1: ozone2003 ($100 in chips) 
Seat 2: Vikulja1993 ($105.92 in chips) 
Seat 3: pandalapa ($202.20 in chips) 
Seat 4: lukeylund ($44.43 in chips) 
Seat 5: ARTVOR640 ($142.43 in chips) 
Seat 6: matiko09 ($110.21 in chips) 
Seat 7: Igor DoUrden ($100 in chips) 
Seat 8: omorfadramou ($100 in chips) 
Seat 9: xxxZeka ($106.03 in chips) 
Igor DoUrden: posts small blind $0.50
omorfadramou: posts big blind $1
*** HOLE CARDS ***
Dealt to matiko09 [7d 6h]
xxxZeka: folds 
ozone2003: folds 
Vikulja1993: raises $2 to $3
pandalapa: folds 
lukeylund: folds 
ARTVOR640: calls $3
matiko09: folds 
Igor DoUrden: folds 
omorfadramou: folds 
*** FLOP *** [2s Ts 7s]
Vikulja1993: bets $4
ARTVOR640: folds 
Uncalled bet ($4) returned to Vikulja1993
Vikulja1993 collected $7.16 from pot
Vikulja1993: doesn't show hand 
*** SUMMARY ***
Total pot $7.50 | Rake $0.34 
Board [2s Ts 7s]
Seat 1: ozone2003 folded before Flop (didn't bet)
Seat 2: Vikulja1993 collected ($7.16)
Seat 3: pandalapa folded before Flop (didn't bet)
Seat 4: lukeylund folded before Flop (didn't bet)
Seat 5: ARTVOR640 folded on the Flop
Seat 6: matiko09 (button) folded before Flop (didn't bet)
Seat 7: Igor DoUrden (small blind) folded before Flop
Seat 8: omorfadramou (big blind) folded before Flop
Seat 9: xxxZeka folded before Flop (didn't bet)





PokerStars Hand #148219166611:  Hold'em No Limit ($0.50/$1.00 USD) - 2016/02/04 15:20:09 CET [2016/02/04 9:20:09 ET]
Table 'Arneb III' 9-max Seat #8 is the button
Seat 1: Vikulja1993 ($114 in chips) 
Seat 2: JeanLima93 ($164.24 in chips) 
Seat 3: matiko09 ($106.44 in chips) 
Seat 4: Igor DoUrden ($257.51 in chips) 
Seat 5: tipner ($143.70 in chips) 
Seat 6: nickreason17 ($111.70 in chips) 
Seat 8: volwebni4ek ($40 in chips) 
Seat 9: ARTVOR640 ($100 in chips) 
ARTVOR640: posts small blind $0.50
Vikulja1993: posts big blind $1
xxxZeka: sits out 
*** HOLE CARDS ***
Dealt to matiko09 [Ac 7d]
JeanLima93: folds 
matiko09: folds 
Igor DoUrden: folds 
tipner: folds 
nickreason17: folds 
volwebni4ek: raises $1 to $2
ARTVOR640: folds 
Vikulja1993: folds 
Uncalled bet ($1) returned to volwebni4ek
volwebni4ek collected $2.50 from pot
volwebni4ek: doesn't show hand 
*** SUMMARY ***
Total pot $2.50 | Rake $0 
Seat 1: Vikulja1993 (big blind) folded before Flop
Seat 2: JeanLima93 folded before Flop (didn't bet)
Seat 3: matiko09 folded before Flop (didn't bet)
Seat 4: Igor DoUrden folded before Flop (didn't bet)
Seat 5: tipner folded before Flop (didn't bet)
Seat 6: nickreason17 folded before Flop (didn't bet)
Seat 8: volwebni4ek (button) collected ($2.50)
Seat 9: ARTVOR640 (small blind) folded before Flop





PokerStars Hand #148219169075:  Hold'em No Limit ($0.50/$1.00 USD) - 2016/02/04 15:20:12 CET [2016/02/04 9:20:12 ET]
Table 'Arneb II' 9-max Seat #3 is the button
Seat 1: matiko09 ($103 in chips) 
Seat 2: sanpidk ($218.46 in chips) 
Seat 3: brille-390 ($100 in chips) 
Seat 4: Venomous100% ($102.55 in chips) 
Seat 5: lixiangli ($76.77 in chips) 
Seat 7: melitakas ($260.35 in chips) 
Seat 8: tedbadger9 ($96.82 in chips) 
Seat 9: tipner ($113.67 in chips) 
Venomous100%: posts small blind $0.50
lixiangli: posts big blind $1
*** HOLE CARDS ***
Dealt to matiko09 [3h Kc]
melitakas: folds 
tedbadger9: raises $1.78 to $2.78
tipner: folds 
matiko09: folds 
sanpidk: folds 
brille-390: folds 
Venomous100%: folds 
lixiangli: folds 
Uncalled bet ($1.78) returned to tedbadger9
tedbadger9 collected $2.50 from pot
*** SUMMARY ***
Total pot $2.50 | Rake $0 
Seat 1: matiko09 folded before Flop (didn't bet)
Seat 2: sanpidk folded before Flop (didn't bet)
Seat 3: brille-390 (button) folded before Flop (didn't bet)
Seat 4: Venomous100% (small blind) folded before Flop
Seat 5: lixiangli (big blind) folded before Flop
Seat 7: melitakas folded before Flop (didn't bet)
Seat 8: tedbadger9 collected ($2.50)
Seat 9: tipner folded before Flop (didn't bet)





PokerStars Hand #148219178886:  Hold'em No Limit ($0.50/$1.00 USD) - 2016/02/04 15:20:26 CET [2016/02/04 9:20:26 ET]
Table 'Dejan' 9-max Seat #3 is the button
Seat 1: matiko09 ($104 in chips) 
Seat 2: xxxZeka ($107.75 in chips) 
Seat 3: lumen21 ($100 in chips) 
Seat 4: yourpro ($148.25 in chips) 
Seat 5: PeterBassett ($98.50 in chips) 
Seat 6: nickreason17 ($100 in chips) 
Seat 7: mycka86 ($124.13 in chips) 
Seat 8: s26s ($102.71 in chips) 
Seat 9: I The King I ($130.35 in chips) 
yourpro: posts small blind $0.50
PeterBassett: posts big blind $1
*** HOLE CARDS ***
Dealt to matiko09 [6h 3h]
nickreason17: folds 
nickreason17 leaves the table
mycka86: folds 
s26s: folds 
sanpidk joins the table at seat #6 
I The King I: folds 
matiko09: folds 
xxxZeka: raises $2 to $3
lumen21: folds 
yourpro: folds 
PeterBassett: folds 
Uncalled bet ($2) returned to xxxZeka
xxxZeka collected $2.50 from pot
*** SUMMARY ***
Total pot $2.50 | Rake $0 
Seat 1: matiko09 folded before Flop (didn't bet)
Seat 2: xxxZeka collected ($2.50)
Seat 3: lumen21 (button) folded before Flop (didn't bet)
Seat 4: yourpro (small blind) folded before Flop
Seat 5: PeterBassett (big blind) folded before Flop
Seat 6: nickreason17 folded before Flop (didn't bet)
Seat 7: mycka86 folded before Flop (didn't bet)
Seat 8: s26s folded before Flop (didn't bet)
Seat 9: I The King I folded before Flop (didn't bet)





PokerStars Hand #148219182739:  Hold'em No Limit (€0.50/€1.00 EUR) - 2016/02/04 15:20:31 CET [2016/02/04 9:20:31 ET]
Table 'Ostenia' 9-max Seat #6 is the button
Seat 1: fastlife61 (€34 in chips) 
Seat 3: maxxmeister (€102.64 in chips) 
Seat 4: MagicKid777 (€120.59 in chips) 
Seat 5: matiko09 (€106 in chips) 
Seat 6: melitakas (€103.35 in chips) 
Seat 7: tipner (€112.90 in chips) 
Seat 8: Venomous100% (€111.65 in chips) 
Seat 9: sanpidk (€100 in chips) 
tipner: posts small blind €0.50
Venomous100%: posts big blind €1
Dante63s: sits out 
*** HOLE CARDS ***
Dealt to matiko09 [Kh 7d]
sanpidk: raises €2 to €3
fastlife61: calls €3
maxxmeister: folds 
MagicKid777: folds 
matiko09: folds 
melitakas: folds 
tipner: folds 
Venomous100%: folds 
*** FLOP *** [3s Jd 2h]
sanpidk: checks 
fastlife61: checks 
*** TURN *** [3s Jd 2h] [Jh]
sanpidk: bets €4.50
fastlife61: folds 
Uncalled bet (€4.50) returned to sanpidk
sanpidk collected €7.16 from pot
sanpidk: doesn't show hand 
*** SUMMARY ***
Total pot €7.50 | Rake €0.34 
Board [3s Jd 2h Jh]
Seat 1: fastlife61 folded on the Turn
Seat 3: maxxmeister folded before Flop (didn't bet)
Seat 4: MagicKid777 folded before Flop (didn't bet)
Seat 5: matiko09 folded before Flop (didn't bet)
Seat 6: melitakas (button) folded before Flop (didn't bet)
Seat 7: tipner (small blind) folded before Flop
Seat 8: Venomous100% (big blind) folded before Flop
Seat 9: sanpidk collected (€7.16)





PokerStars Hand #148219185729:  Hold'em No Limit ($0.50/$1.00 USD) - 2016/02/04 15:20:35 CET [2016/02/04 9:20:35 ET]
Table 'Arneb III' 9-max Seat #9 is the button
Seat 1: Vikulja1993 ($113 in chips) 
Seat 2: JeanLima93 ($164.24 in chips) 
Seat 3: matiko09 ($106.44 in chips) 
Seat 4: Igor DoUrden ($257.51 in chips) 
Seat 5: tipner ($143.70 in chips) 
Seat 6: nickreason17 ($111.70 in chips) 
Seat 8: volwebni4ek ($41.50 in chips) 
Seat 9: ARTVOR640 ($100 in chips) 
Vikulja1993: posts small blind $0.50
JeanLima93: posts big blind $1
xxxZeka: sits out 
*** HOLE CARDS ***
Dealt to matiko09 [Kd Ah]
matiko09: raises $2 to $3
Igor DoUrden: calls $3
tipner: folds 
nickreason17: folds 
volwebni4ek: folds 
ARTVOR640: folds 
Vikulja1993: folds 
JeanLima93: folds 
*** FLOP *** [3h Ts 7d]
matiko09: checks 
Igor DoUrden: bets $4
matiko09: folds 
Uncalled bet ($4) returned to Igor DoUrden
Igor DoUrden collected $7.16 from pot
Igor DoUrden: doesn't show hand 
*** SUMMARY ***
Total pot $7.50 | Rake $0.34 
Board [3h Ts 7d]
Seat 1: Vikulja1993 (small blind) folded before Flop
Seat 2: JeanLima93 (big blind) folded before Flop
Seat 3: matiko09 folded on the Flop
Seat 4: Igor DoUrden collected ($7.16)
Seat 5: tipner folded before Flop (didn't bet)
Seat 6: nickreason17 folded before Flop (didn't bet)
Seat 8: volwebni4ek folded before Flop (didn't bet)
Seat 9: ARTVOR640 (button) folded before Flop (didn't bet)





PokerStars Hand #148219191499:  Hold'em No Limit ($0.50/$1.00 USD) - 2016/02/04 15:20:43 CET [2016/02/04 9:20:43 ET]
Table 'Arneb II' 9-max Seat #4 is the button
Seat 1: matiko09 ($103 in chips) 
Seat 2: sanpidk ($218.46 in chips) 
Seat 3: brille-390 ($100 in chips) 
Seat 4: Venomous100% ($102.05 in chips) 
Seat 5: lixiangli ($75.77 in chips) 
Seat 7: melitakas ($260.35 in chips) 
Seat 8: tedbadger9 ($98.32 in chips) 
Seat 9: tipner ($113.67 in chips) 
lixiangli: posts small blind $0.50
Sweden_Pound was removed from the table for failing to post
melitakas: posts big blind $1
*** HOLE CARDS ***
Dealt to matiko09 [5s Js]
volwebni4ek joins the table at seat #6 
tedbadger9: raises $1.78 to $2.78
tipner: folds 
matiko09: folds 
sanpidk: folds 
brille-390: calls $2.78
Venomous100%: folds 
lixiangli: folds 
melitakas: calls $1.78
*** FLOP *** [3s 7c 6h]
melitakas: checks 
tedbadger9: bets $8.44
brille-390: calls $8.44
melitakas: folds 
*** TURN *** [3s 7c 6h] [5d]
tedbadger9: checks 
brille-390: checks 
*** RIVER *** [3s 7c 6h 5d] [2c]
tedbadger9: bets $12.28
brille-390: calls $12.28
*** SHOW DOWN ***
tedbadger9: shows [8c 8d] (a pair of Eights)
brille-390: shows [Qc Qh] (a pair of Queens)
brille-390 collected $48.02 from pot
*** SUMMARY ***
Total pot $50.28 | Rake $2.26 
Board [3s 7c 6h 5d 2c]
Seat 1: matiko09 folded before Flop (didn't bet)
Seat 2: sanpidk folded before Flop (didn't bet)
Seat 3: brille-390 showed [Qc Qh] and won ($48.02) with a pair of Queens
Seat 4: Venomous100% (button) folded before Flop (didn't bet)
Seat 5: lixiangli (small blind) folded before Flop
Seat 7: melitakas (big blind) folded on the Flop
Seat 8: tedbadger9 showed [8c 8d] and lost with a pair of Eights
Seat 9: tipner folded before Flop (didn't bet)





PokerStars Hand #148219198885:  Hold'em No Limit ($0.50/$1.00 USD) - 2016/02/04 15:20:54 CET [2016/02/04 9:20:54 ET]
Table 'Cepheus III' 9-max Seat #7 is the button
Seat 1: ozone2003 ($100 in chips) 
Seat 2: Vikulja1993 ($110.08 in chips) 
Seat 3: pandalapa ($202.20 in chips) 
Seat 4: lukeylund ($44.43 in chips) 
Seat 5: ARTVOR640 ($139.43 in chips) 
Seat 6: matiko09 ($110.21 in chips) 
Seat 7: Igor DoUrden ($100 in chips) 
Seat 8: omorfadramou ($100 in chips) 
Seat 9: xxxZeka ($106.03 in chips) 
omorfadramou: posts small blind $0.50
xxxZeka: posts big blind $1
*** HOLE CARDS ***
Dealt to matiko09 [5s Qs]
ozone2003: folds 
Vikulja1993: folds 
pandalapa: raises $2 to $3
lukeylund: folds 
ARTVOR640: folds 
matiko09: folds 
Igor DoUrden: folds 
omorfadramou: folds 
xxxZeka: folds 
Uncalled bet ($2) returned to pandalapa
pandalapa collected $2.50 from pot
pandalapa: doesn't show hand 
*** SUMMARY ***
Total pot $2.50 | Rake $0 
Seat 1: ozone2003 folded before Flop (didn't bet)
Seat 2: Vikulja1993 folded before Flop (didn't bet)
Seat 3: pandalapa collected ($2.50)
Seat 4: lukeylund folded before Flop (didn't bet)
Seat 5: ARTVOR640 folded before Flop (didn't bet)
Seat 6: matiko09 folded before Flop (didn't bet)
Seat 7: Igor DoUrden (button) folded before Flop (didn't bet)
Seat 8: omorfadramou (small blind) folded before Flop
Seat 9: xxxZeka (big blind) folded before Flop





PokerStars Hand #148219210839:  Hold'em No Limit (€0.50/€1.00 EUR) - 2016/02/04 15:21:10 CET [2016/02/04 9:21:10 ET]
Table 'Ostenia' 9-max Seat #7 is the button
Seat 1: fastlife61 (€31 in chips) 
Seat 3: maxxmeister (€102.64 in chips) 
Seat 4: MagicKid777 (€120.59 in chips) 
Seat 5: matiko09 (€106 in chips) 
Seat 6: melitakas (€103.35 in chips) 
Seat 7: tipner (€112.40 in chips) 
Seat 8: Venomous100% (€110.65 in chips) 
Seat 9: sanpidk (€104.16 in chips) 
Venomous100%: posts small blind €0.50
sanpidk: posts big blind €1
Dante63s: sits out 
*** HOLE CARDS ***
Dealt to matiko09 [5s Jd]
fastlife61: folds 
maxxmeister: raises €2 to €3
MagicKid777: folds 
matiko09: folds 
melitakas: folds 
tipner: folds 
Venomous100%: folds 
sanpidk: folds 
Uncalled bet (€2) returned to maxxmeister
maxxmeister collected €2.50 from pot
maxxmeister: doesn't show hand 
*** SUMMARY ***
Total pot €2.50 | Rake €0 
Seat 1: fastlife61 folded before Flop (didn't bet)
Seat 3: maxxmeister collected (€2.50)
Seat 4: MagicKid777 folded before Flop (didn't bet)
Seat 5: matiko09 folded before Flop (didn't bet)
Seat 6: melitakas folded before Flop (didn't bet)
Seat 7: tipner (button) folded before Flop (didn't bet)
Seat 8: Venomous100% (small blind) folded before Flop
Seat 9: sanpidk (big blind) folded before Flop





PokerStars Hand #148219212449:  Hold'em No Limit ($0.50/$1.00 USD) - 2016/02/04 15:21:12 CET [2016/02/04 9:21:12 ET]
Table 'Dejan' 9-max Seat #4 is the button
Seat 1: matiko09 ($104 in chips) 
Seat 2: xxxZeka ($109.25 in chips) 
Seat 3: lumen21 ($100 in chips) 
Seat 4: yourpro ($147.75 in chips) 
Seat 5: PeterBassett ($97.50 in chips) 
Seat 6: sanpidk ($236.90 in chips) 
Seat 7: mycka86 ($124.13 in chips) 
Seat 8: s26s ($102.71 in chips) 
Seat 9: I The King I ($130.35 in chips) 
PeterBassett: posts small blind $0.50
sanpidk: posts big blind $1
*** HOLE CARDS ***
Dealt to matiko09 [9d Ah]
mycka86: folds 
s26s: calls $1
I The King I: raises $3 to $4
matiko09: folds 
xxxZeka: folds 
lumen21 has timed out
lumen21: folds 
yourpro: folds 
PeterBassett: folds 
sanpidk: folds 
s26s: calls $3
*** FLOP *** [6h 2d As]
s26s: checks 
I The King I: checks 
*** TURN *** [6h 2d As] [5d]
s26s: checks 
I The King I: checks 
*** RIVER *** [6h 2d As 5d] [6d]
s26s: checks 
I The King I: checks 
*** SHOW DOWN ***
s26s: shows [Qh Ts] (a pair of Sixes)
I The King I: shows [Jd Jh] (two pair, Jacks and Sixes)
I The King I collected $9.07 from pot
*** SUMMARY ***
Total pot $9.50 | Rake $0.43 
Board [6h 2d As 5d 6d]
Seat 1: matiko09 folded before Flop (didn't bet)
Seat 2: xxxZeka folded before Flop (didn't bet)
Seat 3: lumen21 folded before Flop (didn't bet)
Seat 4: yourpro (button) folded before Flop (didn't bet)
Seat 5: PeterBassett (small blind) folded before Flop
Seat 6: sanpidk (big blind) folded before Flop
Seat 7: mycka86 folded before Flop (didn't bet)
Seat 8: s26s showed [Qh Ts] and lost with a pair of Sixes
Seat 9: I The King I showed [Jd Jh] and won ($9.07) with two pair, Jacks and Sixes





PokerStars Hand #148219216549:  Hold'em No Limit ($0.50/$1.00 USD) - 2016/02/04 15:21:18 CET [2016/02/04 9:21:18 ET]
Table 'Cepheus III' 9-max Seat #8 is the button
Seat 1: ozone2003 ($100 in chips) 
Seat 2: Vikulja1993 ($110.08 in chips) 
Seat 3: pandalapa ($203.70 in chips) 
Seat 4: lukeylund ($44.43 in chips) 
Seat 5: ARTVOR640 ($139.43 in chips) 
Seat 6: matiko09 ($110.21 in chips) 
Seat 7: Igor DoUrden ($100 in chips) 
Seat 8: omorfadramou ($100 in chips) 
Seat 9: xxxZeka ($105.03 in chips) 
xxxZeka: posts small blind $0.50
ozone2003: posts big blind $1
*** HOLE CARDS ***
Dealt to matiko09 [Kd 6c]
Vikulja1993: folds 
pandalapa: folds 
lukeylund: folds 
ARTVOR640: folds 
matiko09: folds 
Igor DoUrden: folds 
omorfadramou: raises $1 to $2
xxxZeka: folds 
ozone2003: folds 
Uncalled bet ($1) returned to omorfadramou
omorfadramou collected $2.50 from pot
omorfadramou: doesn't show hand 
*** SUMMARY ***
Total pot $2.50 | Rake $0 
Seat 1: ozone2003 (big blind) folded before Flop
Seat 2: Vikulja1993 folded before Flop (didn't bet)
Seat 3: pandalapa folded before Flop (didn't bet)
Seat 4: lukeylund folded before Flop (didn't bet)
Seat 5: ARTVOR640 folded before Flop (didn't bet)
Seat 6: matiko09 folded before Flop (didn't bet)
Seat 7: Igor DoUrden folded before Flop (didn't bet)
Seat 8: omorfadramou (button) collected ($2.50)
Seat 9: xxxZeka (small blind) folded before Flop





PokerStars Hand #148219222071:  Hold'em No Limit ($0.50/$1.00 USD) - 2016/02/04 15:21:26 CET [2016/02/04 9:21:26 ET]
Table 'Arneb III' 9-max Seat #1 is the button
Seat 1: Vikulja1993 ($112.50 in chips) 
Seat 2: JeanLima93 ($163.24 in chips) 
Seat 3: matiko09 ($103.44 in chips) 
Seat 4: Igor DoUrden ($261.67 in chips) 
Seat 5: tipner ($143.70 in chips) 
Seat 6: nickreason17 ($111.70 in chips) 
Seat 8: volwebni4ek ($41.50 in chips) 
Seat 9: ARTVOR640 ($100 in chips) 
JeanLima93: posts small blind $0.50
matiko09: posts big blind $1
xxxZeka: sits out 
*** HOLE CARDS ***
Dealt to matiko09 [7h Jd]
Igor DoUrden: raises $1.50 to $2.50
tipner: folds 
nickreason17: folds 
volwebni4ek: folds 
ARTVOR640: folds 
Vikulja1993: folds 
JeanLima93: calls $2
matiko09: folds 
*** FLOP *** [Qc 6c Ad]
JeanLima93: bets $2.86
Igor DoUrden: calls $2.86
*** TURN *** [Qc 6c Ad] [6d]
JeanLima93: checks 
Igor DoUrden: checks 
*** RIVER *** [Qc 6c Ad 6d] [8h]
JeanLima93: checks 
Igor DoUrden: bets $11.19
JeanLima93: folds 
Uncalled bet ($11.19) returned to Igor DoUrden
Igor DoUrden collected $11.19 from pot
Igor DoUrden: doesn't show hand 
*** SUMMARY ***
Total pot $11.72 | Rake $0.53 
Board [Qc 6c Ad 6d 8h]
Seat 1: Vikulja1993 (button) folded before Flop (didn't bet)
Seat 2: JeanLima93 (small blind) folded on the River
Seat 3: matiko09 (big blind) folded before Flop
Seat 4: Igor DoUrden collected ($11.19)
Seat 5: tipner folded before Flop (didn't bet)
Seat 6: nickreason17 folded before Flop (didn't bet)
Seat 8: volwebni4ek folded before Flop (didn't bet)
Seat 9: ARTVOR640 folded before Flop (didn't bet)





PokerStars Hand #148219239649:  Hold'em No Limit ($0.50/$1.00 USD) - 2016/02/04 15:21:50 CET [2016/02/04 9:21:50 ET]
Table 'Cepheus III' 9-max Seat #9 is the button
Seat 1: ozone2003 ($100 in chips) 
Seat 3: pandalapa ($203.70 in chips) 
Seat 4: lukeylund ($44.43 in chips) 
Seat 5: ARTVOR640 ($139.43 in chips) 
Seat 6: matiko09 ($110.21 in chips) 
Seat 7: Igor DoUrden ($100 in chips) 
Seat 8: omorfadramou ($101.50 in chips) 
Seat 9: xxxZeka ($104.53 in chips) 
ozone2003: posts small blind $0.50
Vikulja1993: is sitting out 
Vikulja1993 leaves the table
pandalapa: posts big blind $1
*** HOLE CARDS ***
Dealt to matiko09 [8d Jh]
lukeylund: folds 
sanpidk joins the table at seat #2 
ARTVOR640: raises $1.50 to $2.50
sanpidk leaves the table
matiko09: folds 
Igor DoUrden: folds 
omorfadramou: folds 
xxxZeka: folds 
ozone2003: folds 
pandalapa: folds 
Uncalled bet ($1.50) returned to ARTVOR640
ARTVOR640 collected $2.50 from pot
ARTVOR640: doesn't show hand 
*** SUMMARY ***
Total pot $2.50 | Rake $0 
Seat 1: ozone2003 (small blind) folded before Flop
Seat 3: pandalapa (big blind) folded before Flop
Seat 4: lukeylund folded before Flop (didn't bet)
Seat 5: ARTVOR640 collected ($2.50)
Seat 6: matiko09 folded before Flop (didn't bet)
Seat 7: Igor DoUrden folded before Flop (didn't bet)
Seat 8: omorfadramou folded before Flop (didn't bet)
Seat 9: xxxZeka (button) folded before Flop (didn't bet)





PokerStars Hand #148219240835:  Hold'em No Limit (€0.50/€1.00 EUR) - 2016/02/04 15:21:52 CET [2016/02/04 9:21:52 ET]
Table 'Ostenia' 9-max Seat #8 is the button
Seat 1: fastlife61 (€31 in chips) 
Seat 3: maxxmeister (€104.14 in chips) 
Seat 4: MagicKid777 (€120.59 in chips) 
Seat 5: matiko09 (€106 in chips) 
Seat 6: melitakas (€103.35 in chips) 
Seat 7: tipner (€112.40 in chips) 
Seat 8: Venomous100% (€110.15 in chips) 
Seat 9: sanpidk (€103.16 in chips) 
sanpidk: posts small blind €0.50
fastlife61: posts big blind €1
Dante63s: sits out 
*** HOLE CARDS ***
Dealt to matiko09 [8c 5h]
maxxmeister: folds 
MagicKid777: calls €1
matiko09: folds 
melitakas: folds 
tipner: raises €3 to €4
Venomous100%: folds 
sanpidk: folds 
fastlife61: folds 
MagicKid777: folds 
Uncalled bet (€3) returned to tipner
tipner collected €3.50 from pot
tipner: doesn't show hand 
*** SUMMARY ***
Total pot €3.50 | Rake €0 
Seat 1: fastlife61 (big blind) folded before Flop
Seat 3: maxxmeister folded before Flop (didn't bet)
Seat 4: MagicKid777 folded before Flop
Seat 5: matiko09 folded before Flop (didn't bet)
Seat 6: melitakas folded before Flop (didn't bet)
Seat 7: tipner collected (€3.50)
Seat 8: Venomous100% (button) folded before Flop (didn't bet)
Seat 9: sanpidk (small blind) folded before Flop





PokerStars Hand #148219255238:  Hold'em No Limit ($0.50/$1.00 USD) - 2016/02/04 15:22:11 CET [2016/02/04 9:22:11 ET]
Table 'Cepheus III' 9-max Seat #1 is the button
Seat 1: ozone2003 ($100 in chips) 
Seat 3: pandalapa ($202.70 in chips) 
Seat 4: lukeylund ($44.43 in chips) 
Seat 5: ARTVOR640 ($140.93 in chips) 
Seat 6: matiko09 ($110.21 in chips) 
Seat 7: Igor DoUrden ($100 in chips) 
Seat 8: omorfadramou ($101.50 in chips) 
Seat 9: xxxZeka ($104.53 in chips) 
pandalapa: posts small blind $0.50
lukeylund: posts big blind $1
*** HOLE CARDS ***
Dealt to matiko09 [2d 4d]
ARTVOR640: folds 
matiko09: folds 
Igor DoUrden: folds 
omorfadramou: folds 
xxxZeka: folds 
ozone2003: folds 
pandalapa: raises $1.55 to $2.55
lukeylund: folds 
Uncalled bet ($1.55) returned to pandalapa
pandalapa collected $2 from pot
pandalapa: doesn't show hand 
*** SUMMARY ***
Total pot $2 | Rake $0 
Seat 1: ozone2003 (button) folded before Flop (didn't bet)
Seat 3: pandalapa (small blind) collected ($2)
Seat 4: lukeylund (big blind) folded before Flop
Seat 5: ARTVOR640 folded before Flop (didn't bet)
Seat 6: matiko09 folded before Flop (didn't bet)
Seat 7: Igor DoUrden folded before Flop (didn't bet)
Seat 8: omorfadramou folded before Flop (didn't bet)
Seat 9: xxxZeka folded before Flop (didn't bet)





PokerStars Hand #148219265844:  Hold'em No Limit (€0.50/€1.00 EUR) - 2016/02/04 15:22:26 CET [2016/02/04 9:22:26 ET]
Table 'Ostenia' 9-max Seat #9 is the button
Seat 1: fastlife61 (€30 in chips) 
Seat 2: Dante63s (€100 in chips) 
Seat 3: maxxmeister (€104.14 in chips) 
Seat 4: MagicKid777 (€119.59 in chips) 
Seat 5: matiko09 (€106 in chips) 
Seat 6: melitakas (€103.35 in chips) 
Seat 7: tipner (€114.90 in chips) 
Seat 8: Venomous100% (€110.15 in chips) 
Seat 9: sanpidk (€102.66 in chips) 
fastlife61: posts small blind €0.50
Dante63s: posts big blind €1
*** HOLE CARDS ***
Dealt to matiko09 [8h 3s]
maxxmeister: folds 
MagicKid777: folds 
matiko09: folds 
melitakas: folds 
tipner: folds 
Venomous100%: folds 
sanpidk: raises €1.24 to €2.24
fastlife61: calls €1.74
Dante63s: folds 
*** FLOP *** [Jd 5d Jh]
fastlife61: checks 
sanpidk: bets €3.89
fastlife61: calls €3.89
*** TURN *** [Jd 5d Jh] [8c]
fastlife61: checks 
sanpidk: bets €7.90
fastlife61: calls €7.90
*** RIVER *** [Jd 5d Jh 8c] [4d]
fastlife61: checks 
sanpidk: bets €19
fastlife61: calls €15.97 and is all-in
Uncalled bet (€3.03) returned to sanpidk
*** SHOW DOWN ***
sanpidk: shows [Kh Kc] (two pair, Kings and Jacks)
fastlife61: shows [5c Ac] (two pair, Jacks and Fives)
sanpidk collected €58.85 from pot
*** SUMMARY ***
Total pot €61 | Rake €2.15 
Board [Jd 5d Jh 8c 4d]
Seat 1: fastlife61 (small blind) showed [5c Ac] and lost with two pair, Jacks and Fives
Seat 2: Dante63s (big blind) folded before Flop
Seat 3: maxxmeister folded before Flop (didn't bet)
Seat 4: MagicKid777 folded before Flop (didn't bet)
Seat 5: matiko09 folded before Flop (didn't bet)
Seat 6: melitakas folded before Flop (didn't bet)
Seat 7: tipner folded before Flop (didn't bet)
Seat 8: Venomous100% folded before Flop (didn't bet)
Seat 9: sanpidk (button) showed [Kh Kc] and won (€58.85) with two pair, Kings and Jacks





PokerStars Hand #148219274232:  Hold'em No Limit ($0.50/$1.00 USD) - 2016/02/04 15:22:38 CET [2016/02/04 9:22:38 ET]
Table 'Arneb III' 9-max Seat #2 is the button
Seat 1: Vikulja1993 ($112.50 in chips) 
Seat 2: JeanLima93 ($157.88 in chips) 
Seat 3: matiko09 ($102.44 in chips) 
Seat 4: Igor DoUrden ($267.50 in chips) 
Seat 5: tipner ($143.70 in chips) 
Seat 6: nickreason17 ($111.70 in chips) 
Seat 8: volwebni4ek ($41.50 in chips) 
Seat 9: ARTVOR640 ($100 in chips) 
matiko09: posts small blind $0.50
Igor DoUrden: posts big blind $1
xxxZeka: sits out 
*** HOLE CARDS ***
Dealt to matiko09 [Jd 5h]
tipner: folds 
nickreason17: folds 
volwebni4ek: folds 
ARTVOR640: folds 
Vikulja1993: raises $1.50 to $2.50
JeanLima93: calls $2.50
matiko09: folds 
Igor DoUrden: folds 
*** FLOP *** [3h 9c 4h]
Vikulja1993: bets $4
JeanLima93: calls $4
*** TURN *** [3h 9c 4h] [Qc]
Vikulja1993: checks 
JeanLima93: checks 
*** RIVER *** [3h 9c 4h Qc] [6d]
Vikulja1993: checks 
JeanLima93: checks 
*** SHOW DOWN ***
Vikulja1993: shows [7d 7c] (a pair of Sevens)
JeanLima93: mucks hand 
Vikulja1993 collected $13.85 from pot
*** SUMMARY ***
Total pot $14.50 | Rake $0.65 
Board [3h 9c 4h Qc 6d]
Seat 1: Vikulja1993 showed [7d 7c] and won ($13.85) with a pair of Sevens
Seat 2: JeanLima93 (button) mucked [Kd Ac]
Seat 3: matiko09 (small blind) folded before Flop
Seat 4: Igor DoUrden (big blind) folded before Flop
Seat 5: tipner folded before Flop (didn't bet)
Seat 6: nickreason17 folded before Flop (didn't bet)
Seat 8: volwebni4ek folded before Flop (didn't bet)
Seat 9: ARTVOR640 folded before Flop (didn't bet)





PokerStars Hand #148219277364:  Hold'em No Limit ($0.50/$1.00 USD) - 2016/02/04 15:22:42 CET [2016/02/04 9:22:42 ET]
Table 'Arneb II' 9-max Seat #5 is the button
Seat 1: matiko09 ($103 in chips) 
Seat 2: sanpidk ($218.46 in chips) 
Seat 3: brille-390 ($124.52 in chips) 
Seat 4: Venomous100% ($102.05 in chips) 
Seat 5: lixiangli ($75.27 in chips) 
Seat 7: melitakas ($257.57 in chips) 
Seat 8: tedbadger9 ($74.82 in chips) 
Seat 9: tipner ($113.67 in chips) 
volwebni4ek will be allowed to play after the button
melitakas: posts small blind $0.50
tedbadger9: posts big blind $1
*** HOLE CARDS ***
Dealt to matiko09 [5h 5s]
tipner: raises $2 to $3
matiko09: folds 
sanpidk: folds 
brille-390: folds 
Venomous100%: folds 
lixiangli: folds 
melitakas: folds 
tedbadger9: folds 
Uncalled bet ($2) returned to tipner
tipner collected $2.50 from pot
tipner: doesn't show hand 
*** SUMMARY ***
Total pot $2.50 | Rake $0 
Seat 1: matiko09 folded before Flop (didn't bet)
Seat 2: sanpidk folded before Flop (didn't bet)
Seat 3: brille-390 folded before Flop (didn't bet)
Seat 4: Venomous100% folded before Flop (didn't bet)
Seat 5: lixiangli (button) folded before Flop (didn't bet)
Seat 7: melitakas (small blind) folded before Flop
Seat 8: tedbadger9 (big blind) folded before Flop
Seat 9: tipner collected ($2.50)





PokerStars Hand #148219285625:  Hold'em No Limit ($0.50/$1.00 USD) - 2016/02/04 15:22:53 CET [2016/02/04 9:22:53 ET]
Table 'Cepheus III' 9-max Seat #3 is the button
Seat 1: ozone2003 ($100 in chips) 
Seat 3: pandalapa ($203.70 in chips) 
Seat 4: lukeylund ($43.43 in chips) 
Seat 5: ARTVOR640 ($140.93 in chips) 
Seat 6: matiko09 ($110.21 in chips) 
Seat 7: Igor DoUrden ($100 in chips) 
Seat 8: omorfadramou ($101.50 in chips) 
Seat 9: xxxZeka ($104.53 in chips) 
lukeylund: posts small blind $0.50
ARTVOR640: posts big blind $1
*** HOLE CARDS ***
Dealt to matiko09 [7s 5h]
matiko09: folds 
9lKBXKTT6 joins the table at seat #2 
Igor DoUrden: folds 
omorfadramou: raises $1.16 to $2.16
xxxZeka: folds 
ozone2003: folds 
9lKBXKTT6 leaves the table
pandalapa: folds 
lukeylund: folds 
ARTVOR640: folds 
Uncalled bet ($1.16) returned to omorfadramou
omorfadramou collected $2.50 from pot
omorfadramou: doesn't show hand 
*** SUMMARY ***
Total pot $2.50 | Rake $0 
Seat 1: ozone2003 folded before Flop (didn't bet)
Seat 3: pandalapa (button) folded before Flop (didn't bet)
Seat 4: lukeylund (small blind) folded before Flop
Seat 5: ARTVOR640 (big blind) folded before Flop
Seat 6: matiko09 folded before Flop (didn't bet)
Seat 7: Igor DoUrden folded before Flop (didn't bet)
Seat 8: omorfadramou collected ($2.50)
Seat 9: xxxZeka folded before Flop (didn't bet)





PokerStars Hand #148219291274:  Hold'em No Limit ($0.50/$1.00 USD) - 2016/02/04 15:23:01 CET [2016/02/04 9:23:01 ET]
Table 'Dejan' 9-max Seat #5 is the button
Seat 1: matiko09 ($104 in chips) 
Seat 2: xxxZeka ($109.25 in chips) 
Seat 3: lumen21 ($100 in chips) 
Seat 4: yourpro ($147.75 in chips) 
Seat 5: PeterBassett ($97 in chips) 
Seat 6: sanpidk ($235.90 in chips) 
Seat 7: mycka86 ($124.13 in chips) 
Seat 8: s26s ($98.71 in chips) 
Seat 9: I The King I ($135.42 in chips) 
sanpidk: posts small blind $0.50
mycka86: posts big blind $1
*** HOLE CARDS ***
Dealt to matiko09 [3c Kh]
s26s: folds 
I The King I: folds 
matiko09: folds 
xxxZeka: folds 
lumen21: folds 
yourpro: folds 
PeterBassett: raises $1 to $2
sanpidk: folds 
mycka86: folds 
Uncalled bet ($1) returned to PeterBassett
PeterBassett collected $2.50 from pot
PeterBassett: doesn't show hand 
*** SUMMARY ***
Total pot $2.50 | Rake $0 
Seat 1: matiko09 folded before Flop (didn't bet)
Seat 2: xxxZeka folded before Flop (didn't bet)
Seat 3: lumen21 folded before Flop (didn't bet)
Seat 4: yourpro folded before Flop (didn't bet)
Seat 5: PeterBassett (button) collected ($2.50)
Seat 6: sanpidk (small blind) folded before Flop
Seat 7: mycka86 (big blind) folded before Flop
Seat 8: s26s folded before Flop (didn't bet)
Seat 9: I The King I folded before Flop (didn't bet)





PokerStars Hand #148219296532:  Hold'em No Limit ($0.50/$1.00 USD) - 2016/02/04 15:23:08 CET [2016/02/04 9:23:08 ET]
Table 'Arneb II' 9-max Seat #7 is the button
Seat 1: matiko09 ($103 in chips) 
Seat 2: sanpidk ($218.46 in chips) 
Seat 3: brille-390 ($124.52 in chips) 
Seat 4: Venomous100% ($102.05 in chips) 
Seat 5: lixiangli ($75.27 in chips) 
Seat 7: melitakas ($257.07 in chips) 
Seat 8: tedbadger9 ($73.82 in chips) 
Seat 9: tipner ($115.17 in chips) 
tedbadger9: posts small blind $0.50
tipner: posts big blind $1
volwebni4ek: sits out 
*** HOLE CARDS ***
Dealt to matiko09 [4h 7d]
matiko09: folds 
sanpidk: folds 
brille-390: raises $2 to $3
Venomous100%: folds 
lixiangli: folds 
melitakas: calls $3
tedbadger9: calls $2.50
tipner: calls $2
*** FLOP *** [3c Ah 8s]
tedbadger9: checks 
tipner: checks 
brille-390: bets $4
melitakas: calls $4
tedbadger9: folds 
tipner: folds 
*** TURN *** [3c Ah 8s] [5s]
brille-390: bets $15
melitakas: calls $15
*** RIVER *** [3c Ah 8s 5s] [8c]
brille-390: bets $35.81
melitakas: folds 
Uncalled bet ($35.81) returned to brille-390
brille-390 collected $47.75 from pot
brille-390: doesn't show hand 
*** SUMMARY ***
Total pot $50 | Rake $2.25 
Board [3c Ah 8s 5s 8c]
Seat 1: matiko09 folded before Flop (didn't bet)
Seat 2: sanpidk folded before Flop (didn't bet)
Seat 3: brille-390 collected ($47.75)
Seat 4: Venomous100% folded before Flop (didn't bet)
Seat 5: lixiangli folded before Flop (didn't bet)
Seat 7: melitakas (button) folded on the River
Seat 8: tedbadger9 (small blind) folded on the Flop
Seat 9: tipner (big blind) folded on the Flop





PokerStars Hand #148219300929:  Hold'em No Limit ($0.50/$1.00 USD) - 2016/02/04 15:23:14 CET [2016/02/04 9:23:14 ET]
Table 'Cepheus III' 9-max Seat #4 is the button
Seat 1: ozone2003 ($100 in chips) 
Seat 3: pandalapa ($203.70 in chips) 
Seat 4: lukeylund ($42.93 in chips) 
Seat 5: ARTVOR640 ($139.93 in chips) 
Seat 6: matiko09 ($110.21 in chips) 
Seat 7: Igor DoUrden ($100 in chips) 
Seat 8: omorfadramou ($103 in chips) 
Seat 9: xxxZeka ($104.53 in chips) 
ARTVOR640: posts small blind $0.50
matiko09: posts big blind $1
*** HOLE CARDS ***
Dealt to matiko09 [Jc Kh]
tipner joins the table at seat #2 
Igor DoUrden: folds 
omorfadramou: folds 
xxxZeka: folds 
ozone2003: folds 
pandalapa: folds 
lukeylund: folds 
ARTVOR640: folds 
Uncalled bet ($0.50) returned to matiko09
matiko09 collected $1 from pot
matiko09: doesn't show hand 
*** SUMMARY ***
Total pot $1 | Rake $0 
Seat 1: ozone2003 folded before Flop (didn't bet)
Seat 3: pandalapa folded before Flop (didn't bet)
Seat 4: lukeylund (button) folded before Flop (didn't bet)
Seat 5: ARTVOR640 (small blind) folded before Flop
Seat 6: matiko09 (big blind) collected ($1)
Seat 7: Igor DoUrden folded before Flop (didn't bet)
Seat 8: omorfadramou folded before Flop (didn't bet)
Seat 9: xxxZeka folded before Flop (didn't bet)





PokerStars Hand #148219320698:  Hold'em No Limit ($0.50/$1.00 USD) - 2016/02/04 15:23:41 CET [2016/02/04 9:23:41 ET]
Table 'Arneb III' 9-max Seat #3 is the button
Seat 1: Vikulja1993 ($119.85 in chips) 
Seat 2: JeanLima93 ($151.38 in chips) 
Seat 3: matiko09 ($101.94 in chips) 
Seat 4: Igor DoUrden ($266.50 in chips) 
Seat 5: tipner ($143.70 in chips) 
Seat 6: nickreason17 ($111.70 in chips) 
Seat 8: volwebni4ek ($41.50 in chips) 
Seat 9: ARTVOR640 ($100 in chips) 
Igor DoUrden: posts small blind $0.50
tipner: posts big blind $1
xxxZeka: sits out 
*** HOLE CARDS ***
Dealt to matiko09 [Kc 5h]
nickreason17: folds 
volwebni4ek: folds 
ARTVOR640: folds 
Vikulja1993: folds 
JeanLima93: folds 
matiko09: folds 
Igor DoUrden: folds 
Uncalled bet ($0.50) returned to tipner
tipner collected $1 from pot
tipner: doesn't show hand 
*** SUMMARY ***
Total pot $1 | Rake $0 
Seat 1: Vikulja1993 folded before Flop (didn't bet)
Seat 2: JeanLima93 folded before Flop (didn't bet)
Seat 3: matiko09 (button) folded before Flop (didn't bet)
Seat 4: Igor DoUrden (small blind) folded before Flop
Seat 5: tipner (big blind) collected ($1)
Seat 6: nickreason17 folded before Flop (didn't bet)
Seat 8: volwebni4ek folded before Flop (didn't bet)
Seat 9: ARTVOR640 folded before Flop (didn't bet)





PokerStars Hand #148219323306:  Hold'em No Limit ($0.50/$1.00 USD) - 2016/02/04 15:23:45 CET [2016/02/04 9:23:45 ET]
Table 'Cepheus III' 9-max Seat #5 is the button
Seat 1: ozone2003 ($100 in chips) 
Seat 3: pandalapa ($203.70 in chips) 
Seat 4: lukeylund ($42.93 in chips) 
Seat 5: ARTVOR640 ($139.43 in chips) 
Seat 6: matiko09 ($110.71 in chips) 
Seat 7: Igor DoUrden ($100 in chips) 
Seat 8: omorfadramou ($103 in chips) 
Seat 9: xxxZeka ($104.53 in chips) 
matiko09: posts small blind $0.50
Igor DoUrden: posts big blind $1
tipner: sits out 
*** HOLE CARDS ***
Dealt to matiko09 [2d 8h]
omorfadramou: folds 
xxxZeka: folds 
ozone2003: raises $2 to $3
pandalapa: folds 
lukeylund: folds 
ARTVOR640: folds 
matiko09: folds 
Igor DoUrden: folds 
Uncalled bet ($2) returned to ozone2003
ozone2003 collected $2.50 from pot
ozone2003: doesn't show hand 
*** SUMMARY ***
Total pot $2.50 | Rake $0 
Seat 1: ozone2003 collected ($2.50)
Seat 3: pandalapa folded before Flop (didn't bet)
Seat 4: lukeylund folded before Flop (didn't bet)
Seat 5: ARTVOR640 (button) folded before Flop (didn't bet)
Seat 6: matiko09 (small blind) folded before Flop
Seat 7: Igor DoUrden (big blind) folded before Flop
Seat 8: omorfadramou folded before Flop (didn't bet)
Seat 9: xxxZeka folded before Flop (didn't bet)





PokerStars Hand #148219323799:  Hold'em No Limit ($0.50/$1.00 USD) - 2016/02/04 15:23:46 CET [2016/02/04 9:23:46 ET]
Table 'Mothallah' 9-max Seat #7 is the button
Seat 2: davianvalek ($127.05 in chips) 
Seat 3: ozone2003 ($105.68 in chips) 
Seat 4: YOUNG_G70 ($44.83 in chips) 
Seat 5: chaps1988 ($100 in chips) 
Seat 6: I The King I ($131.28 in chips) 
Seat 7: sanpidk ($100 in chips) 
Seat 8: Spid1 ($135.86 in chips) 
Seat 9: matiko09 ($100 in chips) 
Spid1: posts small blind $0.50
matiko09: posts big blind $1
Rafaello18: sits out 
*** HOLE CARDS ***
Dealt to matiko09 [4h 2s]
davianvalek: folds 
ozone2003: folds 
YOUNG_G70: calls $1
chaps1988: raises $2.50 to $3.50
I The King I: folds 
sanpidk: folds 
Spid1: calls $3
matiko09: folds 
YOUNG_G70: calls $2.50
*** FLOP *** [Ah 9s Ad]
Spid1: checks 
YOUNG_G70: checks 
chaps1988: bets $6
Spid1: folds 
YOUNG_G70: calls $6
*** TURN *** [Ah 9s Ad] [3d]
YOUNG_G70: checks 
chaps1988: checks 
*** RIVER *** [Ah 9s Ad 3d] [Tc]
YOUNG_G70: checks 
chaps1988: checks 
*** SHOW DOWN ***
YOUNG_G70: shows [Th Ts] (a full house, Tens full of Aces)
chaps1988: mucks hand 
YOUNG_G70 collected $22.44 from pot
*** SUMMARY ***
Total pot $23.50 | Rake $1.06 
Board [Ah 9s Ad 3d Tc]
Seat 2: davianvalek folded before Flop (didn't bet)
Seat 3: ozone2003 folded before Flop (didn't bet)
Seat 4: YOUNG_G70 showed [Th Ts] and won ($22.44) with a full house, Tens full of Aces
Seat 5: chaps1988 mucked [Qd Js]
Seat 6: I The King I folded before Flop (didn't bet)
Seat 7: sanpidk (button) folded before Flop (didn't bet)
Seat 8: Spid1 (small blind) folded on the Flop
Seat 9: matiko09 (big blind) folded before Flop





PokerStars Hand #148219325308:  Hold'em No Limit (€0.50/€1.00 EUR) - 2016/02/04 15:23:48 CET [2016/02/04 9:23:48 ET]
Table 'Ostenia' 9-max Seat #2 is the button
Seat 2: Dante63s (€100 in chips) 
Seat 3: maxxmeister (€104.14 in chips) 
Seat 4: MagicKid777 (€119.59 in chips) 
Seat 5: matiko09 (€106 in chips) 
Seat 6: melitakas (€103.35 in chips) 
Seat 7: tipner (€114.90 in chips) 
Seat 8: Venomous100% (€110.15 in chips) 
Seat 9: sanpidk (€131.51 in chips) 
fastlife61 leaves the table
maxxmeister: posts small blind €0.50
MagicKid777: posts big blind €1
*** HOLE CARDS ***
Dealt to matiko09 [7s 3s]
Kukuryzka joins the table at seat #1 
matiko09: folds 
melitakas: raises €1 to €2
Kukuryzka leaves the table
tipner: folds 
Venomous100%: folds 
sanpidk: folds 
Dante63s: calls €2
maxxmeister: folds 
MagicKid777: calls €1
*** FLOP *** [5h 9s As]
MagicKid777: checks 
melitakas: bets €3.10
Dante63s: folds 
MagicKid777: folds 
Uncalled bet (€3.10) returned to melitakas
melitakas collected €6.21 from pot
*** SUMMARY ***
Total pot €6.50 | Rake €0.29 
Board [5h 9s As]
Seat 2: Dante63s (button) folded on the Flop
Seat 3: maxxmeister (small blind) folded before Flop
Seat 4: MagicKid777 (big blind) folded on the Flop
Seat 5: matiko09 folded before Flop (didn't bet)
Seat 6: melitakas collected (€6.21)
Seat 7: tipner folded before Flop (didn't bet)
Seat 8: Venomous100% folded before Flop (didn't bet)
Seat 9: sanpidk folded before Flop (didn't bet)





PokerStars Hand #148219326528:  Hold'em No Limit ($0.50/$1.00 USD) - 2016/02/04 15:23:50 CET [2016/02/04 9:23:50 ET]
Table 'Dejan' 9-max Seat #6 is the button
Seat 1: matiko09 ($104 in chips) 
Seat 2: xxxZeka ($109.25 in chips) 
Seat 3: lumen21 ($100 in chips) 
Seat 4: yourpro ($147.75 in chips) 
Seat 5: PeterBassett ($98.50 in chips) 
Seat 6: sanpidk ($235.40 in chips) 
Seat 7: mycka86 ($123.13 in chips) 
Seat 8: s26s ($98.71 in chips) 
Seat 9: I The King I ($135.42 in chips) 
mycka86: posts small blind $0.50
s26s: posts big blind $1
*** HOLE CARDS ***
Dealt to matiko09 [Jc 7d]
I The King I: folds 
matiko09: folds 
xxxZeka: folds 
lumen21: folds 
yourpro: folds 
PeterBassett has timed out while being disconnected
PeterBassett: folds 
sanpidk: raises $1.24 to $2.24
mycka86: folds 
s26s: calls $1.24
*** FLOP *** [Td 2h 3h]
s26s: checks 
PeterBassett leaves the table
sanpidk: bets $3
s26s: folds 
Uncalled bet ($3) returned to sanpidk
sanpidk collected $4.76 from pot
sanpidk: doesn't show hand 
*** SUMMARY ***
Total pot $4.98 | Rake $0.22 
Board [Td 2h 3h]
Seat 1: matiko09 folded before Flop (didn't bet)
Seat 2: xxxZeka folded before Flop (didn't bet)
Seat 3: lumen21 folded before Flop (didn't bet)
Seat 4: yourpro folded before Flop (didn't bet)
Seat 5: PeterBassett folded before Flop (didn't bet)
Seat 6: sanpidk (button) collected ($4.76)
Seat 7: mycka86 (small blind) folded before Flop
Seat 8: s26s (big blind) folded on the Flop
Seat 9: I The King I folded before Flop (didn't bet)





PokerStars Hand #148219336271:  Hold'em No Limit ($0.50/$1.00 USD) - 2016/02/04 15:24:03 CET [2016/02/04 9:24:03 ET]
Table 'Arneb III' 9-max Seat #4 is the button
Seat 1: Vikulja1993 ($119.85 in chips) 
Seat 2: JeanLima93 ($151.38 in chips) 
Seat 3: matiko09 ($101.94 in chips) 
Seat 4: Igor DoUrden ($266 in chips) 
Seat 5: tipner ($144.20 in chips) 
Seat 6: nickreason17 ($111.70 in chips) 
Seat 8: volwebni4ek ($41.50 in chips) 
Seat 9: ARTVOR640 ($100 in chips) 
tipner: posts small blind $0.50
nickreason17: posts big blind $1
xxxZeka: sits out 
*** HOLE CARDS ***
Dealt to matiko09 [8s Kh]
volwebni4ek: folds 
ARTVOR640: folds 
Vikulja1993: raises $2 to $3
JeanLima93: folds 
matiko09: folds 
Igor DoUrden: folds 
tipner: folds 
nickreason17: folds 
Uncalled bet ($2) returned to Vikulja1993
Vikulja1993 collected $2.50 from pot
Vikulja1993: doesn't show hand 
*** SUMMARY ***
Total pot $2.50 | Rake $0 
Seat 1: Vikulja1993 collected ($2.50)
Seat 2: JeanLima93 folded before Flop (didn't bet)
Seat 3: matiko09 folded before Flop (didn't bet)
Seat 4: Igor DoUrden (button) folded before Flop (didn't bet)
Seat 5: tipner (small blind) folded before Flop
Seat 6: nickreason17 (big blind) folded before Flop
Seat 8: volwebni4ek folded before Flop (didn't bet)
Seat 9: ARTVOR640 folded before Flop (didn't bet)





PokerStars Hand #148219342631:  Hold'em No Limit ($0.50/$1.00 USD) - 2016/02/04 15:24:11 CET [2016/02/04 9:24:11 ET]
Table 'Cepheus III' 9-max Seat #6 is the button
Seat 1: ozone2003 ($101.50 in chips) 
Seat 3: pandalapa ($203.70 in chips) 
Seat 4: lukeylund ($42.93 in chips) 
Seat 5: ARTVOR640 ($139.43 in chips) 
Seat 6: matiko09 ($110.21 in chips) 
Seat 7: Igor DoUrden ($100 in chips) 
Seat 8: omorfadramou ($103 in chips) 
Seat 9: xxxZeka ($104.53 in chips) 
Igor DoUrden: posts small blind $0.50
omorfadramou: posts big blind $1
tipner: sits out 
*** HOLE CARDS ***
Dealt to matiko09 [4c Kh]
xxxZeka: folds 
ozone2003: folds 
pandalapa: folds 
lukeylund: raises $1 to $2
ARTVOR640: calls $2
matiko09: folds 
Igor DoUrden: folds 
omorfadramou: folds 
*** FLOP *** [Ac 3s Qc]
lukeylund: bets $2
ARTVOR640: calls $2
*** TURN *** [Ac 3s Qc] [3d]
lukeylund: checks 
ARTVOR640: checks 
*** RIVER *** [Ac 3s Qc 3d] [8h]
lukeylund: checks 
ARTVOR640: checks 
*** SHOW DOWN ***
lukeylund: shows [9d Td] (a pair of Threes)
ARTVOR640: shows [Ks Qd] (two pair, Queens and Threes)
ARTVOR640 collected $9.07 from pot
*** SUMMARY ***
Total pot $9.50 | Rake $0.43 
Board [Ac 3s Qc 3d 8h]
Seat 1: ozone2003 folded before Flop (didn't bet)
Seat 3: pandalapa folded before Flop (didn't bet)
Seat 4: lukeylund showed [9d Td] and lost with a pair of Threes
Seat 5: ARTVOR640 showed [Ks Qd] and won ($9.07) with two pair, Queens and Threes
Seat 6: matiko09 (button) folded before Flop (didn't bet)
Seat 7: Igor DoUrden (small blind) folded before Flop
Seat 8: omorfadramou (big blind) folded before Flop
Seat 9: xxxZeka folded before Flop (didn't bet)





PokerStars Hand #148219352461:  Hold'em No Limit ($0.50/$1.00 USD) - 2016/02/04 15:24:25 CET [2016/02/04 9:24:25 ET]
Table 'Arneb III' 9-max Seat #5 is the button
Seat 1: Vikulja1993 ($121.35 in chips) 
Seat 2: JeanLima93 ($151.38 in chips) 
Seat 3: matiko09 ($101.94 in chips) 
Seat 4: Igor DoUrden ($266 in chips) 
Seat 5: tipner ($143.70 in chips) 
Seat 6: nickreason17 ($110.70 in chips) 
Seat 7: xxxZeka ($100 in chips) 
Seat 8: volwebni4ek ($41.50 in chips) 
Seat 9: ARTVOR640 ($100 in chips) 
nickreason17: posts small blind $0.50
xxxZeka: posts big blind $1
*** HOLE CARDS ***
Dealt to matiko09 [8s Kd]
volwebni4ek: folds 
ARTVOR640: folds 
Vikulja1993: raises $2 to $3
JeanLima93: calls $3
matiko09: folds 
Igor DoUrden: calls $3
tipner: folds 
nickreason17: calls $2.50
xxxZeka: folds 
*** FLOP *** [Kh 9s Kc]
nickreason17: checks 
Vikulja1993: checks 
JeanLima93: bets $6.21
Igor DoUrden: calls $6.21
nickreason17: calls $6.21
Vikulja1993: folds 
*** TURN *** [Kh 9s Kc] [6d]
nickreason17: checks 
JeanLima93: bets $15.10
Igor DoUrden: folds 
nickreason17: folds 
Uncalled bet ($15.10) returned to JeanLima93
JeanLima93 collected $30.21 from pot
JeanLima93: doesn't show hand 
*** SUMMARY ***
Total pot $31.63 | Rake $1.42 
Board [Kh 9s Kc 6d]
Seat 1: Vikulja1993 folded on the Flop
Seat 2: JeanLima93 collected ($30.21)
Seat 3: matiko09 folded before Flop (didn't bet)
Seat 4: Igor DoUrden folded on the Turn
Seat 5: tipner (button) folded before Flop (didn't bet)
Seat 6: nickreason17 (small blind) folded on the Turn
Seat 7: xxxZeka (big blind) folded before Flop
Seat 8: volwebni4ek folded before Flop (didn't bet)
Seat 9: ARTVOR640 folded before Flop (didn't bet)





PokerStars Hand #148219357380:  Hold'em No Limit (€0.50/€1.00 EUR) - 2016/02/04 15:24:32 CET [2016/02/04 9:24:32 ET]
Table 'Amphios III' 9-max Seat #2 is the button
Seat 1: Spid1 (€104.14 in chips) 
Seat 2: tipner (€100 in chips) 
Seat 3: Kukuryzka (€100.50 in chips) 
Seat 4: matiko09 (€100 in chips) 
Seat 6: flozzi (€105.07 in chips) 
Seat 7: TimStone (€100 in chips) 
Seat 8: Dante63s (€101.87 in chips) 
Kukuryzka: posts small blind €0.50
matiko09: posts big blind €1
*** HOLE CARDS ***
Dealt to matiko09 [Ac 2d]
flozzi: folds 
TimStone: folds 
Dante63s: folds 
Spid1: raises €1.50 to €2.50
tipner: folds 
Kukuryzka: folds 
matiko09: folds 
Uncalled bet (€1.50) returned to Spid1
Spid1 collected €2.50 from pot
Spid1: doesn't show hand 
*** SUMMARY ***
Total pot €2.50 | Rake €0 
Seat 1: Spid1 collected (€2.50)
Seat 2: tipner (button) folded before Flop (didn't bet)
Seat 3: Kukuryzka (small blind) folded before Flop
Seat 4: matiko09 (big blind) folded before Flop
Seat 6: flozzi folded before Flop (didn't bet)
Seat 7: TimStone folded before Flop (didn't bet)
Seat 8: Dante63s folded before Flop (didn't bet)





PokerStars Hand #148219362493:  Hold'em No Limit (€0.50/€1.00 EUR) - 2016/02/04 15:24:39 CET [2016/02/04 9:24:39 ET]
Table 'Ostenia' 9-max Seat #3 is the button
Seat 2: Dante63s (€100 in chips) 
Seat 3: maxxmeister (€103.64 in chips) 
Seat 4: MagicKid777 (€117.59 in chips) 
Seat 5: matiko09 (€106 in chips) 
Seat 6: melitakas (€107.56 in chips) 
Seat 7: tipner (€114.90 in chips) 
Seat 8: Venomous100% (€110.15 in chips) 
Seat 9: sanpidk (€131.51 in chips) 
MagicKid777: posts small blind €0.50
matiko09: posts big blind €1
*** HOLE CARDS ***
Dealt to matiko09 [8h 2h]
melitakas: folds 
tipner: folds 
Venomous100%: folds 
sanpidk: folds 
Dante63s: raises €1.50 to €2.50
mycka86 joins the table at seat #1 
maxxmeister: folds 
MagicKid777: folds 
matiko09: folds 
Uncalled bet (€1.50) returned to Dante63s
Dante63s collected €2.50 from pot
Dante63s: doesn't show hand 
*** SUMMARY ***
Total pot €2.50 | Rake €0 
Seat 2: Dante63s collected (€2.50)
Seat 3: maxxmeister (button) folded before Flop (didn't bet)
Seat 4: MagicKid777 (small blind) folded before Flop
Seat 5: matiko09 (big blind) folded before Flop
Seat 6: melitakas folded before Flop (didn't bet)
Seat 7: tipner folded before Flop (didn't bet)
Seat 8: Venomous100% folded before Flop (didn't bet)
Seat 9: sanpidk folded before Flop (didn't bet)





PokerStars Hand #148219367439:  Hold'em No Limit ($0.50/$1.00 USD) - 2016/02/04 15:24:45 CET [2016/02/04 9:24:45 ET]
Table 'Stebbins' 9-max Seat #8 is the button
Seat 1: Dante63s ($100 in chips) 
Seat 2: matiko09 ($100 in chips) 
Seat 8: maxxmeister ($200 in chips) 
Seat 9: Spid1 ($100 in chips) 
Spid1: posts small blind $0.50
Dante63s: posts big blind $1
Dante63s: posts the ante $0.20
matiko09: posts the ante $0.20
maxxmeister: posts the ante $0.20
Spid1: posts the ante $0.20
*** HOLE CARDS ***
Dealt to matiko09 [4h Ks]
natale1966 leaves the table
matiko09: folds 
maxxmeister: raises $2 to $3
Spid1: folds 
Dante63s: calls $2
*** FLOP *** [As Js 9c]
Dante63s: checks 
maxxmeister: checks 
*** TURN *** [As Js 9c] [Td]
Dante63s: checks 
maxxmeister: checks 
*** RIVER *** [As Js 9c Td] [Jh]
Dante63s: bets $7.50
maxxmeister: folds 
Uncalled bet ($7.50) returned to Dante63s
Dante63s collected $6.97 from pot
Dante63s: doesn't show hand 
*** SUMMARY ***
Total pot $7.30 | Rake $0.33 
Board [As Js 9c Td Jh]
Seat 1: Dante63s (big blind) collected ($6.97)
Seat 2: matiko09 folded before Flop (didn't bet)
Seat 8: maxxmeister (button) folded on the River
Seat 9: Spid1 (small blind) folded before Flop





PokerStars Hand #148219370346:  Hold'em No Limit (€0.50/€1.00 EUR) - 2016/02/04 15:24:49 CET [2016/02/04 9:24:49 ET]
Table 'Amphios III' 9-max Seat #3 is the button
Seat 1: Spid1 (€105.64 in chips) 
Seat 2: tipner (€100 in chips) 
Seat 3: Kukuryzka (€100 in chips) 
Seat 4: matiko09 (€100 in chips) 
Seat 8: Dante63s (€101.87 in chips) 
matiko09: posts small blind €0.50
flozzi: is sitting out 
TimStone: is sitting out 
TimStone leaves the table
Dante63s: posts big blind €1
*** HOLE CARDS ***
Dealt to matiko09 [Jh 5d]
9lKBXKTT6 joins the table at seat #5 
Spid1: folds 
flozzi leaves the table
tipner: raises €2 to €3
Kukuryzka: folds 
matiko09: folds 
Dante63s: calls €2
*** FLOP *** [Ts 3h 8s]
Dante63s: checks 
tipner: bets €4
Dante63s: calls €4
*** TURN *** [Ts 3h 8s] [Qc]
Dante63s: checks 
tipner: bets €8
Dante63s: calls €8
*** RIVER *** [Ts 3h 8s Qc] [Jc]
Dante63s: checks 
tipner: checks 
*** SHOW DOWN ***
Dante63s: shows [Th Qh] (two pair, Queens and Tens)
tipner: mucks hand 
Dante63s collected €29.13 from pot
*** SUMMARY ***
Total pot €30.50 | Rake €1.37 
Board [Ts 3h 8s Qc Jc]
Seat 1: Spid1 folded before Flop (didn't bet)
Seat 2: tipner mucked [Kc Qs]
Seat 3: Kukuryzka (button) folded before Flop (didn't bet)
Seat 4: matiko09 (small blind) folded before Flop
Seat 8: Dante63s (big blind) showed [Th Qh] and won (€29.13) with two pair, Queens and Tens





PokerStars Hand #148219371416:  Hold'em No Limit ($0.50/$1.00 USD) - 2016/02/04 15:24:51 CET [2016/02/04 9:24:51 ET]
Table 'Cepheus III' 9-max Seat #7 is the button
Seat 1: ozone2003 ($101.50 in chips) 
Seat 3: pandalapa ($203.70 in chips) 
Seat 4: lukeylund ($38.93 in chips) 
Seat 5: ARTVOR640 ($144.50 in chips) 
Seat 6: matiko09 ($110.21 in chips) 
Seat 7: Igor DoUrden ($100 in chips) 
Seat 8: omorfadramou ($102 in chips) 
Seat 9: xxxZeka ($104.53 in chips) 
omorfadramou: posts small blind $0.50
xxxZeka: posts big blind $1
tipner: sits out 
*** HOLE CARDS ***
Dealt to matiko09 [Tc Kc]
ozone2003: folds 
pandalapa: folds 
lukeylund: raises $1 to $2
ARTVOR640: folds 
matiko09: folds 
Igor DoUrden: raises $6 to $8
omorfadramou: folds 
xxxZeka: folds 
lukeylund: raises $30.93 to $38.93 and is all-in
Igor DoUrden: calls $30.93
*** FLOP *** [Ad 9h Js]
*** TURN *** [Ad 9h Js] [Ah]
*** RIVER *** [Ad 9h Js Ah] [3h]
*** SHOW DOWN ***
lukeylund: shows [Jc Jd] (a full house, Jacks full of Aces)
Igor DoUrden: shows [Qc Qh] (two pair, Aces and Queens)
lukeylund collected $76.56 from pot
*** SUMMARY ***
Total pot $79.36 | Rake $2.80 
Board [Ad 9h Js Ah 3h]
Seat 1: ozone2003 folded before Flop (didn't bet)
Seat 3: pandalapa folded before Flop (didn't bet)
Seat 4: lukeylund showed [Jc Jd] and won ($76.56) with a full house, Jacks full of Aces
Seat 5: ARTVOR640 folded before Flop (didn't bet)
Seat 6: matiko09 folded before Flop (didn't bet)
Seat 7: Igor DoUrden (button) showed [Qc Qh] and lost with two pair, Aces and Queens
Seat 8: omorfadramou (small blind) folded before Flop
Seat 9: xxxZeka (big blind) folded before Flop





PokerStars Hand #148219380284:  Hold'em No Limit ($0.50/$1.00 USD) - 2016/02/04 15:25:03 CET [2016/02/04 9:25:03 ET]
Table 'Mothallah' 9-max Seat #8 is the button
Seat 1: Rafaello18 ($100 in chips) 
Seat 2: davianvalek ($127.05 in chips) 
Seat 3: ozone2003 ($105.68 in chips) 
Seat 4: YOUNG_G70 ($57.77 in chips) 
Seat 5: chaps1988 ($100 in chips) 
Seat 6: I The King I ($131.28 in chips) 
Seat 7: sanpidk ($100 in chips) 
Seat 8: Spid1 ($132.36 in chips) 
Seat 9: matiko09 ($100 in chips) 
matiko09: posts small blind $0.50
Rafaello18: posts big blind $1
*** HOLE CARDS ***
Dealt to matiko09 [Ad Ts]
davianvalek: folds 
ozone2003: folds 
YOUNG_G70: calls $1
chaps1988: folds 
I The King I: folds 
sanpidk: raises $3.50 to $4.50
Spid1: raises $7.50 to $12
matiko09: folds 
Rafaello18: folds 
YOUNG_G70: folds 
sanpidk: folds 
Uncalled bet ($7.50) returned to Spid1
Spid1 collected $11.50 from pot
Spid1: doesn't show hand 
*** SUMMARY ***
Total pot $11.50 | Rake $0 
Seat 1: Rafaello18 (big blind) folded before Flop
Seat 2: davianvalek folded before Flop (didn't bet)
Seat 3: ozone2003 folded before Flop (didn't bet)
Seat 4: YOUNG_G70 folded before Flop
Seat 5: chaps1988 folded before Flop (didn't bet)
Seat 6: I The King I folded before Flop (didn't bet)
Seat 7: sanpidk folded before Flop
Seat 8: Spid1 (button) collected ($11.50)
Seat 9: matiko09 (small blind) folded before Flop





PokerStars Hand #148219388492:  Hold'em No Limit ($0.50/$1.00 USD) - 2016/02/04 15:25:14 CET [2016/02/04 9:25:14 ET]
Table 'Dejan' 9-max Seat #7 is the button
Seat 1: matiko09 ($104 in chips) 
Seat 2: xxxZeka ($109.25 in chips) 
Seat 3: lumen21 ($100 in chips) 
Seat 4: yourpro ($147.75 in chips) 
Seat 6: sanpidk ($237.92 in chips) 
Seat 7: mycka86 ($122.63 in chips) 
Seat 8: s26s ($96.47 in chips) 
Seat 9: I The King I ($135.42 in chips) 
s26s: posts small blind $0.50
I The King I: posts big blind $1
*** HOLE CARDS ***
Dealt to matiko09 [Tc 6c]
matiko09: folds 
xxxZeka: folds 
lumen21: folds 
yourpro: folds 
sanpidk: folds 
mycka86: folds 
s26s: raises $2 to $3
I The King I: folds 
Uncalled bet ($2) returned to s26s
s26s collected $2 from pot
*** SUMMARY ***
Total pot $2 | Rake $0 
Seat 1: matiko09 folded before Flop (didn't bet)
Seat 2: xxxZeka folded before Flop (didn't bet)
Seat 3: lumen21 folded before Flop (didn't bet)
Seat 4: yourpro folded before Flop (didn't bet)
Seat 6: sanpidk folded before Flop (didn't bet)
Seat 7: mycka86 (button) folded before Flop (didn't bet)
Seat 8: s26s (small blind) collected ($2)
Seat 9: I The King I (big blind) folded before Flop





PokerStars Hand #148219393102:  Hold'em No Limit ($0.50/$1.00 USD) - 2016/02/04 15:25:20 CET [2016/02/04 9:25:20 ET]
Table 'Arneb II' 9-max Seat #8 is the button
Seat 1: matiko09 ($103 in chips) 
Seat 2: sanpidk ($218.46 in chips) 
Seat 3: brille-390 ($150.27 in chips) 
Seat 4: Venomous100% ($102.05 in chips) 
Seat 5: lixiangli ($75.27 in chips) 
Seat 7: melitakas ($235.07 in chips) 
Seat 8: tedbadger9 ($70.82 in chips) 
Seat 9: tipner ($112.17 in chips) 
tipner: posts small blind $0.50
matiko09: posts big blind $1
volwebni4ek: sits out 
*** HOLE CARDS ***
Dealt to matiko09 [3s Qc]
sanpidk: folds 
brille-390: raises $1.25 to $2.25
Venomous100%: folds 
lixiangli: raises $6 to $8.25
melitakas: folds 
tedbadger9: folds 
tipner: folds 
matiko09: folds 
brille-390: folds 
Uncalled bet ($6) returned to lixiangli
lixiangli collected $6 from pot
lixiangli: doesn't show hand 
*** SUMMARY ***
Total pot $6 | Rake $0 
Seat 1: matiko09 (big blind) folded before Flop
Seat 2: sanpidk folded before Flop (didn't bet)
Seat 3: brille-390 folded before Flop
Seat 4: Venomous100% folded before Flop (didn't bet)
Seat 5: lixiangli collected ($6)
Seat 7: melitakas folded before Flop (didn't bet)
Seat 8: tedbadger9 (button) folded before Flop (didn't bet)
Seat 9: tipner (small blind) folded before Flop





PokerStars Hand #148219406069:  Hold'em No Limit (€0.50/€1.00 EUR) - 2016/02/04 15:25:38 CET [2016/02/04 9:25:38 ET]
Table 'Ostenia' 9-max Seat #4 is the button
Seat 2: Dante63s (€101.50 in chips) 
Seat 3: maxxmeister (€103.64 in chips) 
Seat 4: MagicKid777 (€117.09 in chips) 
Seat 5: matiko09 (€105 in chips) 
Seat 6: melitakas (€107.56 in chips) 
Seat 7: tipner (€114.90 in chips) 
Seat 8: Venomous100% (€110.15 in chips) 
Seat 9: sanpidk (€131.51 in chips) 
matiko09: posts small blind €0.50
melitakas: posts big blind €1
mycka86: sits out 
*** HOLE CARDS ***
Dealt to matiko09 [5s Js]
tipner: folds 
Venomous100%: folds 
sanpidk: raises €2 to €3
Dante63s: folds 
maxxmeister: folds 
MagicKid777: folds 
matiko09: folds 
melitakas: folds 
Uncalled bet (€2) returned to sanpidk
sanpidk collected €2.50 from pot
*** SUMMARY ***
Total pot €2.50 | Rake €0 
Seat 2: Dante63s folded before Flop (didn't bet)
Seat 3: maxxmeister folded before Flop (didn't bet)
Seat 4: MagicKid777 (button) folded before Flop (didn't bet)
Seat 5: matiko09 (small blind) folded before Flop
Seat 6: melitakas (big blind) folded before Flop
Seat 7: tipner folded before Flop (didn't bet)
Seat 8: Venomous100% folded before Flop (didn't bet)
Seat 9: sanpidk collected (€2.50)





PokerStars Hand #148219409194:  Hold'em No Limit ($0.50/$1.00 USD) - 2016/02/04 15:25:42 CET [2016/02/04 9:25:42 ET]
Table 'Cepheus III' 9-max Seat #8 is the button
Seat 1: ozone2003 ($101.50 in chips) 
Seat 3: pandalapa ($203.70 in chips) 
Seat 4: lukeylund ($76.56 in chips) 
Seat 5: ARTVOR640 ($144.50 in chips) 
Seat 6: matiko09 ($110.21 in chips) 
Seat 7: Igor DoUrden ($100 in chips) 
Seat 8: omorfadramou ($101.50 in chips) 
Seat 9: xxxZeka ($103.53 in chips) 
xxxZeka: posts small blind $0.50
ozone2003: posts big blind $1
tipner: sits out 
*** HOLE CARDS ***
Dealt to matiko09 [Tc 6d]
pandalapa: folds 
lukeylund: folds 
ARTVOR640: folds 
matiko09: folds 
Igor DoUrden: folds 
omorfadramou: folds 
xxxZeka: raises $1.50 to $2.50
ozone2003: folds 
Uncalled bet ($1.50) returned to xxxZeka
xxxZeka collected $2 from pot
*** SUMMARY ***
Total pot $2 | Rake $0 
Seat 1: ozone2003 (big blind) folded before Flop
Seat 3: pandalapa folded before Flop (didn't bet)
Seat 4: lukeylund folded before Flop (didn't bet)
Seat 5: ARTVOR640 folded before Flop (didn't bet)
Seat 6: matiko09 folded before Flop (didn't bet)
Seat 7: Igor DoUrden folded before Flop (didn't bet)
Seat 8: omorfadramou (button) folded before Flop (didn't bet)
Seat 9: xxxZeka (small blind) collected ($2)





PokerStars Hand #148219413541:  Hold'em No Limit ($0.50/$1.00 USD) - 2016/02/04 15:25:48 CET [2016/02/04 9:25:48 ET]
Table 'Dejan' 9-max Seat #8 is the button
Seat 1: matiko09 ($104 in chips) 
Seat 2: xxxZeka ($109.25 in chips) 
Seat 3: lumen21 ($100 in chips) 
Seat 4: yourpro ($147.75 in chips) 
Seat 6: sanpidk ($237.92 in chips) 
Seat 7: mycka86 ($122.63 in chips) 
Seat 8: s26s ($97.47 in chips) 
Seat 9: I The King I ($134.42 in chips) 
I The King I: posts small blind $0.50
matiko09: posts big blind $1
*** HOLE CARDS ***
Dealt to matiko09 [Ad Qd]
xxxZeka: folds 
Düss2411 joins the table at seat #5 
lumen21 has timed out
lumen21: folds 
yourpro: folds 
sanpidk: raises $1.50 to $2.50
Düss2411 leaves the table
mycka86: folds 
s26s: folds 
Rafaello18 joins the table at seat #5 
I The King I: folds 
matiko09: calls $1.50
*** FLOP *** [7s 3s 6h]
matiko09: checks 
sanpidk: bets $3.50
matiko09: folds 
Uncalled bet ($3.50) returned to sanpidk
sanpidk collected $5.25 from pot
sanpidk: doesn't show hand 
*** SUMMARY ***
Total pot $5.50 | Rake $0.25 
Board [7s 3s 6h]
Seat 1: matiko09 (big blind) folded on the Flop
Seat 2: xxxZeka folded before Flop (didn't bet)
Seat 3: lumen21 folded before Flop (didn't bet)
Seat 4: yourpro folded before Flop (didn't bet)
Seat 6: sanpidk collected ($5.25)
Seat 7: mycka86 folded before Flop (didn't bet)
Seat 8: s26s (button) folded before Flop (didn't bet)
Seat 9: I The King I (small blind) folded before Flop





PokerStars Hand #148219415178:  Hold'em No Limit ($0.50/$1.00 USD) - 2016/02/04 15:25:51 CET [2016/02/04 9:25:51 ET]
Table 'Mothallah' 9-max Seat #9 is the button
Seat 1: Rafaello18 ($100 in chips) 
Seat 2: davianvalek ($127.05 in chips) 
Seat 3: ozone2003 ($105.68 in chips) 
Seat 4: YOUNG_G70 ($56.77 in chips) 
Seat 5: chaps1988 ($100 in chips) 
Seat 6: I The King I ($131.28 in chips) 
Seat 7: sanpidk ($100 in chips) 
Seat 8: Spid1 ($139.36 in chips) 
Seat 9: matiko09 ($100 in chips) 
Rafaello18: posts small blind $0.50
davianvalek: posts big blind $1
*** HOLE CARDS ***
Dealt to matiko09 [Qd Th]
ozone2003: folds 
YOUNG_G70: folds 
chaps1988: folds 
I The King I: raises $2 to $3
sanpidk: calls $3
Spid1: folds 
matiko09: folds 
Rafaello18: folds 
davianvalek: calls $2
*** FLOP *** [Ts Ks 7s]
davianvalek: checks 
I The King I: checks 
sanpidk: checks 
*** TURN *** [Ts Ks 7s] [5d]
davianvalek: checks 
I The King I: checks 
sanpidk: bets $6
davianvalek: folds 
I The King I: folds 
Uncalled bet ($6) returned to sanpidk
sanpidk collected $9.07 from pot
sanpidk: doesn't show hand 
*** SUMMARY ***
Total pot $9.50 | Rake $0.43 
Board [Ts Ks 7s 5d]
Seat 1: Rafaello18 (small blind) folded before Flop
Seat 2: davianvalek (big blind) folded on the Turn
Seat 3: ozone2003 folded before Flop (didn't bet)
Seat 4: YOUNG_G70 folded before Flop (didn't bet)
Seat 5: chaps1988 folded before Flop (didn't bet)
Seat 6: I The King I folded on the Turn
Seat 7: sanpidk collected ($9.07)
Seat 8: Spid1 folded before Flop (didn't bet)
Seat 9: matiko09 (button) folded before Flop (didn't bet)





PokerStars Hand #148219416809:  Hold'em No Limit ($0.50/$1.00 USD) - 2016/02/04 15:25:53 CET [2016/02/04 9:25:53 ET]
Table 'Arneb III' 9-max Seat #6 is the button
Seat 1: Vikulja1993 ($118.35 in chips) 
Seat 2: JeanLima93 ($172.38 in chips) 
Seat 3: matiko09 ($101.94 in chips) 
Seat 4: Igor DoUrden ($256.79 in chips) 
Seat 5: tipner ($143.70 in chips) 
Seat 6: nickreason17 ($101.49 in chips) 
Seat 7: xxxZeka ($100 in chips) 
Seat 8: volwebni4ek ($41.50 in chips) 
Seat 9: ARTVOR640 ($100 in chips) 
xxxZeka: posts small blind $0.50
volwebni4ek: posts big blind $1
*** HOLE CARDS ***
Dealt to matiko09 [5s 7d]
ARTVOR640: folds 
Vikulja1993: folds 
JeanLima93: folds 
matiko09: folds 
Igor DoUrden: raises $1.50 to $2.50
tipner: folds 
nickreason17: raises $6.50 to $9
xxxZeka: folds 
volwebni4ek: folds 
Igor DoUrden: calls $6.50
*** FLOP *** [8c Qc 6d]
Igor DoUrden: checks 
nickreason17: bets $9.75
Igor DoUrden: folds 
Uncalled bet ($9.75) returned to nickreason17
nickreason17 collected $18.62 from pot
*** SUMMARY ***
Total pot $19.50 | Rake $0.88 
Board [8c Qc 6d]
Seat 1: Vikulja1993 folded before Flop (didn't bet)
Seat 2: JeanLima93 folded before Flop (didn't bet)
Seat 3: matiko09 folded before Flop (didn't bet)
Seat 4: Igor DoUrden folded on the Flop
Seat 5: tipner folded before Flop (didn't bet)
Seat 6: nickreason17 (button) collected ($18.62)
Seat 7: xxxZeka (small blind) folded before Flop
Seat 8: volwebni4ek (big blind) folded before Flop
Seat 9: ARTVOR640 folded before Flop (didn't bet)





PokerStars Hand #148219418344:  Hold'em No Limit ($0.50/$1.00 USD) - 2016/02/04 15:25:55 CET [2016/02/04 9:25:55 ET]
Table 'Stebbins' 9-max Seat #9 is the button
Seat 1: Dante63s ($103.77 in chips) 
Seat 2: matiko09 ($100 in chips) 
Seat 8: maxxmeister ($250 in chips) 
Seat 9: Spid1 ($100 in chips) 
Dante63s: posts small blind $0.50
matiko09: posts big blind $1
TimStone: sits out 
Dante63s: posts the ante $0.20
matiko09: posts the ante $0.20
maxxmeister: posts the ante $0.20
Spid1: posts the ante $0.20
*** HOLE CARDS ***
Dealt to matiko09 [7d Tc]
maxxmeister: raises $2 to $3
Spid1: folds 
Dante63s: folds 
matiko09: raises $7 to $10
maxxmeister: folds 
Uncalled bet ($7) returned to matiko09
matiko09 collected $7.30 from pot
matiko09: doesn't show hand 
*** SUMMARY ***
Total pot $7.30 | Rake $0 
Seat 1: Dante63s (small blind) folded before Flop
Seat 2: matiko09 (big blind) collected ($7.30)
Seat 8: maxxmeister folded before Flop
Seat 9: Spid1 (button) folded before Flop (didn't bet)





PokerStars Hand #148219432253:  Hold'em No Limit ($0.50/$1.00 USD) - 2016/02/04 15:26:14 CET [2016/02/04 9:26:14 ET]
Table 'Arneb II' 9-max Seat #9 is the button
Seat 1: matiko09 ($102 in chips) 
Seat 2: sanpidk ($218.46 in chips) 
Seat 3: brille-390 ($148.02 in chips) 
Seat 4: Venomous100% ($102.05 in chips) 
Seat 5: lixiangli ($79.02 in chips) 
Seat 7: melitakas ($235.07 in chips) 
Seat 8: tedbadger9 ($70.82 in chips) 
Seat 9: tipner ($111.67 in chips) 
matiko09: posts small blind $0.50
sanpidk: posts big blind $1
volwebni4ek: sits out 
*** HOLE CARDS ***
Dealt to matiko09 [6s Kc]
brille-390: folds 
Venomous100%: raises $2 to $3
lixiangli: folds 
melitakas: folds 
tedbadger9: raises $5 to $8
tipner: folds 
matiko09: folds 
sanpidk: folds 
Venomous100%: folds 
Uncalled bet ($5) returned to tedbadger9
tedbadger9 collected $7.50 from pot
*** SUMMARY ***
Total pot $7.50 | Rake $0 
Seat 1: matiko09 (small blind) folded before Flop
Seat 2: sanpidk (big blind) folded before Flop
Seat 3: brille-390 folded before Flop (didn't bet)
Seat 4: Venomous100% folded before Flop
Seat 5: lixiangli folded before Flop (didn't bet)
Seat 7: melitakas folded before Flop (didn't bet)
Seat 8: tedbadger9 collected ($7.50)
Seat 9: tipner (button) folded before Flop (didn't bet)





PokerStars Hand #148219434513:  Hold'em No Limit (€0.50/€1.00 EUR) - 2016/02/04 15:26:17 CET [2016/02/04 9:26:17 ET]
Table 'Ostenia' 9-max Seat #5 is the button
Seat 2: Dante63s (€101.50 in chips) 
Seat 3: maxxmeister (€103.64 in chips) 
Seat 4: MagicKid777 (€117.09 in chips) 
Seat 5: matiko09 (€104.50 in chips) 
Seat 6: melitakas (€106.56 in chips) 
Seat 7: tipner (€114.90 in chips) 
Seat 8: Venomous100% (€110.15 in chips) 
Seat 9: sanpidk (€133.01 in chips) 
melitakas: posts small blind €0.50
tipner: posts big blind €1
mycka86: sits out 
*** HOLE CARDS ***
Dealt to matiko09 [2d 8h]
Venomous100%: folds 
sanpidk: folds 
Dante63s: raises €1.50 to €2.50
maxxmeister: calls €2.50
MagicKid777: folds 
matiko09: folds 
melitakas: folds 
tipner: calls €1.50
*** FLOP *** [Kc Qc 9h]
tipner: checks 
Dante63s: checks 
maxxmeister: bets €6
tipner: folds 
Dante63s: folds 
Uncalled bet (€6) returned to maxxmeister
maxxmeister collected €7.64 from pot
maxxmeister: doesn't show hand 
*** SUMMARY ***
Total pot €8 | Rake €0.36 
Board [Kc Qc 9h]
Seat 2: Dante63s folded on the Flop
Seat 3: maxxmeister collected (€7.64)
Seat 4: MagicKid777 folded before Flop (didn't bet)
Seat 5: matiko09 (button) folded before Flop (didn't bet)
Seat 6: melitakas (small blind) folded before Flop
Seat 7: tipner (big blind) folded on the Flop
Seat 8: Venomous100% folded before Flop (didn't bet)
Seat 9: sanpidk folded before Flop (didn't bet)





PokerStars Hand #148219444171:  Hold'em No Limit ($0.50/$1.00 USD) - 2016/02/04 15:26:30 CET [2016/02/04 9:26:30 ET]
Table 'Cepheus III' 9-max Seat #9 is the button
Seat 1: ozone2003 ($100.50 in chips) 
Seat 2: tipner ($101.50 in chips) 
Seat 3: pandalapa ($203.70 in chips) 
Seat 4: lukeylund ($76.56 in chips) 
Seat 5: ARTVOR640 ($144.50 in chips) 
Seat 6: matiko09 ($110.21 in chips) 
Seat 7: Igor DoUrden ($100 in chips) 
Seat 8: omorfadramou ($101.50 in chips) 
Seat 9: xxxZeka ($104.53 in chips) 
ozone2003: posts small blind $0.50
tipner: posts big blind $1
*** HOLE CARDS ***
Dealt to matiko09 [Jd 6s]
pandalapa: folds 
lukeylund: raises $1 to $2
ARTVOR640: folds 
matiko09: folds 
Igor DoUrden: folds 
omorfadramou: folds 
xxxZeka: calls $2
ozone2003: folds 
tipner: folds 
*** FLOP *** [8d 5h 9s]
lukeylund: checks 
xxxZeka: checks 
*** TURN *** [8d 5h 9s] [Ts]
lukeylund: checks 
xxxZeka: bets $3.49
lukeylund: folds 
Uncalled bet ($3.49) returned to xxxZeka
xxxZeka collected $5.25 from pot
*** SUMMARY ***
Total pot $5.50 | Rake $0.25 
Board [8d 5h 9s Ts]
Seat 1: ozone2003 (small blind) folded before Flop
Seat 2: tipner (big blind) folded before Flop
Seat 3: pandalapa folded before Flop (didn't bet)
Seat 4: lukeylund folded on the Turn
Seat 5: ARTVOR640 folded before Flop (didn't bet)
Seat 6: matiko09 folded before Flop (didn't bet)
Seat 7: Igor DoUrden folded before Flop (didn't bet)
Seat 8: omorfadramou folded before Flop (didn't bet)
Seat 9: xxxZeka (button) collected ($5.25)





PokerStars Hand #148219445440:  Hold'em No Limit ($0.50/$1.00 USD) - 2016/02/04 15:26:32 CET [2016/02/04 9:26:32 ET]
Table 'Stebbins' 9-max Seat #1 is the button
Seat 1: Dante63s ($103.07 in chips) 
Seat 2: matiko09 ($104.10 in chips) 
Seat 7: TimStone ($100 in chips) 
Seat 8: maxxmeister ($246.80 in chips) 
Seat 9: Spid1 ($100 in chips) 
matiko09: posts small blind $0.50
TimStone: posts big blind $1
Dante63s: posts the ante $0.20
matiko09: posts the ante $0.20
TimStone: posts the ante $0.20
maxxmeister: posts the ante $0.20
Spid1: posts the ante $0.20
*** HOLE CARDS ***
Dealt to matiko09 [Ad 9d]
maxxmeister: folds 
maxxmeister leaves the table
Spid1: folds 
Dante63s: raises $1 to $2
matiko09: folds 
TimStone: folds 
Uncalled bet ($1) returned to Dante63s
Dante63s collected $3.50 from pot
Dante63s: doesn't show hand 
*** SUMMARY ***
Total pot $3.50 | Rake $0 
Seat 1: Dante63s (button) collected ($3.50)
Seat 2: matiko09 (small blind) folded before Flop
Seat 7: TimStone (big blind) folded before Flop
Seat 8: maxxmeister folded before Flop (didn't bet)
Seat 9: Spid1 folded before Flop (didn't bet)





PokerStars Hand #148219455508:  Hold'em No Limit ($0.50/$1.00 USD) - 2016/02/04 15:26:46 CET [2016/02/04 9:26:46 ET]
Table 'Dejan' 9-max Seat #9 is the button
Seat 1: matiko09 ($101.50 in chips) 
Seat 2: xxxZeka ($109.25 in chips) 
Seat 3: lumen21 ($100 in chips) 
Seat 4: yourpro ($147.75 in chips) 
Seat 6: sanpidk ($240.67 in chips) 
Seat 7: mycka86 ($122.63 in chips) 
Seat 8: s26s ($97.47 in chips) 
Seat 9: I The King I ($133.92 in chips) 
matiko09: posts small blind $0.50
xxxZeka: posts big blind $1
Rafaello18: sits out 
*** HOLE CARDS ***
Dealt to matiko09 [Ks 9s]
lumen21: raises $2 to $3
yourpro: folds 
sanpidk: folds 
mycka86: folds 
s26s: folds 
I The King I: folds 
matiko09: folds 
xxxZeka: folds 
Uncalled bet ($2) returned to lumen21
lumen21 collected $2.50 from pot
lumen21: doesn't show hand 
*** SUMMARY ***
Total pot $2.50 | Rake $0 
Seat 1: matiko09 (small blind) folded before Flop
Seat 2: xxxZeka (big blind) folded before Flop
Seat 3: lumen21 collected ($2.50)
Seat 4: yourpro folded before Flop (didn't bet)
Seat 6: sanpidk folded before Flop (didn't bet)
Seat 7: mycka86 folded before Flop (didn't bet)
Seat 8: s26s folded before Flop (didn't bet)
Seat 9: I The King I (button) folded before Flop (didn't bet)





PokerStars Hand #148219474023:  Hold'em No Limit ($0.50/$1.00 USD) - 2016/02/04 15:27:11 CET [2016/02/04 9:27:11 ET]
Table 'Arneb III' 9-max Seat #7 is the button
Seat 1: Vikulja1993 ($118.35 in chips) 
Seat 2: JeanLima93 ($172.38 in chips) 
Seat 3: matiko09 ($101.94 in chips) 
Seat 4: Igor DoUrden ($247.79 in chips) 
Seat 5: tipner ($143.70 in chips) 
Seat 6: nickreason17 ($111.11 in chips) 
Seat 7: xxxZeka ($100 in chips) 
Seat 8: volwebni4ek ($40.50 in chips) 
Seat 9: ARTVOR640 ($100 in chips) 
volwebni4ek: posts small blind $0.50
ARTVOR640: posts big blind $1
*** HOLE CARDS ***
Dealt to matiko09 [Qs 5c]
Vikulja1993: folds 
Vikulja1993 leaves the table
JeanLima93: calls $1
matiko09: folds 
Igor DoUrden: folds 
tipner: folds 
nickreason17: folds 
xxxZeka: raises $3.50 to $4.50
volwebni4ek: folds 
ARTVOR640: folds 
JeanLima93: folds 
Uncalled bet ($3.50) returned to xxxZeka
xxxZeka collected $3.50 from pot
*** SUMMARY ***
Total pot $3.50 | Rake $0 
Seat 1: Vikulja1993 folded before Flop (didn't bet)
Seat 2: JeanLima93 folded before Flop
Seat 3: matiko09 folded before Flop (didn't bet)
Seat 4: Igor DoUrden folded before Flop (didn't bet)
Seat 5: tipner folded before Flop (didn't bet)
Seat 6: nickreason17 folded before Flop (didn't bet)
Seat 7: xxxZeka (button) collected ($3.50)
Seat 8: volwebni4ek (small blind) folded before Flop
Seat 9: ARTVOR640 (big blind) folded before Flop





PokerStars Hand #148219474081:  Hold'em No Limit ($0.50/$1.00 USD) - 2016/02/04 15:27:11 CET [2016/02/04 9:27:11 ET]
Table 'Arneb II' 9-max Seat #1 is the button
Seat 1: matiko09 ($101.50 in chips) 
Seat 2: sanpidk ($217.46 in chips) 
Seat 3: brille-390 ($148.02 in chips) 
Seat 4: Venomous100% ($100 in chips) 
Seat 5: lixiangli ($79.02 in chips) 
Seat 7: melitakas ($235.07 in chips) 
Seat 8: tedbadger9 ($75.32 in chips) 
Seat 9: tipner ($111.67 in chips) 
sanpidk: posts small blind $0.50
brille-390: posts big blind $1
volwebni4ek: sits out 
*** HOLE CARDS ***
Dealt to matiko09 [Qh 4d]
Venomous100%: raises $2 to $3
lixiangli: folds 
melitakas: calls $3
tedbadger9: calls $3
tipner: folds 
matiko09: folds 
sanpidk: folds 
brille-390: folds 
*** FLOP *** [2c 8c 2h]
Venomous100%: bets $6
melitakas: calls $6
tedbadger9: calls $6
*** TURN *** [2c 8c 2h] [9d]
Venomous100%: checks 
melitakas: checks 
tedbadger9: checks 
*** RIVER *** [2c 8c 2h 9d] [Ac]
Venomous100%: checks 
melitakas: checks 
tedbadger9: bets $13.61
Venomous100%: folds 
melitakas: calls $13.61
*** SHOW DOWN ***
tedbadger9: shows [Ah Qs] (two pair, Aces and Deuces)
melitakas: shows [6c 4c] (a flush, Ace high)
melitakas collected $53.21 from pot
*** SUMMARY ***
Total pot $55.72 | Rake $2.51 
Board [2c 8c 2h 9d Ac]
Seat 1: matiko09 (button) folded before Flop (didn't bet)
Seat 2: sanpidk (small blind) folded before Flop
Seat 3: brille-390 (big blind) folded before Flop
Seat 4: Venomous100% folded on the River
Seat 5: lixiangli folded before Flop (didn't bet)
Seat 7: melitakas showed [6c 4c] and won ($53.21) with a flush, Ace high
Seat 8: tedbadger9 showed [Ah Qs] and lost with two pair, Aces and Deuces
Seat 9: tipner folded before Flop (didn't bet)





PokerStars Hand #148219481793:  Hold'em No Limit ($0.50/$1.00 USD) - 2016/02/04 15:27:22 CET [2016/02/04 9:27:22 ET]
Table 'Dejan' 9-max Seat #1 is the button
Seat 1: matiko09 ($101 in chips) 
Seat 2: xxxZeka ($108.25 in chips) 
Seat 3: lumen21 ($101.50 in chips) 
Seat 4: yourpro ($147.75 in chips) 
Seat 6: sanpidk ($240.67 in chips) 
Seat 7: mycka86 ($122.63 in chips) 
Seat 8: s26s ($97.47 in chips) 
Seat 9: I The King I ($133.92 in chips) 
xxxZeka: posts small blind $0.50
lumen21: posts big blind $1
Rafaello18: sits out 
*** HOLE CARDS ***
Dealt to matiko09 [4d 9s]
yourpro: folds 
sanpidk: folds 
mycka86: folds 
s26s: folds 
I The King I: folds 
matiko09: folds 
xxxZeka: folds 
Uncalled bet ($0.50) returned to lumen21
lumen21 collected $1 from pot
lumen21: doesn't show hand 
*** SUMMARY ***
Total pot $1 | Rake $0 
Seat 1: matiko09 (button) folded before Flop (didn't bet)
Seat 2: xxxZeka (small blind) folded before Flop
Seat 3: lumen21 (big blind) collected ($1)
Seat 4: yourpro folded before Flop (didn't bet)
Seat 6: sanpidk folded before Flop (didn't bet)
Seat 7: mycka86 folded before Flop (didn't bet)
Seat 8: s26s folded before Flop (didn't bet)
Seat 9: I The King I folded before Flop (didn't bet)





PokerStars Hand #148219482989:  Hold'em No Limit ($0.50/$1.00 USD) - 2016/02/04 15:27:24 CET [2016/02/04 9:27:24 ET]
Table 'Cepheus III' 9-max Seat #1 is the button
Seat 1: ozone2003 ($100 in chips) 
Seat 2: tipner ($100.50 in chips) 
Seat 3: pandalapa ($203.70 in chips) 
Seat 4: lukeylund ($74.56 in chips) 
Seat 5: ARTVOR640 ($144.50 in chips) 
Seat 6: matiko09 ($110.21 in chips) 
Seat 7: Igor DoUrden ($100 in chips) 
Seat 8: omorfadramou ($101.50 in chips) 
Seat 9: xxxZeka ($107.78 in chips) 
tipner: posts small blind $0.50
pandalapa: posts big blind $1
*** HOLE CARDS ***
Dealt to matiko09 [6c Qc]
lukeylund: raises $1 to $2
ARTVOR640: folds 
matiko09: folds 
Igor DoUrden: folds 
omorfadramou: folds 
xxxZeka: folds 
ozone2003: folds 
tipner: folds 
pandalapa: folds 
Uncalled bet ($1) returned to lukeylund
lukeylund collected $2.50 from pot
lukeylund: doesn't show hand 
*** SUMMARY ***
Total pot $2.50 | Rake $0 
Seat 1: ozone2003 (button) folded before Flop (didn't bet)
Seat 2: tipner (small blind) folded before Flop
Seat 3: pandalapa (big blind) folded before Flop
Seat 4: lukeylund collected ($2.50)
Seat 5: ARTVOR640 folded before Flop (didn't bet)
Seat 6: matiko09 folded before Flop (didn't bet)
Seat 7: Igor DoUrden folded before Flop (didn't bet)
Seat 8: omorfadramou folded before Flop (didn't bet)
Seat 9: xxxZeka folded before Flop (didn't bet)





PokerStars Hand #148219484700:  Hold'em No Limit ($0.50/$1.00 USD) - 2016/02/04 15:27:26 CET [2016/02/04 9:27:26 ET]
Table 'Mothallah' 9-max Seat #1 is the button
Seat 1: Rafaello18 ($100 in chips) 
Seat 2: davianvalek ($124.05 in chips) 
Seat 3: ozone2003 ($105.68 in chips) 
Seat 4: YOUNG_G70 ($56.77 in chips) 
Seat 5: chaps1988 ($100 in chips) 
Seat 6: I The King I ($128.28 in chips) 
Seat 7: sanpidk ($106.07 in chips) 
Seat 8: Spid1 ($139.36 in chips) 
Seat 9: matiko09 ($100 in chips) 
davianvalek: posts small blind $0.50
ozone2003: posts big blind $1
*** HOLE CARDS ***
Dealt to matiko09 [3d 7c]
YOUNG_G70: calls $1
chaps1988: folds 
I The King I: folds 
sanpidk: raises $3.50 to $4.50
Spid1: folds 
matiko09: folds 
Rafaello18: folds 
davianvalek: folds 
ozone2003: folds 
YOUNG_G70: calls $3.50
*** FLOP *** [Qs 6s Jd]
YOUNG_G70: checks 
sanpidk: checks 
*** TURN *** [Qs 6s Jd] [Kc]
YOUNG_G70: bets $5
sanpidk: folds 
Uncalled bet ($5) returned to YOUNG_G70
YOUNG_G70 collected $10.03 from pot
YOUNG_G70: doesn't show hand 
*** SUMMARY ***
Total pot $10.50 | Rake $0.47 
Board [Qs 6s Jd Kc]
Seat 1: Rafaello18 (button) folded before Flop (didn't bet)
Seat 2: davianvalek (small blind) folded before Flop
Seat 3: ozone2003 (big blind) folded before Flop
Seat 4: YOUNG_G70 collected ($10.03)
Seat 5: chaps1988 folded before Flop (didn't bet)
Seat 6: I The King I folded before Flop (didn't bet)
Seat 7: sanpidk folded on the Turn
Seat 8: Spid1 folded before Flop (didn't bet)
Seat 9: matiko09 folded before Flop (didn't bet)





PokerStars Hand #148219489922:  Hold'em No Limit (€0.50/€1.00 EUR) - 2016/02/04 15:27:33 CET [2016/02/04 9:27:33 ET]
Table 'Ostenia' 9-max Seat #6 is the button
Seat 2: Dante63s (€100 in chips) 
Seat 3: maxxmeister (€108.78 in chips) 
Seat 4: MagicKid777 (€117.09 in chips) 
Seat 5: matiko09 (€104.50 in chips) 
Seat 6: melitakas (€106.06 in chips) 
Seat 7: tipner (€112.40 in chips) 
Seat 8: Venomous100% (€110.15 in chips) 
Seat 9: sanpidk (€133.01 in chips) 
tipner: posts small blind €0.50
Venomous100%: posts big blind €1
mycka86: sits out 
*** HOLE CARDS ***
Dealt to matiko09 [9c 2s]
sanpidk: folds 
Dante63s: folds 
maxxmeister: folds 
MagicKid777: raises €2 to €3
matiko09: folds 
melitakas: calls €3
tipner: folds 
Venomous100%: folds 
*** FLOP *** [Ah Ac 9d]
MagicKid777: checks 
melitakas: bets €3.58
MagicKid777: calls €3.58
*** TURN *** [Ah Ac 9d] [Jh]
MagicKid777: checks 
melitakas: checks 
*** RIVER *** [Ah Ac 9d Jh] [3h]
MagicKid777: bets €12
melitakas: folds 
Uncalled bet (€12) returned to MagicKid777
MagicKid777 collected €14 from pot
MagicKid777: doesn't show hand 
*** SUMMARY ***
Total pot €14.66 | Rake €0.66 
Board [Ah Ac 9d Jh 3h]
Seat 2: Dante63s folded before Flop (didn't bet)
Seat 3: maxxmeister folded before Flop (didn't bet)
Seat 4: MagicKid777 collected (€14)
Seat 5: matiko09 folded before Flop (didn't bet)
Seat 6: melitakas (button) folded on the River
Seat 7: tipner (small blind) folded before Flop
Seat 8: Venomous100% (big blind) folded before Flop
Seat 9: sanpidk folded before Flop (didn't bet)





PokerStars Hand #148219501186:  Hold'em No Limit ($0.50/$1.00 USD) - 2016/02/04 15:27:49 CET [2016/02/04 9:27:49 ET]
Table 'Arneb III' 9-max Seat #8 is the button
Seat 2: JeanLima93 ($171.38 in chips) 
Seat 3: matiko09 ($101.94 in chips) 
Seat 4: Igor DoUrden ($247.79 in chips) 
Seat 5: tipner ($143.70 in chips) 
Seat 6: nickreason17 ($111.11 in chips) 
Seat 7: xxxZeka ($102.50 in chips) 
Seat 8: volwebni4ek ($40 in chips) 
Seat 9: ARTVOR640 ($100 in chips) 
ARTVOR640: posts small blind $0.50
JeanLima93: posts big blind $1
*** HOLE CARDS ***
Dealt to matiko09 [Tc 8s]
matiko09: folds 
Igor DoUrden: folds 
sanpidk joins the table at seat #1 
tipner: raises $2 to $3
nickreason17: folds 
xxxZeka: folds 
volwebni4ek: folds 
ARTVOR640: folds 
JeanLima93: calls $2
*** FLOP *** [Js Ad Ts]
JeanLima93: checks 
tipner: bets $4
JeanLima93: calls $4
*** TURN *** [Js Ad Ts] [6h]
JeanLima93: checks 
tipner: bets $7
JeanLima93: calls $7
*** RIVER *** [Js Ad Ts 6h] [3d]
JeanLima93: checks 
tipner: bets $13
JeanLima93: folds 
Uncalled bet ($13) returned to tipner
tipner collected $27.22 from pot
tipner: doesn't show hand 
*** SUMMARY ***
Total pot $28.50 | Rake $1.28 
Board [Js Ad Ts 6h 3d]
Seat 2: JeanLima93 (big blind) folded on the River
Seat 3: matiko09 folded before Flop (didn't bet)
Seat 4: Igor DoUrden folded before Flop (didn't bet)
Seat 5: tipner collected ($27.22)
Seat 6: nickreason17 folded before Flop (didn't bet)
Seat 7: xxxZeka folded before Flop (didn't bet)
Seat 8: volwebni4ek (button) folded before Flop (didn't bet)
Seat 9: ARTVOR640 (small blind) folded before Flop





PokerStars Hand #148219504955:  Hold'em No Limit ($0.50/$1.00 USD) - 2016/02/04 15:27:54 CET [2016/02/04 9:27:54 ET]
Table 'Avior II' 9-max Seat #7 is the button
Seat 2: matiko09 ($100 in chips) 
Seat 3: sanpidk ($133.20 in chips) 
Seat 4: xxxZeka ($100 in chips) 
Seat 5: chaps1988 ($105.85 in chips) 
Seat 6: tipner ($187.19 in chips) 
Seat 7: nickreason17 ($101.50 in chips) 
Seat 8: EdHunder ($53.92 in chips) 
EdHunder: posts small blind $0.50
yourpro: is sitting out 
matiko09: posts big blind $1
*** HOLE CARDS ***
Dealt to matiko09 [9c Ah]
yourpro leaves the table
I The King I joins the table at seat #1 
sanpidk: folds 
xxxZeka: folds 
chaps1988: folds 
tipner: folds 
nickreason17: folds 
EdHunder: folds 
Uncalled bet ($0.50) returned to matiko09
matiko09 collected $1 from pot
matiko09: doesn't show hand 
*** SUMMARY ***
Total pot $1 | Rake $0 
Seat 2: matiko09 (big blind) collected ($1)
Seat 3: sanpidk folded before Flop (didn't bet)
Seat 4: xxxZeka folded before Flop (didn't bet)
Seat 5: chaps1988 folded before Flop (didn't bet)
Seat 6: tipner folded before Flop (didn't bet)
Seat 7: nickreason17 (button) folded before Flop (didn't bet)
Seat 8: EdHunder (small blind) folded before Flop





PokerStars Hand #148219506246:  Hold'em No Limit ($0.50/$1.00 USD) - 2016/02/04 15:27:56 CET [2016/02/04 9:27:56 ET]
Table 'Dejan' 9-max Seat #2 is the button
Seat 1: matiko09 ($101 in chips) 
Seat 2: xxxZeka ($107.75 in chips) 
Seat 3: lumen21 ($102 in chips) 
Seat 5: Rafaello18 ($128.16 in chips) 
Seat 6: sanpidk ($240.67 in chips) 
Seat 7: mycka86 ($122.63 in chips) 
Seat 8: s26s ($97.47 in chips) 
Seat 9: I The King I ($133.92 in chips) 
lumen21: posts small blind $0.50
yourpro: is sitting out 
Rafaello18: posts big blind $1
*** HOLE CARDS ***
Dealt to matiko09 [7h Kh]
yourpro leaves the table
sanpidk: folds 
mycka86: folds 
s26s: raises $2.50 to $3.50
I The King I: folds 
matiko09: folds 
xxxZeka: folds 
lumen21: folds 
Rafaello18: calls $2.50
*** FLOP *** [8h Th 3c]
Rafaello18: checks 
s26s: bets $7.16
pruxa72 joins the table at seat #4 
Rafaello18: raises $14.84 to $22
s26s: folds 
Uncalled bet ($14.84) returned to Rafaello18
Rafaello18 collected $20.84 from pot
Rafaello18: doesn't show hand 
*** SUMMARY ***
Total pot $21.82 | Rake $0.98 
Board [8h Th 3c]
Seat 1: matiko09 folded before Flop (didn't bet)
Seat 2: xxxZeka (button) folded before Flop (didn't bet)
Seat 3: lumen21 (small blind) folded before Flop
Seat 5: Rafaello18 (big blind) collected ($20.84)
Seat 6: sanpidk folded before Flop (didn't bet)
Seat 7: mycka86 folded before Flop (didn't bet)
Seat 8: s26s folded on the Flop
Seat 9: I The King I folded before Flop (didn't bet)





PokerStars Hand #148219513531:  Hold'em No Limit ($0.50/$1.00 USD) - 2016/02/04 15:28:06 CET [2016/02/04 9:28:06 ET]
Table 'Mothallah' 9-max Seat #2 is the button
Seat 1: Rafaello18 ($100 in chips) 
Seat 2: davianvalek ($123.55 in chips) 
Seat 3: ozone2003 ($104.68 in chips) 
Seat 4: YOUNG_G70 ($62.30 in chips) 
Seat 5: chaps1988 ($100 in chips) 
Seat 6: I The King I ($128.28 in chips) 
Seat 7: sanpidk ($101.57 in chips) 
Seat 8: Spid1 ($139.36 in chips) 
Seat 9: matiko09 ($100 in chips) 
ozone2003: posts small blind $0.50
YOUNG_G70: posts big blind $1
*** HOLE CARDS ***
Dealt to matiko09 [6h Jd]
chaps1988: folds 
I The King I: folds 
sanpidk: folds 
Spid1: folds 
matiko09: folds 
Rafaello18: raises $1.50 to $2.50
davianvalek: raises $5.50 to $8
ozone2003: folds 
YOUNG_G70: folds 
Rafaello18: raises $11 to $19
davianvalek: folds 
Uncalled bet ($11) returned to Rafaello18
Rafaello18 collected $17.50 from pot
Rafaello18: doesn't show hand 
*** SUMMARY ***
Total pot $17.50 | Rake $0 
Seat 1: Rafaello18 collected ($17.50)
Seat 2: davianvalek (button) folded before Flop
Seat 3: ozone2003 (small blind) folded before Flop
Seat 4: YOUNG_G70 (big blind) folded before Flop
Seat 5: chaps1988 folded before Flop (didn't bet)
Seat 6: I The King I folded before Flop (didn't bet)
Seat 7: sanpidk folded before Flop (didn't bet)
Seat 8: Spid1 folded before Flop (didn't bet)
Seat 9: matiko09 folded before Flop (didn't bet)





PokerStars Hand #148219515579:  Hold'em No Limit ($0.50/$1.00 USD) - 2016/02/04 15:28:09 CET [2016/02/04 9:28:09 ET]
Table 'Cepheus III' 9-max Seat #2 is the button
Seat 1: ozone2003 ($100 in chips) 
Seat 2: tipner ($100 in chips) 
Seat 3: pandalapa ($202.70 in chips) 
Seat 4: lukeylund ($76.06 in chips) 
Seat 5: ARTVOR640 ($144.50 in chips) 
Seat 6: matiko09 ($110.21 in chips) 
Seat 7: Igor DoUrden ($100 in chips) 
Seat 8: omorfadramou ($101.50 in chips) 
Seat 9: xxxZeka ($107.78 in chips) 
pandalapa: posts small blind $0.50
lukeylund: posts big blind $1
*** HOLE CARDS ***
Dealt to matiko09 [7c 8s]
ARTVOR640: folds 
matiko09: folds 
Igor DoUrden: folds 
omorfadramou: raises $1.16 to $2.16
xxxZeka: calls $2.16
ozone2003: folds 
tipner: folds 
pandalapa: folds 
lukeylund: folds 
*** FLOP *** [7h Jc 9d]
omorfadramou: bets $4.33
xxxZeka: calls $4.33
*** TURN *** [7h Jc 9d] [7s]
omorfadramou: bets $8.71
xxxZeka: calls $8.71
*** RIVER *** [7h Jc 9d 7s] [2h]
omorfadramou: checks 
xxxZeka: bets $20
omorfadramou: calls $20
*** SHOW DOWN ***
xxxZeka: shows [Ad Jd] (two pair, Jacks and Sevens)
omorfadramou: shows [9h Jh] (two pair, Jacks and Nines)
omorfadramou collected $69.10 from pot
*** SUMMARY ***
Total pot $71.90 | Rake $2.80 
Board [7h Jc 9d 7s 2h]
Seat 1: ozone2003 folded before Flop (didn't bet)
Seat 2: tipner (button) folded before Flop (didn't bet)
Seat 3: pandalapa (small blind) folded before Flop
Seat 4: lukeylund (big blind) folded before Flop
Seat 5: ARTVOR640 folded before Flop (didn't bet)
Seat 6: matiko09 folded before Flop (didn't bet)
Seat 7: Igor DoUrden folded before Flop (didn't bet)
Seat 8: omorfadramou showed [9h Jh] and won ($69.10) with two pair, Jacks and Nines
Seat 9: xxxZeka showed [Ad Jd] and lost with two pair, Jacks and Sevens





PokerStars Hand #148219520900:  Hold'em No Limit ($0.50/$1.00 USD) - 2016/02/04 15:28:16 CET [2016/02/04 9:28:16 ET]
Table 'Avior II' 9-max Seat #8 is the button
Seat 2: matiko09 ($100.50 in chips) 
Seat 3: sanpidk ($133.20 in chips) 
Seat 4: xxxZeka ($100 in chips) 
Seat 5: chaps1988 ($105.85 in chips) 
Seat 6: tipner ($187.19 in chips) 
Seat 7: nickreason17 ($101.50 in chips) 
Seat 8: EdHunder ($53.42 in chips) 
I The King I will be allowed to play after the button
matiko09: posts small blind $0.50
sanpidk: posts big blind $1
*** HOLE CARDS ***
Dealt to matiko09 [5c 9h]
xxxZeka: folds 
chaps1988: folds 
tipner: folds 
nickreason17: raises $1.50 to $2.50
EdHunder: folds 
matiko09: folds 
sanpidk: folds 
Uncalled bet ($1.50) returned to nickreason17
nickreason17 collected $2.50 from pot
*** SUMMARY ***
Total pot $2.50 | Rake $0 
Seat 2: matiko09 (small blind) folded before Flop
Seat 3: sanpidk (big blind) folded before Flop
Seat 4: xxxZeka folded before Flop (didn't bet)
Seat 5: chaps1988 folded before Flop (didn't bet)
Seat 6: tipner folded before Flop (didn't bet)
Seat 7: nickreason17 collected ($2.50)
Seat 8: EdHunder (button) folded before Flop (didn't bet)





PokerStars Hand #148219534974:  Hold'em No Limit ($0.50/$1.00 USD) - 2016/02/04 15:28:35 CET [2016/02/04 9:28:35 ET]
Table 'Arneb II' 9-max Seat #2 is the button
Seat 1: matiko09 ($101.50 in chips) 
Seat 2: sanpidk ($216.96 in chips) 
Seat 3: brille-390 ($147.02 in chips) 
Seat 4: Venomous100% ($100 in chips) 
Seat 5: lixiangli ($79.02 in chips) 
Seat 7: melitakas ($265.67 in chips) 
Seat 8: tedbadger9 ($52.71 in chips) 
Seat 9: tipner ($111.67 in chips) 
brille-390: posts small blind $0.50
Venomous100%: posts big blind $1
volwebni4ek: sits out 
*** HOLE CARDS ***
Dealt to matiko09 [4c 8h]
lixiangli: folds 
melitakas: folds 
tedbadger9: folds 
tipner: folds 
matiko09: folds 
sanpidk: raises $1.24 to $2.24
brille-390: folds 
Venomous100%: folds 
Uncalled bet ($1.24) returned to sanpidk
sanpidk collected $2.50 from pot
sanpidk: doesn't show hand 
*** SUMMARY ***
Total pot $2.50 | Rake $0 
Seat 1: matiko09 folded before Flop (didn't bet)
Seat 2: sanpidk (button) collected ($2.50)
Seat 3: brille-390 (small blind) folded before Flop
Seat 4: Venomous100% (big blind) folded before Flop
Seat 5: lixiangli folded before Flop (didn't bet)
Seat 7: melitakas folded before Flop (didn't bet)
Seat 8: tedbadger9 folded before Flop (didn't bet)
Seat 9: tipner folded before Flop (didn't bet)





PokerStars Hand #148219542112:  Hold'em No Limit ($0.50/$1.00 USD) - 2016/02/04 15:28:45 CET [2016/02/04 9:28:45 ET]
Table 'Avior II' 9-max Seat #2 is the button
Seat 2: matiko09 ($100 in chips) 
Seat 3: sanpidk ($132.20 in chips) 
Seat 4: xxxZeka ($100 in chips) 
Seat 5: chaps1988 ($105.85 in chips) 
Seat 6: tipner ($187.19 in chips) 
Seat 7: nickreason17 ($103 in chips) 
Seat 8: EdHunder ($53.42 in chips) 
sanpidk: posts small blind $0.50
xxxZeka: posts big blind $1
I The King I: sits out 
*** HOLE CARDS ***
Dealt to matiko09 [5s 5c]
chaps1988: folds 
tipner: folds 
nickreason17: folds 
EdHunder: folds 
matiko09: raises $1.27 to $2.27
sanpidk: folds 
xxxZeka: folds 
Uncalled bet ($1.27) returned to matiko09
matiko09 collected $2.50 from pot
matiko09: doesn't show hand 
*** SUMMARY ***
Total pot $2.50 | Rake $0 
Seat 2: matiko09 (button) collected ($2.50)
Seat 3: sanpidk (small blind) folded before Flop
Seat 4: xxxZeka (big blind) folded before Flop
Seat 5: chaps1988 folded before Flop (didn't bet)
Seat 6: tipner folded before Flop (didn't bet)
Seat 7: nickreason17 folded before Flop (didn't bet)
Seat 8: EdHunder folded before Flop (didn't bet)





PokerStars Hand #148219553043:  Hold'em No Limit (€0.50/€1.00 EUR) - 2016/02/04 15:29:00 CET [2016/02/04 9:29:00 ET]
Table 'Ostenia' 9-max Seat #7 is the button
Seat 2: Dante63s (€100 in chips) 
Seat 3: maxxmeister (€108.78 in chips) 
Seat 4: MagicKid777 (€124.51 in chips) 
Seat 5: matiko09 (€104.50 in chips) 
Seat 6: melitakas (€100 in chips) 
Seat 7: tipner (€111.90 in chips) 
Seat 8: Venomous100% (€109.15 in chips) 
Seat 9: sanpidk (€133.01 in chips) 
Venomous100%: posts small blind €0.50
sanpidk: posts big blind €1
mycka86: sits out 
*** HOLE CARDS ***
Dealt to matiko09 [6c 7d]
Dante63s: raises €2 to €3
maxxmeister: folds 
MagicKid777: folds 
matiko09: folds 
melitakas: calls €3
tipner: raises €10 to €13
Venomous100%: folds 
sanpidk: folds 
Dante63s: folds 
melitakas: folds 
Uncalled bet (€10) returned to tipner
tipner collected €10.50 from pot
tipner: doesn't show hand 
*** SUMMARY ***
Total pot €10.50 | Rake €0 
Seat 2: Dante63s folded before Flop
Seat 3: maxxmeister folded before Flop (didn't bet)
Seat 4: MagicKid777 folded before Flop (didn't bet)
Seat 5: matiko09 folded before Flop (didn't bet)
Seat 6: melitakas folded before Flop
Seat 7: tipner (button) collected (€10.50)
Seat 8: Venomous100% (small blind) folded before Flop
Seat 9: sanpidk (big blind) folded before Flop





PokerStars Hand #148219559850:  Hold'em No Limit ($0.50/$1.00 USD) - 2016/02/04 15:29:10 CET [2016/02/04 9:29:10 ET]
Table 'Arneb II' 9-max Seat #3 is the button
Seat 1: matiko09 ($101.50 in chips) 
Seat 2: sanpidk ($218.46 in chips) 
Seat 3: brille-390 ($146.52 in chips) 
Seat 4: Venomous100% ($100 in chips) 
Seat 5: lixiangli ($79.02 in chips) 
Seat 7: melitakas ($265.67 in chips) 
Seat 8: tedbadger9 ($52.71 in chips) 
Seat 9: tipner ($111.67 in chips) 
Venomous100%: posts small blind $0.50
lixiangli: posts big blind $1
volwebni4ek: sits out 
*** HOLE CARDS ***
Dealt to matiko09 [Tc Ac]
melitakas: folds 
tedbadger9: raises $2.65 to $3.65
tipner: folds 
matiko09: folds 
sanpidk: folds 
brille-390: folds 
Venomous100%: folds 
lixiangli: calls $2.65
*** FLOP *** [5h 8s 4c]
lixiangli: checks 
tedbadger9: bets $8
lixiangli: folds 
Uncalled bet ($8) returned to tedbadger9
tedbadger9 collected $7.45 from pot
*** SUMMARY ***
Total pot $7.80 | Rake $0.35 
Board [5h 8s 4c]
Seat 1: matiko09 folded before Flop (didn't bet)
Seat 2: sanpidk folded before Flop (didn't bet)
Seat 3: brille-390 (button) folded before Flop (didn't bet)
Seat 4: Venomous100% (small blind) folded before Flop
Seat 5: lixiangli (big blind) folded on the Flop
Seat 7: melitakas folded before Flop (didn't bet)
Seat 8: tedbadger9 collected ($7.45)
Seat 9: tipner folded before Flop (didn't bet)





PokerStars Hand #148219561620:  Hold'em No Limit ($0.50/$1.00 USD) - 2016/02/04 15:29:12 CET [2016/02/04 9:29:12 ET]
Table 'Mothallah' 9-max Seat #3 is the button
Seat 1: Rafaello18 ($109.50 in chips) 
Seat 2: davianvalek ($115.55 in chips) 
Seat 3: ozone2003 ($104.18 in chips) 
Seat 4: YOUNG_G70 ($61.30 in chips) 
Seat 5: chaps1988 ($100 in chips) 
Seat 6: I The King I ($128.28 in chips) 
Seat 7: sanpidk ($101.57 in chips) 
Seat 8: Spid1 ($139.36 in chips) 
Seat 9: matiko09 ($100 in chips) 
YOUNG_G70: posts small blind $0.50
chaps1988: posts big blind $1
*** HOLE CARDS ***
Dealt to matiko09 [Td Qc]
I The King I: folds 
sanpidk: folds 
Spid1: folds 
matiko09: folds 
Rafaello18: folds 
davianvalek: folds 
ozone2003: raises $1.20 to $2.20
YOUNG_G70: folds 
chaps1988: folds 
Uncalled bet ($1.20) returned to ozone2003
ozone2003 collected $2.50 from pot
ozone2003: doesn't show hand 
*** SUMMARY ***
Total pot $2.50 | Rake $0 
Seat 1: Rafaello18 folded before Flop (didn't bet)
Seat 2: davianvalek folded before Flop (didn't bet)
Seat 3: ozone2003 (button) collected ($2.50)
Seat 4: YOUNG_G70 (small blind) folded before Flop
Seat 5: chaps1988 (big blind) folded before Flop
Seat 6: I The King I folded before Flop (didn't bet)
Seat 7: sanpidk folded before Flop (didn't bet)
Seat 8: Spid1 folded before Flop (didn't bet)
Seat 9: matiko09 folded before Flop (didn't bet)





PokerStars Hand #148219563629:  Hold'em No Limit ($0.50/$1.00 USD) - 2016/02/04 15:29:15 CET [2016/02/04 9:29:15 ET]
Table 'Avior II' 9-max Seat #3 is the button
Seat 2: matiko09 ($101.50 in chips) 
Seat 3: sanpidk ($131.70 in chips) 
Seat 4: xxxZeka ($100 in chips) 
Seat 5: chaps1988 ($105.85 in chips) 
Seat 6: tipner ($187.19 in chips) 
Seat 7: nickreason17 ($103 in chips) 
Seat 8: EdHunder ($53.42 in chips) 
xxxZeka: posts small blind $0.50
chaps1988: posts big blind $1
I The King I: sits out 
*** HOLE CARDS ***
Dealt to matiko09 [Js Jd]
tipner: folds 
nickreason17: folds 
EdHunder: folds 
matiko09: raises $1.50 to $2.50
sanpidk: folds 
xxxZeka: folds 
chaps1988: folds 
Uncalled bet ($1.50) returned to matiko09
matiko09 collected $2.50 from pot
matiko09: doesn't show hand 
*** SUMMARY ***
Total pot $2.50 | Rake $0 
Seat 2: matiko09 collected ($2.50)
Seat 3: sanpidk (button) folded before Flop (didn't bet)
Seat 4: xxxZeka (small blind) folded before Flop
Seat 5: chaps1988 (big blind) folded before Flop
Seat 6: tipner folded before Flop (didn't bet)
Seat 7: nickreason17 folded before Flop (didn't bet)
Seat 8: EdHunder folded before Flop (didn't bet)





PokerStars Hand #148219564002:  Hold'em No Limit ($0.50/$1.00 USD) - 2016/02/04 15:29:15 CET [2016/02/04 9:29:15 ET]
Table 'Dejan' 9-max Seat #3 is the button
Seat 1: matiko09 ($101 in chips) 
Seat 2: xxxZeka ($107.75 in chips) 
Seat 3: lumen21 ($101.50 in chips) 
Seat 5: Rafaello18 ($138.34 in chips) 
Seat 6: sanpidk ($240.67 in chips) 
Seat 7: mycka86 ($122.63 in chips) 
Seat 8: s26s ($86.81 in chips) 
Seat 9: I The King I ($133.92 in chips) 
pruxa72 will be allowed to play after the button
Rafaello18: posts small blind $0.50
sanpidk: posts big blind $1
*** HOLE CARDS ***
Dealt to matiko09 [Jc 8d]
mycka86: folds 
s26s: folds 
I The King I: folds 
matiko09: folds 
xxxZeka: folds 
lumen21: raises $1.25 to $2.25
Rafaello18: folds 
sanpidk: raises $5.75 to $8
lumen21: folds 
Uncalled bet ($5.75) returned to sanpidk
sanpidk collected $5 from pot
sanpidk: doesn't show hand 
*** SUMMARY ***
Total pot $5 | Rake $0 
Seat 1: matiko09 folded before Flop (didn't bet)
Seat 2: xxxZeka folded before Flop (didn't bet)
Seat 3: lumen21 (button) folded before Flop
Seat 5: Rafaello18 (small blind) folded before Flop
Seat 6: sanpidk (big blind) collected ($5)
Seat 7: mycka86 folded before Flop (didn't bet)
Seat 8: s26s folded before Flop (didn't bet)
Seat 9: I The King I folded before Flop (didn't bet)





PokerStars Hand #148219565381:  Hold'em No Limit ($0.50/$1.00 USD) - 2016/02/04 15:29:17 CET [2016/02/04 9:29:17 ET]
Table 'Laverna II' 9-max Seat #5 is the button
Seat 1: I The King I ($100 in chips) 
Seat 2: sanpidk ($100 in chips) 
Seat 3: tipner ($100 in chips) 
Seat 4: brille-390 ($100 in chips) 
Seat 5: Iozhek ($80 in chips) 
Seat 6: Mukhin1 ($100 in chips) 
Seat 7: Rafaello18 ($100 in chips) 
Seat 8: Dante63s ($100 in chips) 
Seat 9: matiko09 ($100 in chips) 
Mukhin1: posts small blind $0.50
Rafaello18: posts big blind $1
*** HOLE CARDS ***
Dealt to matiko09 [Qh Kd]
Dante63s: folds 
matiko09: raises $2 to $3
I The King I: folds 
sanpidk: folds 
tipner: folds 
brille-390: folds 
Iozhek: folds 
Mukhin1: folds 
Rafaello18: folds 
Uncalled bet ($2) returned to matiko09
matiko09 collected $2.50 from pot
matiko09: doesn't show hand 
*** SUMMARY ***
Total pot $2.50 | Rake $0 
Seat 1: I The King I folded before Flop (didn't bet)
Seat 2: sanpidk folded before Flop (didn't bet)
Seat 3: tipner folded before Flop (didn't bet)
Seat 4: brille-390 folded before Flop (didn't bet)
Seat 5: Iozhek (button) folded before Flop (didn't bet)
Seat 6: Mukhin1 (small blind) folded before Flop
Seat 7: Rafaello18 (big blind) folded before Flop
Seat 8: Dante63s folded before Flop (didn't bet)
Seat 9: matiko09 collected ($2.50)





PokerStars Hand #148219566632:  Hold'em No Limit ($0.50/$1.00 USD) - 2016/02/04 15:29:19 CET [2016/02/04 9:29:19 ET]
Table 'Arneb III' 9-max Seat #9 is the button
Seat 2: JeanLima93 ($157.38 in chips) 
Seat 3: matiko09 ($101.94 in chips) 
Seat 4: Igor DoUrden ($247.79 in chips) 
Seat 5: tipner ($156.92 in chips) 
Seat 6: nickreason17 ($111.11 in chips) 
Seat 7: xxxZeka ($102.50 in chips) 
Seat 8: volwebni4ek ($40 in chips) 
Seat 9: ARTVOR640 ($100 in chips) 
sanpidk will be allowed to play after the button
JeanLima93: posts small blind $0.50
matiko09: posts big blind $1
*** HOLE CARDS ***
Dealt to matiko09 [8c Qd]
Igor DoUrden: folds 
tipner: folds 
nickreason17: folds 
xxxZeka: folds 
volwebni4ek: folds 
ARTVOR640: folds 
JeanLima93: folds 
Uncalled bet ($0.50) returned to matiko09
matiko09 collected $1 from pot
matiko09: doesn't show hand 
*** SUMMARY ***
Total pot $1 | Rake $0 
Seat 2: JeanLima93 (small blind) folded before Flop
Seat 3: matiko09 (big blind) collected ($1)
Seat 4: Igor DoUrden folded before Flop (didn't bet)
Seat 5: tipner folded before Flop (didn't bet)
Seat 6: nickreason17 folded before Flop (didn't bet)
Seat 7: xxxZeka folded before Flop (didn't bet)
Seat 8: volwebni4ek folded before Flop (didn't bet)
Seat 9: ARTVOR640 (button) folded before Flop (didn't bet)





PokerStars Hand #148219568894:  Hold'em No Limit ($0.50/$1.00 USD) - 2016/02/04 15:29:22 CET [2016/02/04 9:29:22 ET]
Table 'Cepheus III' 9-max Seat #3 is the button
Seat 1: ozone2003 ($100 in chips) 
Seat 2: tipner ($100 in chips) 
Seat 3: pandalapa ($202.20 in chips) 
Seat 4: lukeylund ($75.06 in chips) 
Seat 5: ARTVOR640 ($144.50 in chips) 
Seat 6: matiko09 ($110.21 in chips) 
Seat 7: Igor DoUrden ($100 in chips) 
Seat 8: omorfadramou ($135.40 in chips) 
Seat 9: xxxZeka ($100 in chips) 
lukeylund: posts small blind $0.50
ARTVOR640: posts big blind $1
*** HOLE CARDS ***
Dealt to matiko09 [4c Kc]
matiko09: folds 
Igor DoUrden: raises $1.50 to $2.50
omorfadramou: folds 
xxxZeka: folds 
ozone2003: folds 
tipner: folds 
pandalapa: folds 
lukeylund: folds 
ARTVOR640: folds 
Uncalled bet ($1.50) returned to Igor DoUrden
Igor DoUrden collected $2.50 from pot
Igor DoUrden: doesn't show hand 
*** SUMMARY ***
Total pot $2.50 | Rake $0 
Seat 1: ozone2003 folded before Flop (didn't bet)
Seat 2: tipner folded before Flop (didn't bet)
Seat 3: pandalapa (button) folded before Flop (didn't bet)
Seat 4: lukeylund (small blind) folded before Flop
Seat 5: ARTVOR640 (big blind) folded before Flop
Seat 6: matiko09 folded before Flop (didn't bet)
Seat 7: Igor DoUrden collected ($2.50)
Seat 8: omorfadramou folded before Flop (didn't bet)
Seat 9: xxxZeka folded before Flop (didn't bet)





PokerStars Hand #148219576331:  Hold'em No Limit ($0.50/$1.00 USD) - 2016/02/04 15:29:33 CET [2016/02/04 9:29:33 ET]
Table 'Mothallah' 9-max Seat #4 is the button
Seat 1: Rafaello18 ($109.50 in chips) 
Seat 2: davianvalek ($115.55 in chips) 
Seat 3: ozone2003 ($105.68 in chips) 
Seat 4: YOUNG_G70 ($60.80 in chips) 
Seat 5: chaps1988 ($100 in chips) 
Seat 6: I The King I ($128.28 in chips) 
Seat 7: sanpidk ($101.57 in chips) 
Seat 8: Spid1 ($139.36 in chips) 
Seat 9: matiko09 ($100 in chips) 
chaps1988: posts small blind $0.50
I The King I: posts big blind $1
*** HOLE CARDS ***
Dealt to matiko09 [9c Kd]
sanpidk: folds 
Spid1: folds 
matiko09: folds 
Rafaello18: folds 
davianvalek: folds 
ozone2003: folds 
YOUNG_G70: folds 
chaps1988: raises $2 to $3
I The King I: folds 
Uncalled bet ($2) returned to chaps1988
chaps1988 collected $2 from pot
chaps1988: doesn't show hand 
*** SUMMARY ***
Total pot $2 | Rake $0 
Seat 1: Rafaello18 folded before Flop (didn't bet)
Seat 2: davianvalek folded before Flop (didn't bet)
Seat 3: ozone2003 folded before Flop (didn't bet)
Seat 4: YOUNG_G70 (button) folded before Flop (didn't bet)
Seat 5: chaps1988 (small blind) collected ($2)
Seat 6: I The King I (big blind) folded before Flop
Seat 7: sanpidk folded before Flop (didn't bet)
Seat 8: Spid1 folded before Flop (didn't bet)
Seat 9: matiko09 folded before Flop (didn't bet)





PokerStars Hand #148219586215:  Hold'em No Limit (€0.50/€1.00 EUR) - 2016/02/04 15:29:46 CET [2016/02/04 9:29:46 ET]
Table 'Ostenia' 9-max Seat #8 is the button
Seat 1: mycka86 (€100 in chips) 
Seat 2: Dante63s (€100 in chips) 
Seat 3: maxxmeister (€108.78 in chips) 
Seat 4: MagicKid777 (€124.51 in chips) 
Seat 5: matiko09 (€104.50 in chips) 
Seat 6: melitakas (€100 in chips) 
Seat 7: tipner (€119.40 in chips) 
Seat 8: Venomous100% (€108.65 in chips) 
Seat 9: sanpidk (€132.01 in chips) 
sanpidk: posts small blind €0.50
mycka86: posts big blind €1
*** HOLE CARDS ***
Dealt to matiko09 [8c Kc]
Dante63s: raises €2 to €3
maxxmeister: folds 
MagicKid777: folds 
matiko09: folds 
melitakas: folds 
tipner: folds 
Venomous100%: folds 
sanpidk: folds 
mycka86: folds 
Uncalled bet (€2) returned to Dante63s
Dante63s collected €2.50 from pot
Dante63s: doesn't show hand 
*** SUMMARY ***
Total pot €2.50 | Rake €0 
Seat 1: mycka86 (big blind) folded before Flop
Seat 2: Dante63s collected (€2.50)
Seat 3: maxxmeister folded before Flop (didn't bet)
Seat 4: MagicKid777 folded before Flop (didn't bet)
Seat 5: matiko09 folded before Flop (didn't bet)
Seat 6: melitakas folded before Flop (didn't bet)
Seat 7: tipner folded before Flop (didn't bet)
Seat 8: Venomous100% (button) folded before Flop (didn't bet)
Seat 9: sanpidk (small blind) folded before Flop





PokerStars Hand #148219588947:  Hold'em No Limit ($0.50/$1.00 USD) - 2016/02/04 15:29:50 CET [2016/02/04 9:29:50 ET]
Table 'Arneb III' 9-max Seat #2 is the button
Seat 2: JeanLima93 ($156.88 in chips) 
Seat 3: matiko09 ($102.44 in chips) 
Seat 4: Igor DoUrden ($247.79 in chips) 
Seat 5: tipner ($156.92 in chips) 
Seat 6: nickreason17 ($111.11 in chips) 
Seat 7: xxxZeka ($102.50 in chips) 
Seat 8: volwebni4ek ($40 in chips) 
Seat 9: ARTVOR640 ($100 in chips) 
matiko09: posts small blind $0.50
Igor DoUrden: posts big blind $1
sanpidk: sits out 
*** HOLE CARDS ***
Dealt to matiko09 [8d 3c]
tipner: raises $2 to $3
nickreason17: raises $6 to $9
xxxZeka: folds 
volwebni4ek: folds 
ARTVOR640: folds 
JeanLima93: calls $9
matiko09: folds 
Igor DoUrden: folds 
tipner: calls $6
*** FLOP *** [9c Js 9d]
tipner: checks 
nickreason17: checks 
JeanLima93: checks 
*** TURN *** [9c Js 9d] [7c]
tipner: bets $14
nickreason17: folds 
JeanLima93: calls $14
*** RIVER *** [9c Js 9d 7c] [9s]
tipner: checks 
JeanLima93: checks 
*** SHOW DOWN ***
tipner: shows [Tc Th] (a full house, Nines full of Tens)
JeanLima93: mucks hand 
tipner collected $53.96 from pot
*** SUMMARY ***
Total pot $56.50 | Rake $2.54 
Board [9c Js 9d 7c 9s]
Seat 2: JeanLima93 (button) mucked [6h 6s]
Seat 3: matiko09 (small blind) folded before Flop
Seat 4: Igor DoUrden (big blind) folded before Flop
Seat 5: tipner showed [Tc Th] and won ($53.96) with a full house, Nines full of Tens
Seat 6: nickreason17 folded on the Turn
Seat 7: xxxZeka folded before Flop (didn't bet)
Seat 8: volwebni4ek folded before Flop (didn't bet)
Seat 9: ARTVOR640 folded before Flop (didn't bet)





PokerStars Hand #148219590795:  Hold'em No Limit ($0.50/$1.00 USD) - 2016/02/04 15:29:53 CET [2016/02/04 9:29:53 ET]
Table 'Cepheus III' 9-max Seat #4 is the button
Seat 1: ozone2003 ($100 in chips) 
Seat 2: tipner ($100 in chips) 
Seat 3: pandalapa ($202.20 in chips) 
Seat 4: lukeylund ($74.56 in chips) 
Seat 5: ARTVOR640 ($143.50 in chips) 
Seat 6: matiko09 ($110.21 in chips) 
Seat 7: Igor DoUrden ($101.50 in chips) 
Seat 8: omorfadramou ($135.40 in chips) 
Seat 9: xxxZeka ($100 in chips) 
ARTVOR640: posts small blind $0.50
matiko09: posts big blind $1
*** HOLE CARDS ***
Dealt to matiko09 [Ks 4d]
Igor DoUrden: folds 
omorfadramou: folds 
xxxZeka: raises $2 to $3
ozone2003: folds 
tipner: folds 
pandalapa: folds 
lukeylund: folds 
ARTVOR640: folds 
matiko09: folds 
Uncalled bet ($2) returned to xxxZeka
xxxZeka collected $2.50 from pot
*** SUMMARY ***
Total pot $2.50 | Rake $0 
Seat 1: ozone2003 folded before Flop (didn't bet)
Seat 2: tipner folded before Flop (didn't bet)
Seat 3: pandalapa folded before Flop (didn't bet)
Seat 4: lukeylund (button) folded before Flop (didn't bet)
Seat 5: ARTVOR640 (small blind) folded before Flop
Seat 6: matiko09 (big blind) folded before Flop
Seat 7: Igor DoUrden folded before Flop (didn't bet)
Seat 8: omorfadramou folded before Flop (didn't bet)
Seat 9: xxxZeka collected ($2.50)





PokerStars Hand #148219591280:  Hold'em No Limit ($0.50/$1.00 USD) - 2016/02/04 15:29:54 CET [2016/02/04 9:29:54 ET]
Table 'Avior II' 9-max Seat #4 is the button
Seat 2: matiko09 ($103 in chips) 
Seat 3: sanpidk ($131.70 in chips) 
Seat 4: xxxZeka ($100 in chips) 
Seat 5: chaps1988 ($104.85 in chips) 
Seat 6: tipner ($187.19 in chips) 
Seat 7: nickreason17 ($103 in chips) 
Seat 8: EdHunder ($53.42 in chips) 
chaps1988: posts small blind $0.50
tipner: posts big blind $1
I The King I: sits out 
*** HOLE CARDS ***
Dealt to matiko09 [3h 8s]
nickreason17: raises $2 to $3
EdHunder: folds 
matiko09: folds 
sanpidk: folds 
xxxZeka: folds 
chaps1988: folds 
tipner: folds 
Uncalled bet ($2) returned to nickreason17
nickreason17 collected $2.50 from pot
*** SUMMARY ***
Total pot $2.50 | Rake $0 
Seat 2: matiko09 folded before Flop (didn't bet)
Seat 3: sanpidk folded before Flop (didn't bet)
Seat 4: xxxZeka (button) folded before Flop (didn't bet)
Seat 5: chaps1988 (small blind) folded before Flop
Seat 6: tipner (big blind) folded before Flop
Seat 7: nickreason17 collected ($2.50)
Seat 8: EdHunder folded before Flop (didn't bet)





PokerStars Hand #148219593388:  Hold'em No Limit ($0.50/$1.00 USD) - 2016/02/04 15:29:57 CET [2016/02/04 9:29:57 ET]
Table 'Mothallah' 9-max Seat #5 is the button
Seat 1: Rafaello18 ($109.50 in chips) 
Seat 2: davianvalek ($115.55 in chips) 
Seat 3: ozone2003 ($105.68 in chips) 
Seat 4: YOUNG_G70 ($60.80 in chips) 
Seat 5: chaps1988 ($101 in chips) 
Seat 6: I The King I ($127.28 in chips) 
Seat 7: sanpidk ($101.57 in chips) 
Seat 8: Spid1 ($139.36 in chips) 
Seat 9: matiko09 ($100 in chips) 
I The King I: posts small blind $0.50
sanpidk: posts big blind $1
*** HOLE CARDS ***
Dealt to matiko09 [Ks Kc]
Spid1: folds 
matiko09: raises $2 to $3
Rafaello18: folds 
davianvalek: folds 
ozone2003: folds 
YOUNG_G70: folds 
chaps1988: folds 
I The King I: folds 
sanpidk: folds 
Uncalled bet ($2) returned to matiko09
matiko09 collected $2.50 from pot
matiko09: doesn't show hand 
*** SUMMARY ***
Total pot $2.50 | Rake $0 
Seat 1: Rafaello18 folded before Flop (didn't bet)
Seat 2: davianvalek folded before Flop (didn't bet)
Seat 3: ozone2003 folded before Flop (didn't bet)
Seat 4: YOUNG_G70 folded before Flop (didn't bet)
Seat 5: chaps1988 (button) folded before Flop (didn't bet)
Seat 6: I The King I (small blind) folded before Flop
Seat 7: sanpidk (big blind) folded before Flop
Seat 8: Spid1 folded before Flop (didn't bet)
Seat 9: matiko09 collected ($2.50)





PokerStars Hand #148219596700:  Hold'em No Limit ($0.50/$1.00 USD) - 2016/02/04 15:30:01 CET [2016/02/04 9:30:01 ET]
Table 'Dejan' 9-max Seat #5 is the button
Seat 1: matiko09 ($101 in chips) 
Seat 2: xxxZeka ($107.75 in chips) 
Seat 3: lumen21 ($100 in chips) 
Seat 4: pruxa72 ($100 in chips) 
Seat 5: Rafaello18 ($137.84 in chips) 
Seat 6: sanpidk ($243.42 in chips) 
Seat 7: mycka86 ($122.63 in chips) 
Seat 8: s26s ($100 in chips) 
Seat 9: I The King I ($133.92 in chips) 
sanpidk: posts small blind $0.50
mycka86: posts big blind $1
pruxa72: posts big blind $1
*** HOLE CARDS ***
Dealt to matiko09 [5d 9s]
s26s: calls $1
I The King I: folds 
matiko09: folds 
xxxZeka: folds 
lumen21: folds 
pruxa72: checks 
Rafaello18: folds 
sanpidk: raises $4 to $5
mycka86: folds 
s26s: calls $4
pruxa72: folds 
*** FLOP *** [As 4c Jh]
sanpidk: checks 
s26s: checks 
*** TURN *** [As 4c Jh] [8s]
sanpidk: bets $7
s26s: folds 
Uncalled bet ($7) returned to sanpidk
sanpidk collected $11.46 from pot
sanpidk: doesn't show hand 
*** SUMMARY ***
Total pot $12 | Rake $0.54 
Board [As 4c Jh 8s]
Seat 1: matiko09 folded before Flop (didn't bet)
Seat 2: xxxZeka folded before Flop (didn't bet)
Seat 3: lumen21 folded before Flop (didn't bet)
Seat 4: pruxa72 folded before Flop
Seat 5: Rafaello18 (button) folded before Flop (didn't bet)
Seat 6: sanpidk (small blind) collected ($11.46)
Seat 7: mycka86 (big blind) folded before Flop
Seat 8: s26s folded on the Turn
Seat 9: I The King I folded before Flop (didn't bet)





PokerStars Hand #148219598978:  Hold'em No Limit ($0.50/$1.00 USD) - 2016/02/04 15:30:04 CET [2016/02/04 9:30:04 ET]
Table 'Arneb II' 9-max Seat #4 is the button
Seat 1: matiko09 ($101.50 in chips) 
Seat 2: sanpidk ($218.46 in chips) 
Seat 3: brille-390 ($146.52 in chips) 
Seat 4: Venomous100% ($100 in chips) 
Seat 5: lixiangli ($75.37 in chips) 
Seat 6: volwebni4ek ($82.95 in chips) 
Seat 7: melitakas ($265.67 in chips) 
Seat 8: tedbadger9 ($56.51 in chips) 
Seat 9: tipner ($111.67 in chips) 
lixiangli: posts small blind $0.50
volwebni4ek: posts big blind $1
*** HOLE CARDS ***
Dealt to matiko09 [2h 5d]
melitakas: folds 
tedbadger9: folds 
tipner: folds 
matiko09: folds 
sanpidk: folds 
brille-390: raises $1.25 to $2.25
Venomous100%: folds 
lixiangli: folds 
volwebni4ek: folds 
Uncalled bet ($1.25) returned to brille-390
brille-390 collected $2.50 from pot
brille-390: doesn't show hand 
*** SUMMARY ***
Total pot $2.50 | Rake $0 
Seat 1: matiko09 folded before Flop (didn't bet)
Seat 2: sanpidk folded before Flop (didn't bet)
Seat 3: brille-390 collected ($2.50)
Seat 4: Venomous100% (button) folded before Flop (didn't bet)
Seat 5: lixiangli (small blind) folded before Flop
Seat 6: volwebni4ek (big blind) folded before Flop
Seat 7: melitakas folded before Flop (didn't bet)
Seat 8: tedbadger9 folded before Flop (didn't bet)
Seat 9: tipner folded before Flop (didn't bet)





PokerStars Hand #148219611377:  Hold'em No Limit (€0.50/€1.00 EUR) - 2016/02/04 15:30:21 CET [2016/02/04 9:30:21 ET]
Table 'Ostenia' 9-max Seat #9 is the button
Seat 1: mycka86 (€100 in chips) 
Seat 2: Dante63s (€101.50 in chips) 
Seat 3: maxxmeister (€108.78 in chips) 
Seat 4: MagicKid777 (€124.51 in chips) 
Seat 5: matiko09 (€104.50 in chips) 
Seat 6: melitakas (€100 in chips) 
Seat 7: tipner (€119.40 in chips) 
Seat 8: Venomous100% (€108.65 in chips) 
Seat 9: sanpidk (€131.51 in chips) 
mycka86: posts small blind €0.50
Dante63s: posts big blind €1
*** HOLE CARDS ***
Dealt to matiko09 [8d Kh]
maxxmeister: folds 
MagicKid777: folds 
matiko09: folds 
melitakas: raises €1 to €2
tipner: folds 
Venomous100%: calls €2
sanpidk: folds 
mycka86: folds 
Dante63s: calls €1
*** FLOP *** [Ah Qc 6s]
Dante63s: checks 
melitakas: bets €3.10
Venomous100%: folds 
Dante63s: folds 
Uncalled bet (€3.10) returned to melitakas
melitakas collected €6.21 from pot
*** SUMMARY ***
Total pot €6.50 | Rake €0.29 
Board [Ah Qc 6s]
Seat 1: mycka86 (small blind) folded before Flop
Seat 2: Dante63s (big blind) folded on the Flop
Seat 3: maxxmeister folded before Flop (didn't bet)
Seat 4: MagicKid777 folded before Flop (didn't bet)
Seat 5: matiko09 folded before Flop (didn't bet)
Seat 6: melitakas collected (€6.21)
Seat 7: tipner folded before Flop (didn't bet)
Seat 8: Venomous100% folded on the Flop
Seat 9: sanpidk (button) folded before Flop (didn't bet)





PokerStars Hand #148219613404:  Hold'em No Limit ($0.50/$1.00 USD) - 2016/02/04 15:30:24 CET [2016/02/04 9:30:24 ET]
Table 'Cepheus III' 9-max Seat #5 is the button
Seat 1: ozone2003 ($100 in chips) 
Seat 2: tipner ($100 in chips) 
Seat 3: pandalapa ($202.20 in chips) 
Seat 4: lukeylund ($74.56 in chips) 
Seat 5: ARTVOR640 ($143 in chips) 
Seat 6: matiko09 ($109.21 in chips) 
Seat 7: Igor DoUrden ($101.50 in chips) 
Seat 8: omorfadramou ($135.40 in chips) 
Seat 9: xxxZeka ($101.50 in chips) 
matiko09: posts small blind $0.50
Igor DoUrden: posts big blind $1
*** HOLE CARDS ***
Dealt to matiko09 [4s 5s]
omorfadramou: folds 
xxxZeka: folds 
ozone2003: folds 
tipner: folds 
pandalapa: folds 
lukeylund: folds 
ARTVOR640: folds 
matiko09: folds 
Uncalled bet ($0.50) returned to Igor DoUrden
Igor DoUrden collected $1 from pot
Igor DoUrden: doesn't show hand 
*** SUMMARY ***
Total pot $1 | Rake $0 
Seat 1: ozone2003 folded before Flop (didn't bet)
Seat 2: tipner folded before Flop (didn't bet)
Seat 3: pandalapa folded before Flop (didn't bet)
Seat 4: lukeylund folded before Flop (didn't bet)
Seat 5: ARTVOR640 (button) folded before Flop (didn't bet)
Seat 6: matiko09 (small blind) folded before Flop
Seat 7: Igor DoUrden (big blind) collected ($1)
Seat 8: omorfadramou folded before Flop (didn't bet)
Seat 9: xxxZeka folded before Flop (didn't bet)





PokerStars Hand #148219615317:  Hold'em No Limit ($0.50/$1.00 USD) - 2016/02/04 15:30:27 CET [2016/02/04 9:30:27 ET]
Table 'Mothallah' 9-max Seat #6 is the button
Seat 1: Rafaello18 ($109.50 in chips) 
Seat 2: davianvalek ($115.55 in chips) 
Seat 3: ozone2003 ($105.68 in chips) 
Seat 4: YOUNG_G70 ($60.80 in chips) 
Seat 5: chaps1988 ($101 in chips) 
Seat 6: I The King I ($126.78 in chips) 
Seat 7: sanpidk ($100.57 in chips) 
Seat 8: Spid1 ($139.36 in chips) 
Seat 9: matiko09 ($101.50 in chips) 
sanpidk: posts small blind $0.50
Spid1: posts big blind $1
*** HOLE CARDS ***
Dealt to matiko09 [8h 6s]
matiko09: folds 
Rafaello18: folds 
davianvalek: folds 
ozone2003: raises $2 to $3
YOUNG_G70: folds 
chaps1988: folds 
I The King I: folds 
sanpidk: folds 
Spid1: folds 
Uncalled bet ($2) returned to ozone2003
ozone2003 collected $2.50 from pot
ozone2003: doesn't show hand 
*** SUMMARY ***
Total pot $2.50 | Rake $0 
Seat 1: Rafaello18 folded before Flop (didn't bet)
Seat 2: davianvalek folded before Flop (didn't bet)
Seat 3: ozone2003 collected ($2.50)
Seat 4: YOUNG_G70 folded before Flop (didn't bet)
Seat 5: chaps1988 folded before Flop (didn't bet)
Seat 6: I The King I (button) folded before Flop (didn't bet)
Seat 7: sanpidk (small blind) folded before Flop
Seat 8: Spid1 (big blind) folded before Flop
Seat 9: matiko09 folded before Flop (didn't bet)





PokerStars Hand #148219616482:  Hold'em No Limit ($0.50/$1.00 USD) - 2016/02/04 15:30:28 CET [2016/02/04 9:30:28 ET]
Table 'Avior II' 9-max Seat #5 is the button
Seat 2: matiko09 ($103 in chips) 
Seat 3: sanpidk ($131.70 in chips) 
Seat 4: xxxZeka ($100 in chips) 
Seat 5: chaps1988 ($104.35 in chips) 
Seat 6: tipner ($186.19 in chips) 
Seat 8: EdHunder ($53.42 in chips) 
tipner: posts small blind $0.50
nickreason17: is sitting out 
EdHunder: posts big blind $1
I The King I: sits out 
*** HOLE CARDS ***
Dealt to matiko09 [Ks Kd]
nickreason17 leaves the table
matiko09: raises $2 to $3
sanpidk: folds 
xxxZeka: folds 
chaps1988: calls $3
tipner: folds 
EdHunder: folds 
*** FLOP *** [Qd Qc Ac]
matiko09: checks 
chaps1988: checks 
*** TURN *** [Qd Qc Ac] [7c]
matiko09: checks 
chaps1988: checks 
*** RIVER *** [Qd Qc Ac 7c] [6s]
Düss2411 joins the table at seat #7 
matiko09: checks 
chaps1988: checks 
*** SHOW DOWN ***
matiko09: shows [Ks Kd] (two pair, Kings and Queens)
chaps1988: mucks hand 
Düss2411 leaves the table
matiko09 collected $7.16 from pot
*** SUMMARY ***
Total pot $7.50 | Rake $0.34 
Board [Qd Qc Ac 7c 6s]
Seat 2: matiko09 showed [Ks Kd] and won ($7.16) with two pair, Kings and Queens
Seat 3: sanpidk folded before Flop (didn't bet)
Seat 4: xxxZeka folded before Flop (didn't bet)
Seat 5: chaps1988 (button) mucked [9h 9d]
Seat 6: tipner (small blind) folded before Flop
Seat 8: EdHunder (big blind) folded before Flop





PokerStars Hand #148219626945:  Hold'em No Limit ($0.50/$1.00 USD) - 2016/02/04 15:30:43 CET [2016/02/04 9:30:43 ET]
Table 'Cepheus III' 9-max Seat #6 is the button
Seat 1: ozone2003 ($100 in chips) 
Seat 2: tipner ($100 in chips) 
Seat 3: pandalapa ($202.20 in chips) 
Seat 4: lukeylund ($74.56 in chips) 
Seat 5: ARTVOR640 ($143 in chips) 
Seat 6: matiko09 ($108.71 in chips) 
Seat 7: Igor DoUrden ($102 in chips) 
Seat 8: omorfadramou ($135.40 in chips) 
Seat 9: xxxZeka ($101.50 in chips) 
Igor DoUrden: posts small blind $0.50
omorfadramou: posts big blind $1
*** HOLE CARDS ***
Dealt to matiko09 [Js 4s]
xxxZeka: folds 
ozone2003: folds 
tipner: folds 
pandalapa: folds 
lukeylund: folds 
ARTVOR640: raises $1.50 to $2.50
matiko09: folds 
Igor DoUrden: folds 
omorfadramou: folds 
Uncalled bet ($1.50) returned to ARTVOR640
ARTVOR640 collected $2.50 from pot
ARTVOR640: doesn't show hand 
*** SUMMARY ***
Total pot $2.50 | Rake $0 
Seat 1: ozone2003 folded before Flop (didn't bet)
Seat 2: tipner folded before Flop (didn't bet)
Seat 3: pandalapa folded before Flop (didn't bet)
Seat 4: lukeylund folded before Flop (didn't bet)
Seat 5: ARTVOR640 collected ($2.50)
Seat 6: matiko09 (button) folded before Flop (didn't bet)
Seat 7: Igor DoUrden (small blind) folded before Flop
Seat 8: omorfadramou (big blind) folded before Flop
Seat 9: xxxZeka folded before Flop (didn't bet)





PokerStars Hand #148219630525:  Hold'em No Limit ($0.50/$1.00 USD) - 2016/02/04 15:30:48 CET [2016/02/04 9:30:48 ET]
Table 'Laverna II' 9-max Seat #6 is the button
Seat 1: I The King I ($100 in chips) 
Seat 2: sanpidk ($100 in chips) 
Seat 3: tipner ($100 in chips) 
Seat 4: brille-390 ($100 in chips) 
Seat 5: Iozhek ($80 in chips) 
Seat 6: Mukhin1 ($100 in chips) 
Seat 7: Rafaello18 ($100 in chips) 
Seat 8: Dante63s ($100 in chips) 
Seat 9: matiko09 ($101.50 in chips) 
Rafaello18: posts small blind $0.50
Dante63s: posts big blind $1
*** HOLE CARDS ***
Dealt to matiko09 [3h Qd]
matiko09: folds 
I The King I: folds 
sanpidk: folds 
tipner: folds 
brille-390: folds 
Iozhek: folds 
Mukhin1: folds 
Rafaello18: folds 
Uncalled bet ($0.50) returned to Dante63s
Dante63s collected $1 from pot
Dante63s: doesn't show hand 
*** SUMMARY ***
Total pot $1 | Rake $0 
Seat 1: I The King I folded before Flop (didn't bet)
Seat 2: sanpidk folded before Flop (didn't bet)
Seat 3: tipner folded before Flop (didn't bet)
Seat 4: brille-390 folded before Flop (didn't bet)
Seat 5: Iozhek folded before Flop (didn't bet)
Seat 6: Mukhin1 (button) folded before Flop (didn't bet)
Seat 7: Rafaello18 (small blind) folded before Flop
Seat 8: Dante63s (big blind) collected ($1)
Seat 9: matiko09 folded before Flop (didn't bet)





PokerStars Hand #148219632072:  Hold'em No Limit ($0.50/$1.00 USD) - 2016/02/04 15:30:50 CET [2016/02/04 9:30:50 ET]
Table 'Arneb II' 9-max Seat #5 is the button
Seat 1: matiko09 ($101.50 in chips) 
Seat 2: sanpidk ($218.46 in chips) 
Seat 3: brille-390 ($148.02 in chips) 
Seat 4: Venomous100% ($100 in chips) 
Seat 5: lixiangli ($74.87 in chips) 
Seat 6: volwebni4ek ($81.95 in chips) 
Seat 7: melitakas ($265.67 in chips) 
Seat 8: tedbadger9 ($56.51 in chips) 
Seat 9: tipner ($111.67 in chips) 
volwebni4ek: posts small blind $0.50
melitakas: posts big blind $1
*** HOLE CARDS ***
Dealt to matiko09 [5s 3s]
tedbadger9: folds 
tipner: folds 
matiko09: folds 
sanpidk: folds 
brille-390: folds 
Venomous100%: folds 
lixiangli: folds 
volwebni4ek: raises $1.50 to $2.50
melitakas: folds 
Uncalled bet ($1.50) returned to volwebni4ek
volwebni4ek collected $2 from pot
volwebni4ek: doesn't show hand 
*** SUMMARY ***
Total pot $2 | Rake $0 
Seat 1: matiko09 folded before Flop (didn't bet)
Seat 2: sanpidk folded before Flop (didn't bet)
Seat 3: brille-390 folded before Flop (didn't bet)
Seat 4: Venomous100% folded before Flop (didn't bet)
Seat 5: lixiangli (button) folded before Flop (didn't bet)
Seat 6: volwebni4ek (small blind) collected ($2)
Seat 7: melitakas (big blind) folded before Flop
Seat 8: tedbadger9 folded before Flop (didn't bet)
Seat 9: tipner folded before Flop (didn't bet)





PokerStars Hand #148219641219:  Hold'em No Limit ($0.50/$1.00 USD) - 2016/02/04 15:31:02 CET [2016/02/04 9:31:02 ET]
Table 'Mothallah' 9-max Seat #7 is the button
Seat 1: Rafaello18 ($109.50 in chips) 
Seat 2: davianvalek ($115.55 in chips) 
Seat 3: ozone2003 ($107.18 in chips) 
Seat 4: YOUNG_G70 ($60.80 in chips) 
Seat 5: chaps1988 ($101 in chips) 
Seat 6: I The King I ($126.78 in chips) 
Seat 7: sanpidk ($100.07 in chips) 
Seat 8: Spid1 ($138.36 in chips) 
Seat 9: matiko09 ($101.50 in chips) 
Spid1: posts small blind $0.50
matiko09: posts big blind $1
*** HOLE CARDS ***
Dealt to matiko09 [Th 8d]
Rafaello18: raises $1.50 to $2.50
davianvalek: folds 
ozone2003: folds 
YOUNG_G70: folds 
chaps1988: folds 
I The King I: folds 
sanpidk: calls $2.50
Spid1: folds 
matiko09: folds 
*** FLOP *** [Qh 6c 5h]
Rafaello18: bets $4
sanpidk: raises $8.50 to $12.50
Rafaello18: folds 
Uncalled bet ($8.50) returned to sanpidk
sanpidk collected $13.85 from pot
sanpidk: doesn't show hand 
*** SUMMARY ***
Total pot $14.50 | Rake $0.65 
Board [Qh 6c 5h]
Seat 1: Rafaello18 folded on the Flop
Seat 2: davianvalek folded before Flop (didn't bet)
Seat 3: ozone2003 folded before Flop (didn't bet)
Seat 4: YOUNG_G70 folded before Flop (didn't bet)
Seat 5: chaps1988 folded before Flop (didn't bet)
Seat 6: I The King I folded before Flop (didn't bet)
Seat 7: sanpidk (button) collected ($13.85)
Seat 8: Spid1 (small blind) folded before Flop
Seat 9: matiko09 (big blind) folded before Flop





PokerStars Hand #148219641196:  Hold'em No Limit ($0.50/$1.00 USD) - 2016/02/04 15:31:02 CET [2016/02/04 9:31:02 ET]
Table 'Dejan' 9-max Seat #6 is the button
Seat 1: matiko09 ($101 in chips) 
Seat 2: xxxZeka ($107.75 in chips) 
Seat 3: lumen21 ($100 in chips) 
Seat 4: pruxa72 ($99 in chips) 
Seat 5: Rafaello18 ($137.84 in chips) 
Seat 6: sanpidk ($249.88 in chips) 
Seat 7: mycka86 ($121.63 in chips) 
Seat 8: s26s ($95 in chips) 
Seat 9: I The King I ($133.92 in chips) 
mycka86: posts small blind $0.50
s26s: posts big blind $1
*** HOLE CARDS ***
Dealt to matiko09 [3s 4s]
I The King I: folds 
matiko09: folds 
xxxZeka: raises $2 to $3
lumen21: raises $6 to $9
pruxa72: folds 
Rafaello18: folds 
sanpidk: folds 
mycka86: folds 
s26s: folds 
xxxZeka: folds 
Uncalled bet ($6) returned to lumen21
lumen21 collected $7.50 from pot
lumen21: doesn't show hand 
*** SUMMARY ***
Total pot $7.50 | Rake $0 
Seat 1: matiko09 folded before Flop (didn't bet)
Seat 2: xxxZeka folded before Flop
Seat 3: lumen21 collected ($7.50)
Seat 4: pruxa72 folded before Flop (didn't bet)
Seat 5: Rafaello18 folded before Flop (didn't bet)
Seat 6: sanpidk (button) folded before Flop (didn't bet)
Seat 7: mycka86 (small blind) folded before Flop
Seat 8: s26s (big blind) folded before Flop
Seat 9: I The King I folded before Flop (didn't bet)





PokerStars Hand #148219645773:  Hold'em No Limit ($0.50/$1.00 USD) - 2016/02/04 15:31:09 CET [2016/02/04 9:31:09 ET]
Table 'Cepheus III' 9-max Seat #7 is the button
Seat 1: ozone2003 ($100 in chips) 
Seat 2: tipner ($100 in chips) 
Seat 3: pandalapa ($202.20 in chips) 
Seat 4: lukeylund ($74.56 in chips) 
Seat 5: ARTVOR640 ($144.50 in chips) 
Seat 6: matiko09 ($108.71 in chips) 
Seat 7: Igor DoUrden ($101.50 in chips) 
Seat 8: omorfadramou ($134.40 in chips) 
Seat 9: xxxZeka ($101.50 in chips) 
omorfadramou: posts small blind $0.50
xxxZeka: posts big blind $1
*** HOLE CARDS ***
Dealt to matiko09 [Jd 6c]
ozone2003: folds 
tipner: raises $2 to $3
pandalapa: folds 
lukeylund: folds 
ARTVOR640: folds 
matiko09: folds 
Igor DoUrden: folds 
omorfadramou: folds 
xxxZeka: folds 
Uncalled bet ($2) returned to tipner
tipner collected $2.50 from pot
tipner: doesn't show hand 
*** SUMMARY ***
Total pot $2.50 | Rake $0 
Seat 1: ozone2003 folded before Flop (didn't bet)
Seat 2: tipner collected ($2.50)
Seat 3: pandalapa folded before Flop (didn't bet)
Seat 4: lukeylund folded before Flop (didn't bet)
Seat 5: ARTVOR640 folded before Flop (didn't bet)
Seat 6: matiko09 folded before Flop (didn't bet)
Seat 7: Igor DoUrden (button) folded before Flop (didn't bet)
Seat 8: omorfadramou (small blind) folded before Flop
Seat 9: xxxZeka (big blind) folded before Flop





PokerStars Hand #148219658108:  Hold'em No Limit ($0.50/$1.00 USD) - 2016/02/04 15:31:26 CET [2016/02/04 9:31:26 ET]
Table 'Laverna II' 9-max Seat #7 is the button
Seat 1: I The King I ($100 in chips) 
Seat 2: sanpidk ($100 in chips) 
Seat 3: tipner ($100 in chips) 
Seat 4: brille-390 ($100 in chips) 
Seat 5: Iozhek ($80 in chips) 
Seat 6: Mukhin1 ($100 in chips) 
Seat 7: Rafaello18 ($100 in chips) 
Seat 8: Dante63s ($100.50 in chips) 
Seat 9: matiko09 ($101.50 in chips) 
Dante63s: posts small blind $0.50
matiko09: posts big blind $1
*** HOLE CARDS ***
Dealt to matiko09 [7d Td]
I The King I: folds 
I The King I leaves the table
sanpidk: folds 
KLOP06031987 joins the table at seat #1 
tipner: folds 
KLOP06031987 leaves the table
brille-390: raises $1.25 to $2.25
Iozhek: folds 
Mukhin1: calls $2.25
Rafaello18: folds 
Dante63s: folds 
matiko09: folds 
*** FLOP *** [8c 8d 5h]
brille-390: checks 
Mukhin1: bets $2.52
brille-390: folds 
Uncalled bet ($2.52) returned to Mukhin1
Mukhin1 collected $5.73 from pot
Mukhin1: doesn't show hand 
*** SUMMARY ***
Total pot $6 | Rake $0.27 
Board [8c 8d 5h]
Seat 1: I The King I folded before Flop (didn't bet)
Seat 2: sanpidk folded before Flop (didn't bet)
Seat 3: tipner folded before Flop (didn't bet)
Seat 4: brille-390 folded on the Flop
Seat 5: Iozhek folded before Flop (didn't bet)
Seat 6: Mukhin1 collected ($5.73)
Seat 7: Rafaello18 (button) folded before Flop (didn't bet)
Seat 8: Dante63s (small blind) folded before Flop
Seat 9: matiko09 (big blind) folded before Flop





PokerStars Hand #148219664483:  Hold'em No Limit ($0.50/$1.00 USD) - 2016/02/04 15:31:34 CET [2016/02/04 9:31:34 ET]
Table 'Avior II' 9-max Seat #6 is the button
Seat 1: I The King I ($111.06 in chips) 
Seat 2: matiko09 ($107.16 in chips) 
Seat 3: sanpidk ($131.70 in chips) 
Seat 4: xxxZeka ($100 in chips) 
Seat 5: chaps1988 ($101.35 in chips) 
Seat 6: tipner ($185.69 in chips) 
Seat 8: EdHunder ($52.42 in chips) 
EdHunder: posts small blind $0.50
I The King I: posts big blind $1
*** HOLE CARDS ***
Dealt to matiko09 [Qc Qd]
matiko09: raises $2 to $3
sanpidk: folds 
xxxZeka: folds 
chaps1988: raises $8 to $11
Monsthand joins the table at seat #7 
tipner: calls $11
EdHunder: folds 
I The King I: folds 
matiko09: calls $8
*** FLOP *** [6s Tc 9d]
matiko09: checks 
chaps1988: checks 
tipner: bets $13
matiko09: calls $13
chaps1988: folds 
*** TURN *** [6s Tc 9d] [4c]
matiko09: checks 
tipner: checks 
*** RIVER *** [6s Tc 9d 4c] [8c]
matiko09: checks 
tipner: bets $161.69 and is all-in
matiko09: folds 
Uncalled bet ($161.69) returned to tipner
tipner collected $57.78 from pot
tipner: doesn't show hand 
*** SUMMARY ***
Total pot $60.50 | Rake $2.72 
Board [6s Tc 9d 4c 8c]
Seat 1: I The King I (big blind) folded before Flop
Seat 2: matiko09 folded on the River
Seat 3: sanpidk folded before Flop (didn't bet)
Seat 4: xxxZeka folded before Flop (didn't bet)
Seat 5: chaps1988 folded on the Flop
Seat 6: tipner (button) collected ($57.78)
Seat 8: EdHunder (small blind) folded before Flop





PokerStars Hand #148219671235:  Hold'em No Limit ($0.50/$1.00 USD) - 2016/02/04 15:31:44 CET [2016/02/04 9:31:44 ET]
Table 'Arneb III' 9-max Seat #3 is the button
Seat 2: JeanLima93 ($133.88 in chips) 
Seat 3: matiko09 ($101.94 in chips) 
Seat 4: Igor DoUrden ($246.79 in chips) 
Seat 5: tipner ($187.88 in chips) 
Seat 6: nickreason17 ($102.11 in chips) 
Seat 7: xxxZeka ($102.50 in chips) 
Seat 8: volwebni4ek ($40 in chips) 
Seat 9: ARTVOR640 ($100 in chips) 
Igor DoUrden: posts small blind $0.50
tipner: posts big blind $1
sanpidk: sits out 
*** HOLE CARDS ***
Dealt to matiko09 [Kd 5s]
nickreason17: folds 
xxxZeka: folds 
volwebni4ek: folds 
ARTVOR640: folds 
JeanLima93: calls $1
matiko09: folds 
Igor DoUrden: folds 
tipner: raises $3 to $4
JeanLima93: calls $3
*** FLOP *** [6h Qc 4s]
tipner: bets $5
JeanLima93: calls $5
*** TURN *** [6h Qc 4s] [6s]
tipner: checks 
JeanLima93: bets $8.83
tipner: calls $8.83
*** RIVER *** [6h Qc 4s 6s] [7d]
tipner: checks 
JeanLima93: bets $34.53
tipner: calls $34.53
*** SHOW DOWN ***
JeanLima93: shows [6c 8h] (three of a kind, Sixes)
tipner: mucks hand 
JeanLima93 collected $102.42 from pot
*** SUMMARY ***
Total pot $105.22 | Rake $2.80 
Board [6h Qc 4s 6s 7d]
Seat 2: JeanLima93 showed [6c 8h] and won ($102.42) with three of a kind, Sixes
Seat 3: matiko09 (button) folded before Flop (didn't bet)
Seat 4: Igor DoUrden (small blind) folded before Flop
Seat 5: tipner (big blind) mucked [Td Qd]
Seat 6: nickreason17 folded before Flop (didn't bet)
Seat 7: xxxZeka folded before Flop (didn't bet)
Seat 8: volwebni4ek folded before Flop (didn't bet)
Seat 9: ARTVOR640 folded before Flop (didn't bet)





PokerStars Hand #148219674171:  Hold'em No Limit ($0.50/$1.00 USD) - 2016/02/04 15:31:48 CET [2016/02/04 9:31:48 ET]
Table 'Mothallah' 9-max Seat #8 is the button
Seat 2: davianvalek ($115.55 in chips) 
Seat 3: ozone2003 ($107.18 in chips) 
Seat 4: YOUNG_G70 ($60.80 in chips) 
Seat 5: chaps1988 ($101 in chips) 
Seat 6: I The King I ($126.78 in chips) 
Seat 7: sanpidk ($107.42 in chips) 
Seat 8: Spid1 ($137.86 in chips) 
Seat 9: matiko09 ($100.50 in chips) 
matiko09: posts small blind $0.50
Rafaello18: is sitting out 
davianvalek: posts big blind $1
*** HOLE CARDS ***
Dealt to matiko09 [Jh 2d]
ozone2003: folds 
YOUNG_G70: folds 
chaps1988: folds 
I The King I: folds 
sanpidk: folds 
Spid1: folds 
matiko09: folds 
Uncalled bet ($0.50) returned to davianvalek
davianvalek collected $1 from pot
*** SUMMARY ***
Total pot $1 | Rake $0 
Seat 2: davianvalek (big blind) collected ($1)
Seat 3: ozone2003 folded before Flop (didn't bet)
Seat 4: YOUNG_G70 folded before Flop (didn't bet)
Seat 5: chaps1988 folded before Flop (didn't bet)
Seat 6: I The King I folded before Flop (didn't bet)
Seat 7: sanpidk folded before Flop (didn't bet)
Seat 8: Spid1 (button) folded before Flop (didn't bet)
Seat 9: matiko09 (small blind) folded before Flop





PokerStars Hand #148219675289:  Hold'em No Limit ($0.50/$1.00 USD) - 2016/02/04 15:31:49 CET [2016/02/04 9:31:49 ET]
Table 'Arneb II' 9-max Seat #6 is the button
Seat 1: matiko09 ($101.50 in chips) 
Seat 2: sanpidk ($218.46 in chips) 
Seat 3: brille-390 ($148.02 in chips) 
Seat 4: Venomous100% ($100 in chips) 
Seat 5: lixiangli ($74.87 in chips) 
Seat 6: volwebni4ek ($82.95 in chips) 
Seat 7: melitakas ($264.67 in chips) 
Seat 8: tedbadger9 ($56.51 in chips) 
Seat 9: tipner ($111.67 in chips) 
melitakas: posts small blind $0.50
tedbadger9: posts big blind $1
*** HOLE CARDS ***
Dealt to matiko09 [Ah As]
tipner: folds 
matiko09: raises $2 to $3
sanpidk: folds 
brille-390: folds 
Venomous100%: folds 
lixiangli: folds 
volwebni4ek: folds 
melitakas: folds 
tedbadger9: calls $2
*** FLOP *** [Qh 2s 8h]
tedbadger9: checks 
matiko09: bets $4.04
tedbadger9: calls $4.04
*** TURN *** [Qh 2s 8h] [4c]
tedbadger9: checks 
matiko09: bets $9.05
tedbadger9: folds 
Uncalled bet ($9.05) returned to matiko09
matiko09 collected $13.92 from pot
matiko09: doesn't show hand 
*** SUMMARY ***
Total pot $14.58 | Rake $0.66 
Board [Qh 2s 8h 4c]
Seat 1: matiko09 collected ($13.92)
Seat 2: sanpidk folded before Flop (didn't bet)
Seat 3: brille-390 folded before Flop (didn't bet)
Seat 4: Venomous100% folded before Flop (didn't bet)
Seat 5: lixiangli folded before Flop (didn't bet)
Seat 6: volwebni4ek (button) folded before Flop (didn't bet)
Seat 7: melitakas (small blind) folded before Flop
Seat 8: tedbadger9 (big blind) folded on the Turn
Seat 9: tipner folded before Flop (didn't bet)





PokerStars Hand #148219679287:  Hold'em No Limit (€0.50/€1.00 EUR) - 2016/02/04 15:31:54 CET [2016/02/04 9:31:54 ET]
Table 'Ostenia' 9-max Seat #1 is the button
Seat 1: mycka86 (€100 in chips) 
Seat 2: Dante63s (€100 in chips) 
Seat 3: maxxmeister (€108.78 in chips) 
Seat 4: MagicKid777 (€124.51 in chips) 
Seat 5: matiko09 (€104.50 in chips) 
Seat 6: melitakas (€104.21 in chips) 
Seat 7: tipner (€119.40 in chips) 
Seat 8: Venomous100% (€106.65 in chips) 
Seat 9: sanpidk (€131.51 in chips) 
Dante63s: posts small blind €0.50
maxxmeister: posts big blind €1
*** HOLE CARDS ***
Dealt to matiko09 [5s 6c]
MagicKid777: folds 
matiko09: folds 
melitakas: raises €1 to €2
tipner: folds 
Venomous100%: raises €7 to €9
sanpidk: folds 
mycka86: folds 
Dante63s: folds 
maxxmeister: folds 
melitakas: calls €7
*** FLOP *** [4d 2h Jh]
melitakas: checks 
Venomous100%: bets €12.29
melitakas: calls €12.29
*** TURN *** [4d 2h Jh] [Kc]
melitakas: checks 
Venomous100%: checks 
*** RIVER *** [4d 2h Jh Kc] [8h]
melitakas: bets €82.92 and is all-in
Venomous100%: folds 
Uncalled bet (€82.92) returned to melitakas
melitakas collected €42.10 from pot
*** SUMMARY ***
Total pot €44.08 | Rake €1.98 
Board [4d 2h Jh Kc 8h]
Seat 1: mycka86 (button) folded before Flop (didn't bet)
Seat 2: Dante63s (small blind) folded before Flop
Seat 3: maxxmeister (big blind) folded before Flop
Seat 4: MagicKid777 folded before Flop (didn't bet)
Seat 5: matiko09 folded before Flop (didn't bet)
Seat 6: melitakas collected (€42.10)
Seat 7: tipner folded before Flop (didn't bet)
Seat 8: Venomous100% folded on the River
Seat 9: sanpidk folded before Flop (didn't bet)





PokerStars Hand #148219679994:  Hold'em No Limit ($0.50/$1.00 USD) - 2016/02/04 15:31:55 CET [2016/02/04 9:31:55 ET]
Table 'Dejan' 9-max Seat #7 is the button
Seat 1: matiko09 ($101 in chips) 
Seat 2: xxxZeka ($104.75 in chips) 
Seat 3: lumen21 ($104.50 in chips) 
Seat 4: pruxa72 ($99 in chips) 
Seat 5: Rafaello18 ($137.84 in chips) 
Seat 6: sanpidk ($249.88 in chips) 
Seat 7: mycka86 ($121.13 in chips) 
Seat 8: s26s ($94 in chips) 
Seat 9: I The King I ($133.92 in chips) 
s26s: posts small blind $0.50
I The King I: posts big blind $1
*** HOLE CARDS ***
Dealt to matiko09 [Ad Th]
matiko09: folds 
xxxZeka: folds 
lumen21: folds 
pruxa72: folds 
Rafaello18: folds 
sanpidk: folds 
mycka86: folds 
s26s: raises $2 to $3
I The King I: calls $2
*** FLOP *** [4s Ah 6d]
s26s: bets $5.73
I The King I: folds 
Uncalled bet ($5.73) returned to s26s
s26s collected $5.73 from pot
*** SUMMARY ***
Total pot $6 | Rake $0.27 
Board [4s Ah 6d]
Seat 1: matiko09 folded before Flop (didn't bet)
Seat 2: xxxZeka folded before Flop (didn't bet)
Seat 3: lumen21 folded before Flop (didn't bet)
Seat 4: pruxa72 folded before Flop (didn't bet)
Seat 5: Rafaello18 folded before Flop (didn't bet)
Seat 6: sanpidk folded before Flop (didn't bet)
Seat 7: mycka86 (button) folded before Flop (didn't bet)
Seat 8: s26s (small blind) collected ($5.73)
Seat 9: I The King I (big blind) folded on the Flop





PokerStars Hand #148219681025:  Hold'em No Limit ($0.50/$1.00 USD) - 2016/02/04 15:31:57 CET [2016/02/04 9:31:57 ET]
Table 'Cepheus III' 9-max Seat #8 is the button
Seat 1: ozone2003 ($100 in chips) 
Seat 2: tipner ($101.50 in chips) 
Seat 3: pandalapa ($202.20 in chips) 
Seat 4: lukeylund ($74.56 in chips) 
Seat 5: ARTVOR640 ($144.50 in chips) 
Seat 6: matiko09 ($108.71 in chips) 
Seat 7: Igor DoUrden ($101.50 in chips) 
Seat 8: omorfadramou ($133.90 in chips) 
Seat 9: xxxZeka ($100.50 in chips) 
xxxZeka: posts small blind $0.50
ozone2003: posts big blind $1
*** HOLE CARDS ***
Dealt to matiko09 [3s Qd]
tipner: folds 
pandalapa: folds 
lukeylund: folds 
ARTVOR640: folds 
matiko09: folds 
Igor DoUrden: folds 
omorfadramou: raises $1 to $2
xxxZeka: folds 
ozone2003: folds 
Uncalled bet ($1) returned to omorfadramou
omorfadramou collected $2.50 from pot
omorfadramou: doesn't show hand 
*** SUMMARY ***
Total pot $2.50 | Rake $0 
Seat 1: ozone2003 (big blind) folded before Flop
Seat 2: tipner folded before Flop (didn't bet)
Seat 3: pandalapa folded before Flop (didn't bet)
Seat 4: lukeylund folded before Flop (didn't bet)
Seat 5: ARTVOR640 folded before Flop (didn't bet)
Seat 6: matiko09 folded before Flop (didn't bet)
Seat 7: Igor DoUrden folded before Flop (didn't bet)
Seat 8: omorfadramou (button) collected ($2.50)
Seat 9: xxxZeka (small blind) folded before Flop





PokerStars Hand #148219699422:  Hold'em No Limit ($0.50/$1.00 USD) - 2016/02/04 15:32:22 CET [2016/02/04 9:32:22 ET]
Table 'Mothallah' 9-max Seat #9 is the button
Seat 2: davianvalek ($116.05 in chips) 
Seat 3: ozone2003 ($107.18 in chips) 
Seat 4: YOUNG_G70 ($60.80 in chips) 
Seat 5: chaps1988 ($101 in chips) 
Seat 6: I The King I ($126.78 in chips) 
Seat 7: sanpidk ($107.42 in chips) 
Seat 8: Spid1 ($137.86 in chips) 
Seat 9: matiko09 ($100 in chips) 
davianvalek: posts small blind $0.50
ozone2003: posts big blind $1
*** HOLE CARDS ***
Dealt to matiko09 [4h 7d]
YOUNG_G70: calls $1
chaps1988: folds 
I The King I: folds 
sanpidk: folds 
Spid1: folds 
matiko09: folds 
davianvalek: raises $3 to $4
ozone2003: folds 
YOUNG_G70: calls $3
*** FLOP *** [5h 6d Qs]
davianvalek: bets $6.10
YOUNG_G70: calls $6.10
*** TURN *** [5h 6d Qs] [Ks]
davianvalek: bets $13.37
YOUNG_G70: folds 
Uncalled bet ($13.37) returned to davianvalek
davianvalek collected $20.25 from pot
*** SUMMARY ***
Total pot $21.20 | Rake $0.95 
Board [5h 6d Qs Ks]
Seat 2: davianvalek (small blind) collected ($20.25)
Seat 3: ozone2003 (big blind) folded before Flop
Seat 4: YOUNG_G70 folded on the Turn
Seat 5: chaps1988 folded before Flop (didn't bet)
Seat 6: I The King I folded before Flop (didn't bet)
Seat 7: sanpidk folded before Flop (didn't bet)
Seat 8: Spid1 folded before Flop (didn't bet)
Seat 9: matiko09 (button) folded before Flop (didn't bet)





PokerStars Hand #148219699119:  Hold'em No Limit ($0.50/$1.00 USD) - 2016/02/04 15:32:22 CET [2016/02/04 9:32:22 ET]
Table 'Laverna II' 9-max Seat #8 is the button
Seat 2: sanpidk ($100 in chips) 
Seat 3: tipner ($100 in chips) 
Seat 4: brille-390 ($100 in chips) 
Seat 5: Iozhek ($80 in chips) 
Seat 6: Mukhin1 ($103.48 in chips) 
Seat 7: Rafaello18 ($100 in chips) 
Seat 8: Dante63s ($100 in chips) 
Seat 9: matiko09 ($100.50 in chips) 
matiko09: posts small blind $0.50
sanpidk: posts big blind $1
*** HOLE CARDS ***
Dealt to matiko09 [7c Jh]
tipner: folds 
brille-390: folds 
Iozhek: folds 
Mukhin1: folds 
Rafaello18: folds 
Dante63s: raises $1 to $2
matiko09: folds 
sanpidk: folds 
Uncalled bet ($1) returned to Dante63s
Dante63s collected $2.50 from pot
Dante63s: doesn't show hand 
*** SUMMARY ***
Total pot $2.50 | Rake $0 
Seat 2: sanpidk (big blind) folded before Flop
Seat 3: tipner folded before Flop (didn't bet)
Seat 4: brille-390 folded before Flop (didn't bet)
Seat 5: Iozhek folded before Flop (didn't bet)
Seat 6: Mukhin1 folded before Flop (didn't bet)
Seat 7: Rafaello18 folded before Flop (didn't bet)
Seat 8: Dante63s (button) collected ($2.50)
Seat 9: matiko09 (small blind) folded before Flop





PokerStars Hand #148219709894:  Hold'em No Limit ($0.50/$1.00 USD) - 2016/02/04 15:32:37 CET [2016/02/04 9:32:37 ET]
Table 'Cepheus III' 9-max Seat #9 is the button
Seat 1: ozone2003 ($100 in chips) 
Seat 2: tipner ($101.50 in chips) 
Seat 4: lukeylund ($74.56 in chips) 
Seat 5: ARTVOR640 ($144.50 in chips) 
Seat 6: matiko09 ($108.71 in chips) 
Seat 7: Igor DoUrden ($101.50 in chips) 
Seat 8: omorfadramou ($135.40 in chips) 
Seat 9: xxxZeka ($100 in chips) 
ozone2003: posts small blind $0.50
tipner: posts big blind $1
*** HOLE CARDS ***
Dealt to matiko09 [Qs 9s]
lukeylund: folds 
ARTVOR640: folds 
matiko09: folds 
Igor DoUrden: folds 
omorfadramou: folds 
xxxZeka: folds 
ozone2003: raises $1.95 to $2.95
tipner: folds 
Uncalled bet ($1.95) returned to ozone2003
ozone2003 collected $2 from pot
ozone2003: doesn't show hand 
*** SUMMARY ***
Total pot $2 | Rake $0 
Seat 1: ozone2003 (small blind) collected ($2)
Seat 2: tipner (big blind) folded before Flop
Seat 4: lukeylund folded before Flop (didn't bet)
Seat 5: ARTVOR640 folded before Flop (didn't bet)
Seat 6: matiko09 folded before Flop (didn't bet)
Seat 7: Igor DoUrden folded before Flop (didn't bet)
Seat 8: omorfadramou folded before Flop (didn't bet)
Seat 9: xxxZeka (button) folded before Flop (didn't bet)





PokerStars Hand #148219719784:  Hold'em No Limit ($0.50/$1.00 USD) - 2016/02/04 15:32:50 CET [2016/02/04 9:32:50 ET]
Table 'Arneb II' 9-max Seat #7 is the button
Seat 1: matiko09 ($108.38 in chips) 
Seat 2: sanpidk ($218.46 in chips) 
Seat 3: brille-390 ($148.02 in chips) 
Seat 4: Venomous100% ($100 in chips) 
Seat 5: lixiangli ($74.87 in chips) 
Seat 6: volwebni4ek ($82.95 in chips) 
Seat 7: melitakas ($264.17 in chips) 
Seat 8: tedbadger9 ($49.47 in chips) 
Seat 9: tipner ($111.67 in chips) 
tedbadger9: posts small blind $0.50
tipner: posts big blind $1
*** HOLE CARDS ***
Dealt to matiko09 [Ac Qd]
matiko09: raises $2 to $3
sanpidk: folds 
brille-390: folds 
Venomous100%: folds 
lixiangli: folds 
volwebni4ek: folds 
melitakas: folds 
tedbadger9: calls $2.50
tipner: calls $2
*** FLOP *** [6s 2h 5c]
tedbadger9: checks 
tipner: checks 
matiko09: checks 
*** TURN *** [6s 2h 5c] [3c]
tedbadger9: bets $6.45
tipner: folds 
matiko09: folds 
Uncalled bet ($6.45) returned to tedbadger9
tedbadger9 collected $8.60 from pot
*** SUMMARY ***
Total pot $9 | Rake $0.40 
Board [6s 2h 5c 3c]
Seat 1: matiko09 folded on the Turn
Seat 2: sanpidk folded before Flop (didn't bet)
Seat 3: brille-390 folded before Flop (didn't bet)
Seat 4: Venomous100% folded before Flop (didn't bet)
Seat 5: lixiangli folded before Flop (didn't bet)
Seat 6: volwebni4ek folded before Flop (didn't bet)
Seat 7: melitakas (button) folded before Flop (didn't bet)
Seat 8: tedbadger9 (small blind) collected ($8.60)
Seat 9: tipner (big blind) folded on the Turn





PokerStars Hand #148219721033:  Hold'em No Limit ($0.50/$1.00 USD) - 2016/02/04 15:32:52 CET [2016/02/04 9:32:52 ET]
Table 'Laverna II' 9-max Seat #9 is the button
Seat 2: sanpidk ($100 in chips) 
Seat 3: tipner ($100 in chips) 
Seat 4: brille-390 ($100 in chips) 
Seat 5: Iozhek ($80 in chips) 
Seat 6: Mukhin1 ($103.48 in chips) 
Seat 7: Rafaello18 ($100 in chips) 
Seat 8: Dante63s ($101.50 in chips) 
Seat 9: matiko09 ($100 in chips) 
sanpidk: posts small blind $0.50
tipner: posts big blind $1
*** HOLE CARDS ***
Dealt to matiko09 [Js 5h]
brille-390: folds 
Iozhek: raises $1 to $2
Mukhin1: folds 
Rafaello18: raises $4 to $6
Dante63s: folds 
matiko09: folds 
sanpidk: folds 
tipner: folds 
Iozhek: calls $4
*** FLOP *** [7c 8s Kh]
Iozhek: checks 
Rafaello18: bets $8
Iozhek: calls $8
*** TURN *** [7c 8s Kh] [Qc]
Iozhek: checks 
Rafaello18: checks 
*** RIVER *** [7c 8s Kh Qc] [3c]
Iozhek: checks 
Rafaello18: bets $14
Iozhek: folds 
Uncalled bet ($14) returned to Rafaello18
Rafaello18 collected $28.17 from pot
Rafaello18: doesn't show hand 
*** SUMMARY ***
Total pot $29.50 | Rake $1.33 
Board [7c 8s Kh Qc 3c]
Seat 2: sanpidk (small blind) folded before Flop
Seat 3: tipner (big blind) folded before Flop
Seat 4: brille-390 folded before Flop (didn't bet)
Seat 5: Iozhek folded on the River
Seat 6: Mukhin1 folded before Flop (didn't bet)
Seat 7: Rafaello18 collected ($28.17)
Seat 8: Dante63s folded before Flop (didn't bet)
Seat 9: matiko09 (button) folded before Flop (didn't bet)





PokerStars Hand #148219723216:  Hold'em No Limit ($0.50/$1.00 USD) - 2016/02/04 15:32:55 CET [2016/02/04 9:32:55 ET]
Table 'Dejan' 9-max Seat #8 is the button
Seat 1: matiko09 ($101 in chips) 
Seat 2: xxxZeka ($104.75 in chips) 
Seat 3: lumen21 ($104.50 in chips) 
Seat 4: pruxa72 ($99 in chips) 
Seat 5: Rafaello18 ($137.84 in chips) 
Seat 6: sanpidk ($249.88 in chips) 
Seat 7: mycka86 ($121.13 in chips) 
Seat 8: s26s ($96.73 in chips) 
Seat 9: I The King I ($130.92 in chips) 
I The King I: posts small blind $0.50
matiko09: posts big blind $1
*** HOLE CARDS ***
Dealt to matiko09 [7d 9h]
xxxZeka: folds 
lumen21: raises $2 to $3
pruxa72: folds 
Rafaello18: folds 
sanpidk: folds 
mycka86: folds 
s26s: folds 
I The King I: folds 
matiko09: folds 
Uncalled bet ($2) returned to lumen21
lumen21 collected $2.50 from pot
lumen21: doesn't show hand 
*** SUMMARY ***
Total pot $2.50 | Rake $0 
Seat 1: matiko09 (big blind) folded before Flop
Seat 2: xxxZeka folded before Flop (didn't bet)
Seat 3: lumen21 collected ($2.50)
Seat 4: pruxa72 folded before Flop (didn't bet)
Seat 5: Rafaello18 folded before Flop (didn't bet)
Seat 6: sanpidk folded before Flop (didn't bet)
Seat 7: mycka86 folded before Flop (didn't bet)
Seat 8: s26s (button) folded before Flop (didn't bet)
Seat 9: I The King I (small blind) folded before Flop





PokerStars Hand #148219726585:  Hold'em No Limit ($0.50/$1.00 USD) - 2016/02/04 15:33:00 CET [2016/02/04 9:33:00 ET]
Table 'Cepheus III' 9-max Seat #1 is the button
Seat 1: ozone2003 ($101 in chips) 
Seat 2: tipner ($100.50 in chips) 
Seat 4: lukeylund ($74.56 in chips) 
Seat 5: ARTVOR640 ($144.50 in chips) 
Seat 6: matiko09 ($108.71 in chips) 
Seat 7: Igor DoUrden ($101.50 in chips) 
Seat 8: omorfadramou ($135.40 in chips) 
Seat 9: xxxZeka ($100 in chips) 
tipner: posts small blind $0.50
lukeylund: posts big blind $1
*** HOLE CARDS ***
Dealt to matiko09 [7c 3h]
ARTVOR640: folds 
matiko09: folds 
Igor DoUrden: folds 
omorfadramou: raises $1.16 to $2.16
xxxZeka: folds 
ozone2003: folds 
tipner: folds 
lukeylund: folds 
Uncalled bet ($1.16) returned to omorfadramou
omorfadramou collected $2.50 from pot
omorfadramou: doesn't show hand 
*** SUMMARY ***
Total pot $2.50 | Rake $0 
Seat 1: ozone2003 (button) folded before Flop (didn't bet)
Seat 2: tipner (small blind) folded before Flop
Seat 4: lukeylund (big blind) folded before Flop
Seat 5: ARTVOR640 folded before Flop (didn't bet)
Seat 6: matiko09 folded before Flop (didn't bet)
Seat 7: Igor DoUrden folded before Flop (didn't bet)
Seat 8: omorfadramou collected ($2.50)
Seat 9: xxxZeka folded before Flop (didn't bet)





PokerStars Hand #148219731671:  Hold'em No Limit ($0.50/$1.00 USD) - 2016/02/04 15:33:07 CET [2016/02/04 9:33:07 ET]
Table 'Mothallah' 9-max Seat #2 is the button
Seat 2: davianvalek ($126.20 in chips) 
Seat 3: ozone2003 ($106.18 in chips) 
Seat 4: YOUNG_G70 ($50.70 in chips) 
Seat 5: chaps1988 ($101 in chips) 
Seat 6: I The King I ($126.78 in chips) 
Seat 7: sanpidk ($107.42 in chips) 
Seat 8: Spid1 ($137.86 in chips) 
Seat 9: matiko09 ($100 in chips) 
ozone2003: posts small blind $0.50
YOUNG_G70: posts big blind $1
*** HOLE CARDS ***
Dealt to matiko09 [Jh 8s]
chaps1988: folds 
I The King I: folds 
sanpidk: folds 
Spid1: folds 
matiko09: folds 
davianvalek: raises $1.50 to $2.50
ozone2003: folds 
YOUNG_G70: folds 
Uncalled bet ($1.50) returned to davianvalek
davianvalek collected $2.50 from pot
*** SUMMARY ***
Total pot $2.50 | Rake $0 
Seat 2: davianvalek (button) collected ($2.50)
Seat 3: ozone2003 (small blind) folded before Flop
Seat 4: YOUNG_G70 (big blind) folded before Flop
Seat 5: chaps1988 folded before Flop (didn't bet)
Seat 6: I The King I folded before Flop (didn't bet)
Seat 7: sanpidk folded before Flop (didn't bet)
Seat 8: Spid1 folded before Flop (didn't bet)
Seat 9: matiko09 folded before Flop (didn't bet)





PokerStars Hand #148219740799:  Hold'em No Limit ($0.50/$1.00 USD) - 2016/02/04 15:33:19 CET [2016/02/04 9:33:19 ET]
Table 'Dejan' 9-max Seat #9 is the button
Seat 1: matiko09 ($100 in chips) 
Seat 2: xxxZeka ($104.75 in chips) 
Seat 3: lumen21 ($106 in chips) 
Seat 4: pruxa72 ($99 in chips) 
Seat 5: Rafaello18 ($137.84 in chips) 
Seat 6: sanpidk ($249.88 in chips) 
Seat 7: mycka86 ($121.13 in chips) 
Seat 8: s26s ($96.73 in chips) 
Seat 9: I The King I ($130.42 in chips) 
matiko09: posts small blind $0.50
xxxZeka: posts big blind $1
*** HOLE CARDS ***
Dealt to matiko09 [8c Td]
lumen21: folds 
pruxa72: calls $1
Rafaello18: raises $3 to $4
sanpidk: folds 
mycka86: calls $4
s26s: folds 
I The King I: calls $4
matiko09: folds 
xxxZeka: folds 
pruxa72: calls $3
*** FLOP *** [Jh 9s Kd]
pruxa72: checks 
Rafaello18: bets $10
mycka86: folds 
I The King I: folds 
pruxa72: calls $10
*** TURN *** [Jh 9s Kd] [2s]
pruxa72: checks 
Rafaello18: checks 
*** RIVER *** [Jh 9s Kd 2s] [6d]
pruxa72: checks 
Rafaello18: checks 
*** SHOW DOWN ***
pruxa72: shows [9c Th] (a pair of Nines)
Rafaello18: mucks hand 
pruxa72 collected $35.81 from pot
*** SUMMARY ***
Total pot $37.50 | Rake $1.69 
Board [Jh 9s Kd 2s 6d]
Seat 1: matiko09 (small blind) folded before Flop
Seat 2: xxxZeka (big blind) folded before Flop
Seat 3: lumen21 folded before Flop (didn't bet)
Seat 4: pruxa72 showed [9c Th] and won ($35.81) with a pair of Nines
Seat 5: Rafaello18 mucked [Qc Ad]
Seat 6: sanpidk folded before Flop (didn't bet)
Seat 7: mycka86 folded on the Flop
Seat 8: s26s folded before Flop (didn't bet)
Seat 9: I The King I (button) folded on the Flop





PokerStars Hand #148219741861:  Hold'em No Limit ($0.50/$1.00 USD) - 2016/02/04 15:33:21 CET [2016/02/04 9:33:21 ET]
Table 'Siarnaq' 9-max Seat #3 is the button
Seat 1: sanpidk ($199.20 in chips) 
Seat 2: Igor DoUrden ($101.56 in chips) 
Seat 3: goblind4777 ($125.41 in chips) 
Seat 5: I The King I ($118.21 in chips) 
Seat 7: matiko09 ($100 in chips) 
Seat 8: maxxmeister ($100 in chips) 
Seat 9: TimStone ($104.50 in chips) 
I The King I: posts small blind $0.50
yourpro: is sitting out 
matiko09: posts big blind $1
*** HOLE CARDS ***
Dealt to matiko09 [7c 7d]
yourpro leaves the table
Düss2411 joins the table at seat #6 
maxxmeister: folds 
Düss2411 leaves the table
TimStone: folds 
KLOP06031987 joins the table at seat #6 
KLOP06031987 leaves the table
sanpidk: raises $2 to $3
Monsthand joins the table at seat #6 
Igor DoUrden: calls $3
goblind4777: folds 
I The King I: raises $11 to $14
matiko09: folds 
sanpidk: folds 
Igor DoUrden: folds 
Uncalled bet ($11) returned to I The King I
I The King I collected $10 from pot
I The King I: doesn't show hand 
Venomous100% leaves the table
*** SUMMARY ***
Total pot $10 | Rake $0 
Seat 1: sanpidk folded before Flop
Seat 2: Igor DoUrden folded before Flop
Seat 3: goblind4777 (button) folded before Flop (didn't bet)
Seat 5: I The King I (small blind) collected ($10)
Seat 7: matiko09 (big blind) folded before Flop
Seat 8: maxxmeister folded before Flop (didn't bet)
Seat 9: TimStone folded before Flop (didn't bet)





PokerStars Hand #148219744458:  Hold'em No Limit ($0.50/$1.00 USD) - 2016/02/04 15:33:24 CET [2016/02/04 9:33:24 ET]
Table 'Arneb III' 9-max Seat #4 is the button
Seat 2: JeanLima93 ($183.94 in chips) 
Seat 3: matiko09 ($101.94 in chips) 
Seat 4: Igor DoUrden ($246.29 in chips) 
Seat 5: tipner ($135.52 in chips) 
Seat 6: nickreason17 ($102.11 in chips) 
Seat 7: xxxZeka ($102.50 in chips) 
Seat 8: volwebni4ek ($40 in chips) 
Seat 9: ARTVOR640 ($100 in chips) 
tipner: posts small blind $0.50
nickreason17: posts big blind $1
sanpidk: sits out 
*** HOLE CARDS ***
Dealt to matiko09 [8s Jh]
xxxZeka: folds 
volwebni4ek: folds 
ARTVOR640: folds 
JeanLima93: folds 
matiko09: folds 
Igor DoUrden: folds 
tipner: folds 
Uncalled bet ($0.50) returned to nickreason17
nickreason17 collected $1 from pot
*** SUMMARY ***
Total pot $1 | Rake $0 
Seat 2: JeanLima93 folded before Flop (didn't bet)
Seat 3: matiko09 folded before Flop (didn't bet)
Seat 4: Igor DoUrden (button) folded before Flop (didn't bet)
Seat 5: tipner (small blind) folded before Flop
Seat 6: nickreason17 (big blind) collected ($1)
Seat 7: xxxZeka folded before Flop (didn't bet)
Seat 8: volwebni4ek folded before Flop (didn't bet)
Seat 9: ARTVOR640 folded before Flop (didn't bet)





PokerStars Hand #148219747560:  Hold'em No Limit ($0.50/$1.00 USD) - 2016/02/04 15:33:29 CET [2016/02/04 9:33:29 ET]
Table 'Mothallah' 9-max Seat #3 is the button
Seat 2: davianvalek ($127.70 in chips) 
Seat 3: ozone2003 ($105.68 in chips) 
Seat 4: YOUNG_G70 ($49.70 in chips) 
Seat 5: chaps1988 ($101 in chips) 
Seat 6: I The King I ($126.78 in chips) 
Seat 7: sanpidk ($107.42 in chips) 
Seat 8: Spid1 ($137.86 in chips) 
Seat 9: matiko09 ($100 in chips) 
YOUNG_G70: posts small blind $0.50
chaps1988: posts big blind $1
*** HOLE CARDS ***
Dealt to matiko09 [Tc 5s]
I The King I: folds 
sanpidk: folds 
Spid1: folds 
matiko09: folds 
davianvalek: folds 
ozone2003: raises $1.20 to $2.20
YOUNG_G70: calls $1.70
chaps1988: folds 
*** FLOP *** [Jd 3h 5d]
YOUNG_G70: checks 
ozone2003: bets $4
YOUNG_G70: calls $4
*** TURN *** [Jd 3h 5d] [7s]
YOUNG_G70: checks 
ozone2003: bets $7.68
YOUNG_G70: calls $7.68
*** RIVER *** [Jd 3h 5d 7s] [7c]
YOUNG_G70: checks 
ozone2003: checks 
*** SHOW DOWN ***
YOUNG_G70: shows [Ah 9s] (a pair of Sevens)
ozone2003: shows [Jc Ts] (two pair, Jacks and Sevens)
ozone2003 collected $27.47 from pot
*** SUMMARY ***
Total pot $28.76 | Rake $1.29 
Board [Jd 3h 5d 7s 7c]
Seat 2: davianvalek folded before Flop (didn't bet)
Seat 3: ozone2003 (button) showed [Jc Ts] and won ($27.47) with two pair, Jacks and Sevens
Seat 4: YOUNG_G70 (small blind) showed [Ah 9s] and lost with a pair of Sevens
Seat 5: chaps1988 (big blind) folded before Flop
Seat 6: I The King I folded before Flop (didn't bet)
Seat 7: sanpidk folded before Flop (didn't bet)
Seat 8: Spid1 folded before Flop (didn't bet)
Seat 9: matiko09 folded before Flop (didn't bet)





PokerStars Hand #148219751048:  Hold'em No Limit (€0.50/€1.00 EUR) - 2016/02/04 15:33:33 CET [2016/02/04 9:33:33 ET]
Table 'Ostenia' 9-max Seat #2 is the button
Seat 1: mycka86 (€100 in chips) 
Seat 2: Dante63s (€100 in chips) 
Seat 3: maxxmeister (€107.78 in chips) 
Seat 4: MagicKid777 (€124.51 in chips) 
Seat 5: matiko09 (€104.50 in chips) 
Seat 6: melitakas (€125.02 in chips) 
Seat 7: tipner (€119.40 in chips) 
Seat 8: Venomous100% (€100 in chips) 
Seat 9: sanpidk (€131.51 in chips) 
maxxmeister: posts small blind €0.50
MagicKid777: posts big blind €1
*** HOLE CARDS ***
Dealt to matiko09 [4d 7s]
matiko09: folds 
melitakas: folds 
tipner: raises €2 to €3
Venomous100%: folds 
sanpidk: folds 
mycka86: folds 
Dante63s: folds 
maxxmeister: folds 
MagicKid777: folds 
Uncalled bet (€2) returned to tipner
tipner collected €2.50 from pot
tipner: doesn't show hand 
*** SUMMARY ***
Total pot €2.50 | Rake €0 
Seat 1: mycka86 folded before Flop (didn't bet)
Seat 2: Dante63s (button) folded before Flop (didn't bet)
Seat 3: maxxmeister (small blind) folded before Flop
Seat 4: MagicKid777 (big blind) folded before Flop
Seat 5: matiko09 folded before Flop (didn't bet)
Seat 6: melitakas folded before Flop (didn't bet)
Seat 7: tipner collected (€2.50)
Seat 8: Venomous100% folded before Flop (didn't bet)
Seat 9: sanpidk folded before Flop (didn't bet)





PokerStars Hand #148219756169:  Hold'em No Limit ($0.50/$1.00 USD) - 2016/02/04 15:33:40 CET [2016/02/04 9:33:40 ET]
Table 'Cepheus III' 9-max Seat #2 is the button
Seat 1: ozone2003 ($101 in chips) 
Seat 2: tipner ($100 in chips) 
Seat 4: lukeylund ($73.56 in chips) 
Seat 5: ARTVOR640 ($144.50 in chips) 
Seat 6: matiko09 ($108.71 in chips) 
Seat 7: Igor DoUrden ($101.50 in chips) 
Seat 8: omorfadramou ($136.90 in chips) 
Seat 9: xxxZeka ($100 in chips) 
lukeylund: posts small blind $0.50
ARTVOR640: posts big blind $1
*** HOLE CARDS ***
Dealt to matiko09 [Kh 3h]
matiko09: folds 
Igor DoUrden: folds 
omorfadramou: raises $1.16 to $2.16
xxxZeka: folds 
ozone2003: folds 
tipner: folds 
lukeylund: folds 
ARTVOR640: folds 
Uncalled bet ($1.16) returned to omorfadramou
omorfadramou collected $2.50 from pot
omorfadramou: doesn't show hand 
*** SUMMARY ***
Total pot $2.50 | Rake $0 
Seat 1: ozone2003 folded before Flop (didn't bet)
Seat 2: tipner (button) folded before Flop (didn't bet)
Seat 4: lukeylund (small blind) folded before Flop
Seat 5: ARTVOR640 (big blind) folded before Flop
Seat 6: matiko09 folded before Flop (didn't bet)
Seat 7: Igor DoUrden folded before Flop (didn't bet)
Seat 8: omorfadramou collected ($2.50)
Seat 9: xxxZeka folded before Flop (didn't bet)





PokerStars Hand #148219765898:  Hold'em No Limit ($0.50/$1.00 USD) - 2016/02/04 15:33:54 CET [2016/02/04 9:33:54 ET]
Table 'Arneb III' 9-max Seat #5 is the button
Seat 2: JeanLima93 ($183.94 in chips) 
Seat 3: matiko09 ($101.94 in chips) 
Seat 4: Igor DoUrden ($246.29 in chips) 
Seat 5: tipner ($135.02 in chips) 
Seat 6: nickreason17 ($102.61 in chips) 
Seat 7: xxxZeka ($102.50 in chips) 
Seat 8: volwebni4ek ($40 in chips) 
Seat 9: ARTVOR640 ($100 in chips) 
nickreason17: posts small blind $0.50
xxxZeka: posts big blind $1
sanpidk: sits out 
*** HOLE CARDS ***
Dealt to matiko09 [As Ad]
volwebni4ek: folds 
ARTVOR640: folds 
JeanLima93 has timed out
JeanLima93: folds 
matiko09: raises $2 to $3
Igor DoUrden: folds 
tipner: folds 
nickreason17: folds 
xxxZeka: raises $6.50 to $9.50
matiko09: calls $6.50
*** FLOP *** [Jc 7h 3h]
xxxZeka: bets $12
matiko09: calls $12
*** TURN *** [Jc 7h 3h] [3d]
xxxZeka: bets $27
matiko09: calls $27
*** RIVER *** [Jc 7h 3h 3d] [9h]
xxxZeka: checks 
matiko09: bets $53.44 and is all-in
xxxZeka: folds 
Uncalled bet ($53.44) returned to matiko09
matiko09 collected $94.70 from pot
matiko09: doesn't show hand 
*** SUMMARY ***
Total pot $97.50 | Rake $2.80 
Board [Jc 7h 3h 3d 9h]
Seat 2: JeanLima93 folded before Flop (didn't bet)
Seat 3: matiko09 collected ($94.70)
Seat 4: Igor DoUrden folded before Flop (didn't bet)
Seat 5: tipner (button) folded before Flop (didn't bet)
Seat 6: nickreason17 (small blind) folded before Flop
Seat 7: xxxZeka (big blind) folded on the River
Seat 8: volwebni4ek folded before Flop (didn't bet)
Seat 9: ARTVOR640 folded before Flop (didn't bet)





PokerStars Hand #148219773250:  Hold'em No Limit ($0.50/$1.00 USD) - 2016/02/04 15:34:04 CET [2016/02/04 9:34:04 ET]
Table 'Laverna II' 9-max Seat #2 is the button
Seat 2: sanpidk ($100 in chips) 
Seat 3: tipner ($100 in chips) 
Seat 5: Iozhek ($66 in chips) 
Seat 6: Mukhin1 ($103.48 in chips) 
Seat 7: Rafaello18 ($114.17 in chips) 
Seat 8: Dante63s ($101.50 in chips) 
Seat 9: matiko09 ($100 in chips) 
tipner: posts small blind $0.50
brille-390: is sitting out 
Iozhek: posts big blind $1
*** HOLE CARDS ***
Dealt to matiko09 [2s 7d]
Mukhin1: folds 
Rafaello18: folds 
Dante63s: folds 
brille-390 leaves the table
matiko09: folds 
sanpidk: folds 
tipner: folds 
Uncalled bet ($0.50) returned to Iozhek
Iozhek collected $1 from pot
Iozhek: doesn't show hand 
*** SUMMARY ***
Total pot $1 | Rake $0 
Seat 2: sanpidk (button) folded before Flop (didn't bet)
Seat 3: tipner (small blind) folded before Flop
Seat 5: Iozhek (big blind) collected ($1)
Seat 6: Mukhin1 folded before Flop (didn't bet)
Seat 7: Rafaello18 folded before Flop (didn't bet)
Seat 8: Dante63s folded before Flop (didn't bet)
Seat 9: matiko09 folded before Flop (didn't bet)





PokerStars Hand #148219783994:  Hold'em No Limit ($0.50/$1.00 USD) - 2016/02/04 15:34:19 CET [2016/02/04 9:34:19 ET]
Table 'Mothallah' 9-max Seat #4 is the button
Seat 2: davianvalek ($127.70 in chips) 
Seat 3: ozone2003 ($119.27 in chips) 
Seat 4: YOUNG_G70 ($35.82 in chips) 
Seat 5: chaps1988 ($100 in chips) 
Seat 6: I The King I ($126.78 in chips) 
Seat 7: sanpidk ($107.42 in chips) 
Seat 8: Spid1 ($137.86 in chips) 
Seat 9: matiko09 ($100 in chips) 
chaps1988: posts small blind $0.50
I The King I: posts big blind $1
*** HOLE CARDS ***
Dealt to matiko09 [9s 8d]
sanpidk: folds 
Spid1: folds 
matiko09: folds 
davianvalek: folds 
ozone2003: raises $1.50 to $2.50
YOUNG_G70: folds 
chaps1988: raises $7.50 to $10
I The King I: folds 
ozone2003: raises $11 to $21
chaps1988: folds 
Uncalled bet ($11) returned to ozone2003
ozone2003 collected $21 from pot
ozone2003: doesn't show hand 
*** SUMMARY ***
Total pot $21 | Rake $0 
Seat 2: davianvalek folded before Flop (didn't bet)
Seat 3: ozone2003 collected ($21)
Seat 4: YOUNG_G70 (button) folded before Flop (didn't bet)
Seat 5: chaps1988 (small blind) folded before Flop
Seat 6: I The King I (big blind) folded before Flop
Seat 7: sanpidk folded before Flop (didn't bet)
Seat 8: Spid1 folded before Flop (didn't bet)
Seat 9: matiko09 folded before Flop (didn't bet)





PokerStars Hand #148219790691:  Hold'em No Limit ($0.50/$1.00 USD) - 2016/02/04 15:34:28 CET [2016/02/04 9:34:28 ET]
Table 'Arneb II' 9-max Seat #8 is the button
Seat 1: matiko09 ($105.38 in chips) 
Seat 2: sanpidk ($218.46 in chips) 
Seat 3: brille-390 ($148.02 in chips) 
Seat 4: Venomous100% ($100 in chips) 
Seat 5: lixiangli ($74.87 in chips) 
Seat 6: volwebni4ek ($82.95 in chips) 
Seat 7: melitakas ($264.17 in chips) 
Seat 8: tedbadger9 ($55.07 in chips) 
Seat 9: tipner ($108.67 in chips) 
tipner: posts small blind $0.50
matiko09: posts big blind $1
*** HOLE CARDS ***
Dealt to matiko09 [5h Ad]
sanpidk: folds 
brille-390: folds 
Venomous100%: folds 
lixiangli: folds 
volwebni4ek: raises $1.50 to $2.50
melitakas: calls $2.50
tedbadger9: calls $2.50
tipner: folds 
matiko09: folds 
*** FLOP *** [6h Qc 3s]
volwebni4ek: checks 
melitakas: checks 
tedbadger9: bets $6.45
volwebni4ek: folds 
melitakas: raises $10.75 to $17.20
tedbadger9: calls $10.75
*** TURN *** [6h Qc 3s] [2s]
melitakas: bets $244.47 and is all-in
tedbadger9: folds 
Uncalled bet ($244.47) returned to melitakas
melitakas collected $41.45 from pot
*** SUMMARY ***
Total pot $43.40 | Rake $1.95 
Board [6h Qc 3s 2s]
Seat 1: matiko09 (big blind) folded before Flop
Seat 2: sanpidk folded before Flop (didn't bet)
Seat 3: brille-390 folded before Flop (didn't bet)
Seat 4: Venomous100% folded before Flop (didn't bet)
Seat 5: lixiangli folded before Flop (didn't bet)
Seat 6: volwebni4ek folded on the Flop
Seat 7: melitakas collected ($41.45)
Seat 8: tedbadger9 (button) folded on the Turn
Seat 9: tipner (small blind) folded before Flop





PokerStars Hand #148219798202:  Hold'em No Limit ($0.50/$1.00 USD) - 2016/02/04 15:34:38 CET [2016/02/04 9:34:38 ET]
Table 'Avior II' 9-max Seat #8 is the button
Seat 1: I The King I ($110.06 in chips) 
Seat 2: matiko09 ($100 in chips) 
Seat 3: sanpidk ($131.70 in chips) 
Seat 4: xxxZeka ($100 in chips) 
Seat 5: chaps1988 ($100 in chips) 
Seat 6: tipner ($219.47 in chips) 
Seat 8: EdHunder ($51.92 in chips) 
I The King I: posts small blind $0.50
matiko09: posts big blind $1
Monsthand: sits out 
*** HOLE CARDS ***
Dealt to matiko09 [2c Ks]
sanpidk: folds 
xxxZeka: folds 
chaps1988: folds 
tipner: folds 
EdHunder: folds 
I The King I: raises $2 to $3
matiko09: folds 
Uncalled bet ($2) returned to I The King I
I The King I collected $2 from pot
I The King I: doesn't show hand 
*** SUMMARY ***
Total pot $2 | Rake $0 
Seat 1: I The King I (small blind) collected ($2)
Seat 2: matiko09 (big blind) folded before Flop
Seat 3: sanpidk folded before Flop (didn't bet)
Seat 4: xxxZeka folded before Flop (didn't bet)
Seat 5: chaps1988 folded before Flop (didn't bet)
Seat 6: tipner folded before Flop (didn't bet)
Seat 8: EdHunder (button) folded before Flop (didn't bet)





PokerStars Hand #148219802447:  Hold'em No Limit ($0.50/$1.00 USD) - 2016/02/04 15:34:44 CET [2016/02/04 9:34:44 ET]
Table 'Helio III' 9-max Seat #4 is the button
Seat 1: lixiangli ($80.80 in chips) 
Seat 2: mycka86 ($103.50 in chips) 
Seat 3: RICKA16 ($107.31 in chips) 
Seat 4: scmastersrl ($144.18 in chips) 
Seat 6: I The King I ($116.38 in chips) 
Seat 7: matiko09 ($100 in chips) 
Seat 8: nickreason17 ($100 in chips) 
I The King I: posts small blind $0.50
matiko09: posts big blind $1
*** HOLE CARDS ***
Dealt to matiko09 [5h Ah]
nickreason17: folds 
lixiangli: folds 
mycka86: folds 
RICKA16: raises $2 to $3
scmastersrl: calls $3
I The King I: folds 
matiko09: raises $10 to $13
RICKA16: folds 
scmastersrl: folds 
Uncalled bet ($10) returned to matiko09
matiko09 collected $9.50 from pot
matiko09: doesn't show hand 
*** SUMMARY ***
Total pot $9.50 | Rake $0 
Seat 1: lixiangli folded before Flop (didn't bet)
Seat 2: mycka86 folded before Flop (didn't bet)
Seat 3: RICKA16 folded before Flop
Seat 4: scmastersrl (button) folded before Flop
Seat 6: I The King I (small blind) folded before Flop
Seat 7: matiko09 (big blind) collected ($9.50)
Seat 8: nickreason17 folded before Flop (didn't bet)





PokerStars Hand #148219804359:  Hold'em No Limit ($0.50/$1.00 USD) - 2016/02/04 15:34:46 CET [2016/02/04 9:34:46 ET]
Table 'Laverna II' 9-max Seat #3 is the button
Seat 2: sanpidk ($100 in chips) 
Seat 3: tipner ($100 in chips) 
Seat 5: Iozhek ($66.50 in chips) 
Seat 6: Mukhin1 ($103.48 in chips) 
Seat 7: Rafaello18 ($114.17 in chips) 
Seat 8: Dante63s ($101.50 in chips) 
Seat 9: matiko09 ($100 in chips) 
Iozhek: posts small blind $0.50
Mukhin1: posts big blind $1
*** HOLE CARDS ***
Dealt to matiko09 [9s Td]
Rafaello18: folds 
Dante63s: folds 
matiko09: folds 
sanpidk: folds 
tipner: raises $1.50 to $2.50
Iozhek: folds 
Mukhin1: calls $1.50
*** FLOP *** [2d Ad 4h]
Mukhin1: checks 
Venomous100% joins the table at seat #1 
tipner: checks 
*** TURN *** [2d Ad 4h] [6d]
Mukhin1: bets $3.88
tipner: calls $3.88
*** RIVER *** [2d Ad 4h 6d] [9d]
Mukhin1: checks 
tipner: bets $9
Mukhin1: folds 
Uncalled bet ($9) returned to tipner
tipner collected $12.66 from pot
tipner: doesn't show hand 
*** SUMMARY ***
Total pot $13.26 | Rake $0.60 
Board [2d Ad 4h 6d 9d]
Seat 2: sanpidk folded before Flop (didn't bet)
Seat 3: tipner (button) collected ($12.66)
Seat 5: Iozhek (small blind) folded before Flop
Seat 6: Mukhin1 (big blind) folded on the River
Seat 7: Rafaello18 folded before Flop (didn't bet)
Seat 8: Dante63s folded before Flop (didn't bet)
Seat 9: matiko09 folded before Flop (didn't bet)





PokerStars Hand #148219804712:  Hold'em No Limit ($0.50/$1.00 USD) - 2016/02/04 15:34:47 CET [2016/02/04 9:34:47 ET]
Table 'Siarnaq' 9-max Seat #5 is the button
Seat 1: sanpidk ($196.20 in chips) 
Seat 2: Igor DoUrden ($100 in chips) 
Seat 3: goblind4777 ($125.41 in chips) 
Seat 5: I The King I ($125.21 in chips) 
Seat 7: matiko09 ($100 in chips) 
Seat 8: maxxmeister ($100 in chips) 
Seat 9: TimStone ($104.50 in chips) 
Monsthand will be allowed to play after the button
matiko09: posts small blind $0.50
maxxmeister: posts big blind $1
*** HOLE CARDS ***
Dealt to matiko09 [Kh Qs]
TimStone: folds 
sanpidk: folds 
Igor DoUrden: folds 
goblind4777: folds 
I The King I: raises $1 to $2
matiko09: calls $1.50
maxxmeister: folds 
*** FLOP *** [4d 8d Jh]
matiko09: checks 
I The King I: checks 
*** TURN *** [4d 8d Jh] [8c]
matiko09: bets $3.11
I The King I: folds 
Uncalled bet ($3.11) returned to matiko09
matiko09 collected $4.78 from pot
matiko09: doesn't show hand 
*** SUMMARY ***
Total pot $5 | Rake $0.22 
Board [4d 8d Jh 8c]
Seat 1: sanpidk folded before Flop (didn't bet)
Seat 2: Igor DoUrden folded before Flop (didn't bet)
Seat 3: goblind4777 folded before Flop (didn't bet)
Seat 5: I The King I (button) folded on the Turn
Seat 7: matiko09 (small blind) collected ($4.78)
Seat 8: maxxmeister (big blind) folded before Flop
Seat 9: TimStone folded before Flop (didn't bet)





PokerStars Hand #148219814660:  Hold'em No Limit ($0.50/$1.00 USD) - 2016/02/04 15:35:00 CET [2016/02/04 9:35:00 ET]
Table 'Avior II' 9-max Seat #1 is the button
Seat 1: I The King I ($111.06 in chips) 
Seat 2: matiko09 ($100 in chips) 
Seat 3: sanpidk ($131.70 in chips) 
Seat 4: xxxZeka ($100 in chips) 
Seat 5: chaps1988 ($100 in chips) 
Seat 6: tipner ($219.47 in chips) 
Seat 8: EdHunder ($51.92 in chips) 
matiko09: posts small blind $0.50
sanpidk: posts big blind $1
Monsthand: sits out 
*** HOLE CARDS ***
Dealt to matiko09 [Ts 4d]
xxxZeka: folds 
chaps1988: folds 
tipner: folds 
EdHunder: folds 
I The King I: raises $1 to $2
matiko09: folds 
sanpidk: raises $5.50 to $7.50
I The King I: calls $5.50
*** FLOP *** [Kd 8d 8s]
sanpidk: bets $9
I The King I: folds 
Uncalled bet ($9) returned to sanpidk
sanpidk collected $14.80 from pot
sanpidk: doesn't show hand 
*** SUMMARY ***
Total pot $15.50 | Rake $0.70 
Board [Kd 8d 8s]
Seat 1: I The King I (button) folded on the Flop
Seat 2: matiko09 (small blind) folded before Flop
Seat 3: sanpidk (big blind) collected ($14.80)
Seat 4: xxxZeka folded before Flop (didn't bet)
Seat 5: chaps1988 folded before Flop (didn't bet)
Seat 6: tipner folded before Flop (didn't bet)
Seat 8: EdHunder folded before Flop (didn't bet)





PokerStars Hand #148219817638:  Hold'em No Limit ($0.50/$1.00 USD) - 2016/02/04 15:35:04 CET [2016/02/04 9:35:04 ET]
Table 'Dejan' 9-max Seat #1 is the button
Seat 1: matiko09 ($100 in chips) 
Seat 2: xxxZeka ($103.75 in chips) 
Seat 3: lumen21 ($106 in chips) 
Seat 4: pruxa72 ($120.81 in chips) 
Seat 5: Rafaello18 ($123.84 in chips) 
Seat 6: sanpidk ($249.88 in chips) 
Seat 7: mycka86 ($117.13 in chips) 
Seat 8: s26s ($96.73 in chips) 
Seat 9: I The King I ($126.42 in chips) 
xxxZeka: posts small blind $0.50
lumen21: posts big blind $1
*** HOLE CARDS ***
Dealt to matiko09 [Kd 5h]
pruxa72: raises $1 to $2
Rafaello18: folds 
sanpidk: folds 
mycka86: folds 
s26s: folds 
I The King I: folds 
matiko09: folds 
xxxZeka: folds 
lumen21: folds 
Uncalled bet ($1) returned to pruxa72
pruxa72 collected $2.50 from pot
pruxa72: doesn't show hand 
*** SUMMARY ***
Total pot $2.50 | Rake $0 
Seat 1: matiko09 (button) folded before Flop (didn't bet)
Seat 2: xxxZeka (small blind) folded before Flop
Seat 3: lumen21 (big blind) folded before Flop
Seat 4: pruxa72 collected ($2.50)
Seat 5: Rafaello18 folded before Flop (didn't bet)
Seat 6: sanpidk folded before Flop (didn't bet)
Seat 7: mycka86 folded before Flop (didn't bet)
Seat 8: s26s folded before Flop (didn't bet)
Seat 9: I The King I folded before Flop (didn't bet)





PokerStars Hand #148219828234:  Hold'em No Limit ($0.50/$1.00 USD) - 2016/02/04 15:35:19 CET [2016/02/04 9:35:19 ET]
Table 'Gutemberga' 9-max Seat #6 is the button
Seat 2: Rafaello18 ($100 in chips) 
Seat 3: Oligarhs4 ($66.87 in chips) 
Seat 4: scmastersrl ($123.48 in chips) 
Seat 5: nickreason17 ($129.35 in chips) 
Seat 6: I The King I ($113.81 in chips) 
Seat 7: mycka86 ($102.39 in chips) 
Seat 8: matiko09 ($100 in chips) 
Seat 9: xxxZeka ($100 in chips) 
mycka86: posts small blind $0.50
matiko09: posts big blind $1
RICKA16: sits out 
*** HOLE CARDS ***
Dealt to matiko09 [4c 6c]
xxxZeka: folds 
Rafaello18: folds 
Oligarhs4: folds 
scmastersrl: raises $2 to $3
nickreason17: folds 
I The King I: raises $5.87 to $8.87
mycka86: folds 
matiko09: folds 
scmastersrl: calls $5.87
*** FLOP *** [Qc 8h Jh]
scmastersrl: checks 
I The King I: checks 
*** TURN *** [Qc 8h Jh] [5s]
scmastersrl: bets $11
I The King I: folds 
Uncalled bet ($11) returned to scmastersrl
scmastersrl collected $18.37 from pot
*** SUMMARY ***
Total pot $19.24 | Rake $0.87 
Board [Qc 8h Jh 5s]
Seat 2: Rafaello18 folded before Flop (didn't bet)
Seat 3: Oligarhs4 folded before Flop (didn't bet)
Seat 4: scmastersrl collected ($18.37)
Seat 5: nickreason17 folded before Flop (didn't bet)
Seat 6: I The King I (button) folded on the Turn
Seat 7: mycka86 (small blind) folded before Flop
Seat 8: matiko09 (big blind) folded before Flop
Seat 9: xxxZeka folded before Flop (didn't bet)





PokerStars Hand #148219832034:  Hold'em No Limit ($0.50/$1.00 USD) - 2016/02/04 15:35:24 CET [2016/02/04 9:35:24 ET]
Table 'Mothallah' 9-max Seat #5 is the button
Seat 2: davianvalek ($127.70 in chips) 
Seat 3: ozone2003 ($130.27 in chips) 
Seat 4: YOUNG_G70 ($35.82 in chips) 
Seat 5: chaps1988 ($100 in chips) 
Seat 6: I The King I ($125.78 in chips) 
Seat 7: sanpidk ($107.42 in chips) 
Seat 8: Spid1 ($137.86 in chips) 
Seat 9: matiko09 ($100 in chips) 
I The King I: posts small blind $0.50
sanpidk: posts big blind $1
*** HOLE CARDS ***
Dealt to matiko09 [7s Ac]
Spid1: folds 
matiko09: folds 
davianvalek: folds 
ozone2003: folds 
YOUNG_G70: folds 
chaps1988: folds 
I The King I: folds 
Uncalled bet ($0.50) returned to sanpidk
sanpidk collected $1 from pot
sanpidk: doesn't show hand 
*** SUMMARY ***
Total pot $1 | Rake $0 
Seat 2: davianvalek folded before Flop (didn't bet)
Seat 3: ozone2003 folded before Flop (didn't bet)
Seat 4: YOUNG_G70 folded before Flop (didn't bet)
Seat 5: chaps1988 (button) folded before Flop (didn't bet)
Seat 6: I The King I (small blind) folded before Flop
Seat 7: sanpidk (big blind) collected ($1)
Seat 8: Spid1 folded before Flop (didn't bet)
Seat 9: matiko09 folded before Flop (didn't bet)





PokerStars Hand #148219832565:  Hold'em No Limit ($0.50/$1.00 USD) - 2016/02/04 15:35:25 CET [2016/02/04 9:35:25 ET]
Table 'Helio III' 9-max Seat #6 is the button
Seat 1: lixiangli ($80.80 in chips) 
Seat 2: mycka86 ($103.50 in chips) 
Seat 3: RICKA16 ($104.31 in chips) 
Seat 4: scmastersrl ($141.18 in chips) 
Seat 6: I The King I ($115.88 in chips) 
Seat 7: matiko09 ($106.50 in chips) 
Seat 8: nickreason17 ($100 in chips) 
matiko09: posts small blind $0.50
nickreason17: posts big blind $1
*** HOLE CARDS ***
Dealt to matiko09 [3c Ks]
lixiangli: raises $1.50 to $2.50
mycka86: folds 
RICKA16: folds 
scmastersrl: folds 
I The King I: folds 
matiko09: folds 
nickreason17: folds 
Uncalled bet ($1.50) returned to lixiangli
lixiangli collected $2.50 from pot
lixiangli: doesn't show hand 
*** SUMMARY ***
Total pot $2.50 | Rake $0 
Seat 1: lixiangli collected ($2.50)
Seat 2: mycka86 folded before Flop (didn't bet)
Seat 3: RICKA16 folded before Flop (didn't bet)
Seat 4: scmastersrl folded before Flop (didn't bet)
Seat 6: I The King I (button) folded before Flop (didn't bet)
Seat 7: matiko09 (small blind) folded before Flop
Seat 8: nickreason17 (big blind) folded before Flop





PokerStars Hand #148219835951:  Hold'em No Limit ($0.50/$1.00 USD) - 2016/02/04 15:35:29 CET [2016/02/04 9:35:29 ET]
Table 'Dejan' 9-max Seat #2 is the button
Seat 1: matiko09 ($100 in chips) 
Seat 2: xxxZeka ($103.25 in chips) 
Seat 3: lumen21 ($105 in chips) 
Seat 4: pruxa72 ($122.31 in chips) 
Seat 5: Rafaello18 ($123.84 in chips) 
Seat 6: sanpidk ($249.88 in chips) 
Seat 7: mycka86 ($117.13 in chips) 
Seat 8: s26s ($96.73 in chips) 
Seat 9: I The King I ($126.42 in chips) 
lumen21: posts small blind $0.50
pruxa72: posts big blind $1
*** HOLE CARDS ***
Dealt to matiko09 [8h 3c]
Rafaello18: folds 
sanpidk: folds 
mycka86: folds 
s26s: folds 
I The King I: folds 
matiko09: folds 
xxxZeka: folds 
lumen21: folds 
Uncalled bet ($0.50) returned to pruxa72
pruxa72 collected $1 from pot
pruxa72: doesn't show hand 
*** SUMMARY ***
Total pot $1 | Rake $0 
Seat 1: matiko09 folded before Flop (didn't bet)
Seat 2: xxxZeka (button) folded before Flop (didn't bet)
Seat 3: lumen21 (small blind) folded before Flop
Seat 4: pruxa72 (big blind) collected ($1)
Seat 5: Rafaello18 folded before Flop (didn't bet)
Seat 6: sanpidk folded before Flop (didn't bet)
Seat 7: mycka86 folded before Flop (didn't bet)
Seat 8: s26s folded before Flop (didn't bet)
Seat 9: I The King I folded before Flop (didn't bet)





PokerStars Hand #148219841202:  Hold'em No Limit ($0.50/$1.00 USD) - 2016/02/04 15:35:36 CET [2016/02/04 9:35:36 ET]
Table 'Mothallah' 9-max Seat #6 is the button
Seat 2: davianvalek ($127.70 in chips) 
Seat 3: ozone2003 ($130.27 in chips) 
Seat 4: YOUNG_G70 ($35.82 in chips) 
Seat 5: chaps1988 ($100 in chips) 
Seat 6: I The King I ($125.28 in chips) 
Seat 7: sanpidk ($107.92 in chips) 
Seat 8: Spid1 ($137.86 in chips) 
Seat 9: matiko09 ($100 in chips) 
sanpidk: posts small blind $0.50
Spid1: posts big blind $1
*** HOLE CARDS ***
Dealt to matiko09 [9s 5s]
matiko09: folds 
davianvalek: raises $1.50 to $2.50
ozone2003: folds 
YOUNG_G70: calls $2.50
chaps1988: folds 
I The King I: folds 
sanpidk: calls $2
Spid1: folds 
*** FLOP *** [Ah Tc As]
sanpidk: checks 
davianvalek: checks 
YOUNG_G70: bets $4
sanpidk: folds 
davianvalek: folds 
Uncalled bet ($4) returned to YOUNG_G70
YOUNG_G70 collected $8.12 from pot
YOUNG_G70: doesn't show hand 
*** SUMMARY ***
Total pot $8.50 | Rake $0.38 
Board [Ah Tc As]
Seat 2: davianvalek folded on the Flop
Seat 3: ozone2003 folded before Flop (didn't bet)
Seat 4: YOUNG_G70 collected ($8.12)
Seat 5: chaps1988 folded before Flop (didn't bet)
Seat 6: I The King I (button) folded before Flop (didn't bet)
Seat 7: sanpidk (small blind) folded on the Flop
Seat 8: Spid1 (big blind) folded before Flop
Seat 9: matiko09 folded before Flop (didn't bet)





PokerStars Hand #148219850745:  Hold'em No Limit ($0.50/$1.00 USD) - 2016/02/04 15:35:49 CET [2016/02/04 9:35:49 ET]
Table 'Siarnaq' 9-max Seat #7 is the button
Seat 2: Igor DoUrden ($100 in chips) 
Seat 3: goblind4777 ($125.41 in chips) 
Seat 5: I The King I ($123.21 in chips) 
Seat 7: matiko09 ($102.78 in chips) 
Seat 8: maxxmeister ($100 in chips) 
maxxmeister: posts small blind $0.50
TimStone: is sitting out 
TimStone leaves the table
sanpidk: is sitting out 
Igor DoUrden: posts big blind $1
Monsthand: sits out 
*** HOLE CARDS ***
Dealt to matiko09 [7c 9h]
sanpidk leaves the table
goblind4777: folds 
I The King I: raises $2 to $3
matiko09: folds 
maxxmeister: folds 
Igor DoUrden: folds 
Uncalled bet ($2) returned to I The King I
I The King I collected $2.50 from pot
I The King I: doesn't show hand 
*** SUMMARY ***
Total pot $2.50 | Rake $0 
Seat 2: Igor DoUrden (big blind) folded before Flop
Seat 3: goblind4777 folded before Flop (didn't bet)
Seat 5: I The King I collected ($2.50)
Seat 7: matiko09 (button) folded before Flop (didn't bet)
Seat 8: maxxmeister (small blind) folded before Flop





PokerStars Hand #148219852126:  Hold'em No Limit ($0.50/$1.00 USD) - 2016/02/04 15:35:51 CET [2016/02/04 9:35:51 ET]
Table 'Helio III' 9-max Seat #7 is the button
Seat 1: lixiangli ($82.30 in chips) 
Seat 2: mycka86 ($103.50 in chips) 
Seat 3: RICKA16 ($104.31 in chips) 
Seat 4: scmastersrl ($141.18 in chips) 
Seat 6: I The King I ($115.88 in chips) 
Seat 7: matiko09 ($106 in chips) 
Seat 8: nickreason17 ($100 in chips) 
nickreason17: posts small blind $0.50
lixiangli: posts big blind $1
*** HOLE CARDS ***
Dealt to matiko09 [6d 6c]
mycka86: folds 
RICKA16: folds 
scmastersrl: raises $2 to $3
I The King I: folds 
matiko09: calls $3
nickreason17: folds 
lixiangli: folds 
*** FLOP *** [3c Qd Jc]
scmastersrl: checks 
matiko09: checks 
*** TURN *** [3c Qd Jc] [5d]
scmastersrl: bets $4
matiko09: folds 
Uncalled bet ($4) returned to scmastersrl
scmastersrl collected $7.16 from pot
*** SUMMARY ***
Total pot $7.50 | Rake $0.34 
Board [3c Qd Jc 5d]
Seat 1: lixiangli (big blind) folded before Flop
Seat 2: mycka86 folded before Flop (didn't bet)
Seat 3: RICKA16 folded before Flop (didn't bet)
Seat 4: scmastersrl collected ($7.16)
Seat 6: I The King I folded before Flop (didn't bet)
Seat 7: matiko09 (button) folded on the Turn
Seat 8: nickreason17 (small blind) folded before Flop





PokerStars Hand #148219859762:  Hold'em No Limit ($0.50/$1.00 USD) - 2016/02/04 15:36:01 CET [2016/02/04 9:36:01 ET]
Table 'Isara' 9-max Seat #5 is the button
Seat 1: stojka 2015 ($72.82 in chips) 
Seat 2: davianvalek ($132.23 in chips) 
Seat 3: I The King I ($118.50 in chips) 
Seat 4: Dante63s ($112.49 in chips) 
Seat 5: Igor DoUrden ($100 in chips) 
Seat 7: warney1976 ($69.52 in chips) 
Seat 8: matiko09 ($100 in chips) 
Seat 9: chauyeuba ($86.87 in chips) 
warney1976: posts small blind $0.50
matiko09: posts big blind $1
*** HOLE CARDS ***
Dealt to matiko09 [5s 5d]
chauyeuba: folds 
stojka 2015: folds 
davianvalek: folds 
I The King I: folds 
Dante63s: folds 
Igor DoUrden: folds 
warney1976: raises $3 to $4
matiko09: calls $3
*** FLOP *** [2s Ts 6c]
warney1976: bets $7.64
matiko09: folds 
Uncalled bet ($7.64) returned to warney1976
warney1976 collected $7.64 from pot
*** SUMMARY ***
Total pot $8 | Rake $0.36 
Board [2s Ts 6c]
Seat 1: stojka 2015 folded before Flop (didn't bet)
Seat 2: davianvalek folded before Flop (didn't bet)
Seat 3: I The King I folded before Flop (didn't bet)
Seat 4: Dante63s folded before Flop (didn't bet)
Seat 5: Igor DoUrden (button) folded before Flop (didn't bet)
Seat 7: warney1976 (small blind) collected ($7.64)
Seat 8: matiko09 (big blind) folded on the Flop
Seat 9: chauyeuba folded before Flop (didn't bet)





PokerStars Hand #148219861143:  Hold'em No Limit ($0.50/$1.00 USD) - 2016/02/04 15:36:03 CET [2016/02/04 9:36:03 ET]
Table 'Laverna II' 9-max Seat #5 is the button
Seat 2: sanpidk ($100 in chips) 
Seat 3: tipner ($106.28 in chips) 
Seat 5: Iozhek ($66 in chips) 
Seat 6: Mukhin1 ($100 in chips) 
Seat 8: Dante63s ($101.50 in chips) 
Seat 9: matiko09 ($100 in chips) 
Mukhin1: posts small blind $0.50
Rafaello18: is sitting out 
Dante63s: posts big blind $1
Venomous100%: sits out 
*** HOLE CARDS ***
Dealt to matiko09 [Ks 2h]
matiko09: folds 
sanpidk: folds 
tipner: folds 
Iozhek: folds 
Mukhin1: raises $2 to $3
Dante63s: calls $2
*** FLOP *** [3s 3d 4h]
Mukhin1: bets $2.97
Dante63s: calls $2.97
*** TURN *** [3s 3d 4h] [Th]
Mukhin1: bets $7.29
Dante63s: folds 
Uncalled bet ($7.29) returned to Mukhin1
Mukhin1 collected $11.40 from pot
Mukhin1: doesn't show hand 
*** SUMMARY ***
Total pot $11.94 | Rake $0.54 
Board [3s 3d 4h Th]
Seat 2: sanpidk folded before Flop (didn't bet)
Seat 3: tipner folded before Flop (didn't bet)
Seat 5: Iozhek (button) folded before Flop (didn't bet)
Seat 6: Mukhin1 (small blind) collected ($11.40)
Seat 8: Dante63s (big blind) folded on the Turn
Seat 9: matiko09 folded before Flop (didn't bet)





PokerStars Hand #148219861459:  Hold'em No Limit ($0.50/$1.00 USD) - 2016/02/04 15:36:04 CET [2016/02/04 9:36:04 ET]
Table 'Arneb III' 9-max Seat #6 is the button
Seat 2: JeanLima93 ($183.94 in chips) 
Seat 3: matiko09 ($148.14 in chips) 
Seat 4: Igor DoUrden ($246.29 in chips) 
Seat 5: tipner ($135.02 in chips) 
Seat 6: nickreason17 ($102.11 in chips) 
Seat 7: xxxZeka ($100 in chips) 
Seat 8: volwebni4ek ($40 in chips) 
Seat 9: ARTVOR640 ($100 in chips) 
xxxZeka: posts small blind $0.50
volwebni4ek: posts big blind $1
sanpidk: sits out 
*** HOLE CARDS ***
Dealt to matiko09 [3h Td]
ARTVOR640: folds 
JeanLima93: calls $1
matiko09: folds 
Igor DoUrden: raises $3.50 to $4.50
tipner: folds 
nickreason17: folds 
xxxZeka: folds 
volwebni4ek: folds 
JeanLima93: folds 
Uncalled bet ($3.50) returned to Igor DoUrden
Igor DoUrden collected $3.50 from pot
Igor DoUrden: doesn't show hand 
*** SUMMARY ***
Total pot $3.50 | Rake $0 
Seat 2: JeanLima93 folded before Flop
Seat 3: matiko09 folded before Flop (didn't bet)
Seat 4: Igor DoUrden collected ($3.50)
Seat 5: tipner folded before Flop (didn't bet)
Seat 6: nickreason17 (button) folded before Flop (didn't bet)
Seat 7: xxxZeka (small blind) folded before Flop
Seat 8: volwebni4ek (big blind) folded before Flop
Seat 9: ARTVOR640 folded before Flop (didn't bet)





PokerStars Hand #148219863409:  Hold'em No Limit ($0.50/$1.00 USD) - 2016/02/04 15:36:06 CET [2016/02/04 9:36:06 ET]
Table 'Avior II' 9-max Seat #2 is the button
Seat 1: I The King I ($103.56 in chips) 
Seat 2: matiko09 ($100 in chips) 
Seat 3: sanpidk ($139 in chips) 
Seat 5: chaps1988 ($100 in chips) 
Seat 6: tipner ($219.47 in chips) 
Seat 8: EdHunder ($51.92 in chips) 
sanpidk: posts small blind $0.50
xxxZeka: is sitting out 
chaps1988: posts big blind $1
Monsthand: sits out 
Venomous100%: sits out 
*** HOLE CARDS ***
Dealt to matiko09 [Ks 2s]
xxxZeka leaves the table
tipner: folds 
EdHunder: folds 
I The King I: folds 
KLOP06031987 joins the table at seat #4 
matiko09: raises $1.27 to $2.27
sanpidk: folds 
chaps1988: folds 
Uncalled bet ($1.27) returned to matiko09
matiko09 collected $2.50 from pot
matiko09: doesn't show hand 
*** SUMMARY ***
Total pot $2.50 | Rake $0 
Seat 1: I The King I folded before Flop (didn't bet)
Seat 2: matiko09 (button) collected ($2.50)
Seat 3: sanpidk (small blind) folded before Flop
Seat 5: chaps1988 (big blind) folded before Flop
Seat 6: tipner folded before Flop (didn't bet)
Seat 8: EdHunder folded before Flop (didn't bet)





PokerStars Hand #148219863847:  Hold'em No Limit ($0.50/$1.00 USD) - 2016/02/04 15:36:07 CET [2016/02/04 9:36:07 ET]
Table 'Siarnaq' 9-max Seat #8 is the button
Seat 2: Igor DoUrden ($100 in chips) 
Seat 3: goblind4777 ($125.41 in chips) 
Seat 5: I The King I ($124.71 in chips) 
Seat 7: matiko09 ($102.78 in chips) 
Seat 8: maxxmeister ($100 in chips) 
Igor DoUrden: posts small blind $0.50
goblind4777: posts big blind $1
Monsthand: sits out 
*** HOLE CARDS ***
Dealt to matiko09 [6s As]
I The King I: folds 
matiko09: raises $1.50 to $2.50
maxxmeister: folds 
Igor DoUrden: folds 
goblind4777: folds 
Uncalled bet ($1.50) returned to matiko09
matiko09 collected $2.50 from pot
matiko09: doesn't show hand 
*** SUMMARY ***
Total pot $2.50 | Rake $0 
Seat 2: Igor DoUrden (small blind) folded before Flop
Seat 3: goblind4777 (big blind) folded before Flop
Seat 5: I The King I folded before Flop (didn't bet)
Seat 7: matiko09 collected ($2.50)
Seat 8: maxxmeister (button) folded before Flop (didn't bet)





PokerStars Hand #148219867162:  Hold'em No Limit ($0.50/$1.00 USD) - 2016/02/04 15:36:11 CET [2016/02/04 9:36:11 ET]
Table 'Dejan' 9-max Seat #3 is the button
Seat 1: matiko09 ($100 in chips) 
Seat 2: xxxZeka ($103.25 in chips) 
Seat 3: lumen21 ($104.50 in chips) 
Seat 4: pruxa72 ($122.81 in chips) 
Seat 6: sanpidk ($249.88 in chips) 
Seat 7: mycka86 ($117.13 in chips) 
Seat 8: s26s ($96.73 in chips) 
Seat 9: I The King I ($126.42 in chips) 
pruxa72: posts small blind $0.50
Rafaello18: is sitting out 
sanpidk: posts big blind $1
*** HOLE CARDS ***
Dealt to matiko09 [7d 3h]
mycka86: folds 
s26s: folds 
I The King I: raises $2 to $3
matiko09: folds 
xxxZeka: folds 
lumen21: folds 
pruxa72: calls $2.50
sanpidk: folds 
*** FLOP *** [Ks Ah 7c]
pruxa72: checks 
I The King I: checks 
*** TURN *** [Ks Ah 7c] [Qs]
pruxa72: bets $3.34
I The King I: folds 
Uncalled bet ($3.34) returned to pruxa72
pruxa72 collected $6.68 from pot
pruxa72: doesn't show hand 
*** SUMMARY ***
Total pot $7 | Rake $0.32 
Board [Ks Ah 7c Qs]
Seat 1: matiko09 folded before Flop (didn't bet)
Seat 2: xxxZeka folded before Flop (didn't bet)
Seat 3: lumen21 (button) folded before Flop (didn't bet)
Seat 4: pruxa72 (small blind) collected ($6.68)
Seat 6: sanpidk (big blind) folded before Flop
Seat 7: mycka86 folded before Flop (didn't bet)
Seat 8: s26s folded before Flop (didn't bet)
Seat 9: I The King I folded on the Turn





PokerStars Hand #148219867289:  Hold'em No Limit ($0.50/$1.00 USD) - 2016/02/04 15:36:11 CET [2016/02/04 9:36:11 ET]
Table 'Gutemberga' 9-max Seat #7 is the button
Seat 2: Rafaello18 ($100 in chips) 
Seat 3: Oligarhs4 ($66.87 in chips) 
Seat 4: scmastersrl ($132.98 in chips) 
Seat 5: nickreason17 ($129.35 in chips) 
Seat 6: I The King I ($104.94 in chips) 
Seat 7: mycka86 ($101.89 in chips) 
Seat 8: matiko09 ($100 in chips) 
Seat 9: xxxZeka ($100 in chips) 
matiko09: posts small blind $0.50
xxxZeka: posts big blind $1
*** HOLE CARDS ***
Dealt to matiko09 [8s 4d]
Rafaello18: folds 
Oligarhs4: folds 
scmastersrl: folds 
nickreason17: raises $2 to $3
I The King I: folds 
mycka86: folds 
matiko09: folds 
xxxZeka: folds 
Uncalled bet ($2) returned to nickreason17
nickreason17 collected $2.50 from pot
*** SUMMARY ***
Total pot $2.50 | Rake $0 
Seat 2: Rafaello18 folded before Flop (didn't bet)
Seat 3: Oligarhs4 folded before Flop (didn't bet)
Seat 4: scmastersrl folded before Flop (didn't bet)
Seat 5: nickreason17 collected ($2.50)
Seat 6: I The King I folded before Flop (didn't bet)
Seat 7: mycka86 (button) folded before Flop (didn't bet)
Seat 8: matiko09 (small blind) folded before Flop
Seat 9: xxxZeka (big blind) folded before Flop





PokerStars Hand #148219877301:  Hold'em No Limit ($0.50/$1.00 USD) - 2016/02/04 15:36:25 CET [2016/02/04 9:36:25 ET]
Table 'Siarnaq' 9-max Seat #2 is the button
Seat 2: Igor DoUrden ($100 in chips) 
Seat 3: goblind4777 ($124.41 in chips) 
Seat 5: I The King I ($124.71 in chips) 
Seat 7: matiko09 ($104.28 in chips) 
Seat 8: maxxmeister ($100 in chips) 
goblind4777: posts small blind $0.50
I The King I: posts big blind $1
Monsthand: sits out 
*** HOLE CARDS ***
Dealt to matiko09 [8c 2d]
matiko09: folds 
maxxmeister: folds 
edusavord joins the table at seat #9 
flozzi joins the table at seat #1 
Spid1 joins the table at seat #4 
Igor DoUrden: raises $1.09 to $2.09
goblind4777: folds 
I The King I: folds 
Uncalled bet ($1.09) returned to Igor DoUrden
Igor DoUrden collected $2.50 from pot
Igor DoUrden: doesn't show hand 
*** SUMMARY ***
Total pot $2.50 | Rake $0 
Seat 2: Igor DoUrden (button) collected ($2.50)
Seat 3: goblind4777 (small blind) folded before Flop
Seat 5: I The King I (big blind) folded before Flop
Seat 7: matiko09 folded before Flop (didn't bet)
Seat 8: maxxmeister folded before Flop (didn't bet)





PokerStars Hand #148219878214:  Hold'em No Limit ($0.50/$1.00 USD) - 2016/02/04 15:36:26 CET [2016/02/04 9:36:26 ET]
Table 'Avior II' 9-max Seat #3 is the button
Seat 1: I The King I ($103.56 in chips) 
Seat 2: matiko09 ($101.50 in chips) 
Seat 3: sanpidk ($138.50 in chips) 
Seat 5: chaps1988 ($100 in chips) 
Seat 6: tipner ($219.47 in chips) 
Seat 8: EdHunder ($51.92 in chips) 
chaps1988: posts small blind $0.50
tipner: posts big blind $1
Monsthand: sits out 
Venomous100%: sits out 
*** HOLE CARDS ***
Dealt to matiko09 [Td 4c]
EdHunder: folds 
I The King I: folds 
matiko09: folds 
sanpidk: raises $1.24 to $2.24
chaps1988: folds 
tipner: folds 
Uncalled bet ($1.24) returned to sanpidk
sanpidk collected $2.50 from pot
sanpidk: doesn't show hand 
*** SUMMARY ***
Total pot $2.50 | Rake $0 
Seat 1: I The King I folded before Flop (didn't bet)
Seat 2: matiko09 folded before Flop (didn't bet)
Seat 3: sanpidk (button) collected ($2.50)
Seat 5: chaps1988 (small blind) folded before Flop
Seat 6: tipner (big blind) folded before Flop
Seat 8: EdHunder folded before Flop (didn't bet)





PokerStars Hand #148219886057:  Hold'em No Limit ($0.50/$1.00 USD) - 2016/02/04 15:36:36 CET [2016/02/04 9:36:36 ET]
Table 'Arneb II' 9-max Seat #9 is the button
Seat 1: matiko09 ($104.38 in chips) 
Seat 2: sanpidk ($218.46 in chips) 
Seat 3: brille-390 ($148.02 in chips) 
Seat 4: Venomous100% ($100 in chips) 
Seat 5: lixiangli ($74.87 in chips) 
Seat 6: volwebni4ek ($80.45 in chips) 
Seat 7: melitakas ($285.92 in chips) 
Seat 8: tedbadger9 ($35.37 in chips) 
Seat 9: tipner ($108.17 in chips) 
matiko09: posts small blind $0.50
sanpidk: posts big blind $1
*** HOLE CARDS ***
Dealt to matiko09 [6c 2c]
brille-390: folds 
tedbadger9 said, "bluff"
Venomous100%: raises $2 to $3
lixiangli: folds 
volwebni4ek: calls $3
melitakas: folds 
tedbadger9: folds 
tipner: folds 
matiko09: folds 
sanpidk: folds 
*** FLOP *** [8s 7d Jd]
Venomous100%: bets $4.77
volwebni4ek: folds 
Uncalled bet ($4.77) returned to Venomous100%
Venomous100% collected $7.16 from pot
Venomous100%: doesn't show hand 
*** SUMMARY ***
Total pot $7.50 | Rake $0.34 
Board [8s 7d Jd]
Seat 1: matiko09 (small blind) folded before Flop
Seat 2: sanpidk (big blind) folded before Flop
Seat 3: brille-390 folded before Flop (didn't bet)
Seat 4: Venomous100% collected ($7.16)
Seat 5: lixiangli folded before Flop (didn't bet)
Seat 6: volwebni4ek folded on the Flop
Seat 7: melitakas folded before Flop (didn't bet)
Seat 8: tedbadger9 folded before Flop (didn't bet)
Seat 9: tipner (button) folded before Flop (didn't bet)





PokerStars Hand #148219887131:  Hold'em No Limit ($0.50/$1.00 USD) - 2016/02/04 15:36:38 CET [2016/02/04 9:36:38 ET]
Table 'Mothallah' 9-max Seat #7 is the button
Seat 2: davianvalek ($125.20 in chips) 
Seat 3: ozone2003 ($130.27 in chips) 
Seat 4: YOUNG_G70 ($41.44 in chips) 
Seat 5: chaps1988 ($100 in chips) 
Seat 6: I The King I ($125.28 in chips) 
Seat 7: sanpidk ($105.42 in chips) 
Seat 8: Spid1 ($136.86 in chips) 
Seat 9: matiko09 ($100 in chips) 
Spid1: posts small blind $0.50
matiko09: posts big blind $1
*** HOLE CARDS ***
Dealt to matiko09 [Qh 8h]
davianvalek: folds 
ozone2003: folds 
YOUNG_G70: calls $1
chaps1988: folds 
I The King I: folds 
sanpidk: folds 
Spid1: raises $3 to $4
matiko09: folds 
YOUNG_G70: raises $12 to $16
Spid1: folds 
Uncalled bet ($12) returned to YOUNG_G70
YOUNG_G70 collected $9 from pot
YOUNG_G70: doesn't show hand 
*** SUMMARY ***
Total pot $9 | Rake $0 
Seat 2: davianvalek folded before Flop (didn't bet)
Seat 3: ozone2003 folded before Flop (didn't bet)
Seat 4: YOUNG_G70 collected ($9)
Seat 5: chaps1988 folded before Flop (didn't bet)
Seat 6: I The King I folded before Flop (didn't bet)
Seat 7: sanpidk (button) folded before Flop (didn't bet)
Seat 8: Spid1 (small blind) folded before Flop
Seat 9: matiko09 (big blind) folded before Flop





PokerStars Hand #148219889252:  Hold'em No Limit ($0.50/$1.00 USD) - 2016/02/04 15:36:41 CET [2016/02/04 9:36:41 ET]
Table 'Helio III' 9-max Seat #8 is the button
Seat 1: lixiangli ($81.30 in chips) 
Seat 4: scmastersrl ($145.34 in chips) 
Seat 6: I The King I ($115.88 in chips) 
Seat 7: matiko09 ($103 in chips) 
Seat 8: nickreason17 ($100 in chips) 
lixiangli: posts small blind $0.50
mycka86: is sitting out 
RICKA16: is sitting out 
scmastersrl: posts big blind $1
*** HOLE CARDS ***
Dealt to matiko09 [Tc 5c]
I The King I: folds 
matiko09: folds 
nickreason17: raises $1.04 to $2.04
lixiangli: folds 
scmastersrl: raises $6.04 to $8.08
nickreason17: calls $6.04
*** FLOP *** [6s 5d 7d]
scmastersrl: bets $12
nickreason17: raises $79.92 to $91.92 and is all-in
scmastersrl: folds 
Uncalled bet ($79.92) returned to nickreason17
nickreason17 collected $38.83 from pot
*** SUMMARY ***
Total pot $40.66 | Rake $1.83 
Board [6s 5d 7d]
Seat 1: lixiangli (small blind) folded before Flop
Seat 4: scmastersrl (big blind) folded on the Flop
Seat 6: I The King I folded before Flop (didn't bet)
Seat 7: matiko09 folded before Flop (didn't bet)
Seat 8: nickreason17 (button) collected ($38.83)





PokerStars Hand #148219889372:  Hold'em No Limit ($0.50/$1.00 USD) - 2016/02/04 15:36:41 CET [2016/02/04 9:36:41 ET]
Table 'Gutemberga' 9-max Seat #8 is the button
Seat 3: Oligarhs4 ($66.87 in chips) 
Seat 4: scmastersrl ($132.98 in chips) 
Seat 5: nickreason17 ($130.85 in chips) 
Seat 6: I The King I ($104.94 in chips) 
Seat 7: mycka86 ($101.89 in chips) 
Seat 8: matiko09 ($100 in chips) 
Seat 9: xxxZeka ($100 in chips) 
xxxZeka: posts small blind $0.50
Rafaello18: is sitting out 
Oligarhs4: posts big blind $1
*** HOLE CARDS ***
Dealt to matiko09 [2d 4s]
scmastersrl: raises $2 to $3
nickreason17: folds 
I The King I: folds 
mycka86: folds 
matiko09: folds 
xxxZeka: folds 
Oligarhs4: folds 
Uncalled bet ($2) returned to scmastersrl
scmastersrl collected $2.50 from pot
*** SUMMARY ***
Total pot $2.50 | Rake $0 
Seat 3: Oligarhs4 (big blind) folded before Flop
Seat 4: scmastersrl collected ($2.50)
Seat 5: nickreason17 folded before Flop (didn't bet)
Seat 6: I The King I folded before Flop (didn't bet)
Seat 7: mycka86 folded before Flop (didn't bet)
Seat 8: matiko09 (button) folded before Flop (didn't bet)
Seat 9: xxxZeka (small blind) folded before Flop





PokerStars Hand #148219891430:  Hold'em No Limit ($0.50/$1.00 USD) - 2016/02/04 15:36:44 CET [2016/02/04 9:36:44 ET]
Table 'Isara' 9-max Seat #7 is the button
Seat 1: stojka 2015 ($72.82 in chips) 
Seat 2: davianvalek ($132.23 in chips) 
Seat 3: I The King I ($118.50 in chips) 
Seat 4: Dante63s ($112.49 in chips) 
Seat 5: Igor DoUrden ($100 in chips) 
Seat 7: warney1976 ($73.16 in chips) 
Seat 8: matiko09 ($100 in chips) 
Seat 9: chauyeuba ($86.87 in chips) 
matiko09: posts small blind $0.50
chauyeuba: posts big blind $1
*** HOLE CARDS ***
Dealt to matiko09 [As 5d]
stojka 2015: folds 
stojka 2015 leaves the table
IseeUcards joins the table at seat #1 
IseeUcards leaves the table
davianvalek: folds 
I The King I: folds 
Dante63s: folds 
KLOP06031987 joins the table at seat #1 
Igor DoUrden: folds 
warney1976: raises $2 to $3
matiko09: folds 
chauyeuba: folds 
Uncalled bet ($2) returned to warney1976
warney1976 collected $2.50 from pot
*** SUMMARY ***
Total pot $2.50 | Rake $0 
Seat 1: stojka 2015 folded before Flop (didn't bet)
Seat 2: davianvalek folded before Flop (didn't bet)
Seat 3: I The King I folded before Flop (didn't bet)
Seat 4: Dante63s folded before Flop (didn't bet)
Seat 5: Igor DoUrden folded before Flop (didn't bet)
Seat 7: warney1976 (button) collected ($2.50)
Seat 8: matiko09 (small blind) folded before Flop
Seat 9: chauyeuba (big blind) folded before Flop





PokerStars Hand #148219897112:  Hold'em No Limit ($0.50/$1.00 USD) - 2016/02/04 15:36:51 CET [2016/02/04 9:36:51 ET]
Table 'Siarnaq' 9-max Seat #3 is the button
Seat 2: Igor DoUrden ($101.50 in chips) 
Seat 3: goblind4777 ($123.91 in chips) 
Seat 5: I The King I ($123.71 in chips) 
Seat 6: Monsthand ($100 in chips) 
Seat 7: matiko09 ($104.28 in chips) 
Seat 8: maxxmeister ($100 in chips) 
Spid1 will be allowed to play after the button
I The King I: posts small blind $0.50
Monsthand: posts big blind $1
edusavord: sits out 
flozzi: sits out 
*** HOLE CARDS ***
Dealt to matiko09 [6s 2c]
matiko09: folds 
maxxmeister: raises $2 to $3
edusavord leaves the table
Igor DoUrden: folds 
goblind4777: calls $3
I The King I: folds 
Monsthand: folds 
*** FLOP *** [8s Th Qh]
maxxmeister: bets $4
goblind4777: folds 
Uncalled bet ($4) returned to maxxmeister
maxxmeister collected $7.16 from pot
maxxmeister: doesn't show hand 
*** SUMMARY ***
Total pot $7.50 | Rake $0.34 
Board [8s Th Qh]
Seat 2: Igor DoUrden folded before Flop (didn't bet)
Seat 3: goblind4777 (button) folded on the Flop
Seat 5: I The King I (small blind) folded before Flop
Seat 6: Monsthand (big blind) folded before Flop
Seat 7: matiko09 folded before Flop (didn't bet)
Seat 8: maxxmeister collected ($7.16)





PokerStars Hand #148219900921:  Hold'em No Limit ($0.50/$1.00 USD) - 2016/02/04 15:36:57 CET [2016/02/04 9:36:57 ET]
Table 'Arneb III' 9-max Seat #7 is the button
Seat 2: JeanLima93 ($182.94 in chips) 
Seat 3: matiko09 ($148.14 in chips) 
Seat 4: Igor DoUrden ($248.79 in chips) 
Seat 5: tipner ($135.02 in chips) 
Seat 6: nickreason17 ($102.11 in chips) 
Seat 7: xxxZeka ($100 in chips) 
Seat 8: volwebni4ek ($40 in chips) 
Seat 9: ARTVOR640 ($100 in chips) 
volwebni4ek: posts small blind $0.50
ARTVOR640: posts big blind $1
sanpidk: sits out 
*** HOLE CARDS ***
Dealt to matiko09 [9c 5c]
JeanLima93: folds 
matiko09: folds 
Igor DoUrden: folds 
tipner: folds 
nickreason17: raises $1.50 to $2.50
xxxZeka: folds 
volwebni4ek: raises $5 to $7.50
ARTVOR640: folds 
nickreason17: folds 
Uncalled bet ($5) returned to volwebni4ek
volwebni4ek collected $6 from pot
volwebni4ek: doesn't show hand 
*** SUMMARY ***
Total pot $6 | Rake $0 
Seat 2: JeanLima93 folded before Flop (didn't bet)
Seat 3: matiko09 folded before Flop (didn't bet)
Seat 4: Igor DoUrden folded before Flop (didn't bet)
Seat 5: tipner folded before Flop (didn't bet)
Seat 6: nickreason17 folded before Flop
Seat 7: xxxZeka (button) folded before Flop (didn't bet)
Seat 8: volwebni4ek (small blind) collected ($6)
Seat 9: ARTVOR640 (big blind) folded before Flop





PokerStars Hand #148219906734:  Hold'em No Limit ($0.50/$1.00 USD) - 2016/02/04 15:37:04 CET [2016/02/04 9:37:04 ET]
Table 'Avior II' 9-max Seat #5 is the button
Seat 1: I The King I ($103.56 in chips) 
Seat 2: matiko09 ($101.50 in chips) 
Seat 3: sanpidk ($140 in chips) 
Seat 5: chaps1988 ($100 in chips) 
Seat 6: tipner ($218.47 in chips) 
Seat 7: Monsthand ($100 in chips) 
Seat 8: EdHunder ($51.92 in chips) 
tipner: posts small blind $0.50
Monsthand: posts big blind $1
Venomous100%: sits out 
*** HOLE CARDS ***
Dealt to matiko09 [Td 4c]
EdHunder: raises $2 to $3
KLOP06031987 leaves the table
I The King I: raises $5.87 to $8.87
matiko09: folds 
sanpidk: folds 
chaps1988: folds 
tipner: folds 
Monsthand: folds 
EdHunder: calls $5.87
*** FLOP *** [7s Ks Tc]
EdHunder: checks 
I The King I: checks 
*** TURN *** [7s Ks Tc] [3h]
EdHunder: bets $15
I The King I: calls $15
*** RIVER *** [7s Ks Tc 3h] [Th]
EdHunder: bets $28.05 and is all-in
I The King I: calls $28.05
*** SHOW DOWN ***
EdHunder: shows [Ah Kd] (two pair, Kings and Tens)
I The King I: shows [Qd Qs] (two pair, Queens and Tens)
EdHunder collected $102.54 from pot
KLOP06031987 joins the table at seat #4 
*** SUMMARY ***
Total pot $105.34 | Rake $2.80 
Board [7s Ks Tc 3h Th]
Seat 1: I The King I showed [Qd Qs] and lost with two pair, Queens and Tens
Seat 2: matiko09 folded before Flop (didn't bet)
Seat 3: sanpidk folded before Flop (didn't bet)
Seat 5: chaps1988 (button) folded before Flop (didn't bet)
Seat 6: tipner (small blind) folded before Flop
Seat 7: Monsthand (big blind) folded before Flop
Seat 8: EdHunder showed [Ah Kd] and won ($102.54) with two pair, Kings and Tens





PokerStars Hand #148219907976:  Hold'em No Limit ($0.50/$1.00 USD) - 2016/02/04 15:37:06 CET [2016/02/04 9:37:06 ET]
Table 'Gutemberga' 9-max Seat #9 is the button
Seat 3: Oligarhs4 ($65.87 in chips) 
Seat 4: scmastersrl ($134.48 in chips) 
Seat 5: nickreason17 ($130.85 in chips) 
Seat 6: I The King I ($104.94 in chips) 
Seat 7: mycka86 ($101.89 in chips) 
Seat 8: matiko09 ($100 in chips) 
Seat 9: xxxZeka ($100 in chips) 
Oligarhs4: posts small blind $0.50
scmastersrl: posts big blind $1
*** HOLE CARDS ***
Dealt to matiko09 [Ad 2d]
nickreason17: folds 
nickreason17 leaves the table
I The King I: folds 
mycka86: folds 
KLOP06031987 joins the table at seat #5 
matiko09: raises $1.50 to $2.50
xxxZeka: folds 
Oligarhs4: folds 
scmastersrl: folds 
Uncalled bet ($1.50) returned to matiko09
matiko09 collected $2.50 from pot
matiko09: doesn't show hand 
*** SUMMARY ***
Total pot $2.50 | Rake $0 
Seat 3: Oligarhs4 (small blind) folded before Flop
Seat 4: scmastersrl (big blind) folded before Flop
Seat 5: nickreason17 folded before Flop (didn't bet)
Seat 6: I The King I folded before Flop (didn't bet)
Seat 7: mycka86 folded before Flop (didn't bet)
Seat 8: matiko09 collected ($2.50)
Seat 9: xxxZeka (button) folded before Flop (didn't bet)





PokerStars Hand #148219910770:  Hold'em No Limit ($0.50/$1.00 USD) - 2016/02/04 15:37:10 CET [2016/02/04 9:37:10 ET]
Table 'Dejan' 9-max Seat #4 is the button
Seat 1: matiko09 ($100 in chips) 
Seat 2: xxxZeka ($103.25 in chips) 
Seat 3: lumen21 ($104.50 in chips) 
Seat 4: pruxa72 ($126.49 in chips) 
Seat 6: sanpidk ($248.88 in chips) 
Seat 8: s26s ($96.73 in chips) 
Seat 9: I The King I ($123.42 in chips) 
sanpidk: posts small blind $0.50
mycka86: is sitting out 
s26s: posts big blind $1
*** HOLE CARDS ***
Dealt to matiko09 [Qs 4h]
I The King I: folds 
matiko09: folds 
xxxZeka: folds 
lumen21: raises $1.50 to $2.50
pruxa72: calls $2.50
sanpidk: folds 
s26s: calls $1.50
*** FLOP *** [6s Td Js]
s26s: checks 
lumen21: checks 
pruxa72: checks 
*** TURN *** [6s Td Js] [Tc]
s26s: bets $7.64
lumen21: folds 
pruxa72: folds 
Uncalled bet ($7.64) returned to s26s
s26s collected $7.64 from pot
*** SUMMARY ***
Total pot $8 | Rake $0.36 
Board [6s Td Js Tc]
Seat 1: matiko09 folded before Flop (didn't bet)
Seat 2: xxxZeka folded before Flop (didn't bet)
Seat 3: lumen21 folded on the Turn
Seat 4: pruxa72 (button) folded on the Turn
Seat 6: sanpidk (small blind) folded before Flop
Seat 8: s26s (big blind) collected ($7.64)
Seat 9: I The King I folded before Flop (didn't bet)





PokerStars Hand #148219913151:  Hold'em No Limit ($0.50/$1.00 USD) - 2016/02/04 15:37:13 CET [2016/02/04 9:37:13 ET]
Table 'Isara' 9-max Seat #8 is the button
Seat 1: KLOP06031987 ($100 in chips) 
Seat 2: davianvalek ($132.23 in chips) 
Seat 3: I The King I ($118.50 in chips) 
Seat 4: Dante63s ($112.49 in chips) 
Seat 5: Igor DoUrden ($100 in chips) 
Seat 7: warney1976 ($74.66 in chips) 
Seat 8: matiko09 ($100 in chips) 
Seat 9: chauyeuba ($85.87 in chips) 
chauyeuba: posts small blind $0.50
KLOP06031987: posts big blind $1
*** HOLE CARDS ***
Dealt to matiko09 [7d Kd]
davianvalek: folds 
I The King I: folds 
Dante63s: raises $1.50 to $2.50
Igor DoUrden: folds 
warney1976: calls $2.50
matiko09: folds 
chauyeuba: folds 
KLOP06031987: folds 
*** FLOP *** [5s 2h 5h]
Dante63s: checks 
warney1976: bets $3
Dante63s: folds 
Uncalled bet ($3) returned to warney1976
warney1976 collected $6.21 from pot
*** SUMMARY ***
Total pot $6.50 | Rake $0.29 
Board [5s 2h 5h]
Seat 1: KLOP06031987 (big blind) folded before Flop
Seat 2: davianvalek folded before Flop (didn't bet)
Seat 3: I The King I folded before Flop (didn't bet)
Seat 4: Dante63s folded on the Flop
Seat 5: Igor DoUrden folded before Flop (didn't bet)
Seat 7: warney1976 collected ($6.21)
Seat 8: matiko09 (button) folded before Flop (didn't bet)
Seat 9: chauyeuba (small blind) folded before Flop





PokerStars Hand #148219913921:  Hold'em No Limit ($0.50/$1.00 USD) - 2016/02/04 15:37:14 CET [2016/02/04 9:37:14 ET]
Table 'Mothallah' 9-max Seat #8 is the button
Seat 2: davianvalek ($125.20 in chips) 
Seat 3: ozone2003 ($130.27 in chips) 
Seat 4: YOUNG_G70 ($46.44 in chips) 
Seat 5: chaps1988 ($100 in chips) 
Seat 6: I The King I ($125.28 in chips) 
Seat 7: sanpidk ($105.42 in chips) 
Seat 8: Spid1 ($132.86 in chips) 
Seat 9: matiko09 ($100 in chips) 
matiko09: posts small blind $0.50
davianvalek: posts big blind $1
*** HOLE CARDS ***
Dealt to matiko09 [Jh 7c]
ozone2003: folds 
YOUNG_G70: calls $1
chaps1988: folds 
I The King I: folds 
sanpidk: raises $3 to $4
Spid1: folds 
matiko09: folds 
davianvalek: folds 
YOUNG_G70: raises $42.44 to $46.44 and is all-in
sanpidk: folds 
Uncalled bet ($42.44) returned to YOUNG_G70
YOUNG_G70 collected $9.50 from pot
YOUNG_G70: doesn't show hand 
*** SUMMARY ***
Total pot $9.50 | Rake $0 
Seat 2: davianvalek (big blind) folded before Flop
Seat 3: ozone2003 folded before Flop (didn't bet)
Seat 4: YOUNG_G70 collected ($9.50)
Seat 5: chaps1988 folded before Flop (didn't bet)
Seat 6: I The King I folded before Flop (didn't bet)
Seat 7: sanpidk folded before Flop
Seat 8: Spid1 (button) folded before Flop (didn't bet)
Seat 9: matiko09 (small blind) folded before Flop





PokerStars Hand #148219918463:  Hold'em No Limit ($0.50/$1.00 USD) - 2016/02/04 15:37:20 CET [2016/02/04 9:37:20 ET]
Table 'Helio III' 9-max Seat #1 is the button
Seat 1: lixiangli ($80.80 in chips) 
Seat 4: scmastersrl ($125.26 in chips) 
Seat 6: I The King I ($115.88 in chips) 
Seat 7: matiko09 ($103 in chips) 
Seat 8: nickreason17 ($118.75 in chips) 
scmastersrl: posts small blind $0.50
I The King I: posts big blind $1
*** HOLE CARDS ***
Dealt to matiko09 [Kh 4h]
matiko09: folds 
nickreason17: folds 
lixiangli: raises $1.50 to $2.50
scmastersrl: folds 
I The King I: calls $1.50
*** FLOP *** [Ts 3s Ad]
I The King I: bets $4
lixiangli: raises $8 to $12
I The King I: folds 
Uncalled bet ($8) returned to lixiangli
lixiangli collected $12.89 from pot
lixiangli: doesn't show hand 
*** SUMMARY ***
Total pot $13.50 | Rake $0.61 
Board [Ts 3s Ad]
Seat 1: lixiangli (button) collected ($12.89)
Seat 4: scmastersrl (small blind) folded before Flop
Seat 6: I The King I (big blind) folded on the Flop
Seat 7: matiko09 folded before Flop (didn't bet)
Seat 8: nickreason17 folded before Flop (didn't bet)





PokerStars Hand #148219927407:  Hold'em No Limit ($0.50/$1.00 USD) - 2016/02/04 15:37:32 CET [2016/02/04 9:37:32 ET]
Table 'Gutemberga' 9-max Seat #3 is the button
Seat 3: Oligarhs4 ($65.37 in chips) 
Seat 4: scmastersrl ($133.48 in chips) 
Seat 6: I The King I ($104.94 in chips) 
Seat 7: mycka86 ($101.89 in chips) 
Seat 8: matiko09 ($101.50 in chips) 
Seat 9: xxxZeka ($100 in chips) 
scmastersrl: posts small blind $0.50
I The King I: posts big blind $1
*** HOLE CARDS ***
Dealt to matiko09 [5d Kc]
mycka86: folds 
matiko09: folds 
xxxZeka: folds 
Oligarhs4: raises $2 to $3
scmastersrl: folds 
I The King I: folds 
Uncalled bet ($2) returned to Oligarhs4
Oligarhs4 collected $2.50 from pot
Oligarhs4: doesn't show hand 
*** SUMMARY ***
Total pot $2.50 | Rake $0 
Seat 3: Oligarhs4 (button) collected ($2.50)
Seat 4: scmastersrl (small blind) folded before Flop
Seat 6: I The King I (big blind) folded before Flop
Seat 7: mycka86 folded before Flop (didn't bet)
Seat 8: matiko09 folded before Flop (didn't bet)
Seat 9: xxxZeka folded before Flop (didn't bet)





PokerStars Hand #148219928870:  Hold'em No Limit ($0.50/$1.00 USD) - 2016/02/04 15:37:34 CET [2016/02/04 9:37:34 ET]
Table 'Siarnaq' 9-max Seat #5 is the button
Seat 2: Igor DoUrden ($101.50 in chips) 
Seat 3: goblind4777 ($120.91 in chips) 
Seat 5: I The King I ($123.21 in chips) 
Seat 6: Monsthand ($100 in chips) 
Seat 7: matiko09 ($104.28 in chips) 
Seat 8: maxxmeister ($104.16 in chips) 
Monsthand: posts small blind $0.50
matiko09: posts big blind $1
flozzi: sits out 
Spid1: sits out 
*** HOLE CARDS ***
Dealt to matiko09 [Kd 9h]
maxxmeister: folds 
maxxmeister leaves the table
flozzi leaves the table
Igor DoUrden: folds 
goblind4777: folds 
I The King I: raises $1 to $2
Monsthand: folds 
Dante63s joins the table at seat #1 
matiko09: calls $1
*** FLOP *** [Jd 4s Ks]
matiko09: checks 
I The King I: bets $3
matiko09: calls $3
*** TURN *** [Jd 4s Ks] [4d]
matiko09: checks 
I The King I: bets $8
matiko09: calls $8
*** RIVER *** [Jd 4s Ks 4d] [6d]
matiko09: checks 
I The King I: checks 
*** SHOW DOWN ***
matiko09: shows [Kd 9h] (two pair, Kings and Fours)
I The King I: mucks hand 
matiko09 collected $25.31 from pot
Sweden_Pound joins the table at seat #8 
*** SUMMARY ***
Total pot $26.50 | Rake $1.19 
Board [Jd 4s Ks 4d 6d]
Seat 2: Igor DoUrden folded before Flop (didn't bet)
Seat 3: goblind4777 folded before Flop (didn't bet)
Seat 5: I The King I (button) mucked [Qc Tc]
Seat 6: Monsthand (small blind) folded before Flop
Seat 7: matiko09 (big blind) showed [Kd 9h] and won ($25.31) with two pair, Kings and Fours
Seat 8: maxxmeister folded before Flop (didn't bet)





PokerStars Hand #148219928941:  Hold'em No Limit ($0.50/$1.00 USD) - 2016/02/04 15:37:34 CET [2016/02/04 9:37:34 ET]
Table 'Arneb III' 9-max Seat #8 is the button
Seat 1: sanpidk ($100 in chips) 
Seat 2: JeanLima93 ($182.94 in chips) 
Seat 3: matiko09 ($148.14 in chips) 
Seat 4: Igor DoUrden ($248.79 in chips) 
Seat 5: tipner ($135.02 in chips) 
Seat 6: nickreason17 ($100 in chips) 
Seat 7: xxxZeka ($100 in chips) 
Seat 8: volwebni4ek ($43.50 in chips) 
Seat 9: ARTVOR640 ($100 in chips) 
ARTVOR640: posts small blind $0.50
sanpidk: posts big blind $1
*** HOLE CARDS ***
Dealt to matiko09 [Qc Ks]
JeanLima93 has timed out
JeanLima93: folds 
matiko09: raises $2 to $3
Igor DoUrden: folds 
tipner: folds 
nickreason17: folds 
xxxZeka: folds 
volwebni4ek: folds 
ARTVOR640: folds 
sanpidk: folds 
Uncalled bet ($2) returned to matiko09
matiko09 collected $2.50 from pot
matiko09: doesn't show hand 
*** SUMMARY ***
Total pot $2.50 | Rake $0 
Seat 1: sanpidk (big blind) folded before Flop
Seat 2: JeanLima93 folded before Flop (didn't bet)
Seat 3: matiko09 collected ($2.50)
Seat 4: Igor DoUrden folded before Flop (didn't bet)
Seat 5: tipner folded before Flop (didn't bet)
Seat 6: nickreason17 folded before Flop (didn't bet)
Seat 7: xxxZeka folded before Flop (didn't bet)
Seat 8: volwebni4ek (button) folded before Flop (didn't bet)
Seat 9: ARTVOR640 (small blind) folded before Flop





PokerStars Hand #148219935976:  Hold'em No Limit ($0.50/$1.00 USD) - 2016/02/04 15:37:44 CET [2016/02/04 9:37:44 ET]
Table 'Arneb II' 9-max Seat #1 is the button
Seat 1: matiko09 ($103.88 in chips) 
Seat 2: sanpidk ($217.46 in chips) 
Seat 3: brille-390 ($148.02 in chips) 
Seat 4: Venomous100% ($104.16 in chips) 
Seat 5: lixiangli ($74.87 in chips) 
Seat 6: volwebni4ek ($77.45 in chips) 
Seat 7: melitakas ($285.92 in chips) 
Seat 8: tedbadger9 ($35.37 in chips) 
Seat 9: tipner ($108.17 in chips) 
sanpidk: posts small blind $0.50
brille-390: posts big blind $1
*** HOLE CARDS ***
Dealt to matiko09 [Jh 4d]
Venomous100%: raises $2 to $3
lixiangli: folds 
volwebni4ek: folds 
melitakas: folds 
tedbadger9: folds 
tipner: folds 
matiko09: folds 
sanpidk: folds 
brille-390: folds 
Uncalled bet ($2) returned to Venomous100%
Venomous100% collected $2.50 from pot
Venomous100%: doesn't show hand 
*** SUMMARY ***
Total pot $2.50 | Rake $0 
Seat 1: matiko09 (button) folded before Flop (didn't bet)
Seat 2: sanpidk (small blind) folded before Flop
Seat 3: brille-390 (big blind) folded before Flop
Seat 4: Venomous100% collected ($2.50)
Seat 5: lixiangli folded before Flop (didn't bet)
Seat 6: volwebni4ek folded before Flop (didn't bet)
Seat 7: melitakas folded before Flop (didn't bet)
Seat 8: tedbadger9 folded before Flop (didn't bet)
Seat 9: tipner folded before Flop (didn't bet)





PokerStars Hand #148219942631:  Hold'em No Limit ($0.50/$1.00 USD) - 2016/02/04 15:37:53 CET [2016/02/04 9:37:53 ET]
Table 'Helio III' 9-max Seat #4 is the button
Seat 1: lixiangli ($87.19 in chips) 
Seat 4: scmastersrl ($124.76 in chips) 
Seat 6: I The King I ($109.38 in chips) 
Seat 7: matiko09 ($103 in chips) 
Seat 8: nickreason17 ($118.75 in chips) 
I The King I: posts small blind $0.50
matiko09: posts big blind $1
*** HOLE CARDS ***
Dealt to matiko09 [2d 5h]
nickreason17: raises $2 to $3
lixiangli: folds 
scmastersrl: calls $3
I The King I: folds 
matiko09: folds 
*** FLOP *** [Qh 4h 8c]
nickreason17: bets $3.75
scmastersrl: folds 
Uncalled bet ($3.75) returned to nickreason17
nickreason17 collected $7.16 from pot
*** SUMMARY ***
Total pot $7.50 | Rake $0.34 
Board [Qh 4h 8c]
Seat 1: lixiangli folded before Flop (didn't bet)
Seat 4: scmastersrl (button) folded on the Flop
Seat 6: I The King I (small blind) folded before Flop
Seat 7: matiko09 (big blind) folded before Flop
Seat 8: nickreason17 collected ($7.16)





PokerStars Hand #148219944735:  Hold'em No Limit ($0.50/$1.00 USD) - 2016/02/04 15:37:56 CET [2016/02/04 9:37:56 ET]
Table 'Mothallah' 9-max Seat #9 is the button
Seat 2: davianvalek ($124.20 in chips) 
Seat 3: ozone2003 ($130.27 in chips) 
Seat 4: YOUNG_G70 ($51.94 in chips) 
Seat 5: chaps1988 ($100 in chips) 
Seat 6: I The King I ($125.28 in chips) 
Seat 7: sanpidk ($101.42 in chips) 
Seat 8: Spid1 ($132.86 in chips) 
Seat 9: matiko09 ($100 in chips) 
davianvalek: posts small blind $0.50
ozone2003: posts big blind $1
*** HOLE CARDS ***
Dealt to matiko09 [5s 6h]
YOUNG_G70: calls $1
chaps1988: folds 
I The King I: folds 
sanpidk: folds 
Spid1: raises $3 to $4
matiko09: folds 
davianvalek: calls $3.50
ozone2003: folds 
YOUNG_G70: calls $3
*** FLOP *** [8d 8s 9s]
davianvalek: checks 
YOUNG_G70: checks 
Spid1: bets $8
davianvalek: folds 
YOUNG_G70: folds 
Uncalled bet ($8) returned to Spid1
Spid1 collected $12.42 from pot
Spid1: doesn't show hand 
*** SUMMARY ***
Total pot $13 | Rake $0.58 
Board [8d 8s 9s]
Seat 2: davianvalek (small blind) folded on the Flop
Seat 3: ozone2003 (big blind) folded before Flop
Seat 4: YOUNG_G70 folded on the Flop
Seat 5: chaps1988 folded before Flop (didn't bet)
Seat 6: I The King I folded before Flop (didn't bet)
Seat 7: sanpidk folded before Flop (didn't bet)
Seat 8: Spid1 collected ($12.42)
Seat 9: matiko09 (button) folded before Flop (didn't bet)





PokerStars Hand #148219946330:  Hold'em No Limit ($0.50/$1.00 USD) - 2016/02/04 15:37:58 CET [2016/02/04 9:37:58 ET]
Table 'Isara' 9-max Seat #9 is the button
Seat 1: KLOP06031987 ($100 in chips) 
Seat 2: davianvalek ($132.23 in chips) 
Seat 3: I The King I ($118.50 in chips) 
Seat 4: Dante63s ($109.99 in chips) 
Seat 5: Igor DoUrden ($100 in chips) 
Seat 7: warney1976 ($78.37 in chips) 
Seat 8: matiko09 ($100 in chips) 
Seat 9: chauyeuba ($85.37 in chips) 
KLOP06031987: posts small blind $0.50
davianvalek: posts big blind $1
*** HOLE CARDS ***
Dealt to matiko09 [8c Qh]
I The King I: folds 
I The King I leaves the table
Dante63s: folds 
Monsthand joins the table at seat #3 
Igor DoUrden: folds 
warney1976: raises $1 to $2
matiko09: folds 
chauyeuba: folds 
KLOP06031987: folds 
davianvalek: calls $1
*** FLOP *** [4s 2c 2s]
davianvalek: checks 
warney1976: checks 
*** TURN *** [4s 2c 2s] [7s]
davianvalek: checks 
warney1976: checks 
*** RIVER *** [4s 2c 2s 7s] [Td]
davianvalek: checks 
warney1976: checks 
*** SHOW DOWN ***
davianvalek: shows [Kh Qd] (a pair of Deuces)
warney1976: shows [Ac Js] (a pair of Deuces - Ace kicker)
warney1976 collected $4.30 from pot
*** SUMMARY ***
Total pot $4.50 | Rake $0.20 
Board [4s 2c 2s 7s Td]
Seat 1: KLOP06031987 (small blind) folded before Flop
Seat 2: davianvalek (big blind) showed [Kh Qd] and lost with a pair of Deuces
Seat 3: I The King I folded before Flop (didn't bet)
Seat 4: Dante63s folded before Flop (didn't bet)
Seat 5: Igor DoUrden folded before Flop (didn't bet)
Seat 7: warney1976 showed [Ac Js] and won ($4.30) with a pair of Deuces
Seat 8: matiko09 folded before Flop (didn't bet)
Seat 9: chauyeuba (button) folded before Flop (didn't bet)





PokerStars Hand #148219946273:  Hold'em No Limit ($0.50/$1.00 USD) - 2016/02/04 15:37:58 CET [2016/02/04 9:37:58 ET]
Table 'Gutemberga' 9-max Seat #4 is the button
Seat 3: Oligarhs4 ($66.87 in chips) 
Seat 4: scmastersrl ($132.98 in chips) 
Seat 6: I The King I ($103.94 in chips) 
Seat 8: matiko09 ($101.50 in chips) 
Seat 9: xxxZeka ($100 in chips) 
I The King I: posts small blind $0.50
mycka86: is sitting out 
matiko09: posts big blind $1
*** HOLE CARDS ***
Dealt to matiko09 [Td Ac]
xxxZeka: folds 
Oligarhs4: folds 
scmastersrl: raises $2 to $3
I The King I: folds 
matiko09: calls $2
*** FLOP *** [Ts 4d Ks]
matiko09: checks 
scmastersrl: checks 
*** TURN *** [Ts 4d Ks] [7s]
matiko09: checks 
scmastersrl: checks 
*** RIVER *** [Ts 4d Ks 7s] [Kc]
matiko09: bets $4.04
scmastersrl: folds 
Uncalled bet ($4.04) returned to matiko09
matiko09 collected $6.21 from pot
matiko09: doesn't show hand 
*** SUMMARY ***
Total pot $6.50 | Rake $0.29 
Board [Ts 4d Ks 7s Kc]
Seat 3: Oligarhs4 folded before Flop (didn't bet)
Seat 4: scmastersrl (button) folded on the River
Seat 6: I The King I (small blind) folded before Flop
Seat 8: matiko09 (big blind) collected ($6.21)
Seat 9: xxxZeka folded before Flop (didn't bet)





PokerStars Hand #148219959014:  Hold'em No Limit ($0.50/$1.00 USD) - 2016/02/04 15:38:15 CET [2016/02/04 9:38:15 ET]
Table 'Avior II' 9-max Seat #6 is the button
Seat 1: I The King I ($100 in chips) 
Seat 2: matiko09 ($101.50 in chips) 
Seat 3: sanpidk ($140 in chips) 
Seat 5: chaps1988 ($100 in chips) 
Seat 6: tipner ($217.97 in chips) 
Seat 7: Monsthand ($100 in chips) 
Seat 8: EdHunder ($102.54 in chips) 
Monsthand: posts small blind $0.50
EdHunder: posts big blind $1
Venomous100%: sits out 
KLOP06031987: sits out 
*** HOLE CARDS ***
Dealt to matiko09 [2h 6d]
KLOP06031987 leaves the table
I The King I: folds 
matiko09: folds 
maxxmeister joins the table at seat #4 
sanpidk: raises $1.50 to $2.50
chaps1988: folds 
tipner: folds 
Monsthand: raises $6.50 to $9
EdHunder: folds 
sanpidk: folds 
Uncalled bet ($6.50) returned to Monsthand
Monsthand collected $6 from pot
*** SUMMARY ***
Total pot $6 | Rake $0 
Seat 1: I The King I folded before Flop (didn't bet)
Seat 2: matiko09 folded before Flop (didn't bet)
Seat 3: sanpidk folded before Flop
Seat 5: chaps1988 folded before Flop (didn't bet)
Seat 6: tipner (button) folded before Flop (didn't bet)
Seat 7: Monsthand (small blind) collected ($6)
Seat 8: EdHunder (big blind) folded before Flop





PokerStars Hand #148219959075:  Hold'em No Limit ($0.50/$1.00 USD) - 2016/02/04 15:38:15 CET [2016/02/04 9:38:15 ET]
Table 'Dejan' 9-max Seat #6 is the button
Seat 1: matiko09 ($100 in chips) 
Seat 2: xxxZeka ($103.25 in chips) 
Seat 3: lumen21 ($102 in chips) 
Seat 4: pruxa72 ($123.99 in chips) 
Seat 6: sanpidk ($248.38 in chips) 
Seat 8: s26s ($101.87 in chips) 
Seat 9: I The King I ($123.42 in chips) 
s26s: posts small blind $0.50
I The King I: posts big blind $1
*** HOLE CARDS ***
Dealt to matiko09 [5h As]
matiko09: folds 
xxxZeka: folds 
lumen21: folds 
pruxa72: folds 
sanpidk: raises $1.24 to $2.24
s26s: calls $1.74
I The King I: folds 
*** FLOP *** [5d Ks 5s]
s26s: checks 
sanpidk: checks 
*** TURN *** [5d Ks 5s] [Qh]
s26s: checks 
sanpidk: bets $3
s26s: calls $3
*** RIVER *** [5d Ks 5s Qh] [Kd]
s26s: checks 
sanpidk: checks 
*** SHOW DOWN ***
s26s: shows [8c Qc] (two pair, Kings and Queens)
sanpidk: mucks hand 
s26s collected $10.96 from pot
*** SUMMARY ***
Total pot $11.48 | Rake $0.52 
Board [5d Ks 5s Qh Kd]
Seat 1: matiko09 folded before Flop (didn't bet)
Seat 2: xxxZeka folded before Flop (didn't bet)
Seat 3: lumen21 folded before Flop (didn't bet)
Seat 4: pruxa72 folded before Flop (didn't bet)
Seat 6: sanpidk (button) mucked [3d 3s]
Seat 8: s26s (small blind) showed [8c Qc] and won ($10.96) with two pair, Kings and Queens
Seat 9: I The King I (big blind) folded before Flop





PokerStars Hand #148219963900:  Hold'em No Limit ($0.50/$1.00 USD) - 2016/02/04 15:38:22 CET [2016/02/04 9:38:22 ET]
Table 'Helio III' 9-max Seat #6 is the button
Seat 4: scmastersrl ($121.76 in chips) 
Seat 6: I The King I ($108.88 in chips) 
Seat 7: matiko09 ($102 in chips) 
matiko09: posts small blind $0.50
nickreason17: is sitting out 
nickreason17 leaves the table
lixiangli: is sitting out 
scmastersrl: posts big blind $1
*** HOLE CARDS ***
Dealt to matiko09 [9h 6d]
lixiangli leaves the table
I The King I: folds 
matiko09: folds 
Uncalled bet ($0.50) returned to scmastersrl
scmastersrl collected $1 from pot
*** SUMMARY ***
Total pot $1 | Rake $0 
Seat 4: scmastersrl (big blind) collected ($1)
Seat 6: I The King I (button) folded before Flop (didn't bet)
Seat 7: matiko09 (small blind) folded before Flop





PokerStars Hand #148219964126:  Hold'em No Limit ($0.50/$1.00 USD) - 2016/02/04 15:38:22 CET [2016/02/04 9:38:22 ET]
Table 'Arneb II' 9-max Seat #2 is the button
Seat 1: matiko09 ($103.88 in chips) 
Seat 2: sanpidk ($216.96 in chips) 
Seat 3: brille-390 ($147.02 in chips) 
Seat 4: Venomous100% ($105.66 in chips) 
Seat 5: lixiangli ($74.87 in chips) 
Seat 6: volwebni4ek ($77.45 in chips) 
Seat 7: melitakas ($285.92 in chips) 
Seat 8: tedbadger9 ($75.37 in chips) 
Seat 9: tipner ($108.17 in chips) 
brille-390: posts small blind $0.50
Venomous100%: posts big blind $1
*** HOLE CARDS ***
Dealt to matiko09 [8s 7s]
lixiangli: folds 
volwebni4ek: folds 
melitakas: folds 
tedbadger9: folds 
tipner: folds 
matiko09: raises $1.50 to $2.50
sanpidk: folds 
brille-390: folds 
Venomous100%: folds 
Uncalled bet ($1.50) returned to matiko09
matiko09 collected $2.50 from pot
matiko09: doesn't show hand 
*** SUMMARY ***
Total pot $2.50 | Rake $0 
Seat 1: matiko09 collected ($2.50)
Seat 2: sanpidk (button) folded before Flop (didn't bet)
Seat 3: brille-390 (small blind) folded before Flop
Seat 4: Venomous100% (big blind) folded before Flop
Seat 5: lixiangli folded before Flop (didn't bet)
Seat 6: volwebni4ek folded before Flop (didn't bet)
Seat 7: melitakas folded before Flop (didn't bet)
Seat 8: tedbadger9 folded before Flop (didn't bet)
Seat 9: tipner folded before Flop (didn't bet)





PokerStars Hand #148219964788:  Hold'em No Limit ($0.50/$1.00 USD) - 2016/02/04 15:38:23 CET [2016/02/04 9:38:23 ET]
Table 'Arneb III' 9-max Seat #9 is the button
Seat 1: sanpidk ($100 in chips) 
Seat 3: matiko09 ($149.64 in chips) 
Seat 4: Igor DoUrden ($248.79 in chips) 
Seat 5: tipner ($135.02 in chips) 
Seat 6: nickreason17 ($100 in chips) 
Seat 7: xxxZeka ($100 in chips) 
Seat 8: volwebni4ek ($43.50 in chips) 
Seat 9: ARTVOR640 ($100 in chips) 
sanpidk: posts small blind $0.50
matiko09: posts big blind $1
*** HOLE CARDS ***
Dealt to matiko09 [Ts 6c]
Igor DoUrden: folds 
tipner: folds 
nickreason17: raises $2 to $3
xxxZeka: folds 
volwebni4ek: folds 
ARTVOR640: folds 
sanpidk: folds 
matiko09: folds 
Uncalled bet ($2) returned to nickreason17
nickreason17 collected $2.50 from pot
*** SUMMARY ***
Total pot $2.50 | Rake $0 
Seat 1: sanpidk (small blind) folded before Flop
Seat 3: matiko09 (big blind) folded before Flop
Seat 4: Igor DoUrden folded before Flop (didn't bet)
Seat 5: tipner folded before Flop (didn't bet)
Seat 6: nickreason17 collected ($2.50)
Seat 7: xxxZeka folded before Flop (didn't bet)
Seat 8: volwebni4ek folded before Flop (didn't bet)
Seat 9: ARTVOR640 (button) folded before Flop (didn't bet)





PokerStars Hand #148219978809:  Hold'em No Limit ($0.50/$1.00 USD) - 2016/02/04 15:38:42 CET [2016/02/04 9:38:42 ET]
Table 'Helio III' 9-max Seat #7 is the button
Seat 4: scmastersrl ($122.26 in chips) 
Seat 6: I The King I ($108.88 in chips) 
Seat 7: matiko09 ($101.50 in chips) 
scmastersrl: posts small blind $0.50
I The King I: posts big blind $1
*** HOLE CARDS ***
Dealt to matiko09 [Js 9s]
matiko09: raises $1.27 to $2.27
Düss2411 joins the table at seat #8 
scmastersrl: raises $5.54 to $7.81
I The King I: folds 
Düss2411 leaves the table
matiko09: calls $5.54
*** FLOP *** [2h Ac 2s]
KLOP06031987 joins the table at seat #8 
scmastersrl: bets $9
KLOP06031987 leaves the table
matiko09: folds 
Uncalled bet ($9) returned to scmastersrl
scmastersrl collected $15.87 from pot
*** SUMMARY ***
Total pot $16.62 | Rake $0.75 
Board [2h Ac 2s]
Seat 4: scmastersrl (small blind) collected ($15.87)
Seat 6: I The King I (big blind) folded before Flop
Seat 7: matiko09 (button) folded on the Flop





PokerStars Hand #148219981388:  Hold'em No Limit ($0.50/$1.00 USD) - 2016/02/04 15:38:46 CET [2016/02/04 9:38:46 ET]
Table 'Avior II' 9-max Seat #7 is the button
Seat 1: I The King I ($100 in chips) 
Seat 2: matiko09 ($101.50 in chips) 
Seat 3: sanpidk ($137.50 in chips) 
Seat 5: chaps1988 ($100 in chips) 
Seat 6: tipner ($217.97 in chips) 
Seat 7: Monsthand ($103.50 in chips) 
Seat 8: EdHunder ($101.54 in chips) 
Seat 9: Venomous100% ($100 in chips) 
EdHunder: posts small blind $0.50
Venomous100%: posts big blind $1
maxxmeister: sits out 
*** HOLE CARDS ***
Dealt to matiko09 [4h 7s]
I The King I: folds 
matiko09: folds 
sanpidk: folds 
chaps1988: raises $1.10 to $2.10
tipner: folds 
Monsthand: folds 
EdHunder: folds 
Venomous100%: folds 
Uncalled bet ($1.10) returned to chaps1988
chaps1988 collected $2.50 from pot
chaps1988: doesn't show hand 
*** SUMMARY ***
Total pot $2.50 | Rake $0 
Seat 1: I The King I folded before Flop (didn't bet)
Seat 2: matiko09 folded before Flop (didn't bet)
Seat 3: sanpidk folded before Flop (didn't bet)
Seat 5: chaps1988 collected ($2.50)
Seat 6: tipner folded before Flop (didn't bet)
Seat 7: Monsthand (button) folded before Flop (didn't bet)
Seat 8: EdHunder (small blind) folded before Flop
Seat 9: Venomous100% (big blind) folded before Flop





PokerStars Hand #148219982415:  Hold'em No Limit ($0.50/$1.00 USD) - 2016/02/04 15:38:47 CET [2016/02/04 9:38:47 ET]
Table 'Gutemberga' 9-max Seat #6 is the button
Seat 3: Oligarhs4 ($66.87 in chips) 
Seat 4: scmastersrl ($129.98 in chips) 
Seat 6: I The King I ($103.44 in chips) 
Seat 8: matiko09 ($104.71 in chips) 
Seat 9: xxxZeka ($100 in chips) 
matiko09: posts small blind $0.50
xxxZeka: posts big blind $1
KLOP06031987: sits out 
*** HOLE CARDS ***
Dealt to matiko09 [5h Qd]
Oligarhs4: folds 
scmastersrl: raises $2 to $3
I The King I: folds 
matiko09: folds 
xxxZeka: raises $6.50 to $9.50
scmastersrl: folds 
Uncalled bet ($6.50) returned to xxxZeka
xxxZeka collected $6.50 from pot
*** SUMMARY ***
Total pot $6.50 | Rake $0 
Seat 3: Oligarhs4 folded before Flop (didn't bet)
Seat 4: scmastersrl folded before Flop
Seat 6: I The King I (button) folded before Flop (didn't bet)
Seat 8: matiko09 (small blind) folded before Flop
Seat 9: xxxZeka (big blind) collected ($6.50)





PokerStars Hand #148219986553:  Hold'em No Limit ($0.50/$1.00 USD) - 2016/02/04 15:38:53 CET [2016/02/04 9:38:53 ET]
Table 'Arneb II' 9-max Seat #3 is the button
Seat 1: matiko09 ($105.38 in chips) 
Seat 2: sanpidk ($216.96 in chips) 
Seat 3: brille-390 ($146.52 in chips) 
Seat 4: Venomous100% ($104.66 in chips) 
Seat 6: volwebni4ek ($77.45 in chips) 
Seat 7: melitakas ($285.92 in chips) 
Seat 8: tedbadger9 ($75.37 in chips) 
Seat 9: tipner ($108.17 in chips) 
Venomous100%: posts small blind $0.50
lixiangli: is sitting out 
volwebni4ek: posts big blind $1
*** HOLE CARDS ***
Dealt to matiko09 [Jd 8d]
melitakas: folds 
tedbadger9: folds 
tipner: folds 
lixiangli leaves the table
matiko09: folds 
sanpidk: raises $1.50 to $2.50
brille-390: folds 
Venomous100%: folds 
volwebni4ek: folds 
Uncalled bet ($1.50) returned to sanpidk
sanpidk collected $2.50 from pot
sanpidk: doesn't show hand 
*** SUMMARY ***
Total pot $2.50 | Rake $0 
Seat 1: matiko09 folded before Flop (didn't bet)
Seat 2: sanpidk collected ($2.50)
Seat 3: brille-390 (button) folded before Flop (didn't bet)
Seat 4: Venomous100% (small blind) folded before Flop
Seat 6: volwebni4ek (big blind) folded before Flop
Seat 7: melitakas folded before Flop (didn't bet)
Seat 8: tedbadger9 folded before Flop (didn't bet)
Seat 9: tipner folded before Flop (didn't bet)





PokerStars Hand #148219989498:  Hold'em No Limit ($0.50/$1.00 USD) - 2016/02/04 15:38:57 CET [2016/02/04 9:38:57 ET]
Table 'Siarnaq' 9-max Seat #6 is the button
Seat 2: Igor DoUrden ($101.50 in chips) 
Seat 3: goblind4777 ($120.91 in chips) 
Seat 5: I The King I ($110.21 in chips) 
Seat 6: Monsthand ($100 in chips) 
Seat 7: matiko09 ($116.59 in chips) 
Seat 8: Sweden_Pound ($100 in chips) 
matiko09: posts small blind $0.50
Sweden_Pound: posts big blind $1
Dante63s: sits out 
Spid1: sits out 
*** HOLE CARDS ***
Dealt to matiko09 [Kh 4s]
Igor DoUrden: folds 
goblind4777: folds 
Dante63s leaves the table
I The King I: raises $1.50 to $2.50
Monsthand: folds 
matiko09: folds 
Sweden_Pound: raises $7.50 to $10
I The King I: calls $7.50
*** FLOP *** [8s 3c 8d]
Sweden_Pound: bets $12.73
I The King I: calls $12.73
*** TURN *** [8s 3c 8d] [Qh]
Sweden_Pound: checks 
I The King I: checks 
*** RIVER *** [8s 3c 8d Qh] [7h]
Sweden_Pound: checks 
Dante63s joins the table at seat #1 
I The King I: bets $24
MagicKid777 joins the table at seat #9 
Sweden_Pound: folds 
Uncalled bet ($24) returned to I The King I
I The King I collected $43.89 from pot
I The King I: doesn't show hand 
*** SUMMARY ***
Total pot $45.96 | Rake $2.07 
Board [8s 3c 8d Qh 7h]
Seat 2: Igor DoUrden folded before Flop (didn't bet)
Seat 3: goblind4777 folded before Flop (didn't bet)
Seat 5: I The King I collected ($43.89)
Seat 6: Monsthand (button) folded before Flop (didn't bet)
Seat 7: matiko09 (small blind) folded before Flop
Seat 8: Sweden_Pound (big blind) folded on the River





PokerStars Hand #148219991479:  Hold'em No Limit ($0.50/$1.00 USD) - 2016/02/04 15:38:59 CET [2016/02/04 9:38:59 ET]
Table 'Mothallah' 9-max Seat #2 is the button
Seat 2: davianvalek ($120.20 in chips) 
Seat 3: ozone2003 ($129.27 in chips) 
Seat 4: YOUNG_G70 ($47.94 in chips) 
Seat 5: chaps1988 ($100 in chips) 
Seat 6: I The King I ($125.28 in chips) 
Seat 7: sanpidk ($101.42 in chips) 
Seat 8: Spid1 ($141.28 in chips) 
Seat 9: matiko09 ($100 in chips) 
ozone2003: posts small blind $0.50
YOUNG_G70: posts big blind $1
*** HOLE CARDS ***
Dealt to matiko09 [As Jd]
chaps1988: folds 
I The King I: folds 
sanpidk: folds 
Spid1: folds 
matiko09: raises $1.50 to $2.50
davianvalek: folds 
ozone2003: folds 
YOUNG_G70: calls $1.50
*** FLOP *** [7h 2d 6c]
YOUNG_G70: checks 
matiko09: checks 
*** TURN *** [7h 2d 6c] [Kc]
YOUNG_G70: bets $3
matiko09: folds 
Uncalled bet ($3) returned to YOUNG_G70
YOUNG_G70 collected $5.25 from pot
YOUNG_G70: doesn't show hand 
*** SUMMARY ***
Total pot $5.50 | Rake $0.25 
Board [7h 2d 6c Kc]
Seat 2: davianvalek (button) folded before Flop (didn't bet)
Seat 3: ozone2003 (small blind) folded before Flop
Seat 4: YOUNG_G70 (big blind) collected ($5.25)
Seat 5: chaps1988 folded before Flop (didn't bet)
Seat 6: I The King I folded before Flop (didn't bet)
Seat 7: sanpidk folded before Flop (didn't bet)
Seat 8: Spid1 folded before Flop (didn't bet)
Seat 9: matiko09 folded on the Turn





PokerStars Hand #148219998528:  Hold'em No Limit ($0.50/$1.00 USD) - 2016/02/04 15:39:09 CET [2016/02/04 9:39:09 ET]
Table 'Isara' 9-max Seat #1 is the button
Seat 1: KLOP06031987 ($100 in chips) 
Seat 2: davianvalek ($130.23 in chips) 
Seat 3: Monsthand ($100 in chips) 
Seat 4: Dante63s ($109.99 in chips) 
Seat 5: Igor DoUrden ($100 in chips) 
Seat 7: warney1976 ($80.67 in chips) 
Seat 8: matiko09 ($100 in chips) 
Seat 9: chauyeuba ($85.37 in chips) 
davianvalek: posts small blind $0.50
Monsthand: posts big blind $1
*** HOLE CARDS ***
Dealt to matiko09 [3d 8s]
Dante63s: folds 
Igor DoUrden: folds 
warney1976: calls $1
matiko09: folds 
chauyeuba: raises $2 to $3
KLOP06031987: folds 
davianvalek: folds 
Monsthand: folds 
warney1976: calls $2
*** FLOP *** [2c 5h Ks]
warney1976: checks 
chauyeuba: bets $3.58
warney1976: calls $3.58
*** TURN *** [2c 5h Ks] [As]
warney1976: bets $7
chauyeuba: folds 
Uncalled bet ($7) returned to warney1976
warney1976 collected $14 from pot
*** SUMMARY ***
Total pot $14.66 | Rake $0.66 
Board [2c 5h Ks As]
Seat 1: KLOP06031987 (button) folded before Flop (didn't bet)
Seat 2: davianvalek (small blind) folded before Flop
Seat 3: Monsthand (big blind) folded before Flop
Seat 4: Dante63s folded before Flop (didn't bet)
Seat 5: Igor DoUrden folded before Flop (didn't bet)
Seat 7: warney1976 collected ($14)
Seat 8: matiko09 folded before Flop (didn't bet)
Seat 9: chauyeuba folded on the Turn





PokerStars Hand #148219999238:  Hold'em No Limit ($0.50/$1.00 USD) - 2016/02/04 15:39:10 CET [2016/02/04 9:39:10 ET]
Table 'Dejan' 9-max Seat #8 is the button
Seat 1: matiko09 ($100 in chips) 
Seat 2: xxxZeka ($103.25 in chips) 
Seat 3: lumen21 ($102 in chips) 
Seat 4: pruxa72 ($123.99 in chips) 
Seat 6: sanpidk ($243.14 in chips) 
Seat 8: s26s ($107.59 in chips) 
Seat 9: I The King I ($122.42 in chips) 
I The King I: posts small blind $0.50
matiko09: posts big blind $1
*** HOLE CARDS ***
Dealt to matiko09 [As Td]
xxxZeka: folds 
lumen21: folds 
pruxa72: raises $2 to $3
sanpidk: folds 
s26s: folds 
I The King I: folds 
matiko09: folds 
Uncalled bet ($2) returned to pruxa72
pruxa72 collected $2.50 from pot
pruxa72: doesn't show hand 
*** SUMMARY ***
Total pot $2.50 | Rake $0 
Seat 1: matiko09 (big blind) folded before Flop
Seat 2: xxxZeka folded before Flop (didn't bet)
Seat 3: lumen21 folded before Flop (didn't bet)
Seat 4: pruxa72 collected ($2.50)
Seat 6: sanpidk folded before Flop (didn't bet)
Seat 8: s26s (button) folded before Flop (didn't bet)
Seat 9: I The King I (small blind) folded before Flop





PokerStars Hand #148220000692:  Hold'em No Limit ($0.50/$1.00 USD) - 2016/02/04 15:39:12 CET [2016/02/04 9:39:12 ET]
Table 'Arneb III' 9-max Seat #1 is the button
Seat 1: sanpidk ($100 in chips) 
Seat 3: matiko09 ($148.64 in chips) 
Seat 4: Igor DoUrden ($248.79 in chips) 
Seat 5: tipner ($135.02 in chips) 
Seat 6: nickreason17 ($101.50 in chips) 
Seat 7: xxxZeka ($100 in chips) 
Seat 8: volwebni4ek ($43.50 in chips) 
Seat 9: ARTVOR640 ($100 in chips) 
JeanLima93 will be allowed to play after the button
matiko09: posts small blind $0.50
Igor DoUrden: posts big blind $1
*** HOLE CARDS ***
Dealt to matiko09 [Td Qd]
tipner: folds 
nickreason17: folds 
xxxZeka: folds 
volwebni4ek: folds 
ARTVOR640: folds 
sanpidk: raises $1.24 to $2.24
matiko09: folds 
Igor DoUrden: raises $5.76 to $8
sanpidk: folds 
Uncalled bet ($5.76) returned to Igor DoUrden
Igor DoUrden collected $4.98 from pot
Igor DoUrden: doesn't show hand 
*** SUMMARY ***
Total pot $4.98 | Rake $0 
Seat 1: sanpidk (button) folded before Flop
Seat 3: matiko09 (small blind) folded before Flop
Seat 4: Igor DoUrden (big blind) collected ($4.98)
Seat 5: tipner folded before Flop (didn't bet)
Seat 6: nickreason17 folded before Flop (didn't bet)
Seat 7: xxxZeka folded before Flop (didn't bet)
Seat 8: volwebni4ek folded before Flop (didn't bet)
Seat 9: ARTVOR640 folded before Flop (didn't bet)





PokerStars Hand #148220004294:  Hold'em No Limit ($0.50/$1.00 USD) - 2016/02/04 15:39:17 CET [2016/02/04 9:39:17 ET]
Table 'Helio III' 9-max Seat #4 is the button
Seat 4: scmastersrl ($130.32 in chips) 
Seat 6: I The King I ($107.88 in chips) 
Seat 7: matiko09 ($100 in chips) 
Sweden_Pound joins the table at seat #8 
I The King I: posts small blind $0.50
matiko09: posts big blind $1
*** HOLE CARDS ***
Dealt to matiko09 [7d 6s]
scmastersrl: raises $2 to $3
I The King I: folds 
matiko09: folds 
Uncalled bet ($2) returned to scmastersrl
scmastersrl collected $2.50 from pot
*** SUMMARY ***
Total pot $2.50 | Rake $0 
Seat 4: scmastersrl (button) collected ($2.50)
Seat 6: I The King I (small blind) folded before Flop
Seat 7: matiko09 (big blind) folded before Flop





PokerStars Hand #148220007941:  Hold'em No Limit ($0.50/$1.00 USD) - 2016/02/04 15:39:22 CET [2016/02/04 9:39:22 ET]
Table 'Gutemberga' 9-max Seat #8 is the button
Seat 3: Oligarhs4 ($66.87 in chips) 
Seat 4: scmastersrl ($126.98 in chips) 
Seat 6: I The King I ($103.44 in chips) 
Seat 8: matiko09 ($104.21 in chips) 
Seat 9: xxxZeka ($103.50 in chips) 
xxxZeka: posts small blind $0.50
Oligarhs4: posts big blind $1
*** HOLE CARDS ***
Dealt to matiko09 [9d 4s]
KLOP06031987 leaves the table
scmastersrl: folds 
I The King I: folds 
Monsthand joins the table at seat #5 
matiko09: folds 
xxxZeka: folds 
Uncalled bet ($0.50) returned to Oligarhs4
Oligarhs4 collected $1 from pot
Oligarhs4: doesn't show hand 
*** SUMMARY ***
Total pot $1 | Rake $0 
Seat 3: Oligarhs4 (big blind) collected ($1)
Seat 4: scmastersrl folded before Flop (didn't bet)
Seat 6: I The King I folded before Flop (didn't bet)
Seat 8: matiko09 (button) folded before Flop (didn't bet)
Seat 9: xxxZeka (small blind) folded before Flop





PokerStars Hand #148220011040:  Hold'em No Limit ($0.50/$1.00 USD) - 2016/02/04 15:39:26 CET [2016/02/04 9:39:26 ET]
Table 'Avior II' 9-max Seat #8 is the button
Seat 1: I The King I ($100 in chips) 
Seat 2: matiko09 ($101.50 in chips) 
Seat 3: sanpidk ($137.50 in chips) 
Seat 5: chaps1988 ($101.50 in chips) 
Seat 6: tipner ($217.97 in chips) 
Seat 7: Monsthand ($103.50 in chips) 
Seat 8: EdHunder ($101.04 in chips) 
Seat 9: Venomous100% ($100 in chips) 
Venomous100%: posts small blind $0.50
I The King I: posts big blind $1
maxxmeister: sits out 
*** HOLE CARDS ***
Dealt to matiko09 [Td 8h]
matiko09: folds 
sanpidk: folds 
chaps1988: folds 
tipner: folds 
Monsthand: folds 
EdHunder: folds 
Venomous100%: folds 
Uncalled bet ($0.50) returned to I The King I
I The King I collected $1 from pot
I The King I: doesn't show hand 
*** SUMMARY ***
Total pot $1 | Rake $0 
Seat 1: I The King I (big blind) collected ($1)
Seat 2: matiko09 folded before Flop (didn't bet)
Seat 3: sanpidk folded before Flop (didn't bet)
Seat 5: chaps1988 folded before Flop (didn't bet)
Seat 6: tipner folded before Flop (didn't bet)
Seat 7: Monsthand folded before Flop (didn't bet)
Seat 8: EdHunder (button) folded before Flop (didn't bet)
Seat 9: Venomous100% (small blind) folded before Flop





PokerStars Hand #148220015694:  Hold'em No Limit ($0.50/$1.00 USD) - 2016/02/04 15:39:32 CET [2016/02/04 9:39:32 ET]
Table 'Helio III' 9-max Seat #6 is the button
Seat 4: scmastersrl ($131.82 in chips) 
Seat 6: I The King I ($107.38 in chips) 
Seat 7: matiko09 ($100 in chips) 
Seat 8: Sweden_Pound ($101.50 in chips) 
matiko09: posts small blind $0.50
Sweden_Pound: posts big blind $1
*** HOLE CARDS ***
Dealt to matiko09 [5h 7d]
scmastersrl: raises $2 to $3
I The King I: calls $3
matiko09: folds 
Sweden_Pound: raises $8 to $11
scmastersrl: calls $8
I The King I: calls $8
*** FLOP *** [5s Tc Td]
Sweden_Pound: bets $18.50
scmastersrl: folds 
I The King I: calls $18.50
*** TURN *** [5s Tc Td] [5c]
Sweden_Pound: checks 
I The King I: checks 
*** RIVER *** [5s Tc Td 5c] [8d]
Sweden_Pound: checks 
I The King I: bets $42.78
MagicKid777 joins the table at seat #1 
Sweden_Pound: folds 
Uncalled bet ($42.78) returned to I The King I
I The King I collected $69 from pot
I The King I: doesn't show hand 
*** SUMMARY ***
Total pot $70.50 | Rake $1.50 
Board [5s Tc Td 5c 8d]
Seat 4: scmastersrl folded on the Flop
Seat 6: I The King I (button) collected ($69)
Seat 7: matiko09 (small blind) folded before Flop
Seat 8: Sweden_Pound (big blind) folded on the River





PokerStars Hand #148220017976:  Hold'em No Limit ($0.50/$1.00 USD) - 2016/02/04 15:39:35 CET [2016/02/04 9:39:35 ET]
Table 'Arneb II' 9-max Seat #4 is the button
Seat 1: matiko09 ($105.38 in chips) 
Seat 2: sanpidk ($218.46 in chips) 
Seat 3: brille-390 ($146.52 in chips) 
Seat 4: Venomous100% ($104.16 in chips) 
Seat 6: volwebni4ek ($76.45 in chips) 
Seat 7: melitakas ($285.92 in chips) 
Seat 8: tedbadger9 ($75.37 in chips) 
Seat 9: tipner ($108.17 in chips) 
volwebni4ek: posts small blind $0.50
melitakas: posts big blind $1
*** HOLE CARDS ***
Dealt to matiko09 [Qc 3d]
tedbadger9: folds 
lumen21 joins the table at seat #5 
tipner: folds 
matiko09: folds 
sanpidk: folds 
brille-390: raises $1.25 to $2.25
Venomous100%: folds 
volwebni4ek: folds 
melitakas: folds 
Uncalled bet ($1.25) returned to brille-390
brille-390 collected $2.50 from pot
brille-390: doesn't show hand 
*** SUMMARY ***
Total pot $2.50 | Rake $0 
Seat 1: matiko09 folded before Flop (didn't bet)
Seat 2: sanpidk folded before Flop (didn't bet)
Seat 3: brille-390 collected ($2.50)
Seat 4: Venomous100% (button) folded before Flop (didn't bet)
Seat 6: volwebni4ek (small blind) folded before Flop
Seat 7: melitakas (big blind) folded before Flop
Seat 8: tedbadger9 folded before Flop (didn't bet)
Seat 9: tipner folded before Flop (didn't bet)





PokerStars Hand #148220017634:  Hold'em No Limit ($0.50/$1.00 USD) - 2016/02/04 15:39:35 CET [2016/02/04 9:39:35 ET]
Table 'Mothallah' 9-max Seat #3 is the button
Seat 2: davianvalek ($120.20 in chips) 
Seat 3: ozone2003 ($128.77 in chips) 
Seat 4: YOUNG_G70 ($50.69 in chips) 
Seat 5: chaps1988 ($100 in chips) 
Seat 6: I The King I ($125.28 in chips) 
Seat 7: sanpidk ($101.42 in chips) 
Seat 8: Spid1 ($141.28 in chips) 
Seat 9: matiko09 ($100 in chips) 
YOUNG_G70: posts small blind $0.50
chaps1988: posts big blind $1
*** HOLE CARDS ***
Dealt to matiko09 [Ac Jd]
I The King I: folds 
sanpidk: raises $2 to $3
Spid1: folds 
matiko09: raises $6.50 to $9.50
davianvalek: folds 
ozone2003: folds 
YOUNG_G70: folds 
chaps1988: folds 
sanpidk: folds 
Uncalled bet ($6.50) returned to matiko09
matiko09 collected $7.50 from pot
matiko09: doesn't show hand 
*** SUMMARY ***
Total pot $7.50 | Rake $0 
Seat 2: davianvalek folded before Flop (didn't bet)
Seat 3: ozone2003 (button) folded before Flop (didn't bet)
Seat 4: YOUNG_G70 (small blind) folded before Flop
Seat 5: chaps1988 (big blind) folded before Flop
Seat 6: I The King I folded before Flop (didn't bet)
Seat 7: sanpidk folded before Flop
Seat 8: Spid1 folded before Flop (didn't bet)
Seat 9: matiko09 collected ($7.50)





PokerStars Hand #148220018145:  Hold'em No Limit ($0.50/$1.00 USD) - 2016/02/04 15:39:36 CET [2016/02/04 9:39:36 ET]
Table 'Gutemberga' 9-max Seat #9 is the button
Seat 3: Oligarhs4 ($67.37 in chips) 
Seat 4: scmastersrl ($126.98 in chips) 
Seat 6: I The King I ($103.44 in chips) 
Seat 8: matiko09 ($104.21 in chips) 
Seat 9: xxxZeka ($103 in chips) 
Oligarhs4: posts small blind $0.50
scmastersrl: posts big blind $1
Monsthand: sits out 
*** HOLE CARDS ***
Dealt to matiko09 [5s Qh]
I The King I: folds 
matiko09: folds 
xxxZeka: folds 
Oligarhs4: folds 
Uncalled bet ($0.50) returned to scmastersrl
scmastersrl collected $1 from pot
*** SUMMARY ***
Total pot $1 | Rake $0 
Seat 3: Oligarhs4 (small blind) folded before Flop
Seat 4: scmastersrl (big blind) collected ($1)
Seat 6: I The King I folded before Flop (didn't bet)
Seat 8: matiko09 folded before Flop (didn't bet)
Seat 9: xxxZeka (button) folded before Flop (didn't bet)





PokerStars Hand #148220030261:  Hold'em No Limit ($0.50/$1.00 USD) - 2016/02/04 15:39:52 CET [2016/02/04 9:39:52 ET]
Table 'Dejan' 9-max Seat #9 is the button
Seat 1: matiko09 ($100 in chips) 
Seat 2: xxxZeka ($103.25 in chips) 
Seat 3: lumen21 ($102 in chips) 
Seat 4: pruxa72 ($125.49 in chips) 
Seat 6: sanpidk ($243.14 in chips) 
Seat 8: s26s ($107.59 in chips) 
Seat 9: I The King I ($121.92 in chips) 
matiko09: posts small blind $0.50
xxxZeka: posts big blind $1
*** HOLE CARDS ***
Dealt to matiko09 [Kc 2c]
lumen21 has timed out
lumen21: folds 
pruxa72: calls $1
sanpidk: folds 
s26s: folds 
I The King I: folds 
matiko09: calls $0.50
xxxZeka: checks 
*** FLOP *** [Qs Jc 2h]
matiko09: checks 
xxxZeka: checks 
pruxa72: bets $2.86
matiko09: folds 
xxxZeka: folds 
Uncalled bet ($2.86) returned to pruxa72
pruxa72 collected $2.86 from pot
pruxa72: doesn't show hand 
*** SUMMARY ***
Total pot $3 | Rake $0.14 
Board [Qs Jc 2h]
Seat 1: matiko09 (small blind) folded on the Flop
Seat 2: xxxZeka (big blind) folded on the Flop
Seat 3: lumen21 folded before Flop (didn't bet)
Seat 4: pruxa72 collected ($2.86)
Seat 6: sanpidk folded before Flop (didn't bet)
Seat 8: s26s folded before Flop (didn't bet)
Seat 9: I The King I (button) folded before Flop (didn't bet)





PokerStars Hand #148220034975:  Hold'em No Limit ($0.50/$1.00 USD) - 2016/02/04 15:39:58 CET [2016/02/04 9:39:58 ET]
Table 'Arneb III' 9-max Seat #3 is the button
Seat 1: sanpidk ($100 in chips) 
Seat 2: JeanLima93 ($182.94 in chips) 
Seat 3: matiko09 ($148.14 in chips) 
Seat 4: Igor DoUrden ($251.53 in chips) 
Seat 5: tipner ($135.02 in chips) 
Seat 6: nickreason17 ($101.50 in chips) 
Seat 7: xxxZeka ($100 in chips) 
Seat 8: volwebni4ek ($43.50 in chips) 
Seat 9: ARTVOR640 ($100 in chips) 
Igor DoUrden: posts small blind $0.50
tipner: posts big blind $1
JeanLima93: posts small & big blinds $1.50
*** HOLE CARDS ***
Dealt to matiko09 [3d 8s]
nickreason17: folds 
nickreason17 leaves the table
xxxZeka: folds 
volwebni4ek: raises $3 to $4
ARTVOR640: folds 
sanpidk: folds 
JeanLima93: folds 
lumen21 joins the table at seat #6 
matiko09: folds 
Igor DoUrden: folds 
tipner: folds 
Uncalled bet ($3) returned to volwebni4ek
volwebni4ek collected $4 from pot
volwebni4ek: doesn't show hand 
*** SUMMARY ***
Total pot $4 | Rake $0 
Seat 1: sanpidk folded before Flop (didn't bet)
Seat 2: JeanLima93 folded before Flop
Seat 3: matiko09 (button) folded before Flop (didn't bet)
Seat 4: Igor DoUrden (small blind) folded before Flop
Seat 5: tipner (big blind) folded before Flop
Seat 6: nickreason17 folded before Flop (didn't bet)
Seat 7: xxxZeka folded before Flop (didn't bet)
Seat 8: volwebni4ek collected ($4)
Seat 9: ARTVOR640 folded before Flop (didn't bet)





PokerStars Hand #148220037834:  Hold'em No Limit ($0.50/$1.00 USD) - 2016/02/04 15:40:02 CET [2016/02/04 9:40:02 ET]
Table 'Gutemberga' 9-max Seat #3 is the button
Seat 3: Oligarhs4 ($66.87 in chips) 
Seat 4: scmastersrl ($127.48 in chips) 
Seat 5: Monsthand ($100 in chips) 
Seat 6: I The King I ($103.44 in chips) 
Seat 8: matiko09 ($104.21 in chips) 
Seat 9: xxxZeka ($103 in chips) 
scmastersrl: posts small blind $0.50
Monsthand: posts big blind $1
*** HOLE CARDS ***
Dealt to matiko09 [Qd Qs]
I The King I: folds 
matiko09: raises $2 to $3
xxxZeka: folds 
Oligarhs4: folds 
scmastersrl: folds 
Monsthand: folds 
Uncalled bet ($2) returned to matiko09
matiko09 collected $2.50 from pot
matiko09: doesn't show hand 
*** SUMMARY ***
Total pot $2.50 | Rake $0 
Seat 3: Oligarhs4 (button) folded before Flop (didn't bet)
Seat 4: scmastersrl (small blind) folded before Flop
Seat 5: Monsthand (big blind) folded before Flop
Seat 6: I The King I folded before Flop (didn't bet)
Seat 8: matiko09 collected ($2.50)
Seat 9: xxxZeka folded before Flop (didn't bet)





PokerStars Hand #148220040639:  Hold'em No Limit ($0.50/$1.00 USD) - 2016/02/04 15:40:06 CET [2016/02/04 9:40:06 ET]
Table 'Arneb II' 9-max Seat #6 is the button
Seat 1: matiko09 ($105.38 in chips) 
Seat 2: sanpidk ($218.46 in chips) 
Seat 3: brille-390 ($148.02 in chips) 
Seat 4: Venomous100% ($104.16 in chips) 
Seat 6: volwebni4ek ($75.95 in chips) 
Seat 7: melitakas ($284.92 in chips) 
Seat 8: tedbadger9 ($75.37 in chips) 
Seat 9: tipner ($108.17 in chips) 
melitakas: posts small blind $0.50
tedbadger9: posts big blind $1
lumen21: sits out 
*** HOLE CARDS ***
Dealt to matiko09 [Jh Qd]
tipner: folds 
matiko09: folds 
sanpidk: raises $2 to $3
brille-390: folds 
Venomous100%: calls $3
volwebni4ek: folds 
melitakas: folds 
tedbadger9: calls $2
*** FLOP *** [2d 4d Ac]
tedbadger9: checks 
sanpidk: checks 
Venomous100%: checks 
*** TURN *** [2d 4d Ac] [5c]
tedbadger9: checks 
sanpidk: bets $5.50
Venomous100%: folds 
tedbadger9: calls $5.50
*** RIVER *** [2d 4d Ac 5c] [3c]
tedbadger9: checks 
sanpidk: checks 
*** SHOW DOWN ***
tedbadger9: shows [Qh Qs] (a straight, Ace to Five)
sanpidk: shows [Ks Kh] (a straight, Ace to Five)
tedbadger9 collected $9.79 from pot
sanpidk collected $9.79 from pot
*** SUMMARY ***
Total pot $20.50 | Rake $0.92 
Board [2d 4d Ac 5c 3c]
Seat 1: matiko09 folded before Flop (didn't bet)
Seat 2: sanpidk showed [Ks Kh] and won ($9.79) with a straight, Ace to Five
Seat 3: brille-390 folded before Flop (didn't bet)
Seat 4: Venomous100% folded on the Turn
Seat 6: volwebni4ek (button) folded before Flop (didn't bet)
Seat 7: melitakas (small blind) folded before Flop
Seat 8: tedbadger9 (big blind) showed [Qh Qs] and won ($9.79) with a straight, Ace to Five
Seat 9: tipner folded before Flop (didn't bet)





PokerStars Hand #148220048148:  Hold'em No Limit ($0.50/$1.00 USD) - 2016/02/04 15:40:17 CET [2016/02/04 9:40:17 ET]
Table 'Avior II' 9-max Seat #9 is the button
Seat 1: I The King I ($100.50 in chips) 
Seat 2: matiko09 ($101.50 in chips) 
Seat 3: sanpidk ($137.50 in chips) 
Seat 5: chaps1988 ($101.50 in chips) 
Seat 6: tipner ($217.97 in chips) 
Seat 7: Monsthand ($103.50 in chips) 
Seat 8: EdHunder ($101.04 in chips) 
Seat 9: Venomous100% ($100 in chips) 
I The King I: posts small blind $0.50
matiko09: posts big blind $1
maxxmeister: sits out 
*** HOLE CARDS ***
Dealt to matiko09 [4s 6s]
sanpidk: folds 
chaps1988: folds 
tipner: folds 
Monsthand: folds 
EdHunder: folds 
Venomous100%: raises $1 to $2
I The King I: folds 
matiko09: folds 
Uncalled bet ($1) returned to Venomous100%
Venomous100% collected $2.50 from pot
Venomous100%: doesn't show hand 
*** SUMMARY ***
Total pot $2.50 | Rake $0 
Seat 1: I The King I (small blind) folded before Flop
Seat 2: matiko09 (big blind) folded before Flop
Seat 3: sanpidk folded before Flop (didn't bet)
Seat 5: chaps1988 folded before Flop (didn't bet)
Seat 6: tipner folded before Flop (didn't bet)
Seat 7: Monsthand folded before Flop (didn't bet)
Seat 8: EdHunder folded before Flop (didn't bet)
Seat 9: Venomous100% (button) collected ($2.50)





PokerStars Hand #148220051446:  Hold'em No Limit ($0.50/$1.00 USD) - 2016/02/04 15:40:21 CET [2016/02/04 9:40:21 ET]
Table 'Gutemberga' 9-max Seat #4 is the button
Seat 3: Oligarhs4 ($66.87 in chips) 
Seat 4: scmastersrl ($126.98 in chips) 
Seat 5: Monsthand ($100 in chips) 
Seat 6: I The King I ($103.44 in chips) 
Seat 8: matiko09 ($105.71 in chips) 
Seat 9: xxxZeka ($103 in chips) 
Monsthand: posts small blind $0.50
I The King I: posts big blind $1
Rafaello18: sits out 
*** HOLE CARDS ***
Dealt to matiko09 [Ah 6d]
matiko09: folds 
xxxZeka: folds 
Oligarhs4: raises $2 to $3
scmastersrl: folds 
Monsthand: folds 
I The King I: folds 
Uncalled bet ($2) returned to Oligarhs4
Oligarhs4 collected $2.50 from pot
Oligarhs4: doesn't show hand 
*** SUMMARY ***
Total pot $2.50 | Rake $0 
Seat 3: Oligarhs4 collected ($2.50)
Seat 4: scmastersrl (button) folded before Flop (didn't bet)
Seat 5: Monsthand (small blind) folded before Flop
Seat 6: I The King I (big blind) folded before Flop
Seat 8: matiko09 folded before Flop (didn't bet)
Seat 9: xxxZeka folded before Flop (didn't bet)





PokerStars Hand #148220057842:  Hold'em No Limit ($0.50/$1.00 USD) - 2016/02/04 15:40:30 CET [2016/02/04 9:40:30 ET]
Table 'Mothallah' 9-max Seat #4 is the button
Seat 2: davianvalek ($120.20 in chips) 
Seat 3: ozone2003 ($128.77 in chips) 
Seat 4: YOUNG_G70 ($50.19 in chips) 
Seat 5: chaps1988 ($100 in chips) 
Seat 6: I The King I ($125.28 in chips) 
Seat 7: sanpidk ($100 in chips) 
Seat 8: Spid1 ($141.28 in chips) 
Seat 9: matiko09 ($104.50 in chips) 
chaps1988: posts small blind $0.50
I The King I: posts big blind $1
Rafaello18: sits out 
*** HOLE CARDS ***
Dealt to matiko09 [9h Th]
sanpidk: folds 
Spid1: folds 
matiko09: raises $2 to $3
davianvalek: folds 
ozone2003: folds 
YOUNG_G70: folds 
chaps1988: folds 
I The King I: folds 
Uncalled bet ($2) returned to matiko09
matiko09 collected $2.50 from pot
matiko09: doesn't show hand 
*** SUMMARY ***
Total pot $2.50 | Rake $0 
Seat 2: davianvalek folded before Flop (didn't bet)
Seat 3: ozone2003 folded before Flop (didn't bet)
Seat 4: YOUNG_G70 (button) folded before Flop (didn't bet)
Seat 5: chaps1988 (small blind) folded before Flop
Seat 6: I The King I (big blind) folded before Flop
Seat 7: sanpidk folded before Flop (didn't bet)
Seat 8: Spid1 folded before Flop (didn't bet)
Seat 9: matiko09 collected ($2.50)





PokerStars Hand #148220067123:  Hold'em No Limit ($0.50/$1.00 USD) - 2016/02/04 15:40:42 CET [2016/02/04 9:40:42 ET]
Table 'Isara' 9-max Seat #2 is the button
Seat 1: KLOP06031987 ($100 in chips) 
Seat 2: davianvalek ($129.73 in chips) 
Seat 3: Monsthand ($100 in chips) 
Seat 4: Dante63s ($109.99 in chips) 
Seat 5: Igor DoUrden ($100 in chips) 
Seat 7: warney1976 ($88.09 in chips) 
Seat 8: matiko09 ($100 in chips) 
Seat 9: chauyeuba ($78.79 in chips) 
Monsthand: posts small blind $0.50
Dante63s: posts big blind $1
Rafaello18: sits out 
*** HOLE CARDS ***
Dealt to matiko09 [Jh Kc]
Igor DoUrden: raises $1.50 to $2.50
warney1976: folds 
matiko09: folds 
chauyeuba: calls $2.50
KLOP06031987: folds 
davianvalek: folds 
Monsthand: folds 
Dante63s: folds 
*** FLOP *** [2h 8s 2c]
Igor DoUrden: checks 
chauyeuba: bets $4
Igor DoUrden: calls $4
*** TURN *** [2h 8s 2c] [Jc]
Igor DoUrden: checks 
chauyeuba: checks 
*** RIVER *** [2h 8s 2c Jc] [Kd]
Igor DoUrden: checks 
chauyeuba: checks 
*** SHOW DOWN ***
Igor DoUrden: shows [8h 8d] (a full house, Eights full of Deuces)
chauyeuba: mucks hand 
Igor DoUrden collected $13.85 from pot
*** SUMMARY ***
Total pot $14.50 | Rake $0.65 
Board [2h 8s 2c Jc Kd]
Seat 1: KLOP06031987 folded before Flop (didn't bet)
Seat 2: davianvalek (button) folded before Flop (didn't bet)
Seat 3: Monsthand (small blind) folded before Flop
Seat 4: Dante63s (big blind) folded before Flop
Seat 5: Igor DoUrden showed [8h 8d] and won ($13.85) with a full house, Eights full of Deuces
Seat 7: warney1976 folded before Flop (didn't bet)
Seat 8: matiko09 folded before Flop (didn't bet)
Seat 9: chauyeuba mucked [3s 3c]





PokerStars Hand #148220073933:  Hold'em No Limit ($0.50/$1.00 USD) - 2016/02/04 15:40:51 CET [2016/02/04 9:40:51 ET]
Table 'Arneb III' 9-max Seat #4 is the button
Seat 1: sanpidk ($100 in chips) 
Seat 2: JeanLima93 ($181.44 in chips) 
Seat 3: matiko09 ($148.14 in chips) 
Seat 4: Igor DoUrden ($251.03 in chips) 
Seat 5: tipner ($134.02 in chips) 
Seat 6: lumen21 ($100 in chips) 
Seat 7: xxxZeka ($100 in chips) 
Seat 8: volwebni4ek ($46.50 in chips) 
Seat 9: ARTVOR640 ($100 in chips) 
tipner: posts small blind $0.50
lumen21: posts big blind $1
*** HOLE CARDS ***
Dealt to matiko09 [3c 2s]
xxxZeka: folds 
volwebni4ek: raises $2 to $3
ARTVOR640: folds 
sanpidk: folds 
JeanLima93: folds 
matiko09: folds 
Igor DoUrden: folds 
tipner: folds 
lumen21: folds 
Uncalled bet ($2) returned to volwebni4ek
volwebni4ek collected $2.50 from pot
volwebni4ek: doesn't show hand 
*** SUMMARY ***
Total pot $2.50 | Rake $0 
Seat 1: sanpidk folded before Flop (didn't bet)
Seat 2: JeanLima93 folded before Flop (didn't bet)
Seat 3: matiko09 folded before Flop (didn't bet)
Seat 4: Igor DoUrden (button) folded before Flop (didn't bet)
Seat 5: tipner (small blind) folded before Flop
Seat 6: lumen21 (big blind) folded before Flop
Seat 7: xxxZeka folded before Flop (didn't bet)
Seat 8: volwebni4ek collected ($2.50)
Seat 9: ARTVOR640 folded before Flop (didn't bet)





PokerStars Hand #148220075254:  Hold'em No Limit ($0.50/$1.00 USD) - 2016/02/04 15:40:53 CET [2016/02/04 9:40:53 ET]
Table 'Amelia II' 9-max Seat #8 is the button
Seat 1: matiko09 ($100 in chips) 
Seat 2: WYY790125 ($119.59 in chips) 
Seat 4: Monsthand ($115.45 in chips) 
Seat 5: maxxmeister ($250 in chips) 
Seat 7: Spid1 ($185.59 in chips) 
Seat 8: Sweden_Pound ($250 in chips) 
Seat 9: Cikadejooo ($98.80 in chips) 
Cikadejooo: posts small blind $0.50
matiko09: posts big blind $1
Dante63s: sits out 
tipner: sits out 
matiko09: posts the ante $0.20
WYY790125: posts the ante $0.20
Monsthand: posts the ante $0.20
maxxmeister: posts the ante $0.20
Spid1: posts the ante $0.20
Sweden_Pound: posts the ante $0.20
Cikadejooo: posts the ante $0.20
*** HOLE CARDS ***
Dealt to matiko09 [Ac Th]
WYY790125: folds 
Monsthand: folds 
maxxmeister: raises $2.50 to $3.50
Spid1: folds 
Sweden_Pound: folds 
Cikadejooo: folds 
matiko09: folds 
Uncalled bet ($2.50) returned to maxxmeister
maxxmeister collected $3.90 from pot
maxxmeister: doesn't show hand 
*** SUMMARY ***
Total pot $3.90 | Rake $0 
Seat 1: matiko09 (big blind) folded before Flop
Seat 2: WYY790125 folded before Flop (didn't bet)
Seat 4: Monsthand folded before Flop (didn't bet)
Seat 5: maxxmeister collected ($3.90)
Seat 7: Spid1 folded before Flop (didn't bet)
Seat 8: Sweden_Pound (button) folded before Flop (didn't bet)
Seat 9: Cikadejooo (small blind) folded before Flop





PokerStars Hand #148220077319:  Hold'em No Limit ($0.50/$1.00 USD) - 2016/02/04 15:40:56 CET [2016/02/04 9:40:56 ET]
Table 'Gutemberga' 9-max Seat #5 is the button
Seat 3: Oligarhs4 ($68.37 in chips) 
Seat 4: scmastersrl ($126.98 in chips) 
Seat 5: Monsthand ($100 in chips) 
Seat 6: I The King I ($102.44 in chips) 
Seat 8: matiko09 ($105.71 in chips) 
Seat 9: xxxZeka ($103 in chips) 
I The King I: posts small blind $0.50
matiko09: posts big blind $1
RICKA16: sits out 
Rafaello18: sits out 
*** HOLE CARDS ***
Dealt to matiko09 [Jd 4h]
xxxZeka: folds 
Oligarhs4: folds 
scmastersrl: folds 
Monsthand: folds 
I The King I: raises $2 to $3
matiko09: folds 
Uncalled bet ($2) returned to I The King I
I The King I collected $2 from pot
I The King I: doesn't show hand 
*** SUMMARY ***
Total pot $2 | Rake $0 
Seat 3: Oligarhs4 folded before Flop (didn't bet)
Seat 4: scmastersrl folded before Flop (didn't bet)
Seat 5: Monsthand (button) folded before Flop (didn't bet)
Seat 6: I The King I (small blind) collected ($2)
Seat 8: matiko09 (big blind) folded before Flop
Seat 9: xxxZeka folded before Flop (didn't bet)





PokerStars Hand #148220078084:  Hold'em No Limit ($0.50/$1.00 USD) - 2016/02/04 15:40:57 CET [2016/02/04 9:40:57 ET]
Table 'Siarnaq' 9-max Seat #7 is the button
Seat 2: Igor DoUrden ($101.50 in chips) 
Seat 3: goblind4777 ($120.91 in chips) 
Seat 5: I The King I ($131.37 in chips) 
Seat 6: Monsthand ($100 in chips) 
Seat 7: matiko09 ($116.09 in chips) 
Seat 8: Sweden_Pound ($100 in chips) 
Seat 9: MagicKid777 ($100 in chips) 
Sweden_Pound: posts small blind $0.50
MagicKid777: posts big blind $1
Dante63s: sits out 
Spid1: sits out 
*** HOLE CARDS ***
Dealt to matiko09 [5d 2s]
Igor DoUrden: folds 
goblind4777: folds 
I The King I: folds 
Monsthand: folds 
matiko09: folds 
Sweden_Pound: raises $2 to $3
MagicKid777: folds 
Uncalled bet ($2) returned to Sweden_Pound
Sweden_Pound collected $2 from pot
Sweden_Pound: doesn't show hand 
*** SUMMARY ***
Total pot $2 | Rake $0 
Seat 2: Igor DoUrden folded before Flop (didn't bet)
Seat 3: goblind4777 folded before Flop (didn't bet)
Seat 5: I The King I folded before Flop (didn't bet)
Seat 6: Monsthand folded before Flop (didn't bet)
Seat 7: matiko09 (button) folded before Flop (didn't bet)
Seat 8: Sweden_Pound (small blind) collected ($2)
Seat 9: MagicKid777 (big blind) folded before Flop





PokerStars Hand #148220085912:  Hold'em No Limit ($0.50/$1.00 USD) - 2016/02/04 15:41:08 CET [2016/02/04 9:41:08 ET]
Table 'Avior II' 9-max Seat #1 is the button
Seat 1: I The King I ($100 in chips) 
Seat 2: matiko09 ($100.50 in chips) 
Seat 3: sanpidk ($137.50 in chips) 
Seat 5: chaps1988 ($101.50 in chips) 
Seat 6: tipner ($217.97 in chips) 
Seat 7: Monsthand ($103.50 in chips) 
Seat 8: EdHunder ($101.04 in chips) 
Seat 9: Venomous100% ($101.50 in chips) 
matiko09: posts small blind $0.50
sanpidk: posts big blind $1
maxxmeister: sits out 
*** HOLE CARDS ***
Dealt to matiko09 [9c Kc]
chaps1988: folds 
tipner: folds 
Monsthand: folds 
EdHunder: folds 
Venomous100%: folds 
I The King I: raises $1 to $2
matiko09: folds 
sanpidk: raises $5.50 to $7.50
I The King I: folds 
Uncalled bet ($5.50) returned to sanpidk
sanpidk collected $4.50 from pot
sanpidk: doesn't show hand 
*** SUMMARY ***
Total pot $4.50 | Rake $0 
Seat 1: I The King I (button) folded before Flop
Seat 2: matiko09 (small blind) folded before Flop
Seat 3: sanpidk (big blind) collected ($4.50)
Seat 5: chaps1988 folded before Flop (didn't bet)
Seat 6: tipner folded before Flop (didn't bet)
Seat 7: Monsthand folded before Flop (didn't bet)
Seat 8: EdHunder folded before Flop (didn't bet)
Seat 9: Venomous100% folded before Flop (didn't bet)





PokerStars Hand #148220087505:  Hold'em No Limit ($0.50/$1.00 USD) - 2016/02/04 15:41:10 CET [2016/02/04 9:41:10 ET]
Table 'Dejan' 9-max Seat #1 is the button
Seat 1: matiko09 ($100 in chips) 
Seat 2: xxxZeka ($102.25 in chips) 
Seat 3: lumen21 ($102 in chips) 
Seat 4: pruxa72 ($127.35 in chips) 
Seat 6: sanpidk ($243.14 in chips) 
Seat 8: s26s ($107.59 in chips) 
Seat 9: I The King I ($121.92 in chips) 
xxxZeka: posts small blind $0.50
lumen21: posts big blind $1
Rafaello18: sits out 
*** HOLE CARDS ***
Dealt to matiko09 [7s 6c]
pruxa72: folds 
sanpidk: folds 
s26s: calls $1
I The King I: folds 
matiko09: folds 
xxxZeka: folds 
lumen21: checks 
*** FLOP *** [Qh 3h Th]
lumen21: checks 
s26s: bets $2.39
lumen21: folds 
Uncalled bet ($2.39) returned to s26s
s26s collected $2.39 from pot
*** SUMMARY ***
Total pot $2.50 | Rake $0.11 
Board [Qh 3h Th]
Seat 1: matiko09 (button) folded before Flop (didn't bet)
Seat 2: xxxZeka (small blind) folded before Flop
Seat 3: lumen21 (big blind) folded on the Flop
Seat 4: pruxa72 folded before Flop (didn't bet)
Seat 6: sanpidk folded before Flop (didn't bet)
Seat 8: s26s collected ($2.39)
Seat 9: I The King I folded before Flop (didn't bet)





PokerStars Hand #148220088307:  Hold'em No Limit ($0.50/$1.00 USD) - 2016/02/04 15:41:11 CET [2016/02/04 9:41:11 ET]
Table 'Mothallah' 9-max Seat #5 is the button
Seat 2: davianvalek ($120.20 in chips) 
Seat 3: ozone2003 ($128.77 in chips) 
Seat 4: YOUNG_G70 ($50.19 in chips) 
Seat 5: chaps1988 ($100 in chips) 
Seat 6: I The King I ($124.28 in chips) 
Seat 7: sanpidk ($100 in chips) 
Seat 8: Spid1 ($141.28 in chips) 
Seat 9: matiko09 ($106 in chips) 
I The King I: posts small blind $0.50
sanpidk: posts big blind $1
Rafaello18: sits out 
*** HOLE CARDS ***
Dealt to matiko09 [Kh Jc]
Spid1: folds 
matiko09: folds 
davianvalek: folds 
ozone2003: folds 
YOUNG_G70: folds 
chaps1988: folds 
I The King I: raises $2 to $3
sanpidk: calls $2
*** FLOP *** [9c Ah 2h]
I The King I: checks 
sanpidk: bets $3
I The King I: folds 
Uncalled bet ($3) returned to sanpidk
sanpidk collected $5.73 from pot
sanpidk: doesn't show hand 
*** SUMMARY ***
Total pot $6 | Rake $0.27 
Board [9c Ah 2h]
Seat 2: davianvalek folded before Flop (didn't bet)
Seat 3: ozone2003 folded before Flop (didn't bet)
Seat 4: YOUNG_G70 folded before Flop (didn't bet)
Seat 5: chaps1988 (button) folded before Flop (didn't bet)
Seat 6: I The King I (small blind) folded on the Flop
Seat 7: sanpidk (big blind) collected ($5.73)
Seat 8: Spid1 folded before Flop (didn't bet)
Seat 9: matiko09 folded before Flop (didn't bet)





PokerStars Hand #148220093830:  Hold'em No Limit ($0.50/$1.00 USD) - 2016/02/04 15:41:18 CET [2016/02/04 9:41:18 ET]
Table 'Siarnaq' 9-max Seat #8 is the button
Seat 1: Dante63s ($100 in chips) 
Seat 2: Igor DoUrden ($101.50 in chips) 
Seat 3: goblind4777 ($120.91 in chips) 
Seat 5: I The King I ($131.37 in chips) 
Seat 6: Monsthand ($100 in chips) 
Seat 7: matiko09 ($116.09 in chips) 
Seat 8: Sweden_Pound ($101 in chips) 
Seat 9: MagicKid777 ($99 in chips) 
MagicKid777: posts small blind $0.50
Dante63s: posts big blind $1
Spid1: sits out 
*** HOLE CARDS ***
Dealt to matiko09 [7d 5s]
Igor DoUrden: folds 
goblind4777: folds 
I The King I: folds 
Monsthand: raises $1.50 to $2.50
matiko09: folds 
Sweden_Pound: folds 
MagicKid777: folds 
Dante63s: folds 
Uncalled bet ($1.50) returned to Monsthand
Monsthand collected $2.50 from pot
*** SUMMARY ***
Total pot $2.50 | Rake $0 
Seat 1: Dante63s (big blind) folded before Flop
Seat 2: Igor DoUrden folded before Flop (didn't bet)
Seat 3: goblind4777 folded before Flop (didn't bet)
Seat 5: I The King I folded before Flop (didn't bet)
Seat 6: Monsthand collected ($2.50)
Seat 7: matiko09 folded before Flop (didn't bet)
Seat 8: Sweden_Pound (button) folded before Flop (didn't bet)
Seat 9: MagicKid777 (small blind) folded before Flop





PokerStars Hand #148220096545:  Hold'em No Limit ($0.50/$1.00 USD) - 2016/02/04 15:41:22 CET [2016/02/04 9:41:22 ET]
Table 'Gutemberga' 9-max Seat #6 is the button
Seat 3: Oligarhs4 ($68.37 in chips) 
Seat 5: Monsthand ($100 in chips) 
Seat 6: I The King I ($103.44 in chips) 
Seat 8: matiko09 ($104.71 in chips) 
Seat 9: xxxZeka ($103 in chips) 
matiko09: posts small blind $0.50
xxxZeka: posts big blind $1
RICKA16: sits out 
Rafaello18: sits out 
*** HOLE CARDS ***
Dealt to matiko09 [6d 7c]
Oligarhs4: folds 
Monsthand: folds 
I The King I: folds 
matiko09: folds 
Uncalled bet ($0.50) returned to xxxZeka
xxxZeka collected $1 from pot
*** SUMMARY ***
Total pot $1 | Rake $0 
Seat 3: Oligarhs4 folded before Flop (didn't bet)
Seat 5: Monsthand folded before Flop (didn't bet)
Seat 6: I The King I (button) folded before Flop (didn't bet)
Seat 8: matiko09 (small blind) folded before Flop
Seat 9: xxxZeka (big blind) collected ($1)





PokerStars Hand #148220098904:  Hold'em No Limit ($0.50/$1.00 USD) - 2016/02/04 15:41:25 CET [2016/02/04 9:41:25 ET]
Table 'Arneb II' 9-max Seat #7 is the button
Seat 1: matiko09 ($105.38 in chips) 
Seat 2: sanpidk ($219.75 in chips) 
Seat 3: brille-390 ($148.02 in chips) 
Seat 4: Venomous100% ($101.16 in chips) 
Seat 6: volwebni4ek ($75.95 in chips) 
Seat 7: melitakas ($284.42 in chips) 
Seat 8: tedbadger9 ($76.66 in chips) 
Seat 9: tipner ($108.17 in chips) 
tedbadger9: posts small blind $0.50
tipner: posts big blind $1
lumen21: sits out 
*** HOLE CARDS ***
Dealt to matiko09 [4h Ac]
matiko09: folds 
sanpidk: folds 
brille-390: folds 
Venomous100%: folds 
volwebni4ek: folds 
melitakas: raises $1 to $2
tedbadger9: calls $1.50
tipner: folds 
*** FLOP *** [2d 3h 6c]
tedbadger9: checks 
melitakas: checks 
*** TURN *** [2d 3h 6c] [Qc]
tedbadger9: checks 
melitakas: checks 
*** RIVER *** [2d 3h 6c Qc] [3s]
tedbadger9: checks 
melitakas: checks 
*** SHOW DOWN ***
tedbadger9: shows [Ts 8s] (a pair of Threes)
melitakas: shows [7s As] (a pair of Threes - Ace kicker)
melitakas collected $4.78 from pot
*** SUMMARY ***
Total pot $5 | Rake $0.22 
Board [2d 3h 6c Qc 3s]
Seat 1: matiko09 folded before Flop (didn't bet)
Seat 2: sanpidk folded before Flop (didn't bet)
Seat 3: brille-390 folded before Flop (didn't bet)
Seat 4: Venomous100% folded before Flop (didn't bet)
Seat 6: volwebni4ek folded before Flop (didn't bet)
Seat 7: melitakas (button) showed [7s As] and won ($4.78) with a pair of Threes
Seat 8: tedbadger9 (small blind) showed [Ts 8s] and lost with a pair of Threes
Seat 9: tipner (big blind) folded before Flop





PokerStars Hand #148220100130:  Hold'em No Limit ($0.50/$1.00 USD) - 2016/02/04 15:41:27 CET [2016/02/04 9:41:27 ET]
Table 'Arneb III' 9-max Seat #5 is the button
Seat 1: sanpidk ($100 in chips) 
Seat 2: JeanLima93 ($181.44 in chips) 
Seat 3: matiko09 ($148.14 in chips) 
Seat 4: Igor DoUrden ($251.03 in chips) 
Seat 5: tipner ($133.52 in chips) 
Seat 6: lumen21 ($100 in chips) 
Seat 7: xxxZeka ($100 in chips) 
Seat 8: volwebni4ek ($48 in chips) 
Seat 9: ARTVOR640 ($100 in chips) 
lumen21: posts small blind $0.50
xxxZeka: posts big blind $1
*** HOLE CARDS ***
Dealt to matiko09 [Qh Ah]
volwebni4ek: folds 
ARTVOR640: folds 
sanpidk: folds 
JeanLima93: raises $2 to $3
matiko09: raises $5 to $8
Igor DoUrden: folds 
tipner: folds 
lumen21: folds 
xxxZeka: folds 
JeanLima93: calls $5
*** FLOP *** [As 3s 9c]
JeanLima93: bets $173.44 and is all-in
matiko09: calls $140.14 and is all-in
Uncalled bet ($33.30) returned to JeanLima93
*** TURN *** [As 3s 9c] [2c]
*** RIVER *** [As 3s 9c 2c] [Kd]
*** SHOW DOWN ***
JeanLima93: shows [Kh Ad] (two pair, Aces and Kings)
matiko09: mucks hand 
JeanLima93 collected $294.98 from pot
*** SUMMARY ***
Total pot $297.78 | Rake $2.80 
Board [As 3s 9c 2c Kd]
Seat 1: sanpidk folded before Flop (didn't bet)
Seat 2: JeanLima93 showed [Kh Ad] and won ($294.98) with two pair, Aces and Kings
Seat 3: matiko09 mucked [Qh Ah]
Seat 4: Igor DoUrden folded before Flop (didn't bet)
Seat 5: tipner (button) folded before Flop (didn't bet)
Seat 6: lumen21 (small blind) folded before Flop
Seat 7: xxxZeka (big blind) folded before Flop
Seat 8: volwebni4ek folded before Flop (didn't bet)
Seat 9: ARTVOR640 folded before Flop (didn't bet)





PokerStars Hand #148220099821:  Hold'em No Limit ($0.50/$1.00 USD) - 2016/02/04 15:41:27 CET [2016/02/04 9:41:27 ET]
Table 'Amelia II' 9-max Seat #9 is the button
Seat 1: matiko09 ($100 in chips) 
Seat 2: WYY790125 ($119.39 in chips) 
Seat 4: Monsthand ($115.25 in chips) 
Seat 5: maxxmeister ($252.70 in chips) 
Seat 7: Spid1 ($185.39 in chips) 
Seat 8: Sweden_Pound ($250 in chips) 
Seat 9: Cikadejooo ($98.10 in chips) 
matiko09: posts small blind $0.50
WYY790125: posts big blind $1
Dante63s: sits out 
tipner: sits out 
matiko09: posts the ante $0.20
WYY790125: posts the ante $0.20
Monsthand: posts the ante $0.20
maxxmeister: posts the ante $0.20
Spid1: posts the ante $0.20
Sweden_Pound: posts the ante $0.20
Cikadejooo: posts the ante $0.20
*** HOLE CARDS ***
Dealt to matiko09 [8c 2s]
Monsthand: folds 
maxxmeister: raises $2 to $3
Spid1: folds 
Sweden_Pound: folds 
Cikadejooo: calls $3
matiko09: folds 
WYY790125: folds 
*** FLOP *** [7c Qd Js]
maxxmeister: checks 
Cikadejooo: checks 
*** TURN *** [7c Qd Js] [9c]
maxxmeister: checks 
Cikadejooo: checks 
*** RIVER *** [7c Qd Js 9c] [9h]
maxxmeister: checks 
Cikadejooo: checks 
*** SHOW DOWN ***
maxxmeister: shows [4s 4d] (two pair, Nines and Fours)
Cikadejooo: shows [6d 6s] (two pair, Nines and Sixes)
Cikadejooo collected $8.50 from pot
*** SUMMARY ***
Total pot $8.90 | Rake $0.40 
Board [7c Qd Js 9c 9h]
Seat 1: matiko09 (small blind) folded before Flop
Seat 2: WYY790125 (big blind) folded before Flop
Seat 4: Monsthand folded before Flop (didn't bet)
Seat 5: maxxmeister showed [4s 4d] and lost with two pair, Nines and Fours
Seat 7: Spid1 folded before Flop (didn't bet)
Seat 8: Sweden_Pound folded before Flop (didn't bet)
Seat 9: Cikadejooo (button) showed [6d 6s] and won ($8.50) with two pair, Nines and Sixes





PokerStars Hand #148220105475:  Hold'em No Limit ($0.50/$1.00 USD) - 2016/02/04 15:41:34 CET [2016/02/04 9:41:34 ET]
Table 'Helio III' 9-max Seat #7 is the button
Seat 4: scmastersrl ($120.82 in chips) 
Seat 6: I The King I ($146.88 in chips) 
Seat 7: matiko09 ($100 in chips) 
Seat 8: Sweden_Pound ($100 in chips) 
Seat 9: pandalapa ($113.99 in chips) 
Sweden_Pound: posts small blind $0.50
pandalapa: posts big blind $1
MagicKid777: sits out 
RICKA16: sits out 
Rafaello18: sits out 
*** HOLE CARDS ***
Dealt to matiko09 [9d 8h]
scmastersrl: folds 
I The King I: folds 
matiko09: folds 
Sweden_Pound: raises $2 to $3
pandalapa: folds 
Uncalled bet ($2) returned to Sweden_Pound
Sweden_Pound collected $2 from pot
Sweden_Pound: doesn't show hand 
*** SUMMARY ***
Total pot $2 | Rake $0 
Seat 4: scmastersrl folded before Flop (didn't bet)
Seat 6: I The King I folded before Flop (didn't bet)
Seat 7: matiko09 (button) folded before Flop (didn't bet)
Seat 8: Sweden_Pound (small blind) collected ($2)
Seat 9: pandalapa (big blind) folded before Flop





PokerStars Hand #148220111790:  Hold'em No Limit ($0.50/$1.00 USD) - 2016/02/04 15:41:43 CET [2016/02/04 9:41:43 ET]
Table 'Siarnaq' 9-max Seat #9 is the button
Seat 1: Dante63s ($100 in chips) 
Seat 3: goblind4777 ($120.91 in chips) 
Seat 5: I The King I ($131.37 in chips) 
Seat 6: Monsthand ($101.50 in chips) 
Seat 7: matiko09 ($116.09 in chips) 
Seat 8: Sweden_Pound ($101 in chips) 
Seat 9: MagicKid777 ($98.50 in chips) 
Dante63s: posts small blind $0.50
Igor DoUrden: is sitting out 
goblind4777: posts big blind $1
Igor DoUrden leaves the table
Spid1: sits out 
*** HOLE CARDS ***
Dealt to matiko09 [2h 6s]
I The King I: raises $2 to $3
Monsthand: folds 
matiko09: folds 
Sweden_Pound: folds 
MagicKid777: folds 
Dante63s: folds 
goblind4777: folds 
Uncalled bet ($2) returned to I The King I
I The King I collected $2.50 from pot
I The King I: doesn't show hand 
*** SUMMARY ***
Total pot $2.50 | Rake $0 
Seat 1: Dante63s (small blind) folded before Flop
Seat 3: goblind4777 (big blind) folded before Flop
Seat 5: I The King I collected ($2.50)
Seat 6: Monsthand folded before Flop (didn't bet)
Seat 7: matiko09 folded before Flop (didn't bet)
Seat 8: Sweden_Pound folded before Flop (didn't bet)
Seat 9: MagicKid777 (button) folded before Flop (didn't bet)





PokerStars Hand #148220115169:  Hold'em No Limit ($0.50/$1.00 USD) - 2016/02/04 15:41:47 CET [2016/02/04 9:41:47 ET]
Table 'Gutemberga' 9-max Seat #8 is the button
Seat 1: RICKA16 ($100 in chips) 
Seat 3: Oligarhs4 ($68.37 in chips) 
Seat 5: Monsthand ($100 in chips) 
Seat 6: I The King I ($103.44 in chips) 
Seat 8: matiko09 ($104.21 in chips) 
Seat 9: xxxZeka ($103.50 in chips) 
xxxZeka: posts small blind $0.50
RICKA16: posts big blind $1
Rafaello18: sits out 
*** HOLE CARDS ***
Dealt to matiko09 [Ac Jc]
Oligarhs4: folds 
Monsthand: raises $1.50 to $2.50
I The King I: folds 
matiko09: calls $2.50
xxxZeka: folds 
RICKA16: folds 
*** FLOP *** [2c 6c Jh]
Monsthand: bets $4
matiko09: calls $4
*** TURN *** [2c 6c Jh] [9h]
Monsthand: checks 
matiko09: bets $9
Monsthand: raises $18.75 to $27.75
matiko09: calls $18.75
*** RIVER *** [2c 6c Jh 9h] [5c]
scmastersrl leaves the table
Monsthand: checks 
matiko09: bets $69.96 and is all-in
Monsthand: folds 
Uncalled bet ($69.96) returned to matiko09
Sweden_Pound joins the table at seat #4 
matiko09 collected $67.20 from pot
matiko09: doesn't show hand 
*** SUMMARY ***
Total pot $70 | Rake $2.80 
Board [2c 6c Jh 9h 5c]
Seat 1: RICKA16 (big blind) folded before Flop
Seat 3: Oligarhs4 folded before Flop (didn't bet)
Seat 5: Monsthand folded on the River
Seat 6: I The King I folded before Flop (didn't bet)
Seat 8: matiko09 (button) collected ($67.20)
Seat 9: xxxZeka (small blind) folded before Flop





PokerStars Hand #148220115304:  Hold'em No Limit ($0.50/$1.00 USD) - 2016/02/04 15:41:48 CET [2016/02/04 9:41:48 ET]
Table 'Isara' 9-max Seat #3 is the button
Seat 1: KLOP06031987 ($100 in chips) 
Seat 2: davianvalek ($129.73 in chips) 
Seat 3: Monsthand ($100 in chips) 
Seat 4: Dante63s ($108.99 in chips) 
Seat 5: Igor DoUrden ($107.35 in chips) 
Seat 7: warney1976 ($88.09 in chips) 
Seat 8: matiko09 ($100 in chips) 
Seat 9: chauyeuba ($72.29 in chips) 
Dante63s: posts small blind $0.50
Igor DoUrden: posts big blind $1
Rafaello18: sits out 
*** HOLE CARDS ***
Dealt to matiko09 [6s 7h]
warney1976: folds 
matiko09: folds 
chauyeuba: folds 
KLOP06031987: folds 
davianvalek: folds 
Monsthand: raises $1 to $2
Dante63s: folds 
Igor DoUrden: folds 
Uncalled bet ($1) returned to Monsthand
Monsthand collected $2.50 from pot
*** SUMMARY ***
Total pot $2.50 | Rake $0 
Seat 1: KLOP06031987 folded before Flop (didn't bet)
Seat 2: davianvalek folded before Flop (didn't bet)
Seat 3: Monsthand (button) collected ($2.50)
Seat 4: Dante63s (small blind) folded before Flop
Seat 5: Igor DoUrden (big blind) folded before Flop
Seat 7: warney1976 folded before Flop (didn't bet)
Seat 8: matiko09 folded before Flop (didn't bet)
Seat 9: chauyeuba folded before Flop (didn't bet)





PokerStars Hand #148220116694:  Hold'em No Limit ($0.50/$1.00 USD) - 2016/02/04 15:41:50 CET [2016/02/04 9:41:50 ET]
Table 'Avior II' 9-max Seat #2 is the button
Seat 1: I The King I ($100 in chips) 
Seat 2: matiko09 ($100 in chips) 
Seat 3: sanpidk ($140 in chips) 
Seat 4: maxxmeister ($100 in chips) 
Seat 5: chaps1988 ($101.50 in chips) 
Seat 6: tipner ($217.97 in chips) 
Seat 7: Monsthand ($103.50 in chips) 
Seat 8: EdHunder ($101.04 in chips) 
Seat 9: Venomous100% ($101.50 in chips) 
sanpidk: posts small blind $0.50
maxxmeister: posts big blind $1
*** HOLE CARDS ***
Dealt to matiko09 [8s 5c]
chaps1988: folds 
tipner: folds 
Monsthand: folds 
EdHunder: raises $2 to $3
Venomous100%: folds 
I The King I: folds 
matiko09: folds 
sanpidk: folds 
maxxmeister: calls $2
*** FLOP *** [3s 4s 5h]
maxxmeister: checks 
EdHunder: bets $6
maxxmeister: raises $11.76 to $17.76
EdHunder: calls $11.76
*** TURN *** [3s 4s 5h] [Th]
maxxmeister: checks 
EdHunder: checks 
*** RIVER *** [3s 4s 5h Th] [3c]
maxxmeister: bets $21.75
EdHunder: folds 
Uncalled bet ($21.75) returned to maxxmeister
maxxmeister collected $40.13 from pot
maxxmeister: doesn't show hand 
*** SUMMARY ***
Total pot $42.02 | Rake $1.89 
Board [3s 4s 5h Th 3c]
Seat 1: I The King I folded before Flop (didn't bet)
Seat 2: matiko09 (button) folded before Flop (didn't bet)
Seat 3: sanpidk (small blind) folded before Flop
Seat 4: maxxmeister (big blind) collected ($40.13)
Seat 5: chaps1988 folded before Flop (didn't bet)
Seat 6: tipner folded before Flop (didn't bet)
Seat 7: Monsthand folded before Flop (didn't bet)
Seat 8: EdHunder folded on the River
Seat 9: Venomous100% folded before Flop (didn't bet)





PokerStars Hand #148220119786:  Hold'em No Limit ($0.50/$1.00 USD) - 2016/02/04 15:41:54 CET [2016/02/04 9:41:54 ET]
Table 'Dejan' 9-max Seat #2 is the button
Seat 1: matiko09 ($100 in chips) 
Seat 2: xxxZeka ($101.75 in chips) 
Seat 3: lumen21 ($101 in chips) 
Seat 4: pruxa72 ($127.35 in chips) 
Seat 6: sanpidk ($243.14 in chips) 
Seat 8: s26s ($108.98 in chips) 
Seat 9: I The King I ($121.92 in chips) 
lumen21: posts small blind $0.50
pruxa72: posts big blind $1
Rafaello18: sits out 
*** HOLE CARDS ***
Dealt to matiko09 [7c 3c]
sanpidk: raises $2 to $3
s26s: calls $3
I The King I: folds 
matiko09: folds 
xxxZeka: folds 
lumen21: folds 
pruxa72: folds 
*** FLOP *** [Qd 2d 4h]
sanpidk: bets $5
s26s: calls $5
*** TURN *** [Qd 2d 4h] [6s]
sanpidk: checks 
s26s: checks 
*** RIVER *** [Qd 2d 4h 6s] [Jd]
sanpidk: checks 
s26s: checks 
*** SHOW DOWN ***
sanpidk: shows [Js Ad] (a pair of Jacks)
s26s: shows [Ac Qc] (a pair of Queens)
s26s collected $16.71 from pot
*** SUMMARY ***
Total pot $17.50 | Rake $0.79 
Board [Qd 2d 4h 6s Jd]
Seat 1: matiko09 folded before Flop (didn't bet)
Seat 2: xxxZeka (button) folded before Flop (didn't bet)
Seat 3: lumen21 (small blind) folded before Flop
Seat 4: pruxa72 (big blind) folded before Flop
Seat 6: sanpidk showed [Js Ad] and lost with a pair of Jacks
Seat 8: s26s showed [Ac Qc] and won ($16.71) with a pair of Queens
Seat 9: I The King I folded before Flop (didn't bet)





PokerStars Hand #148220124721:  Hold'em No Limit ($0.50/$1.00 USD) - 2016/02/04 15:42:00 CET [2016/02/04 9:42:00 ET]
Table 'Mothallah' 9-max Seat #6 is the button
Seat 2: davianvalek ($120.20 in chips) 
Seat 3: ozone2003 ($128.77 in chips) 
Seat 4: YOUNG_G70 ($50.19 in chips) 
Seat 5: chaps1988 ($100 in chips) 
Seat 6: I The King I ($121.28 in chips) 
Seat 7: sanpidk ($102.73 in chips) 
Seat 8: Spid1 ($141.28 in chips) 
Seat 9: matiko09 ($106 in chips) 
sanpidk: posts small blind $0.50
Spid1: posts big blind $1
Rafaello18: sits out 
*** HOLE CARDS ***
Dealt to matiko09 [Qs 2h]
matiko09: folds 
davianvalek: folds 
ozone2003: folds 
YOUNG_G70: calls $1
chaps1988: folds 
I The King I: folds 
sanpidk: raises $4 to $5
Spid1: folds 
YOUNG_G70: calls $4
*** FLOP *** [4d 2d 6d]
sanpidk: bets $9.50
YOUNG_G70: raises $35.69 to $45.19 and is all-in
sanpidk: calls $35.69
*** TURN *** [4d 2d 6d] [3s]
*** RIVER *** [4d 2d 6d 3s] [Tc]
*** SHOW DOWN ***
sanpidk: shows [9c 9s] (a pair of Nines)
YOUNG_G70: shows [3d 7d] (a flush, Seven high)
YOUNG_G70 collected $98.58 from pot
*** SUMMARY ***
Total pot $101.38 | Rake $2.80 
Board [4d 2d 6d 3s Tc]
Seat 2: davianvalek folded before Flop (didn't bet)
Seat 3: ozone2003 folded before Flop (didn't bet)
Seat 4: YOUNG_G70 showed [3d 7d] and won ($98.58) with a flush, Seven high
Seat 5: chaps1988 folded before Flop (didn't bet)
Seat 6: I The King I (button) folded before Flop (didn't bet)
Seat 7: sanpidk (small blind) showed [9c 9s] and lost with a pair of Nines
Seat 8: Spid1 (big blind) folded before Flop
Seat 9: matiko09 folded before Flop (didn't bet)





PokerStars Hand #148220125947:  Hold'em No Limit ($0.50/$1.00 USD) - 2016/02/04 15:42:02 CET [2016/02/04 9:42:02 ET]
Table 'Helio III' 9-max Seat #8 is the button
Seat 1: MagicKid777 ($100 in chips) 
Seat 6: I The King I ($146.88 in chips) 
Seat 7: matiko09 ($100 in chips) 
Seat 8: Sweden_Pound ($101 in chips) 
Seat 9: pandalapa ($112.99 in chips) 
pandalapa: posts small blind $0.50
MagicKid777: posts big blind $1
RICKA16: sits out 
Rafaello18: sits out 
*** HOLE CARDS ***
Dealt to matiko09 [9c 8h]
I The King I: raises $2 to $3
matiko09: folds 
Sweden_Pound: folds 
pandalapa: folds 
MagicKid777: calls $2
*** FLOP *** [Th 7s 3c]
MagicKid777: checks 
I The King I: bets $4
MagicKid777: folds 
Uncalled bet ($4) returned to I The King I
I The King I collected $6.21 from pot
I The King I: doesn't show hand 
*** SUMMARY ***
Total pot $6.50 | Rake $0.29 
Board [Th 7s 3c]
Seat 1: MagicKid777 (big blind) folded on the Flop
Seat 6: I The King I collected ($6.21)
Seat 7: matiko09 folded before Flop (didn't bet)
Seat 8: Sweden_Pound (button) folded before Flop (didn't bet)
Seat 9: pandalapa (small blind) folded before Flop





PokerStars Hand #148220132674:  Hold'em No Limit ($0.50/$1.00 USD) - 2016/02/04 15:42:11 CET [2016/02/04 9:42:11 ET]
Table 'Arneb II' 9-max Seat #8 is the button
Seat 1: matiko09 ($105.38 in chips) 
Seat 2: sanpidk ($219.75 in chips) 
Seat 3: brille-390 ($148.02 in chips) 
Seat 4: Venomous100% ($101.16 in chips) 
Seat 6: volwebni4ek ($75.95 in chips) 
Seat 7: melitakas ($287.20 in chips) 
Seat 8: tedbadger9 ($74.66 in chips) 
Seat 9: tipner ($107.17 in chips) 
tipner: posts small blind $0.50
matiko09: posts big blind $1
lumen21: sits out 
*** HOLE CARDS ***
Dealt to matiko09 [6s 8s]
sanpidk: folds 
brille-390: folds 
Venomous100%: folds 
volwebni4ek: folds 
melitakas: folds 
tedbadger9: raises $2 to $3
tipner: folds 
matiko09: folds 
Uncalled bet ($2) returned to tedbadger9
tedbadger9 collected $2.50 from pot
*** SUMMARY ***
Total pot $2.50 | Rake $0 
Seat 1: matiko09 (big blind) folded before Flop
Seat 2: sanpidk folded before Flop (didn't bet)
Seat 3: brille-390 folded before Flop (didn't bet)
Seat 4: Venomous100% folded before Flop (didn't bet)
Seat 6: volwebni4ek folded before Flop (didn't bet)
Seat 7: melitakas folded before Flop (didn't bet)
Seat 8: tedbadger9 (button) collected ($2.50)
Seat 9: tipner (small blind) folded before Flop





PokerStars Hand #148220137197:  Hold'em No Limit ($0.50/$1.00 USD) - 2016/02/04 15:42:17 CET [2016/02/04 9:42:17 ET]
Table 'Siarnaq' 9-max Seat #1 is the button
Seat 1: Dante63s ($100 in chips) 
Seat 3: goblind4777 ($119.91 in chips) 
Seat 4: Spid1 ($100 in chips) 
Seat 5: I The King I ($132.87 in chips) 
Seat 6: Monsthand ($101.50 in chips) 
Seat 7: matiko09 ($116.09 in chips) 
Seat 8: Sweden_Pound ($101 in chips) 
Seat 9: MagicKid777 ($98.50 in chips) 
goblind4777: posts small blind $0.50
Spid1: posts big blind $1
*** HOLE CARDS ***
Dealt to matiko09 [Ac Td]
I The King I: folds 
Monsthand: folds 
matiko09: folds 
Sweden_Pound: folds 
MagicKid777: folds 
Dante63s: raises $1 to $2
V.Barinov joins the table at seat #2 
goblind4777: calls $1.50
Spid1: calls $1
*** FLOP *** [Kd 4h 6d]
goblind4777: checks 
Spid1: checks 
Dante63s: checks 
*** TURN *** [Kd 4h 6d] [7h]
goblind4777: checks 
Spid1: bets $4.50
Dante63s: folds 
goblind4777: calls $4.50
*** RIVER *** [Kd 4h 6d 7h] [4d]
goblind4777: checks 
Spid1: bets $11
goblind4777: raises $26 to $37
Spid1: folds 
Uncalled bet ($26) returned to goblind4777
goblind4777 collected $35.34 from pot
goblind4777: doesn't show hand 
*** SUMMARY ***
Total pot $37 | Rake $1.66 
Board [Kd 4h 6d 7h 4d]
Seat 1: Dante63s (button) folded on the Turn
Seat 3: goblind4777 (small blind) collected ($35.34)
Seat 4: Spid1 (big blind) folded on the River
Seat 5: I The King I folded before Flop (didn't bet)
Seat 6: Monsthand folded before Flop (didn't bet)
Seat 7: matiko09 folded before Flop (didn't bet)
Seat 8: Sweden_Pound folded before Flop (didn't bet)
Seat 9: MagicKid777 folded before Flop (didn't bet)





PokerStars Hand #148220137489:  Hold'em No Limit ($0.50/$1.00 USD) - 2016/02/04 15:42:17 CET [2016/02/04 9:42:17 ET]
Table 'Isara' 9-max Seat #4 is the button
Seat 1: KLOP06031987 ($100 in chips) 
Seat 2: davianvalek ($129.73 in chips) 
Seat 3: Monsthand ($101.50 in chips) 
Seat 4: Dante63s ($108.49 in chips) 
Seat 5: Igor DoUrden ($106.35 in chips) 
Seat 6: Rafaello18 ($157.55 in chips) 
Seat 7: warney1976 ($88.09 in chips) 
Seat 8: matiko09 ($100 in chips) 
Seat 9: chauyeuba ($72.29 in chips) 
Igor DoUrden: posts small blind $0.50
Rafaello18: posts big blind $1
*** HOLE CARDS ***
Dealt to matiko09 [8h 9h]
warney1976: folds 
matiko09: raises $2 to $3
chauyeuba: calls $3
KLOP06031987: folds 
davianvalek: folds 
Monsthand: folds 
Dante63s: folds 
Igor DoUrden: folds 
Rafaello18: folds 
*** FLOP *** [2h 4h 2d]
matiko09: bets $4.65
chauyeuba: calls $4.65
*** TURN *** [2h 4h 2d] [Kc]
matiko09: bets $10
chauyeuba: folds 
Uncalled bet ($10) returned to matiko09
matiko09 collected $16.04 from pot
matiko09: doesn't show hand 
*** SUMMARY ***
Total pot $16.80 | Rake $0.76 
Board [2h 4h 2d Kc]
Seat 1: KLOP06031987 folded before Flop (didn't bet)
Seat 2: davianvalek folded before Flop (didn't bet)
Seat 3: Monsthand folded before Flop (didn't bet)
Seat 4: Dante63s (button) folded before Flop (didn't bet)
Seat 5: Igor DoUrden (small blind) folded before Flop
Seat 6: Rafaello18 (big blind) folded before Flop
Seat 7: warney1976 folded before Flop (didn't bet)
Seat 8: matiko09 collected ($16.04)
Seat 9: chauyeuba folded on the Turn





PokerStars Hand #148220153256:  Hold'em No Limit ($0.50/$1.00 USD) - 2016/02/04 15:42:39 CET [2016/02/04 9:42:39 ET]
Table 'Arneb II' 9-max Seat #9 is the button
Seat 1: matiko09 ($104.38 in chips) 
Seat 2: sanpidk ($219.75 in chips) 
Seat 3: brille-390 ($148.02 in chips) 
Seat 4: Venomous100% ($101.16 in chips) 
Seat 6: volwebni4ek ($75.95 in chips) 
Seat 7: melitakas ($287.20 in chips) 
Seat 8: tedbadger9 ($76.16 in chips) 
Seat 9: tipner ($106.67 in chips) 
matiko09: posts small blind $0.50
sanpidk: posts big blind $1
lumen21: sits out 
*** HOLE CARDS ***
Dealt to matiko09 [9c 8c]
brille-390: folds 
Venomous100%: raises $2 to $3
volwebni4ek: folds 
melitakas: calls $3
tedbadger9: calls $3
tipner: raises $11 to $14
matiko09: folds 
sanpidk: folds 
Venomous100%: folds 
melitakas: folds 
tedbadger9: folds 
Uncalled bet ($11) returned to tipner
tipner collected $13.50 from pot
tipner: doesn't show hand 
*** SUMMARY ***
Total pot $13.50 | Rake $0 
Seat 1: matiko09 (small blind) folded before Flop
Seat 2: sanpidk (big blind) folded before Flop
Seat 3: brille-390 folded before Flop (didn't bet)
Seat 4: Venomous100% folded before Flop
Seat 6: volwebni4ek folded before Flop (didn't bet)
Seat 7: melitakas folded before Flop
Seat 8: tedbadger9 folded before Flop
Seat 9: tipner (button) collected ($13.50)





PokerStars Hand #148220153847:  Hold'em No Limit ($0.50/$1.00 USD) - 2016/02/04 15:42:40 CET [2016/02/04 9:42:40 ET]
Table 'Helio III' 9-max Seat #9 is the button
Seat 1: MagicKid777 ($97 in chips) 
Seat 3: RICKA16 ($104.31 in chips) 
Seat 6: I The King I ($150.09 in chips) 
Seat 7: matiko09 ($100 in chips) 
Seat 8: Sweden_Pound ($101 in chips) 
Seat 9: pandalapa ($112.49 in chips) 
MagicKid777: posts small blind $0.50
RICKA16: posts big blind $1
Rafaello18: sits out 
*** HOLE CARDS ***
Dealt to matiko09 [Qs 2d]
I The King I: folds 
matiko09: folds 
Sweden_Pound: raises $1.50 to $2.50
pandalapa: folds 
MagicKid777: folds 
RICKA16: folds 
Uncalled bet ($1.50) returned to Sweden_Pound
Sweden_Pound collected $2.50 from pot
Sweden_Pound: doesn't show hand 
*** SUMMARY ***
Total pot $2.50 | Rake $0 
Seat 1: MagicKid777 (small blind) folded before Flop
Seat 3: RICKA16 (big blind) folded before Flop
Seat 6: I The King I folded before Flop (didn't bet)
Seat 7: matiko09 folded before Flop (didn't bet)
Seat 8: Sweden_Pound collected ($2.50)
Seat 9: pandalapa (button) folded before Flop (didn't bet)





PokerStars Hand #148220157380:  Hold'em No Limit ($0.50/$1.00 USD) - 2016/02/04 15:42:45 CET [2016/02/04 9:42:45 ET]
Table 'Arneb III' 9-max Seat #6 is the button
Seat 1: sanpidk ($100 in chips) 
Seat 2: JeanLima93 ($328.28 in chips) 
Seat 3: matiko09 ($100 in chips) 
Seat 4: Igor DoUrden ($251.03 in chips) 
Seat 5: tipner ($133.52 in chips) 
Seat 6: lumen21 ($100 in chips) 
Seat 7: xxxZeka ($100 in chips) 
Seat 8: volwebni4ek ($48 in chips) 
Seat 9: ARTVOR640 ($100 in chips) 
xxxZeka: posts small blind $0.50
volwebni4ek: posts big blind $1
*** HOLE CARDS ***
Dealt to matiko09 [As Ac]
ARTVOR640: folds 
sanpidk: folds 
JeanLima93: folds 
matiko09: raises $2 to $3
Igor DoUrden: folds 
tipner: folds 
lumen21: folds 
xxxZeka: folds 
volwebni4ek: folds 
Uncalled bet ($2) returned to matiko09
matiko09 collected $2.50 from pot
matiko09: doesn't show hand 
*** SUMMARY ***
Total pot $2.50 | Rake $0 
Seat 1: sanpidk folded before Flop (didn't bet)
Seat 2: JeanLima93 folded before Flop (didn't bet)
Seat 3: matiko09 collected ($2.50)
Seat 4: Igor DoUrden folded before Flop (didn't bet)
Seat 5: tipner folded before Flop (didn't bet)
Seat 6: lumen21 (button) folded before Flop (didn't bet)
Seat 7: xxxZeka (small blind) folded before Flop
Seat 8: volwebni4ek (big blind) folded before Flop
Seat 9: ARTVOR640 folded before Flop (didn't bet)





PokerStars Hand #148220158519:  Hold'em No Limit ($0.50/$1.00 USD) - 2016/02/04 15:42:46 CET [2016/02/04 9:42:46 ET]
Table 'Amelia II' 9-max Seat #1 is the button
Seat 1: matiko09 ($100 in chips) 
Seat 2: WYY790125 ($118.19 in chips) 
Seat 3: Dante63s ($200 in chips) 
Seat 4: Monsthand ($115.05 in chips) 
Seat 5: maxxmeister ($250 in chips) 
Seat 7: Spid1 ($185.19 in chips) 
Seat 8: Sweden_Pound ($250 in chips) 
Seat 9: Cikadejooo ($103.40 in chips) 
WYY790125: posts small blind $0.50
Dante63s: posts big blind $1
tipner: sits out 
matiko09: posts the ante $0.20
WYY790125: posts the ante $0.20
Dante63s: posts the ante $0.20
Monsthand: posts the ante $0.20
maxxmeister: posts the ante $0.20
Spid1: posts the ante $0.20
Sweden_Pound: posts the ante $0.20
Cikadejooo: posts the ante $0.20
*** HOLE CARDS ***
Dealt to matiko09 [Th 3s]
Monsthand: folds 
maxxmeister: folds 
Spid1: folds 
Sweden_Pound: raises $2 to $3
Cikadejooo: raises $6 to $9
matiko09: folds 
WYY790125: folds 
Dante63s: folds 
Sweden_Pound: calls $6
*** FLOP *** [2h Jd 6s]
Sweden_Pound: checks 
Cikadejooo: bets $94.20 and is all-in
Sweden_Pound: calls $94.20
*** TURN *** [2h Jd 6s] [4s]
*** RIVER *** [2h Jd 6s 4s] [5d]
*** SHOW DOWN ***
Sweden_Pound: shows [8s 8d] (a pair of Eights)
Cikadejooo: shows [Kd Kc] (a pair of Kings)
Cikadejooo collected $206.70 from pot
*** SUMMARY ***
Total pot $209.50 | Rake $2.80 
Board [2h Jd 6s 4s 5d]
Seat 1: matiko09 (button) folded before Flop (didn't bet)
Seat 2: WYY790125 (small blind) folded before Flop
Seat 3: Dante63s (big blind) folded before Flop
Seat 4: Monsthand folded before Flop (didn't bet)
Seat 5: maxxmeister folded before Flop (didn't bet)
Seat 7: Spid1 folded before Flop (didn't bet)
Seat 8: Sweden_Pound showed [8s 8d] and lost with a pair of Eights
Seat 9: Cikadejooo showed [Kd Kc] and won ($206.70) with a pair of Kings





PokerStars Hand #148220162194:  Hold'em No Limit ($0.50/$1.00 USD) - 2016/02/04 15:42:51 CET [2016/02/04 9:42:51 ET]
Table 'Mothallah' 9-max Seat #7 is the button
Seat 2: davianvalek ($120.20 in chips) 
Seat 3: ozone2003 ($128.77 in chips) 
Seat 4: YOUNG_G70 ($98.58 in chips) 
Seat 5: chaps1988 ($100 in chips) 
Seat 6: I The King I ($121.28 in chips) 
Seat 7: sanpidk ($100 in chips) 
Seat 8: Spid1 ($140.28 in chips) 
Seat 9: matiko09 ($106 in chips) 
Spid1: posts small blind $0.50
matiko09: posts big blind $1
Rafaello18: sits out 
*** HOLE CARDS ***
Dealt to matiko09 [6h Jh]
davianvalek: folds 
ozone2003: raises $2 to $3
YOUNG_G70: folds 
chaps1988: folds 
I The King I: calls $3
sanpidk: folds 
Spid1: folds 
matiko09: folds 
*** FLOP *** [Jd 7c Qh]
ozone2003: bets $6
I The King I: folds 
Uncalled bet ($6) returned to ozone2003
ozone2003 collected $7.16 from pot
ozone2003: doesn't show hand 
*** SUMMARY ***
Total pot $7.50 | Rake $0.34 
Board [Jd 7c Qh]
Seat 2: davianvalek folded before Flop (didn't bet)
Seat 3: ozone2003 collected ($7.16)
Seat 4: YOUNG_G70 folded before Flop (didn't bet)
Seat 5: chaps1988 folded before Flop (didn't bet)
Seat 6: I The King I folded on the Flop
Seat 7: sanpidk (button) folded before Flop (didn't bet)
Seat 8: Spid1 (small blind) folded before Flop
Seat 9: matiko09 (big blind) folded before Flop





PokerStars Hand #148220167127:  Hold'em No Limit ($0.50/$1.00 USD) - 2016/02/04 15:42:58 CET [2016/02/04 9:42:58 ET]
Table 'Helio III' 9-max Seat #1 is the button
Seat 1: MagicKid777 ($96.50 in chips) 
Seat 3: RICKA16 ($103.31 in chips) 
Seat 5: Rafaello18 ($108.68 in chips) 
Seat 6: I The King I ($150.09 in chips) 
Seat 7: matiko09 ($100 in chips) 
Seat 8: Sweden_Pound ($102.50 in chips) 
Seat 9: pandalapa ($112.49 in chips) 
RICKA16: posts small blind $0.50
Rafaello18: posts big blind $1
*** HOLE CARDS ***
Dealt to matiko09 [3d 8d]
I The King I: folds 
matiko09: folds 
Sweden_Pound: folds 
pandalapa: folds 
MagicKid777: raises $2 to $3
RICKA16: calls $2.50
scmastersrl leaves the table
Rafaello18: folds 
*** FLOP *** [6d Ad As]
RICKA16 has timed out
RICKA16: checks 
MagicKid777: checks 
*** TURN *** [6d Ad As] [Qh]
RSBoris joins the table at seat #4 
RICKA16 has timed out
RICKA16: checks 
MagicKid777: bets $4
RICKA16: folds 
Uncalled bet ($4) returned to MagicKid777
MagicKid777 collected $6.68 from pot
MagicKid777: doesn't show hand 
*** SUMMARY ***
Total pot $7 | Rake $0.32 
Board [6d Ad As Qh]
Seat 1: MagicKid777 (button) collected ($6.68)
Seat 3: RICKA16 (small blind) folded on the Turn
Seat 5: Rafaello18 (big blind) folded before Flop
Seat 6: I The King I folded before Flop (didn't bet)
Seat 7: matiko09 folded before Flop (didn't bet)
Seat 8: Sweden_Pound folded before Flop (didn't bet)
Seat 9: pandalapa folded before Flop (didn't bet)





PokerStars Hand #148220168212:  Hold'em No Limit ($0.50/$1.00 USD) - 2016/02/04 15:42:59 CET [2016/02/04 9:42:59 ET]
Table 'Dejan' 9-max Seat #3 is the button
Seat 1: matiko09 ($100 in chips) 
Seat 2: xxxZeka ($101.75 in chips) 
Seat 3: lumen21 ($100.50 in chips) 
Seat 4: pruxa72 ($126.35 in chips) 
Seat 5: Rafaello18 ($123.84 in chips) 
Seat 6: sanpidk ($235.14 in chips) 
Seat 8: s26s ($117.69 in chips) 
Seat 9: I The King I ($121.92 in chips) 
pruxa72: posts small blind $0.50
Rafaello18: posts big blind $1
*** HOLE CARDS ***
Dealt to matiko09 [6d 3c]
sanpidk: folds 
s26s: calls $1
I The King I: folds 
matiko09: folds 
xxxZeka: folds 
lumen21: raises $3.50 to $4.50
pruxa72: folds 
Rafaello18: folds 
s26s: calls $3.50
*** FLOP *** [Td 7d Kd]
s26s: checks 
lumen21: bets $5.51
s26s: raises $10.52 to $16.03
lumen21: folds 
Uncalled bet ($10.52) returned to s26s
s26s collected $20.55 from pot
*** SUMMARY ***
Total pot $21.52 | Rake $0.97 
Board [Td 7d Kd]
Seat 1: matiko09 folded before Flop (didn't bet)
Seat 2: xxxZeka folded before Flop (didn't bet)
Seat 3: lumen21 (button) folded on the Flop
Seat 4: pruxa72 (small blind) folded before Flop
Seat 5: Rafaello18 (big blind) folded before Flop
Seat 6: sanpidk folded before Flop (didn't bet)
Seat 8: s26s collected ($20.55)
Seat 9: I The King I folded before Flop (didn't bet)





PokerStars Hand #148220178506:  Hold'em No Limit ($0.50/$1.00 USD) - 2016/02/04 15:43:13 CET [2016/02/04 9:43:13 ET]
Table 'Avior II' 9-max Seat #3 is the button
Seat 1: I The King I ($100 in chips) 
Seat 2: matiko09 ($100 in chips) 
Seat 3: sanpidk ($139.50 in chips) 
Seat 4: maxxmeister ($119.37 in chips) 
Seat 5: chaps1988 ($101.50 in chips) 
Seat 6: tipner ($217.97 in chips) 
Seat 7: Monsthand ($103.50 in chips) 
Seat 8: EdHunder ($80.28 in chips) 
Seat 9: Venomous100% ($101.50 in chips) 
maxxmeister: posts small blind $0.50
chaps1988: posts big blind $1
*** HOLE CARDS ***
Dealt to matiko09 [Qc 9c]
tipner: folds 
Monsthand: folds 
EdHunder: folds 
Venomous100%: folds 
I The King I: folds 
matiko09: folds 
sanpidk: raises $1.24 to $2.24
maxxmeister: folds 
chaps1988: folds 
Uncalled bet ($1.24) returned to sanpidk
sanpidk collected $2.50 from pot
sanpidk: doesn't show hand 
*** SUMMARY ***
Total pot $2.50 | Rake $0 
Seat 1: I The King I folded before Flop (didn't bet)
Seat 2: matiko09 folded before Flop (didn't bet)
Seat 3: sanpidk (button) collected ($2.50)
Seat 4: maxxmeister (small blind) folded before Flop
Seat 5: chaps1988 (big blind) folded before Flop
Seat 6: tipner folded before Flop (didn't bet)
Seat 7: Monsthand folded before Flop (didn't bet)
Seat 8: EdHunder folded before Flop (didn't bet)
Seat 9: Venomous100% folded before Flop (didn't bet)





PokerStars Hand #148220186454:  Hold'em No Limit ($0.50/$1.00 USD) - 2016/02/04 15:43:24 CET [2016/02/04 9:43:24 ET]
Table 'Arneb III' 9-max Seat #7 is the button
Seat 1: sanpidk ($100 in chips) 
Seat 2: JeanLima93 ($328.28 in chips) 
Seat 3: matiko09 ($101.50 in chips) 
Seat 4: Igor DoUrden ($251.03 in chips) 
Seat 5: tipner ($133.52 in chips) 
Seat 6: lumen21 ($100 in chips) 
Seat 7: xxxZeka ($100 in chips) 
Seat 8: volwebni4ek ($47 in chips) 
Seat 9: ARTVOR640 ($100 in chips) 
volwebni4ek: posts small blind $0.50
ARTVOR640: posts big blind $1
*** HOLE CARDS ***
Dealt to matiko09 [5c Td]
sanpidk: folds 
JeanLima93: calls $1
matiko09: folds 
Igor DoUrden: folds 
tipner: folds 
lumen21: folds 
xxxZeka: raises $3.50 to $4.50
volwebni4ek: calls $4
ARTVOR640: folds 
JeanLima93: calls $3.50
*** FLOP *** [6s Kd Qh]
volwebni4ek: checks 
JeanLima93: checks 
xxxZeka: checks 
*** TURN *** [6s Kd Qh] [3h]
volwebni4ek: checks 
JeanLima93: checks 
xxxZeka: checks 
*** RIVER *** [6s Kd Qh 3h] [Ts]
volwebni4ek: checks 
JeanLima93: checks 
xxxZeka: bets $5
volwebni4ek: folds 
JeanLima93: folds 
Uncalled bet ($5) returned to xxxZeka
xxxZeka collected $13.85 from pot
*** SUMMARY ***
Total pot $14.50 | Rake $0.65 
Board [6s Kd Qh 3h Ts]
Seat 1: sanpidk folded before Flop (didn't bet)
Seat 2: JeanLima93 folded on the River
Seat 3: matiko09 folded before Flop (didn't bet)
Seat 4: Igor DoUrden folded before Flop (didn't bet)
Seat 5: tipner folded before Flop (didn't bet)
Seat 6: lumen21 folded before Flop (didn't bet)
Seat 7: xxxZeka (button) collected ($13.85)
Seat 8: volwebni4ek (small blind) folded on the River
Seat 9: ARTVOR640 (big blind) folded before Flop





PokerStars Hand #148220191002:  Hold'em No Limit ($0.50/$1.00 USD) - 2016/02/04 15:43:30 CET [2016/02/04 9:43:30 ET]
Table 'Mothallah' 9-max Seat #8 is the button
Seat 1: Rafaello18 ($103 in chips) 
Seat 2: davianvalek ($120.20 in chips) 
Seat 3: ozone2003 ($132.93 in chips) 
Seat 4: YOUNG_G70 ($98.58 in chips) 
Seat 5: chaps1988 ($100 in chips) 
Seat 6: I The King I ($118.28 in chips) 
Seat 7: sanpidk ($100 in chips) 
Seat 8: Spid1 ($139.78 in chips) 
Seat 9: matiko09 ($105 in chips) 
matiko09: posts small blind $0.50
Rafaello18: posts big blind $1
*** HOLE CARDS ***
Dealt to matiko09 [7c Th]
davianvalek: folds 
ozone2003: folds 
YOUNG_G70: calls $1
chaps1988 has timed out
chaps1988: folds 
I The King I: raises $3 to $4
sanpidk: calls $4
Spid1: folds 
matiko09: folds 
Rafaello18: raises $12 to $16
YOUNG_G70: folds 
I The King I: folds 
sanpidk: folds 
Uncalled bet ($12) returned to Rafaello18
Rafaello18 collected $13.50 from pot
Rafaello18: doesn't show hand 
*** SUMMARY ***
Total pot $13.50 | Rake $0 
Seat 1: Rafaello18 (big blind) collected ($13.50)
Seat 2: davianvalek folded before Flop (didn't bet)
Seat 3: ozone2003 folded before Flop (didn't bet)
Seat 4: YOUNG_G70 folded before Flop
Seat 5: chaps1988 folded before Flop (didn't bet)
Seat 6: I The King I folded before Flop
Seat 7: sanpidk folded before Flop
Seat 8: Spid1 (button) folded before Flop (didn't bet)
Seat 9: matiko09 (small blind) folded before Flop





PokerStars Hand #148220191965:  Hold'em No Limit ($0.50/$1.00 USD) - 2016/02/04 15:43:32 CET [2016/02/04 9:43:32 ET]
Table 'Arneb II' 9-max Seat #1 is the button
Seat 1: matiko09 ($103.88 in chips) 
Seat 2: sanpidk ($218.75 in chips) 
Seat 3: brille-390 ($148.02 in chips) 
Seat 4: Venomous100% ($100 in chips) 
Seat 6: volwebni4ek ($75.95 in chips) 
Seat 7: melitakas ($284.20 in chips) 
Seat 8: tedbadger9 ($73.16 in chips) 
Seat 9: tipner ($117.17 in chips) 
sanpidk: posts small blind $0.50
brille-390: posts big blind $1
lumen21: sits out 
*** HOLE CARDS ***
Dealt to matiko09 [9h 2d]
Venomous100%: folds 
volwebni4ek: folds 
melitakas: folds 
tedbadger9: folds 
tipner: raises $2 to $3
matiko09: folds 
sanpidk: folds 
brille-390: folds 
Uncalled bet ($2) returned to tipner
tipner collected $2.50 from pot
tipner: doesn't show hand 
*** SUMMARY ***
Total pot $2.50 | Rake $0 
Seat 1: matiko09 (button) folded before Flop (didn't bet)
Seat 2: sanpidk (small blind) folded before Flop
Seat 3: brille-390 (big blind) folded before Flop
Seat 4: Venomous100% folded before Flop (didn't bet)
Seat 6: volwebni4ek folded before Flop (didn't bet)
Seat 7: melitakas folded before Flop (didn't bet)
Seat 8: tedbadger9 folded before Flop (didn't bet)
Seat 9: tipner collected ($2.50)





PokerStars Hand #148220192145:  Hold'em No Limit ($0.50/$1.00 USD) - 2016/02/04 15:43:32 CET [2016/02/04 9:43:32 ET]
Table 'Isara' 9-max Seat #5 is the button
Seat 1: KLOP06031987 ($100 in chips) 
Seat 2: davianvalek ($129.73 in chips) 
Seat 3: Monsthand ($101.50 in chips) 
Seat 4: Dante63s ($108.49 in chips) 
Seat 5: Igor DoUrden ($105.85 in chips) 
Seat 6: Rafaello18 ($156.55 in chips) 
Seat 7: warney1976 ($88.09 in chips) 
Seat 8: matiko09 ($108.39 in chips) 
Seat 9: chauyeuba ($64.64 in chips) 
Rafaello18: posts small blind $0.50
warney1976: posts big blind $1
*** HOLE CARDS ***
Dealt to matiko09 [3s 7s]
matiko09: folds 
chauyeuba: folds 
KLOP06031987: folds 
davianvalek: folds 
Monsthand: raises $1.50 to $2.50
Dante63s: folds 
Igor DoUrden: folds 
Rafaello18: folds 
warney1976: calls $1.50
*** FLOP *** [3d 5h Kd]
warney1976: checks 
Monsthand: bets $3.41
warney1976: calls $3.41
*** TURN *** [3d 5h Kd] [Td]
warney1976: checks 
Monsthand: bets $8.50
warney1976: raises $16.50 to $25
Monsthand: folds 
Uncalled bet ($16.50) returned to warney1976
warney1976 collected $28 from pot
*** SUMMARY ***
Total pot $29.32 | Rake $1.32 
Board [3d 5h Kd Td]
Seat 1: KLOP06031987 folded before Flop (didn't bet)
Seat 2: davianvalek folded before Flop (didn't bet)
Seat 3: Monsthand folded on the Turn
Seat 4: Dante63s folded before Flop (didn't bet)
Seat 5: Igor DoUrden (button) folded before Flop (didn't bet)
Seat 6: Rafaello18 (small blind) folded before Flop
Seat 7: warney1976 (big blind) collected ($28)
Seat 8: matiko09 folded before Flop (didn't bet)
Seat 9: chauyeuba folded before Flop (didn't bet)





PokerStars Hand #148220197750:  Hold'em No Limit ($0.50/$1.00 USD) - 2016/02/04 15:43:39 CET [2016/02/04 9:43:39 ET]
Table 'Siarnaq' 9-max Seat #3 is the button
Seat 1: Dante63s ($100 in chips) 
Seat 3: goblind4777 ($137.75 in chips) 
Seat 4: Spid1 ($100 in chips) 
Seat 5: I The King I ($132.87 in chips) 
Seat 6: Monsthand ($101.50 in chips) 
Seat 7: matiko09 ($116.09 in chips) 
Seat 8: Sweden_Pound ($101 in chips) 
Seat 9: MagicKid777 ($98.50 in chips) 
Spid1: posts small blind $0.50
I The King I: posts big blind $1
V.Barinov: sits out 
*** HOLE CARDS ***
Dealt to matiko09 [Js 6s]
Monsthand: folds 
matiko09: folds 
Sweden_Pound: folds 
MagicKid777: folds 
Dante63s: folds 
goblind4777: folds 
Spid1: raises $1.50 to $2.50
I The King I: folds 
Uncalled bet ($1.50) returned to Spid1
Spid1 collected $2 from pot
*** SUMMARY ***
Total pot $2 | Rake $0 
Seat 1: Dante63s folded before Flop (didn't bet)
Seat 3: goblind4777 (button) folded before Flop (didn't bet)
Seat 4: Spid1 (small blind) collected ($2)
Seat 5: I The King I (big blind) folded before Flop
Seat 6: Monsthand folded before Flop (didn't bet)
Seat 7: matiko09 folded before Flop (didn't bet)
Seat 8: Sweden_Pound folded before Flop (didn't bet)
Seat 9: MagicKid777 folded before Flop (didn't bet)





PokerStars Hand #148220209370:  Hold'em No Limit ($0.50/$1.00 USD) - 2016/02/04 15:43:55 CET [2016/02/04 9:43:55 ET]
Table 'Arneb II' 9-max Seat #2 is the button
Seat 1: matiko09 ($103.88 in chips) 
Seat 2: sanpidk ($218.25 in chips) 
Seat 3: brille-390 ($147.02 in chips) 
Seat 4: Venomous100% ($100 in chips) 
Seat 6: volwebni4ek ($75.95 in chips) 
Seat 7: melitakas ($284.20 in chips) 
Seat 8: tedbadger9 ($73.16 in chips) 
Seat 9: tipner ($118.67 in chips) 
brille-390: posts small blind $0.50
Venomous100%: posts big blind $1
lumen21: sits out 
*** HOLE CARDS ***
Dealt to matiko09 [Ts 5c]
volwebni4ek: raises $2 to $3
melitakas: folds 
tedbadger9: folds 
tipner: folds 
matiko09: folds 
sanpidk: folds 
brille-390: folds 
Venomous100%: folds 
Uncalled bet ($2) returned to volwebni4ek
volwebni4ek collected $2.50 from pot
volwebni4ek: doesn't show hand 
*** SUMMARY ***
Total pot $2.50 | Rake $0 
Seat 1: matiko09 folded before Flop (didn't bet)
Seat 2: sanpidk (button) folded before Flop (didn't bet)
Seat 3: brille-390 (small blind) folded before Flop
Seat 4: Venomous100% (big blind) folded before Flop
Seat 6: volwebni4ek collected ($2.50)
Seat 7: melitakas folded before Flop (didn't bet)
Seat 8: tedbadger9 folded before Flop (didn't bet)
Seat 9: tipner folded before Flop (didn't bet)





PokerStars Hand #148220211365:  Hold'em No Limit ($0.50/$1.00 USD) - 2016/02/04 15:43:58 CET [2016/02/04 9:43:58 ET]
Table 'Amelia II' 9-max Seat #2 is the button
Seat 1: matiko09 ($100 in chips) 
Seat 2: WYY790125 ($117.49 in chips) 
Seat 3: Dante63s ($198.80 in chips) 
Seat 4: Monsthand ($114.85 in chips) 
Seat 5: maxxmeister ($250 in chips) 
Seat 7: Spid1 ($184.99 in chips) 
Seat 8: Sweden_Pound ($250 in chips) 
Seat 9: Cikadejooo ($206.70 in chips) 
Dante63s: posts small blind $0.50
Monsthand: posts big blind $1
tipner: sits out 
matiko09: posts the ante $0.20
WYY790125: posts the ante $0.20
Dante63s: posts the ante $0.20
Monsthand: posts the ante $0.20
maxxmeister: posts the ante $0.20
Spid1: posts the ante $0.20
Sweden_Pound: posts the ante $0.20
Cikadejooo: posts the ante $0.20
*** HOLE CARDS ***
Dealt to matiko09 [6c 8c]
maxxmeister: folds 
Spid1: folds 
Sweden_Pound: folds 
Cikadejooo: calls $1
matiko09: raises $3 to $4
WYY790125: folds 
Dante63s: folds 
Monsthand: folds 
Cikadejooo: folds 
Uncalled bet ($3) returned to matiko09
matiko09 collected $5.10 from pot
matiko09: doesn't show hand 
*** SUMMARY ***
Total pot $5.10 | Rake $0 
Seat 1: matiko09 collected ($5.10)
Seat 2: WYY790125 (button) folded before Flop (didn't bet)
Seat 3: Dante63s (small blind) folded before Flop
Seat 4: Monsthand (big blind) folded before Flop
Seat 5: maxxmeister folded before Flop (didn't bet)
Seat 7: Spid1 folded before Flop (didn't bet)
Seat 8: Sweden_Pound folded before Flop (didn't bet)
Seat 9: Cikadejooo folded before Flop





PokerStars Hand #148220214615:  Hold'em No Limit ($0.50/$1.00 USD) - 2016/02/04 15:44:02 CET [2016/02/04 9:44:02 ET]
Table 'Siarnaq' 9-max Seat #4 is the button
Seat 1: Dante63s ($100 in chips) 
Seat 3: goblind4777 ($137.75 in chips) 
Seat 4: Spid1 ($101 in chips) 
Seat 5: I The King I ($131.87 in chips) 
Seat 6: Monsthand ($101.50 in chips) 
Seat 7: matiko09 ($116.09 in chips) 
Seat 8: Sweden_Pound ($101 in chips) 
Seat 9: MagicKid777 ($98.50 in chips) 
I The King I: posts small blind $0.50
Monsthand: posts big blind $1
V.Barinov: sits out 
*** HOLE CARDS ***
Dealt to matiko09 [9d 7d]
matiko09: folds 
Sweden_Pound: raises $2 to $3
MagicKid777: folds 
Dante63s: folds 
goblind4777: calls $3
Spid1: folds 
I The King I: folds 
Monsthand: raises $10 to $13
Sweden_Pound: calls $10
goblind4777: folds 
*** FLOP *** [2d 4s 6c]
Monsthand: checks 
Sweden_Pound: bets $16.50
Monsthand: folds 
Uncalled bet ($16.50) returned to Sweden_Pound
Sweden_Pound collected $28.17 from pot
Sweden_Pound: doesn't show hand 
*** SUMMARY ***
Total pot $29.50 | Rake $1.33 
Board [2d 4s 6c]
Seat 1: Dante63s folded before Flop (didn't bet)
Seat 3: goblind4777 folded before Flop
Seat 4: Spid1 (button) folded before Flop (didn't bet)
Seat 5: I The King I (small blind) folded before Flop
Seat 6: Monsthand (big blind) folded on the Flop
Seat 7: matiko09 folded before Flop (didn't bet)
Seat 8: Sweden_Pound collected ($28.17)
Seat 9: MagicKid777 folded before Flop (didn't bet)





PokerStars Hand #148220214925:  Hold'em No Limit ($0.50/$1.00 USD) - 2016/02/04 15:44:02 CET [2016/02/04 9:44:02 ET]
Table 'Avior II' 9-max Seat #4 is the button
Seat 1: I The King I ($100 in chips) 
Seat 2: matiko09 ($100 in chips) 
Seat 3: sanpidk ($141 in chips) 
Seat 4: maxxmeister ($118.87 in chips) 
Seat 5: chaps1988 ($100.50 in chips) 
Seat 6: tipner ($217.97 in chips) 
Seat 7: Monsthand ($103.50 in chips) 
Seat 8: EdHunder ($80.28 in chips) 
Seat 9: Venomous100% ($101.50 in chips) 
chaps1988: posts small blind $0.50
tipner: posts big blind $1
*** HOLE CARDS ***
Dealt to matiko09 [7d As]
Monsthand: folds 
EdHunder: folds 
Venomous100%: calls $1
I The King I: folds 
matiko09: folds 
sanpidk: folds 
maxxmeister: raises $1 to $2
chaps1988: folds 
tipner: folds 
Venomous100%: calls $1
*** FLOP *** [8h 3c Jc]
Venomous100%: checks 
maxxmeister: checks 
*** TURN *** [8h 3c Jc] [2h]
Venomous100%: bets $3.46
maxxmeister: calls $3.46
*** RIVER *** [8h 3c Jc 2h] [Jd]
Venomous100%: checks 
maxxmeister: checks 
*** SHOW DOWN ***
Venomous100%: shows [3d 3h] (a full house, Threes full of Jacks)
maxxmeister: mucks hand 
Venomous100% collected $11.86 from pot
*** SUMMARY ***
Total pot $12.42 | Rake $0.56 
Board [8h 3c Jc 2h Jd]
Seat 1: I The King I folded before Flop (didn't bet)
Seat 2: matiko09 folded before Flop (didn't bet)
Seat 3: sanpidk folded before Flop (didn't bet)
Seat 4: maxxmeister (button) mucked [Td 2d]
Seat 5: chaps1988 (small blind) folded before Flop
Seat 6: tipner (big blind) folded before Flop
Seat 7: Monsthand folded before Flop (didn't bet)
Seat 8: EdHunder folded before Flop (didn't bet)
Seat 9: Venomous100% showed [3d 3h] and won ($11.86) with a full house, Threes full of Jacks





PokerStars Hand #148220216565:  Hold'em No Limit ($0.50/$1.00 USD) - 2016/02/04 15:44:05 CET [2016/02/04 9:44:05 ET]
Table 'Dejan' 9-max Seat #4 is the button
Seat 1: matiko09 ($100 in chips) 
Seat 2: xxxZeka ($101.75 in chips) 
Seat 3: lumen21 ($100 in chips) 
Seat 4: pruxa72 ($125.85 in chips) 
Seat 5: Rafaello18 ($122.84 in chips) 
Seat 8: s26s ($128.23 in chips) 
Seat 9: I The King I ($121.92 in chips) 
Rafaello18: posts small blind $0.50
sanpidk: is sitting out 
s26s: posts big blind $1
*** HOLE CARDS ***
Dealt to matiko09 [Ts 5s]
sanpidk leaves the table
I The King I: folds 
matiko09: folds 
xxxZeka: folds 
KLOP06031987 joins the table at seat #6 
lumen21: folds 
pruxa72: folds 
Rafaello18: folds 
Uncalled bet ($0.50) returned to s26s
s26s collected $1 from pot
*** SUMMARY ***
Total pot $1 | Rake $0 
Seat 1: matiko09 folded before Flop (didn't bet)
Seat 2: xxxZeka folded before Flop (didn't bet)
Seat 3: lumen21 folded before Flop (didn't bet)
Seat 4: pruxa72 (button) folded before Flop (didn't bet)
Seat 5: Rafaello18 (small blind) folded before Flop
Seat 8: s26s (big blind) collected ($1)
Seat 9: I The King I folded before Flop (didn't bet)





PokerStars Hand #148220232088:  Hold'em No Limit ($0.50/$1.00 USD) - 2016/02/04 15:44:26 CET [2016/02/04 9:44:26 ET]
Table 'Dejan' 9-max Seat #5 is the button
Seat 1: matiko09 ($100 in chips) 
Seat 2: xxxZeka ($101.75 in chips) 
Seat 3: lumen21 ($100 in chips) 
Seat 4: pruxa72 ($125.85 in chips) 
Seat 5: Rafaello18 ($122.34 in chips) 
Seat 8: s26s ($128.73 in chips) 
Seat 9: I The King I ($121.92 in chips) 
KLOP06031987 will be allowed to play after the button
s26s: posts small blind $0.50
I The King I: posts big blind $1
*** HOLE CARDS ***
Dealt to matiko09 [8d Ad]
matiko09: folds 
xxxZeka: folds 
lumen21: folds 
pruxa72: raises $2 to $3
Rafaello18: folds 
s26s: calls $2.50
I The King I: folds 
*** FLOP *** [4h 4d 8c]
s26s: checks 
pruxa72: bets $7
s26s: folds 
Uncalled bet ($7) returned to pruxa72
pruxa72 collected $6.68 from pot
pruxa72: doesn't show hand 
*** SUMMARY ***
Total pot $7 | Rake $0.32 
Board [4h 4d 8c]
Seat 1: matiko09 folded before Flop (didn't bet)
Seat 2: xxxZeka folded before Flop (didn't bet)
Seat 3: lumen21 folded before Flop (didn't bet)
Seat 4: pruxa72 collected ($6.68)
Seat 5: Rafaello18 (button) folded before Flop (didn't bet)
Seat 8: s26s (small blind) folded on the Flop
Seat 9: I The King I (big blind) folded before Flop





PokerStars Hand #148220234150:  Hold'em No Limit ($0.50/$1.00 USD) - 2016/02/04 15:44:29 CET [2016/02/04 9:44:29 ET]
Table 'Gutemberga' 9-max Seat #9 is the button
Seat 1: RICKA16 ($99 in chips) 
Seat 2: Rafaello18 ($100 in chips) 
Seat 3: Oligarhs4 ($68.37 in chips) 
Seat 5: Monsthand ($100 in chips) 
Seat 6: I The King I ($103.44 in chips) 
Seat 8: matiko09 ($137.16 in chips) 
Seat 9: xxxZeka ($103 in chips) 
RICKA16: posts small blind $0.50
Rafaello18: posts big blind $1
Sweden_Pound: sits out 
*** HOLE CARDS ***
Dealt to matiko09 [7c Ac]
Oligarhs4: folds 
Monsthand: folds 
I The King I: folds 
matiko09: raises $1.50 to $2.50
xxxZeka: folds 
RICKA16: calls $2
Rafaello18: folds 
*** FLOP *** [Qs 4h Ts]
RICKA16: checks 
matiko09: checks 
*** TURN *** [Qs 4h Ts] [Th]
RICKA16: bets $4
matiko09: folds 
Uncalled bet ($4) returned to RICKA16
RICKA16 collected $5.73 from pot
RICKA16: doesn't show hand 
*** SUMMARY ***
Total pot $6 | Rake $0.27 
Board [Qs 4h Ts Th]
Seat 1: RICKA16 (small blind) collected ($5.73)
Seat 2: Rafaello18 (big blind) folded before Flop
Seat 3: Oligarhs4 folded before Flop (didn't bet)
Seat 5: Monsthand folded before Flop (didn't bet)
Seat 6: I The King I folded before Flop (didn't bet)
Seat 8: matiko09 folded on the Turn
Seat 9: xxxZeka (button) folded before Flop (didn't bet)





PokerStars Hand #148220235463:  Hold'em No Limit ($0.50/$1.00 USD) - 2016/02/04 15:44:30 CET [2016/02/04 9:44:30 ET]
Table 'Arneb II' 9-max Seat #3 is the button
Seat 1: matiko09 ($103.88 in chips) 
Seat 2: sanpidk ($218.25 in chips) 
Seat 3: brille-390 ($146.52 in chips) 
Seat 4: Venomous100% ($100 in chips) 
Seat 5: lumen21 ($100 in chips) 
Seat 6: volwebni4ek ($77.45 in chips) 
Seat 7: melitakas ($284.20 in chips) 
Seat 8: tedbadger9 ($73.16 in chips) 
Seat 9: tipner ($118.67 in chips) 
Venomous100%: posts small blind $0.50
lumen21: posts big blind $1
*** HOLE CARDS ***
Dealt to matiko09 [4h Jd]
volwebni4ek: folds 
melitakas: raises $1 to $2
tedbadger9: calls $2
tipner: folds 
matiko09: folds 
sanpidk: calls $2
brille-390: folds 
Venomous100%: folds 
lumen21: folds 
*** FLOP *** [Ac Qd Kh]
melitakas: bets $3.58
tedbadger9: calls $3.58
sanpidk: folds 
*** TURN *** [Ac Qd Kh] [Jh]
melitakas: checks 
tedbadger9: checks 
*** RIVER *** [Ac Qd Kh Jh] [6c]
melitakas: checks 
tedbadger9: bets $10.50
melitakas: folds 
Uncalled bet ($10.50) returned to tedbadger9
tedbadger9 collected $14 from pot
*** SUMMARY ***
Total pot $14.66 | Rake $0.66 
Board [Ac Qd Kh Jh 6c]
Seat 1: matiko09 folded before Flop (didn't bet)
Seat 2: sanpidk folded on the Flop
Seat 3: brille-390 (button) folded before Flop (didn't bet)
Seat 4: Venomous100% (small blind) folded before Flop
Seat 5: lumen21 (big blind) folded before Flop
Seat 6: volwebni4ek folded before Flop (didn't bet)
Seat 7: melitakas folded on the River
Seat 8: tedbadger9 collected ($14)
Seat 9: tipner folded before Flop (didn't bet)





PokerStars Hand #148220235513:  Hold'em No Limit ($0.50/$1.00 USD) - 2016/02/04 15:44:30 CET [2016/02/04 9:44:30 ET]
Table 'Mothallah' 9-max Seat #9 is the button
Seat 1: Rafaello18 ($112.50 in chips) 
Seat 2: davianvalek ($120.20 in chips) 
Seat 3: ozone2003 ($132.93 in chips) 
Seat 4: YOUNG_G70 ($97.58 in chips) 
Seat 5: chaps1988 ($100 in chips) 
Seat 6: I The King I ($114.28 in chips) 
Seat 7: sanpidk ($100 in chips) 
Seat 8: Spid1 ($139.78 in chips) 
Seat 9: matiko09 ($104.50 in chips) 
Rafaello18: posts small blind $0.50
davianvalek: posts big blind $1
*** HOLE CARDS ***
Dealt to matiko09 [Ah 3c]
ozone2003: folds 
YOUNG_G70: folds 
chaps1988: folds 
I The King I: raises $2 to $3
sanpidk: folds 
Spid1: folds 
matiko09: folds 
Rafaello18: folds 
davianvalek: calls $2
*** FLOP *** [9d Jh 6h]
davianvalek: checks 
I The King I: bets $4
davianvalek: calls $4
*** TURN *** [9d Jh 6h] [2s]
davianvalek: checks 
I The King I: bets $10
davianvalek: calls $10
*** RIVER *** [9d Jh 6h 2s] [8s]
davianvalek: checks 
I The King I: bets $19
davianvalek: folds 
Uncalled bet ($19) returned to I The King I
I The King I collected $32.95 from pot
I The King I: doesn't show hand 
*** SUMMARY ***
Total pot $34.50 | Rake $1.55 
Board [9d Jh 6h 2s 8s]
Seat 1: Rafaello18 (small blind) folded before Flop
Seat 2: davianvalek (big blind) folded on the River
Seat 3: ozone2003 folded before Flop (didn't bet)
Seat 4: YOUNG_G70 folded before Flop (didn't bet)
Seat 5: chaps1988 folded before Flop (didn't bet)
Seat 6: I The King I collected ($32.95)
Seat 7: sanpidk folded before Flop (didn't bet)
Seat 8: Spid1 folded before Flop (didn't bet)
Seat 9: matiko09 (button) folded before Flop (didn't bet)





PokerStars Hand #148220247005:  Hold'em No Limit ($0.50/$1.00 USD) - 2016/02/04 15:44:46 CET [2016/02/04 9:44:46 ET]
Table 'Amelia II' 9-max Seat #3 is the button
Seat 1: matiko09 ($103.90 in chips) 
Seat 2: WYY790125 ($117.29 in chips) 
Seat 3: Dante63s ($198.10 in chips) 
Seat 4: Monsthand ($113.65 in chips) 
Seat 5: maxxmeister ($250 in chips) 
Seat 7: Spid1 ($184.79 in chips) 
Seat 8: Sweden_Pound ($250 in chips) 
Seat 9: Cikadejooo ($205.50 in chips) 
Monsthand: posts small blind $0.50
maxxmeister: posts big blind $1
tipner: sits out 
matiko09: posts the ante $0.20
WYY790125: posts the ante $0.20
Dante63s: posts the ante $0.20
Monsthand: posts the ante $0.20
maxxmeister: posts the ante $0.20
Spid1: posts the ante $0.20
Sweden_Pound: posts the ante $0.20
Cikadejooo: posts the ante $0.20
*** HOLE CARDS ***
Dealt to matiko09 [2c 2h]
Spid1: folds 
Sweden_Pound: folds 
Cikadejooo: folds 
matiko09: raises $2 to $3
WYY790125: folds 
Dante63s: folds 
Monsthand: folds 
maxxmeister: raises $9 to $12
matiko09: folds 
Uncalled bet ($9) returned to maxxmeister
maxxmeister collected $8.10 from pot
maxxmeister: doesn't show hand 
*** SUMMARY ***
Total pot $8.10 | Rake $0 
Seat 1: matiko09 folded before Flop
Seat 2: WYY790125 folded before Flop (didn't bet)
Seat 3: Dante63s (button) folded before Flop (didn't bet)
Seat 4: Monsthand (small blind) folded before Flop
Seat 5: maxxmeister (big blind) collected ($8.10)
Seat 7: Spid1 folded before Flop (didn't bet)
Seat 8: Sweden_Pound folded before Flop (didn't bet)
Seat 9: Cikadejooo folded before Flop (didn't bet)





PokerStars Hand #148220259704:  Hold'em No Limit ($0.50/$1.00 USD) - 2016/02/04 15:45:03 CET [2016/02/04 9:45:03 ET]
Table 'Avior II' 9-max Seat #5 is the button
Seat 1: I The King I ($100 in chips) 
Seat 2: matiko09 ($100 in chips) 
Seat 3: sanpidk ($141 in chips) 
Seat 4: maxxmeister ($113.41 in chips) 
Seat 5: chaps1988 ($100 in chips) 
Seat 6: tipner ($216.97 in chips) 
Seat 7: Monsthand ($103.50 in chips) 
Seat 8: EdHunder ($80.28 in chips) 
Seat 9: Venomous100% ($107.90 in chips) 
tipner: posts small blind $0.50
Monsthand: posts big blind $1
*** HOLE CARDS ***
Dealt to matiko09 [Ts As]
EdHunder: raises $2 to $3
Venomous100%: folds 
I The King I: folds 
matiko09: folds 
sanpidk: folds 
maxxmeister: folds 
chaps1988: calls $3
tipner: folds 
Monsthand: folds 
*** FLOP *** [3h 9d 3c]
EdHunder: bets $5
chaps1988: calls $5
*** TURN *** [3h 9d 3c] [Ac]
EdHunder: checks 
chaps1988: bets $10
EdHunder: raises $62.28 to $72.28 and is all-in
chaps1988: calls $62.28
*** RIVER *** [3h 9d 3c Ac] [6d]
*** SHOW DOWN ***
EdHunder: shows [Kh Jc] (a pair of Threes)
chaps1988: shows [3d 3s] (four of a kind, Threes)
chaps1988 collected $159.26 from pot
*** SUMMARY ***
Total pot $162.06 | Rake $2.80 
Board [3h 9d 3c Ac 6d]
Seat 1: I The King I folded before Flop (didn't bet)
Seat 2: matiko09 folded before Flop (didn't bet)
Seat 3: sanpidk folded before Flop (didn't bet)
Seat 4: maxxmeister folded before Flop (didn't bet)
Seat 5: chaps1988 (button) showed [3d 3s] and won ($159.26) with four of a kind, Threes
Seat 6: tipner (small blind) folded before Flop
Seat 7: Monsthand (big blind) folded before Flop
Seat 8: EdHunder showed [Kh Jc] and lost with a pair of Threes
Seat 9: Venomous100% folded before Flop (didn't bet)





PokerStars Hand #148220262532:  Hold'em No Limit ($0.50/$1.00 USD) - 2016/02/04 15:45:07 CET [2016/02/04 9:45:07 ET]
Table 'Dejan' 9-max Seat #8 is the button
Seat 1: matiko09 ($100 in chips) 
Seat 2: xxxZeka ($101.75 in chips) 
Seat 3: lumen21 ($100 in chips) 
Seat 4: pruxa72 ($129.53 in chips) 
Seat 5: Rafaello18 ($122.34 in chips) 
Seat 8: s26s ($125.73 in chips) 
Seat 9: I The King I ($120.92 in chips) 
I The King I: posts small blind $0.50
matiko09: posts big blind $1
KLOP06031987: sits out 
*** HOLE CARDS ***
Dealt to matiko09 [Jc 5h]
xxxZeka: folds 
lumen21: folds 
pruxa72: folds 
Rafaello18: folds 
s26s: raises $2.50 to $3.50
I The King I: folds 
matiko09: folds 
Uncalled bet ($2.50) returned to s26s
s26s collected $2.50 from pot
*** SUMMARY ***
Total pot $2.50 | Rake $0 
Seat 1: matiko09 (big blind) folded before Flop
Seat 2: xxxZeka folded before Flop (didn't bet)
Seat 3: lumen21 folded before Flop (didn't bet)
Seat 4: pruxa72 folded before Flop (didn't bet)
Seat 5: Rafaello18 folded before Flop (didn't bet)
Seat 8: s26s (button) collected ($2.50)
Seat 9: I The King I (small blind) folded before Flop





PokerStars Hand #148220263356:  Hold'em No Limit ($0.50/$1.00 USD) - 2016/02/04 15:45:08 CET [2016/02/04 9:45:08 ET]
Table 'Helio III' 9-max Seat #3 is the button
Seat 1: MagicKid777 ($100.18 in chips) 
Seat 3: RICKA16 ($100.31 in chips) 
Seat 5: Rafaello18 ($107.68 in chips) 
Seat 6: I The King I ($150.09 in chips) 
Seat 7: matiko09 ($100 in chips) 
Seat 8: Sweden_Pound ($102.50 in chips) 
Seat 9: pandalapa ($112.49 in chips) 
RSBoris will be allowed to play after the button
Rafaello18: posts small blind $0.50
I The King I: posts big blind $1
*** HOLE CARDS ***
Dealt to matiko09 [Js 4h]
matiko09: folds 
Sweden_Pound: folds 
pandalapa: folds 
MagicKid777: folds 
RICKA16: raises $2 to $3
Rafaello18: folds 
I The King I: folds 
Uncalled bet ($2) returned to RICKA16
RICKA16 collected $2.50 from pot
RICKA16: doesn't show hand 
*** SUMMARY ***
Total pot $2.50 | Rake $0 
Seat 1: MagicKid777 folded before Flop (didn't bet)
Seat 3: RICKA16 (button) collected ($2.50)
Seat 5: Rafaello18 (small blind) folded before Flop
Seat 6: I The King I (big blind) folded before Flop
Seat 7: matiko09 folded before Flop (didn't bet)
Seat 8: Sweden_Pound folded before Flop (didn't bet)
Seat 9: pandalapa folded before Flop (didn't bet)





PokerStars Hand #148220268602:  Hold'em No Limit ($0.50/$1.00 USD) - 2016/02/04 15:45:15 CET [2016/02/04 9:45:15 ET]
Table 'Isara' 9-max Seat #6 is the button
Seat 1: KLOP06031987 ($100 in chips) 
Seat 2: davianvalek ($129.73 in chips) 
Seat 3: Monsthand ($100 in chips) 
Seat 4: Dante63s ($108.49 in chips) 
Seat 5: Igor DoUrden ($105.85 in chips) 
Seat 6: Rafaello18 ($156.05 in chips) 
Seat 7: warney1976 ($101.68 in chips) 
Seat 8: matiko09 ($108.39 in chips) 
Seat 9: chauyeuba ($64.64 in chips) 
warney1976: posts small blind $0.50
matiko09: posts big blind $1
*** HOLE CARDS ***
Dealt to matiko09 [Ks Ac]
chauyeuba: folds 
KLOP06031987: folds 
davianvalek: folds 
Monsthand: folds 
Dante63s: folds 
Igor DoUrden: folds 
Rafaello18: folds 
warney1976: raises $1 to $2
matiko09: raises $6 to $8
warney1976: calls $6
*** FLOP *** [2h Ah 7s]
warney1976: checks 
matiko09: bets $9.93
warney1976: folds 
Uncalled bet ($9.93) returned to matiko09
matiko09 collected $15.28 from pot
matiko09: doesn't show hand 
*** SUMMARY ***
Total pot $16 | Rake $0.72 
Board [2h Ah 7s]
Seat 1: KLOP06031987 folded before Flop (didn't bet)
Seat 2: davianvalek folded before Flop (didn't bet)
Seat 3: Monsthand folded before Flop (didn't bet)
Seat 4: Dante63s folded before Flop (didn't bet)
Seat 5: Igor DoUrden folded before Flop (didn't bet)
Seat 6: Rafaello18 (button) folded before Flop (didn't bet)
Seat 7: warney1976 (small blind) folded on the Flop
Seat 8: matiko09 (big blind) collected ($15.28)
Seat 9: chauyeuba folded before Flop (didn't bet)





PokerStars Hand #148220268290:  Hold'em No Limit ($0.50/$1.00 USD) - 2016/02/04 15:45:15 CET [2016/02/04 9:45:15 ET]
Table 'Arneb III' 9-max Seat #8 is the button
Seat 2: JeanLima93 ($323.78 in chips) 
Seat 3: matiko09 ($101.50 in chips) 
Seat 4: Igor DoUrden ($251.03 in chips) 
Seat 5: tipner ($133.52 in chips) 
Seat 6: lumen21 ($100 in chips) 
Seat 7: xxxZeka ($109.35 in chips) 
Seat 8: volwebni4ek ($42.50 in chips) 
Seat 9: ARTVOR640 ($100 in chips) 
ARTVOR640: posts small blind $0.50
sanpidk: is sitting out 
sanpidk leaves the table
JeanLima93: posts big blind $1
*** HOLE CARDS ***
Dealt to matiko09 [3d Tc]
matiko09: folds 
Kukuryzka joins the table at seat #1 
Igor DoUrden: folds 
tipner: folds 
lumen21: folds 
xxxZeka: raises $2 to $3
volwebni4ek: folds 
ARTVOR640: folds 
JeanLima93: calls $2
*** FLOP *** [Kc 2s 4c]
JeanLima93: checks 
xxxZeka: bets $4
JeanLima93: folds 
Uncalled bet ($4) returned to xxxZeka
xxxZeka collected $6.21 from pot
*** SUMMARY ***
Total pot $6.50 | Rake $0.29 
Board [Kc 2s 4c]
Seat 2: JeanLima93 (big blind) folded on the Flop
Seat 3: matiko09 folded before Flop (didn't bet)
Seat 4: Igor DoUrden folded before Flop (didn't bet)
Seat 5: tipner folded before Flop (didn't bet)
Seat 6: lumen21 folded before Flop (didn't bet)
Seat 7: xxxZeka collected ($6.21)
Seat 8: volwebni4ek (button) folded before Flop (didn't bet)
Seat 9: ARTVOR640 (small blind) folded before Flop





PokerStars Hand #148220269465:  Hold'em No Limit ($0.50/$1.00 USD) - 2016/02/04 15:45:17 CET [2016/02/04 9:45:17 ET]
Table 'Alkaid II' 9-max Seat #7 is the button
Seat 1: Dante63s ($109.90 in chips) 
Seat 3: omorfadramou ($100 in chips) 
Seat 4: SumPosad ($52.99 in chips) 
Seat 5: geoffreyjo ($81.85 in chips) 
Seat 6: I The King I ($153.43 in chips) 
Seat 7: Monsthand ($100 in chips) 
Seat 8: KLOP06031987 ($112.89 in chips) 
Seat 9: matiko09 ($100 in chips) 
KLOP06031987: posts small blind $0.50
matiko09: posts big blind $1
Sweden_Pound: sits out 
*** HOLE CARDS ***
Dealt to matiko09 [Kd Jh]
Dante63s: folds 
omorfadramou: folds 
SumPosad: folds 
geoffreyjo: folds 
I The King I: folds 
Monsthand: folds 
KLOP06031987: folds 
Uncalled bet ($0.50) returned to matiko09
matiko09 collected $1 from pot
matiko09: doesn't show hand 
*** SUMMARY ***
Total pot $1 | Rake $0 
Seat 1: Dante63s folded before Flop (didn't bet)
Seat 3: omorfadramou folded before Flop (didn't bet)
Seat 4: SumPosad folded before Flop (didn't bet)
Seat 5: geoffreyjo folded before Flop (didn't bet)
Seat 6: I The King I folded before Flop (didn't bet)
Seat 7: Monsthand (button) folded before Flop (didn't bet)
Seat 8: KLOP06031987 (small blind) folded before Flop
Seat 9: matiko09 (big blind) collected ($1)





PokerStars Hand #148220276018:  Hold'em No Limit ($0.50/$1.00 USD) - 2016/02/04 15:45:26 CET [2016/02/04 9:45:26 ET]
Table 'Amelia II' 9-max Seat #4 is the button
Seat 1: matiko09 ($100.70 in chips) 
Seat 2: WYY790125 ($117.09 in chips) 
Seat 3: Dante63s ($197.90 in chips) 
Seat 4: Monsthand ($112.95 in chips) 
Seat 5: maxxmeister ($254.90 in chips) 
Seat 6: tipner ($121.83 in chips) 
Seat 7: Spid1 ($184.59 in chips) 
Seat 8: Sweden_Pound ($250 in chips) 
Seat 9: Cikadejooo ($205.30 in chips) 
maxxmeister: posts small blind $0.50
tipner: posts big blind $1
matiko09: posts the ante $0.20
WYY790125: posts the ante $0.20
Dante63s: posts the ante $0.20
Monsthand: posts the ante $0.20
maxxmeister: posts the ante $0.20
tipner: posts the ante $0.20
Spid1: posts the ante $0.20
Sweden_Pound: posts the ante $0.20
Cikadejooo: posts the ante $0.20
*** HOLE CARDS ***
Dealt to matiko09 [Ts 7d]
Spid1: folds 
Sweden_Pound: folds 
Cikadejooo: folds 
matiko09: folds 
WYY790125: raises $2 to $3
Dante63s: folds 
Monsthand: folds 
maxxmeister: folds 
tipner: folds 
Uncalled bet ($2) returned to WYY790125
WYY790125 collected $4.30 from pot
WYY790125: doesn't show hand 
*** SUMMARY ***
Total pot $4.30 | Rake $0 
Seat 1: matiko09 folded before Flop (didn't bet)
Seat 2: WYY790125 collected ($4.30)
Seat 3: Dante63s folded before Flop (didn't bet)
Seat 4: Monsthand (button) folded before Flop (didn't bet)
Seat 5: maxxmeister (small blind) folded before Flop
Seat 6: tipner (big blind) folded before Flop
Seat 7: Spid1 folded before Flop (didn't bet)
Seat 8: Sweden_Pound folded before Flop (didn't bet)
Seat 9: Cikadejooo folded before Flop (didn't bet)





PokerStars Hand #148220278081:  Hold'em No Limit ($0.50/$1.00 USD) - 2016/02/04 15:45:28 CET [2016/02/04 9:45:28 ET]
Table 'Siarnaq' 9-max Seat #5 is the button
Seat 1: Dante63s ($100 in chips) 
Seat 3: goblind4777 ($134.75 in chips) 
Seat 4: Spid1 ($101 in chips) 
Seat 5: I The King I ($131.37 in chips) 
Seat 6: Monsthand ($100 in chips) 
Seat 7: matiko09 ($116.09 in chips) 
Seat 8: Sweden_Pound ($116.17 in chips) 
Seat 9: MagicKid777 ($98.50 in chips) 
Monsthand: posts small blind $0.50
matiko09: posts big blind $1
V.Barinov: sits out 
*** HOLE CARDS ***
Dealt to matiko09 [Ac 4h]
Sweden_Pound: folds 
MagicKid777: folds 
Dante63s: folds 
goblind4777: folds 
Spid1: raises $1.50 to $2.50
I The King I: folds 
Monsthand: folds 
matiko09: folds 
Uncalled bet ($1.50) returned to Spid1
Spid1 collected $2.50 from pot
Spid1: doesn't show hand 
*** SUMMARY ***
Total pot $2.50 | Rake $0 
Seat 1: Dante63s folded before Flop (didn't bet)
Seat 3: goblind4777 folded before Flop (didn't bet)
Seat 4: Spid1 collected ($2.50)
Seat 5: I The King I (button) folded before Flop (didn't bet)
Seat 6: Monsthand (small blind) folded before Flop
Seat 7: matiko09 (big blind) folded before Flop
Seat 8: Sweden_Pound folded before Flop (didn't bet)
Seat 9: MagicKid777 folded before Flop (didn't bet)





PokerStars Hand #148220279380:  Hold'em No Limit ($0.50/$1.00 USD) - 2016/02/04 15:45:30 CET [2016/02/04 9:45:30 ET]
Table 'Dejan' 9-max Seat #9 is the button
Seat 1: matiko09 ($100 in chips) 
Seat 2: xxxZeka ($101.75 in chips) 
Seat 3: lumen21 ($100 in chips) 
Seat 4: pruxa72 ($129.53 in chips) 
Seat 5: Rafaello18 ($122.34 in chips) 
Seat 8: s26s ($127.23 in chips) 
Seat 9: I The King I ($120.42 in chips) 
matiko09: posts small blind $0.50
xxxZeka: posts big blind $1
KLOP06031987: sits out 
*** HOLE CARDS ***
Dealt to matiko09 [9s 4h]
lumen21: folds 
pruxa72: calls $1
Rafaello18: folds 
s26s: folds 
I The King I: raises $3 to $4
matiko09: folds 
xxxZeka: folds 
pruxa72: calls $3
*** FLOP *** [5c As Kd]
pruxa72: checks 
I The King I: checks 
*** TURN *** [5c As Kd] [Jh]
pruxa72: checks 
I The King I: checks 
*** RIVER *** [5c As Kd Jh] [Qh]
pruxa72: checks 
I The King I: checks 
*** SHOW DOWN ***
pruxa72: shows [6c 9c] (high card Ace)
I The King I: shows [2s 2c] (a pair of Deuces)
I The King I collected $9.07 from pot
*** SUMMARY ***
Total pot $9.50 | Rake $0.43 
Board [5c As Kd Jh Qh]
Seat 1: matiko09 (small blind) folded before Flop
Seat 2: xxxZeka (big blind) folded before Flop
Seat 3: lumen21 folded before Flop (didn't bet)
Seat 4: pruxa72 showed [6c 9c] and lost with high card Ace
Seat 5: Rafaello18 folded before Flop (didn't bet)
Seat 8: s26s folded before Flop (didn't bet)
Seat 9: I The King I (button) showed [2s 2c] and won ($9.07) with a pair of Deuces





PokerStars Hand #148220280426:  Hold'em No Limit ($0.50/$1.00 USD) - 2016/02/04 15:45:32 CET [2016/02/04 9:45:32 ET]
Table 'Gutemberga' 9-max Seat #1 is the button
Seat 1: RICKA16 ($102.23 in chips) 
Seat 2: Rafaello18 ($100 in chips) 
Seat 3: Oligarhs4 ($68.37 in chips) 
Seat 5: Monsthand ($100 in chips) 
Seat 6: I The King I ($103.44 in chips) 
Seat 8: matiko09 ($134.66 in chips) 
Seat 9: xxxZeka ($103 in chips) 
Rafaello18: posts small blind $0.50
Oligarhs4: posts big blind $1
Sweden_Pound: sits out 
*** HOLE CARDS ***
Dealt to matiko09 [9d 2h]
Monsthand: raises $1.70 to $2.70
I The King I: folds 
matiko09: folds 
xxxZeka: folds 
RICKA16: folds 
Rafaello18: folds 
Oligarhs4: folds 
Uncalled bet ($1.70) returned to Monsthand
Monsthand collected $2.50 from pot
*** SUMMARY ***
Total pot $2.50 | Rake $0 
Seat 1: RICKA16 (button) folded before Flop (didn't bet)
Seat 2: Rafaello18 (small blind) folded before Flop
Seat 3: Oligarhs4 (big blind) folded before Flop
Seat 5: Monsthand collected ($2.50)
Seat 6: I The King I folded before Flop (didn't bet)
Seat 8: matiko09 folded before Flop (didn't bet)
Seat 9: xxxZeka folded before Flop (didn't bet)





PokerStars Hand #148220283073:  Hold'em No Limit ($0.50/$1.00 USD) - 2016/02/04 15:45:35 CET [2016/02/04 9:45:35 ET]
Table 'Alkaid II' 9-max Seat #8 is the button
Seat 1: Dante63s ($109.90 in chips) 
Seat 3: omorfadramou ($100 in chips) 
Seat 4: SumPosad ($52.99 in chips) 
Seat 5: geoffreyjo ($81.85 in chips) 
Seat 6: I The King I ($153.43 in chips) 
Seat 7: Monsthand ($100 in chips) 
Seat 8: KLOP06031987 ($112.39 in chips) 
Seat 9: matiko09 ($100.50 in chips) 
matiko09: posts small blind $0.50
Dante63s: posts big blind $1
Sweden_Pound: sits out 
*** HOLE CARDS ***
Dealt to matiko09 [6c 6h]
omorfadramou: folds 
SumPosad: folds 
geoffreyjo: raises $2 to $3
I The King I: calls $3
Monsthand: folds 
KLOP06031987: folds 
matiko09: calls $2.50
Dante63s: folds 
*** FLOP *** [2h 8c 3c]
matiko09: bets $6
geoffreyjo: folds 
I The King I: folds 
Uncalled bet ($6) returned to matiko09
matiko09 collected $9.55 from pot
matiko09: doesn't show hand 
*** SUMMARY ***
Total pot $10 | Rake $0.45 
Board [2h 8c 3c]
Seat 1: Dante63s (big blind) folded before Flop
Seat 3: omorfadramou folded before Flop (didn't bet)
Seat 4: SumPosad folded before Flop (didn't bet)
Seat 5: geoffreyjo folded on the Flop
Seat 6: I The King I folded on the Flop
Seat 7: Monsthand folded before Flop (didn't bet)
Seat 8: KLOP06031987 (button) folded before Flop (didn't bet)
Seat 9: matiko09 (small blind) collected ($9.55)





PokerStars Hand #148220284354:  Hold'em No Limit ($0.50/$1.00 USD) - 2016/02/04 15:45:37 CET [2016/02/04 9:45:37 ET]
Table 'Helio III' 9-max Seat #5 is the button
Seat 1: MagicKid777 ($100.18 in chips) 
Seat 3: RICKA16 ($101.81 in chips) 
Seat 5: Rafaello18 ($107.18 in chips) 
Seat 6: I The King I ($149.09 in chips) 
Seat 7: matiko09 ($100 in chips) 
Seat 8: Sweden_Pound ($102.50 in chips) 
Seat 9: pandalapa ($112.49 in chips) 
I The King I: posts small blind $0.50
matiko09: posts big blind $1
RSBoris: sits out 
*** HOLE CARDS ***
Dealt to matiko09 [Th Ts]
Sweden_Pound: folds 
pandalapa: folds 
MagicKid777: folds 
RICKA16: folds 
Rafaello18: raises $1.50 to $2.50
I The King I: folds 
matiko09: raises $6.50 to $9
Rafaello18: raises $10 to $19
matiko09: folds 
Uncalled bet ($10) returned to Rafaello18
Rafaello18 collected $18.50 from pot
Rafaello18: doesn't show hand 
*** SUMMARY ***
Total pot $18.50 | Rake $0 
Seat 1: MagicKid777 folded before Flop (didn't bet)
Seat 3: RICKA16 folded before Flop (didn't bet)
Seat 5: Rafaello18 (button) collected ($18.50)
Seat 6: I The King I (small blind) folded before Flop
Seat 7: matiko09 (big blind) folded before Flop
Seat 8: Sweden_Pound folded before Flop (didn't bet)
Seat 9: pandalapa folded before Flop (didn't bet)





PokerStars Hand #148220286761:  Hold'em No Limit ($0.50/$1.00 USD) - 2016/02/04 15:45:40 CET [2016/02/04 9:45:40 ET]
Table 'Arneb II' 9-max Seat #4 is the button
Seat 1: matiko09 ($103.88 in chips) 
Seat 2: sanpidk ($216.25 in chips) 
Seat 3: brille-390 ($146.52 in chips) 
Seat 4: Venomous100% ($100 in chips) 
Seat 5: lumen21 ($100 in chips) 
Seat 6: volwebni4ek ($77.45 in chips) 
Seat 7: melitakas ($278.62 in chips) 
Seat 8: tedbadger9 ($81.58 in chips) 
Seat 9: tipner ($118.67 in chips) 
lumen21: posts small blind $0.50
volwebni4ek: posts big blind $1
*** HOLE CARDS ***
Dealt to matiko09 [2c 6c]
melitakas: folds 
tedbadger9: raises $1.78 to $2.78
tipner: raises $5.22 to $8
matiko09: folds 
sanpidk: folds 
brille-390: folds 
Venomous100%: folds 
lumen21: folds 
volwebni4ek: folds 
tedbadger9: calls $5.22
*** FLOP *** [5h Kd Ad]
tedbadger9: checks 
tipner: checks 
*** TURN *** [5h Kd Ad] [Tc]
tedbadger9: bets $5
tipner: raises $13 to $18
tedbadger9: calls $13
*** RIVER *** [5h Kd Ad Tc] [2s]
tedbadger9: bets $55.58 and is all-in
tipner: calls $55.58
*** SHOW DOWN ***
tedbadger9: shows [Td Qs] (a pair of Tens)
tipner: shows [Ts Th] (three of a kind, Tens)
tipner collected $161.86 from pot
*** SUMMARY ***
Total pot $164.66 | Rake $2.80 
Board [5h Kd Ad Tc 2s]
Seat 1: matiko09 folded before Flop (didn't bet)
Seat 2: sanpidk folded before Flop (didn't bet)
Seat 3: brille-390 folded before Flop (didn't bet)
Seat 4: Venomous100% (button) folded before Flop (didn't bet)
Seat 5: lumen21 (small blind) folded before Flop
Seat 6: volwebni4ek (big blind) folded before Flop
Seat 7: melitakas folded before Flop (didn't bet)
Seat 8: tedbadger9 showed [Td Qs] and lost with a pair of Tens
Seat 9: tipner showed [Ts Th] and won ($161.86) with three of a kind, Tens





PokerStars Hand #148220291697:  Hold'em No Limit ($0.50/$1.00 USD) - 2016/02/04 15:45:47 CET [2016/02/04 9:45:47 ET]
Table 'Siarnaq' 9-max Seat #6 is the button
Seat 1: Dante63s ($100 in chips) 
Seat 3: goblind4777 ($134.75 in chips) 
Seat 4: Spid1 ($102.50 in chips) 
Seat 5: I The King I ($131.37 in chips) 
Seat 6: Monsthand ($100 in chips) 
Seat 7: matiko09 ($115.09 in chips) 
Seat 8: Sweden_Pound ($116.17 in chips) 
Seat 9: MagicKid777 ($98.50 in chips) 
matiko09: posts small blind $0.50
Sweden_Pound: posts big blind $1
V.Barinov: sits out 
*** HOLE CARDS ***
Dealt to matiko09 [4d Tc]
MagicKid777: folds 
Dante63s: folds 
goblind4777: raises $2.44 to $3.44
Spid1: folds 
I The King I: folds 
Monsthand: folds 
matiko09: folds 
Sweden_Pound: folds 
Uncalled bet ($2.44) returned to goblind4777
goblind4777 collected $2.50 from pot
goblind4777: doesn't show hand 
*** SUMMARY ***
Total pot $2.50 | Rake $0 
Seat 1: Dante63s folded before Flop (didn't bet)
Seat 3: goblind4777 collected ($2.50)
Seat 4: Spid1 folded before Flop (didn't bet)
Seat 5: I The King I folded before Flop (didn't bet)
Seat 6: Monsthand (button) folded before Flop (didn't bet)
Seat 7: matiko09 (small blind) folded before Flop
Seat 8: Sweden_Pound (big blind) folded before Flop
Seat 9: MagicKid777 folded before Flop (didn't bet)





PokerStars Hand #148220293227:  Hold'em No Limit ($0.50/$1.00 USD) - 2016/02/04 15:45:49 CET [2016/02/04 9:45:49 ET]
Table 'Gutemberga' 9-max Seat #2 is the button
Seat 1: RICKA16 ($102.23 in chips) 
Seat 2: Rafaello18 ($100 in chips) 
Seat 3: Oligarhs4 ($67.37 in chips) 
Seat 4: Sweden_Pound ($100 in chips) 
Seat 5: Monsthand ($101.50 in chips) 
Seat 6: I The King I ($103.44 in chips) 
Seat 8: matiko09 ($134.66 in chips) 
Seat 9: xxxZeka ($103 in chips) 
Oligarhs4: posts small blind $0.50
Sweden_Pound: posts big blind $1
*** HOLE CARDS ***
Dealt to matiko09 [4s 9c]
Monsthand: folds 
I The King I: folds 
matiko09: folds 
xxxZeka: folds 
RICKA16: folds 
Rafaello18: folds 
Oligarhs4: folds 
Uncalled bet ($0.50) returned to Sweden_Pound
Sweden_Pound collected $1 from pot
Sweden_Pound: doesn't show hand 
*** SUMMARY ***
Total pot $1 | Rake $0 
Seat 1: RICKA16 folded before Flop (didn't bet)
Seat 2: Rafaello18 (button) folded before Flop (didn't bet)
Seat 3: Oligarhs4 (small blind) folded before Flop
Seat 4: Sweden_Pound (big blind) collected ($1)
Seat 5: Monsthand folded before Flop (didn't bet)
Seat 6: I The King I folded before Flop (didn't bet)
Seat 8: matiko09 folded before Flop (didn't bet)
Seat 9: xxxZeka folded before Flop (didn't bet)





PokerStars Hand #148220304275:  Hold'em No Limit ($0.50/$1.00 USD) - 2016/02/04 15:46:04 CET [2016/02/04 9:46:04 ET]
Table 'Arneb III' 9-max Seat #9 is the button
Seat 2: JeanLima93 ($320.78 in chips) 
Seat 3: matiko09 ($101.50 in chips) 
Seat 4: Igor DoUrden ($251.03 in chips) 
Seat 5: tipner ($133.52 in chips) 
Seat 6: lumen21 ($100 in chips) 
Seat 7: xxxZeka ($112.56 in chips) 
Seat 8: volwebni4ek ($42.50 in chips) 
Seat 9: ARTVOR640 ($100 in chips) 
Kukuryzka will be allowed to play after the button
JeanLima93: posts small blind $0.50
matiko09: posts big blind $1
*** HOLE CARDS ***
Dealt to matiko09 [9d 3h]
Igor DoUrden: folds 
tipner: folds 
lumen21: folds 
xxxZeka: folds 
volwebni4ek: folds 
ARTVOR640: folds 
JeanLima93: calls $0.50
matiko09: checks 
*** FLOP *** [4s Ts 8s]
JeanLima93: checks 
matiko09: checks 
*** TURN *** [4s Ts 8s] [3c]
JeanLima93: checks 
matiko09: checks 
*** RIVER *** [4s Ts 8s 3c] [Kd]
JeanLima93: checks 
matiko09: checks 
*** SHOW DOWN ***
JeanLima93: shows [Ad 8c] (a pair of Eights)
matiko09: mucks hand 
JeanLima93 collected $1.91 from pot
*** SUMMARY ***
Total pot $2 | Rake $0.09 
Board [4s Ts 8s 3c Kd]
Seat 2: JeanLima93 (small blind) showed [Ad 8c] and won ($1.91) with a pair of Eights
Seat 3: matiko09 (big blind) mucked [9d 3h]
Seat 4: Igor DoUrden folded before Flop (didn't bet)
Seat 5: tipner folded before Flop (didn't bet)
Seat 6: lumen21 folded before Flop (didn't bet)
Seat 7: xxxZeka folded before Flop (didn't bet)
Seat 8: volwebni4ek folded before Flop (didn't bet)
Seat 9: ARTVOR640 (button) folded before Flop (didn't bet)





PokerStars Hand #148220305664:  Hold'em No Limit ($0.50/$1.00 USD) - 2016/02/04 15:46:06 CET [2016/02/04 9:46:06 ET]
Table 'Amelia II' 9-max Seat #5 is the button
Seat 1: matiko09 ($100.50 in chips) 
Seat 2: WYY790125 ($120.19 in chips) 
Seat 3: Dante63s ($197.70 in chips) 
Seat 4: Monsthand ($112.75 in chips) 
Seat 5: maxxmeister ($254.20 in chips) 
Seat 6: tipner ($120.63 in chips) 
Seat 7: Spid1 ($184.39 in chips) 
Seat 8: Sweden_Pound ($250 in chips) 
Seat 9: Cikadejooo ($205.10 in chips) 
tipner: posts small blind $0.50
Spid1: posts big blind $1
matiko09: posts the ante $0.20
WYY790125: posts the ante $0.20
Dante63s: posts the ante $0.20
Monsthand: posts the ante $0.20
maxxmeister: posts the ante $0.20
tipner: posts the ante $0.20
Spid1: posts the ante $0.20
Sweden_Pound: posts the ante $0.20
Cikadejooo: posts the ante $0.20
*** HOLE CARDS ***
Dealt to matiko09 [8d Qh]
Sweden_Pound: folds 
Cikadejooo: folds 
matiko09: folds 
WYY790125: folds 
Dante63s: folds 
Monsthand: folds 
maxxmeister: folds 
tipner: folds 
Uncalled bet ($0.50) returned to Spid1
Spid1 collected $2.80 from pot
Spid1: doesn't show hand 
*** SUMMARY ***
Total pot $2.80 | Rake $0 
Seat 1: matiko09 folded before Flop (didn't bet)
Seat 2: WYY790125 folded before Flop (didn't bet)
Seat 3: Dante63s folded before Flop (didn't bet)
Seat 4: Monsthand folded before Flop (didn't bet)
Seat 5: maxxmeister (button) folded before Flop (didn't bet)
Seat 6: tipner (small blind) folded before Flop
Seat 7: Spid1 (big blind) collected ($2.80)
Seat 8: Sweden_Pound folded before Flop (didn't bet)
Seat 9: Cikadejooo folded before Flop (didn't bet)





PokerStars Hand #148220310735:  Hold'em No Limit ($0.50/$1.00 USD) - 2016/02/04 15:46:13 CET [2016/02/04 9:46:13 ET]
Table 'Isara' 9-max Seat #7 is the button
Seat 1: KLOP06031987 ($100 in chips) 
Seat 2: davianvalek ($129.73 in chips) 
Seat 3: Monsthand ($100 in chips) 
Seat 4: Dante63s ($108.49 in chips) 
Seat 5: Igor DoUrden ($105.85 in chips) 
Seat 6: Rafaello18 ($156.05 in chips) 
Seat 7: warney1976 ($93.68 in chips) 
Seat 8: matiko09 ($115.67 in chips) 
Seat 9: chauyeuba ($64.64 in chips) 
matiko09: posts small blind $0.50
chauyeuba: posts big blind $1
*** HOLE CARDS ***
Dealt to matiko09 [4h 7c]
KLOP06031987: folds 
davianvalek: folds 
Monsthand: folds 
Dante63s: raises $1.50 to $2.50
Igor DoUrden: folds 
Rafaello18: folds 
warney1976: folds 
matiko09: folds 
chauyeuba: folds 
Uncalled bet ($1.50) returned to Dante63s
Dante63s collected $2.50 from pot
Dante63s: doesn't show hand 
*** SUMMARY ***
Total pot $2.50 | Rake $0 
Seat 1: KLOP06031987 folded before Flop (didn't bet)
Seat 2: davianvalek folded before Flop (didn't bet)
Seat 3: Monsthand folded before Flop (didn't bet)
Seat 4: Dante63s collected ($2.50)
Seat 5: Igor DoUrden folded before Flop (didn't bet)
Seat 6: Rafaello18 folded before Flop (didn't bet)
Seat 7: warney1976 (button) folded before Flop (didn't bet)
Seat 8: matiko09 (small blind) folded before Flop
Seat 9: chauyeuba (big blind) folded before Flop





PokerStars Hand #148220315001:  Hold'em No Limit ($0.50/$1.00 USD) - 2016/02/04 15:46:19 CET [2016/02/04 9:46:19 ET]
Table 'Gutemberga' 9-max Seat #3 is the button
Seat 1: RICKA16 ($102.23 in chips) 
Seat 2: Rafaello18 ($100 in chips) 
Seat 3: Oligarhs4 ($66.87 in chips) 
Seat 4: Sweden_Pound ($100.50 in chips) 
Seat 5: Monsthand ($101.50 in chips) 
Seat 6: I The King I ($103.44 in chips) 
Seat 8: matiko09 ($134.66 in chips) 
Seat 9: xxxZeka ($103 in chips) 
Sweden_Pound: posts small blind $0.50
Monsthand: posts big blind $1
*** HOLE CARDS ***
Dealt to matiko09 [Qd 2c]
I The King I: folds 
matiko09: folds 
xxxZeka: folds 
RICKA16: folds 
Rafaello18: folds 
Oligarhs4: folds 
Sweden_Pound: folds 
Uncalled bet ($0.50) returned to Monsthand
Monsthand collected $1 from pot
*** SUMMARY ***
Total pot $1 | Rake $0 
Seat 1: RICKA16 folded before Flop (didn't bet)
Seat 2: Rafaello18 folded before Flop (didn't bet)
Seat 3: Oligarhs4 (button) folded before Flop (didn't bet)
Seat 4: Sweden_Pound (small blind) folded before Flop
Seat 5: Monsthand (big blind) collected ($1)
Seat 6: I The King I folded before Flop (didn't bet)
Seat 8: matiko09 folded before Flop (didn't bet)
Seat 9: xxxZeka folded before Flop (didn't bet)





PokerStars Hand #148220320516:  Hold'em No Limit ($0.50/$1.00 USD) - 2016/02/04 15:46:27 CET [2016/02/04 9:46:27 ET]
Table 'Avior II' 9-max Seat #6 is the button
Seat 1: I The King I ($100 in chips) 
Seat 2: matiko09 ($100 in chips) 
Seat 3: sanpidk ($141 in chips) 
Seat 4: maxxmeister ($113.41 in chips) 
Seat 5: chaps1988 ($178.98 in chips) 
Seat 6: tipner ($216.47 in chips) 
Seat 7: Monsthand ($102.50 in chips) 
Monsthand: posts small blind $0.50
Venomous100%: is sitting out 
I The King I: posts big blind $1
*** HOLE CARDS ***
Dealt to matiko09 [9s 6s]
matiko09: folds 
Venomous100% leaves the table
sanpidk: folds 
Sweden_Pound joins the table at seat #9 
maxxmeister: folds 
chaps1988: folds 
tipner: folds 
Monsthand: folds 
Uncalled bet ($0.50) returned to I The King I
I The King I collected $1 from pot
I The King I: doesn't show hand 
*** SUMMARY ***
Total pot $1 | Rake $0 
Seat 1: I The King I (big blind) collected ($1)
Seat 2: matiko09 folded before Flop (didn't bet)
Seat 3: sanpidk folded before Flop (didn't bet)
Seat 4: maxxmeister folded before Flop (didn't bet)
Seat 5: chaps1988 folded before Flop (didn't bet)
Seat 6: tipner (button) folded before Flop (didn't bet)
Seat 7: Monsthand (small blind) folded before Flop





PokerStars Hand #148220324772:  Hold'em No Limit ($0.50/$1.00 USD) - 2016/02/04 15:46:33 CET [2016/02/04 9:46:33 ET]
Table 'Dejan' 9-max Seat #1 is the button
Seat 1: matiko09 ($100 in chips) 
Seat 2: xxxZeka ($100.75 in chips) 
Seat 3: lumen21 ($100 in chips) 
Seat 4: pruxa72 ($125.53 in chips) 
Seat 5: Rafaello18 ($122.34 in chips) 
Seat 8: s26s ($127.23 in chips) 
Seat 9: I The King I ($125.49 in chips) 
xxxZeka: posts small blind $0.50
lumen21: posts big blind $1
KLOP06031987: sits out 
*** HOLE CARDS ***
Dealt to matiko09 [Qh Kd]
pruxa72: folds 
Rafaello18: raises $1.50 to $2.50
s26s: folds 
I The King I: folds 
matiko09: raises $6 to $8.50
xxxZeka: folds 
lumen21: folds 
Rafaello18: folds 
Uncalled bet ($6) returned to matiko09
matiko09 collected $6.50 from pot
matiko09: doesn't show hand 
*** SUMMARY ***
Total pot $6.50 | Rake $0 
Seat 1: matiko09 (button) collected ($6.50)
Seat 2: xxxZeka (small blind) folded before Flop
Seat 3: lumen21 (big blind) folded before Flop
Seat 4: pruxa72 folded before Flop (didn't bet)
Seat 5: Rafaello18 folded before Flop
Seat 8: s26s folded before Flop (didn't bet)
Seat 9: I The King I folded before Flop (didn't bet)





PokerStars Hand #148220333769:  Hold'em No Limit ($0.50/$1.00 USD) - 2016/02/04 15:46:45 CET [2016/02/04 9:46:45 ET]
Table 'Amelia II' 9-max Seat #6 is the button
Seat 1: matiko09 ($100.30 in chips) 
Seat 2: WYY790125 ($119.99 in chips) 
Seat 3: Dante63s ($197.50 in chips) 
Seat 4: Monsthand ($112.55 in chips) 
Seat 5: maxxmeister ($254 in chips) 
Seat 6: tipner ($119.93 in chips) 
Seat 7: Spid1 ($186.49 in chips) 
Seat 8: Sweden_Pound ($250 in chips) 
Seat 9: Cikadejooo ($204.90 in chips) 
Spid1: posts small blind $0.50
Sweden_Pound: posts big blind $1
matiko09: posts the ante $0.20
WYY790125: posts the ante $0.20
Dante63s: posts the ante $0.20
Monsthand: posts the ante $0.20
maxxmeister: posts the ante $0.20
tipner: posts the ante $0.20
Spid1: posts the ante $0.20
Sweden_Pound: posts the ante $0.20
Cikadejooo: posts the ante $0.20
*** HOLE CARDS ***
Dealt to matiko09 [3d 5c]
Cikadejooo: folds 
matiko09: folds 
WYY790125: raises $2 to $3
Dante63s: folds 
Monsthand: raises $6.35 to $9.35
maxxmeister: folds 
tipner: folds 
Spid1: folds 
Sweden_Pound: folds 
WYY790125: calls $6.35
*** FLOP *** [8d 9s 9d]
WYY790125: checks 
Monsthand: bets $12.85
WYY790125: folds 
Uncalled bet ($12.85) returned to Monsthand
Monsthand collected $21.01 from pot
*** SUMMARY ***
Total pot $22 | Rake $0.99 
Board [8d 9s 9d]
Seat 1: matiko09 folded before Flop (didn't bet)
Seat 2: WYY790125 folded on the Flop
Seat 3: Dante63s folded before Flop (didn't bet)
Seat 4: Monsthand collected ($21.01)
Seat 5: maxxmeister folded before Flop (didn't bet)
Seat 6: tipner (button) folded before Flop (didn't bet)
Seat 7: Spid1 (small blind) folded before Flop
Seat 8: Sweden_Pound (big blind) folded before Flop
Seat 9: Cikadejooo folded before Flop (didn't bet)





PokerStars Hand #148220334936:  Hold'em No Limit ($0.50/$1.00 USD) - 2016/02/04 15:46:47 CET [2016/02/04 9:46:47 ET]
Table 'Alkaid II' 9-max Seat #9 is the button
Seat 1: Dante63s ($108.90 in chips) 
Seat 2: Sweden_Pound ($114.48 in chips) 
Seat 3: omorfadramou ($100 in chips) 
Seat 4: SumPosad ($52.99 in chips) 
Seat 5: geoffreyjo ($78.85 in chips) 
Seat 6: I The King I ($150.43 in chips) 
Seat 7: Monsthand ($100 in chips) 
Seat 8: KLOP06031987 ($112.39 in chips) 
Seat 9: matiko09 ($107.05 in chips) 
Dante63s: posts small blind $0.50
Sweden_Pound: posts big blind $1
*** HOLE CARDS ***
Dealt to matiko09 [8h 3c]
omorfadramou: folds 
SumPosad: raises $2 to $3
geoffreyjo: folds 
I The King I: folds 
Monsthand: folds 
KLOP06031987: folds 
matiko09: folds 
Dante63s: folds 
Sweden_Pound: folds 
Uncalled bet ($2) returned to SumPosad
SumPosad collected $2.50 from pot
SumPosad: doesn't show hand 
*** SUMMARY ***
Total pot $2.50 | Rake $0 
Seat 1: Dante63s (small blind) folded before Flop
Seat 2: Sweden_Pound (big blind) folded before Flop
Seat 3: omorfadramou folded before Flop (didn't bet)
Seat 4: SumPosad collected ($2.50)
Seat 5: geoffreyjo folded before Flop (didn't bet)
Seat 6: I The King I folded before Flop (didn't bet)
Seat 7: Monsthand folded before Flop (didn't bet)
Seat 8: KLOP06031987 folded before Flop (didn't bet)
Seat 9: matiko09 (button) folded before Flop (didn't bet)





PokerStars Hand #148220335442:  Hold'em No Limit ($0.50/$1.00 USD) - 2016/02/04 15:46:48 CET [2016/02/04 9:46:48 ET]
Table 'Arneb II' 9-max Seat #5 is the button
Seat 1: matiko09 ($103.88 in chips) 
Seat 2: sanpidk ($216.25 in chips) 
Seat 3: brille-390 ($146.52 in chips) 
Seat 4: Venomous100% ($100 in chips) 
Seat 5: lumen21 ($100 in chips) 
Seat 6: volwebni4ek ($76.45 in chips) 
Seat 7: melitakas ($278.62 in chips) 
Seat 9: tipner ($198.95 in chips) 
volwebni4ek: posts small blind $0.50
melitakas: posts big blind $1
*** HOLE CARDS ***
Dealt to matiko09 [7c Td]
tipner: folds 
matiko09: folds 
tedbadger9 leaves the table
sanpidk: raises $2 to $3
brille-390: folds 
Venomous100%: folds 
xxxZeka joins the table at seat #8 
lumen21: folds 
volwebni4ek: folds 
melitakas: folds 
Uncalled bet ($2) returned to sanpidk
sanpidk collected $2.50 from pot
sanpidk: doesn't show hand 
*** SUMMARY ***
Total pot $2.50 | Rake $0 
Seat 1: matiko09 folded before Flop (didn't bet)
Seat 2: sanpidk collected ($2.50)
Seat 3: brille-390 folded before Flop (didn't bet)
Seat 4: Venomous100% folded before Flop (didn't bet)
Seat 5: lumen21 (button) folded before Flop (didn't bet)
Seat 6: volwebni4ek (small blind) folded before Flop
Seat 7: melitakas (big blind) folded before Flop
Seat 9: tipner folded before Flop (didn't bet)





PokerStars Hand #148220340796:  Hold'em No Limit ($0.50/$1.00 USD) - 2016/02/04 15:46:55 CET [2016/02/04 9:46:55 ET]
Table 'Arneb III' 9-max Seat #2 is the button
Seat 2: JeanLima93 ($321.69 in chips) 
Seat 3: matiko09 ($100.50 in chips) 
Seat 4: Igor DoUrden ($251.03 in chips) 
Seat 5: tipner ($133.52 in chips) 
Seat 6: lumen21 ($100 in chips) 
Seat 7: xxxZeka ($112.56 in chips) 
Seat 8: volwebni4ek ($42.50 in chips) 
Seat 9: ARTVOR640 ($100 in chips) 
matiko09: posts small blind $0.50
Igor DoUrden: posts big blind $1
Kukuryzka: sits out 
*** HOLE CARDS ***
Dealt to matiko09 [8c 6s]
tipner: folds 
lumen21: folds 
xxxZeka: folds 
volwebni4ek: raises $1.50 to $2.50
ARTVOR640: calls $2.50
JeanLima93: folds 
matiko09: folds 
Igor DoUrden: folds 
*** FLOP *** [Qd 2c Qs]
volwebni4ek: bets $4
ARTVOR640: calls $4
*** TURN *** [Qd 2c Qs] [3h]
volwebni4ek: bets $7.50
ARTVOR640: calls $7.50
*** RIVER *** [Qd 2c Qs 3h] [4s]
volwebni4ek: checks 
ARTVOR640: bets $9.50
volwebni4ek: folds 
Uncalled bet ($9.50) returned to ARTVOR640
ARTVOR640 collected $28.17 from pot
ARTVOR640: doesn't show hand 
*** SUMMARY ***
Total pot $29.50 | Rake $1.33 
Board [Qd 2c Qs 3h 4s]
Seat 2: JeanLima93 (button) folded before Flop (didn't bet)
Seat 3: matiko09 (small blind) folded before Flop
Seat 4: Igor DoUrden (big blind) folded before Flop
Seat 5: tipner folded before Flop (didn't bet)
Seat 6: lumen21 folded before Flop (didn't bet)
Seat 7: xxxZeka folded before Flop (didn't bet)
Seat 8: volwebni4ek folded on the River
Seat 9: ARTVOR640 collected ($28.17)





PokerStars Hand #148220343227:  Hold'em No Limit ($0.50/$1.00 USD) - 2016/02/04 15:46:58 CET [2016/02/04 9:46:58 ET]
Table 'Siarnaq' 9-max Seat #7 is the button
Seat 1: Dante63s ($100 in chips) 
Seat 3: goblind4777 ($136.25 in chips) 
Seat 4: Spid1 ($102.50 in chips) 
Seat 5: I The King I ($131.37 in chips) 
Seat 6: Monsthand ($100 in chips) 
Seat 7: matiko09 ($114.59 in chips) 
Seat 8: Sweden_Pound ($115.17 in chips) 
Seat 9: MagicKid777 ($98.50 in chips) 
Sweden_Pound: posts small blind $0.50
MagicKid777: posts big blind $1
V.Barinov: sits out 
*** HOLE CARDS ***
Dealt to matiko09 [As 7h]
Dante63s: folds 
goblind4777: folds 
Spid1: folds 
I The King I: raises $2 to $3
Monsthand: folds 
matiko09: folds 
Sweden_Pound: folds 
MagicKid777: folds 
Uncalled bet ($2) returned to I The King I
I The King I collected $2.50 from pot
I The King I: doesn't show hand 
*** SUMMARY ***
Total pot $2.50 | Rake $0 
Seat 1: Dante63s folded before Flop (didn't bet)
Seat 3: goblind4777 folded before Flop (didn't bet)
Seat 4: Spid1 folded before Flop (didn't bet)
Seat 5: I The King I collected ($2.50)
Seat 6: Monsthand folded before Flop (didn't bet)
Seat 7: matiko09 (button) folded before Flop (didn't bet)
Seat 8: Sweden_Pound (small blind) folded before Flop
Seat 9: MagicKid777 (big blind) folded before Flop





PokerStars Hand #148220343311:  Hold'em No Limit ($0.50/$1.00 USD) - 2016/02/04 15:46:58 CET [2016/02/04 9:46:58 ET]
Table 'Isara' 9-max Seat #8 is the button
Seat 2: davianvalek ($129.73 in chips) 
Seat 3: Monsthand ($100 in chips) 
Seat 4: Dante63s ($109.99 in chips) 
Seat 5: Igor DoUrden ($105.85 in chips) 
Seat 6: Rafaello18 ($156.05 in chips) 
Seat 7: warney1976 ($93.68 in chips) 
Seat 8: matiko09 ($115.17 in chips) 
Seat 9: chauyeuba ($63.64 in chips) 
chauyeuba: posts small blind $0.50
KLOP06031987: is sitting out 
davianvalek: posts big blind $1
*** HOLE CARDS ***
Dealt to matiko09 [Th Qd]
KLOP06031987 leaves the table
Monsthand: folds 
Sweden_Pound joins the table at seat #1 
Dante63s: raises $2 to $3
Igor DoUrden: folds 
Rafaello18: folds 
warney1976: folds 
matiko09: folds 
chauyeuba: folds 
davianvalek: folds 
Uncalled bet ($2) returned to Dante63s
Dante63s collected $2.50 from pot
Dante63s: doesn't show hand 
*** SUMMARY ***
Total pot $2.50 | Rake $0 
Seat 2: davianvalek (big blind) folded before Flop
Seat 3: Monsthand folded before Flop (didn't bet)
Seat 4: Dante63s collected ($2.50)
Seat 5: Igor DoUrden folded before Flop (didn't bet)
Seat 6: Rafaello18 folded before Flop (didn't bet)
Seat 7: warney1976 folded before Flop (didn't bet)
Seat 8: matiko09 (button) folded before Flop (didn't bet)
Seat 9: chauyeuba (small blind) folded before Flop





PokerStars Hand #148220351762:  Hold'em No Limit ($0.50/$1.00 USD) - 2016/02/04 15:47:04 CET [2016/02/04 9:47:04 ET]
Table 'Mothallah' 9-max Seat #1 is the button
Seat 1: Rafaello18 ($112 in chips) 
Seat 2: davianvalek ($103.20 in chips) 
Seat 3: ozone2003 ($132.93 in chips) 
Seat 4: YOUNG_G70 ($97.58 in chips) 
Seat 5: chaps1988 ($100 in chips) 
Seat 6: I The King I ($130.23 in chips) 
Seat 7: sanpidk ($100 in chips) 
Seat 8: Spid1 ($139.78 in chips) 
Seat 9: matiko09 ($104.50 in chips) 
davianvalek: posts small blind $0.50
ozone2003: posts big blind $1
*** HOLE CARDS ***
Dealt to matiko09 [7s 7h]
YOUNG_G70: folds 
chaps1988: folds 
I The King I: folds 
sanpidk: folds 
Spid1: folds 
matiko09: raises $1.50 to $2.50
Rafaello18: folds 
davianvalek: folds 
ozone2003: folds 
Uncalled bet ($1.50) returned to matiko09
matiko09 collected $2.50 from pot
matiko09: doesn't show hand 
*** SUMMARY ***
Total pot $2.50 | Rake $0 
Seat 1: Rafaello18 (button) folded before Flop (didn't bet)
Seat 2: davianvalek (small blind) folded before Flop
Seat 3: ozone2003 (big blind) folded before Flop
Seat 4: YOUNG_G70 folded before Flop (didn't bet)
Seat 5: chaps1988 folded before Flop (didn't bet)
Seat 6: I The King I folded before Flop (didn't bet)
Seat 7: sanpidk folded before Flop (didn't bet)
Seat 8: Spid1 folded before Flop (didn't bet)
Seat 9: matiko09 collected ($2.50)





PokerStars Hand #148220354338:  Hold'em No Limit ($0.50/$1.00 USD) - 2016/02/04 15:47:08 CET [2016/02/04 9:47:08 ET]
Table 'Gutemberga' 9-max Seat #4 is the button
Seat 1: RICKA16 ($102.23 in chips) 
Seat 2: Rafaello18 ($100 in chips) 
Seat 3: Oligarhs4 ($66.87 in chips) 
Seat 4: Sweden_Pound ($100 in chips) 
Seat 5: Monsthand ($102 in chips) 
Seat 6: I The King I ($103.44 in chips) 
Seat 8: matiko09 ($134.66 in chips) 
Seat 9: xxxZeka ($103 in chips) 
Monsthand: posts small blind $0.50
I The King I: posts big blind $1
*** HOLE CARDS ***
Dealt to matiko09 [8d Ks]
matiko09: folds 
xxxZeka: raises $2 to $3
RICKA16: folds 
Rafaello18: folds 
Oligarhs4: folds 
Sweden_Pound: folds 
Monsthand: folds 
I The King I: folds 
Uncalled bet ($2) returned to xxxZeka
xxxZeka collected $2.50 from pot
*** SUMMARY ***
Total pot $2.50 | Rake $0 
Seat 1: RICKA16 folded before Flop (didn't bet)
Seat 2: Rafaello18 folded before Flop (didn't bet)
Seat 3: Oligarhs4 folded before Flop (didn't bet)
Seat 4: Sweden_Pound (button) folded before Flop (didn't bet)
Seat 5: Monsthand (small blind) folded before Flop
Seat 6: I The King I (big blind) folded before Flop
Seat 8: matiko09 folded before Flop (didn't bet)
Seat 9: xxxZeka collected ($2.50)





PokerStars Hand #148220355102:  Hold'em No Limit ($0.50/$1.00 USD) - 2016/02/04 15:47:09 CET [2016/02/04 9:47:09 ET]
Table 'Avior II' 9-max Seat #7 is the button
Seat 1: I The King I ($100.50 in chips) 
Seat 2: matiko09 ($100 in chips) 
Seat 3: sanpidk ($141 in chips) 
Seat 4: maxxmeister ($113.41 in chips) 
Seat 5: chaps1988 ($178.98 in chips) 
Seat 6: tipner ($216.47 in chips) 
Seat 7: Monsthand ($102 in chips) 
Sweden_Pound will be allowed to play after the button
I The King I: posts small blind $0.50
matiko09: posts big blind $1
*** HOLE CARDS ***
Dealt to matiko09 [2s 9d]
EdHunder leaves the table
sanpidk: calls $1
KLOP06031987 joins the table at seat #8 
KLOP06031987 leaves the table
maxxmeister: raises $4 to $5
chaps1988: folds 
tipner: folds 
Monsthand: folds 
Düss2411 joins the table at seat #8 
I The King I: folds 
matiko09: folds 
Düss2411 leaves the table
RSBoris joins the table at seat #8 
sanpidk: raises $11.50 to $16.50
maxxmeister: folds 
Uncalled bet ($11.50) returned to sanpidk
sanpidk collected $11.50 from pot
sanpidk: doesn't show hand 
*** SUMMARY ***
Total pot $11.50 | Rake $0 
Seat 1: I The King I (small blind) folded before Flop
Seat 2: matiko09 (big blind) folded before Flop
Seat 3: sanpidk collected ($11.50)
Seat 4: maxxmeister folded before Flop
Seat 5: chaps1988 folded before Flop (didn't bet)
Seat 6: tipner folded before Flop (didn't bet)
Seat 7: Monsthand (button) folded before Flop (didn't bet)





PokerStars Hand #148220355662:  Hold'em No Limit ($0.50/$1.00 USD) - 2016/02/04 15:47:09 CET [2016/02/04 9:47:09 ET]
Table 'Helio III' 9-max Seat #6 is the button
Seat 1: MagicKid777 ($100.18 in chips) 
Seat 3: RICKA16 ($101.81 in chips) 
Seat 5: Rafaello18 ($116.68 in chips) 
Seat 6: I The King I ($148.59 in chips) 
Seat 7: matiko09 ($100 in chips) 
Seat 8: Sweden_Pound ($102.50 in chips) 
Seat 9: pandalapa ($112.49 in chips) 
matiko09: posts small blind $0.50
Sweden_Pound: posts big blind $1
RSBoris: sits out 
*** HOLE CARDS ***
Dealt to matiko09 [8d 3h]
pandalapa: folds 
MagicKid777: folds 
RICKA16: folds 
Rafaello18: raises $1.50 to $2.50
I The King I: raises $4.96 to $7.46
matiko09: folds 
Sweden_Pound: folds 
Rafaello18: calls $4.96
*** FLOP *** [6s 7d 5s]
Rafaello18: checks 
I The King I: checks 
*** TURN *** [6s 7d 5s] [9s]
Rafaello18: bets $10.50
I The King I: folds 
Uncalled bet ($10.50) returned to Rafaello18
Rafaello18 collected $15.68 from pot
Rafaello18: doesn't show hand 
*** SUMMARY ***
Total pot $16.42 | Rake $0.74 
Board [6s 7d 5s 9s]
Seat 1: MagicKid777 folded before Flop (didn't bet)
Seat 3: RICKA16 folded before Flop (didn't bet)
Seat 5: Rafaello18 collected ($15.68)
Seat 6: I The King I (button) folded on the Turn
Seat 7: matiko09 (small blind) folded before Flop
Seat 8: Sweden_Pound (big blind) folded before Flop
Seat 9: pandalapa folded before Flop (didn't bet)





PokerStars Hand #148220363170:  Hold'em No Limit ($0.50/$1.00 USD) - 2016/02/04 15:47:16 CET [2016/02/04 9:47:16 ET]
Table 'Alkaid II' 9-max Seat #1 is the button
Seat 1: Dante63s ($108.40 in chips) 
Seat 2: Sweden_Pound ($113.48 in chips) 
Seat 4: SumPosad ($54.49 in chips) 
Seat 5: geoffreyjo ($78.85 in chips) 
Seat 6: I The King I ($150.43 in chips) 
Seat 7: Monsthand ($100 in chips) 
Seat 8: KLOP06031987 ($112.39 in chips) 
Seat 9: matiko09 ($107.05 in chips) 
Sweden_Pound: posts small blind $0.50
omorfadramou: is sitting out 
SumPosad: posts big blind $1
omorfadramou leaves the table
*** HOLE CARDS ***
Dealt to matiko09 [2h Ah]
geoffreyjo: folds 
sebaaastian joins the table at seat #3 
I The King I: folds 
Monsthand: folds 
KLOP06031987: folds 
matiko09: raises $1.50 to $2.50
Dante63s: folds 
Sweden_Pound: folds 
SumPosad: folds 
Uncalled bet ($1.50) returned to matiko09
matiko09 collected $2.50 from pot
matiko09: doesn't show hand 
*** SUMMARY ***
Total pot $2.50 | Rake $0 
Seat 1: Dante63s (button) folded before Flop (didn't bet)
Seat 2: Sweden_Pound (small blind) folded before Flop
Seat 4: SumPosad (big blind) folded before Flop
Seat 5: geoffreyjo folded before Flop (didn't bet)
Seat 6: I The King I folded before Flop (didn't bet)
Seat 7: Monsthand folded before Flop (didn't bet)
Seat 8: KLOP06031987 folded before Flop (didn't bet)
Seat 9: matiko09 collected ($2.50)





PokerStars Hand #148220363814:  Hold'em No Limit ($0.50/$1.00 USD) - 2016/02/04 15:47:16 CET [2016/02/04 9:47:16 ET]
Table 'Arneb II' 9-max Seat #6 is the button
Seat 1: matiko09 ($103.88 in chips) 
Seat 2: sanpidk ($217.75 in chips) 
Seat 3: brille-390 ($146.52 in chips) 
Seat 4: Venomous100% ($100 in chips) 
Seat 5: lumen21 ($100 in chips) 
Seat 6: volwebni4ek ($75.95 in chips) 
Seat 7: melitakas ($277.62 in chips) 
Seat 8: xxxZeka ($100 in chips) 
Seat 9: tipner ($198.95 in chips) 
melitakas: posts small blind $0.50
xxxZeka: posts big blind $1
*** HOLE CARDS ***
Dealt to matiko09 [8h 9d]
tipner: folds 
matiko09: folds 
sanpidk: folds 
brille-390: folds 
Venomous100%: folds 
lumen21: folds 
volwebni4ek: folds 
melitakas: raises $1 to $2
xxxZeka: calls $1
*** FLOP *** [6d Jc 6h]
melitakas: bets $1.91
xxxZeka: folds 
Uncalled bet ($1.91) returned to melitakas
melitakas collected $3.82 from pot
*** SUMMARY ***
Total pot $4 | Rake $0.18 
Board [6d Jc 6h]
Seat 1: matiko09 folded before Flop (didn't bet)
Seat 2: sanpidk folded before Flop (didn't bet)
Seat 3: brille-390 folded before Flop (didn't bet)
Seat 4: Venomous100% folded before Flop (didn't bet)
Seat 5: lumen21 folded before Flop (didn't bet)
Seat 6: volwebni4ek (button) folded before Flop (didn't bet)
Seat 7: melitakas (small blind) collected ($3.82)
Seat 8: xxxZeka (big blind) folded on the Flop
Seat 9: tipner folded before Flop (didn't bet)





PokerStars Hand #148220365233:  Hold'em No Limit ($0.50/$1.00 USD) - 2016/02/04 15:47:17 CET [2016/02/04 9:47:17 ET]
Table 'Siarnaq' 9-max Seat #8 is the button
Seat 1: Dante63s ($100 in chips) 
Seat 3: goblind4777 ($136.25 in chips) 
Seat 4: Spid1 ($102.50 in chips) 
Seat 5: I The King I ($132.87 in chips) 
Seat 6: Monsthand ($100 in chips) 
Seat 7: matiko09 ($114.59 in chips) 
Seat 8: Sweden_Pound ($114.67 in chips) 
Seat 9: MagicKid777 ($97.50 in chips) 
MagicKid777: posts small blind $0.50
Dante63s: posts big blind $1
V.Barinov: sits out 
*** HOLE CARDS ***
Dealt to matiko09 [Ts 4c]
goblind4777: folds 
Spid1: folds 
I The King I: folds 
Monsthand: folds 
matiko09: folds 
Sweden_Pound: folds 
MagicKid777: raises $2 to $3
Dante63s: folds 
Uncalled bet ($2) returned to MagicKid777
MagicKid777 collected $2 from pot
MagicKid777: doesn't show hand 
*** SUMMARY ***
Total pot $2 | Rake $0 
Seat 1: Dante63s (big blind) folded before Flop
Seat 3: goblind4777 folded before Flop (didn't bet)
Seat 4: Spid1 folded before Flop (didn't bet)
Seat 5: I The King I folded before Flop (didn't bet)
Seat 6: Monsthand folded before Flop (didn't bet)
Seat 7: matiko09 folded before Flop (didn't bet)
Seat 8: Sweden_Pound (button) folded before Flop (didn't bet)
Seat 9: MagicKid777 (small blind) collected ($2)





PokerStars Hand #148220367918:  Hold'em No Limit ($0.50/$1.00 USD) - 2016/02/04 15:47:21 CET [2016/02/04 9:47:21 ET]
Table 'Isara' 9-max Seat #9 is the button
Seat 2: davianvalek ($128.73 in chips) 
Seat 3: Monsthand ($100 in chips) 
Seat 4: Dante63s ($111.49 in chips) 
Seat 5: Igor DoUrden ($105.85 in chips) 
Seat 6: Rafaello18 ($156.05 in chips) 
Seat 7: warney1976 ($93.68 in chips) 
Seat 8: matiko09 ($115.17 in chips) 
Seat 9: chauyeuba ($63.14 in chips) 
Sweden_Pound will be allowed to play after the button
davianvalek: posts small blind $0.50
Monsthand: posts big blind $1
*** HOLE CARDS ***
Dealt to matiko09 [Tc 9h]
Dante63s: folds 
Igor DoUrden: folds 
Rafaello18: folds 
warney1976: raises $2 to $3
matiko09: folds 
chauyeuba: calls $3
davianvalek: folds 
Monsthand: raises $10 to $13
warney1976: folds 
chauyeuba: folds 
Uncalled bet ($10) returned to Monsthand
Monsthand collected $9.50 from pot
*** SUMMARY ***
Total pot $9.50 | Rake $0 
Seat 2: davianvalek (small blind) folded before Flop
Seat 3: Monsthand (big blind) collected ($9.50)
Seat 4: Dante63s folded before Flop (didn't bet)
Seat 5: Igor DoUrden folded before Flop (didn't bet)
Seat 6: Rafaello18 folded before Flop (didn't bet)
Seat 7: warney1976 folded before Flop
Seat 8: matiko09 folded before Flop (didn't bet)
Seat 9: chauyeuba (button) folded before Flop





PokerStars Hand #148220382340:  Hold'em No Limit ($0.50/$1.00 USD) - 2016/02/04 15:47:36 CET [2016/02/04 9:47:36 ET]
Table 'Mothallah' 9-max Seat #2 is the button
Seat 1: Rafaello18 ($112 in chips) 
Seat 2: davianvalek ($102.70 in chips) 
Seat 3: ozone2003 ($131.93 in chips) 
Seat 4: YOUNG_G70 ($97.58 in chips) 
Seat 5: chaps1988 ($100 in chips) 
Seat 6: I The King I ($130.23 in chips) 
Seat 7: sanpidk ($100 in chips) 
Seat 8: Spid1 ($139.78 in chips) 
Seat 9: matiko09 ($106 in chips) 
ozone2003: posts small blind $0.50
YOUNG_G70: posts big blind $1
*** HOLE CARDS ***
Dealt to matiko09 [3d 2d]
chaps1988: folds 
I The King I: folds 
sanpidk: folds 
Spid1: folds 
matiko09: folds 
Rafaello18: folds 
davianvalek: folds 
ozone2003: folds 
Uncalled bet ($0.50) returned to YOUNG_G70
YOUNG_G70 collected $1 from pot
YOUNG_G70: doesn't show hand 
*** SUMMARY ***
Total pot $1 | Rake $0 
Seat 1: Rafaello18 folded before Flop (didn't bet)
Seat 2: davianvalek (button) folded before Flop (didn't bet)
Seat 3: ozone2003 (small blind) folded before Flop
Seat 4: YOUNG_G70 (big blind) collected ($1)
Seat 5: chaps1988 folded before Flop (didn't bet)
Seat 6: I The King I folded before Flop (didn't bet)
Seat 7: sanpidk folded before Flop (didn't bet)
Seat 8: Spid1 folded before Flop (didn't bet)
Seat 9: matiko09 folded before Flop (didn't bet)





PokerStars Hand #148220384230:  Hold'em No Limit ($0.50/$1.00 USD) - 2016/02/04 15:47:36 CET [2016/02/04 9:47:36 ET]
Table 'Gutemberga' 9-max Seat #5 is the button
Seat 1: RICKA16 ($102.23 in chips) 
Seat 2: Rafaello18 ($100 in chips) 
Seat 3: Oligarhs4 ($66.87 in chips) 
Seat 4: Sweden_Pound ($100 in chips) 
Seat 5: Monsthand ($101.50 in chips) 
Seat 6: I The King I ($102.44 in chips) 
Seat 8: matiko09 ($134.66 in chips) 
Seat 9: xxxZeka ($104.50 in chips) 
I The King I: posts small blind $0.50
matiko09: posts big blind $1
*** HOLE CARDS ***
Dealt to matiko09 [3s Qd]
xxxZeka: folds 
RICKA16: folds 
Rafaello18: folds 
Oligarhs4: folds 
Sweden_Pound: folds 
Monsthand: raises $1 to $2
I The King I: raises $5 to $7
matiko09: folds 
Monsthand: calls $5
*** FLOP *** [Qs 5c 3h]
I The King I: checks 
Monsthand: bets $8.75
I The King I: folds 
Uncalled bet ($8.75) returned to Monsthand
Monsthand collected $14.32 from pot
*** SUMMARY ***
Total pot $15 | Rake $0.68 
Board [Qs 5c 3h]
Seat 1: RICKA16 folded before Flop (didn't bet)
Seat 2: Rafaello18 folded before Flop (didn't bet)
Seat 3: Oligarhs4 folded before Flop (didn't bet)
Seat 4: Sweden_Pound folded before Flop (didn't bet)
Seat 5: Monsthand (button) collected ($14.32)
Seat 6: I The King I (small blind) folded on the Flop
Seat 8: matiko09 (big blind) folded before Flop
Seat 9: xxxZeka folded before Flop (didn't bet)





PokerStars Hand #148220391800:  Hold'em No Limit ($0.50/$1.00 USD) - 2016/02/04 15:47:43 CET [2016/02/04 9:47:43 ET]
Table 'Siarnaq' 9-max Seat #9 is the button
Seat 1: Dante63s ($100 in chips) 
Seat 2: V.Barinov ($100 in chips) 
Seat 3: goblind4777 ($136.25 in chips) 
Seat 4: Spid1 ($102.50 in chips) 
Seat 5: I The King I ($132.87 in chips) 
Seat 6: Monsthand ($100 in chips) 
Seat 7: matiko09 ($114.59 in chips) 
Seat 8: Sweden_Pound ($114.67 in chips) 
Seat 9: MagicKid777 ($98.50 in chips) 
Dante63s: posts small blind $0.50
V.Barinov: posts big blind $1
*** HOLE CARDS ***
Dealt to matiko09 [6c Td]
goblind4777: folds 
Spid1: raises $2 to $3
I The King I: folds 
Monsthand: folds 
matiko09: folds 
Sweden_Pound: folds 
MagicKid777: folds 
Dante63s: folds 
V.Barinov: folds 
Uncalled bet ($2) returned to Spid1
Spid1 collected $2.50 from pot
Spid1: doesn't show hand 
*** SUMMARY ***
Total pot $2.50 | Rake $0 
Seat 1: Dante63s (small blind) folded before Flop
Seat 2: V.Barinov (big blind) folded before Flop
Seat 3: goblind4777 folded before Flop (didn't bet)
Seat 4: Spid1 collected ($2.50)
Seat 5: I The King I folded before Flop (didn't bet)
Seat 6: Monsthand folded before Flop (didn't bet)
Seat 7: matiko09 folded before Flop (didn't bet)
Seat 8: Sweden_Pound folded before Flop (didn't bet)
Seat 9: MagicKid777 (button) folded before Flop (didn't bet)





PokerStars Hand #148220394744:  Hold'em No Limit ($0.50/$1.00 USD) - 2016/02/04 15:47:47 CET [2016/02/04 9:47:47 ET]
Table 'Dejan' 9-max Seat #2 is the button
Seat 1: matiko09 ($104 in chips) 
Seat 2: xxxZeka ($100.25 in chips) 
Seat 3: lumen21 ($100 in chips) 
Seat 4: pruxa72 ($125.53 in chips) 
Seat 5: Rafaello18 ($119.84 in chips) 
Seat 8: s26s ($127.23 in chips) 
Seat 9: I The King I ($125.49 in chips) 
lumen21: posts small blind $0.50
pruxa72: posts big blind $1
KLOP06031987: sits out 
*** HOLE CARDS ***
Dealt to matiko09 [7s Kd]
Rafaello18: folds 
s26s: folds 
I The King I: folds 
matiko09: folds 
xxxZeka: folds 
lumen21: folds 
Uncalled bet ($0.50) returned to pruxa72
pruxa72 collected $1 from pot
pruxa72: doesn't show hand 
*** SUMMARY ***
Total pot $1 | Rake $0 
Seat 1: matiko09 folded before Flop (didn't bet)
Seat 2: xxxZeka (button) folded before Flop (didn't bet)
Seat 3: lumen21 (small blind) folded before Flop
Seat 4: pruxa72 (big blind) collected ($1)
Seat 5: Rafaello18 folded before Flop (didn't bet)
Seat 8: s26s folded before Flop (didn't bet)
Seat 9: I The King I folded before Flop (didn't bet)





PokerStars Hand #148220400556:  Hold'em No Limit ($0.50/$1.00 USD) - 2016/02/04 15:47:51 CET [2016/02/04 9:47:51 ET]
Table 'Alkaid II' 9-max Seat #2 is the button
Seat 1: Dante63s ($108.40 in chips) 
Seat 2: Sweden_Pound ($112.98 in chips) 
Seat 4: SumPosad ($53.49 in chips) 
Seat 5: geoffreyjo ($78.85 in chips) 
Seat 6: I The King I ($150.43 in chips) 
Seat 7: Monsthand ($100 in chips) 
Seat 8: KLOP06031987 ($112.39 in chips) 
Seat 9: matiko09 ($108.55 in chips) 
sebaaastian will be allowed to play after the button
SumPosad: posts small blind $0.50
geoffreyjo: posts big blind $1
*** HOLE CARDS ***
Dealt to matiko09 [Qh 7s]
I The King I: folds 
Monsthand: raises $2 to $3
KLOP06031987: folds 
matiko09: folds 
Dante63s: folds 
Sweden_Pound: folds 
SumPosad: folds 
geoffreyjo: calls $2
*** FLOP *** [3s 2c 6s]
geoffreyjo: checks 
Monsthand: bets $4
geoffreyjo: calls $4
*** TURN *** [3s 2c 6s] [3d]
geoffreyjo: checks 
Monsthand: checks 
*** RIVER *** [3s 2c 6s 3d] [Js]
geoffreyjo: checks 
Monsthand: bets $8
geoffreyjo: calls $8
*** SHOW DOWN ***
Monsthand: shows [Jd Ah] (two pair, Jacks and Threes)
geoffreyjo: mucks hand 
Monsthand collected $29.13 from pot
*** SUMMARY ***
Total pot $30.50 | Rake $1.37 
Board [3s 2c 6s 3d Js]
Seat 1: Dante63s folded before Flop (didn't bet)
Seat 2: Sweden_Pound (button) folded before Flop (didn't bet)
Seat 4: SumPosad (small blind) folded before Flop
Seat 5: geoffreyjo (big blind) mucked [Ad Qc]
Seat 6: I The King I folded before Flop (didn't bet)
Seat 7: Monsthand showed [Jd Ah] and won ($29.13) with two pair, Jacks and Threes
Seat 8: KLOP06031987 folded before Flop (didn't bet)
Seat 9: matiko09 folded before Flop (didn't bet)





PokerStars Hand #148220412350:  Hold'em No Limit ($0.50/$1.00 USD) - 2016/02/04 15:48:05 CET [2016/02/04 9:48:05 ET]
Table 'Mothallah' 9-max Seat #3 is the button
Seat 1: Rafaello18 ($112 in chips) 
Seat 2: davianvalek ($102.70 in chips) 
Seat 3: ozone2003 ($131.43 in chips) 
Seat 4: YOUNG_G70 ($98.08 in chips) 
Seat 5: chaps1988 ($100 in chips) 
Seat 6: I The King I ($130.23 in chips) 
Seat 7: sanpidk ($100 in chips) 
Seat 8: Spid1 ($139.78 in chips) 
Seat 9: matiko09 ($106 in chips) 
YOUNG_G70: posts small blind $0.50
chaps1988: posts big blind $1
*** HOLE CARDS ***
Dealt to matiko09 [2h 3h]
I The King I: folds 
sanpidk: folds 
Spid1: raises $2 to $3
matiko09: folds 
Rafaello18: folds 
davianvalek: folds 
ozone2003: folds 
YOUNG_G70: folds 
chaps1988: folds 
Uncalled bet ($2) returned to Spid1
Spid1 collected $2.50 from pot
Spid1: doesn't show hand 
*** SUMMARY ***
Total pot $2.50 | Rake $0 
Seat 1: Rafaello18 folded before Flop (didn't bet)
Seat 2: davianvalek folded before Flop (didn't bet)
Seat 3: ozone2003 (button) folded before Flop (didn't bet)
Seat 4: YOUNG_G70 (small blind) folded before Flop
Seat 5: chaps1988 (big blind) folded before Flop
Seat 6: I The King I folded before Flop (didn't bet)
Seat 7: sanpidk folded before Flop (didn't bet)
Seat 8: Spid1 collected ($2.50)
Seat 9: matiko09 folded before Flop (didn't bet)





PokerStars Hand #148220414349:  Hold'em No Limit ($0.50/$1.00 USD) - 2016/02/04 15:48:08 CET [2016/02/04 9:48:08 ET]
Table 'Avior II' 9-max Seat #1 is the button
Seat 1: I The King I ($100 in chips) 
Seat 2: matiko09 ($100 in chips) 
Seat 4: maxxmeister ($108.41 in chips) 
Seat 5: chaps1988 ($178.98 in chips) 
Seat 6: tipner ($216.47 in chips) 
Seat 7: Monsthand ($102 in chips) 
matiko09: posts small blind $0.50
sanpidk: is sitting out 
maxxmeister: posts big blind $1
sanpidk leaves the table
RSBoris: sits out 
Sweden_Pound: sits out 
*** HOLE CARDS ***
Dealt to matiko09 [Qd As]
Galador72 joins the table at seat #3 
chaps1988: folds 
tipner: folds 
Monsthand: folds 
I The King I: raises $1 to $2
matiko09: raises $6 to $8
maxxmeister: folds 
I The King I: calls $6
*** FLOP *** [Td Ad 7d]
matiko09: checks 
I The King I: checks 
*** TURN *** [Td Ad 7d] [Th]
matiko09: checks 
I The King I: checks 
*** RIVER *** [Td Ad 7d Th] [5d]
matiko09: bets $11
I The King I: folds 
Uncalled bet ($11) returned to matiko09
matiko09 collected $16.24 from pot
matiko09: doesn't show hand 
*** SUMMARY ***
Total pot $17 | Rake $0.76 
Board [Td Ad 7d Th 5d]
Seat 1: I The King I (button) folded on the River
Seat 2: matiko09 (small blind) collected ($16.24)
Seat 4: maxxmeister (big blind) folded before Flop
Seat 5: chaps1988 folded before Flop (didn't bet)
Seat 6: tipner folded before Flop (didn't bet)
Seat 7: Monsthand folded before Flop (didn't bet)





PokerStars Hand #148220416032:  Hold'em No Limit ($0.50/$1.00 USD) - 2016/02/04 15:48:10 CET [2016/02/04 9:48:10 ET]
Table 'Arneb II' 9-max Seat #7 is the button
Seat 1: matiko09 ($103.88 in chips) 
Seat 2: sanpidk ($217.75 in chips) 
Seat 3: brille-390 ($146.52 in chips) 
Seat 4: Venomous100% ($100 in chips) 
Seat 5: lumen21 ($100 in chips) 
Seat 6: volwebni4ek ($75.95 in chips) 
Seat 7: melitakas ($279.44 in chips) 
Seat 8: xxxZeka ($100 in chips) 
Seat 9: tipner ($198.95 in chips) 
xxxZeka: posts small blind $0.50
tipner: posts big blind $1
*** HOLE CARDS ***
Dealt to matiko09 [2c 5d]
matiko09: folds 
sanpidk: folds 
brille-390: folds 
Venomous100%: folds 
lumen21: raises $2 to $3
volwebni4ek: folds 
melitakas: folds 
xxxZeka: folds 
tipner: folds 
Uncalled bet ($2) returned to lumen21
lumen21 collected $2.50 from pot
lumen21: doesn't show hand 
*** SUMMARY ***
Total pot $2.50 | Rake $0 
Seat 1: matiko09 folded before Flop (didn't bet)
Seat 2: sanpidk folded before Flop (didn't bet)
Seat 3: brille-390 folded before Flop (didn't bet)
Seat 4: Venomous100% folded before Flop (didn't bet)
Seat 5: lumen21 collected ($2.50)
Seat 6: volwebni4ek folded before Flop (didn't bet)
Seat 7: melitakas (button) folded before Flop (didn't bet)
Seat 8: xxxZeka (small blind) folded before Flop
Seat 9: tipner (big blind) folded before Flop





PokerStars Hand #148220419351:  Hold'em No Limit ($0.50/$1.00 USD) - 2016/02/04 15:48:14 CET [2016/02/04 9:48:14 ET]
Table 'Amelia II' 9-max Seat #7 is the button
Seat 1: matiko09 ($100.10 in chips) 
Seat 2: WYY790125 ($110.44 in chips) 
Seat 3: Dante63s ($197.30 in chips) 
Seat 4: Monsthand ($124.01 in chips) 
Seat 5: maxxmeister ($253.80 in chips) 
Seat 6: tipner ($119.73 in chips) 
Seat 7: Spid1 ($185.79 in chips) 
Seat 8: Sweden_Pound ($250 in chips) 
Sweden_Pound: posts small blind $0.50
Cikadejooo is disconnected 
Cikadejooo has timed out while disconnected
Cikadejooo: is sitting out 
matiko09: posts big blind $1
matiko09: posts the ante $0.20
WYY790125: posts the ante $0.20
Dante63s: posts the ante $0.20
Monsthand: posts the ante $0.20
maxxmeister: posts the ante $0.20
tipner: posts the ante $0.20
Spid1: posts the ante $0.20
Sweden_Pound: posts the ante $0.20
*** HOLE CARDS ***
Dealt to matiko09 [3h Tc]
WYY790125: folds 
Dante63s: folds 
Monsthand: folds 
maxxmeister: folds 
tipner: folds 
Spid1: raises $1.50 to $2.50
Sweden_Pound: folds 
matiko09: folds 
Uncalled bet ($1.50) returned to Spid1
Spid1 collected $4.10 from pot
Spid1: doesn't show hand 
*** SUMMARY ***
Total pot $4.10 | Rake $0 
Seat 1: matiko09 (big blind) folded before Flop
Seat 2: WYY790125 folded before Flop (didn't bet)
Seat 3: Dante63s folded before Flop (didn't bet)
Seat 4: Monsthand folded before Flop (didn't bet)
Seat 5: maxxmeister folded before Flop (didn't bet)
Seat 6: tipner folded before Flop (didn't bet)
Seat 7: Spid1 (button) collected ($4.10)
Seat 8: Sweden_Pound (small blind) folded before Flop





PokerStars Hand #148220421767:  Hold'em No Limit ($0.50/$1.00 USD) - 2016/02/04 15:48:17 CET [2016/02/04 9:48:17 ET]
Table 'Helio III' 9-max Seat #7 is the button
Seat 1: MagicKid777 ($100.18 in chips) 
Seat 3: RICKA16 ($101.81 in chips) 
Seat 5: Rafaello18 ($124.90 in chips) 
Seat 6: I The King I ($141.13 in chips) 
Seat 7: matiko09 ($100 in chips) 
Seat 8: Sweden_Pound ($101.50 in chips) 
Seat 9: pandalapa ($112.49 in chips) 
Sweden_Pound: posts small blind $0.50
pandalapa: posts big blind $1
mycka86: sits out 
RSBoris: sits out 
*** HOLE CARDS ***
Dealt to matiko09 [8h 2d]
MagicKid777: folds 
RICKA16: folds 
Rafaello18: folds 
I The King I: raises $2 to $3
matiko09: folds 
Sweden_Pound: folds 
pandalapa: folds 
Uncalled bet ($2) returned to I The King I
I The King I collected $2.50 from pot
I The King I: doesn't show hand 
*** SUMMARY ***
Total pot $2.50 | Rake $0 
Seat 1: MagicKid777 folded before Flop (didn't bet)
Seat 3: RICKA16 folded before Flop (didn't bet)
Seat 5: Rafaello18 folded before Flop (didn't bet)
Seat 6: I The King I collected ($2.50)
Seat 7: matiko09 (button) folded before Flop (didn't bet)
Seat 8: Sweden_Pound (small blind) folded before Flop
Seat 9: pandalapa (big blind) folded before Flop





PokerStars Hand #148220424758:  Hold'em No Limit (€0.50/€1.00 EUR) - 2016/02/04 15:48:21 CET [2016/02/04 9:48:21 ET]
Table 'Roemera II' 9-max Seat #7 is the button
Seat 1: Venomous100% (€100 in chips) 
Seat 2: August518 (€62.57 in chips) 
Seat 3: All in Julio (€75 in chips) 
Seat 4: Kukuryzka (€100 in chips) 
Seat 5: tipner (€100 in chips) 
Seat 6: Dante63s (€100 in chips) 
Seat 7: Sweden_Pound (€100 in chips) 
Seat 8: Rafaello18 (€100 in chips) 
Seat 9: matiko09 (€100 in chips) 
Rafaello18: posts small blind €0.50
matiko09: posts big blind €1
*** HOLE CARDS ***
Dealt to matiko09 [6s Qd]
Venomous100%: folds 
August518: folds 
All in Julio: folds 
Kukuryzka: folds 
tipner: folds 
Dante63s: folds 
Sweden_Pound: raises €1 to €2
Rafaello18: calls €1.50
matiko09: folds 
*** FLOP *** [3h 8d Jh]
Rafaello18: checks 
Sweden_Pound: bets €3
Rafaello18: folds 
Uncalled bet (€3) returned to Sweden_Pound
Sweden_Pound collected €4.78 from pot
Sweden_Pound: doesn't show hand 
*** SUMMARY ***
Total pot €5 | Rake €0.22 
Board [3h 8d Jh]
Seat 1: Venomous100% folded before Flop (didn't bet)
Seat 2: August518 folded before Flop (didn't bet)
Seat 3: All in Julio folded before Flop (didn't bet)
Seat 4: Kukuryzka folded before Flop (didn't bet)
Seat 5: tipner folded before Flop (didn't bet)
Seat 6: Dante63s folded before Flop (didn't bet)
Seat 7: Sweden_Pound (button) collected (€4.78)
Seat 8: Rafaello18 (small blind) folded on the Flop
Seat 9: matiko09 (big blind) folded before Flop





PokerStars Hand #148220426690:  Hold'em No Limit ($0.50/$1.00 USD) - 2016/02/04 15:48:23 CET [2016/02/04 9:48:23 ET]
Table 'Mothallah' 9-max Seat #4 is the button
Seat 1: Rafaello18 ($112 in chips) 
Seat 2: davianvalek ($102.70 in chips) 
Seat 3: ozone2003 ($131.43 in chips) 
Seat 4: YOUNG_G70 ($97.58 in chips) 
Seat 5: chaps1988 ($100 in chips) 
Seat 6: I The King I ($130.23 in chips) 
Seat 7: sanpidk ($100 in chips) 
Seat 8: Spid1 ($141.28 in chips) 
Seat 9: matiko09 ($106 in chips) 
chaps1988: posts small blind $0.50
I The King I: posts big blind $1
*** HOLE CARDS ***
Dealt to matiko09 [4h Qc]
sanpidk: raises $2 to $3
Spid1: folds 
matiko09: folds 
Rafaello18: folds 
davianvalek: folds 
ozone2003: folds 
YOUNG_G70: folds 
chaps1988: folds 
I The King I: folds 
Uncalled bet ($2) returned to sanpidk
sanpidk collected $2.50 from pot
sanpidk: doesn't show hand 
*** SUMMARY ***
Total pot $2.50 | Rake $0 
Seat 1: Rafaello18 folded before Flop (didn't bet)
Seat 2: davianvalek folded before Flop (didn't bet)
Seat 3: ozone2003 folded before Flop (didn't bet)
Seat 4: YOUNG_G70 (button) folded before Flop (didn't bet)
Seat 5: chaps1988 (small blind) folded before Flop
Seat 6: I The King I (big blind) folded before Flop
Seat 7: sanpidk collected ($2.50)
Seat 8: Spid1 folded before Flop (didn't bet)
Seat 9: matiko09 folded before Flop (didn't bet)





PokerStars Hand #148220427336:  Hold'em No Limit ($0.50/$1.00 USD) - 2016/02/04 15:48:24 CET [2016/02/04 9:48:24 ET]
Table 'Dejan' 9-max Seat #3 is the button
Seat 1: matiko09 ($104 in chips) 
Seat 2: xxxZeka ($100.25 in chips) 
Seat 3: lumen21 ($100 in chips) 
Seat 4: pruxa72 ($126.03 in chips) 
Seat 5: Rafaello18 ($119.84 in chips) 
Seat 8: s26s ($127.23 in chips) 
Seat 9: I The King I ($125.49 in chips) 
pruxa72: posts small blind $0.50
Rafaello18: posts big blind $1
KLOP06031987: sits out 
mycka86: sits out 
*** HOLE CARDS ***
Dealt to matiko09 [Qs 3d]
s26s: raises $2.50 to $3.50
I The King I: calls $3.50
matiko09: folds 
xxxZeka: folds 
lumen21: calls $3.50
pruxa72: calls $3
Rafaello18: folds 
*** FLOP *** [2c Ad 8s]
pruxa72: checks 
s26s: bets $9
I The King I: calls $9
lumen21: folds 
pruxa72: folds 
*** TURN *** [2c Ad 8s] [6s]
s26s: bets $15.76
I The King I: calls $15.76
*** RIVER *** [2c Ad 8s 6s] [3h]
s26s: checks 
I The King I: checks 
*** SHOW DOWN ***
s26s: shows [Kd Ah] (a pair of Aces)
I The King I: mucks hand 
s26s collected $61.72 from pot
*** SUMMARY ***
Total pot $64.52 | Rake $2.80 
Board [2c Ad 8s 6s 3h]
Seat 1: matiko09 folded before Flop (didn't bet)
Seat 2: xxxZeka folded before Flop (didn't bet)
Seat 3: lumen21 (button) folded on the Flop
Seat 4: pruxa72 (small blind) folded on the Flop
Seat 5: Rafaello18 (big blind) folded before Flop
Seat 8: s26s showed [Kd Ah] and won ($61.72) with a pair of Aces
Seat 9: I The King I mucked [Jc Ac]





PokerStars Hand #148220430437:  Hold'em No Limit ($0.50/$1.00 USD) - 2016/02/04 15:48:28 CET [2016/02/04 9:48:28 ET]
Table 'Arneb III' 9-max Seat #3 is the button
Seat 2: JeanLima93 ($321.69 in chips) 
Seat 3: matiko09 ($100 in chips) 
Seat 4: Igor DoUrden ($250.03 in chips) 
Seat 5: tipner ($133.52 in chips) 
Seat 6: lumen21 ($100 in chips) 
Seat 7: xxxZeka ($112.56 in chips) 
Seat 8: volwebni4ek ($40 in chips) 
Seat 9: ARTVOR640 ($114.17 in chips) 
Igor DoUrden: posts small blind $0.50
tipner: posts big blind $1
Kukuryzka: sits out 
*** HOLE CARDS ***
Dealt to matiko09 [4s 3s]
lumen21: folds 
xxxZeka: folds 
volwebni4ek: folds 
ARTVOR640: folds 
JeanLima93: folds 
matiko09: folds 
Igor DoUrden: folds 
Uncalled bet ($0.50) returned to tipner
tipner collected $1 from pot
tipner: doesn't show hand 
*** SUMMARY ***
Total pot $1 | Rake $0 
Seat 2: JeanLima93 folded before Flop (didn't bet)
Seat 3: matiko09 (button) folded before Flop (didn't bet)
Seat 4: Igor DoUrden (small blind) folded before Flop
Seat 5: tipner (big blind) collected ($1)
Seat 6: lumen21 folded before Flop (didn't bet)
Seat 7: xxxZeka folded before Flop (didn't bet)
Seat 8: volwebni4ek folded before Flop (didn't bet)
Seat 9: ARTVOR640 folded before Flop (didn't bet)





PokerStars Hand #148220432546:  Hold'em No Limit ($0.50/$1.00 USD) - 2016/02/04 15:48:31 CET [2016/02/04 9:48:31 ET]
Table 'Isara' 9-max Seat #2 is the button
Seat 2: davianvalek ($128.23 in chips) 
Seat 3: Monsthand ($106.50 in chips) 
Seat 4: Dante63s ($111.49 in chips) 
Seat 5: Igor DoUrden ($105.85 in chips) 
Seat 6: Rafaello18 ($156.05 in chips) 
Seat 7: warney1976 ($90.68 in chips) 
Seat 8: matiko09 ($115.17 in chips) 
Seat 9: chauyeuba ($60.14 in chips) 
Monsthand: posts small blind $0.50
Dante63s: posts big blind $1
Sweden_Pound: sits out 
*** HOLE CARDS ***
Dealt to matiko09 [6h Js]
Igor DoUrden: folds 
Rafaello18: folds 
warney1976: raises $1 to $2
matiko09: folds 
chauyeuba: folds 
davianvalek: folds 
Monsthand: folds 
Dante63s: folds 
Uncalled bet ($1) returned to warney1976
warney1976 collected $2.50 from pot
*** SUMMARY ***
Total pot $2.50 | Rake $0 
Seat 2: davianvalek (button) folded before Flop (didn't bet)
Seat 3: Monsthand (small blind) folded before Flop
Seat 4: Dante63s (big blind) folded before Flop
Seat 5: Igor DoUrden folded before Flop (didn't bet)
Seat 6: Rafaello18 folded before Flop (didn't bet)
Seat 7: warney1976 collected ($2.50)
Seat 8: matiko09 folded before Flop (didn't bet)
Seat 9: chauyeuba folded before Flop (didn't bet)





PokerStars Hand #148220443598:  Hold'em No Limit ($0.50/$1.00 USD) - 2016/02/04 15:48:46 CET [2016/02/04 9:48:46 ET]
Table 'Siarnaq' 9-max Seat #1 is the button
Seat 1: Dante63s ($100 in chips) 
Seat 2: V.Barinov ($99 in chips) 
Seat 3: goblind4777 ($136.25 in chips) 
Seat 4: Spid1 ($104 in chips) 
Seat 5: I The King I ($132.87 in chips) 
Seat 6: Monsthand ($100 in chips) 
Seat 7: matiko09 ($114.59 in chips) 
Seat 8: Sweden_Pound ($114.67 in chips) 
Seat 9: MagicKid777 ($98.50 in chips) 
V.Barinov: posts small blind $0.50
goblind4777: posts big blind $1
*** HOLE CARDS ***
Dealt to matiko09 [Tc 6c]
Spid1: folds 
I The King I: folds 
Monsthand: folds 
matiko09: folds 
Sweden_Pound: raises $2 to $3
MagicKid777: folds 
Dante63s: folds 
V.Barinov: folds 
goblind4777: folds 
Uncalled bet ($2) returned to Sweden_Pound
Sweden_Pound collected $2.50 from pot
Sweden_Pound: doesn't show hand 
*** SUMMARY ***
Total pot $2.50 | Rake $0 
Seat 1: Dante63s (button) folded before Flop (didn't bet)
Seat 2: V.Barinov (small blind) folded before Flop
Seat 3: goblind4777 (big blind) folded before Flop
Seat 4: Spid1 folded before Flop (didn't bet)
Seat 5: I The King I folded before Flop (didn't bet)
Seat 6: Monsthand folded before Flop (didn't bet)
Seat 7: matiko09 folded before Flop (didn't bet)
Seat 8: Sweden_Pound collected ($2.50)
Seat 9: MagicKid777 folded before Flop (didn't bet)





PokerStars Hand #148220443169:  Hold'em No Limit ($0.50/$1.00 USD) - 2016/02/04 15:48:46 CET [2016/02/04 9:48:46 ET]
Table 'Helio III' 9-max Seat #8 is the button
Seat 1: MagicKid777 ($100.18 in chips) 
Seat 3: RICKA16 ($101.81 in chips) 
Seat 5: Rafaello18 ($124.90 in chips) 
Seat 6: I The King I ($142.63 in chips) 
Seat 7: matiko09 ($100 in chips) 
Seat 8: Sweden_Pound ($101 in chips) 
Seat 9: pandalapa ($111.49 in chips) 
pandalapa: posts small blind $0.50
MagicKid777: posts big blind $1
mycka86: sits out 
RSBoris: sits out 
*** HOLE CARDS ***
Dealt to matiko09 [Qs Kd]
RICKA16: folds 
Rafaello18: folds 
I The King I: folds 
matiko09: raises $1.50 to $2.50
Sweden_Pound: calls $2.50
pandalapa: folds 
MagicKid777: calls $1.50
*** FLOP *** [Qh 7s 8c]
MagicKid777: checks 
matiko09: bets $4.97
Sweden_Pound: folds 
MagicKid777: folds 
Uncalled bet ($4.97) returned to matiko09
matiko09 collected $7.64 from pot
matiko09: doesn't show hand 
*** SUMMARY ***
Total pot $8 | Rake $0.36 
Board [Qh 7s 8c]
Seat 1: MagicKid777 (big blind) folded on the Flop
Seat 3: RICKA16 folded before Flop (didn't bet)
Seat 5: Rafaello18 folded before Flop (didn't bet)
Seat 6: I The King I folded before Flop (didn't bet)
Seat 7: matiko09 collected ($7.64)
Seat 8: Sweden_Pound (button) folded on the Flop
Seat 9: pandalapa (small blind) folded before Flop





PokerStars Hand #148220449207:  Hold'em No Limit ($0.50/$1.00 USD) - 2016/02/04 15:48:54 CET [2016/02/04 9:48:54 ET]
Table 'Arneb III' 9-max Seat #4 is the button
Seat 2: JeanLima93 ($321.69 in chips) 
Seat 3: matiko09 ($100 in chips) 
Seat 4: Igor DoUrden ($249.53 in chips) 
Seat 5: tipner ($134.02 in chips) 
Seat 6: lumen21 ($100 in chips) 
Seat 7: xxxZeka ($112.56 in chips) 
Seat 8: volwebni4ek ($40 in chips) 
Seat 9: ARTVOR640 ($114.17 in chips) 
tipner: posts small blind $0.50
lumen21: posts big blind $1
Kukuryzka: sits out 
*** HOLE CARDS ***
Dealt to matiko09 [Ks 7s]
xxxZeka: folds 
volwebni4ek: folds 
ARTVOR640: folds 
JeanLima93: folds 
matiko09: folds 
Igor DoUrden: folds 
tipner: folds 
Uncalled bet ($0.50) returned to lumen21
lumen21 collected $1 from pot
lumen21: doesn't show hand 
*** SUMMARY ***
Total pot $1 | Rake $0 
Seat 2: JeanLima93 folded before Flop (didn't bet)
Seat 3: matiko09 folded before Flop (didn't bet)
Seat 4: Igor DoUrden (button) folded before Flop (didn't bet)
Seat 5: tipner (small blind) folded before Flop
Seat 6: lumen21 (big blind) collected ($1)
Seat 7: xxxZeka folded before Flop (didn't bet)
Seat 8: volwebni4ek folded before Flop (didn't bet)
Seat 9: ARTVOR640 folded before Flop (didn't bet)





PokerStars Hand #148220450584:  Hold'em No Limit ($0.50/$1.00 USD) - 2016/02/04 15:48:56 CET [2016/02/04 9:48:56 ET]
Table 'Mothallah' 9-max Seat #5 is the button
Seat 1: Rafaello18 ($112 in chips) 
Seat 2: davianvalek ($102.70 in chips) 
Seat 3: ozone2003 ($131.43 in chips) 
Seat 4: YOUNG_G70 ($97.58 in chips) 
Seat 5: chaps1988 ($100 in chips) 
Seat 6: I The King I ($129.23 in chips) 
Seat 8: Spid1 ($141.28 in chips) 
Seat 9: matiko09 ($106 in chips) 
I The King I: posts small blind $0.50
sanpidk: is sitting out 
sanpidk leaves the table
Spid1: posts big blind $1
*** HOLE CARDS ***
Dealt to matiko09 [Th Jd]
matiko09: folds 
Rafaello18: folds 
davianvalek: folds 
ozone2003: raises $2 to $3
YOUNG_G70: folds 
chaps1988: folds 
I The King I: folds 
Spid1: folds 
Uncalled bet ($2) returned to ozone2003
ozone2003 collected $2.50 from pot
*** SUMMARY ***
Total pot $2.50 | Rake $0 
Seat 1: Rafaello18 folded before Flop (didn't bet)
Seat 2: davianvalek folded before Flop (didn't bet)
Seat 3: ozone2003 collected ($2.50)
Seat 4: YOUNG_G70 folded before Flop (didn't bet)
Seat 5: chaps1988 (button) folded before Flop (didn't bet)
Seat 6: I The King I (small blind) folded before Flop
Seat 8: Spid1 (big blind) folded before Flop
Seat 9: matiko09 folded before Flop (didn't bet)





PokerStars Hand #148220452593:  Hold'em No Limit ($0.50/$1.00 USD) - 2016/02/04 15:48:58 CET [2016/02/04 9:48:58 ET]
Table 'Arneb II' 9-max Seat #8 is the button
Seat 1: matiko09 ($103.88 in chips) 
Seat 2: sanpidk ($217.75 in chips) 
Seat 3: brille-390 ($146.52 in chips) 
Seat 4: Venomous100% ($100 in chips) 
Seat 5: lumen21 ($101.50 in chips) 
Seat 6: volwebni4ek ($75.95 in chips) 
Seat 7: melitakas ($279.44 in chips) 
Seat 8: xxxZeka ($100 in chips) 
Seat 9: tipner ($197.95 in chips) 
tipner: posts small blind $0.50
matiko09: posts big blind $1
*** HOLE CARDS ***
Dealt to matiko09 [7d Ks]
sanpidk: folds 
brille-390: folds 
Venomous100%: folds 
lumen21: folds 
volwebni4ek: folds 
melitakas: folds 
xxxZeka: raises $1.50 to $2.50
tipner: folds 
matiko09: folds 
Uncalled bet ($1.50) returned to xxxZeka
xxxZeka collected $2.50 from pot
sanpidk leaves the table
*** SUMMARY ***
Total pot $2.50 | Rake $0 
Seat 1: matiko09 (big blind) folded before Flop
Seat 2: sanpidk folded before Flop (didn't bet)
Seat 3: brille-390 folded before Flop (didn't bet)
Seat 4: Venomous100% folded before Flop (didn't bet)
Seat 5: lumen21 folded before Flop (didn't bet)
Seat 6: volwebni4ek folded before Flop (didn't bet)
Seat 7: melitakas folded before Flop (didn't bet)
Seat 8: xxxZeka (button) collected ($2.50)
Seat 9: tipner (small blind) folded before Flop





PokerStars Hand #148220454983:  Hold'em No Limit ($0.50/$1.00 USD) - 2016/02/04 15:49:01 CET [2016/02/04 9:49:01 ET]
Table 'Gutemberga' 9-max Seat #6 is the button
Seat 2: Rafaello18 ($100 in chips) 
Seat 3: Oligarhs4 ($66.87 in chips) 
Seat 4: Sweden_Pound ($100 in chips) 
Seat 5: Monsthand ($108.82 in chips) 
Seat 6: I The King I ($100 in chips) 
Seat 8: matiko09 ($133.66 in chips) 
mycka86 will be allowed to play after the button
matiko09: posts small blind $0.50
xxxZeka: is sitting out 
RICKA16: is sitting out 
Rafaello18: posts big blind $1
*** HOLE CARDS ***
Dealt to matiko09 [9c 4c]
RICKA16 leaves the table
RSBoris joins the table at seat #1 
Oligarhs4: folds 
xxxZeka leaves the table
Düss2411 joins the table at seat #9 
Sweden_Pound: raises $2 to $3
Monsthand: folds 
I The King I: folds 
matiko09: folds 
Rafaello18: folds 
Uncalled bet ($2) returned to Sweden_Pound
Sweden_Pound collected $2.50 from pot
Düss2411 leaves the table
Sweden_Pound: doesn't show hand 
*** SUMMARY ***
Total pot $2.50 | Rake $0 
Seat 2: Rafaello18 (big blind) folded before Flop
Seat 3: Oligarhs4 folded before Flop (didn't bet)
Seat 4: Sweden_Pound collected ($2.50)
Seat 5: Monsthand folded before Flop (didn't bet)
Seat 6: I The King I (button) folded before Flop (didn't bet)
Seat 8: matiko09 (small blind) folded before Flop





PokerStars Hand #148220462556:  Hold'em No Limit ($0.50/$1.00 USD) - 2016/02/04 15:49:11 CET [2016/02/04 9:49:11 ET]
Table 'Alkaid II' 9-max Seat #4 is the button
Seat 1: Dante63s ($108.40 in chips) 
Seat 2: Sweden_Pound ($112.98 in chips) 
Seat 4: SumPosad ($52.99 in chips) 
Seat 5: geoffreyjo ($63.85 in chips) 
Seat 6: I The King I ($150.43 in chips) 
Seat 7: Monsthand ($114.13 in chips) 
Seat 8: KLOP06031987 ($112.39 in chips) 
Seat 9: matiko09 ($108.55 in chips) 
geoffreyjo: posts small blind $0.50
I The King I: posts big blind $1
sebaaastian: sits out 
*** HOLE CARDS ***
Dealt to matiko09 [8c Ac]
Monsthand: folds 
KLOP06031987: folds 
matiko09: folds 
Dante63s: folds 
Sweden_Pound: folds 
SumPosad: raises $1.40 to $2.40
geoffreyjo: calls $1.90
I The King I: calls $1.40
*** FLOP *** [Ad 2s 3d]
geoffreyjo: checks 
I The King I: checks 
SumPosad: checks 
*** TURN *** [Ad 2s 3d] [Jd]
geoffreyjo: checks 
I The King I: checks 
SumPosad: bets $4
geoffreyjo: calls $4
I The King I: folds 
*** RIVER *** [Ad 2s 3d Jd] [Tc]
geoffreyjo: bets $7
SumPosad: calls $7
*** SHOW DOWN ***
geoffreyjo: shows [6d 7d] (a flush, Ace high)
SumPosad: mucks hand 
geoffreyjo collected $27.89 from pot
*** SUMMARY ***
Total pot $29.20 | Rake $1.31 
Board [Ad 2s 3d Jd Tc]
Seat 1: Dante63s folded before Flop (didn't bet)
Seat 2: Sweden_Pound folded before Flop (didn't bet)
Seat 4: SumPosad (button) mucked [Th Jh]
Seat 5: geoffreyjo (small blind) showed [6d 7d] and won ($27.89) with a flush, Ace high
Seat 6: I The King I (big blind) folded on the Turn
Seat 7: Monsthand folded before Flop (didn't bet)
Seat 8: KLOP06031987 folded before Flop (didn't bet)
Seat 9: matiko09 folded before Flop (didn't bet)





PokerStars Hand #148220465673:  Hold'em No Limit ($0.50/$1.00 USD) - 2016/02/04 15:49:16 CET [2016/02/04 9:49:16 ET]
Table 'Isara' 9-max Seat #3 is the button
Seat 2: davianvalek ($128.23 in chips) 
Seat 3: Monsthand ($106 in chips) 
Seat 4: Dante63s ($110.49 in chips) 
Seat 5: Igor DoUrden ($105.85 in chips) 
Seat 6: Rafaello18 ($156.05 in chips) 
Seat 7: warney1976 ($92.18 in chips) 
Seat 8: matiko09 ($115.17 in chips) 
Seat 9: chauyeuba ($60.14 in chips) 
Dante63s: posts small blind $0.50
Igor DoUrden: posts big blind $1
Sweden_Pound: sits out 
*** HOLE CARDS ***
Dealt to matiko09 [2s Tc]
Rafaello18: folds 
warney1976: folds 
matiko09: folds 
chauyeuba: folds 
davianvalek: folds 
Monsthand: folds 
Dante63s: folds 
Uncalled bet ($0.50) returned to Igor DoUrden
Igor DoUrden collected $1 from pot
Igor DoUrden: doesn't show hand 
*** SUMMARY ***
Total pot $1 | Rake $0 
Seat 2: davianvalek folded before Flop (didn't bet)
Seat 3: Monsthand (button) folded before Flop (didn't bet)
Seat 4: Dante63s (small blind) folded before Flop
Seat 5: Igor DoUrden (big blind) collected ($1)
Seat 6: Rafaello18 folded before Flop (didn't bet)
Seat 7: warney1976 folded before Flop (didn't bet)
Seat 8: matiko09 folded before Flop (didn't bet)
Seat 9: chauyeuba folded before Flop (didn't bet)





PokerStars Hand #148220470743:  Hold'em No Limit ($0.50/$1.00 USD) - 2016/02/04 15:49:22 CET [2016/02/04 9:49:22 ET]
Table 'Avior II' 9-max Seat #2 is the button
Seat 1: I The King I ($100 in chips) 
Seat 2: matiko09 ($108.24 in chips) 
Seat 4: maxxmeister ($107.41 in chips) 
Seat 5: chaps1988 ($178.98 in chips) 
Seat 6: tipner ($216.47 in chips) 
Seat 7: Monsthand ($102 in chips) 
Galador72 will be allowed to play after the button
maxxmeister: posts small blind $0.50
chaps1988: posts big blind $1
RSBoris: sits out 
Sweden_Pound: sits out 
*** HOLE CARDS ***
Dealt to matiko09 [8h Qc]
tipner: folds 
Monsthand: folds 
I The King I: folds 
matiko09: raises $1.27 to $2.27
maxxmeister: calls $1.77
chaps1988: folds 
*** FLOP *** [3c 2h 6s]
maxxmeister: checks 
matiko09: bets $3.44
maxxmeister: calls $3.44
*** TURN *** [3c 2h 6s] [Ts]
maxxmeister: checks 
matiko09: checks 
*** RIVER *** [3c 2h 6s Ts] [5d]
maxxmeister: checks 
matiko09: checks 
*** SHOW DOWN ***
maxxmeister: shows [9h Ah] (high card Ace)
matiko09: mucks hand 
maxxmeister collected $11.86 from pot
*** SUMMARY ***
Total pot $12.42 | Rake $0.56 
Board [3c 2h 6s Ts 5d]
Seat 1: I The King I folded before Flop (didn't bet)
Seat 2: matiko09 (button) mucked [8h Qc]
Seat 4: maxxmeister (small blind) showed [9h Ah] and won ($11.86) with high card Ace
Seat 5: chaps1988 (big blind) folded before Flop
Seat 6: tipner folded before Flop (didn't bet)
Seat 7: Monsthand folded before Flop (didn't bet)





PokerStars Hand #148220473528:  Hold'em No Limit ($0.50/$1.00 USD) - 2016/02/04 15:49:26 CET [2016/02/04 9:49:26 ET]
Table 'Mothallah' 9-max Seat #6 is the button
Seat 1: Rafaello18 ($112 in chips) 
Seat 2: davianvalek ($102.70 in chips) 
Seat 3: ozone2003 ($132.93 in chips) 
Seat 4: YOUNG_G70 ($97.58 in chips) 
Seat 5: chaps1988 ($100 in chips) 
Seat 6: I The King I ($128.73 in chips) 
Seat 8: Spid1 ($140.28 in chips) 
Seat 9: matiko09 ($106 in chips) 
Spid1: posts small blind $0.50
matiko09: posts big blind $1
*** HOLE CARDS ***
Dealt to matiko09 [4c 6h]
Rafaello18: folds 
davianvalek: folds 
ozone2003: raises $2 to $3
Düss2411 joins the table at seat #7 
YOUNG_G70: calls $3
chaps1988: folds 
I The King I: folds 
Spid1: folds 
matiko09: folds 
*** FLOP *** [Ah Qs 5h]
ozone2003: checks 
YOUNG_G70: checks 
*** TURN *** [Ah Qs 5h] [4h]
ozone2003: checks 
YOUNG_G70: bets $4
ozone2003: calls $4
*** RIVER *** [Ah Qs 5h 4h] [3d]
ozone2003: checks 
YOUNG_G70: checks 
*** SHOW DOWN ***
ozone2003: shows [9h 9d] (a pair of Nines)
YOUNG_G70: shows [Ad 2d] (a straight, Ace to Five)
YOUNG_G70 collected $14.80 from pot
*** SUMMARY ***
Total pot $15.50 | Rake $0.70 
Board [Ah Qs 5h 4h 3d]
Seat 1: Rafaello18 folded before Flop (didn't bet)
Seat 2: davianvalek folded before Flop (didn't bet)
Seat 3: ozone2003 showed [9h 9d] and lost with a pair of Nines
Seat 4: YOUNG_G70 showed [Ad 2d] and won ($14.80) with a straight, Ace to Five
Seat 5: chaps1988 folded before Flop (didn't bet)
Seat 6: I The King I (button) folded before Flop (didn't bet)
Seat 8: Spid1 (small blind) folded before Flop
Seat 9: matiko09 (big blind) folded before Flop





PokerStars Hand #148220475769:  Hold'em No Limit ($0.50/$1.00 USD) - 2016/02/04 15:49:29 CET [2016/02/04 9:49:29 ET]
Table 'Gutemberga' 9-max Seat #8 is the button
Seat 2: Rafaello18 ($100 in chips) 
Seat 3: Oligarhs4 ($66.87 in chips) 
Seat 4: Sweden_Pound ($101.50 in chips) 
Seat 5: Monsthand ($108.82 in chips) 
Seat 6: I The King I ($100 in chips) 
Seat 8: matiko09 ($133.16 in chips) 
RSBoris will be allowed to play after the button
Rafaello18: posts small blind $0.50
Oligarhs4: posts big blind $1
mycka86: sits out 
*** HOLE CARDS ***
Dealt to matiko09 [7s 2h]
Galador72 joins the table at seat #9 
Sweden_Pound: folds 
Sweden_Pound leaves the table
Monsthand: folds 
I The King I: raises $2 to $3
matiko09: folds 
Rafaello18: folds 
Oligarhs4: calls $2
*** FLOP *** [6d As 9h]
Oligarhs4: checks 
I The King I: checks 
*** TURN *** [6d As 9h] [Ks]
Oligarhs4: checks 
?lupi_AA joins the table at seat #4 
I The King I: checks 
*** RIVER *** [6d As 9h Ks] [6s]
Oligarhs4: checks 
I The King I: checks 
*** SHOW DOWN ***
Oligarhs4: shows [Js Kh] (two pair, Kings and Sixes)
I The King I: mucks hand 
Oligarhs4 collected $6.21 from pot
*** SUMMARY ***
Total pot $6.50 | Rake $0.29 
Board [6d As 9h Ks 6s]
Seat 2: Rafaello18 (small blind) folded before Flop
Seat 3: Oligarhs4 (big blind) showed [Js Kh] and won ($6.21) with two pair, Kings and Sixes
Seat 4: Sweden_Pound folded before Flop (didn't bet)
Seat 5: Monsthand folded before Flop (didn't bet)
Seat 6: I The King I mucked [5d 5c]
Seat 8: matiko09 (button) folded before Flop (didn't bet)





PokerStars Hand #148220479303:  Hold'em No Limit ($0.50/$1.00 USD) - 2016/02/04 15:49:34 CET [2016/02/04 9:49:34 ET]
Table 'Amelia II' 9-max Seat #8 is the button
Seat 1: matiko09 ($100 in chips) 
Seat 2: WYY790125 ($110.24 in chips) 
Seat 3: Dante63s ($197.10 in chips) 
Seat 4: Monsthand ($123.81 in chips) 
Seat 5: maxxmeister ($253.60 in chips) 
Seat 6: tipner ($119.53 in chips) 
Seat 7: Spid1 ($188.69 in chips) 
Seat 8: Sweden_Pound ($250 in chips) 
Cikadejooo will be allowed to play after the button
matiko09: posts small blind $0.50
WYY790125: posts big blind $1
matiko09: posts the ante $0.20
WYY790125: posts the ante $0.20
Dante63s: posts the ante $0.20
Monsthand: posts the ante $0.20
maxxmeister: posts the ante $0.20
tipner: posts the ante $0.20
Spid1: posts the ante $0.20
Sweden_Pound: posts the ante $0.20
*** HOLE CARDS ***
Dealt to matiko09 [4s Kd]
Dante63s: folds 
Monsthand: folds 
maxxmeister: folds 
tipner: folds 
Spid1: raises $1.50 to $2.50
Sweden_Pound: folds 
matiko09: folds 
WYY790125: calls $1.50
*** FLOP *** [5s 3d 5c]
Cikadejooo is disconnected 
WYY790125: checks 
Spid1: checks 
*** TURN *** [5s 3d 5c] [Jc]
WYY790125: checks 
Spid1: bets $5
WYY790125: folds 
Uncalled bet ($5) returned to Spid1
Spid1 collected $6.78 from pot
Spid1: doesn't show hand 
*** SUMMARY ***
Total pot $7.10 | Rake $0.32 
Board [5s 3d 5c Jc]
Seat 1: matiko09 (small blind) folded before Flop
Seat 2: WYY790125 (big blind) folded on the Turn
Seat 3: Dante63s folded before Flop (didn't bet)
Seat 4: Monsthand folded before Flop (didn't bet)
Seat 5: maxxmeister folded before Flop (didn't bet)
Seat 6: tipner folded before Flop (didn't bet)
Seat 7: Spid1 collected ($6.78)
Seat 8: Sweden_Pound (button) folded before Flop (didn't bet)





PokerStars Hand #148220480057:  Hold'em No Limit ($0.50/$1.00 USD) - 2016/02/04 15:49:35 CET [2016/02/04 9:49:35 ET]
Table 'Arneb III' 9-max Seat #5 is the button
Seat 2: JeanLima93 ($321.69 in chips) 
Seat 3: matiko09 ($100 in chips) 
Seat 4: Igor DoUrden ($249.53 in chips) 
Seat 5: tipner ($133.52 in chips) 
Seat 6: lumen21 ($100.50 in chips) 
Seat 7: xxxZeka ($112.56 in chips) 
Seat 8: volwebni4ek ($40 in chips) 
Seat 9: ARTVOR640 ($114.17 in chips) 
lumen21: posts small blind $0.50
xxxZeka: posts big blind $1
Kukuryzka: sits out 
*** HOLE CARDS ***
Dealt to matiko09 [6c 9d]
volwebni4ek: folds 
ARTVOR640: folds 
JeanLima93: raises $2 to $3
matiko09: folds 
Igor DoUrden: folds 
tipner: folds 
lumen21: folds 
xxxZeka: folds 
Uncalled bet ($2) returned to JeanLima93
JeanLima93 collected $2.50 from pot
JeanLima93: doesn't show hand 
*** SUMMARY ***
Total pot $2.50 | Rake $0 
Seat 2: JeanLima93 collected ($2.50)
Seat 3: matiko09 folded before Flop (didn't bet)
Seat 4: Igor DoUrden folded before Flop (didn't bet)
Seat 5: tipner (button) folded before Flop (didn't bet)
Seat 6: lumen21 (small blind) folded before Flop
Seat 7: xxxZeka (big blind) folded before Flop
Seat 8: volwebni4ek folded before Flop (didn't bet)
Seat 9: ARTVOR640 folded before Flop (didn't bet)





PokerStars Hand #148220481908:  Hold'em No Limit ($0.50/$1.00 USD) - 2016/02/04 15:49:38 CET [2016/02/04 9:49:38 ET]
Table 'Siarnaq' 9-max Seat #2 is the button
Seat 1: Dante63s ($100 in chips) 
Seat 2: V.Barinov ($98.50 in chips) 
Seat 3: goblind4777 ($135.25 in chips) 
Seat 5: I The King I ($132.87 in chips) 
Seat 6: Monsthand ($100 in chips) 
Seat 7: matiko09 ($114.59 in chips) 
Seat 8: Sweden_Pound ($116.17 in chips) 
Seat 9: MagicKid777 ($98.50 in chips) 
goblind4777: posts small blind $0.50
Spid1: is sitting out 
I The King I: posts big blind $1
*** HOLE CARDS ***
Dealt to matiko09 [Kh Js]
Spid1 leaves the table
Monsthand: folds 
RSBoris joins the table at seat #4 
matiko09: folds 
Sweden_Pound: raises $2 to $3
MagicKid777: folds 
Dante63s: folds 
V.Barinov: folds 
goblind4777: folds 
I The King I: folds 
Uncalled bet ($2) returned to Sweden_Pound
Sweden_Pound collected $2.50 from pot
Sweden_Pound: doesn't show hand 
*** SUMMARY ***
Total pot $2.50 | Rake $0 
Seat 1: Dante63s folded before Flop (didn't bet)
Seat 2: V.Barinov (button) folded before Flop (didn't bet)
Seat 3: goblind4777 (small blind) folded before Flop
Seat 5: I The King I (big blind) folded before Flop
Seat 6: Monsthand folded before Flop (didn't bet)
Seat 7: matiko09 folded before Flop (didn't bet)
Seat 8: Sweden_Pound collected ($2.50)
Seat 9: MagicKid777 folded before Flop (didn't bet)





PokerStars Hand #148220488697:  Hold'em No Limit ($0.50/$1.00 USD) - 2016/02/04 15:49:47 CET [2016/02/04 9:49:47 ET]
Table 'Arneb II' 9-max Seat #9 is the button
Seat 1: matiko09 ($102.88 in chips) 
Seat 3: brille-390 ($146.52 in chips) 
Seat 4: Venomous100% ($100 in chips) 
Seat 5: lumen21 ($101.50 in chips) 
Seat 6: volwebni4ek ($75.95 in chips) 
Seat 7: melitakas ($279.44 in chips) 
Seat 8: xxxZeka ($101.50 in chips) 
Seat 9: tipner ($197.45 in chips) 
matiko09: posts small blind $0.50
brille-390: posts big blind $1
*** HOLE CARDS ***
Dealt to matiko09 [7h Kh]
I The King I joins the table at seat #2 
I The King I leaves the table
Venomous100%: folds 
lumen21: folds 
Rafaello18 joins the table at seat #2 
Rafaello18 leaves the table
volwebni4ek: folds 
melitakas: folds 
xxxZeka: folds 
Düss2411 joins the table at seat #2 
tipner: raises $1.50 to $2.50
matiko09: folds 
brille-390: folds 
Uncalled bet ($1.50) returned to tipner
tipner collected $2.50 from pot
tipner: doesn't show hand 
*** SUMMARY ***
Total pot $2.50 | Rake $0 
Seat 1: matiko09 (small blind) folded before Flop
Seat 3: brille-390 (big blind) folded before Flop
Seat 4: Venomous100% folded before Flop (didn't bet)
Seat 5: lumen21 folded before Flop (didn't bet)
Seat 6: volwebni4ek folded before Flop (didn't bet)
Seat 7: melitakas folded before Flop (didn't bet)
Seat 8: xxxZeka folded before Flop (didn't bet)
Seat 9: tipner (button) collected ($2.50)





PokerStars Hand #148220493979:  Hold'em No Limit ($0.50/$1.00 USD) - 2016/02/04 15:49:54 CET [2016/02/04 9:49:54 ET]
Table 'Isara' 9-max Seat #4 is the button
Seat 2: davianvalek ($128.23 in chips) 
Seat 3: Monsthand ($106 in chips) 
Seat 4: Dante63s ($109.99 in chips) 
Seat 5: Igor DoUrden ($106.35 in chips) 
Seat 6: Rafaello18 ($156.05 in chips) 
Seat 7: warney1976 ($92.18 in chips) 
Seat 8: matiko09 ($115.17 in chips) 
Seat 9: chauyeuba ($60.14 in chips) 
Igor DoUrden: posts small blind $0.50
Rafaello18: posts big blind $1
Sweden_Pound: sits out 
*** HOLE CARDS ***
Dealt to matiko09 [8s 4s]
warney1976: folds 
matiko09: folds 
chauyeuba: folds 
davianvalek: folds 
Monsthand: folds 
Dante63s: folds 
Igor DoUrden: folds 
Uncalled bet ($0.50) returned to Rafaello18
Rafaello18 collected $1 from pot
Rafaello18: doesn't show hand 
*** SUMMARY ***
Total pot $1 | Rake $0 
Seat 2: davianvalek folded before Flop (didn't bet)
Seat 3: Monsthand folded before Flop (didn't bet)
Seat 4: Dante63s (button) folded before Flop (didn't bet)
Seat 5: Igor DoUrden (small blind) folded before Flop
Seat 6: Rafaello18 (big blind) collected ($1)
Seat 7: warney1976 folded before Flop (didn't bet)
Seat 8: matiko09 folded before Flop (didn't bet)
Seat 9: chauyeuba folded before Flop (didn't bet)





PokerStars Hand #148220494981:  Hold'em No Limit ($0.50/$1.00 USD) - 2016/02/04 15:49:55 CET [2016/02/04 9:49:55 ET]
Table 'Helio III' 9-max Seat #9 is the button
Seat 1: MagicKid777 ($97.68 in chips) 
Seat 2: mycka86 ($103.50 in chips) 
Seat 3: RICKA16 ($101.81 in chips) 
Seat 5: Rafaello18 ($124.90 in chips) 
Seat 6: I The King I ($142.63 in chips) 
Seat 7: matiko09 ($105.14 in chips) 
Seat 8: Sweden_Pound ($100 in chips) 
Seat 9: pandalapa ($110.99 in chips) 
MagicKid777: posts small blind $0.50
mycka86: posts big blind $1
RSBoris: sits out 
*** HOLE CARDS ***
Dealt to matiko09 [7d 2c]
RICKA16: folds 
Rafaello18: folds 
I The King I: folds 
matiko09: folds 
Sweden_Pound: folds 
pandalapa: raises $1 to $2
MagicKid777: folds 
mycka86: calls $1
*** FLOP *** [Ks 6s Qh]
mycka86: checks 
pandalapa: bets $3.22
mycka86: folds 
Uncalled bet ($3.22) returned to pandalapa
pandalapa collected $4.30 from pot
pandalapa: doesn't show hand 
*** SUMMARY ***
Total pot $4.50 | Rake $0.20 
Board [Ks 6s Qh]
Seat 1: MagicKid777 (small blind) folded before Flop
Seat 2: mycka86 (big blind) folded on the Flop
Seat 3: RICKA16 folded before Flop (didn't bet)
Seat 5: Rafaello18 folded before Flop (didn't bet)
Seat 6: I The King I folded before Flop (didn't bet)
Seat 7: matiko09 folded before Flop (didn't bet)
Seat 8: Sweden_Pound folded before Flop (didn't bet)
Seat 9: pandalapa (button) collected ($4.30)





PokerStars Hand #148220498463:  Hold'em No Limit ($0.50/$1.00 USD) - 2016/02/04 15:50:00 CET [2016/02/04 9:50:00 ET]
Table 'Arneb III' 9-max Seat #6 is the button
Seat 2: JeanLima93 ($323.19 in chips) 
Seat 3: matiko09 ($100 in chips) 
Seat 4: Igor DoUrden ($249.53 in chips) 
Seat 5: tipner ($133.52 in chips) 
Seat 6: lumen21 ($100 in chips) 
Seat 7: xxxZeka ($111.56 in chips) 
Seat 8: volwebni4ek ($40 in chips) 
Seat 9: ARTVOR640 ($114.17 in chips) 
xxxZeka: posts small blind $0.50
volwebni4ek: posts big blind $1
Kukuryzka: sits out 
*** HOLE CARDS ***
Dealt to matiko09 [7c Jd]
ARTVOR640: folds 
JeanLima93: folds 
matiko09: folds 
Igor DoUrden: folds 
tipner: folds 
lumen21: raises $1.25 to $2.25
xxxZeka: folds 
volwebni4ek: calls $1.25
*** FLOP *** [Th 2h 8h]
volwebni4ek: checks 
lumen21: bets $3.58
volwebni4ek: calls $3.58
*** TURN *** [Th 2h 8h] [Ad]
volwebni4ek: checks 
lumen21: checks 
*** RIVER *** [Th 2h 8h Ad] [Tc]
volwebni4ek: checks 
lumen21: checks 
*** SHOW DOWN ***
volwebni4ek: shows [Jh Qd] (a pair of Tens)
lumen21: shows [Td Kc] (three of a kind, Tens)
lumen21 collected $11.61 from pot
*** SUMMARY ***
Total pot $12.16 | Rake $0.55 
Board [Th 2h 8h Ad Tc]
Seat 2: JeanLima93 folded before Flop (didn't bet)
Seat 3: matiko09 folded before Flop (didn't bet)
Seat 4: Igor DoUrden folded before Flop (didn't bet)
Seat 5: tipner folded before Flop (didn't bet)
Seat 6: lumen21 (button) showed [Td Kc] and won ($11.61) with three of a kind, Tens
Seat 7: xxxZeka (small blind) folded before Flop
Seat 8: volwebni4ek (big blind) showed [Jh Qd] and lost with a pair of Tens
Seat 9: ARTVOR640 folded before Flop (didn't bet)





PokerStars Hand #148220499583:  Hold'em No Limit ($0.50/$1.00 USD) - 2016/02/04 15:50:02 CET [2016/02/04 9:50:02 ET]
Table 'Dejan' 9-max Seat #4 is the button
Seat 1: matiko09 ($104 in chips) 
Seat 2: xxxZeka ($100.25 in chips) 
Seat 3: lumen21 ($100 in chips) 
Seat 4: pruxa72 ($122.53 in chips) 
Seat 5: Rafaello18 ($118.84 in chips) 
Seat 6: KLOP06031987 ($100 in chips) 
Seat 8: s26s ($160.69 in chips) 
Seat 9: I The King I ($100 in chips) 
Rafaello18: posts small blind $0.50
KLOP06031987: posts big blind $1
mycka86: sits out 
*** HOLE CARDS ***
Dealt to matiko09 [8d 4s]
s26s: folds 
I The King I: folds 
matiko09: folds 
xxxZeka: folds 
lumen21: raises $1.50 to $2.50
pruxa72: calls $2.50
Rafaello18: folds 
KLOP06031987: raises $9.50 to $12
lumen21: folds 
pruxa72: calls $9.50
*** FLOP *** [5h 6d 3d]
KLOP06031987: checks 
pruxa72: checks 
*** TURN *** [5h 6d 3d] [2c]
KLOP06031987: checks 
pruxa72: bets $25.78
KLOP06031987: folds 
Uncalled bet ($25.78) returned to pruxa72
pruxa72 collected $25.78 from pot
pruxa72: doesn't show hand 
*** SUMMARY ***
Total pot $27 | Rake $1.22 
Board [5h 6d 3d 2c]
Seat 1: matiko09 folded before Flop (didn't bet)
Seat 2: xxxZeka folded before Flop (didn't bet)
Seat 3: lumen21 folded before Flop
Seat 4: pruxa72 (button) collected ($25.78)
Seat 5: Rafaello18 (small blind) folded before Flop
Seat 6: KLOP06031987 (big blind) folded on the Turn
Seat 8: s26s folded before Flop (didn't bet)
Seat 9: I The King I folded before Flop (didn't bet)





PokerStars Hand #148220501256:  Hold'em No Limit ($0.50/$1.00 USD) - 2016/02/04 15:50:04 CET [2016/02/04 9:50:04 ET]
Table 'Siarnaq' 9-max Seat #3 is the button
Seat 1: Dante63s ($100 in chips) 
Seat 2: V.Barinov ($98.50 in chips) 
Seat 3: goblind4777 ($134.75 in chips) 
Seat 5: I The King I ($131.87 in chips) 
Seat 6: Monsthand ($100 in chips) 
Seat 7: matiko09 ($114.59 in chips) 
Seat 8: Sweden_Pound ($117.67 in chips) 
Seat 9: MagicKid777 ($98.50 in chips) 
RSBoris will be allowed to play after the button
I The King I: posts small blind $0.50
Monsthand: posts big blind $1
*** HOLE CARDS ***
Dealt to matiko09 [9s 9h]
matiko09: raises $2 to $3
Sweden_Pound: folds 
MagicKid777: folds 
Dante63s: folds 
V.Barinov: folds 
goblind4777: folds 
I The King I: folds 
Monsthand: folds 
Uncalled bet ($2) returned to matiko09
matiko09 collected $2.50 from pot
matiko09: doesn't show hand 
*** SUMMARY ***
Total pot $2.50 | Rake $0 
Seat 1: Dante63s folded before Flop (didn't bet)
Seat 2: V.Barinov folded before Flop (didn't bet)
Seat 3: goblind4777 (button) folded before Flop (didn't bet)
Seat 5: I The King I (small blind) folded before Flop
Seat 6: Monsthand (big blind) folded before Flop
Seat 7: matiko09 collected ($2.50)
Seat 8: Sweden_Pound folded before Flop (didn't bet)
Seat 9: MagicKid777 folded before Flop (didn't bet)





PokerStars Hand #148220508548:  Hold'em No Limit (€0.50/€1.00 EUR) - 2016/02/04 15:50:14 CET [2016/02/04 9:50:14 ET]
Table 'Roemera II' 9-max Seat #8 is the button
Seat 1: Venomous100% (€100 in chips) 
Seat 2: August518 (€62.57 in chips) 
Seat 3: All in Julio (€75 in chips) 
Seat 4: Kukuryzka (€100 in chips) 
Seat 5: tipner (€100 in chips) 
Seat 6: Dante63s (€100 in chips) 
Seat 7: Sweden_Pound (€102.78 in chips) 
Seat 8: Rafaello18 (€100 in chips) 
Seat 9: matiko09 (€100 in chips) 
matiko09: posts small blind €0.50
Venomous100%: posts big blind €1
*** HOLE CARDS ***
Dealt to matiko09 [Kd 6c]
August518: folds 
All in Julio: folds 
Kukuryzka: folds 
tipner: raises €2 to €3
Dante63s: folds 
Sweden_Pound: raises €6 to €9
Rafaello18: folds 
matiko09: folds 
Venomous100%: folds 
tipner: folds 
Uncalled bet (€6) returned to Sweden_Pound
Sweden_Pound collected €7.50 from pot
Sweden_Pound: doesn't show hand 
*** SUMMARY ***
Total pot €7.50 | Rake €0 
Seat 1: Venomous100% (big blind) folded before Flop
Seat 2: August518 folded before Flop (didn't bet)
Seat 3: All in Julio folded before Flop (didn't bet)
Seat 4: Kukuryzka folded before Flop (didn't bet)
Seat 5: tipner folded before Flop
Seat 6: Dante63s folded before Flop (didn't bet)
Seat 7: Sweden_Pound collected (€7.50)
Seat 8: Rafaello18 (button) folded before Flop (didn't bet)
Seat 9: matiko09 (small blind) folded before Flop





PokerStars Hand #148220509415:  Hold'em No Limit ($0.50/$1.00 USD) - 2016/02/04 15:50:15 CET [2016/02/04 9:50:15 ET]
Table 'Isara' 9-max Seat #5 is the button
Seat 2: davianvalek ($128.23 in chips) 
Seat 3: Monsthand ($106 in chips) 
Seat 4: Dante63s ($109.99 in chips) 
Seat 5: Igor DoUrden ($105.85 in chips) 
Seat 6: Rafaello18 ($156.55 in chips) 
Seat 7: warney1976 ($92.18 in chips) 
Seat 8: matiko09 ($115.17 in chips) 
Seat 9: chauyeuba ($60.14 in chips) 
Rafaello18: posts small blind $0.50
warney1976: posts big blind $1
Sweden_Pound: sits out 
*** HOLE CARDS ***
Dealt to matiko09 [8c 6c]
matiko09: folds 
chauyeuba: folds 
davianvalek: folds 
Monsthand: folds 
Dante63s: folds 
Igor DoUrden: folds 
Rafaello18: folds 
Uncalled bet ($0.50) returned to warney1976
warney1976 collected $1 from pot
*** SUMMARY ***
Total pot $1 | Rake $0 
Seat 2: davianvalek folded before Flop (didn't bet)
Seat 3: Monsthand folded before Flop (didn't bet)
Seat 4: Dante63s folded before Flop (didn't bet)
Seat 5: Igor DoUrden (button) folded before Flop (didn't bet)
Seat 6: Rafaello18 (small blind) folded before Flop
Seat 7: warney1976 (big blind) collected ($1)
Seat 8: matiko09 folded before Flop (didn't bet)
Seat 9: chauyeuba folded before Flop (didn't bet)





PokerStars Hand #148220514707:  Hold'em No Limit ($0.50/$1.00 USD) - 2016/02/04 15:50:22 CET [2016/02/04 9:50:22 ET]
Table 'Siarnaq' 9-max Seat #5 is the button
Seat 1: Dante63s ($100 in chips) 
Seat 2: V.Barinov ($98.50 in chips) 
Seat 3: goblind4777 ($134.75 in chips) 
Seat 5: I The King I ($131.37 in chips) 
Seat 6: Monsthand ($100 in chips) 
Seat 7: matiko09 ($116.09 in chips) 
Seat 8: Sweden_Pound ($117.67 in chips) 
Seat 9: MagicKid777 ($98.50 in chips) 
Monsthand: posts small blind $0.50
matiko09: posts big blind $1
RSBoris: sits out 
*** HOLE CARDS ***
Dealt to matiko09 [6s 2c]
Sweden_Pound: folds 
MagicKid777: folds 
Dante63s: folds 
V.Barinov: folds 
goblind4777: folds 
I The King I: folds 
Monsthand: raises $2 to $3
matiko09: folds 
Uncalled bet ($2) returned to Monsthand
Monsthand collected $2 from pot
*** SUMMARY ***
Total pot $2 | Rake $0 
Seat 1: Dante63s folded before Flop (didn't bet)
Seat 2: V.Barinov folded before Flop (didn't bet)
Seat 3: goblind4777 folded before Flop (didn't bet)
Seat 5: I The King I (button) folded before Flop (didn't bet)
Seat 6: Monsthand (small blind) collected ($2)
Seat 7: matiko09 (big blind) folded before Flop
Seat 8: Sweden_Pound folded before Flop (didn't bet)
Seat 9: MagicKid777 folded before Flop (didn't bet)





PokerStars Hand #148220516456:  Hold'em No Limit ($0.50/$1.00 USD) - 2016/02/04 15:50:24 CET [2016/02/04 9:50:24 ET]
Table 'Gutemberga' 9-max Seat #2 is the button
Seat 2: Rafaello18 ($100 in chips) 
Seat 3: Oligarhs4 ($70.08 in chips) 
Seat 4: ?lupi_AA ($100 in chips) 
Seat 5: Monsthand ($108.82 in chips) 
Seat 6: I The King I ($100 in chips) 
Seat 8: matiko09 ($133.16 in chips) 
Oligarhs4: posts small blind $0.50
?lupi_AA: posts big blind $1
mycka86: sits out 
Galador72: sits out 
RSBoris: sits out 
*** HOLE CARDS ***
Dealt to matiko09 [4s Jh]
Monsthand: folds 
I The King I: folds 
matiko09: folds 
Rafaello18: folds 
Oligarhs4: folds 
Uncalled bet ($0.50) returned to ?lupi_AA
?lupi_AA collected $1 from pot
?lupi_AA: doesn't show hand 
*** SUMMARY ***
Total pot $1 | Rake $0 
Seat 2: Rafaello18 (button) folded before Flop (didn't bet)
Seat 3: Oligarhs4 (small blind) folded before Flop
Seat 4: ?lupi_AA (big blind) collected ($1)
Seat 5: Monsthand folded before Flop (didn't bet)
Seat 6: I The King I folded before Flop (didn't bet)
Seat 8: matiko09 folded before Flop (didn't bet)





PokerStars Hand #148220523537:  Hold'em No Limit ($0.50/$1.00 USD) - 2016/02/04 15:50:34 CET [2016/02/04 9:50:34 ET]
Table 'Mothallah' 9-max Seat #8 is the button
Seat 1: Rafaello18 ($112 in chips) 
Seat 2: davianvalek ($102.70 in chips) 
Seat 3: ozone2003 ($125.93 in chips) 
Seat 4: YOUNG_G70 ($105.38 in chips) 
Seat 5: chaps1988 ($100 in chips) 
Seat 6: I The King I ($128.73 in chips) 
Seat 8: Spid1 ($139.78 in chips) 
Seat 9: matiko09 ($105 in chips) 
matiko09: posts small blind $0.50
Rafaello18: posts big blind $1
Düss2411: sits out 
*** HOLE CARDS ***
Dealt to matiko09 [7h 3d]
davianvalek: folds 
ozone2003: folds 
YOUNG_G70: folds 
chaps1988: folds 
I The King I: folds 
Spid1: folds 
matiko09: folds 
Uncalled bet ($0.50) returned to Rafaello18
Rafaello18 collected $1 from pot
Rafaello18: doesn't show hand 
*** SUMMARY ***
Total pot $1 | Rake $0 
Seat 1: Rafaello18 (big blind) collected ($1)
Seat 2: davianvalek folded before Flop (didn't bet)
Seat 3: ozone2003 folded before Flop (didn't bet)
Seat 4: YOUNG_G70 folded before Flop (didn't bet)
Seat 5: chaps1988 folded before Flop (didn't bet)
Seat 6: I The King I folded before Flop (didn't bet)
Seat 8: Spid1 (button) folded before Flop (didn't bet)
Seat 9: matiko09 (small blind) folded before Flop





PokerStars Hand #148220524221:  Hold'em No Limit ($0.50/$1.00 USD) - 2016/02/04 15:50:35 CET [2016/02/04 9:50:35 ET]
Table 'Arneb II' 9-max Seat #1 is the button
Seat 1: matiko09 ($102.38 in chips) 
Seat 3: brille-390 ($145.52 in chips) 
Seat 4: Venomous100% ($100 in chips) 
Seat 5: lumen21 ($101.50 in chips) 
Seat 6: volwebni4ek ($75.95 in chips) 
Seat 7: melitakas ($279.44 in chips) 
Seat 8: xxxZeka ($101.50 in chips) 
Seat 9: tipner ($198.95 in chips) 
Düss2411 will be allowed to play after the button
brille-390: posts small blind $0.50
Venomous100%: posts big blind $1
*** HOLE CARDS ***
Dealt to matiko09 [8h 8c]
lumen21: folds 
lumen21 leaves the table
Monsthand joins the table at seat #5 
Düss2411 leaves the table
volwebni4ek: raises $2 to $3
melitakas: folds 
xxxZeka: folds 
tipner: folds 
Sweden_Pound joins the table at seat #2 
matiko09: calls $3
brille-390: raises $11 to $14
Venomous100%: folds 
volwebni4ek: folds 
matiko09: folds 
Uncalled bet ($11) returned to brille-390
brille-390 collected $10 from pot
brille-390: doesn't show hand 
*** SUMMARY ***
Total pot $10 | Rake $0 
Seat 1: matiko09 (button) folded before Flop
Seat 3: brille-390 (small blind) collected ($10)
Seat 4: Venomous100% (big blind) folded before Flop
Seat 5: lumen21 folded before Flop (didn't bet)
Seat 6: volwebni4ek folded before Flop
Seat 7: melitakas folded before Flop (didn't bet)
Seat 8: xxxZeka folded before Flop (didn't bet)
Seat 9: tipner folded before Flop (didn't bet)





PokerStars Hand #148220525056:  Hold'em No Limit ($0.50/$1.00 USD) - 2016/02/04 15:50:36 CET [2016/02/04 9:50:36 ET]
Table 'Avior II' 9-max Seat #4 is the button
Seat 1: I The King I ($100 in chips) 
Seat 2: matiko09 ($102.53 in chips) 
Seat 4: maxxmeister ($113.56 in chips) 
Seat 5: chaps1988 ($177.98 in chips) 
Seat 8: RSBoris ($52.50 in chips) 
chaps1988: posts small blind $0.50
tipner: is sitting out 
Monsthand: is sitting out 
RSBoris: posts big blind $1
Sweden_Pound: sits out 
Galador72: sits out 
*** HOLE CARDS ***
Dealt to matiko09 [5c Th]
I The King I: folds 
Monsthand leaves the table
tipner leaves the table
Düss2411 joins the table at seat #6 
matiko09: folds 
maxxmeister: folds 
chaps1988: folds 
Uncalled bet ($0.50) returned to RSBoris
Düss2411 leaves the table
RSBoris collected $1 from pot
RSBoris: doesn't show hand 
*** SUMMARY ***
Total pot $1 | Rake $0 
Seat 1: I The King I folded before Flop (didn't bet)
Seat 2: matiko09 folded before Flop (didn't bet)
Seat 4: maxxmeister (button) folded before Flop (didn't bet)
Seat 5: chaps1988 (small blind) folded before Flop
Seat 8: RSBoris (big blind) collected ($1)





PokerStars Hand #148220526439:  Hold'em No Limit ($0.50/$1.00 USD) - 2016/02/04 15:50:38 CET [2016/02/04 9:50:38 ET]
Table 'Helio III' 9-max Seat #1 is the button
Seat 1: MagicKid777 ($97.18 in chips) 
Seat 2: mycka86 ($101.50 in chips) 
Seat 4: RSBoris ($50.12 in chips) 
Seat 5: Rafaello18 ($124.90 in chips) 
Seat 6: I The King I ($142.63 in chips) 
Seat 7: matiko09 ($105.14 in chips) 
Seat 8: Sweden_Pound ($100 in chips) 
Seat 9: pandalapa ($113.29 in chips) 
mycka86: posts small blind $0.50
RICKA16: is sitting out 
RSBoris: posts big blind $1
*** HOLE CARDS ***
Dealt to matiko09 [9h 3c]
Rafaello18: folds 
RICKA16 leaves the table
Düss2411 joins the table at seat #3 
I The King I: raises $2 to $3
matiko09: folds 
Sweden_Pound: folds 
pandalapa: folds 
MagicKid777: folds 
mycka86: folds 
RSBoris: folds 
Uncalled bet ($2) returned to I The King I
I The King I collected $2.50 from pot
I The King I: doesn't show hand 
*** SUMMARY ***
Total pot $2.50 | Rake $0 
Seat 1: MagicKid777 (button) folded before Flop (didn't bet)
Seat 2: mycka86 (small blind) folded before Flop
Seat 4: RSBoris (big blind) folded before Flop
Seat 5: Rafaello18 folded before Flop (didn't bet)
Seat 6: I The King I collected ($2.50)
Seat 7: matiko09 folded before Flop (didn't bet)
Seat 8: Sweden_Pound folded before Flop (didn't bet)
Seat 9: pandalapa folded before Flop (didn't bet)





PokerStars Hand #148220526279:  Hold'em No Limit ($0.50/$1.00 USD) - 2016/02/04 15:50:38 CET [2016/02/04 9:50:38 ET]
Table 'Gutemberga' 9-max Seat #3 is the button
Seat 2: Rafaello18 ($100 in chips) 
Seat 3: Oligarhs4 ($69.58 in chips) 
Seat 4: ?lupi_AA ($100.50 in chips) 
Seat 5: Monsthand ($108.82 in chips) 
Seat 6: I The King I ($100 in chips) 
Seat 8: matiko09 ($133.16 in chips) 
?lupi_AA: posts small blind $0.50
Monsthand: posts big blind $1
mycka86: sits out 
Galador72: sits out 
RSBoris: sits out 
*** HOLE CARDS ***
Dealt to matiko09 [9c 2h]
I The King I: folds 
matiko09: folds 
Rafaello18: folds 
Oligarhs4: raises $2 to $3
?lupi_AA: calls $2.50
Monsthand: calls $2
*** FLOP *** [9h Ac 9s]
?lupi_AA: checks 
Monsthand: checks 
Oligarhs4: checks 
*** TURN *** [9h Ac 9s] [5s]
?lupi_AA: bets $4.21
Monsthand: calls $4.21
Oligarhs4: calls $4.21
*** RIVER *** [9h Ac 9s 5s] [Ah]
?lupi_AA: bets $93.29 and is all-in
Monsthand: calls $93.29
Oligarhs4: folds 
*** SHOW DOWN ***
?lupi_AA: shows [3c As] (a full house, Aces full of Nines)
Monsthand: shows [3d Ad] (a full house, Aces full of Nines)
?lupi_AA collected $102.71 from pot
Monsthand collected $102.70 from pot
*** SUMMARY ***
Total pot $208.21 | Rake $2.80 
Board [9h Ac 9s 5s Ah]
Seat 2: Rafaello18 folded before Flop (didn't bet)
Seat 3: Oligarhs4 (button) folded on the River
Seat 4: ?lupi_AA (small blind) showed [3c As] and won ($102.71) with a full house, Aces full of Nines
Seat 5: Monsthand (big blind) showed [3d Ad] and won ($102.70) with a full house, Aces full of Nines
Seat 6: I The King I folded before Flop (didn't bet)
Seat 8: matiko09 folded before Flop (didn't bet)





PokerStars Hand #148220533651:  Hold'em No Limit ($0.50/$1.00 USD) - 2016/02/04 15:50:48 CET [2016/02/04 9:50:48 ET]
Table 'Amelia II' 9-max Seat #1 is the button
Seat 1: matiko09 ($100 in chips) 
Seat 2: WYY790125 ($107.54 in chips) 
Seat 3: Dante63s ($196.90 in chips) 
Seat 4: Monsthand ($123.61 in chips) 
Seat 5: maxxmeister ($253.40 in chips) 
Seat 6: tipner ($119.33 in chips) 
Seat 7: Spid1 ($192.77 in chips) 
Seat 8: Sweden_Pound ($250 in chips) 
WYY790125: posts small blind $0.50
Dante63s: posts big blind $1
Cikadejooo is connected 
Cikadejooo: sits out 
matiko09: posts the ante $0.20
WYY790125: posts the ante $0.20
Dante63s: posts the ante $0.20
Monsthand: posts the ante $0.20
maxxmeister: posts the ante $0.20
tipner: posts the ante $0.20
Spid1: posts the ante $0.20
Sweden_Pound: posts the ante $0.20
*** HOLE CARDS ***
Dealt to matiko09 [7c Kd]
Monsthand: folds 
maxxmeister: raises $2 to $3
tipner: folds 
Spid1: folds 
Sweden_Pound: calls $3
matiko09: folds 
WYY790125: folds 
Dante63s: folds 
*** FLOP *** [6h 2c Kc]
maxxmeister: checks 
Sweden_Pound: bets $5.65
maxxmeister: calls $5.65
*** TURN *** [6h 2c Kc] [8c]
maxxmeister: checks 
Sweden_Pound: checks 
*** RIVER *** [6h 2c Kc 8c] [5c]
maxxmeister: checks 
Sweden_Pound: checks 
*** SHOW DOWN ***
maxxmeister: shows [8d 8s] (three of a kind, Eights)
Sweden_Pound: mucks hand 
maxxmeister collected $19.48 from pot
*** SUMMARY ***
Total pot $20.40 | Rake $0.92 
Board [6h 2c Kc 8c 5c]
Seat 1: matiko09 (button) folded before Flop (didn't bet)
Seat 2: WYY790125 (small blind) folded before Flop
Seat 3: Dante63s (big blind) folded before Flop
Seat 4: Monsthand folded before Flop (didn't bet)
Seat 5: maxxmeister showed [8d 8s] and won ($19.48) with three of a kind, Eights
Seat 6: tipner folded before Flop (didn't bet)
Seat 7: Spid1 folded before Flop (didn't bet)
Seat 8: Sweden_Pound mucked [As Qd]





PokerStars Hand #148220533763:  Hold'em No Limit ($0.50/$1.00 USD) - 2016/02/04 15:50:48 CET [2016/02/04 9:50:48 ET]
Table 'Siarnaq' 9-max Seat #6 is the button
Seat 1: Dante63s ($100 in chips) 
Seat 2: V.Barinov ($98.50 in chips) 
Seat 3: goblind4777 ($134.75 in chips) 
Seat 5: I The King I ($131.37 in chips) 
Seat 6: Monsthand ($101 in chips) 
Seat 7: matiko09 ($115.09 in chips) 
Seat 8: Sweden_Pound ($117.67 in chips) 
Seat 9: MagicKid777 ($98.50 in chips) 
matiko09: posts small blind $0.50
Sweden_Pound: posts big blind $1
RSBoris: sits out 
*** HOLE CARDS ***
Dealt to matiko09 [8s 4s]
MagicKid777: folds 
Dante63s: folds 
V.Barinov: folds 
goblind4777: folds 
I The King I: folds 
Monsthand: raises $1 to $2
matiko09: folds 
Sweden_Pound: folds 
Uncalled bet ($1) returned to Monsthand
Monsthand collected $2.50 from pot
*** SUMMARY ***
Total pot $2.50 | Rake $0 
Seat 1: Dante63s folded before Flop (didn't bet)
Seat 2: V.Barinov folded before Flop (didn't bet)
Seat 3: goblind4777 folded before Flop (didn't bet)
Seat 5: I The King I folded before Flop (didn't bet)
Seat 6: Monsthand (button) collected ($2.50)
Seat 7: matiko09 (small blind) folded before Flop
Seat 8: Sweden_Pound (big blind) folded before Flop
Seat 9: MagicKid777 folded before Flop (didn't bet)





PokerStars Hand #148220540275:  Hold'em No Limit ($0.50/$1.00 USD) - 2016/02/04 15:50:56 CET [2016/02/04 9:50:56 ET]
Table 'Mothallah' 9-max Seat #9 is the button
Seat 1: Rafaello18 ($112.50 in chips) 
Seat 2: davianvalek ($102.70 in chips) 
Seat 3: ozone2003 ($125.93 in chips) 
Seat 4: YOUNG_G70 ($105.38 in chips) 
Seat 5: chaps1988 ($100 in chips) 
Seat 6: I The King I ($128.73 in chips) 
Seat 8: Spid1 ($139.78 in chips) 
Seat 9: matiko09 ($104.50 in chips) 
Rafaello18: posts small blind $0.50
davianvalek: posts big blind $1
Düss2411: sits out 
*** HOLE CARDS ***
Dealt to matiko09 [2c Kc]
ozone2003: folds 
YOUNG_G70: folds 
chaps1988: folds 
I The King I: folds 
Spid1: raises $1.50 to $2.50
matiko09: folds 
Rafaello18: folds 
davianvalek: folds 
Uncalled bet ($1.50) returned to Spid1
Düss2411 leaves the table
Spid1 collected $2.50 from pot
Spid1: doesn't show hand 
*** SUMMARY ***
Total pot $2.50 | Rake $0 
Seat 1: Rafaello18 (small blind) folded before Flop
Seat 2: davianvalek (big blind) folded before Flop
Seat 3: ozone2003 folded before Flop (didn't bet)
Seat 4: YOUNG_G70 folded before Flop (didn't bet)
Seat 5: chaps1988 folded before Flop (didn't bet)
Seat 6: I The King I folded before Flop (didn't bet)
Seat 8: Spid1 collected ($2.50)
Seat 9: matiko09 (button) folded before Flop (didn't bet)





PokerStars Hand #148220541711:  Hold'em No Limit ($0.50/$1.00 USD) - 2016/02/04 15:50:58 CET [2016/02/04 9:50:58 ET]
Table 'Avior II' 9-max Seat #5 is the button
Seat 1: I The King I ($100 in chips) 
Seat 2: matiko09 ($102.53 in chips) 
Seat 4: maxxmeister ($113.56 in chips) 
Seat 5: chaps1988 ($177.48 in chips) 
Seat 8: RSBoris ($53 in chips) 
Seat 9: Sweden_Pound ($222.21 in chips) 
RSBoris: posts small blind $0.50
Sweden_Pound: posts big blind $1
Galador72: sits out 
*** HOLE CARDS ***
Dealt to matiko09 [9s 6d]
gabi_igna joins the table at seat #6 
I The King I: folds 
matiko09: folds 
maxxmeister: raises $2 to $3
chaps1988: folds 
RSBoris: folds 
Sweden_Pound: folds 
Uncalled bet ($2) returned to maxxmeister
maxxmeister collected $2.50 from pot
maxxmeister: doesn't show hand 
*** SUMMARY ***
Total pot $2.50 | Rake $0 
Seat 1: I The King I folded before Flop (didn't bet)
Seat 2: matiko09 folded before Flop (didn't bet)
Seat 4: maxxmeister collected ($2.50)
Seat 5: chaps1988 (button) folded before Flop (didn't bet)
Seat 8: RSBoris (small blind) folded before Flop
Seat 9: Sweden_Pound (big blind) folded before Flop





PokerStars Hand #148220541328:  Hold'em No Limit (€0.50/€1.00 EUR) - 2016/02/04 15:50:58 CET [2016/02/04 9:50:58 ET]
Table 'Roemera II' 9-max Seat #9 is the button
Seat 1: Venomous100% (€100 in chips) 
Seat 2: August518 (€62.57 in chips) 
Seat 3: All in Julio (€75 in chips) 
Seat 4: Kukuryzka (€100 in chips) 
Seat 5: tipner (€100 in chips) 
Seat 6: Dante63s (€100 in chips) 
Seat 7: Sweden_Pound (€107.28 in chips) 
Seat 8: Rafaello18 (€100 in chips) 
Seat 9: matiko09 (€100 in chips) 
Venomous100%: posts small blind €0.50
August518: posts big blind €1
*** HOLE CARDS ***
Dealt to matiko09 [9d Kc]
All in Julio: folds 
Kukuryzka: folds 
tipner: folds 
Dante63s: folds 
Sweden_Pound: folds 
Rafaello18: folds 
matiko09: raises €1.27 to €2.27
Venomous100%: folds 
August518: folds 
Uncalled bet (€1.27) returned to matiko09
matiko09 collected €2.50 from pot
matiko09: doesn't show hand 
*** SUMMARY ***
Total pot €2.50 | Rake €0 
Seat 1: Venomous100% (small blind) folded before Flop
Seat 2: August518 (big blind) folded before Flop
Seat 3: All in Julio folded before Flop (didn't bet)
Seat 4: Kukuryzka folded before Flop (didn't bet)
Seat 5: tipner folded before Flop (didn't bet)
Seat 6: Dante63s folded before Flop (didn't bet)
Seat 7: Sweden_Pound folded before Flop (didn't bet)
Seat 8: Rafaello18 folded before Flop (didn't bet)
Seat 9: matiko09 (button) collected (€2.50)





PokerStars Hand #148220541254:  Hold'em No Limit ($0.50/$1.00 USD) - 2016/02/04 15:50:58 CET [2016/02/04 9:50:58 ET]
Table 'Isara' 9-max Seat #6 is the button
Seat 2: davianvalek ($128.23 in chips) 
Seat 3: Monsthand ($106 in chips) 
Seat 4: Dante63s ($109.99 in chips) 
Seat 5: Igor DoUrden ($105.85 in chips) 
Seat 6: Rafaello18 ($156.05 in chips) 
Seat 7: warney1976 ($92.68 in chips) 
Seat 8: matiko09 ($115.17 in chips) 
Seat 9: chauyeuba ($60.14 in chips) 
warney1976: posts small blind $0.50
matiko09: posts big blind $1
Sweden_Pound: sits out 
*** HOLE CARDS ***
Dealt to matiko09 [7c 4c]
chauyeuba: raises $2 to $3
davianvalek: folds 
Monsthand: folds 
Dante63s: folds 
Igor DoUrden: folds 
Rafaello18: folds 
warney1976: calls $2.50
matiko09: folds 
*** FLOP *** [8d Kh 6c]
warney1976: checks 
chauyeuba: bets $3.34
warney1976: folds 
Uncalled bet ($3.34) returned to chauyeuba
chauyeuba collected $6.68 from pot
chauyeuba: doesn't show hand 
*** SUMMARY ***
Total pot $7 | Rake $0.32 
Board [8d Kh 6c]
Seat 2: davianvalek folded before Flop (didn't bet)
Seat 3: Monsthand folded before Flop (didn't bet)
Seat 4: Dante63s folded before Flop (didn't bet)
Seat 5: Igor DoUrden folded before Flop (didn't bet)
Seat 6: Rafaello18 (button) folded before Flop (didn't bet)
Seat 7: warney1976 (small blind) folded on the Flop
Seat 8: matiko09 (big blind) folded before Flop
Seat 9: chauyeuba collected ($6.68)





PokerStars Hand #148220545551:  Hold'em No Limit ($0.50/$1.00 USD) - 2016/02/04 15:51:04 CET [2016/02/04 9:51:04 ET]
Table 'Dejan' 9-max Seat #5 is the button
Seat 1: matiko09 ($104 in chips) 
Seat 2: xxxZeka ($100.25 in chips) 
Seat 3: lumen21 ($100 in chips) 
Seat 4: pruxa72 ($136.31 in chips) 
Seat 5: Rafaello18 ($118.34 in chips) 
Seat 6: KLOP06031987 ($100 in chips) 
Seat 7: mycka86 ($117.13 in chips) 
Seat 8: s26s ($160.69 in chips) 
Seat 9: I The King I ($100 in chips) 
KLOP06031987: posts small blind $0.50
mycka86: posts big blind $1
*** HOLE CARDS ***
Dealt to matiko09 [2c 5d]
s26s: folds 
I The King I: folds 
matiko09: folds 
xxxZeka: folds 
lumen21: folds 
pruxa72: raises $2 to $3
Rafaello18: folds 
KLOP06031987: calls $2.50
mycka86: raises $9 to $12
pruxa72: folds 
KLOP06031987: folds 
Uncalled bet ($9) returned to mycka86
mycka86 collected $9 from pot
*** SUMMARY ***
Total pot $9 | Rake $0 
Seat 1: matiko09 folded before Flop (didn't bet)
Seat 2: xxxZeka folded before Flop (didn't bet)
Seat 3: lumen21 folded before Flop (didn't bet)
Seat 4: pruxa72 folded before Flop
Seat 5: Rafaello18 (button) folded before Flop (didn't bet)
Seat 6: KLOP06031987 (small blind) folded before Flop
Seat 7: mycka86 (big blind) collected ($9)
Seat 8: s26s folded before Flop (didn't bet)
Seat 9: I The King I folded before Flop (didn't bet)





PokerStars Hand #148220550749:  Hold'em No Limit ($0.50/$1.00 USD) - 2016/02/04 15:51:11 CET [2016/02/04 9:51:11 ET]
Table 'Helio III' 9-max Seat #2 is the button
Seat 1: MagicKid777 ($97.18 in chips) 
Seat 2: mycka86 ($101 in chips) 
Seat 4: RSBoris ($49.12 in chips) 
Seat 5: Rafaello18 ($124.90 in chips) 
Seat 6: I The King I ($144.13 in chips) 
Seat 7: matiko09 ($105.14 in chips) 
Seat 8: Sweden_Pound ($100 in chips) 
Seat 9: pandalapa ($113.29 in chips) 
Düss2411 will be allowed to play after the button
RSBoris: posts small blind $0.50
Rafaello18: posts big blind $1
*** HOLE CARDS ***
Dealt to matiko09 [9h Jc]
I The King I: folds 
matiko09: folds 
Sweden_Pound: folds 
pandalapa: folds 
MagicKid777: raises $2 to $3
mycka86: folds 
RSBoris: folds 
Rafaello18: folds 
Uncalled bet ($2) returned to MagicKid777
MagicKid777 collected $2.50 from pot
MagicKid777: doesn't show hand 
*** SUMMARY ***
Total pot $2.50 | Rake $0 
Seat 1: MagicKid777 collected ($2.50)
Seat 2: mycka86 (button) folded before Flop (didn't bet)
Seat 4: RSBoris (small blind) folded before Flop
Seat 5: Rafaello18 (big blind) folded before Flop
Seat 6: I The King I folded before Flop (didn't bet)
Seat 7: matiko09 folded before Flop (didn't bet)
Seat 8: Sweden_Pound folded before Flop (didn't bet)
Seat 9: pandalapa folded before Flop (didn't bet)





PokerStars Hand #148220551864:  Hold'em No Limit ($0.50/$1.00 USD) - 2016/02/04 15:51:12 CET [2016/02/04 9:51:12 ET]
Table 'Alkaid II' 9-max Seat #5 is the button
Seat 1: Dante63s ($108.40 in chips) 
Seat 2: Sweden_Pound ($112.98 in chips) 
Seat 4: SumPosad ($39.59 in chips) 
Seat 5: geoffreyjo ($78.34 in chips) 
Seat 6: I The King I ($148.03 in chips) 
Seat 7: Monsthand ($114.13 in chips) 
Seat 8: KLOP06031987 ($112.39 in chips) 
Seat 9: matiko09 ($108.55 in chips) 
I The King I: posts small blind $0.50
Monsthand: posts big blind $1
sebaaastian: sits out 
*** HOLE CARDS ***
Dealt to matiko09 [Qd 3d]
KLOP06031987: folds 
matiko09: folds 
Dante63s: folds 
Sweden_Pound: folds 
SumPosad: folds 
geoffreyjo: folds 
I The King I: folds 
Uncalled bet ($0.50) returned to Monsthand
Monsthand collected $1 from pot
*** SUMMARY ***
Total pot $1 | Rake $0 
Seat 1: Dante63s folded before Flop (didn't bet)
Seat 2: Sweden_Pound folded before Flop (didn't bet)
Seat 4: SumPosad folded before Flop (didn't bet)
Seat 5: geoffreyjo (button) folded before Flop (didn't bet)
Seat 6: I The King I (small blind) folded before Flop
Seat 7: Monsthand (big blind) collected ($1)
Seat 8: KLOP06031987 folded before Flop (didn't bet)
Seat 9: matiko09 folded before Flop (didn't bet)





PokerStars Hand #148220552886:  Hold'em No Limit ($0.50/$1.00 USD) - 2016/02/04 15:51:14 CET [2016/02/04 9:51:14 ET]
Table 'Siarnaq' 9-max Seat #7 is the button
Seat 1: Dante63s ($100 in chips) 
Seat 2: V.Barinov ($98.50 in chips) 
Seat 3: goblind4777 ($134.75 in chips) 
Seat 5: I The King I ($131.37 in chips) 
Seat 6: Monsthand ($102.50 in chips) 
Seat 7: matiko09 ($114.59 in chips) 
Seat 8: Sweden_Pound ($116.67 in chips) 
Seat 9: MagicKid777 ($98.50 in chips) 
Sweden_Pound: posts small blind $0.50
MagicKid777: posts big blind $1
RSBoris: sits out 
*** HOLE CARDS ***
Dealt to matiko09 [9s 2s]
Dante63s: folds 
V.Barinov: folds 
goblind4777: folds 
I The King I: folds 
Monsthand: folds 
matiko09: folds 
Sweden_Pound: raises $2 to $3
MagicKid777: calls $2
*** FLOP *** [7s Ks 5h]
Sweden_Pound: bets $3.72
MagicKid777: folds 
Uncalled bet ($3.72) returned to Sweden_Pound
Sweden_Pound collected $5.73 from pot
Sweden_Pound: doesn't show hand 
*** SUMMARY ***
Total pot $6 | Rake $0.27 
Board [7s Ks 5h]
Seat 1: Dante63s folded before Flop (didn't bet)
Seat 2: V.Barinov folded before Flop (didn't bet)
Seat 3: goblind4777 folded before Flop (didn't bet)
Seat 5: I The King I folded before Flop (didn't bet)
Seat 6: Monsthand folded before Flop (didn't bet)
Seat 7: matiko09 (button) folded before Flop (didn't bet)
Seat 8: Sweden_Pound (small blind) collected ($5.73)
Seat 9: MagicKid777 (big blind) folded on the Flop





PokerStars Hand #148220560045:  Hold'em No Limit ($0.50/$1.00 USD) - 2016/02/04 15:51:24 CET [2016/02/04 9:51:24 ET]
Table 'Mothallah' 9-max Seat #1 is the button
Seat 1: Rafaello18 ($112 in chips) 
Seat 2: davianvalek ($101.70 in chips) 
Seat 3: ozone2003 ($125.93 in chips) 
Seat 4: YOUNG_G70 ($105.38 in chips) 
Seat 5: chaps1988 ($100 in chips) 
Seat 6: I The King I ($128.73 in chips) 
Seat 8: Spid1 ($141.28 in chips) 
Seat 9: matiko09 ($104.50 in chips) 
davianvalek: posts small blind $0.50
ozone2003: posts big blind $1
*** HOLE CARDS ***
Dealt to matiko09 [5d 6d]
YOUNG_G70: folds 
chaps1988: folds 
I The King I: raises $2 to $3
Spid1: folds 
matiko09: folds 
Rafaello18: folds 
davianvalek: folds 
ozone2003: folds 
Uncalled bet ($2) returned to I The King I
I The King I collected $2.50 from pot
I The King I: doesn't show hand 
*** SUMMARY ***
Total pot $2.50 | Rake $0 
Seat 1: Rafaello18 (button) folded before Flop (didn't bet)
Seat 2: davianvalek (small blind) folded before Flop
Seat 3: ozone2003 (big blind) folded before Flop
Seat 4: YOUNG_G70 folded before Flop (didn't bet)
Seat 5: chaps1988 folded before Flop (didn't bet)
Seat 6: I The King I collected ($2.50)
Seat 8: Spid1 folded before Flop (didn't bet)
Seat 9: matiko09 folded before Flop (didn't bet)





PokerStars Hand #148220575420:  Hold'em No Limit ($0.50/$1.00 USD) - 2016/02/04 15:51:45 CET [2016/02/04 9:51:45 ET]
Table 'Mothallah' 9-max Seat #2 is the button
Seat 1: Rafaello18 ($112 in chips) 
Seat 2: davianvalek ($101.20 in chips) 
Seat 3: ozone2003 ($124.93 in chips) 
Seat 4: YOUNG_G70 ($105.38 in chips) 
Seat 5: chaps1988 ($100 in chips) 
Seat 6: I The King I ($130.23 in chips) 
Seat 8: Spid1 ($141.28 in chips) 
Seat 9: matiko09 ($104.50 in chips) 
ozone2003: posts small blind $0.50
YOUNG_G70: posts big blind $1
*** HOLE CARDS ***
Dealt to matiko09 [Qd 6d]
chaps1988: folds 
I The King I: folds 
Spid1: folds 
matiko09: folds 
KLOP06031987 joins the table at seat #7 
Rafaello18: raises $1.50 to $2.50
davianvalek: calls $2.50
ozone2003: calls $2
YOUNG_G70: folds 
*** FLOP *** [Ts Kd 4s]
ozone2003: checks 
Rafaello18: checks 
davianvalek: checks 
*** TURN *** [Ts Kd 4s] [As]
ozone2003: checks 
Rafaello18: checks 
davianvalek: checks 
*** RIVER *** [Ts Kd 4s As] [Js]
ozone2003: checks 
Rafaello18: checks 
davianvalek: checks 
*** SHOW DOWN ***
ozone2003: shows [Jh Tc] (two pair, Jacks and Tens)
Rafaello18: mucks hand 
davianvalek: mucks hand 
ozone2003 collected $8.12 from pot
*** SUMMARY ***
Total pot $8.50 | Rake $0.38 
Board [Ts Kd 4s As Js]
Seat 1: Rafaello18 mucked [6h Ah]
Seat 2: davianvalek (button) mucked [7c 9c]
Seat 3: ozone2003 (small blind) showed [Jh Tc] and won ($8.12) with two pair, Jacks and Tens
Seat 4: YOUNG_G70 (big blind) folded before Flop
Seat 5: chaps1988 folded before Flop (didn't bet)
Seat 6: I The King I folded before Flop (didn't bet)
Seat 8: Spid1 folded before Flop (didn't bet)
Seat 9: matiko09 folded before Flop (didn't bet)





PokerStars Hand #148220576651:  Hold'em No Limit ($0.50/$1.00 USD) - 2016/02/04 15:51:46 CET [2016/02/04 9:51:46 ET]
Table 'Alkaid II' 9-max Seat #6 is the button
Seat 1: Dante63s ($108.40 in chips) 
Seat 2: Sweden_Pound ($112.98 in chips) 
Seat 4: SumPosad ($39.59 in chips) 
Seat 5: geoffreyjo ($78.34 in chips) 
Seat 6: I The King I ($147.53 in chips) 
Seat 7: Monsthand ($114.63 in chips) 
Seat 8: KLOP06031987 ($112.39 in chips) 
Seat 9: matiko09 ($108.55 in chips) 
Monsthand: posts small blind $0.50
KLOP06031987: posts big blind $1
sebaaastian: sits out 
*** HOLE CARDS ***
Dealt to matiko09 [4d 8c]
matiko09: folds 
Dante63s: folds 
Sweden_Pound: raises $2 to $3
SumPosad: folds 
geoffreyjo: folds 
I The King I: calls $3
Monsthand: folds 
KLOP06031987: folds 
*** FLOP *** [6c Th Kh]
Sweden_Pound: bets $4.65
I The King I: calls $4.65
*** TURN *** [6c Th Kh] [As]
Sweden_Pound: checks 
I The King I: bets $10
Sweden_Pound: folds 
Uncalled bet ($10) returned to I The King I
I The King I collected $16.04 from pot
I The King I: doesn't show hand 
*** SUMMARY ***
Total pot $16.80 | Rake $0.76 
Board [6c Th Kh As]
Seat 1: Dante63s folded before Flop (didn't bet)
Seat 2: Sweden_Pound folded on the Turn
Seat 4: SumPosad folded before Flop (didn't bet)
Seat 5: geoffreyjo folded before Flop (didn't bet)
Seat 6: I The King I (button) collected ($16.04)
Seat 7: Monsthand (small blind) folded before Flop
Seat 8: KLOP06031987 (big blind) folded before Flop
Seat 9: matiko09 folded before Flop (didn't bet)





PokerStars Hand #148220576873:  Hold'em No Limit (€0.50/€1.00 EUR) - 2016/02/04 15:51:47 CET [2016/02/04 9:51:47 ET]
Table 'Roemera II' 9-max Seat #1 is the button
Seat 1: Venomous100% (€100 in chips) 
Seat 2: August518 (€61.57 in chips) 
Seat 3: All in Julio (€75 in chips) 
Seat 4: Kukuryzka (€100 in chips) 
Seat 5: tipner (€100 in chips) 
Seat 6: Dante63s (€100 in chips) 
Seat 7: Sweden_Pound (€107.28 in chips) 
Seat 8: Rafaello18 (€100 in chips) 
Seat 9: matiko09 (€101.50 in chips) 
August518: posts small blind €0.50
All in Julio: posts big blind €1
*** HOLE CARDS ***
Dealt to matiko09 [3d 2h]
Kukuryzka: folds 
tipner: folds 
Dante63s: raises €2 to €3
Sweden_Pound: calls €3
Rafaello18: folds 
matiko09: folds 
Venomous100%: folds 
August518: folds 
All in Julio: folds 
*** FLOP *** [Js 4h 6d]
Dante63s: checks 
Sweden_Pound: bets €4.65
Dante63s: folds 
Uncalled bet (€4.65) returned to Sweden_Pound
Sweden_Pound collected €7.16 from pot
Sweden_Pound: doesn't show hand 
*** SUMMARY ***
Total pot €7.50 | Rake €0.34 
Board [Js 4h 6d]
Seat 1: Venomous100% (button) folded before Flop (didn't bet)
Seat 2: August518 (small blind) folded before Flop
Seat 3: All in Julio (big blind) folded before Flop
Seat 4: Kukuryzka folded before Flop (didn't bet)
Seat 5: tipner folded before Flop (didn't bet)
Seat 6: Dante63s folded on the Flop
Seat 7: Sweden_Pound collected (€7.16)
Seat 8: Rafaello18 folded before Flop (didn't bet)
Seat 9: matiko09 folded before Flop (didn't bet)





PokerStars Hand #148220576913:  Hold'em No Limit ($0.50/$1.00 USD) - 2016/02/04 15:51:47 CET [2016/02/04 9:51:47 ET]
Table 'Helio III' 9-max Seat #4 is the button
Seat 1: MagicKid777 ($98.68 in chips) 
Seat 2: mycka86 ($101 in chips) 
Seat 4: RSBoris ($48.62 in chips) 
Seat 5: Rafaello18 ($123.90 in chips) 
Seat 6: I The King I ($144.13 in chips) 
Seat 7: matiko09 ($105.14 in chips) 
Seat 8: Sweden_Pound ($100 in chips) 
Seat 9: pandalapa ($113.29 in chips) 
Rafaello18: posts small blind $0.50
I The King I: posts big blind $1
Düss2411: sits out 
*** HOLE CARDS ***
Dealt to matiko09 [Qh 7c]
matiko09: folds 
Sweden_Pound: folds 
pandalapa: folds 
MagicKid777: folds 
mycka86: raises $1.10 to $2.10
RSBoris: folds 
Rafaello18: folds 
I The King I: folds 
Uncalled bet ($1.10) returned to mycka86
mycka86 collected $2.50 from pot
*** SUMMARY ***
Total pot $2.50 | Rake $0 
Seat 1: MagicKid777 folded before Flop (didn't bet)
Seat 2: mycka86 collected ($2.50)
Seat 4: RSBoris (button) folded before Flop (didn't bet)
Seat 5: Rafaello18 (small blind) folded before Flop
Seat 6: I The King I (big blind) folded before Flop
Seat 7: matiko09 folded before Flop (didn't bet)
Seat 8: Sweden_Pound folded before Flop (didn't bet)
Seat 9: pandalapa folded before Flop (didn't bet)





PokerStars Hand #148220579114:  Hold'em No Limit ($0.50/$1.00 USD) - 2016/02/04 15:51:50 CET [2016/02/04 9:51:50 ET]
Table 'Siarnaq' 9-max Seat #8 is the button
Seat 1: Dante63s ($100 in chips) 
Seat 2: V.Barinov ($98.50 in chips) 
Seat 3: goblind4777 ($134.75 in chips) 
Seat 5: I The King I ($131.37 in chips) 
Seat 6: Monsthand ($102.50 in chips) 
Seat 7: matiko09 ($114.59 in chips) 
Seat 8: Sweden_Pound ($119.40 in chips) 
Seat 9: MagicKid777 ($95.50 in chips) 
MagicKid777: posts small blind $0.50
Dante63s: posts big blind $1
RSBoris: sits out 
*** HOLE CARDS ***
Dealt to matiko09 [Ks 8s]
V.Barinov: folds 
goblind4777: folds 
I The King I: raises $2 to $3
Monsthand: folds 
matiko09: folds 
Sweden_Pound: folds 
MagicKid777: calls $2.50
Dante63s: folds 
*** FLOP *** [3s 4d 2s]
MagicKid777: checks 
I The King I: bets $4.14
MagicKid777: calls $4.14
*** TURN *** [3s 4d 2s] [9d]
MagicKid777: checks 
I The King I: bets $10
MagicKid777: calls $10
*** RIVER *** [3s 4d 2s 9d] [Jh]
MagicKid777: checks 
I The King I: checks 
*** SHOW DOWN ***
MagicKid777: shows [6d 5d] (a straight, Deuce to Six)
I The King I: mucks hand 
MagicKid777 collected $33.69 from pot
*** SUMMARY ***
Total pot $35.28 | Rake $1.59 
Board [3s 4d 2s 9d Jh]
Seat 1: Dante63s (big blind) folded before Flop
Seat 2: V.Barinov folded before Flop (didn't bet)
Seat 3: goblind4777 folded before Flop (didn't bet)
Seat 5: I The King I mucked [As Kc]
Seat 6: Monsthand folded before Flop (didn't bet)
Seat 7: matiko09 folded before Flop (didn't bet)
Seat 8: Sweden_Pound (button) folded before Flop (didn't bet)
Seat 9: MagicKid777 (small blind) showed [6d 5d] and won ($33.69) with a straight, Deuce to Six





PokerStars Hand #148220582025:  Hold'em No Limit ($0.50/$1.00 USD) - 2016/02/04 15:51:54 CET [2016/02/04 9:51:54 ET]
Table 'Gutemberga' 9-max Seat #4 is the button
Seat 2: Rafaello18 ($100 in chips) 
Seat 3: Oligarhs4 ($62.37 in chips) 
Seat 4: ?lupi_AA ($102.71 in chips) 
Seat 5: Monsthand ($111.02 in chips) 
Seat 6: I The King I ($100 in chips) 
Seat 8: matiko09 ($133.16 in chips) 
Monsthand: posts small blind $0.50
I The King I: posts big blind $1
mycka86: sits out 
Galador72: sits out 
RSBoris: sits out 
*** HOLE CARDS ***
Dealt to matiko09 [3c 3d]
Monsthand said, "super push"
matiko09: folds 
Rafaello18: folds 
Oligarhs4: folds 
?lupi_AA: folds 
Monsthand: folds 
Uncalled bet ($0.50) returned to I The King I
I The King I collected $1 from pot
I The King I: doesn't show hand 
*** SUMMARY ***
Total pot $1 | Rake $0 
Seat 2: Rafaello18 folded before Flop (didn't bet)
Seat 3: Oligarhs4 folded before Flop (didn't bet)
Seat 4: ?lupi_AA (button) folded before Flop (didn't bet)
Seat 5: Monsthand (small blind) folded before Flop
Seat 6: I The King I (big blind) collected ($1)
Seat 8: matiko09 folded before Flop (didn't bet)





PokerStars Hand #148220586220:  Hold'em No Limit ($0.50/$1.00 USD) - 2016/02/04 15:51:59 CET [2016/02/04 9:51:59 ET]
Table 'Dejan' 9-max Seat #6 is the button
Seat 1: matiko09 ($104 in chips) 
Seat 2: xxxZeka ($100.25 in chips) 
Seat 3: lumen21 ($100 in chips) 
Seat 4: pruxa72 ($133.31 in chips) 
Seat 5: Rafaello18 ($118.34 in chips) 
Seat 6: KLOP06031987 ($100 in chips) 
Seat 7: mycka86 ($123.13 in chips) 
Seat 8: s26s ($160.69 in chips) 
Seat 9: I The King I ($100 in chips) 
mycka86: posts small blind $0.50
s26s: posts big blind $1
*** HOLE CARDS ***
Dealt to matiko09 [Jh 2h]
I The King I: folds 
matiko09: folds 
xxxZeka: folds 
lumen21: folds 
pruxa72: raises $3 to $4
Rafaello18: folds 
KLOP06031987: calls $4
mycka86: folds 
s26s: calls $3
*** FLOP *** [5h 8d 7d]
s26s: checks 
pruxa72: checks 
KLOP06031987: bets $9
s26s: folds 
pruxa72: folds 
Uncalled bet ($9) returned to KLOP06031987
KLOP06031987 collected $11.94 from pot
KLOP06031987: doesn't show hand 
*** SUMMARY ***
Total pot $12.50 | Rake $0.56 
Board [5h 8d 7d]
Seat 1: matiko09 folded before Flop (didn't bet)
Seat 2: xxxZeka folded before Flop (didn't bet)
Seat 3: lumen21 folded before Flop (didn't bet)
Seat 4: pruxa72 folded on the Flop
Seat 5: Rafaello18 folded before Flop (didn't bet)
Seat 6: KLOP06031987 (button) collected ($11.94)
Seat 7: mycka86 (small blind) folded before Flop
Seat 8: s26s (big blind) folded on the Flop
Seat 9: I The King I folded before Flop (didn't bet)





PokerStars Hand #148220589470:  Hold'em No Limit ($0.50/$1.00 USD) - 2016/02/04 15:52:04 CET [2016/02/04 9:52:04 ET]
Table 'Arneb II' 9-max Seat #3 is the button
Seat 1: matiko09 ($100 in chips) 
Seat 3: brille-390 ($152.52 in chips) 
Seat 4: Venomous100% ($100 in chips) 
Seat 5: Monsthand ($100 in chips) 
Seat 6: volwebni4ek ($72.95 in chips) 
Seat 7: melitakas ($279.44 in chips) 
Seat 8: xxxZeka ($101.50 in chips) 
Seat 9: tipner ($198.95 in chips) 
Venomous100%: posts small blind $0.50
Monsthand: posts big blind $1
Sweden_Pound: sits out 
*** HOLE CARDS ***
Dealt to matiko09 [Td 7c]
volwebni4ek: folds 
melitakas: folds 
xxxZeka: folds 
tipner: raises $2 to $3
matiko09: folds 
brille-390: folds 
Venomous100%: folds 
Monsthand: folds 
Uncalled bet ($2) returned to tipner
tipner collected $2.50 from pot
tipner: doesn't show hand 
*** SUMMARY ***
Total pot $2.50 | Rake $0 
Seat 1: matiko09 folded before Flop (didn't bet)
Seat 3: brille-390 (button) folded before Flop (didn't bet)
Seat 4: Venomous100% (small blind) folded before Flop
Seat 5: Monsthand (big blind) folded before Flop
Seat 6: volwebni4ek folded before Flop (didn't bet)
Seat 7: melitakas folded before Flop (didn't bet)
Seat 8: xxxZeka folded before Flop (didn't bet)
Seat 9: tipner collected ($2.50)





PokerStars Hand #148220595921:  Hold'em No Limit ($0.50/$1.00 USD) - 2016/02/04 15:52:12 CET [2016/02/04 9:52:12 ET]
Table 'Arneb III' 9-max Seat #7 is the button
Seat 2: JeanLima93 ($323.19 in chips) 
Seat 3: matiko09 ($100 in chips) 
Seat 4: Igor DoUrden ($249.53 in chips) 
Seat 5: tipner ($133.52 in chips) 
Seat 6: lumen21 ($105.78 in chips) 
Seat 7: xxxZeka ($111.06 in chips) 
Seat 8: volwebni4ek ($40 in chips) 
Seat 9: ARTVOR640 ($114.17 in chips) 
volwebni4ek: posts small blind $0.50
ARTVOR640: posts big blind $1
Kukuryzka: sits out 
*** HOLE CARDS ***
Dealt to matiko09 [Jh 2h]
JeanLima93: calls $1
matiko09: folds 
Igor DoUrden: folds 
tipner: raises $3 to $4
lumen21: folds 
xxxZeka: calls $4
volwebni4ek: folds 
ARTVOR640: folds 
JeanLima93: folds 
*** FLOP *** [9d Ks Qd]
tipner: checks 
xxxZeka: checks 
*** TURN *** [9d Ks Qd] [5d]
tipner: checks 
xxxZeka: bets $6
tipner: folds 
Uncalled bet ($6) returned to xxxZeka
xxxZeka collected $10.03 from pot
*** SUMMARY ***
Total pot $10.50 | Rake $0.47 
Board [9d Ks Qd 5d]
Seat 2: JeanLima93 folded before Flop
Seat 3: matiko09 folded before Flop (didn't bet)
Seat 4: Igor DoUrden folded before Flop (didn't bet)
Seat 5: tipner folded on the Turn
Seat 6: lumen21 folded before Flop (didn't bet)
Seat 7: xxxZeka (button) collected ($10.03)
Seat 8: volwebni4ek (small blind) folded before Flop
Seat 9: ARTVOR640 (big blind) folded before Flop





PokerStars Hand #148220598974:  Hold'em No Limit ($0.50/$1.00 USD) - 2016/02/04 15:52:17 CET [2016/02/04 9:52:17 ET]
Table 'Isara' 9-max Seat #7 is the button
Seat 2: davianvalek ($128.23 in chips) 
Seat 3: Monsthand ($106 in chips) 
Seat 4: Dante63s ($109.99 in chips) 
Seat 5: Igor DoUrden ($105.85 in chips) 
Seat 6: Rafaello18 ($156.05 in chips) 
Seat 7: warney1976 ($89.68 in chips) 
Seat 8: matiko09 ($114.17 in chips) 
Seat 9: chauyeuba ($63.82 in chips) 
matiko09: posts small blind $0.50
chauyeuba: posts big blind $1
Sweden_Pound: sits out 
*** HOLE CARDS ***
Dealt to matiko09 [7c 3d]
davianvalek: folds 
Monsthand: folds 
Dante63s: folds 
Igor DoUrden: raises $1.50 to $2.50
Rafaello18: folds 
warney1976: folds 
matiko09: folds 
chauyeuba: folds 
Uncalled bet ($1.50) returned to Igor DoUrden
Igor DoUrden collected $2.50 from pot
Igor DoUrden: doesn't show hand 
*** SUMMARY ***
Total pot $2.50 | Rake $0 
Seat 2: davianvalek folded before Flop (didn't bet)
Seat 3: Monsthand folded before Flop (didn't bet)
Seat 4: Dante63s folded before Flop (didn't bet)
Seat 5: Igor DoUrden collected ($2.50)
Seat 6: Rafaello18 folded before Flop (didn't bet)
Seat 7: warney1976 (button) folded before Flop (didn't bet)
Seat 8: matiko09 (small blind) folded before Flop
Seat 9: chauyeuba (big blind) folded before Flop





PokerStars Hand #148220599501:  Hold'em No Limit ($0.50/$1.00 USD) - 2016/02/04 15:52:17 CET [2016/02/04 9:52:17 ET]
Table 'Gutemberga' 9-max Seat #5 is the button
Seat 2: Rafaello18 ($100 in chips) 
Seat 3: Oligarhs4 ($62.37 in chips) 
Seat 4: ?lupi_AA ($102.71 in chips) 
Seat 5: Monsthand ($110.52 in chips) 
Seat 6: I The King I ($100.50 in chips) 
Seat 7: mycka86 ($101.89 in chips) 
Seat 8: matiko09 ($133.16 in chips) 
I The King I: posts small blind $0.50
mycka86: posts big blind $1
Galador72: sits out 
RSBoris: sits out 
*** HOLE CARDS ***
Dealt to matiko09 [6d 5s]
matiko09: folds 
Rafaello18: folds 
Oligarhs4: folds 
?lupi_AA: folds 
Monsthand: raises $1 to $2
I The King I: raises $5 to $7
mycka86: folds 
Monsthand: calls $5
*** FLOP *** [9s Td Qc]
I The King I: bets $10
Monsthand: calls $10
*** TURN *** [9s Td Qc] [2h]
I The King I: checks 
Monsthand: checks 
*** RIVER *** [9s Td Qc 2h] [7s]
?lupi_AA said, "n]'/"
I The King I: checks 
Monsthand: bets $14.50
I The King I: raises $42.50 to $57
Monsthand: folds 
Uncalled bet ($42.50) returned to I The King I
I The King I collected $61.20 from pot
I The King I: doesn't show hand 
*** SUMMARY ***
Total pot $64 | Rake $2.80 
Board [9s Td Qc 2h 7s]
Seat 2: Rafaello18 folded before Flop (didn't bet)
Seat 3: Oligarhs4 folded before Flop (didn't bet)
Seat 4: ?lupi_AA folded before Flop (didn't bet)
Seat 5: Monsthand (button) folded on the River
Seat 6: I The King I (small blind) collected ($61.20)
Seat 7: mycka86 (big blind) folded before Flop
Seat 8: matiko09 folded before Flop (didn't bet)





PokerStars Hand #148220604650:  Hold'em No Limit ($0.50/$1.00 USD) - 2016/02/04 15:52:24 CET [2016/02/04 9:52:24 ET]
Table 'Helio III' 9-max Seat #5 is the button
Seat 1: MagicKid777 ($98.68 in chips) 
Seat 2: mycka86 ($102.50 in chips) 
Seat 4: RSBoris ($48.62 in chips) 
Seat 5: Rafaello18 ($123.40 in chips) 
Seat 6: I The King I ($143.13 in chips) 
Seat 7: matiko09 ($105.14 in chips) 
Seat 8: Sweden_Pound ($100 in chips) 
Seat 9: pandalapa ($113.29 in chips) 
I The King I: posts small blind $0.50
matiko09: posts big blind $1
Düss2411: sits out 
*** HOLE CARDS ***
Dealt to matiko09 [Kh 9s]
Sweden_Pound: folds 
pandalapa: folds 
MagicKid777: folds 
mycka86: folds 
RSBoris: folds 
Rafaello18: raises $1.50 to $2.50
I The King I: folds 
matiko09: calls $1.50
*** FLOP *** [2s Qc 4c]
matiko09: checks 
Rafaello18: bets $3.50
matiko09: folds 
Uncalled bet ($3.50) returned to Rafaello18
Rafaello18 collected $5.25 from pot
Rafaello18: doesn't show hand 
*** SUMMARY ***
Total pot $5.50 | Rake $0.25 
Board [2s Qc 4c]
Seat 1: MagicKid777 folded before Flop (didn't bet)
Seat 2: mycka86 folded before Flop (didn't bet)
Seat 4: RSBoris folded before Flop (didn't bet)
Seat 5: Rafaello18 (button) collected ($5.25)
Seat 6: I The King I (small blind) folded before Flop
Seat 7: matiko09 (big blind) folded on the Flop
Seat 8: Sweden_Pound folded before Flop (didn't bet)
Seat 9: pandalapa folded before Flop (didn't bet)





PokerStars Hand #148220607020:  Hold'em No Limit ($0.50/$1.00 USD) - 2016/02/04 15:52:28 CET [2016/02/04 9:52:28 ET]
Table 'Arneb II' 9-max Seat #4 is the button
Seat 1: matiko09 ($100 in chips) 
Seat 3: brille-390 ($152.52 in chips) 
Seat 4: Venomous100% ($100 in chips) 
Seat 5: Monsthand ($100 in chips) 
Seat 7: melitakas ($279.44 in chips) 
Seat 8: xxxZeka ($101.50 in chips) 
Seat 9: tipner ($200.45 in chips) 
Monsthand: posts small blind $0.50
volwebni4ek: is sitting out 
melitakas: posts big blind $1
Sweden_Pound: sits out 
*** HOLE CARDS ***
Dealt to matiko09 [Ah Jc]
xxxZeka: folds 
tipner: folds 
matiko09: raises $2 to $3
brille-390: folds 
Venomous100%: folds 
Monsthand: folds 
melitakas: calls $2
*** FLOP *** [8h 9h 9c]
melitakas: checks 
matiko09: checks 
*** TURN *** [8h 9h 9c] [7h]
melitakas: checks 
matiko09: checks 
*** RIVER *** [8h 9h 9c 7h] [7c]
melitakas: checks 
matiko09: checks 
*** SHOW DOWN ***
melitakas: shows [3h 3d] (two pair, Nines and Sevens)
matiko09: shows [Ah Jc] (two pair, Nines and Sevens - Ace kicker)
matiko09 collected $6.21 from pot
*** SUMMARY ***
Total pot $6.50 | Rake $0.29 
Board [8h 9h 9c 7h 7c]
Seat 1: matiko09 showed [Ah Jc] and won ($6.21) with two pair, Nines and Sevens
Seat 3: brille-390 folded before Flop (didn't bet)
Seat 4: Venomous100% (button) folded before Flop (didn't bet)
Seat 5: Monsthand (small blind) folded before Flop
Seat 7: melitakas (big blind) showed [3h 3d] and lost with two pair, Nines and Sevens
Seat 8: xxxZeka folded before Flop (didn't bet)
Seat 9: tipner folded before Flop (didn't bet)





PokerStars Hand #148220614745:  Hold'em No Limit (€0.50/€1.00 EUR) - 2016/02/04 15:52:38 CET [2016/02/04 9:52:38 ET]
Table 'Roemera II' 9-max Seat #2 is the button
Seat 1: Venomous100% (€100 in chips) 
Seat 2: August518 (€61.07 in chips) 
Seat 3: All in Julio (€74 in chips) 
Seat 4: Kukuryzka (€100 in chips) 
Seat 5: tipner (€100 in chips) 
Seat 6: Dante63s (€100 in chips) 
Seat 7: Sweden_Pound (€111.44 in chips) 
Seat 8: Rafaello18 (€100 in chips) 
Seat 9: matiko09 (€101.50 in chips) 
All in Julio: posts small blind €0.50
Kukuryzka: posts big blind €1
*** HOLE CARDS ***
Dealt to matiko09 [7c Ks]
tipner: folds 
Dante63s: folds 
Sweden_Pound: folds 
Rafaello18: folds 
matiko09: folds 
Venomous100%: raises €1.50 to €2.50
August518: folds 
All in Julio: folds 
Kukuryzka: folds 
Uncalled bet (€1.50) returned to Venomous100%
Venomous100% collected €2.50 from pot
Venomous100%: doesn't show hand 
*** SUMMARY ***
Total pot €2.50 | Rake €0 
Seat 1: Venomous100% collected (€2.50)
Seat 2: August518 (button) folded before Flop (didn't bet)
Seat 3: All in Julio (small blind) folded before Flop
Seat 4: Kukuryzka (big blind) folded before Flop
Seat 5: tipner folded before Flop (didn't bet)
Seat 6: Dante63s folded before Flop (didn't bet)
Seat 7: Sweden_Pound folded before Flop (didn't bet)
Seat 8: Rafaello18 folded before Flop (didn't bet)
Seat 9: matiko09 folded before Flop (didn't bet)





PokerStars Hand #148220619363:  Hold'em No Limit ($0.50/$1.00 USD) - 2016/02/04 15:52:44 CET [2016/02/04 9:52:44 ET]
Table 'Amelia II' 9-max Seat #2 is the button
Seat 1: matiko09 ($100 in chips) 
Seat 2: WYY790125 ($106.84 in chips) 
Seat 3: Dante63s ($195.70 in chips) 
Seat 4: Monsthand ($123.41 in chips) 
Seat 5: maxxmeister ($264.03 in chips) 
Seat 6: tipner ($119.13 in chips) 
Seat 7: Spid1 ($192.57 in chips) 
Seat 8: Sweden_Pound ($250 in chips) 
Seat 9: Cikadejooo ($204.70 in chips) 
Dante63s: posts small blind $0.50
Monsthand: posts big blind $1
Cikadejooo: posts small & big blinds $1.50
matiko09: posts the ante $0.20
WYY790125: posts the ante $0.20
Dante63s: posts the ante $0.20
Monsthand: posts the ante $0.20
maxxmeister: posts the ante $0.20
tipner: posts the ante $0.20
Spid1: posts the ante $0.20
Sweden_Pound: posts the ante $0.20
Cikadejooo: posts the ante $0.20
*** HOLE CARDS ***
Dealt to matiko09 [4d 3c]
maxxmeister: folds 
tipner: folds 
Spid1: folds 
Sweden_Pound: folds 
Cikadejooo: checks 
matiko09: folds 
WYY790125: folds 
Dante63s: raises $3 to $4
Monsthand: folds 
Cikadejooo: folds 
Uncalled bet ($3) returned to Dante63s
Dante63s collected $5.30 from pot
*** SUMMARY ***
Total pot $5.30 | Rake $0 
Seat 1: matiko09 folded before Flop (didn't bet)
Seat 2: WYY790125 (button) folded before Flop (didn't bet)
Seat 3: Dante63s (small blind) collected ($5.30)
Seat 4: Monsthand (big blind) folded before Flop
Seat 5: maxxmeister folded before Flop (didn't bet)
Seat 6: tipner folded before Flop (didn't bet)
Seat 7: Spid1 folded before Flop (didn't bet)
Seat 8: Sweden_Pound folded before Flop (didn't bet)
Seat 9: Cikadejooo folded before Flop





PokerStars Hand #148220621404:  Hold'em No Limit ($0.50/$1.00 USD) - 2016/02/04 15:52:47 CET [2016/02/04 9:52:47 ET]
Table 'Alkaid II' 9-max Seat #7 is the button
Seat 1: Dante63s ($108.40 in chips) 
Seat 2: Sweden_Pound ($105.33 in chips) 
Seat 4: SumPosad ($39.59 in chips) 
Seat 5: geoffreyjo ($78.34 in chips) 
Seat 6: I The King I ($155.92 in chips) 
Seat 7: Monsthand ($114.13 in chips) 
Seat 8: KLOP06031987 ($111.39 in chips) 
Seat 9: matiko09 ($108.55 in chips) 
KLOP06031987: posts small blind $0.50
matiko09: posts big blind $1
sebaaastian: sits out 
*** HOLE CARDS ***
Dealt to matiko09 [Tc 6c]
Dante63s: folds 
Sweden_Pound: folds 
SumPosad: raises $2 to $3
geoffreyjo: folds 
I The King I: calls $3
Monsthand: folds 
KLOP06031987: folds 
matiko09: folds 
*** FLOP *** [3h 9c Js]
SumPosad: bets $4.20
I The King I: folds 
Uncalled bet ($4.20) returned to SumPosad
SumPosad collected $7.16 from pot
SumPosad: doesn't show hand 
*** SUMMARY ***
Total pot $7.50 | Rake $0.34 
Board [3h 9c Js]
Seat 1: Dante63s folded before Flop (didn't bet)
Seat 2: Sweden_Pound folded before Flop (didn't bet)
Seat 4: SumPosad collected ($7.16)
Seat 5: geoffreyjo folded before Flop (didn't bet)
Seat 6: I The King I folded on the Flop
Seat 7: Monsthand (button) folded before Flop (didn't bet)
Seat 8: KLOP06031987 (small blind) folded before Flop
Seat 9: matiko09 (big blind) folded before Flop





PokerStars Hand #148220628287:  Hold'em No Limit ($0.50/$1.00 USD) - 2016/02/04 15:52:56 CET [2016/02/04 9:52:56 ET]
Table 'Arneb II' 9-max Seat #5 is the button
Seat 1: matiko09 ($103.21 in chips) 
Seat 3: brille-390 ($152.52 in chips) 
Seat 4: Venomous100% ($100 in chips) 
Seat 5: Monsthand ($100 in chips) 
Seat 7: melitakas ($276.44 in chips) 
Seat 8: xxxZeka ($101.50 in chips) 
Seat 9: tipner ($200.45 in chips) 
melitakas: posts small blind $0.50
xxxZeka: posts big blind $1
Sweden_Pound: sits out 
*** HOLE CARDS ***
Dealt to matiko09 [Jc Ts]
tipner: folds 
matiko09: folds 
brille-390: folds 
Venomous100%: folds 
Monsthand: folds 
melitakas: folds 
Uncalled bet ($0.50) returned to xxxZeka
xxxZeka collected $1 from pot
*** SUMMARY ***
Total pot $1 | Rake $0 
Seat 1: matiko09 folded before Flop (didn't bet)
Seat 3: brille-390 folded before Flop (didn't bet)
Seat 4: Venomous100% folded before Flop (didn't bet)
Seat 5: Monsthand (button) folded before Flop (didn't bet)
Seat 7: melitakas (small blind) folded before Flop
Seat 8: xxxZeka (big blind) collected ($1)
Seat 9: tipner folded before Flop (didn't bet)





PokerStars Hand #148220627919:  Hold'em No Limit ($0.50/$1.00 USD) - 2016/02/04 15:52:56 CET [2016/02/04 9:52:56 ET]
Table 'Siarnaq' 9-max Seat #9 is the button
Seat 1: Dante63s ($100 in chips) 
Seat 2: V.Barinov ($98.50 in chips) 
Seat 3: goblind4777 ($134.75 in chips) 
Seat 5: I The King I ($114.23 in chips) 
Seat 6: Monsthand ($102.50 in chips) 
Seat 7: matiko09 ($114.59 in chips) 
Seat 8: Sweden_Pound ($119.40 in chips) 
Seat 9: MagicKid777 ($112.05 in chips) 
Dante63s: posts small blind $0.50
V.Barinov: posts big blind $1
RSBoris: sits out 
*** HOLE CARDS ***
Dealt to matiko09 [Qs Ad]
goblind4777: folds 
I The King I: raises $2 to $3
Monsthand: folds 
matiko09: raises $6.50 to $9.50
Sweden_Pound: folds 
MagicKid777: folds 
Dante63s: folds 
V.Barinov: folds 
I The King I: folds 
Uncalled bet ($6.50) returned to matiko09
matiko09 collected $7.50 from pot
matiko09: doesn't show hand 
*** SUMMARY ***
Total pot $7.50 | Rake $0 
Seat 1: Dante63s (small blind) folded before Flop
Seat 2: V.Barinov (big blind) folded before Flop
Seat 3: goblind4777 folded before Flop (didn't bet)
Seat 5: I The King I folded before Flop
Seat 6: Monsthand folded before Flop (didn't bet)
Seat 7: matiko09 collected ($7.50)
Seat 8: Sweden_Pound folded before Flop (didn't bet)
Seat 9: MagicKid777 (button) folded before Flop (didn't bet)





