PokerStars Hand #147707298493:  Hold'em No Limit ($0.50/$1.00 USD) - 2016/01/26 15:52:41 CET [2016/01/26 9:52:41 ET]
Table 'Calypso II' 9-max Seat #6 is the button
Seat 1: Peu3aHy ($137.12 in chips) 
Seat 2: Hardwell1993 ($99 in chips) 
Seat 3: matiko09 ($219.25 in chips) 
Seat 4: Sweden_Pound ($115.29 in chips) 
Seat 5: mycka86 ($100 in chips) 
Seat 6: MrDeeee25 ($100 in chips) 
Seat 7: Jimy Tiltman ($100 in chips) 
Seat 8: Reven9er ($102.50 in chips) 
Seat 9: Filojoes ($161.93 in chips) 
Jimy Tiltman: posts small blind $0.50
Reven9er: posts big blind $1
*** HOLE CARDS ***
Dealt to matiko09 [4c 6c]
Filojoes: folds 
Peu3aHy: folds 
Hardwell1993: folds 
matiko09: folds 
Sweden_Pound: folds 
mycka86: folds 
MrDeeee25: folds 
Jimy Tiltman: raises $2 to $3
Reven9er: folds 
Uncalled bet ($2) returned to Jimy Tiltman
Jimy Tiltman collected $2 from pot
Jimy Tiltman: doesn't show hand 
*** SUMMARY ***
Total pot $2 | Rake $0 
Seat 1: Peu3aHy folded before Flop (didn't bet)
Seat 2: Hardwell1993 folded before Flop (didn't bet)
Seat 3: matiko09 folded before Flop (didn't bet)
Seat 4: Sweden_Pound folded before Flop (didn't bet)
Seat 5: mycka86 folded before Flop (didn't bet)
Seat 6: MrDeeee25 (button) folded before Flop (didn't bet)
Seat 7: Jimy Tiltman (small blind) collected ($2)
Seat 8: Reven9er (big blind) folded before Flop
Seat 9: Filojoes folded before Flop (didn't bet)





PokerStars Hand #147707302608:  Hold'em No Limit ($0.50/$1.00 USD) - 2016/01/26 15:52:46 CET [2016/01/26 9:52:46 ET]
Table 'Strenua III' 9-max Seat #4 is the button
Seat 1: ICallSaul ($100 in chips) 
Seat 2: cn_chayanne ($101.50 in chips) 
Seat 4: mycka86 ($101.50 in chips) 
Seat 5: DeWeijz ($39 in chips) 
Seat 6: matiko09 ($145.34 in chips) 
Seat 7: KLOP06031987 ($100 in chips) 
Seat 8: Filojoes ($100 in chips) 
DeWeijz: posts small blind $0.50
matiko09: posts big blind $1
Dante63s: sits out 
ICallSaul: posts big blind $1
petalouda10: sits out 
*** HOLE CARDS ***
Dealt to matiko09 [3c Td]
KLOP06031987: raises $5 to $6
Filojoes: folds 
ICallSaul: folds 
cn_chayanne: folds 
mycka86: folds 
DeWeijz: folds 
matiko09: folds 
Uncalled bet ($5) returned to KLOP06031987
KLOP06031987 collected $3.50 from pot
KLOP06031987: doesn't show hand 
*** SUMMARY ***
Total pot $3.50 | Rake $0 
Seat 1: ICallSaul folded before Flop
Seat 2: cn_chayanne folded before Flop (didn't bet)
Seat 4: mycka86 (button) folded before Flop (didn't bet)
Seat 5: DeWeijz (small blind) folded before Flop
Seat 6: matiko09 (big blind) folded before Flop
Seat 7: KLOP06031987 collected ($3.50)
Seat 8: Filojoes folded before Flop (didn't bet)





PokerStars Hand #147707313060:  Hold'em No Limit ($0.50/$1.00 USD) - 2016/01/26 15:53:01 CET [2016/01/26 9:53:01 ET]
Table 'Mashona' 9-max Seat #4 is the button
Seat 2: werades ($198.42 in chips) 
Seat 3: matiko09 ($113.63 in chips) 
Seat 4: Sweden_Pound ($152.78 in chips) 
Seat 5: KLOP06031987 ($103.56 in chips) 
Seat 7: EB0LARAMA ($211.18 in chips) 
Seat 8: Jimy Tiltman ($177.16 in chips) 
Seat 9: Peu3aHy ($101.50 in chips) 
KLOP06031987: posts small blind $0.50
soplak: is sitting out 
EB0LARAMA: posts big blind $1
soplak leaves the table
maxxmeister: sits out 
*** HOLE CARDS ***
Dealt to matiko09 [8s 5h]
Filojoes joins the table at seat #6 
Jimy Tiltman: folds 
Peu3aHy: folds 
werades: folds 
matiko09: folds 
Sweden_Pound: raises $1 to $2
KLOP06031987: calls $1.50
EB0LARAMA: folds 
*** FLOP *** [Td 6d 9s]
KLOP06031987: checks 
Sweden_Pound: bets $3.11
KLOP06031987: folds 
Uncalled bet ($3.11) returned to Sweden_Pound
Sweden_Pound collected $4.78 from pot
Sweden_Pound: doesn't show hand 
*** SUMMARY ***
Total pot $5 | Rake $0.22 
Board [Td 6d 9s]
Seat 2: werades folded before Flop (didn't bet)
Seat 3: matiko09 folded before Flop (didn't bet)
Seat 4: Sweden_Pound (button) collected ($4.78)
Seat 5: KLOP06031987 (small blind) folded on the Flop
Seat 7: EB0LARAMA (big blind) folded before Flop
Seat 8: Jimy Tiltman folded before Flop (didn't bet)
Seat 9: Peu3aHy folded before Flop (didn't bet)





PokerStars Hand #147707315001:  Hold'em No Limit ($0.50/$1.00 USD) - 2016/01/26 15:53:03 CET [2016/01/26 9:53:03 ET]
Table 'Haedus' 9-max Seat #2 is the button
Seat 1: Dante63s ($119.50 in chips) 
Seat 2: Sweden_Pound ($100 in chips) 
Seat 3: cn_chayanne ($103.66 in chips) 
Seat 4: FroggyPlay ($101.39 in chips) 
Seat 5: matiko09 ($101.50 in chips) 
Seat 6: nnne409 ($72.29 in chips) 
Seat 7: KLOP06031987 ($106 in chips) 
cn_chayanne: posts small blind $0.50
FroggyPlay: posts big blind $1
Jimy Tiltman: sits out 
Filojoes: sits out 
*** HOLE CARDS ***
Dealt to matiko09 [3s 4h]
matiko09: folds 
nnne409: folds 
KLOP06031987: folds 
Dante63s: folds 
Sweden_Pound: raises $1 to $2
cn_chayanne: folds 
FroggyPlay: calls $1
*** FLOP *** [6s Qh 5h]
FroggyPlay: checks 
Sweden_Pound: bets $2.80
FroggyPlay: folds 
Uncalled bet ($2.80) returned to Sweden_Pound
Sweden_Pound collected $4.30 from pot
Sweden_Pound: doesn't show hand 
*** SUMMARY ***
Total pot $4.50 | Rake $0.20 
Board [6s Qh 5h]
Seat 1: Dante63s folded before Flop (didn't bet)
Seat 2: Sweden_Pound (button) collected ($4.30)
Seat 3: cn_chayanne (small blind) folded before Flop
Seat 4: FroggyPlay (big blind) folded on the Flop
Seat 5: matiko09 folded before Flop (didn't bet)
Seat 6: nnne409 folded before Flop (didn't bet)
Seat 7: KLOP06031987 folded before Flop (didn't bet)





PokerStars Hand #147707318630:  Hold'em No Limit ($0.50/$1.00 USD) - 2016/01/26 15:53:08 CET [2016/01/26 9:53:08 ET]
Table 'Calypso II' 9-max Seat #7 is the button
Seat 1: Peu3aHy ($137.12 in chips) 
Seat 2: Hardwell1993 ($99 in chips) 
Seat 3: matiko09 ($219.25 in chips) 
Seat 4: Sweden_Pound ($115.29 in chips) 
Seat 5: mycka86 ($100 in chips) 
Seat 6: MrDeeee25 ($100 in chips) 
Seat 7: Jimy Tiltman ($101 in chips) 
Seat 8: Reven9er ($101.50 in chips) 
Seat 9: Filojoes ($161.93 in chips) 
Reven9er: posts small blind $0.50
Filojoes: posts big blind $1
*** HOLE CARDS ***
Dealt to matiko09 [5s Kd]
Peu3aHy: folds 
Hardwell1993: folds 
matiko09: folds 
Sweden_Pound: folds 
mycka86: raises $1.50 to $2.50
MrDeeee25: folds 
Jimy Tiltman: folds 
Reven9er: folds 
Filojoes: folds 
Uncalled bet ($1.50) returned to mycka86
mycka86 collected $2.50 from pot
*** SUMMARY ***
Total pot $2.50 | Rake $0 
Seat 1: Peu3aHy folded before Flop (didn't bet)
Seat 2: Hardwell1993 folded before Flop (didn't bet)
Seat 3: matiko09 folded before Flop (didn't bet)
Seat 4: Sweden_Pound folded before Flop (didn't bet)
Seat 5: mycka86 collected ($2.50)
Seat 6: MrDeeee25 folded before Flop (didn't bet)
Seat 7: Jimy Tiltman (button) folded before Flop (didn't bet)
Seat 8: Reven9er (small blind) folded before Flop
Seat 9: Filojoes (big blind) folded before Flop





PokerStars Hand #147707321284:  Hold'em No Limit ($0.50/$1.00 USD) - 2016/01/26 15:53:12 CET [2016/01/26 9:53:12 ET]
Table 'Strenua III' 9-max Seat #5 is the button
Seat 1: ICallSaul ($99 in chips) 
Seat 2: cn_chayanne ($101.50 in chips) 
Seat 3: petalouda10 ($80 in chips) 
Seat 4: mycka86 ($101.50 in chips) 
Seat 5: DeWeijz ($38.50 in chips) 
Seat 6: matiko09 ($144.34 in chips) 
Seat 7: KLOP06031987 ($102.50 in chips) 
Seat 8: Filojoes ($100 in chips) 
matiko09: posts small blind $0.50
KLOP06031987: posts big blind $1
Dante63s: sits out 
petalouda10: posts big blind $1
*** HOLE CARDS ***
Dealt to matiko09 [4s 7c]
Filojoes: folds 
ICallSaul: folds 
cn_chayanne: raises $1.50 to $2.50
petalouda10: calls $1.50
mycka86: folds 
DeWeijz: folds 
matiko09: folds 
KLOP06031987: folds 
*** FLOP *** [Td Ad Kc]
cn_chayanne: bets $4.65
petalouda10: calls $4.65
*** TURN *** [Td Ad Kc] [Qd]
cn_chayanne: checks 
petalouda10: bets $7.54
cn_chayanne: folds 
Uncalled bet ($7.54) returned to petalouda10
petalouda10 collected $15.09 from pot
petalouda10: doesn't show hand 
*** SUMMARY ***
Total pot $15.80 | Rake $0.71 
Board [Td Ad Kc Qd]
Seat 1: ICallSaul folded before Flop (didn't bet)
Seat 2: cn_chayanne folded on the Turn
Seat 3: petalouda10 collected ($15.09)
Seat 4: mycka86 folded before Flop (didn't bet)
Seat 5: DeWeijz (button) folded before Flop (didn't bet)
Seat 6: matiko09 (small blind) folded before Flop
Seat 7: KLOP06031987 (big blind) folded before Flop
Seat 8: Filojoes folded before Flop (didn't bet)





PokerStars Hand #147707325031:  Hold'em No Limit ($0.50/$1.00 USD) - 2016/01/26 15:53:17 CET [2016/01/26 9:53:17 ET]
Table 'Achates III' 9-max Seat #8 is the button
Seat 1: CI58 ($100 in chips) 
Seat 2: matiko09 ($100 in chips) 
Seat 3: Jimy Tiltman ($100.02 in chips) 
Seat 4: cn_chayanne ($110.26 in chips) 
Seat 5: Sweden_Pound ($221.79 in chips) 
Seat 7: KLOP06031987 ($100 in chips) 
Seat 8: Männerzimmer ($187.11 in chips) 
Seat 9: T-chaos_IMBA ($331.42 in chips) 
T-chaos_IMBA: posts small blind $0.50
CI58: posts big blind $1
Kukuryzka: sits out 
*** HOLE CARDS ***
Dealt to matiko09 [3h Tc]
matiko09: folds 
Jimy Tiltman: folds 
cn_chayanne: folds 
Sweden_Pound: folds 
KLOP06031987: folds 
Männerzimmer: folds 
T-chaos_IMBA: raises $3 to $4
CI58: folds 
Uncalled bet ($3) returned to T-chaos_IMBA
T-chaos_IMBA collected $2 from pot
T-chaos_IMBA: doesn't show hand 
*** SUMMARY ***
Total pot $2 | Rake $0 
Seat 1: CI58 (big blind) folded before Flop
Seat 2: matiko09 folded before Flop (didn't bet)
Seat 3: Jimy Tiltman folded before Flop (didn't bet)
Seat 4: cn_chayanne folded before Flop (didn't bet)
Seat 5: Sweden_Pound folded before Flop (didn't bet)
Seat 7: KLOP06031987 folded before Flop (didn't bet)
Seat 8: Männerzimmer (button) folded before Flop (didn't bet)
Seat 9: T-chaos_IMBA (small blind) collected ($2)





PokerStars Hand #147707328910:  Hold'em No Limit ($0.50/$1.00 USD) - 2016/01/26 15:53:23 CET [2016/01/26 9:53:23 ET]
Table 'Impala' 9-max Seat #1 is the button
Seat 1: mycka86 ($127.59 in chips) 
Seat 2: Filojoes ($100.50 in chips) 
Seat 3: Dante63s ($104 in chips) 
Seat 4: KLOP06031987 ($100 in chips) 
Seat 5: Kukuryzka ($100 in chips) 
Seat 6: Tijger R.d.J ($70.40 in chips) 
Seat 7: matiko09 ($118.26 in chips) 
Seat 8: Peu3aHy ($105.52 in chips) 
Seat 9: flozzi ($100 in chips) 
Filojoes: posts small blind $0.50
Dante63s: posts big blind $1
*** HOLE CARDS ***
Dealt to matiko09 [As Jc]
KLOP06031987: folds 
Kukuryzka: folds 
Tijger R.d.J: folds 
matiko09: raises $2 to $3
Peu3aHy: calls $3
flozzi: folds 
mycka86: folds 
Filojoes: folds 
Dante63s: folds 
*** FLOP *** [6h Ad 9h]
matiko09: bets $4.65
Peu3aHy: calls $4.65
*** TURN *** [6h Ad 9h] [Js]
matiko09: bets $24
Peu3aHy: folds 
Uncalled bet ($24) returned to matiko09
matiko09 collected $16.04 from pot
matiko09: doesn't show hand 
*** SUMMARY ***
Total pot $16.80 | Rake $0.76 
Board [6h Ad 9h Js]
Seat 1: mycka86 (button) folded before Flop (didn't bet)
Seat 2: Filojoes (small blind) folded before Flop
Seat 3: Dante63s (big blind) folded before Flop
Seat 4: KLOP06031987 folded before Flop (didn't bet)
Seat 5: Kukuryzka folded before Flop (didn't bet)
Seat 6: Tijger R.d.J folded before Flop (didn't bet)
Seat 7: matiko09 collected ($16.04)
Seat 8: Peu3aHy folded on the Turn
Seat 9: flozzi folded before Flop (didn't bet)





PokerStars Hand #147707333207:  Hold'em No Limit ($0.50/$1.00 USD) - 2016/01/26 15:53:29 CET [2016/01/26 9:53:29 ET]
Table 'Heike II' 9-max Seat #4 is the button
Seat 1: ilaviiitech ($121.51 in chips) 
Seat 2: Dante63s ($112.48 in chips) 
Seat 3: matiko09 ($129.82 in chips) 
Seat 4: Reven9er ($112.28 in chips) 
Seat 5: Sweden_Pound ($100 in chips) 
Seat 6: H8fulM0n ($108.40 in chips) 
Seat 7: Momess ($105 in chips) 
Seat 8: THE RIPPER V ($52.95 in chips) 
Seat 9: uonlylive1ce ($142.45 in chips) 
Sweden_Pound: posts small blind $0.50
H8fulM0n: posts big blind $1
*** HOLE CARDS ***
Dealt to matiko09 [9d Jd]
Momess: folds 
THE RIPPER V: folds 
uonlylive1ce: folds 
ilaviiitech: folds 
Dante63s: folds 
matiko09: raises $1.50 to $2.50
Reven9er: folds 
Sweden_Pound: folds 
H8fulM0n: calls $1.50
*** FLOP *** [4s Qh 4c]
H8fulM0n: checks 
matiko09: checks 
*** TURN *** [4s Qh 4c] [8d]
H8fulM0n: checks 
matiko09: checks 
*** RIVER *** [4s Qh 4c 8d] [Qd]
H8fulM0n: checks 
matiko09: checks 
*** SHOW DOWN ***
H8fulM0n: shows [8c 4h] (a full house, Fours full of Queens)
matiko09: mucks hand 
H8fulM0n collected $5.25 from pot
*** SUMMARY ***
Total pot $5.50 | Rake $0.25 
Board [4s Qh 4c 8d Qd]
Seat 1: ilaviiitech folded before Flop (didn't bet)
Seat 2: Dante63s folded before Flop (didn't bet)
Seat 3: matiko09 mucked [9d Jd]
Seat 4: Reven9er (button) folded before Flop (didn't bet)
Seat 5: Sweden_Pound (small blind) folded before Flop
Seat 6: H8fulM0n (big blind) showed [8c 4h] and won ($5.25) with a full house, Fours full of Queens
Seat 7: Momess folded before Flop (didn't bet)
Seat 8: THE RIPPER V folded before Flop (didn't bet)
Seat 9: uonlylive1ce folded before Flop (didn't bet)





PokerStars Hand #147707345352:  Hold'em No Limit ($0.50/$1.00 USD) - 2016/01/26 15:53:45 CET [2016/01/26 9:53:45 ET]
Table 'Calypso II' 9-max Seat #8 is the button
Seat 2: Hardwell1993 ($99 in chips) 
Seat 3: matiko09 ($219.25 in chips) 
Seat 4: Sweden_Pound ($115.29 in chips) 
Seat 5: mycka86 ($101.50 in chips) 
Seat 6: MrDeeee25 ($100 in chips) 
Seat 7: Jimy Tiltman ($101 in chips) 
Seat 8: Reven9er ($101 in chips) 
Seat 9: Filojoes ($160.93 in chips) 
Filojoes: posts small blind $0.50
Peu3aHy: is sitting out 
Hardwell1993: posts big blind $1
*** HOLE CARDS ***
Dealt to matiko09 [2s 6s]
Peu3aHy leaves the table
matiko09: folds 
Sweden_Pound: folds 
mycka86: raises $1.50 to $2.50
CI58 joins the table at seat #1 
MrDeeee25: folds 
Jimy Tiltman: folds 
Reven9er: raises $3.50 to $6
Filojoes: folds 
Hardwell1993: folds 
mycka86: calls $3.50
*** FLOP *** [2d 5d 8s]
mycka86: checks 
Reven9er: checks 
*** TURN *** [2d 5d 8s] [6d]
CI58 leaves the table
KLOP06031987 joins the table at seat #1 
mycka86: checks 
Reven9er: checks 
*** RIVER *** [2d 5d 8s 6d] [8h]
mycka86: checks 
Reven9er: bets $5
mycka86: folds 
Uncalled bet ($5) returned to Reven9er
Reven9er collected $12.89 from pot
Reven9er: doesn't show hand 
*** SUMMARY ***
Total pot $13.50 | Rake $0.61 
Board [2d 5d 8s 6d 8h]
Seat 2: Hardwell1993 (big blind) folded before Flop
Seat 3: matiko09 folded before Flop (didn't bet)
Seat 4: Sweden_Pound folded before Flop (didn't bet)
Seat 5: mycka86 folded on the River
Seat 6: MrDeeee25 folded before Flop (didn't bet)
Seat 7: Jimy Tiltman folded before Flop (didn't bet)
Seat 8: Reven9er (button) collected ($12.89)
Seat 9: Filojoes (small blind) folded before Flop





PokerStars Hand #147707346060:  Hold'em No Limit ($0.50/$1.00 USD) - 2016/01/26 15:53:46 CET [2016/01/26 9:53:46 ET]
Table 'Gyas IV' 9-max Seat #1 is the button
Seat 1: sharkside90 ($38.40 in chips) 
Seat 2: Dante63s ($120.04 in chips) 
Seat 5: matiko09 ($108.18 in chips) 
Seat 6: flozzi ($100 in chips) 
Seat 7: mycka86 ($100 in chips) 
Seat 8: Peu3aHy ($148.59 in chips) 
Seat 9: Sweden_Pound ($125.50 in chips) 
Dante63s: posts small blind $0.50
maxxmeister: is sitting out 
cn_chayanne: is sitting out 
matiko09: posts big blind $1
*** HOLE CARDS ***
Dealt to matiko09 [2c 9d]
flozzi: folds 
maxxmeister leaves the table
flozzi leaves the table
mycka86: folds 
Peu3aHy: folds 
KLOP06031987 joins the table at seat #6 
Sweden_Pound: folds 
KLOP06031987 leaves the table
Filojoes joins the table at seat #6 
sharkside90: raises $2 to $3
Dante63s: folds 
matiko09: folds 
Uncalled bet ($2) returned to sharkside90
sharkside90 collected $2.50 from pot
*** SUMMARY ***
Total pot $2.50 | Rake $0 
Seat 1: sharkside90 (button) collected ($2.50)
Seat 2: Dante63s (small blind) folded before Flop
Seat 5: matiko09 (big blind) folded before Flop
Seat 6: flozzi folded before Flop (didn't bet)
Seat 7: mycka86 folded before Flop (didn't bet)
Seat 8: Peu3aHy folded before Flop (didn't bet)
Seat 9: Sweden_Pound folded before Flop (didn't bet)





PokerStars Hand #147707347975:  Hold'em No Limit ($0.50/$1.00 USD) - 2016/01/26 15:53:49 CET [2016/01/26 9:53:49 ET]
Table 'Strenua III' 9-max Seat #6 is the button
Seat 1: ICallSaul ($99 in chips) 
Seat 2: cn_chayanne ($100 in chips) 
Seat 3: petalouda10 ($87.94 in chips) 
Seat 4: mycka86 ($101.50 in chips) 
Seat 5: DeWeijz ($38.50 in chips) 
Seat 6: matiko09 ($143.84 in chips) 
Seat 7: KLOP06031987 ($101.50 in chips) 
Seat 8: Filojoes ($100 in chips) 
KLOP06031987: posts small blind $0.50
Filojoes: posts big blind $1
Dante63s: sits out 
*** HOLE CARDS ***
Dealt to matiko09 [5s 3s]
ICallSaul: folds 
cn_chayanne: folds 
petalouda10: folds 
mycka86: folds 
DeWeijz: folds 
matiko09: folds 
KLOP06031987: folds 
Uncalled bet ($0.50) returned to Filojoes
Filojoes collected $1 from pot
Filojoes: doesn't show hand 
*** SUMMARY ***
Total pot $1 | Rake $0 
Seat 1: ICallSaul folded before Flop (didn't bet)
Seat 2: cn_chayanne folded before Flop (didn't bet)
Seat 3: petalouda10 folded before Flop (didn't bet)
Seat 4: mycka86 folded before Flop (didn't bet)
Seat 5: DeWeijz folded before Flop (didn't bet)
Seat 6: matiko09 (button) folded before Flop (didn't bet)
Seat 7: KLOP06031987 (small blind) folded before Flop
Seat 8: Filojoes (big blind) collected ($1)





PokerStars Hand #147707348215:  Hold'em No Limit ($0.50/$1.00 USD) - 2016/01/26 15:53:49 CET [2016/01/26 9:53:49 ET]
Table 'Mashona' 9-max Seat #5 is the button
Seat 2: werades ($198.42 in chips) 
Seat 3: matiko09 ($113.63 in chips) 
Seat 4: Sweden_Pound ($155.56 in chips) 
Seat 5: KLOP06031987 ($101.56 in chips) 
Seat 7: EB0LARAMA ($210.18 in chips) 
Seat 8: Jimy Tiltman ($177.16 in chips) 
Seat 9: Peu3aHy ($101.50 in chips) 
Filojoes will be allowed to play after the button
EB0LARAMA: posts small blind $0.50
Jimy Tiltman: posts big blind $1
maxxmeister: sits out 
*** HOLE CARDS ***
Dealt to matiko09 [3c 8h]
Peu3aHy: folds 
werades: folds 
matiko09: folds 
Sweden_Pound: folds 
KLOP06031987: folds 
EB0LARAMA: folds 
Uncalled bet ($0.50) returned to Jimy Tiltman
Jimy Tiltman collected $1 from pot
Jimy Tiltman: doesn't show hand 
*** SUMMARY ***
Total pot $1 | Rake $0 
Seat 2: werades folded before Flop (didn't bet)
Seat 3: matiko09 folded before Flop (didn't bet)
Seat 4: Sweden_Pound folded before Flop (didn't bet)
Seat 5: KLOP06031987 (button) folded before Flop (didn't bet)
Seat 7: EB0LARAMA (small blind) folded before Flop
Seat 8: Jimy Tiltman (big blind) collected ($1)
Seat 9: Peu3aHy folded before Flop (didn't bet)





PokerStars Hand #147707350521:  Hold'em No Limit ($0.50/$1.00 USD) - 2016/01/26 15:53:53 CET [2016/01/26 9:53:53 ET]
Table 'Montefiore' 9-max Seat #6 is the button
Seat 1: Celsinho0311 ($32.65 in chips) 
Seat 2: Dante63s ($104.08 in chips) 
Seat 3: Filojoes ($100 in chips) 
Seat 4: matiko09 ($108.05 in chips) 
Seat 5: ilaviiitech ($100 in chips) 
Seat 6: Kosh20 ($54.74 in chips) 
Seat 7: flozzi ($100 in chips) 
Seat 8: Kukuryzka ($100 in chips) 
flozzi: posts small blind $0.50
Kukuryzka: posts big blind $1
KLOP06031987: sits out 
*** HOLE CARDS ***
Dealt to matiko09 [Ts Qc]
Celsinho0311: raises $2 to $3
Dante63s: folds 
Filojoes: folds 
matiko09: folds 
ilaviiitech: folds 
Kosh20: folds 
flozzi: folds 
Kukuryzka: folds 
Uncalled bet ($2) returned to Celsinho0311
Celsinho0311 collected $2.50 from pot
Celsinho0311: doesn't show hand 
*** SUMMARY ***
Total pot $2.50 | Rake $0 
Seat 1: Celsinho0311 collected ($2.50)
Seat 2: Dante63s folded before Flop (didn't bet)
Seat 3: Filojoes folded before Flop (didn't bet)
Seat 4: matiko09 folded before Flop (didn't bet)
Seat 5: ilaviiitech folded before Flop (didn't bet)
Seat 6: Kosh20 (button) folded before Flop (didn't bet)
Seat 7: flozzi (small blind) folded before Flop
Seat 8: Kukuryzka (big blind) folded before Flop





PokerStars Hand #147707355875:  Hold'em No Limit ($0.50/$1.00 USD) - 2016/01/26 15:54:00 CET [2016/01/26 9:54:00 ET]
Table 'Haedus' 9-max Seat #3 is the button
Seat 1: Dante63s ($119.50 in chips) 
Seat 2: Sweden_Pound ($102.30 in chips) 
Seat 3: cn_chayanne ($103.16 in chips) 
Seat 4: FroggyPlay ($100 in chips) 
Seat 5: matiko09 ($101.50 in chips) 
Seat 6: nnne409 ($72.29 in chips) 
Seat 7: KLOP06031987 ($106 in chips) 
FroggyPlay: posts small blind $0.50
matiko09: posts big blind $1
Jimy Tiltman: sits out 
Filojoes: sits out 
*** HOLE CARDS ***
Dealt to matiko09 [Qh 3s]
nnne409: folds 
KLOP06031987: folds 
Dante63s: folds 
Sweden_Pound: raises $1.50 to $2.50
cn_chayanne: calls $2.50
FroggyPlay: folds 
matiko09: folds 
*** FLOP *** [6s Ks 8d]
Sweden_Pound: checks 
cn_chayanne: bets $4.65
Sweden_Pound: folds 
Uncalled bet ($4.65) returned to cn_chayanne
cn_chayanne collected $6.21 from pot
cn_chayanne: doesn't show hand 
*** SUMMARY ***
Total pot $6.50 | Rake $0.29 
Board [6s Ks 8d]
Seat 1: Dante63s folded before Flop (didn't bet)
Seat 2: Sweden_Pound folded on the Flop
Seat 3: cn_chayanne (button) collected ($6.21)
Seat 4: FroggyPlay (small blind) folded before Flop
Seat 5: matiko09 (big blind) folded before Flop
Seat 6: nnne409 folded before Flop (didn't bet)
Seat 7: KLOP06031987 folded before Flop (didn't bet)





PokerStars Hand #147707362058:  Hold'em No Limit ($0.50/$1.00 USD) - 2016/01/26 15:54:08 CET [2016/01/26 9:54:08 ET]
Table 'Strenua III' 9-max Seat #7 is the button
Seat 1: ICallSaul ($99 in chips) 
Seat 2: cn_chayanne ($100 in chips) 
Seat 3: petalouda10 ($87.94 in chips) 
Seat 4: mycka86 ($101.50 in chips) 
Seat 5: DeWeijz ($38.50 in chips) 
Seat 6: matiko09 ($143.84 in chips) 
Seat 7: KLOP06031987 ($101 in chips) 
Seat 8: Filojoes ($100.50 in chips) 
Seat 9: Dante63s ($100 in chips) 
Filojoes: posts small blind $0.50
Dante63s: posts big blind $1
*** HOLE CARDS ***
Dealt to matiko09 [9d 7s]
ICallSaul: folds 
cn_chayanne: folds 
petalouda10: raises $2 to $3
mycka86: folds 
DeWeijz: folds 
matiko09: folds 
KLOP06031987: folds 
Filojoes: folds 
Dante63s: folds 
Uncalled bet ($2) returned to petalouda10
petalouda10 collected $2.50 from pot
petalouda10: doesn't show hand 
*** SUMMARY ***
Total pot $2.50 | Rake $0 
Seat 1: ICallSaul folded before Flop (didn't bet)
Seat 2: cn_chayanne folded before Flop (didn't bet)
Seat 3: petalouda10 collected ($2.50)
Seat 4: mycka86 folded before Flop (didn't bet)
Seat 5: DeWeijz folded before Flop (didn't bet)
Seat 6: matiko09 folded before Flop (didn't bet)
Seat 7: KLOP06031987 (button) folded before Flop (didn't bet)
Seat 8: Filojoes (small blind) folded before Flop
Seat 9: Dante63s (big blind) folded before Flop





PokerStars Hand #147707361875:  Hold'em No Limit ($0.50/$1.00 USD) - 2016/01/26 15:54:08 CET [2016/01/26 9:54:08 ET]
Table 'Achates III' 9-max Seat #9 is the button
Seat 1: CI58 ($100 in chips) 
Seat 2: matiko09 ($100 in chips) 
Seat 3: Jimy Tiltman ($100.02 in chips) 
Seat 4: cn_chayanne ($110.26 in chips) 
Seat 5: Sweden_Pound ($221.79 in chips) 
Seat 7: KLOP06031987 ($100 in chips) 
Seat 8: Männerzimmer ($187.11 in chips) 
Seat 9: T-chaos_IMBA ($332.42 in chips) 
CI58: posts small blind $0.50
matiko09: posts big blind $1
Kukuryzka: sits out 
*** HOLE CARDS ***
Dealt to matiko09 [8s 2s]
Jimy Tiltman: folds 
cn_chayanne: folds 
Sweden_Pound: folds 
KLOP06031987: folds 
Männerzimmer: raises $2 to $3
T-chaos_IMBA: folds 
CI58: folds 
matiko09: folds 
Uncalled bet ($2) returned to Männerzimmer
Männerzimmer collected $2.50 from pot
Männerzimmer: doesn't show hand 
*** SUMMARY ***
Total pot $2.50 | Rake $0 
Seat 1: CI58 (small blind) folded before Flop
Seat 2: matiko09 (big blind) folded before Flop
Seat 3: Jimy Tiltman folded before Flop (didn't bet)
Seat 4: cn_chayanne folded before Flop (didn't bet)
Seat 5: Sweden_Pound folded before Flop (didn't bet)
Seat 7: KLOP06031987 folded before Flop (didn't bet)
Seat 8: Männerzimmer collected ($2.50)
Seat 9: T-chaos_IMBA (button) folded before Flop (didn't bet)





PokerStars Hand #147707363307:  Hold'em No Limit ($0.50/$1.00 USD) - 2016/01/26 15:54:10 CET [2016/01/26 9:54:10 ET]
Table 'Mashona' 9-max Seat #7 is the button
Seat 1: maxxmeister ($100 in chips) 
Seat 2: werades ($198.42 in chips) 
Seat 3: matiko09 ($113.63 in chips) 
Seat 4: Sweden_Pound ($155.56 in chips) 
Seat 5: KLOP06031987 ($101.56 in chips) 
Seat 7: EB0LARAMA ($209.68 in chips) 
Seat 8: Jimy Tiltman ($177.66 in chips) 
Jimy Tiltman: posts small blind $0.50
Peu3aHy: is sitting out 
maxxmeister: posts big blind $1
Filojoes: sits out 
*** HOLE CARDS ***
Dealt to matiko09 [Qc Ac]
Peu3aHy leaves the table
werades: folds 
matiko09: raises $2 to $3
apfush joins the table at seat #9 
Sweden_Pound: calls $3
KLOP06031987: folds 
EB0LARAMA: folds 
Jimy Tiltman: folds 
maxxmeister: calls $2
*** FLOP *** [9h 4c 6d]
maxxmeister: checks 
matiko09: bets $5.90
Sweden_Pound: folds 
maxxmeister: calls $5.90
*** TURN *** [9h 4c 6d] [5c]
maxxmeister: checks 
matiko09: bets $14
maxxmeister: folds 
Uncalled bet ($14) returned to matiko09
matiko09 collected $20.34 from pot
matiko09: doesn't show hand 
*** SUMMARY ***
Total pot $21.30 | Rake $0.96 
Board [9h 4c 6d 5c]
Seat 1: maxxmeister (big blind) folded on the Turn
Seat 2: werades folded before Flop (didn't bet)
Seat 3: matiko09 collected ($20.34)
Seat 4: Sweden_Pound folded on the Flop
Seat 5: KLOP06031987 folded before Flop (didn't bet)
Seat 7: EB0LARAMA (button) folded before Flop (didn't bet)
Seat 8: Jimy Tiltman (small blind) folded before Flop





PokerStars Hand #147707377814:  Hold'em No Limit ($0.50/$1.00 USD) - 2016/01/26 15:54:30 CET [2016/01/26 9:54:30 ET]
Table 'Impala' 9-max Seat #2 is the button
Seat 1: mycka86 ($127.59 in chips) 
Seat 2: Filojoes ($100 in chips) 
Seat 3: Dante63s ($103 in chips) 
Seat 4: KLOP06031987 ($100 in chips) 
Seat 5: Kukuryzka ($100 in chips) 
Seat 6: Tijger R.d.J ($70.40 in chips) 
Seat 7: matiko09 ($126.65 in chips) 
Seat 8: Peu3aHy ($100 in chips) 
Seat 9: flozzi ($100 in chips) 
Dante63s: posts small blind $0.50
KLOP06031987: posts big blind $1
*** HOLE CARDS ***
Dealt to matiko09 [9c Kc]
Kukuryzka: folds 
Tijger R.d.J: raises $1 to $2
matiko09: folds 
Peu3aHy: folds 
flozzi: calls $2
mycka86: calls $2
Filojoes: folds 
Dante63s: folds 
KLOP06031987: calls $1
*** FLOP *** [Js Jh 9d]
KLOP06031987: checks 
Tijger R.d.J: checks 
flozzi: checks 
mycka86: bets $5.50
KLOP06031987: folds 
Tijger R.d.J: folds 
flozzi: folds 
Uncalled bet ($5.50) returned to mycka86
mycka86 collected $8.12 from pot
*** SUMMARY ***
Total pot $8.50 | Rake $0.38 
Board [Js Jh 9d]
Seat 1: mycka86 collected ($8.12)
Seat 2: Filojoes (button) folded before Flop (didn't bet)
Seat 3: Dante63s (small blind) folded before Flop
Seat 4: KLOP06031987 (big blind) folded on the Flop
Seat 5: Kukuryzka folded before Flop (didn't bet)
Seat 6: Tijger R.d.J folded on the Flop
Seat 7: matiko09 folded before Flop (didn't bet)
Seat 8: Peu3aHy folded before Flop (didn't bet)
Seat 9: flozzi folded on the Flop





PokerStars Hand #147707377664:  Hold'em No Limit ($0.50/$1.00 USD) - 2016/01/26 15:54:30 CET [2016/01/26 9:54:30 ET]
Table 'Gyas IV' 9-max Seat #2 is the button
Seat 1: sharkside90 ($39.90 in chips) 
Seat 2: Dante63s ($119.54 in chips) 
Seat 5: matiko09 ($107.18 in chips) 
Seat 6: Filojoes ($100 in chips) 
Seat 7: mycka86 ($100 in chips) 
Seat 8: Peu3aHy ($148.59 in chips) 
Seat 9: Sweden_Pound ($125.50 in chips) 
matiko09: posts small blind $0.50
Filojoes: posts big blind $1
*** HOLE CARDS ***
Dealt to matiko09 [7s 3c]
mycka86: folds 
Peu3aHy: folds 
Sweden_Pound: raises $2 to $3
sharkside90: folds 
Dante63s: folds 
matiko09: folds 
Filojoes: folds 
Uncalled bet ($2) returned to Sweden_Pound
Sweden_Pound collected $2.50 from pot
Sweden_Pound: doesn't show hand 
*** SUMMARY ***
Total pot $2.50 | Rake $0 
Seat 1: sharkside90 folded before Flop (didn't bet)
Seat 2: Dante63s (button) folded before Flop (didn't bet)
Seat 5: matiko09 (small blind) folded before Flop
Seat 6: Filojoes (big blind) folded before Flop
Seat 7: mycka86 folded before Flop (didn't bet)
Seat 8: Peu3aHy folded before Flop (didn't bet)
Seat 9: Sweden_Pound collected ($2.50)





PokerStars Hand #147707378653:  Hold'em No Limit ($0.50/$1.00 USD) - 2016/01/26 15:54:31 CET [2016/01/26 9:54:31 ET]
Table 'Heike II' 9-max Seat #5 is the button
Seat 1: ilaviiitech ($121.51 in chips) 
Seat 2: Dante63s ($112.48 in chips) 
Seat 3: matiko09 ($127.32 in chips) 
Seat 4: Reven9er ($112.28 in chips) 
Seat 5: Sweden_Pound ($100 in chips) 
Seat 6: H8fulM0n ($111.15 in chips) 
Seat 7: Momess ($105 in chips) 
Seat 8: THE RIPPER V ($52.95 in chips) 
Seat 9: uonlylive1ce ($142.45 in chips) 
H8fulM0n: posts small blind $0.50
Momess: posts big blind $1
*** HOLE CARDS ***
Dealt to matiko09 [2d 8h]
THE RIPPER V: folds 
uonlylive1ce: folds 
ilaviiitech: folds 
Dante63s: folds 
matiko09: folds 
Reven9er: folds 
Sweden_Pound: raises $1 to $2
H8fulM0n: calls $1.50
Momess: raises $6.50 to $8.50
Sweden_Pound: calls $6.50
H8fulM0n: calls $6.50
*** FLOP *** [Ts 7c 9c]
H8fulM0n: checks 
Momess: checks 
Sweden_Pound: checks 
*** TURN *** [Ts 7c 9c] [2s]
H8fulM0n: bets $24
Momess: folds 
Sweden_Pound: folds 
Uncalled bet ($24) returned to H8fulM0n
H8fulM0n collected $24.35 from pot
H8fulM0n: doesn't show hand 
*** SUMMARY ***
Total pot $25.50 | Rake $1.15 
Board [Ts 7c 9c 2s]
Seat 1: ilaviiitech folded before Flop (didn't bet)
Seat 2: Dante63s folded before Flop (didn't bet)
Seat 3: matiko09 folded before Flop (didn't bet)
Seat 4: Reven9er folded before Flop (didn't bet)
Seat 5: Sweden_Pound (button) folded on the Turn
Seat 6: H8fulM0n (small blind) collected ($24.35)
Seat 7: Momess (big blind) folded on the Turn
Seat 8: THE RIPPER V folded before Flop (didn't bet)
Seat 9: uonlylive1ce folded before Flop (didn't bet)





PokerStars Hand #147707380799:  Hold'em No Limit ($0.50/$1.00 USD) - 2016/01/26 15:54:34 CET [2016/01/26 9:54:34 ET]
Table 'Montefiore' 9-max Seat #7 is the button
Seat 1: Celsinho0311 ($34.15 in chips) 
Seat 2: Dante63s ($104.08 in chips) 
Seat 3: Filojoes ($100 in chips) 
Seat 4: matiko09 ($108.05 in chips) 
Seat 5: ilaviiitech ($100 in chips) 
Seat 6: Kosh20 ($54.74 in chips) 
Seat 7: flozzi ($100 in chips) 
Seat 8: Kukuryzka ($99 in chips) 
Seat 9: KLOP06031987 ($100 in chips) 
Kukuryzka: posts small blind $0.50
KLOP06031987: posts big blind $1
*** HOLE CARDS ***
Dealt to matiko09 [Ac 9s]
Celsinho0311: folds 
Dante63s: folds 
Filojoes: folds 
matiko09: folds 
ilaviiitech: folds 
Kosh20: raises $2 to $3
flozzi: folds 
Kukuryzka: folds 
KLOP06031987: folds 
Uncalled bet ($2) returned to Kosh20
Kosh20 collected $2.50 from pot
Kosh20: doesn't show hand 
*** SUMMARY ***
Total pot $2.50 | Rake $0 
Seat 1: Celsinho0311 folded before Flop (didn't bet)
Seat 2: Dante63s folded before Flop (didn't bet)
Seat 3: Filojoes folded before Flop (didn't bet)
Seat 4: matiko09 folded before Flop (didn't bet)
Seat 5: ilaviiitech folded before Flop (didn't bet)
Seat 6: Kosh20 collected ($2.50)
Seat 7: flozzi (button) folded before Flop (didn't bet)
Seat 8: Kukuryzka (small blind) folded before Flop
Seat 9: KLOP06031987 (big blind) folded before Flop





PokerStars Hand #147707387643:  Hold'em No Limit ($0.50/$1.00 USD) - 2016/01/26 15:54:44 CET [2016/01/26 9:54:44 ET]
Table 'Achates III' 9-max Seat #1 is the button
Seat 1: CI58 ($100 in chips) 
Seat 2: matiko09 ($100 in chips) 
Seat 3: Jimy Tiltman ($100.02 in chips) 
Seat 4: cn_chayanne ($110.26 in chips) 
Seat 5: Sweden_Pound ($221.79 in chips) 
Seat 7: KLOP06031987 ($100 in chips) 
Seat 8: Männerzimmer ($188.61 in chips) 
Seat 9: T-chaos_IMBA ($332.42 in chips) 
matiko09: posts small blind $0.50
Jimy Tiltman: posts big blind $1
Kukuryzka: sits out 
*** HOLE CARDS ***
Dealt to matiko09 [7s Kc]
cn_chayanne: raises $1.50 to $2.50
Sweden_Pound: folds 
KLOP06031987: folds 
Männerzimmer: calls $2.50
T-chaos_IMBA: folds 
CI58: folds 
matiko09: folds 
Jimy Tiltman: folds 
*** FLOP *** [2c 8s 9d]
cn_chayanne: checks 
Männerzimmer: bets $3
cn_chayanne: calls $3
*** TURN *** [2c 8s 9d] [7c]
cn_chayanne: checks 
Männerzimmer: bets $4
cn_chayanne: calls $4
*** RIVER *** [2c 8s 9d 7c] [7d]
cn_chayanne: checks 
Männerzimmer: checks 
*** SHOW DOWN ***
cn_chayanne: shows [Ac Kd] (a pair of Sevens)
Männerzimmer: shows [Td 8h] (two pair, Eights and Sevens)
Männerzimmer collected $19.58 from pot
*** SUMMARY ***
Total pot $20.50 | Rake $0.92 
Board [2c 8s 9d 7c 7d]
Seat 1: CI58 (button) folded before Flop (didn't bet)
Seat 2: matiko09 (small blind) folded before Flop
Seat 3: Jimy Tiltman (big blind) folded before Flop
Seat 4: cn_chayanne showed [Ac Kd] and lost with a pair of Sevens
Seat 5: Sweden_Pound folded before Flop (didn't bet)
Seat 7: KLOP06031987 folded before Flop (didn't bet)
Seat 8: Männerzimmer showed [Td 8h] and won ($19.58) with two pair, Eights and Sevens
Seat 9: T-chaos_IMBA folded before Flop (didn't bet)





PokerStars Hand #147707391443:  Hold'em No Limit ($0.50/$1.00 USD) - 2016/01/26 15:54:49 CET [2016/01/26 9:54:49 ET]
Table 'Strenua III' 9-max Seat #8 is the button
Seat 1: ICallSaul ($100 in chips) 
Seat 2: cn_chayanne ($100 in chips) 
Seat 3: petalouda10 ($89.44 in chips) 
Seat 4: mycka86 ($101.50 in chips) 
Seat 5: DeWeijz ($38.50 in chips) 
Seat 6: matiko09 ($143.84 in chips) 
Seat 7: KLOP06031987 ($101 in chips) 
Seat 8: Filojoes ($100 in chips) 
Seat 9: Dante63s ($100 in chips) 
Dante63s: posts small blind $0.50
ICallSaul: posts big blind $1
*** HOLE CARDS ***
Dealt to matiko09 [4h Qd]
cn_chayanne: folds 
petalouda10: folds 
mycka86: raises $1.50 to $2.50
DeWeijz: folds 
matiko09: folds 
KLOP06031987: calls $2.50
Filojoes: folds 
Dante63s: folds 
ICallSaul: calls $1.50
*** FLOP *** [5d 4d As]
ICallSaul: checks 
mycka86: checks 
KLOP06031987: bets $4
ICallSaul: calls $4
mycka86: folds 
*** TURN *** [5d 4d As] [9s]
ICallSaul: checks 
KLOP06031987: checks 
*** RIVER *** [5d 4d As 9s] [8h]
ICallSaul: bets $7
KLOP06031987: folds 
Uncalled bet ($7) returned to ICallSaul
ICallSaul collected $15.28 from pot
*** SUMMARY ***
Total pot $16 | Rake $0.72 
Board [5d 4d As 9s 8h]
Seat 1: ICallSaul (big blind) collected ($15.28)
Seat 2: cn_chayanne folded before Flop (didn't bet)
Seat 3: petalouda10 folded before Flop (didn't bet)
Seat 4: mycka86 folded on the Flop
Seat 5: DeWeijz folded before Flop (didn't bet)
Seat 6: matiko09 folded before Flop (didn't bet)
Seat 7: KLOP06031987 folded on the River
Seat 8: Filojoes (button) folded before Flop (didn't bet)
Seat 9: Dante63s (small blind) folded before Flop





PokerStars Hand #147707399512:  Hold'em No Limit ($0.50/$1.00 USD) - 2016/01/26 15:55:00 CET [2016/01/26 9:55:00 ET]
Table 'Gyas IV' 9-max Seat #5 is the button
Seat 1: sharkside90 ($39.90 in chips) 
Seat 2: Dante63s ($119.54 in chips) 
Seat 5: matiko09 ($106.68 in chips) 
Seat 6: Filojoes ($100 in chips) 
Seat 7: mycka86 ($100 in chips) 
Seat 8: Peu3aHy ($148.59 in chips) 
Seat 9: Sweden_Pound ($127 in chips) 
Filojoes: posts small blind $0.50
mycka86: posts big blind $1
*** HOLE CARDS ***
Dealt to matiko09 [9s Qh]
Peu3aHy: folds 
Sweden_Pound: folds 
sharkside90: folds 
Dante63s: folds 
matiko09: raises $1.27 to $2.27
Filojoes: folds 
mycka86: folds 
Uncalled bet ($1.27) returned to matiko09
matiko09 collected $2.50 from pot
matiko09: doesn't show hand 
*** SUMMARY ***
Total pot $2.50 | Rake $0 
Seat 1: sharkside90 folded before Flop (didn't bet)
Seat 2: Dante63s folded before Flop (didn't bet)
Seat 5: matiko09 (button) collected ($2.50)
Seat 6: Filojoes (small blind) folded before Flop
Seat 7: mycka86 (big blind) folded before Flop
Seat 8: Peu3aHy folded before Flop (didn't bet)
Seat 9: Sweden_Pound folded before Flop (didn't bet)





PokerStars Hand #147707407277:  Hold'em No Limit ($0.50/$1.00 USD) - 2016/01/26 15:55:13 CET [2016/01/26 9:55:13 ET]
Table 'Montefiore' 9-max Seat #8 is the button
Seat 1: Celsinho0311 ($34.15 in chips) 
Seat 2: Dante63s ($104.08 in chips) 
Seat 3: Filojoes ($100 in chips) 
Seat 4: matiko09 ($108.05 in chips) 
Seat 5: ilaviiitech ($100 in chips) 
Seat 6: Kosh20 ($56.24 in chips) 
Seat 7: flozzi ($100 in chips) 
Seat 8: Kukuryzka ($100 in chips) 
Seat 9: KLOP06031987 ($100 in chips) 
KLOP06031987: posts small blind $0.50
Celsinho0311: posts big blind $1
*** HOLE CARDS ***
Dealt to matiko09 [Qh 3d]
Dante63s: raises $2 to $3
Filojoes: folds 
matiko09: folds 
ilaviiitech: folds 
Kosh20: calls $3
flozzi: folds 
Kukuryzka: folds 
KLOP06031987: folds 
Celsinho0311: raises $5.88 to $8.88
Dante63s: calls $5.88
Kosh20: calls $5.88
*** FLOP *** [Ts Jh 2h]
Celsinho0311: bets $25.27 and is all-in
Dante63s: folds 
Kosh20: folds 
Uncalled bet ($25.27) returned to Celsinho0311
Celsinho0311 collected $25.92 from pot
Celsinho0311: doesn't show hand 
*** SUMMARY ***
Total pot $27.14 | Rake $1.22 
Board [Ts Jh 2h]
Seat 1: Celsinho0311 (big blind) collected ($25.92)
Seat 2: Dante63s folded on the Flop
Seat 3: Filojoes folded before Flop (didn't bet)
Seat 4: matiko09 folded before Flop (didn't bet)
Seat 5: ilaviiitech folded before Flop (didn't bet)
Seat 6: Kosh20 folded on the Flop
Seat 7: flozzi folded before Flop (didn't bet)
Seat 8: Kukuryzka (button) folded before Flop (didn't bet)
Seat 9: KLOP06031987 (small blind) folded before Flop





PokerStars Hand #147707410536:  Hold'em No Limit ($0.50/$1.00 USD) - 2016/01/26 15:55:18 CET [2016/01/26 9:55:18 ET]
Table 'Haedus' 9-max Seat #4 is the button
Seat 1: Dante63s ($119.50 in chips) 
Seat 2: Sweden_Pound ($100 in chips) 
Seat 3: cn_chayanne ($106.87 in chips) 
Seat 4: FroggyPlay ($100 in chips) 
Seat 5: matiko09 ($100.50 in chips) 
Seat 6: nnne409 ($72.29 in chips) 
Seat 7: KLOP06031987 ($106 in chips) 
matiko09: posts small blind $0.50
nnne409: posts big blind $1
Jimy Tiltman: sits out 
Filojoes: sits out 
*** HOLE CARDS ***
Dealt to matiko09 [5d Jc]
KLOP06031987: folds 
Dante63s: folds 
Sweden_Pound: folds 
cn_chayanne: folds 
FroggyPlay: raises $1 to $2
matiko09: folds 
nnne409: calls $1
*** FLOP *** [8h 6d 7h]
nnne409: checks 
FroggyPlay: bets $3.22
nnne409: calls $3.22
*** TURN *** [8h 6d 7h] [8s]
nnne409: bets $4
FroggyPlay: calls $4
*** RIVER *** [8h 6d 7h 8s] [3h]
nnne409: checks 
FroggyPlay: bets $20
nnne409: folds 
Uncalled bet ($20) returned to FroggyPlay
FroggyPlay collected $18.09 from pot
FroggyPlay: doesn't show hand 
*** SUMMARY ***
Total pot $18.94 | Rake $0.85 
Board [8h 6d 7h 8s 3h]
Seat 1: Dante63s folded before Flop (didn't bet)
Seat 2: Sweden_Pound folded before Flop (didn't bet)
Seat 3: cn_chayanne folded before Flop (didn't bet)
Seat 4: FroggyPlay (button) collected ($18.09)
Seat 5: matiko09 (small blind) folded before Flop
Seat 6: nnne409 (big blind) folded on the River
Seat 7: KLOP06031987 folded before Flop (didn't bet)





PokerStars Hand #147707418583:  Hold'em No Limit ($0.50/$1.00 USD) - 2016/01/26 15:55:32 CET [2016/01/26 9:55:32 ET]
Table 'Gyas IV' 9-max Seat #6 is the button
Seat 1: sharkside90 ($39.90 in chips) 
Seat 2: Dante63s ($119.54 in chips) 
Seat 5: matiko09 ($108.18 in chips) 
Seat 6: Filojoes ($100 in chips) 
Seat 7: mycka86 ($100 in chips) 
Seat 9: Sweden_Pound ($127 in chips) 
mycka86: posts small blind $0.50
Peu3aHy: is sitting out 
Sweden_Pound: posts big blind $1
*** HOLE CARDS ***
Dealt to matiko09 [3h 8h]
Peu3aHy leaves the table
sharkside90: calls $1
Dante63s: folds 
matiko09: folds 
Filojoes: folds 
mycka86: raises $3.50 to $4.50
Sweden_Pound: calls $3.50
sharkside90: calls $3.50
*** FLOP *** [2c Qc 8s]
solbi86 joins the table at seat #3 
mycka86: checks 
Sweden_Pound: checks 
sharkside90: checks 
*** TURN *** [2c Qc 8s] [7c]
mycka86: checks 
Sweden_Pound: checks 
sharkside90: checks 
*** RIVER *** [2c Qc 8s 7c] [3c]
mycka86: checks 
changpiao joins the table at seat #8 
Sweden_Pound: checks 
sharkside90: bets $2.50
mycka86: folds 
Sweden_Pound: folds 
Uncalled bet ($2.50) returned to sharkside90
sharkside90 collected $12.89 from pot
*** SUMMARY ***
Total pot $13.50 | Rake $0.61 
Board [2c Qc 8s 7c 3c]
Seat 1: sharkside90 collected ($12.89)
Seat 2: Dante63s folded before Flop (didn't bet)
Seat 5: matiko09 folded before Flop (didn't bet)
Seat 6: Filojoes (button) folded before Flop (didn't bet)
Seat 7: mycka86 (small blind) folded on the River
Seat 9: Sweden_Pound (big blind) folded on the River





PokerStars Hand #147707423292:  Hold'em No Limit ($0.50/$1.00 USD) - 2016/01/26 15:55:40 CET [2016/01/26 9:55:40 ET]
Table 'Mashona' 9-max Seat #8 is the button
Seat 1: maxxmeister ($100 in chips) 
Seat 2: werades ($198.42 in chips) 
Seat 3: matiko09 ($125.07 in chips) 
Seat 4: Sweden_Pound ($152.56 in chips) 
Seat 5: KLOP06031987 ($101.56 in chips) 
Seat 7: EB0LARAMA ($209.68 in chips) 
Seat 8: Jimy Tiltman ($177.16 in chips) 
apfush will be allowed to play after the button
maxxmeister: posts small blind $0.50
werades: posts big blind $1
Filojoes: sits out 
*** HOLE CARDS ***
Dealt to matiko09 [Ks 5d]
matiko09: folds 
Sweden_Pound: folds 
KLOP06031987: folds 
EB0LARAMA: folds 
Jimy Tiltman: folds 
maxxmeister: raises $2.50 to $3.50
werades: calls $2.50
*** FLOP *** [7s Ac Kh]
maxxmeister: checks 
werades: checks 
*** TURN *** [7s Ac Kh] [2h]
maxxmeister: checks 
werades: bets $3.13
maxxmeister: folds 
Uncalled bet ($3.13) returned to werades
werades collected $6.68 from pot
werades: doesn't show hand 
*** SUMMARY ***
Total pot $7 | Rake $0.32 
Board [7s Ac Kh 2h]
Seat 1: maxxmeister (small blind) folded on the Turn
Seat 2: werades (big blind) collected ($6.68)
Seat 3: matiko09 folded before Flop (didn't bet)
Seat 4: Sweden_Pound folded before Flop (didn't bet)
Seat 5: KLOP06031987 folded before Flop (didn't bet)
Seat 7: EB0LARAMA folded before Flop (didn't bet)
Seat 8: Jimy Tiltman (button) folded before Flop (didn't bet)





PokerStars Hand #147707427036:  Hold'em No Limit ($0.50/$1.00 USD) - 2016/01/26 15:55:46 CET [2016/01/26 9:55:46 ET]
Table 'Impala' 9-max Seat #3 is the button
Seat 1: mycka86 ($133.71 in chips) 
Seat 2: Filojoes ($100 in chips) 
Seat 3: Dante63s ($102.50 in chips) 
Seat 4: KLOP06031987 ($100 in chips) 
Seat 5: Kukuryzka ($100 in chips) 
Seat 6: Tijger R.d.J ($68.40 in chips) 
Seat 7: matiko09 ($126.65 in chips) 
Seat 8: Peu3aHy ($100 in chips) 
Seat 9: flozzi ($100 in chips) 
KLOP06031987: posts small blind $0.50
Kukuryzka: posts big blind $1
*** HOLE CARDS ***
Dealt to matiko09 [4s 8s]
Tijger R.d.J: raises $1 to $2
matiko09: folds 
Peu3aHy: folds 
flozzi: folds 
mycka86: folds 
Filojoes: raises $5 to $7
Dante63s: folds 
KLOP06031987: folds 
Kukuryzka: folds 
Tijger R.d.J: raises $8 to $15
Filojoes: folds 
Uncalled bet ($8) returned to Tijger R.d.J
Tijger R.d.J collected $15.50 from pot
Tijger R.d.J: doesn't show hand 
*** SUMMARY ***
Total pot $15.50 | Rake $0 
Seat 1: mycka86 folded before Flop (didn't bet)
Seat 2: Filojoes folded before Flop
Seat 3: Dante63s (button) folded before Flop (didn't bet)
Seat 4: KLOP06031987 (small blind) folded before Flop
Seat 5: Kukuryzka (big blind) folded before Flop
Seat 6: Tijger R.d.J collected ($15.50)
Seat 7: matiko09 folded before Flop (didn't bet)
Seat 8: Peu3aHy folded before Flop (didn't bet)
Seat 9: flozzi folded before Flop (didn't bet)





PokerStars Hand #147707436983:  Hold'em No Limit ($0.50/$1.00 USD) - 2016/01/26 15:56:03 CET [2016/01/26 9:56:03 ET]
Table 'Achates III' 9-max Seat #2 is the button
Seat 1: CI58 ($100 in chips) 
Seat 2: matiko09 ($100 in chips) 
Seat 3: Jimy Tiltman ($100 in chips) 
Seat 5: Sweden_Pound ($221.79 in chips) 
Seat 7: KLOP06031987 ($100 in chips) 
Seat 8: Männerzimmer ($198.69 in chips) 
Seat 9: T-chaos_IMBA ($332.42 in chips) 
Jimy Tiltman: posts small blind $0.50
cn_chayanne: is sitting out 
Sweden_Pound: posts big blind $1
Kukuryzka: sits out 
*** HOLE CARDS ***
Dealt to matiko09 [4s 2c]
KLOP06031987: folds 
Männerzimmer: calls $1
T-chaos_IMBA: folds 
CI58: folds 
matiko09: folds 
Jimy Tiltman: calls $0.50
Sweden_Pound: checks 
*** FLOP *** [Td 6c 8h]
Jimy Tiltman: checks 
Sweden_Pound: checks 
Männerzimmer: bets $3
Jimy Tiltman: folds 
Sweden_Pound: folds 
Uncalled bet ($3) returned to Männerzimmer
Männerzimmer collected $2.86 from pot
Männerzimmer: doesn't show hand 
*** SUMMARY ***
Total pot $3 | Rake $0.14 
Board [Td 6c 8h]
Seat 1: CI58 folded before Flop (didn't bet)
Seat 2: matiko09 (button) folded before Flop (didn't bet)
Seat 3: Jimy Tiltman (small blind) folded on the Flop
Seat 5: Sweden_Pound (big blind) folded on the Flop
Seat 7: KLOP06031987 folded before Flop (didn't bet)
Seat 8: Männerzimmer collected ($2.86)
Seat 9: T-chaos_IMBA folded before Flop (didn't bet)





PokerStars Hand #147707440862:  Hold'em No Limit ($0.50/$1.00 USD) - 2016/01/26 15:56:09 CET [2016/01/26 9:56:09 ET]
Table 'Kale II' 9-max Seat #9 is the button
Seat 1: lootstool ($73.44 in chips) 
Seat 2: matiko09 ($100 in chips) 
Seat 3: Reven9er ($128.70 in chips) 
Seat 4: Jimy Tiltman ($196.57 in chips) 
Seat 5: Dante63s ($100 in chips) 
Seat 6: Filojoes ($121 in chips) 
Seat 8: mycka86 ($100 in chips) 
Seat 9: Sweden_Pound ($129.78 in chips) 
lootstool: posts small blind $0.50
matiko09: posts big blind $1
Kukuryzka: sits out 
*** HOLE CARDS ***
Dealt to matiko09 [3s Ks]
Reven9er: folds 
Jimy Tiltman: folds 
Dante63s: raises $1.50 to $2.50
Filojoes: folds 
mycka86: folds 
Sweden_Pound: folds 
lootstool: folds 
matiko09: folds 
Uncalled bet ($1.50) returned to Dante63s
Dante63s collected $2.50 from pot
Dante63s: doesn't show hand 
*** SUMMARY ***
Total pot $2.50 | Rake $0 
Seat 1: lootstool (small blind) folded before Flop
Seat 2: matiko09 (big blind) folded before Flop
Seat 3: Reven9er folded before Flop (didn't bet)
Seat 4: Jimy Tiltman folded before Flop (didn't bet)
Seat 5: Dante63s collected ($2.50)
Seat 6: Filojoes folded before Flop (didn't bet)
Seat 8: mycka86 folded before Flop (didn't bet)
Seat 9: Sweden_Pound (button) folded before Flop (didn't bet)





PokerStars Hand #147707440895:  Hold'em No Limit ($0.50/$1.00 USD) - 2016/01/26 15:56:09 CET [2016/01/26 9:56:09 ET]
Table 'Calypso II' 9-max Seat #9 is the button
Seat 2: Hardwell1993 ($98 in chips) 
Seat 3: matiko09 ($219.25 in chips) 
Seat 4: Sweden_Pound ($115.29 in chips) 
Seat 5: mycka86 ($100 in chips) 
Seat 6: MrDeeee25 ($100 in chips) 
Seat 7: Jimy Tiltman ($101 in chips) 
Seat 8: Reven9er ($107.89 in chips) 
Seat 9: Filojoes ($160.43 in chips) 
Hardwell1993: posts small blind $0.50
matiko09: posts big blind $1
*** HOLE CARDS ***
Dealt to matiko09 [5h Jd]
Sweden_Pound: folds 
mycka86: raises $2 to $3
MrDeeee25: folds 
Jimy Tiltman: folds 
Reven9er: folds 
Filojoes: folds 
Hardwell1993: folds 
matiko09: folds 
Uncalled bet ($2) returned to mycka86
mycka86 collected $2.50 from pot
*** SUMMARY ***
Total pot $2.50 | Rake $0 
Seat 2: Hardwell1993 (small blind) folded before Flop
Seat 3: matiko09 (big blind) folded before Flop
Seat 4: Sweden_Pound folded before Flop (didn't bet)
Seat 5: mycka86 collected ($2.50)
Seat 6: MrDeeee25 folded before Flop (didn't bet)
Seat 7: Jimy Tiltman folded before Flop (didn't bet)
Seat 8: Reven9er folded before Flop (didn't bet)
Seat 9: Filojoes (button) folded before Flop (didn't bet)





PokerStars Hand #147707441200:  Hold'em No Limit ($0.50/$1.00 USD) - 2016/01/26 15:56:10 CET [2016/01/26 9:56:10 ET]
Table 'Heike II' 9-max Seat #6 is the button
Seat 1: ilaviiitech ($121.51 in chips) 
Seat 2: Dante63s ($112.48 in chips) 
Seat 3: matiko09 ($127.32 in chips) 
Seat 4: Reven9er ($112.28 in chips) 
Seat 5: Sweden_Pound ($100 in chips) 
Seat 6: H8fulM0n ($127 in chips) 
Seat 7: Momess ($100 in chips) 
Seat 8: THE RIPPER V ($52.95 in chips) 
Seat 9: uonlylive1ce ($142.45 in chips) 
Momess: posts small blind $0.50
THE RIPPER V: posts big blind $1
*** HOLE CARDS ***
Dealt to matiko09 [8h Ah]
uonlylive1ce: folds 
ilaviiitech: folds 
Dante63s: folds 
matiko09: raises $2 to $3
Reven9er: calls $3
Sweden_Pound: folds 
H8fulM0n: folds 
Momess: folds 
THE RIPPER V: folds 
*** FLOP *** [9d 7d 9c]
H8fulM0n is disconnected 
matiko09: checks 
Reven9er: checks 
*** TURN *** [9d 7d 9c] [5s]
matiko09: bets $4.65
Reven9er: calls $4.65
*** RIVER *** [9d 7d 9c 5s] [2h]
matiko09: checks 
Reven9er: checks 
*** SHOW DOWN ***
matiko09: shows [8h Ah] (a pair of Nines)
Reven9er: shows [6s 6c] (two pair, Nines and Sixes)
Reven9er collected $16.04 from pot
*** SUMMARY ***
Total pot $16.80 | Rake $0.76 
Board [9d 7d 9c 5s 2h]
Seat 1: ilaviiitech folded before Flop (didn't bet)
Seat 2: Dante63s folded before Flop (didn't bet)
Seat 3: matiko09 showed [8h Ah] and lost with a pair of Nines
Seat 4: Reven9er showed [6s 6c] and won ($16.04) with two pair, Nines and Sixes
Seat 5: Sweden_Pound folded before Flop (didn't bet)
Seat 6: H8fulM0n (button) folded before Flop (didn't bet)
Seat 7: Momess (small blind) folded before Flop
Seat 8: THE RIPPER V (big blind) folded before Flop
Seat 9: uonlylive1ce folded before Flop (didn't bet)





PokerStars Hand #147707447493:  Hold'em No Limit ($0.50/$1.00 USD) - 2016/01/26 15:56:20 CET [2016/01/26 9:56:20 ET]
Table 'Strenua III' 9-max Seat #9 is the button
Seat 1: ICallSaul ($108.78 in chips) 
Seat 3: petalouda10 ($89.44 in chips) 
Seat 4: mycka86 ($100 in chips) 
Seat 5: DeWeijz ($38.50 in chips) 
Seat 6: matiko09 ($143.84 in chips) 
Seat 7: KLOP06031987 ($100 in chips) 
Seat 8: Filojoes ($100 in chips) 
Seat 9: Dante63s ($100 in chips) 
ICallSaul: posts small blind $0.50
petalouda10: posts big blind $1
*** HOLE CARDS ***
Dealt to matiko09 [Js 6c]
mycka86: raises $2 to $3
DeWeijz: folds 
matiko09: folds 
KLOP06031987: folds 
Filojoes: folds 
Dante63s: folds 
ICallSaul: folds 
petalouda10: calls $2
*** FLOP *** [Ts 6s 7d]
petalouda10: checks 
mycka86: bets $4.84
petalouda10: calls $4.84
*** TURN *** [Ts 6s 7d] [Qs]
petalouda10: checks 
mycka86: checks 
*** RIVER *** [Ts 6s 7d Qs] [3c]
petalouda10: bets $15.45
mycka86: calls $15.45
*** SHOW DOWN ***
petalouda10: shows [9c Jh] (high card Queen)
mycka86: shows [Ks Kc] (a pair of Kings)
mycka86 collected $44.96 from pot
*** SUMMARY ***
Total pot $47.08 | Rake $2.12 
Board [Ts 6s 7d Qs 3c]
Seat 1: ICallSaul (small blind) folded before Flop
Seat 3: petalouda10 (big blind) showed [9c Jh] and lost with high card Queen
Seat 4: mycka86 showed [Ks Kc] and won ($44.96) with a pair of Kings
Seat 5: DeWeijz folded before Flop (didn't bet)
Seat 6: matiko09 folded before Flop (didn't bet)
Seat 7: KLOP06031987 folded before Flop (didn't bet)
Seat 8: Filojoes folded before Flop (didn't bet)
Seat 9: Dante63s (button) folded before Flop (didn't bet)





PokerStars Hand #147707457967:  Hold'em No Limit ($0.50/$1.00 USD) - 2016/01/26 15:56:37 CET [2016/01/26 9:56:37 ET]
Table 'Mashona' 9-max Seat #1 is the button
Seat 1: maxxmeister ($100 in chips) 
Seat 2: werades ($201.60 in chips) 
Seat 3: matiko09 ($125.07 in chips) 
Seat 4: Sweden_Pound ($152.56 in chips) 
Seat 5: KLOP06031987 ($101.56 in chips) 
Seat 7: EB0LARAMA ($209.68 in chips) 
Seat 8: Jimy Tiltman ($177.16 in chips) 
werades: posts small blind $0.50
matiko09: posts big blind $1
Filojoes: sits out 
apfush: sits out 
*** HOLE CARDS ***
Dealt to matiko09 [9c 2h]
Sweden_Pound: folds 
KLOP06031987: raises $1.31 to $2.31
EB0LARAMA: calls $2.31
Jimy Tiltman: folds 
maxxmeister: folds 
werades: folds 
matiko09: folds 
*** FLOP *** [5c 7h Jd]
KLOP06031987: bets $4.08
EB0LARAMA: folds 
Uncalled bet ($4.08) returned to KLOP06031987
KLOP06031987 collected $5.84 from pot
KLOP06031987: doesn't show hand 
*** SUMMARY ***
Total pot $6.12 | Rake $0.28 
Board [5c 7h Jd]
Seat 1: maxxmeister (button) folded before Flop (didn't bet)
Seat 2: werades (small blind) folded before Flop
Seat 3: matiko09 (big blind) folded before Flop
Seat 4: Sweden_Pound folded before Flop (didn't bet)
Seat 5: KLOP06031987 collected ($5.84)
Seat 7: EB0LARAMA folded on the Flop
Seat 8: Jimy Tiltman folded before Flop (didn't bet)





PokerStars Hand #147707459041:  Hold'em No Limit ($0.50/$1.00 USD) - 2016/01/26 15:56:39 CET [2016/01/26 9:56:39 ET]
Table 'Impala' 9-max Seat #4 is the button
Seat 1: mycka86 ($133.71 in chips) 
Seat 2: Filojoes ($100 in chips) 
Seat 3: Dante63s ($102.50 in chips) 
Seat 4: KLOP06031987 ($100 in chips) 
Seat 5: Kukuryzka ($99 in chips) 
Seat 6: Tijger R.d.J ($76.90 in chips) 
Seat 7: matiko09 ($126.65 in chips) 
Seat 8: Peu3aHy ($100 in chips) 
Seat 9: flozzi ($100 in chips) 
Kukuryzka: posts small blind $0.50
Tijger R.d.J: posts big blind $1
*** HOLE CARDS ***
Dealt to matiko09 [7h 6c]
matiko09: folds 
Peu3aHy: folds 
flozzi: folds 
mycka86: folds 
Filojoes: raises $2 to $3
Dante63s: folds 
KLOP06031987: folds 
Kukuryzka: folds 
Tijger R.d.J: calls $2
*** FLOP *** [5s Qh 6s]
Tijger R.d.J: checks 
Filojoes: bets $4
Tijger R.d.J: raises $4 to $8
Filojoes: calls $4
*** TURN *** [5s Qh 6s] [Jh]
Tijger R.d.J: checks 
Filojoes: checks 
*** RIVER *** [5s Qh 6s Jh] [2h]
Tijger R.d.J: bets $12
Filojoes: calls $12
*** SHOW DOWN ***
Tijger R.d.J: shows [Qc 5d] (two pair, Queens and Fives)
Filojoes: mucks hand 
Tijger R.d.J collected $44.41 from pot
*** SUMMARY ***
Total pot $46.50 | Rake $2.09 
Board [5s Qh 6s Jh 2h]
Seat 1: mycka86 folded before Flop (didn't bet)
Seat 2: Filojoes mucked [As Ac]
Seat 3: Dante63s folded before Flop (didn't bet)
Seat 4: KLOP06031987 (button) folded before Flop (didn't bet)
Seat 5: Kukuryzka (small blind) folded before Flop
Seat 6: Tijger R.d.J (big blind) showed [Qc 5d] and won ($44.41) with two pair, Queens and Fives
Seat 7: matiko09 folded before Flop (didn't bet)
Seat 8: Peu3aHy folded before Flop (didn't bet)
Seat 9: flozzi folded before Flop (didn't bet)





PokerStars Hand #147707459570:  Hold'em No Limit ($0.50/$1.00 USD) - 2016/01/26 15:56:40 CET [2016/01/26 9:56:40 ET]
Table 'Montefiore' 9-max Seat #9 is the button
Seat 1: Celsinho0311 ($51.19 in chips) 
Seat 2: Dante63s ($100 in chips) 
Seat 3: Filojoes ($100 in chips) 
Seat 4: matiko09 ($108.05 in chips) 
Seat 5: ilaviiitech ($100 in chips) 
Seat 6: Kosh20 ($47.36 in chips) 
Seat 7: flozzi ($100 in chips) 
Seat 8: Kukuryzka ($100 in chips) 
Seat 9: KLOP06031987 ($100 in chips) 
Celsinho0311: posts small blind $0.50
Dante63s: posts big blind $1
*** HOLE CARDS ***
Dealt to matiko09 [2d Ts]
Filojoes: folds 
matiko09: folds 
ilaviiitech: raises $2 to $3
Kosh20: calls $3
flozzi: folds 
Kukuryzka: folds 
KLOP06031987: folds 
Celsinho0311: raises $48.19 to $51.19 and is all-in
Dante63s: folds 
ilaviiitech: folds 
Kosh20: folds 
Uncalled bet ($48.19) returned to Celsinho0311
Celsinho0311 collected $10 from pot
Celsinho0311: doesn't show hand 
*** SUMMARY ***
Total pot $10 | Rake $0 
Seat 1: Celsinho0311 (small blind) collected ($10)
Seat 2: Dante63s (big blind) folded before Flop
Seat 3: Filojoes folded before Flop (didn't bet)
Seat 4: matiko09 folded before Flop (didn't bet)
Seat 5: ilaviiitech folded before Flop
Seat 6: Kosh20 folded before Flop
Seat 7: flozzi folded before Flop (didn't bet)
Seat 8: Kukuryzka folded before Flop (didn't bet)
Seat 9: KLOP06031987 (button) folded before Flop (didn't bet)





PokerStars Hand #147707461873:  Hold'em No Limit ($0.50/$1.00 USD) - 2016/01/26 15:56:43 CET [2016/01/26 9:56:43 ET]
Table 'Calypso II' 9-max Seat #2 is the button
Seat 2: Hardwell1993 ($97.50 in chips) 
Seat 3: matiko09 ($218.25 in chips) 
Seat 4: Sweden_Pound ($115.29 in chips) 
Seat 5: mycka86 ($101.50 in chips) 
Seat 6: MrDeeee25 ($100 in chips) 
Seat 7: Jimy Tiltman ($101 in chips) 
Seat 8: Reven9er ($107.89 in chips) 
Seat 9: Filojoes ($160.43 in chips) 
matiko09: posts small blind $0.50
Sweden_Pound: posts big blind $1
*** HOLE CARDS ***
Dealt to matiko09 [2c Kh]
mycka86: folds 
MrDeeee25: folds 
Jimy Tiltman: folds 
Reven9er: raises $1 to $2
Filojoes: folds 
Hardwell1993: folds 
matiko09: folds 
Sweden_Pound: folds 
Uncalled bet ($1) returned to Reven9er
Reven9er collected $2.50 from pot
Reven9er: doesn't show hand 
*** SUMMARY ***
Total pot $2.50 | Rake $0 
Seat 2: Hardwell1993 (button) folded before Flop (didn't bet)
Seat 3: matiko09 (small blind) folded before Flop
Seat 4: Sweden_Pound (big blind) folded before Flop
Seat 5: mycka86 folded before Flop (didn't bet)
Seat 6: MrDeeee25 folded before Flop (didn't bet)
Seat 7: Jimy Tiltman folded before Flop (didn't bet)
Seat 8: Reven9er collected ($2.50)
Seat 9: Filojoes folded before Flop (didn't bet)





PokerStars Hand #147707464134:  Hold'em No Limit ($0.50/$1.00 USD) - 2016/01/26 15:56:47 CET [2016/01/26 9:56:47 ET]
Table 'Achates III' 9-max Seat #3 is the button
Seat 1: CI58 ($100 in chips) 
Seat 2: matiko09 ($100 in chips) 
Seat 3: Jimy Tiltman ($100 in chips) 
Seat 5: Sweden_Pound ($220.79 in chips) 
Seat 6: Kukuryzka ($100 in chips) 
Seat 7: KLOP06031987 ($100 in chips) 
Seat 8: Männerzimmer ($200.55 in chips) 
Seat 9: T-chaos_IMBA ($332.42 in chips) 
Sweden_Pound: posts small blind $0.50
Kukuryzka: posts big blind $1
*** HOLE CARDS ***
Dealt to matiko09 [9h Th]
KLOP06031987: folds 
Männerzimmer: calls $1
T-chaos_IMBA: folds 
CI58: folds 
matiko09: raises $4 to $5
Jimy Tiltman: folds 
Sweden_Pound: folds 
Kukuryzka: folds 
Männerzimmer: calls $4
*** FLOP *** [2h Jd 9d]
Männerzimmer: checks 
matiko09: bets $6
Männerzimmer: calls $6
*** TURN *** [2h Jd 9d] [2s]
Männerzimmer: checks 
matiko09: bets $11
Männerzimmer: calls $11
*** RIVER *** [2h Jd 9d 2s] [5d]
Männerzimmer: checks 
matiko09: checks 
*** SHOW DOWN ***
Männerzimmer: shows [8d Jh] (two pair, Jacks and Deuces)
matiko09: mucks hand 
Männerzimmer collected $43.45 from pot
*** SUMMARY ***
Total pot $45.50 | Rake $2.05 
Board [2h Jd 9d 2s 5d]
Seat 1: CI58 folded before Flop (didn't bet)
Seat 2: matiko09 mucked [9h Th]
Seat 3: Jimy Tiltman (button) folded before Flop (didn't bet)
Seat 5: Sweden_Pound (small blind) folded before Flop
Seat 6: Kukuryzka (big blind) folded before Flop
Seat 7: KLOP06031987 folded before Flop (didn't bet)
Seat 8: Männerzimmer showed [8d Jh] and won ($43.45) with two pair, Jacks and Deuces
Seat 9: T-chaos_IMBA folded before Flop (didn't bet)





PokerStars Hand #147707470452:  Hold'em No Limit ($0.50/$1.00 USD) - 2016/01/26 15:56:58 CET [2016/01/26 9:56:58 ET]
Table 'Kale II' 9-max Seat #1 is the button
Seat 1: lootstool ($72.94 in chips) 
Seat 2: matiko09 ($100 in chips) 
Seat 3: Reven9er ($128.70 in chips) 
Seat 4: Jimy Tiltman ($196.57 in chips) 
Seat 5: Dante63s ($101.50 in chips) 
Seat 6: Filojoes ($121 in chips) 
Seat 8: mycka86 ($100 in chips) 
Seat 9: Sweden_Pound ($129.78 in chips) 
matiko09: posts small blind $0.50
Reven9er: posts big blind $1
Kukuryzka: sits out 
*** HOLE CARDS ***
Dealt to matiko09 [Tc 3c]
Jimy Tiltman: folds 
Dante63s: raises $2 to $3
Filojoes: folds 
mycka86: folds 
Sweden_Pound: folds 
lootstool: calls $3
matiko09: folds 
Reven9er: folds 
*** FLOP *** [Ad 8d 2s]
Dante63s: bets $4.50
lootstool: calls $4.50
*** TURN *** [Ad 8d 2s] [5d]
Dante63s: checks 
lootstool: bets $7.88
Dante63s: folds 
Uncalled bet ($7.88) returned to lootstool
lootstool collected $15.76 from pot
lootstool: doesn't show hand 
*** SUMMARY ***
Total pot $16.50 | Rake $0.74 
Board [Ad 8d 2s 5d]
Seat 1: lootstool (button) collected ($15.76)
Seat 2: matiko09 (small blind) folded before Flop
Seat 3: Reven9er (big blind) folded before Flop
Seat 4: Jimy Tiltman folded before Flop (didn't bet)
Seat 5: Dante63s folded on the Turn
Seat 6: Filojoes folded before Flop (didn't bet)
Seat 8: mycka86 folded before Flop (didn't bet)
Seat 9: Sweden_Pound folded before Flop (didn't bet)





PokerStars Hand #147707475667:  Hold'em No Limit ($0.50/$1.00 USD) - 2016/01/26 15:57:06 CET [2016/01/26 9:57:06 ET]
Table 'Haedus' 9-max Seat #5 is the button
Seat 1: Dante63s ($119.50 in chips) 
Seat 2: Sweden_Pound ($100 in chips) 
Seat 4: FroggyPlay ($108.87 in chips) 
Seat 5: matiko09 ($100 in chips) 
Seat 6: nnne409 ($63.07 in chips) 
Seat 7: KLOP06031987 ($106 in chips) 
nnne409: posts small blind $0.50
KLOP06031987: posts big blind $1
Jimy Tiltman: sits out 
Filojoes: sits out 
*** HOLE CARDS ***
Dealt to matiko09 [Kh 9h]
Dante63s: folds 
Sweden_Pound: folds 
FroggyPlay: raises $1.50 to $2.50
matiko09: folds 
nnne409: calls $2
KLOP06031987: raises $11.50 to $14
FroggyPlay: folds 
nnne409: folds 
Uncalled bet ($11.50) returned to KLOP06031987
KLOP06031987 collected $7.50 from pot
KLOP06031987: doesn't show hand 
*** SUMMARY ***
Total pot $7.50 | Rake $0 
Seat 1: Dante63s folded before Flop (didn't bet)
Seat 2: Sweden_Pound folded before Flop (didn't bet)
Seat 4: FroggyPlay folded before Flop
Seat 5: matiko09 (button) folded before Flop (didn't bet)
Seat 6: nnne409 (small blind) folded before Flop
Seat 7: KLOP06031987 (big blind) collected ($7.50)





PokerStars Hand #147707478386:  Hold'em No Limit ($0.50/$1.00 USD) - 2016/01/26 15:57:11 CET [2016/01/26 9:57:11 ET]
Table 'Medusa III' 9-max Seat #3 is the button
Seat 1: soplak ($100 in chips) 
Seat 2: happydrake ($50.10 in chips) 
Seat 3: mycka86 ($108 in chips) 
Seat 4: Sweden_Pound ($151.48 in chips) 
Seat 5: matiko09 ($208.62 in chips) 
Seat 6: Dante63s ($192.99 in chips) 
Seat 7: Reven9er ($133.66 in chips) 
Sweden_Pound: posts small blind $0.50
matiko09: posts big blind $1
*** HOLE CARDS ***
Dealt to matiko09 [5h 3d]
Dante63s: folds 
Reven9er: folds 
soplak: folds 
happydrake: raises $2.50 to $3.50
mycka86: folds 
Sweden_Pound: folds 
matiko09: folds 
Uncalled bet ($2.50) returned to happydrake
happydrake collected $2.50 from pot
happydrake: doesn't show hand 
*** SUMMARY ***
Total pot $2.50 | Rake $0 
Seat 1: soplak folded before Flop (didn't bet)
Seat 2: happydrake collected ($2.50)
Seat 3: mycka86 (button) folded before Flop (didn't bet)
Seat 4: Sweden_Pound (small blind) folded before Flop
Seat 5: matiko09 (big blind) folded before Flop
Seat 6: Dante63s folded before Flop (didn't bet)
Seat 7: Reven9er folded before Flop (didn't bet)





PokerStars Hand #147707479664:  Hold'em No Limit ($0.50/$1.00 USD) - 2016/01/26 15:57:13 CET [2016/01/26 9:57:13 ET]
Table 'Strenua III' 9-max Seat #1 is the button
Seat 1: ICallSaul ($108.28 in chips) 
Seat 3: petalouda10 ($66.15 in chips) 
Seat 4: mycka86 ($121.67 in chips) 
Seat 5: DeWeijz ($38.50 in chips) 
Seat 6: matiko09 ($143.84 in chips) 
Seat 7: KLOP06031987 ($100 in chips) 
Seat 8: Filojoes ($100 in chips) 
Seat 9: Dante63s ($100 in chips) 
petalouda10: posts small blind $0.50
mycka86: posts big blind $1
*** HOLE CARDS ***
Dealt to matiko09 [Ah 8s]
DeWeijz: raises $1 to $2
matiko09: folds 
KLOP06031987: folds 
Filojoes: folds 
Dante63s: calls $2
ICallSaul: folds 
petalouda10: calls $1.50
mycka86: folds 
*** FLOP *** [2d Kh Qs]
petalouda10: checks 
DeWeijz: bets $3.34
Dante63s: folds 
petalouda10: folds 
Uncalled bet ($3.34) returned to DeWeijz
DeWeijz collected $6.68 from pot
DeWeijz: doesn't show hand 
*** SUMMARY ***
Total pot $7 | Rake $0.32 
Board [2d Kh Qs]
Seat 1: ICallSaul (button) folded before Flop (didn't bet)
Seat 3: petalouda10 (small blind) folded on the Flop
Seat 4: mycka86 (big blind) folded before Flop
Seat 5: DeWeijz collected ($6.68)
Seat 6: matiko09 folded before Flop (didn't bet)
Seat 7: KLOP06031987 folded before Flop (didn't bet)
Seat 8: Filojoes folded before Flop (didn't bet)
Seat 9: Dante63s folded on the Flop





PokerStars Hand #147707486292:  Hold'em No Limit ($0.50/$1.00 USD) - 2016/01/26 15:57:24 CET [2016/01/26 9:57:24 ET]
Table 'Mashona' 9-max Seat #2 is the button
Seat 1: maxxmeister ($100 in chips) 
Seat 2: werades ($201.10 in chips) 
Seat 3: matiko09 ($124.07 in chips) 
Seat 4: Sweden_Pound ($152.56 in chips) 
Seat 5: KLOP06031987 ($105.09 in chips) 
Seat 7: EB0LARAMA ($207.37 in chips) 
Seat 8: Jimy Tiltman ($177.16 in chips) 
matiko09: posts small blind $0.50
Sweden_Pound: posts big blind $1
Filojoes: sits out 
apfush: sits out 
*** HOLE CARDS ***
Dealt to matiko09 [3s Jh]
KLOP06031987: folds 
EB0LARAMA: calls $1
KLOP06031987 leaves the table
solbi86 joins the table at seat #5 
Jimy Tiltman: folds 
maxxmeister: folds 
werades: folds 
matiko09: folds 
Sweden_Pound: checks 
*** FLOP *** [Jc 3d Ks]
Sweden_Pound: checks 
EB0LARAMA: checks 
*** TURN *** [Jc 3d Ks] [Qs]
Sweden_Pound: checks 
EB0LARAMA: bets $2
Sweden_Pound: folds 
Uncalled bet ($2) returned to EB0LARAMA
EB0LARAMA collected $2.39 from pot
EB0LARAMA: doesn't show hand 
*** SUMMARY ***
Total pot $2.50 | Rake $0.11 
Board [Jc 3d Ks Qs]
Seat 1: maxxmeister folded before Flop (didn't bet)
Seat 2: werades (button) folded before Flop (didn't bet)
Seat 3: matiko09 (small blind) folded before Flop
Seat 4: Sweden_Pound (big blind) folded on the Turn
Seat 5: KLOP06031987 folded before Flop (didn't bet)
Seat 7: EB0LARAMA collected ($2.39)
Seat 8: Jimy Tiltman folded before Flop (didn't bet)





PokerStars Hand #147707488983:  Hold'em No Limit ($0.50/$1.00 USD) - 2016/01/26 15:57:28 CET [2016/01/26 9:57:28 ET]
Table 'Heike II' 9-max Seat #7 is the button
Seat 1: ilaviiitech ($121.51 in chips) 
Seat 2: Dante63s ($112.48 in chips) 
Seat 3: matiko09 ($119.67 in chips) 
Seat 4: Reven9er ($120.67 in chips) 
Seat 5: Sweden_Pound ($100 in chips) 
Seat 6: H8fulM0n ($127 in chips) 
Seat 7: Momess ($100 in chips) 
Seat 8: THE RIPPER V ($51.95 in chips) 
THE RIPPER V: posts small blind $0.50
uonlylive1ce: is sitting out 
uonlylive1ce leaves the table
ilaviiitech: posts big blind $1
*** HOLE CARDS ***
Dealt to matiko09 [6c Kd]
Dante63s: folds 
mycka86 joins the table at seat #9 
matiko09: folds 
Reven9er: folds 
Sweden_Pound: folds 
H8fulM0n has timed out while disconnected
H8fulM0n: folds 
Momess: raises $1.50 to $2.50
THE RIPPER V: raises $3.50 to $6
ilaviiitech: folds 
Momess: folds 
Uncalled bet ($3.50) returned to THE RIPPER V
THE RIPPER V collected $6 from pot
THE RIPPER V: doesn't show hand 
*** SUMMARY ***
Total pot $6 | Rake $0 
Seat 1: ilaviiitech (big blind) folded before Flop
Seat 2: Dante63s folded before Flop (didn't bet)
Seat 3: matiko09 folded before Flop (didn't bet)
Seat 4: Reven9er folded before Flop (didn't bet)
Seat 5: Sweden_Pound folded before Flop (didn't bet)
Seat 6: H8fulM0n folded before Flop (didn't bet)
Seat 7: Momess (button) folded before Flop
Seat 8: THE RIPPER V (small blind) collected ($6)





PokerStars Hand #147707489042:  Hold'em No Limit ($0.50/$1.00 USD) - 2016/01/26 15:57:28 CET [2016/01/26 9:57:28 ET]
Table 'Calypso II' 9-max Seat #3 is the button
Seat 2: Hardwell1993 ($97.50 in chips) 
Seat 3: matiko09 ($217.75 in chips) 
Seat 4: Sweden_Pound ($114.29 in chips) 
Seat 5: mycka86 ($101.50 in chips) 
Seat 6: MrDeeee25 ($100 in chips) 
Seat 7: Jimy Tiltman ($101 in chips) 
Seat 8: Reven9er ($109.39 in chips) 
Seat 9: Filojoes ($160.43 in chips) 
Sweden_Pound: posts small blind $0.50
mycka86: posts big blind $1
*** HOLE CARDS ***
Dealt to matiko09 [6c 4c]
MrDeeee25: folds 
Jimy Tiltman: folds 
Reven9er: folds 
Filojoes: folds 
Hardwell1993: folds 
matiko09: folds 
Sweden_Pound: folds 
Uncalled bet ($0.50) returned to mycka86
mycka86 collected $1 from pot
*** SUMMARY ***
Total pot $1 | Rake $0 
Seat 2: Hardwell1993 folded before Flop (didn't bet)
Seat 3: matiko09 (button) folded before Flop (didn't bet)
Seat 4: Sweden_Pound (small blind) folded before Flop
Seat 5: mycka86 (big blind) collected ($1)
Seat 6: MrDeeee25 folded before Flop (didn't bet)
Seat 7: Jimy Tiltman folded before Flop (didn't bet)
Seat 8: Reven9er folded before Flop (didn't bet)
Seat 9: Filojoes folded before Flop (didn't bet)





PokerStars Hand #147707491906:  Hold'em No Limit ($0.50/$1.00 USD) - 2016/01/26 15:57:33 CET [2016/01/26 9:57:33 ET]
Table 'Montefiore' 9-max Seat #1 is the button
Seat 1: Celsinho0311 ($58.19 in chips) 
Seat 2: Dante63s ($100 in chips) 
Seat 3: Filojoes ($100 in chips) 
Seat 4: matiko09 ($108.05 in chips) 
Seat 5: ilaviiitech ($100 in chips) 
Seat 6: Kosh20 ($44.36 in chips) 
Seat 7: flozzi ($100 in chips) 
Seat 8: Kukuryzka ($100 in chips) 
Seat 9: KLOP06031987 ($100 in chips) 
Dante63s: posts small blind $0.50
Filojoes: posts big blind $1
*** HOLE CARDS ***
Dealt to matiko09 [5d 4h]
matiko09: folds 
ilaviiitech: folds 
Kosh20: folds 
flozzi: raises $2 to $3
Kukuryzka: folds 
KLOP06031987: folds 
Celsinho0311: folds 
Dante63s: folds 
Filojoes: folds 
Uncalled bet ($2) returned to flozzi
flozzi collected $2.50 from pot
flozzi: doesn't show hand 
*** SUMMARY ***
Total pot $2.50 | Rake $0 
Seat 1: Celsinho0311 (button) folded before Flop (didn't bet)
Seat 2: Dante63s (small blind) folded before Flop
Seat 3: Filojoes (big blind) folded before Flop
Seat 4: matiko09 folded before Flop (didn't bet)
Seat 5: ilaviiitech folded before Flop (didn't bet)
Seat 6: Kosh20 folded before Flop (didn't bet)
Seat 7: flozzi collected ($2.50)
Seat 8: Kukuryzka folded before Flop (didn't bet)
Seat 9: KLOP06031987 folded before Flop (didn't bet)





PokerStars Hand #147707492279:  Hold'em No Limit ($0.50/$1.00 USD) - 2016/01/26 15:57:33 CET [2016/01/26 9:57:33 ET]
Table 'Medusa III' 9-max Seat #4 is the button
Seat 1: soplak ($100 in chips) 
Seat 2: happydrake ($51.60 in chips) 
Seat 3: mycka86 ($108 in chips) 
Seat 4: Sweden_Pound ($150.98 in chips) 
Seat 5: matiko09 ($207.62 in chips) 
Seat 6: Dante63s ($192.99 in chips) 
Seat 7: Reven9er ($133.66 in chips) 
matiko09: posts small blind $0.50
Dante63s: posts big blind $1
KLOP06031987: sits out 
*** HOLE CARDS ***
Dealt to matiko09 [3h Ac]
Reven9er: folds 
soplak: folds 
happydrake: folds 
mycka86: folds 
Sweden_Pound: raises $1 to $2
matiko09: folds 
Dante63s: folds 
Uncalled bet ($1) returned to Sweden_Pound
Sweden_Pound collected $2.50 from pot
Sweden_Pound: doesn't show hand 
*** SUMMARY ***
Total pot $2.50 | Rake $0 
Seat 1: soplak folded before Flop (didn't bet)
Seat 2: happydrake folded before Flop (didn't bet)
Seat 3: mycka86 folded before Flop (didn't bet)
Seat 4: Sweden_Pound (button) collected ($2.50)
Seat 5: matiko09 (small blind) folded before Flop
Seat 6: Dante63s (big blind) folded before Flop
Seat 7: Reven9er folded before Flop (didn't bet)





PokerStars Hand #147707496745:  Hold'em No Limit ($0.50/$1.00 USD) - 2016/01/26 15:57:41 CET [2016/01/26 9:57:41 ET]
Table 'Gyas IV' 9-max Seat #7 is the button
Seat 1: sharkside90 ($48.29 in chips) 
Seat 2: Dante63s ($119.54 in chips) 
Seat 5: matiko09 ($108.18 in chips) 
Seat 6: Filojoes ($100 in chips) 
Seat 7: mycka86 ($100 in chips) 
Seat 9: Sweden_Pound ($122.50 in chips) 
changpiao will be allowed to play after the button
Sweden_Pound: posts small blind $0.50
sharkside90: posts big blind $1
solbi86: sits out 
*** HOLE CARDS ***
Dealt to matiko09 [Ac 5s]
Dante63s: folds 
matiko09: folds 
Filojoes: folds 
mycka86: raises $1.10 to $2.10
Sweden_Pound: folds 
sharkside90: folds 
Uncalled bet ($1.10) returned to mycka86
mycka86 collected $2.50 from pot
*** SUMMARY ***
Total pot $2.50 | Rake $0 
Seat 1: sharkside90 (big blind) folded before Flop
Seat 2: Dante63s folded before Flop (didn't bet)
Seat 5: matiko09 folded before Flop (didn't bet)
Seat 6: Filojoes folded before Flop (didn't bet)
Seat 7: mycka86 (button) collected ($2.50)
Seat 9: Sweden_Pound (small blind) folded before Flop





PokerStars Hand #147707501692:  Hold'em No Limit ($0.50/$1.00 USD) - 2016/01/26 15:57:49 CET [2016/01/26 9:57:49 ET]
Table 'Impala' 9-max Seat #5 is the button
Seat 1: mycka86 ($133.71 in chips) 
Seat 2: Filojoes ($100 in chips) 
Seat 3: Dante63s ($102.50 in chips) 
Seat 4: KLOP06031987 ($100 in chips) 
Seat 5: Kukuryzka ($100 in chips) 
Seat 6: Tijger R.d.J ($98.31 in chips) 
Seat 7: matiko09 ($126.65 in chips) 
Seat 8: Peu3aHy ($100 in chips) 
Seat 9: flozzi ($100 in chips) 
Tijger R.d.J: posts small blind $0.50
matiko09: posts big blind $1
*** HOLE CARDS ***
Dealt to matiko09 [6d 3d]
Peu3aHy: folds 
flozzi: folds 
Peu3aHy leaves the table
mycka86: raises $1.50 to $2.50
Filojoes: folds 
Dante63s: folds 
KLOP06031987: folds 
Kukuryzka: folds 
Tijger R.d.J: calls $2
matiko09: folds 
*** FLOP *** [Ad 4c 6s]
Tijger R.d.J: checks 
mycka86: bets $4.20
apfush joins the table at seat #8 
Tijger R.d.J: folds 
Uncalled bet ($4.20) returned to mycka86
mycka86 collected $5.73 from pot
*** SUMMARY ***
Total pot $6 | Rake $0.27 
Board [Ad 4c 6s]
Seat 1: mycka86 collected ($5.73)
Seat 2: Filojoes folded before Flop (didn't bet)
Seat 3: Dante63s folded before Flop (didn't bet)
Seat 4: KLOP06031987 folded before Flop (didn't bet)
Seat 5: Kukuryzka (button) folded before Flop (didn't bet)
Seat 6: Tijger R.d.J (small blind) folded on the Flop
Seat 7: matiko09 (big blind) folded before Flop
Seat 8: Peu3aHy folded before Flop (didn't bet)
Seat 9: flozzi folded before Flop (didn't bet)





PokerStars Hand #147707503959:  Hold'em No Limit ($0.50/$1.00 USD) - 2016/01/26 15:57:52 CET [2016/01/26 9:57:52 ET]
Table 'Haedus' 9-max Seat #6 is the button
Seat 1: Dante63s ($119.50 in chips) 
Seat 2: Sweden_Pound ($100 in chips) 
Seat 4: FroggyPlay ($106.37 in chips) 
Seat 5: matiko09 ($100 in chips) 
Seat 6: nnne409 ($60.57 in chips) 
Seat 7: KLOP06031987 ($111 in chips) 
Seat 8: Jimy Tiltman ($100 in chips) 
KLOP06031987: posts small blind $0.50
Jimy Tiltman: posts big blind $1
Filojoes: sits out 
*** HOLE CARDS ***
Dealt to matiko09 [7d 7s]
Dante63s: folds 
Sweden_Pound: folds 
FroggyPlay: folds 
matiko09: raises $1.50 to $2.50
nnne409: folds 
KLOP06031987: folds 
Jimy Tiltman: folds 
Uncalled bet ($1.50) returned to matiko09
matiko09 collected $2.50 from pot
*** SUMMARY ***
Total pot $2.50 | Rake $0 
Seat 1: Dante63s folded before Flop (didn't bet)
Seat 2: Sweden_Pound folded before Flop (didn't bet)
Seat 4: FroggyPlay folded before Flop (didn't bet)
Seat 5: matiko09 collected ($2.50)
Seat 6: nnne409 (button) folded before Flop (didn't bet)
Seat 7: KLOP06031987 (small blind) folded before Flop
Seat 8: Jimy Tiltman (big blind) folded before Flop





PokerStars Hand #147707506670:  Hold'em No Limit ($0.50/$1.00 USD) - 2016/01/26 15:57:57 CET [2016/01/26 9:57:57 ET]
Table 'Strenua III' 9-max Seat #3 is the button
Seat 1: ICallSaul ($108.28 in chips) 
Seat 3: petalouda10 ($64.15 in chips) 
Seat 4: mycka86 ($120.67 in chips) 
Seat 5: DeWeijz ($43.18 in chips) 
Seat 6: matiko09 ($143.84 in chips) 
Seat 7: KLOP06031987 ($100 in chips) 
Seat 8: Filojoes ($100 in chips) 
Seat 9: Dante63s ($100 in chips) 
mycka86: posts small blind $0.50
DeWeijz: posts big blind $1
*** HOLE CARDS ***
Dealt to matiko09 [7s Qh]
matiko09: folds 
KLOP06031987: raises $1.31 to $2.31
Filojoes: folds 
Dante63s: folds 
ICallSaul: folds 
petalouda10: calls $2.31
mycka86: folds 
DeWeijz: calls $1.31
*** FLOP *** [3h 6c 3d]
DeWeijz: checks 
KLOP06031987: checks 
petalouda10: bets $3.55
DeWeijz: folds 
KLOP06031987: calls $3.55
*** TURN *** [3h 6c 3d] [Th]
KLOP06031987: checks 
petalouda10: bets $6.94
KLOP06031987: folds 
Uncalled bet ($6.94) returned to petalouda10
petalouda10 collected $13.88 from pot
petalouda10: doesn't show hand 
*** SUMMARY ***
Total pot $14.53 | Rake $0.65 
Board [3h 6c 3d Th]
Seat 1: ICallSaul folded before Flop (didn't bet)
Seat 3: petalouda10 (button) collected ($13.88)
Seat 4: mycka86 (small blind) folded before Flop
Seat 5: DeWeijz (big blind) folded on the Flop
Seat 6: matiko09 folded before Flop (didn't bet)
Seat 7: KLOP06031987 folded on the Turn
Seat 8: Filojoes folded before Flop (didn't bet)
Seat 9: Dante63s folded before Flop (didn't bet)





PokerStars Hand #147707507969:  Hold'em No Limit ($0.50/$1.00 USD) - 2016/01/26 15:57:59 CET [2016/01/26 9:57:59 ET]
Table 'Calypso II' 9-max Seat #4 is the button
Seat 2: Hardwell1993 ($97.50 in chips) 
Seat 3: matiko09 ($217.75 in chips) 
Seat 4: Sweden_Pound ($113.79 in chips) 
Seat 5: mycka86 ($102 in chips) 
Seat 6: MrDeeee25 ($100 in chips) 
Seat 7: Jimy Tiltman ($101 in chips) 
Seat 8: Reven9er ($109.39 in chips) 
Seat 9: Filojoes ($160.43 in chips) 
mycka86: posts small blind $0.50
MrDeeee25: posts big blind $1
*** HOLE CARDS ***
Dealt to matiko09 [Qc 5c]
Jimy Tiltman: folds 
Reven9er: folds 
Filojoes: folds 
Hardwell1993: calls $1
matiko09: folds 
Sweden_Pound: raises $3 to $4
mycka86: folds 
MrDeeee25: folds 
Hardwell1993: folds 
Uncalled bet ($3) returned to Sweden_Pound
Sweden_Pound collected $3.50 from pot
Sweden_Pound: doesn't show hand 
*** SUMMARY ***
Total pot $3.50 | Rake $0 
Seat 2: Hardwell1993 folded before Flop
Seat 3: matiko09 folded before Flop (didn't bet)
Seat 4: Sweden_Pound (button) collected ($3.50)
Seat 5: mycka86 (small blind) folded before Flop
Seat 6: MrDeeee25 (big blind) folded before Flop
Seat 7: Jimy Tiltman folded before Flop (didn't bet)
Seat 8: Reven9er folded before Flop (didn't bet)
Seat 9: Filojoes folded before Flop (didn't bet)





PokerStars Hand #147707515474:  Hold'em No Limit ($0.50/$1.00 USD) - 2016/01/26 15:58:04 CET [2016/01/26 9:58:04 ET]
Table 'Gyas IV' 9-max Seat #9 is the button
Seat 1: sharkside90 ($47.29 in chips) 
Seat 2: Dante63s ($119.54 in chips) 
Seat 5: matiko09 ($108.18 in chips) 
Seat 6: Filojoes ($100 in chips) 
Seat 7: mycka86 ($101.50 in chips) 
Seat 9: Sweden_Pound ($122 in chips) 
sharkside90: posts small blind $0.50
Dante63s: posts big blind $1
solbi86: sits out 
changpiao: sits out 
*** HOLE CARDS ***
Dealt to matiko09 [Th 8h]
matiko09: folds 
Filojoes: folds 
mycka86: folds 
Sweden_Pound: raises $1 to $2
sharkside90: folds 
Dante63s: calls $1
*** FLOP *** [Kh Ad Td]
Dante63s: checks 
Sweden_Pound: checks 
*** TURN *** [Kh Ad Td] [Tc]
Dante63s: bets $2.50
Sweden_Pound: folds 
Uncalled bet ($2.50) returned to Dante63s
Dante63s collected $4.30 from pot
Dante63s: doesn't show hand 
*** SUMMARY ***
Total pot $4.50 | Rake $0.20 
Board [Kh Ad Td Tc]
Seat 1: sharkside90 (small blind) folded before Flop
Seat 2: Dante63s (big blind) collected ($4.30)
Seat 5: matiko09 folded before Flop (didn't bet)
Seat 6: Filojoes folded before Flop (didn't bet)
Seat 7: mycka86 folded before Flop (didn't bet)
Seat 9: Sweden_Pound (button) folded on the Turn





PokerStars Hand #147707516170:  Hold'em No Limit ($0.50/$1.00 USD) - 2016/01/26 15:58:05 CET [2016/01/26 9:58:05 ET]
Table 'Achates III' 9-max Seat #5 is the button
Seat 1: CI58 ($100 in chips) 
Seat 2: matiko09 ($100 in chips) 
Seat 3: Jimy Tiltman ($100 in chips) 
Seat 5: Sweden_Pound ($220.29 in chips) 
Seat 6: Kukuryzka ($99 in chips) 
Seat 7: KLOP06031987 ($100 in chips) 
Seat 8: Männerzimmer ($222 in chips) 
Seat 9: T-chaos_IMBA ($332.42 in chips) 
Kukuryzka: posts small blind $0.50
KLOP06031987: posts big blind $1
*** HOLE CARDS ***
Dealt to matiko09 [Qd Jh]
Männerzimmer: raises $2 to $3
T-chaos_IMBA: calls $3
CI58: folds 
matiko09: folds 
Jimy Tiltman: folds 
Sweden_Pound: raises $8 to $11
Kukuryzka: folds 
KLOP06031987: folds 
Männerzimmer: calls $8
T-chaos_IMBA: folds 
*** FLOP *** [4h Ts 4s]
Männerzimmer: checks 
Sweden_Pound: bets $16.45
Männerzimmer: folds 
Uncalled bet ($16.45) returned to Sweden_Pound
Sweden_Pound collected $25.31 from pot
Sweden_Pound: doesn't show hand 
*** SUMMARY ***
Total pot $26.50 | Rake $1.19 
Board [4h Ts 4s]
Seat 1: CI58 folded before Flop (didn't bet)
Seat 2: matiko09 folded before Flop (didn't bet)
Seat 3: Jimy Tiltman folded before Flop (didn't bet)
Seat 5: Sweden_Pound (button) collected ($25.31)
Seat 6: Kukuryzka (small blind) folded before Flop
Seat 7: KLOP06031987 (big blind) folded before Flop
Seat 8: Männerzimmer folded on the Flop
Seat 9: T-chaos_IMBA folded before Flop





PokerStars Hand #147707518484:  Hold'em No Limit ($0.50/$1.00 USD) - 2016/01/26 15:58:09 CET [2016/01/26 9:58:09 ET]
Table 'Medusa III' 9-max Seat #5 is the button
Seat 1: soplak ($100 in chips) 
Seat 2: happydrake ($51.60 in chips) 
Seat 3: mycka86 ($108 in chips) 
Seat 4: Sweden_Pound ($152.48 in chips) 
Seat 5: matiko09 ($207.12 in chips) 
Seat 6: Dante63s ($191.99 in chips) 
Seat 7: Reven9er ($133.66 in chips) 
Dante63s: posts small blind $0.50
Reven9er: posts big blind $1
KLOP06031987: sits out 
*** HOLE CARDS ***
Dealt to matiko09 [8d 3s]
soplak: folds 
happydrake: folds 
mycka86: folds 
Sweden_Pound: folds 
matiko09: folds 
Dante63s: folds 
Uncalled bet ($0.50) returned to Reven9er
Reven9er collected $1 from pot
Reven9er: doesn't show hand 
*** SUMMARY ***
Total pot $1 | Rake $0 
Seat 1: soplak folded before Flop (didn't bet)
Seat 2: happydrake folded before Flop (didn't bet)
Seat 3: mycka86 folded before Flop (didn't bet)
Seat 4: Sweden_Pound folded before Flop (didn't bet)
Seat 5: matiko09 (button) folded before Flop (didn't bet)
Seat 6: Dante63s (small blind) folded before Flop
Seat 7: Reven9er (big blind) collected ($1)





PokerStars Hand #147707519149:  Hold'em No Limit ($0.50/$1.00 USD) - 2016/01/26 15:58:10 CET [2016/01/26 9:58:10 ET]
Table 'Montefiore' 9-max Seat #2 is the button
Seat 1: Celsinho0311 ($58.19 in chips) 
Seat 2: Dante63s ($100 in chips) 
Seat 3: Filojoes ($100 in chips) 
Seat 4: matiko09 ($108.05 in chips) 
Seat 5: ilaviiitech ($100 in chips) 
Seat 6: Kosh20 ($44.36 in chips) 
Seat 7: flozzi ($101.50 in chips) 
Seat 8: Kukuryzka ($100 in chips) 
Seat 9: KLOP06031987 ($100 in chips) 
Filojoes: posts small blind $0.50
matiko09: posts big blind $1
*** HOLE CARDS ***
Dealt to matiko09 [3c 6s]
ilaviiitech: folds 
Kosh20 has timed out
Kosh20: folds 
flozzi: folds 
Kukuryzka: folds 
KLOP06031987: folds 
Celsinho0311: raises $2 to $3
Dante63s: folds 
Filojoes: folds 
matiko09: folds 
Uncalled bet ($2) returned to Celsinho0311
Celsinho0311 collected $2.50 from pot
Celsinho0311: doesn't show hand 
*** SUMMARY ***
Total pot $2.50 | Rake $0 
Seat 1: Celsinho0311 collected ($2.50)
Seat 2: Dante63s (button) folded before Flop (didn't bet)
Seat 3: Filojoes (small blind) folded before Flop
Seat 4: matiko09 (big blind) folded before Flop
Seat 5: ilaviiitech folded before Flop (didn't bet)
Seat 6: Kosh20 folded before Flop (didn't bet)
Seat 7: flozzi folded before Flop (didn't bet)
Seat 8: Kukuryzka folded before Flop (didn't bet)
Seat 9: KLOP06031987 folded before Flop (didn't bet)





PokerStars Hand #147707519226:  Hold'em No Limit ($0.50/$1.00 USD) - 2016/01/26 15:58:11 CET [2016/01/26 9:58:11 ET]
Table 'Kale II' 9-max Seat #2 is the button
Seat 1: lootstool ($81.20 in chips) 
Seat 2: matiko09 ($100 in chips) 
Seat 3: Reven9er ($127.70 in chips) 
Seat 4: Jimy Tiltman ($196.57 in chips) 
Seat 5: Dante63s ($100 in chips) 
Seat 6: Filojoes ($121 in chips) 
Seat 8: mycka86 ($100 in chips) 
Seat 9: Sweden_Pound ($129.78 in chips) 
Reven9er: posts small blind $0.50
Jimy Tiltman: posts big blind $1
Kukuryzka: sits out 
*** HOLE CARDS ***
Dealt to matiko09 [7h 8c]
Dante63s: folds 
Filojoes: folds 
mycka86: folds 
Sweden_Pound: folds 
lootstool: calls $1
matiko09: raises $3 to $4
Reven9er: raises $6 to $10
Jimy Tiltman: folds 
lootstool: folds 
matiko09: folds 
Uncalled bet ($6) returned to Reven9er
Reven9er collected $10 from pot
Reven9er: doesn't show hand 
*** SUMMARY ***
Total pot $10 | Rake $0 
Seat 1: lootstool folded before Flop
Seat 2: matiko09 (button) folded before Flop
Seat 3: Reven9er (small blind) collected ($10)
Seat 4: Jimy Tiltman (big blind) folded before Flop
Seat 5: Dante63s folded before Flop (didn't bet)
Seat 6: Filojoes folded before Flop (didn't bet)
Seat 8: mycka86 folded before Flop (didn't bet)
Seat 9: Sweden_Pound folded before Flop (didn't bet)





PokerStars Hand #147707519963:  Hold'em No Limit ($0.50/$1.00 USD) - 2016/01/26 15:58:12 CET [2016/01/26 9:58:12 ET]
Table 'Mashona' 9-max Seat #3 is the button
Seat 1: maxxmeister ($100 in chips) 
Seat 2: werades ($201.10 in chips) 
Seat 3: matiko09 ($123.57 in chips) 
Seat 4: Sweden_Pound ($151.56 in chips) 
Seat 5: solbi86 ($148.05 in chips) 
Seat 7: EB0LARAMA ($208.76 in chips) 
Seat 8: Jimy Tiltman ($177.16 in chips) 
Sweden_Pound: posts small blind $0.50
solbi86: posts big blind $1
Filojoes: sits out 
apfush: sits out 
*** HOLE CARDS ***
Dealt to matiko09 [Tc 6s]
EB0LARAMA: calls $1
Jimy Tiltman: folds 
maxxmeister: raises $3 to $4
werades: folds 
matiko09: folds 
Sweden_Pound: folds 
solbi86: folds 
EB0LARAMA: calls $3
*** FLOP *** [Qd 8d 9s]
EB0LARAMA: checks 
maxxmeister: checks 
*** TURN *** [Qd 8d 9s] [5d]
EB0LARAMA: bets $4
maxxmeister: raises $20 to $24
EB0LARAMA: calls $20
*** RIVER *** [Qd 8d 9s 5d] [8s]
EB0LARAMA: checks 
maxxmeister: bets $72 and is all-in
EB0LARAMA: calls $72
*** SHOW DOWN ***
maxxmeister: shows [Ad Td] (a flush, Ace high)
EB0LARAMA: shows [Qh Qc] (a full house, Queens full of Eights)
EB0LARAMA collected $198.70 from pot
*** SUMMARY ***
Total pot $201.50 | Rake $2.80 
Board [Qd 8d 9s 5d 8s]
Seat 1: maxxmeister showed [Ad Td] and lost with a flush, Ace high
Seat 2: werades folded before Flop (didn't bet)
Seat 3: matiko09 (button) folded before Flop (didn't bet)
Seat 4: Sweden_Pound (small blind) folded before Flop
Seat 5: solbi86 (big blind) folded before Flop
Seat 7: EB0LARAMA showed [Qh Qc] and won ($198.70) with a full house, Queens full of Eights
Seat 8: Jimy Tiltman folded before Flop (didn't bet)





PokerStars Hand #147707528447:  Hold'em No Limit ($0.50/$1.00 USD) - 2016/01/26 15:58:20 CET [2016/01/26 9:58:20 ET]
Table 'Heike II' 9-max Seat #8 is the button
Seat 1: ilaviiitech ($120.51 in chips) 
Seat 2: Dante63s ($112.48 in chips) 
Seat 3: matiko09 ($119.67 in chips) 
Seat 4: Reven9er ($120.67 in chips) 
Seat 5: Sweden_Pound ($100 in chips) 
Seat 7: Momess ($100 in chips) 
Seat 8: THE RIPPER V ($55.45 in chips) 
mycka86 will be allowed to play after the button
ilaviiitech: posts small blind $0.50
Dante63s: posts big blind $1
*** HOLE CARDS ***
Dealt to matiko09 [Jh Tc]
matiko09: folds 
Reven9er: folds 
Sweden_Pound: folds 
Momess: folds 
THE RIPPER V: folds 
ilaviiitech: folds 
Uncalled bet ($0.50) returned to Dante63s
Dante63s collected $1 from pot
Dante63s: doesn't show hand 
*** SUMMARY ***
Total pot $1 | Rake $0 
Seat 1: ilaviiitech (small blind) folded before Flop
Seat 2: Dante63s (big blind) collected ($1)
Seat 3: matiko09 folded before Flop (didn't bet)
Seat 4: Reven9er folded before Flop (didn't bet)
Seat 5: Sweden_Pound folded before Flop (didn't bet)
Seat 7: Momess folded before Flop (didn't bet)
Seat 8: THE RIPPER V (button) folded before Flop (didn't bet)





PokerStars Hand #147707540274:  Hold'em No Limit ($0.50/$1.00 USD) - 2016/01/26 15:58:34 CET [2016/01/26 9:58:34 ET]
Table 'Heike II' 9-max Seat #1 is the button
Seat 1: ilaviiitech ($120.01 in chips) 
Seat 2: Dante63s ($112.98 in chips) 
Seat 3: matiko09 ($119.67 in chips) 
Seat 4: Reven9er ($120.67 in chips) 
Seat 5: Sweden_Pound ($100 in chips) 
Seat 7: Momess ($100 in chips) 
Seat 8: THE RIPPER V ($55.45 in chips) 
Dante63s: posts small blind $0.50
matiko09: posts big blind $1
mycka86: sits out 
*** HOLE CARDS ***
Dealt to matiko09 [9s Kc]
Reven9er: folds 
Sweden_Pound: raises $2 to $3
Momess: folds 
THE RIPPER V: folds 
ilaviiitech: folds 
Dante63s: folds 
matiko09: folds 
Uncalled bet ($2) returned to Sweden_Pound
Sweden_Pound collected $2.50 from pot
Sweden_Pound: doesn't show hand 
*** SUMMARY ***
Total pot $2.50 | Rake $0 
Seat 1: ilaviiitech (button) folded before Flop (didn't bet)
Seat 2: Dante63s (small blind) folded before Flop
Seat 3: matiko09 (big blind) folded before Flop
Seat 4: Reven9er folded before Flop (didn't bet)
Seat 5: Sweden_Pound collected ($2.50)
Seat 7: Momess folded before Flop (didn't bet)
Seat 8: THE RIPPER V folded before Flop (didn't bet)





PokerStars Hand #147707541651:  Hold'em No Limit ($0.50/$1.00 USD) - 2016/01/26 15:58:36 CET [2016/01/26 9:58:36 ET]
Table 'Haedus' 9-max Seat #7 is the button
Seat 1: Dante63s ($119.50 in chips) 
Seat 2: Sweden_Pound ($100 in chips) 
Seat 4: FroggyPlay ($106.37 in chips) 
Seat 5: matiko09 ($101.50 in chips) 
Seat 6: nnne409 ($60.57 in chips) 
Seat 7: KLOP06031987 ($110.50 in chips) 
Seat 8: Jimy Tiltman ($100 in chips) 
Seat 9: Filojoes ($100 in chips) 
Jimy Tiltman: posts small blind $0.50
Filojoes: posts big blind $1
*** HOLE CARDS ***
Dealt to matiko09 [2d 8c]
Dante63s: folds 
Sweden_Pound: raises $2 to $3
FroggyPlay: folds 
matiko09: folds 
nnne409: folds 
KLOP06031987: folds 
Jimy Tiltman: folds 
Filojoes: folds 
Uncalled bet ($2) returned to Sweden_Pound
Sweden_Pound collected $2.50 from pot
Sweden_Pound: doesn't show hand 
*** SUMMARY ***
Total pot $2.50 | Rake $0 
Seat 1: Dante63s folded before Flop (didn't bet)
Seat 2: Sweden_Pound collected ($2.50)
Seat 4: FroggyPlay folded before Flop (didn't bet)
Seat 5: matiko09 folded before Flop (didn't bet)
Seat 6: nnne409 folded before Flop (didn't bet)
Seat 7: KLOP06031987 (button) folded before Flop (didn't bet)
Seat 8: Jimy Tiltman (small blind) folded before Flop
Seat 9: Filojoes (big blind) folded before Flop





PokerStars Hand #147707545661:  Hold'em No Limit ($0.50/$1.00 USD) - 2016/01/26 15:58:39 CET [2016/01/26 9:58:39 ET]
Table 'Calypso II' 9-max Seat #5 is the button
Seat 2: Hardwell1993 ($96.50 in chips) 
Seat 3: matiko09 ($217.75 in chips) 
Seat 4: Sweden_Pound ($116.29 in chips) 
Seat 5: mycka86 ($101.50 in chips) 
Seat 6: MrDeeee25 ($100 in chips) 
Seat 7: Jimy Tiltman ($101 in chips) 
Seat 8: Reven9er ($109.39 in chips) 
Seat 9: Filojoes ($160.43 in chips) 
MrDeeee25: posts small blind $0.50
Jimy Tiltman: posts big blind $1
*** HOLE CARDS ***
Dealt to matiko09 [3s Ad]
Reven9er: folds 
Filojoes: folds 
Hardwell1993: folds 
matiko09: folds 
Sweden_Pound: folds 
mycka86: raises $1.10 to $2.10
MrDeeee25: calls $1.60
Jimy Tiltman: calls $1.10
*** FLOP *** [Th 7c 6c]
MrDeeee25: bets $3.01
Jimy Tiltman: calls $3.01
mycka86: calls $3.01
*** TURN *** [Th 7c 6c] [9s]
MrDeeee25: checks 
Jimy Tiltman: checks 
mycka86: bets $8.05
MrDeeee25: calls $8.05
Jimy Tiltman: folds 
*** RIVER *** [Th 7c 6c 9s] [3h]
MrDeeee25: checks 
mycka86: checks 
*** SHOW DOWN ***
MrDeeee25: shows [7d 7h] (three of a kind, Sevens)
mycka86: mucks hand 
MrDeeee25 collected $30.02 from pot
*** SUMMARY ***
Total pot $31.43 | Rake $1.41 
Board [Th 7c 6c 9s 3h]
Seat 2: Hardwell1993 folded before Flop (didn't bet)
Seat 3: matiko09 folded before Flop (didn't bet)
Seat 4: Sweden_Pound folded before Flop (didn't bet)
Seat 5: mycka86 (button) mucked [Td 9c]
Seat 6: MrDeeee25 (small blind) showed [7d 7h] and won ($30.02) with three of a kind, Sevens
Seat 7: Jimy Tiltman (big blind) folded on the Turn
Seat 8: Reven9er folded before Flop (didn't bet)
Seat 9: Filojoes folded before Flop (didn't bet)





PokerStars Hand #147707546816:  Hold'em No Limit ($0.50/$1.00 USD) - 2016/01/26 15:58:41 CET [2016/01/26 9:58:41 ET]
Table 'Medusa III' 9-max Seat #6 is the button
Seat 1: soplak ($100 in chips) 
Seat 2: happydrake ($51.60 in chips) 
Seat 3: mycka86 ($108 in chips) 
Seat 4: Sweden_Pound ($152.48 in chips) 
Seat 5: matiko09 ($207.12 in chips) 
Seat 6: Dante63s ($191.49 in chips) 
Seat 7: Reven9er ($134.16 in chips) 
Seat 9: KLOP06031987 ($100 in chips) 
Reven9er: posts small blind $0.50
KLOP06031987: posts big blind $1
*** HOLE CARDS ***
Dealt to matiko09 [5c 7d]
soplak: raises $1.39 to $2.39
happydrake: folds 
mycka86: folds 
Sweden_Pound: folds 
matiko09: folds 
Dante63s: folds 
Reven9er: folds 
KLOP06031987: folds 
Uncalled bet ($1.39) returned to soplak
soplak collected $2.50 from pot
*** SUMMARY ***
Total pot $2.50 | Rake $0 
Seat 1: soplak collected ($2.50)
Seat 2: happydrake folded before Flop (didn't bet)
Seat 3: mycka86 folded before Flop (didn't bet)
Seat 4: Sweden_Pound folded before Flop (didn't bet)
Seat 5: matiko09 folded before Flop (didn't bet)
Seat 6: Dante63s (button) folded before Flop (didn't bet)
Seat 7: Reven9er (small blind) folded before Flop
Seat 9: KLOP06031987 (big blind) folded before Flop





PokerStars Hand #147707555871:  Hold'em No Limit ($0.50/$1.00 USD) - 2016/01/26 15:58:55 CET [2016/01/26 9:58:55 ET]
Table 'Strenua III' 9-max Seat #4 is the button
Seat 1: ICallSaul ($108.28 in chips) 
Seat 3: petalouda10 ($72.17 in chips) 
Seat 4: mycka86 ($120.17 in chips) 
Seat 5: DeWeijz ($40.87 in chips) 
Seat 6: matiko09 ($143.84 in chips) 
Seat 7: KLOP06031987 ($100 in chips) 
Seat 8: Filojoes ($100 in chips) 
Seat 9: Dante63s ($100 in chips) 
DeWeijz: posts small blind $0.50
matiko09: posts big blind $1
*** HOLE CARDS ***
Dealt to matiko09 [Jh 6s]
KLOP06031987: folds 
Filojoes: folds 
Dante63s: folds 
ICallSaul: folds 
petalouda10: folds 
mycka86: raises $1.10 to $2.10
DeWeijz: folds 
matiko09: folds 
Uncalled bet ($1.10) returned to mycka86
mycka86 collected $2.50 from pot
*** SUMMARY ***
Total pot $2.50 | Rake $0 
Seat 1: ICallSaul folded before Flop (didn't bet)
Seat 3: petalouda10 folded before Flop (didn't bet)
Seat 4: mycka86 (button) collected ($2.50)
Seat 5: DeWeijz (small blind) folded before Flop
Seat 6: matiko09 (big blind) folded before Flop
Seat 7: KLOP06031987 folded before Flop (didn't bet)
Seat 8: Filojoes folded before Flop (didn't bet)
Seat 9: Dante63s folded before Flop (didn't bet)





PokerStars Hand #147707557457:  Hold'em No Limit ($0.50/$1.00 USD) - 2016/01/26 15:58:57 CET [2016/01/26 9:58:57 ET]
Table 'Impala' 9-max Seat #6 is the button
Seat 1: mycka86 ($136.94 in chips) 
Seat 2: Filojoes ($100 in chips) 
Seat 3: Dante63s ($102.50 in chips) 
Seat 4: KLOP06031987 ($100 in chips) 
Seat 5: Kukuryzka ($100 in chips) 
Seat 6: Tijger R.d.J ($95.81 in chips) 
Seat 7: matiko09 ($125.65 in chips) 
Seat 8: apfush ($100 in chips) 
Seat 9: flozzi ($100 in chips) 
matiko09: posts small blind $0.50
apfush: posts big blind $1
*** HOLE CARDS ***
Dealt to matiko09 [Th 5s]
flozzi: folds 
mycka86: folds 
Filojoes: raises $2 to $3
Dante63s: folds 
KLOP06031987: folds 
Kukuryzka: folds 
Tijger R.d.J: folds 
matiko09: folds 
apfush: folds 
Uncalled bet ($2) returned to Filojoes
Filojoes collected $2.50 from pot
Filojoes: doesn't show hand 
*** SUMMARY ***
Total pot $2.50 | Rake $0 
Seat 1: mycka86 folded before Flop (didn't bet)
Seat 2: Filojoes collected ($2.50)
Seat 3: Dante63s folded before Flop (didn't bet)
Seat 4: KLOP06031987 folded before Flop (didn't bet)
Seat 5: Kukuryzka folded before Flop (didn't bet)
Seat 6: Tijger R.d.J (button) folded before Flop (didn't bet)
Seat 7: matiko09 (small blind) folded before Flop
Seat 8: apfush (big blind) folded before Flop
Seat 9: flozzi folded before Flop (didn't bet)





PokerStars Hand #147707559786:  Hold'em No Limit ($0.50/$1.00 USD) - 2016/01/26 15:59:00 CET [2016/01/26 9:59:00 ET]
Table 'Heike II' 9-max Seat #2 is the button
Seat 1: ilaviiitech ($120.01 in chips) 
Seat 2: Dante63s ($112.48 in chips) 
Seat 3: matiko09 ($118.67 in chips) 
Seat 4: Reven9er ($120.67 in chips) 
Seat 5: Sweden_Pound ($101.50 in chips) 
Seat 7: Momess ($100 in chips) 
Seat 8: THE RIPPER V ($55.45 in chips) 
matiko09: posts small blind $0.50
Reven9er: posts big blind $1
mycka86: sits out 
*** HOLE CARDS ***
Dealt to matiko09 [Td Ac]
Sweden_Pound: folds 
Momess: folds 
THE RIPPER V: folds 
ilaviiitech: folds 
Dante63s: folds 
matiko09: raises $1.50 to $2.50
Reven9er: calls $1.50
*** FLOP *** [Kc Ad Qh]
matiko09: bets $3.11
Reven9er: folds 
Uncalled bet ($3.11) returned to matiko09
matiko09 collected $4.78 from pot
matiko09: doesn't show hand 
*** SUMMARY ***
Total pot $5 | Rake $0.22 
Board [Kc Ad Qh]
Seat 1: ilaviiitech folded before Flop (didn't bet)
Seat 2: Dante63s (button) folded before Flop (didn't bet)
Seat 3: matiko09 (small blind) collected ($4.78)
Seat 4: Reven9er (big blind) folded on the Flop
Seat 5: Sweden_Pound folded before Flop (didn't bet)
Seat 7: Momess folded before Flop (didn't bet)
Seat 8: THE RIPPER V folded before Flop (didn't bet)





PokerStars Hand #147707566130:  Hold'em No Limit ($0.50/$1.00 USD) - 2016/01/26 15:59:10 CET [2016/01/26 9:59:10 ET]
Table 'Kale II' 9-max Seat #3 is the button
Seat 1: lootstool ($80.20 in chips) 
Seat 2: matiko09 ($100 in chips) 
Seat 3: Reven9er ($133.70 in chips) 
Seat 4: Jimy Tiltman ($195.57 in chips) 
Seat 5: Dante63s ($100 in chips) 
Seat 6: Filojoes ($121 in chips) 
Seat 8: mycka86 ($100 in chips) 
Seat 9: Sweden_Pound ($129.78 in chips) 
Jimy Tiltman: posts small blind $0.50
Dante63s: posts big blind $1
Kukuryzka: sits out 
*** HOLE CARDS ***
Dealt to matiko09 [Qd Ad]
Filojoes: folds 
mycka86: folds 
Sweden_Pound: raises $2 to $3
lootstool: folds 
matiko09: calls $3
Reven9er: folds 
Jimy Tiltman: folds 
Dante63s: folds 
*** FLOP *** [As Kd 9d]
Sweden_Pound: checks 
matiko09: bets $4.65
Sweden_Pound: folds 
Uncalled bet ($4.65) returned to matiko09
matiko09 collected $7.16 from pot
matiko09: doesn't show hand 
*** SUMMARY ***
Total pot $7.50 | Rake $0.34 
Board [As Kd 9d]
Seat 1: lootstool folded before Flop (didn't bet)
Seat 2: matiko09 collected ($7.16)
Seat 3: Reven9er (button) folded before Flop (didn't bet)
Seat 4: Jimy Tiltman (small blind) folded before Flop
Seat 5: Dante63s (big blind) folded before Flop
Seat 6: Filojoes folded before Flop (didn't bet)
Seat 8: mycka86 folded before Flop (didn't bet)
Seat 9: Sweden_Pound folded on the Flop





PokerStars Hand #147707570133:  Hold'em No Limit ($0.50/$1.00 USD) - 2016/01/26 15:59:17 CET [2016/01/26 9:59:17 ET]
Table 'Gyas IV' 9-max Seat #1 is the button
Seat 1: sharkside90 ($46.79 in chips) 
Seat 2: Dante63s ($121.84 in chips) 
Seat 3: solbi86 ($100 in chips) 
Seat 5: matiko09 ($108.18 in chips) 
Seat 6: Filojoes ($100 in chips) 
Seat 7: mycka86 ($101.50 in chips) 
Seat 9: Sweden_Pound ($120 in chips) 
Dante63s: posts small blind $0.50
solbi86: posts big blind $1
changpiao: sits out 
*** HOLE CARDS ***
Dealt to matiko09 [Qs Th]
matiko09: folds 
Filojoes: folds 
mycka86: folds 
Sweden_Pound: folds 
sharkside90: folds 
Dante63s: folds 
Uncalled bet ($0.50) returned to solbi86
solbi86 collected $1 from pot
solbi86: doesn't show hand 
*** SUMMARY ***
Total pot $1 | Rake $0 
Seat 1: sharkside90 (button) folded before Flop (didn't bet)
Seat 2: Dante63s (small blind) folded before Flop
Seat 3: solbi86 (big blind) collected ($1)
Seat 5: matiko09 folded before Flop (didn't bet)
Seat 6: Filojoes folded before Flop (didn't bet)
Seat 7: mycka86 folded before Flop (didn't bet)
Seat 9: Sweden_Pound folded before Flop (didn't bet)





PokerStars Hand #147707572002:  Hold'em No Limit ($0.50/$1.00 USD) - 2016/01/26 15:59:20 CET [2016/01/26 9:59:20 ET]
Table 'Haedus' 9-max Seat #8 is the button
Seat 1: Dante63s ($119.50 in chips) 
Seat 2: Sweden_Pound ($101.50 in chips) 
Seat 4: FroggyPlay ($106.37 in chips) 
Seat 5: matiko09 ($101.50 in chips) 
Seat 6: nnne409 ($60.57 in chips) 
Seat 7: KLOP06031987 ($110.50 in chips) 
Seat 8: Jimy Tiltman ($100 in chips) 
Seat 9: Filojoes ($100 in chips) 
Filojoes: posts small blind $0.50
Dante63s: posts big blind $1
*** HOLE CARDS ***
Dealt to matiko09 [9d 5h]
Sweden_Pound: folds 
FroggyPlay: folds 
matiko09: folds 
nnne409: folds 
KLOP06031987: folds 
Jimy Tiltman: folds 
Filojoes: raises $1.50 to $2.50
Dante63s: calls $1.50
*** FLOP *** [4s Qc 2d]
Filojoes: checks 
Dante63s: bets $3
Filojoes: folds 
Uncalled bet ($3) returned to Dante63s
Dante63s collected $4.78 from pot
Dante63s: doesn't show hand 
*** SUMMARY ***
Total pot $5 | Rake $0.22 
Board [4s Qc 2d]
Seat 1: Dante63s (big blind) collected ($4.78)
Seat 2: Sweden_Pound folded before Flop (didn't bet)
Seat 4: FroggyPlay folded before Flop (didn't bet)
Seat 5: matiko09 folded before Flop (didn't bet)
Seat 6: nnne409 folded before Flop (didn't bet)
Seat 7: KLOP06031987 folded before Flop (didn't bet)
Seat 8: Jimy Tiltman (button) folded before Flop (didn't bet)
Seat 9: Filojoes (small blind) folded on the Flop





PokerStars Hand #147707572510:  Hold'em No Limit ($0.50/$1.00 USD) - 2016/01/26 15:59:21 CET [2016/01/26 9:59:21 ET]
Table 'Strenua III' 9-max Seat #5 is the button
Seat 1: ICallSaul ($108.28 in chips) 
Seat 3: petalouda10 ($72.17 in chips) 
Seat 4: mycka86 ($121.67 in chips) 
Seat 5: DeWeijz ($40.37 in chips) 
Seat 6: matiko09 ($142.84 in chips) 
Seat 7: KLOP06031987 ($100 in chips) 
Seat 8: Filojoes ($100 in chips) 
Seat 9: Dante63s ($100 in chips) 
matiko09: posts small blind $0.50
KLOP06031987: posts big blind $1
*** HOLE CARDS ***
Dealt to matiko09 [Kd Ah]
Filojoes: folds 
Dante63s: folds 
ICallSaul: folds 
petalouda10: folds 
mycka86: raises $1.10 to $2.10
DeWeijz: folds 
matiko09: raises $6.40 to $8.50
KLOP06031987: folds 
mycka86: calls $6.40
*** FLOP *** [5h 7c 6d]
matiko09: checks 
mycka86: bets $10.45
matiko09: folds 
Uncalled bet ($10.45) returned to mycka86
mycka86 collected $17.19 from pot
*** SUMMARY ***
Total pot $18 | Rake $0.81 
Board [5h 7c 6d]
Seat 1: ICallSaul folded before Flop (didn't bet)
Seat 3: petalouda10 folded before Flop (didn't bet)
Seat 4: mycka86 collected ($17.19)
Seat 5: DeWeijz (button) folded before Flop (didn't bet)
Seat 6: matiko09 (small blind) folded on the Flop
Seat 7: KLOP06031987 (big blind) folded before Flop
Seat 8: Filojoes folded before Flop (didn't bet)
Seat 9: Dante63s folded before Flop (didn't bet)





PokerStars Hand #147707574558:  Hold'em No Limit ($0.50/$1.00 USD) - 2016/01/26 15:59:24 CET [2016/01/26 9:59:24 ET]
Table 'Mashona' 9-max Seat #4 is the button
Seat 1: maxxmeister ($100 in chips) 
Seat 2: werades ($201.10 in chips) 
Seat 3: matiko09 ($123.57 in chips) 
Seat 4: Sweden_Pound ($151.06 in chips) 
Seat 5: solbi86 ($147.05 in chips) 
Seat 6: Filojoes ($100 in chips) 
Seat 7: EB0LARAMA ($307.46 in chips) 
Seat 8: Jimy Tiltman ($177.16 in chips) 
solbi86: posts small blind $0.50
Filojoes: posts big blind $1
apfush: sits out 
*** HOLE CARDS ***
Dealt to matiko09 [As Ts]
EB0LARAMA: folds 
Jimy Tiltman: folds 
maxxmeister: folds 
werades: folds 
matiko09: raises $1.50 to $2.50
Sweden_Pound: folds 
solbi86: folds 
Filojoes: folds 
Uncalled bet ($1.50) returned to matiko09
matiko09 collected $2.50 from pot
matiko09: doesn't show hand 
*** SUMMARY ***
Total pot $2.50 | Rake $0 
Seat 1: maxxmeister folded before Flop (didn't bet)
Seat 2: werades folded before Flop (didn't bet)
Seat 3: matiko09 collected ($2.50)
Seat 4: Sweden_Pound (button) folded before Flop (didn't bet)
Seat 5: solbi86 (small blind) folded before Flop
Seat 6: Filojoes (big blind) folded before Flop
Seat 7: EB0LARAMA folded before Flop (didn't bet)
Seat 8: Jimy Tiltman folded before Flop (didn't bet)





PokerStars Hand #147707574278:  Hold'em No Limit ($0.50/$1.00 USD) - 2016/01/26 15:59:24 CET [2016/01/26 9:59:24 ET]
Table 'Achates III' 9-max Seat #6 is the button
Seat 1: CI58 ($100 in chips) 
Seat 2: matiko09 ($100 in chips) 
Seat 3: Jimy Tiltman ($100 in chips) 
Seat 5: Sweden_Pound ($234.60 in chips) 
Seat 6: Kukuryzka ($100 in chips) 
Seat 7: KLOP06031987 ($100 in chips) 
Seat 8: Männerzimmer ($211 in chips) 
Seat 9: T-chaos_IMBA ($329.42 in chips) 
KLOP06031987: posts small blind $0.50
Männerzimmer: posts big blind $1
*** HOLE CARDS ***
Dealt to matiko09 [7s 2d]
T-chaos_IMBA: folds 
CI58: folds 
matiko09: folds 
Jimy Tiltman: folds 
Sweden_Pound: folds 
Kukuryzka: folds 
KLOP06031987: raises $3 to $4
Männerzimmer: calls $3
*** FLOP *** [Js Jh 8d]
KLOP06031987: bets $3.05
Männerzimmer: folds 
Uncalled bet ($3.05) returned to KLOP06031987
KLOP06031987 collected $7.64 from pot
KLOP06031987: doesn't show hand 
*** SUMMARY ***
Total pot $8 | Rake $0.36 
Board [Js Jh 8d]
Seat 1: CI58 folded before Flop (didn't bet)
Seat 2: matiko09 folded before Flop (didn't bet)
Seat 3: Jimy Tiltman folded before Flop (didn't bet)
Seat 5: Sweden_Pound folded before Flop (didn't bet)
Seat 6: Kukuryzka (button) folded before Flop (didn't bet)
Seat 7: KLOP06031987 (small blind) collected ($7.64)
Seat 8: Männerzimmer (big blind) folded on the Flop
Seat 9: T-chaos_IMBA folded before Flop (didn't bet)





PokerStars Hand #147707578212:  Hold'em No Limit ($0.50/$1.00 USD) - 2016/01/26 15:59:30 CET [2016/01/26 9:59:30 ET]
Table 'Medusa III' 9-max Seat #7 is the button
Seat 1: soplak ($101.50 in chips) 
Seat 2: happydrake ($51.60 in chips) 
Seat 3: mycka86 ($108 in chips) 
Seat 4: Sweden_Pound ($152.48 in chips) 
Seat 5: matiko09 ($207.12 in chips) 
Seat 6: Dante63s ($191.49 in chips) 
Seat 7: Reven9er ($133.66 in chips) 
Seat 9: KLOP06031987 ($100 in chips) 
KLOP06031987: posts small blind $0.50
soplak: posts big blind $1
*** HOLE CARDS ***
Dealt to matiko09 [Tc 8c]
happydrake: raises $2.50 to $3.50
mycka86: folds 
Sweden_Pound: folds 
matiko09: folds 
Dante63s: folds 
Reven9er: calls $3.50
KLOP06031987: folds 
soplak: folds 
*** FLOP *** [8h 5d 3c]
happydrake: bets $4.06
Reven9er: calls $4.06
*** TURN *** [8h 5d 3c] [9h]
happydrake: checks 
Reven9er: checks 
*** RIVER *** [8h 5d 3c 9h] [8d]
happydrake: bets $15.87
Reven9er: raises $29.63 to $45.50
happydrake: calls $28.17 and is all-in
Uncalled bet ($1.46) returned to Reven9er
*** SHOW DOWN ***
Reven9er: shows [5h 5s] (a full house, Fives full of Eights)
happydrake: shows [Kc Ac] (a pair of Eights)
Reven9er collected $101.90 from pot
*** SUMMARY ***
Total pot $104.70 | Rake $2.80 
Board [8h 5d 3c 9h 8d]
Seat 1: soplak (big blind) folded before Flop
Seat 2: happydrake showed [Kc Ac] and lost with a pair of Eights
Seat 3: mycka86 folded before Flop (didn't bet)
Seat 4: Sweden_Pound folded before Flop (didn't bet)
Seat 5: matiko09 folded before Flop (didn't bet)
Seat 6: Dante63s folded before Flop (didn't bet)
Seat 7: Reven9er (button) showed [5h 5s] and won ($101.90) with a full house, Fives full of Eights
Seat 9: KLOP06031987 (small blind) folded before Flop





PokerStars Hand #147707582204:  Hold'em No Limit ($0.50/$1.00 USD) - 2016/01/26 15:59:37 CET [2016/01/26 9:59:37 ET]
Table 'Heike II' 9-max Seat #3 is the button
Seat 1: ilaviiitech ($120.01 in chips) 
Seat 2: Dante63s ($112.48 in chips) 
Seat 3: matiko09 ($120.95 in chips) 
Seat 4: Reven9er ($118.17 in chips) 
Seat 5: Sweden_Pound ($101.50 in chips) 
Seat 7: Momess ($100 in chips) 
Seat 8: THE RIPPER V ($55.45 in chips) 
Reven9er: posts small blind $0.50
Sweden_Pound: posts big blind $1
mycka86: sits out 
*** HOLE CARDS ***
Dealt to matiko09 [Qs 6s]
Momess: raises $1.50 to $2.50
THE RIPPER V: raises $4.50 to $7
ilaviiitech: folds 
Dante63s: folds 
matiko09: folds 
Reven9er: folds 
Sweden_Pound: folds 
Momess: calls $4.50
*** FLOP *** [Jd 5d 4h]
Momess: checks 
THE RIPPER V: checks 
*** TURN *** [Jd 5d 4h] [Ac]
Momess: checks 
THE RIPPER V: bets $7.40
Momess: folds 
Uncalled bet ($7.40) returned to THE RIPPER V
THE RIPPER V collected $14.80 from pot
THE RIPPER V: doesn't show hand 
*** SUMMARY ***
Total pot $15.50 | Rake $0.70 
Board [Jd 5d 4h Ac]
Seat 1: ilaviiitech folded before Flop (didn't bet)
Seat 2: Dante63s folded before Flop (didn't bet)
Seat 3: matiko09 (button) folded before Flop (didn't bet)
Seat 4: Reven9er (small blind) folded before Flop
Seat 5: Sweden_Pound (big blind) folded before Flop
Seat 7: Momess folded on the Turn
Seat 8: THE RIPPER V collected ($14.80)





PokerStars Hand #147707583490:  Hold'em No Limit ($0.50/$1.00 USD) - 2016/01/26 15:59:39 CET [2016/01/26 9:59:39 ET]
Table 'Calypso II' 9-max Seat #6 is the button
Seat 2: Hardwell1993 ($96.50 in chips) 
Seat 3: matiko09 ($217.75 in chips) 
Seat 4: Sweden_Pound ($116.29 in chips) 
Seat 5: mycka86 ($100 in chips) 
Seat 6: MrDeeee25 ($116.86 in chips) 
Seat 7: Jimy Tiltman ($100 in chips) 
Seat 8: Reven9er ($109.39 in chips) 
Seat 9: Filojoes ($160.43 in chips) 
Jimy Tiltman: posts small blind $0.50
Reven9er: posts big blind $1
*** HOLE CARDS ***
Dealt to matiko09 [Jd 8c]
Filojoes: folds 
Hardwell1993: folds 
matiko09: folds 
Sweden_Pound: folds 
mycka86: raises $1.10 to $2.10
MrDeeee25: calls $2.10
Jimy Tiltman: folds 
Reven9er: folds 
*** FLOP *** [2d 6s 4c]
mycka86: checks 
MrDeeee25: bets $2.72
mycka86: folds 
Uncalled bet ($2.72) returned to MrDeeee25
MrDeeee25 collected $5.44 from pot
*** SUMMARY ***
Total pot $5.70 | Rake $0.26 
Board [2d 6s 4c]
Seat 2: Hardwell1993 folded before Flop (didn't bet)
Seat 3: matiko09 folded before Flop (didn't bet)
Seat 4: Sweden_Pound folded before Flop (didn't bet)
Seat 5: mycka86 folded on the Flop
Seat 6: MrDeeee25 (button) collected ($5.44)
Seat 7: Jimy Tiltman (small blind) folded before Flop
Seat 8: Reven9er (big blind) folded before Flop
Seat 9: Filojoes folded before Flop (didn't bet)





PokerStars Hand #147707589146:  Hold'em No Limit ($0.50/$1.00 USD) - 2016/01/26 15:59:48 CET [2016/01/26 9:59:48 ET]
Table 'Montefiore' 9-max Seat #3 is the button
Seat 1: Celsinho0311 ($59.69 in chips) 
Seat 2: Dante63s ($100 in chips) 
Seat 3: Filojoes ($100 in chips) 
Seat 4: matiko09 ($107.05 in chips) 
Seat 5: ilaviiitech ($100 in chips) 
Seat 6: Kosh20 ($44.36 in chips) 
Seat 7: flozzi ($101.50 in chips) 
Seat 8: Kukuryzka ($100 in chips) 
Seat 9: KLOP06031987 ($100 in chips) 
matiko09: posts small blind $0.50
ilaviiitech: posts big blind $1
*** HOLE CARDS ***
Dealt to matiko09 [Qs Kh]
Kosh20: calls $1
flozzi: folds 
Kukuryzka: folds 
KLOP06031987: folds 
Celsinho0311: folds 
Dante63s: raises $2.50 to $3.50
Filojoes: folds 
matiko09: calls $3
ilaviiitech: folds 
Kosh20: calls $2.50
*** FLOP *** [7s Js 4h]
matiko09: bets $6
Kosh20: raises $13 to $19
Dante63s: calls $19
matiko09: folds 
*** TURN *** [7s Js 4h] [6d]
Kosh20: bets $21.86 and is all-in
Dante63s: calls $21.86
*** RIVER *** [7s Js 4h 6d] [8h]
*** SHOW DOWN ***
Kosh20: shows [Ah 7h] (a pair of Sevens)
Dante63s: shows [Ks Jh] (a pair of Jacks)
Dante63s collected $96.42 from pot
*** SUMMARY ***
Total pot $99.22 | Rake $2.80 
Board [7s Js 4h 6d 8h]
Seat 1: Celsinho0311 folded before Flop (didn't bet)
Seat 2: Dante63s showed [Ks Jh] and won ($96.42) with a pair of Jacks
Seat 3: Filojoes (button) folded before Flop (didn't bet)
Seat 4: matiko09 (small blind) folded on the Flop
Seat 5: ilaviiitech (big blind) folded before Flop
Seat 6: Kosh20 showed [Ah 7h] and lost with a pair of Sevens
Seat 7: flozzi folded before Flop (didn't bet)
Seat 8: Kukuryzka folded before Flop (didn't bet)
Seat 9: KLOP06031987 folded before Flop (didn't bet)





PokerStars Hand #147707590867:  Hold'em No Limit ($0.50/$1.00 USD) - 2016/01/26 15:59:51 CET [2016/01/26 9:59:51 ET]
Table 'Impala' 9-max Seat #7 is the button
Seat 1: mycka86 ($136.94 in chips) 
Seat 2: Filojoes ($101.50 in chips) 
Seat 3: Dante63s ($102.50 in chips) 
Seat 4: KLOP06031987 ($100 in chips) 
Seat 5: Kukuryzka ($100 in chips) 
Seat 6: Tijger R.d.J ($95.81 in chips) 
Seat 7: matiko09 ($125.15 in chips) 
Seat 8: apfush ($100 in chips) 
Seat 9: flozzi ($100 in chips) 
apfush: posts small blind $0.50
flozzi: posts big blind $1
*** HOLE CARDS ***
Dealt to matiko09 [Jc Jd]
mycka86: folds 
Filojoes: folds 
Dante63s: folds 
KLOP06031987: raises $1.31 to $2.31
Kukuryzka: folds 
Tijger R.d.J: folds 
matiko09: calls $2.31
apfush: folds 
flozzi: folds 
*** FLOP *** [5d Ts As]
KLOP06031987: bets $3
matiko09: calls $3
*** TURN *** [5d Ts As] [6s]
KLOP06031987: checks 
matiko09: checks 
*** RIVER *** [5d Ts As 6s] [9h]
KLOP06031987: checks 
matiko09: checks 
*** SHOW DOWN ***
KLOP06031987: shows [Qs Ad] (a pair of Aces)
matiko09: mucks hand 
KLOP06031987 collected $11.57 from pot
*** SUMMARY ***
Total pot $12.12 | Rake $0.55 
Board [5d Ts As 6s 9h]
Seat 1: mycka86 folded before Flop (didn't bet)
Seat 2: Filojoes folded before Flop (didn't bet)
Seat 3: Dante63s folded before Flop (didn't bet)
Seat 4: KLOP06031987 showed [Qs Ad] and won ($11.57) with a pair of Aces
Seat 5: Kukuryzka folded before Flop (didn't bet)
Seat 6: Tijger R.d.J folded before Flop (didn't bet)
Seat 7: matiko09 (button) mucked [Jc Jd]
Seat 8: apfush (small blind) folded before Flop
Seat 9: flozzi (big blind) folded before Flop





PokerStars Hand #147707592533:  Hold'em No Limit ($0.50/$1.00 USD) - 2016/01/26 15:59:53 CET [2016/01/26 9:59:53 ET]
Table 'Mashona' 9-max Seat #5 is the button
Seat 1: maxxmeister ($100 in chips) 
Seat 2: werades ($201.10 in chips) 
Seat 3: matiko09 ($125.07 in chips) 
Seat 4: Sweden_Pound ($151.06 in chips) 
Seat 5: solbi86 ($146.55 in chips) 
Seat 6: Filojoes ($100 in chips) 
Seat 7: EB0LARAMA ($307.46 in chips) 
Seat 8: Jimy Tiltman ($177.16 in chips) 
Filojoes: posts small blind $0.50
EB0LARAMA: posts big blind $1
apfush: sits out 
*** HOLE CARDS ***
Dealt to matiko09 [Qd 7c]
Jimy Tiltman: folds 
maxxmeister: folds 
werades: folds 
matiko09: folds 
Sweden_Pound: folds 
solbi86: folds 
Filojoes: raises $1.50 to $2.50
EB0LARAMA: calls $1.50
*** FLOP *** [3h As 4h]
Filojoes: checks 
EB0LARAMA: checks 
*** TURN *** [3h As 4h] [5c]
Filojoes: checks 
EB0LARAMA: checks 
*** RIVER *** [3h As 4h 5c] [Qc]
Filojoes: checks 
EB0LARAMA: bets $1
Filojoes: folds 
Uncalled bet ($1) returned to EB0LARAMA
EB0LARAMA collected $4.78 from pot
EB0LARAMA: doesn't show hand 
*** SUMMARY ***
Total pot $5 | Rake $0.22 
Board [3h As 4h 5c Qc]
Seat 1: maxxmeister folded before Flop (didn't bet)
Seat 2: werades folded before Flop (didn't bet)
Seat 3: matiko09 folded before Flop (didn't bet)
Seat 4: Sweden_Pound folded before Flop (didn't bet)
Seat 5: solbi86 (button) folded before Flop (didn't bet)
Seat 6: Filojoes (small blind) folded on the River
Seat 7: EB0LARAMA (big blind) collected ($4.78)
Seat 8: Jimy Tiltman folded before Flop (didn't bet)





PokerStars Hand #147707608337:  Hold'em No Limit ($0.50/$1.00 USD) - 2016/01/26 16:00:18 CET [2016/01/26 10:00:18 ET]
Table 'Haedus' 9-max Seat #9 is the button
Seat 1: Dante63s ($121.78 in chips) 
Seat 2: Sweden_Pound ($101.50 in chips) 
Seat 4: FroggyPlay ($106.37 in chips) 
Seat 5: matiko09 ($101.50 in chips) 
Seat 6: nnne409 ($60.57 in chips) 
Seat 7: KLOP06031987 ($110.50 in chips) 
Seat 8: Jimy Tiltman ($100 in chips) 
Seat 9: Filojoes ($100 in chips) 
Dante63s: posts small blind $0.50
Sweden_Pound: posts big blind $1
*** HOLE CARDS ***
Dealt to matiko09 [4s Jh]
FroggyPlay: folds 
matiko09: folds 
nnne409: folds 
KLOP06031987: folds 
Jimy Tiltman: raises $1 to $2
Filojoes: folds 
Dante63s: raises $6 to $8
Sweden_Pound: folds 
Jimy Tiltman: calls $6
*** FLOP *** [Qc 6d 7d]
Dante63s: checks 
Jimy Tiltman: bets $8.12
Dante63s: folds 
Uncalled bet ($8.12) returned to Jimy Tiltman
Jimy Tiltman collected $16.24 from pot
Jimy Tiltman: doesn't show hand 
*** SUMMARY ***
Total pot $17 | Rake $0.76 
Board [Qc 6d 7d]
Seat 1: Dante63s (small blind) folded on the Flop
Seat 2: Sweden_Pound (big blind) folded before Flop
Seat 4: FroggyPlay folded before Flop (didn't bet)
Seat 5: matiko09 folded before Flop (didn't bet)
Seat 6: nnne409 folded before Flop (didn't bet)
Seat 7: KLOP06031987 folded before Flop (didn't bet)
Seat 8: Jimy Tiltman collected ($16.24)
Seat 9: Filojoes (button) folded before Flop (didn't bet)





PokerStars Hand #147707609420:  Hold'em No Limit ($0.50/$1.00 USD) - 2016/01/26 16:00:20 CET [2016/01/26 10:00:20 ET]
Table 'Achates III' 9-max Seat #7 is the button
Seat 1: CI58 ($100 in chips) 
Seat 2: matiko09 ($100 in chips) 
Seat 3: Jimy Tiltman ($100 in chips) 
Seat 5: Sweden_Pound ($234.60 in chips) 
Seat 6: Kukuryzka ($100 in chips) 
Seat 7: KLOP06031987 ($103.64 in chips) 
Seat 8: Männerzimmer ($207 in chips) 
Seat 9: T-chaos_IMBA ($329.42 in chips) 
Männerzimmer: posts small blind $0.50
T-chaos_IMBA: posts big blind $1
*** HOLE CARDS ***
Dealt to matiko09 [Kc 7h]
CI58: folds 
matiko09: folds 
Jimy Tiltman: folds 
Sweden_Pound: folds 
Kukuryzka: raises $1.50 to $2.50
KLOP06031987: folds 
Männerzimmer: calls $2
T-chaos_IMBA: calls $1.50
*** FLOP *** [8s 4c 2s]
Männerzimmer: bets $3
T-chaos_IMBA: calls $3
Kukuryzka: calls $3
*** TURN *** [8s 4c 2s] [5d]
Männerzimmer: bets $7
T-chaos_IMBA: folds 
Kukuryzka: calls $7
*** RIVER *** [8s 4c 2s 5d] [5s]
Männerzimmer: bets $11
Kukuryzka: folds 
Uncalled bet ($11) returned to Männerzimmer
Männerzimmer collected $29.13 from pot
Männerzimmer: doesn't show hand 
*** SUMMARY ***
Total pot $30.50 | Rake $1.37 
Board [8s 4c 2s 5d 5s]
Seat 1: CI58 folded before Flop (didn't bet)
Seat 2: matiko09 folded before Flop (didn't bet)
Seat 3: Jimy Tiltman folded before Flop (didn't bet)
Seat 5: Sweden_Pound folded before Flop (didn't bet)
Seat 6: Kukuryzka folded on the River
Seat 7: KLOP06031987 (button) folded before Flop (didn't bet)
Seat 8: Männerzimmer (small blind) collected ($29.13)
Seat 9: T-chaos_IMBA (big blind) folded on the Turn





PokerStars Hand #147707612140:  Hold'em No Limit ($0.50/$1.00 USD) - 2016/01/26 16:00:24 CET [2016/01/26 10:00:24 ET]
Table 'Heike II' 9-max Seat #4 is the button
Seat 1: ilaviiitech ($120.01 in chips) 
Seat 2: Dante63s ($112.48 in chips) 
Seat 3: matiko09 ($120.95 in chips) 
Seat 4: Reven9er ($117.67 in chips) 
Seat 5: Sweden_Pound ($100.50 in chips) 
Seat 8: THE RIPPER V ($63.25 in chips) 
Sweden_Pound: posts small blind $0.50
Momess: is sitting out 
THE RIPPER V: posts big blind $1
mycka86: sits out 
*** HOLE CARDS ***
Dealt to matiko09 [Qc Th]
Momess leaves the table
ilaviiitech: raises $2 to $3
Dante63s: folds 
KLOP06031987 joins the table at seat #7 
matiko09: folds 
Reven9er: folds 
Sweden_Pound: folds 
THE RIPPER V: calls $2
*** FLOP *** [Tc 4d 2s]
THE RIPPER V: checks 
ilaviiitech: bets $5
THE RIPPER V: calls $5
*** TURN *** [Tc 4d 2s] [9h]
THE RIPPER V: checks 
ilaviiitech: checks 
*** RIVER *** [Tc 4d 2s 9h] [8d]
THE RIPPER V: checks 
ilaviiitech: bets $9.45
THE RIPPER V: calls $9.45
*** SHOW DOWN ***
ilaviiitech: shows [Ad As] (a pair of Aces)
THE RIPPER V: mucks hand 
ilaviiitech collected $33.81 from pot
*** SUMMARY ***
Total pot $35.40 | Rake $1.59 
Board [Tc 4d 2s 9h 8d]
Seat 1: ilaviiitech showed [Ad As] and won ($33.81) with a pair of Aces
Seat 2: Dante63s folded before Flop (didn't bet)
Seat 3: matiko09 folded before Flop (didn't bet)
Seat 4: Reven9er (button) folded before Flop (didn't bet)
Seat 5: Sweden_Pound (small blind) folded before Flop
Seat 8: THE RIPPER V (big blind) mucked [7h 4h]





PokerStars Hand #147707624285:  Hold'em No Limit ($0.50/$1.00 USD) - 2016/01/26 16:00:42 CET [2016/01/26 10:00:42 ET]
Table 'Calypso II' 9-max Seat #7 is the button
Seat 2: Hardwell1993 ($96.50 in chips) 
Seat 3: matiko09 ($217.75 in chips) 
Seat 4: Sweden_Pound ($116.29 in chips) 
Seat 5: mycka86 ($100 in chips) 
Seat 6: MrDeeee25 ($120.20 in chips) 
Seat 7: Jimy Tiltman ($100 in chips) 
Seat 8: Reven9er ($108.39 in chips) 
Seat 9: Filojoes ($160.43 in chips) 
Reven9er: posts small blind $0.50
Filojoes: posts big blind $1
*** HOLE CARDS ***
Dealt to matiko09 [Ts 9s]
Hardwell1993: calls $1
matiko09: raises $3 to $4
Sweden_Pound: folds 
mycka86: folds 
MrDeeee25: folds 
Jimy Tiltman: folds 
Reven9er: folds 
Filojoes: folds 
Hardwell1993: folds 
Uncalled bet ($3) returned to matiko09
matiko09 collected $3.50 from pot
matiko09: doesn't show hand 
*** SUMMARY ***
Total pot $3.50 | Rake $0 
Seat 2: Hardwell1993 folded before Flop
Seat 3: matiko09 collected ($3.50)
Seat 4: Sweden_Pound folded before Flop (didn't bet)
Seat 5: mycka86 folded before Flop (didn't bet)
Seat 6: MrDeeee25 folded before Flop (didn't bet)
Seat 7: Jimy Tiltman (button) folded before Flop (didn't bet)
Seat 8: Reven9er (small blind) folded before Flop
Seat 9: Filojoes (big blind) folded before Flop





PokerStars Hand #147707626287:  Hold'em No Limit ($0.50/$1.00 USD) - 2016/01/26 16:00:45 CET [2016/01/26 10:00:45 ET]
Table 'Kale II' 9-max Seat #4 is the button
Seat 1: lootstool ($80.20 in chips) 
Seat 2: matiko09 ($104.16 in chips) 
Seat 3: Reven9er ($133.70 in chips) 
Seat 4: Jimy Tiltman ($195.07 in chips) 
Seat 5: Dante63s ($100 in chips) 
Seat 6: Filojoes ($121 in chips) 
Seat 8: mycka86 ($100 in chips) 
Seat 9: Sweden_Pound ($126.78 in chips) 
Dante63s: posts small blind $0.50
Filojoes: posts big blind $1
Kukuryzka: sits out 
*** HOLE CARDS ***
Dealt to matiko09 [Td Qc]
mycka86: folds 
Sweden_Pound: folds 
lootstool: folds 
matiko09: folds 
Reven9er: folds 
Jimy Tiltman: raises $1 to $2
Dante63s: folds 
Filojoes: calls $1
*** FLOP *** [Th 9h 9d]
Filojoes: checks 
Jimy Tiltman: checks 
*** TURN *** [Th 9h 9d] [7h]
Filojoes: bets $2.58
Jimy Tiltman: folds 
Uncalled bet ($2.58) returned to Filojoes
Filojoes collected $4.30 from pot
Filojoes: doesn't show hand 
*** SUMMARY ***
Total pot $4.50 | Rake $0.20 
Board [Th 9h 9d 7h]
Seat 1: lootstool folded before Flop (didn't bet)
Seat 2: matiko09 folded before Flop (didn't bet)
Seat 3: Reven9er folded before Flop (didn't bet)
Seat 4: Jimy Tiltman (button) folded on the Turn
Seat 5: Dante63s (small blind) folded before Flop
Seat 6: Filojoes (big blind) collected ($4.30)
Seat 8: mycka86 folded before Flop (didn't bet)
Seat 9: Sweden_Pound folded before Flop (didn't bet)





PokerStars Hand #147707635735:  Hold'em No Limit ($0.50/$1.00 USD) - 2016/01/26 16:00:59 CET [2016/01/26 10:00:59 ET]
Table 'Mashona' 9-max Seat #6 is the button
Seat 1: maxxmeister ($100 in chips) 
Seat 2: werades ($201.10 in chips) 
Seat 3: matiko09 ($125.07 in chips) 
Seat 4: Sweden_Pound ($151.06 in chips) 
Seat 5: solbi86 ($146.55 in chips) 
Seat 6: Filojoes ($100 in chips) 
Seat 7: EB0LARAMA ($309.74 in chips) 
Seat 8: Jimy Tiltman ($177.16 in chips) 
EB0LARAMA: posts small blind $0.50
Jimy Tiltman: posts big blind $1
apfush: sits out 
*** HOLE CARDS ***
Dealt to matiko09 [Jh 4d]
maxxmeister: raises $3 to $4
werades: folds 
matiko09: folds 
Sweden_Pound: folds 
solbi86: calls $4
Filojoes: folds 
EB0LARAMA: folds 
Jimy Tiltman: folds 
*** FLOP *** [Qs 4h 8h]
maxxmeister: checks 
solbi86: bets $5.16
maxxmeister: calls $5.16
*** TURN *** [Qs 4h 8h] [7s]
maxxmeister: checks 
solbi86: bets $11
maxxmeister: calls $11
*** RIVER *** [Qs 4h 8h 7s] [Tc]
maxxmeister: checks 
solbi86: checks 
*** SHOW DOWN ***
maxxmeister: shows [Ac Ah] (a pair of Aces)
solbi86: mucks hand 
maxxmeister collected $39.94 from pot
*** SUMMARY ***
Total pot $41.82 | Rake $1.88 
Board [Qs 4h 8h 7s Tc]
Seat 1: maxxmeister showed [Ac Ah] and won ($39.94) with a pair of Aces
Seat 2: werades folded before Flop (didn't bet)
Seat 3: matiko09 folded before Flop (didn't bet)
Seat 4: Sweden_Pound folded before Flop (didn't bet)
Seat 5: solbi86 mucked [Qh Kh]
Seat 6: Filojoes (button) folded before Flop (didn't bet)
Seat 7: EB0LARAMA (small blind) folded before Flop
Seat 8: Jimy Tiltman (big blind) folded before Flop





PokerStars Hand #147707635139:  Hold'em No Limit ($0.50/$1.00 USD) - 2016/01/26 16:00:59 CET [2016/01/26 10:00:59 ET]
Table 'Strenua III' 9-max Seat #6 is the button
Seat 1: ICallSaul ($108.28 in chips) 
Seat 3: petalouda10 ($72.17 in chips) 
Seat 4: mycka86 ($130.36 in chips) 
Seat 5: DeWeijz ($40.37 in chips) 
Seat 6: matiko09 ($134.34 in chips) 
Seat 7: KLOP06031987 ($100 in chips) 
Seat 8: Filojoes ($100 in chips) 
Seat 9: Dante63s ($100 in chips) 
KLOP06031987: posts small blind $0.50
Filojoes: posts big blind $1
*** HOLE CARDS ***
Dealt to matiko09 [2s 7c]
Dante63s: folds 
ICallSaul: folds 
petalouda10: folds 
mycka86: raises $1.50 to $2.50
DeWeijz: folds 
matiko09: folds 
KLOP06031987: folds 
Filojoes: folds 
Uncalled bet ($1.50) returned to mycka86
mycka86 collected $2.50 from pot
*** SUMMARY ***
Total pot $2.50 | Rake $0 
Seat 1: ICallSaul folded before Flop (didn't bet)
Seat 3: petalouda10 folded before Flop (didn't bet)
Seat 4: mycka86 collected ($2.50)
Seat 5: DeWeijz folded before Flop (didn't bet)
Seat 6: matiko09 (button) folded before Flop (didn't bet)
Seat 7: KLOP06031987 (small blind) folded before Flop
Seat 8: Filojoes (big blind) folded before Flop
Seat 9: Dante63s folded before Flop (didn't bet)





PokerStars Hand #147707650179:  Hold'em No Limit ($0.50/$1.00 USD) - 2016/01/26 16:01:20 CET [2016/01/26 10:01:20 ET]
Table 'Impala' 9-max Seat #8 is the button
Seat 1: mycka86 ($136.94 in chips) 
Seat 2: Filojoes ($101.50 in chips) 
Seat 3: Dante63s ($102.50 in chips) 
Seat 4: KLOP06031987 ($106.26 in chips) 
Seat 5: Kukuryzka ($100 in chips) 
Seat 6: Tijger R.d.J ($95.81 in chips) 
Seat 7: matiko09 ($119.84 in chips) 
Seat 8: apfush ($100 in chips) 
Seat 9: flozzi ($100 in chips) 
flozzi: posts small blind $0.50
mycka86: posts big blind $1
*** HOLE CARDS ***
Dealt to matiko09 [4d 5s]
Filojoes: raises $2 to $3
Dante63s: folds 
KLOP06031987: folds 
Kukuryzka: folds 
Tijger R.d.J: folds 
matiko09: folds 
apfush: folds 
flozzi: calls $2.50
mycka86: folds 
*** FLOP *** [Ac 9s 4h]
flozzi: checks 
Filojoes: checks 
*** TURN *** [Ac 9s 4h] [5d]
flozzi: bets $4.80
Filojoes: calls $4.80
*** RIVER *** [Ac 9s 4h 5d] [Qs]
flozzi: checks 
Filojoes: bets $10
flozzi: calls $10
*** SHOW DOWN ***
Filojoes: shows [Kd Ad] (a pair of Aces)
flozzi: shows [Ks Ah] (a pair of Aces)
flozzi collected $17.48 from pot
Filojoes collected $17.47 from pot
*** SUMMARY ***
Total pot $36.60 | Rake $1.65 
Board [Ac 9s 4h 5d Qs]
Seat 1: mycka86 (big blind) folded before Flop
Seat 2: Filojoes showed [Kd Ad] and won ($17.47) with a pair of Aces
Seat 3: Dante63s folded before Flop (didn't bet)
Seat 4: KLOP06031987 folded before Flop (didn't bet)
Seat 5: Kukuryzka folded before Flop (didn't bet)
Seat 6: Tijger R.d.J folded before Flop (didn't bet)
Seat 7: matiko09 folded before Flop (didn't bet)
Seat 8: apfush (button) folded before Flop (didn't bet)
Seat 9: flozzi (small blind) showed [Ks Ah] and won ($17.48) with a pair of Aces





PokerStars Hand #147707652359:  Hold'em No Limit ($0.50/$1.00 USD) - 2016/01/26 16:01:24 CET [2016/01/26 10:01:24 ET]
Table 'Calypso II' 9-max Seat #8 is the button
Seat 2: Hardwell1993 ($95.50 in chips) 
Seat 3: matiko09 ($220.25 in chips) 
Seat 4: Sweden_Pound ($116.29 in chips) 
Seat 5: mycka86 ($100 in chips) 
Seat 6: MrDeeee25 ($120.20 in chips) 
Seat 7: Jimy Tiltman ($100 in chips) 
Seat 8: Reven9er ($107.89 in chips) 
Seat 9: Filojoes ($159.43 in chips) 
Filojoes: posts small blind $0.50
Hardwell1993: posts big blind $1
*** HOLE CARDS ***
Dealt to matiko09 [Ks Td]
matiko09: raises $2 to $3
Sweden_Pound: folds 
mycka86: folds 
MrDeeee25: calls $3
Jimy Tiltman: folds 
Reven9er: calls $3
Filojoes: folds 
Hardwell1993: calls $2
*** FLOP *** [3h Ah 6s]
Hardwell1993: checks 
matiko09: checks 
MrDeeee25: checks 
Reven9er: bets $5
Hardwell1993: folds 
matiko09: folds 
MrDeeee25: folds 
Uncalled bet ($5) returned to Reven9er
Reven9er collected $11.94 from pot
Reven9er: doesn't show hand 
*** SUMMARY ***
Total pot $12.50 | Rake $0.56 
Board [3h Ah 6s]
Seat 2: Hardwell1993 (big blind) folded on the Flop
Seat 3: matiko09 folded on the Flop
Seat 4: Sweden_Pound folded before Flop (didn't bet)
Seat 5: mycka86 folded before Flop (didn't bet)
Seat 6: MrDeeee25 folded on the Flop
Seat 7: Jimy Tiltman folded before Flop (didn't bet)
Seat 8: Reven9er (button) collected ($11.94)
Seat 9: Filojoes (small blind) folded before Flop





PokerStars Hand #147707656027:  Hold'em No Limit ($0.50/$1.00 USD) - 2016/01/26 16:01:28 CET [2016/01/26 10:01:28 ET]
Table 'Achates III' 9-max Seat #8 is the button
Seat 1: CI58 ($100 in chips) 
Seat 2: matiko09 ($100 in chips) 
Seat 3: Jimy Tiltman ($100 in chips) 
Seat 5: Sweden_Pound ($234.60 in chips) 
Seat 6: Kukuryzka ($100 in chips) 
Seat 7: KLOP06031987 ($103.64 in chips) 
Seat 8: Männerzimmer ($223.63 in chips) 
Seat 9: T-chaos_IMBA ($323.92 in chips) 
T-chaos_IMBA: posts small blind $0.50
CI58: posts big blind $1
cn_chayanne: sits out 
*** HOLE CARDS ***
Dealt to matiko09 [6h Ks]
matiko09: folds 
Jimy Tiltman: folds 
Sweden_Pound: folds 
Kukuryzka: folds 
KLOP06031987: folds 
Männerzimmer: folds 
T-chaos_IMBA: folds 
Uncalled bet ($0.50) returned to CI58
CI58 collected $1 from pot
CI58: doesn't show hand 
*** SUMMARY ***
Total pot $1 | Rake $0 
Seat 1: CI58 (big blind) collected ($1)
Seat 2: matiko09 folded before Flop (didn't bet)
Seat 3: Jimy Tiltman folded before Flop (didn't bet)
Seat 5: Sweden_Pound folded before Flop (didn't bet)
Seat 6: Kukuryzka folded before Flop (didn't bet)
Seat 7: KLOP06031987 folded before Flop (didn't bet)
Seat 8: Männerzimmer (button) folded before Flop (didn't bet)
Seat 9: T-chaos_IMBA (small blind) folded before Flop





PokerStars Hand #147707656554:  Hold'em No Limit ($0.50/$1.00 USD) - 2016/01/26 16:01:29 CET [2016/01/26 10:01:29 ET]
Table 'Strenua III' 9-max Seat #7 is the button
Seat 1: ICallSaul ($108.28 in chips) 
Seat 3: petalouda10 ($72.17 in chips) 
Seat 4: mycka86 ($131.86 in chips) 
Seat 5: DeWeijz ($40.37 in chips) 
Seat 6: matiko09 ($134.34 in chips) 
Seat 7: KLOP06031987 ($100 in chips) 
Seat 8: Filojoes ($100 in chips) 
Seat 9: Dante63s ($100 in chips) 
Filojoes: posts small blind $0.50
Dante63s: posts big blind $1
cn_chayanne: sits out 
*** HOLE CARDS ***
Dealt to matiko09 [Kd Th]
ICallSaul: folds 
petalouda10: folds 
mycka86: folds 
DeWeijz: folds 
matiko09: raises $1.50 to $2.50
KLOP06031987: folds 
Filojoes: raises $6.75 to $9.25
Dante63s: raises $9.75 to $19
matiko09: folds 
Filojoes: raises $15 to $34
Dante63s: folds 
Uncalled bet ($15) returned to Filojoes
Filojoes collected $40.50 from pot
Filojoes: doesn't show hand 
*** SUMMARY ***
Total pot $40.50 | Rake $0 
Seat 1: ICallSaul folded before Flop (didn't bet)
Seat 3: petalouda10 folded before Flop (didn't bet)
Seat 4: mycka86 folded before Flop (didn't bet)
Seat 5: DeWeijz folded before Flop (didn't bet)
Seat 6: matiko09 folded before Flop
Seat 7: KLOP06031987 (button) folded before Flop (didn't bet)
Seat 8: Filojoes (small blind) collected ($40.50)
Seat 9: Dante63s (big blind) folded before Flop





PokerStars Hand #147707657519:  Hold'em No Limit ($0.50/$1.00 USD) - 2016/01/26 16:01:30 CET [2016/01/26 10:01:30 ET]
Table 'Heike II' 9-max Seat #5 is the button
Seat 1: ilaviiitech ($136.37 in chips) 
Seat 2: Dante63s ($112.48 in chips) 
Seat 3: matiko09 ($120.95 in chips) 
Seat 4: Reven9er ($117.67 in chips) 
Seat 5: Sweden_Pound ($100 in chips) 
Seat 8: THE RIPPER V ($45.80 in chips) 
Seat 9: mycka86 ($100 in chips) 
THE RIPPER V: posts small blind $0.50
mycka86: posts big blind $1
*** HOLE CARDS ***
Dealt to matiko09 [Ah 9c]
ilaviiitech: folds 
Dante63s: folds 
matiko09: folds 
Reven9er: folds 
Sweden_Pound: folds 
THE RIPPER V: raises $1.25 to $2.25
mycka86: calls $1.25
*** FLOP *** [Jh Tc 3s]
THE RIPPER V: bets $1.50
mycka86: raises $3.50 to $5
THE RIPPER V: folds 
Uncalled bet ($3.50) returned to mycka86
mycka86 collected $7.16 from pot
*** SUMMARY ***
Total pot $7.50 | Rake $0.34 
Board [Jh Tc 3s]
Seat 1: ilaviiitech folded before Flop (didn't bet)
Seat 2: Dante63s folded before Flop (didn't bet)
Seat 3: matiko09 folded before Flop (didn't bet)
Seat 4: Reven9er folded before Flop (didn't bet)
Seat 5: Sweden_Pound (button) folded before Flop (didn't bet)
Seat 8: THE RIPPER V (small blind) folded on the Flop
Seat 9: mycka86 (big blind) collected ($7.16)





PokerStars Hand #147707659112:  Hold'em No Limit ($0.50/$1.00 USD) - 2016/01/26 16:01:32 CET [2016/01/26 10:01:32 ET]
Table 'Medusa III' 9-max Seat #9 is the button
Seat 1: soplak ($100.50 in chips) 
Seat 3: mycka86 ($108 in chips) 
Seat 4: Sweden_Pound ($152.48 in chips) 
Seat 5: matiko09 ($207.12 in chips) 
Seat 6: Dante63s ($191.49 in chips) 
Seat 7: Reven9er ($183.96 in chips) 
Seat 9: KLOP06031987 ($100 in chips) 
soplak: posts small blind $0.50
mycka86: posts big blind $1
cn_chayanne: sits out 
*** HOLE CARDS ***
Dealt to matiko09 [Tc 8d]
Sweden_Pound: folds 
Reven9er said, "(y)"
matiko09: folds 
Dante63s: raises $1.50 to $2.50
cn_chayanne leaves the table
Reven9er: folds 
Filojoes joins the table at seat #8 
KLOP06031987: folds 
soplak: folds 
mycka86: folds 
Uncalled bet ($1.50) returned to Dante63s
Dante63s collected $2.50 from pot
*** SUMMARY ***
Total pot $2.50 | Rake $0 
Seat 1: soplak (small blind) folded before Flop
Seat 3: mycka86 (big blind) folded before Flop
Seat 4: Sweden_Pound folded before Flop (didn't bet)
Seat 5: matiko09 folded before Flop (didn't bet)
Seat 6: Dante63s collected ($2.50)
Seat 7: Reven9er folded before Flop (didn't bet)
Seat 9: KLOP06031987 (button) folded before Flop (didn't bet)





PokerStars Hand #147707659078:  Hold'em No Limit ($0.50/$1.00 USD) - 2016/01/26 16:01:32 CET [2016/01/26 10:01:32 ET]
Table 'Haedus' 9-max Seat #1 is the button
Seat 1: Dante63s ($113.78 in chips) 
Seat 2: Sweden_Pound ($100.50 in chips) 
Seat 3: cn_chayanne ($106.87 in chips) 
Seat 4: FroggyPlay ($106.37 in chips) 
Seat 5: matiko09 ($101.50 in chips) 
Seat 6: nnne409 ($60.57 in chips) 
Seat 7: KLOP06031987 ($110.50 in chips) 
Seat 8: Jimy Tiltman ($108.24 in chips) 
Seat 9: Filojoes ($100 in chips) 
Sweden_Pound: posts small blind $0.50
cn_chayanne: posts big blind $1
*** HOLE CARDS ***
Dealt to matiko09 [Jh 2s]
FroggyPlay: folds 
matiko09: folds 
nnne409: raises $1 to $2
KLOP06031987: folds 
Jimy Tiltman: folds 
Filojoes: folds 
Dante63s: folds 
Sweden_Pound: folds 
cn_chayanne: folds 
Uncalled bet ($1) returned to nnne409
nnne409 collected $2.50 from pot
nnne409: doesn't show hand 
*** SUMMARY ***
Total pot $2.50 | Rake $0 
Seat 1: Dante63s (button) folded before Flop (didn't bet)
Seat 2: Sweden_Pound (small blind) folded before Flop
Seat 3: cn_chayanne (big blind) folded before Flop
Seat 4: FroggyPlay folded before Flop (didn't bet)
Seat 5: matiko09 folded before Flop (didn't bet)
Seat 6: nnne409 collected ($2.50)
Seat 7: KLOP06031987 folded before Flop (didn't bet)
Seat 8: Jimy Tiltman folded before Flop (didn't bet)
Seat 9: Filojoes folded before Flop (didn't bet)





PokerStars Hand #147707662897:  Hold'em No Limit ($0.50/$1.00 USD) - 2016/01/26 16:01:38 CET [2016/01/26 10:01:38 ET]
Table 'Montefiore' 9-max Seat #4 is the button
Seat 1: Celsinho0311 ($59.69 in chips) 
Seat 2: Dante63s ($152.06 in chips) 
Seat 3: Filojoes ($100 in chips) 
Seat 4: matiko09 ($100 in chips) 
Seat 5: ilaviiitech ($100 in chips) 
Seat 8: Kukuryzka ($100 in chips) 
Seat 9: KLOP06031987 ($100 in chips) 
ilaviiitech: posts small blind $0.50
flozzi: is sitting out 
Kukuryzka: posts big blind $1
*** HOLE CARDS ***
Dealt to matiko09 [9c 8c]
KLOP06031987: folds 
Celsinho0311: folds 
flozzi leaves the table
Dante63s: folds 
Filojoes: folds 
Kosh20 leaves the table
matiko09: raises $1.27 to $2.27
ilaviiitech: folds 
Kukuryzka: folds 
Uncalled bet ($1.27) returned to matiko09
matiko09 collected $2.50 from pot
matiko09: doesn't show hand 
*** SUMMARY ***
Total pot $2.50 | Rake $0 
Seat 1: Celsinho0311 folded before Flop (didn't bet)
Seat 2: Dante63s folded before Flop (didn't bet)
Seat 3: Filojoes folded before Flop (didn't bet)
Seat 4: matiko09 (button) collected ($2.50)
Seat 5: ilaviiitech (small blind) folded before Flop
Seat 8: Kukuryzka (big blind) folded before Flop
Seat 9: KLOP06031987 folded before Flop (didn't bet)





PokerStars Hand #147707686141:  Hold'em No Limit ($0.50/$1.00 USD) - 2016/01/26 16:02:09 CET [2016/01/26 10:02:09 ET]
Table 'Achates III' 9-max Seat #9 is the button
Seat 1: CI58 ($100.50 in chips) 
Seat 2: matiko09 ($100 in chips) 
Seat 3: Jimy Tiltman ($100 in chips) 
Seat 5: Sweden_Pound ($234.60 in chips) 
Seat 6: Kukuryzka ($100 in chips) 
Seat 7: KLOP06031987 ($103.64 in chips) 
Seat 8: Männerzimmer ($223.63 in chips) 
Seat 9: T-chaos_IMBA ($323.42 in chips) 
CI58: posts small blind $0.50
matiko09: posts big blind $1
cn_chayanne: sits out 
*** HOLE CARDS ***
Dealt to matiko09 [7c 7h]
Jimy Tiltman: folds 
Sweden_Pound: folds 
Kukuryzka: raises $2 to $3
KLOP06031987: folds 
Männerzimmer: calls $3
T-chaos_IMBA: folds 
CI58: folds 
matiko09: calls $2
*** FLOP *** [Kh 7d Ks]
matiko09: checks 
Kukuryzka: checks 
Männerzimmer: bets $4
matiko09: calls $4
Kukuryzka: raises $12 to $16
Männerzimmer: folds 
matiko09: raises $12 to $28
Kukuryzka: folds 
Uncalled bet ($12) returned to matiko09
Männerzimmer leaves the table
matiko09 collected $43.45 from pot
matiko09: doesn't show hand 
*** SUMMARY ***
Total pot $45.50 | Rake $2.05 
Board [Kh 7d Ks]
Seat 1: CI58 (small blind) folded before Flop
Seat 2: matiko09 (big blind) collected ($43.45)
Seat 3: Jimy Tiltman folded before Flop (didn't bet)
Seat 5: Sweden_Pound folded before Flop (didn't bet)
Seat 6: Kukuryzka folded on the Flop
Seat 7: KLOP06031987 folded before Flop (didn't bet)
Seat 8: Männerzimmer folded on the Flop
Seat 9: T-chaos_IMBA (button) folded before Flop (didn't bet)





PokerStars Hand #147707687994:  Hold'em No Limit ($0.50/$1.00 USD) - 2016/01/26 16:02:11 CET [2016/01/26 10:02:11 ET]
Table 'Montefiore' 9-max Seat #5 is the button
Seat 1: Celsinho0311 ($59.69 in chips) 
Seat 2: Dante63s ($152.06 in chips) 
Seat 3: Filojoes ($100 in chips) 
Seat 4: matiko09 ($101.50 in chips) 
Seat 5: ilaviiitech ($100 in chips) 
Seat 8: Kukuryzka ($99 in chips) 
Seat 9: KLOP06031987 ($100 in chips) 
Kukuryzka: posts small blind $0.50
KLOP06031987: posts big blind $1
*** HOLE CARDS ***
Dealt to matiko09 [As 7c]
Celsinho0311: folds 
Dante63s: folds 
mycka86 joins the table at seat #7 
Filojoes: raises $2 to $3
matiko09: folds 
FroggyPlay joins the table at seat #6 
ilaviiitech: raises $6 to $9
Kukuryzka: folds 
KLOP06031987: folds 
Filojoes: folds 
Uncalled bet ($6) returned to ilaviiitech
ilaviiitech collected $7.50 from pot
ilaviiitech: doesn't show hand 
*** SUMMARY ***
Total pot $7.50 | Rake $0 
Seat 1: Celsinho0311 folded before Flop (didn't bet)
Seat 2: Dante63s folded before Flop (didn't bet)
Seat 3: Filojoes folded before Flop
Seat 4: matiko09 folded before Flop (didn't bet)
Seat 5: ilaviiitech (button) collected ($7.50)
Seat 8: Kukuryzka (small blind) folded before Flop
Seat 9: KLOP06031987 (big blind) folded before Flop





PokerStars Hand #147707689634:  Hold'em No Limit ($0.50/$1.00 USD) - 2016/01/26 16:02:14 CET [2016/01/26 10:02:14 ET]
Table 'Medusa III' 9-max Seat #1 is the button
Seat 1: soplak ($100 in chips) 
Seat 3: mycka86 ($107 in chips) 
Seat 4: Sweden_Pound ($152.48 in chips) 
Seat 5: matiko09 ($207.12 in chips) 
Seat 6: Dante63s ($192.99 in chips) 
Seat 7: Reven9er ($183.96 in chips) 
Seat 9: KLOP06031987 ($100 in chips) 
mycka86: posts small blind $0.50
Sweden_Pound: posts big blind $1
Filojoes: sits out 
*** HOLE CARDS ***
Dealt to matiko09 [9c Qc]
matiko09: folds 
Dante63s: folds 
Reven9er: folds 
KLOP06031987: raises $1.31 to $2.31
soplak: folds 
mycka86: folds 
Sweden_Pound: folds 
Uncalled bet ($1.31) returned to KLOP06031987
KLOP06031987 collected $2.50 from pot
KLOP06031987: doesn't show hand 
*** SUMMARY ***
Total pot $2.50 | Rake $0 
Seat 1: soplak (button) folded before Flop (didn't bet)
Seat 3: mycka86 (small blind) folded before Flop
Seat 4: Sweden_Pound (big blind) folded before Flop
Seat 5: matiko09 folded before Flop (didn't bet)
Seat 6: Dante63s folded before Flop (didn't bet)
Seat 7: Reven9er folded before Flop (didn't bet)
Seat 9: KLOP06031987 collected ($2.50)





PokerStars Hand #147707692898:  Hold'em No Limit ($0.50/$1.00 USD) - 2016/01/26 16:02:18 CET [2016/01/26 10:02:18 ET]
Table 'Kale II' 9-max Seat #5 is the button
Seat 1: lootstool ($80.20 in chips) 
Seat 2: matiko09 ($104.16 in chips) 
Seat 3: Reven9er ($133.70 in chips) 
Seat 4: Jimy Tiltman ($193.07 in chips) 
Seat 5: Dante63s ($100 in chips) 
Seat 6: Filojoes ($123.30 in chips) 
Seat 7: Kukuryzka ($100 in chips) 
Seat 8: mycka86 ($100 in chips) 
Seat 9: Sweden_Pound ($126.78 in chips) 
Filojoes: posts small blind $0.50
Kukuryzka: posts big blind $1
*** HOLE CARDS ***
Dealt to matiko09 [6d Kh]
mycka86: folds 
Sweden_Pound: folds 
lootstool: folds 
matiko09: folds 
Reven9er: folds 
Jimy Tiltman: folds 
Dante63s: raises $1 to $2
Filojoes: folds 
Kukuryzka: calls $1
*** FLOP *** [5c 3h Js]
Kukuryzka: checks 
Dante63s: checks 
*** TURN *** [5c 3h Js] [2c]
Kukuryzka: bets $2.50
Dante63s: folds 
Uncalled bet ($2.50) returned to Kukuryzka
Kukuryzka collected $4.30 from pot
Kukuryzka: doesn't show hand 
*** SUMMARY ***
Total pot $4.50 | Rake $0.20 
Board [5c 3h Js 2c]
Seat 1: lootstool folded before Flop (didn't bet)
Seat 2: matiko09 folded before Flop (didn't bet)
Seat 3: Reven9er folded before Flop (didn't bet)
Seat 4: Jimy Tiltman folded before Flop (didn't bet)
Seat 5: Dante63s (button) folded on the Turn
Seat 6: Filojoes (small blind) folded before Flop
Seat 7: Kukuryzka (big blind) collected ($4.30)
Seat 8: mycka86 folded before Flop (didn't bet)
Seat 9: Sweden_Pound folded before Flop (didn't bet)





PokerStars Hand #147707701035:  Hold'em No Limit ($0.50/$1.00 USD) - 2016/01/26 16:02:30 CET [2016/01/26 10:02:30 ET]
Table 'Heike II' 9-max Seat #8 is the button
Seat 1: ilaviiitech ($136.37 in chips) 
Seat 2: Dante63s ($112.48 in chips) 
Seat 3: matiko09 ($120.95 in chips) 
Seat 4: Reven9er ($117.67 in chips) 
Seat 5: Sweden_Pound ($100 in chips) 
Seat 8: THE RIPPER V ($42.05 in chips) 
Seat 9: mycka86 ($103.41 in chips) 
mycka86: posts small blind $0.50
ilaviiitech: posts big blind $1
*** HOLE CARDS ***
Dealt to matiko09 [9d Qd]
Dante63s: folds 
matiko09: folds 
Reven9er: raises $1 to $2
Sweden_Pound: folds 
THE RIPPER V: folds 
THE RIPPER V leaves the table
mycka86: folds 
ilaviiitech: calls $1
*** FLOP *** [5d 7c Jc]
ilaviiitech: checks 
Reven9er: bets $1.50
ilaviiitech: calls $1.50
*** TURN *** [5d 7c Jc] [8c]
ilaviiitech: checks 
Reven9er: checks 
*** RIVER *** [5d 7c Jc 8c] [3d]
ilaviiitech: bets $4.29
Reven9er: folds 
Uncalled bet ($4.29) returned to ilaviiitech
ilaviiitech collected $7.16 from pot
ilaviiitech: doesn't show hand 
*** SUMMARY ***
Total pot $7.50 | Rake $0.34 
Board [5d 7c Jc 8c 3d]
Seat 1: ilaviiitech (big blind) collected ($7.16)
Seat 2: Dante63s folded before Flop (didn't bet)
Seat 3: matiko09 folded before Flop (didn't bet)
Seat 4: Reven9er folded on the River
Seat 5: Sweden_Pound folded before Flop (didn't bet)
Seat 8: THE RIPPER V (button) folded before Flop (didn't bet)
Seat 9: mycka86 (small blind) folded before Flop





PokerStars Hand #147707704219:  Hold'em No Limit ($0.50/$1.00 USD) - 2016/01/26 16:02:34 CET [2016/01/26 10:02:34 ET]
Table 'Medusa III' 9-max Seat #3 is the button
Seat 1: soplak ($100 in chips) 
Seat 2: happydrake ($90.50 in chips) 
Seat 3: mycka86 ($106.50 in chips) 
Seat 4: Sweden_Pound ($151.48 in chips) 
Seat 5: matiko09 ($207.12 in chips) 
Seat 6: Dante63s ($192.99 in chips) 
Seat 7: Reven9er ($183.96 in chips) 
Seat 9: KLOP06031987 ($101.50 in chips) 
Sweden_Pound: posts small blind $0.50
matiko09: posts big blind $1
Filojoes: sits out 
happydrake: posts small & big blinds $1.50
*** HOLE CARDS ***
Dealt to matiko09 [Ac Ah]
Dante63s: folds 
Reven9er: folds 
KLOP06031987: folds 
soplak: raises $3 to $4
happydrake: folds 
mycka86: folds 
Sweden_Pound: folds 
matiko09: raises $8 to $12
soplak: calls $8
*** FLOP *** [2d 6h 3d]
matiko09: bets $14
soplak: calls $14
*** TURN *** [2d 6h 3d] [8c]
matiko09: bets $32
soplak: folds 
Uncalled bet ($32) returned to matiko09
matiko09 collected $51.57 from pot
matiko09: doesn't show hand 
*** SUMMARY ***
Total pot $54 | Rake $2.43 
Board [2d 6h 3d 8c]
Seat 1: soplak folded on the Turn
Seat 2: happydrake folded before Flop
Seat 3: mycka86 (button) folded before Flop (didn't bet)
Seat 4: Sweden_Pound (small blind) folded before Flop
Seat 5: matiko09 (big blind) collected ($51.57)
Seat 6: Dante63s folded before Flop (didn't bet)
Seat 7: Reven9er folded before Flop (didn't bet)
Seat 9: KLOP06031987 folded before Flop (didn't bet)





PokerStars Hand #147707708652:  Hold'em No Limit ($0.50/$1.00 USD) - 2016/01/26 16:02:40 CET [2016/01/26 10:02:40 ET]
Table 'Mashona' 9-max Seat #7 is the button
Seat 1: maxxmeister ($119.78 in chips) 
Seat 2: werades ($201.10 in chips) 
Seat 3: matiko09 ($125.07 in chips) 
Seat 4: Sweden_Pound ($151.06 in chips) 
Seat 5: solbi86 ($126.39 in chips) 
Seat 6: Filojoes ($100 in chips) 
Seat 7: EB0LARAMA ($309.24 in chips) 
Seat 8: Jimy Tiltman ($176.16 in chips) 
Seat 9: apfush ($100 in chips) 
Jimy Tiltman: posts small blind $0.50
apfush: posts big blind $1
*** HOLE CARDS ***
Dealt to matiko09 [4d Ks]
maxxmeister: folds 
werades: folds 
matiko09: folds 
Sweden_Pound: folds 
solbi86: folds 
Filojoes: folds 
EB0LARAMA: folds 
Jimy Tiltman: folds 
Uncalled bet ($0.50) returned to apfush
apfush collected $1 from pot
apfush: doesn't show hand 
*** SUMMARY ***
Total pot $1 | Rake $0 
Seat 1: maxxmeister folded before Flop (didn't bet)
Seat 2: werades folded before Flop (didn't bet)
Seat 3: matiko09 folded before Flop (didn't bet)
Seat 4: Sweden_Pound folded before Flop (didn't bet)
Seat 5: solbi86 folded before Flop (didn't bet)
Seat 6: Filojoes folded before Flop (didn't bet)
Seat 7: EB0LARAMA (button) folded before Flop (didn't bet)
Seat 8: Jimy Tiltman (small blind) folded before Flop
Seat 9: apfush (big blind) collected ($1)





PokerStars Hand #147707714475:  Hold'em No Limit ($0.50/$1.00 USD) - 2016/01/26 16:02:48 CET [2016/01/26 10:02:48 ET]
Table 'Impala' 9-max Seat #9 is the button
Seat 1: mycka86 ($135.94 in chips) 
Seat 2: Filojoes ($101.17 in chips) 
Seat 3: Dante63s ($102.50 in chips) 
Seat 4: KLOP06031987 ($106.26 in chips) 
Seat 5: Kukuryzka ($100 in chips) 
Seat 6: Tijger R.d.J ($95.81 in chips) 
Seat 7: matiko09 ($119.84 in chips) 
Seat 8: apfush ($100 in chips) 
Seat 9: flozzi ($100 in chips) 
mycka86: posts small blind $0.50
Filojoes: posts big blind $1
*** HOLE CARDS ***
Dealt to matiko09 [3h Kd]
Dante63s: folds 
KLOP06031987: folds 
Kukuryzka: folds 
Tijger R.d.J: raises $1.34 to $2.34
matiko09: folds 
apfush: folds 
flozzi: folds 
mycka86: folds 
Filojoes: calls $1.34
*** FLOP *** [2s 5d Ac]
Filojoes: checks 
Tijger R.d.J: bets $2.45
Filojoes: folds 
Uncalled bet ($2.45) returned to Tijger R.d.J
Tijger R.d.J collected $4.95 from pot
Tijger R.d.J: doesn't show hand 
*** SUMMARY ***
Total pot $5.18 | Rake $0.23 
Board [2s 5d Ac]
Seat 1: mycka86 (small blind) folded before Flop
Seat 2: Filojoes (big blind) folded on the Flop
Seat 3: Dante63s folded before Flop (didn't bet)
Seat 4: KLOP06031987 folded before Flop (didn't bet)
Seat 5: Kukuryzka folded before Flop (didn't bet)
Seat 6: Tijger R.d.J collected ($4.95)
Seat 7: matiko09 folded before Flop (didn't bet)
Seat 8: apfush folded before Flop (didn't bet)
Seat 9: flozzi (button) folded before Flop (didn't bet)





PokerStars Hand #147707724411:  Hold'em No Limit ($0.50/$1.00 USD) - 2016/01/26 16:03:01 CET [2016/01/26 10:03:01 ET]
Table 'Calypso II' 9-max Seat #9 is the button
Seat 2: Hardwell1993 ($92.50 in chips) 
Seat 3: matiko09 ($217.25 in chips) 
Seat 4: Sweden_Pound ($116.29 in chips) 
Seat 5: mycka86 ($100 in chips) 
Seat 6: MrDeeee25 ($117.20 in chips) 
Seat 7: Jimy Tiltman ($100 in chips) 
Seat 8: Reven9er ($116.83 in chips) 
Seat 9: Filojoes ($158.93 in chips) 
KLOP06031987 will be allowed to play after the button
Hardwell1993: posts small blind $0.50
matiko09: posts big blind $1
*** HOLE CARDS ***
Dealt to matiko09 [8c 4c]
Sweden_Pound: folds 
mycka86: raises $2 to $3
MrDeeee25: calls $3
Jimy Tiltman: folds 
Reven9er: folds 
Filojoes: raises $9 to $12
Hardwell1993: folds 
matiko09: folds 
mycka86: raises $13.50 to $25.50
MrDeeee25: folds 
Filojoes: folds 
Uncalled bet ($13.50) returned to mycka86
mycka86 collected $28.50 from pot
*** SUMMARY ***
Total pot $28.50 | Rake $0 
Seat 2: Hardwell1993 (small blind) folded before Flop
Seat 3: matiko09 (big blind) folded before Flop
Seat 4: Sweden_Pound folded before Flop (didn't bet)
Seat 5: mycka86 collected ($28.50)
Seat 6: MrDeeee25 folded before Flop
Seat 7: Jimy Tiltman folded before Flop (didn't bet)
Seat 8: Reven9er folded before Flop (didn't bet)
Seat 9: Filojoes (button) folded before Flop





PokerStars Hand #147707726359:  Hold'em No Limit ($0.50/$1.00 USD) - 2016/01/26 16:03:04 CET [2016/01/26 10:03:04 ET]
Table 'Strenua III' 9-max Seat #8 is the button
Seat 1: ICallSaul ($108.28 in chips) 
Seat 3: petalouda10 ($72.17 in chips) 
Seat 4: mycka86 ($131.86 in chips) 
Seat 5: DeWeijz ($40.37 in chips) 
Seat 6: matiko09 ($131.84 in chips) 
Seat 7: KLOP06031987 ($100 in chips) 
Seat 8: Filojoes ($121.50 in chips) 
Seat 9: Dante63s ($100 in chips) 
Dante63s: posts small blind $0.50
ICallSaul: posts big blind $1
cn_chayanne: sits out 
*** HOLE CARDS ***
Dealt to matiko09 [9h 3d]
petalouda10: folds 
mycka86: folds 
DeWeijz: raises $3 to $4
matiko09: folds 
KLOP06031987: folds 
Filojoes: folds 
Dante63s: folds 
ICallSaul: calls $3
*** FLOP *** [5d 2d Tc]
ICallSaul: checks 
DeWeijz: bets $5
ICallSaul: folds 
Uncalled bet ($5) returned to DeWeijz
DeWeijz collected $8.12 from pot
DeWeijz: doesn't show hand 
*** SUMMARY ***
Total pot $8.50 | Rake $0.38 
Board [5d 2d Tc]
Seat 1: ICallSaul (big blind) folded on the Flop
Seat 3: petalouda10 folded before Flop (didn't bet)
Seat 4: mycka86 folded before Flop (didn't bet)
Seat 5: DeWeijz collected ($8.12)
Seat 6: matiko09 folded before Flop (didn't bet)
Seat 7: KLOP06031987 folded before Flop (didn't bet)
Seat 8: Filojoes (button) folded before Flop (didn't bet)
Seat 9: Dante63s (small blind) folded before Flop





PokerStars Hand #147707732077:  Hold'em No Limit ($0.50/$1.00 USD) - 2016/01/26 16:03:12 CET [2016/01/26 10:03:12 ET]
Table 'Mashona' 9-max Seat #8 is the button
Seat 1: maxxmeister ($119.78 in chips) 
Seat 2: werades ($201.10 in chips) 
Seat 3: matiko09 ($125.07 in chips) 
Seat 4: Sweden_Pound ($151.06 in chips) 
Seat 5: solbi86 ($126.39 in chips) 
Seat 6: Filojoes ($100 in chips) 
Seat 7: EB0LARAMA ($309.24 in chips) 
Seat 8: Jimy Tiltman ($175.66 in chips) 
Seat 9: apfush ($100.50 in chips) 
apfush: posts small blind $0.50
maxxmeister: posts big blind $1
*** HOLE CARDS ***
Dealt to matiko09 [6d Jh]
werades: calls $1
matiko09: folds 
Sweden_Pound: folds 
solbi86: folds 
Filojoes: folds 
EB0LARAMA: folds 
Jimy Tiltman: raises $2.50 to $3.50
apfush: folds 
maxxmeister: folds 
werades: folds 
Uncalled bet ($2.50) returned to Jimy Tiltman
Jimy Tiltman collected $3.50 from pot
Jimy Tiltman: doesn't show hand 
*** SUMMARY ***
Total pot $3.50 | Rake $0 
Seat 1: maxxmeister (big blind) folded before Flop
Seat 2: werades folded before Flop
Seat 3: matiko09 folded before Flop (didn't bet)
Seat 4: Sweden_Pound folded before Flop (didn't bet)
Seat 5: solbi86 folded before Flop (didn't bet)
Seat 6: Filojoes folded before Flop (didn't bet)
Seat 7: EB0LARAMA folded before Flop (didn't bet)
Seat 8: Jimy Tiltman (button) collected ($3.50)
Seat 9: apfush (small blind) folded before Flop





PokerStars Hand #147707739603:  Hold'em No Limit ($0.50/$1.00 USD) - 2016/01/26 16:03:21 CET [2016/01/26 10:03:21 ET]
Table 'Montefiore' 9-max Seat #8 is the button
Seat 1: Celsinho0311 ($59.69 in chips) 
Seat 2: Dante63s ($152.06 in chips) 
Seat 3: Filojoes ($100 in chips) 
Seat 4: matiko09 ($101.50 in chips) 
Seat 5: ilaviiitech ($104.50 in chips) 
Seat 8: Kukuryzka ($100 in chips) 
Seat 9: KLOP06031987 ($100 in chips) 
KLOP06031987: posts small blind $0.50
Celsinho0311: posts big blind $1
FroggyPlay: sits out 
mycka86: sits out 
*** HOLE CARDS ***
Dealt to matiko09 [5c 6c]
Dante63s: folds 
Filojoes: raises $2 to $3
matiko09: folds 
ilaviiitech: folds 
Kukuryzka: folds 
KLOP06031987: folds 
Celsinho0311: calls $2
*** FLOP *** [As 4h 8c]
Celsinho0311: checks 
Filojoes: checks 
*** TURN *** [As 4h 8c] [4d]
Celsinho0311: bets $3.10
Filojoes: folds 
Uncalled bet ($3.10) returned to Celsinho0311
Celsinho0311 collected $6.21 from pot
*** SUMMARY ***
Total pot $6.50 | Rake $0.29 
Board [As 4h 8c 4d]
Seat 1: Celsinho0311 (big blind) collected ($6.21)
Seat 2: Dante63s folded before Flop (didn't bet)
Seat 3: Filojoes folded on the Turn
Seat 4: matiko09 folded before Flop (didn't bet)
Seat 5: ilaviiitech folded before Flop (didn't bet)
Seat 8: Kukuryzka (button) folded before Flop (didn't bet)
Seat 9: KLOP06031987 (small blind) folded before Flop





PokerStars Hand #147707745867:  Hold'em No Limit ($0.50/$1.00 USD) - 2016/01/26 16:03:30 CET [2016/01/26 10:03:30 ET]
Table 'Kale II' 9-max Seat #6 is the button
Seat 1: lootstool ($80.20 in chips) 
Seat 2: matiko09 ($104.16 in chips) 
Seat 3: Reven9er ($133.70 in chips) 
Seat 4: Jimy Tiltman ($193.07 in chips) 
Seat 5: Dante63s ($100 in chips) 
Seat 6: Filojoes ($122.80 in chips) 
Seat 7: Kukuryzka ($102.30 in chips) 
Seat 8: mycka86 ($100 in chips) 
Seat 9: Sweden_Pound ($126.78 in chips) 
Kukuryzka: posts small blind $0.50
mycka86: posts big blind $1
*** HOLE CARDS ***
Dealt to matiko09 [9s 3c]
Sweden_Pound: folds 
lootstool is disconnected 
lootstool has timed out while disconnected
lootstool: folds 
matiko09: folds 
Reven9er: folds 
Jimy Tiltman: folds 
Dante63s: folds 
Filojoes: folds 
Kukuryzka: raises $1.50 to $2.50
mycka86: folds 
Uncalled bet ($1.50) returned to Kukuryzka
Kukuryzka collected $2 from pot
Kukuryzka: doesn't show hand 
*** SUMMARY ***
Total pot $2 | Rake $0 
Seat 1: lootstool folded before Flop (didn't bet)
Seat 2: matiko09 folded before Flop (didn't bet)
Seat 3: Reven9er folded before Flop (didn't bet)
Seat 4: Jimy Tiltman folded before Flop (didn't bet)
Seat 5: Dante63s folded before Flop (didn't bet)
Seat 6: Filojoes (button) folded before Flop (didn't bet)
Seat 7: Kukuryzka (small blind) collected ($2)
Seat 8: mycka86 (big blind) folded before Flop
Seat 9: Sweden_Pound folded before Flop (didn't bet)





PokerStars Hand #147707749534:  Hold'em No Limit ($0.50/$1.00 USD) - 2016/01/26 16:03:35 CET [2016/01/26 10:03:35 ET]
Table 'Heike II' 9-max Seat #9 is the button
Seat 1: ilaviiitech ($140.03 in chips) 
Seat 2: Dante63s ($112.48 in chips) 
Seat 3: matiko09 ($120.95 in chips) 
Seat 4: Reven9er ($114.17 in chips) 
Seat 5: Sweden_Pound ($100 in chips) 
Seat 9: mycka86 ($102.91 in chips) 
ilaviiitech: posts small blind $0.50
Dante63s: posts big blind $1
*** HOLE CARDS ***
Dealt to matiko09 [Th 8d]
matiko09: folds 
Reven9er: folds 
Sweden_Pound: folds 
mycka86: folds 
ilaviiitech: folds 
Uncalled bet ($0.50) returned to Dante63s
Dante63s collected $1 from pot
Dante63s: doesn't show hand 
*** SUMMARY ***
Total pot $1 | Rake $0 
Seat 1: ilaviiitech (small blind) folded before Flop
Seat 2: Dante63s (big blind) collected ($1)
Seat 3: matiko09 folded before Flop (didn't bet)
Seat 4: Reven9er folded before Flop (didn't bet)
Seat 5: Sweden_Pound folded before Flop (didn't bet)
Seat 9: mycka86 (button) folded before Flop (didn't bet)





PokerStars Hand #147707755371:  Hold'em No Limit ($0.50/$1.00 USD) - 2016/01/26 16:03:42 CET [2016/01/26 10:03:42 ET]
Table 'Strenua III' 9-max Seat #9 is the button
Seat 1: ICallSaul ($104.28 in chips) 
Seat 2: cn_chayanne ($100 in chips) 
Seat 3: petalouda10 ($72.17 in chips) 
Seat 4: mycka86 ($131.86 in chips) 
Seat 5: DeWeijz ($44.49 in chips) 
Seat 6: matiko09 ($131.84 in chips) 
Seat 7: KLOP06031987 ($100 in chips) 
Seat 8: Filojoes ($121.50 in chips) 
Seat 9: Dante63s ($100 in chips) 
ICallSaul: posts small blind $0.50
cn_chayanne: posts big blind $1
*** HOLE CARDS ***
Dealt to matiko09 [Kh 3s]
petalouda10: folds 
mycka86: folds 
DeWeijz: folds 
matiko09: folds 
KLOP06031987: folds 
Filojoes: folds 
Dante63s: folds 
ICallSaul: folds 
Uncalled bet ($0.50) returned to cn_chayanne
cn_chayanne collected $1 from pot
cn_chayanne: doesn't show hand 
*** SUMMARY ***
Total pot $1 | Rake $0 
Seat 1: ICallSaul (small blind) folded before Flop
Seat 2: cn_chayanne (big blind) collected ($1)
Seat 3: petalouda10 folded before Flop (didn't bet)
Seat 4: mycka86 folded before Flop (didn't bet)
Seat 5: DeWeijz folded before Flop (didn't bet)
Seat 6: matiko09 folded before Flop (didn't bet)
Seat 7: KLOP06031987 folded before Flop (didn't bet)
Seat 8: Filojoes folded before Flop (didn't bet)
Seat 9: Dante63s (button) folded before Flop (didn't bet)





PokerStars Hand #147707759315:  Hold'em No Limit ($0.50/$1.00 USD) - 2016/01/26 16:03:48 CET [2016/01/26 10:03:48 ET]
Table 'Achates III' 9-max Seat #1 is the button
Seat 1: CI58 ($100 in chips) 
Seat 2: matiko09 ($124.45 in chips) 
Seat 3: Jimy Tiltman ($100 in chips) 
Seat 5: Sweden_Pound ($234.60 in chips) 
Seat 6: Kukuryzka ($100 in chips) 
Seat 7: KLOP06031987 ($103.64 in chips) 
Seat 9: T-chaos_IMBA ($323.42 in chips) 
matiko09: posts small blind $0.50
Jimy Tiltman: posts big blind $1
cn_chayanne: sits out 
*** HOLE CARDS ***
Dealt to matiko09 [Ad Qd]
Sweden_Pound: folds 
Kukuryzka: raises $2 to $3
KLOP06031987: folds 
T-chaos_IMBA: folds 
CI58: folds 
matiko09: calls $2.50
Jimy Tiltman: folds 
*** FLOP *** [5s 7c 9c]
Filojoes joins the table at seat #8 
matiko09: checks 
Filojoes leaves the table
Kukuryzka: bets $5.01
matiko09: folds 
Uncalled bet ($5.01) returned to Kukuryzka
Kukuryzka collected $6.68 from pot
Kukuryzka: doesn't show hand 
*** SUMMARY ***
Total pot $7 | Rake $0.32 
Board [5s 7c 9c]
Seat 1: CI58 (button) folded before Flop (didn't bet)
Seat 2: matiko09 (small blind) folded on the Flop
Seat 3: Jimy Tiltman (big blind) folded before Flop
Seat 5: Sweden_Pound folded before Flop (didn't bet)
Seat 6: Kukuryzka collected ($6.68)
Seat 7: KLOP06031987 folded before Flop (didn't bet)
Seat 9: T-chaos_IMBA folded before Flop (didn't bet)





PokerStars Hand #147707767951:  Hold'em No Limit ($0.50/$1.00 USD) - 2016/01/26 16:03:59 CET [2016/01/26 10:03:59 ET]
Table 'Mashona' 9-max Seat #9 is the button
Seat 1: maxxmeister ($118.78 in chips) 
Seat 2: werades ($200.10 in chips) 
Seat 3: matiko09 ($125.07 in chips) 
Seat 4: Sweden_Pound ($151.06 in chips) 
Seat 5: solbi86 ($126.39 in chips) 
Seat 6: Filojoes ($100 in chips) 
Seat 7: EB0LARAMA ($309.24 in chips) 
Seat 8: Jimy Tiltman ($178.16 in chips) 
Seat 9: apfush ($100 in chips) 
maxxmeister: posts small blind $0.50
werades: posts big blind $1
*** HOLE CARDS ***
Dealt to matiko09 [As Jd]
matiko09: raises $2 to $3
Sweden_Pound: folds 
solbi86: folds 
Filojoes: folds 
EB0LARAMA: folds 
Jimy Tiltman: folds 
apfush: folds 
maxxmeister: raises $10 to $13
werades: folds 
matiko09: folds 
Uncalled bet ($10) returned to maxxmeister
maxxmeister collected $7 from pot
maxxmeister: doesn't show hand 
*** SUMMARY ***
Total pot $7 | Rake $0 
Seat 1: maxxmeister (small blind) collected ($7)
Seat 2: werades (big blind) folded before Flop
Seat 3: matiko09 folded before Flop
Seat 4: Sweden_Pound folded before Flop (didn't bet)
Seat 5: solbi86 folded before Flop (didn't bet)
Seat 6: Filojoes folded before Flop (didn't bet)
Seat 7: EB0LARAMA folded before Flop (didn't bet)
Seat 8: Jimy Tiltman folded before Flop (didn't bet)
Seat 9: apfush (button) folded before Flop (didn't bet)





PokerStars Hand #147707776032:  Hold'em No Limit ($0.50/$1.00 USD) - 2016/01/26 16:04:10 CET [2016/01/26 10:04:10 ET]
Table 'Impala' 9-max Seat #1 is the button
Seat 1: mycka86 ($135.44 in chips) 
Seat 2: Filojoes ($100 in chips) 
Seat 3: Dante63s ($102.50 in chips) 
Seat 4: KLOP06031987 ($106.26 in chips) 
Seat 5: Kukuryzka ($100 in chips) 
Seat 6: Tijger R.d.J ($98.42 in chips) 
Seat 7: matiko09 ($119.84 in chips) 
Seat 8: apfush ($100 in chips) 
Seat 9: flozzi ($100 in chips) 
Filojoes: posts small blind $0.50
Dante63s: posts big blind $1
*** HOLE CARDS ***
Dealt to matiko09 [7s Qh]
KLOP06031987: folds 
Kukuryzka: folds 
Tijger R.d.J: raises $1 to $2
matiko09: folds 
apfush: folds 
flozzi: folds 
mycka86: folds 
Filojoes: calls $1.50
Dante63s: folds 
*** FLOP *** [2h 3d 5s]
Filojoes: checks 
Tijger R.d.J: bets $2
Filojoes: calls $2
*** TURN *** [2h 3d 5s] [Ks]
Filojoes: checks 
Tijger R.d.J: bets $3
Filojoes: calls $3
*** RIVER *** [2h 3d 5s Ks] [Ac]
Filojoes: checks 
Tijger R.d.J: bets $12
Filojoes: folds 
Uncalled bet ($12) returned to Tijger R.d.J
Tijger R.d.J collected $14.32 from pot
Tijger R.d.J: doesn't show hand 
*** SUMMARY ***
Total pot $15 | Rake $0.68 
Board [2h 3d 5s Ks Ac]
Seat 1: mycka86 (button) folded before Flop (didn't bet)
Seat 2: Filojoes (small blind) folded on the River
Seat 3: Dante63s (big blind) folded before Flop
Seat 4: KLOP06031987 folded before Flop (didn't bet)
Seat 5: Kukuryzka folded before Flop (didn't bet)
Seat 6: Tijger R.d.J collected ($14.32)
Seat 7: matiko09 folded before Flop (didn't bet)
Seat 8: apfush folded before Flop (didn't bet)
Seat 9: flozzi folded before Flop (didn't bet)





PokerStars Hand #147707780703:  Hold'em No Limit ($0.50/$1.00 USD) - 2016/01/26 16:04:16 CET [2016/01/26 10:04:16 ET]
Table 'Medusa III' 9-max Seat #4 is the button
Seat 1: soplak ($100 in chips) 
Seat 2: happydrake ($89 in chips) 
Seat 3: mycka86 ($106.50 in chips) 
Seat 4: Sweden_Pound ($150.98 in chips) 
Seat 5: matiko09 ($232.69 in chips) 
Seat 6: Dante63s ($192.99 in chips) 
Seat 7: Reven9er ($183.96 in chips) 
Seat 9: KLOP06031987 ($101.50 in chips) 
matiko09: posts small blind $0.50
Dante63s: posts big blind $1
Filojoes: sits out 
*** HOLE CARDS ***
Dealt to matiko09 [8c 8d]
Reven9er: folds 
KLOP06031987: folds 
soplak: folds 
happydrake: folds 
mycka86: folds 
Sweden_Pound: folds 
matiko09: raises $1.50 to $2.50
Dante63s: folds 
Uncalled bet ($1.50) returned to matiko09
matiko09 collected $2 from pot
matiko09: doesn't show hand 
*** SUMMARY ***
Total pot $2 | Rake $0 
Seat 1: soplak folded before Flop (didn't bet)
Seat 2: happydrake folded before Flop (didn't bet)
Seat 3: mycka86 folded before Flop (didn't bet)
Seat 4: Sweden_Pound (button) folded before Flop (didn't bet)
Seat 5: matiko09 (small blind) collected ($2)
Seat 6: Dante63s (big blind) folded before Flop
Seat 7: Reven9er folded before Flop (didn't bet)
Seat 9: KLOP06031987 folded before Flop (didn't bet)





PokerStars Hand #147707788263:  Hold'em No Limit ($0.50/$1.00 USD) - 2016/01/26 16:04:26 CET [2016/01/26 10:04:26 ET]
Table 'Calypso II' 9-max Seat #2 is the button
Seat 2: Hardwell1993 ($92 in chips) 
Seat 3: matiko09 ($216.25 in chips) 
Seat 4: Sweden_Pound ($116.29 in chips) 
Seat 5: mycka86 ($116.50 in chips) 
Seat 6: MrDeeee25 ($114.20 in chips) 
Seat 7: Jimy Tiltman ($100 in chips) 
Seat 8: Reven9er ($116.83 in chips) 
Seat 9: Filojoes ($146.93 in chips) 
matiko09: posts small blind $0.50
Sweden_Pound: posts big blind $1
KLOP06031987: sits out 
*** HOLE CARDS ***
Dealt to matiko09 [4h 9c]
mycka86: folds 
MrDeeee25: folds 
Jimy Tiltman: folds 
Reven9er: folds 
Filojoes: folds 
Hardwell1993: calls $1
matiko09: folds 
Sweden_Pound: checks 
*** FLOP *** [3h 4c Js]
Sweden_Pound: checks 
Hardwell1993: bets $3
Sweden_Pound: calls $3
*** TURN *** [3h 4c Js] [5d]
Sweden_Pound: checks 
Hardwell1993: bets $4
Sweden_Pound: folds 
Uncalled bet ($4) returned to Hardwell1993
Hardwell1993 collected $8.12 from pot
*** SUMMARY ***
Total pot $8.50 | Rake $0.38 
Board [3h 4c Js 5d]
Seat 2: Hardwell1993 (button) collected ($8.12)
Seat 3: matiko09 (small blind) folded before Flop
Seat 4: Sweden_Pound (big blind) folded on the Turn
Seat 5: mycka86 folded before Flop (didn't bet)
Seat 6: MrDeeee25 folded before Flop (didn't bet)
Seat 7: Jimy Tiltman folded before Flop (didn't bet)
Seat 8: Reven9er folded before Flop (didn't bet)
Seat 9: Filojoes folded before Flop (didn't bet)





PokerStars Hand #147707790085:  Hold'em No Limit ($0.50/$1.00 USD) - 2016/01/26 16:04:28 CET [2016/01/26 10:04:28 ET]
Table 'Achates III' 9-max Seat #2 is the button
Seat 1: CI58 ($100 in chips) 
Seat 2: matiko09 ($121.45 in chips) 
Seat 3: Jimy Tiltman ($100 in chips) 
Seat 4: cn_chayanne ($100.76 in chips) 
Seat 5: Sweden_Pound ($234.60 in chips) 
Seat 6: Kukuryzka ($103.68 in chips) 
Seat 7: KLOP06031987 ($103.64 in chips) 
Seat 9: T-chaos_IMBA ($323.42 in chips) 
Jimy Tiltman: posts small blind $0.50
cn_chayanne: posts big blind $1
*** HOLE CARDS ***
Dealt to matiko09 [9c 3h]
Sweden_Pound: folds 
Kukuryzka: folds 
KLOP06031987: folds 
T-chaos_IMBA: raises $2 to $3
CI58: folds 
matiko09: folds 
Jimy Tiltman: folds 
cn_chayanne: raises $6 to $9
T-chaos_IMBA: calls $6
*** FLOP *** [Qs Ah Jh]
cn_chayanne: bets $8.83
T-chaos_IMBA: raises $10.17 to $19
cn_chayanne: calls $10.17
*** TURN *** [Qs Ah Jh] [4s]
Rikti joins the table at seat #8 
cn_chayanne: checks 
Rikti leaves the table
T-chaos_IMBA: checks 
*** RIVER *** [Qs Ah Jh 4s] [2c]
cn_chayanne: checks 
T-chaos_IMBA: bets $40
cn_chayanne: folds 
Uncalled bet ($40) returned to T-chaos_IMBA
T-chaos_IMBA collected $53.96 from pot
T-chaos_IMBA: doesn't show hand 
*** SUMMARY ***
Total pot $56.50 | Rake $2.54 
Board [Qs Ah Jh 4s 2c]
Seat 1: CI58 folded before Flop (didn't bet)
Seat 2: matiko09 (button) folded before Flop (didn't bet)
Seat 3: Jimy Tiltman (small blind) folded before Flop
Seat 4: cn_chayanne (big blind) folded on the River
Seat 5: Sweden_Pound folded before Flop (didn't bet)
Seat 6: Kukuryzka folded before Flop (didn't bet)
Seat 7: KLOP06031987 folded before Flop (didn't bet)
Seat 9: T-chaos_IMBA collected ($53.96)





PokerStars Hand #147707799991:  Hold'em No Limit ($0.50/$1.00 USD) - 2016/01/26 16:04:42 CET [2016/01/26 10:04:42 ET]
Table 'Strenua III' 9-max Seat #1 is the button
Seat 1: ICallSaul ($103.78 in chips) 
Seat 2: cn_chayanne ($100.50 in chips) 
Seat 3: petalouda10 ($72.17 in chips) 
Seat 4: mycka86 ($131.86 in chips) 
Seat 5: DeWeijz ($44.49 in chips) 
Seat 6: matiko09 ($131.84 in chips) 
Seat 7: KLOP06031987 ($100 in chips) 
Seat 8: Filojoes ($121.50 in chips) 
Seat 9: Dante63s ($100 in chips) 
cn_chayanne: posts small blind $0.50
petalouda10: posts big blind $1
*** HOLE CARDS ***
Dealt to matiko09 [6h Jh]
mycka86: folds 
DeWeijz: raises $2 to $3
matiko09: folds 
KLOP06031987: folds 
Filojoes: folds 
Dante63s: calls $3
ICallSaul: calls $3
cn_chayanne: calls $2.50
petalouda10: calls $2
*** FLOP *** [2d Ts 4h]
cn_chayanne: checks 
petalouda10: checks 
DeWeijz: checks 
Dante63s: checks 
ICallSaul: checks 
*** TURN *** [2d Ts 4h] [Qs]
cn_chayanne: bets $12.60
petalouda10: folds 
DeWeijz: folds 
Dante63s: calls $12.60
ICallSaul: folds 
*** RIVER *** [2d Ts 4h Qs] [7h]
cn_chayanne: bets $28.79
Dante63s: folds 
Uncalled bet ($28.79) returned to cn_chayanne
cn_chayanne collected $38.39 from pot
cn_chayanne: doesn't show hand 
*** SUMMARY ***
Total pot $40.20 | Rake $1.81 
Board [2d Ts 4h Qs 7h]
Seat 1: ICallSaul (button) folded on the Turn
Seat 2: cn_chayanne (small blind) collected ($38.39)
Seat 3: petalouda10 (big blind) folded on the Turn
Seat 4: mycka86 folded before Flop (didn't bet)
Seat 5: DeWeijz folded on the Turn
Seat 6: matiko09 folded before Flop (didn't bet)
Seat 7: KLOP06031987 folded before Flop (didn't bet)
Seat 8: Filojoes folded before Flop (didn't bet)
Seat 9: Dante63s folded on the River





PokerStars Hand #147707801861:  Hold'em No Limit ($0.50/$1.00 USD) - 2016/01/26 16:04:44 CET [2016/01/26 10:04:44 ET]
Table 'Montefiore' 9-max Seat #9 is the button
Seat 1: Celsinho0311 ($62.90 in chips) 
Seat 2: Dante63s ($152.06 in chips) 
Seat 3: Filojoes ($100 in chips) 
Seat 4: matiko09 ($101.50 in chips) 
Seat 5: ilaviiitech ($104.50 in chips) 
Seat 8: Kukuryzka ($100 in chips) 
Seat 9: KLOP06031987 ($100 in chips) 
Celsinho0311: posts small blind $0.50
Dante63s: posts big blind $1
FroggyPlay: sits out 
mycka86: sits out 
*** HOLE CARDS ***
Dealt to matiko09 [Qs 9d]
Filojoes: folds 
matiko09: folds 
ilaviiitech: folds 
Kukuryzka: folds 
KLOP06031987: folds 
Celsinho0311: raises $2 to $3
Dante63s: calls $2
*** FLOP *** [6d 7c 5s]
Celsinho0311: checks 
Dante63s: bets $3.50
Celsinho0311: folds 
Uncalled bet ($3.50) returned to Dante63s
Dante63s collected $5.73 from pot
Dante63s: doesn't show hand 
*** SUMMARY ***
Total pot $6 | Rake $0.27 
Board [6d 7c 5s]
Seat 1: Celsinho0311 (small blind) folded on the Flop
Seat 2: Dante63s (big blind) collected ($5.73)
Seat 3: Filojoes folded before Flop (didn't bet)
Seat 4: matiko09 folded before Flop (didn't bet)
Seat 5: ilaviiitech folded before Flop (didn't bet)
Seat 8: Kukuryzka folded before Flop (didn't bet)
Seat 9: KLOP06031987 (button) folded before Flop (didn't bet)





PokerStars Hand #147707809523:  Hold'em No Limit ($0.50/$1.00 USD) - 2016/01/26 16:04:55 CET [2016/01/26 10:04:55 ET]
Table 'Kale II' 9-max Seat #7 is the button
Seat 2: matiko09 ($104.16 in chips) 
Seat 3: Reven9er ($133.70 in chips) 
Seat 4: Jimy Tiltman ($193.07 in chips) 
Seat 5: Dante63s ($100 in chips) 
Seat 6: Filojoes ($122.80 in chips) 
Seat 7: Kukuryzka ($103.30 in chips) 
Seat 8: mycka86 ($100 in chips) 
Seat 9: Sweden_Pound ($126.78 in chips) 
mycka86: posts small blind $0.50
Sweden_Pound: posts big blind $1
*** HOLE CARDS ***
Dealt to matiko09 [8s 2c]
matiko09: folds 
Reven9er: folds 
Jimy Tiltman: raises $1.50 to $2.50
Dante63s: folds 
Filojoes: folds 
Kukuryzka: folds 
mycka86: folds 
Sweden_Pound: folds 
Uncalled bet ($1.50) returned to Jimy Tiltman
Jimy Tiltman collected $2.50 from pot
Jimy Tiltman: doesn't show hand 
*** SUMMARY ***
Total pot $2.50 | Rake $0 
Seat 2: matiko09 folded before Flop (didn't bet)
Seat 3: Reven9er folded before Flop (didn't bet)
Seat 4: Jimy Tiltman collected ($2.50)
Seat 5: Dante63s folded before Flop (didn't bet)
Seat 6: Filojoes folded before Flop (didn't bet)
Seat 7: Kukuryzka (button) folded before Flop (didn't bet)
Seat 8: mycka86 (small blind) folded before Flop
Seat 9: Sweden_Pound (big blind) folded before Flop





PokerStars Hand #147707810631:  Hold'em No Limit ($0.50/$1.00 USD) - 2016/01/26 16:04:56 CET [2016/01/26 10:04:56 ET]
Table 'Medusa III' 9-max Seat #5 is the button
Seat 1: soplak ($100 in chips) 
Seat 2: happydrake ($89 in chips) 
Seat 3: mycka86 ($106.50 in chips) 
Seat 4: Sweden_Pound ($150.98 in chips) 
Seat 5: matiko09 ($233.69 in chips) 
Seat 6: Dante63s ($191.99 in chips) 
Seat 7: Reven9er ($183.96 in chips) 
Seat 9: KLOP06031987 ($101.50 in chips) 
Dante63s: posts small blind $0.50
Reven9er: posts big blind $1
Filojoes: sits out 
*** HOLE CARDS ***
Dealt to matiko09 [9s 9c]
KLOP06031987: folds 
soplak: folds 
happydrake: calls $1
mycka86: folds 
Sweden_Pound: raises $3 to $4
matiko09: calls $4
Dante63s: folds 
Reven9er: folds 
happydrake: calls $3
*** FLOP *** [Kh Kd 8c]
happydrake: checks 
Sweden_Pound: checks 
matiko09: bets $8.38
happydrake: folds 
Sweden_Pound: folds 
Uncalled bet ($8.38) returned to matiko09
matiko09 collected $12.89 from pot
matiko09: doesn't show hand 
*** SUMMARY ***
Total pot $13.50 | Rake $0.61 
Board [Kh Kd 8c]
Seat 1: soplak folded before Flop (didn't bet)
Seat 2: happydrake folded on the Flop
Seat 3: mycka86 folded before Flop (didn't bet)
Seat 4: Sweden_Pound folded on the Flop
Seat 5: matiko09 (button) collected ($12.89)
Seat 6: Dante63s (small blind) folded before Flop
Seat 7: Reven9er (big blind) folded before Flop
Seat 9: KLOP06031987 folded before Flop (didn't bet)





PokerStars Hand #147707815469:  Hold'em No Limit ($0.50/$1.00 USD) - 2016/01/26 16:05:02 CET [2016/01/26 10:05:02 ET]
Table 'Volga III' 9-max Seat #7 is the button
Seat 1: CI58 ($100 in chips) 
Seat 2: KLOP06031987 ($112.20 in chips) 
Seat 3: Kukuryzka ($100 in chips) 
Seat 4: mycka86 ($103.71 in chips) 
Seat 5: veno79 ($53.85 in chips) 
Seat 6: Sweden_Pound ($101.86 in chips) 
Seat 7: soplak ($107.45 in chips) 
Seat 8: cn_chayanne ($101.50 in chips) 
Seat 9: matiko09 ($100 in chips) 
cn_chayanne: posts small blind $0.50
matiko09: posts big blind $1
*** HOLE CARDS ***
Dealt to matiko09 [3c 2d]
CI58: folds 
KLOP06031987: folds 
Kukuryzka: folds 
mycka86: folds 
veno79: folds 
Sweden_Pound: folds 
soplak: raises $1 to $2
cn_chayanne: folds 
matiko09: folds 
Uncalled bet ($1) returned to soplak
soplak collected $2.50 from pot
*** SUMMARY ***
Total pot $2.50 | Rake $0 
Seat 1: CI58 folded before Flop (didn't bet)
Seat 2: KLOP06031987 folded before Flop (didn't bet)
Seat 3: Kukuryzka folded before Flop (didn't bet)
Seat 4: mycka86 folded before Flop (didn't bet)
Seat 5: veno79 folded before Flop (didn't bet)
Seat 6: Sweden_Pound folded before Flop (didn't bet)
Seat 7: soplak (button) collected ($2.50)
Seat 8: cn_chayanne (small blind) folded before Flop
Seat 9: matiko09 (big blind) folded before Flop





PokerStars Hand #147707821185:  Hold'em No Limit ($0.50/$1.00 USD) - 2016/01/26 16:05:10 CET [2016/01/26 10:05:10 ET]
Table 'Aten II' 9-max Seat #2 is the button
Seat 1: cn_chayanne ($108.56 in chips) 
Seat 2: solbi86 ($100 in chips) 
Seat 3: ilaviiitech ($100 in chips) 
Seat 4: matiko09 ($100 in chips) 
Seat 6: ooohaaah ($83.25 in chips) 
Seat 7: Legioner721 ($37 in chips) 
Seat 9: TorontoBum ($103.34 in chips) 
ilaviiitech: posts small blind $0.50
matiko09: posts big blind $1
sebaaastian: sits out 
*** HOLE CARDS ***
Dealt to matiko09 [4h 2h]
ooohaaah: folds 
Legioner721: folds 
TorontoBum: calls $1
cn_chayanne: folds 
solbi86: raises $3 to $4
ilaviiitech: folds 
matiko09: folds 
TorontoBum: calls $3
*** FLOP *** [Jd Tc Ad]
TorontoBum: checks 
solbi86: checks 
*** TURN *** [Jd Tc Ad] [2s]
TorontoBum: checks 
solbi86: bets $5.16
TorontoBum: calls $5.16
*** RIVER *** [Jd Tc Ad 2s] [4c]
TorontoBum: bets $12.61
solbi86: folds 
Uncalled bet ($12.61) returned to TorontoBum
TorontoBum collected $18.93 from pot
TorontoBum: doesn't show hand 
*** SUMMARY ***
Total pot $19.82 | Rake $0.89 
Board [Jd Tc Ad 2s 4c]
Seat 1: cn_chayanne folded before Flop (didn't bet)
Seat 2: solbi86 (button) folded on the River
Seat 3: ilaviiitech (small blind) folded before Flop
Seat 4: matiko09 (big blind) folded before Flop
Seat 6: ooohaaah folded before Flop (didn't bet)
Seat 7: Legioner721 folded before Flop (didn't bet)
Seat 9: TorontoBum collected ($18.93)





PokerStars Hand #147707828923:  Hold'em No Limit ($0.50/$1.00 USD) - 2016/01/26 16:05:20 CET [2016/01/26 10:05:20 ET]
Table 'Calypso II' 9-max Seat #3 is the button
Seat 2: Hardwell1993 ($96.12 in chips) 
Seat 3: matiko09 ($215.75 in chips) 
Seat 4: Sweden_Pound ($112.29 in chips) 
Seat 5: mycka86 ($116.50 in chips) 
Seat 6: MrDeeee25 ($114.20 in chips) 
Seat 7: Jimy Tiltman ($100 in chips) 
Seat 8: Reven9er ($116.83 in chips) 
Seat 9: Filojoes ($146.93 in chips) 
Sweden_Pound: posts small blind $0.50
mycka86: posts big blind $1
KLOP06031987: sits out 
*** HOLE CARDS ***
Dealt to matiko09 [Tc 4d]
MrDeeee25: raises $2 to $3
Jimy Tiltman: folds 
Reven9er: calls $3
Filojoes: raises $14 to $17
Hardwell1993: folds 
matiko09: folds 
Sweden_Pound: folds 
mycka86: folds 
MrDeeee25: folds 
Reven9er: folds 
Uncalled bet ($14) returned to Filojoes
Filojoes collected $10.50 from pot
Filojoes: doesn't show hand 
*** SUMMARY ***
Total pot $10.50 | Rake $0 
Seat 2: Hardwell1993 folded before Flop (didn't bet)
Seat 3: matiko09 (button) folded before Flop (didn't bet)
Seat 4: Sweden_Pound (small blind) folded before Flop
Seat 5: mycka86 (big blind) folded before Flop
Seat 6: MrDeeee25 folded before Flop
Seat 7: Jimy Tiltman folded before Flop (didn't bet)
Seat 8: Reven9er folded before Flop
Seat 9: Filojoes collected ($10.50)





PokerStars Hand #147707831439:  Hold'em No Limit ($0.50/$1.00 USD) - 2016/01/26 16:05:24 CET [2016/01/26 10:05:24 ET]
Table 'Montefiore' 9-max Seat #1 is the button
Seat 1: Celsinho0311 ($59.90 in chips) 
Seat 2: Dante63s ($154.79 in chips) 
Seat 3: Filojoes ($100 in chips) 
Seat 4: matiko09 ($101.50 in chips) 
Seat 5: ilaviiitech ($104.50 in chips) 
Seat 8: Kukuryzka ($100 in chips) 
Seat 9: KLOP06031987 ($100 in chips) 
Dante63s: posts small blind $0.50
Filojoes: posts big blind $1
FroggyPlay: sits out 
mycka86: sits out 
*** HOLE CARDS ***
Dealt to matiko09 [9c Jc]
matiko09: raises $2 to $3
ilaviiitech: folds 
Kukuryzka: folds 
KLOP06031987: folds 
Celsinho0311: folds 
Dante63s: folds 
Filojoes: folds 
Uncalled bet ($2) returned to matiko09
matiko09 collected $2.50 from pot
matiko09: doesn't show hand 
*** SUMMARY ***
Total pot $2.50 | Rake $0 
Seat 1: Celsinho0311 (button) folded before Flop (didn't bet)
Seat 2: Dante63s (small blind) folded before Flop
Seat 3: Filojoes (big blind) folded before Flop
Seat 4: matiko09 collected ($2.50)
Seat 5: ilaviiitech folded before Flop (didn't bet)
Seat 8: Kukuryzka folded before Flop (didn't bet)
Seat 9: KLOP06031987 folded before Flop (didn't bet)





PokerStars Hand #147707832087:  Hold'em No Limit ($0.50/$1.00 USD) - 2016/01/26 16:05:25 CET [2016/01/26 10:05:25 ET]
Table 'Kale II' 9-max Seat #8 is the button
Seat 2: matiko09 ($104.16 in chips) 
Seat 3: Reven9er ($133.70 in chips) 
Seat 4: Jimy Tiltman ($194.57 in chips) 
Seat 5: Dante63s ($100 in chips) 
Seat 6: Filojoes ($122.80 in chips) 
Seat 7: Kukuryzka ($103.30 in chips) 
Seat 8: mycka86 ($100 in chips) 
Seat 9: Sweden_Pound ($125.78 in chips) 
Sweden_Pound: posts small blind $0.50
matiko09: posts big blind $1
*** HOLE CARDS ***
Dealt to matiko09 [9c 4h]
Reven9er: folds 
Jimy Tiltman: folds 
Dante63s: folds 
Filojoes: folds 
Kukuryzka: folds 
mycka86: raises $1.10 to $2.10
Sweden_Pound: folds 
matiko09: folds 
Uncalled bet ($1.10) returned to mycka86
mycka86 collected $2.50 from pot
*** SUMMARY ***
Total pot $2.50 | Rake $0 
Seat 2: matiko09 (big blind) folded before Flop
Seat 3: Reven9er folded before Flop (didn't bet)
Seat 4: Jimy Tiltman folded before Flop (didn't bet)
Seat 5: Dante63s folded before Flop (didn't bet)
Seat 6: Filojoes folded before Flop (didn't bet)
Seat 7: Kukuryzka folded before Flop (didn't bet)
Seat 8: mycka86 (button) collected ($2.50)
Seat 9: Sweden_Pound (small blind) folded before Flop





PokerStars Hand #147707835963:  Hold'em No Limit ($0.50/$1.00 USD) - 2016/01/26 16:05:30 CET [2016/01/26 10:05:30 ET]
Table 'Mashona' 9-max Seat #1 is the button
Seat 1: maxxmeister ($122.78 in chips) 
Seat 2: werades ($199.10 in chips) 
Seat 3: matiko09 ($122.07 in chips) 
Seat 4: Sweden_Pound ($151.06 in chips) 
Seat 5: solbi86 ($126.39 in chips) 
Seat 6: Filojoes ($100 in chips) 
Seat 7: EB0LARAMA ($309.24 in chips) 
Seat 8: Jimy Tiltman ($178.16 in chips) 
Seat 9: apfush ($100 in chips) 
werades: posts small blind $0.50
matiko09: posts big blind $1
*** HOLE CARDS ***
Dealt to matiko09 [5s 3h]
Sweden_Pound: folds 
solbi86: folds 
Filojoes: folds 
EB0LARAMA: calls $1
Jimy Tiltman: folds 
apfush: folds 
maxxmeister: folds 
werades: calls $0.50
matiko09: checks 
*** FLOP *** [Kh Kd 5d]
werades: bets $1.67
matiko09: calls $1.67
EB0LARAMA: folds 
*** TURN *** [Kh Kd 5d] [4s]
werades: bets $2.56
matiko09: calls $2.56
*** RIVER *** [Kh Kd 5d 4s] [Th]
werades: checks 
matiko09: checks 
*** SHOW DOWN ***
werades: shows [2c 5c] (two pair, Kings and Fives)
matiko09: shows [5s 3h] (two pair, Kings and Fives)
werades collected $5.47 from pot
matiko09 collected $5.47 from pot
*** SUMMARY ***
Total pot $11.46 | Rake $0.52 
Board [Kh Kd 5d 4s Th]
Seat 1: maxxmeister (button) folded before Flop (didn't bet)
Seat 2: werades (small blind) showed [2c 5c] and won ($5.47) with two pair, Kings and Fives
Seat 3: matiko09 (big blind) showed [5s 3h] and won ($5.47) with two pair, Kings and Fives
Seat 4: Sweden_Pound folded before Flop (didn't bet)
Seat 5: solbi86 folded before Flop (didn't bet)
Seat 6: Filojoes folded before Flop (didn't bet)
Seat 7: EB0LARAMA folded on the Flop
Seat 8: Jimy Tiltman folded before Flop (didn't bet)
Seat 9: apfush folded before Flop (didn't bet)





PokerStars Hand #147707836041:  Hold'em No Limit ($0.50/$1.00 USD) - 2016/01/26 16:05:30 CET [2016/01/26 10:05:30 ET]
Table 'Impala' 9-max Seat #2 is the button
Seat 1: mycka86 ($135.44 in chips) 
Seat 2: Filojoes ($100 in chips) 
Seat 3: Dante63s ($101.50 in chips) 
Seat 5: Kukuryzka ($100 in chips) 
Seat 6: Tijger R.d.J ($105.74 in chips) 
Seat 7: matiko09 ($119.84 in chips) 
Seat 8: apfush ($100 in chips) 
Seat 9: flozzi ($100 in chips) 
Dante63s: posts small blind $0.50
KLOP06031987: is sitting out 
Kukuryzka: posts big blind $1
*** HOLE CARDS ***
Dealt to matiko09 [7s 7h]
KLOP06031987 leaves the table
Tijger R.d.J: raises $1 to $2
matiko09: raises $5 to $7
apfush: folds 
flozzi: folds 
mycka86: folds 
Filojoes: folds 
Dante63s: folds 
Kukuryzka: folds 
Tijger R.d.J: folds 
Uncalled bet ($5) returned to matiko09
matiko09 collected $5.50 from pot
matiko09: doesn't show hand 
*** SUMMARY ***
Total pot $5.50 | Rake $0 
Seat 1: mycka86 folded before Flop (didn't bet)
Seat 2: Filojoes (button) folded before Flop (didn't bet)
Seat 3: Dante63s (small blind) folded before Flop
Seat 5: Kukuryzka (big blind) folded before Flop
Seat 6: Tijger R.d.J folded before Flop
Seat 7: matiko09 collected ($5.50)
Seat 8: apfush folded before Flop (didn't bet)
Seat 9: flozzi folded before Flop (didn't bet)





PokerStars Hand #147707854673:  Hold'em No Limit ($0.50/$1.00 USD) - 2016/01/26 16:05:55 CET [2016/01/26 10:05:55 ET]
Table 'Achates III' 9-max Seat #3 is the button
Seat 1: CI58 ($100 in chips) 
Seat 2: matiko09 ($121.45 in chips) 
Seat 3: Jimy Tiltman ($100 in chips) 
Seat 4: cn_chayanne ($100 in chips) 
Seat 5: Sweden_Pound ($234.60 in chips) 
Seat 6: Kukuryzka ($103.68 in chips) 
Seat 7: KLOP06031987 ($103.64 in chips) 
Seat 9: T-chaos_IMBA ($349.38 in chips) 
cn_chayanne: posts small blind $0.50
Sweden_Pound: posts big blind $1
*** HOLE CARDS ***
Dealt to matiko09 [3s Ad]
Kukuryzka: folds 
Kukuryzka leaves the table
KLOP06031987: folds 
T-chaos_IMBA said, "flop nuts"
KLOP06031987 leaves the table
T-chaos_IMBA: raises $2 to $3
CI58: folds 
matiko09: folds 
Jimy Tiltman: folds 
cn_chayanne: folds 
Sweden_Pound: folds 
Uncalled bet ($2) returned to T-chaos_IMBA
T-chaos_IMBA collected $2.50 from pot
T-chaos_IMBA: doesn't show hand 
*** SUMMARY ***
Total pot $2.50 | Rake $0 
Seat 1: CI58 folded before Flop (didn't bet)
Seat 2: matiko09 folded before Flop (didn't bet)
Seat 3: Jimy Tiltman (button) folded before Flop (didn't bet)
Seat 4: cn_chayanne (small blind) folded before Flop
Seat 5: Sweden_Pound (big blind) folded before Flop
Seat 6: Kukuryzka folded before Flop (didn't bet)
Seat 7: KLOP06031987 folded before Flop (didn't bet)
Seat 9: T-chaos_IMBA collected ($2.50)





PokerStars Hand #147707857529:  Hold'em No Limit ($0.50/$1.00 USD) - 2016/01/26 16:05:59 CET [2016/01/26 10:05:59 ET]
Table 'Volga III' 9-max Seat #8 is the button
Seat 1: CI58 ($100 in chips) 
Seat 2: KLOP06031987 ($112.20 in chips) 
Seat 3: Kukuryzka ($100 in chips) 
Seat 4: mycka86 ($103.71 in chips) 
Seat 5: veno79 ($53.85 in chips) 
Seat 6: Sweden_Pound ($101.86 in chips) 
Seat 7: soplak ($108.95 in chips) 
Seat 8: cn_chayanne ($101 in chips) 
Seat 9: matiko09 ($100 in chips) 
matiko09: posts small blind $0.50
CI58: posts big blind $1
*** HOLE CARDS ***
Dealt to matiko09 [As 4d]
KLOP06031987: folds 
Kukuryzka: raises $2 to $3
mycka86: folds 
veno79: folds 
Sweden_Pound: folds 
soplak: folds 
cn_chayanne: folds 
matiko09: folds 
CI58: folds 
Uncalled bet ($2) returned to Kukuryzka
Kukuryzka collected $2.50 from pot
Kukuryzka: doesn't show hand 
*** SUMMARY ***
Total pot $2.50 | Rake $0 
Seat 1: CI58 (big blind) folded before Flop
Seat 2: KLOP06031987 folded before Flop (didn't bet)
Seat 3: Kukuryzka collected ($2.50)
Seat 4: mycka86 folded before Flop (didn't bet)
Seat 5: veno79 folded before Flop (didn't bet)
Seat 6: Sweden_Pound folded before Flop (didn't bet)
Seat 7: soplak folded before Flop (didn't bet)
Seat 8: cn_chayanne (button) folded before Flop (didn't bet)
Seat 9: matiko09 (small blind) folded before Flop





PokerStars Hand #147707859749:  Hold'em No Limit ($0.50/$1.00 USD) - 2016/01/26 16:06:01 CET [2016/01/26 10:06:01 ET]
Table 'Montefiore' 9-max Seat #2 is the button
Seat 1: Celsinho0311 ($59.90 in chips) 
Seat 2: Dante63s ($154.29 in chips) 
Seat 3: Filojoes ($100 in chips) 
Seat 4: matiko09 ($103 in chips) 
Seat 5: ilaviiitech ($104.50 in chips) 
Seat 8: Kukuryzka ($100 in chips) 
Seat 9: KLOP06031987 ($100 in chips) 
Filojoes: posts small blind $0.50
matiko09: posts big blind $1
FroggyPlay: sits out 
mycka86: sits out 
*** HOLE CARDS ***
Dealt to matiko09 [Td 4d]
ilaviiitech: folds 
Kukuryzka: folds 
KLOP06031987: folds 
Celsinho0311: folds 
Dante63s: folds 
Filojoes: raises $1.50 to $2.50
matiko09: folds 
Uncalled bet ($1.50) returned to Filojoes
Filojoes collected $2 from pot
Filojoes: doesn't show hand 
*** SUMMARY ***
Total pot $2 | Rake $0 
Seat 1: Celsinho0311 folded before Flop (didn't bet)
Seat 2: Dante63s (button) folded before Flop (didn't bet)
Seat 3: Filojoes (small blind) collected ($2)
Seat 4: matiko09 (big blind) folded before Flop
Seat 5: ilaviiitech folded before Flop (didn't bet)
Seat 8: Kukuryzka folded before Flop (didn't bet)
Seat 9: KLOP06031987 folded before Flop (didn't bet)





PokerStars Hand #147707862378:  Hold'em No Limit ($0.50/$1.00 USD) - 2016/01/26 16:06:05 CET [2016/01/26 10:06:05 ET]
Table 'Aten II' 9-max Seat #3 is the button
Seat 1: cn_chayanne ($108.56 in chips) 
Seat 2: solbi86 ($100 in chips) 
Seat 3: ilaviiitech ($100 in chips) 
Seat 4: matiko09 ($100 in chips) 
Seat 5: sebaaastian ($100 in chips) 
Seat 6: ooohaaah ($83.25 in chips) 
Seat 7: Legioner721 ($37 in chips) 
Seat 9: TorontoBum ($113.11 in chips) 
matiko09: posts small blind $0.50
sebaaastian: posts big blind $1
*** HOLE CARDS ***
Dealt to matiko09 [8h As]
ooohaaah: folds 
Legioner721: folds 
TorontoBum: folds 
cn_chayanne: raises $1.50 to $2.50
solbi86: folds 
ilaviiitech: folds 
matiko09: folds 
sebaaastian: folds 
Uncalled bet ($1.50) returned to cn_chayanne
cn_chayanne collected $2.50 from pot
cn_chayanne: doesn't show hand 
*** SUMMARY ***
Total pot $2.50 | Rake $0 
Seat 1: cn_chayanne collected ($2.50)
Seat 2: solbi86 folded before Flop (didn't bet)
Seat 3: ilaviiitech (button) folded before Flop (didn't bet)
Seat 4: matiko09 (small blind) folded before Flop
Seat 5: sebaaastian (big blind) folded before Flop
Seat 6: ooohaaah folded before Flop (didn't bet)
Seat 7: Legioner721 folded before Flop (didn't bet)
Seat 9: TorontoBum folded before Flop (didn't bet)





PokerStars Hand #147707867851:  Hold'em No Limit ($0.50/$1.00 USD) - 2016/01/26 16:06:12 CET [2016/01/26 10:06:12 ET]
Table 'Impala' 9-max Seat #3 is the button
Seat 1: mycka86 ($135.44 in chips) 
Seat 2: Filojoes ($100 in chips) 
Seat 3: Dante63s ($101 in chips) 
Seat 5: Kukuryzka ($99 in chips) 
Seat 6: Tijger R.d.J ($103.74 in chips) 
Seat 7: matiko09 ($123.34 in chips) 
Seat 8: apfush ($100 in chips) 
Seat 9: flozzi ($100 in chips) 
Kukuryzka: posts small blind $0.50
Tijger R.d.J: posts big blind $1
*** HOLE CARDS ***
Dealt to matiko09 [2c 7d]
matiko09: folds 
apfush: folds 
flozzi: folds 
mycka86: folds 
Filojoes: folds 
Dante63s: raises $1 to $2
Rikti joins the table at seat #4 
Kukuryzka: folds 
Tijger R.d.J: calls $1
*** FLOP *** [Ad 3c Qs]
Tijger R.d.J: checks 
Dante63s: bets $3
Tijger R.d.J: folds 
Uncalled bet ($3) returned to Dante63s
Dante63s collected $4.30 from pot
Dante63s: doesn't show hand 
*** SUMMARY ***
Total pot $4.50 | Rake $0.20 
Board [Ad 3c Qs]
Seat 1: mycka86 folded before Flop (didn't bet)
Seat 2: Filojoes folded before Flop (didn't bet)
Seat 3: Dante63s (button) collected ($4.30)
Seat 5: Kukuryzka (small blind) folded before Flop
Seat 6: Tijger R.d.J (big blind) folded on the Flop
Seat 7: matiko09 folded before Flop (didn't bet)
Seat 8: apfush folded before Flop (didn't bet)
Seat 9: flozzi folded before Flop (didn't bet)





PokerStars Hand #147707870373:  Hold'em No Limit ($0.50/$1.00 USD) - 2016/01/26 16:06:15 CET [2016/01/26 10:06:15 ET]
Table 'Medusa III' 9-max Seat #6 is the button
Seat 1: soplak ($100 in chips) 
Seat 2: happydrake ($85 in chips) 
Seat 3: mycka86 ($106.50 in chips) 
Seat 4: Sweden_Pound ($146.98 in chips) 
Seat 5: matiko09 ($242.58 in chips) 
Seat 6: Dante63s ($191.49 in chips) 
Seat 7: Reven9er ($182.96 in chips) 
Seat 8: Filojoes ($100 in chips) 
Seat 9: KLOP06031987 ($101.50 in chips) 
Reven9er: posts small blind $0.50
Filojoes: posts big blind $1
*** HOLE CARDS ***
Dealt to matiko09 [2d 7d]
KLOP06031987: folds 
soplak: folds 
happydrake: folds 
mycka86: raises $1.50 to $2.50
Sweden_Pound: folds 
matiko09: folds 
Dante63s: folds 
Reven9er: folds 
Filojoes: folds 
Uncalled bet ($1.50) returned to mycka86
mycka86 collected $2.50 from pot
*** SUMMARY ***
Total pot $2.50 | Rake $0 
Seat 1: soplak folded before Flop (didn't bet)
Seat 2: happydrake folded before Flop (didn't bet)
Seat 3: mycka86 collected ($2.50)
Seat 4: Sweden_Pound folded before Flop (didn't bet)
Seat 5: matiko09 folded before Flop (didn't bet)
Seat 6: Dante63s (button) folded before Flop (didn't bet)
Seat 7: Reven9er (small blind) folded before Flop
Seat 8: Filojoes (big blind) folded before Flop
Seat 9: KLOP06031987 folded before Flop (didn't bet)





PokerStars Hand #147707875423:  Hold'em No Limit ($0.50/$1.00 USD) - 2016/01/26 16:06:22 CET [2016/01/26 10:06:22 ET]
Table 'Calypso II' 9-max Seat #4 is the button
Seat 2: Hardwell1993 ($96.12 in chips) 
Seat 3: matiko09 ($215.75 in chips) 
Seat 4: Sweden_Pound ($111.79 in chips) 
Seat 5: mycka86 ($115.50 in chips) 
Seat 6: MrDeeee25 ($111.20 in chips) 
Seat 7: Jimy Tiltman ($100 in chips) 
Seat 8: Reven9er ($113.83 in chips) 
Seat 9: Filojoes ($154.43 in chips) 
mycka86: posts small blind $0.50
MrDeeee25: posts big blind $1
KLOP06031987: sits out 
*** HOLE CARDS ***
Dealt to matiko09 [8c As]
Jimy Tiltman: folds 
Reven9er: folds 
Filojoes: folds 
Hardwell1993: calls $1
matiko09: raises $3 to $4
Sweden_Pound: folds 
mycka86: folds 
MrDeeee25: folds 
Hardwell1993: calls $3
*** FLOP *** [2h 8h 4d]
Hardwell1993: checks 
matiko09: bets $7
Hardwell1993: calls $7
*** TURN *** [2h 8h 4d] [9h]
Hardwell1993: bets $7
matiko09: calls $7
*** RIVER *** [2h 8h 4d 9h] [9d]
Hardwell1993: bets $7
matiko09: calls $7
*** SHOW DOWN ***
Hardwell1993: shows [Ac 4h] (two pair, Nines and Fours)
matiko09: shows [8c As] (two pair, Nines and Eights)
matiko09 collected $49.18 from pot
*** SUMMARY ***
Total pot $51.50 | Rake $2.32 
Board [2h 8h 4d 9h 9d]
Seat 2: Hardwell1993 showed [Ac 4h] and lost with two pair, Nines and Fours
Seat 3: matiko09 showed [8c As] and won ($49.18) with two pair, Nines and Eights
Seat 4: Sweden_Pound (button) folded before Flop (didn't bet)
Seat 5: mycka86 (small blind) folded before Flop
Seat 6: MrDeeee25 (big blind) folded before Flop
Seat 7: Jimy Tiltman folded before Flop (didn't bet)
Seat 8: Reven9er folded before Flop (didn't bet)
Seat 9: Filojoes folded before Flop (didn't bet)





PokerStars Hand #147707876686:  Hold'em No Limit ($0.50/$1.00 USD) - 2016/01/26 16:06:24 CET [2016/01/26 10:06:24 ET]
Table 'Montefiore' 9-max Seat #3 is the button
Seat 1: Celsinho0311 ($59.90 in chips) 
Seat 2: Dante63s ($154.29 in chips) 
Seat 3: Filojoes ($101 in chips) 
Seat 4: matiko09 ($102 in chips) 
Seat 5: ilaviiitech ($104.50 in chips) 
Seat 8: Kukuryzka ($100 in chips) 
Seat 9: KLOP06031987 ($100 in chips) 
matiko09: posts small blind $0.50
ilaviiitech: posts big blind $1
FroggyPlay: sits out 
mycka86: sits out 
*** HOLE CARDS ***
Dealt to matiko09 [Ac Jd]
Kukuryzka: raises $2 to $3
KLOP06031987: folds 
Celsinho0311: folds 
Dante63s: folds 
Filojoes: folds 
matiko09: folds 
ilaviiitech: folds 
Uncalled bet ($2) returned to Kukuryzka
Kukuryzka collected $2.50 from pot
Kukuryzka: doesn't show hand 
*** SUMMARY ***
Total pot $2.50 | Rake $0 
Seat 1: Celsinho0311 folded before Flop (didn't bet)
Seat 2: Dante63s folded before Flop (didn't bet)
Seat 3: Filojoes (button) folded before Flop (didn't bet)
Seat 4: matiko09 (small blind) folded before Flop
Seat 5: ilaviiitech (big blind) folded before Flop
Seat 8: Kukuryzka collected ($2.50)
Seat 9: KLOP06031987 folded before Flop (didn't bet)





PokerStars Hand #147707876711:  Hold'em No Limit ($0.50/$1.00 USD) - 2016/01/26 16:06:24 CET [2016/01/26 10:06:24 ET]
Table 'Strenua III' 9-max Seat #2 is the button
Seat 1: ICallSaul ($100.78 in chips) 
Seat 2: cn_chayanne ($123.29 in chips) 
Seat 3: petalouda10 ($69.17 in chips) 
Seat 4: mycka86 ($131.86 in chips) 
Seat 5: DeWeijz ($41.49 in chips) 
Seat 6: matiko09 ($131.84 in chips) 
Seat 7: KLOP06031987 ($100 in chips) 
Seat 8: Filojoes ($121.50 in chips) 
Seat 9: Dante63s ($100 in chips) 
petalouda10: posts small blind $0.50
mycka86: posts big blind $1
*** HOLE CARDS ***
Dealt to matiko09 [4s 4d]
DeWeijz: folds 
matiko09: raises $2 to $3
KLOP06031987: folds 
Filojoes: folds 
Dante63s: folds 
ICallSaul: folds 
cn_chayanne: folds 
petalouda10: folds 
mycka86: folds 
Uncalled bet ($2) returned to matiko09
matiko09 collected $2.50 from pot
matiko09: doesn't show hand 
*** SUMMARY ***
Total pot $2.50 | Rake $0 
Seat 1: ICallSaul folded before Flop (didn't bet)
Seat 2: cn_chayanne (button) folded before Flop (didn't bet)
Seat 3: petalouda10 (small blind) folded before Flop
Seat 4: mycka86 (big blind) folded before Flop
Seat 5: DeWeijz folded before Flop (didn't bet)
Seat 6: matiko09 collected ($2.50)
Seat 7: KLOP06031987 folded before Flop (didn't bet)
Seat 8: Filojoes folded before Flop (didn't bet)
Seat 9: Dante63s folded before Flop (didn't bet)





PokerStars Hand #147707877741:  Hold'em No Limit ($0.50/$1.00 USD) - 2016/01/26 16:06:25 CET [2016/01/26 10:06:25 ET]
Table 'Kale II' 9-max Seat #9 is the button
Seat 2: matiko09 ($103.16 in chips) 
Seat 3: Reven9er ($133.70 in chips) 
Seat 4: Jimy Tiltman ($194.57 in chips) 
Seat 5: Dante63s ($100 in chips) 
Seat 6: Filojoes ($122.80 in chips) 
Seat 7: Kukuryzka ($103.30 in chips) 
Seat 8: mycka86 ($101.50 in chips) 
Seat 9: Sweden_Pound ($125.28 in chips) 
matiko09: posts small blind $0.50
Reven9er: posts big blind $1
*** HOLE CARDS ***
Dealt to matiko09 [9h Qs]
Jimy Tiltman: folds 
Dante63s: folds 
Filojoes: folds 
Kukuryzka: folds 
mycka86: folds 
Sweden_Pound: folds 
matiko09: raises $1.50 to $2.50
Reven9er: calls $1.50
*** FLOP *** [2d Js Ah]
matiko09: bets $3.11
Reven9er: calls $3.11
*** TURN *** [2d Js Ah] [8d]
matiko09: checks 
Reven9er: bets $3
matiko09: folds 
Uncalled bet ($3) returned to Reven9er
Reven9er collected $10.72 from pot
Reven9er: doesn't show hand 
*** SUMMARY ***
Total pot $11.22 | Rake $0.50 
Board [2d Js Ah 8d]
Seat 2: matiko09 (small blind) folded on the Turn
Seat 3: Reven9er (big blind) collected ($10.72)
Seat 4: Jimy Tiltman folded before Flop (didn't bet)
Seat 5: Dante63s folded before Flop (didn't bet)
Seat 6: Filojoes folded before Flop (didn't bet)
Seat 7: Kukuryzka folded before Flop (didn't bet)
Seat 8: mycka86 folded before Flop (didn't bet)
Seat 9: Sweden_Pound (button) folded before Flop (didn't bet)





PokerStars Hand #147707881642:  Hold'em No Limit ($0.50/$1.00 USD) - 2016/01/26 16:06:30 CET [2016/01/26 10:06:30 ET]
Table 'Achates III' 9-max Seat #4 is the button
Seat 1: CI58 ($100 in chips) 
Seat 2: matiko09 ($121.45 in chips) 
Seat 3: Jimy Tiltman ($100 in chips) 
Seat 4: cn_chayanne ($100 in chips) 
Seat 5: Sweden_Pound ($233.60 in chips) 
Seat 9: T-chaos_IMBA ($350.88 in chips) 
Sweden_Pound: posts small blind $0.50
T-chaos_IMBA: posts big blind $1
*** HOLE CARDS ***
Dealt to matiko09 [8h Ts]
CI58: folds 
matiko09: folds 
Jimy Tiltman: raises $1 to $2
cn_chayanne: folds 
Sweden_Pound: folds 
solbi86 joins the table at seat #6 
T-chaos_IMBA: calls $1
*** FLOP *** [6d 2h 5s]
T-chaos_IMBA: checks 
Jimy Tiltman: bets $2.50
T-chaos_IMBA: raises $3.50 to $6
Jimy Tiltman: calls $3.50
*** TURN *** [6d 2h 5s] [Kh]
T-chaos_IMBA: bets $5.20
easycomengo joins the table at seat #8 
Jimy Tiltman: calls $5.20
*** RIVER *** [6d 2h 5s Kh] [Td]
randi_0 joins the table at seat #7 
T-chaos_IMBA: bets $8.47
Jimy Tiltman: folds 
Uncalled bet ($8.47) returned to T-chaos_IMBA
T-chaos_IMBA collected $25.69 from pot
T-chaos_IMBA: doesn't show hand 
*** SUMMARY ***
Total pot $26.90 | Rake $1.21 
Board [6d 2h 5s Kh Td]
Seat 1: CI58 folded before Flop (didn't bet)
Seat 2: matiko09 folded before Flop (didn't bet)
Seat 3: Jimy Tiltman folded on the River
Seat 4: cn_chayanne (button) folded before Flop (didn't bet)
Seat 5: Sweden_Pound (small blind) folded before Flop
Seat 9: T-chaos_IMBA (big blind) collected ($25.69)





PokerStars Hand #147707886410:  Hold'em No Limit ($0.50/$1.00 USD) - 2016/01/26 16:06:37 CET [2016/01/26 10:06:37 ET]
Table 'Mashona' 9-max Seat #2 is the button
Seat 1: maxxmeister ($122.78 in chips) 
Seat 2: werades ($199.34 in chips) 
Seat 3: matiko09 ($122.31 in chips) 
Seat 4: Sweden_Pound ($151.06 in chips) 
Seat 5: solbi86 ($126.39 in chips) 
Seat 6: Filojoes ($100 in chips) 
Seat 7: EB0LARAMA ($308.24 in chips) 
Seat 8: Jimy Tiltman ($178.16 in chips) 
Seat 9: apfush ($100 in chips) 
matiko09: posts small blind $0.50
Sweden_Pound: posts big blind $1
*** HOLE CARDS ***
Dealt to matiko09 [6h 5d]
solbi86: folds 
werades said, "lol"
werades said, "nh"
Filojoes: folds 
EB0LARAMA: folds 
Jimy Tiltman: folds 
apfush: folds 
maxxmeister: raises $2 to $3
werades: folds 
matiko09: folds 
Sweden_Pound: folds 
Uncalled bet ($2) returned to maxxmeister
maxxmeister collected $2.50 from pot
maxxmeister: doesn't show hand 
*** SUMMARY ***
Total pot $2.50 | Rake $0 
Seat 1: maxxmeister collected ($2.50)
Seat 2: werades (button) folded before Flop (didn't bet)
Seat 3: matiko09 (small blind) folded before Flop
Seat 4: Sweden_Pound (big blind) folded before Flop
Seat 5: solbi86 folded before Flop (didn't bet)
Seat 6: Filojoes folded before Flop (didn't bet)
Seat 7: EB0LARAMA folded before Flop (didn't bet)
Seat 8: Jimy Tiltman folded before Flop (didn't bet)
Seat 9: apfush folded before Flop (didn't bet)





PokerStars Hand #147707896012:  Hold'em No Limit ($0.50/$1.00 USD) - 2016/01/26 16:06:49 CET [2016/01/26 10:06:49 ET]
Table 'Srbija III' 9-max Seat #4 is the button
Seat 1: Sweden_Pound ($100 in chips) 
Seat 2: cn_chayanne ($101.50 in chips) 
Seat 4: petalouda10 ($89.14 in chips) 
Seat 5: mycka86 ($100 in chips) 
Seat 6: matiko09 ($199.94 in chips) 
Seat 8: solbi86 ($101.16 in chips) 
Seat 9: soplak ($121.65 in chips) 
mycka86: posts small blind $0.50
matiko09: posts big blind $1
KLOP06031987: sits out 
*** HOLE CARDS ***
Dealt to matiko09 [Td 9c]
solbi86: folds 
soplak: folds 
Sweden_Pound: folds 
cn_chayanne: folds 
petalouda10: folds 
mycka86: raises $1.75 to $2.75
LIGOPSIXIS78 joins the table at seat #3 
matiko09: calls $1.75
*** FLOP *** [Qd 6h 6s]
mycka86: checks 
matiko09: checks 
*** TURN *** [Qd 6h 6s] [Jh]
mycka86: checks 
matiko09: bets $3.41
mycka86: calls $3.41
*** RIVER *** [Qd 6h 6s Jh] [Tc]
mycka86: checks 
matiko09: checks 
*** SHOW DOWN ***
mycka86: shows [As 9s] (a pair of Sixes)
matiko09: shows [Td 9c] (two pair, Tens and Sixes)
matiko09 collected $11.77 from pot
*** SUMMARY ***
Total pot $12.32 | Rake $0.55 
Board [Qd 6h 6s Jh Tc]
Seat 1: Sweden_Pound folded before Flop (didn't bet)
Seat 2: cn_chayanne folded before Flop (didn't bet)
Seat 4: petalouda10 (button) folded before Flop (didn't bet)
Seat 5: mycka86 (small blind) showed [As 9s] and lost with a pair of Sixes
Seat 6: matiko09 (big blind) showed [Td 9c] and won ($11.77) with two pair, Tens and Sixes
Seat 8: solbi86 folded before Flop (didn't bet)
Seat 9: soplak folded before Flop (didn't bet)





PokerStars Hand #147707896430:  Hold'em No Limit ($0.50/$1.00 USD) - 2016/01/26 16:06:50 CET [2016/01/26 10:06:50 ET]
Table 'Aten II' 9-max Seat #4 is the button
Seat 1: cn_chayanne ($110.06 in chips) 
Seat 2: solbi86 ($100 in chips) 
Seat 3: ilaviiitech ($100 in chips) 
Seat 4: matiko09 ($100 in chips) 
Seat 5: sebaaastian ($100 in chips) 
Seat 6: ooohaaah ($83.25 in chips) 
Seat 7: Legioner721 ($37 in chips) 
Seat 9: TorontoBum ($113.11 in chips) 
sebaaastian: posts small blind $0.50
ooohaaah: posts big blind $1
*** HOLE CARDS ***
Dealt to matiko09 [Ah Ad]
Legioner721: calls $1
TorontoBum: folds 
cn_chayanne: folds 
solbi86: raises $3 to $4
ilaviiitech: folds 
matiko09: calls $4
sebaaastian: folds 
ooohaaah: folds 
Legioner721: calls $3
*** FLOP *** [Kh 9c 5c]
Legioner721: checks 
solbi86: bets $8.50
matiko09: calls $8.50
Legioner721: folds 
*** TURN *** [Kh 9c 5c] [5h]
solbi86: checks 
matiko09: bets $19
solbi86: raises $25 to $44
matiko09: folds 
Uncalled bet ($25) returned to solbi86
solbi86 collected $65.70 from pot
solbi86: doesn't show hand 
*** SUMMARY ***
Total pot $68.50 | Rake $2.80 
Board [Kh 9c 5c 5h]
Seat 1: cn_chayanne folded before Flop (didn't bet)
Seat 2: solbi86 collected ($65.70)
Seat 3: ilaviiitech folded before Flop (didn't bet)
Seat 4: matiko09 (button) folded on the Turn
Seat 5: sebaaastian (small blind) folded before Flop
Seat 6: ooohaaah (big blind) folded before Flop
Seat 7: Legioner721 folded on the Flop
Seat 9: TorontoBum folded before Flop (didn't bet)





PokerStars Hand #147707897104:  Hold'em No Limit ($0.50/$1.00 USD) - 2016/01/26 16:06:51 CET [2016/01/26 10:06:51 ET]
Table 'Impala' 9-max Seat #5 is the button
Seat 1: mycka86 ($135.44 in chips) 
Seat 2: Filojoes ($100 in chips) 
Seat 3: Dante63s ($103.30 in chips) 
Seat 5: Kukuryzka ($100 in chips) 
Seat 6: Tijger R.d.J ($101.74 in chips) 
Seat 7: matiko09 ($123.34 in chips) 
Seat 8: apfush ($100 in chips) 
Seat 9: flozzi ($100 in chips) 
Tijger R.d.J: posts small blind $0.50
matiko09: posts big blind $1
Rikti: sits out 
*** HOLE CARDS ***
Dealt to matiko09 [Ah Qd]
apfush: folds 
flozzi: folds 
mycka86: folds 
Filojoes: folds 
Dante63s: raises $1.50 to $2.50
Kukuryzka: folds 
Tijger R.d.J: calls $2
matiko09: raises $8.50 to $11
Dante63s: folds 
Tijger R.d.J: calls $8.50
*** FLOP *** [6c 3c 9c]
Tijger R.d.J: checks 
matiko09: checks 
*** TURN *** [6c 3c 9c] [As]
Tijger R.d.J: checks 
matiko09: bets $18
Tijger R.d.J: folds 
Uncalled bet ($18) returned to matiko09
matiko09 collected $23.40 from pot
matiko09: doesn't show hand 
*** SUMMARY ***
Total pot $24.50 | Rake $1.10 
Board [6c 3c 9c As]
Seat 1: mycka86 folded before Flop (didn't bet)
Seat 2: Filojoes folded before Flop (didn't bet)
Seat 3: Dante63s folded before Flop
Seat 5: Kukuryzka (button) folded before Flop (didn't bet)
Seat 6: Tijger R.d.J (small blind) folded on the Turn
Seat 7: matiko09 (big blind) collected ($23.40)
Seat 8: apfush folded before Flop (didn't bet)
Seat 9: flozzi folded before Flop (didn't bet)





PokerStars Hand #147707901127:  Hold'em No Limit ($0.50/$1.00 USD) - 2016/01/26 16:06:56 CET [2016/01/26 10:06:56 ET]
Table 'Medusa III' 9-max Seat #7 is the button
Seat 1: soplak ($100 in chips) 
Seat 2: happydrake ($85 in chips) 
Seat 3: mycka86 ($108 in chips) 
Seat 4: Sweden_Pound ($146.98 in chips) 
Seat 5: matiko09 ($242.58 in chips) 
Seat 6: Dante63s ($191.49 in chips) 
Seat 7: Reven9er ($182.46 in chips) 
Seat 8: Filojoes ($100 in chips) 
Filojoes: posts small blind $0.50
KLOP06031987: is sitting out 
soplak: posts big blind $1
*** HOLE CARDS ***
Dealt to matiko09 [Ks Kc]
KLOP06031987 leaves the table
happydrake: folds 
mycka86: folds 
Sweden_Pound: folds 
matiko09: raises $2 to $3
Dante63s: folds 
Reven9er: folds 
Filojoes: folds 
soplak: folds 
Uncalled bet ($2) returned to matiko09
matiko09 collected $2.50 from pot
matiko09: doesn't show hand 
*** SUMMARY ***
Total pot $2.50 | Rake $0 
Seat 1: soplak (big blind) folded before Flop
Seat 2: happydrake folded before Flop (didn't bet)
Seat 3: mycka86 folded before Flop (didn't bet)
Seat 4: Sweden_Pound folded before Flop (didn't bet)
Seat 5: matiko09 collected ($2.50)
Seat 6: Dante63s folded before Flop (didn't bet)
Seat 7: Reven9er (button) folded before Flop (didn't bet)
Seat 8: Filojoes (small blind) folded before Flop





PokerStars Hand #147707905603:  Hold'em No Limit ($0.50/$1.00 USD) - 2016/01/26 16:07:02 CET [2016/01/26 10:07:02 ET]
Table 'Volga III' 9-max Seat #9 is the button
Seat 1: CI58 ($100 in chips) 
Seat 2: KLOP06031987 ($112.20 in chips) 
Seat 3: Kukuryzka ($101.50 in chips) 
Seat 4: mycka86 ($103.71 in chips) 
Seat 5: veno79 ($53.85 in chips) 
Seat 6: Sweden_Pound ($101.86 in chips) 
Seat 7: soplak ($108.95 in chips) 
Seat 8: cn_chayanne ($101 in chips) 
Seat 9: matiko09 ($100 in chips) 
CI58: posts small blind $0.50
KLOP06031987: posts big blind $1
*** HOLE CARDS ***
Dealt to matiko09 [9h Qh]
Kukuryzka: folds 
mycka86: folds 
veno79 has timed out
veno79: folds 
Sweden_Pound: folds 
soplak: folds 
cn_chayanne: folds 
matiko09: raises $1.27 to $2.27
CI58: folds 
KLOP06031987: calls $1.27
*** FLOP *** [2c Td Qc]
KLOP06031987: checks 
matiko09: bets $3.13
KLOP06031987: folds 
Uncalled bet ($3.13) returned to matiko09
matiko09 collected $4.81 from pot
matiko09: doesn't show hand 
*** SUMMARY ***
Total pot $5.04 | Rake $0.23 
Board [2c Td Qc]
Seat 1: CI58 (small blind) folded before Flop
Seat 2: KLOP06031987 (big blind) folded on the Flop
Seat 3: Kukuryzka folded before Flop (didn't bet)
Seat 4: mycka86 folded before Flop (didn't bet)
Seat 5: veno79 folded before Flop (didn't bet)
Seat 6: Sweden_Pound folded before Flop (didn't bet)
Seat 7: soplak folded before Flop (didn't bet)
Seat 8: cn_chayanne folded before Flop (didn't bet)
Seat 9: matiko09 (button) collected ($4.81)





PokerStars Hand #147707906020:  Hold'em No Limit ($0.50/$1.00 USD) - 2016/01/26 16:07:03 CET [2016/01/26 10:07:03 ET]
Table 'Strenua III' 9-max Seat #3 is the button
Seat 1: ICallSaul ($100.78 in chips) 
Seat 2: cn_chayanne ($123.29 in chips) 
Seat 3: petalouda10 ($68.67 in chips) 
Seat 4: mycka86 ($130.86 in chips) 
Seat 5: DeWeijz ($41.49 in chips) 
Seat 6: matiko09 ($133.34 in chips) 
Seat 7: KLOP06031987 ($100 in chips) 
Seat 8: Filojoes ($121.50 in chips) 
Seat 9: Dante63s ($100 in chips) 
mycka86: posts small blind $0.50
DeWeijz: posts big blind $1
*** HOLE CARDS ***
Dealt to matiko09 [8s As]
matiko09: folds 
KLOP06031987: folds 
Filojoes: folds 
Dante63s: raises $1.50 to $2.50
ICallSaul: folds 
cn_chayanne: folds 
petalouda10: folds 
mycka86: folds 
DeWeijz: folds 
Uncalled bet ($1.50) returned to Dante63s
Dante63s collected $2.50 from pot
Dante63s: doesn't show hand 
*** SUMMARY ***
Total pot $2.50 | Rake $0 
Seat 1: ICallSaul folded before Flop (didn't bet)
Seat 2: cn_chayanne folded before Flop (didn't bet)
Seat 3: petalouda10 (button) folded before Flop (didn't bet)
Seat 4: mycka86 (small blind) folded before Flop
Seat 5: DeWeijz (big blind) folded before Flop
Seat 6: matiko09 folded before Flop (didn't bet)
Seat 7: KLOP06031987 folded before Flop (didn't bet)
Seat 8: Filojoes folded before Flop (didn't bet)
Seat 9: Dante63s collected ($2.50)





PokerStars Hand #147707908229:  Hold'em No Limit ($0.50/$1.00 USD) - 2016/01/26 16:07:06 CET [2016/01/26 10:07:06 ET]
Table 'Montefiore' 9-max Seat #4 is the button
Seat 1: Celsinho0311 ($59.90 in chips) 
Seat 2: Dante63s ($154.29 in chips) 
Seat 3: Filojoes ($101 in chips) 
Seat 4: matiko09 ($101.50 in chips) 
Seat 5: ilaviiitech ($103.50 in chips) 
Seat 6: FroggyPlay ($100 in chips) 
Seat 8: Kukuryzka ($101.50 in chips) 
Seat 9: KLOP06031987 ($100 in chips) 
ilaviiitech: posts small blind $0.50
FroggyPlay: posts big blind $1
mycka86: sits out 
*** HOLE CARDS ***
Dealt to matiko09 [Qd 7h]
Kukuryzka: folds 
KLOP06031987: folds 
Celsinho0311: raises $2 to $3
Dante63s: folds 
Filojoes: folds 
matiko09: folds 
ilaviiitech: folds 
FroggyPlay: folds 
Uncalled bet ($2) returned to Celsinho0311
Celsinho0311 collected $2.50 from pot
*** SUMMARY ***
Total pot $2.50 | Rake $0 
Seat 1: Celsinho0311 collected ($2.50)
Seat 2: Dante63s folded before Flop (didn't bet)
Seat 3: Filojoes folded before Flop (didn't bet)
Seat 4: matiko09 (button) folded before Flop (didn't bet)
Seat 5: ilaviiitech (small blind) folded before Flop
Seat 6: FroggyPlay (big blind) folded before Flop
Seat 8: Kukuryzka folded before Flop (didn't bet)
Seat 9: KLOP06031987 folded before Flop (didn't bet)





PokerStars Hand #147707917750:  Hold'em No Limit ($0.50/$1.00 USD) - 2016/01/26 16:07:19 CET [2016/01/26 10:07:19 ET]
Table 'Mashona' 9-max Seat #3 is the button
Seat 1: maxxmeister ($124.28 in chips) 
Seat 2: werades ($199.34 in chips) 
Seat 3: matiko09 ($121.81 in chips) 
Seat 4: Sweden_Pound ($150.06 in chips) 
Seat 5: solbi86 ($126.39 in chips) 
Seat 6: Filojoes ($100 in chips) 
Seat 7: EB0LARAMA ($308.24 in chips) 
Seat 8: Jimy Tiltman ($178.16 in chips) 
Seat 9: apfush ($100 in chips) 
Sweden_Pound: posts small blind $0.50
solbi86: posts big blind $1
*** HOLE CARDS ***
Dealt to matiko09 [Tc Js]
Filojoes: folds 
EB0LARAMA: folds 
Jimy Tiltman: folds 
apfush: folds 
maxxmeister: folds 
werades: raises $1.50 to $2.50
matiko09: folds 
Sweden_Pound: folds 
solbi86: folds 
Uncalled bet ($1.50) returned to werades
werades collected $2.50 from pot
werades: doesn't show hand 
*** SUMMARY ***
Total pot $2.50 | Rake $0 
Seat 1: maxxmeister folded before Flop (didn't bet)
Seat 2: werades collected ($2.50)
Seat 3: matiko09 (button) folded before Flop (didn't bet)
Seat 4: Sweden_Pound (small blind) folded before Flop
Seat 5: solbi86 (big blind) folded before Flop
Seat 6: Filojoes folded before Flop (didn't bet)
Seat 7: EB0LARAMA folded before Flop (didn't bet)
Seat 8: Jimy Tiltman folded before Flop (didn't bet)
Seat 9: apfush folded before Flop (didn't bet)





PokerStars Hand #147707927246:  Hold'em No Limit ($0.50/$1.00 USD) - 2016/01/26 16:07:31 CET [2016/01/26 10:07:31 ET]
Table 'Medusa III' 9-max Seat #8 is the button
Seat 1: soplak ($100 in chips) 
Seat 2: happydrake ($85 in chips) 
Seat 3: mycka86 ($108 in chips) 
Seat 4: Sweden_Pound ($146.98 in chips) 
Seat 5: matiko09 ($244.08 in chips) 
Seat 6: Dante63s ($191.49 in chips) 
Seat 7: Reven9er ($182.46 in chips) 
Seat 8: Filojoes ($100 in chips) 
soplak: posts small blind $0.50
happydrake: posts big blind $1
*** HOLE CARDS ***
Dealt to matiko09 [9d 8s]
mycka86: folds 
sebaaastian joins the table at seat #9 
Sweden_Pound: folds 
matiko09: folds 
Dante63s: folds 
Reven9er: folds 
Filojoes: raises $1 to $2
soplak: raises $5 to $7
happydrake: folds 
Filojoes: raises $12 to $19
soplak: calls $12
*** FLOP *** [8d 6h 8h]
soplak: checks 
Filojoes: bets $16.50
soplak: calls $16.50
*** TURN *** [8d 6h 8h] [8c]
soplak: checks 
Filojoes: bets $64.50 and is all-in
soplak: folds 
Uncalled bet ($64.50) returned to Filojoes
Filojoes collected $69.20 from pot
Filojoes: doesn't show hand 
*** SUMMARY ***
Total pot $72 | Rake $2.80 
Board [8d 6h 8h 8c]
Seat 1: soplak (small blind) folded on the Turn
Seat 2: happydrake (big blind) folded before Flop
Seat 3: mycka86 folded before Flop (didn't bet)
Seat 4: Sweden_Pound folded before Flop (didn't bet)
Seat 5: matiko09 folded before Flop (didn't bet)
Seat 6: Dante63s folded before Flop (didn't bet)
Seat 7: Reven9er folded before Flop (didn't bet)
Seat 8: Filojoes (button) collected ($69.20)





PokerStars Hand #147707930431:  Hold'em No Limit ($0.50/$1.00 USD) - 2016/01/26 16:07:36 CET [2016/01/26 10:07:36 ET]
Table 'Calypso II' 9-max Seat #5 is the button
Seat 2: Hardwell1993 ($71.12 in chips) 
Seat 3: matiko09 ($239.93 in chips) 
Seat 4: Sweden_Pound ($111.79 in chips) 
Seat 5: mycka86 ($115 in chips) 
Seat 6: MrDeeee25 ($110.20 in chips) 
Seat 7: Jimy Tiltman ($100 in chips) 
Seat 8: Reven9er ($113.83 in chips) 
Seat 9: Filojoes ($154.43 in chips) 
MrDeeee25: posts small blind $0.50
Jimy Tiltman: posts big blind $1
KLOP06031987: sits out 
*** HOLE CARDS ***
Dealt to matiko09 [6s Qc]
Reven9er: folds 
Filojoes: raises $2 to $3
Hardwell1993: calls $3
matiko09: folds 
Sweden_Pound: folds 
mycka86: folds 
MrDeeee25: folds 
Jimy Tiltman: folds 
*** FLOP *** [2c Ah Jh]
Filojoes: checks 
Hardwell1993: checks 
*** TURN *** [2c Ah Jh] [8s]
Filojoes: bets $5.01
Hardwell1993: calls $5.01
*** RIVER *** [2c Ah Jh 8s] [5d]
Filojoes: bets $12
Hardwell1993: raises $12 to $24
Filojoes: folds 
Uncalled bet ($12) returned to Hardwell1993
Hardwell1993 collected $39.65 from pot
*** SUMMARY ***
Total pot $41.52 | Rake $1.87 
Board [2c Ah Jh 8s 5d]
Seat 2: Hardwell1993 collected ($39.65)
Seat 3: matiko09 folded before Flop (didn't bet)
Seat 4: Sweden_Pound folded before Flop (didn't bet)
Seat 5: mycka86 (button) folded before Flop (didn't bet)
Seat 6: MrDeeee25 (small blind) folded before Flop
Seat 7: Jimy Tiltman (big blind) folded before Flop
Seat 8: Reven9er folded before Flop (didn't bet)
Seat 9: Filojoes folded on the River





PokerStars Hand #147707931370:  Hold'em No Limit ($0.50/$1.00 USD) - 2016/01/26 16:07:37 CET [2016/01/26 10:07:37 ET]
Table 'Strenua III' 9-max Seat #4 is the button
Seat 1: ICallSaul ($100.78 in chips) 
Seat 2: cn_chayanne ($123.29 in chips) 
Seat 3: petalouda10 ($68.67 in chips) 
Seat 4: mycka86 ($130.36 in chips) 
Seat 5: DeWeijz ($40.49 in chips) 
Seat 6: matiko09 ($133.34 in chips) 
Seat 7: KLOP06031987 ($100 in chips) 
Seat 8: Filojoes ($121.50 in chips) 
Seat 9: Dante63s ($101.50 in chips) 
DeWeijz: posts small blind $0.50
matiko09: posts big blind $1
*** HOLE CARDS ***
Dealt to matiko09 [4s Kd]
KLOP06031987: folds 
Filojoes: folds 
Dante63s: folds 
ICallSaul: raises $2 to $3
cn_chayanne: folds 
petalouda10: calls $3
mycka86: folds 
DeWeijz: folds 
matiko09: folds 
*** FLOP *** [Kh Ks 3s]
ICallSaul: checks 
petalouda10: checks 
*** TURN *** [Kh Ks 3s] [4h]
ICallSaul: checks 
petalouda10: bets $3.58
ICallSaul: folds 
Uncalled bet ($3.58) returned to petalouda10
petalouda10 collected $7.16 from pot
petalouda10: doesn't show hand 
*** SUMMARY ***
Total pot $7.50 | Rake $0.34 
Board [Kh Ks 3s 4h]
Seat 1: ICallSaul folded on the Turn
Seat 2: cn_chayanne folded before Flop (didn't bet)
Seat 3: petalouda10 collected ($7.16)
Seat 4: mycka86 (button) folded before Flop (didn't bet)
Seat 5: DeWeijz (small blind) folded before Flop
Seat 6: matiko09 (big blind) folded before Flop
Seat 7: KLOP06031987 folded before Flop (didn't bet)
Seat 8: Filojoes folded before Flop (didn't bet)
Seat 9: Dante63s folded before Flop (didn't bet)





PokerStars Hand #147707938261:  Hold'em No Limit ($0.50/$1.00 USD) - 2016/01/26 16:07:46 CET [2016/01/26 10:07:46 ET]
Table 'Achates III' 9-max Seat #5 is the button
Seat 2: matiko09 ($121.45 in chips) 
Seat 3: Jimy Tiltman ($100 in chips) 
Seat 4: cn_chayanne ($100 in chips) 
Seat 5: Sweden_Pound ($233.10 in chips) 
Seat 9: T-chaos_IMBA ($363.37 in chips) 
solbi86 will be allowed to play after the button
randi_0 will be allowed to play after the button
easycomengo will be allowed to play after the button
T-chaos_IMBA: posts small blind $0.50
CI58: is sitting out 
matiko09: posts big blind $1
*** HOLE CARDS ***
Dealt to matiko09 [Jc 2h]
CI58 leaves the table
Jimy Tiltman: folds 
cn_chayanne: folds 
Sweden_Pound: folds 
T-chaos_IMBA: folds 
Uncalled bet ($0.50) returned to matiko09
matiko09 collected $1 from pot
matiko09: doesn't show hand 
*** SUMMARY ***
Total pot $1 | Rake $0 
Seat 2: matiko09 (big blind) collected ($1)
Seat 3: Jimy Tiltman folded before Flop (didn't bet)
Seat 4: cn_chayanne folded before Flop (didn't bet)
Seat 5: Sweden_Pound (button) folded before Flop (didn't bet)
Seat 9: T-chaos_IMBA (small blind) folded before Flop





PokerStars Hand #147707944759:  Hold'em No Limit ($0.50/$1.00 USD) - 2016/01/26 16:07:55 CET [2016/01/26 10:07:55 ET]
Table 'Montefiore' 9-max Seat #5 is the button
Seat 1: Celsinho0311 ($61.40 in chips) 
Seat 2: Dante63s ($154.29 in chips) 
Seat 3: Filojoes ($101 in chips) 
Seat 4: matiko09 ($101.50 in chips) 
Seat 5: ilaviiitech ($103 in chips) 
Seat 6: FroggyPlay ($100 in chips) 
Seat 7: mycka86 ($100 in chips) 
Seat 8: Kukuryzka ($101.50 in chips) 
Seat 9: KLOP06031987 ($100 in chips) 
FroggyPlay: posts small blind $0.50
mycka86: posts big blind $1
*** HOLE CARDS ***
Dealt to matiko09 [Ac 8d]
Kukuryzka: folds 
KLOP06031987: folds 
Celsinho0311: folds 
Dante63s: folds 
Filojoes: folds 
matiko09: folds 
ilaviiitech: folds 
FroggyPlay: folds 
Uncalled bet ($0.50) returned to mycka86
mycka86 collected $1 from pot
*** SUMMARY ***
Total pot $1 | Rake $0 
Seat 1: Celsinho0311 folded before Flop (didn't bet)
Seat 2: Dante63s folded before Flop (didn't bet)
Seat 3: Filojoes folded before Flop (didn't bet)
Seat 4: matiko09 folded before Flop (didn't bet)
Seat 5: ilaviiitech (button) folded before Flop (didn't bet)
Seat 6: FroggyPlay (small blind) folded before Flop
Seat 7: mycka86 (big blind) collected ($1)
Seat 8: Kukuryzka folded before Flop (didn't bet)
Seat 9: KLOP06031987 folded before Flop (didn't bet)





PokerStars Hand #147707953616:  Hold'em No Limit ($0.50/$1.00 USD) - 2016/01/26 16:08:06 CET [2016/01/26 10:08:06 ET]
Table 'Mashona' 9-max Seat #4 is the button
Seat 1: maxxmeister ($124.28 in chips) 
Seat 2: werades ($200.84 in chips) 
Seat 3: matiko09 ($121.81 in chips) 
Seat 4: Sweden_Pound ($149.56 in chips) 
Seat 5: solbi86 ($125.39 in chips) 
Seat 6: Filojoes ($100 in chips) 
Seat 7: EB0LARAMA ($308.24 in chips) 
Seat 8: Jimy Tiltman ($178.16 in chips) 
Seat 9: apfush ($100 in chips) 
solbi86: posts small blind $0.50
Filojoes: posts big blind $1
*** HOLE CARDS ***
Dealt to matiko09 [Js 9h]
EB0LARAMA: folds 
Jimy Tiltman: folds 
apfush: folds 
maxxmeister: folds 
werades: folds 
matiko09: folds 
Sweden_Pound: raises $1 to $2
solbi86: raises $6 to $8
Filojoes: folds 
Sweden_Pound: calls $6
*** FLOP *** [Tc 5h 8d]
solbi86: bets $9
Sweden_Pound: folds 
Uncalled bet ($9) returned to solbi86
solbi86 collected $16.24 from pot
solbi86: doesn't show hand 
*** SUMMARY ***
Total pot $17 | Rake $0.76 
Board [Tc 5h 8d]
Seat 1: maxxmeister folded before Flop (didn't bet)
Seat 2: werades folded before Flop (didn't bet)
Seat 3: matiko09 folded before Flop (didn't bet)
Seat 4: Sweden_Pound (button) folded on the Flop
Seat 5: solbi86 (small blind) collected ($16.24)
Seat 6: Filojoes (big blind) folded before Flop
Seat 7: EB0LARAMA folded before Flop (didn't bet)
Seat 8: Jimy Tiltman folded before Flop (didn't bet)
Seat 9: apfush folded before Flop (didn't bet)





PokerStars Hand #147707954662:  Hold'em No Limit ($0.50/$1.00 USD) - 2016/01/26 16:08:08 CET [2016/01/26 10:08:08 ET]
Table 'Kale II' 9-max Seat #2 is the button
Seat 2: matiko09 ($100 in chips) 
Seat 3: Reven9er ($138.81 in chips) 
Seat 4: Jimy Tiltman ($194.57 in chips) 
Seat 5: Dante63s ($100 in chips) 
Seat 6: Filojoes ($122.80 in chips) 
Seat 7: Kukuryzka ($103.30 in chips) 
Seat 8: mycka86 ($101.50 in chips) 
Seat 9: Sweden_Pound ($125.28 in chips) 
Reven9er: posts small blind $0.50
Jimy Tiltman: posts big blind $1
*** HOLE CARDS ***
Dealt to matiko09 [9c 2h]
Dante63s: folds 
Filojoes: raises $2 to $3
Kukuryzka: folds 
mycka86: folds 
Sweden_Pound: folds 
matiko09: folds 
Reven9er: folds 
Jimy Tiltman: folds 
Uncalled bet ($2) returned to Filojoes
Filojoes collected $2.50 from pot
Filojoes: doesn't show hand 
*** SUMMARY ***
Total pot $2.50 | Rake $0 
Seat 2: matiko09 (button) folded before Flop (didn't bet)
Seat 3: Reven9er (small blind) folded before Flop
Seat 4: Jimy Tiltman (big blind) folded before Flop
Seat 5: Dante63s folded before Flop (didn't bet)
Seat 6: Filojoes collected ($2.50)
Seat 7: Kukuryzka folded before Flop (didn't bet)
Seat 8: mycka86 folded before Flop (didn't bet)
Seat 9: Sweden_Pound folded before Flop (didn't bet)





PokerStars Hand #147707956261:  Hold'em No Limit ($0.50/$1.00 USD) - 2016/01/26 16:08:10 CET [2016/01/26 10:08:10 ET]
Table 'Impala' 9-max Seat #6 is the button
Seat 1: mycka86 ($135.44 in chips) 
Seat 2: Filojoes ($100 in chips) 
Seat 3: Dante63s ($100.80 in chips) 
Seat 5: Kukuryzka ($100 in chips) 
Seat 6: Tijger R.d.J ($90.74 in chips) 
Seat 7: matiko09 ($135.74 in chips) 
Seat 8: apfush ($100 in chips) 
Seat 9: flozzi ($100 in chips) 
matiko09: posts small blind $0.50
apfush: posts big blind $1
Rikti: sits out 
*** HOLE CARDS ***
Dealt to matiko09 [3h Qc]
flozzi: folds 
mycka86: folds 
Filojoes: raises $2 to $3
Dante63s: folds 
Kukuryzka: folds 
Tijger R.d.J: folds 
matiko09: folds 
apfush: folds 
Uncalled bet ($2) returned to Filojoes
Filojoes collected $2.50 from pot
Filojoes: doesn't show hand 
*** SUMMARY ***
Total pot $2.50 | Rake $0 
Seat 1: mycka86 folded before Flop (didn't bet)
Seat 2: Filojoes collected ($2.50)
Seat 3: Dante63s folded before Flop (didn't bet)
Seat 5: Kukuryzka folded before Flop (didn't bet)
Seat 6: Tijger R.d.J (button) folded before Flop (didn't bet)
Seat 7: matiko09 (small blind) folded before Flop
Seat 8: apfush (big blind) folded before Flop
Seat 9: flozzi folded before Flop (didn't bet)





PokerStars Hand #147707957362:  Hold'em No Limit ($0.50/$1.00 USD) - 2016/01/26 16:08:11 CET [2016/01/26 10:08:11 ET]
Table 'Volga III' 9-max Seat #1 is the button
Seat 1: CI58 ($100 in chips) 
Seat 2: KLOP06031987 ($109.93 in chips) 
Seat 3: Kukuryzka ($101.50 in chips) 
Seat 4: mycka86 ($103.71 in chips) 
Seat 5: veno79 ($53.85 in chips) 
Seat 6: Sweden_Pound ($101.86 in chips) 
Seat 7: soplak ($108.95 in chips) 
Seat 8: cn_chayanne ($101 in chips) 
Seat 9: matiko09 ($102.54 in chips) 
KLOP06031987: posts small blind $0.50
Kukuryzka: posts big blind $1
*** HOLE CARDS ***
Dealt to matiko09 [9h 4c]
mycka86: folds 
veno79: calls $1
Sweden_Pound: raises $3 to $4
soplak: folds 
cn_chayanne: folds 
matiko09: folds 
CI58: folds 
KLOP06031987: folds 
Kukuryzka: folds 
veno79: calls $3
*** FLOP *** [3c Ad 3d]
veno79: checks 
Sweden_Pound: bets $5.90
veno79: folds 
Uncalled bet ($5.90) returned to Sweden_Pound
Sweden_Pound collected $9.07 from pot
Sweden_Pound: doesn't show hand 
*** SUMMARY ***
Total pot $9.50 | Rake $0.43 
Board [3c Ad 3d]
Seat 1: CI58 (button) folded before Flop (didn't bet)
Seat 2: KLOP06031987 (small blind) folded before Flop
Seat 3: Kukuryzka (big blind) folded before Flop
Seat 4: mycka86 folded before Flop (didn't bet)
Seat 5: veno79 folded on the Flop
Seat 6: Sweden_Pound collected ($9.07)
Seat 7: soplak folded before Flop (didn't bet)
Seat 8: cn_chayanne folded before Flop (didn't bet)
Seat 9: matiko09 folded before Flop (didn't bet)





PokerStars Hand #147707956811:  Hold'em No Limit ($0.50/$1.00 USD) - 2016/01/26 16:08:11 CET [2016/01/26 10:08:11 ET]
Table 'Achates III' 9-max Seat #9 is the button
Seat 2: matiko09 ($121.95 in chips) 
Seat 3: Jimy Tiltman ($100 in chips) 
Seat 4: cn_chayanne ($100 in chips) 
Seat 5: Sweden_Pound ($233.10 in chips) 
Seat 7: randi_0 ($53.22 in chips) 
Seat 9: T-chaos_IMBA ($362.87 in chips) 
matiko09: posts small blind $0.50
Jimy Tiltman: posts big blind $1
solbi86: sits out 
randi_0: posts big blind $1
easycomengo: sits out 
*** HOLE CARDS ***
Dealt to matiko09 [6c 8h]
cn_chayanne: folds 
Sweden_Pound: raises $3 to $4
randi_0: folds 
T-chaos_IMBA: raises $7 to $11
matiko09: folds 
Jimy Tiltman: folds 
Sweden_Pound: calls $7
*** FLOP *** [4d Kd As]
KLOP06031987 joins the table at seat #1 
Sweden_Pound: bets $14
T-chaos_IMBA: raises $16 to $30
Sweden_Pound: folds 
Uncalled bet ($16) returned to T-chaos_IMBA
T-chaos_IMBA collected $50.14 from pot
T-chaos_IMBA: doesn't show hand 
*** SUMMARY ***
Total pot $52.50 | Rake $2.36 
Board [4d Kd As]
Seat 2: matiko09 (small blind) folded before Flop
Seat 3: Jimy Tiltman (big blind) folded before Flop
Seat 4: cn_chayanne folded before Flop (didn't bet)
Seat 5: Sweden_Pound folded on the Flop
Seat 7: randi_0 folded before Flop
Seat 9: T-chaos_IMBA (button) collected ($50.14)





PokerStars Hand #147707964060:  Hold'em No Limit ($0.50/$1.00 USD) - 2016/01/26 16:08:20 CET [2016/01/26 10:08:20 ET]
Table 'Srbija III' 9-max Seat #5 is the button
Seat 1: Sweden_Pound ($100 in chips) 
Seat 2: cn_chayanne ($101.50 in chips) 
Seat 4: petalouda10 ($89.14 in chips) 
Seat 5: mycka86 ($100 in chips) 
Seat 6: matiko09 ($205.55 in chips) 
Seat 7: KLOP06031987 ($100 in chips) 
Seat 8: solbi86 ($101.16 in chips) 
Seat 9: soplak ($121.65 in chips) 
matiko09: posts small blind $0.50
KLOP06031987: posts big blind $1
LIGOPSIXIS78: sits out 
*** HOLE CARDS ***
Dealt to matiko09 [9d 3d]
solbi86: folds 
soplak: folds 
Sweden_Pound: folds 
cn_chayanne: folds 
petalouda10: raises $2 to $3
mycka86: folds 
matiko09: folds 
KLOP06031987: folds 
Uncalled bet ($2) returned to petalouda10
petalouda10 collected $2.50 from pot
petalouda10: doesn't show hand 
*** SUMMARY ***
Total pot $2.50 | Rake $0 
Seat 1: Sweden_Pound folded before Flop (didn't bet)
Seat 2: cn_chayanne folded before Flop (didn't bet)
Seat 4: petalouda10 collected ($2.50)
Seat 5: mycka86 (button) folded before Flop (didn't bet)
Seat 6: matiko09 (small blind) folded before Flop
Seat 7: KLOP06031987 (big blind) folded before Flop
Seat 8: solbi86 folded before Flop (didn't bet)
Seat 9: soplak folded before Flop (didn't bet)





PokerStars Hand #147707971549:  Hold'em No Limit ($0.50/$1.00 USD) - 2016/01/26 16:08:31 CET [2016/01/26 10:08:31 ET]
Table 'Strenua III' 9-max Seat #5 is the button
Seat 1: ICallSaul ($97.78 in chips) 
Seat 2: cn_chayanne ($123.29 in chips) 
Seat 3: petalouda10 ($72.83 in chips) 
Seat 4: mycka86 ($130.36 in chips) 
Seat 5: DeWeijz ($39.99 in chips) 
Seat 6: matiko09 ($132.34 in chips) 
Seat 7: KLOP06031987 ($100 in chips) 
Seat 8: Filojoes ($121.50 in chips) 
Seat 9: Dante63s ($101.50 in chips) 
matiko09: posts small blind $0.50
KLOP06031987: posts big blind $1
*** HOLE CARDS ***
Dealt to matiko09 [Th 4c]
Filojoes: raises $2 to $3
Dante63s: folds 
ICallSaul: folds 
cn_chayanne: folds 
petalouda10: folds 
mycka86: folds 
DeWeijz: folds 
matiko09: folds 
KLOP06031987: folds 
Uncalled bet ($2) returned to Filojoes
Filojoes collected $2.50 from pot
Filojoes: doesn't show hand 
*** SUMMARY ***
Total pot $2.50 | Rake $0 
Seat 1: ICallSaul folded before Flop (didn't bet)
Seat 2: cn_chayanne folded before Flop (didn't bet)
Seat 3: petalouda10 folded before Flop (didn't bet)
Seat 4: mycka86 folded before Flop (didn't bet)
Seat 5: DeWeijz (button) folded before Flop (didn't bet)
Seat 6: matiko09 (small blind) folded before Flop
Seat 7: KLOP06031987 (big blind) folded before Flop
Seat 8: Filojoes collected ($2.50)
Seat 9: Dante63s folded before Flop (didn't bet)





PokerStars Hand #147707975417:  Hold'em No Limit ($0.50/$1.00 USD) - 2016/01/26 16:08:36 CET [2016/01/26 10:08:36 ET]
Table 'Montefiore' 9-max Seat #6 is the button
Seat 1: Celsinho0311 ($61.40 in chips) 
Seat 2: Dante63s ($154.29 in chips) 
Seat 3: Filojoes ($101 in chips) 
Seat 4: matiko09 ($101.50 in chips) 
Seat 5: ilaviiitech ($103 in chips) 
Seat 6: FroggyPlay ($100 in chips) 
Seat 7: mycka86 ($100.50 in chips) 
Seat 8: Kukuryzka ($101.50 in chips) 
Seat 9: KLOP06031987 ($100 in chips) 
mycka86: posts small blind $0.50
Kukuryzka: posts big blind $1
*** HOLE CARDS ***
Dealt to matiko09 [9c Jd]
KLOP06031987: folds 
Celsinho0311: raises $2 to $3
Dante63s: folds 
Filojoes: folds 
matiko09: folds 
ilaviiitech: folds 
FroggyPlay: folds 
mycka86: folds 
Kukuryzka: folds 
Uncalled bet ($2) returned to Celsinho0311
Celsinho0311 collected $2.50 from pot
*** SUMMARY ***
Total pot $2.50 | Rake $0 
Seat 1: Celsinho0311 collected ($2.50)
Seat 2: Dante63s folded before Flop (didn't bet)
Seat 3: Filojoes folded before Flop (didn't bet)
Seat 4: matiko09 folded before Flop (didn't bet)
Seat 5: ilaviiitech folded before Flop (didn't bet)
Seat 6: FroggyPlay (button) folded before Flop (didn't bet)
Seat 7: mycka86 (small blind) folded before Flop
Seat 8: Kukuryzka (big blind) folded before Flop
Seat 9: KLOP06031987 folded before Flop (didn't bet)





PokerStars Hand #147707986631:  Hold'em No Limit ($0.50/$1.00 USD) - 2016/01/26 16:08:51 CET [2016/01/26 10:08:51 ET]
Table 'Srbija III' 9-max Seat #6 is the button
Seat 1: Sweden_Pound ($100 in chips) 
Seat 2: cn_chayanne ($101.50 in chips) 
Seat 4: petalouda10 ($90.64 in chips) 
Seat 5: mycka86 ($100 in chips) 
Seat 6: matiko09 ($205.05 in chips) 
Seat 7: KLOP06031987 ($100 in chips) 
Seat 8: solbi86 ($101.16 in chips) 
Seat 9: soplak ($121.65 in chips) 
KLOP06031987: posts small blind $0.50
solbi86: posts big blind $1
LIGOPSIXIS78: sits out 
*** HOLE CARDS ***
Dealt to matiko09 [Ah As]
soplak: folds 
Sweden_Pound: folds 
cn_chayanne: folds 
petalouda10: folds 
mycka86: raises $1.10 to $2.10
matiko09: raises $5.90 to $8
KLOP06031987: folds 
solbi86: folds 
mycka86: calls $5.90
*** FLOP *** [6c 3h 5s]
mycka86: checks 
matiko09: bets $8.68
mycka86: folds 
Uncalled bet ($8.68) returned to matiko09
matiko09 collected $16.71 from pot
matiko09: doesn't show hand 
*** SUMMARY ***
Total pot $17.50 | Rake $0.79 
Board [6c 3h 5s]
Seat 1: Sweden_Pound folded before Flop (didn't bet)
Seat 2: cn_chayanne folded before Flop (didn't bet)
Seat 4: petalouda10 folded before Flop (didn't bet)
Seat 5: mycka86 folded on the Flop
Seat 6: matiko09 (button) collected ($16.71)
Seat 7: KLOP06031987 (small blind) folded before Flop
Seat 8: solbi86 (big blind) folded before Flop
Seat 9: soplak folded before Flop (didn't bet)





PokerStars Hand #147708007142:  Hold'em No Limit ($0.50/$1.00 USD) - 2016/01/26 16:09:18 CET [2016/01/26 10:09:18 ET]
Table 'Aten II' 9-max Seat #5 is the button
Seat 1: cn_chayanne ($110.06 in chips) 
Seat 2: solbi86 ($134.20 in chips) 
Seat 3: ilaviiitech ($100 in chips) 
Seat 4: matiko09 ($100 in chips) 
Seat 5: sebaaastian ($100 in chips) 
Seat 6: ooohaaah ($82.25 in chips) 
Seat 7: Legioner721 ($33 in chips) 
Seat 9: TorontoBum ($113.11 in chips) 
ooohaaah: posts small blind $0.50
Legioner721: posts big blind $1
*** HOLE CARDS ***
Dealt to matiko09 [Kc Jh]
TorontoBum: folds 
cn_chayanne: folds 
solbi86: folds 
ilaviiitech: folds 
matiko09: raises $1.50 to $2.50
sebaaastian: folds 
ooohaaah: folds 
Legioner721: calls $1.50
*** FLOP *** [7c Kd Qc]
Legioner721: checks 
matiko09: bets $3.41
Legioner721: folds 
Uncalled bet ($3.41) returned to matiko09
matiko09 collected $5.25 from pot
matiko09: doesn't show hand 
*** SUMMARY ***
Total pot $5.50 | Rake $0.25 
Board [7c Kd Qc]
Seat 1: cn_chayanne folded before Flop (didn't bet)
Seat 2: solbi86 folded before Flop (didn't bet)
Seat 3: ilaviiitech folded before Flop (didn't bet)
Seat 4: matiko09 collected ($5.25)
Seat 5: sebaaastian (button) folded before Flop (didn't bet)
Seat 6: ooohaaah (small blind) folded before Flop
Seat 7: Legioner721 (big blind) folded on the Flop
Seat 9: TorontoBum folded before Flop (didn't bet)





PokerStars Hand #147708006464:  Hold'em No Limit ($0.50/$1.00 USD) - 2016/01/26 16:09:18 CET [2016/01/26 10:09:18 ET]
Table 'Impala' 9-max Seat #7 is the button
Seat 1: mycka86 ($135.44 in chips) 
Seat 2: Filojoes ($101.50 in chips) 
Seat 3: Dante63s ($100.80 in chips) 
Seat 5: Kukuryzka ($100 in chips) 
Seat 6: Tijger R.d.J ($90.74 in chips) 
Seat 7: matiko09 ($135.24 in chips) 
Seat 8: apfush ($100 in chips) 
Seat 9: flozzi ($100 in chips) 
apfush: posts small blind $0.50
flozzi: posts big blind $1
Rikti: sits out 
*** HOLE CARDS ***
Dealt to matiko09 [Qc Ac]
mycka86: folds 
Filojoes: folds 
Dante63s: folds 
Kukuryzka: folds 
Tijger R.d.J: folds 
matiko09: raises $1.27 to $2.27
apfush: folds 
flozzi: folds 
Uncalled bet ($1.27) returned to matiko09
matiko09 collected $2.50 from pot
matiko09: doesn't show hand 
*** SUMMARY ***
Total pot $2.50 | Rake $0 
Seat 1: mycka86 folded before Flop (didn't bet)
Seat 2: Filojoes folded before Flop (didn't bet)
Seat 3: Dante63s folded before Flop (didn't bet)
Seat 5: Kukuryzka folded before Flop (didn't bet)
Seat 6: Tijger R.d.J folded before Flop (didn't bet)
Seat 7: matiko09 (button) collected ($2.50)
Seat 8: apfush (small blind) folded before Flop
Seat 9: flozzi (big blind) folded before Flop





PokerStars Hand #147708007713:  Hold'em No Limit ($0.50/$1.00 USD) - 2016/01/26 16:09:19 CET [2016/01/26 10:09:19 ET]
Table 'Calypso II' 9-max Seat #6 is the button
Seat 2: Hardwell1993 ($90.76 in chips) 
Seat 3: matiko09 ($239.93 in chips) 
Seat 4: Sweden_Pound ($111.79 in chips) 
Seat 5: mycka86 ($115 in chips) 
Seat 6: MrDeeee25 ($109.70 in chips) 
Seat 7: Jimy Tiltman ($100 in chips) 
Seat 8: Reven9er ($113.83 in chips) 
Seat 9: Filojoes ($134.42 in chips) 
Jimy Tiltman: posts small blind $0.50
Reven9er: posts big blind $1
KLOP06031987: sits out 
*** HOLE CARDS ***
Dealt to matiko09 [Tc 6d]
Filojoes: folds 
Hardwell1993: folds 
matiko09: folds 
Sweden_Pound: folds 
mycka86: folds 
MrDeeee25: raises $2 to $3
Jimy Tiltman: folds 
Reven9er: calls $2
*** FLOP *** [Kd 8h 8c]
Reven9er: checks 
MrDeeee25: bets $3.10
Reven9er: folds 
Uncalled bet ($3.10) returned to MrDeeee25
MrDeeee25 collected $6.21 from pot
*** SUMMARY ***
Total pot $6.50 | Rake $0.29 
Board [Kd 8h 8c]
Seat 2: Hardwell1993 folded before Flop (didn't bet)
Seat 3: matiko09 folded before Flop (didn't bet)
Seat 4: Sweden_Pound folded before Flop (didn't bet)
Seat 5: mycka86 folded before Flop (didn't bet)
Seat 6: MrDeeee25 (button) collected ($6.21)
Seat 7: Jimy Tiltman (small blind) folded before Flop
Seat 8: Reven9er (big blind) folded on the Flop
Seat 9: Filojoes folded before Flop (didn't bet)





PokerStars Hand #147708008331:  Hold'em No Limit ($0.50/$1.00 USD) - 2016/01/26 16:09:20 CET [2016/01/26 10:09:20 ET]
Table 'Kale II' 9-max Seat #3 is the button
Seat 1: lootstool ($80.20 in chips) 
Seat 2: matiko09 ($100 in chips) 
Seat 3: Reven9er ($138.31 in chips) 
Seat 4: Jimy Tiltman ($193.57 in chips) 
Seat 8: mycka86 ($101.50 in chips) 
Seat 9: Sweden_Pound ($125.28 in chips) 
Jimy Tiltman: posts small blind $0.50
Dante63s: is sitting out 
Filojoes: is sitting out 
Kukuryzka: is sitting out 
Dante63s leaves the table
mycka86: posts big blind $1
Filojoes leaves the table
lootstool: posts small & big blinds $1.50
*** HOLE CARDS ***
Dealt to matiko09 [Kc 5c]
Sweden_Pound: folds 
Sweden_Pound leaves the table
lootstool: checks 
matiko09: raises $3 to $4
Reven9er: folds 
Jimy Tiltman: folds 
mycka86: raises $8.50 to $12.50
lootstool: folds 
KLOP06031987 joins the table at seat #9 
KLOP06031987 leaves the table
KLOP06031987 joins the table at seat #5 
matiko09: folds 
Uncalled bet ($8.50) returned to mycka86
lootstool leaves the table
solbi86 joins the table at seat #9 
Kukuryzka leaves the table
mycka86 collected $10 from pot
*** SUMMARY ***
Total pot $10 | Rake $0 
Seat 1: lootstool folded before Flop
Seat 2: matiko09 folded before Flop
Seat 3: Reven9er (button) folded before Flop (didn't bet)
Seat 4: Jimy Tiltman (small blind) folded before Flop
Seat 8: mycka86 (big blind) collected ($10)
Seat 9: Sweden_Pound folded before Flop (didn't bet)





PokerStars Hand #147708009145:  Hold'em No Limit ($0.50/$1.00 USD) - 2016/01/26 16:09:21 CET [2016/01/26 10:09:21 ET]
Table 'Achates III' 9-max Seat #2 is the button
Seat 2: matiko09 ($121.45 in chips) 
Seat 3: Jimy Tiltman ($100 in chips) 
Seat 4: cn_chayanne ($100 in chips) 
Seat 5: Sweden_Pound ($208.10 in chips) 
Seat 7: randi_0 ($52.22 in chips) 
Seat 9: T-chaos_IMBA ($388.01 in chips) 
Jimy Tiltman: posts small blind $0.50
cn_chayanne: posts big blind $1
solbi86: sits out 
easycomengo: sits out 
*** HOLE CARDS ***
Dealt to matiko09 [7c 4d]
Sweden_Pound: folds 
Sweden_Pound leaves the table
randi_0: folds 
T-chaos_IMBA: folds 
matiko09: folds 
Jimy Tiltman: folds 
Uncalled bet ($0.50) returned to cn_chayanne
cn_chayanne collected $1 from pot
cn_chayanne: doesn't show hand 
*** SUMMARY ***
Total pot $1 | Rake $0 
Seat 2: matiko09 (button) folded before Flop (didn't bet)
Seat 3: Jimy Tiltman (small blind) folded before Flop
Seat 4: cn_chayanne (big blind) collected ($1)
Seat 5: Sweden_Pound folded before Flop (didn't bet)
Seat 7: randi_0 folded before Flop (didn't bet)
Seat 9: T-chaos_IMBA folded before Flop (didn't bet)





PokerStars Hand #147708010224:  Hold'em No Limit ($0.50/$1.00 USD) - 2016/01/26 16:09:23 CET [2016/01/26 10:09:23 ET]
Table 'Strenua III' 9-max Seat #6 is the button
Seat 1: ICallSaul ($97.78 in chips) 
Seat 2: cn_chayanne ($123.29 in chips) 
Seat 3: petalouda10 ($72.83 in chips) 
Seat 4: mycka86 ($130.36 in chips) 
Seat 5: DeWeijz ($39.99 in chips) 
Seat 6: matiko09 ($131.84 in chips) 
Seat 7: KLOP06031987 ($100 in chips) 
Seat 8: Filojoes ($123 in chips) 
Seat 9: Dante63s ($101.50 in chips) 
KLOP06031987: posts small blind $0.50
Filojoes: posts big blind $1
*** HOLE CARDS ***
Dealt to matiko09 [Qd 6s]
Dante63s: folds 
ICallSaul: calls $1
cn_chayanne: raises $3 to $4
petalouda10: calls $4
mycka86: folds 
DeWeijz: folds 
matiko09: folds 
KLOP06031987: folds 
Filojoes: raises $12 to $16
ICallSaul: folds 
cn_chayanne: calls $12
petalouda10: calls $12
*** FLOP *** [Th Qh 8h]
Filojoes: checks 
cn_chayanne: checks 
petalouda10: checks 
*** TURN *** [Th Qh 8h] [Ad]
Filojoes: checks 
cn_chayanne: bets $35.45
petalouda10: folds 
Filojoes: folds 
Uncalled bet ($35.45) returned to cn_chayanne
cn_chayanne collected $47.27 from pot
cn_chayanne: doesn't show hand 
*** SUMMARY ***
Total pot $49.50 | Rake $2.23 
Board [Th Qh 8h Ad]
Seat 1: ICallSaul folded before Flop
Seat 2: cn_chayanne collected ($47.27)
Seat 3: petalouda10 folded on the Turn
Seat 4: mycka86 folded before Flop (didn't bet)
Seat 5: DeWeijz folded before Flop (didn't bet)
Seat 6: matiko09 (button) folded before Flop (didn't bet)
Seat 7: KLOP06031987 (small blind) folded before Flop
Seat 8: Filojoes (big blind) folded on the Turn
Seat 9: Dante63s folded before Flop (didn't bet)





PokerStars Hand #147708012537:  Hold'em No Limit ($0.50/$1.00 USD) - 2016/01/26 16:09:26 CET [2016/01/26 10:09:26 ET]
Table 'Mashona' 9-max Seat #5 is the button
Seat 1: maxxmeister ($124.28 in chips) 
Seat 2: werades ($200.84 in chips) 
Seat 3: matiko09 ($121.81 in chips) 
Seat 4: Sweden_Pound ($141.56 in chips) 
Seat 5: solbi86 ($133.63 in chips) 
Seat 6: Filojoes ($100 in chips) 
Seat 7: EB0LARAMA ($308.24 in chips) 
Seat 8: Jimy Tiltman ($178.16 in chips) 
Seat 9: apfush ($100 in chips) 
Filojoes: posts small blind $0.50
EB0LARAMA: posts big blind $1
*** HOLE CARDS ***
Dealt to matiko09 [9s Jd]
Jimy Tiltman: folds 
apfush: folds 
maxxmeister: raises $2.50 to $3.50
werades: folds 
matiko09: folds 
Sweden_Pound: folds 
solbi86: calls $3.50
Filojoes: folds 
EB0LARAMA: folds 
*** FLOP *** [5s 5d Qc]
maxxmeister: bets $6
solbi86: folds 
Uncalled bet ($6) returned to maxxmeister
maxxmeister collected $8.12 from pot
maxxmeister: doesn't show hand 
*** SUMMARY ***
Total pot $8.50 | Rake $0.38 
Board [5s 5d Qc]
Seat 1: maxxmeister collected ($8.12)
Seat 2: werades folded before Flop (didn't bet)
Seat 3: matiko09 folded before Flop (didn't bet)
Seat 4: Sweden_Pound folded before Flop (didn't bet)
Seat 5: solbi86 (button) folded on the Flop
Seat 6: Filojoes (small blind) folded before Flop
Seat 7: EB0LARAMA (big blind) folded before Flop
Seat 8: Jimy Tiltman folded before Flop (didn't bet)
Seat 9: apfush folded before Flop (didn't bet)





PokerStars Hand #147708021549:  Hold'em No Limit ($0.50/$1.00 USD) - 2016/01/26 16:09:38 CET [2016/01/26 10:09:38 ET]
Table 'Achates III' 9-max Seat #3 is the button
Seat 2: matiko09 ($121.45 in chips) 
Seat 3: Jimy Tiltman ($100 in chips) 
Seat 4: cn_chayanne ($100.50 in chips) 
Seat 6: solbi86 ($126.47 in chips) 
Seat 7: randi_0 ($52.22 in chips) 
Seat 9: T-chaos_IMBA ($388.01 in chips) 
cn_chayanne: posts small blind $0.50
solbi86: posts big blind $1
easycomengo: sits out 
*** HOLE CARDS ***
Dealt to matiko09 [Ts 5s]
randi_0: raises $2.50 to $3.50
T-chaos_IMBA: calls $3.50
matiko09: folds 
Jimy Tiltman: folds 
cn_chayanne: folds 
solbi86: folds 
*** FLOP *** [7c 3h 4d]
randi_0: bets $4.06
T-chaos_IMBA: calls $4.06
*** TURN *** [7c 3h 4d] [6d]
randi_0: bets $44.66 and is all-in
T-chaos_IMBA: calls $44.66
*** RIVER *** [7c 3h 4d 6d] [Td]
*** SHOW DOWN ***
randi_0: shows [Jd Jc] (a pair of Jacks)
T-chaos_IMBA: shows [6c 8c] (a pair of Sixes)
randi_0 collected $103.14 from pot
*** SUMMARY ***
Total pot $105.94 | Rake $2.80 
Board [7c 3h 4d 6d Td]
Seat 2: matiko09 folded before Flop (didn't bet)
Seat 3: Jimy Tiltman (button) folded before Flop (didn't bet)
Seat 4: cn_chayanne (small blind) folded before Flop
Seat 6: solbi86 (big blind) folded before Flop
Seat 7: randi_0 showed [Jd Jc] and won ($103.14) with a pair of Jacks
Seat 9: T-chaos_IMBA showed [6c 8c] and lost with a pair of Sixes





PokerStars Hand #147708024562:  Hold'em No Limit ($0.50/$1.00 USD) - 2016/01/26 16:09:42 CET [2016/01/26 10:09:42 ET]
Table 'Montefiore' 9-max Seat #7 is the button
Seat 1: Celsinho0311 ($62.90 in chips) 
Seat 2: Dante63s ($154.29 in chips) 
Seat 3: Filojoes ($101 in chips) 
Seat 4: matiko09 ($101.50 in chips) 
Seat 5: ilaviiitech ($103 in chips) 
Seat 6: FroggyPlay ($100 in chips) 
Seat 7: mycka86 ($100 in chips) 
Seat 8: Kukuryzka ($100.50 in chips) 
Seat 9: KLOP06031987 ($100 in chips) 
Kukuryzka: posts small blind $0.50
KLOP06031987: posts big blind $1
*** HOLE CARDS ***
Dealt to matiko09 [6c 3s]
Celsinho0311: folds 
Dante63s: folds 
Filojoes: folds 
matiko09: folds 
ilaviiitech: folds 
FroggyPlay: folds 
mycka86: raises $1.10 to $2.10
Kukuryzka: folds 
KLOP06031987: folds 
Uncalled bet ($1.10) returned to mycka86
mycka86 collected $2.50 from pot
*** SUMMARY ***
Total pot $2.50 | Rake $0 
Seat 1: Celsinho0311 folded before Flop (didn't bet)
Seat 2: Dante63s folded before Flop (didn't bet)
Seat 3: Filojoes folded before Flop (didn't bet)
Seat 4: matiko09 folded before Flop (didn't bet)
Seat 5: ilaviiitech folded before Flop (didn't bet)
Seat 6: FroggyPlay folded before Flop (didn't bet)
Seat 7: mycka86 (button) collected ($2.50)
Seat 8: Kukuryzka (small blind) folded before Flop
Seat 9: KLOP06031987 (big blind) folded before Flop





PokerStars Hand #147708029880:  Hold'em No Limit ($0.50/$1.00 USD) - 2016/01/26 16:09:49 CET [2016/01/26 10:09:49 ET]
Table 'Aten II' 9-max Seat #6 is the button
Seat 1: cn_chayanne ($110.06 in chips) 
Seat 2: solbi86 ($134.20 in chips) 
Seat 3: ilaviiitech ($100 in chips) 
Seat 4: matiko09 ($102.75 in chips) 
Seat 5: sebaaastian ($100 in chips) 
Seat 6: ooohaaah ($81.75 in chips) 
Seat 7: Legioner721 ($30.50 in chips) 
Seat 9: TorontoBum ($113.11 in chips) 
Legioner721: posts small blind $0.50
TorontoBum: posts big blind $1
*** HOLE CARDS ***
Dealt to matiko09 [Jh 9d]
cn_chayanne: folds 
solbi86: folds 
ilaviiitech: folds 
matiko09: folds 
sebaaastian: raises $1.50 to $2.50
ooohaaah: calls $2.50
Legioner721: folds 
TorontoBum: folds 
*** FLOP *** [7s Qd 8d]
sebaaastian: bets $3.10
ooohaaah: folds 
Uncalled bet ($3.10) returned to sebaaastian
sebaaastian collected $6.21 from pot
sebaaastian: doesn't show hand 
*** SUMMARY ***
Total pot $6.50 | Rake $0.29 
Board [7s Qd 8d]
Seat 1: cn_chayanne folded before Flop (didn't bet)
Seat 2: solbi86 folded before Flop (didn't bet)
Seat 3: ilaviiitech folded before Flop (didn't bet)
Seat 4: matiko09 folded before Flop (didn't bet)
Seat 5: sebaaastian collected ($6.21)
Seat 6: ooohaaah (button) folded on the Flop
Seat 7: Legioner721 (small blind) folded before Flop
Seat 9: TorontoBum (big blind) folded before Flop





PokerStars Hand #147708034216:  Hold'em No Limit ($0.50/$1.00 USD) - 2016/01/26 16:09:55 CET [2016/01/26 10:09:55 ET]
Table 'Srbija III' 9-max Seat #7 is the button
Seat 1: Sweden_Pound ($100 in chips) 
Seat 2: cn_chayanne ($101.50 in chips) 
Seat 4: petalouda10 ($90.64 in chips) 
Seat 5: mycka86 ($100 in chips) 
Seat 6: matiko09 ($213.76 in chips) 
Seat 7: KLOP06031987 ($100 in chips) 
Seat 8: solbi86 ($100.16 in chips) 
Seat 9: soplak ($121.65 in chips) 
solbi86: posts small blind $0.50
soplak: posts big blind $1
LIGOPSIXIS78: sits out 
*** HOLE CARDS ***
Dealt to matiko09 [Ks 4d]
Sweden_Pound: folds 
Sweden_Pound leaves the table
cn_chayanne: raises $1.50 to $2.50
petalouda10: folds 
mycka86: folds 
matiko09: folds 
KLOP06031987: folds 
solbi86: folds 
soplak: folds 
Uncalled bet ($1.50) returned to cn_chayanne
cn_chayanne collected $2.50 from pot
cn_chayanne: doesn't show hand 
*** SUMMARY ***
Total pot $2.50 | Rake $0 
Seat 1: Sweden_Pound folded before Flop (didn't bet)
Seat 2: cn_chayanne collected ($2.50)
Seat 4: petalouda10 folded before Flop (didn't bet)
Seat 5: mycka86 folded before Flop (didn't bet)
Seat 6: matiko09 folded before Flop (didn't bet)
Seat 7: KLOP06031987 (button) folded before Flop (didn't bet)
Seat 8: solbi86 (small blind) folded before Flop
Seat 9: soplak (big blind) folded before Flop





PokerStars Hand #147708041464:  Hold'em No Limit ($0.50/$1.00 USD) - 2016/01/26 16:10:05 CET [2016/01/26 10:10:05 ET]
Table 'Calypso II' 9-max Seat #7 is the button
Seat 2: Hardwell1993 ($90.76 in chips) 
Seat 3: matiko09 ($239.93 in chips) 
Seat 4: Sweden_Pound ($111.79 in chips) 
Seat 5: mycka86 ($115 in chips) 
Seat 6: MrDeeee25 ($112.91 in chips) 
Seat 7: Jimy Tiltman ($100 in chips) 
Seat 8: Reven9er ($110.83 in chips) 
Seat 9: Filojoes ($134.42 in chips) 
Reven9er: posts small blind $0.50
Filojoes: posts big blind $1
KLOP06031987: sits out 
*** HOLE CARDS ***
Dealt to matiko09 [9d 4d]
Hardwell1993: raises $1 to $2
matiko09: folds 
Sweden_Pound: folds 
mycka86: folds 
MrDeeee25: folds 
Jimy Tiltman: folds 
Reven9er: folds 
Filojoes: folds 
Uncalled bet ($1) returned to Hardwell1993
Hardwell1993 collected $2.50 from pot
*** SUMMARY ***
Total pot $2.50 | Rake $0 
Seat 2: Hardwell1993 collected ($2.50)
Seat 3: matiko09 folded before Flop (didn't bet)
Seat 4: Sweden_Pound folded before Flop (didn't bet)
Seat 5: mycka86 folded before Flop (didn't bet)
Seat 6: MrDeeee25 folded before Flop (didn't bet)
Seat 7: Jimy Tiltman (button) folded before Flop (didn't bet)
Seat 8: Reven9er (small blind) folded before Flop
Seat 9: Filojoes (big blind) folded before Flop





PokerStars Hand #147708043494:  Hold'em No Limit ($0.50/$1.00 USD) - 2016/01/26 16:10:07 CET [2016/01/26 10:10:07 ET]
Table 'Kale II' 9-max Seat #4 is the button
Seat 2: matiko09 ($100 in chips) 
Seat 3: Reven9er ($138.31 in chips) 
Seat 4: Jimy Tiltman ($193.07 in chips) 
Seat 8: mycka86 ($107.50 in chips) 
Seat 9: solbi86 ($197.27 in chips) 
mycka86: posts small blind $0.50
solbi86: posts big blind $1
*** HOLE CARDS ***
Dealt to matiko09 [Ts 5s]
matiko09: folds 
Reven9er: folds 
Jimy Tiltman: raises $1 to $2
mycka86: folds 
solbi86: folds 
Uncalled bet ($1) returned to Jimy Tiltman
Jimy Tiltman collected $2.50 from pot
Jimy Tiltman: doesn't show hand 
*** SUMMARY ***
Total pot $2.50 | Rake $0 
Seat 2: matiko09 folded before Flop (didn't bet)
Seat 3: Reven9er folded before Flop (didn't bet)
Seat 4: Jimy Tiltman (button) collected ($2.50)
Seat 8: mycka86 (small blind) folded before Flop
Seat 9: solbi86 (big blind) folded before Flop





PokerStars Hand #147708044260:  Hold'em No Limit ($0.50/$1.00 USD) - 2016/01/26 16:10:08 CET [2016/01/26 10:10:08 ET]
Table 'Volga III' 9-max Seat #2 is the button
Seat 1: CI58 ($100 in chips) 
Seat 2: KLOP06031987 ($109.43 in chips) 
Seat 3: Kukuryzka ($100.50 in chips) 
Seat 4: mycka86 ($103.71 in chips) 
Seat 5: veno79 ($49.85 in chips) 
Seat 6: Sweden_Pound ($106.93 in chips) 
Seat 7: soplak ($108.95 in chips) 
Seat 8: cn_chayanne ($101 in chips) 
Seat 9: matiko09 ($102.54 in chips) 
Kukuryzka: posts small blind $0.50
mycka86: posts big blind $1
*** HOLE CARDS ***
Dealt to matiko09 [7h 8h]
veno79: folds 
Sweden_Pound: folds 
soplak: folds 
cn_chayanne: folds 
matiko09: raises $2 to $3
CI58: folds 
KLOP06031987: folds 
Kukuryzka: folds 
mycka86: calls $2
*** FLOP *** [5c Ks 8s]
mycka86: checks 
matiko09: bets $4.04
mycka86: folds 
Uncalled bet ($4.04) returned to matiko09
matiko09 collected $6.21 from pot
matiko09: doesn't show hand 
*** SUMMARY ***
Total pot $6.50 | Rake $0.29 
Board [5c Ks 8s]
Seat 1: CI58 folded before Flop (didn't bet)
Seat 2: KLOP06031987 (button) folded before Flop (didn't bet)
Seat 3: Kukuryzka (small blind) folded before Flop
Seat 4: mycka86 (big blind) folded on the Flop
Seat 5: veno79 folded before Flop (didn't bet)
Seat 6: Sweden_Pound folded before Flop (didn't bet)
Seat 7: soplak folded before Flop (didn't bet)
Seat 8: cn_chayanne folded before Flop (didn't bet)
Seat 9: matiko09 collected ($6.21)





PokerStars Hand #147708048368:  Hold'em No Limit ($0.50/$1.00 USD) - 2016/01/26 16:10:14 CET [2016/01/26 10:10:14 ET]
Table 'Achates III' 9-max Seat #4 is the button
Seat 2: matiko09 ($121.45 in chips) 
Seat 3: Jimy Tiltman ($100 in chips) 
Seat 4: cn_chayanne ($100 in chips) 
Seat 6: solbi86 ($125.47 in chips) 
Seat 8: easycomengo ($100 in chips) 
Seat 9: T-chaos_IMBA ($335.79 in chips) 
solbi86: posts small blind $0.50
randi_0: is sitting out 
easycomengo: posts big blind $1
*** HOLE CARDS ***
Dealt to matiko09 [6d 2s]
simoniustin joins the table at seat #5 
T-chaos_IMBA said, "nh"
T-chaos_IMBA: folds 
matiko09: folds 
randi_0 leaves the table
Jimy Tiltman: folds 
cn_chayanne: raises $1.50 to $2.50
solbi86: folds 
easycomengo: folds 
Uncalled bet ($1.50) returned to cn_chayanne
cn_chayanne collected $2.50 from pot
cn_chayanne: doesn't show hand 
*** SUMMARY ***
Total pot $2.50 | Rake $0 
Seat 2: matiko09 folded before Flop (didn't bet)
Seat 3: Jimy Tiltman folded before Flop (didn't bet)
Seat 4: cn_chayanne (button) collected ($2.50)
Seat 6: solbi86 (small blind) folded before Flop
Seat 8: easycomengo (big blind) folded before Flop
Seat 9: T-chaos_IMBA folded before Flop (didn't bet)





PokerStars Hand #147708048663:  Hold'em No Limit ($0.50/$1.00 USD) - 2016/01/26 16:10:14 CET [2016/01/26 10:10:14 ET]
Table 'Medusa III' 9-max Seat #1 is the button
Seat 1: soplak ($100 in chips) 
Seat 2: happydrake ($84 in chips) 
Seat 3: mycka86 ($108 in chips) 
Seat 4: Sweden_Pound ($146.98 in chips) 
Seat 5: matiko09 ($244.08 in chips) 
Seat 6: Dante63s ($191.49 in chips) 
Seat 7: Reven9er ($182.46 in chips) 
Seat 8: Filojoes ($133.70 in chips) 
happydrake: posts small blind $0.50
mycka86: posts big blind $1
sebaaastian: sits out 
*** HOLE CARDS ***
Dealt to matiko09 [8h 7s]
Sweden_Pound: raises $2 to $3
matiko09: folds 
Dante63s: folds 
Reven9er: folds 
Filojoes: folds 
soplak: folds 
happydrake: folds 
soplak leaves the table
mycka86: folds 
Uncalled bet ($2) returned to Sweden_Pound
Sweden_Pound collected $2.50 from pot
Sweden_Pound: doesn't show hand 
*** SUMMARY ***
Total pot $2.50 | Rake $0 
Seat 1: soplak (button) folded before Flop (didn't bet)
Seat 2: happydrake (small blind) folded before Flop
Seat 3: mycka86 (big blind) folded before Flop
Seat 4: Sweden_Pound collected ($2.50)
Seat 5: matiko09 folded before Flop (didn't bet)
Seat 6: Dante63s folded before Flop (didn't bet)
Seat 7: Reven9er folded before Flop (didn't bet)
Seat 8: Filojoes folded before Flop (didn't bet)





PokerStars Hand #147708049700:  Hold'em No Limit ($0.50/$1.00 USD) - 2016/01/26 16:10:16 CET [2016/01/26 10:10:16 ET]
Table 'Vincentina' 9-max Seat #5 is the button
Seat 1: cn_chayanne ($100 in chips) 
Seat 2: simoniustin ($100 in chips) 
Seat 3: Mukhin1 ($100 in chips) 
Seat 4: Dödi123 ($100 in chips) 
Seat 5: solbi86 ($100 in chips) 
Seat 6: Sweden_Pound ($100 in chips) 
Seat 7: sebaaastian ($100 in chips) 
Seat 8: er13to ($100 in chips) 
Seat 9: matiko09 ($100 in chips) 
Sweden_Pound: posts small blind $0.50
sebaaastian: posts big blind $1
*** HOLE CARDS ***
Dealt to matiko09 [7c 7s]
er13to has timed out
er13to: folds 
matiko09: raises $2 to $3
cn_chayanne: folds 
simoniustin: folds 
Mukhin1: folds 
Dödi123: folds 
solbi86: folds 
Sweden_Pound: folds 
sebaaastian: folds 
Uncalled bet ($2) returned to matiko09
matiko09 collected $2.50 from pot
matiko09: doesn't show hand 
*** SUMMARY ***
Total pot $2.50 | Rake $0 
Seat 1: cn_chayanne folded before Flop (didn't bet)
Seat 2: simoniustin folded before Flop (didn't bet)
Seat 3: Mukhin1 folded before Flop (didn't bet)
Seat 4: Dödi123 folded before Flop (didn't bet)
Seat 5: solbi86 (button) folded before Flop (didn't bet)
Seat 6: Sweden_Pound (small blind) folded before Flop
Seat 7: sebaaastian (big blind) folded before Flop
Seat 8: er13to folded before Flop (didn't bet)
Seat 9: matiko09 collected ($2.50)





PokerStars Hand #147708050358:  Hold'em No Limit ($0.50/$1.00 USD) - 2016/01/26 16:10:17 CET [2016/01/26 10:10:17 ET]
Table 'Impala' 9-max Seat #8 is the button
Seat 1: mycka86 ($135.44 in chips) 
Seat 2: Filojoes ($101.50 in chips) 
Seat 3: Dante63s ($100.80 in chips) 
Seat 5: Kukuryzka ($100 in chips) 
Seat 6: Tijger R.d.J ($90.74 in chips) 
Seat 7: matiko09 ($136.74 in chips) 
Seat 8: apfush ($100 in chips) 
Seat 9: flozzi ($100 in chips) 
flozzi: posts small blind $0.50
mycka86: posts big blind $1
Rikti: sits out 
*** HOLE CARDS ***
Dealt to matiko09 [6d 6c]
Filojoes: raises $2 to $3
Dante63s: calls $3
Kukuryzka: folds 
Tijger R.d.J: folds 
matiko09: calls $3
apfush: folds 
flozzi: folds 
mycka86: raises $12 to $15
Filojoes: folds 
Dante63s: folds 
matiko09: folds 
Uncalled bet ($12) returned to mycka86
mycka86 collected $12.50 from pot
*** SUMMARY ***
Total pot $12.50 | Rake $0 
Seat 1: mycka86 (big blind) collected ($12.50)
Seat 2: Filojoes folded before Flop
Seat 3: Dante63s folded before Flop
Seat 5: Kukuryzka folded before Flop (didn't bet)
Seat 6: Tijger R.d.J folded before Flop (didn't bet)
Seat 7: matiko09 folded before Flop
Seat 8: apfush (button) folded before Flop (didn't bet)
Seat 9: flozzi (small blind) folded before Flop





PokerStars Hand #147708053590:  Hold'em No Limit ($0.50/$1.00 USD) - 2016/01/26 16:10:21 CET [2016/01/26 10:10:21 ET]
Table 'Kale II' 9-max Seat #8 is the button
Seat 2: matiko09 ($100 in chips) 
Seat 3: Reven9er ($138.31 in chips) 
Seat 4: Jimy Tiltman ($194.57 in chips) 
Seat 8: mycka86 ($107 in chips) 
Seat 9: solbi86 ($196.27 in chips) 
solbi86: posts small blind $0.50
matiko09: posts big blind $1
*** HOLE CARDS ***
Dealt to matiko09 [9d Tc]
Reven9er: folds 
simoniustin joins the table at seat #6 
MILLIONCHIC joins the table at seat #7 
Jimy Tiltman: folds 
mycka86: raises $1.10 to $2.10
solbi86: folds 
soplak joins the table at seat #1 
matiko09: calls $1.10
*** FLOP *** [Jd Ks Js]
matiko09: checks 
mycka86: checks 
*** TURN *** [Jd Ks Js] [3s]
matiko09: checks 
mycka86: bets $3.10
matiko09: folds 
Uncalled bet ($3.10) returned to mycka86
mycka86 collected $4.49 from pot
*** SUMMARY ***
Total pot $4.70 | Rake $0.21 
Board [Jd Ks Js 3s]
Seat 2: matiko09 (big blind) folded on the Turn
Seat 3: Reven9er folded before Flop (didn't bet)
Seat 4: Jimy Tiltman folded before Flop (didn't bet)
Seat 8: mycka86 (button) collected ($4.49)
Seat 9: solbi86 (small blind) folded before Flop





PokerStars Hand #147708054598:  Hold'em No Limit ($0.50/$1.00 USD) - 2016/01/26 16:10:22 CET [2016/01/26 10:10:22 ET]
Table 'Srbija III' 9-max Seat #8 is the button
Seat 2: cn_chayanne ($103 in chips) 
Seat 4: petalouda10 ($90.64 in chips) 
Seat 5: mycka86 ($100 in chips) 
Seat 6: matiko09 ($213.76 in chips) 
Seat 7: KLOP06031987 ($100 in chips) 
Seat 8: solbi86 ($100 in chips) 
Seat 9: soplak ($120.65 in chips) 
soplak: posts small blind $0.50
cn_chayanne: posts big blind $1
LIGOPSIXIS78: sits out 
*** HOLE CARDS ***
Dealt to matiko09 [9d 7h]
petalouda10: folds 
mycka86: folds 
matiko09: folds 
KLOP06031987: folds 
solbi86: raises $1 to $2
soplak: folds 
cn_chayanne: folds 
Uncalled bet ($1) returned to solbi86
solbi86 collected $2.50 from pot
solbi86: doesn't show hand 
*** SUMMARY ***
Total pot $2.50 | Rake $0 
Seat 2: cn_chayanne (big blind) folded before Flop
Seat 4: petalouda10 folded before Flop (didn't bet)
Seat 5: mycka86 folded before Flop (didn't bet)
Seat 6: matiko09 folded before Flop (didn't bet)
Seat 7: KLOP06031987 folded before Flop (didn't bet)
Seat 8: solbi86 (button) collected ($2.50)
Seat 9: soplak (small blind) folded before Flop





PokerStars Hand #147708056023:  Hold'em No Limit ($0.50/$1.00 USD) - 2016/01/26 16:10:24 CET [2016/01/26 10:10:24 ET]
Table 'Mashona' 9-max Seat #6 is the button
Seat 1: maxxmeister ($128.90 in chips) 
Seat 2: werades ($200.84 in chips) 
Seat 3: matiko09 ($121.81 in chips) 
Seat 4: Sweden_Pound ($141.56 in chips) 
Seat 5: solbi86 ($130.13 in chips) 
Seat 6: Filojoes ($100 in chips) 
Seat 7: EB0LARAMA ($307.24 in chips) 
Seat 8: Jimy Tiltman ($178.16 in chips) 
Seat 9: apfush ($100 in chips) 
EB0LARAMA: posts small blind $0.50
Jimy Tiltman: posts big blind $1
*** HOLE CARDS ***
Dealt to matiko09 [Qc 6s]
apfush: folds 
maxxmeister: folds 
werades: folds 
matiko09: folds 
Sweden_Pound: raises $2 to $3
solbi86: folds 
Filojoes: calls $3
EB0LARAMA: folds 
Jimy Tiltman: folds 
*** FLOP *** [6h 6d 9h]
Sweden_Pound: bets $4.65
Filojoes: folds 
Uncalled bet ($4.65) returned to Sweden_Pound
Sweden_Pound collected $7.16 from pot
Sweden_Pound: doesn't show hand 
*** SUMMARY ***
Total pot $7.50 | Rake $0.34 
Board [6h 6d 9h]
Seat 1: maxxmeister folded before Flop (didn't bet)
Seat 2: werades folded before Flop (didn't bet)
Seat 3: matiko09 folded before Flop (didn't bet)
Seat 4: Sweden_Pound collected ($7.16)
Seat 5: solbi86 folded before Flop (didn't bet)
Seat 6: Filojoes (button) folded on the Flop
Seat 7: EB0LARAMA (small blind) folded before Flop
Seat 8: Jimy Tiltman (big blind) folded before Flop
Seat 9: apfush folded before Flop (didn't bet)





PokerStars Hand #147708062534:  Hold'em No Limit ($0.50/$1.00 USD) - 2016/01/26 16:10:33 CET [2016/01/26 10:10:33 ET]
Table 'Montefiore' 9-max Seat #8 is the button
Seat 1: Celsinho0311 ($62.90 in chips) 
Seat 2: Dante63s ($154.29 in chips) 
Seat 3: Filojoes ($101 in chips) 
Seat 4: matiko09 ($101.50 in chips) 
Seat 5: ilaviiitech ($103 in chips) 
Seat 6: FroggyPlay ($100 in chips) 
Seat 7: mycka86 ($101.50 in chips) 
Seat 8: Kukuryzka ($100 in chips) 
Seat 9: KLOP06031987 ($100 in chips) 
KLOP06031987: posts small blind $0.50
Celsinho0311: posts big blind $1
*** HOLE CARDS ***
Dealt to matiko09 [3s 8c]
Dante63s: folds 
Filojoes: raises $2 to $3
matiko09: folds 
ilaviiitech: folds 
FroggyPlay: folds 
mycka86: folds 
Kukuryzka: folds 
KLOP06031987: folds 
Celsinho0311: calls $2
*** FLOP *** [3c Kd Jh]
Celsinho0311: checks 
Filojoes: bets $3.73
Celsinho0311: folds 
Uncalled bet ($3.73) returned to Filojoes
Filojoes collected $6.21 from pot
Filojoes: doesn't show hand 
*** SUMMARY ***
Total pot $6.50 | Rake $0.29 
Board [3c Kd Jh]
Seat 1: Celsinho0311 (big blind) folded on the Flop
Seat 2: Dante63s folded before Flop (didn't bet)
Seat 3: Filojoes collected ($6.21)
Seat 4: matiko09 folded before Flop (didn't bet)
Seat 5: ilaviiitech folded before Flop (didn't bet)
Seat 6: FroggyPlay folded before Flop (didn't bet)
Seat 7: mycka86 folded before Flop (didn't bet)
Seat 8: Kukuryzka (button) folded before Flop (didn't bet)
Seat 9: KLOP06031987 (small blind) folded before Flop





PokerStars Hand #147708063532:  Hold'em No Limit ($0.50/$1.00 USD) - 2016/01/26 16:10:34 CET [2016/01/26 10:10:34 ET]
Table 'Calypso II' 9-max Seat #8 is the button
Seat 1: KLOP06031987 ($100 in chips) 
Seat 2: Hardwell1993 ($92.26 in chips) 
Seat 3: matiko09 ($239.93 in chips) 
Seat 4: Sweden_Pound ($111.79 in chips) 
Seat 5: mycka86 ($115 in chips) 
Seat 6: MrDeeee25 ($112.91 in chips) 
Seat 7: Jimy Tiltman ($100 in chips) 
Seat 8: Reven9er ($110.33 in chips) 
Seat 9: Filojoes ($133.42 in chips) 
Filojoes: posts small blind $0.50
KLOP06031987: posts big blind $1
*** HOLE CARDS ***
Dealt to matiko09 [2s 2h]
Hardwell1993: raises $1 to $2
matiko09: folds 
Sweden_Pound: folds 
mycka86: folds 
MrDeeee25: folds 
Jimy Tiltman: folds 
Reven9er: calls $2
Filojoes: calls $1.50
KLOP06031987: calls $1
*** FLOP *** [Qh 9c 7h]
Filojoes: checks 
KLOP06031987: checks 
Hardwell1993: checks 
Reven9er: bets $5
Filojoes: raises $13 to $18
KLOP06031987: folds 
Hardwell1993: folds 
Reven9er: folds 
Uncalled bet ($13) returned to Filojoes
Filojoes collected $17.19 from pot
Filojoes: doesn't show hand 
*** SUMMARY ***
Total pot $18 | Rake $0.81 
Board [Qh 9c 7h]
Seat 1: KLOP06031987 (big blind) folded on the Flop
Seat 2: Hardwell1993 folded on the Flop
Seat 3: matiko09 folded before Flop (didn't bet)
Seat 4: Sweden_Pound folded before Flop (didn't bet)
Seat 5: mycka86 folded before Flop (didn't bet)
Seat 6: MrDeeee25 folded before Flop (didn't bet)
Seat 7: Jimy Tiltman folded before Flop (didn't bet)
Seat 8: Reven9er (button) folded on the Flop
Seat 9: Filojoes (small blind) collected ($17.19)





PokerStars Hand #147708067736:  Hold'em No Limit ($0.50/$1.00 USD) - 2016/01/26 16:10:40 CET [2016/01/26 10:10:40 ET]
Table 'Medusa III' 9-max Seat #2 is the button
Seat 2: happydrake ($83.50 in chips) 
Seat 3: mycka86 ($107 in chips) 
Seat 5: matiko09 ($244.08 in chips) 
Seat 6: Dante63s ($191.49 in chips) 
Seat 7: Reven9er ($182.46 in chips) 
Seat 8: Filojoes ($133.70 in chips) 
mycka86: posts small blind $0.50
Sweden_Pound: is sitting out 
matiko09: posts big blind $1
sebaaastian: sits out 
*** HOLE CARDS ***
Dealt to matiko09 [3s Qh]
Sweden_Pound leaves the table
KLOP06031987 joins the table at seat #1 
Dante63s: folds 
Reven9er: folds 
Filojoes: raises $1.50 to $2.50
happydrake: folds 
simoniustin joins the table at seat #4 
mycka86: folds 
matiko09: folds 
Uncalled bet ($1.50) returned to Filojoes
Filojoes collected $2.50 from pot
Filojoes: doesn't show hand 
*** SUMMARY ***
Total pot $2.50 | Rake $0 
Seat 2: happydrake (button) folded before Flop (didn't bet)
Seat 3: mycka86 (small blind) folded before Flop
Seat 5: matiko09 (big blind) folded before Flop
Seat 6: Dante63s folded before Flop (didn't bet)
Seat 7: Reven9er folded before Flop (didn't bet)
Seat 8: Filojoes collected ($2.50)





PokerStars Hand #147708069552:  Hold'em No Limit ($0.50/$1.00 USD) - 2016/01/26 16:10:42 CET [2016/01/26 10:10:42 ET]
Table 'Achates III' 9-max Seat #6 is the button
Seat 2: matiko09 ($121.45 in chips) 
Seat 3: Jimy Tiltman ($100 in chips) 
Seat 4: cn_chayanne ($101.50 in chips) 
Seat 6: solbi86 ($124.97 in chips) 
Seat 8: easycomengo ($99 in chips) 
Seat 9: T-chaos_IMBA ($335.79 in chips) 
easycomengo: posts small blind $0.50
T-chaos_IMBA: posts big blind $1
simoniustin: sits out 
*** HOLE CARDS ***
Dealt to matiko09 [2d Td]
matiko09: folds 
Jimy Tiltman: folds 
cn_chayanne: raises $1.50 to $2.50
solbi86: folds 
easycomengo: calls $2
T-chaos_IMBA: calls $1.50
*** FLOP *** [6s 4d 7d]
easycomengo: checks 
T-chaos_IMBA: checks 
soplak joins the table at seat #7 
cn_chayanne: checks 
*** TURN *** [6s 4d 7d] [Jh]
soplak leaves the table
easycomengo: bets $3
T-chaos_IMBA: calls $3
cn_chayanne: folds 
*** RIVER *** [6s 4d 7d Jh] [7h]
easycomengo: checks 
T-chaos_IMBA: bets $9.50
easycomengo: calls $9.50
*** SHOW DOWN ***
T-chaos_IMBA: shows [8c Th] (a pair of Sevens)
easycomengo: shows [Js Ks] (two pair, Jacks and Sevens)
easycomengo collected $31.04 from pot
*** SUMMARY ***
Total pot $32.50 | Rake $1.46 
Board [6s 4d 7d Jh 7h]
Seat 2: matiko09 folded before Flop (didn't bet)
Seat 3: Jimy Tiltman folded before Flop (didn't bet)
Seat 4: cn_chayanne folded on the Turn
Seat 6: solbi86 (button) folded before Flop (didn't bet)
Seat 8: easycomengo (small blind) showed [Js Ks] and won ($31.04) with two pair, Jacks and Sevens
Seat 9: T-chaos_IMBA (big blind) showed [8c Th] and lost with a pair of Sevens





PokerStars Hand #147708072471:  Hold'em No Limit ($0.50/$1.00 USD) - 2016/01/26 16:10:46 CET [2016/01/26 10:10:46 ET]
Table 'Srbija III' 9-max Seat #9 is the button
Seat 2: cn_chayanne ($102 in chips) 
Seat 3: LIGOPSIXIS78 ($60 in chips) 
Seat 4: petalouda10 ($90.64 in chips) 
Seat 5: mycka86 ($100 in chips) 
Seat 6: matiko09 ($213.76 in chips) 
Seat 7: KLOP06031987 ($100 in chips) 
Seat 8: solbi86 ($101.50 in chips) 
Seat 9: soplak ($120.15 in chips) 
cn_chayanne: posts small blind $0.50
LIGOPSIXIS78: posts big blind $1
*** HOLE CARDS ***
Dealt to matiko09 [3s Js]
petalouda10: raises $1 to $2
simoniustin joins the table at seat #1 
mycka86: folds 
matiko09: folds 
KLOP06031987: folds 
solbi86: folds 
soplak: folds 
cn_chayanne: folds 
LIGOPSIXIS78: calls $1
*** FLOP *** [5h Qh Ks]
LIGOPSIXIS78: checks 
petalouda10: bets $2.15
LIGOPSIXIS78: raises $4.30 to $6.45
petalouda10: calls $4.30
*** TURN *** [5h Qh Ks] [8h]
LIGOPSIXIS78: bets $8.31
petalouda10: folds 
Uncalled bet ($8.31) returned to LIGOPSIXIS78
LIGOPSIXIS78 collected $16.62 from pot
LIGOPSIXIS78: doesn't show hand 
*** SUMMARY ***
Total pot $17.40 | Rake $0.78 
Board [5h Qh Ks 8h]
Seat 2: cn_chayanne (small blind) folded before Flop
Seat 3: LIGOPSIXIS78 (big blind) collected ($16.62)
Seat 4: petalouda10 folded on the Turn
Seat 5: mycka86 folded before Flop (didn't bet)
Seat 6: matiko09 folded before Flop (didn't bet)
Seat 7: KLOP06031987 folded before Flop (didn't bet)
Seat 8: solbi86 folded before Flop (didn't bet)
Seat 9: soplak (button) folded before Flop (didn't bet)





PokerStars Hand #147708074108:  Hold'em No Limit ($0.50/$1.00 USD) - 2016/01/26 16:10:49 CET [2016/01/26 10:10:49 ET]
Table 'Aten II' 9-max Seat #7 is the button
Seat 1: cn_chayanne ($110.06 in chips) 
Seat 2: solbi86 ($134.20 in chips) 
Seat 3: ilaviiitech ($100 in chips) 
Seat 4: matiko09 ($102.75 in chips) 
Seat 5: sebaaastian ($103.71 in chips) 
Seat 6: ooohaaah ($79.25 in chips) 
Seat 7: Legioner721 ($30 in chips) 
Seat 9: TorontoBum ($112.11 in chips) 
TorontoBum: posts small blind $0.50
cn_chayanne: posts big blind $1
*** HOLE CARDS ***
Dealt to matiko09 [7s 6h]
solbi86: folds 
ilaviiitech: folds 
matiko09: folds 
sebaaastian: folds 
ooohaaah: folds 
Legioner721: calls $1
TorontoBum: folds 
cn_chayanne: checks 
*** FLOP *** [Kc 4s 4d]
cn_chayanne: checks 
Legioner721: checks 
*** TURN *** [Kc 4s 4d] [9s]
cn_chayanne: checks 
Legioner721: checks 
*** RIVER *** [Kc 4s 4d 9s] [3d]
cn_chayanne: checks 
Legioner721: checks 
*** SHOW DOWN ***
cn_chayanne: shows [3c Qs] (two pair, Fours and Threes)
Legioner721: mucks hand 
cn_chayanne collected $2.39 from pot
*** SUMMARY ***
Total pot $2.50 | Rake $0.11 
Board [Kc 4s 4d 9s 3d]
Seat 1: cn_chayanne (big blind) showed [3c Qs] and won ($2.39) with two pair, Fours and Threes
Seat 2: solbi86 folded before Flop (didn't bet)
Seat 3: ilaviiitech folded before Flop (didn't bet)
Seat 4: matiko09 folded before Flop (didn't bet)
Seat 5: sebaaastian folded before Flop (didn't bet)
Seat 6: ooohaaah folded before Flop (didn't bet)
Seat 7: Legioner721 (button) mucked [Th Qd]
Seat 9: TorontoBum (small blind) folded before Flop





PokerStars Hand #147708079085:  Hold'em No Limit ($0.50/$1.00 USD) - 2016/01/26 16:10:55 CET [2016/01/26 10:10:55 ET]
Table 'Volga III' 9-max Seat #3 is the button
Seat 1: CI58 ($100 in chips) 
Seat 2: KLOP06031987 ($109.43 in chips) 
Seat 3: Kukuryzka ($100 in chips) 
Seat 4: mycka86 ($100.71 in chips) 
Seat 5: veno79 ($49.85 in chips) 
Seat 6: Sweden_Pound ($106.93 in chips) 
Seat 7: soplak ($108.95 in chips) 
Seat 8: cn_chayanne ($101 in chips) 
Seat 9: matiko09 ($105.75 in chips) 
mycka86: posts small blind $0.50
veno79: posts big blind $1
*** HOLE CARDS ***
Dealt to matiko09 [3d 5c]
Sweden_Pound: folds 
Sweden_Pound leaves the table
soplak: folds 
Jimy Tiltman joins the table at seat #6 
cn_chayanne: folds 
matiko09: folds 
CI58: raises $2 to $3
KLOP06031987: raises $6 to $9
Kukuryzka: folds 
mycka86: folds 
veno79: folds 
CI58: calls $6
*** FLOP *** [Ac Ah 2s]
CI58: checks 
KLOP06031987: bets $9
CI58: calls $9
*** TURN *** [Ac Ah 2s] [4d]
CI58: checks 
KLOP06031987: checks 
*** RIVER *** [Ac Ah 2s 4d] [6h]
CI58: checks 
KLOP06031987: checks 
*** SHOW DOWN ***
CI58: shows [Th Ts] (two pair, Aces and Tens)
KLOP06031987: mucks hand 
CI58 collected $35.81 from pot
*** SUMMARY ***
Total pot $37.50 | Rake $1.69 
Board [Ac Ah 2s 4d 6h]
Seat 1: CI58 showed [Th Ts] and won ($35.81) with two pair, Aces and Tens
Seat 2: KLOP06031987 mucked [Kd Jd]
Seat 3: Kukuryzka (button) folded before Flop (didn't bet)
Seat 4: mycka86 (small blind) folded before Flop
Seat 5: veno79 (big blind) folded before Flop
Seat 6: Sweden_Pound folded before Flop (didn't bet)
Seat 7: soplak folded before Flop (didn't bet)
Seat 8: cn_chayanne folded before Flop (didn't bet)
Seat 9: matiko09 folded before Flop (didn't bet)





PokerStars Hand #147708079706:  Hold'em No Limit ($0.50/$1.00 USD) - 2016/01/26 16:10:56 CET [2016/01/26 10:10:56 ET]
Table 'Strenua III' 9-max Seat #7 is the button
Seat 1: ICallSaul ($96.78 in chips) 
Seat 2: cn_chayanne ($154.56 in chips) 
Seat 3: petalouda10 ($56.83 in chips) 
Seat 4: mycka86 ($130.36 in chips) 
Seat 5: DeWeijz ($39.99 in chips) 
Seat 6: matiko09 ($131.84 in chips) 
Seat 7: KLOP06031987 ($100 in chips) 
Seat 8: Filojoes ($107 in chips) 
Filojoes: posts small blind $0.50
Dante63s: is sitting out 
ICallSaul: posts big blind $1
*** HOLE CARDS ***
Dealt to matiko09 [Ts Kc]
Dante63s leaves the table
cn_chayanne: folds 
petalouda10: calls $1
mycka86: folds 
DeWeijz: folds 
matiko09: raises $3 to $4
KLOP06031987: calls $4
Filojoes: folds 
ICallSaul: calls $3
petalouda10: calls $3
*** FLOP *** [Jh 3d 2d]
ICallSaul: checks 
petalouda10: checks 
matiko09: checks 
KLOP06031987: bets $14.18
maxxmeister joins the table at seat #9 
ICallSaul: raises $22.06 to $36.24
petalouda10: folds 
matiko09: folds 
KLOP06031987: raises $59.76 to $96 and is all-in
ICallSaul: calls $56.54 and is all-in
Uncalled bet ($3.22) returned to KLOP06031987
*** TURN *** [Jh 3d 2d] [8d]
*** RIVER *** [Jh 3d 2d 8d] [3s]
*** SHOW DOWN ***
ICallSaul: shows [3c 3h] (four of a kind, Threes)
KLOP06031987: shows [Ad Ah] (two pair, Aces and Threes)
ICallSaul collected $199.26 from pot
*** SUMMARY ***
Total pot $202.06 | Rake $2.80 
Board [Jh 3d 2d 8d 3s]
Seat 1: ICallSaul (big blind) showed [3c 3h] and won ($199.26) with four of a kind, Threes
Seat 2: cn_chayanne folded before Flop (didn't bet)
Seat 3: petalouda10 folded on the Flop
Seat 4: mycka86 folded before Flop (didn't bet)
Seat 5: DeWeijz folded before Flop (didn't bet)
Seat 6: matiko09 folded on the Flop
Seat 7: KLOP06031987 (button) showed [Ad Ah] and lost with two pair, Aces and Threes
Seat 8: Filojoes (small blind) folded before Flop





PokerStars Hand #147708087863:  Hold'em No Limit ($0.50/$1.00 USD) - 2016/01/26 16:11:07 CET [2016/01/26 10:11:07 ET]
Table 'Kale II' 9-max Seat #9 is the button
Seat 2: matiko09 ($100 in chips) 
Seat 3: Reven9er ($138.31 in chips) 
Seat 4: Jimy Tiltman ($194.57 in chips) 
Seat 7: MILLIONCHIC ($80 in chips) 
Seat 8: mycka86 ($109.39 in chips) 
Seat 9: solbi86 ($195.77 in chips) 
soplak will be allowed to play after the button
matiko09: posts small blind $0.50
Reven9er: posts big blind $1
simoniustin: sits out 
MILLIONCHIC: posts big blind $1
*** HOLE CARDS ***
Dealt to matiko09 [6h Qc]
Jimy Tiltman: raises $3 to $4
MILLIONCHIC: calls $3
mycka86: calls $4
solbi86: folds 
matiko09: folds 
Reven9er: calls $3
*** FLOP *** [8c Kd Ks]
Reven9er: checks 
Jimy Tiltman: checks 
MILLIONCHIC: checks 
mycka86: bets $8.66
Reven9er: folds 
Jimy Tiltman: folds 
MILLIONCHIC: folds 
Uncalled bet ($8.66) returned to mycka86
mycka86 collected $15.76 from pot
*** SUMMARY ***
Total pot $16.50 | Rake $0.74 
Board [8c Kd Ks]
Seat 2: matiko09 (small blind) folded before Flop
Seat 3: Reven9er (big blind) folded on the Flop
Seat 4: Jimy Tiltman folded on the Flop
Seat 7: MILLIONCHIC folded on the Flop
Seat 8: mycka86 collected ($15.76)
Seat 9: solbi86 (button) folded before Flop (didn't bet)





PokerStars Hand #147708091638:  Hold'em No Limit ($0.50/$1.00 USD) - 2016/01/26 16:11:12 CET [2016/01/26 10:11:12 ET]
Table 'Mashona' 9-max Seat #7 is the button
Seat 1: maxxmeister ($128.90 in chips) 
Seat 2: werades ($200.84 in chips) 
Seat 3: matiko09 ($121.81 in chips) 
Seat 4: Sweden_Pound ($145.72 in chips) 
Seat 5: solbi86 ($130.13 in chips) 
Seat 6: Filojoes ($100 in chips) 
Seat 7: EB0LARAMA ($306.74 in chips) 
Seat 8: Jimy Tiltman ($177.16 in chips) 
Seat 9: apfush ($100 in chips) 
Jimy Tiltman: posts small blind $0.50
apfush: posts big blind $1
*** HOLE CARDS ***
Dealt to matiko09 [2c Jh]
maxxmeister: folds 
werades: folds 
matiko09: folds 
Sweden_Pound: folds 
solbi86: raises $2 to $3
Filojoes: folds 
EB0LARAMA: calls $3
Jimy Tiltman: folds 
apfush: calls $2
*** FLOP *** [Ts Jc 8s]
apfush: bets $6.50
solbi86: folds 
EB0LARAMA: folds 
Uncalled bet ($6.50) returned to apfush
apfush collected $9.07 from pot
apfush: doesn't show hand 
*** SUMMARY ***
Total pot $9.50 | Rake $0.43 
Board [Ts Jc 8s]
Seat 1: maxxmeister folded before Flop (didn't bet)
Seat 2: werades folded before Flop (didn't bet)
Seat 3: matiko09 folded before Flop (didn't bet)
Seat 4: Sweden_Pound folded before Flop (didn't bet)
Seat 5: solbi86 folded on the Flop
Seat 6: Filojoes folded before Flop (didn't bet)
Seat 7: EB0LARAMA (button) folded on the Flop
Seat 8: Jimy Tiltman (small blind) folded before Flop
Seat 9: apfush (big blind) collected ($9.07)





PokerStars Hand #147708093876:  Hold'em No Limit ($0.50/$1.00 USD) - 2016/01/26 16:11:15 CET [2016/01/26 10:11:15 ET]
Table 'Medusa III' 9-max Seat #3 is the button
Seat 2: happydrake ($83.50 in chips) 
Seat 3: mycka86 ($106.50 in chips) 
Seat 5: matiko09 ($243.08 in chips) 
Seat 7: Reven9er ($182.46 in chips) 
Seat 8: Filojoes ($135.20 in chips) 
simoniustin will be allowed to play after the button
matiko09: posts small blind $0.50
Dante63s: is sitting out 
Reven9er: posts big blind $1
sebaaastian: sits out 
*** HOLE CARDS ***
Dealt to matiko09 [7s 2s]
Dante63s leaves the table
Filojoes: folds 
happydrake: folds 
aseban11 joins the table at seat #6 
mycka86: raises $1.10 to $2.10
matiko09: folds 
Reven9er: folds 
Uncalled bet ($1.10) returned to mycka86
mycka86 collected $2.50 from pot
*** SUMMARY ***
Total pot $2.50 | Rake $0 
Seat 2: happydrake folded before Flop (didn't bet)
Seat 3: mycka86 (button) collected ($2.50)
Seat 5: matiko09 (small blind) folded before Flop
Seat 7: Reven9er (big blind) folded before Flop
Seat 8: Filojoes folded before Flop (didn't bet)





PokerStars Hand #147708105163:  Hold'em No Limit ($0.50/$1.00 USD) - 2016/01/26 16:11:31 CET [2016/01/26 10:11:31 ET]
Table 'Medusa III' 9-max Seat #5 is the button
Seat 2: happydrake ($83.50 in chips) 
Seat 3: mycka86 ($108 in chips) 
Seat 5: matiko09 ($242.58 in chips) 
Seat 7: Reven9er ($181.46 in chips) 
Seat 8: Filojoes ($135.20 in chips) 
Reven9er: posts small blind $0.50
Filojoes: posts big blind $1
sebaaastian: sits out 
simoniustin: sits out 
*** HOLE CARDS ***
Dealt to matiko09 [Jd 4h]
happydrake: folds 
mycka86: raises $1.10 to $2.10
matiko09: folds 
Reven9er: folds 
Filojoes: folds 
Uncalled bet ($1.10) returned to mycka86
mycka86 collected $2.50 from pot
*** SUMMARY ***
Total pot $2.50 | Rake $0 
Seat 2: happydrake folded before Flop (didn't bet)
Seat 3: mycka86 collected ($2.50)
Seat 5: matiko09 (button) folded before Flop (didn't bet)
Seat 7: Reven9er (small blind) folded before Flop
Seat 8: Filojoes (big blind) folded before Flop





PokerStars Hand #147708105344:  Hold'em No Limit ($0.50/$1.00 USD) - 2016/01/26 16:11:31 CET [2016/01/26 10:11:31 ET]
Table 'Impala' 9-max Seat #9 is the button
Seat 1: mycka86 ($144.94 in chips) 
Seat 2: Filojoes ($100 in chips) 
Seat 3: Dante63s ($100 in chips) 
Seat 5: Kukuryzka ($100 in chips) 
Seat 6: Tijger R.d.J ($90.74 in chips) 
Seat 7: matiko09 ($133.74 in chips) 
Seat 8: apfush ($100 in chips) 
Seat 9: flozzi ($100 in chips) 
mycka86: posts small blind $0.50
Filojoes: posts big blind $1
Rikti: sits out 
*** HOLE CARDS ***
Dealt to matiko09 [8d Kd]
Dante63s: folds 
Kukuryzka: folds 
Tijger R.d.J: folds 
matiko09: folds 
apfush: folds 
flozzi: folds 
mycka86: folds 
Uncalled bet ($0.50) returned to Filojoes
Filojoes collected $1 from pot
Filojoes: doesn't show hand 
*** SUMMARY ***
Total pot $1 | Rake $0 
Seat 1: mycka86 (small blind) folded before Flop
Seat 2: Filojoes (big blind) collected ($1)
Seat 3: Dante63s folded before Flop (didn't bet)
Seat 5: Kukuryzka folded before Flop (didn't bet)
Seat 6: Tijger R.d.J folded before Flop (didn't bet)
Seat 7: matiko09 folded before Flop (didn't bet)
Seat 8: apfush folded before Flop (didn't bet)
Seat 9: flozzi (button) folded before Flop (didn't bet)





PokerStars Hand #147708116860:  Hold'em No Limit ($0.50/$1.00 USD) - 2016/01/26 16:11:46 CET [2016/01/26 10:11:46 ET]
Table 'Montefiore' 9-max Seat #9 is the button
Seat 1: Celsinho0311 ($59.90 in chips) 
Seat 3: Filojoes ($104.21 in chips) 
Seat 4: matiko09 ($101.50 in chips) 
Seat 5: ilaviiitech ($103 in chips) 
Seat 6: FroggyPlay ($100 in chips) 
Seat 7: mycka86 ($101.50 in chips) 
Seat 8: Kukuryzka ($100 in chips) 
Seat 9: KLOP06031987 ($100 in chips) 
Celsinho0311: posts small blind $0.50
Dante63s: is sitting out 
Filojoes: posts big blind $1
*** HOLE CARDS ***
Dealt to matiko09 [5d Kd]
Dante63s leaves the table
matiko09: folds 
ilaviiitech: folds 
D†est7oye†R joins the table at seat #2 
FroggyPlay: folds 
mycka86: folds 
Kukuryzka: folds 
KLOP06031987: raises $1 to $2
Celsinho0311: raises $4 to $6
Filojoes: folds 
KLOP06031987: folds 
Uncalled bet ($4) returned to Celsinho0311
Celsinho0311 collected $5 from pot
*** SUMMARY ***
Total pot $5 | Rake $0 
Seat 1: Celsinho0311 (small blind) collected ($5)
Seat 3: Filojoes (big blind) folded before Flop
Seat 4: matiko09 folded before Flop (didn't bet)
Seat 5: ilaviiitech folded before Flop (didn't bet)
Seat 6: FroggyPlay folded before Flop (didn't bet)
Seat 7: mycka86 folded before Flop (didn't bet)
Seat 8: Kukuryzka folded before Flop (didn't bet)
Seat 9: KLOP06031987 (button) folded before Flop





PokerStars Hand #147708116963:  Hold'em No Limit ($0.50/$1.00 USD) - 2016/01/26 16:11:47 CET [2016/01/26 10:11:47 ET]
Table 'Achates III' 9-max Seat #8 is the button
Seat 2: matiko09 ($121.45 in chips) 
Seat 3: Jimy Tiltman ($100 in chips) 
Seat 4: cn_chayanne ($100 in chips) 
Seat 6: solbi86 ($124.97 in chips) 
Seat 8: easycomengo ($115.04 in chips) 
Seat 9: T-chaos_IMBA ($320.79 in chips) 
T-chaos_IMBA: posts small blind $0.50
matiko09: posts big blind $1
simoniustin: sits out 
*** HOLE CARDS ***
Dealt to matiko09 [Qh Qc]
Jimy Tiltman: folds 
cn_chayanne: folds 
solbi86: raises $1.50 to $2.50
easycomengo: folds 
T-chaos_IMBA: folds 
matiko09: raises $6.50 to $9
solbi86: calls $6.50
*** FLOP *** [Jd 4c 4s]
matiko09: bets $9.18
solbi86: folds 
Uncalled bet ($9.18) returned to matiko09
matiko09 collected $17.67 from pot
matiko09: doesn't show hand 
1989freak joins the table at seat #7 
*** SUMMARY ***
Total pot $18.50 | Rake $0.83 
Board [Jd 4c 4s]
Seat 2: matiko09 (big blind) collected ($17.67)
Seat 3: Jimy Tiltman folded before Flop (didn't bet)
Seat 4: cn_chayanne folded before Flop (didn't bet)
Seat 6: solbi86 folded on the Flop
Seat 8: easycomengo (button) folded before Flop (didn't bet)
Seat 9: T-chaos_IMBA (small blind) folded before Flop





PokerStars Hand #147708117350:  Hold'em No Limit ($0.50/$1.00 USD) - 2016/01/26 16:11:47 CET [2016/01/26 10:11:47 ET]
Table 'Aten II' 9-max Seat #9 is the button
Seat 1: cn_chayanne ($111.45 in chips) 
Seat 2: solbi86 ($134.20 in chips) 
Seat 3: ilaviiitech ($100 in chips) 
Seat 4: matiko09 ($102.75 in chips) 
Seat 5: sebaaastian ($103.71 in chips) 
Seat 6: ooohaaah ($79.25 in chips) 
Seat 7: Legioner721 ($29 in chips) 
Seat 9: TorontoBum ($111.61 in chips) 
cn_chayanne: posts small blind $0.50
solbi86: posts big blind $1
*** HOLE CARDS ***
Dealt to matiko09 [Th 2h]
ilaviiitech: folds 
matiko09: folds 
sebaaastian: folds 
ooohaaah: folds 
Legioner721: calls $1
TorontoBum: folds 
cn_chayanne: folds 
solbi86: checks 
*** FLOP *** [9d 5c 3d]
solbi86: checks 
Legioner721: bets $1
solbi86: folds 
Uncalled bet ($1) returned to Legioner721
Legioner721 collected $2.39 from pot
Legioner721: doesn't show hand 
*** SUMMARY ***
Total pot $2.50 | Rake $0.11 
Board [9d 5c 3d]
Seat 1: cn_chayanne (small blind) folded before Flop
Seat 2: solbi86 (big blind) folded on the Flop
Seat 3: ilaviiitech folded before Flop (didn't bet)
Seat 4: matiko09 folded before Flop (didn't bet)
Seat 5: sebaaastian folded before Flop (didn't bet)
Seat 6: ooohaaah folded before Flop (didn't bet)
Seat 7: Legioner721 collected ($2.39)
Seat 9: TorontoBum (button) folded before Flop (didn't bet)





PokerStars Hand #147708122845:  Hold'em No Limit ($0.50/$1.00 USD) - 2016/01/26 16:11:54 CET [2016/01/26 10:11:54 ET]
Table 'Srbija III' 9-max Seat #2 is the button
Seat 2: cn_chayanne ($101.50 in chips) 
Seat 3: LIGOPSIXIS78 ($68.17 in chips) 
Seat 4: petalouda10 ($82.19 in chips) 
Seat 5: mycka86 ($100 in chips) 
Seat 6: matiko09 ($213.76 in chips) 
Seat 7: KLOP06031987 ($100 in chips) 
Seat 8: solbi86 ($101.50 in chips) 
Seat 9: soplak ($120.15 in chips) 
LIGOPSIXIS78: posts small blind $0.50
petalouda10: posts big blind $1
simoniustin: sits out 
*** HOLE CARDS ***
Dealt to matiko09 [Kd Qc]
mycka86: folds 
matiko09: raises $2 to $3
KLOP06031987: folds 
solbi86: folds 
soplak: folds 
cn_chayanne: folds 
LIGOPSIXIS78: folds 
petalouda10: folds 
Uncalled bet ($2) returned to matiko09
matiko09 collected $2.50 from pot
matiko09: doesn't show hand 
*** SUMMARY ***
Total pot $2.50 | Rake $0 
Seat 2: cn_chayanne (button) folded before Flop (didn't bet)
Seat 3: LIGOPSIXIS78 (small blind) folded before Flop
Seat 4: petalouda10 (big blind) folded before Flop
Seat 5: mycka86 folded before Flop (didn't bet)
Seat 6: matiko09 collected ($2.50)
Seat 7: KLOP06031987 folded before Flop (didn't bet)
Seat 8: solbi86 folded before Flop (didn't bet)
Seat 9: soplak folded before Flop (didn't bet)





PokerStars Hand #147708129787:  Hold'em No Limit ($0.50/$1.00 USD) - 2016/01/26 16:12:04 CET [2016/01/26 10:12:04 ET]
Table 'Medusa III' 9-max Seat #7 is the button
Seat 2: happydrake ($83.50 in chips) 
Seat 3: mycka86 ($109.50 in chips) 
Seat 5: matiko09 ($242.58 in chips) 
Seat 7: Reven9er ($180.96 in chips) 
Seat 8: Filojoes ($134.20 in chips) 
Seat 9: sebaaastian ($100 in chips) 
Filojoes: posts small blind $0.50
sebaaastian: posts big blind $1
simoniustin: sits out 
*** HOLE CARDS ***
Dealt to matiko09 [6d Ad]
happydrake: folds 
mycka86: folds 
matiko09: raises $1.50 to $2.50
Reven9er: folds 
Filojoes: folds 
sebaaastian: folds 
Uncalled bet ($1.50) returned to matiko09
matiko09 collected $2.50 from pot
matiko09: doesn't show hand 
*** SUMMARY ***
Total pot $2.50 | Rake $0 
Seat 2: happydrake folded before Flop (didn't bet)
Seat 3: mycka86 folded before Flop (didn't bet)
Seat 5: matiko09 collected ($2.50)
Seat 7: Reven9er (button) folded before Flop (didn't bet)
Seat 8: Filojoes (small blind) folded before Flop
Seat 9: sebaaastian (big blind) folded before Flop





PokerStars Hand #147708130009:  Hold'em No Limit ($0.50/$1.00 USD) - 2016/01/26 16:12:04 CET [2016/01/26 10:12:04 ET]
Table 'Vincentina' 9-max Seat #6 is the button
Seat 1: cn_chayanne ($100 in chips) 
Seat 2: simoniustin ($100 in chips) 
Seat 3: Mukhin1 ($100 in chips) 
Seat 4: Dödi123 ($100 in chips) 
Seat 5: solbi86 ($100 in chips) 
Seat 6: Sweden_Pound ($100 in chips) 
Seat 7: sebaaastian ($100 in chips) 
Seat 9: matiko09 ($101.50 in chips) 
sebaaastian: posts small blind $0.50
matiko09: posts big blind $1
*** HOLE CARDS ***
Dealt to matiko09 [7s 2d]
cn_chayanne: folds 
simoniustin: folds 
Mukhin1: folds 
Dödi123: folds 
solbi86: raises $1.50 to $2.50
Sweden_Pound: folds 
sebaaastian: folds 
matiko09: folds 
Uncalled bet ($1.50) returned to solbi86
solbi86 collected $2.50 from pot
solbi86: doesn't show hand 
*** SUMMARY ***
Total pot $2.50 | Rake $0 
Seat 1: cn_chayanne folded before Flop (didn't bet)
Seat 2: simoniustin folded before Flop (didn't bet)
Seat 3: Mukhin1 folded before Flop (didn't bet)
Seat 4: Dödi123 folded before Flop (didn't bet)
Seat 5: solbi86 collected ($2.50)
Seat 6: Sweden_Pound (button) folded before Flop (didn't bet)
Seat 7: sebaaastian (small blind) folded before Flop
Seat 9: matiko09 (big blind) folded before Flop





PokerStars Hand #147708130700:  Hold'em No Limit ($0.50/$1.00 USD) - 2016/01/26 16:12:05 CET [2016/01/26 10:12:05 ET]
Table 'Kale II' 9-max Seat #2 is the button
Seat 2: matiko09 ($100 in chips) 
Seat 3: Reven9er ($134.31 in chips) 
Seat 4: Jimy Tiltman ($190.57 in chips) 
Seat 7: MILLIONCHIC ($76 in chips) 
Seat 8: mycka86 ($121.15 in chips) 
Seat 9: solbi86 ($195.77 in chips) 
Reven9er: posts small blind $0.50
Jimy Tiltman: posts big blind $1
simoniustin: sits out 
soplak: sits out 
*** HOLE CARDS ***
Dealt to matiko09 [9c Kc]
MILLIONCHIC: raises $2 to $3
mycka86: folds 
solbi86: folds 
matiko09: folds 
Reven9er: folds 
Jimy Tiltman: folds 
Uncalled bet ($2) returned to MILLIONCHIC
MILLIONCHIC collected $2.50 from pot
MILLIONCHIC: doesn't show hand 
*** SUMMARY ***
Total pot $2.50 | Rake $0 
Seat 2: matiko09 (button) folded before Flop (didn't bet)
Seat 3: Reven9er (small blind) folded before Flop
Seat 4: Jimy Tiltman (big blind) folded before Flop
Seat 7: MILLIONCHIC collected ($2.50)
Seat 8: mycka86 folded before Flop (didn't bet)
Seat 9: solbi86 folded before Flop (didn't bet)





PokerStars Hand #147708131627:  Hold'em No Limit ($0.50/$1.00 USD) - 2016/01/26 16:12:06 CET [2016/01/26 10:12:06 ET]
Table 'Impala' 9-max Seat #1 is the button
Seat 1: mycka86 ($144.44 in chips) 
Seat 2: Filojoes ($100.50 in chips) 
Seat 4: Rikti ($93.76 in chips) 
Seat 5: Kukuryzka ($100 in chips) 
Seat 6: Tijger R.d.J ($90.74 in chips) 
Seat 7: matiko09 ($133.74 in chips) 
Seat 8: apfush ($100 in chips) 
Seat 9: flozzi ($100 in chips) 
Filojoes: posts small blind $0.50
Dante63s: is sitting out 
Rikti: posts big blind $1
*** HOLE CARDS ***
Dealt to matiko09 [9c 2c]
Dante63s leaves the table
Kukuryzka: folds 
Tijger R.d.J: folds 
matiko09: folds 
simoniustin joins the table at seat #3 
apfush: folds 
flozzi: folds 
mycka86: raises $1.10 to $2.10
Filojoes: folds 
Rikti: folds 
Uncalled bet ($1.10) returned to mycka86
mycka86 collected $2.50 from pot
*** SUMMARY ***
Total pot $2.50 | Rake $0 
Seat 1: mycka86 (button) collected ($2.50)
Seat 2: Filojoes (small blind) folded before Flop
Seat 4: Rikti (big blind) folded before Flop
Seat 5: Kukuryzka folded before Flop (didn't bet)
Seat 6: Tijger R.d.J folded before Flop (didn't bet)
Seat 7: matiko09 folded before Flop (didn't bet)
Seat 8: apfush folded before Flop (didn't bet)
Seat 9: flozzi folded before Flop (didn't bet)





PokerStars Hand #147708132406:  Hold'em No Limit ($0.50/$1.00 USD) - 2016/01/26 16:12:07 CET [2016/01/26 10:12:07 ET]
Table 'Strenua III' 9-max Seat #8 is the button
Seat 1: ICallSaul ($199.26 in chips) 
Seat 2: cn_chayanne ($154.56 in chips) 
Seat 3: petalouda10 ($52.83 in chips) 
Seat 4: mycka86 ($130.36 in chips) 
Seat 5: DeWeijz ($39.99 in chips) 
Seat 6: matiko09 ($127.84 in chips) 
Seat 7: KLOP06031987 ($100 in chips) 
Seat 8: Filojoes ($106.50 in chips) 
maxxmeister will be allowed to play after the button
ICallSaul: posts small blind $0.50
cn_chayanne: posts big blind $1
*** HOLE CARDS ***
Dealt to matiko09 [2h Ks]
petalouda10: folds 
mycka86: folds 
DeWeijz: folds 
matiko09: folds 
KLOP06031987: raises $1.31 to $2.31
Filojoes: calls $2.31
ICallSaul: folds 
cn_chayanne: calls $1.31
*** FLOP *** [As Ah Kc]
cn_chayanne: checks 
KLOP06031987: bets $5
Filojoes: folds 
cn_chayanne: folds 
Uncalled bet ($5) returned to KLOP06031987
KLOP06031987 collected $7.10 from pot
KLOP06031987: doesn't show hand 
*** SUMMARY ***
Total pot $7.43 | Rake $0.33 
Board [As Ah Kc]
Seat 1: ICallSaul (small blind) folded before Flop
Seat 2: cn_chayanne (big blind) folded on the Flop
Seat 3: petalouda10 folded before Flop (didn't bet)
Seat 4: mycka86 folded before Flop (didn't bet)
Seat 5: DeWeijz folded before Flop (didn't bet)
Seat 6: matiko09 folded before Flop (didn't bet)
Seat 7: KLOP06031987 collected ($7.10)
Seat 8: Filojoes (button) folded on the Flop





PokerStars Hand #147708138118:  Hold'em No Limit ($0.50/$1.00 USD) - 2016/01/26 16:12:15 CET [2016/01/26 10:12:15 ET]
Table 'Calypso II' 9-max Seat #9 is the button
Seat 1: KLOP06031987 ($100 in chips) 
Seat 2: Hardwell1993 ($90.26 in chips) 
Seat 3: matiko09 ($239.93 in chips) 
Seat 4: Sweden_Pound ($111.79 in chips) 
Seat 5: mycka86 ($115 in chips) 
Seat 6: MrDeeee25 ($112.91 in chips) 
Seat 7: Jimy Tiltman ($100 in chips) 
Seat 8: Reven9er ($103.33 in chips) 
Seat 9: Filojoes ($143.61 in chips) 
KLOP06031987: posts small blind $0.50
Hardwell1993: posts big blind $1
*** HOLE CARDS ***
Dealt to matiko09 [Td 2s]
matiko09: folds 
Sweden_Pound: folds 
mycka86: folds 
MrDeeee25: folds 
Jimy Tiltman: folds 
Reven9er: raises $1 to $2
Filojoes: folds 
KLOP06031987: folds 
Hardwell1993: calls $1
*** FLOP *** [Kd 4d 4c]
Hardwell1993: checks 
Reven9er: checks 
*** TURN *** [Kd 4d 4c] [4s]
Hardwell1993: bets $3
Reven9er: calls $3
*** RIVER *** [Kd 4d 4c 4s] [6s]
Hardwell1993: bets $5
Reven9er: calls $5
*** SHOW DOWN ***
Hardwell1993: shows [Kc Th] (a full house, Fours full of Kings)
Reven9er: mucks hand 
Hardwell1993 collected $19.58 from pot
*** SUMMARY ***
Total pot $20.50 | Rake $0.92 
Board [Kd 4d 4c 4s 6s]
Seat 1: KLOP06031987 (small blind) folded before Flop
Seat 2: Hardwell1993 (big blind) showed [Kc Th] and won ($19.58) with a full house, Fours full of Kings
Seat 3: matiko09 folded before Flop (didn't bet)
Seat 4: Sweden_Pound folded before Flop (didn't bet)
Seat 5: mycka86 folded before Flop (didn't bet)
Seat 6: MrDeeee25 folded before Flop (didn't bet)
Seat 7: Jimy Tiltman folded before Flop (didn't bet)
Seat 8: Reven9er mucked [8h 8s]
Seat 9: Filojoes (button) folded before Flop (didn't bet)





PokerStars Hand #147708141756:  Hold'em No Limit ($0.50/$1.00 USD) - 2016/01/26 16:12:19 CET [2016/01/26 10:12:19 ET]
Table 'Mashona' 9-max Seat #8 is the button
Seat 1: maxxmeister ($128.90 in chips) 
Seat 2: werades ($200.84 in chips) 
Seat 3: matiko09 ($121.81 in chips) 
Seat 4: Sweden_Pound ($145.72 in chips) 
Seat 5: solbi86 ($127.13 in chips) 
Seat 6: Filojoes ($100 in chips) 
Seat 7: EB0LARAMA ($303.74 in chips) 
Seat 8: Jimy Tiltman ($176.66 in chips) 
Seat 9: apfush ($106.07 in chips) 
apfush: posts small blind $0.50
maxxmeister: posts big blind $1
*** HOLE CARDS ***
Dealt to matiko09 [Kd 9s]
werades: raises $2.01 to $3.01
matiko09: folds 
Sweden_Pound: folds 
solbi86: folds 
Filojoes: folds 
EB0LARAMA: folds 
Jimy Tiltman: raises $5.99 to $9
apfush: folds 
maxxmeister: folds 
werades: calls $5.99
*** FLOP *** [5h Qh Ah]
werades: checks 
Jimy Tiltman: bets $6
werades: raises $6 to $12
Jimy Tiltman: calls $6
*** TURN *** [5h Qh Ah] [5s]
werades: checks 
Jimy Tiltman: checks 
*** RIVER *** [5h Qh Ah 5s] [Qc]
werades: bets $14
Jimy Tiltman: folds 
Uncalled bet ($14) returned to werades
werades collected $41.54 from pot
werades: doesn't show hand 
*** SUMMARY ***
Total pot $43.50 | Rake $1.96 
Board [5h Qh Ah 5s Qc]
Seat 1: maxxmeister (big blind) folded before Flop
Seat 2: werades collected ($41.54)
Seat 3: matiko09 folded before Flop (didn't bet)
Seat 4: Sweden_Pound folded before Flop (didn't bet)
Seat 5: solbi86 folded before Flop (didn't bet)
Seat 6: Filojoes folded before Flop (didn't bet)
Seat 7: EB0LARAMA folded before Flop (didn't bet)
Seat 8: Jimy Tiltman (button) folded on the River
Seat 9: apfush (small blind) folded before Flop





PokerStars Hand #147708142005:  Hold'em No Limit ($0.50/$1.00 USD) - 2016/01/26 16:12:20 CET [2016/01/26 10:12:20 ET]
Table 'Srbija III' 9-max Seat #3 is the button
Seat 2: cn_chayanne ($101.50 in chips) 
Seat 3: LIGOPSIXIS78 ($67.67 in chips) 
Seat 4: petalouda10 ($81.19 in chips) 
Seat 5: mycka86 ($100 in chips) 
Seat 6: matiko09 ($215.26 in chips) 
Seat 7: KLOP06031987 ($100 in chips) 
Seat 8: solbi86 ($101.50 in chips) 
Seat 9: soplak ($120.15 in chips) 
petalouda10: posts small blind $0.50
mycka86: posts big blind $1
simoniustin: sits out 
*** HOLE CARDS ***
Dealt to matiko09 [Ts 8d]
matiko09: folds 
KLOP06031987: folds 
solbi86: folds 
soplak: folds 
cn_chayanne: raises $1.50 to $2.50
LIGOPSIXIS78: folds 
petalouda10: folds 
mycka86: folds 
Uncalled bet ($1.50) returned to cn_chayanne
cn_chayanne collected $2.50 from pot
cn_chayanne: doesn't show hand 
*** SUMMARY ***
Total pot $2.50 | Rake $0 
Seat 2: cn_chayanne collected ($2.50)
Seat 3: LIGOPSIXIS78 (button) folded before Flop (didn't bet)
Seat 4: petalouda10 (small blind) folded before Flop
Seat 5: mycka86 (big blind) folded before Flop
Seat 6: matiko09 folded before Flop (didn't bet)
Seat 7: KLOP06031987 folded before Flop (didn't bet)
Seat 8: solbi86 folded before Flop (didn't bet)
Seat 9: soplak folded before Flop (didn't bet)





PokerStars Hand #147708143906:  Hold'em No Limit ($0.50/$1.00 USD) - 2016/01/26 16:12:22 CET [2016/01/26 10:12:22 ET]
Table 'Kale II' 9-max Seat #3 is the button
Seat 2: matiko09 ($100 in chips) 
Seat 3: Reven9er ($133.81 in chips) 
Seat 4: Jimy Tiltman ($189.57 in chips) 
Seat 6: simoniustin ($100 in chips) 
Seat 7: MILLIONCHIC ($77.50 in chips) 
Seat 8: mycka86 ($121.15 in chips) 
Seat 9: solbi86 ($195.77 in chips) 
Jimy Tiltman: posts small blind $0.50
simoniustin: posts big blind $1
soplak: sits out 
*** HOLE CARDS ***
Dealt to matiko09 [3h Ah]
MILLIONCHIC: calls $1
mycka86: folds 
solbi86: folds 
matiko09: raises $3 to $4
Reven9er: folds 
Jimy Tiltman: folds 
simoniustin: folds 
MILLIONCHIC: calls $3
*** FLOP *** [2c Tc 2d]
MILLIONCHIC: checks 
matiko09: checks 
*** TURN *** [2c Tc 2d] [Qh]
MILLIONCHIC: checks 
matiko09: bets $2.81
MILLIONCHIC: calls $2.81
*** RIVER *** [2c Tc 2d Qh] [3d]
MILLIONCHIC: checks 
matiko09: checks 
*** SHOW DOWN ***
MILLIONCHIC: shows [6c 9c] (a pair of Deuces)
matiko09: shows [3h Ah] (two pair, Threes and Deuces)
matiko09 collected $14.44 from pot
*** SUMMARY ***
Total pot $15.12 | Rake $0.68 
Board [2c Tc 2d Qh 3d]
Seat 2: matiko09 showed [3h Ah] and won ($14.44) with two pair, Threes and Deuces
Seat 3: Reven9er (button) folded before Flop (didn't bet)
Seat 4: Jimy Tiltman (small blind) folded before Flop
Seat 6: simoniustin (big blind) folded before Flop
Seat 7: MILLIONCHIC showed [6c 9c] and lost with a pair of Deuces
Seat 8: mycka86 folded before Flop (didn't bet)
Seat 9: solbi86 folded before Flop (didn't bet)





PokerStars Hand #147708145485:  Hold'em No Limit ($0.50/$1.00 USD) - 2016/01/26 16:12:24 CET [2016/01/26 10:12:24 ET]
Table 'Aten II' 9-max Seat #1 is the button
Seat 1: cn_chayanne ($110.95 in chips) 
Seat 2: solbi86 ($133.20 in chips) 
Seat 3: ilaviiitech ($100 in chips) 
Seat 4: matiko09 ($102.75 in chips) 
Seat 5: sebaaastian ($103.71 in chips) 
Seat 6: ooohaaah ($79.25 in chips) 
Seat 7: Legioner721 ($30.39 in chips) 
Seat 9: TorontoBum ($111.61 in chips) 
solbi86: posts small blind $0.50
ilaviiitech: posts big blind $1
*** HOLE CARDS ***
Dealt to matiko09 [3h Ad]
matiko09: folds 
sebaaastian: folds 
ooohaaah: folds 
Legioner721: folds 
TorontoBum: raises $2 to $3
cn_chayanne: folds 
solbi86: calls $2.50
ilaviiitech: folds 
*** FLOP *** [4s Qc Th]
solbi86: checks 
TorontoBum: bets $5.01
solbi86: calls $5.01
*** TURN *** [4s Qc Th] [5d]
solbi86: checks 
TorontoBum: bets $12.18
solbi86: folds 
Uncalled bet ($12.18) returned to TorontoBum
TorontoBum collected $16.25 from pot
TorontoBum: doesn't show hand 
*** SUMMARY ***
Total pot $17.02 | Rake $0.77 
Board [4s Qc Th 5d]
Seat 1: cn_chayanne (button) folded before Flop (didn't bet)
Seat 2: solbi86 (small blind) folded on the Turn
Seat 3: ilaviiitech (big blind) folded before Flop
Seat 4: matiko09 folded before Flop (didn't bet)
Seat 5: sebaaastian folded before Flop (didn't bet)
Seat 6: ooohaaah folded before Flop (didn't bet)
Seat 7: Legioner721 folded before Flop (didn't bet)
Seat 9: TorontoBum collected ($16.25)





PokerStars Hand #147708146751:  Hold'em No Limit ($0.50/$1.00 USD) - 2016/01/26 16:12:26 CET [2016/01/26 10:12:26 ET]
Table 'Achates III' 9-max Seat #9 is the button
Seat 2: matiko09 ($130.12 in chips) 
Seat 3: Jimy Tiltman ($100 in chips) 
Seat 4: cn_chayanne ($100 in chips) 
Seat 6: solbi86 ($115.97 in chips) 
Seat 8: easycomengo ($115.04 in chips) 
Seat 9: T-chaos_IMBA ($320.29 in chips) 
matiko09: posts small blind $0.50
Jimy Tiltman: posts big blind $1
simoniustin: sits out 
1989freak: sits out 
*** HOLE CARDS ***
Dealt to matiko09 [Jh 7h]
cn_chayanne: folds 
solbi86: folds 
easycomengo: folds 
T-chaos_IMBA: raises $3 to $4
matiko09: folds 
Jimy Tiltman: folds 
Uncalled bet ($3) returned to T-chaos_IMBA
T-chaos_IMBA collected $2.50 from pot
T-chaos_IMBA: doesn't show hand 
*** SUMMARY ***
Total pot $2.50 | Rake $0 
Seat 2: matiko09 (small blind) folded before Flop
Seat 3: Jimy Tiltman (big blind) folded before Flop
Seat 4: cn_chayanne folded before Flop (didn't bet)
Seat 6: solbi86 folded before Flop (didn't bet)
Seat 8: easycomengo folded before Flop (didn't bet)
Seat 9: T-chaos_IMBA (button) collected ($2.50)





PokerStars Hand #147708151618:  Hold'em No Limit ($0.50/$1.00 USD) - 2016/01/26 16:12:33 CET [2016/01/26 10:12:33 ET]
Table 'Vincentina' 9-max Seat #7 is the button
Seat 1: cn_chayanne ($100 in chips) 
Seat 2: simoniustin ($100 in chips) 
Seat 3: Mukhin1 ($100 in chips) 
Seat 4: Dödi123 ($100 in chips) 
Seat 5: solbi86 ($101.50 in chips) 
Seat 6: Sweden_Pound ($100 in chips) 
Seat 7: sebaaastian ($100 in chips) 
Seat 9: matiko09 ($100.50 in chips) 
matiko09: posts small blind $0.50
cn_chayanne: posts big blind $1
*** HOLE CARDS ***
Dealt to matiko09 [6h 8h]
simoniustin: folds 
Mukhin1: folds 
Dödi123: folds 
solbi86: folds 
Sweden_Pound: folds 
sebaaastian: raises $2 to $3
matiko09: folds 
cn_chayanne: calls $2
*** FLOP *** [9c 5h 2s]
cn_chayanne: checks 
sebaaastian: bets $3.10
cn_chayanne: calls $3.10
*** TURN *** [9c 5h 2s] [6d]
cn_chayanne: checks 
sebaaastian: checks 
*** RIVER *** [9c 5h 2s 6d] [Ah]
cn_chayanne: checks 
sebaaastian: bets $7
cn_chayanne: folds 
Uncalled bet ($7) returned to sebaaastian
sebaaastian collected $12.13 from pot
sebaaastian: doesn't show hand 
*** SUMMARY ***
Total pot $12.70 | Rake $0.57 
Board [9c 5h 2s 6d Ah]
Seat 1: cn_chayanne (big blind) folded on the River
Seat 2: simoniustin folded before Flop (didn't bet)
Seat 3: Mukhin1 folded before Flop (didn't bet)
Seat 4: Dödi123 folded before Flop (didn't bet)
Seat 5: solbi86 folded before Flop (didn't bet)
Seat 6: Sweden_Pound folded before Flop (didn't bet)
Seat 7: sebaaastian (button) collected ($12.13)
Seat 9: matiko09 (small blind) folded before Flop





PokerStars Hand #147708154685:  Hold'em No Limit ($0.50/$1.00 USD) - 2016/01/26 16:12:37 CET [2016/01/26 10:12:37 ET]
Table 'Volga III' 9-max Seat #4 is the button
Seat 1: CI58 ($117.81 in chips) 
Seat 2: KLOP06031987 ($100 in chips) 
Seat 3: Kukuryzka ($100 in chips) 
Seat 4: mycka86 ($100.21 in chips) 
Seat 5: veno79 ($48.85 in chips) 
Seat 6: Jimy Tiltman ($100 in chips) 
Seat 7: soplak ($108.95 in chips) 
Seat 8: cn_chayanne ($101 in chips) 
Seat 9: matiko09 ($105.75 in chips) 
veno79: posts small blind $0.50
Jimy Tiltman: posts big blind $1
*** HOLE CARDS ***
Dealt to matiko09 [Js 3s]
soplak: folds 
cn_chayanne: folds 
matiko09: folds 
CI58: folds 
KLOP06031987: folds 
Kukuryzka: folds 
mycka86: raises $1.10 to $2.10
veno79: calls $1.60
Jimy Tiltman: calls $1.10
*** FLOP *** [7s Jc 3d]
veno79: checks 
Jimy Tiltman: checks 
mycka86: bets $4
veno79: folds 
Jimy Tiltman: folds 
Uncalled bet ($4) returned to mycka86
mycka86 collected $6.02 from pot
*** SUMMARY ***
Total pot $6.30 | Rake $0.28 
Board [7s Jc 3d]
Seat 1: CI58 folded before Flop (didn't bet)
Seat 2: KLOP06031987 folded before Flop (didn't bet)
Seat 3: Kukuryzka folded before Flop (didn't bet)
Seat 4: mycka86 (button) collected ($6.02)
Seat 5: veno79 (small blind) folded on the Flop
Seat 6: Jimy Tiltman (big blind) folded on the Flop
Seat 7: soplak folded before Flop (didn't bet)
Seat 8: cn_chayanne folded before Flop (didn't bet)
Seat 9: matiko09 folded before Flop (didn't bet)





PokerStars Hand #147708155966:  Hold'em No Limit ($0.50/$1.00 USD) - 2016/01/26 16:12:38 CET [2016/01/26 10:12:38 ET]
Table 'Medusa III' 9-max Seat #8 is the button
Seat 2: happydrake ($83.50 in chips) 
Seat 3: mycka86 ($109.50 in chips) 
Seat 5: matiko09 ($244.08 in chips) 
Seat 7: Reven9er ($180.96 in chips) 
Seat 8: Filojoes ($133.70 in chips) 
Seat 9: sebaaastian ($100 in chips) 
sebaaastian: posts small blind $0.50
happydrake: posts big blind $1
simoniustin: sits out 
*** HOLE CARDS ***
Dealt to matiko09 [Ad 3h]
mycka86: folds 
matiko09: folds 
Reven9er: folds 
Filojoes: folds 
sebaaastian: folds 
Uncalled bet ($0.50) returned to happydrake
happydrake collected $1 from pot
happydrake: doesn't show hand 
*** SUMMARY ***
Total pot $1 | Rake $0 
Seat 2: happydrake (big blind) collected ($1)
Seat 3: mycka86 folded before Flop (didn't bet)
Seat 5: matiko09 folded before Flop (didn't bet)
Seat 7: Reven9er folded before Flop (didn't bet)
Seat 8: Filojoes (button) folded before Flop (didn't bet)
Seat 9: sebaaastian (small blind) folded before Flop





PokerStars Hand #147708158766:  Hold'em No Limit ($0.50/$1.00 USD) - 2016/01/26 16:12:42 CET [2016/01/26 10:12:42 ET]
Table 'Achates III' 9-max Seat #2 is the button
Seat 2: matiko09 ($129.62 in chips) 
Seat 3: Jimy Tiltman ($100 in chips) 
Seat 4: cn_chayanne ($100 in chips) 
Seat 6: solbi86 ($115.97 in chips) 
Seat 8: easycomengo ($115.04 in chips) 
Seat 9: T-chaos_IMBA ($321.79 in chips) 
Jimy Tiltman: posts small blind $0.50
cn_chayanne: posts big blind $1
simoniustin: sits out 
1989freak: sits out 
*** HOLE CARDS ***
Dealt to matiko09 [Jc 6c]
solbi86: folds 
easycomengo: folds 
T-chaos_IMBA: folds 
matiko09: raises $1.27 to $2.27
Jimy Tiltman: raises $6.23 to $8.50
cn_chayanne: folds 
matiko09: folds 
Uncalled bet ($6.23) returned to Jimy Tiltman
Jimy Tiltman collected $5.54 from pot
Jimy Tiltman: doesn't show hand 
*** SUMMARY ***
Total pot $5.54 | Rake $0 
Seat 2: matiko09 (button) folded before Flop
Seat 3: Jimy Tiltman (small blind) collected ($5.54)
Seat 4: cn_chayanne (big blind) folded before Flop
Seat 6: solbi86 folded before Flop (didn't bet)
Seat 8: easycomengo folded before Flop (didn't bet)
Seat 9: T-chaos_IMBA folded before Flop (didn't bet)





PokerStars Hand #147708159400:  Hold'em No Limit ($0.50/$1.00 USD) - 2016/01/26 16:12:43 CET [2016/01/26 10:12:43 ET]
Table 'Montefiore' 9-max Seat #1 is the button
Seat 1: Celsinho0311 ($62.90 in chips) 
Seat 3: Filojoes ($103.21 in chips) 
Seat 4: matiko09 ($101.50 in chips) 
Seat 5: ilaviiitech ($103 in chips) 
Seat 6: FroggyPlay ($100 in chips) 
Seat 7: mycka86 ($101.50 in chips) 
Seat 8: Kukuryzka ($100 in chips) 
Seat 9: KLOP06031987 ($100 in chips) 
D†est7oye†R will be allowed to play after the button
Filojoes: posts small blind $0.50
matiko09: posts big blind $1
*** HOLE CARDS ***
Dealt to matiko09 [Jc 6h]
ilaviiitech: folds 
FroggyPlay: raises $2 to $3
mycka86: folds 
Kukuryzka: folds 
KLOP06031987: folds 
Celsinho0311: calls $3
Filojoes: folds 
matiko09: folds 
*** FLOP *** [Qc Kh 8c]
FroggyPlay: bets $7.08
Celsinho0311: folds 
Uncalled bet ($7.08) returned to FroggyPlay
FroggyPlay collected $7.16 from pot
FroggyPlay: doesn't show hand 
*** SUMMARY ***
Total pot $7.50 | Rake $0.34 
Board [Qc Kh 8c]
Seat 1: Celsinho0311 (button) folded on the Flop
Seat 3: Filojoes (small blind) folded before Flop
Seat 4: matiko09 (big blind) folded before Flop
Seat 5: ilaviiitech folded before Flop (didn't bet)
Seat 6: FroggyPlay collected ($7.16)
Seat 7: mycka86 folded before Flop (didn't bet)
Seat 8: Kukuryzka folded before Flop (didn't bet)
Seat 9: KLOP06031987 folded before Flop (didn't bet)





PokerStars Hand #147708162019:  Hold'em No Limit ($0.50/$1.00 USD) - 2016/01/26 16:12:46 CET [2016/01/26 10:12:46 ET]
Table 'Srbija III' 9-max Seat #4 is the button
Seat 2: cn_chayanne ($103 in chips) 
Seat 3: LIGOPSIXIS78 ($67.67 in chips) 
Seat 4: petalouda10 ($80.69 in chips) 
Seat 5: mycka86 ($100 in chips) 
Seat 6: matiko09 ($215.26 in chips) 
Seat 7: KLOP06031987 ($100 in chips) 
Seat 8: solbi86 ($101.50 in chips) 
Seat 9: soplak ($120.15 in chips) 
mycka86: posts small blind $0.50
matiko09: posts big blind $1
simoniustin: sits out 
*** HOLE CARDS ***
Dealt to matiko09 [Ah 9h]
KLOP06031987: folds 
solbi86: folds 
soplak: raises $2 to $3
cn_chayanne: folds 
LIGOPSIXIS78: folds 
petalouda10: folds 
mycka86: folds 
matiko09: folds 
Uncalled bet ($2) returned to soplak
soplak collected $2.50 from pot
*** SUMMARY ***
Total pot $2.50 | Rake $0 
Seat 2: cn_chayanne folded before Flop (didn't bet)
Seat 3: LIGOPSIXIS78 folded before Flop (didn't bet)
Seat 4: petalouda10 (button) folded before Flop (didn't bet)
Seat 5: mycka86 (small blind) folded before Flop
Seat 6: matiko09 (big blind) folded before Flop
Seat 7: KLOP06031987 folded before Flop (didn't bet)
Seat 8: solbi86 folded before Flop (didn't bet)
Seat 9: soplak collected ($2.50)





PokerStars Hand #147708170834:  Hold'em No Limit ($0.50/$1.00 USD) - 2016/01/26 16:12:58 CET [2016/01/26 10:12:58 ET]
Table 'Impala' 9-max Seat #2 is the button
Seat 1: mycka86 ($145.94 in chips) 
Seat 2: Filojoes ($100 in chips) 
Seat 4: Rikti ($92.76 in chips) 
Seat 5: Kukuryzka ($100 in chips) 
Seat 6: Tijger R.d.J ($90.74 in chips) 
Seat 7: matiko09 ($133.74 in chips) 
Seat 8: apfush ($100 in chips) 
Seat 9: flozzi ($100 in chips) 
simoniustin will be allowed to play after the button
Rikti: posts small blind $0.50
Kukuryzka: posts big blind $1
*** HOLE CARDS ***
Dealt to matiko09 [Jh Qd]
Tijger R.d.J: raises $1 to $2
matiko09: folds 
apfush: folds 
flozzi: calls $2
mycka86: folds 
Filojoes: folds 
Rikti: folds 
Kukuryzka: folds 
*** FLOP *** [2d 8s 9h]
Tijger R.d.J: bets $2
flozzi: calls $2
*** TURN *** [2d 8s 9h] [Js]
Tijger R.d.J: checks 
flozzi: bets $6.53
Tijger R.d.J: folds 
Uncalled bet ($6.53) returned to flozzi
flozzi collected $9.07 from pot
flozzi: doesn't show hand 
*** SUMMARY ***
Total pot $9.50 | Rake $0.43 
Board [2d 8s 9h Js]
Seat 1: mycka86 folded before Flop (didn't bet)
Seat 2: Filojoes (button) folded before Flop (didn't bet)
Seat 4: Rikti (small blind) folded before Flop
Seat 5: Kukuryzka (big blind) folded before Flop
Seat 6: Tijger R.d.J folded on the Turn
Seat 7: matiko09 folded before Flop (didn't bet)
Seat 8: apfush folded before Flop (didn't bet)
Seat 9: flozzi collected ($9.07)





PokerStars Hand #147708174455:  Hold'em No Limit ($0.50/$1.00 USD) - 2016/01/26 16:13:03 CET [2016/01/26 10:13:03 ET]
Table 'Strenua III' 9-max Seat #1 is the button
Seat 1: ICallSaul ($198.76 in chips) 
Seat 2: cn_chayanne ($152.25 in chips) 
Seat 3: petalouda10 ($52.83 in chips) 
Seat 4: mycka86 ($130.36 in chips) 
Seat 5: DeWeijz ($39.99 in chips) 
Seat 6: matiko09 ($127.84 in chips) 
Seat 7: KLOP06031987 ($104.79 in chips) 
Seat 8: Filojoes ($104.19 in chips) 
cn_chayanne: posts small blind $0.50
petalouda10: posts big blind $1
maxxmeister: sits out 
*** HOLE CARDS ***
Dealt to matiko09 [Ac Ad]
mycka86: folds 
DeWeijz: raises $1.50 to $2.50
matiko09: calls $2.50
KLOP06031987: folds 
Filojoes: folds 
ICallSaul: folds 
ICallSaul leaves the table
cn_chayanne: folds 
petalouda10: folds 
*** FLOP *** [5s 7s 4c]
Rikti joins the table at seat #1 
DeWeijz: checks 
matiko09: bets $5.03
DeWeijz: folds 
Uncalled bet ($5.03) returned to matiko09
matiko09 collected $6.21 from pot
matiko09: doesn't show hand 
*** SUMMARY ***
Total pot $6.50 | Rake $0.29 
Board [5s 7s 4c]
Seat 1: ICallSaul (button) folded before Flop (didn't bet)
Seat 2: cn_chayanne (small blind) folded before Flop
Seat 3: petalouda10 (big blind) folded before Flop
Seat 4: mycka86 folded before Flop (didn't bet)
Seat 5: DeWeijz folded on the Flop
Seat 6: matiko09 collected ($6.21)
Seat 7: KLOP06031987 folded before Flop (didn't bet)
Seat 8: Filojoes folded before Flop (didn't bet)





PokerStars Hand #147708176676:  Hold'em No Limit ($0.50/$1.00 USD) - 2016/01/26 16:13:06 CET [2016/01/26 10:13:06 ET]
Table 'Medusa III' 9-max Seat #9 is the button
Seat 2: happydrake ($84 in chips) 
Seat 3: mycka86 ($109.50 in chips) 
Seat 5: matiko09 ($244.08 in chips) 
Seat 7: Reven9er ($180.96 in chips) 
Seat 8: Filojoes ($133.70 in chips) 
Seat 9: sebaaastian ($100 in chips) 
happydrake: posts small blind $0.50
mycka86: posts big blind $1
simoniustin: sits out 
*** HOLE CARDS ***
Dealt to matiko09 [9s 3c]
matiko09: folds 
Reven9er: folds 
Filojoes: folds 
sebaaastian: folds 
happydrake: folds 
Uncalled bet ($0.50) returned to mycka86
mycka86 collected $1 from pot
*** SUMMARY ***
Total pot $1 | Rake $0 
Seat 2: happydrake (small blind) folded before Flop
Seat 3: mycka86 (big blind) collected ($1)
Seat 5: matiko09 folded before Flop (didn't bet)
Seat 7: Reven9er folded before Flop (didn't bet)
Seat 8: Filojoes folded before Flop (didn't bet)
Seat 9: sebaaastian (button) folded before Flop (didn't bet)





PokerStars Hand #147708184394:  Hold'em No Limit ($0.50/$1.00 USD) - 2016/01/26 16:13:17 CET [2016/01/26 10:13:17 ET]
Table 'Achates III' 9-max Seat #3 is the button
Seat 2: matiko09 ($127.35 in chips) 
Seat 3: Jimy Tiltman ($103.27 in chips) 
Seat 4: cn_chayanne ($100 in chips) 
Seat 5: simoniustin ($100 in chips) 
Seat 6: solbi86 ($115.97 in chips) 
Seat 8: easycomengo ($115.04 in chips) 
Seat 9: T-chaos_IMBA ($321.79 in chips) 
cn_chayanne: posts small blind $0.50
simoniustin: posts big blind $1
1989freak: sits out 
*** HOLE CARDS ***
Dealt to matiko09 [Ad Js]
solbi86: folds 
easycomengo: folds 
T-chaos_IMBA: raises $2 to $3
matiko09: raises $6 to $9
Jimy Tiltman: folds 
cn_chayanne: folds 
simoniustin: folds 
T-chaos_IMBA: calls $6
*** FLOP *** [Ks 8s Qd]
T-chaos_IMBA: checks 
matiko09: bets $9.68
T-chaos_IMBA: calls $9.68
*** TURN *** [Ks 8s Qd] [Tc]
T-chaos_IMBA: checks 
matiko09: bets $26
T-chaos_IMBA: raises $31 to $57
matiko09: calls $31
*** RIVER *** [Ks 8s Qd Tc] [Qs]
T-chaos_IMBA: checks 
matiko09: checks 
*** SHOW DOWN ***
T-chaos_IMBA: shows [Ac Jd] (a straight, Ten to Ace)
matiko09: shows [Ad Js] (a straight, Ten to Ace)
T-chaos_IMBA collected $75.03 from pot
matiko09 collected $75.03 from pot
*** SUMMARY ***
Total pot $152.86 | Rake $2.80 
Board [Ks 8s Qd Tc Qs]
Seat 2: matiko09 showed [Ad Js] and won ($75.03) with a straight, Ten to Ace
Seat 3: Jimy Tiltman (button) folded before Flop (didn't bet)
Seat 4: cn_chayanne (small blind) folded before Flop
Seat 5: simoniustin (big blind) folded before Flop
Seat 6: solbi86 folded before Flop (didn't bet)
Seat 8: easycomengo folded before Flop (didn't bet)
Seat 9: T-chaos_IMBA showed [Ac Jd] and won ($75.03) with a straight, Ten to Ace





PokerStars Hand #147708184435:  Hold'em No Limit ($0.50/$1.00 USD) - 2016/01/26 16:13:17 CET [2016/01/26 10:13:17 ET]
Table 'Aten II' 9-max Seat #2 is the button
Seat 1: cn_chayanne ($110.95 in chips) 
Seat 2: solbi86 ($125.19 in chips) 
Seat 3: ilaviiitech ($100 in chips) 
Seat 4: matiko09 ($102.75 in chips) 
Seat 5: sebaaastian ($103.71 in chips) 
Seat 6: ooohaaah ($79.25 in chips) 
Seat 7: Legioner721 ($30.39 in chips) 
Seat 9: TorontoBum ($119.85 in chips) 
ilaviiitech: posts small blind $0.50
matiko09: posts big blind $1
*** HOLE CARDS ***
Dealt to matiko09 [As Ah]
sebaaastian: folds 
ooohaaah: folds 
Legioner721: folds 
TorontoBum: folds 
cn_chayanne: folds 
solbi86: folds 
ilaviiitech: folds 
Uncalled bet ($0.50) returned to matiko09
matiko09 collected $1 from pot
matiko09: doesn't show hand 
*** SUMMARY ***
Total pot $1 | Rake $0 
Seat 1: cn_chayanne folded before Flop (didn't bet)
Seat 2: solbi86 (button) folded before Flop (didn't bet)
Seat 3: ilaviiitech (small blind) folded before Flop
Seat 4: matiko09 (big blind) collected ($1)
Seat 5: sebaaastian folded before Flop (didn't bet)
Seat 6: ooohaaah folded before Flop (didn't bet)
Seat 7: Legioner721 folded before Flop (didn't bet)
Seat 9: TorontoBum folded before Flop (didn't bet)





PokerStars Hand #147708186831:  Hold'em No Limit ($0.50/$1.00 USD) - 2016/01/26 16:13:20 CET [2016/01/26 10:13:20 ET]
Table 'Kale II' 9-max Seat #4 is the button
Seat 2: matiko09 ($107.63 in chips) 
Seat 3: Reven9er ($133.81 in chips) 
Seat 4: Jimy Tiltman ($189.07 in chips) 
Seat 6: simoniustin ($100 in chips) 
Seat 7: MILLIONCHIC ($70.69 in chips) 
Seat 8: mycka86 ($121.15 in chips) 
Seat 9: solbi86 ($195.77 in chips) 
simoniustin: posts small blind $0.50
MILLIONCHIC: posts big blind $1
*** HOLE CARDS ***
Dealt to matiko09 [7c 3h]
mycka86: raises $2 to $3
solbi86: folds 
matiko09: folds 
Reven9er: folds 
Jimy Tiltman: folds 
simoniustin: folds 
MILLIONCHIC: calls $2
*** FLOP *** [5c 8d 3d]
MILLIONCHIC: checks 
mycka86: bets $4
MILLIONCHIC: folds 
Uncalled bet ($4) returned to mycka86
mycka86 collected $6.21 from pot
*** SUMMARY ***
Total pot $6.50 | Rake $0.29 
Board [5c 8d 3d]
Seat 2: matiko09 folded before Flop (didn't bet)
Seat 3: Reven9er folded before Flop (didn't bet)
Seat 4: Jimy Tiltman (button) folded before Flop (didn't bet)
Seat 6: simoniustin (small blind) folded before Flop
Seat 7: MILLIONCHIC (big blind) folded on the Flop
Seat 8: mycka86 collected ($6.21)
Seat 9: solbi86 folded before Flop (didn't bet)





PokerStars Hand #147708190294:  Hold'em No Limit ($0.50/$1.00 USD) - 2016/01/26 16:13:24 CET [2016/01/26 10:13:24 ET]
Table 'Srbija III' 9-max Seat #5 is the button
Seat 2: cn_chayanne ($103 in chips) 
Seat 3: LIGOPSIXIS78 ($67.67 in chips) 
Seat 4: petalouda10 ($80.69 in chips) 
Seat 5: mycka86 ($100 in chips) 
Seat 6: matiko09 ($214.26 in chips) 
Seat 7: KLOP06031987 ($100 in chips) 
Seat 8: solbi86 ($101.50 in chips) 
matiko09: posts small blind $0.50
KLOP06031987: posts big blind $1
simoniustin: sits out 
*** HOLE CARDS ***
Dealt to matiko09 [As 2c]
solbi86: folds 
cn_chayanne: folds 
LIGOPSIXIS78: folds 
petalouda10: folds 
mycka86: raises $1.10 to $2.10
matiko09: folds 
KLOP06031987: calls $1.10
*** FLOP *** [9c Jd 6h]
KLOP06031987: checks 
mycka86: bets $3
KLOP06031987: calls $3
*** TURN *** [9c Jd 6h] [5d]
KLOP06031987: checks 
mycka86: bets $7.50
KLOP06031987: calls $7.50
*** RIVER *** [9c Jd 6h 5d] [4h]
KLOP06031987: checks 
mycka86: checks 
*** SHOW DOWN ***
KLOP06031987: shows [Ad 4d] (a pair of Fours)
mycka86: mucks hand 
KLOP06031987 collected $24.54 from pot
*** SUMMARY ***
Total pot $25.70 | Rake $1.16 
Board [9c Jd 6h 5d 4h]
Seat 2: cn_chayanne folded before Flop (didn't bet)
Seat 3: LIGOPSIXIS78 folded before Flop (didn't bet)
Seat 4: petalouda10 folded before Flop (didn't bet)
Seat 5: mycka86 (button) mucked [Qc Th]
Seat 6: matiko09 (small blind) folded before Flop
Seat 7: KLOP06031987 (big blind) showed [Ad 4d] and won ($24.54) with a pair of Fours
Seat 8: solbi86 folded before Flop (didn't bet)





PokerStars Hand #147708193704:  Hold'em No Limit ($0.50/$1.00 USD) - 2016/01/26 16:13:29 CET [2016/01/26 10:13:29 ET]
Table 'Calypso II' 9-max Seat #1 is the button
Seat 1: KLOP06031987 ($100 in chips) 
Seat 2: Hardwell1993 ($99.84 in chips) 
Seat 3: matiko09 ($239.93 in chips) 
Seat 4: Sweden_Pound ($111.79 in chips) 
Seat 5: mycka86 ($115 in chips) 
Seat 6: MrDeeee25 ($112.91 in chips) 
Seat 7: Jimy Tiltman ($100 in chips) 
Seat 8: Reven9er ($100 in chips) 
Seat 9: Filojoes ($143.61 in chips) 
Hardwell1993: posts small blind $0.50
matiko09: posts big blind $1
*** HOLE CARDS ***
Dealt to matiko09 [5d 7c]
Sweden_Pound: folds 
mycka86: folds 
MrDeeee25: folds 
Jimy Tiltman: folds 
Reven9er: raises $1 to $2
Filojoes: folds 
KLOP06031987: calls $2
Hardwell1993: calls $1.50
matiko09: folds 
*** FLOP *** [9h 4c 3s]
Hardwell1993: bets $4
Reven9er: folds 
KLOP06031987: folds 
Uncalled bet ($4) returned to Hardwell1993
Hardwell1993 collected $6.68 from pot
*** SUMMARY ***
Total pot $7 | Rake $0.32 
Board [9h 4c 3s]
Seat 1: KLOP06031987 (button) folded on the Flop
Seat 2: Hardwell1993 (small blind) collected ($6.68)
Seat 3: matiko09 (big blind) folded before Flop
Seat 4: Sweden_Pound folded before Flop (didn't bet)
Seat 5: mycka86 folded before Flop (didn't bet)
Seat 6: MrDeeee25 folded before Flop (didn't bet)
Seat 7: Jimy Tiltman folded before Flop (didn't bet)
Seat 8: Reven9er folded on the Flop
Seat 9: Filojoes folded before Flop (didn't bet)





PokerStars Hand #147708194452:  Hold'em No Limit ($0.50/$1.00 USD) - 2016/01/26 16:13:30 CET [2016/01/26 10:13:30 ET]
Table 'Volga III' 9-max Seat #5 is the button
Seat 1: CI58 ($117.81 in chips) 
Seat 2: KLOP06031987 ($100 in chips) 
Seat 3: Kukuryzka ($100 in chips) 
Seat 4: mycka86 ($104.13 in chips) 
Seat 5: veno79 ($46.75 in chips) 
Seat 6: Jimy Tiltman ($100 in chips) 
Seat 8: cn_chayanne ($101 in chips) 
Seat 9: matiko09 ($105.75 in chips) 
Jimy Tiltman: posts small blind $0.50
cn_chayanne: posts big blind $1
*** HOLE CARDS ***
Dealt to matiko09 [8s Kd]
matiko09: folds 
CI58: folds 
KLOP06031987: folds 
Kukuryzka: folds 
mycka86: folds 
veno79: calls $1
Jimy Tiltman: folds 
cn_chayanne: raises $3 to $4
veno79: calls $3
*** FLOP *** [8h 2c 7d]
cn_chayanne: bets $5.12
veno79: calls $5.12
*** TURN *** [8h 2c 7d] [5s]
cn_chayanne: checks 
veno79: bets $4
cn_chayanne: calls $4
*** RIVER *** [8h 2c 7d 5s] [8c]
cn_chayanne: bets $24
veno79: folds 
Uncalled bet ($24) returned to cn_chayanne
cn_chayanne collected $25.54 from pot
cn_chayanne: doesn't show hand 
*** SUMMARY ***
Total pot $26.74 | Rake $1.20 
Board [8h 2c 7d 5s 8c]
Seat 1: CI58 folded before Flop (didn't bet)
Seat 2: KLOP06031987 folded before Flop (didn't bet)
Seat 3: Kukuryzka folded before Flop (didn't bet)
Seat 4: mycka86 folded before Flop (didn't bet)
Seat 5: veno79 (button) folded on the River
Seat 6: Jimy Tiltman (small blind) folded before Flop
Seat 8: cn_chayanne (big blind) collected ($25.54)
Seat 9: matiko09 folded before Flop (didn't bet)





PokerStars Hand #147708194213:  Hold'em No Limit ($0.50/$1.00 USD) - 2016/01/26 16:13:30 CET [2016/01/26 10:13:30 ET]
Table 'Medusa III' 9-max Seat #2 is the button
Seat 2: happydrake ($83.50 in chips) 
Seat 3: mycka86 ($110 in chips) 
Seat 4: simoniustin ($100 in chips) 
Seat 5: matiko09 ($244.08 in chips) 
Seat 7: Reven9er ($180.96 in chips) 
Seat 8: Filojoes ($133.70 in chips) 
Seat 9: sebaaastian ($100 in chips) 
mycka86: posts small blind $0.50
simoniustin: posts big blind $1
*** HOLE CARDS ***
Dealt to matiko09 [2s 9c]
matiko09: folds 
Reven9er: raises $1.50 to $2.50
Filojoes: folds 
sebaaastian: folds 
happydrake: calls $2.50
mycka86: folds 
simoniustin: folds 
*** FLOP *** [6c 7h 7s]
Reven9er: checks 
happydrake: checks 
*** TURN *** [6c 7h 7s] [Tc]
Reven9er: bets $3
happydrake: calls $3
*** RIVER *** [6c 7h 7s Tc] [Jd]
Reven9er: bets $11
happydrake: calls $11
*** SHOW DOWN ***
Reven9er: shows [Ah Qd] (a pair of Sevens)
happydrake: shows [Ks Js] (two pair, Jacks and Sevens)
happydrake collected $32.95 from pot
*** SUMMARY ***
Total pot $34.50 | Rake $1.55 
Board [6c 7h 7s Tc Jd]
Seat 2: happydrake (button) showed [Ks Js] and won ($32.95) with two pair, Jacks and Sevens
Seat 3: mycka86 (small blind) folded before Flop
Seat 4: simoniustin (big blind) folded before Flop
Seat 5: matiko09 folded before Flop (didn't bet)
Seat 7: Reven9er showed [Ah Qd] and lost with a pair of Sevens
Seat 8: Filojoes folded before Flop (didn't bet)
Seat 9: sebaaastian folded before Flop (didn't bet)





PokerStars Hand #147708199034:  Hold'em No Limit ($0.50/$1.00 USD) - 2016/01/26 16:13:36 CET [2016/01/26 10:13:36 ET]
Table 'Aten II' 9-max Seat #3 is the button
Seat 1: cn_chayanne ($110.95 in chips) 
Seat 2: solbi86 ($125.19 in chips) 
Seat 3: ilaviiitech ($100 in chips) 
Seat 4: matiko09 ($103.25 in chips) 
Seat 5: sebaaastian ($103.71 in chips) 
Seat 6: ooohaaah ($79.25 in chips) 
Seat 7: Legioner721 ($30.39 in chips) 
Seat 9: TorontoBum ($119.85 in chips) 
matiko09: posts small blind $0.50
sebaaastian: posts big blind $1
*** HOLE CARDS ***
Dealt to matiko09 [6h 2c]
ooohaaah: folds 
Legioner721: calls $1
TorontoBum: folds 
cn_chayanne: folds 
solbi86: folds 
ilaviiitech: folds 
matiko09: folds 
sebaaastian: raises $3 to $4
Legioner721: calls $3
*** FLOP *** [4c 9c 5c]
sebaaastian: checks 
Legioner721: checks 
*** TURN *** [4c 9c 5c] [8d]
sebaaastian: checks 
Legioner721: checks 
*** RIVER *** [4c 9c 5c 8d] [Kh]
sebaaastian: checks 
Legioner721: checks 
*** SHOW DOWN ***
sebaaastian: shows [As Kd] (a pair of Kings)
Legioner721: mucks hand 
sebaaastian collected $8.12 from pot
*** SUMMARY ***
Total pot $8.50 | Rake $0.38 
Board [4c 9c 5c 8d Kh]
Seat 1: cn_chayanne folded before Flop (didn't bet)
Seat 2: solbi86 folded before Flop (didn't bet)
Seat 3: ilaviiitech (button) folded before Flop (didn't bet)
Seat 4: matiko09 (small blind) folded before Flop
Seat 5: sebaaastian (big blind) showed [As Kd] and won ($8.12) with a pair of Kings
Seat 6: ooohaaah folded before Flop (didn't bet)
Seat 7: Legioner721 mucked [Qh 3h]
Seat 9: TorontoBum folded before Flop (didn't bet)





PokerStars Hand #147708200272:  Hold'em No Limit ($0.50/$1.00 USD) - 2016/01/26 16:13:38 CET [2016/01/26 10:13:38 ET]
Table 'Mashona' 9-max Seat #9 is the button
Seat 1: maxxmeister ($127.90 in chips) 
Seat 2: werades ($221.38 in chips) 
Seat 3: matiko09 ($121.81 in chips) 
Seat 4: Sweden_Pound ($145.72 in chips) 
Seat 5: solbi86 ($127.13 in chips) 
Seat 6: Filojoes ($100 in chips) 
Seat 7: EB0LARAMA ($303.74 in chips) 
Seat 8: Jimy Tiltman ($155.66 in chips) 
Seat 9: apfush ($105.57 in chips) 
maxxmeister: posts small blind $0.50
werades: posts big blind $1
*** HOLE CARDS ***
Dealt to matiko09 [9s 7c]
matiko09: folds 
Sweden_Pound: folds 
solbi86: folds 
Filojoes: folds 
EB0LARAMA: raises $2 to $3
Jimy Tiltman: folds 
apfush: folds 
maxxmeister: folds 
werades: folds 
Uncalled bet ($2) returned to EB0LARAMA
EB0LARAMA collected $2.50 from pot
EB0LARAMA: doesn't show hand 
*** SUMMARY ***
Total pot $2.50 | Rake $0 
Seat 1: maxxmeister (small blind) folded before Flop
Seat 2: werades (big blind) folded before Flop
Seat 3: matiko09 folded before Flop (didn't bet)
Seat 4: Sweden_Pound folded before Flop (didn't bet)
Seat 5: solbi86 folded before Flop (didn't bet)
Seat 6: Filojoes folded before Flop (didn't bet)
Seat 7: EB0LARAMA collected ($2.50)
Seat 8: Jimy Tiltman folded before Flop (didn't bet)
Seat 9: apfush (button) folded before Flop (didn't bet)





PokerStars Hand #147708201760:  Hold'em No Limit ($0.50/$1.00 USD) - 2016/01/26 16:13:40 CET [2016/01/26 10:13:40 ET]
Table 'Vincentina' 9-max Seat #9 is the button
Seat 1: cn_chayanne ($100 in chips) 
Seat 2: simoniustin ($100 in chips) 
Seat 3: Mukhin1 ($100 in chips) 
Seat 4: Dödi123 ($100 in chips) 
Seat 5: solbi86 ($101.50 in chips) 
Seat 6: Sweden_Pound ($100 in chips) 
Seat 7: sebaaastian ($106.03 in chips) 
Seat 9: matiko09 ($100 in chips) 
cn_chayanne: posts small blind $0.50
simoniustin: posts big blind $1
*** HOLE CARDS ***
Dealt to matiko09 [2h 8s]
Mukhin1: folds 
Dödi123: folds 
solbi86: folds 
Sweden_Pound: folds 
sebaaastian: folds 
matiko09: folds 
cn_chayanne: raises $2 to $3
simoniustin: folds 
Uncalled bet ($2) returned to cn_chayanne
cn_chayanne collected $2 from pot
cn_chayanne: doesn't show hand 
*** SUMMARY ***
Total pot $2 | Rake $0 
Seat 1: cn_chayanne (small blind) collected ($2)
Seat 2: simoniustin (big blind) folded before Flop
Seat 3: Mukhin1 folded before Flop (didn't bet)
Seat 4: Dödi123 folded before Flop (didn't bet)
Seat 5: solbi86 folded before Flop (didn't bet)
Seat 6: Sweden_Pound folded before Flop (didn't bet)
Seat 7: sebaaastian folded before Flop (didn't bet)
Seat 9: matiko09 (button) folded before Flop (didn't bet)





PokerStars Hand #147708208167:  Hold'em No Limit ($0.50/$1.00 USD) - 2016/01/26 16:13:48 CET [2016/01/26 10:13:48 ET]
Table 'Montefiore' 9-max Seat #3 is the button
Seat 1: Celsinho0311 ($59.90 in chips) 
Seat 3: Filojoes ($102.71 in chips) 
Seat 4: matiko09 ($100.50 in chips) 
Seat 5: ilaviiitech ($103 in chips) 
Seat 6: FroggyPlay ($104.16 in chips) 
Seat 7: mycka86 ($101.50 in chips) 
Seat 8: Kukuryzka ($100 in chips) 
Seat 9: KLOP06031987 ($100 in chips) 
matiko09: posts small blind $0.50
ilaviiitech: posts big blind $1
D†est7oye†R: sits out 
*** HOLE CARDS ***
Dealt to matiko09 [Jc 8s]
FroggyPlay: raises $2 to $3
mycka86: folds 
Kukuryzka: folds 
KLOP06031987: folds 
Celsinho0311: folds 
Filojoes: folds 
matiko09: folds 
ilaviiitech: folds 
Uncalled bet ($2) returned to FroggyPlay
FroggyPlay collected $2.50 from pot
FroggyPlay: doesn't show hand 
*** SUMMARY ***
Total pot $2.50 | Rake $0 
Seat 1: Celsinho0311 folded before Flop (didn't bet)
Seat 3: Filojoes (button) folded before Flop (didn't bet)
Seat 4: matiko09 (small blind) folded before Flop
Seat 5: ilaviiitech (big blind) folded before Flop
Seat 6: FroggyPlay collected ($2.50)
Seat 7: mycka86 folded before Flop (didn't bet)
Seat 8: Kukuryzka folded before Flop (didn't bet)
Seat 9: KLOP06031987 folded before Flop (didn't bet)





PokerStars Hand #147708208475:  Hold'em No Limit ($0.50/$1.00 USD) - 2016/01/26 16:13:49 CET [2016/01/26 10:13:49 ET]
Table 'Kale II' 9-max Seat #6 is the button
Seat 2: matiko09 ($107.63 in chips) 
Seat 3: Reven9er ($133.81 in chips) 
Seat 4: Jimy Tiltman ($189.07 in chips) 
Seat 6: simoniustin ($100 in chips) 
Seat 7: MILLIONCHIC ($67.69 in chips) 
Seat 8: mycka86 ($124.36 in chips) 
Seat 9: solbi86 ($195.77 in chips) 
MILLIONCHIC: posts small blind $0.50
mycka86: posts big blind $1
*** HOLE CARDS ***
Dealt to matiko09 [6d 9s]
solbi86: folds 
matiko09: folds 
Reven9er: folds 
Jimy Tiltman: raises $2 to $3
simoniustin: folds 
MILLIONCHIC: folds 
mycka86: folds 
Uncalled bet ($2) returned to Jimy Tiltman
Jimy Tiltman collected $2.50 from pot
Jimy Tiltman: doesn't show hand 
*** SUMMARY ***
Total pot $2.50 | Rake $0 
Seat 2: matiko09 folded before Flop (didn't bet)
Seat 3: Reven9er folded before Flop (didn't bet)
Seat 4: Jimy Tiltman collected ($2.50)
Seat 6: simoniustin (button) folded before Flop (didn't bet)
Seat 7: MILLIONCHIC (small blind) folded before Flop
Seat 8: mycka86 (big blind) folded before Flop
Seat 9: solbi86 folded before Flop (didn't bet)





PokerStars Hand #147708212749:  Hold'em No Limit ($0.50/$1.00 USD) - 2016/01/26 16:13:54 CET [2016/01/26 10:13:54 ET]
Table 'Impala' 9-max Seat #4 is the button
Seat 1: mycka86 ($145.94 in chips) 
Seat 2: Filojoes ($100 in chips) 
Seat 4: Rikti ($92.26 in chips) 
Seat 5: Kukuryzka ($99 in chips) 
Seat 6: Tijger R.d.J ($86.74 in chips) 
Seat 7: matiko09 ($133.74 in chips) 
Seat 8: apfush ($100 in chips) 
Seat 9: flozzi ($105.07 in chips) 
Kukuryzka: posts small blind $0.50
Tijger R.d.J: posts big blind $1
simoniustin: sits out 
*** HOLE CARDS ***
Dealt to matiko09 [9c Jc]
matiko09: raises $4 to $5
apfush: folds 
flozzi: folds 
mycka86: folds 
Filojoes: folds 
Rikti: folds 
Kukuryzka: folds 
Tijger R.d.J: calls $4
*** FLOP *** [Qh 3h Jh]
Tijger R.d.J: checks 
matiko09: checks 
*** TURN *** [Qh 3h Jh] [2s]
Tijger R.d.J: bets $5
matiko09: calls $5
*** RIVER *** [Qh 3h Jh 2s] [5d]
Tijger R.d.J: bets $9
matiko09: calls $9
*** SHOW DOWN ***
Tijger R.d.J: shows [Qc Td] (a pair of Queens)
matiko09: mucks hand 
Tijger R.d.J collected $36.77 from pot
*** SUMMARY ***
Total pot $38.50 | Rake $1.73 
Board [Qh 3h Jh 2s 5d]
Seat 1: mycka86 folded before Flop (didn't bet)
Seat 2: Filojoes folded before Flop (didn't bet)
Seat 4: Rikti (button) folded before Flop (didn't bet)
Seat 5: Kukuryzka (small blind) folded before Flop
Seat 6: Tijger R.d.J (big blind) showed [Qc Td] and won ($36.77) with a pair of Queens
Seat 7: matiko09 mucked [9c Jc]
Seat 8: apfush folded before Flop (didn't bet)
Seat 9: flozzi folded before Flop (didn't bet)





PokerStars Hand #147708214726:  Hold'em No Limit ($0.50/$1.00 USD) - 2016/01/26 16:13:57 CET [2016/01/26 10:13:57 ET]
Table 'Strenua III' 9-max Seat #2 is the button
Seat 2: cn_chayanne ($151.75 in chips) 
Seat 3: petalouda10 ($51.83 in chips) 
Seat 4: mycka86 ($130.36 in chips) 
Seat 5: DeWeijz ($37.49 in chips) 
Seat 6: matiko09 ($131.55 in chips) 
Seat 7: KLOP06031987 ($104.79 in chips) 
Seat 8: Filojoes ($104.19 in chips) 
petalouda10: posts small blind $0.50
mycka86: posts big blind $1
maxxmeister: sits out 
Rikti: sits out 
*** HOLE CARDS ***
Dealt to matiko09 [8c 5s]
DeWeijz: raises $1 to $2
matiko09: folds 
KLOP06031987: folds 
Filojoes: folds 
cn_chayanne: folds 
petalouda10: folds 
mycka86: folds 
Uncalled bet ($1) returned to DeWeijz
DeWeijz collected $2.50 from pot
DeWeijz: doesn't show hand 
*** SUMMARY ***
Total pot $2.50 | Rake $0 
Seat 2: cn_chayanne (button) folded before Flop (didn't bet)
Seat 3: petalouda10 (small blind) folded before Flop
Seat 4: mycka86 (big blind) folded before Flop
Seat 5: DeWeijz collected ($2.50)
Seat 6: matiko09 folded before Flop (didn't bet)
Seat 7: KLOP06031987 folded before Flop (didn't bet)
Seat 8: Filojoes folded before Flop (didn't bet)





PokerStars Hand #147708221841:  Hold'em No Limit ($0.50/$1.00 USD) - 2016/01/26 16:14:06 CET [2016/01/26 10:14:06 ET]
Table 'Kale II' 9-max Seat #7 is the button
Seat 2: matiko09 ($107.63 in chips) 
Seat 3: Reven9er ($133.81 in chips) 
Seat 4: Jimy Tiltman ($190.57 in chips) 
Seat 6: simoniustin ($100 in chips) 
Seat 7: MILLIONCHIC ($67.19 in chips) 
Seat 8: mycka86 ($123.36 in chips) 
Seat 9: solbi86 ($195.77 in chips) 
mycka86: posts small blind $0.50
solbi86: posts big blind $1
*** HOLE CARDS ***
Dealt to matiko09 [Kc 6d]
matiko09: folds 
Reven9er: folds 
Jimy Tiltman: folds 
simoniustin: folds 
MILLIONCHIC: raises $2 to $3
mycka86: folds 
solbi86: folds 
Uncalled bet ($2) returned to MILLIONCHIC
MILLIONCHIC collected $2.50 from pot
MILLIONCHIC: doesn't show hand 
*** SUMMARY ***
Total pot $2.50 | Rake $0 
Seat 2: matiko09 folded before Flop (didn't bet)
Seat 3: Reven9er folded before Flop (didn't bet)
Seat 4: Jimy Tiltman folded before Flop (didn't bet)
Seat 6: simoniustin folded before Flop (didn't bet)
Seat 7: MILLIONCHIC (button) collected ($2.50)
Seat 8: mycka86 (small blind) folded before Flop
Seat 9: solbi86 (big blind) folded before Flop





PokerStars Hand #147708227827:  Hold'em No Limit ($0.50/$1.00 USD) - 2016/01/26 16:14:14 CET [2016/01/26 10:14:14 ET]
Table 'Mashona' 9-max Seat #1 is the button
Seat 1: maxxmeister ($127.40 in chips) 
Seat 2: werades ($220.38 in chips) 
Seat 3: matiko09 ($121.81 in chips) 
Seat 4: Sweden_Pound ($145.72 in chips) 
Seat 5: solbi86 ($127.13 in chips) 
Seat 6: Filojoes ($100 in chips) 
Seat 7: EB0LARAMA ($305.24 in chips) 
Seat 8: Jimy Tiltman ($155.66 in chips) 
Seat 9: apfush ($105.57 in chips) 
werades: posts small blind $0.50
matiko09: posts big blind $1
*** HOLE CARDS ***
Dealt to matiko09 [Tc Qc]
Sweden_Pound: folds 
Sweden_Pound leaves the table
solbi86: folds 
Filojoes: folds 
EB0LARAMA: folds 
Jimy Tiltman: folds 
apfush: folds 
maxxmeister: raises $2 to $3
mycka86 joins the table at seat #4 
werades: calls $2.50
matiko09: raises $9 to $12
maxxmeister: folds 
werades: folds [As]
Uncalled bet ($9) returned to matiko09
matiko09 collected $9 from pot
matiko09: doesn't show hand 
*** SUMMARY ***
Total pot $9 | Rake $0 
Seat 1: maxxmeister (button) folded before Flop
Seat 2: werades (small blind) folded before Flop
Seat 3: matiko09 (big blind) collected ($9)
Seat 4: Sweden_Pound folded before Flop (didn't bet)
Seat 5: solbi86 folded before Flop (didn't bet)
Seat 6: Filojoes folded before Flop (didn't bet)
Seat 7: EB0LARAMA folded before Flop (didn't bet)
Seat 8: Jimy Tiltman folded before Flop (didn't bet)
Seat 9: apfush folded before Flop (didn't bet)





PokerStars Hand #147708235697:  Hold'em No Limit ($0.50/$1.00 USD) - 2016/01/26 16:14:25 CET [2016/01/26 10:14:25 ET]
Table 'Montefiore' 9-max Seat #4 is the button
Seat 1: Celsinho0311 ($59.90 in chips) 
Seat 3: Filojoes ($102.71 in chips) 
Seat 4: matiko09 ($100 in chips) 
Seat 5: ilaviiitech ($102 in chips) 
Seat 6: FroggyPlay ($105.66 in chips) 
Seat 7: mycka86 ($101.50 in chips) 
Seat 8: Kukuryzka ($100 in chips) 
Seat 9: KLOP06031987 ($100 in chips) 
ilaviiitech: posts small blind $0.50
FroggyPlay: posts big blind $1
D†est7oye†R: sits out 
*** HOLE CARDS ***
Dealt to matiko09 [5c 3c]
mycka86: folds 
Kukuryzka: folds 
KLOP06031987: raises $1.31 to $2.31
Celsinho0311: folds 
Filojoes: folds 
matiko09: folds 
ilaviiitech: folds 
FroggyPlay: folds 
Uncalled bet ($1.31) returned to KLOP06031987
KLOP06031987 collected $2.50 from pot
KLOP06031987: doesn't show hand 
*** SUMMARY ***
Total pot $2.50 | Rake $0 
Seat 1: Celsinho0311 folded before Flop (didn't bet)
Seat 3: Filojoes folded before Flop (didn't bet)
Seat 4: matiko09 (button) folded before Flop (didn't bet)
Seat 5: ilaviiitech (small blind) folded before Flop
Seat 6: FroggyPlay (big blind) folded before Flop
Seat 7: mycka86 folded before Flop (didn't bet)
Seat 8: Kukuryzka folded before Flop (didn't bet)
Seat 9: KLOP06031987 collected ($2.50)





PokerStars Hand #147708236510:  Hold'em No Limit ($0.50/$1.00 USD) - 2016/01/26 16:14:26 CET [2016/01/26 10:14:26 ET]
Table 'Kale II' 9-max Seat #8 is the button
Seat 2: matiko09 ($107.63 in chips) 
Seat 3: Reven9er ($133.81 in chips) 
Seat 4: Jimy Tiltman ($190.57 in chips) 
Seat 6: simoniustin ($100 in chips) 
Seat 7: MILLIONCHIC ($68.69 in chips) 
Seat 8: mycka86 ($122.86 in chips) 
Seat 9: solbi86 ($194.77 in chips) 
solbi86: posts small blind $0.50
matiko09: posts big blind $1
*** HOLE CARDS ***
Dealt to matiko09 [Qd Js]
Reven9er: folds 
Jimy Tiltman: folds 
simoniustin: folds 
MILLIONCHIC: folds 
mycka86: folds 
solbi86: raises $1.50 to $2.50
matiko09: calls $1.50
*** FLOP *** [7h 9s 6h]
solbi86: bets $3.15
matiko09: folds 
Uncalled bet ($3.15) returned to solbi86
solbi86 collected $4.78 from pot
solbi86: doesn't show hand 
*** SUMMARY ***
Total pot $5 | Rake $0.22 
Board [7h 9s 6h]
Seat 2: matiko09 (big blind) folded on the Flop
Seat 3: Reven9er folded before Flop (didn't bet)
Seat 4: Jimy Tiltman folded before Flop (didn't bet)
Seat 6: simoniustin folded before Flop (didn't bet)
Seat 7: MILLIONCHIC folded before Flop (didn't bet)
Seat 8: mycka86 (button) folded before Flop (didn't bet)
Seat 9: solbi86 (small blind) collected ($4.78)





PokerStars Hand #147708237478:  Hold'em No Limit ($0.50/$1.00 USD) - 2016/01/26 16:14:27 CET [2016/01/26 10:14:27 ET]
Table 'Haedus' 9-max Seat #8 is the button
Seat 1: matiko09 ($101.50 in chips) 
Seat 3: cn_chayanne ($101.50 in chips) 
Seat 4: timur3-5-7 ($96.64 in chips) 
Seat 5: solbi86 ($105 in chips) 
Seat 6: nnne409 ($71.44 in chips) 
Seat 7: KLOP06031987 ($106 in chips) 
Seat 8: Jimy Tiltman ($106.24 in chips) 
Seat 9: Filojoes ($135.19 in chips) 
Filojoes: posts small blind $0.50
matiko09: posts big blind $1
*** HOLE CARDS ***
Dealt to matiko09 [8c Kh]
cn_chayanne: folds 
timur3-5-7: raises $1 to $2
solbi86: raises $5 to $7
nnne409: folds 
KLOP06031987: folds 
Jimy Tiltman: folds 
Filojoes: folds 
matiko09: folds 
timur3-5-7: calls $5
*** FLOP *** [8d 2s 7h]
timur3-5-7: checks 
solbi86: bets $8
timur3-5-7: calls $8
*** TURN *** [8d 2s 7h] [Qc]
timur3-5-7: checks 
solbi86: bets $17
timur3-5-7: folds 
Uncalled bet ($17) returned to solbi86
solbi86 collected $30.08 from pot
solbi86: doesn't show hand 
*** SUMMARY ***
Total pot $31.50 | Rake $1.42 
Board [8d 2s 7h Qc]
Seat 1: matiko09 (big blind) folded before Flop
Seat 3: cn_chayanne folded before Flop (didn't bet)
Seat 4: timur3-5-7 folded on the Turn
Seat 5: solbi86 collected ($30.08)
Seat 6: nnne409 folded before Flop (didn't bet)
Seat 7: KLOP06031987 folded before Flop (didn't bet)
Seat 8: Jimy Tiltman (button) folded before Flop (didn't bet)
Seat 9: Filojoes (small blind) folded before Flop





PokerStars Hand #147708243264:  Hold'em No Limit ($0.50/$1.00 USD) - 2016/01/26 16:14:35 CET [2016/01/26 10:14:35 ET]
Table 'Medusa III' 9-max Seat #3 is the button
Seat 2: happydrake ($99.95 in chips) 
Seat 3: mycka86 ($109.50 in chips) 
Seat 4: simoniustin ($100 in chips) 
Seat 5: matiko09 ($244.08 in chips) 
Seat 7: Reven9er ($164.46 in chips) 
Seat 8: Filojoes ($133.70 in chips) 
Seat 9: sebaaastian ($100 in chips) 
simoniustin: posts small blind $0.50
matiko09: posts big blind $1
aseban11: sits out 
*** HOLE CARDS ***
Dealt to matiko09 [Jc 8c]
Reven9er: folds 
Filojoes: folds 
sebaaastian: folds 
happydrake: folds 
mycka86: raises $1.10 to $2.10
simoniustin: folds 
matiko09: calls $1.10
*** FLOP *** [3d Qs 3s]
matiko09: checks 
mycka86: checks 
*** TURN *** [3d Qs 3s] [Tc]
matiko09: bets $2.92
mycka86: calls $2.92
*** RIVER *** [3d Qs 3s Tc] [4s]
matiko09: bets $8.15
mycka86: folds 
Uncalled bet ($8.15) returned to matiko09
matiko09 collected $10.07 from pot
matiko09: doesn't show hand 
*** SUMMARY ***
Total pot $10.54 | Rake $0.47 
Board [3d Qs 3s Tc 4s]
Seat 2: happydrake folded before Flop (didn't bet)
Seat 3: mycka86 (button) folded on the River
Seat 4: simoniustin (small blind) folded before Flop
Seat 5: matiko09 (big blind) collected ($10.07)
Seat 7: Reven9er folded before Flop (didn't bet)
Seat 8: Filojoes folded before Flop (didn't bet)
Seat 9: sebaaastian folded before Flop (didn't bet)





PokerStars Hand #147708244005:  Hold'em No Limit ($0.50/$1.00 USD) - 2016/01/26 16:14:36 CET [2016/01/26 10:14:36 ET]
Table 'Vincentina' 9-max Seat #1 is the button
Seat 1: cn_chayanne ($101 in chips) 
Seat 2: simoniustin ($100 in chips) 
Seat 3: Mukhin1 ($100 in chips) 
Seat 4: Dödi123 ($100 in chips) 
Seat 5: solbi86 ($101.50 in chips) 
Seat 6: Sweden_Pound ($100 in chips) 
Seat 7: sebaaastian ($106.03 in chips) 
Seat 9: matiko09 ($100 in chips) 
simoniustin: posts small blind $0.50
Mukhin1: posts big blind $1
*** HOLE CARDS ***
Dealt to matiko09 [3h 3d]
Dödi123: folds 
solbi86: folds 
Sweden_Pound: folds 
sebaaastian: folds 
matiko09: raises $1.50 to $2.50
cn_chayanne: folds 
simoniustin: folds 
Mukhin1: folds 
Uncalled bet ($1.50) returned to matiko09
matiko09 collected $2.50 from pot
matiko09: doesn't show hand 
*** SUMMARY ***
Total pot $2.50 | Rake $0 
Seat 1: cn_chayanne (button) folded before Flop (didn't bet)
Seat 2: simoniustin (small blind) folded before Flop
Seat 3: Mukhin1 (big blind) folded before Flop
Seat 4: Dödi123 folded before Flop (didn't bet)
Seat 5: solbi86 folded before Flop (didn't bet)
Seat 6: Sweden_Pound folded before Flop (didn't bet)
Seat 7: sebaaastian folded before Flop (didn't bet)
Seat 9: matiko09 collected ($2.50)





PokerStars Hand #147708245716:  Hold'em No Limit ($0.50/$1.00 USD) - 2016/01/26 16:14:38 CET [2016/01/26 10:14:38 ET]
Table 'Srbija III' 9-max Seat #6 is the button
Seat 2: cn_chayanne ($103 in chips) 
Seat 3: LIGOPSIXIS78 ($67.67 in chips) 
Seat 4: petalouda10 ($80.69 in chips) 
Seat 5: mycka86 ($100 in chips) 
Seat 6: matiko09 ($213.76 in chips) 
Seat 7: KLOP06031987 ($111.94 in chips) 
Seat 8: solbi86 ($101.50 in chips) 
KLOP06031987: posts small blind $0.50
solbi86: posts big blind $1
simoniustin: sits out 
*** HOLE CARDS ***
Dealt to matiko09 [8h 2s]
cn_chayanne: folds 
LIGOPSIXIS78: folds 
petalouda10: raises $2 to $3
mycka86: folds 
matiko09: folds 
KLOP06031987: folds 
solbi86: folds 
Uncalled bet ($2) returned to petalouda10
petalouda10 collected $2.50 from pot
petalouda10: doesn't show hand 
*** SUMMARY ***
Total pot $2.50 | Rake $0 
Seat 2: cn_chayanne folded before Flop (didn't bet)
Seat 3: LIGOPSIXIS78 folded before Flop (didn't bet)
Seat 4: petalouda10 collected ($2.50)
Seat 5: mycka86 folded before Flop (didn't bet)
Seat 6: matiko09 (button) folded before Flop (didn't bet)
Seat 7: KLOP06031987 (small blind) folded before Flop
Seat 8: solbi86 (big blind) folded before Flop





PokerStars Hand #147708246831:  Hold'em No Limit ($0.50/$1.00 USD) - 2016/01/26 16:14:39 CET [2016/01/26 10:14:39 ET]
Table 'Strenua III' 9-max Seat #3 is the button
Seat 2: cn_chayanne ($151.75 in chips) 
Seat 3: petalouda10 ($51.33 in chips) 
Seat 4: mycka86 ($129.36 in chips) 
Seat 5: DeWeijz ($38.99 in chips) 
Seat 6: matiko09 ($131.55 in chips) 
Seat 7: KLOP06031987 ($104.79 in chips) 
Seat 8: Filojoes ($104.19 in chips) 
mycka86: posts small blind $0.50
DeWeijz: posts big blind $1
maxxmeister: sits out 
Rikti: sits out 
*** HOLE CARDS ***
Dealt to matiko09 [6h 3c]
matiko09: folds 
KLOP06031987: raises $1.31 to $2.31
Filojoes: folds 
cn_chayanne: folds 
petalouda10: folds 
mycka86: folds 
DeWeijz: calls $1.31
*** FLOP *** [6s 5s 9h]
DeWeijz: bets $3
KLOP06031987: folds 
Uncalled bet ($3) returned to DeWeijz
DeWeijz collected $4.89 from pot
DeWeijz: doesn't show hand 
*** SUMMARY ***
Total pot $5.12 | Rake $0.23 
Board [6s 5s 9h]
Seat 2: cn_chayanne folded before Flop (didn't bet)
Seat 3: petalouda10 (button) folded before Flop (didn't bet)
Seat 4: mycka86 (small blind) folded before Flop
Seat 5: DeWeijz (big blind) collected ($4.89)
Seat 6: matiko09 folded before Flop (didn't bet)
Seat 7: KLOP06031987 folded on the Flop
Seat 8: Filojoes folded before Flop (didn't bet)





PokerStars Hand #147708248657:  Hold'em No Limit ($0.50/$1.00 USD) - 2016/01/26 16:14:42 CET [2016/01/26 10:14:42 ET]
Table 'Aten II' 9-max Seat #4 is the button
Seat 1: cn_chayanne ($110.95 in chips) 
Seat 2: solbi86 ($125.19 in chips) 
Seat 3: ilaviiitech ($100 in chips) 
Seat 4: matiko09 ($102.75 in chips) 
Seat 5: sebaaastian ($107.83 in chips) 
Seat 6: ooohaaah ($79.25 in chips) 
Seat 7: Legioner721 ($26.39 in chips) 
Seat 9: TorontoBum ($119.85 in chips) 
sebaaastian: posts small blind $0.50
ooohaaah: posts big blind $1
*** HOLE CARDS ***
Dealt to matiko09 [Kd 5h]
Legioner721: folds 
TorontoBum: folds 
cn_chayanne: raises $1.50 to $2.50
solbi86: folds 
ilaviiitech: calls $2.50
matiko09: folds 
sebaaastian: folds 
ooohaaah: folds 
*** FLOP *** [6h 5d 9h]
cn_chayanne: checks 
ilaviiitech: checks 
*** TURN *** [6h 5d 9h] [Th]
cn_chayanne: bets $4.65
ilaviiitech: folds 
Uncalled bet ($4.65) returned to cn_chayanne
cn_chayanne collected $6.21 from pot
cn_chayanne: doesn't show hand 
*** SUMMARY ***
Total pot $6.50 | Rake $0.29 
Board [6h 5d 9h Th]
Seat 1: cn_chayanne collected ($6.21)
Seat 2: solbi86 folded before Flop (didn't bet)
Seat 3: ilaviiitech folded on the Turn
Seat 4: matiko09 (button) folded before Flop (didn't bet)
Seat 5: sebaaastian (small blind) folded before Flop
Seat 6: ooohaaah (big blind) folded before Flop
Seat 7: Legioner721 folded before Flop (didn't bet)
Seat 9: TorontoBum folded before Flop (didn't bet)





PokerStars Hand #147708250951:  Hold'em No Limit ($0.50/$1.00 USD) - 2016/01/26 16:14:45 CET [2016/01/26 10:14:45 ET]
Table 'Volga III' 9-max Seat #6 is the button
Seat 1: CI58 ($117.81 in chips) 
Seat 2: KLOP06031987 ($100 in chips) 
Seat 3: Kukuryzka ($100 in chips) 
Seat 4: mycka86 ($104.13 in chips) 
Seat 5: veno79 ($33.63 in chips) 
Seat 6: Jimy Tiltman ($100 in chips) 
Seat 8: cn_chayanne ($113.42 in chips) 
Seat 9: matiko09 ($105.75 in chips) 
cn_chayanne: posts small blind $0.50
matiko09: posts big blind $1
*** HOLE CARDS ***
Dealt to matiko09 [6c 2h]
CI58: folds 
KLOP06031987: folds 
Kukuryzka: folds 
mycka86: folds 
veno79: calls $1
Jimy Tiltman: folds 
cn_chayanne: raises $3 to $4
matiko09: folds 
veno79: calls $3
*** FLOP *** [2s 5h Js]
cn_chayanne: bets $6.45
veno79: calls $6.45
*** TURN *** [2s 5h Js] [Qc]
cn_chayanne: bets $15.68
veno79: raises $7.50 to $23.18 and is all-in
cn_chayanne: calls $7.50
*** RIVER *** [2s 5h Js Qc] [2c]
*** SHOW DOWN ***
cn_chayanne: shows [Jh Kd] (two pair, Jacks and Deuces)
veno79: shows [7c Jc] (two pair, Jacks and Deuces - lower kicker)
cn_chayanne collected $65.46 from pot
*** SUMMARY ***
Total pot $68.26 | Rake $2.80 
Board [2s 5h Js Qc 2c]
Seat 1: CI58 folded before Flop (didn't bet)
Seat 2: KLOP06031987 folded before Flop (didn't bet)
Seat 3: Kukuryzka folded before Flop (didn't bet)
Seat 4: mycka86 folded before Flop (didn't bet)
Seat 5: veno79 showed [7c Jc] and lost with two pair, Jacks and Deuces
Seat 6: Jimy Tiltman (button) folded before Flop (didn't bet)
Seat 8: cn_chayanne (small blind) showed [Jh Kd] and won ($65.46) with two pair, Jacks and Deuces
Seat 9: matiko09 (big blind) folded before Flop





PokerStars Hand #147708252237:  Hold'em No Limit ($0.50/$1.00 USD) - 2016/01/26 16:14:47 CET [2016/01/26 10:14:47 ET]
Table 'Calypso II' 9-max Seat #2 is the button
Seat 1: KLOP06031987 ($100 in chips) 
Seat 2: Hardwell1993 ($104.52 in chips) 
Seat 3: matiko09 ($238.93 in chips) 
Seat 5: mycka86 ($115 in chips) 
Seat 6: MrDeeee25 ($112.91 in chips) 
Seat 7: Jimy Tiltman ($100 in chips) 
Seat 8: Reven9er ($100 in chips) 
Seat 9: Filojoes ($143.61 in chips) 
matiko09: posts small blind $0.50
Sweden_Pound: is sitting out 
mycka86: posts big blind $1
*** HOLE CARDS ***
Dealt to matiko09 [As Tc]
MrDeeee25: folds 
Sweden_Pound leaves the table
Kukuryzka joins the table at seat #4 
Jimy Tiltman: raises $2 to $3
Reven9er: folds 
Filojoes: folds 
KLOP06031987: folds 
Hardwell1993: folds 
Hardwell1993 leaves the table
CI58 joins the table at seat #2 
matiko09: folds 
mycka86: folds 
Uncalled bet ($2) returned to Jimy Tiltman
CI58 leaves the table
Jimy Tiltman collected $2.50 from pot
Jimy Tiltman: doesn't show hand 
*** SUMMARY ***
Total pot $2.50 | Rake $0 
Seat 1: KLOP06031987 folded before Flop (didn't bet)
Seat 2: Hardwell1993 (button) folded before Flop (didn't bet)
Seat 3: matiko09 (small blind) folded before Flop
Seat 5: mycka86 (big blind) folded before Flop
Seat 6: MrDeeee25 folded before Flop (didn't bet)
Seat 7: Jimy Tiltman collected ($2.50)
Seat 8: Reven9er folded before Flop (didn't bet)
Seat 9: Filojoes folded before Flop (didn't bet)





PokerStars Hand #147708256326:  Hold'em No Limit ($0.50/$1.00 USD) - 2016/01/26 16:14:52 CET [2016/01/26 10:14:52 ET]
Table 'Montefiore' 9-max Seat #5 is the button
Seat 1: Celsinho0311 ($59.90 in chips) 
Seat 3: Filojoes ($102.71 in chips) 
Seat 4: matiko09 ($100 in chips) 
Seat 5: ilaviiitech ($101.50 in chips) 
Seat 6: FroggyPlay ($104.66 in chips) 
Seat 7: mycka86 ($101.50 in chips) 
Seat 8: Kukuryzka ($100 in chips) 
Seat 9: KLOP06031987 ($101.50 in chips) 
FroggyPlay: posts small blind $0.50
mycka86: posts big blind $1
D†est7oye†R: sits out 
*** HOLE CARDS ***
Dealt to matiko09 [Kh 5c]
Kukuryzka: folds 
KLOP06031987: folds 
Celsinho0311: raises $2 to $3
Filojoes: calls $3
matiko09: folds 
ilaviiitech: folds 
FroggyPlay: raises $10 to $13
mycka86: folds 
Celsinho0311: calls $10
Filojoes: folds 
*** FLOP *** [3c 5h 4c]
FroggyPlay: bets $8.59
Celsinho0311: calls $8.59
*** TURN *** [3c 5h 4c] [6d]
FroggyPlay: checks 
Celsinho0311: checks 
*** RIVER *** [3c 5h 4c 6d] [Qd]
FroggyPlay: checks 
Celsinho0311: checks 
*** SHOW DOWN ***
FroggyPlay: shows [Js As] (high card Ace)
Celsinho0311: shows [Jc Jd] (a pair of Jacks)
Celsinho0311 collected $45.06 from pot
*** SUMMARY ***
Total pot $47.18 | Rake $2.12 
Board [3c 5h 4c 6d Qd]
Seat 1: Celsinho0311 showed [Jc Jd] and won ($45.06) with a pair of Jacks
Seat 3: Filojoes folded before Flop
Seat 4: matiko09 folded before Flop (didn't bet)
Seat 5: ilaviiitech (button) folded before Flop (didn't bet)
Seat 6: FroggyPlay (small blind) showed [Js As] and lost with high card Ace
Seat 7: mycka86 (big blind) folded before Flop
Seat 8: Kukuryzka folded before Flop (didn't bet)
Seat 9: KLOP06031987 folded before Flop (didn't bet)





PokerStars Hand #147708261095:  Hold'em No Limit ($0.50/$1.00 USD) - 2016/01/26 16:14:58 CET [2016/01/26 10:14:58 ET]
Table 'Srbija III' 9-max Seat #7 is the button
Seat 1: simoniustin ($100 in chips) 
Seat 2: cn_chayanne ($103 in chips) 
Seat 3: LIGOPSIXIS78 ($67.67 in chips) 
Seat 4: petalouda10 ($82.19 in chips) 
Seat 5: mycka86 ($100 in chips) 
Seat 6: matiko09 ($213.76 in chips) 
Seat 7: KLOP06031987 ($111.44 in chips) 
Seat 8: solbi86 ($100.50 in chips) 
solbi86: posts small blind $0.50
simoniustin: posts big blind $1
*** HOLE CARDS ***
Dealt to matiko09 [Td 9c]
cn_chayanne: folds 
LIGOPSIXIS78: folds 
petalouda10: raises $2 to $3
mycka86: folds 
matiko09: folds 
KLOP06031987: folds 
solbi86: calls $2.50
simoniustin: folds 
*** FLOP *** [7c 7d 6h]
solbi86: checks 
petalouda10: bets $3.34
solbi86: calls $3.34
*** TURN *** [7c 7d 6h] [7s]
solbi86: checks 
petalouda10: checks 
*** RIVER *** [7c 7d 6h 7s] [Kd]
solbi86: checks 
petalouda10: checks 
*** SHOW DOWN ***
solbi86: shows [Qc As] (three of a kind, Sevens)
petalouda10: shows [2d Ah] (three of a kind, Sevens)
solbi86 collected $6.53 from pot
petalouda10 collected $6.53 from pot
*** SUMMARY ***
Total pot $13.68 | Rake $0.62 
Board [7c 7d 6h 7s Kd]
Seat 1: simoniustin (big blind) folded before Flop
Seat 2: cn_chayanne folded before Flop (didn't bet)
Seat 3: LIGOPSIXIS78 folded before Flop (didn't bet)
Seat 4: petalouda10 showed [2d Ah] and won ($6.53) with three of a kind, Sevens
Seat 5: mycka86 folded before Flop (didn't bet)
Seat 6: matiko09 folded before Flop (didn't bet)
Seat 7: KLOP06031987 (button) folded before Flop (didn't bet)
Seat 8: solbi86 (small blind) showed [Qc As] and won ($6.53) with three of a kind, Sevens





PokerStars Hand #147708267482:  Hold'em No Limit ($0.50/$1.00 USD) - 2016/01/26 16:15:07 CET [2016/01/26 10:15:07 ET]
Table 'Kale II' 9-max Seat #9 is the button
Seat 2: matiko09 ($105.13 in chips) 
Seat 3: Reven9er ($133.81 in chips) 
Seat 4: Jimy Tiltman ($190.57 in chips) 
Seat 6: simoniustin ($100 in chips) 
Seat 7: MILLIONCHIC ($68.69 in chips) 
Seat 8: mycka86 ($122.86 in chips) 
Seat 9: solbi86 ($197.05 in chips) 
matiko09: posts small blind $0.50
Reven9er: posts big blind $1
*** HOLE CARDS ***
Dealt to matiko09 [Js 2s]
Jimy Tiltman: folds 
simoniustin: folds 
Jimy Tiltman leaves the table
MILLIONCHIC: raises $2 to $3
mycka86: folds 
solbi86: folds 
matiko09: folds 
Reven9er: calls $2
*** FLOP *** [5s Kd 6d]
Reven9er: checks 
MILLIONCHIC: checks 
*** TURN *** [5s Kd 6d] [6s]
Reven9er: checks 
MILLIONCHIC: checks 
*** RIVER *** [5s Kd 6d 6s] [5h]
Reven9er: checks 
MILLIONCHIC: checks 
*** SHOW DOWN ***
Reven9er: shows [Jh Ac] (two pair, Sixes and Fives)
MILLIONCHIC: shows [4c Ad] (two pair, Sixes and Fives)
Reven9er collected $3.11 from pot
MILLIONCHIC collected $3.10 from pot
*** SUMMARY ***
Total pot $6.50 | Rake $0.29 
Board [5s Kd 6d 6s 5h]
Seat 2: matiko09 (small blind) folded before Flop
Seat 3: Reven9er (big blind) showed [Jh Ac] and won ($3.11) with two pair, Sixes and Fives
Seat 4: Jimy Tiltman folded before Flop (didn't bet)
Seat 6: simoniustin folded before Flop (didn't bet)
Seat 7: MILLIONCHIC showed [4c Ad] and won ($3.10) with two pair, Sixes and Fives
Seat 8: mycka86 folded before Flop (didn't bet)
Seat 9: solbi86 (button) folded before Flop (didn't bet)





PokerStars Hand #147708272054:  Hold'em No Limit ($0.50/$1.00 USD) - 2016/01/26 16:15:13 CET [2016/01/26 10:15:13 ET]
Table 'Achates III' 9-max Seat #4 is the button
Seat 2: matiko09 ($126.70 in chips) 
Seat 3: Jimy Tiltman ($103.27 in chips) 
Seat 4: cn_chayanne ($100 in chips) 
Seat 5: simoniustin ($100 in chips) 
Seat 6: solbi86 ($115.97 in chips) 
Seat 7: 1989freak ($100 in chips) 
Seat 8: easycomengo ($115.04 in chips) 
Seat 9: T-chaos_IMBA ($321.14 in chips) 
simoniustin: posts small blind $0.50
solbi86: posts big blind $1
1989freak: posts big blind $1
*** HOLE CARDS ***
Dealt to matiko09 [8h Kd]
T-chaos_IMBA said, "nh"
1989freak has timed out
1989freak: checks 
easycomengo: folds 
T-chaos_IMBA: folds 
matiko09: folds 
Jimy Tiltman: folds 
cn_chayanne: folds 
simoniustin: folds 
solbi86: checks 
*** FLOP *** [2s Qs 9s]
solbi86: checks 
1989freak: bets $1.75
solbi86: folds 
Uncalled bet ($1.75) returned to 1989freak
1989freak collected $2.39 from pot
1989freak: doesn't show hand 
*** SUMMARY ***
Total pot $2.50 | Rake $0.11 
Board [2s Qs 9s]
Seat 2: matiko09 folded before Flop (didn't bet)
Seat 3: Jimy Tiltman folded before Flop (didn't bet)
Seat 4: cn_chayanne (button) folded before Flop (didn't bet)
Seat 5: simoniustin (small blind) folded before Flop
Seat 6: solbi86 (big blind) folded on the Flop
Seat 7: 1989freak collected ($2.39)
Seat 8: easycomengo folded before Flop (didn't bet)
Seat 9: T-chaos_IMBA folded before Flop (didn't bet)





PokerStars Hand #147708272770:  Hold'em No Limit ($0.50/$1.00 USD) - 2016/01/26 16:15:14 CET [2016/01/26 10:15:14 ET]
Table 'Mashona' 9-max Seat #2 is the button
Seat 1: maxxmeister ($124.40 in chips) 
Seat 2: werades ($217.38 in chips) 
Seat 3: matiko09 ($127.81 in chips) 
Seat 4: mycka86 ($100 in chips) 
Seat 5: solbi86 ($127.13 in chips) 
Seat 6: Filojoes ($100 in chips) 
Seat 7: EB0LARAMA ($305.24 in chips) 
Seat 8: Jimy Tiltman ($155.66 in chips) 
Seat 9: apfush ($105.57 in chips) 
matiko09: posts small blind $0.50
mycka86: posts big blind $1
*** HOLE CARDS ***
Dealt to matiko09 [Qc 6h]
solbi86: folds 
Filojoes: folds 
EB0LARAMA: folds 
Jimy Tiltman: raises $2 to $3
apfush: folds 
maxxmeister: folds 
werades: folds 
matiko09: folds 
mycka86: folds 
Uncalled bet ($2) returned to Jimy Tiltman
Jimy Tiltman collected $2.50 from pot
Jimy Tiltman: doesn't show hand 
*** SUMMARY ***
Total pot $2.50 | Rake $0 
Seat 1: maxxmeister folded before Flop (didn't bet)
Seat 2: werades (button) folded before Flop (didn't bet)
Seat 3: matiko09 (small blind) folded before Flop
Seat 4: mycka86 (big blind) folded before Flop
Seat 5: solbi86 folded before Flop (didn't bet)
Seat 6: Filojoes folded before Flop (didn't bet)
Seat 7: EB0LARAMA folded before Flop (didn't bet)
Seat 8: Jimy Tiltman collected ($2.50)
Seat 9: apfush folded before Flop (didn't bet)





PokerStars Hand #147708281460:  Hold'em No Limit ($0.50/$1.00 USD) - 2016/01/26 16:15:25 CET [2016/01/26 10:15:25 ET]
Table 'Strenua III' 9-max Seat #4 is the button
Seat 2: cn_chayanne ($151.75 in chips) 
Seat 3: petalouda10 ($51.33 in chips) 
Seat 4: mycka86 ($128.86 in chips) 
Seat 5: DeWeijz ($41.57 in chips) 
Seat 6: matiko09 ($131.55 in chips) 
Seat 7: KLOP06031987 ($102.48 in chips) 
Seat 8: Filojoes ($104.19 in chips) 
DeWeijz: posts small blind $0.50
matiko09: posts big blind $1
maxxmeister: sits out 
Rikti: sits out 
*** HOLE CARDS ***
Dealt to matiko09 [8c Kh]
KLOP06031987: folds 
Filojoes: folds 
cn_chayanne: raises $1.50 to $2.50
petalouda10: calls $2.50
mycka86: folds 
DeWeijz: folds 
matiko09: folds 
*** FLOP *** [Jc 2h Jd]
cn_chayanne: checks 
petalouda10: checks 
*** TURN *** [Jc 2h Jd] [As]
cn_chayanne: checks 
petalouda10: checks 
*** RIVER *** [Jc 2h Jd As] [9c]
cn_chayanne: bets $4.66
petalouda10: calls $4.66
*** SHOW DOWN ***
cn_chayanne: shows [Ah Th] (two pair, Aces and Jacks)
petalouda10: mucks hand 
cn_chayanne collected $15.11 from pot
*** SUMMARY ***
Total pot $15.82 | Rake $0.71 
Board [Jc 2h Jd As 9c]
Seat 2: cn_chayanne showed [Ah Th] and won ($15.11) with two pair, Aces and Jacks
Seat 3: petalouda10 mucked [9h Ad]
Seat 4: mycka86 (button) folded before Flop (didn't bet)
Seat 5: DeWeijz (small blind) folded before Flop
Seat 6: matiko09 (big blind) folded before Flop
Seat 7: KLOP06031987 folded before Flop (didn't bet)
Seat 8: Filojoes folded before Flop (didn't bet)





PokerStars Hand #147708281955:  Hold'em No Limit ($0.50/$1.00 USD) - 2016/01/26 16:15:26 CET [2016/01/26 10:15:26 ET]
Table 'Vincentina' 9-max Seat #2 is the button
Seat 1: cn_chayanne ($101 in chips) 
Seat 2: simoniustin ($100 in chips) 
Seat 3: Mukhin1 ($100 in chips) 
Seat 4: Dödi123 ($100 in chips) 
Seat 5: solbi86 ($101.50 in chips) 
Seat 6: Sweden_Pound ($100 in chips) 
Seat 7: sebaaastian ($106.03 in chips) 
Seat 9: matiko09 ($101.50 in chips) 
Mukhin1: posts small blind $0.50
Dödi123: posts big blind $1
*** HOLE CARDS ***
Dealt to matiko09 [7d 6c]
solbi86: folds 
Sweden_Pound: folds 
sebaaastian: folds 
matiko09: folds 
cn_chayanne: raises $1.50 to $2.50
simoniustin: folds 
Mukhin1: folds 
Dödi123: folds 
Uncalled bet ($1.50) returned to cn_chayanne
cn_chayanne collected $2.50 from pot
cn_chayanne: doesn't show hand 
*** SUMMARY ***
Total pot $2.50 | Rake $0 
Seat 1: cn_chayanne collected ($2.50)
Seat 2: simoniustin (button) folded before Flop (didn't bet)
Seat 3: Mukhin1 (small blind) folded before Flop
Seat 4: Dödi123 (big blind) folded before Flop
Seat 5: solbi86 folded before Flop (didn't bet)
Seat 6: Sweden_Pound folded before Flop (didn't bet)
Seat 7: sebaaastian folded before Flop (didn't bet)
Seat 9: matiko09 folded before Flop (didn't bet)





PokerStars Hand #147708283058:  Hold'em No Limit ($0.50/$1.00 USD) - 2016/01/26 16:15:27 CET [2016/01/26 10:15:27 ET]
Table 'Calypso II' 9-max Seat #3 is the button
Seat 1: KLOP06031987 ($100 in chips) 
Seat 3: matiko09 ($238.43 in chips) 
Seat 5: mycka86 ($114 in chips) 
Seat 6: MrDeeee25 ($112.91 in chips) 
Seat 7: Jimy Tiltman ($101.50 in chips) 
Seat 8: Reven9er ($100 in chips) 
Seat 9: Filojoes ($143.61 in chips) 
Kukuryzka will be allowed to play after the button
mycka86: posts small blind $0.50
MrDeeee25: posts big blind $1
*** HOLE CARDS ***
Dealt to matiko09 [4h 2s]
simoniustin joins the table at seat #2 
Jimy Tiltman: folds 
Reven9er: folds 
Jimy Tiltman leaves the table
Filojoes: folds 
KLOP06031987: folds 
Tasvision_mö joins the table at seat #7 
matiko09: folds 
mycka86: folds 
Uncalled bet ($0.50) returned to MrDeeee25
MrDeeee25 collected $1 from pot
*** SUMMARY ***
Total pot $1 | Rake $0 
Seat 1: KLOP06031987 folded before Flop (didn't bet)
Seat 3: matiko09 (button) folded before Flop (didn't bet)
Seat 5: mycka86 (small blind) folded before Flop
Seat 6: MrDeeee25 (big blind) collected ($1)
Seat 7: Jimy Tiltman folded before Flop (didn't bet)
Seat 8: Reven9er folded before Flop (didn't bet)
Seat 9: Filojoes folded before Flop (didn't bet)





PokerStars Hand #147708289597:  Hold'em No Limit ($0.50/$1.00 USD) - 2016/01/26 16:15:36 CET [2016/01/26 10:15:36 ET]
Table 'Impala' 9-max Seat #5 is the button
Seat 1: mycka86 ($145.94 in chips) 
Seat 2: Filojoes ($100 in chips) 
Seat 4: Rikti ($92.26 in chips) 
Seat 5: Kukuryzka ($100 in chips) 
Seat 6: Tijger R.d.J ($104.51 in chips) 
Seat 7: matiko09 ($114.74 in chips) 
Seat 8: apfush ($100 in chips) 
Seat 9: flozzi ($105.07 in chips) 
Tijger R.d.J: posts small blind $0.50
matiko09: posts big blind $1
simoniustin: sits out 
*** HOLE CARDS ***
Dealt to matiko09 [5d Th]
apfush: raises $2 to $3
flozzi: folds 
mycka86: folds 
Filojoes: folds 
Rikti: folds 
Kukuryzka: folds 
Tijger R.d.J: calls $2.50
matiko09: folds 
*** FLOP *** [4c Qs 9c]
Tijger R.d.J: checks 
apfush: bets $4.50
Tijger R.d.J: calls $4.50
*** TURN *** [4c Qs 9c] [Kd]
Tijger R.d.J: checks 
apfush: checks 
*** RIVER *** [4c Qs 9c Kd] [Ks]
Tijger R.d.J: bets $9
apfush: folds 
Uncalled bet ($9) returned to Tijger R.d.J
Tijger R.d.J collected $15.28 from pot
Tijger R.d.J: doesn't show hand 
*** SUMMARY ***
Total pot $16 | Rake $0.72 
Board [4c Qs 9c Kd Ks]
Seat 1: mycka86 folded before Flop (didn't bet)
Seat 2: Filojoes folded before Flop (didn't bet)
Seat 4: Rikti folded before Flop (didn't bet)
Seat 5: Kukuryzka (button) folded before Flop (didn't bet)
Seat 6: Tijger R.d.J (small blind) collected ($15.28)
Seat 7: matiko09 (big blind) folded before Flop
Seat 8: apfush folded on the River
Seat 9: flozzi folded before Flop (didn't bet)





PokerStars Hand #147708299718:  Hold'em No Limit ($0.50/$1.00 USD) - 2016/01/26 16:15:49 CET [2016/01/26 10:15:49 ET]
Table 'Srbija III' 9-max Seat #8 is the button
Seat 1: simoniustin ($100 in chips) 
Seat 2: cn_chayanne ($103 in chips) 
Seat 3: LIGOPSIXIS78 ($67.67 in chips) 
Seat 4: petalouda10 ($82.38 in chips) 
Seat 5: mycka86 ($100 in chips) 
Seat 6: matiko09 ($213.76 in chips) 
Seat 7: KLOP06031987 ($111.44 in chips) 
Seat 8: solbi86 ($100.69 in chips) 
simoniustin: posts small blind $0.50
cn_chayanne: posts big blind $1
*** HOLE CARDS ***
Dealt to matiko09 [3h Td]
LIGOPSIXIS78: raises $1 to $2
petalouda10: folds 
mycka86: folds 
matiko09: folds 
KLOP06031987: folds 
solbi86: folds 
simoniustin: folds 
cn_chayanne: folds 
Uncalled bet ($1) returned to LIGOPSIXIS78
LIGOPSIXIS78 collected $2.50 from pot
LIGOPSIXIS78: doesn't show hand 
*** SUMMARY ***
Total pot $2.50 | Rake $0 
Seat 1: simoniustin (small blind) folded before Flop
Seat 2: cn_chayanne (big blind) folded before Flop
Seat 3: LIGOPSIXIS78 collected ($2.50)
Seat 4: petalouda10 folded before Flop (didn't bet)
Seat 5: mycka86 folded before Flop (didn't bet)
Seat 6: matiko09 folded before Flop (didn't bet)
Seat 7: KLOP06031987 folded before Flop (didn't bet)
Seat 8: solbi86 (button) folded before Flop (didn't bet)





PokerStars Hand #147708302793:  Hold'em No Limit ($0.50/$1.00 USD) - 2016/01/26 16:15:53 CET [2016/01/26 10:15:53 ET]
Table 'Mashona' 9-max Seat #3 is the button
Seat 1: maxxmeister ($124.40 in chips) 
Seat 2: werades ($217.38 in chips) 
Seat 3: matiko09 ($127.31 in chips) 
Seat 4: mycka86 ($100 in chips) 
Seat 5: solbi86 ($127.13 in chips) 
Seat 6: Filojoes ($100 in chips) 
Seat 7: EB0LARAMA ($305.24 in chips) 
Seat 8: Jimy Tiltman ($157.16 in chips) 
Seat 9: apfush ($105.57 in chips) 
mycka86: posts small blind $0.50
solbi86: posts big blind $1
*** HOLE CARDS ***
Dealt to matiko09 [2h 5h]
Filojoes: folds 
EB0LARAMA: folds 
Jimy Tiltman: folds 
apfush: folds 
maxxmeister: folds 
werades: raises $1.50 to $2.50
matiko09: folds 
mycka86: folds 
solbi86: calls $1.50
*** FLOP *** [4c 5s 7h]
solbi86: checks 
werades: checks 
*** TURN *** [4c 5s 7h] [Jc]
solbi86: bets $2.99
werades: folds 
Uncalled bet ($2.99) returned to solbi86
solbi86 collected $5.25 from pot
solbi86: doesn't show hand 
*** SUMMARY ***
Total pot $5.50 | Rake $0.25 
Board [4c 5s 7h Jc]
Seat 1: maxxmeister folded before Flop (didn't bet)
Seat 2: werades folded on the Turn
Seat 3: matiko09 (button) folded before Flop (didn't bet)
Seat 4: mycka86 (small blind) folded before Flop
Seat 5: solbi86 (big blind) collected ($5.25)
Seat 6: Filojoes folded before Flop (didn't bet)
Seat 7: EB0LARAMA folded before Flop (didn't bet)
Seat 8: Jimy Tiltman folded before Flop (didn't bet)
Seat 9: apfush folded before Flop (didn't bet)





PokerStars Hand #147708303447:  Hold'em No Limit ($0.50/$1.00 USD) - 2016/01/26 16:15:54 CET [2016/01/26 10:15:54 ET]
Table 'Vincentina' 9-max Seat #3 is the button
Seat 1: cn_chayanne ($102.50 in chips) 
Seat 2: simoniustin ($100 in chips) 
Seat 3: Mukhin1 ($100 in chips) 
Seat 4: Dödi123 ($100 in chips) 
Seat 5: solbi86 ($101.50 in chips) 
Seat 6: Sweden_Pound ($100 in chips) 
Seat 7: sebaaastian ($106.03 in chips) 
Seat 9: matiko09 ($101.50 in chips) 
Dödi123: posts small blind $0.50
solbi86: posts big blind $1
*** HOLE CARDS ***
Dealt to matiko09 [8s Kh]
Sweden_Pound: folds 
Sweden_Pound leaves the table
sebaaastian: folds 
matiko09: folds 
cn_chayanne: folds 
simoniustin: folds 
Mukhin1: folds 
Dödi123: folds 
Uncalled bet ($0.50) returned to solbi86
solbi86 collected $1 from pot
solbi86: doesn't show hand 
*** SUMMARY ***
Total pot $1 | Rake $0 
Seat 1: cn_chayanne folded before Flop (didn't bet)
Seat 2: simoniustin folded before Flop (didn't bet)
Seat 3: Mukhin1 (button) folded before Flop (didn't bet)
Seat 4: Dödi123 (small blind) folded before Flop
Seat 5: solbi86 (big blind) collected ($1)
Seat 6: Sweden_Pound folded before Flop (didn't bet)
Seat 7: sebaaastian folded before Flop (didn't bet)
Seat 9: matiko09 folded before Flop (didn't bet)





PokerStars Hand #147708304370:  Hold'em No Limit ($0.50/$1.00 USD) - 2016/01/26 16:15:55 CET [2016/01/26 10:15:55 ET]
Table 'Aten II' 9-max Seat #5 is the button
Seat 1: cn_chayanne ($114.66 in chips) 
Seat 2: solbi86 ($125.19 in chips) 
Seat 3: ilaviiitech ($100 in chips) 
Seat 4: matiko09 ($102.75 in chips) 
Seat 5: sebaaastian ($107.33 in chips) 
Seat 6: ooohaaah ($78.25 in chips) 
Seat 7: Legioner721 ($26.39 in chips) 
Seat 9: TorontoBum ($119.85 in chips) 
ooohaaah: posts small blind $0.50
Legioner721: posts big blind $1
*** HOLE CARDS ***
Dealt to matiko09 [2s Js]
TorontoBum: folds 
cn_chayanne: folds 
solbi86: folds 
ilaviiitech: folds 
matiko09: folds 
sebaaastian: raises $1.50 to $2.50
ooohaaah: folds 
Legioner721: calls $1.50
*** FLOP *** [Jd 4d 8h]
Legioner721: checks 
sebaaastian: checks 
*** TURN *** [Jd 4d 8h] [5d]
Legioner721: bets $1
sebaaastian: folds 
Uncalled bet ($1) returned to Legioner721
Legioner721 collected $5.25 from pot
*** SUMMARY ***
Total pot $5.50 | Rake $0.25 
Board [Jd 4d 8h 5d]
Seat 1: cn_chayanne folded before Flop (didn't bet)
Seat 2: solbi86 folded before Flop (didn't bet)
Seat 3: ilaviiitech folded before Flop (didn't bet)
Seat 4: matiko09 folded before Flop (didn't bet)
Seat 5: sebaaastian (button) folded on the Turn
Seat 6: ooohaaah (small blind) folded before Flop
Seat 7: Legioner721 (big blind) collected ($5.25)
Seat 9: TorontoBum folded before Flop (didn't bet)





PokerStars Hand #147708313960:  Hold'em No Limit ($0.50/$1.00 USD) - 2016/01/26 16:16:08 CET [2016/01/26 10:16:08 ET]
Table 'Medusa III' 9-max Seat #4 is the button
Seat 2: happydrake ($99.95 in chips) 
Seat 3: mycka86 ($104.48 in chips) 
Seat 4: simoniustin ($100 in chips) 
Seat 5: matiko09 ($249.13 in chips) 
Seat 6: aseban11 ($100 in chips) 
Seat 7: Reven9er ($164.46 in chips) 
Seat 8: Filojoes ($133.70 in chips) 
Seat 9: sebaaastian ($100 in chips) 
matiko09: posts small blind $0.50
aseban11: posts big blind $1
*** HOLE CARDS ***
Dealt to matiko09 [4d Th]
Reven9er: folds 
Filojoes: raises $2 to $3
sebaaastian: calls $3
happydrake: folds 
mycka86: folds 
simoniustin: folds 
matiko09: folds 
aseban11: calls $2
*** FLOP *** [6h 4c 7s]
aseban11: checks 
Filojoes: checks 
sebaaastian: bets $5
aseban11: raises $14.30 to $19.30
Filojoes: folds 
sebaaastian: folds 
Uncalled bet ($14.30) returned to aseban11
aseban11 collected $18.62 from pot
aseban11: doesn't show hand 
*** SUMMARY ***
Total pot $19.50 | Rake $0.88 
Board [6h 4c 7s]
Seat 2: happydrake folded before Flop (didn't bet)
Seat 3: mycka86 folded before Flop (didn't bet)
Seat 4: simoniustin (button) folded before Flop (didn't bet)
Seat 5: matiko09 (small blind) folded before Flop
Seat 6: aseban11 (big blind) collected ($18.62)
Seat 7: Reven9er folded before Flop (didn't bet)
Seat 8: Filojoes folded on the Flop
Seat 9: sebaaastian folded on the Flop





PokerStars Hand #147708313463:  Hold'em No Limit ($0.50/$1.00 USD) - 2016/01/26 16:16:08 CET [2016/01/26 10:16:08 ET]
Table 'Volga III' 9-max Seat #8 is the button
Seat 1: CI58 ($117.81 in chips) 
Seat 2: KLOP06031987 ($100 in chips) 
Seat 3: Kukuryzka ($100 in chips) 
Seat 4: mycka86 ($104.13 in chips) 
Seat 6: Jimy Tiltman ($100 in chips) 
Seat 8: cn_chayanne ($145.25 in chips) 
Seat 9: matiko09 ($104.75 in chips) 
matiko09: posts small blind $0.50
CI58: posts big blind $1
*** HOLE CARDS ***
Dealt to matiko09 [9h 7c]
KLOP06031987: folds 
veno79 leaves the table
Kukuryzka: folds 
Filojoes joins the table at seat #5 
mycka86: folds 
Jimy Tiltman: folds 
Filojoes leaves the table
cn_chayanne: folds 
matiko09: folds 
Uncalled bet ($0.50) returned to CI58
CI58 collected $1 from pot
CI58: doesn't show hand 
*** SUMMARY ***
Total pot $1 | Rake $0 
Seat 1: CI58 (big blind) collected ($1)
Seat 2: KLOP06031987 folded before Flop (didn't bet)
Seat 3: Kukuryzka folded before Flop (didn't bet)
Seat 4: mycka86 folded before Flop (didn't bet)
Seat 6: Jimy Tiltman folded before Flop (didn't bet)
Seat 8: cn_chayanne (button) folded before Flop (didn't bet)
Seat 9: matiko09 (small blind) folded before Flop





PokerStars Hand #147708314236:  Hold'em No Limit ($0.50/$1.00 USD) - 2016/01/26 16:16:09 CET [2016/01/26 10:16:09 ET]
Table 'Kale II' 9-max Seat #2 is the button
Seat 2: matiko09 ($104.63 in chips) 
Seat 3: Reven9er ($133.92 in chips) 
Seat 6: simoniustin ($100 in chips) 
Seat 7: MILLIONCHIC ($68.79 in chips) 
Seat 8: mycka86 ($122.86 in chips) 
Seat 9: solbi86 ($197.05 in chips) 
aseban11 joins the table at seat #4 
Reven9er: posts small blind $0.50
simoniustin: posts big blind $1
*** HOLE CARDS ***
Dealt to matiko09 [Qd 2s]
MILLIONCHIC: folds 
mycka86: folds 
solbi86: folds 
matiko09: folds 
Reven9er: folds 
Uncalled bet ($0.50) returned to simoniustin
simoniustin collected $1 from pot
simoniustin: doesn't show hand 
*** SUMMARY ***
Total pot $1 | Rake $0 
Seat 2: matiko09 (button) folded before Flop (didn't bet)
Seat 3: Reven9er (small blind) folded before Flop
Seat 6: simoniustin (big blind) collected ($1)
Seat 7: MILLIONCHIC folded before Flop (didn't bet)
Seat 8: mycka86 folded before Flop (didn't bet)
Seat 9: solbi86 folded before Flop (didn't bet)





PokerStars Hand #147708316097:  Hold'em No Limit ($0.50/$1.00 USD) - 2016/01/26 16:16:11 CET [2016/01/26 10:16:11 ET]
Table 'Calypso II' 9-max Seat #5 is the button
Seat 1: KLOP06031987 ($100 in chips) 
Seat 3: matiko09 ($238.43 in chips) 
Seat 5: mycka86 ($113.50 in chips) 
Seat 6: MrDeeee25 ($113.41 in chips) 
Seat 7: Tasvision_mö ($40 in chips) 
Seat 8: Reven9er ($100 in chips) 
Seat 9: Filojoes ($143.61 in chips) 
MrDeeee25: posts small blind $0.50
Tasvision_mö: posts big blind $1
simoniustin: sits out 
Kukuryzka: sits out 
*** HOLE CARDS ***
Dealt to matiko09 [2c 8d]
Reven9er: raises $1 to $2
Filojoes: folds 
KLOP06031987: folds 
matiko09: folds 
mycka86: folds 
MrDeeee25: folds 
Tasvision_mö: folds 
Uncalled bet ($1) returned to Reven9er
Reven9er collected $2.50 from pot
Reven9er: doesn't show hand 
*** SUMMARY ***
Total pot $2.50 | Rake $0 
Seat 1: KLOP06031987 folded before Flop (didn't bet)
Seat 3: matiko09 folded before Flop (didn't bet)
Seat 5: mycka86 (button) folded before Flop (didn't bet)
Seat 6: MrDeeee25 (small blind) folded before Flop
Seat 7: Tasvision_mö (big blind) folded before Flop
Seat 8: Reven9er collected ($2.50)
Seat 9: Filojoes folded before Flop (didn't bet)





PokerStars Hand #147708324367:  Hold'em No Limit ($0.50/$1.00 USD) - 2016/01/26 16:16:22 CET [2016/01/26 10:16:22 ET]
Table 'Haedus' 9-max Seat #9 is the button
Seat 1: matiko09 ($100.50 in chips) 
Seat 3: cn_chayanne ($101.50 in chips) 
Seat 4: timur3-5-7 ($81.64 in chips) 
Seat 5: solbi86 ($120.08 in chips) 
Seat 6: nnne409 ($71.44 in chips) 
Seat 7: KLOP06031987 ($106 in chips) 
Seat 8: Jimy Tiltman ($106.24 in chips) 
Seat 9: Filojoes ($134.69 in chips) 
matiko09: posts small blind $0.50
cn_chayanne: posts big blind $1
*** HOLE CARDS ***
Dealt to matiko09 [6h 8h]
timur3-5-7: folds 
solbi86: folds 
nnne409: folds 
KLOP06031987: folds 
Jimy Tiltman: folds 
Filojoes: raises $1 to $2
matiko09: folds 
cn_chayanne: calls $1
*** FLOP *** [2h As 9c]
cn_chayanne: checks 
Filojoes: bets $2.58
cn_chayanne: folds 
Uncalled bet ($2.58) returned to Filojoes
Filojoes collected $4.30 from pot
Filojoes: doesn't show hand 
*** SUMMARY ***
Total pot $4.50 | Rake $0.20 
Board [2h As 9c]
Seat 1: matiko09 (small blind) folded before Flop
Seat 3: cn_chayanne (big blind) folded on the Flop
Seat 4: timur3-5-7 folded before Flop (didn't bet)
Seat 5: solbi86 folded before Flop (didn't bet)
Seat 6: nnne409 folded before Flop (didn't bet)
Seat 7: KLOP06031987 folded before Flop (didn't bet)
Seat 8: Jimy Tiltman folded before Flop (didn't bet)
Seat 9: Filojoes (button) collected ($4.30)





PokerStars Hand #147708324320:  Hold'em No Limit ($0.50/$1.00 USD) - 2016/01/26 16:16:22 CET [2016/01/26 10:16:22 ET]
Table 'Kale II' 9-max Seat #3 is the button
Seat 2: matiko09 ($104.63 in chips) 
Seat 3: Reven9er ($133.42 in chips) 
Seat 6: simoniustin ($100.50 in chips) 
Seat 7: MILLIONCHIC ($68.79 in chips) 
Seat 8: mycka86 ($122.86 in chips) 
Seat 9: solbi86 ($197.05 in chips) 
aseban11 will be allowed to play after the button
simoniustin: posts small blind $0.50
MILLIONCHIC: posts big blind $1
*** HOLE CARDS ***
Dealt to matiko09 [4c Qd]
mycka86: folds 
solbi86: folds 
matiko09: folds 
Reven9er: raises $1 to $2
simoniustin: folds 
MILLIONCHIC: calls $1
*** FLOP *** [Qs 4s 9s]
MILLIONCHIC: checks 
Reven9er: checks 
*** TURN *** [Qs 4s 9s] [9d]
MILLIONCHIC: checks 
Reven9er: checks 
*** RIVER *** [Qs 4s 9s 9d] [Td]
MILLIONCHIC: checks 
Reven9er: bets $1.50
MILLIONCHIC: folds 
Uncalled bet ($1.50) returned to Reven9er
Reven9er collected $4.30 from pot
Reven9er: doesn't show hand 
*** SUMMARY ***
Total pot $4.50 | Rake $0.20 
Board [Qs 4s 9s 9d Td]
Seat 2: matiko09 folded before Flop (didn't bet)
Seat 3: Reven9er (button) collected ($4.30)
Seat 6: simoniustin (small blind) folded before Flop
Seat 7: MILLIONCHIC (big blind) folded on the River
Seat 8: mycka86 folded before Flop (didn't bet)
Seat 9: solbi86 folded before Flop (didn't bet)





PokerStars Hand #147708325822:  Hold'em No Limit ($0.50/$1.00 USD) - 2016/01/26 16:16:24 CET [2016/01/26 10:16:24 ET]
Table 'Srbija III' 9-max Seat #1 is the button
Seat 1: simoniustin ($100 in chips) 
Seat 2: cn_chayanne ($102 in chips) 
Seat 3: LIGOPSIXIS78 ($69.17 in chips) 
Seat 4: petalouda10 ($82.38 in chips) 
Seat 5: mycka86 ($100 in chips) 
Seat 6: matiko09 ($213.76 in chips) 
Seat 7: KLOP06031987 ($111.44 in chips) 
Seat 8: solbi86 ($100.69 in chips) 
cn_chayanne: posts small blind $0.50
LIGOPSIXIS78: posts big blind $1
*** HOLE CARDS ***
Dealt to matiko09 [4d Ac]
petalouda10: folds 
mycka86: folds 
matiko09: folds 
KLOP06031987: folds 
solbi86: folds 
simoniustin: raises $1.50 to $2.50
cn_chayanne: calls $2
LIGOPSIXIS78: folds 
*** FLOP *** [4s 2d Qs]
cn_chayanne: checks 
simoniustin: bets $4
cn_chayanne: folds 
Uncalled bet ($4) returned to simoniustin
simoniustin collected $5.73 from pot
simoniustin: doesn't show hand 
*** SUMMARY ***
Total pot $6 | Rake $0.27 
Board [4s 2d Qs]
Seat 1: simoniustin (button) collected ($5.73)
Seat 2: cn_chayanne (small blind) folded on the Flop
Seat 3: LIGOPSIXIS78 (big blind) folded before Flop
Seat 4: petalouda10 folded before Flop (didn't bet)
Seat 5: mycka86 folded before Flop (didn't bet)
Seat 6: matiko09 folded before Flop (didn't bet)
Seat 7: KLOP06031987 folded before Flop (didn't bet)
Seat 8: solbi86 folded before Flop (didn't bet)





PokerStars Hand #147708329611:  Hold'em No Limit ($0.50/$1.00 USD) - 2016/01/26 16:16:29 CET [2016/01/26 10:16:29 ET]
Table 'Strenua III' 9-max Seat #5 is the button
Seat 2: cn_chayanne ($159.70 in chips) 
Seat 3: petalouda10 ($44.17 in chips) 
Seat 4: mycka86 ($128.86 in chips) 
Seat 5: DeWeijz ($41.07 in chips) 
Seat 6: matiko09 ($130.55 in chips) 
Seat 7: KLOP06031987 ($102.48 in chips) 
Seat 8: Filojoes ($104.19 in chips) 
matiko09: posts small blind $0.50
KLOP06031987: posts big blind $1
maxxmeister: sits out 
Rikti: sits out 
*** HOLE CARDS ***
Dealt to matiko09 [6d 6s]
Filojoes: folds 
cn_chayanne: folds 
petalouda10: calls $1
mycka86: raises $3.50 to $4.50
DeWeijz: folds 
matiko09: calls $4
KLOP06031987: folds 
petalouda10: calls $3.50
*** FLOP *** [8s 9h 7h]
matiko09: checks 
petalouda10: checks 
mycka86: checks 
*** TURN *** [8s 9h 7h] [4s]
matiko09: checks 
petalouda10: bets $7
mycka86: calls $7
matiko09: folds 
*** RIVER *** [8s 9h 7h 4s] [Ts]
petalouda10: bets $7
mycka86: folds 
Uncalled bet ($7) returned to petalouda10
petalouda10 collected $27.22 from pot
petalouda10: doesn't show hand 
*** SUMMARY ***
Total pot $28.50 | Rake $1.28 
Board [8s 9h 7h 4s Ts]
Seat 2: cn_chayanne folded before Flop (didn't bet)
Seat 3: petalouda10 collected ($27.22)
Seat 4: mycka86 folded on the River
Seat 5: DeWeijz (button) folded before Flop (didn't bet)
Seat 6: matiko09 (small blind) folded on the Turn
Seat 7: KLOP06031987 (big blind) folded before Flop
Seat 8: Filojoes folded before Flop (didn't bet)





PokerStars Hand #147708329813:  Hold'em No Limit ($0.50/$1.00 USD) - 2016/01/26 16:16:29 CET [2016/01/26 10:16:29 ET]
Table 'Volga III' 9-max Seat #9 is the button
Seat 1: CI58 ($118.31 in chips) 
Seat 4: mycka86 ($104.13 in chips) 
Seat 6: Jimy Tiltman ($100 in chips) 
Seat 8: cn_chayanne ($145.25 in chips) 
Seat 9: matiko09 ($104.25 in chips) 
CI58: posts small blind $0.50
KLOP06031987: is sitting out 
Kukuryzka: is sitting out 
mycka86: posts big blind $1
*** HOLE CARDS ***
Dealt to matiko09 [6h As]
KLOP06031987 leaves the table
Kukuryzka leaves the table
simoniustin joins the table at seat #5 
Jimy Tiltman: folds 
Jimy Tiltman leaves the table
aseban11 joins the table at seat #6 
aseban11 leaves the table
cn_chayanne: folds 
matiko09: raises $1.27 to $2.27
CI58: folds 
mycka86: folds 
Uncalled bet ($1.27) returned to matiko09
matiko09 collected $2.50 from pot
matiko09: doesn't show hand 
*** SUMMARY ***
Total pot $2.50 | Rake $0 
Seat 1: CI58 (small blind) folded before Flop
Seat 4: mycka86 (big blind) folded before Flop
Seat 6: Jimy Tiltman folded before Flop (didn't bet)
Seat 8: cn_chayanne folded before Flop (didn't bet)
Seat 9: matiko09 (button) collected ($2.50)





PokerStars Hand #147708340722:  Hold'em No Limit ($0.50/$1.00 USD) - 2016/01/26 16:16:44 CET [2016/01/26 10:16:44 ET]
Table 'Calypso II' 9-max Seat #6 is the button
Seat 1: KLOP06031987 ($100 in chips) 
Seat 3: matiko09 ($238.43 in chips) 
Seat 5: mycka86 ($113.50 in chips) 
Seat 6: MrDeeee25 ($112.91 in chips) 
Seat 7: Tasvision_mö ($39 in chips) 
Seat 8: Reven9er ($101.50 in chips) 
Seat 9: Filojoes ($143.61 in chips) 
Tasvision_mö: posts small blind $0.50
Reven9er: posts big blind $1
simoniustin: sits out 
Kukuryzka: sits out 
*** HOLE CARDS ***
Dealt to matiko09 [5h 7c]
Filojoes: folds 
KLOP06031987: raises $1.31 to $2.31
matiko09: folds 
mycka86: folds 
MrDeeee25: folds 
Tasvision_mö: calls $1.81
Reven9er: calls $1.31
*** FLOP *** [Qs 8d Jh]
Tasvision_mö: checks 
Reven9er: checks 
KLOP06031987: checks 
*** TURN *** [Qs 8d Jh] [Tc]
Tasvision_mö: bets $5
Reven9er: folds 
KLOP06031987: folds 
Uncalled bet ($5) returned to Tasvision_mö
Tasvision_mö collected $6.62 from pot
Tasvision_mö: doesn't show hand 
*** SUMMARY ***
Total pot $6.93 | Rake $0.31 
Board [Qs 8d Jh Tc]
Seat 1: KLOP06031987 folded on the Turn
Seat 3: matiko09 folded before Flop (didn't bet)
Seat 5: mycka86 folded before Flop (didn't bet)
Seat 6: MrDeeee25 (button) folded before Flop (didn't bet)
Seat 7: Tasvision_mö (small blind) collected ($6.62)
Seat 8: Reven9er (big blind) folded on the Turn
Seat 9: Filojoes folded before Flop (didn't bet)





PokerStars Hand #147708346937:  Hold'em No Limit ($0.50/$1.00 USD) - 2016/01/26 16:16:52 CET [2016/01/26 10:16:52 ET]
Table 'Aten II' 9-max Seat #6 is the button
Seat 1: cn_chayanne ($114.66 in chips) 
Seat 2: solbi86 ($125.19 in chips) 
Seat 3: ilaviiitech ($100 in chips) 
Seat 4: matiko09 ($102.75 in chips) 
Seat 5: sebaaastian ($104.83 in chips) 
Seat 6: ooohaaah ($77.75 in chips) 
Seat 7: Legioner721 ($29.14 in chips) 
Seat 8: KLOP06031987 ($100 in chips) 
Seat 9: TorontoBum ($119.85 in chips) 
Legioner721: posts small blind $0.50
KLOP06031987: posts big blind $1
*** HOLE CARDS ***
Dealt to matiko09 [Jh 4s]
TorontoBum: folds 
cn_chayanne: folds 
solbi86: folds 
ilaviiitech: raises $2 to $3
matiko09: folds 
sebaaastian: folds 
ooohaaah: folds 
Legioner721: calls $2.50
KLOP06031987: folds 
*** FLOP *** [Ks 2d 5c]
Legioner721: checks 
ilaviiitech: checks 
*** TURN *** [Ks 2d 5c] [4h]
Legioner721: checks 
ilaviiitech: checks 
*** RIVER *** [Ks 2d 5c 4h] [8h]
Legioner721: checks 
ilaviiitech: checks 
*** SHOW DOWN ***
Legioner721: shows [Qc 3s] (high card King)
ilaviiitech: shows [As Ts] (high card Ace)
ilaviiitech collected $6.68 from pot
*** SUMMARY ***
Total pot $7 | Rake $0.32 
Board [Ks 2d 5c 4h 8h]
Seat 1: cn_chayanne folded before Flop (didn't bet)
Seat 2: solbi86 folded before Flop (didn't bet)
Seat 3: ilaviiitech showed [As Ts] and won ($6.68) with high card Ace
Seat 4: matiko09 folded before Flop (didn't bet)
Seat 5: sebaaastian folded before Flop (didn't bet)
Seat 6: ooohaaah (button) folded before Flop (didn't bet)
Seat 7: Legioner721 (small blind) showed [Qc 3s] and lost with high card King
Seat 8: KLOP06031987 (big blind) folded before Flop
Seat 9: TorontoBum folded before Flop (didn't bet)





PokerStars Hand #147708352504:  Hold'em No Limit ($0.50/$1.00 USD) - 2016/01/26 16:16:59 CET [2016/01/26 10:16:59 ET]
Table 'Achates III' 9-max Seat #5 is the button
Seat 2: matiko09 ($126.70 in chips) 
Seat 3: Jimy Tiltman ($103.27 in chips) 
Seat 4: cn_chayanne ($100 in chips) 
Seat 5: simoniustin ($100 in chips) 
Seat 6: solbi86 ($114.97 in chips) 
Seat 7: 1989freak ($101.39 in chips) 
Seat 8: easycomengo ($115.04 in chips) 
Seat 9: T-chaos_IMBA ($321.14 in chips) 
solbi86: posts small blind $0.50
1989freak: posts big blind $1
*** HOLE CARDS ***
Dealt to matiko09 [5d Jd]
easycomengo: folds 
T-chaos_IMBA: folds 
matiko09: folds 
Jimy Tiltman: folds 
cn_chayanne: folds 
simoniustin: folds 
solbi86: folds 
Uncalled bet ($0.50) returned to 1989freak
1989freak collected $1 from pot
1989freak: doesn't show hand 
*** SUMMARY ***
Total pot $1 | Rake $0 
Seat 2: matiko09 folded before Flop (didn't bet)
Seat 3: Jimy Tiltman folded before Flop (didn't bet)
Seat 4: cn_chayanne folded before Flop (didn't bet)
Seat 5: simoniustin (button) folded before Flop (didn't bet)
Seat 6: solbi86 (small blind) folded before Flop
Seat 7: 1989freak (big blind) collected ($1)
Seat 8: easycomengo folded before Flop (didn't bet)
Seat 9: T-chaos_IMBA folded before Flop (didn't bet)





PokerStars Hand #147708354449:  Hold'em No Limit ($0.50/$1.00 USD) - 2016/01/26 16:17:02 CET [2016/01/26 10:17:02 ET]
Table 'Mashona' 9-max Seat #4 is the button
Seat 1: maxxmeister ($124.40 in chips) 
Seat 2: werades ($214.88 in chips) 
Seat 3: matiko09 ($127.31 in chips) 
Seat 4: mycka86 ($100 in chips) 
Seat 5: solbi86 ($129.88 in chips) 
Seat 6: Filojoes ($100 in chips) 
Seat 7: EB0LARAMA ($305.24 in chips) 
Seat 8: Jimy Tiltman ($157.16 in chips) 
Seat 9: apfush ($105.57 in chips) 
solbi86: posts small blind $0.50
Filojoes: posts big blind $1
*** HOLE CARDS ***
Dealt to matiko09 [3d 2s]
EB0LARAMA: folds 
Jimy Tiltman: folds 
apfush: folds 
maxxmeister: raises $2.50 to $3.50
werades: folds 
matiko09: folds 
mycka86: folds 
solbi86: folds 
Filojoes: folds 
Uncalled bet ($2.50) returned to maxxmeister
maxxmeister collected $2.50 from pot
maxxmeister: doesn't show hand 
*** SUMMARY ***
Total pot $2.50 | Rake $0 
Seat 1: maxxmeister collected ($2.50)
Seat 2: werades folded before Flop (didn't bet)
Seat 3: matiko09 folded before Flop (didn't bet)
Seat 4: mycka86 (button) folded before Flop (didn't bet)
Seat 5: solbi86 (small blind) folded before Flop
Seat 6: Filojoes (big blind) folded before Flop
Seat 7: EB0LARAMA folded before Flop (didn't bet)
Seat 8: Jimy Tiltman folded before Flop (didn't bet)
Seat 9: apfush folded before Flop (didn't bet)





PokerStars Hand #147708359761:  Hold'em No Limit ($0.50/$1.00 USD) - 2016/01/26 16:17:09 CET [2016/01/26 10:17:09 ET]
Table 'Montefiore' 9-max Seat #6 is the button
Seat 1: Celsinho0311 ($83.37 in chips) 
Seat 3: Filojoes ($100 in chips) 
Seat 4: matiko09 ($100 in chips) 
Seat 5: ilaviiitech ($101.50 in chips) 
Seat 6: FroggyPlay ($100 in chips) 
Seat 7: mycka86 ($100.50 in chips) 
Seat 8: Kukuryzka ($100 in chips) 
Seat 9: KLOP06031987 ($101.50 in chips) 
mycka86: posts small blind $0.50
Kukuryzka: posts big blind $1
D†est7oye†R: sits out 
*** HOLE CARDS ***
Dealt to matiko09 [6d Ad]
KLOP06031987: folds 
Celsinho0311: folds 
Filojoes: folds 
matiko09: raises $2 to $3
ilaviiitech: folds 
FroggyPlay: folds 
mycka86: folds 
Kukuryzka: folds 
Uncalled bet ($2) returned to matiko09
matiko09 collected $2.50 from pot
matiko09: doesn't show hand 
*** SUMMARY ***
Total pot $2.50 | Rake $0 
Seat 1: Celsinho0311 folded before Flop (didn't bet)
Seat 3: Filojoes folded before Flop (didn't bet)
Seat 4: matiko09 collected ($2.50)
Seat 5: ilaviiitech folded before Flop (didn't bet)
Seat 6: FroggyPlay (button) folded before Flop (didn't bet)
Seat 7: mycka86 (small blind) folded before Flop
Seat 8: Kukuryzka (big blind) folded before Flop
Seat 9: KLOP06031987 folded before Flop (didn't bet)





PokerStars Hand #147708361969:  Hold'em No Limit ($0.50/$1.00 USD) - 2016/01/26 16:17:12 CET [2016/01/26 10:17:12 ET]
Table 'Impala' 9-max Seat #6 is the button
Seat 1: mycka86 ($145.94 in chips) 
Seat 2: Filojoes ($100 in chips) 
Seat 4: Rikti ($92.26 in chips) 
Seat 5: Kukuryzka ($100 in chips) 
Seat 6: Tijger R.d.J ($112.29 in chips) 
Seat 7: matiko09 ($113.74 in chips) 
Seat 8: apfush ($100 in chips) 
Seat 9: flozzi ($105.07 in chips) 
matiko09: posts small blind $0.50
apfush: posts big blind $1
simoniustin: sits out 
*** HOLE CARDS ***
Dealt to matiko09 [6d 5d]
flozzi: folds 
mycka86: folds 
Filojoes: folds 
Rikti has timed out
Rikti: folds 
Kukuryzka: folds 
Tijger R.d.J: folds 
matiko09: raises $1.50 to $2.50
apfush: raises $5 to $7.50
matiko09: folds 
Uncalled bet ($5) returned to apfush
apfush collected $5 from pot
apfush: doesn't show hand 
*** SUMMARY ***
Total pot $5 | Rake $0 
Seat 1: mycka86 folded before Flop (didn't bet)
Seat 2: Filojoes folded before Flop (didn't bet)
Seat 4: Rikti folded before Flop (didn't bet)
Seat 5: Kukuryzka folded before Flop (didn't bet)
Seat 6: Tijger R.d.J (button) folded before Flop (didn't bet)
Seat 7: matiko09 (small blind) folded before Flop
Seat 8: apfush (big blind) collected ($5)
Seat 9: flozzi folded before Flop (didn't bet)





PokerStars Hand #147708363880:  Hold'em No Limit ($0.50/$1.00 USD) - 2016/01/26 16:17:15 CET [2016/01/26 10:17:15 ET]
Table 'Haedus' 9-max Seat #1 is the button
Seat 1: matiko09 ($100 in chips) 
Seat 3: cn_chayanne ($100 in chips) 
Seat 4: timur3-5-7 ($81.64 in chips) 
Seat 5: solbi86 ($120.08 in chips) 
Seat 6: nnne409 ($71.44 in chips) 
Seat 7: KLOP06031987 ($106 in chips) 
Seat 8: Jimy Tiltman ($106.24 in chips) 
Seat 9: Filojoes ($136.99 in chips) 
cn_chayanne: posts small blind $0.50
timur3-5-7: posts big blind $1
*** HOLE CARDS ***
Dealt to matiko09 [7c Jd]
solbi86: raises $2 to $3
nnne409: folds 
KLOP06031987: raises $6 to $9
Jimy Tiltman: folds 
Filojoes: folds 
matiko09: folds 
cn_chayanne: folds 
timur3-5-7: folds 
solbi86: folds 
Uncalled bet ($6) returned to KLOP06031987
KLOP06031987 collected $7.50 from pot
KLOP06031987: doesn't show hand 
*** SUMMARY ***
Total pot $7.50 | Rake $0 
Seat 1: matiko09 (button) folded before Flop (didn't bet)
Seat 3: cn_chayanne (small blind) folded before Flop
Seat 4: timur3-5-7 (big blind) folded before Flop
Seat 5: solbi86 folded before Flop
Seat 6: nnne409 folded before Flop (didn't bet)
Seat 7: KLOP06031987 collected ($7.50)
Seat 8: Jimy Tiltman folded before Flop (didn't bet)
Seat 9: Filojoes folded before Flop (didn't bet)





PokerStars Hand #147708369291:  Hold'em No Limit ($0.50/$1.00 USD) - 2016/01/26 16:17:22 CET [2016/01/26 10:17:22 ET]
Table 'Achates III' 9-max Seat #6 is the button
Seat 2: matiko09 ($126.70 in chips) 
Seat 3: Jimy Tiltman ($103.27 in chips) 
Seat 4: cn_chayanne ($100 in chips) 
Seat 5: simoniustin ($100 in chips) 
Seat 6: solbi86 ($114.47 in chips) 
Seat 7: 1989freak ($101.89 in chips) 
Seat 8: easycomengo ($115.04 in chips) 
Seat 9: T-chaos_IMBA ($321.14 in chips) 
1989freak: posts small blind $0.50
easycomengo: posts big blind $1
*** HOLE CARDS ***
Dealt to matiko09 [8h Kh]
T-chaos_IMBA: raises $1 to $2
matiko09: folds 
Jimy Tiltman: folds 
cn_chayanne: folds 
simoniustin: folds 
solbi86: folds 
1989freak: folds 
easycomengo: folds 
Uncalled bet ($1) returned to T-chaos_IMBA
T-chaos_IMBA collected $2.50 from pot
T-chaos_IMBA: doesn't show hand 
*** SUMMARY ***
Total pot $2.50 | Rake $0 
Seat 2: matiko09 folded before Flop (didn't bet)
Seat 3: Jimy Tiltman folded before Flop (didn't bet)
Seat 4: cn_chayanne folded before Flop (didn't bet)
Seat 5: simoniustin folded before Flop (didn't bet)
Seat 6: solbi86 (button) folded before Flop (didn't bet)
Seat 7: 1989freak (small blind) folded before Flop
Seat 8: easycomengo (big blind) folded before Flop
Seat 9: T-chaos_IMBA collected ($2.50)





PokerStars Hand #147708375293:  Hold'em No Limit ($0.50/$1.00 USD) - 2016/01/26 16:17:30 CET [2016/01/26 10:17:30 ET]
Table 'Srbija III' 9-max Seat #2 is the button
Seat 1: simoniustin ($103.23 in chips) 
Seat 2: cn_chayanne ($100 in chips) 
Seat 3: LIGOPSIXIS78 ($68.17 in chips) 
Seat 4: petalouda10 ($82.38 in chips) 
Seat 5: mycka86 ($100 in chips) 
Seat 6: matiko09 ($213.76 in chips) 
Seat 7: KLOP06031987 ($111.44 in chips) 
Seat 8: solbi86 ($100.69 in chips) 
LIGOPSIXIS78: posts small blind $0.50
petalouda10: posts big blind $1
soplak: sits out 
*** HOLE CARDS ***
Dealt to matiko09 [Ts 7h]
mycka86: folds 
matiko09: folds 
KLOP06031987: raises $1.31 to $2.31
solbi86: folds 
simoniustin: folds 
cn_chayanne: folds 
LIGOPSIXIS78: folds 
petalouda10: calls $1.31
*** FLOP *** [Qd 2h Jd]
petalouda10: checks 
KLOP06031987: bets $1.95
petalouda10: folds 
Uncalled bet ($1.95) returned to KLOP06031987
KLOP06031987 collected $4.89 from pot
KLOP06031987: doesn't show hand 
*** SUMMARY ***
Total pot $5.12 | Rake $0.23 
Board [Qd 2h Jd]
Seat 1: simoniustin folded before Flop (didn't bet)
Seat 2: cn_chayanne (button) folded before Flop (didn't bet)
Seat 3: LIGOPSIXIS78 (small blind) folded before Flop
Seat 4: petalouda10 (big blind) folded on the Flop
Seat 5: mycka86 folded before Flop (didn't bet)
Seat 6: matiko09 folded before Flop (didn't bet)
Seat 7: KLOP06031987 collected ($4.89)
Seat 8: solbi86 folded before Flop (didn't bet)





PokerStars Hand #147708377038:  Hold'em No Limit ($0.50/$1.00 USD) - 2016/01/26 16:17:32 CET [2016/01/26 10:17:32 ET]
Table 'Kale II' 9-max Seat #6 is the button
Seat 2: matiko09 ($104.63 in chips) 
Seat 3: Reven9er ($135.72 in chips) 
Seat 6: simoniustin ($100 in chips) 
Seat 7: MILLIONCHIC ($66.79 in chips) 
Seat 8: mycka86 ($122.86 in chips) 
Seat 9: solbi86 ($197.05 in chips) 
MILLIONCHIC: posts small blind $0.50
mycka86: posts big blind $1
soplak: sits out 
aseban11: sits out 
*** HOLE CARDS ***
Dealt to matiko09 [Ac Qh]
solbi86: raises $2 to $3
matiko09: calls $3
Reven9er: folds 
simoniustin: raises $11 to $14
MILLIONCHIC: folds 
mycka86: folds 
solbi86: folds 
matiko09: folds 
Uncalled bet ($11) returned to simoniustin
simoniustin collected $10.50 from pot
simoniustin: doesn't show hand 
*** SUMMARY ***
Total pot $10.50 | Rake $0 
Seat 2: matiko09 folded before Flop
Seat 3: Reven9er folded before Flop (didn't bet)
Seat 6: simoniustin (button) collected ($10.50)
Seat 7: MILLIONCHIC (small blind) folded before Flop
Seat 8: mycka86 (big blind) folded before Flop
Seat 9: solbi86 folded before Flop





PokerStars Hand #147708386783:  Hold'em No Limit ($0.50/$1.00 USD) - 2016/01/26 16:17:45 CET [2016/01/26 10:17:45 ET]
Table 'Medusa III' 9-max Seat #5 is the button
Seat 2: happydrake ($99.95 in chips) 
Seat 3: mycka86 ($104.48 in chips) 
Seat 4: simoniustin ($100 in chips) 
Seat 5: matiko09 ($248.63 in chips) 
Seat 6: aseban11 ($110.62 in chips) 
Seat 7: Reven9er ($164.46 in chips) 
Seat 8: Filojoes ($130.70 in chips) 
Seat 9: sebaaastian ($100 in chips) 
aseban11: posts small blind $0.50
Reven9er: posts big blind $1
*** HOLE CARDS ***
Dealt to matiko09 [3c 6d]
Filojoes: folds 
sebaaastian: folds 
happydrake: calls $1
mycka86: folds 
simoniustin: raises $2 to $3
matiko09: folds 
aseban11: folds 
Reven9er: folds 
happydrake: calls $2
*** FLOP *** [8s Th Jd]
happydrake: bets $3.58
simoniustin: calls $3.58
*** TURN *** [8s Th Jd] [5c]
happydrake: checks 
simoniustin: bets $8
happydrake: calls $8
*** RIVER *** [8s Th Jd 5c] [Jc]
happydrake: bets $29.28
simoniustin: calls $29.28
*** SHOW DOWN ***
happydrake: shows [9c Js] (three of a kind, Jacks)
simoniustin: mucks hand 
happydrake collected $86.42 from pot
*** SUMMARY ***
Total pot $89.22 | Rake $2.80 
Board [8s Th Jd 5c Jc]
Seat 2: happydrake showed [9c Js] and won ($86.42) with three of a kind, Jacks
Seat 3: mycka86 folded before Flop (didn't bet)
Seat 4: simoniustin mucked [Qc Ts]
Seat 5: matiko09 (button) folded before Flop (didn't bet)
Seat 6: aseban11 (small blind) folded before Flop
Seat 7: Reven9er (big blind) folded before Flop
Seat 8: Filojoes folded before Flop (didn't bet)
Seat 9: sebaaastian folded before Flop (didn't bet)





PokerStars Hand #147708391460:  Hold'em No Limit ($0.50/$1.00 USD) - 2016/01/26 16:17:51 CET [2016/01/26 10:17:51 ET]
Table 'Montefiore' 9-max Seat #7 is the button
Seat 1: Celsinho0311 ($83.37 in chips) 
Seat 3: Filojoes ($100 in chips) 
Seat 4: matiko09 ($101.50 in chips) 
Seat 5: ilaviiitech ($101.50 in chips) 
Seat 6: FroggyPlay ($100 in chips) 
Seat 7: mycka86 ($100 in chips) 
Seat 8: Kukuryzka ($99 in chips) 
Seat 9: KLOP06031987 ($101.50 in chips) 
Kukuryzka: posts small blind $0.50
KLOP06031987: posts big blind $1
D†est7oye†R: sits out 
*** HOLE CARDS ***
Dealt to matiko09 [Ah Kd]
Celsinho0311: folds 
Celsinho0311 leaves the table
simoniustin joins the table at seat #1 
Filojoes: folds 
matiko09: raises $2 to $3
ilaviiitech: folds 
FroggyPlay: folds 
mycka86: folds 
Kukuryzka: folds 
KLOP06031987: raises $7 to $10
matiko09: calls $7
*** FLOP *** [Td 3s 7s]
KLOP06031987: bets $12
matiko09: folds 
Uncalled bet ($12) returned to KLOP06031987
KLOP06031987 collected $19.58 from pot
KLOP06031987: doesn't show hand 
*** SUMMARY ***
Total pot $20.50 | Rake $0.92 
Board [Td 3s 7s]
Seat 1: Celsinho0311 folded before Flop (didn't bet)
Seat 3: Filojoes folded before Flop (didn't bet)
Seat 4: matiko09 folded on the Flop
Seat 5: ilaviiitech folded before Flop (didn't bet)
Seat 6: FroggyPlay folded before Flop (didn't bet)
Seat 7: mycka86 (button) folded before Flop (didn't bet)
Seat 8: Kukuryzka (small blind) folded before Flop
Seat 9: KLOP06031987 (big blind) collected ($19.58)





PokerStars Hand #147708390800:  Hold'em No Limit ($0.50/$1.00 USD) - 2016/01/26 16:17:51 CET [2016/01/26 10:17:51 ET]
Table 'Calypso II' 9-max Seat #7 is the button
Seat 1: KLOP06031987 ($100 in chips) 
Seat 3: matiko09 ($238.43 in chips) 
Seat 5: mycka86 ($113.50 in chips) 
Seat 6: MrDeeee25 ($112.91 in chips) 
Seat 7: Tasvision_mö ($43.31 in chips) 
Seat 8: Reven9er ($100 in chips) 
Seat 9: Filojoes ($143.61 in chips) 
Reven9er: posts small blind $0.50
Filojoes: posts big blind $1
simoniustin: sits out 
Kukuryzka: sits out 
*** HOLE CARDS ***
Dealt to matiko09 [5c Jd]
KLOP06031987: folds 
matiko09: folds 
mycka86: folds 
MrDeeee25: folds 
Tasvision_mö: folds 
Reven9er: folds 
Uncalled bet ($0.50) returned to Filojoes
Filojoes collected $1 from pot
Filojoes: doesn't show hand 
*** SUMMARY ***
Total pot $1 | Rake $0 
Seat 1: KLOP06031987 folded before Flop (didn't bet)
Seat 3: matiko09 folded before Flop (didn't bet)
Seat 5: mycka86 folded before Flop (didn't bet)
Seat 6: MrDeeee25 folded before Flop (didn't bet)
Seat 7: Tasvision_mö (button) folded before Flop (didn't bet)
Seat 8: Reven9er (small blind) folded before Flop
Seat 9: Filojoes (big blind) collected ($1)





PokerStars Hand #147708392679:  Hold'em No Limit ($0.50/$1.00 USD) - 2016/01/26 16:17:53 CET [2016/01/26 10:17:53 ET]
Table 'Mashona' 9-max Seat #5 is the button
Seat 1: maxxmeister ($125.90 in chips) 
Seat 2: werades ($214.88 in chips) 
Seat 3: matiko09 ($127.31 in chips) 
Seat 4: mycka86 ($100 in chips) 
Seat 5: solbi86 ($129.38 in chips) 
Seat 6: Filojoes ($100 in chips) 
Seat 7: EB0LARAMA ($305.24 in chips) 
Seat 8: Jimy Tiltman ($157.16 in chips) 
Seat 9: apfush ($105.57 in chips) 
Filojoes: posts small blind $0.50
EB0LARAMA: posts big blind $1
*** HOLE CARDS ***
Dealt to matiko09 [Ks Ah]
Jimy Tiltman: folds 
apfush: folds 
maxxmeister: folds 
Jimy Tiltman leaves the table
simoniustin joins the table at seat #8 
werades: raises $1.50 to $2.50
matiko09: raises $6.50 to $9
mycka86: folds 
solbi86: folds 
Filojoes: folds 
EB0LARAMA: calls $8
werades: folds 
*** FLOP *** [2d Kh Kd]
EB0LARAMA: checks 
matiko09: bets $10.43
EB0LARAMA: folds 
Uncalled bet ($10.43) returned to matiko09
matiko09 collected $20.06 from pot
matiko09: doesn't show hand 
*** SUMMARY ***
Total pot $21 | Rake $0.94 
Board [2d Kh Kd]
Seat 1: maxxmeister folded before Flop (didn't bet)
Seat 2: werades folded before Flop
Seat 3: matiko09 collected ($20.06)
Seat 4: mycka86 folded before Flop (didn't bet)
Seat 5: solbi86 (button) folded before Flop (didn't bet)
Seat 6: Filojoes (small blind) folded before Flop
Seat 7: EB0LARAMA (big blind) folded on the Flop
Seat 8: Jimy Tiltman folded before Flop (didn't bet)
Seat 9: apfush folded before Flop (didn't bet)





PokerStars Hand #147708394034:  Hold'em No Limit ($0.50/$1.00 USD) - 2016/01/26 16:17:55 CET [2016/01/26 10:17:55 ET]
Table 'Achates III' 9-max Seat #7 is the button
Seat 2: matiko09 ($126.70 in chips) 
Seat 3: Jimy Tiltman ($103.27 in chips) 
Seat 4: cn_chayanne ($100 in chips) 
Seat 5: simoniustin ($100 in chips) 
Seat 6: solbi86 ($114.47 in chips) 
Seat 7: 1989freak ($101.39 in chips) 
Seat 8: easycomengo ($114.04 in chips) 
Seat 9: T-chaos_IMBA ($322.64 in chips) 
easycomengo: posts small blind $0.50
T-chaos_IMBA: posts big blind $1
*** HOLE CARDS ***
Dealt to matiko09 [8d Qs]
matiko09: folds 
Jimy Tiltman: folds 
cn_chayanne: raises $1.50 to $2.50
simoniustin: folds 
solbi86: folds 
1989freak: folds 
easycomengo: calls $2
T-chaos_IMBA: calls $1.50
*** FLOP *** [6d Jd 8h]
easycomengo: checks 
T-chaos_IMBA: checks 
cn_chayanne: bets $4.51
easycomengo: folds 
T-chaos_IMBA: calls $4.51
*** TURN *** [6d Jd 8h] [7h]
T-chaos_IMBA: checks 
cn_chayanne: bets $11.83
T-chaos_IMBA: calls $11.83
*** RIVER *** [6d Jd 8h 7h] [Ad]
T-chaos_IMBA: bets $22
cn_chayanne: folds 
Uncalled bet ($22) returned to T-chaos_IMBA
T-chaos_IMBA collected $38.37 from pot
T-chaos_IMBA: doesn't show hand 
*** SUMMARY ***
Total pot $40.18 | Rake $1.81 
Board [6d Jd 8h 7h Ad]
Seat 2: matiko09 folded before Flop (didn't bet)
Seat 3: Jimy Tiltman folded before Flop (didn't bet)
Seat 4: cn_chayanne folded on the River
Seat 5: simoniustin folded before Flop (didn't bet)
Seat 6: solbi86 folded before Flop (didn't bet)
Seat 7: 1989freak (button) folded before Flop (didn't bet)
Seat 8: easycomengo (small blind) folded on the Flop
Seat 9: T-chaos_IMBA (big blind) collected ($38.37)





PokerStars Hand #147708396473:  Hold'em No Limit ($0.50/$1.00 USD) - 2016/01/26 16:17:58 CET [2016/01/26 10:17:58 ET]
Table 'Strenua III' 9-max Seat #6 is the button
Seat 2: cn_chayanne ($159.70 in chips) 
Seat 3: petalouda10 ($59.89 in chips) 
Seat 4: mycka86 ($117.36 in chips) 
Seat 5: DeWeijz ($41.07 in chips) 
Seat 6: matiko09 ($126.05 in chips) 
Seat 7: KLOP06031987 ($101.48 in chips) 
Seat 8: Filojoes ($104.19 in chips) 
KLOP06031987: posts small blind $0.50
Filojoes: posts big blind $1
maxxmeister: sits out 
Rikti: sits out 
*** HOLE CARDS ***
Dealt to matiko09 [4c 6h]
cn_chayanne: folds 
petalouda10: folds 
mycka86: folds 
DeWeijz: raises $2 to $3
matiko09: folds 
KLOP06031987: folds 
Filojoes: folds 
Uncalled bet ($2) returned to DeWeijz
DeWeijz collected $2.50 from pot
DeWeijz: doesn't show hand 
*** SUMMARY ***
Total pot $2.50 | Rake $0 
Seat 2: cn_chayanne folded before Flop (didn't bet)
Seat 3: petalouda10 folded before Flop (didn't bet)
Seat 4: mycka86 folded before Flop (didn't bet)
Seat 5: DeWeijz collected ($2.50)
Seat 6: matiko09 (button) folded before Flop (didn't bet)
Seat 7: KLOP06031987 (small blind) folded before Flop
Seat 8: Filojoes (big blind) folded before Flop





PokerStars Hand #147708400183:  Hold'em No Limit ($0.50/$1.00 USD) - 2016/01/26 16:18:03 CET [2016/01/26 10:18:03 ET]
Table 'Calypso II' 9-max Seat #8 is the button
Seat 1: KLOP06031987 ($100 in chips) 
Seat 3: matiko09 ($238.43 in chips) 
Seat 5: mycka86 ($113.50 in chips) 
Seat 6: MrDeeee25 ($112.91 in chips) 
Seat 7: Tasvision_mö ($43.31 in chips) 
Seat 8: Reven9er ($100 in chips) 
Seat 9: Filojoes ($144.11 in chips) 
Filojoes: posts small blind $0.50
KLOP06031987: posts big blind $1
simoniustin: sits out 
Kukuryzka: sits out 
*** HOLE CARDS ***
Dealt to matiko09 [Kd Kh]
matiko09: raises $2 to $3
mycka86: folds 
MrDeeee25: folds 
Tasvision_mö: folds 
Reven9er: folds 
Filojoes: folds 
KLOP06031987: folds 
Uncalled bet ($2) returned to matiko09
matiko09 collected $2.50 from pot
matiko09: doesn't show hand 
*** SUMMARY ***
Total pot $2.50 | Rake $0 
Seat 1: KLOP06031987 (big blind) folded before Flop
Seat 3: matiko09 collected ($2.50)
Seat 5: mycka86 folded before Flop (didn't bet)
Seat 6: MrDeeee25 folded before Flop (didn't bet)
Seat 7: Tasvision_mö folded before Flop (didn't bet)
Seat 8: Reven9er (button) folded before Flop (didn't bet)
Seat 9: Filojoes (small blind) folded before Flop





PokerStars Hand #147708402907:  Hold'em No Limit ($0.50/$1.00 USD) - 2016/01/26 16:18:07 CET [2016/01/26 10:18:07 ET]
Table 'Srbija III' 9-max Seat #3 is the button
Seat 1: simoniustin ($103.23 in chips) 
Seat 2: cn_chayanne ($100 in chips) 
Seat 3: LIGOPSIXIS78 ($67.67 in chips) 
Seat 4: petalouda10 ($80.07 in chips) 
Seat 5: mycka86 ($100 in chips) 
Seat 6: matiko09 ($213.76 in chips) 
Seat 7: KLOP06031987 ($114.02 in chips) 
Seat 8: solbi86 ($100.69 in chips) 
petalouda10: posts small blind $0.50
mycka86: posts big blind $1
soplak: sits out 
*** HOLE CARDS ***
Dealt to matiko09 [8c 2s]
matiko09: folds 
KLOP06031987: folds 
solbi86: folds 
simoniustin: folds 
cn_chayanne: folds 
LIGOPSIXIS78: raises $1.50 to $2.50
petalouda10: calls $2
mycka86: calls $1.50
*** FLOP *** [3d 6c Jd]
petalouda10: checks 
mycka86: checks 
LIGOPSIXIS78: checks 
*** TURN *** [3d 6c Jd] [Ts]
petalouda10: checks 
mycka86: checks 
LIGOPSIXIS78: checks 
*** RIVER *** [3d 6c Jd Ts] [9h]
petalouda10: checks 
mycka86: checks 
LIGOPSIXIS78: checks 
*** SHOW DOWN ***
petalouda10: shows [2h 2c] (a pair of Deuces)
mycka86: mucks hand 
LIGOPSIXIS78: mucks hand 
petalouda10 collected $7.16 from pot
*** SUMMARY ***
Total pot $7.50 | Rake $0.34 
Board [3d 6c Jd Ts 9h]
Seat 1: simoniustin folded before Flop (didn't bet)
Seat 2: cn_chayanne folded before Flop (didn't bet)
Seat 3: LIGOPSIXIS78 (button) mucked [As 5h]
Seat 4: petalouda10 (small blind) showed [2h 2c] and won ($7.16) with a pair of Deuces
Seat 5: mycka86 (big blind) mucked [Ah 8h]
Seat 6: matiko09 folded before Flop (didn't bet)
Seat 7: KLOP06031987 folded before Flop (didn't bet)
Seat 8: solbi86 folded before Flop (didn't bet)





PokerStars Hand #147708405470:  Hold'em No Limit ($0.50/$1.00 USD) - 2016/01/26 16:18:10 CET [2016/01/26 10:18:10 ET]
Table 'Aten II' 9-max Seat #7 is the button
Seat 1: cn_chayanne ($114.66 in chips) 
Seat 2: solbi86 ($125.19 in chips) 
Seat 3: ilaviiitech ($103.68 in chips) 
Seat 4: matiko09 ($102.75 in chips) 
Seat 5: sebaaastian ($104.83 in chips) 
Seat 6: ooohaaah ($77.75 in chips) 
Seat 7: Legioner721 ($26.14 in chips) 
Seat 8: KLOP06031987 ($100 in chips) 
Seat 9: TorontoBum ($119.85 in chips) 
KLOP06031987: posts small blind $0.50
TorontoBum: posts big blind $1
*** HOLE CARDS ***
Dealt to matiko09 [2d Ts]
cn_chayanne: folds 
solbi86: folds 
ilaviiitech: folds 
matiko09: folds 
sebaaastian: folds 
ooohaaah: folds 
Legioner721: folds 
Legioner721 leaves the table
KLOP06031987: raises $1.31 to $2.31
TorontoBum: calls $1.31
*** FLOP *** [4s 9h Ks]
KLOP06031987: checks 
TorontoBum: checks 
*** TURN *** [4s 9h Ks] [6d]
KLOP06031987: bets $3
TorontoBum: folds 
Uncalled bet ($3) returned to KLOP06031987
KLOP06031987 collected $4.41 from pot
KLOP06031987: doesn't show hand 
*** SUMMARY ***
Total pot $4.62 | Rake $0.21 
Board [4s 9h Ks 6d]
Seat 1: cn_chayanne folded before Flop (didn't bet)
Seat 2: solbi86 folded before Flop (didn't bet)
Seat 3: ilaviiitech folded before Flop (didn't bet)
Seat 4: matiko09 folded before Flop (didn't bet)
Seat 5: sebaaastian folded before Flop (didn't bet)
Seat 6: ooohaaah folded before Flop (didn't bet)
Seat 7: Legioner721 (button) folded before Flop (didn't bet)
Seat 8: KLOP06031987 (small blind) collected ($4.41)
Seat 9: TorontoBum (big blind) folded on the Turn





PokerStars Hand #147708409645:  Hold'em No Limit ($0.50/$1.00 USD) - 2016/01/26 16:18:16 CET [2016/01/26 10:18:16 ET]
Table 'Kale II' 9-max Seat #7 is the button
Seat 2: matiko09 ($101.63 in chips) 
Seat 3: Reven9er ($135.72 in chips) 
Seat 6: simoniustin ($107.50 in chips) 
Seat 7: MILLIONCHIC ($66.29 in chips) 
Seat 8: mycka86 ($121.86 in chips) 
Seat 9: solbi86 ($194.05 in chips) 
mycka86: posts small blind $0.50
solbi86: posts big blind $1
soplak: sits out 
aseban11: sits out 
*** HOLE CARDS ***
Dealt to matiko09 [2h 9s]
matiko09: folds 
Reven9er: folds 
simoniustin: folds 
MILLIONCHIC: folds 
mycka86: raises $1.75 to $2.75
solbi86: folds 
Uncalled bet ($1.75) returned to mycka86
mycka86 collected $2 from pot
*** SUMMARY ***
Total pot $2 | Rake $0 
Seat 2: matiko09 folded before Flop (didn't bet)
Seat 3: Reven9er folded before Flop (didn't bet)
Seat 6: simoniustin folded before Flop (didn't bet)
Seat 7: MILLIONCHIC (button) folded before Flop (didn't bet)
Seat 8: mycka86 (small blind) collected ($2)
Seat 9: solbi86 (big blind) folded before Flop





PokerStars Hand #147708409976:  Hold'em No Limit ($0.50/$1.00 USD) - 2016/01/26 16:18:16 CET [2016/01/26 10:18:16 ET]
Table 'Haedus' 9-max Seat #3 is the button
Seat 1: matiko09 ($100 in chips) 
Seat 3: cn_chayanne ($100 in chips) 
Seat 4: timur3-5-7 ($80.64 in chips) 
Seat 5: solbi86 ($117.08 in chips) 
Seat 6: nnne409 ($71.44 in chips) 
Seat 7: KLOP06031987 ($110.50 in chips) 
Seat 8: Jimy Tiltman ($106.24 in chips) 
Seat 9: Filojoes ($136.99 in chips) 
timur3-5-7: posts small blind $0.50
solbi86: posts big blind $1
soplak: sits out 
*** HOLE CARDS ***
Dealt to matiko09 [Qh Kc]
nnne409: folds 
nnne409 leaves the table
KLOP06031987: folds 
Jimy Tiltman: folds 
soplak leaves the table
simoniustin joins the table at seat #6 
Filojoes: folds 
aseban11 joins the table at seat #2 
matiko09: raises $1.50 to $2.50
cn_chayanne: folds 
timur3-5-7: calls $2
solbi86: folds 
*** FLOP *** [Qd 6d 6s]
timur3-5-7: bets $2.86
matiko09: calls $2.86
*** TURN *** [Qd 6d 6s] [4s]
timur3-5-7: bets $5.59
matiko09: calls $5.59
*** RIVER *** [Qd 6d 6s 4s] [Tc]
timur3-5-7: bets $10.93
matiko09: calls $10.93
*** SHOW DOWN ***
timur3-5-7: shows [Th Qc] (two pair, Queens and Tens)
matiko09: mucks hand 
timur3-5-7 collected $42.75 from pot
*** SUMMARY ***
Total pot $44.76 | Rake $2.01 
Board [Qd 6d 6s 4s Tc]
Seat 1: matiko09 mucked [Qh Kc]
Seat 3: cn_chayanne (button) folded before Flop (didn't bet)
Seat 4: timur3-5-7 (small blind) showed [Th Qc] and won ($42.75) with two pair, Queens and Tens
Seat 5: solbi86 (big blind) folded before Flop
Seat 6: nnne409 folded before Flop (didn't bet)
Seat 7: KLOP06031987 folded before Flop (didn't bet)
Seat 8: Jimy Tiltman folded before Flop (didn't bet)
Seat 9: Filojoes folded before Flop (didn't bet)





PokerStars Hand #147708415819:  Hold'em No Limit ($0.50/$1.00 USD) - 2016/01/26 16:18:24 CET [2016/01/26 10:18:24 ET]
Table 'Calypso II' 9-max Seat #9 is the button
Seat 1: KLOP06031987 ($100 in chips) 
Seat 2: simoniustin ($100 in chips) 
Seat 3: matiko09 ($239.93 in chips) 
Seat 5: mycka86 ($113.50 in chips) 
Seat 6: MrDeeee25 ($112.91 in chips) 
Seat 7: Tasvision_mö ($43.31 in chips) 
Seat 8: Reven9er ($100 in chips) 
Seat 9: Filojoes ($143.61 in chips) 
KLOP06031987: posts small blind $0.50
simoniustin: posts big blind $1
Kukuryzka: sits out 
*** HOLE CARDS ***
Dealt to matiko09 [3h Qs]
matiko09: folds 
mycka86: folds 
MrDeeee25: folds 
Tasvision_mö: folds 
Reven9er: folds 
Filojoes: folds 
Kukuryzka leaves the table
KLOP06031987: folds 
Uncalled bet ($0.50) returned to simoniustin
simoniustin collected $1 from pot
simoniustin: doesn't show hand 
*** SUMMARY ***
Total pot $1 | Rake $0 
Seat 1: KLOP06031987 (small blind) folded before Flop
Seat 2: simoniustin (big blind) collected ($1)
Seat 3: matiko09 folded before Flop (didn't bet)
Seat 5: mycka86 folded before Flop (didn't bet)
Seat 6: MrDeeee25 folded before Flop (didn't bet)
Seat 7: Tasvision_mö folded before Flop (didn't bet)
Seat 8: Reven9er folded before Flop (didn't bet)
Seat 9: Filojoes (button) folded before Flop (didn't bet)





PokerStars Hand #147708421397:  Hold'em No Limit ($0.50/$1.00 USD) - 2016/01/26 16:18:31 CET [2016/01/26 10:18:31 ET]
Table 'Strenua III' 9-max Seat #7 is the button
Seat 2: cn_chayanne ($159.70 in chips) 
Seat 3: petalouda10 ($59.89 in chips) 
Seat 4: mycka86 ($117.36 in chips) 
Seat 5: DeWeijz ($42.57 in chips) 
Seat 6: matiko09 ($126.05 in chips) 
Seat 7: KLOP06031987 ($100.98 in chips) 
Seat 8: Filojoes ($103.19 in chips) 
Seat 9: maxxmeister ($100 in chips) 
Filojoes: posts small blind $0.50
maxxmeister: posts big blind $1
Rikti: sits out 
*** HOLE CARDS ***
Dealt to matiko09 [Ad 4c]
cn_chayanne: folds 
petalouda10: folds 
mycka86: raises $1.50 to $2.50
DeWeijz: folds 
matiko09: folds 
KLOP06031987: folds 
Filojoes: folds 
maxxmeister: folds 
Uncalled bet ($1.50) returned to mycka86
mycka86 collected $2.50 from pot
*** SUMMARY ***
Total pot $2.50 | Rake $0 
Seat 2: cn_chayanne folded before Flop (didn't bet)
Seat 3: petalouda10 folded before Flop (didn't bet)
Seat 4: mycka86 collected ($2.50)
Seat 5: DeWeijz folded before Flop (didn't bet)
Seat 6: matiko09 folded before Flop (didn't bet)
Seat 7: KLOP06031987 (button) folded before Flop (didn't bet)
Seat 8: Filojoes (small blind) folded before Flop
Seat 9: maxxmeister (big blind) folded before Flop





PokerStars Hand #147708428800:  Hold'em No Limit ($0.50/$1.00 USD) - 2016/01/26 16:18:41 CET [2016/01/26 10:18:41 ET]
Table 'Kale II' 9-max Seat #8 is the button
Seat 1: soplak ($100 in chips) 
Seat 2: matiko09 ($101.63 in chips) 
Seat 3: Reven9er ($135.72 in chips) 
Seat 6: simoniustin ($107.50 in chips) 
Seat 7: MILLIONCHIC ($66.29 in chips) 
Seat 8: mycka86 ($122.86 in chips) 
Seat 9: solbi86 ($193.05 in chips) 
solbi86: posts small blind $0.50
soplak: posts big blind $1
aseban11: sits out 
*** HOLE CARDS ***
Dealt to matiko09 [5c 8s]
matiko09: folds 
Reven9er: folds 
simoniustin: folds 
MILLIONCHIC: raises $2 to $3
mycka86: folds 
solbi86: folds 
soplak: folds 
Uncalled bet ($2) returned to MILLIONCHIC
MILLIONCHIC collected $2.50 from pot
MILLIONCHIC: doesn't show hand 
*** SUMMARY ***
Total pot $2.50 | Rake $0 
Seat 1: soplak (big blind) folded before Flop
Seat 2: matiko09 folded before Flop (didn't bet)
Seat 3: Reven9er folded before Flop (didn't bet)
Seat 6: simoniustin folded before Flop (didn't bet)
Seat 7: MILLIONCHIC collected ($2.50)
Seat 8: mycka86 (button) folded before Flop (didn't bet)
Seat 9: solbi86 (small blind) folded before Flop





PokerStars Hand #147708434603:  Hold'em No Limit ($0.50/$1.00 USD) - 2016/01/26 16:18:49 CET [2016/01/26 10:18:49 ET]
Table 'Impala' 9-max Seat #7 is the button
Seat 1: mycka86 ($145.94 in chips) 
Seat 2: Filojoes ($100 in chips) 
Seat 4: Rikti ($92.26 in chips) 
Seat 5: Kukuryzka ($100 in chips) 
Seat 6: Tijger R.d.J ($112.29 in chips) 
Seat 7: matiko09 ($111.24 in chips) 
Seat 8: apfush ($102.50 in chips) 
Seat 9: flozzi ($105.07 in chips) 
apfush: posts small blind $0.50
flozzi: posts big blind $1
simoniustin: sits out 
*** HOLE CARDS ***
Dealt to matiko09 [5s Ts]
mycka86: folds 
Filojoes: raises $2 to $3
Rikti: folds 
Kukuryzka: folds 
Tijger R.d.J: calls $3
matiko09: folds 
apfush: folds 
flozzi: folds 
*** FLOP *** [Jd Td Ks]
Filojoes: checks 
Tijger R.d.J: checks 
*** TURN *** [Jd Td Ks] [Js]
Filojoes: checks 
Tijger R.d.J: checks 
*** RIVER *** [Jd Td Ks Js] [7c]
Filojoes: checks 
Tijger R.d.J: checks 
*** SHOW DOWN ***
Filojoes: shows [8h 8d] (two pair, Jacks and Eights)
Tijger R.d.J: mucks hand 
Filojoes collected $7.16 from pot
*** SUMMARY ***
Total pot $7.50 | Rake $0.34 
Board [Jd Td Ks Js 7c]
Seat 1: mycka86 folded before Flop (didn't bet)
Seat 2: Filojoes showed [8h 8d] and won ($7.16) with two pair, Jacks and Eights
Seat 4: Rikti folded before Flop (didn't bet)
Seat 5: Kukuryzka folded before Flop (didn't bet)
Seat 6: Tijger R.d.J mucked [7h Qc]
Seat 7: matiko09 (button) folded before Flop (didn't bet)
Seat 8: apfush (small blind) folded before Flop
Seat 9: flozzi (big blind) folded before Flop





PokerStars Hand #147708439202:  Hold'em No Limit ($0.50/$1.00 USD) - 2016/01/26 16:18:55 CET [2016/01/26 10:18:55 ET]
Table 'Calypso II' 9-max Seat #1 is the button
Seat 1: KLOP06031987 ($100 in chips) 
Seat 2: simoniustin ($100.50 in chips) 
Seat 3: matiko09 ($239.93 in chips) 
Seat 5: mycka86 ($113.50 in chips) 
Seat 6: MrDeeee25 ($112.91 in chips) 
Seat 7: Tasvision_mö ($43.31 in chips) 
Seat 8: Reven9er ($100 in chips) 
Seat 9: Filojoes ($143.61 in chips) 
simoniustin: posts small blind $0.50
matiko09: posts big blind $1
*** HOLE CARDS ***
Dealt to matiko09 [5c 8h]
mycka86: raises $2 to $3
MrDeeee25: folds 
Tasvision_mö: folds 
Reven9er: folds 
Filojoes: folds 
KLOP06031987: folds 
aseban11 joins the table at seat #4 
simoniustin: folds 
matiko09: folds 
Uncalled bet ($2) returned to mycka86
mycka86 collected $2.50 from pot
*** SUMMARY ***
Total pot $2.50 | Rake $0 
Seat 1: KLOP06031987 (button) folded before Flop (didn't bet)
Seat 2: simoniustin (small blind) folded before Flop
Seat 3: matiko09 (big blind) folded before Flop
Seat 5: mycka86 collected ($2.50)
Seat 6: MrDeeee25 folded before Flop (didn't bet)
Seat 7: Tasvision_mö folded before Flop (didn't bet)
Seat 8: Reven9er folded before Flop (didn't bet)
Seat 9: Filojoes folded before Flop (didn't bet)





PokerStars Hand #147708446357:  Hold'em No Limit ($0.50/$1.00 USD) - 2016/01/26 16:19:04 CET [2016/01/26 10:19:04 ET]
Table 'Mashona' 9-max Seat #6 is the button
Seat 1: maxxmeister ($125.90 in chips) 
Seat 2: werades ($212.38 in chips) 
Seat 3: matiko09 ($138.37 in chips) 
Seat 4: mycka86 ($100 in chips) 
Seat 5: solbi86 ($129.38 in chips) 
Seat 6: Filojoes ($100 in chips) 
Seat 7: EB0LARAMA ($296.24 in chips) 
Seat 8: simoniustin ($100 in chips) 
Seat 9: apfush ($105.57 in chips) 
EB0LARAMA: posts small blind $0.50
simoniustin: posts big blind $1
*** HOLE CARDS ***
Dealt to matiko09 [8c 6s]
apfush: folds 
maxxmeister: folds 
werades: folds 
matiko09: folds 
mycka86: raises $1.50 to $2.50
solbi86: folds 
Filojoes: calls $2.50
EB0LARAMA: folds 
simoniustin: folds 
*** FLOP *** [Kd 2d As]
mycka86: checks 
Filojoes: checks 
*** TURN *** [Kd 2d As] [Ac]
mycka86: bets $4.30
Filojoes: calls $4.30
*** RIVER *** [Kd 2d As Ac] [9c]
mycka86: bets $10.50
Filojoes: folds 
Uncalled bet ($10.50) returned to mycka86
mycka86 collected $14.42 from pot
*** SUMMARY ***
Total pot $15.10 | Rake $0.68 
Board [Kd 2d As Ac 9c]
Seat 1: maxxmeister folded before Flop (didn't bet)
Seat 2: werades folded before Flop (didn't bet)
Seat 3: matiko09 folded before Flop (didn't bet)
Seat 4: mycka86 collected ($14.42)
Seat 5: solbi86 folded before Flop (didn't bet)
Seat 6: Filojoes (button) folded on the River
Seat 7: EB0LARAMA (small blind) folded before Flop
Seat 8: simoniustin (big blind) folded before Flop
Seat 9: apfush folded before Flop (didn't bet)





PokerStars Hand #147708448707:  Hold'em No Limit ($0.50/$1.00 USD) - 2016/01/26 16:19:07 CET [2016/01/26 10:19:07 ET]
Table 'Achates III' 9-max Seat #8 is the button
Seat 2: matiko09 ($126.70 in chips) 
Seat 3: Jimy Tiltman ($103.27 in chips) 
Seat 4: cn_chayanne ($100 in chips) 
Seat 5: simoniustin ($100 in chips) 
Seat 6: solbi86 ($114.47 in chips) 
Seat 7: 1989freak ($101.39 in chips) 
Seat 8: easycomengo ($111.54 in chips) 
Seat 9: T-chaos_IMBA ($342.17 in chips) 
T-chaos_IMBA: posts small blind $0.50
matiko09: posts big blind $1
*** HOLE CARDS ***
Dealt to matiko09 [5s 8d]
Jimy Tiltman: raises $2 to $3
cn_chayanne: folds 
simoniustin: folds 
solbi86: folds 
1989freak: folds 
easycomengo: folds 
T-chaos_IMBA: calls $2.50
matiko09: folds 
*** FLOP *** [Th 5c 7h]
T-chaos_IMBA: checks 
Jimy Tiltman: bets $4
T-chaos_IMBA: raises $6 to $10
Jimy Tiltman: calls $6
*** TURN *** [Th 5c 7h] [Qs]
T-chaos_IMBA: checks 
Jimy Tiltman: bets $17
T-chaos_IMBA: folds 
Uncalled bet ($17) returned to Jimy Tiltman
Jimy Tiltman collected $25.78 from pot
Jimy Tiltman: doesn't show hand 
*** SUMMARY ***
Total pot $27 | Rake $1.22 
Board [Th 5c 7h Qs]
Seat 2: matiko09 (big blind) folded before Flop
Seat 3: Jimy Tiltman collected ($25.78)
Seat 4: cn_chayanne folded before Flop (didn't bet)
Seat 5: simoniustin folded before Flop (didn't bet)
Seat 6: solbi86 folded before Flop (didn't bet)
Seat 7: 1989freak folded before Flop (didn't bet)
Seat 8: easycomengo (button) folded before Flop (didn't bet)
Seat 9: T-chaos_IMBA (small blind) folded on the Turn





PokerStars Hand #147708449802:  Hold'em No Limit ($0.50/$1.00 USD) - 2016/01/26 16:19:09 CET [2016/01/26 10:19:09 ET]
Table 'Kale II' 9-max Seat #9 is the button
Seat 1: soplak ($100 in chips) 
Seat 2: matiko09 ($101.63 in chips) 
Seat 3: Reven9er ($135.72 in chips) 
Seat 6: simoniustin ($107.50 in chips) 
Seat 7: MILLIONCHIC ($67.79 in chips) 
Seat 8: mycka86 ($122.86 in chips) 
Seat 9: solbi86 ($192.55 in chips) 
soplak: posts small blind $0.50
matiko09: posts big blind $1
aseban11: sits out 
*** HOLE CARDS ***
Dealt to matiko09 [Th 5d]
Reven9er: folds 
simoniustin: folds 
MILLIONCHIC: calls $1
mycka86: folds 
solbi86: raises $3 to $4
soplak: folds 
matiko09: folds 
MILLIONCHIC: folds 
Uncalled bet ($3) returned to solbi86
solbi86 collected $3.50 from pot
solbi86: doesn't show hand 
*** SUMMARY ***
Total pot $3.50 | Rake $0 
Seat 1: soplak (small blind) folded before Flop
Seat 2: matiko09 (big blind) folded before Flop
Seat 3: Reven9er folded before Flop (didn't bet)
Seat 6: simoniustin folded before Flop (didn't bet)
Seat 7: MILLIONCHIC folded before Flop
Seat 8: mycka86 folded before Flop (didn't bet)
Seat 9: solbi86 (button) collected ($3.50)





PokerStars Hand #147708452324:  Hold'em No Limit ($0.50/$1.00 USD) - 2016/01/26 16:19:12 CET [2016/01/26 10:19:12 ET]
Table 'Montefiore' 9-max Seat #8 is the button
Seat 1: simoniustin ($100 in chips) 
Seat 3: Filojoes ($100 in chips) 
Seat 4: matiko09 ($100 in chips) 
Seat 5: ilaviiitech ($101.50 in chips) 
Seat 6: FroggyPlay ($100 in chips) 
Seat 7: mycka86 ($100 in chips) 
Seat 8: Kukuryzka ($100 in chips) 
Seat 9: KLOP06031987 ($111.08 in chips) 
KLOP06031987: posts small blind $0.50
simoniustin: posts big blind $1
D†est7oye†R: sits out 
*** HOLE CARDS ***
Dealt to matiko09 [9c Ts]
Filojoes: folds 
matiko09: folds 
ilaviiitech: folds 
FroggyPlay: folds 
mycka86: folds 
Kukuryzka: raises $1 to $2
KLOP06031987: folds 
simoniustin: folds 
Uncalled bet ($1) returned to Kukuryzka
Kukuryzka collected $2.50 from pot
Kukuryzka: doesn't show hand 
*** SUMMARY ***
Total pot $2.50 | Rake $0 
Seat 1: simoniustin (big blind) folded before Flop
Seat 3: Filojoes folded before Flop (didn't bet)
Seat 4: matiko09 folded before Flop (didn't bet)
Seat 5: ilaviiitech folded before Flop (didn't bet)
Seat 6: FroggyPlay folded before Flop (didn't bet)
Seat 7: mycka86 folded before Flop (didn't bet)
Seat 8: Kukuryzka (button) collected ($2.50)
Seat 9: KLOP06031987 (small blind) folded before Flop





PokerStars Hand #147708456016:  Hold'em No Limit ($0.50/$1.00 USD) - 2016/01/26 16:19:17 CET [2016/01/26 10:19:17 ET]
Table 'Medusa III' 9-max Seat #6 is the button
Seat 2: happydrake ($142.51 in chips) 
Seat 3: mycka86 ($104.48 in chips) 
Seat 4: simoniustin ($100 in chips) 
Seat 5: matiko09 ($248.63 in chips) 
Seat 6: aseban11 ($110.12 in chips) 
Seat 7: Reven9er ($163.46 in chips) 
Seat 9: sebaaastian ($100 in chips) 
Reven9er: posts small blind $0.50
Filojoes: is sitting out 
sebaaastian: posts big blind $1
*** HOLE CARDS ***
Dealt to matiko09 [Qd Qc]
Filojoes leaves the table
happydrake: folds 
mycka86: folds 
simoniustin: folds 
solbi86 joins the table at seat #8 
matiko09: raises $1.50 to $2.50
aseban11: folds 
Reven9er: folds 
sebaaastian: folds 
Uncalled bet ($1.50) returned to matiko09
matiko09 collected $2.50 from pot
matiko09: doesn't show hand 
*** SUMMARY ***
Total pot $2.50 | Rake $0 
Seat 2: happydrake folded before Flop (didn't bet)
Seat 3: mycka86 folded before Flop (didn't bet)
Seat 4: simoniustin folded before Flop (didn't bet)
Seat 5: matiko09 collected ($2.50)
Seat 6: aseban11 (button) folded before Flop (didn't bet)
Seat 7: Reven9er (small blind) folded before Flop
Seat 9: sebaaastian (big blind) folded before Flop





PokerStars Hand #147708459475:  Hold'em No Limit ($0.50/$1.00 USD) - 2016/01/26 16:19:22 CET [2016/01/26 10:19:22 ET]
Table 'Aten II' 9-max Seat #8 is the button
Seat 1: cn_chayanne ($114.66 in chips) 
Seat 2: solbi86 ($125.19 in chips) 
Seat 3: ilaviiitech ($103.68 in chips) 
Seat 4: matiko09 ($102.75 in chips) 
Seat 5: sebaaastian ($104.83 in chips) 
Seat 6: ooohaaah ($77.75 in chips) 
Seat 8: KLOP06031987 ($102.10 in chips) 
Seat 9: TorontoBum ($117.54 in chips) 
TorontoBum: posts small blind $0.50
cn_chayanne: posts big blind $1
*** HOLE CARDS ***
Dealt to matiko09 [Ah 7h]
solbi86: folds 
Filojoes joins the table at seat #7 
ilaviiitech: raises $2 to $3
matiko09: folds 
sebaaastian: folds 
ooohaaah: calls $3
KLOP06031987: folds 
TorontoBum: folds 
cn_chayanne: folds 
*** FLOP *** [Th As 9c]
ilaviiitech: checks 
ooohaaah: bets $6
ilaviiitech: folds 
Uncalled bet ($6) returned to ooohaaah
ooohaaah collected $7.16 from pot
ooohaaah: doesn't show hand 
*** SUMMARY ***
Total pot $7.50 | Rake $0.34 
Board [Th As 9c]
Seat 1: cn_chayanne (big blind) folded before Flop
Seat 2: solbi86 folded before Flop (didn't bet)
Seat 3: ilaviiitech folded on the Flop
Seat 4: matiko09 folded before Flop (didn't bet)
Seat 5: sebaaastian folded before Flop (didn't bet)
Seat 6: ooohaaah collected ($7.16)
Seat 8: KLOP06031987 (button) folded before Flop (didn't bet)
Seat 9: TorontoBum (small blind) folded before Flop





PokerStars Hand #147708461141:  Hold'em No Limit ($0.50/$1.00 USD) - 2016/01/26 16:19:24 CET [2016/01/26 10:19:24 ET]
Table 'Strenua III' 9-max Seat #8 is the button
Seat 1: Rikti ($98.16 in chips) 
Seat 2: cn_chayanne ($159.70 in chips) 
Seat 3: petalouda10 ($59.89 in chips) 
Seat 4: mycka86 ($118.86 in chips) 
Seat 5: DeWeijz ($42.57 in chips) 
Seat 6: matiko09 ($126.05 in chips) 
Seat 7: KLOP06031987 ($100.98 in chips) 
Seat 8: Filojoes ($102.69 in chips) 
Seat 9: maxxmeister ($100 in chips) 
maxxmeister: posts small blind $0.50
Rikti: posts big blind $1
*** HOLE CARDS ***
Dealt to matiko09 [As Qs]
cn_chayanne: folds 
petalouda10: raises $2 to $3
mycka86: folds 
DeWeijz: folds 
matiko09: raises $5 to $8
KLOP06031987: folds 
Filojoes: folds 
maxxmeister: folds 
Rikti: folds 
petalouda10: calls $5
*** FLOP *** [Qd 8d Th]
petalouda10: checks 
matiko09: bets $10.86
petalouda10: calls $10.86
*** TURN *** [Qd 8d Th] [2h]
petalouda10: checks 
matiko09: bets $26
petalouda10: calls $26
*** RIVER *** [Qd 8d Th 2h] [2s]
petalouda10: checks 
matiko09: bets $57.47
petalouda10: folds 
Uncalled bet ($57.47) returned to matiko09
matiko09 collected $88.42 from pot
matiko09: doesn't show hand 
*** SUMMARY ***
Total pot $91.22 | Rake $2.80 
Board [Qd 8d Th 2h 2s]
Seat 1: Rikti (big blind) folded before Flop
Seat 2: cn_chayanne folded before Flop (didn't bet)
Seat 3: petalouda10 folded on the River
Seat 4: mycka86 folded before Flop (didn't bet)
Seat 5: DeWeijz folded before Flop (didn't bet)
Seat 6: matiko09 collected ($88.42)
Seat 7: KLOP06031987 folded before Flop (didn't bet)
Seat 8: Filojoes (button) folded before Flop (didn't bet)
Seat 9: maxxmeister (small blind) folded before Flop





PokerStars Hand #147708461186:  Hold'em No Limit ($0.50/$1.00 USD) - 2016/01/26 16:19:24 CET [2016/01/26 10:19:24 ET]
Table 'Calypso II' 9-max Seat #2 is the button
Seat 1: KLOP06031987 ($100 in chips) 
Seat 2: simoniustin ($100 in chips) 
Seat 3: matiko09 ($238.93 in chips) 
Seat 4: aseban11 ($100 in chips) 
Seat 5: mycka86 ($115 in chips) 
Seat 6: MrDeeee25 ($112.91 in chips) 
Seat 7: Tasvision_mö ($43.31 in chips) 
Seat 8: Reven9er ($100 in chips) 
Seat 9: Filojoes ($143.61 in chips) 
matiko09: posts small blind $0.50
aseban11: posts big blind $1
*** HOLE CARDS ***
Dealt to matiko09 [3h Ah]
mycka86: folds 
MrDeeee25: folds 
Tasvision_mö: folds 
Reven9er: raises $1 to $2
Filojoes: folds 
KLOP06031987: folds 
simoniustin: folds 
matiko09: folds 
aseban11: folds 
Uncalled bet ($1) returned to Reven9er
Reven9er collected $2.50 from pot
Reven9er: doesn't show hand 
*** SUMMARY ***
Total pot $2.50 | Rake $0 
Seat 1: KLOP06031987 folded before Flop (didn't bet)
Seat 2: simoniustin (button) folded before Flop (didn't bet)
Seat 3: matiko09 (small blind) folded before Flop
Seat 4: aseban11 (big blind) folded before Flop
Seat 5: mycka86 folded before Flop (didn't bet)
Seat 6: MrDeeee25 folded before Flop (didn't bet)
Seat 7: Tasvision_mö folded before Flop (didn't bet)
Seat 8: Reven9er collected ($2.50)
Seat 9: Filojoes folded before Flop (didn't bet)





PokerStars Hand #147708465840:  Hold'em No Limit ($0.50/$1.00 USD) - 2016/01/26 16:19:30 CET [2016/01/26 10:19:30 ET]
Table 'Haedus' 9-max Seat #4 is the button
Seat 1: matiko09 ($100 in chips) 
Seat 3: cn_chayanne ($100 in chips) 
Seat 4: timur3-5-7 ($101.51 in chips) 
Seat 5: solbi86 ($116.08 in chips) 
Seat 6: simoniustin ($100 in chips) 
Seat 7: KLOP06031987 ($110.50 in chips) 
Seat 8: Jimy Tiltman ($106.24 in chips) 
Seat 9: Filojoes ($136.99 in chips) 
solbi86: posts small blind $0.50
simoniustin: posts big blind $1
aseban11: sits out 
*** HOLE CARDS ***
Dealt to matiko09 [3c 5s]
KLOP06031987: folds 
Jimy Tiltman: folds 
Filojoes: folds 
matiko09: folds 
cn_chayanne: folds 
timur3-5-7: folds 
solbi86: folds 
Uncalled bet ($0.50) returned to simoniustin
simoniustin collected $1 from pot
simoniustin: doesn't show hand 
*** SUMMARY ***
Total pot $1 | Rake $0 
Seat 1: matiko09 folded before Flop (didn't bet)
Seat 3: cn_chayanne folded before Flop (didn't bet)
Seat 4: timur3-5-7 (button) folded before Flop (didn't bet)
Seat 5: solbi86 (small blind) folded before Flop
Seat 6: simoniustin (big blind) collected ($1)
Seat 7: KLOP06031987 folded before Flop (didn't bet)
Seat 8: Jimy Tiltman folded before Flop (didn't bet)
Seat 9: Filojoes folded before Flop (didn't bet)





PokerStars Hand #147708473378:  Hold'em No Limit ($0.50/$1.00 USD) - 2016/01/26 16:19:40 CET [2016/01/26 10:19:40 ET]
Table 'Kale II' 9-max Seat #1 is the button
Seat 1: soplak ($100 in chips) 
Seat 2: matiko09 ($100.63 in chips) 
Seat 3: Reven9er ($135.72 in chips) 
Seat 6: simoniustin ($107.50 in chips) 
Seat 7: MILLIONCHIC ($66.79 in chips) 
Seat 8: mycka86 ($122.86 in chips) 
Seat 9: solbi86 ($195.05 in chips) 
matiko09: posts small blind $0.50
Reven9er: posts big blind $1
aseban11: sits out 
*** HOLE CARDS ***
Dealt to matiko09 [4c 4h]
simoniustin: folds 
MILLIONCHIC: folds 
mycka86: raises $1.50 to $2.50
solbi86: raises $6.50 to $9
soplak: folds 
matiko09: folds 
Reven9er: folds 
mycka86: folds 
Uncalled bet ($6.50) returned to solbi86
solbi86 collected $6.50 from pot
solbi86: doesn't show hand 
*** SUMMARY ***
Total pot $6.50 | Rake $0 
Seat 1: soplak (button) folded before Flop (didn't bet)
Seat 2: matiko09 (small blind) folded before Flop
Seat 3: Reven9er (big blind) folded before Flop
Seat 6: simoniustin folded before Flop (didn't bet)
Seat 7: MILLIONCHIC folded before Flop (didn't bet)
Seat 8: mycka86 folded before Flop
Seat 9: solbi86 collected ($6.50)





PokerStars Hand #147708474202:  Hold'em No Limit ($0.50/$1.00 USD) - 2016/01/26 16:19:41 CET [2016/01/26 10:19:41 ET]
Table 'Srbija III' 9-max Seat #4 is the button
Seat 1: simoniustin ($103.23 in chips) 
Seat 2: cn_chayanne ($100 in chips) 
Seat 3: LIGOPSIXIS78 ($65.17 in chips) 
Seat 4: petalouda10 ($84.73 in chips) 
Seat 5: mycka86 ($100 in chips) 
Seat 6: matiko09 ($213.76 in chips) 
Seat 7: KLOP06031987 ($114.02 in chips) 
Seat 8: solbi86 ($100.69 in chips) 
mycka86: posts small blind $0.50
matiko09: posts big blind $1
soplak: sits out 
*** HOLE CARDS ***
Dealt to matiko09 [4c 7d]
KLOP06031987: folds 
solbi86: folds 
simoniustin: raises $2 to $3
cn_chayanne: folds 
LIGOPSIXIS78: folds 
petalouda10: folds 
mycka86: folds 
matiko09: folds 
Uncalled bet ($2) returned to simoniustin
simoniustin collected $2.50 from pot
simoniustin: doesn't show hand 
*** SUMMARY ***
Total pot $2.50 | Rake $0 
Seat 1: simoniustin collected ($2.50)
Seat 2: cn_chayanne folded before Flop (didn't bet)
Seat 3: LIGOPSIXIS78 folded before Flop (didn't bet)
Seat 4: petalouda10 (button) folded before Flop (didn't bet)
Seat 5: mycka86 (small blind) folded before Flop
Seat 6: matiko09 (big blind) folded before Flop
Seat 7: KLOP06031987 folded before Flop (didn't bet)
Seat 8: solbi86 folded before Flop (didn't bet)





PokerStars Hand #147708475870:  Hold'em No Limit ($0.50/$1.00 USD) - 2016/01/26 16:19:43 CET [2016/01/26 10:19:43 ET]
Table 'Montefiore' 9-max Seat #9 is the button
Seat 1: simoniustin ($100 in chips) 
Seat 2: D†est7oye†R ($100 in chips) 
Seat 3: Filojoes ($100 in chips) 
Seat 4: matiko09 ($100 in chips) 
Seat 5: ilaviiitech ($101.50 in chips) 
Seat 6: FroggyPlay ($100 in chips) 
Seat 7: mycka86 ($100 in chips) 
Seat 8: Kukuryzka ($101.50 in chips) 
Seat 9: KLOP06031987 ($110.58 in chips) 
simoniustin: posts small blind $0.50
D†est7oye†R: posts big blind $1
*** HOLE CARDS ***
Dealt to matiko09 [6d Kc]
Filojoes: folds 
matiko09: folds 
ilaviiitech: folds 
FroggyPlay: folds 
mycka86: raises $1.50 to $2.50
Kukuryzka: calls $2.50
KLOP06031987: folds 
simoniustin: folds 
D†est7oye†R: folds 
*** FLOP *** [Td Ks 2h]
mycka86: bets $4
Kukuryzka: folds 
Uncalled bet ($4) returned to mycka86
mycka86 collected $6.21 from pot
*** SUMMARY ***
Total pot $6.50 | Rake $0.29 
Board [Td Ks 2h]
Seat 1: simoniustin (small blind) folded before Flop
Seat 2: D†est7oye†R (big blind) folded before Flop
Seat 3: Filojoes folded before Flop (didn't bet)
Seat 4: matiko09 folded before Flop (didn't bet)
Seat 5: ilaviiitech folded before Flop (didn't bet)
Seat 6: FroggyPlay folded before Flop (didn't bet)
Seat 7: mycka86 collected ($6.21)
Seat 8: Kukuryzka folded on the Flop
Seat 9: KLOP06031987 (button) folded before Flop (didn't bet)





PokerStars Hand #147708487295:  Hold'em No Limit ($0.50/$1.00 USD) - 2016/01/26 16:19:58 CET [2016/01/26 10:19:58 ET]
Table 'Aten II' 9-max Seat #9 is the button
Seat 1: cn_chayanne ($113.66 in chips) 
Seat 2: solbi86 ($125.19 in chips) 
Seat 3: ilaviiitech ($100.68 in chips) 
Seat 4: matiko09 ($102.75 in chips) 
Seat 5: sebaaastian ($104.83 in chips) 
Seat 6: ooohaaah ($81.91 in chips) 
Seat 8: KLOP06031987 ($102.10 in chips) 
Seat 9: TorontoBum ($117.04 in chips) 
cn_chayanne: posts small blind $0.50
solbi86: posts big blind $1
Filojoes: sits out 
*** HOLE CARDS ***
Dealt to matiko09 [8h Js]
ilaviiitech: folds 
matiko09: folds 
sebaaastian: folds 
ooohaaah: calls $1
KLOP06031987: folds 
TorontoBum: folds 
cn_chayanne: raises $3 to $4
solbi86: folds 
ooohaaah: folds 
Uncalled bet ($3) returned to cn_chayanne
cn_chayanne collected $3 from pot
cn_chayanne: doesn't show hand 
*** SUMMARY ***
Total pot $3 | Rake $0 
Seat 1: cn_chayanne (small blind) collected ($3)
Seat 2: solbi86 (big blind) folded before Flop
Seat 3: ilaviiitech folded before Flop (didn't bet)
Seat 4: matiko09 folded before Flop (didn't bet)
Seat 5: sebaaastian folded before Flop (didn't bet)
Seat 6: ooohaaah folded before Flop
Seat 8: KLOP06031987 folded before Flop (didn't bet)
Seat 9: TorontoBum (button) folded before Flop (didn't bet)





PokerStars Hand #147708492203:  Hold'em No Limit ($0.50/$1.00 USD) - 2016/01/26 16:20:04 CET [2016/01/26 10:20:04 ET]
Table 'Medusa III' 9-max Seat #7 is the button
Seat 2: happydrake ($142.51 in chips) 
Seat 3: mycka86 ($104.48 in chips) 
Seat 4: simoniustin ($100 in chips) 
Seat 5: matiko09 ($250.13 in chips) 
Seat 6: aseban11 ($110.12 in chips) 
Seat 7: Reven9er ($162.96 in chips) 
Seat 9: sebaaastian ($100 in chips) 
solbi86 will be allowed to play after the button
sebaaastian: posts small blind $0.50
happydrake: posts big blind $1
*** HOLE CARDS ***
Dealt to matiko09 [Kc Qc]
mycka86: folds 
simoniustin: raises $2 to $3
matiko09: calls $3
aseban11: folds 
Reven9er: folds 
sebaaastian: folds 
happydrake: folds 
*** FLOP *** [6s Ad 8c]
simoniustin: bets $4
matiko09: calls $4
*** TURN *** [6s Ad 8c] [Jh]
simoniustin: checks 
matiko09: checks 
*** RIVER *** [6s Ad 8c Jh] [9s]
simoniustin: checks 
matiko09: bets $7.69
simoniustin: folds 
Uncalled bet ($7.69) returned to matiko09
matiko09 collected $14.80 from pot
matiko09: doesn't show hand 
*** SUMMARY ***
Total pot $15.50 | Rake $0.70 
Board [6s Ad 8c Jh 9s]
Seat 2: happydrake (big blind) folded before Flop
Seat 3: mycka86 folded before Flop (didn't bet)
Seat 4: simoniustin folded on the River
Seat 5: matiko09 collected ($14.80)
Seat 6: aseban11 folded before Flop (didn't bet)
Seat 7: Reven9er (button) folded before Flop (didn't bet)
Seat 9: sebaaastian (small blind) folded before Flop





PokerStars Hand #147708494308:  Hold'em No Limit ($0.50/$1.00 USD) - 2016/01/26 16:20:07 CET [2016/01/26 10:20:07 ET]
Table 'Kale II' 9-max Seat #2 is the button
Seat 1: soplak ($100 in chips) 
Seat 2: matiko09 ($100.13 in chips) 
Seat 3: Reven9er ($134.72 in chips) 
Seat 4: aseban11 ($100 in chips) 
Seat 6: simoniustin ($107.50 in chips) 
Seat 7: MILLIONCHIC ($66.79 in chips) 
Seat 8: mycka86 ($120.36 in chips) 
Seat 9: solbi86 ($199.05 in chips) 
Reven9er: posts small blind $0.50
aseban11: posts big blind $1
*** HOLE CARDS ***
Dealt to matiko09 [Kc Jc]
simoniustin: folds 
MILLIONCHIC: calls $1
mycka86: folds 
solbi86: folds 
soplak: raises $3 to $4
matiko09: calls $4
Reven9er: raises $9.50 to $13.50
aseban11: folds 
MILLIONCHIC: folds 
soplak: folds 
matiko09: folds 
Uncalled bet ($9.50) returned to Reven9er
Reven9er collected $14 from pot
Reven9er: doesn't show hand 
*** SUMMARY ***
Total pot $14 | Rake $0 
Seat 1: soplak folded before Flop
Seat 2: matiko09 (button) folded before Flop
Seat 3: Reven9er (small blind) collected ($14)
Seat 4: aseban11 (big blind) folded before Flop
Seat 6: simoniustin folded before Flop (didn't bet)
Seat 7: MILLIONCHIC folded before Flop
Seat 8: mycka86 folded before Flop (didn't bet)
Seat 9: solbi86 folded before Flop (didn't bet)





PokerStars Hand #147708495539:  Hold'em No Limit ($0.50/$1.00 USD) - 2016/01/26 16:20:09 CET [2016/01/26 10:20:09 ET]
Table 'Haedus' 9-max Seat #5 is the button
Seat 1: matiko09 ($100 in chips) 
Seat 3: cn_chayanne ($100 in chips) 
Seat 4: timur3-5-7 ($101.51 in chips) 
Seat 5: solbi86 ($115.58 in chips) 
Seat 6: simoniustin ($100.50 in chips) 
Seat 7: KLOP06031987 ($110.50 in chips) 
Seat 8: Jimy Tiltman ($106.24 in chips) 
Seat 9: Filojoes ($136.99 in chips) 
simoniustin: posts small blind $0.50
KLOP06031987: posts big blind $1
aseban11: sits out 
*** HOLE CARDS ***
Dealt to matiko09 [6c Th]
Jimy Tiltman: folds 
Jimy Tiltman leaves the table
Filojoes: folds 
matiko09: folds 
XxInsanexXQc joins the table at seat #8 
cn_chayanne: folds 
timur3-5-7: folds 
solbi86: raises $1 to $2
simoniustin: folds 
KLOP06031987: raises $6 to $8
solbi86: calls $6
*** FLOP *** [Kd Ks 9s]
KLOP06031987: checks 
solbi86: checks 
*** TURN *** [Kd Ks 9s] [7c]
KLOP06031987: checks 
solbi86: checks 
*** RIVER *** [Kd Ks 9s 7c] [Ts]
KLOP06031987: bets $7
solbi86: calls $7
*** SHOW DOWN ***
KLOP06031987: shows [Kh Kc] (four of a kind, Kings)
solbi86: mucks hand 
KLOP06031987 collected $29.13 from pot
*** SUMMARY ***
Total pot $30.50 | Rake $1.37 
Board [Kd Ks 9s 7c Ts]
Seat 1: matiko09 folded before Flop (didn't bet)
Seat 3: cn_chayanne folded before Flop (didn't bet)
Seat 4: timur3-5-7 folded before Flop (didn't bet)
Seat 5: solbi86 (button) mucked [7s 8s]
Seat 6: simoniustin (small blind) folded before Flop
Seat 7: KLOP06031987 (big blind) showed [Kh Kc] and won ($29.13) with four of a kind, Kings
Seat 8: Jimy Tiltman folded before Flop (didn't bet)
Seat 9: Filojoes folded before Flop (didn't bet)





PokerStars Hand #147708498396:  Hold'em No Limit ($0.50/$1.00 USD) - 2016/01/26 16:20:12 CET [2016/01/26 10:20:12 ET]
Table 'Srbija III' 9-max Seat #5 is the button
Seat 1: simoniustin ($104.73 in chips) 
Seat 2: cn_chayanne ($100 in chips) 
Seat 3: LIGOPSIXIS78 ($65.17 in chips) 
Seat 4: petalouda10 ($84.73 in chips) 
Seat 5: mycka86 ($100 in chips) 
Seat 6: matiko09 ($212.76 in chips) 
Seat 7: KLOP06031987 ($114.02 in chips) 
Seat 8: solbi86 ($100.69 in chips) 
matiko09: posts small blind $0.50
KLOP06031987: posts big blind $1
soplak: sits out 
*** HOLE CARDS ***
Dealt to matiko09 [Th Qs]
solbi86: folds 
simoniustin: folds 
cn_chayanne: raises $1.50 to $2.50
LIGOPSIXIS78: folds 
petalouda10: folds 
mycka86: folds 
matiko09: folds 
KLOP06031987: folds 
Uncalled bet ($1.50) returned to cn_chayanne
cn_chayanne collected $2.50 from pot
cn_chayanne: doesn't show hand 
*** SUMMARY ***
Total pot $2.50 | Rake $0 
Seat 1: simoniustin folded before Flop (didn't bet)
Seat 2: cn_chayanne collected ($2.50)
Seat 3: LIGOPSIXIS78 folded before Flop (didn't bet)
Seat 4: petalouda10 folded before Flop (didn't bet)
Seat 5: mycka86 (button) folded before Flop (didn't bet)
Seat 6: matiko09 (small blind) folded before Flop
Seat 7: KLOP06031987 (big blind) folded before Flop
Seat 8: solbi86 folded before Flop (didn't bet)





PokerStars Hand #147708500070:  Hold'em No Limit ($0.50/$1.00 USD) - 2016/01/26 16:20:15 CET [2016/01/26 10:20:15 ET]
Table 'Impala' 9-max Seat #8 is the button
Seat 1: mycka86 ($145.94 in chips) 
Seat 2: Filojoes ($104.16 in chips) 
Seat 4: Rikti ($92.26 in chips) 
Seat 5: Kukuryzka ($100 in chips) 
Seat 6: Tijger R.d.J ($109.29 in chips) 
Seat 7: matiko09 ($111.24 in chips) 
Seat 8: apfush ($102 in chips) 
Seat 9: flozzi ($104.07 in chips) 
flozzi: posts small blind $0.50
mycka86: posts big blind $1
simoniustin: sits out 
*** HOLE CARDS ***
Dealt to matiko09 [8h Ts]
Filojoes: folds 
Rikti: folds 
Kukuryzka: folds 
Tijger R.d.J: raises $1 to $2
matiko09: folds 
apfush: folds 
flozzi: folds 
mycka86: folds 
Uncalled bet ($1) returned to Tijger R.d.J
Tijger R.d.J collected $2.50 from pot
Tijger R.d.J: doesn't show hand 
*** SUMMARY ***
Total pot $2.50 | Rake $0 
Seat 1: mycka86 (big blind) folded before Flop
Seat 2: Filojoes folded before Flop (didn't bet)
Seat 4: Rikti folded before Flop (didn't bet)
Seat 5: Kukuryzka folded before Flop (didn't bet)
Seat 6: Tijger R.d.J collected ($2.50)
Seat 7: matiko09 folded before Flop (didn't bet)
Seat 8: apfush (button) folded before Flop (didn't bet)
Seat 9: flozzi (small blind) folded before Flop





PokerStars Hand #147708501623:  Hold'em No Limit ($0.50/$1.00 USD) - 2016/01/26 16:20:17 CET [2016/01/26 10:20:17 ET]
Table 'Achates III' 9-max Seat #9 is the button
Seat 2: matiko09 ($125.70 in chips) 
Seat 4: cn_chayanne ($100 in chips) 
Seat 5: simoniustin ($100 in chips) 
Seat 6: solbi86 ($114.47 in chips) 
Seat 7: 1989freak ($101.39 in chips) 
Seat 8: easycomengo ($111.54 in chips) 
Seat 9: T-chaos_IMBA ($329.17 in chips) 
matiko09: posts small blind $0.50
Jimy Tiltman: is sitting out 
cn_chayanne: posts big blind $1
*** HOLE CARDS ***
Dealt to matiko09 [Kh 6h]
Jimy Tiltman leaves the table
simoniustin: folds 
solbi86: folds 
maxxmeister joins the table at seat #3 
1989freak has timed out
1989freak: folds 
easycomengo: raises $2 to $3
T-chaos_IMBA: calls $3
matiko09: folds 
cn_chayanne: calls $2
*** FLOP *** [Ks 2h Kd]
cn_chayanne: checks 
easycomengo: bets $4.08
T-chaos_IMBA: calls $4.08
cn_chayanne: folds 
*** TURN *** [Ks 2h Kd] [4d]
easycomengo: bets $9
T-chaos_IMBA: raises $11 to $20
easycomengo: calls $11
*** RIVER *** [Ks 2h Kd 4d] [8c]
easycomengo: checks 
T-chaos_IMBA: bets $39
maxxmeister leaves the table
easycomengo: calls $39
*** SHOW DOWN ***
T-chaos_IMBA: shows [4h 4s] (a full house, Fours full of Kings)
easycomengo: mucks hand 
T-chaos_IMBA collected $132.86 from pot
*** SUMMARY ***
Total pot $135.66 | Rake $2.80 
Board [Ks 2h Kd 4d 8c]
Seat 2: matiko09 (small blind) folded before Flop
Seat 4: cn_chayanne (big blind) folded on the Flop
Seat 5: simoniustin folded before Flop (didn't bet)
Seat 6: solbi86 folded before Flop (didn't bet)
Seat 7: 1989freak folded before Flop (didn't bet)
Seat 8: easycomengo mucked [Kc Js]
Seat 9: T-chaos_IMBA (button) showed [4h 4s] and won ($132.86) with a full house, Fours full of Kings





PokerStars Hand #147708501524:  Hold'em No Limit ($0.50/$1.00 USD) - 2016/01/26 16:20:17 CET [2016/01/26 10:20:17 ET]
Table 'Calypso II' 9-max Seat #3 is the button
Seat 1: KLOP06031987 ($100 in chips) 
Seat 2: simoniustin ($100 in chips) 
Seat 3: matiko09 ($238.43 in chips) 
Seat 4: aseban11 ($100 in chips) 
Seat 5: mycka86 ($115 in chips) 
Seat 6: MrDeeee25 ($112.91 in chips) 
Seat 7: Tasvision_mö ($43.31 in chips) 
Seat 8: Reven9er ($101.50 in chips) 
Seat 9: Filojoes ($143.61 in chips) 
aseban11: posts small blind $0.50
mycka86: posts big blind $1
*** HOLE CARDS ***
Dealt to matiko09 [4s Qc]
MrDeeee25: folds 
Tasvision_mö: raises $1 to $2
MrDeeee25 leaves the table
Reven9er: raises $4.50 to $6.50
Filojoes: folds 
KLOP06031987: folds 
simoniustin: folds 
matiko09: folds 
lobede joins the table at seat #6 
aseban11: folds 
mycka86: folds 
Tasvision_mö: folds 
Uncalled bet ($4.50) returned to Reven9er
Reven9er collected $5.50 from pot
Reven9er: doesn't show hand 
*** SUMMARY ***
Total pot $5.50 | Rake $0 
Seat 1: KLOP06031987 folded before Flop (didn't bet)
Seat 2: simoniustin folded before Flop (didn't bet)
Seat 3: matiko09 (button) folded before Flop (didn't bet)
Seat 4: aseban11 (small blind) folded before Flop
Seat 5: mycka86 (big blind) folded before Flop
Seat 6: MrDeeee25 folded before Flop (didn't bet)
Seat 7: Tasvision_mö folded before Flop
Seat 8: Reven9er collected ($5.50)
Seat 9: Filojoes folded before Flop (didn't bet)





PokerStars Hand #147708503314:  Hold'em No Limit ($0.50/$1.00 USD) - 2016/01/26 16:20:19 CET [2016/01/26 10:20:19 ET]
Table 'Aten II' 9-max Seat #1 is the button
Seat 1: cn_chayanne ($115.66 in chips) 
Seat 2: solbi86 ($124.19 in chips) 
Seat 4: matiko09 ($102.75 in chips) 
Seat 5: sebaaastian ($104.83 in chips) 
Seat 6: ooohaaah ($80.91 in chips) 
Seat 8: KLOP06031987 ($102.10 in chips) 
Seat 9: TorontoBum ($117.04 in chips) 
solbi86: posts small blind $0.50
ilaviiitech: is sitting out 
matiko09: posts big blind $1
Filojoes: sits out 
*** HOLE CARDS ***
Dealt to matiko09 [5h 7d]
sebaaastian: folds 
ilaviiitech leaves the table
ooohaaah: folds 
KLOP06031987: folds 
TorontoBum: folds 
cn_chayanne: folds 
solbi86: raises $1.50 to $2.50
matiko09: folds 
Uncalled bet ($1.50) returned to solbi86
solbi86 collected $2 from pot
solbi86: doesn't show hand 
*** SUMMARY ***
Total pot $2 | Rake $0 
Seat 1: cn_chayanne (button) folded before Flop (didn't bet)
Seat 2: solbi86 (small blind) collected ($2)
Seat 4: matiko09 (big blind) folded before Flop
Seat 5: sebaaastian folded before Flop (didn't bet)
Seat 6: ooohaaah folded before Flop (didn't bet)
Seat 8: KLOP06031987 folded before Flop (didn't bet)
Seat 9: TorontoBum folded before Flop (didn't bet)





PokerStars Hand #147708513000:  Hold'em No Limit ($0.50/$1.00 USD) - 2016/01/26 16:20:31 CET [2016/01/26 10:20:31 ET]
Table 'Strenua III' 9-max Seat #9 is the button
Seat 1: Rikti ($97.16 in chips) 
Seat 3: petalouda10 ($15.03 in chips) 
Seat 4: mycka86 ($118.86 in chips) 
Seat 5: DeWeijz ($42.57 in chips) 
Seat 6: matiko09 ($169.61 in chips) 
Seat 7: KLOP06031987 ($100.98 in chips) 
Seat 8: Filojoes ($102.69 in chips) 
Seat 9: maxxmeister ($100 in chips) 
Rikti: posts small blind $0.50
cn_chayanne: is sitting out 
petalouda10: posts big blind $1
*** HOLE CARDS ***
Dealt to matiko09 [7d 6h]
cn_chayanne leaves the table
mycka86: raises $2 to $3
DeWeijz: folds 
simoniustin joins the table at seat #2 
matiko09: folds 
KLOP06031987: folds 
Filojoes: folds 
maxxmeister: folds 
Rikti: folds 
petalouda10: folds 
Uncalled bet ($2) returned to mycka86
mycka86 collected $2.50 from pot
*** SUMMARY ***
Total pot $2.50 | Rake $0 
Seat 1: Rikti (small blind) folded before Flop
Seat 3: petalouda10 (big blind) folded before Flop
Seat 4: mycka86 collected ($2.50)
Seat 5: DeWeijz folded before Flop (didn't bet)
Seat 6: matiko09 folded before Flop (didn't bet)
Seat 7: KLOP06031987 folded before Flop (didn't bet)
Seat 8: Filojoes folded before Flop (didn't bet)
Seat 9: maxxmeister (button) folded before Flop (didn't bet)





PokerStars Hand #147708517499:  Hold'em No Limit ($0.50/$1.00 USD) - 2016/01/26 16:20:37 CET [2016/01/26 10:20:37 ET]
Table 'Aten II' 9-max Seat #2 is the button
Seat 1: cn_chayanne ($115.66 in chips) 
Seat 2: solbi86 ($125.19 in chips) 
Seat 4: matiko09 ($101.75 in chips) 
Seat 5: sebaaastian ($104.83 in chips) 
Seat 6: ooohaaah ($80.91 in chips) 
Seat 8: KLOP06031987 ($102.10 in chips) 
Seat 9: TorontoBum ($117.04 in chips) 
matiko09: posts small blind $0.50
sebaaastian: posts big blind $1
Filojoes: sits out 
*** HOLE CARDS ***
Dealt to matiko09 [Ad 4h]
aseban11 joins the table at seat #3 
ooohaaah: folds 
KLOP06031987: folds 
TorontoBum: folds 
cn_chayanne: folds 
solbi86: raises $1 to $2
matiko09: folds 
sebaaastian: calls $1
*** FLOP *** [2h Ts 2c]
sebaaastian: checks 
solbi86: bets $2.45
sebaaastian: folds 
Uncalled bet ($2.45) returned to solbi86
solbi86 collected $4.30 from pot
solbi86: doesn't show hand 
*** SUMMARY ***
Total pot $4.50 | Rake $0.20 
Board [2h Ts 2c]
Seat 1: cn_chayanne folded before Flop (didn't bet)
Seat 2: solbi86 (button) collected ($4.30)
Seat 4: matiko09 (small blind) folded before Flop
Seat 5: sebaaastian (big blind) folded on the Flop
Seat 6: ooohaaah folded before Flop (didn't bet)
Seat 8: KLOP06031987 folded before Flop (didn't bet)
Seat 9: TorontoBum folded before Flop (didn't bet)





PokerStars Hand #147708520427:  Hold'em No Limit ($0.50/$1.00 USD) - 2016/01/26 16:20:41 CET [2016/01/26 10:20:41 ET]
Table 'Srbija III' 9-max Seat #6 is the button
Seat 1: simoniustin ($104.73 in chips) 
Seat 2: cn_chayanne ($101.50 in chips) 
Seat 3: LIGOPSIXIS78 ($65.17 in chips) 
Seat 4: petalouda10 ($84.73 in chips) 
Seat 5: mycka86 ($100 in chips) 
Seat 6: matiko09 ($212.26 in chips) 
Seat 7: KLOP06031987 ($113.02 in chips) 
Seat 8: solbi86 ($100.69 in chips) 
KLOP06031987: posts small blind $0.50
solbi86: posts big blind $1
soplak: sits out 
*** HOLE CARDS ***
Dealt to matiko09 [As 8h]
simoniustin: folds 
cn_chayanne: folds 
LIGOPSIXIS78: folds 
petalouda10: folds 
mycka86: raises $1.10 to $2.10
matiko09: folds 
KLOP06031987: folds 
solbi86: folds 
Uncalled bet ($1.10) returned to mycka86
mycka86 collected $2.50 from pot
*** SUMMARY ***
Total pot $2.50 | Rake $0 
Seat 1: simoniustin folded before Flop (didn't bet)
Seat 2: cn_chayanne folded before Flop (didn't bet)
Seat 3: LIGOPSIXIS78 folded before Flop (didn't bet)
Seat 4: petalouda10 folded before Flop (didn't bet)
Seat 5: mycka86 collected ($2.50)
Seat 6: matiko09 (button) folded before Flop (didn't bet)
Seat 7: KLOP06031987 (small blind) folded before Flop
Seat 8: solbi86 (big blind) folded before Flop





PokerStars Hand #147708531020:  Hold'em No Limit ($0.50/$1.00 USD) - 2016/01/26 16:20:55 CET [2016/01/26 10:20:55 ET]
Table 'Montefiore' 9-max Seat #1 is the button
Seat 1: simoniustin ($100 in chips) 
Seat 2: D†est7oye†R ($100 in chips) 
Seat 3: Filojoes ($100 in chips) 
Seat 4: matiko09 ($100 in chips) 
Seat 5: ilaviiitech ($101.50 in chips) 
Seat 6: FroggyPlay ($100 in chips) 
Seat 7: mycka86 ($103.71 in chips) 
Seat 8: Kukuryzka ($99 in chips) 
Seat 9: KLOP06031987 ($110.58 in chips) 
D†est7oye†R: posts small blind $0.50
Filojoes: posts big blind $1
*** HOLE CARDS ***
Dealt to matiko09 [9d 7h]
matiko09: folds 
ilaviiitech: folds 
FroggyPlay: folds 
mycka86: folds 
Kukuryzka: folds 
KLOP06031987: folds 
simoniustin: raises $1.50 to $2.50
D†est7oye†R: folds 
Filojoes: folds 
Uncalled bet ($1.50) returned to simoniustin
simoniustin collected $2.50 from pot
simoniustin: doesn't show hand 
*** SUMMARY ***
Total pot $2.50 | Rake $0 
Seat 1: simoniustin (button) collected ($2.50)
Seat 2: D†est7oye†R (small blind) folded before Flop
Seat 3: Filojoes (big blind) folded before Flop
Seat 4: matiko09 folded before Flop (didn't bet)
Seat 5: ilaviiitech folded before Flop (didn't bet)
Seat 6: FroggyPlay folded before Flop (didn't bet)
Seat 7: mycka86 folded before Flop (didn't bet)
Seat 8: Kukuryzka folded before Flop (didn't bet)
Seat 9: KLOP06031987 folded before Flop (didn't bet)





PokerStars Hand #147708531565:  Hold'em No Limit ($0.50/$1.00 USD) - 2016/01/26 16:20:56 CET [2016/01/26 10:20:56 ET]
Table 'Strenua III' 9-max Seat #1 is the button
Seat 1: Rikti ($96.66 in chips) 
Seat 3: petalouda10 ($14.03 in chips) 
Seat 4: mycka86 ($120.36 in chips) 
Seat 5: DeWeijz ($42.57 in chips) 
Seat 6: matiko09 ($169.61 in chips) 
Seat 7: KLOP06031987 ($100.98 in chips) 
Seat 8: Filojoes ($102.69 in chips) 
Seat 9: maxxmeister ($100 in chips) 
simoniustin will be allowed to play after the button
petalouda10: posts small blind $0.50
mycka86: posts big blind $1
*** HOLE CARDS ***
Dealt to matiko09 [Qh 4d]
DeWeijz: folds 
matiko09: folds 
KLOP06031987: folds 
Filojoes: folds 
maxxmeister: folds 
Rikti: raises $1.50 to $2.50
petalouda10: folds 
mycka86: folds 
Uncalled bet ($1.50) returned to Rikti
Rikti collected $2.50 from pot
Rikti: doesn't show hand 
*** SUMMARY ***
Total pot $2.50 | Rake $0 
Seat 1: Rikti (button) collected ($2.50)
Seat 3: petalouda10 (small blind) folded before Flop
Seat 4: mycka86 (big blind) folded before Flop
Seat 5: DeWeijz folded before Flop (didn't bet)
Seat 6: matiko09 folded before Flop (didn't bet)
Seat 7: KLOP06031987 folded before Flop (didn't bet)
Seat 8: Filojoes folded before Flop (didn't bet)
Seat 9: maxxmeister folded before Flop (didn't bet)





PokerStars Hand #147708534262:  Hold'em No Limit ($0.50/$1.00 USD) - 2016/01/26 16:21:00 CET [2016/01/26 10:21:00 ET]
Table 'Mashona' 9-max Seat #7 is the button
Seat 1: maxxmeister ($125.90 in chips) 
Seat 2: werades ($212.38 in chips) 
Seat 3: matiko09 ($138.37 in chips) 
Seat 4: mycka86 ($107.62 in chips) 
Seat 5: solbi86 ($129.38 in chips) 
Seat 6: Filojoes ($100 in chips) 
Seat 7: EB0LARAMA ($295.74 in chips) 
Seat 8: simoniustin ($100 in chips) 
Seat 9: apfush ($105.57 in chips) 
simoniustin: posts small blind $0.50
apfush: posts big blind $1
*** HOLE CARDS ***
Dealt to matiko09 [2d Qs]
maxxmeister: folds 
werades: folds 
matiko09: folds 
mycka86: folds 
solbi86: raises $2 to $3
Filojoes: folds 
EB0LARAMA: folds 
simoniustin: folds 
apfush: calls $2
*** FLOP *** [Kh Th Ts]
apfush: checks 
solbi86: bets $4.09
apfush: folds 
Uncalled bet ($4.09) returned to solbi86
solbi86 collected $6.21 from pot
solbi86: doesn't show hand 
*** SUMMARY ***
Total pot $6.50 | Rake $0.29 
Board [Kh Th Ts]
Seat 1: maxxmeister folded before Flop (didn't bet)
Seat 2: werades folded before Flop (didn't bet)
Seat 3: matiko09 folded before Flop (didn't bet)
Seat 4: mycka86 folded before Flop (didn't bet)
Seat 5: solbi86 collected ($6.21)
Seat 6: Filojoes folded before Flop (didn't bet)
Seat 7: EB0LARAMA (button) folded before Flop (didn't bet)
Seat 8: simoniustin (small blind) folded before Flop
Seat 9: apfush (big blind) folded on the Flop





PokerStars Hand #147708536530:  Hold'em No Limit ($0.50/$1.00 USD) - 2016/01/26 16:21:03 CET [2016/01/26 10:21:03 ET]
Table 'Medusa III' 9-max Seat #9 is the button
Seat 2: happydrake ($141.51 in chips) 
Seat 3: mycka86 ($104.48 in chips) 
Seat 4: simoniustin ($100 in chips) 
Seat 5: matiko09 ($257.93 in chips) 
Seat 6: aseban11 ($110.12 in chips) 
Seat 7: Reven9er ($162.96 in chips) 
Seat 9: sebaaastian ($100 in chips) 
happydrake: posts small blind $0.50
mycka86: posts big blind $1
solbi86: sits out 
*** HOLE CARDS ***
Dealt to matiko09 [As Ks]
simoniustin: folds 
matiko09: raises $2 to $3
aseban11: folds 
Reven9er: folds 
sebaaastian: folds 
happydrake: folds 
mycka86: folds 
Uncalled bet ($2) returned to matiko09
matiko09 collected $2.50 from pot
matiko09: doesn't show hand 
*** SUMMARY ***
Total pot $2.50 | Rake $0 
Seat 2: happydrake (small blind) folded before Flop
Seat 3: mycka86 (big blind) folded before Flop
Seat 4: simoniustin folded before Flop (didn't bet)
Seat 5: matiko09 collected ($2.50)
Seat 6: aseban11 folded before Flop (didn't bet)
Seat 7: Reven9er folded before Flop (didn't bet)
Seat 9: sebaaastian (button) folded before Flop (didn't bet)





PokerStars Hand #147708544426:  Hold'em No Limit ($0.50/$1.00 USD) - 2016/01/26 16:21:13 CET [2016/01/26 10:21:13 ET]
Table 'Kale II' 9-max Seat #3 is the button
Seat 1: soplak ($100 in chips) 
Seat 2: matiko09 ($100 in chips) 
Seat 3: Reven9er ($144.72 in chips) 
Seat 4: aseban11 ($100 in chips) 
Seat 6: simoniustin ($107.50 in chips) 
Seat 7: MILLIONCHIC ($65.79 in chips) 
Seat 8: mycka86 ($120.36 in chips) 
Seat 9: solbi86 ($199.05 in chips) 
aseban11: posts small blind $0.50
simoniustin: posts big blind $1
*** HOLE CARDS ***
Dealt to matiko09 [Kd 7c]
MILLIONCHIC: calls $1
mycka86: folds 
solbi86: folds 
soplak: folds 
matiko09: folds 
Reven9er: raises $1.50 to $2.50
aseban11: folds 
simoniustin: raises $11.50 to $14
MILLIONCHIC: folds 
Reven9er: folds 
Uncalled bet ($11.50) returned to simoniustin
simoniustin collected $6.50 from pot
simoniustin: doesn't show hand 
*** SUMMARY ***
Total pot $6.50 | Rake $0 
Seat 1: soplak folded before Flop (didn't bet)
Seat 2: matiko09 folded before Flop (didn't bet)
Seat 3: Reven9er (button) folded before Flop
Seat 4: aseban11 (small blind) folded before Flop
Seat 6: simoniustin (big blind) collected ($6.50)
Seat 7: MILLIONCHIC folded before Flop
Seat 8: mycka86 folded before Flop (didn't bet)
Seat 9: solbi86 folded before Flop (didn't bet)





PokerStars Hand #147708550899:  Hold'em No Limit ($0.50/$1.00 USD) - 2016/01/26 16:21:21 CET [2016/01/26 10:21:21 ET]
Table 'Calypso II' 9-max Seat #4 is the button
Seat 1: KLOP06031987 ($100 in chips) 
Seat 2: simoniustin ($100 in chips) 
Seat 3: matiko09 ($238.43 in chips) 
Seat 4: aseban11 ($100 in chips) 
Seat 5: mycka86 ($114 in chips) 
Seat 6: lobede ($100 in chips) 
Seat 7: Tasvision_mö ($41.31 in chips) 
Seat 8: Reven9er ($105 in chips) 
Seat 9: Filojoes ($143.61 in chips) 
mycka86: posts small blind $0.50
lobede: posts big blind $1
*** HOLE CARDS ***
Dealt to matiko09 [2d 8s]
Tasvision_mö: folds 
Reven9er: folds 
Filojoes: folds 
KLOP06031987: folds 
simoniustin: folds 
matiko09: folds 
aseban11: folds 
mycka86: raises $1.75 to $2.75
lobede: calls $1.75
*** FLOP *** [4h 2s 9s]
mycka86: bets $2.88
lobede: calls $2.88
*** TURN *** [4h 2s 9s] [Js]
mycka86: checks 
lobede: bets $5
mycka86: folds 
Uncalled bet ($5) returned to lobede
lobede collected $10.75 from pot
lobede: doesn't show hand 
*** SUMMARY ***
Total pot $11.26 | Rake $0.51 
Board [4h 2s 9s Js]
Seat 1: KLOP06031987 folded before Flop (didn't bet)
Seat 2: simoniustin folded before Flop (didn't bet)
Seat 3: matiko09 folded before Flop (didn't bet)
Seat 4: aseban11 (button) folded before Flop (didn't bet)
Seat 5: mycka86 (small blind) folded on the Turn
Seat 6: lobede (big blind) collected ($10.75)
Seat 7: Tasvision_mö folded before Flop (didn't bet)
Seat 8: Reven9er folded before Flop (didn't bet)
Seat 9: Filojoes folded before Flop (didn't bet)





PokerStars Hand #147708551508:  Hold'em No Limit ($0.50/$1.00 USD) - 2016/01/26 16:21:22 CET [2016/01/26 10:21:22 ET]
Table 'Srbija III' 9-max Seat #7 is the button
Seat 1: simoniustin ($104.73 in chips) 
Seat 2: cn_chayanne ($101.50 in chips) 
Seat 3: LIGOPSIXIS78 ($65.17 in chips) 
Seat 4: petalouda10 ($84.73 in chips) 
Seat 5: mycka86 ($101.50 in chips) 
Seat 6: matiko09 ($212.26 in chips) 
Seat 7: KLOP06031987 ($112.52 in chips) 
Seat 8: solbi86 ($100 in chips) 
Seat 9: soplak ($121.65 in chips) 
solbi86: posts small blind $0.50
soplak: posts big blind $1
*** HOLE CARDS ***
Dealt to matiko09 [2h As]
simoniustin: folds 
cn_chayanne: folds 
LIGOPSIXIS78: folds 
petalouda10: calls $1
mycka86: folds 
matiko09: raises $3 to $4
KLOP06031987: folds 
solbi86: folds 
soplak: calls $3
petalouda10: calls $3
*** FLOP *** [7c 9s 6d]
soplak: checks 
petalouda10: bets $5.97
matiko09: folds 
soplak: raises $15.83 to $21.80
petalouda10: calls $15.83
*** TURN *** [7c 9s 6d] [5d]
soplak: checks 
petalouda10: bets $26.79
soplak: raises $69.06 to $95.85 and is all-in
petalouda10: calls $32.14 and is all-in
Uncalled bet ($36.92) returned to soplak
*** RIVER *** [7c 9s 6d 5d] [4s]
*** SHOW DOWN ***
soplak: shows [9d 9c] (three of a kind, Nines)
petalouda10: shows [Kh 8h] (a straight, Five to Nine)
petalouda10 collected $171.16 from pot
*** SUMMARY ***
Total pot $173.96 | Rake $2.80 
Board [7c 9s 6d 5d 4s]
Seat 1: simoniustin folded before Flop (didn't bet)
Seat 2: cn_chayanne folded before Flop (didn't bet)
Seat 3: LIGOPSIXIS78 folded before Flop (didn't bet)
Seat 4: petalouda10 showed [Kh 8h] and won ($171.16) with a straight, Five to Nine
Seat 5: mycka86 folded before Flop (didn't bet)
Seat 6: matiko09 folded on the Flop
Seat 7: KLOP06031987 (button) folded before Flop (didn't bet)
Seat 8: solbi86 (small blind) folded before Flop
Seat 9: soplak (big blind) showed [9d 9c] and lost with three of a kind, Nines





PokerStars Hand #147708552606:  Hold'em No Limit ($0.50/$1.00 USD) - 2016/01/26 16:21:24 CET [2016/01/26 10:21:24 ET]
Table 'Impala' 9-max Seat #9 is the button
Seat 1: mycka86 ($144.94 in chips) 
Seat 2: Filojoes ($104.16 in chips) 
Seat 4: Rikti ($92.26 in chips) 
Seat 5: Kukuryzka ($100 in chips) 
Seat 6: Tijger R.d.J ($110.79 in chips) 
Seat 7: matiko09 ($111.24 in chips) 
Seat 8: apfush ($102 in chips) 
Seat 9: flozzi ($103.57 in chips) 
mycka86: posts small blind $0.50
Filojoes: posts big blind $1
simoniustin: sits out 
*** HOLE CARDS ***
Dealt to matiko09 [3h Js]
Rikti: folds 
Kukuryzka: folds 
Tijger R.d.J: raises $1.45 to $2.45
matiko09: folds 
apfush: folds 
flozzi: folds 
mycka86: folds 
Filojoes: calls $1.45
*** FLOP *** [Qc 8s Ks]
Filojoes: bets $3.10
Tijger R.d.J: calls $3.10
*** TURN *** [Qc 8s Ks] [4h]
Filojoes: bets $7
Tijger R.d.J: folds 
Uncalled bet ($7) returned to Filojoes
Filojoes collected $11.08 from pot
Filojoes: doesn't show hand 
*** SUMMARY ***
Total pot $11.60 | Rake $0.52 
Board [Qc 8s Ks 4h]
Seat 1: mycka86 (small blind) folded before Flop
Seat 2: Filojoes (big blind) collected ($11.08)
Seat 4: Rikti folded before Flop (didn't bet)
Seat 5: Kukuryzka folded before Flop (didn't bet)
Seat 6: Tijger R.d.J folded on the Turn
Seat 7: matiko09 folded before Flop (didn't bet)
Seat 8: apfush folded before Flop (didn't bet)
Seat 9: flozzi (button) folded before Flop (didn't bet)





PokerStars Hand #147708557166:  Hold'em No Limit ($0.50/$1.00 USD) - 2016/01/26 16:21:30 CET [2016/01/26 10:21:30 ET]
Table 'Strenua III' 9-max Seat #3 is the button
Seat 1: Rikti ($98.16 in chips) 
Seat 3: petalouda10 ($13.53 in chips) 
Seat 4: mycka86 ($119.36 in chips) 
Seat 5: DeWeijz ($42.57 in chips) 
Seat 6: matiko09 ($169.61 in chips) 
Seat 7: KLOP06031987 ($100.98 in chips) 
Seat 8: Filojoes ($102.69 in chips) 
Seat 9: maxxmeister ($100 in chips) 
mycka86: posts small blind $0.50
DeWeijz: posts big blind $1
simoniustin: sits out 
*** HOLE CARDS ***
Dealt to matiko09 [Kc Jc]
matiko09: raises $2 to $3
KLOP06031987: raises $6 to $9
Filojoes: folds 
maxxmeister: folds 
Rikti: folds 
petalouda10: folds 
mycka86: folds 
DeWeijz: folds 
matiko09: folds 
Uncalled bet ($6) returned to KLOP06031987
KLOP06031987 collected $7.50 from pot
KLOP06031987: doesn't show hand 
*** SUMMARY ***
Total pot $7.50 | Rake $0 
Seat 1: Rikti folded before Flop (didn't bet)
Seat 3: petalouda10 (button) folded before Flop (didn't bet)
Seat 4: mycka86 (small blind) folded before Flop
Seat 5: DeWeijz (big blind) folded before Flop
Seat 6: matiko09 folded before Flop
Seat 7: KLOP06031987 collected ($7.50)
Seat 8: Filojoes folded before Flop (didn't bet)
Seat 9: maxxmeister folded before Flop (didn't bet)





PokerStars Hand #147708560184:  Hold'em No Limit ($0.50/$1.00 USD) - 2016/01/26 16:21:34 CET [2016/01/26 10:21:34 ET]
Table 'Aten II' 9-max Seat #4 is the button
Seat 1: cn_chayanne ($115.66 in chips) 
Seat 2: solbi86 ($127.49 in chips) 
Seat 4: matiko09 ($101.25 in chips) 
Seat 5: sebaaastian ($102.83 in chips) 
Seat 6: ooohaaah ($80.91 in chips) 
Seat 8: KLOP06031987 ($102.10 in chips) 
Seat 9: TorontoBum ($117.04 in chips) 
sebaaastian: posts small blind $0.50
ooohaaah: posts big blind $1
Filojoes: sits out 
aseban11: sits out 
*** HOLE CARDS ***
Dealt to matiko09 [8h Js]
KLOP06031987: folds 
TorontoBum: folds 
cn_chayanne: folds 
solbi86: folds 
matiko09: raises $1.27 to $2.27
sebaaastian: folds 
ooohaaah: calls $1.27
*** FLOP *** [As 8d 7h]
ooohaaah: checks 
matiko09: bets $2.50
ooohaaah: raises $2.50 to $5
matiko09: folds 
Uncalled bet ($2.50) returned to ooohaaah
ooohaaah collected $9.59 from pot
ooohaaah: doesn't show hand 
*** SUMMARY ***
Total pot $10.04 | Rake $0.45 
Board [As 8d 7h]
Seat 1: cn_chayanne folded before Flop (didn't bet)
Seat 2: solbi86 folded before Flop (didn't bet)
Seat 4: matiko09 (button) folded on the Flop
Seat 5: sebaaastian (small blind) folded before Flop
Seat 6: ooohaaah (big blind) collected ($9.59)
Seat 8: KLOP06031987 folded before Flop (didn't bet)
Seat 9: TorontoBum folded before Flop (didn't bet)





PokerStars Hand #147708561070:  Hold'em No Limit ($0.50/$1.00 USD) - 2016/01/26 16:21:35 CET [2016/01/26 10:21:35 ET]
Table 'Medusa III' 9-max Seat #2 is the button
Seat 2: happydrake ($141.01 in chips) 
Seat 3: mycka86 ($103.48 in chips) 
Seat 4: simoniustin ($100 in chips) 
Seat 5: matiko09 ($259.43 in chips) 
Seat 6: aseban11 ($110.12 in chips) 
Seat 7: Reven9er ($162.96 in chips) 
Seat 9: sebaaastian ($100 in chips) 
mycka86: posts small blind $0.50
simoniustin: posts big blind $1
solbi86: sits out 
*** HOLE CARDS ***
Dealt to matiko09 [5s Kc]
matiko09: folds 
aseban11: folds 
Reven9er: folds 
sebaaastian: folds 
happydrake: calls $1
mycka86: raises $3.50 to $4.50
simoniustin: folds 
happydrake: calls $3.50
*** FLOP *** [5h Th Ks]
mycka86: bets $6.50
happydrake: folds 
Uncalled bet ($6.50) returned to mycka86
mycka86 collected $9.55 from pot
*** SUMMARY ***
Total pot $10 | Rake $0.45 
Board [5h Th Ks]
Seat 2: happydrake (button) folded on the Flop
Seat 3: mycka86 (small blind) collected ($9.55)
Seat 4: simoniustin (big blind) folded before Flop
Seat 5: matiko09 folded before Flop (didn't bet)
Seat 6: aseban11 folded before Flop (didn't bet)
Seat 7: Reven9er folded before Flop (didn't bet)
Seat 9: sebaaastian folded before Flop (didn't bet)





PokerStars Hand #147708566688:  Hold'em No Limit ($0.50/$1.00 USD) - 2016/01/26 16:21:42 CET [2016/01/26 10:21:42 ET]
Table 'Haedus' 9-max Seat #6 is the button
Seat 1: matiko09 ($100 in chips) 
Seat 3: cn_chayanne ($100 in chips) 
Seat 4: timur3-5-7 ($101.51 in chips) 
Seat 5: solbi86 ($100.58 in chips) 
Seat 6: simoniustin ($100 in chips) 
Seat 7: KLOP06031987 ($124.63 in chips) 
Seat 8: XxInsanexXQc ($100 in chips) 
Seat 9: Filojoes ($136.99 in chips) 
KLOP06031987: posts small blind $0.50
XxInsanexXQc: posts big blind $1
aseban11: sits out 
*** HOLE CARDS ***
Dealt to matiko09 [Td 8d]
Filojoes: raises $2 to $3
matiko09: folds 
cn_chayanne: folds 
timur3-5-7: folds 
solbi86: folds 
simoniustin: folds 
KLOP06031987: folds 
XxInsanexXQc: folds 
Uncalled bet ($2) returned to Filojoes
Filojoes collected $2.50 from pot
Filojoes: doesn't show hand 
*** SUMMARY ***
Total pot $2.50 | Rake $0 
Seat 1: matiko09 folded before Flop (didn't bet)
Seat 3: cn_chayanne folded before Flop (didn't bet)
Seat 4: timur3-5-7 folded before Flop (didn't bet)
Seat 5: solbi86 folded before Flop (didn't bet)
Seat 6: simoniustin (button) folded before Flop (didn't bet)
Seat 7: KLOP06031987 (small blind) folded before Flop
Seat 8: XxInsanexXQc (big blind) folded before Flop
Seat 9: Filojoes collected ($2.50)





PokerStars Hand #147708574819:  Hold'em No Limit ($0.50/$1.00 USD) - 2016/01/26 16:21:53 CET [2016/01/26 10:21:53 ET]
Table 'Achates III' 9-max Seat #2 is the button
Seat 2: matiko09 ($125.20 in chips) 
Seat 4: cn_chayanne ($100 in chips) 
Seat 5: simoniustin ($100 in chips) 
Seat 6: solbi86 ($114.47 in chips) 
Seat 7: 1989freak ($101.39 in chips) 
Seat 8: easycomengo ($45.46 in chips) 
Seat 9: T-chaos_IMBA ($395.95 in chips) 
cn_chayanne: posts small blind $0.50
simoniustin: posts big blind $1
*** HOLE CARDS ***
Dealt to matiko09 [2s Ah]
solbi86: folds 
1989freak: folds 
easycomengo: folds 
T-chaos_IMBA: folds 
matiko09: raises $1.27 to $2.27
cn_chayanne: folds 
simoniustin: folds 
Uncalled bet ($1.27) returned to matiko09
matiko09 collected $2.50 from pot
matiko09: doesn't show hand 
*** SUMMARY ***
Total pot $2.50 | Rake $0 
Seat 2: matiko09 (button) collected ($2.50)
Seat 4: cn_chayanne (small blind) folded before Flop
Seat 5: simoniustin (big blind) folded before Flop
Seat 6: solbi86 folded before Flop (didn't bet)
Seat 7: 1989freak folded before Flop (didn't bet)
Seat 8: easycomengo folded before Flop (didn't bet)
Seat 9: T-chaos_IMBA folded before Flop (didn't bet)





PokerStars Hand #147708589197:  Hold'em No Limit ($0.50/$1.00 USD) - 2016/01/26 16:22:12 CET [2016/01/26 10:22:12 ET]
Table 'Achates III' 9-max Seat #4 is the button
Seat 2: matiko09 ($126.70 in chips) 
Seat 4: cn_chayanne ($100 in chips) 
Seat 5: simoniustin ($100 in chips) 
Seat 6: solbi86 ($114.47 in chips) 
Seat 7: 1989freak ($101.39 in chips) 
Seat 8: easycomengo ($100 in chips) 
Seat 9: T-chaos_IMBA ($395.95 in chips) 
simoniustin: posts small blind $0.50
solbi86: posts big blind $1
*** HOLE CARDS ***
Dealt to matiko09 [7d Js]
1989freak: folds 
easycomengo: folds 
T-chaos_IMBA: folds 
aseban11 joins the table at seat #3 
matiko09: folds 
cn_chayanne: folds 
simoniustin: raises $1.02 to $2.02
solbi86: calls $1.02
*** FLOP *** [9h 2c 2h]
simoniustin: bets $2.32
solbi86: calls $2.32
*** TURN *** [9h 2c 2h] [Td]
simoniustin: checks 
solbi86: checks 
*** RIVER *** [9h 2c 2h Td] [Jc]
simoniustin: bets $6
solbi86: folds 
Uncalled bet ($6) returned to simoniustin
simoniustin collected $8.29 from pot
simoniustin: doesn't show hand 
*** SUMMARY ***
Total pot $8.68 | Rake $0.39 
Board [9h 2c 2h Td Jc]
Seat 2: matiko09 folded before Flop (didn't bet)
Seat 4: cn_chayanne (button) folded before Flop (didn't bet)
Seat 5: simoniustin (small blind) collected ($8.29)
Seat 6: solbi86 (big blind) folded on the River
Seat 7: 1989freak folded before Flop (didn't bet)
Seat 8: easycomengo folded before Flop (didn't bet)
Seat 9: T-chaos_IMBA folded before Flop (didn't bet)





PokerStars Hand #147708591702:  Hold'em No Limit ($0.50/$1.00 USD) - 2016/01/26 16:22:15 CET [2016/01/26 10:22:15 ET]
Table 'Mashona' 9-max Seat #8 is the button
Seat 1: maxxmeister ($125.90 in chips) 
Seat 2: werades ($212.38 in chips) 
Seat 3: matiko09 ($138.37 in chips) 
Seat 4: mycka86 ($107.62 in chips) 
Seat 5: solbi86 ($132.59 in chips) 
Seat 6: Filojoes ($100 in chips) 
Seat 7: EB0LARAMA ($295.74 in chips) 
Seat 8: simoniustin ($100 in chips) 
Seat 9: apfush ($102.57 in chips) 
apfush: posts small blind $0.50
maxxmeister: posts big blind $1
*** HOLE CARDS ***
Dealt to matiko09 [6s Ac]
werades: folds 
matiko09: folds 
mycka86: raises $1.50 to $2.50
solbi86: folds 
Filojoes: folds 
EB0LARAMA: folds 
simoniustin: folds 
apfush: folds 
maxxmeister: folds 
Uncalled bet ($1.50) returned to mycka86
mycka86 collected $2.50 from pot
*** SUMMARY ***
Total pot $2.50 | Rake $0 
Seat 1: maxxmeister (big blind) folded before Flop
Seat 2: werades folded before Flop (didn't bet)
Seat 3: matiko09 folded before Flop (didn't bet)
Seat 4: mycka86 collected ($2.50)
Seat 5: solbi86 folded before Flop (didn't bet)
Seat 6: Filojoes folded before Flop (didn't bet)
Seat 7: EB0LARAMA folded before Flop (didn't bet)
Seat 8: simoniustin (button) folded before Flop (didn't bet)
Seat 9: apfush (small blind) folded before Flop





PokerStars Hand #147708592445:  Hold'em No Limit ($0.50/$1.00 USD) - 2016/01/26 16:22:16 CET [2016/01/26 10:22:16 ET]
Table 'Kale II' 9-max Seat #4 is the button
Seat 1: soplak ($100 in chips) 
Seat 2: matiko09 ($100 in chips) 
Seat 3: Reven9er ($142.22 in chips) 
Seat 4: aseban11 ($100 in chips) 
Seat 6: simoniustin ($111.50 in chips) 
Seat 7: MILLIONCHIC ($64.79 in chips) 
Seat 8: mycka86 ($120.36 in chips) 
Seat 9: solbi86 ($199.05 in chips) 
simoniustin: posts small blind $0.50
MILLIONCHIC: posts big blind $1
*** HOLE CARDS ***
Dealt to matiko09 [5s 7s]
mycka86: folds 
solbi86: folds 
soplak: folds 
matiko09: folds 
Reven9er: folds 
aseban11: folds 
simoniustin: folds 
Uncalled bet ($0.50) returned to MILLIONCHIC
MILLIONCHIC collected $1 from pot
MILLIONCHIC: doesn't show hand 
*** SUMMARY ***
Total pot $1 | Rake $0 
Seat 1: soplak folded before Flop (didn't bet)
Seat 2: matiko09 folded before Flop (didn't bet)
Seat 3: Reven9er folded before Flop (didn't bet)
Seat 4: aseban11 (button) folded before Flop (didn't bet)
Seat 6: simoniustin (small blind) folded before Flop
Seat 7: MILLIONCHIC (big blind) collected ($1)
Seat 8: mycka86 folded before Flop (didn't bet)
Seat 9: solbi86 folded before Flop (didn't bet)





PokerStars Hand #147708598201:  Hold'em No Limit ($0.50/$1.00 USD) - 2016/01/26 16:22:24 CET [2016/01/26 10:22:24 ET]
Table 'Aten II' 9-max Seat #5 is the button
Seat 1: cn_chayanne ($115.66 in chips) 
Seat 2: solbi86 ($127.49 in chips) 
Seat 4: matiko09 ($100 in chips) 
Seat 5: sebaaastian ($102.33 in chips) 
Seat 6: ooohaaah ($85.73 in chips) 
Seat 7: Filojoes ($100 in chips) 
Seat 8: KLOP06031987 ($102.10 in chips) 
Seat 9: TorontoBum ($117.04 in chips) 
ooohaaah: posts small blind $0.50
Filojoes: posts big blind $1
aseban11: sits out 
*** HOLE CARDS ***
Dealt to matiko09 [8s 7d]
KLOP06031987: folds 
TorontoBum: folds 
cn_chayanne: folds 
solbi86: folds 
matiko09: folds 
sebaaastian: raises $1.50 to $2.50
ooohaaah: raises $5.50 to $8
Filojoes: folds 
sebaaastian: calls $5.50
*** FLOP *** [3d 4s 3s]
ooohaaah: bets $19
sebaaastian: raises $75.33 to $94.33 and is all-in
ooohaaah: calls $58.73 and is all-in
Uncalled bet ($16.60) returned to sebaaastian
*** TURN *** [3d 4s 3s] [Jh]
*** RIVER *** [3d 4s 3s Jh] [5h]
*** SHOW DOWN ***
ooohaaah: shows [Ad Ah] (two pair, Aces and Threes)
sebaaastian: shows [As Ks] (a pair of Threes)
ooohaaah collected $169.66 from pot
*** SUMMARY ***
Total pot $172.46 | Rake $2.80 
Board [3d 4s 3s Jh 5h]
Seat 1: cn_chayanne folded before Flop (didn't bet)
Seat 2: solbi86 folded before Flop (didn't bet)
Seat 4: matiko09 folded before Flop (didn't bet)
Seat 5: sebaaastian (button) showed [As Ks] and lost with a pair of Threes
Seat 6: ooohaaah (small blind) showed [Ad Ah] and won ($169.66) with two pair, Aces and Threes
Seat 7: Filojoes (big blind) folded before Flop
Seat 8: KLOP06031987 folded before Flop (didn't bet)
Seat 9: TorontoBum folded before Flop (didn't bet)





PokerStars Hand #147708609226:  Hold'em No Limit ($0.50/$1.00 USD) - 2016/01/26 16:22:38 CET [2016/01/26 10:22:38 ET]
Table 'Haedus' 9-max Seat #7 is the button
Seat 1: matiko09 ($100 in chips) 
Seat 3: cn_chayanne ($100 in chips) 
Seat 4: timur3-5-7 ($101.51 in chips) 
Seat 5: solbi86 ($100.58 in chips) 
Seat 6: simoniustin ($100 in chips) 
Seat 7: KLOP06031987 ($124.13 in chips) 
Seat 8: XxInsanexXQc ($99 in chips) 
Seat 9: Filojoes ($138.49 in chips) 
XxInsanexXQc: posts small blind $0.50
Filojoes: posts big blind $1
aseban11: sits out 
*** HOLE CARDS ***
Dealt to matiko09 [5d 2c]
matiko09: folds 
cn_chayanne: folds 
timur3-5-7: folds 
solbi86: folds 
simoniustin: folds 
KLOP06031987: raises $1 to $2
XxInsanexXQc: folds 
Filojoes: folds 
Uncalled bet ($1) returned to KLOP06031987
KLOP06031987 collected $2.50 from pot
KLOP06031987: doesn't show hand 
*** SUMMARY ***
Total pot $2.50 | Rake $0 
Seat 1: matiko09 folded before Flop (didn't bet)
Seat 3: cn_chayanne folded before Flop (didn't bet)
Seat 4: timur3-5-7 folded before Flop (didn't bet)
Seat 5: solbi86 folded before Flop (didn't bet)
Seat 6: simoniustin folded before Flop (didn't bet)
Seat 7: KLOP06031987 (button) collected ($2.50)
Seat 8: XxInsanexXQc (small blind) folded before Flop
Seat 9: Filojoes (big blind) folded before Flop





PokerStars Hand #147708616523:  Hold'em No Limit ($0.50/$1.00 USD) - 2016/01/26 16:22:48 CET [2016/01/26 10:22:48 ET]
Table 'Srbija III' 9-max Seat #8 is the button
Seat 1: simoniustin ($104.73 in chips) 
Seat 2: cn_chayanne ($101.50 in chips) 
Seat 3: LIGOPSIXIS78 ($65.17 in chips) 
Seat 4: petalouda10 ($171.16 in chips) 
Seat 5: mycka86 ($101.50 in chips) 
Seat 6: matiko09 ($208.26 in chips) 
Seat 7: KLOP06031987 ($112.52 in chips) 
Seat 8: solbi86 ($100 in chips) 
Seat 9: soplak ($100 in chips) 
soplak: posts small blind $0.50
simoniustin: posts big blind $1
*** HOLE CARDS ***
Dealt to matiko09 [8c Qd]
cn_chayanne: folds 
LIGOPSIXIS78: raises $1 to $2
petalouda10: folds 
mycka86: folds 
matiko09: folds 
KLOP06031987: folds 
solbi86: folds 
soplak: folds 
simoniustin: calls $1
*** FLOP *** [Ad 3d Kh]
simoniustin: checks 
LIGOPSIXIS78: bets $2
simoniustin: calls $2
*** TURN *** [Ad 3d Kh] [Tc]
simoniustin: checks 
LIGOPSIXIS78: checks 
*** RIVER *** [Ad 3d Kh Tc] [Qh]
simoniustin: bets $6
LIGOPSIXIS78: calls $6
*** SHOW DOWN ***
simoniustin: shows [Ac Jh] (a straight, Ten to Ace)
LIGOPSIXIS78: mucks hand 
simoniustin collected $19.58 from pot
*** SUMMARY ***
Total pot $20.50 | Rake $0.92 
Board [Ad 3d Kh Tc Qh]
Seat 1: simoniustin (big blind) showed [Ac Jh] and won ($19.58) with a straight, Ten to Ace
Seat 2: cn_chayanne folded before Flop (didn't bet)
Seat 3: LIGOPSIXIS78 mucked [6s Ah]
Seat 4: petalouda10 folded before Flop (didn't bet)
Seat 5: mycka86 folded before Flop (didn't bet)
Seat 6: matiko09 folded before Flop (didn't bet)
Seat 7: KLOP06031987 folded before Flop (didn't bet)
Seat 8: solbi86 (button) folded before Flop (didn't bet)
Seat 9: soplak (small blind) folded before Flop





PokerStars Hand #147708617188:  Hold'em No Limit ($0.50/$1.00 USD) - 2016/01/26 16:22:49 CET [2016/01/26 10:22:49 ET]
Table 'Impala' 9-max Seat #1 is the button
Seat 1: mycka86 ($144.44 in chips) 
Seat 2: Filojoes ($109.69 in chips) 
Seat 3: simoniustin ($100 in chips) 
Seat 4: Rikti ($92.26 in chips) 
Seat 5: Kukuryzka ($100 in chips) 
Seat 6: Tijger R.d.J ($105.24 in chips) 
Seat 7: matiko09 ($111.24 in chips) 
Seat 8: apfush ($102 in chips) 
Seat 9: flozzi ($103.57 in chips) 
Filojoes: posts small blind $0.50
simoniustin: posts big blind $1
*** HOLE CARDS ***
Dealt to matiko09 [9s Kd]
Rikti: folds 
Kukuryzka: raises $2 to $3
Tijger R.d.J: folds 
matiko09: folds 
apfush: folds 
flozzi: folds 
mycka86: folds 
Filojoes: folds 
simoniustin: folds 
Uncalled bet ($2) returned to Kukuryzka
Kukuryzka collected $2.50 from pot
Kukuryzka: doesn't show hand 
*** SUMMARY ***
Total pot $2.50 | Rake $0 
Seat 1: mycka86 (button) folded before Flop (didn't bet)
Seat 2: Filojoes (small blind) folded before Flop
Seat 3: simoniustin (big blind) folded before Flop
Seat 4: Rikti folded before Flop (didn't bet)
Seat 5: Kukuryzka collected ($2.50)
Seat 6: Tijger R.d.J folded before Flop (didn't bet)
Seat 7: matiko09 folded before Flop (didn't bet)
Seat 8: apfush folded before Flop (didn't bet)
Seat 9: flozzi folded before Flop (didn't bet)





PokerStars Hand #147708618788:  Hold'em No Limit ($0.50/$1.00 USD) - 2016/01/26 16:22:51 CET [2016/01/26 10:22:51 ET]
Table 'Calypso II' 9-max Seat #5 is the button
Seat 1: KLOP06031987 ($100 in chips) 
Seat 2: simoniustin ($100 in chips) 
Seat 3: matiko09 ($238.43 in chips) 
Seat 4: aseban11 ($100 in chips) 
Seat 5: mycka86 ($108.37 in chips) 
Seat 6: lobede ($105.12 in chips) 
Seat 7: Tasvision_mö ($41.31 in chips) 
Seat 8: Reven9er ($105 in chips) 
Seat 9: Filojoes ($143.61 in chips) 
lobede: posts small blind $0.50
Tasvision_mö: posts big blind $1
*** HOLE CARDS ***
Dealt to matiko09 [Js 8c]
Reven9er: folds 
Filojoes: folds 
KLOP06031987: folds 
simoniustin: folds 
matiko09: folds 
aseban11: folds 
mycka86: folds 
lobede: calls $0.50
Tasvision_mö: raises $4 to $5
lobede: calls $4
*** FLOP *** [Qs 2c 6c]
lobede: checks 
Tasvision_mö: bets $6
lobede: calls $6
*** TURN *** [Qs 2c 6c] [8d]
lobede: checks 
Tasvision_mö: checks 
*** RIVER *** [Qs 2c 6c 8d] [3h]
lobede: bets $5
Tasvision_mö: folds 
Uncalled bet ($5) returned to lobede
lobede collected $21.01 from pot
lobede: doesn't show hand 
*** SUMMARY ***
Total pot $22 | Rake $0.99 
Board [Qs 2c 6c 8d 3h]
Seat 1: KLOP06031987 folded before Flop (didn't bet)
Seat 2: simoniustin folded before Flop (didn't bet)
Seat 3: matiko09 folded before Flop (didn't bet)
Seat 4: aseban11 folded before Flop (didn't bet)
Seat 5: mycka86 (button) folded before Flop (didn't bet)
Seat 6: lobede (small blind) collected ($21.01)
Seat 7: Tasvision_mö (big blind) folded on the River
Seat 8: Reven9er folded before Flop (didn't bet)
Seat 9: Filojoes folded before Flop (didn't bet)





PokerStars Hand #147708621023:  Hold'em No Limit ($0.50/$1.00 USD) - 2016/01/26 16:22:54 CET [2016/01/26 10:22:54 ET]
Table 'Kale II' 9-max Seat #6 is the button
Seat 1: soplak ($100 in chips) 
Seat 2: matiko09 ($100 in chips) 
Seat 3: Reven9er ($142.22 in chips) 
Seat 4: aseban11 ($100 in chips) 
Seat 6: simoniustin ($111 in chips) 
Seat 7: MILLIONCHIC ($65.29 in chips) 
Seat 8: mycka86 ($120.36 in chips) 
Seat 9: solbi86 ($199.05 in chips) 
MILLIONCHIC: posts small blind $0.50
mycka86: posts big blind $1
*** HOLE CARDS ***
Dealt to matiko09 [5d 6c]
solbi86: folds 
soplak: folds 
matiko09: folds 
Reven9er: folds 
aseban11: folds 
simoniustin: raises $1.50 to $2.50
MILLIONCHIC: calls $2
mycka86: folds 
*** FLOP *** [2c 2h Jd]
MILLIONCHIC: checks 
simoniustin: checks 
*** TURN *** [2c 2h Jd] [Jc]
MILLIONCHIC: bets $2.86
simoniustin: folds 
Uncalled bet ($2.86) returned to MILLIONCHIC
MILLIONCHIC collected $5.73 from pot
MILLIONCHIC: doesn't show hand 
*** SUMMARY ***
Total pot $6 | Rake $0.27 
Board [2c 2h Jd Jc]
Seat 1: soplak folded before Flop (didn't bet)
Seat 2: matiko09 folded before Flop (didn't bet)
Seat 3: Reven9er folded before Flop (didn't bet)
Seat 4: aseban11 folded before Flop (didn't bet)
Seat 6: simoniustin (button) folded on the Turn
Seat 7: MILLIONCHIC (small blind) collected ($5.73)
Seat 8: mycka86 (big blind) folded before Flop
Seat 9: solbi86 folded before Flop (didn't bet)





PokerStars Hand #147708629742:  Hold'em No Limit ($0.50/$1.00 USD) - 2016/01/26 16:23:06 CET [2016/01/26 10:23:06 ET]
Table 'Mashona' 9-max Seat #9 is the button
Seat 1: maxxmeister ($124.90 in chips) 
Seat 2: werades ($212.38 in chips) 
Seat 3: matiko09 ($138.37 in chips) 
Seat 4: mycka86 ($109.12 in chips) 
Seat 5: solbi86 ($132.59 in chips) 
Seat 6: Filojoes ($100 in chips) 
Seat 7: EB0LARAMA ($295.74 in chips) 
Seat 8: simoniustin ($100 in chips) 
Seat 9: apfush ($102.07 in chips) 
maxxmeister: posts small blind $0.50
werades: posts big blind $1
*** HOLE CARDS ***
Dealt to matiko09 [9d Ah]
matiko09: folds 
mycka86: folds 
solbi86: folds 
Filojoes: folds 
EB0LARAMA: calls $1
simoniustin: raises $4 to $5
apfush: folds 
maxxmeister: folds 
werades: folds 
EB0LARAMA: calls $4
*** FLOP *** [8s Jh 9s]
EB0LARAMA: checks 
simoniustin: bets $6
EB0LARAMA: folds 
Uncalled bet ($6) returned to simoniustin
simoniustin collected $10.98 from pot
simoniustin: doesn't show hand 
*** SUMMARY ***
Total pot $11.50 | Rake $0.52 
Board [8s Jh 9s]
Seat 1: maxxmeister (small blind) folded before Flop
Seat 2: werades (big blind) folded before Flop
Seat 3: matiko09 folded before Flop (didn't bet)
Seat 4: mycka86 folded before Flop (didn't bet)
Seat 5: solbi86 folded before Flop (didn't bet)
Seat 6: Filojoes folded before Flop (didn't bet)
Seat 7: EB0LARAMA folded on the Flop
Seat 8: simoniustin collected ($10.98)
Seat 9: apfush (button) folded before Flop (didn't bet)





PokerStars Hand #147708634805:  Hold'em No Limit ($0.50/$1.00 USD) - 2016/01/26 16:23:12 CET [2016/01/26 10:23:12 ET]
Table 'Achates III' 9-max Seat #5 is the button
Seat 2: matiko09 ($126.70 in chips) 
Seat 4: cn_chayanne ($100 in chips) 
Seat 5: simoniustin ($103.95 in chips) 
Seat 6: solbi86 ($110.13 in chips) 
Seat 7: 1989freak ($101.39 in chips) 
Seat 8: easycomengo ($100 in chips) 
Seat 9: T-chaos_IMBA ($395.95 in chips) 
solbi86: posts small blind $0.50
1989freak: posts big blind $1
aseban11: sits out 
*** HOLE CARDS ***
Dealt to matiko09 [7h 9h]
easycomengo: folds 
T-chaos_IMBA: raises $2 to $3
matiko09: folds 
cn_chayanne: folds 
simoniustin: folds 
solbi86: folds 
1989freak: folds 
Uncalled bet ($2) returned to T-chaos_IMBA
T-chaos_IMBA collected $2.50 from pot
T-chaos_IMBA: doesn't show hand 
*** SUMMARY ***
Total pot $2.50 | Rake $0 
Seat 2: matiko09 folded before Flop (didn't bet)
Seat 4: cn_chayanne folded before Flop (didn't bet)
Seat 5: simoniustin (button) folded before Flop (didn't bet)
Seat 6: solbi86 (small blind) folded before Flop
Seat 7: 1989freak (big blind) folded before Flop
Seat 8: easycomengo folded before Flop (didn't bet)
Seat 9: T-chaos_IMBA collected ($2.50)





PokerStars Hand #147708637643:  Hold'em No Limit ($0.50/$1.00 USD) - 2016/01/26 16:23:16 CET [2016/01/26 10:23:16 ET]
Table 'Aten II' 9-max Seat #6 is the button
Seat 1: cn_chayanne ($115.66 in chips) 
Seat 2: solbi86 ($127.49 in chips) 
Seat 4: matiko09 ($100 in chips) 
Seat 5: sebaaastian ($100 in chips) 
Seat 6: ooohaaah ($169.66 in chips) 
Seat 7: Filojoes ($100 in chips) 
Seat 8: KLOP06031987 ($102.10 in chips) 
Seat 9: TorontoBum ($117.04 in chips) 
Filojoes: posts small blind $0.50
KLOP06031987: posts big blind $1
aseban11: sits out 
*** HOLE CARDS ***
Dealt to matiko09 [8d Ts]
TorontoBum: folds 
cn_chayanne: raises $1.50 to $2.50
solbi86: folds 
matiko09: folds 
sebaaastian: folds 
ooohaaah: folds 
Filojoes: folds 
KLOP06031987: folds 
Uncalled bet ($1.50) returned to cn_chayanne
cn_chayanne collected $2.50 from pot
cn_chayanne: doesn't show hand 
*** SUMMARY ***
Total pot $2.50 | Rake $0 
Seat 1: cn_chayanne collected ($2.50)
Seat 2: solbi86 folded before Flop (didn't bet)
Seat 4: matiko09 folded before Flop (didn't bet)
Seat 5: sebaaastian folded before Flop (didn't bet)
Seat 6: ooohaaah (button) folded before Flop (didn't bet)
Seat 7: Filojoes (small blind) folded before Flop
Seat 8: KLOP06031987 (big blind) folded before Flop
Seat 9: TorontoBum folded before Flop (didn't bet)





PokerStars Hand #147708643327:  Hold'em No Limit ($0.50/$1.00 USD) - 2016/01/26 16:23:23 CET [2016/01/26 10:23:23 ET]
Table 'Impala' 9-max Seat #2 is the button
Seat 1: mycka86 ($144.44 in chips) 
Seat 2: Filojoes ($109.19 in chips) 
Seat 3: simoniustin ($100 in chips) 
Seat 4: Rikti ($92.26 in chips) 
Seat 5: Kukuryzka ($101.50 in chips) 
Seat 6: Tijger R.d.J ($105.24 in chips) 
Seat 7: matiko09 ($111.24 in chips) 
Seat 8: apfush ($102 in chips) 
Seat 9: flozzi ($103.57 in chips) 
simoniustin: posts small blind $0.50
Rikti: posts big blind $1
*** HOLE CARDS ***
Dealt to matiko09 [Kh 3h]
Kukuryzka: folds 
Tijger R.d.J: folds 
matiko09: folds 
apfush: folds 
flozzi: folds 
mycka86: folds 
Filojoes: raises $1 to $2
simoniustin: folds 
Rikti: calls $1
*** FLOP *** [Qc 5s 7c]
Rikti: checks 
Filojoes: bets $2.58
Rikti: calls $2.58
*** TURN *** [Qc 5s 7c] [Ks]
Rikti: checks 
Filojoes: checks 
*** RIVER *** [Qc 5s 7c Ks] [9h]
Rikti: checks 
Filojoes: bets $6
Rikti: folds 
Uncalled bet ($6) returned to Filojoes
Filojoes collected $9.23 from pot
Filojoes: doesn't show hand 
*** SUMMARY ***
Total pot $9.66 | Rake $0.43 
Board [Qc 5s 7c Ks 9h]
Seat 1: mycka86 folded before Flop (didn't bet)
Seat 2: Filojoes (button) collected ($9.23)
Seat 3: simoniustin (small blind) folded before Flop
Seat 4: Rikti (big blind) folded on the River
Seat 5: Kukuryzka folded before Flop (didn't bet)
Seat 6: Tijger R.d.J folded before Flop (didn't bet)
Seat 7: matiko09 folded before Flop (didn't bet)
Seat 8: apfush folded before Flop (didn't bet)
Seat 9: flozzi folded before Flop (didn't bet)





PokerStars Hand #147708652666:  Hold'em No Limit ($0.50/$1.00 USD) - 2016/01/26 16:23:36 CET [2016/01/26 10:23:36 ET]
Table 'Achates III' 9-max Seat #6 is the button
Seat 2: matiko09 ($126.70 in chips) 
Seat 4: cn_chayanne ($100 in chips) 
Seat 5: simoniustin ($103.95 in chips) 
Seat 6: solbi86 ($109.63 in chips) 
Seat 7: 1989freak ($100.39 in chips) 
Seat 8: easycomengo ($100 in chips) 
Seat 9: T-chaos_IMBA ($397.45 in chips) 
1989freak: posts small blind $0.50
easycomengo: posts big blind $1
aseban11: sits out 
*** HOLE CARDS ***
Dealt to matiko09 [9d Ah]
T-chaos_IMBA: folds 
matiko09: folds 
cn_chayanne: raises $1.50 to $2.50
simoniustin: folds 
solbi86: folds 
1989freak: raises $4.50 to $7
easycomengo: folds 
cn_chayanne: calls $4.50
*** FLOP *** [7s Qd 3s]
1989freak: bets $8
cn_chayanne: calls $8
*** TURN *** [7s Qd 3s] [2h]
1989freak: checks 
cn_chayanne: bets $14.80
1989freak: folds 
Uncalled bet ($14.80) returned to cn_chayanne
cn_chayanne collected $29.60 from pot
cn_chayanne: doesn't show hand 
*** SUMMARY ***
Total pot $31 | Rake $1.40 
Board [7s Qd 3s 2h]
Seat 2: matiko09 folded before Flop (didn't bet)
Seat 4: cn_chayanne collected ($29.60)
Seat 5: simoniustin folded before Flop (didn't bet)
Seat 6: solbi86 (button) folded before Flop (didn't bet)
Seat 7: 1989freak (small blind) folded on the Turn
Seat 8: easycomengo (big blind) folded before Flop
Seat 9: T-chaos_IMBA folded before Flop (didn't bet)





PokerStars Hand #147708659660:  Hold'em No Limit ($0.50/$1.00 USD) - 2016/01/26 16:23:45 CET [2016/01/26 10:23:45 ET]
Table 'Kale II' 9-max Seat #7 is the button
Seat 1: soplak ($100 in chips) 
Seat 2: matiko09 ($100 in chips) 
Seat 3: Reven9er ($142.22 in chips) 
Seat 4: aseban11 ($100 in chips) 
Seat 6: simoniustin ($108.50 in chips) 
Seat 7: MILLIONCHIC ($68.52 in chips) 
Seat 8: mycka86 ($119.36 in chips) 
Seat 9: solbi86 ($199.05 in chips) 
mycka86: posts small blind $0.50
solbi86: posts big blind $1
*** HOLE CARDS ***
Dealt to matiko09 [2s 3c]
soplak: raises $2 to $3
matiko09: folds 
Reven9er: folds 
aseban11: folds 
simoniustin: folds 
MILLIONCHIC: folds 
mycka86: folds 
solbi86: folds 
Uncalled bet ($2) returned to soplak
soplak collected $2.50 from pot
*** SUMMARY ***
Total pot $2.50 | Rake $0 
Seat 1: soplak collected ($2.50)
Seat 2: matiko09 folded before Flop (didn't bet)
Seat 3: Reven9er folded before Flop (didn't bet)
Seat 4: aseban11 folded before Flop (didn't bet)
Seat 6: simoniustin folded before Flop (didn't bet)
Seat 7: MILLIONCHIC (button) folded before Flop (didn't bet)
Seat 8: mycka86 (small blind) folded before Flop
Seat 9: solbi86 (big blind) folded before Flop





PokerStars Hand #147708665182:  Hold'em No Limit ($0.50/$1.00 USD) - 2016/01/26 16:23:52 CET [2016/01/26 10:23:52 ET]
Table 'Aten II' 9-max Seat #7 is the button
Seat 1: cn_chayanne ($117.16 in chips) 
Seat 2: solbi86 ($127.49 in chips) 
Seat 4: matiko09 ($100 in chips) 
Seat 5: sebaaastian ($100 in chips) 
Seat 6: ooohaaah ($169.66 in chips) 
Seat 7: Filojoes ($100 in chips) 
Seat 8: KLOP06031987 ($101.10 in chips) 
Seat 9: TorontoBum ($117.04 in chips) 
KLOP06031987: posts small blind $0.50
TorontoBum: posts big blind $1
aseban11: sits out 
*** HOLE CARDS ***
Dealt to matiko09 [Qd 2c]
cn_chayanne: raises $1.50 to $2.50
solbi86: folds 
matiko09: folds 
sebaaastian: folds 
ooohaaah: folds 
Filojoes: calls $2.50
KLOP06031987: folds 
TorontoBum: folds 
*** FLOP *** [9d 6c 7d]
cn_chayanne: bets $3.91
Filojoes: calls $3.91
*** TURN *** [9d 6c 7d] [5s]
cn_chayanne: checks 
Filojoes: checks 
*** RIVER *** [9d 6c 7d 5s] [7s]
cn_chayanne: checks 
Filojoes: bets $9
cn_chayanne: calls $9
*** SHOW DOWN ***
Filojoes: shows [8c Kc] (a straight, Five to Nine)
cn_chayanne: mucks hand 
Filojoes collected $30.87 from pot
*** SUMMARY ***
Total pot $32.32 | Rake $1.45 
Board [9d 6c 7d 5s 7s]
Seat 1: cn_chayanne mucked [Th Td]
Seat 2: solbi86 folded before Flop (didn't bet)
Seat 4: matiko09 folded before Flop (didn't bet)
Seat 5: sebaaastian folded before Flop (didn't bet)
Seat 6: ooohaaah folded before Flop (didn't bet)
Seat 7: Filojoes (button) showed [8c Kc] and won ($30.87) with a straight, Five to Nine
Seat 8: KLOP06031987 (small blind) folded before Flop
Seat 9: TorontoBum (big blind) folded before Flop





PokerStars Hand #147708677502:  Hold'em No Limit ($0.50/$1.00 USD) - 2016/01/26 16:24:08 CET [2016/01/26 10:24:08 ET]
Table 'Srbija III' 9-max Seat #9 is the button
Seat 1: simoniustin ($114.31 in chips) 
Seat 2: cn_chayanne ($101.50 in chips) 
Seat 3: LIGOPSIXIS78 ($55.17 in chips) 
Seat 4: petalouda10 ($171.16 in chips) 
Seat 5: mycka86 ($101.50 in chips) 
Seat 6: matiko09 ($208.26 in chips) 
Seat 7: KLOP06031987 ($112.52 in chips) 
Seat 8: solbi86 ($100 in chips) 
Seat 9: soplak ($100 in chips) 
simoniustin: posts small blind $0.50
cn_chayanne: posts big blind $1
*** HOLE CARDS ***
Dealt to matiko09 [Kc As]
LIGOPSIXIS78: folds 
petalouda10: folds 
mycka86: folds 
matiko09: raises $2 to $3
KLOP06031987: folds 
solbi86: folds 
soplak: folds 
simoniustin: folds 
cn_chayanne: folds 
Uncalled bet ($2) returned to matiko09
matiko09 collected $2.50 from pot
matiko09: doesn't show hand 
*** SUMMARY ***
Total pot $2.50 | Rake $0 
Seat 1: simoniustin (small blind) folded before Flop
Seat 2: cn_chayanne (big blind) folded before Flop
Seat 3: LIGOPSIXIS78 folded before Flop (didn't bet)
Seat 4: petalouda10 folded before Flop (didn't bet)
Seat 5: mycka86 folded before Flop (didn't bet)
Seat 6: matiko09 collected ($2.50)
Seat 7: KLOP06031987 folded before Flop (didn't bet)
Seat 8: solbi86 folded before Flop (didn't bet)
Seat 9: soplak (button) folded before Flop (didn't bet)





PokerStars Hand #147708679906:  Hold'em No Limit ($0.50/$1.00 USD) - 2016/01/26 16:24:12 CET [2016/01/26 10:24:12 ET]
Table 'Kale II' 9-max Seat #8 is the button
Seat 1: soplak ($101.50 in chips) 
Seat 2: matiko09 ($100 in chips) 
Seat 3: Reven9er ($142.22 in chips) 
Seat 4: aseban11 ($100 in chips) 
Seat 6: simoniustin ($108.50 in chips) 
Seat 7: MILLIONCHIC ($68.52 in chips) 
Seat 8: mycka86 ($118.86 in chips) 
Seat 9: solbi86 ($198.05 in chips) 
solbi86: posts small blind $0.50
soplak: posts big blind $1
*** HOLE CARDS ***
Dealt to matiko09 [5d As]
matiko09: folds 
Reven9er: raises $1 to $2
aseban11: folds 
simoniustin: calls $2
MILLIONCHIC: folds 
mycka86: folds 
solbi86: folds 
soplak: folds 
*** FLOP *** [Qd 9s Jd]
Reven9er: checks 
simoniustin: checks 
*** TURN *** [Qd 9s Jd] [4c]
Reven9er: checks 
simoniustin: checks 
*** RIVER *** [Qd 9s Jd 4c] [8h]
Reven9er: checks 
simoniustin: bets $4
Reven9er: folds 
Uncalled bet ($4) returned to simoniustin
simoniustin collected $5.25 from pot
simoniustin: doesn't show hand 
*** SUMMARY ***
Total pot $5.50 | Rake $0.25 
Board [Qd 9s Jd 4c 8h]
Seat 1: soplak (big blind) folded before Flop
Seat 2: matiko09 folded before Flop (didn't bet)
Seat 3: Reven9er folded on the River
Seat 4: aseban11 folded before Flop (didn't bet)
Seat 6: simoniustin collected ($5.25)
Seat 7: MILLIONCHIC folded before Flop (didn't bet)
Seat 8: mycka86 (button) folded before Flop (didn't bet)
Seat 9: solbi86 (small blind) folded before Flop





PokerStars Hand #147708701036:  Hold'em No Limit ($0.50/$1.00 USD) - 2016/01/26 16:24:39 CET [2016/01/26 10:24:39 ET]
Table 'Calypso II' 9-max Seat #6 is the button
Seat 1: KLOP06031987 ($100 in chips) 
Seat 2: simoniustin ($100 in chips) 
Seat 3: matiko09 ($238.43 in chips) 
Seat 4: aseban11 ($100 in chips) 
Seat 5: mycka86 ($108.37 in chips) 
Seat 6: lobede ($115.13 in chips) 
Seat 7: Tasvision_mö ($30.31 in chips) 
Seat 8: Reven9er ($105 in chips) 
Seat 9: Filojoes ($143.61 in chips) 
Tasvision_mö: posts small blind $0.50
Reven9er: posts big blind $1
*** HOLE CARDS ***
Dealt to matiko09 [4c 7d]
Filojoes: raises $2 to $3
KLOP06031987: folds 
simoniustin: folds 
matiko09: folds 
aseban11: folds 
mycka86: folds 
lobede: calls $3
Tasvision_mö: folds 
Reven9er: folds 
*** FLOP *** [6s 3c Jh]
Filojoes: checks 
lobede: checks 
*** TURN *** [6s 3c Jh] [5h]
Filojoes: bets $4.30
lobede: calls $4.30
*** RIVER *** [6s 3c Jh 5h] [5s]
Filojoes: checks 
lobede: checks 
*** SHOW DOWN ***
Filojoes: shows [4d 4h] (two pair, Fives and Fours)
lobede: mucks hand 
Filojoes collected $15.38 from pot
*** SUMMARY ***
Total pot $16.10 | Rake $0.72 
Board [6s 3c Jh 5h 5s]
Seat 1: KLOP06031987 folded before Flop (didn't bet)
Seat 2: simoniustin folded before Flop (didn't bet)
Seat 3: matiko09 folded before Flop (didn't bet)
Seat 4: aseban11 folded before Flop (didn't bet)
Seat 5: mycka86 folded before Flop (didn't bet)
Seat 6: lobede (button) mucked [As 7s]
Seat 7: Tasvision_mö (small blind) folded before Flop
Seat 8: Reven9er (big blind) folded before Flop
Seat 9: Filojoes showed [4d 4h] and won ($15.38) with two pair, Fives and Fours





PokerStars Hand #147708702933:  Hold'em No Limit ($0.50/$1.00 USD) - 2016/01/26 16:24:42 CET [2016/01/26 10:24:42 ET]
Table 'Srbija III' 9-max Seat #1 is the button
Seat 1: simoniustin ($113.81 in chips) 
Seat 2: cn_chayanne ($100.50 in chips) 
Seat 3: LIGOPSIXIS78 ($55.17 in chips) 
Seat 4: petalouda10 ($171.16 in chips) 
Seat 5: mycka86 ($101.50 in chips) 
Seat 6: matiko09 ($209.76 in chips) 
Seat 7: KLOP06031987 ($112.52 in chips) 
Seat 8: solbi86 ($100 in chips) 
Seat 9: soplak ($100 in chips) 
cn_chayanne: posts small blind $0.50
LIGOPSIXIS78: posts big blind $1
*** HOLE CARDS ***
Dealt to matiko09 [5c Ts]
petalouda10: folds 
mycka86: folds 
matiko09: folds 
KLOP06031987: folds 
solbi86: folds 
soplak: folds 
simoniustin: raises $1.50 to $2.50
cn_chayanne: calls $2
LIGOPSIXIS78: folds 
*** FLOP *** [Qd 9h Ks]
cn_chayanne: checks 
simoniustin: bets $4
cn_chayanne: folds 
Uncalled bet ($4) returned to simoniustin
simoniustin collected $5.73 from pot
simoniustin: doesn't show hand 
*** SUMMARY ***
Total pot $6 | Rake $0.27 
Board [Qd 9h Ks]
Seat 1: simoniustin (button) collected ($5.73)
Seat 2: cn_chayanne (small blind) folded on the Flop
Seat 3: LIGOPSIXIS78 (big blind) folded before Flop
Seat 4: petalouda10 folded before Flop (didn't bet)
Seat 5: mycka86 folded before Flop (didn't bet)
Seat 6: matiko09 folded before Flop (didn't bet)
Seat 7: KLOP06031987 folded before Flop (didn't bet)
Seat 8: solbi86 folded before Flop (didn't bet)
Seat 9: soplak folded before Flop (didn't bet)





PokerStars Hand #147708730321:  Hold'em No Limit ($0.50/$1.00 USD) - 2016/01/26 16:25:18 CET [2016/01/26 10:25:18 ET]
Table 'Achates III' 9-max Seat #7 is the button
Seat 2: matiko09 ($126.70 in chips) 
Seat 4: cn_chayanne ($114.60 in chips) 
Seat 5: simoniustin ($103.95 in chips) 
Seat 6: solbi86 ($109.63 in chips) 
Seat 7: 1989freak ($85.39 in chips) 
Seat 8: easycomengo ($99 in chips) 
Seat 9: T-chaos_IMBA ($397.45 in chips) 
easycomengo: posts small blind $0.50
T-chaos_IMBA: posts big blind $1
aseban11: sits out 
*** HOLE CARDS ***
Dealt to matiko09 [Qc 3d]
matiko09: folds 
cn_chayanne: folds 
simoniustin: folds 
solbi86: folds 
1989freak: raises $2 to $3
easycomengo: calls $2.50
T-chaos_IMBA: folds 
*** FLOP *** [6s 8s Js]
easycomengo: checks 
1989freak: bets $5
easycomengo: folds 
Uncalled bet ($5) returned to 1989freak
1989freak collected $6.68 from pot
1989freak: doesn't show hand 
*** SUMMARY ***
Total pot $7 | Rake $0.32 
Board [6s 8s Js]
Seat 2: matiko09 folded before Flop (didn't bet)
Seat 4: cn_chayanne folded before Flop (didn't bet)
Seat 5: simoniustin folded before Flop (didn't bet)
Seat 6: solbi86 folded before Flop (didn't bet)
Seat 7: 1989freak (button) collected ($6.68)
Seat 8: easycomengo (small blind) folded on the Flop
Seat 9: T-chaos_IMBA (big blind) folded before Flop





PokerStars Hand #147708741408:  Hold'em No Limit ($0.50/$1.00 USD) - 2016/01/26 16:25:33 CET [2016/01/26 10:25:33 ET]
Table 'Impala' 9-max Seat #3 is the button
Seat 1: mycka86 ($144.44 in chips) 
Seat 2: Filojoes ($113.84 in chips) 
Seat 3: simoniustin ($100 in chips) 
Seat 4: Rikti ($87.68 in chips) 
Seat 5: Kukuryzka ($101.50 in chips) 
Seat 6: Tijger R.d.J ($105.24 in chips) 
Seat 7: matiko09 ($111.24 in chips) 
Seat 8: apfush ($102 in chips) 
Seat 9: flozzi ($103.57 in chips) 
Rikti: posts small blind $0.50
Kukuryzka: posts big blind $1
*** HOLE CARDS ***
Dealt to matiko09 [Ks 6d]
Tijger R.d.J: folds 
matiko09: folds 
apfush: folds 
flozzi: folds 
mycka86: folds 
Filojoes: raises $1.50 to $2.50
simoniustin: folds 
Rikti: folds 
Kukuryzka: folds 
Uncalled bet ($1.50) returned to Filojoes
Filojoes collected $2.50 from pot
Filojoes: doesn't show hand 
*** SUMMARY ***
Total pot $2.50 | Rake $0 
Seat 1: mycka86 folded before Flop (didn't bet)
Seat 2: Filojoes collected ($2.50)
Seat 3: simoniustin (button) folded before Flop (didn't bet)
Seat 4: Rikti (small blind) folded before Flop
Seat 5: Kukuryzka (big blind) folded before Flop
Seat 6: Tijger R.d.J folded before Flop (didn't bet)
Seat 7: matiko09 folded before Flop (didn't bet)
Seat 8: apfush folded before Flop (didn't bet)
Seat 9: flozzi folded before Flop (didn't bet)





PokerStars Hand #147708744067:  Hold'em No Limit ($0.50/$1.00 USD) - 2016/01/26 16:25:36 CET [2016/01/26 10:25:36 ET]
Table 'Aten II' 9-max Seat #8 is the button
Seat 2: solbi86 ($127.49 in chips) 
Seat 4: matiko09 ($100 in chips) 
Seat 5: sebaaastian ($100 in chips) 
Seat 6: ooohaaah ($169.66 in chips) 
Seat 7: Filojoes ($115.46 in chips) 
Seat 8: KLOP06031987 ($100.60 in chips) 
Seat 9: TorontoBum ($116.04 in chips) 
TorontoBum: posts small blind $0.50
cn_chayanne: is sitting out 
solbi86: posts big blind $1
aseban11: sits out 
*** HOLE CARDS ***
Dealt to matiko09 [As Qd]
matiko09: raises $2 to $3
cn_chayanne leaves the table
simoniustin joins the table at seat #1 
sebaaastian: folds 
ooohaaah: calls $3
Filojoes: folds 
KLOP06031987: folds 
TorontoBum: folds 
solbi86: raises $10 to $13
matiko09: folds 
ooohaaah: calls $10
*** FLOP *** [6d Ac Js]
solbi86: checks 
ooohaaah: bets $15
solbi86: calls $15
*** TURN *** [6d Ac Js] [Jh]
solbi86: checks 
ooohaaah: checks 
*** RIVER *** [6d Ac Js Jh] [Ts]
solbi86: bets $36
ooohaaah: calls $36
*** SHOW DOWN ***
solbi86: shows [Jc Jd] (four of a kind, Jacks)
ooohaaah: mucks hand 
solbi86 collected $128.70 from pot
*** SUMMARY ***
Total pot $131.50 | Rake $2.80 
Board [6d Ac Js Jh Ts]
Seat 2: solbi86 (big blind) showed [Jc Jd] and won ($128.70) with four of a kind, Jacks
Seat 4: matiko09 folded before Flop
Seat 5: sebaaastian folded before Flop (didn't bet)
Seat 6: ooohaaah mucked [Ad Ks]
Seat 7: Filojoes folded before Flop (didn't bet)
Seat 8: KLOP06031987 (button) folded before Flop (didn't bet)
Seat 9: TorontoBum (small blind) folded before Flop





PokerStars Hand #147708752294:  Hold'em No Limit ($0.50/$1.00 USD) - 2016/01/26 16:25:47 CET [2016/01/26 10:25:47 ET]
Table 'Srbija III' 9-max Seat #2 is the button
Seat 1: simoniustin ($117.04 in chips) 
Seat 2: cn_chayanne ($100 in chips) 
Seat 3: LIGOPSIXIS78 ($54.17 in chips) 
Seat 4: petalouda10 ($171.16 in chips) 
Seat 5: mycka86 ($101.50 in chips) 
Seat 6: matiko09 ($209.76 in chips) 
Seat 7: KLOP06031987 ($112.52 in chips) 
Seat 8: solbi86 ($100 in chips) 
Seat 9: soplak ($100 in chips) 
LIGOPSIXIS78: posts small blind $0.50
petalouda10: posts big blind $1
*** HOLE CARDS ***
Dealt to matiko09 [7c 4d]
mycka86: folds 
matiko09: folds 
KLOP06031987: raises $1.31 to $2.31
solbi86: calls $2.31
soplak: folds 
simoniustin: calls $2.31
cn_chayanne: folds 
LIGOPSIXIS78: calls $1.81
petalouda10: calls $1.31
*** FLOP *** [5h 9c 2s]
LIGOPSIXIS78: checks 
petalouda10: bets $2
KLOP06031987: folds 
solbi86: calls $2
simoniustin: folds 
LIGOPSIXIS78: calls $2
*** TURN *** [5h 9c 2s] [Ad]
LIGOPSIXIS78: checks 
petalouda10: checks 
solbi86: checks 
*** RIVER *** [5h 9c 2s Ad] [Jc]
LIGOPSIXIS78: checks 
petalouda10: checks 
solbi86: checks 
*** SHOW DOWN ***
LIGOPSIXIS78: shows [Tc Jh] (a pair of Jacks)
petalouda10: mucks hand 
solbi86: mucks hand 
LIGOPSIXIS78 collected $16.76 from pot
*** SUMMARY ***
Total pot $17.55 | Rake $0.79 
Board [5h 9c 2s Ad Jc]
Seat 1: simoniustin folded on the Flop
Seat 2: cn_chayanne (button) folded before Flop (didn't bet)
Seat 3: LIGOPSIXIS78 (small blind) showed [Tc Jh] and won ($16.76) with a pair of Jacks
Seat 4: petalouda10 (big blind) mucked [Kc 2h]
Seat 5: mycka86 folded before Flop (didn't bet)
Seat 6: matiko09 folded before Flop (didn't bet)
Seat 7: KLOP06031987 folded on the Flop
Seat 8: solbi86 mucked [8c 8h]
Seat 9: soplak folded before Flop (didn't bet)





PokerStars Hand #147708773783:  Hold'em No Limit ($0.50/$1.00 USD) - 2016/01/26 16:26:15 CET [2016/01/26 10:26:15 ET]
Table 'Impala' 9-max Seat #4 is the button
Seat 1: mycka86 ($144.44 in chips) 
Seat 2: Filojoes ($115.34 in chips) 
Seat 3: simoniustin ($100 in chips) 
Seat 4: Rikti ($87.18 in chips) 
Seat 5: Kukuryzka ($100.50 in chips) 
Seat 6: Tijger R.d.J ($105.24 in chips) 
Seat 7: matiko09 ($111.24 in chips) 
Seat 8: apfush ($102 in chips) 
Seat 9: flozzi ($103.57 in chips) 
Kukuryzka: posts small blind $0.50
Tijger R.d.J: posts big blind $1
*** HOLE CARDS ***
Dealt to matiko09 [Kc Qs]
matiko09: raises $2 to $3
apfush: folds 
flozzi: folds 
mycka86: folds 
Filojoes: folds 
simoniustin: folds 
Rikti: folds 
Kukuryzka: folds 
Tijger R.d.J: calls $2
*** FLOP *** [Qd Td 2h]
Tijger R.d.J: checks 
matiko09: bets $4.04
Tijger R.d.J: folds 
Uncalled bet ($4.04) returned to matiko09
matiko09 collected $6.21 from pot
matiko09: doesn't show hand 
*** SUMMARY ***
Total pot $6.50 | Rake $0.29 
Board [Qd Td 2h]
Seat 1: mycka86 folded before Flop (didn't bet)
Seat 2: Filojoes folded before Flop (didn't bet)
Seat 3: simoniustin folded before Flop (didn't bet)
Seat 4: Rikti (button) folded before Flop (didn't bet)
Seat 5: Kukuryzka (small blind) folded before Flop
Seat 6: Tijger R.d.J (big blind) folded on the Flop
Seat 7: matiko09 collected ($6.21)
Seat 8: apfush folded before Flop (didn't bet)
Seat 9: flozzi folded before Flop (didn't bet)





PokerStars Hand #147708787238:  Hold'em No Limit ($0.50/$1.00 USD) - 2016/01/26 16:26:33 CET [2016/01/26 10:26:33 ET]
Table 'Calypso II' 9-max Seat #7 is the button
Seat 1: KLOP06031987 ($100 in chips) 
Seat 2: simoniustin ($100 in chips) 
Seat 3: matiko09 ($238.43 in chips) 
Seat 4: aseban11 ($100 in chips) 
Seat 5: mycka86 ($108.37 in chips) 
Seat 6: lobede ($107.83 in chips) 
Seat 7: Tasvision_mö ($29.81 in chips) 
Seat 8: Reven9er ($104 in chips) 
Seat 9: Filojoes ($151.69 in chips) 
Reven9er: posts small blind $0.50
Filojoes: posts big blind $1
*** HOLE CARDS ***
Dealt to matiko09 [Kd Jd]
KLOP06031987: folds 
simoniustin: raises $2 to $3
matiko09: calls $3
aseban11: folds 
mycka86: folds 
lobede: folds 
Tasvision_mö: folds 
Reven9er: folds 
lobede leaves the table
Filojoes: folds 
*** FLOP *** [9c Ks 2c]
simoniustin: bets $5
matiko09: calls $5
*** TURN *** [9c Ks 2c] [8c]
simoniustin: checks 
matiko09: checks 
*** RIVER *** [9c Ks 2c 8c] [4h]
simoniustin: checks 
matiko09: checks 
*** SHOW DOWN ***
simoniustin: shows [Th Ah] (high card Ace)
matiko09: shows [Kd Jd] (a pair of Kings)
matiko09 collected $16.71 from pot
*** SUMMARY ***
Total pot $17.50 | Rake $0.79 
Board [9c Ks 2c 8c 4h]
Seat 1: KLOP06031987 folded before Flop (didn't bet)
Seat 2: simoniustin showed [Th Ah] and lost with high card Ace
Seat 3: matiko09 showed [Kd Jd] and won ($16.71) with a pair of Kings
Seat 4: aseban11 folded before Flop (didn't bet)
Seat 5: mycka86 folded before Flop (didn't bet)
Seat 6: lobede folded before Flop (didn't bet)
Seat 7: Tasvision_mö (button) folded before Flop (didn't bet)
Seat 8: Reven9er (small blind) folded before Flop
Seat 9: Filojoes (big blind) folded before Flop





PokerStars Hand #147708798507:  Hold'em No Limit ($0.50/$1.00 USD) - 2016/01/26 16:26:48 CET [2016/01/26 10:26:48 ET]
Table 'Aten II' 9-max Seat #9 is the button
Seat 2: solbi86 ($192.19 in chips) 
Seat 3: aseban11 ($100 in chips) 
Seat 4: matiko09 ($100 in chips) 
Seat 5: sebaaastian ($100 in chips) 
Seat 6: ooohaaah ($105.66 in chips) 
Seat 7: Filojoes ($115.46 in chips) 
Seat 8: KLOP06031987 ($100.60 in chips) 
Seat 9: TorontoBum ($115.54 in chips) 
simoniustin will be allowed to play after the button
solbi86: posts small blind $0.50
aseban11: posts big blind $1
*** HOLE CARDS ***
Dealt to matiko09 [Qc 6s]
matiko09: folds 
sebaaastian: folds 
ooohaaah: folds 
Filojoes: folds 
KLOP06031987: folds 
TorontoBum: folds 
solbi86: raises $1.50 to $2.50
aseban11: folds 
Uncalled bet ($1.50) returned to solbi86
solbi86 collected $2 from pot
solbi86: doesn't show hand 
*** SUMMARY ***
Total pot $2 | Rake $0 
Seat 2: solbi86 (small blind) collected ($2)
Seat 3: aseban11 (big blind) folded before Flop
Seat 4: matiko09 folded before Flop (didn't bet)
Seat 5: sebaaastian folded before Flop (didn't bet)
Seat 6: ooohaaah folded before Flop (didn't bet)
Seat 7: Filojoes folded before Flop (didn't bet)
Seat 8: KLOP06031987 folded before Flop (didn't bet)
Seat 9: TorontoBum (button) folded before Flop (didn't bet)





PokerStars Hand #147708829399:  Hold'em No Limit ($0.50/$1.00 USD) - 2016/01/26 16:27:28 CET [2016/01/26 10:27:28 ET]
Table 'Calypso II' 9-max Seat #8 is the button
Seat 1: KLOP06031987 ($100 in chips) 
Seat 2: simoniustin ($100 in chips) 
Seat 3: matiko09 ($247.14 in chips) 
Seat 4: aseban11 ($100 in chips) 
Seat 5: mycka86 ($108.37 in chips) 
Seat 7: Tasvision_mö ($29.81 in chips) 
Seat 8: Reven9er ($103.50 in chips) 
Seat 9: Filojoes ($150.69 in chips) 
Filojoes: posts small blind $0.50
KLOP06031987: posts big blind $1
*** HOLE CARDS ***
Dealt to matiko09 [3s 6h]
simoniustin: folds 
matiko09: folds 
aseban11: folds 
mycka86: folds 
Tasvision_mö: folds 
Reven9er: raises $1 to $2
Filojoes: calls $1.50
KLOP06031987: calls $1
*** FLOP *** [3c Js 6s]
Filojoes: checks 
KLOP06031987: checks 
Reven9er: checks 
*** TURN *** [3c Js 6s] [Jd]
aP0StAl joins the table at seat #6 
aP0StAl leaves the table
Filojoes: checks 
KLOP06031987: checks 
Reven9er: bets $2.50
Filojoes: folds 
KLOP06031987: folds 
Uncalled bet ($2.50) returned to Reven9er
Reven9er collected $5.73 from pot
Reven9er: doesn't show hand 
*** SUMMARY ***
Total pot $6 | Rake $0.27 
Board [3c Js 6s Jd]
Seat 1: KLOP06031987 (big blind) folded on the Turn
Seat 2: simoniustin folded before Flop (didn't bet)
Seat 3: matiko09 folded before Flop (didn't bet)
Seat 4: aseban11 folded before Flop (didn't bet)
Seat 5: mycka86 folded before Flop (didn't bet)
Seat 7: Tasvision_mö folded before Flop (didn't bet)
Seat 8: Reven9er (button) collected ($5.73)
Seat 9: Filojoes (small blind) folded on the Turn





PokerStars Hand #147708831482:  Hold'em No Limit ($0.50/$1.00 USD) - 2016/01/26 16:27:31 CET [2016/01/26 10:27:31 ET]
Table 'Srbija III' 9-max Seat #3 is the button
Seat 1: simoniustin ($114.73 in chips) 
Seat 2: cn_chayanne ($100 in chips) 
Seat 3: LIGOPSIXIS78 ($66.62 in chips) 
Seat 4: petalouda10 ($166.85 in chips) 
Seat 5: mycka86 ($101.50 in chips) 
Seat 6: matiko09 ($209.76 in chips) 
Seat 7: KLOP06031987 ($110.21 in chips) 
Seat 8: solbi86 ($100 in chips) 
Seat 9: soplak ($100 in chips) 
petalouda10: posts small blind $0.50
mycka86: posts big blind $1
*** HOLE CARDS ***
Dealt to matiko09 [3h 7s]
matiko09: folds 
KLOP06031987: folds 
solbi86: folds 
soplak: folds 
simoniustin: raises $2 to $3
cn_chayanne: folds 
LIGOPSIXIS78: folds 
petalouda10: calls $2.50
mycka86: folds 
*** FLOP *** [9c Ks Kh]
petalouda10: checks 
simoniustin: bets $4
petalouda10: calls $4
*** TURN *** [9c Ks Kh] [Ac]
petalouda10: checks 
simoniustin: checks 
*** RIVER *** [9c Ks Kh Ac] [9h]
petalouda10: bets $14.32
simoniustin: folds 
Uncalled bet ($14.32) returned to petalouda10
petalouda10 collected $14.32 from pot
petalouda10: doesn't show hand 
*** SUMMARY ***
Total pot $15 | Rake $0.68 
Board [9c Ks Kh Ac 9h]
Seat 1: simoniustin folded on the River
Seat 2: cn_chayanne folded before Flop (didn't bet)
Seat 3: LIGOPSIXIS78 (button) folded before Flop (didn't bet)
Seat 4: petalouda10 (small blind) collected ($14.32)
Seat 5: mycka86 (big blind) folded before Flop
Seat 6: matiko09 folded before Flop (didn't bet)
Seat 7: KLOP06031987 folded before Flop (didn't bet)
Seat 8: solbi86 folded before Flop (didn't bet)
Seat 9: soplak folded before Flop (didn't bet)





PokerStars Hand #147708896095:  Hold'em No Limit ($0.50/$1.00 USD) - 2016/01/26 16:28:55 CET [2016/01/26 10:28:55 ET]
Table 'Calypso II' 9-max Seat #9 is the button
Seat 1: KLOP06031987 ($100 in chips) 
Seat 2: simoniustin ($100 in chips) 
Seat 3: matiko09 ($247.14 in chips) 
Seat 4: aseban11 ($100 in chips) 
Seat 5: mycka86 ($108.37 in chips) 
Seat 7: Tasvision_mö ($29.81 in chips) 
Seat 8: Reven9er ($107.23 in chips) 
Seat 9: Filojoes ($148.69 in chips) 
KLOP06031987: posts small blind $0.50
simoniustin: posts big blind $1
*** HOLE CARDS ***
Dealt to matiko09 [2d As]
matiko09: folds 
aseban11: folds 
mycka86: folds 
Tasvision_mö: folds 
Reven9er: raises $1 to $2
Filojoes: calls $2
KLOP06031987: folds 
simoniustin: calls $1
*** FLOP *** [9c Qc Ah]
simoniustin: checks 
Reven9er: bets $4
Filojoes: raises $8 to $12
simoniustin: folds 
Reven9er: folds 
Uncalled bet ($8) returned to Filojoes
Filojoes collected $13.85 from pot
Filojoes: doesn't show hand 
*** SUMMARY ***
Total pot $14.50 | Rake $0.65 
Board [9c Qc Ah]
Seat 1: KLOP06031987 (small blind) folded before Flop
Seat 2: simoniustin (big blind) folded on the Flop
Seat 3: matiko09 folded before Flop (didn't bet)
Seat 4: aseban11 folded before Flop (didn't bet)
Seat 5: mycka86 folded before Flop (didn't bet)
Seat 7: Tasvision_mö folded before Flop (didn't bet)
Seat 8: Reven9er folded on the Flop
Seat 9: Filojoes (button) collected ($13.85)





PokerStars Hand #147753403925:  Hold'em No Limit ($0.50/$1.00 USD) - 2016/01/27 11:10:37 CET [2016/01/27 5:10:37 ET]
Table 'Palisana III' 9-max Seat #1 is the button
Seat 1: Largie1994 ($40 in chips) 
Seat 6: matiko09 ($100 in chips) 
Largie1994: posts small blind $0.50
matiko09: posts big blind $1
*** HOLE CARDS ***
Dealt to matiko09 [Kd Th]
tipner joins the table at seat #2 
Largie1994: raises $1 to $2
matiko09: calls $1
*** FLOP *** [7d 5d 6c]
matiko09: checks 
Largie1994: bets $2
matiko09: folds 
Uncalled bet ($2) returned to Largie1994
Kukuryzka joins the table at seat #3 
Largie1994 collected $3.82 from pot
*** SUMMARY ***
Total pot $4 | Rake $0.18 
Board [7d 5d 6c]
Seat 1: Largie1994 (button) (small blind) collected ($3.82)
Seat 6: matiko09 (big blind) folded on the Flop





PokerStars Hand #147753417553:  Hold'em No Limit ($0.50/$1.00 USD) - 2016/01/27 11:11:06 CET [2016/01/27 5:11:06 ET]
Table 'Palisana III' 9-max Seat #6 is the button
Seat 1: Largie1994 ($41.82 in chips) 
Seat 6: matiko09 ($100 in chips) 
matiko09: posts small blind $0.50
Largie1994: posts big blind $1
*** HOLE CARDS ***
Dealt to matiko09 [Ks Ts]
matiko09: raises $1.50 to $2.50
danuuutz joins the table at seat #4 
Largie1994: folds 
Uncalled bet ($1.50) returned to matiko09
matiko09 collected $2 from pot
matiko09: doesn't show hand 
*** SUMMARY ***
Total pot $2 | Rake $0 
Seat 1: Largie1994 (big blind) folded before Flop
Seat 6: matiko09 (button) (small blind) collected ($2)





PokerStars Hand #147753428270:  Hold'em No Limit ($0.50/$1.00 USD) - 2016/01/27 11:11:28 CET [2016/01/27 5:11:28 ET]
Table 'Palisana III' 9-max Seat #6 is the button
Seat 1: Largie1994 ($40.82 in chips) 
Seat 3: Kukuryzka ($100 in chips) 
Seat 6: matiko09 ($101 in chips) 
Largie1994: posts small blind $0.50
Kukuryzka: posts big blind $1
danuuutz: sits out 
*** HOLE CARDS ***
Dealt to matiko09 [3s Kc]
matiko09: folds 
Largie1994: folds 
Uncalled bet ($0.50) returned to Kukuryzka
Kukuryzka collected $1 from pot
Kukuryzka: doesn't show hand 
*** SUMMARY ***
Total pot $1 | Rake $0 
Seat 1: Largie1994 (small blind) folded before Flop
Seat 3: Kukuryzka (big blind) collected ($1)
Seat 6: matiko09 (button) folded before Flop (didn't bet)





PokerStars Hand #147753434902:  Hold'em No Limit ($0.50/$1.00 USD) - 2016/01/27 11:11:42 CET [2016/01/27 5:11:42 ET]
Table 'Palisana III' 9-max Seat #1 is the button
Seat 1: Largie1994 ($40.32 in chips) 
Seat 3: Kukuryzka ($100.50 in chips) 
Seat 4: danuuutz ($100 in chips) 
Seat 6: matiko09 ($101 in chips) 
Kukuryzka: posts small blind $0.50
danuuutz: posts big blind $1
*** HOLE CARDS ***
Dealt to matiko09 [2h 3d]
matiko09: folds 
Largie1994: folds 
di0d80 joins the table at seat #5 
Kukuryzka: folds 
Uncalled bet ($0.50) returned to danuuutz
danuuutz collected $1 from pot
danuuutz: doesn't show hand 
*** SUMMARY ***
Total pot $1 | Rake $0 
Seat 1: Largie1994 (button) folded before Flop (didn't bet)
Seat 3: Kukuryzka (small blind) folded before Flop
Seat 4: danuuutz (big blind) collected ($1)
Seat 6: matiko09 folded before Flop (didn't bet)





PokerStars Hand #147753445943:  Hold'em No Limit ($0.50/$1.00 USD) - 2016/01/27 11:12:05 CET [2016/01/27 5:12:05 ET]
Table 'Palisana III' 9-max Seat #3 is the button
Seat 1: Largie1994 ($40.32 in chips) 
Seat 3: Kukuryzka ($100 in chips) 
Seat 4: danuuutz ($100.50 in chips) 
Seat 5: di0d80 ($100 in chips) 
Seat 6: matiko09 ($101 in chips) 
danuuutz: posts small blind $0.50
di0d80: posts big blind $1
*** HOLE CARDS ***
Dealt to matiko09 [4s 2c]
matiko09: folds 
sylvian31 joins the table at seat #7 
Largie1994 has timed out
Largie1994: folds 
Kukuryzka: folds 
danuuutz: folds 
Uncalled bet ($0.50) returned to di0d80
di0d80 collected $1 from pot
di0d80: doesn't show hand 
*** SUMMARY ***
Total pot $1 | Rake $0 
Seat 1: Largie1994 folded before Flop (didn't bet)
Seat 3: Kukuryzka (button) folded before Flop (didn't bet)
Seat 4: danuuutz (small blind) folded before Flop
Seat 5: di0d80 (big blind) collected ($1)
Seat 6: matiko09 folded before Flop (didn't bet)





PokerStars Hand #147753462230:  Hold'em No Limit ($0.50/$1.00 USD) - 2016/01/27 11:12:39 CET [2016/01/27 5:12:39 ET]
Table 'Palisana III' 9-max Seat #4 is the button
Seat 1: Largie1994 ($40.32 in chips) 
Seat 3: Kukuryzka ($100 in chips) 
Seat 4: danuuutz ($100 in chips) 
Seat 5: di0d80 ($100.50 in chips) 
Seat 6: matiko09 ($101 in chips) 
di0d80: posts small blind $0.50
matiko09: posts big blind $1
sylvian31: sits out 
*** HOLE CARDS ***
Dealt to matiko09 [8d Jc]
Largie1994: folds 
Kukuryzka: folds 
danuuutz: folds 
di0d80: raises $2 to $3
matiko09: calls $2
*** FLOP *** [3s 8c 6s]
di0d80: checks 
matiko09: bets $3.72
di0d80: folds 
Uncalled bet ($3.72) returned to matiko09
matiko09 collected $5.73 from pot
matiko09: doesn't show hand 
*** SUMMARY ***
Total pot $6 | Rake $0.27 
Board [3s 8c 6s]
Seat 1: Largie1994 folded before Flop (didn't bet)
Seat 3: Kukuryzka folded before Flop (didn't bet)
Seat 4: danuuutz (button) folded before Flop (didn't bet)
Seat 5: di0d80 (small blind) folded on the Flop
Seat 6: matiko09 (big blind) collected ($5.73)





PokerStars Hand #147753465516:  Hold'em No Limit ($0.50/$1.00 USD) - 2016/01/27 11:12:46 CET [2016/01/27 5:12:46 ET]
Table 'Helene III' 9-max Seat #4 is the button
Seat 2: sylvian31 ($105.41 in chips) 
Seat 3: RoadtoNepal ($103.71 in chips) 
Seat 4: Sweden_Pound ($100 in chips) 
Seat 5: XMesuraX ($200.36 in chips) 
Seat 6: matiko09 ($100 in chips) 
Seat 9: Peu3aHy ($103.76 in chips) 
XMesuraX: posts small blind $0.50
matiko09: posts big blind $1
deepblue0000: sits out 
*** HOLE CARDS ***
Dealt to matiko09 [Jd 4h]
Peu3aHy: folds 
sylvian31: folds 
RoadtoNepal: folds 
Sweden_Pound: raises $1 to $2
XMesuraX: folds 
matiko09: folds 
Uncalled bet ($1) returned to Sweden_Pound
Sweden_Pound collected $2.50 from pot
Sweden_Pound: doesn't show hand 
*** SUMMARY ***
Total pot $2.50 | Rake $0 
Seat 2: sylvian31 folded before Flop (didn't bet)
Seat 3: RoadtoNepal folded before Flop (didn't bet)
Seat 4: Sweden_Pound (button) collected ($2.50)
Seat 5: XMesuraX (small blind) folded before Flop
Seat 6: matiko09 (big blind) folded before Flop
Seat 9: Peu3aHy folded before Flop (didn't bet)





PokerStars Hand #147753482603:  Hold'em No Limit ($0.50/$1.00 USD) - 2016/01/27 11:13:22 CET [2016/01/27 5:13:22 ET]
Table 'Helene III' 9-max Seat #5 is the button
Seat 2: sylvian31 ($105.41 in chips) 
Seat 3: RoadtoNepal ($103.71 in chips) 
Seat 4: Sweden_Pound ($101.50 in chips) 
Seat 5: XMesuraX ($199.86 in chips) 
Seat 6: matiko09 ($100 in chips) 
Seat 8: deepblue0000 ($100 in chips) 
Seat 9: Peu3aHy ($103.76 in chips) 
matiko09: posts small blind $0.50
deepblue0000: posts big blind $1
UShallGimme$: sits out 
*** HOLE CARDS ***
Dealt to matiko09 [9d Qd]
Peu3aHy: folds 
sylvian31: folds 
RoadtoNepal: folds 
Sweden_Pound: folds 
XMesuraX: folds 
matiko09: raises $1.50 to $2.50
deepblue0000: calls $1.50
*** FLOP *** [Jd 5s Th]
matiko09: bets $3.11
deepblue0000: calls $3.11
*** TURN *** [Jd 5s Th] [Kc]
matiko09: bets $7.48
deepblue0000: folds 
Uncalled bet ($7.48) returned to matiko09
matiko09 collected $10.72 from pot
matiko09: doesn't show hand 
*** SUMMARY ***
Total pot $11.22 | Rake $0.50 
Board [Jd 5s Th Kc]
Seat 2: sylvian31 folded before Flop (didn't bet)
Seat 3: RoadtoNepal folded before Flop (didn't bet)
Seat 4: Sweden_Pound folded before Flop (didn't bet)
Seat 5: XMesuraX (button) folded before Flop (didn't bet)
Seat 6: matiko09 (small blind) collected ($10.72)
Seat 8: deepblue0000 (big blind) folded on the Turn
Seat 9: Peu3aHy folded before Flop (didn't bet)





PokerStars Hand #147753489895:  Hold'em No Limit ($0.50/$1.00 USD) - 2016/01/27 11:13:37 CET [2016/01/27 5:13:37 ET]
Table 'Palisana III' 9-max Seat #5 is the button
Seat 1: Largie1994 ($40.32 in chips) 
Seat 3: Kukuryzka ($100 in chips) 
Seat 4: danuuutz ($100 in chips) 
Seat 5: di0d80 ($100 in chips) 
Seat 6: matiko09 ($103.73 in chips) 
Seat 7: sylvian31 ($100 in chips) 
matiko09: posts small blind $0.50
sylvian31: posts big blind $1
*** HOLE CARDS ***
Dealt to matiko09 [7s 4s]
Largie1994: folds 
Kukuryzka: folds 
Vadim Smole joins the table at seat #8 
danuuutz: folds 
di0d80: raises $1 to $2
matiko09: folds 
sylvian31: calls $1
*** FLOP *** [Kd 2c 5d]
sylvian31: checks 
di0d80: bets $3
sylvian31: calls $3
*** TURN *** [Kd 2c 5d] [Ad]
sylvian31: checks 
di0d80: checks 
*** RIVER *** [Kd 2c 5d Ad] [Jd]
sylvian31: checks 
di0d80: bets $7
Vadim Smole leaves the table
sylvian31: calls $7
*** SHOW DOWN ***
di0d80: shows [6c Ks] (a pair of Kings)
sylvian31: shows [Kc 4d] (a flush, Ace high)
sylvian31 collected $23.40 from pot
*** SUMMARY ***
Total pot $24.50 | Rake $1.10 
Board [Kd 2c 5d Ad Jd]
Seat 1: Largie1994 folded before Flop (didn't bet)
Seat 3: Kukuryzka folded before Flop (didn't bet)
Seat 4: danuuutz folded before Flop (didn't bet)
Seat 5: di0d80 (button) showed [6c Ks] and lost with a pair of Kings
Seat 6: matiko09 (small blind) folded before Flop
Seat 7: sylvian31 (big blind) showed [Kc 4d] and won ($23.40) with a flush, Ace high





PokerStars Hand #147753514460:  Hold'em No Limit ($0.50/$1.00 USD) - 2016/01/27 11:14:28 CET [2016/01/27 5:14:28 ET]
Table 'Helene III' 9-max Seat #6 is the button
Seat 2: sylvian31 ($105.41 in chips) 
Seat 3: RoadtoNepal ($103.71 in chips) 
Seat 4: Sweden_Pound ($101.50 in chips) 
Seat 5: XMesuraX ($199.86 in chips) 
Seat 6: matiko09 ($105.11 in chips) 
Seat 8: deepblue0000 ($100 in chips) 
Seat 9: Peu3aHy ($103.76 in chips) 
deepblue0000: posts small blind $0.50
Peu3aHy: posts big blind $1
UShallGimme$: sits out 
*** HOLE CARDS ***
Dealt to matiko09 [Ac 3h]
sylvian31: folds 
RoadtoNepal: folds 
Sweden_Pound: folds 
XMesuraX: raises $2 to $3
matiko09: folds 
deepblue0000: folds 
Peu3aHy: folds 
Uncalled bet ($2) returned to XMesuraX
XMesuraX collected $2.50 from pot
XMesuraX: doesn't show hand 
*** SUMMARY ***
Total pot $2.50 | Rake $0 
Seat 2: sylvian31 folded before Flop (didn't bet)
Seat 3: RoadtoNepal folded before Flop (didn't bet)
Seat 4: Sweden_Pound folded before Flop (didn't bet)
Seat 5: XMesuraX collected ($2.50)
Seat 6: matiko09 (button) folded before Flop (didn't bet)
Seat 8: deepblue0000 (small blind) folded before Flop
Seat 9: Peu3aHy (big blind) folded before Flop





PokerStars Hand #147753529581:  Hold'em No Limit ($0.50/$1.00 USD) - 2016/01/27 11:15:00 CET [2016/01/27 5:15:00 ET]
Table 'Helene III' 9-max Seat #8 is the button
Seat 1: UShallGimme$ ($101.50 in chips) 
Seat 2: sylvian31 ($105.41 in chips) 
Seat 3: RoadtoNepal ($103.71 in chips) 
Seat 4: Sweden_Pound ($101.50 in chips) 
Seat 5: XMesuraX ($201.36 in chips) 
Seat 6: matiko09 ($105.11 in chips) 
Seat 8: deepblue0000 ($100 in chips) 
Seat 9: Peu3aHy ($102.76 in chips) 
Peu3aHy: posts small blind $0.50
UShallGimme$: posts big blind $1
*** HOLE CARDS ***
Dealt to matiko09 [2h Qs]
sylvian31: raises $2 to $3
RoadtoNepal: folds 
Sweden_Pound: folds 
XMesuraX: folds 
matiko09: folds 
deepblue0000: calls $3
Peu3aHy: folds 
UShallGimme$: folds 
*** FLOP *** [Jc 3h Kc]
sylvian31: bets $4
deepblue0000: folds 
Uncalled bet ($4) returned to sylvian31
sylvian31 collected $7.16 from pot
sylvian31: doesn't show hand 
*** SUMMARY ***
Total pot $7.50 | Rake $0.34 
Board [Jc 3h Kc]
Seat 1: UShallGimme$ (big blind) folded before Flop
Seat 2: sylvian31 collected ($7.16)
Seat 3: RoadtoNepal folded before Flop (didn't bet)
Seat 4: Sweden_Pound folded before Flop (didn't bet)
Seat 5: XMesuraX folded before Flop (didn't bet)
Seat 6: matiko09 folded before Flop (didn't bet)
Seat 8: deepblue0000 (button) folded on the Flop
Seat 9: Peu3aHy (small blind) folded before Flop





PokerStars Hand #147753531975:  Hold'em No Limit ($0.50/$1.00 USD) - 2016/01/27 11:15:05 CET [2016/01/27 5:15:05 ET]
Table 'Eudora III' 9-max Seat #1 is the button
Seat 1: Eberhard314 ($100 in chips) 
Seat 2: Pablo1337 ($100 in chips) 
Seat 3: matiko09 ($100 in chips) 
Pablo1337: posts small blind $0.50
matiko09: posts big blind $1
*** HOLE CARDS ***
Dealt to matiko09 [Ts 3h]
Reven9er joins the table at seat #4 
Eberhard314: folds 
Pablo1337: folds 
Uncalled bet ($0.50) returned to matiko09
matiko09 collected $1 from pot
matiko09: doesn't show hand 
*** SUMMARY ***
Total pot $1 | Rake $0 
Seat 1: Eberhard314 (button) folded before Flop (didn't bet)
Seat 2: Pablo1337 (small blind) folded before Flop
Seat 3: matiko09 (big blind) collected ($1)





PokerStars Hand #147753536840:  Hold'em No Limit ($0.50/$1.00 USD) - 2016/01/27 11:15:15 CET [2016/01/27 5:15:15 ET]
Table 'Eudora III' 9-max Seat #2 is the button
Seat 1: Eberhard314 ($100 in chips) 
Seat 2: Pablo1337 ($100 in chips) 
Seat 3: matiko09 ($100.50 in chips) 
Seat 4: Reven9er ($100 in chips) 
matiko09: posts small blind $0.50
Reven9er: posts big blind $1
*** HOLE CARDS ***
Dealt to matiko09 [Ad 6s]
Eberhard314: folds 
sylvian31 leaves the table
Pablo1337: folds 
matiko09: folds 
Uncalled bet ($0.50) returned to Reven9er
Reven9er collected $1 from pot
Reven9er: doesn't show hand 
*** SUMMARY ***
Total pot $1 | Rake $0 
Seat 1: Eberhard314 folded before Flop (didn't bet)
Seat 2: Pablo1337 (button) folded before Flop (didn't bet)
Seat 3: matiko09 (small blind) folded before Flop
Seat 4: Reven9er (big blind) collected ($1)





PokerStars Hand #147753538669:  Hold'em No Limit ($0.50/$1.00 USD) - 2016/01/27 11:15:18 CET [2016/01/27 5:15:18 ET]
Table 'Palisana III' 9-max Seat #6 is the button
Seat 1: Largie1994 ($40.32 in chips) 
Seat 3: Kukuryzka ($100 in chips) 
Seat 4: danuuutz ($100 in chips) 
Seat 5: di0d80 ($100 in chips) 
Seat 6: matiko09 ($103.23 in chips) 
Seat 7: sylvian31 ($111.40 in chips) 
sylvian31: posts small blind $0.50
Largie1994: posts big blind $1
*** HOLE CARDS ***
Dealt to matiko09 [9d 5c]
Kukuryzka: folds 
danuuutz: folds 
di0d80: folds 
matiko09: folds 
sylvian31: raises $1.50 to $2.50
Largie1994: folds 
Uncalled bet ($1.50) returned to sylvian31
sylvian31 collected $2 from pot
sylvian31: doesn't show hand 
*** SUMMARY ***
Total pot $2 | Rake $0 
Seat 1: Largie1994 (big blind) folded before Flop
Seat 3: Kukuryzka folded before Flop (didn't bet)
Seat 4: danuuutz folded before Flop (didn't bet)
Seat 5: di0d80 folded before Flop (didn't bet)
Seat 6: matiko09 (button) folded before Flop (didn't bet)
Seat 7: sylvian31 (small blind) collected ($2)





PokerStars Hand #147753545431:  Hold'em No Limit ($0.50/$1.00 USD) - 2016/01/27 11:15:33 CET [2016/01/27 5:15:33 ET]
Table 'Eudora III' 9-max Seat #3 is the button
Seat 1: Eberhard314 ($100 in chips) 
Seat 2: Pablo1337 ($100 in chips) 
Seat 3: matiko09 ($100 in chips) 
Seat 4: Reven9er ($100.50 in chips) 
Reven9er: posts small blind $0.50
Eberhard314: posts big blind $1
*** HOLE CARDS ***
Dealt to matiko09 [5s Kh]
Pablo1337: raises $2 to $3
matiko09: folds 
Reven9er: folds 
Eberhard314: calls $2
*** FLOP *** [3d 5d Th]
di0d80 joins the table at seat #5 
Eberhard314: bets $4
Pablo1337: folds 
Uncalled bet ($4) returned to Eberhard314
Eberhard314 collected $6.21 from pot
*** SUMMARY ***
Total pot $6.50 | Rake $0.29 
Board [3d 5d Th]
Seat 1: Eberhard314 (big blind) collected ($6.21)
Seat 2: Pablo1337 folded on the Flop
Seat 3: matiko09 (button) folded before Flop (didn't bet)
Seat 4: Reven9er (small blind) folded before Flop





PokerStars Hand #147753548587:  Hold'em No Limit ($0.50/$1.00 USD) - 2016/01/27 11:15:39 CET [2016/01/27 5:15:39 ET]
Table 'Palisana III' 9-max Seat #7 is the button
Seat 1: Largie1994 ($39.32 in chips) 
Seat 3: Kukuryzka ($100 in chips) 
Seat 4: danuuutz ($100 in chips) 
Seat 5: di0d80 ($100 in chips) 
Seat 6: matiko09 ($103.23 in chips) 
Seat 7: sylvian31 ($112.40 in chips) 
Largie1994: posts small blind $0.50
Kukuryzka: posts big blind $1
*** HOLE CARDS ***
Dealt to matiko09 [Qc Td]
danuuutz: folds 
di0d80: folds 
matiko09: raises $1.50 to $2.50
danuuutz leaves the table
COOLIKO\/23 joins the table at seat #8 
sylvian31: folds 
Largie1994: folds 
Reven9er joins the table at seat #4 
Kukuryzka: folds 
Uncalled bet ($1.50) returned to matiko09
matiko09 collected $2.50 from pot
matiko09: doesn't show hand 
*** SUMMARY ***
Total pot $2.50 | Rake $0 
Seat 1: Largie1994 (small blind) folded before Flop
Seat 3: Kukuryzka (big blind) folded before Flop
Seat 4: danuuutz folded before Flop (didn't bet)
Seat 5: di0d80 folded before Flop (didn't bet)
Seat 6: matiko09 collected ($2.50)
Seat 7: sylvian31 (button) folded before Flop (didn't bet)





PokerStars Hand #147753549085:  Hold'em No Limit ($0.50/$1.00 USD) - 2016/01/27 11:15:40 CET [2016/01/27 5:15:40 ET]
Table 'Malzovia' 9-max Seat #2 is the button
Seat 1: mycka86 ($105.39 in chips) 
Seat 2: xJANN1x ($34.89 in chips) 
Seat 3: er13to ($111.12 in chips) 
Seat 5: matiko09 ($100 in chips) 
Seat 6: deepblue0000 ($279.46 in chips) 
Seat 7: Peu3aHy ($167.85 in chips) 
Seat 8: Sweden_Pound ($116.12 in chips) 
er13to: posts small blind $0.50
matiko09: posts big blind $1
UShallGimme$: sits out 
*** HOLE CARDS ***
Dealt to matiko09 [Jh Ac]
deepblue0000: folds 
Peu3aHy: folds 
Sweden_Pound: folds 
mycka86: folds 
xJANN1x: calls $1
er13to: folds 
matiko09: raises $3.50 to $4.50
xJANN1x: calls $3.50
*** FLOP *** [Ah 8s Ts]
matiko09: bets $7
xJANN1x: folds 
Uncalled bet ($7) returned to matiko09
matiko09 collected $9.07 from pot
matiko09: doesn't show hand 
*** SUMMARY ***
Total pot $9.50 | Rake $0.43 
Board [Ah 8s Ts]
Seat 1: mycka86 folded before Flop (didn't bet)
Seat 2: xJANN1x (button) folded on the Flop
Seat 3: er13to (small blind) folded before Flop
Seat 5: matiko09 (big blind) collected ($9.07)
Seat 6: deepblue0000 folded before Flop (didn't bet)
Seat 7: Peu3aHy folded before Flop (didn't bet)
Seat 8: Sweden_Pound folded before Flop (didn't bet)





PokerStars Hand #147753555425:  Hold'em No Limit ($0.50/$1.00 USD) - 2016/01/27 11:15:53 CET [2016/01/27 5:15:53 ET]
Table 'Helene III' 9-max Seat #9 is the button
Seat 1: UShallGimme$ ($100.50 in chips) 
Seat 4: Sweden_Pound ($101.50 in chips) 
Seat 5: XMesuraX ($201.36 in chips) 
Seat 6: matiko09 ($105.11 in chips) 
Seat 8: deepblue0000 ($100 in chips) 
Seat 9: Peu3aHy ($102.26 in chips) 
UShallGimme$: posts small blind $0.50
sylvian31: is sitting out 
RoadtoNepal: is sitting out 
Sweden_Pound: posts big blind $1
*** HOLE CARDS ***
Dealt to matiko09 [4c Tc]
XMesuraX: raises $1 to $2
sylvian31 leaves the table
matiko09: folds 
deepblue0000: calls $2
di0d80 joins the table at seat #2 
di0d80 leaves the table
Peu3aHy: folds 
UShallGimme$: folds 
Sweden_Pound: folds 
*** FLOP *** [4d Qh 6c]
XMesuraX: bets $3
deepblue0000: folds 
Uncalled bet ($3) returned to XMesuraX
XMesuraX collected $5.25 from pot
XMesuraX: doesn't show hand 
*** SUMMARY ***
Total pot $5.50 | Rake $0.25 
Board [4d Qh 6c]
Seat 1: UShallGimme$ (small blind) folded before Flop
Seat 4: Sweden_Pound (big blind) folded before Flop
Seat 5: XMesuraX collected ($5.25)
Seat 6: matiko09 folded before Flop (didn't bet)
Seat 8: deepblue0000 folded on the Flop
Seat 9: Peu3aHy (button) folded before Flop (didn't bet)





PokerStars Hand #147753561112:  Hold'em No Limit ($0.50/$1.00 USD) - 2016/01/27 11:16:05 CET [2016/01/27 5:16:05 ET]
Table 'Eudora III' 9-max Seat #4 is the button
Seat 1: Eberhard314 ($103.21 in chips) 
Seat 2: Pablo1337 ($100 in chips) 
Seat 3: matiko09 ($100 in chips) 
Seat 4: Reven9er ($100 in chips) 
di0d80 will be allowed to play after the button
Eberhard314: posts small blind $0.50
Pablo1337: posts big blind $1
*** HOLE CARDS ***
Dealt to matiko09 [Ks 6c]
matiko09: folds 
Reven9er: raises $1 to $2
Eberhard314: folds 
Pablo1337: folds 
Uncalled bet ($1) returned to Reven9er
Reven9er collected $2.50 from pot
Reven9er: doesn't show hand 
*** SUMMARY ***
Total pot $2.50 | Rake $0 
Seat 1: Eberhard314 (small blind) folded before Flop
Seat 2: Pablo1337 (big blind) folded before Flop
Seat 3: matiko09 folded before Flop (didn't bet)
Seat 4: Reven9er (button) collected ($2.50)





PokerStars Hand #147753568622:  Hold'em No Limit ($0.50/$1.00 USD) - 2016/01/27 11:16:21 CET [2016/01/27 5:16:21 ET]
Table 'Eudora III' 9-max Seat #1 is the button
Seat 1: Eberhard314 ($102.71 in chips) 
Seat 2: Pablo1337 ($100 in chips) 
Seat 3: matiko09 ($100 in chips) 
Seat 4: Reven9er ($101.50 in chips) 
Pablo1337: posts small blind $0.50
matiko09: posts big blind $1
di0d80: sits out 
*** HOLE CARDS ***
Dealt to matiko09 [Ks 3c]
Reven9er: folds 
Eberhard314: raises $2 to $3
Pablo1337: folds 
matiko09: folds 
Uncalled bet ($2) returned to Eberhard314
Eberhard314 collected $2.50 from pot
*** SUMMARY ***
Total pot $2.50 | Rake $0 
Seat 1: Eberhard314 (button) collected ($2.50)
Seat 2: Pablo1337 (small blind) folded before Flop
Seat 3: matiko09 (big blind) folded before Flop
Seat 4: Reven9er folded before Flop (didn't bet)





PokerStars Hand #147753572027:  Hold'em No Limit ($0.50/$1.00 USD) - 2016/01/27 11:16:27 CET [2016/01/27 5:16:27 ET]
Table 'Palisana III' 9-max Seat #1 is the button
Seat 1: Largie1994 ($38.82 in chips) 
Seat 3: Kukuryzka ($99 in chips) 
Seat 4: Reven9er ($100 in chips) 
Seat 5: di0d80 ($100 in chips) 
Seat 6: matiko09 ($104.73 in chips) 
Seat 7: sylvian31 ($112.40 in chips) 
Kukuryzka: posts small blind $0.50
Reven9er: posts big blind $1
COOLIKO\/23: sits out 
*** HOLE CARDS ***
Dealt to matiko09 [2d 9h]
di0d80: folds 
matiko09: folds 
sylvian31: folds 
Largie1994: folds 
Kukuryzka: folds 
Uncalled bet ($0.50) returned to Reven9er
Reven9er collected $1 from pot
Reven9er: doesn't show hand 
*** SUMMARY ***
Total pot $1 | Rake $0 
Seat 1: Largie1994 (button) folded before Flop (didn't bet)
Seat 3: Kukuryzka (small blind) folded before Flop
Seat 4: Reven9er (big blind) collected ($1)
Seat 5: di0d80 folded before Flop (didn't bet)
Seat 6: matiko09 folded before Flop (didn't bet)
Seat 7: sylvian31 folded before Flop (didn't bet)





PokerStars Hand #147753572441:  Hold'em No Limit ($0.50/$1.00 USD) - 2016/01/27 11:16:28 CET [2016/01/27 5:16:28 ET]
Table 'Helene III' 9-max Seat #1 is the button
Seat 1: UShallGimme$ ($100 in chips) 
Seat 4: Sweden_Pound ($100.50 in chips) 
Seat 5: XMesuraX ($204.61 in chips) 
Seat 6: matiko09 ($105.11 in chips) 
Seat 8: deepblue0000 ($100 in chips) 
Seat 9: Peu3aHy ($102.26 in chips) 
Sweden_Pound: posts small blind $0.50
XMesuraX: posts big blind $1
*** HOLE CARDS ***
Dealt to matiko09 [Jh 4c]
matiko09: folds 
Reven9er joins the table at seat #2 
deepblue0000: folds 
Peu3aHy: folds 
UShallGimme$: raises $1 to $2
Sweden_Pound: raises $5 to $7
XMesuraX: folds 
UShallGimme$: raises $10 to $17
Sweden_Pound: raises $83.50 to $100.50 and is all-in
UShallGimme$: calls $83 and is all-in
Uncalled bet ($0.50) returned to Sweden_Pound
*** FLOP *** [Kh 4s 2h]
*** TURN *** [Kh 4s 2h] [Kd]
*** RIVER *** [Kh 4s 2h Kd] [Jc]
*** SHOW DOWN ***
Sweden_Pound: shows [As Ad] (two pair, Aces and Kings)
UShallGimme$: shows [Qc Qh] (two pair, Kings and Queens)
Sweden_Pound collected $198.20 from pot
*** SUMMARY ***
Total pot $201 | Rake $2.80 
Board [Kh 4s 2h Kd Jc]
Seat 1: UShallGimme$ (button) showed [Qc Qh] and lost with two pair, Kings and Queens
Seat 4: Sweden_Pound (small blind) showed [As Ad] and won ($198.20) with two pair, Aces and Kings
Seat 5: XMesuraX (big blind) folded before Flop
Seat 6: matiko09 folded before Flop (didn't bet)
Seat 8: deepblue0000 folded before Flop (didn't bet)
Seat 9: Peu3aHy folded before Flop (didn't bet)





PokerStars Hand #147753572544:  Hold'em No Limit ($0.50/$1.00 USD) - 2016/01/27 11:16:29 CET [2016/01/27 5:16:29 ET]
Table 'Malzovia' 9-max Seat #3 is the button
Seat 1: mycka86 ($105.39 in chips) 
Seat 2: xJANN1x ($30.39 in chips) 
Seat 3: er13to ($110.62 in chips) 
Seat 5: matiko09 ($104.57 in chips) 
Seat 6: deepblue0000 ($279.46 in chips) 
Seat 7: Peu3aHy ($167.85 in chips) 
Seat 8: Sweden_Pound ($116.12 in chips) 
matiko09: posts small blind $0.50
deepblue0000: posts big blind $1
UShallGimme$: sits out 
*** HOLE CARDS ***
Dealt to matiko09 [Jc 8c]
Peu3aHy: folds 
Sweden_Pound: folds 
mycka86: folds 
xJANN1x: folds 
er13to: raises $1.50 to $2.50
matiko09: folds 
deepblue0000: raises $6.50 to $9
er13to: folds 
Uncalled bet ($6.50) returned to deepblue0000
deepblue0000 collected $5.50 from pot
*** SUMMARY ***
Total pot $5.50 | Rake $0 
Seat 1: mycka86 folded before Flop (didn't bet)
Seat 2: xJANN1x folded before Flop (didn't bet)
Seat 3: er13to (button) folded before Flop
Seat 5: matiko09 (small blind) folded before Flop
Seat 6: deepblue0000 (big blind) collected ($5.50)
Seat 7: Peu3aHy folded before Flop (didn't bet)
Seat 8: Sweden_Pound folded before Flop (didn't bet)





PokerStars Hand #147753574688:  Hold'em No Limit ($0.50/$1.00 USD) - 2016/01/27 11:16:33 CET [2016/01/27 5:16:33 ET]
Table 'Impala' 9-max Seat #1 is the button
Seat 1: Saintreine ($237.97 in chips) 
Seat 3: Peu3aHy ($100 in chips) 
Seat 4: matiko09 ($100 in chips) 
Seat 5: er13to ($134.59 in chips) 
Seat 6: deepblue0000 ($100 in chips) 
Seat 8: UShallGimme$ ($106.42 in chips) 
Peu3aHy: posts small blind $0.50
matiko09: posts big blind $1
RUS)Timur: sits out 
Reven9er: sits out 
*** HOLE CARDS ***
Dealt to matiko09 [Kh Kd]
er13to: raises $1.50 to $2.50
deepblue0000: folds 
UShallGimme$: folds 
Saintreine: folds 
Peu3aHy: calls $2
matiko09: raises $8.50 to $11
er13to: folds 
Peu3aHy: folds 
Uncalled bet ($8.50) returned to matiko09
matiko09 collected $7.50 from pot
matiko09: doesn't show hand 
*** SUMMARY ***
Total pot $7.50 | Rake $0 
Seat 1: Saintreine (button) folded before Flop (didn't bet)
Seat 3: Peu3aHy (small blind) folded before Flop
Seat 4: matiko09 (big blind) collected ($7.50)
Seat 5: er13to folded before Flop
Seat 6: deepblue0000 folded before Flop (didn't bet)
Seat 8: UShallGimme$ folded before Flop (didn't bet)





PokerStars Hand #147753577565:  Hold'em No Limit ($0.50/$1.00 USD) - 2016/01/27 11:16:39 CET [2016/01/27 5:16:39 ET]
Table 'Eudora III' 9-max Seat #2 is the button
Seat 1: Eberhard314 ($104.21 in chips) 
Seat 2: Pablo1337 ($100 in chips) 
Seat 3: matiko09 ($100 in chips) 
Seat 4: Reven9er ($101.50 in chips) 
matiko09: posts small blind $0.50
Reven9er: posts big blind $1
di0d80: sits out 
*** HOLE CARDS ***
Dealt to matiko09 [4h 4d]
Eberhard314: raises $2 to $3
Pablo1337: folds 
matiko09: folds 
Reven9er: folds 
Uncalled bet ($2) returned to Eberhard314
Eberhard314 collected $2.50 from pot
*** SUMMARY ***
Total pot $2.50 | Rake $0 
Seat 1: Eberhard314 collected ($2.50)
Seat 2: Pablo1337 (button) folded before Flop (didn't bet)
Seat 3: matiko09 (small blind) folded before Flop
Seat 4: Reven9er (big blind) folded before Flop





PokerStars Hand #147753589983:  Hold'em No Limit ($0.50/$1.00 USD) - 2016/01/27 11:17:05 CET [2016/01/27 5:17:05 ET]
Table 'Galilea' 9-max Seat #7 is the button
Seat 1: pandalapa ($100 in chips) 
Seat 3: Peu3aHy ($205.70 in chips) 
Seat 4: Sweden_Pound ($117.29 in chips) 
Seat 5: Saintreine ($118.07 in chips) 
Seat 6: UShallGimme$ ($130.84 in chips) 
Seat 7: mycka86 ($100 in chips) 
Seat 8: deepblue0000 ($223.43 in chips) 
Seat 9: matiko09 ($100 in chips) 
deepblue0000: posts small blind $0.50
matiko09: posts big blind $1
*** HOLE CARDS ***
Dealt to matiko09 [2d Js]
pandalapa: folds 
Peu3aHy: raises $2 to $3
Pablo1337 leaves the table
RUS)Timur joins the table at seat #2 
Sweden_Pound: folds 
Saintreine: folds 
UShallGimme$: raises $6 to $9
mycka86: folds 
deepblue0000: folds 
matiko09: folds 
Peu3aHy: folds 
Uncalled bet ($6) returned to UShallGimme$
UShallGimme$ collected $7.50 from pot
UShallGimme$: doesn't show hand 
*** SUMMARY ***
Total pot $7.50 | Rake $0 
Seat 1: pandalapa folded before Flop (didn't bet)
Seat 3: Peu3aHy folded before Flop
Seat 4: Sweden_Pound folded before Flop (didn't bet)
Seat 5: Saintreine folded before Flop (didn't bet)
Seat 6: UShallGimme$ collected ($7.50)
Seat 7: mycka86 (button) folded before Flop (didn't bet)
Seat 8: deepblue0000 (small blind) folded before Flop
Seat 9: matiko09 (big blind) folded before Flop





PokerStars Hand #147753591574:  Hold'em No Limit ($0.50/$1.00 USD) - 2016/01/27 11:17:08 CET [2016/01/27 5:17:08 ET]
Table 'Palisana III' 9-max Seat #3 is the button
Seat 1: Largie1994 ($38.82 in chips) 
Seat 3: Kukuryzka ($100 in chips) 
Seat 4: Reven9er ($100.50 in chips) 
Seat 5: di0d80 ($100 in chips) 
Seat 6: matiko09 ($104.73 in chips) 
Seat 7: sylvian31 ($112.40 in chips) 
Reven9er: posts small blind $0.50
di0d80: posts big blind $1
COOLIKO\/23: sits out 
*** HOLE CARDS ***
Dealt to matiko09 [Kh 7d]
matiko09: folds 
sylvian31: folds 
Largie1994: raises $2 to $3
Kukuryzka: folds 
Reven9er: folds 
di0d80: folds 
Uncalled bet ($2) returned to Largie1994
Largie1994 collected $2.50 from pot
*** SUMMARY ***
Total pot $2.50 | Rake $0 
Seat 1: Largie1994 collected ($2.50)
Seat 3: Kukuryzka (button) folded before Flop (didn't bet)
Seat 4: Reven9er (small blind) folded before Flop
Seat 5: di0d80 (big blind) folded before Flop
Seat 6: matiko09 folded before Flop (didn't bet)
Seat 7: sylvian31 folded before Flop (didn't bet)





PokerStars Hand #147753591442:  Hold'em No Limit ($0.50/$1.00 USD) - 2016/01/27 11:17:08 CET [2016/01/27 5:17:08 ET]
Table 'Malzovia' 9-max Seat #5 is the button
Seat 1: mycka86 ($105.39 in chips) 
Seat 2: xJANN1x ($30.39 in chips) 
Seat 3: er13to ($108.12 in chips) 
Seat 5: matiko09 ($104.07 in chips) 
Seat 6: deepblue0000 ($282.46 in chips) 
Seat 7: Peu3aHy ($167.85 in chips) 
Seat 8: Sweden_Pound ($116.12 in chips) 
deepblue0000: posts small blind $0.50
Peu3aHy: posts big blind $1
UShallGimme$: sits out 
*** HOLE CARDS ***
Dealt to matiko09 [6c 7h]
Sweden_Pound: folds 
mycka86: folds 
xJANN1x: folds 
er13to: folds 
matiko09: folds 
deepblue0000: raises $2 to $3
Peu3aHy: raises $4 to $7
deepblue0000: calls $4
*** FLOP *** [Jc Kd 9s]
deepblue0000: checks 
Peu3aHy: checks 
*** TURN *** [Jc Kd 9s] [2d]
deepblue0000: checks 
Peu3aHy: bets $9
deepblue0000: raises $31.37 to $40.37
Peu3aHy: folds 
Uncalled bet ($31.37) returned to deepblue0000
deepblue0000 collected $30.56 from pot
*** SUMMARY ***
Total pot $32 | Rake $1.44 
Board [Jc Kd 9s 2d]
Seat 1: mycka86 folded before Flop (didn't bet)
Seat 2: xJANN1x folded before Flop (didn't bet)
Seat 3: er13to folded before Flop (didn't bet)
Seat 5: matiko09 (button) folded before Flop (didn't bet)
Seat 6: deepblue0000 (small blind) collected ($30.56)
Seat 7: Peu3aHy (big blind) folded on the Turn
Seat 8: Sweden_Pound folded before Flop (didn't bet)





PokerStars Hand #147753594011:  Hold'em No Limit ($0.50/$1.00 USD) - 2016/01/27 11:17:13 CET [2016/01/27 5:17:13 ET]
Table 'Eudora III' 9-max Seat #3 is the button
Seat 1: Eberhard314 ($105.71 in chips) 
Seat 2: Pablo1337 ($100 in chips) 
Seat 3: matiko09 ($100 in chips) 
Seat 4: Reven9er ($100.50 in chips) 
Seat 5: di0d80 ($100 in chips) 
Reven9er: posts small blind $0.50
di0d80: posts big blind $1
*** HOLE CARDS ***
Dealt to matiko09 [3h 3c]
Eberhard314: folds 
Pablo1337: raises $2 to $3
DIMAZAYAC joins the table at seat #6 
matiko09: calls $3
Reven9er: folds 
Sweden_Pound joins the table at seat #7 
RUS)Timur joins the table at seat #8 
di0d80: folds 
*** FLOP *** [4d Th Qd]
Pablo1337: checks 
matiko09: checks 
*** TURN *** [4d Th Qd] [8c]
Pablo1337: checks 
matiko09: checks 
*** RIVER *** [4d Th Qd 8c] [4c]
Venomous100% joins the table at seat #9 
Pablo1337: checks 
matiko09: checks 
*** SHOW DOWN ***
Pablo1337: shows [9h 9c] (two pair, Nines and Fours)
matiko09: mucks hand 
Pablo1337 collected $7.16 from pot
*** SUMMARY ***
Total pot $7.50 | Rake $0.34 
Board [4d Th Qd 8c 4c]
Seat 1: Eberhard314 folded before Flop (didn't bet)
Seat 2: Pablo1337 showed [9h 9c] and won ($7.16) with two pair, Nines and Fours
Seat 3: matiko09 (button) mucked [3h 3c]
Seat 4: Reven9er (small blind) folded before Flop
Seat 5: di0d80 (big blind) folded before Flop





PokerStars Hand #147753601000:  Hold'em No Limit ($0.50/$1.00 USD) - 2016/01/27 11:17:28 CET [2016/01/27 5:17:28 ET]
Table 'Helene III' 9-max Seat #4 is the button
Seat 1: UShallGimme$ ($100 in chips) 
Seat 4: Sweden_Pound ($198.70 in chips) 
Seat 5: XMesuraX ($203.61 in chips) 
Seat 6: matiko09 ($105.11 in chips) 
Seat 8: deepblue0000 ($100 in chips) 
Seat 9: Peu3aHy ($102.26 in chips) 
XMesuraX: posts small blind $0.50
matiko09: posts big blind $1
Reven9er: sits out 
*** HOLE CARDS ***
Dealt to matiko09 [Qs 9c]
deepblue0000: folds 
Peu3aHy: raises $2 to $3
UShallGimme$: folds 
Sweden_Pound: folds 
XMesuraX: folds 
matiko09: folds 
Uncalled bet ($2) returned to Peu3aHy
Peu3aHy collected $2.50 from pot
Peu3aHy: doesn't show hand 
*** SUMMARY ***
Total pot $2.50 | Rake $0 
Seat 1: UShallGimme$ folded before Flop (didn't bet)
Seat 4: Sweden_Pound (button) folded before Flop (didn't bet)
Seat 5: XMesuraX (small blind) folded before Flop
Seat 6: matiko09 (big blind) folded before Flop
Seat 8: deepblue0000 folded before Flop (didn't bet)
Seat 9: Peu3aHy collected ($2.50)





PokerStars Hand #147753601589:  Hold'em No Limit ($0.50/$1.00 USD) - 2016/01/27 11:17:29 CET [2016/01/27 5:17:29 ET]
Table 'Impala' 9-max Seat #3 is the button
Seat 1: Saintreine ($237.97 in chips) 
Seat 3: Peu3aHy ($100 in chips) 
Seat 4: matiko09 ($105 in chips) 
Seat 5: er13to ($132.09 in chips) 
Seat 6: deepblue0000 ($100 in chips) 
Seat 8: UShallGimme$ ($106.42 in chips) 
matiko09: posts small blind $0.50
er13to: posts big blind $1
RUS)Timur: sits out 
Reven9er: sits out 
AlKatrone: sits out 
*** HOLE CARDS ***
Dealt to matiko09 [Qc Jh]
deepblue0000: folds 
UShallGimme$: raises $2 to $3
Saintreine: folds 
Peu3aHy: calls $3
matiko09: folds 
er13to: raises $12 to $15
UShallGimme$: folds 
Peu3aHy: folds 
Uncalled bet ($12) returned to er13to
er13to collected $9.50 from pot
*** SUMMARY ***
Total pot $9.50 | Rake $0 
Seat 1: Saintreine folded before Flop (didn't bet)
Seat 3: Peu3aHy (button) folded before Flop
Seat 4: matiko09 (small blind) folded before Flop
Seat 5: er13to (big blind) collected ($9.50)
Seat 6: deepblue0000 folded before Flop (didn't bet)
Seat 8: UShallGimme$ folded before Flop





PokerStars Hand #147753607904:  Hold'em No Limit ($0.50/$1.00 USD) - 2016/01/27 11:17:42 CET [2016/01/27 5:17:42 ET]
Table 'Galilea' 9-max Seat #8 is the button
Seat 1: pandalapa ($100 in chips) 
Seat 3: Peu3aHy ($202.70 in chips) 
Seat 4: Sweden_Pound ($117.29 in chips) 
Seat 5: Saintreine ($118.07 in chips) 
Seat 6: UShallGimme$ ($135.34 in chips) 
Seat 7: mycka86 ($100 in chips) 
Seat 8: deepblue0000 ($222.93 in chips) 
Seat 9: matiko09 ($100 in chips) 
matiko09: posts small blind $0.50
pandalapa: posts big blind $1
RUS)Timur: sits out 
*** HOLE CARDS ***
Dealt to matiko09 [3c 7c]
Peu3aHy: folds 
Sweden_Pound: folds 
Saintreine: raises $1.14 to $2.14
UShallGimme$: folds 
mycka86: folds 
deepblue0000: folds 
matiko09: folds 
pandalapa: folds 
Uncalled bet ($1.14) returned to Saintreine
Saintreine collected $2.50 from pot
Saintreine: doesn't show hand 
*** SUMMARY ***
Total pot $2.50 | Rake $0 
Seat 1: pandalapa (big blind) folded before Flop
Seat 3: Peu3aHy folded before Flop (didn't bet)
Seat 4: Sweden_Pound folded before Flop (didn't bet)
Seat 5: Saintreine collected ($2.50)
Seat 6: UShallGimme$ folded before Flop (didn't bet)
Seat 7: mycka86 folded before Flop (didn't bet)
Seat 8: deepblue0000 (button) folded before Flop (didn't bet)
Seat 9: matiko09 (small blind) folded before Flop





PokerStars Hand #147753612986:  Hold'em No Limit ($0.50/$1.00 USD) - 2016/01/27 11:17:53 CET [2016/01/27 5:17:53 ET]
Table 'Helene III' 9-max Seat #5 is the button
Seat 1: UShallGimme$ ($100 in chips) 
Seat 4: Sweden_Pound ($198.70 in chips) 
Seat 5: XMesuraX ($203.11 in chips) 
Seat 6: matiko09 ($104.11 in chips) 
Seat 8: deepblue0000 ($100 in chips) 
Seat 9: Peu3aHy ($103.76 in chips) 
matiko09: posts small blind $0.50
deepblue0000: posts big blind $1
Reven9er: sits out 
*** HOLE CARDS ***
Dealt to matiko09 [Ks 5h]
Peu3aHy: folds 
UShallGimme$: folds 
Sweden_Pound: folds 
XMesuraX: folds 
matiko09: folds 
Uncalled bet ($0.50) returned to deepblue0000
deepblue0000 collected $1 from pot
*** SUMMARY ***
Total pot $1 | Rake $0 
Seat 1: UShallGimme$ folded before Flop (didn't bet)
Seat 4: Sweden_Pound folded before Flop (didn't bet)
Seat 5: XMesuraX (button) folded before Flop (didn't bet)
Seat 6: matiko09 (small blind) folded before Flop
Seat 8: deepblue0000 (big blind) collected ($1)
Seat 9: Peu3aHy folded before Flop (didn't bet)





PokerStars Hand #147753618344:  Hold'em No Limit ($0.50/$1.00 USD) - 2016/01/27 11:18:03 CET [2016/01/27 5:18:03 ET]
Table 'Galilea' 9-max Seat #9 is the button
Seat 1: pandalapa ($100 in chips) 
Seat 2: RUS)Timur ($100 in chips) 
Seat 3: Peu3aHy ($202.70 in chips) 
Seat 4: Sweden_Pound ($117.29 in chips) 
Seat 5: Saintreine ($119.57 in chips) 
Seat 6: UShallGimme$ ($135.34 in chips) 
Seat 7: mycka86 ($100 in chips) 
Seat 8: deepblue0000 ($222.93 in chips) 
Seat 9: matiko09 ($100 in chips) 
pandalapa: posts small blind $0.50
RUS)Timur: posts big blind $1
*** HOLE CARDS ***
Dealt to matiko09 [Jc 2h]
Peu3aHy: raises $2 to $3
Sweden_Pound: folds 
Saintreine: folds 
UShallGimme$: folds 
mycka86: folds 
deepblue0000: folds 
matiko09: folds 
pandalapa: folds 
RUS)Timur: folds 
Uncalled bet ($2) returned to Peu3aHy
Peu3aHy collected $2.50 from pot
Peu3aHy: doesn't show hand 
*** SUMMARY ***
Total pot $2.50 | Rake $0 
Seat 1: pandalapa (small blind) folded before Flop
Seat 2: RUS)Timur (big blind) folded before Flop
Seat 3: Peu3aHy collected ($2.50)
Seat 4: Sweden_Pound folded before Flop (didn't bet)
Seat 5: Saintreine folded before Flop (didn't bet)
Seat 6: UShallGimme$ folded before Flop (didn't bet)
Seat 7: mycka86 folded before Flop (didn't bet)
Seat 8: deepblue0000 folded before Flop (didn't bet)
Seat 9: matiko09 (button) folded before Flop (didn't bet)





PokerStars Hand #147753618728:  Hold'em No Limit ($0.50/$1.00 USD) - 2016/01/27 11:18:04 CET [2016/01/27 5:18:04 ET]
Table 'Impala' 9-max Seat #4 is the button
Seat 1: Saintreine ($237.97 in chips) 
Seat 3: Peu3aHy ($100 in chips) 
Seat 4: matiko09 ($104.50 in chips) 
Seat 5: er13to ($138.59 in chips) 
Seat 6: deepblue0000 ($100 in chips) 
Seat 8: UShallGimme$ ($103.42 in chips) 
er13to: posts small blind $0.50
deepblue0000: posts big blind $1
RUS)Timur: sits out 
Reven9er: sits out 
AlKatrone: sits out 
*** HOLE CARDS ***
Dealt to matiko09 [4c Th]
UShallGimme$: folds 
Saintreine: folds 
Peu3aHy: folds 
matiko09: folds 
er13to: raises $1.50 to $2.50
deepblue0000: calls $1.50
*** FLOP *** [2s Jd Kh]
er13to is disconnected 
er13to is connected 
er13to: checks 
deepblue0000: checks 
*** TURN *** [2s Jd Kh] [3s]
er13to is disconnected 
er13to is connected 
er13to: checks 
deepblue0000: checks 
*** RIVER *** [2s Jd Kh 3s] [4d]
er13to: checks 
deepblue0000: bets $2
er13to: folds 
Uncalled bet ($2) returned to deepblue0000
deepblue0000 collected $4.78 from pot
*** SUMMARY ***
Total pot $5 | Rake $0.22 
Board [2s Jd Kh 3s 4d]
Seat 1: Saintreine folded before Flop (didn't bet)
Seat 3: Peu3aHy folded before Flop (didn't bet)
Seat 4: matiko09 (button) folded before Flop (didn't bet)
Seat 5: er13to (small blind) folded on the River
Seat 6: deepblue0000 (big blind) collected ($4.78)
Seat 8: UShallGimme$ folded before Flop (didn't bet)





PokerStars Hand #147753619528:  Hold'em No Limit ($0.50/$1.00 USD) - 2016/01/27 11:18:06 CET [2016/01/27 5:18:06 ET]
Table 'Palisana III' 9-max Seat #4 is the button
Seat 1: Largie1994 ($40.32 in chips) 
Seat 3: Kukuryzka ($100 in chips) 
Seat 4: Reven9er ($100 in chips) 
Seat 5: di0d80 ($100 in chips) 
Seat 6: matiko09 ($104.73 in chips) 
Seat 7: sylvian31 ($112.40 in chips) 
di0d80: posts small blind $0.50
matiko09: posts big blind $1
COOLIKO\/23: sits out 
*** HOLE CARDS ***
Dealt to matiko09 [Ts 6s]
sylvian31: folds 
sylvian31 leaves the table
Sweden_Pound joins the table at seat #7 
Largie1994: calls $1
Kukuryzka: raises $4 to $5
Reven9er: folds 
di0d80: folds 
matiko09: folds 
Largie1994: folds 
Uncalled bet ($4) returned to Kukuryzka
Kukuryzka collected $3.50 from pot
Kukuryzka: doesn't show hand 
*** SUMMARY ***
Total pot $3.50 | Rake $0 
Seat 1: Largie1994 folded before Flop
Seat 3: Kukuryzka collected ($3.50)
Seat 4: Reven9er (button) folded before Flop (didn't bet)
Seat 5: di0d80 (small blind) folded before Flop
Seat 6: matiko09 (big blind) folded before Flop
Seat 7: sylvian31 folded before Flop (didn't bet)





PokerStars Hand #147753622719:  Hold'em No Limit ($0.50/$1.00 USD) - 2016/01/27 11:18:13 CET [2016/01/27 5:18:13 ET]
Table 'Malzovia' 9-max Seat #6 is the button
Seat 1: mycka86 ($105.39 in chips) 
Seat 2: xJANN1x ($30.39 in chips) 
Seat 3: er13to ($108.12 in chips) 
Seat 5: matiko09 ($104.07 in chips) 
Seat 6: deepblue0000 ($297.02 in chips) 
Seat 7: Peu3aHy ($151.85 in chips) 
Seat 8: Sweden_Pound ($116.12 in chips) 
Peu3aHy: posts small blind $0.50
Sweden_Pound: posts big blind $1
UShallGimme$: sits out 
AlKatrone: sits out 
*** HOLE CARDS ***
Dealt to matiko09 [9s Qs]
mycka86: folds 
xJANN1x: folds 
er13to is disconnected 
er13to has timed out while disconnected
er13to: folds 
matiko09: raises $1.50 to $2.50
deepblue0000: folds 
Peu3aHy: folds 
Sweden_Pound: folds 
Uncalled bet ($1.50) returned to matiko09
matiko09 collected $2.50 from pot
matiko09: doesn't show hand 
*** SUMMARY ***
Total pot $2.50 | Rake $0 
Seat 1: mycka86 folded before Flop (didn't bet)
Seat 2: xJANN1x folded before Flop (didn't bet)
Seat 3: er13to folded before Flop (didn't bet)
Seat 5: matiko09 collected ($2.50)
Seat 6: deepblue0000 (button) folded before Flop (didn't bet)
Seat 7: Peu3aHy (small blind) folded before Flop
Seat 8: Sweden_Pound (big blind) folded before Flop





PokerStars Hand #147753628277:  Hold'em No Limit ($0.50/$1.00 USD) - 2016/01/27 11:18:24 CET [2016/01/27 5:18:24 ET]
Table 'Helene III' 9-max Seat #6 is the button
Seat 1: UShallGimme$ ($100 in chips) 
Seat 4: Sweden_Pound ($198.70 in chips) 
Seat 5: XMesuraX ($203.11 in chips) 
Seat 6: matiko09 ($103.61 in chips) 
Seat 8: deepblue0000 ($100.50 in chips) 
Seat 9: Peu3aHy ($103.76 in chips) 
deepblue0000: posts small blind $0.50
Peu3aHy: posts big blind $1
Reven9er: sits out 
*** HOLE CARDS ***
Dealt to matiko09 [7s Qh]
UShallGimme$: folds 
Sweden_Pound: folds 
XMesuraX: folds 
matiko09: folds 
deepblue0000: folds 
Uncalled bet ($0.50) returned to Peu3aHy
Peu3aHy collected $1 from pot
Peu3aHy: doesn't show hand 
*** SUMMARY ***
Total pot $1 | Rake $0 
Seat 1: UShallGimme$ folded before Flop (didn't bet)
Seat 4: Sweden_Pound folded before Flop (didn't bet)
Seat 5: XMesuraX folded before Flop (didn't bet)
Seat 6: matiko09 (button) folded before Flop (didn't bet)
Seat 8: deepblue0000 (small blind) folded before Flop
Seat 9: Peu3aHy (big blind) collected ($1)





PokerStars Hand #147753632503:  Hold'em No Limit ($0.50/$1.00 USD) - 2016/01/27 11:18:33 CET [2016/01/27 5:18:33 ET]
Table 'Eudora III' 9-max Seat #4 is the button
Seat 1: Eberhard314 ($105.71 in chips) 
Seat 2: Pablo1337 ($104.16 in chips) 
Seat 3: matiko09 ($100 in chips) 
Seat 4: Reven9er ($100 in chips) 
Seat 5: di0d80 ($100 in chips) 
Seat 6: DIMAZAYAC ($45 in chips) 
di0d80: posts small blind $0.50
DIMAZAYAC: posts big blind $1
Sweden_Pound: sits out 
RUS)Timur: sits out 
Venomous100%: sits out 
*** HOLE CARDS ***
Dealt to matiko09 [8c 5c]
Eberhard314: folds 
Pablo1337: folds 
matiko09: raises $1.50 to $2.50
Reven9er: folds 
di0d80: folds 
DIMAZAYAC: folds 
Uncalled bet ($1.50) returned to matiko09
matiko09 collected $2.50 from pot
matiko09: doesn't show hand 
*** SUMMARY ***
Total pot $2.50 | Rake $0 
Seat 1: Eberhard314 folded before Flop (didn't bet)
Seat 2: Pablo1337 folded before Flop (didn't bet)
Seat 3: matiko09 collected ($2.50)
Seat 4: Reven9er (button) folded before Flop (didn't bet)
Seat 5: di0d80 (small blind) folded before Flop
Seat 6: DIMAZAYAC (big blind) folded before Flop





PokerStars Hand #147753635029:  Hold'em No Limit ($0.50/$1.00 USD) - 2016/01/27 11:18:38 CET [2016/01/27 5:18:38 ET]
Table 'Siegena III' 9-max Seat #7 is the button
Seat 1: nnne409 ($80 in chips) 
Seat 2: tipner ($100 in chips) 
Seat 3: masaytoo ($100 in chips) 
Seat 4: Sweden_Pound ($100 in chips) 
Seat 5: matiko09 ($100 in chips) 
Seat 6: RUS)Timur ($100 in chips) 
Seat 7: sylvian31 ($100 in chips) 
Seat 8: Venomous100% ($100 in chips) 
Seat 9: di0d80 ($100 in chips) 
Venomous100%: posts small blind $0.50
di0d80: posts big blind $1
*** HOLE CARDS ***
Dealt to matiko09 [Ts Qd]
nnne409: folds 
tipner: folds 
masaytoo: calls $1
Sweden_Pound: folds 
matiko09: raises $3 to $4
RUS)Timur: folds 
sylvian31: folds 
Venomous100%: folds 
di0d80: folds 
masaytoo: folds 
Uncalled bet ($3) returned to matiko09
matiko09 collected $3.50 from pot
matiko09: doesn't show hand 
*** SUMMARY ***
Total pot $3.50 | Rake $0 
Seat 1: nnne409 folded before Flop (didn't bet)
Seat 2: tipner folded before Flop (didn't bet)
Seat 3: masaytoo folded before Flop
Seat 4: Sweden_Pound folded before Flop (didn't bet)
Seat 5: matiko09 collected ($3.50)
Seat 6: RUS)Timur folded before Flop (didn't bet)
Seat 7: sylvian31 (button) folded before Flop (didn't bet)
Seat 8: Venomous100% (small blind) folded before Flop
Seat 9: di0d80 (big blind) folded before Flop





PokerStars Hand #147753636517:  Hold'em No Limit ($0.50/$1.00 USD) - 2016/01/27 11:18:41 CET [2016/01/27 5:18:41 ET]
Table 'Galilea' 9-max Seat #1 is the button
Seat 1: pandalapa ($100 in chips) 
Seat 2: RUS)Timur ($100 in chips) 
Seat 3: Peu3aHy ($204.20 in chips) 
Seat 4: Sweden_Pound ($117.29 in chips) 
Seat 5: Saintreine ($119.57 in chips) 
Seat 6: UShallGimme$ ($135.34 in chips) 
Seat 7: mycka86 ($100 in chips) 
Seat 8: deepblue0000 ($222.93 in chips) 
Seat 9: matiko09 ($100 in chips) 
RUS)Timur: posts small blind $0.50
Peu3aHy: posts big blind $1
*** HOLE CARDS ***
Dealt to matiko09 [9s Kh]
Sweden_Pound: folds 
Saintreine: raises $1.50 to $2.50
UShallGimme$: folds 
mycka86: folds 
deepblue0000: folds 
matiko09: folds 
pandalapa: folds 
RUS)Timur: folds 
Peu3aHy: folds 
Uncalled bet ($1.50) returned to Saintreine
Saintreine collected $2.50 from pot
Saintreine: doesn't show hand 
*** SUMMARY ***
Total pot $2.50 | Rake $0 
Seat 1: pandalapa (button) folded before Flop (didn't bet)
Seat 2: RUS)Timur (small blind) folded before Flop
Seat 3: Peu3aHy (big blind) folded before Flop
Seat 4: Sweden_Pound folded before Flop (didn't bet)
Seat 5: Saintreine collected ($2.50)
Seat 6: UShallGimme$ folded before Flop (didn't bet)
Seat 7: mycka86 folded before Flop (didn't bet)
Seat 8: deepblue0000 folded before Flop (didn't bet)
Seat 9: matiko09 folded before Flop (didn't bet)





PokerStars Hand #147753636702:  Hold'em No Limit ($0.50/$1.00 USD) - 2016/01/27 11:18:42 CET [2016/01/27 5:18:42 ET]
Table 'Helene III' 9-max Seat #8 is the button
Seat 1: UShallGimme$ ($100 in chips) 
Seat 4: Sweden_Pound ($198.70 in chips) 
Seat 5: XMesuraX ($203.11 in chips) 
Seat 6: matiko09 ($103.61 in chips) 
Seat 8: deepblue0000 ($100 in chips) 
Seat 9: Peu3aHy ($104.26 in chips) 
Peu3aHy: posts small blind $0.50
UShallGimme$: posts big blind $1
Reven9er: sits out 
*** HOLE CARDS ***
Dealt to matiko09 [Qh Jh]
Sweden_Pound: folds 
XMesuraX: folds 
matiko09: raises $1.50 to $2.50
deepblue0000: folds 
Peu3aHy: folds 
UShallGimme$: raises $6 to $8.50
matiko09: calls $6
*** FLOP *** [7d 3h Th]
UShallGimme$: checks 
matiko09: bets $8.68
tipner leaves the table
di0d80 joins the table at seat #7 
UShallGimme$: folds 
Uncalled bet ($8.68) returned to matiko09
matiko09 collected $16.71 from pot
matiko09: doesn't show hand 
*** SUMMARY ***
Total pot $17.50 | Rake $0.79 
Board [7d 3h Th]
Seat 1: UShallGimme$ (big blind) folded on the Flop
Seat 4: Sweden_Pound folded before Flop (didn't bet)
Seat 5: XMesuraX folded before Flop (didn't bet)
Seat 6: matiko09 collected ($16.71)
Seat 8: deepblue0000 (button) folded before Flop (didn't bet)
Seat 9: Peu3aHy (small blind) folded before Flop





PokerStars Hand #147753640533:  Hold'em No Limit ($0.50/$1.00 USD) - 2016/01/27 11:18:50 CET [2016/01/27 5:18:50 ET]
Table 'Palisana III' 9-max Seat #5 is the button
Seat 1: Largie1994 ($39.32 in chips) 
Seat 3: Kukuryzka ($102.50 in chips) 
Seat 4: Reven9er ($100 in chips) 
Seat 5: di0d80 ($100 in chips) 
Seat 6: matiko09 ($103.73 in chips) 
Seat 7: Sweden_Pound ($100 in chips) 
matiko09: posts small blind $0.50
Sweden_Pound: posts big blind $1
COOLIKO\/23: sits out 
*** HOLE CARDS ***
Dealt to matiko09 [Td Kh]
Largie1994: folds 
Kukuryzka: folds 
Reven9er: folds 
di0d80: raises $1 to $2
matiko09: folds 
Sweden_Pound: folds 
Uncalled bet ($1) returned to di0d80
di0d80 collected $2.50 from pot
di0d80: doesn't show hand 
*** SUMMARY ***
Total pot $2.50 | Rake $0 
Seat 1: Largie1994 folded before Flop (didn't bet)
Seat 3: Kukuryzka folded before Flop (didn't bet)
Seat 4: Reven9er folded before Flop (didn't bet)
Seat 5: di0d80 (button) collected ($2.50)
Seat 6: matiko09 (small blind) folded before Flop
Seat 7: Sweden_Pound (big blind) folded before Flop





PokerStars Hand #147753642717:  Hold'em No Limit ($0.50/$1.00 USD) - 2016/01/27 11:18:54 CET [2016/01/27 5:18:54 ET]
Table 'Eudora III' 9-max Seat #5 is the button
Seat 1: Eberhard314 ($105.71 in chips) 
Seat 2: Pablo1337 ($104.16 in chips) 
Seat 3: matiko09 ($101.50 in chips) 
Seat 4: Reven9er ($100 in chips) 
Seat 5: di0d80 ($100 in chips) 
Seat 6: DIMAZAYAC ($44 in chips) 
Seat 7: Sweden_Pound ($100 in chips) 
DIMAZAYAC: posts small blind $0.50
Sweden_Pound: posts big blind $1
RUS)Timur: sits out 
Venomous100%: sits out 
*** HOLE CARDS ***
Dealt to matiko09 [8s Ks]
Eberhard314: folds 
Pablo1337: folds 
matiko09: raises $2 to $3
Reven9er: raises $4 to $7
di0d80: folds 
DIMAZAYAC: folds 
Sweden_Pound: folds 
matiko09: folds 
Uncalled bet ($4) returned to Reven9er
Reven9er collected $7.50 from pot
Reven9er: doesn't show hand 
*** SUMMARY ***
Total pot $7.50 | Rake $0 
Seat 1: Eberhard314 folded before Flop (didn't bet)
Seat 2: Pablo1337 folded before Flop (didn't bet)
Seat 3: matiko09 folded before Flop
Seat 4: Reven9er collected ($7.50)
Seat 5: di0d80 (button) folded before Flop (didn't bet)
Seat 6: DIMAZAYAC (small blind) folded before Flop
Seat 7: Sweden_Pound (big blind) folded before Flop





PokerStars Hand #147753650637:  Hold'em No Limit ($0.50/$1.00 USD) - 2016/01/27 11:19:10 CET [2016/01/27 5:19:10 ET]
Table 'Palisana III' 9-max Seat #6 is the button
Seat 1: Largie1994 ($39.32 in chips) 
Seat 3: Kukuryzka ($102.50 in chips) 
Seat 4: Reven9er ($100 in chips) 
Seat 5: di0d80 ($101.50 in chips) 
Seat 6: matiko09 ($103.23 in chips) 
Seat 7: Sweden_Pound ($100 in chips) 
Seat 8: COOLIKO\/23 ($100 in chips) 
Sweden_Pound: posts small blind $0.50
COOLIKO\/23: posts big blind $1
*** HOLE CARDS ***
Dealt to matiko09 [4c 3s]
Largie1994: folds 
Kukuryzka: folds 
Reven9er: folds 
di0d80: raises $1.50 to $2.50
matiko09: folds 
Sweden_Pound: folds 
COOLIKO\/23: folds 
Uncalled bet ($1.50) returned to di0d80
di0d80 collected $2.50 from pot
di0d80: doesn't show hand 
*** SUMMARY ***
Total pot $2.50 | Rake $0 
Seat 1: Largie1994 folded before Flop (didn't bet)
Seat 3: Kukuryzka folded before Flop (didn't bet)
Seat 4: Reven9er folded before Flop (didn't bet)
Seat 5: di0d80 collected ($2.50)
Seat 6: matiko09 (button) folded before Flop (didn't bet)
Seat 7: Sweden_Pound (small blind) folded before Flop
Seat 8: COOLIKO\/23 (big blind) folded before Flop





PokerStars Hand #147753656756:  Hold'em No Limit ($0.50/$1.00 USD) - 2016/01/27 11:19:23 CET [2016/01/27 5:19:23 ET]
Table 'Malzovia' 9-max Seat #7 is the button
Seat 1: mycka86 ($105.39 in chips) 
Seat 2: xJANN1x ($30.39 in chips) 
Seat 5: matiko09 ($105.57 in chips) 
Seat 6: deepblue0000 ($297.02 in chips) 
Seat 7: Peu3aHy ($151.35 in chips) 
Seat 8: Sweden_Pound ($115.12 in chips) 
Seat 9: UShallGimme$ ($121.32 in chips) 
Sweden_Pound: posts small blind $0.50
UShallGimme$: posts big blind $1
AlKatrone: sits out 
*** HOLE CARDS ***
Dealt to matiko09 [Ts 9d]
mycka86: folds 
xJANN1x: folds 
matiko09: folds 
er13to is disconnected 
deepblue0000: folds 
Peu3aHy: raises $2 to $3
Sweden_Pound: folds 
UShallGimme$: calls $2
*** FLOP *** [Tc 2s 3d]
UShallGimme$: checks 
Peu3aHy: bets $4
UShallGimme$: folds 
Uncalled bet ($4) returned to Peu3aHy
Peu3aHy collected $6.21 from pot
Peu3aHy: doesn't show hand 
*** SUMMARY ***
Total pot $6.50 | Rake $0.29 
Board [Tc 2s 3d]
Seat 1: mycka86 folded before Flop (didn't bet)
Seat 2: xJANN1x folded before Flop (didn't bet)
Seat 5: matiko09 folded before Flop (didn't bet)
Seat 6: deepblue0000 folded before Flop (didn't bet)
Seat 7: Peu3aHy (button) collected ($6.21)
Seat 8: Sweden_Pound (small blind) folded before Flop
Seat 9: UShallGimme$ (big blind) folded on the Flop





PokerStars Hand #147753662750:  Hold'em No Limit ($0.50/$1.00 USD) - 2016/01/27 11:19:36 CET [2016/01/27 5:19:36 ET]
Table 'Galilea' 9-max Seat #2 is the button
Seat 1: pandalapa ($100 in chips) 
Seat 2: RUS)Timur ($100 in chips) 
Seat 3: Peu3aHy ($203.20 in chips) 
Seat 4: Sweden_Pound ($117.29 in chips) 
Seat 5: Saintreine ($121.07 in chips) 
Seat 6: UShallGimme$ ($135.34 in chips) 
Seat 7: mycka86 ($100 in chips) 
Seat 8: deepblue0000 ($222.93 in chips) 
Seat 9: matiko09 ($100 in chips) 
Peu3aHy: posts small blind $0.50
Sweden_Pound: posts big blind $1
*** HOLE CARDS ***
Dealt to matiko09 [Ad 3c]
Saintreine: folds 
UShallGimme$: folds 
mycka86: folds 
deepblue0000: folds 
matiko09: folds 
pandalapa: folds 
RUS)Timur: folds 
Peu3aHy: folds 
Uncalled bet ($0.50) returned to Sweden_Pound
Sweden_Pound collected $1 from pot
Sweden_Pound: doesn't show hand 
*** SUMMARY ***
Total pot $1 | Rake $0 
Seat 1: pandalapa folded before Flop (didn't bet)
Seat 2: RUS)Timur (button) folded before Flop (didn't bet)
Seat 3: Peu3aHy (small blind) folded before Flop
Seat 4: Sweden_Pound (big blind) collected ($1)
Seat 5: Saintreine folded before Flop (didn't bet)
Seat 6: UShallGimme$ folded before Flop (didn't bet)
Seat 7: mycka86 folded before Flop (didn't bet)
Seat 8: deepblue0000 folded before Flop (didn't bet)
Seat 9: matiko09 folded before Flop (didn't bet)





PokerStars Hand #147753665978:  Hold'em No Limit ($0.50/$1.00 USD) - 2016/01/27 11:19:43 CET [2016/01/27 5:19:43 ET]
Table 'Eudora III' 9-max Seat #6 is the button
Seat 1: Eberhard314 ($105.71 in chips) 
Seat 2: Pablo1337 ($104.16 in chips) 
Seat 3: matiko09 ($100 in chips) 
Seat 4: Reven9er ($104.50 in chips) 
Seat 5: di0d80 ($100 in chips) 
Seat 6: DIMAZAYAC ($43.50 in chips) 
Seat 7: Sweden_Pound ($100 in chips) 
Seat 8: RUS)Timur ($100 in chips) 
Sweden_Pound: posts small blind $0.50
RUS)Timur: posts big blind $1
Venomous100%: sits out 
*** HOLE CARDS ***
Dealt to matiko09 [Js Ad]
Eberhard314: folds 
Pablo1337: folds 
matiko09: raises $2 to $3
Reven9er: folds 
di0d80: folds 
DIMAZAYAC: calls $3
Sweden_Pound: folds 
RUS)Timur: calls $2
*** FLOP *** [Th Kh Kd]
RUS)Timur: checks 
matiko09: checks 
DIMAZAYAC: bets $5
RUS)Timur: folds 
matiko09: folds 
Uncalled bet ($5) returned to DIMAZAYAC
DIMAZAYAC collected $9.07 from pot
*** SUMMARY ***
Total pot $9.50 | Rake $0.43 
Board [Th Kh Kd]
Seat 1: Eberhard314 folded before Flop (didn't bet)
Seat 2: Pablo1337 folded before Flop (didn't bet)
Seat 3: matiko09 folded on the Flop
Seat 4: Reven9er folded before Flop (didn't bet)
Seat 5: di0d80 folded before Flop (didn't bet)
Seat 6: DIMAZAYAC (button) collected ($9.07)
Seat 7: Sweden_Pound (small blind) folded before Flop
Seat 8: RUS)Timur (big blind) folded on the Flop





PokerStars Hand #147753668322:  Hold'em No Limit ($0.50/$1.00 USD) - 2016/01/27 11:19:47 CET [2016/01/27 5:19:47 ET]
Table 'Helene III' 9-max Seat #9 is the button
Seat 1: UShallGimme$ ($100 in chips) 
Seat 2: Reven9er ($100 in chips) 
Seat 4: Sweden_Pound ($198.70 in chips) 
Seat 5: XMesuraX ($203.11 in chips) 
Seat 6: matiko09 ($111.82 in chips) 
Seat 8: deepblue0000 ($100 in chips) 
Seat 9: Peu3aHy ($103.76 in chips) 
UShallGimme$: posts small blind $0.50
Reven9er: posts big blind $1
di0d80: sits out 
*** HOLE CARDS ***
Dealt to matiko09 [7d Qd]
Sweden_Pound: folds 
XMesuraX: raises $2 to $3
matiko09: folds 
deepblue0000: raises $6 to $9
Peu3aHy: folds 
UShallGimme$: folds 
Reven9er: folds 
XMesuraX: folds 
Uncalled bet ($6) returned to deepblue0000
deepblue0000 collected $7.50 from pot
*** SUMMARY ***
Total pot $7.50 | Rake $0 
Seat 1: UShallGimme$ (small blind) folded before Flop
Seat 2: Reven9er (big blind) folded before Flop
Seat 4: Sweden_Pound folded before Flop (didn't bet)
Seat 5: XMesuraX folded before Flop
Seat 6: matiko09 folded before Flop (didn't bet)
Seat 8: deepblue0000 collected ($7.50)
Seat 9: Peu3aHy (button) folded before Flop (didn't bet)





PokerStars Hand #147753671877:  Hold'em No Limit ($0.50/$1.00 USD) - 2016/01/27 11:19:55 CET [2016/01/27 5:19:55 ET]
Table 'Siegena III' 9-max Seat #8 is the button
Seat 1: nnne409 ($80 in chips) 
Seat 2: tipner ($100 in chips) 
Seat 3: masaytoo ($99 in chips) 
Seat 4: Sweden_Pound ($100 in chips) 
Seat 5: matiko09 ($102.50 in chips) 
Seat 6: RUS)Timur ($100 in chips) 
Seat 7: sylvian31 ($100 in chips) 
Seat 8: Venomous100% ($100 in chips) 
Seat 9: di0d80 ($100 in chips) 
di0d80: posts small blind $0.50
nnne409: posts big blind $1
*** HOLE CARDS ***
Dealt to matiko09 [8h 5d]
tipner: folds 
masaytoo: folds 
Sweden_Pound: folds 
matiko09: folds 
RUS)Timur: folds 
sylvian31: folds 
Venomous100%: folds 
di0d80: raises $2 to $3
nnne409: folds 
Uncalled bet ($2) returned to di0d80
di0d80 collected $2 from pot
di0d80: doesn't show hand 
*** SUMMARY ***
Total pot $2 | Rake $0 
Seat 1: nnne409 (big blind) folded before Flop
Seat 2: tipner folded before Flop (didn't bet)
Seat 3: masaytoo folded before Flop (didn't bet)
Seat 4: Sweden_Pound folded before Flop (didn't bet)
Seat 5: matiko09 folded before Flop (didn't bet)
Seat 6: RUS)Timur folded before Flop (didn't bet)
Seat 7: sylvian31 folded before Flop (didn't bet)
Seat 8: Venomous100% (button) folded before Flop (didn't bet)
Seat 9: di0d80 (small blind) collected ($2)





PokerStars Hand #147753672442:  Hold'em No Limit ($0.50/$1.00 USD) - 2016/01/27 11:19:56 CET [2016/01/27 5:19:56 ET]
Table 'Malzovia' 9-max Seat #8 is the button
Seat 1: mycka86 ($105.39 in chips) 
Seat 2: xJANN1x ($30.39 in chips) 
Seat 5: matiko09 ($105.57 in chips) 
Seat 6: deepblue0000 ($297.02 in chips) 
Seat 7: Peu3aHy ($154.56 in chips) 
Seat 8: Sweden_Pound ($114.62 in chips) 
Seat 9: UShallGimme$ ($118.32 in chips) 
UShallGimme$: posts small blind $0.50
mycka86: posts big blind $1
AlKatrone: sits out 
*** HOLE CARDS ***
Dealt to matiko09 [4h Jc]
xJANN1x: folds 
matiko09: folds 
deepblue0000: raises $2 to $3
Peu3aHy: folds 
er13to leaves the table
Sweden_Pound: folds 
di0d80 joins the table at seat #3 
UShallGimme$: folds 
di0d80 leaves the table
mycka86: folds 
Uncalled bet ($2) returned to deepblue0000
deepblue0000 collected $2.50 from pot
*** SUMMARY ***
Total pot $2.50 | Rake $0 
Seat 1: mycka86 (big blind) folded before Flop
Seat 2: xJANN1x folded before Flop (didn't bet)
Seat 5: matiko09 folded before Flop (didn't bet)
Seat 6: deepblue0000 collected ($2.50)
Seat 7: Peu3aHy folded before Flop (didn't bet)
Seat 8: Sweden_Pound (button) folded before Flop (didn't bet)
Seat 9: UShallGimme$ (small blind) folded before Flop





PokerStars Hand #147753673208:  Hold'em No Limit ($0.50/$1.00 USD) - 2016/01/27 11:19:58 CET [2016/01/27 5:19:58 ET]
Table 'Palisana III' 9-max Seat #7 is the button
Seat 1: Largie1994 ($39.32 in chips) 
Seat 3: Kukuryzka ($102.50 in chips) 
Seat 4: Reven9er ($100 in chips) 
Seat 5: di0d80 ($103 in chips) 
Seat 6: matiko09 ($103.23 in chips) 
Seat 7: Sweden_Pound ($100 in chips) 
Seat 8: COOLIKO\/23 ($100 in chips) 
COOLIKO\/23: posts small blind $0.50
Largie1994: posts big blind $1
tipner: sits out 
*** HOLE CARDS ***
Dealt to matiko09 [Ac Ks]
Kukuryzka: folds 
Reven9er: folds 
di0d80: folds 
matiko09: raises $1.50 to $2.50
Sweden_Pound: folds 
COOLIKO\/23: folds 
Largie1994: folds 
Uncalled bet ($1.50) returned to matiko09
matiko09 collected $2.50 from pot
matiko09: doesn't show hand 
*** SUMMARY ***
Total pot $2.50 | Rake $0 
Seat 1: Largie1994 (big blind) folded before Flop
Seat 3: Kukuryzka folded before Flop (didn't bet)
Seat 4: Reven9er folded before Flop (didn't bet)
Seat 5: di0d80 folded before Flop (didn't bet)
Seat 6: matiko09 collected ($2.50)
Seat 7: Sweden_Pound (button) folded before Flop (didn't bet)
Seat 8: COOLIKO\/23 (small blind) folded before Flop





PokerStars Hand #147753673980:  Hold'em No Limit ($0.50/$1.00 USD) - 2016/01/27 11:19:59 CET [2016/01/27 5:19:59 ET]
Table 'Galilea' 9-max Seat #3 is the button
Seat 1: pandalapa ($100 in chips) 
Seat 2: RUS)Timur ($100 in chips) 
Seat 3: Peu3aHy ($202.70 in chips) 
Seat 4: Sweden_Pound ($117.79 in chips) 
Seat 5: Saintreine ($121.07 in chips) 
Seat 6: UShallGimme$ ($135.34 in chips) 
Seat 7: mycka86 ($100 in chips) 
Seat 8: deepblue0000 ($222.93 in chips) 
Seat 9: matiko09 ($100 in chips) 
Sweden_Pound: posts small blind $0.50
Saintreine: posts big blind $1
*** HOLE CARDS ***
Dealt to matiko09 [4h 7c]
UShallGimme$: folds 
mycka86: folds 
deepblue0000: folds 
matiko09: folds 
pandalapa: folds 
RUS)Timur: raises $1.45 to $2.45
Peu3aHy: folds 
Sweden_Pound: folds 
Saintreine: calls $1.45
*** FLOP *** [Ks Tc 2h]
Saintreine: checks 
RUS)Timur: bets $3.30
Saintreine: folds 
Uncalled bet ($3.30) returned to RUS)Timur
RUS)Timur collected $5.16 from pot
RUS)Timur: doesn't show hand 
*** SUMMARY ***
Total pot $5.40 | Rake $0.24 
Board [Ks Tc 2h]
Seat 1: pandalapa folded before Flop (didn't bet)
Seat 2: RUS)Timur collected ($5.16)
Seat 3: Peu3aHy (button) folded before Flop (didn't bet)
Seat 4: Sweden_Pound (small blind) folded before Flop
Seat 5: Saintreine (big blind) folded on the Flop
Seat 6: UShallGimme$ folded before Flop (didn't bet)
Seat 7: mycka86 folded before Flop (didn't bet)
Seat 8: deepblue0000 folded before Flop (didn't bet)
Seat 9: matiko09 folded before Flop (didn't bet)





PokerStars Hand #147753683370:  Hold'em No Limit ($0.50/$1.00 USD) - 2016/01/27 11:20:19 CET [2016/01/27 5:20:19 ET]
Table 'Helene III' 9-max Seat #1 is the button
Seat 1: UShallGimme$ ($100 in chips) 
Seat 2: Reven9er ($100 in chips) 
Seat 4: Sweden_Pound ($198.70 in chips) 
Seat 5: XMesuraX ($200.11 in chips) 
Seat 6: matiko09 ($111.82 in chips) 
Seat 8: deepblue0000 ($104.50 in chips) 
Seat 9: Peu3aHy ($103.76 in chips) 
Reven9er: posts small blind $0.50
Sweden_Pound: posts big blind $1
di0d80: sits out 
*** HOLE CARDS ***
Dealt to matiko09 [8c Td]
XMesuraX: folds 
matiko09: folds 
deepblue0000: raises $2 to $3
Peu3aHy: calls $3
UShallGimme$: folds 
Reven9er: calls $2.50
Sweden_Pound: calls $2
*** FLOP *** [6h 3d Qd]
Reven9er: checks 
Sweden_Pound: checks 
deepblue0000: checks 
Peu3aHy: bets $8
RoadtoNepal leaves the table
Reven9er: calls $8
Sweden_Pound: folds 
deepblue0000: folds 
*** TURN *** [6h 3d Qd] [3c]
tipner joins the table at seat #3 
Reven9er: checks 
Peu3aHy: bets $20
Reven9er: calls $20
*** RIVER *** [6h 3d Qd 3c] [6d]
Reven9er: bets $36.50
Peu3aHy: calls $36.50
*** SHOW DOWN ***
Reven9er: shows [6s 5s] (a full house, Sixes full of Threes)
Peu3aHy: mucks hand 
Reven9er collected $138.20 from pot
*** SUMMARY ***
Total pot $141 | Rake $2.80 
Board [6h 3d Qd 3c 6d]
Seat 1: UShallGimme$ (button) folded before Flop (didn't bet)
Seat 2: Reven9er (small blind) showed [6s 5s] and won ($138.20) with a full house, Sixes full of Threes
Seat 4: Sweden_Pound (big blind) folded on the Flop
Seat 5: XMesuraX folded before Flop (didn't bet)
Seat 6: matiko09 folded before Flop (didn't bet)
Seat 8: deepblue0000 folded on the Flop
Seat 9: Peu3aHy mucked [2d Ad]





PokerStars Hand #147753683767:  Hold'em No Limit ($0.50/$1.00 USD) - 2016/01/27 11:20:20 CET [2016/01/27 5:20:20 ET]
Table 'Impala' 9-max Seat #5 is the button
Seat 1: Saintreine ($237.97 in chips) 
Seat 3: Peu3aHy ($100 in chips) 
Seat 4: matiko09 ($104.50 in chips) 
Seat 5: er13to ($136.09 in chips) 
Seat 6: deepblue0000 ($102.28 in chips) 
Seat 7: RUS)Timur ($100 in chips) 
Seat 8: UShallGimme$ ($103.42 in chips) 
deepblue0000: posts small blind $0.50
RUS)Timur: posts big blind $1
Reven9er: sits out 
AlKatrone: sits out 
*** HOLE CARDS ***
Dealt to matiko09 [7c Ts]
UShallGimme$: folds 
Saintreine: folds 
Peu3aHy: folds 
matiko09: folds 
er13to: folds 
deepblue0000: raises $2 to $3
RUS)Timur: calls $2
*** FLOP *** [Tc As 5d]
deepblue0000: checks 
RUS)Timur: bets $2.81
deepblue0000: folds 
Uncalled bet ($2.81) returned to RUS)Timur
RUS)Timur collected $5.73 from pot
RUS)Timur: doesn't show hand 
*** SUMMARY ***
Total pot $6 | Rake $0.27 
Board [Tc As 5d]
Seat 1: Saintreine folded before Flop (didn't bet)
Seat 3: Peu3aHy folded before Flop (didn't bet)
Seat 4: matiko09 folded before Flop (didn't bet)
Seat 5: er13to (button) folded before Flop (didn't bet)
Seat 6: deepblue0000 (small blind) folded on the Flop
Seat 7: RUS)Timur (big blind) collected ($5.73)
Seat 8: UShallGimme$ folded before Flop (didn't bet)





PokerStars Hand #147753685419:  Hold'em No Limit ($0.50/$1.00 USD) - 2016/01/27 11:20:23 CET [2016/01/27 5:20:23 ET]
Table 'Malzovia' 9-max Seat #9 is the button
Seat 1: mycka86 ($104.39 in chips) 
Seat 4: AlKatrone ($100 in chips) 
Seat 5: matiko09 ($105.57 in chips) 
Seat 6: deepblue0000 ($298.52 in chips) 
Seat 7: Peu3aHy ($154.56 in chips) 
Seat 8: Sweden_Pound ($114.62 in chips) 
Seat 9: UShallGimme$ ($117.82 in chips) 
mycka86: posts small blind $0.50
AlKatrone: posts big blind $1
*** HOLE CARDS ***
Dealt to matiko09 [Th 6h]
matiko09: folds 
deepblue0000: raises $2 to $3
Peu3aHy: folds 
Sweden_Pound: folds 
UShallGimme$: folds 
mycka86: folds 
xJANN1x is disconnected 
AlKatrone: folds 
Uncalled bet ($2) returned to deepblue0000
deepblue0000 collected $2.50 from pot
*** SUMMARY ***
Total pot $2.50 | Rake $0 
Seat 1: mycka86 (small blind) folded before Flop
Seat 4: AlKatrone (big blind) folded before Flop
Seat 5: matiko09 folded before Flop (didn't bet)
Seat 6: deepblue0000 collected ($2.50)
Seat 7: Peu3aHy folded before Flop (didn't bet)
Seat 8: Sweden_Pound folded before Flop (didn't bet)
Seat 9: UShallGimme$ (button) folded before Flop (didn't bet)





PokerStars Hand #147753687671:  Hold'em No Limit ($0.50/$1.00 USD) - 2016/01/27 11:20:28 CET [2016/01/27 5:20:28 ET]
Table 'Palisana III' 9-max Seat #8 is the button
Seat 1: Largie1994 ($38.32 in chips) 
Seat 2: tipner ($100 in chips) 
Seat 3: Kukuryzka ($102.50 in chips) 
Seat 4: Reven9er ($100 in chips) 
Seat 5: di0d80 ($103 in chips) 
Seat 6: matiko09 ($104.73 in chips) 
Seat 7: Sweden_Pound ($100 in chips) 
Seat 8: COOLIKO\/23 ($100 in chips) 
Largie1994: posts small blind $0.50
tipner: posts big blind $1
*** HOLE CARDS ***
Dealt to matiko09 [Ad 5s]
Kukuryzka: folds 
Reven9er: raises $1 to $2
di0d80: folds 
matiko09: folds 
Sweden_Pound: folds 
COOLIKO\/23: folds 
Largie1994: calls $1.50
tipner: folds 
*** FLOP *** [3h Kh Ac]
Largie1994: checks 
Reven9er: bets $2.50
Largie1994: calls $2.50
*** TURN *** [3h Kh Ac] [9c]
Largie1994: checks 
Reven9er: checks 
*** RIVER *** [3h Kh Ac 9c] [Jh]
Largie1994: bets $3
Reven9er: folds 
Uncalled bet ($3) returned to Largie1994
Largie1994 collected $9.55 from pot
Largie1994: doesn't show hand 
*** SUMMARY ***
Total pot $10 | Rake $0.45 
Board [3h Kh Ac 9c Jh]
Seat 1: Largie1994 (small blind) collected ($9.55)
Seat 2: tipner (big blind) folded before Flop
Seat 3: Kukuryzka folded before Flop (didn't bet)
Seat 4: Reven9er folded on the River
Seat 5: di0d80 folded before Flop (didn't bet)
Seat 6: matiko09 folded before Flop (didn't bet)
Seat 7: Sweden_Pound folded before Flop (didn't bet)
Seat 8: COOLIKO\/23 (button) folded before Flop (didn't bet)





PokerStars Hand #147753689562:  Hold'em No Limit ($0.50/$1.00 USD) - 2016/01/27 11:20:32 CET [2016/01/27 5:20:32 ET]
Table 'Siegena III' 9-max Seat #9 is the button
Seat 1: nnne409 ($79 in chips) 
Seat 2: tipner ($100 in chips) 
Seat 3: masaytoo ($99 in chips) 
Seat 4: Sweden_Pound ($100 in chips) 
Seat 5: matiko09 ($102.50 in chips) 
Seat 6: RUS)Timur ($100 in chips) 
Seat 7: sylvian31 ($100 in chips) 
Seat 8: Venomous100% ($100 in chips) 
Seat 9: di0d80 ($101 in chips) 
nnne409: posts small blind $0.50
tipner: posts big blind $1
*** HOLE CARDS ***
Dealt to matiko09 [4c Qs]
masaytoo: folds 
Sweden_Pound: folds 
matiko09: folds 
RUS)Timur: raises $1.45 to $2.45
sylvian31: folds 
Venomous100%: folds 
di0d80: folds 
nnne409: folds 
tipner: folds 
Uncalled bet ($1.45) returned to RUS)Timur
RUS)Timur collected $2.50 from pot
RUS)Timur: doesn't show hand 
*** SUMMARY ***
Total pot $2.50 | Rake $0 
Seat 1: nnne409 (small blind) folded before Flop
Seat 2: tipner (big blind) folded before Flop
Seat 3: masaytoo folded before Flop (didn't bet)
Seat 4: Sweden_Pound folded before Flop (didn't bet)
Seat 5: matiko09 folded before Flop (didn't bet)
Seat 6: RUS)Timur collected ($2.50)
Seat 7: sylvian31 folded before Flop (didn't bet)
Seat 8: Venomous100% folded before Flop (didn't bet)
Seat 9: di0d80 (button) folded before Flop (didn't bet)





PokerStars Hand #147753699083:  Hold'em No Limit ($0.50/$1.00 USD) - 2016/01/27 11:20:52 CET [2016/01/27 5:20:52 ET]
Table 'Malzovia' 9-max Seat #1 is the button
Seat 1: mycka86 ($103.89 in chips) 
Seat 4: AlKatrone ($100 in chips) 
Seat 5: matiko09 ($105.57 in chips) 
Seat 6: deepblue0000 ($300.02 in chips) 
Seat 7: Peu3aHy ($154.56 in chips) 
Seat 8: Sweden_Pound ($114.62 in chips) 
Seat 9: UShallGimme$ ($117.82 in chips) 
AlKatrone: posts small blind $0.50
matiko09: posts big blind $1
*** HOLE CARDS ***
Dealt to matiko09 [8c Ac]
deepblue0000: folds 
Peu3aHy: folds 
Sweden_Pound: folds 
UShallGimme$: folds 
mycka86: folds 
AlKatrone: calls $0.50
matiko09: raises $3 to $4
AlKatrone: folds 
Uncalled bet ($3) returned to matiko09
matiko09 collected $2 from pot
matiko09: doesn't show hand 
*** SUMMARY ***
Total pot $2 | Rake $0 
Seat 1: mycka86 (button) folded before Flop (didn't bet)
Seat 4: AlKatrone (small blind) folded before Flop
Seat 5: matiko09 (big blind) collected ($2)
Seat 6: deepblue0000 folded before Flop (didn't bet)
Seat 7: Peu3aHy folded before Flop (didn't bet)
Seat 8: Sweden_Pound folded before Flop (didn't bet)
Seat 9: UShallGimme$ folded before Flop (didn't bet)





PokerStars Hand #147753700724:  Hold'em No Limit ($0.50/$1.00 USD) - 2016/01/27 11:20:55 CET [2016/01/27 5:20:55 ET]
Table 'Eudora III' 9-max Seat #7 is the button
Seat 1: Eberhard314 ($105.71 in chips) 
Seat 2: Pablo1337 ($104.16 in chips) 
Seat 3: matiko09 ($100 in chips) 
Seat 4: Reven9er ($104.50 in chips) 
Seat 5: di0d80 ($100 in chips) 
Seat 6: DIMAZAYAC ($49.57 in chips) 
Seat 7: Sweden_Pound ($100 in chips) 
Seat 8: RUS)Timur ($100 in chips) 
Seat 9: Venomous100% ($100 in chips) 
RUS)Timur: posts small blind $0.50
Venomous100%: posts big blind $1
*** HOLE CARDS ***
Dealt to matiko09 [Ts 5s]
Eberhard314: folds 
Pablo1337: folds 
matiko09: folds 
Reven9er: folds 
di0d80: folds 
DIMAZAYAC: folds 
Sweden_Pound: raises $1 to $2
RUS)Timur: folds 
Venomous100%: folds 
Uncalled bet ($1) returned to Sweden_Pound
Sweden_Pound collected $2.50 from pot
Sweden_Pound: doesn't show hand 
*** SUMMARY ***
Total pot $2.50 | Rake $0 
Seat 1: Eberhard314 folded before Flop (didn't bet)
Seat 2: Pablo1337 folded before Flop (didn't bet)
Seat 3: matiko09 folded before Flop (didn't bet)
Seat 4: Reven9er folded before Flop (didn't bet)
Seat 5: di0d80 folded before Flop (didn't bet)
Seat 6: DIMAZAYAC folded before Flop (didn't bet)
Seat 7: Sweden_Pound (button) collected ($2.50)
Seat 8: RUS)Timur (small blind) folded before Flop
Seat 9: Venomous100% (big blind) folded before Flop





PokerStars Hand #147753705894:  Hold'em No Limit ($0.50/$1.00 USD) - 2016/01/27 11:21:06 CET [2016/01/27 5:21:06 ET]
Table 'Alkmene II' 9-max Seat #8 is the button
Seat 1: matiko09 ($100 in chips) 
Seat 2: deepblue0000 ($100 in chips) 
Seat 3: MuSaShiBuShi ($47.23 in chips) 
Seat 4: CoolFireX ($142.84 in chips) 
Seat 5: Sweden_Pound ($128.57 in chips) 
Seat 6: Peu3aHy ($100 in chips) 
Seat 7: mycka86 ($100 in chips) 
Seat 8: fecsok1 ($81.05 in chips) 
Seat 9: pandalapa ($100.50 in chips) 
pandalapa: posts small blind $0.50
matiko09: posts big blind $1
*** HOLE CARDS ***
Dealt to matiko09 [4d 9d]
deepblue0000: folds 
MuSaShiBuShi: folds 
CoolFireX: folds 
Sweden_Pound: folds 
Peu3aHy: folds 
mycka86: raises $1.10 to $2.10
fecsok1: folds 
pandalapa: folds 
matiko09: folds 
Uncalled bet ($1.10) returned to mycka86
mycka86 collected $2.50 from pot
*** SUMMARY ***
Total pot $2.50 | Rake $0 
Seat 1: matiko09 (big blind) folded before Flop
Seat 2: deepblue0000 folded before Flop (didn't bet)
Seat 3: MuSaShiBuShi folded before Flop (didn't bet)
Seat 4: CoolFireX folded before Flop (didn't bet)
Seat 5: Sweden_Pound folded before Flop (didn't bet)
Seat 6: Peu3aHy folded before Flop (didn't bet)
Seat 7: mycka86 collected ($2.50)
Seat 8: fecsok1 (button) folded before Flop (didn't bet)
Seat 9: pandalapa (small blind) folded before Flop





PokerStars Hand #147753706926:  Hold'em No Limit ($0.50/$1.00 USD) - 2016/01/27 11:21:08 CET [2016/01/27 5:21:08 ET]
Table 'Siegena III' 9-max Seat #1 is the button
Seat 1: nnne409 ($78.50 in chips) 
Seat 2: tipner ($100 in chips) 
Seat 3: masaytoo ($99 in chips) 
Seat 4: Sweden_Pound ($100 in chips) 
Seat 5: matiko09 ($102.50 in chips) 
Seat 6: RUS)Timur ($101.50 in chips) 
Seat 7: sylvian31 ($100 in chips) 
Seat 8: Venomous100% ($100 in chips) 
Seat 9: di0d80 ($101 in chips) 
tipner: posts small blind $0.50
masaytoo: posts big blind $1
*** HOLE CARDS ***
Dealt to matiko09 [Qs 8c]
Sweden_Pound: folds 
matiko09: folds 
RUS)Timur: folds 
sylvian31: folds 
Venomous100%: folds 
di0d80: folds 
nnne409: folds 
tipner: folds 
Uncalled bet ($0.50) returned to masaytoo
masaytoo collected $1 from pot
masaytoo: doesn't show hand 
*** SUMMARY ***
Total pot $1 | Rake $0 
Seat 1: nnne409 (button) folded before Flop (didn't bet)
Seat 2: tipner (small blind) folded before Flop
Seat 3: masaytoo (big blind) collected ($1)
Seat 4: Sweden_Pound folded before Flop (didn't bet)
Seat 5: matiko09 folded before Flop (didn't bet)
Seat 6: RUS)Timur folded before Flop (didn't bet)
Seat 7: sylvian31 folded before Flop (didn't bet)
Seat 8: Venomous100% folded before Flop (didn't bet)
Seat 9: di0d80 folded before Flop (didn't bet)





PokerStars Hand #147753706687:  Hold'em No Limit ($0.50/$1.00 USD) - 2016/01/27 11:21:08 CET [2016/01/27 5:21:08 ET]
Table 'Impala' 9-max Seat #6 is the button
Seat 1: Saintreine ($237.97 in chips) 
Seat 3: Peu3aHy ($100 in chips) 
Seat 4: matiko09 ($104.50 in chips) 
Seat 5: er13to ($136.09 in chips) 
Seat 6: deepblue0000 ($100 in chips) 
Seat 7: RUS)Timur ($102.73 in chips) 
Seat 8: UShallGimme$ ($103.42 in chips) 
RUS)Timur: posts small blind $0.50
UShallGimme$: posts big blind $1
Reven9er: sits out 
AlKatrone: sits out 
*** HOLE CARDS ***
Dealt to matiko09 [Ah 9c]
Saintreine: folds 
Peu3aHy: folds 
matiko09: folds 
er13to: folds 
deepblue0000: folds 
RUS)Timur: calls $0.50
UShallGimme$: raises $3 to $4
RUS)Timur: folds 
Uncalled bet ($3) returned to UShallGimme$
UShallGimme$ collected $2 from pot
UShallGimme$: doesn't show hand 
*** SUMMARY ***
Total pot $2 | Rake $0 
Seat 1: Saintreine folded before Flop (didn't bet)
Seat 3: Peu3aHy folded before Flop (didn't bet)
Seat 4: matiko09 folded before Flop (didn't bet)
Seat 5: er13to folded before Flop (didn't bet)
Seat 6: deepblue0000 (button) folded before Flop (didn't bet)
Seat 7: RUS)Timur (small blind) folded before Flop
Seat 8: UShallGimme$ (big blind) collected ($2)





PokerStars Hand #147753711838:  Hold'em No Limit ($0.50/$1.00 USD) - 2016/01/27 11:21:19 CET [2016/01/27 5:21:19 ET]
Table 'Galilea' 9-max Seat #4 is the button
Seat 1: pandalapa ($100 in chips) 
Seat 2: RUS)Timur ($102.71 in chips) 
Seat 3: Peu3aHy ($202.70 in chips) 
Seat 4: Sweden_Pound ($117.29 in chips) 
Seat 5: Saintreine ($118.62 in chips) 
Seat 6: UShallGimme$ ($135.34 in chips) 
Seat 7: mycka86 ($100 in chips) 
Seat 8: deepblue0000 ($222.93 in chips) 
Seat 9: matiko09 ($100 in chips) 
Saintreine: posts small blind $0.50
UShallGimme$: posts big blind $1
*** HOLE CARDS ***
Dealt to matiko09 [4d Ad]
mycka86: folds 
deepblue0000: folds 
matiko09: folds 
pandalapa: folds 
RUS)Timur: raises $1.45 to $2.45
Peu3aHy: calls $2.45
Sweden_Pound: folds 
Saintreine: calls $1.95
UShallGimme$: raises $10.55 to $13
RUS)Timur: folds 
Peu3aHy: folds 
Saintreine: folds 
Uncalled bet ($10.55) returned to UShallGimme$
UShallGimme$ collected $9.80 from pot
UShallGimme$: doesn't show hand 
*** SUMMARY ***
Total pot $9.80 | Rake $0 
Seat 1: pandalapa folded before Flop (didn't bet)
Seat 2: RUS)Timur folded before Flop
Seat 3: Peu3aHy folded before Flop
Seat 4: Sweden_Pound (button) folded before Flop (didn't bet)
Seat 5: Saintreine (small blind) folded before Flop
Seat 6: UShallGimme$ (big blind) collected ($9.80)
Seat 7: mycka86 folded before Flop (didn't bet)
Seat 8: deepblue0000 folded before Flop (didn't bet)
Seat 9: matiko09 folded before Flop (didn't bet)





PokerStars Hand #147753717937:  Hold'em No Limit ($0.50/$1.00 USD) - 2016/01/27 11:21:31 CET [2016/01/27 5:21:31 ET]
Table 'Malzovia' 9-max Seat #4 is the button
Seat 1: mycka86 ($103.89 in chips) 
Seat 4: AlKatrone ($100 in chips) 
Seat 5: matiko09 ($106.57 in chips) 
Seat 6: deepblue0000 ($300.02 in chips) 
Seat 7: Peu3aHy ($154.56 in chips) 
Seat 8: Sweden_Pound ($114.62 in chips) 
Seat 9: UShallGimme$ ($117.82 in chips) 
matiko09: posts small blind $0.50
deepblue0000: posts big blind $1
*** HOLE CARDS ***
Dealt to matiko09 [7d 5h]
Peu3aHy: folds 
Sweden_Pound: folds 
UShallGimme$: folds 
mycka86: folds 
AlKatrone: folds 
matiko09: folds 
Uncalled bet ($0.50) returned to deepblue0000
deepblue0000 collected $1 from pot
*** SUMMARY ***
Total pot $1 | Rake $0 
Seat 1: mycka86 folded before Flop (didn't bet)
Seat 4: AlKatrone (button) folded before Flop (didn't bet)
Seat 5: matiko09 (small blind) folded before Flop
Seat 6: deepblue0000 (big blind) collected ($1)
Seat 7: Peu3aHy folded before Flop (didn't bet)
Seat 8: Sweden_Pound folded before Flop (didn't bet)
Seat 9: UShallGimme$ folded before Flop (didn't bet)





PokerStars Hand #147753720699:  Hold'em No Limit ($0.50/$1.00 USD) - 2016/01/27 11:21:37 CET [2016/01/27 5:21:37 ET]
Table 'Alkmene II' 9-max Seat #9 is the button
Seat 1: matiko09 ($100 in chips) 
Seat 2: deepblue0000 ($100 in chips) 
Seat 3: MuSaShiBuShi ($47.23 in chips) 
Seat 4: CoolFireX ($142.84 in chips) 
Seat 5: Sweden_Pound ($128.57 in chips) 
Seat 6: Peu3aHy ($100 in chips) 
Seat 7: mycka86 ($101.50 in chips) 
Seat 8: fecsok1 ($81.05 in chips) 
Seat 9: pandalapa ($100 in chips) 
matiko09: posts small blind $0.50
deepblue0000: posts big blind $1
*** HOLE CARDS ***
Dealt to matiko09 [Ad 7d]
MuSaShiBuShi: folds 
CoolFireX: folds 
Sweden_Pound: folds 
Peu3aHy: folds 
mycka86: folds 
fecsok1: folds 
pandalapa: folds 
matiko09: raises $1.50 to $2.50
deepblue0000: calls $1.50
*** FLOP *** [6h Kc Qs]
matiko09: checks 
deepblue0000: bets $3.18
matiko09: folds 
Uncalled bet ($3.18) returned to deepblue0000
deepblue0000 collected $4.78 from pot
*** SUMMARY ***
Total pot $5 | Rake $0.22 
Board [6h Kc Qs]
Seat 1: matiko09 (small blind) folded on the Flop
Seat 2: deepblue0000 (big blind) collected ($4.78)
Seat 3: MuSaShiBuShi folded before Flop (didn't bet)
Seat 4: CoolFireX folded before Flop (didn't bet)
Seat 5: Sweden_Pound folded before Flop (didn't bet)
Seat 6: Peu3aHy folded before Flop (didn't bet)
Seat 7: mycka86 folded before Flop (didn't bet)
Seat 8: fecsok1 folded before Flop (didn't bet)
Seat 9: pandalapa (button) folded before Flop (didn't bet)





PokerStars Hand #147753721532:  Hold'em No Limit ($0.50/$1.00 USD) - 2016/01/27 11:21:39 CET [2016/01/27 5:21:39 ET]
Table 'Siegena III' 9-max Seat #2 is the button
Seat 1: nnne409 ($78.50 in chips) 
Seat 2: tipner ($100 in chips) 
Seat 3: masaytoo ($99.50 in chips) 
Seat 4: Sweden_Pound ($100 in chips) 
Seat 5: matiko09 ($102.50 in chips) 
Seat 6: RUS)Timur ($101.50 in chips) 
Seat 7: sylvian31 ($100 in chips) 
Seat 8: Venomous100% ($100 in chips) 
Seat 9: di0d80 ($101 in chips) 
masaytoo: posts small blind $0.50
Sweden_Pound: posts big blind $1
*** HOLE CARDS ***
Dealt to matiko09 [8d Jc]
matiko09: folds 
RUS)Timur: raises $1.45 to $2.45
sylvian31: folds 
Venomous100%: folds 
di0d80: folds 
nnne409: folds 
tipner: folds 
masaytoo: calls $1.95
Sweden_Pound: folds 
*** FLOP *** [Kd 3s 5h]
masaytoo: checks 
RUS)Timur: bets $1.80
masaytoo: calls $1.80
*** TURN *** [Kd 3s 5h] [5c]
masaytoo: checks 
RUS)Timur: checks 
*** RIVER *** [Kd 3s 5h 5c] [Jd]
masaytoo: checks 
RUS)Timur: checks 
*** SHOW DOWN ***
masaytoo: shows [4d 4s] (two pair, Fives and Fours)
RUS)Timur: shows [9d 9c] (two pair, Nines and Fives)
RUS)Timur collected $9.07 from pot
*** SUMMARY ***
Total pot $9.50 | Rake $0.43 
Board [Kd 3s 5h 5c Jd]
Seat 1: nnne409 folded before Flop (didn't bet)
Seat 2: tipner (button) folded before Flop (didn't bet)
Seat 3: masaytoo (small blind) showed [4d 4s] and lost with two pair, Fives and Fours
Seat 4: Sweden_Pound (big blind) folded before Flop
Seat 5: matiko09 folded before Flop (didn't bet)
Seat 6: RUS)Timur showed [9d 9c] and won ($9.07) with two pair, Nines and Fives
Seat 7: sylvian31 folded before Flop (didn't bet)
Seat 8: Venomous100% folded before Flop (didn't bet)
Seat 9: di0d80 folded before Flop (didn't bet)





PokerStars Hand #147753722713:  Hold'em No Limit ($0.50/$1.00 USD) - 2016/01/27 11:21:41 CET [2016/01/27 5:21:41 ET]
Table 'Eudora III' 9-max Seat #8 is the button
Seat 1: Eberhard314 ($105.71 in chips) 
Seat 2: Pablo1337 ($104.16 in chips) 
Seat 3: matiko09 ($100 in chips) 
Seat 4: Reven9er ($104.50 in chips) 
Seat 5: di0d80 ($100 in chips) 
Seat 6: DIMAZAYAC ($49.57 in chips) 
Seat 7: Sweden_Pound ($101.50 in chips) 
Seat 8: RUS)Timur ($100 in chips) 
Seat 9: Venomous100% ($100 in chips) 
Venomous100%: posts small blind $0.50
Eberhard314: posts big blind $1
*** HOLE CARDS ***
Dealt to matiko09 [Jd Kc]
Pablo1337: folds 
matiko09: folds 
Reven9er: folds 
di0d80: raises $1.50 to $2.50
DIMAZAYAC: calls $2.50
Sweden_Pound: folds 
RUS)Timur: folds 
Venomous100%: folds 
Eberhard314: folds 
*** FLOP *** [Td 7c 6h]
di0d80: bets $5
DIMAZAYAC: calls $5
*** TURN *** [Td 7c 6h] [Ah]
di0d80: bets $10
DIMAZAYAC: calls $10
*** RIVER *** [Td 7c 6h Ah] [4c]
di0d80: bets $33
DIMAZAYAC: folds 
Uncalled bet ($33) returned to di0d80
di0d80 collected $34.86 from pot
di0d80: doesn't show hand 
*** SUMMARY ***
Total pot $36.50 | Rake $1.64 
Board [Td 7c 6h Ah 4c]
Seat 1: Eberhard314 (big blind) folded before Flop
Seat 2: Pablo1337 folded before Flop (didn't bet)
Seat 3: matiko09 folded before Flop (didn't bet)
Seat 4: Reven9er folded before Flop (didn't bet)
Seat 5: di0d80 collected ($34.86)
Seat 6: DIMAZAYAC folded on the River
Seat 7: Sweden_Pound folded before Flop (didn't bet)
Seat 8: RUS)Timur (button) folded before Flop (didn't bet)
Seat 9: Venomous100% (small blind) folded before Flop





PokerStars Hand #147753728437:  Hold'em No Limit ($0.50/$1.00 USD) - 2016/01/27 11:21:53 CET [2016/01/27 5:21:53 ET]
Table 'Impala' 9-max Seat #7 is the button
Seat 1: Saintreine ($237.97 in chips) 
Seat 3: Peu3aHy ($100 in chips) 
Seat 4: matiko09 ($104.50 in chips) 
Seat 5: er13to ($136.09 in chips) 
Seat 6: deepblue0000 ($100 in chips) 
Seat 7: RUS)Timur ($101.73 in chips) 
Seat 8: UShallGimme$ ($104.42 in chips) 
Seat 9: Reven9er ($100 in chips) 
UShallGimme$: posts small blind $0.50
Reven9er: posts big blind $1
AlKatrone: sits out 
*** HOLE CARDS ***
Dealt to matiko09 [Qh Kd]
Saintreine: folds 
Peu3aHy: folds 
matiko09: raises $2 to $3
er13to: folds 
deepblue0000: folds 
RUS)Timur: folds 
UShallGimme$: folds 
Reven9er: folds 
Uncalled bet ($2) returned to matiko09
matiko09 collected $2.50 from pot
matiko09: doesn't show hand 
*** SUMMARY ***
Total pot $2.50 | Rake $0 
Seat 1: Saintreine folded before Flop (didn't bet)
Seat 3: Peu3aHy folded before Flop (didn't bet)
Seat 4: matiko09 collected ($2.50)
Seat 5: er13to folded before Flop (didn't bet)
Seat 6: deepblue0000 folded before Flop (didn't bet)
Seat 7: RUS)Timur (button) folded before Flop (didn't bet)
Seat 8: UShallGimme$ (small blind) folded before Flop
Seat 9: Reven9er (big blind) folded before Flop





PokerStars Hand #147753729795:  Hold'em No Limit ($0.50/$1.00 USD) - 2016/01/27 11:21:56 CET [2016/01/27 5:21:56 ET]
Table 'Palisana III' 9-max Seat #1 is the button
Seat 1: Largie1994 ($43.37 in chips) 
Seat 2: tipner ($100 in chips) 
Seat 3: Kukuryzka ($102.50 in chips) 
Seat 4: Reven9er ($100 in chips) 
Seat 5: di0d80 ($103 in chips) 
Seat 6: matiko09 ($104.73 in chips) 
Seat 7: Sweden_Pound ($100 in chips) 
Seat 8: COOLIKO\/23 ($100 in chips) 
tipner: posts small blind $0.50
Kukuryzka: posts big blind $1
*** HOLE CARDS ***
Dealt to matiko09 [Ac Jh]
Reven9er: raises $1 to $2
di0d80: folds 
matiko09: folds 
Sweden_Pound: folds 
COOLIKO\/23: folds 
Largie1994: raises $1 to $3
tipner: folds 
Kukuryzka: folds 
Reven9er: calls $1
*** FLOP *** [4s 8h 8s]
Reven9er: checks 
Largie1994: bets $3.50
Reven9er: calls $3.50
*** TURN *** [4s 8h 8s] [Th]
Reven9er: checks 
Largie1994: bets $5.80
Reven9er: folds 
Uncalled bet ($5.80) returned to Largie1994
Largie1994 collected $13.85 from pot
Largie1994: doesn't show hand 
*** SUMMARY ***
Total pot $14.50 | Rake $0.65 
Board [4s 8h 8s Th]
Seat 1: Largie1994 (button) collected ($13.85)
Seat 2: tipner (small blind) folded before Flop
Seat 3: Kukuryzka (big blind) folded before Flop
Seat 4: Reven9er folded on the Turn
Seat 5: di0d80 folded before Flop (didn't bet)
Seat 6: matiko09 folded before Flop (didn't bet)
Seat 7: Sweden_Pound folded before Flop (didn't bet)
Seat 8: COOLIKO\/23 folded before Flop (didn't bet)





PokerStars Hand #147753732810:  Hold'em No Limit ($0.50/$1.00 USD) - 2016/01/27 11:22:02 CET [2016/01/27 5:22:02 ET]
Table 'Malzovia' 9-max Seat #5 is the button
Seat 1: mycka86 ($103.89 in chips) 
Seat 4: AlKatrone ($100 in chips) 
Seat 5: matiko09 ($106.07 in chips) 
Seat 6: deepblue0000 ($300.52 in chips) 
Seat 7: Peu3aHy ($154.56 in chips) 
Seat 8: Sweden_Pound ($114.62 in chips) 
Seat 9: UShallGimme$ ($117.82 in chips) 
deepblue0000: posts small blind $0.50
Peu3aHy: posts big blind $1
*** HOLE CARDS ***
Dealt to matiko09 [Jd 6h]
Sweden_Pound: folds 
UShallGimme$: folds 
mycka86: raises $1.50 to $2.50
AlKatrone: folds 
matiko09: folds 
deepblue0000: calls $2
Peu3aHy: folds 
*** FLOP *** [Th 7h 2d]
deepblue0000: checks 
mycka86: bets $3.50
deepblue0000: calls $3.50
*** TURN *** [Th 7h 2d] [2c]
deepblue0000: checks 
Reven9er joins the table at seat #3 
mycka86: checks 
*** RIVER *** [Th 7h 2d 2c] [7d]
deepblue0000: bets $6.21
mycka86: folds 
Uncalled bet ($6.21) returned to deepblue0000
deepblue0000 collected $12.42 from pot
*** SUMMARY ***
Total pot $13 | Rake $0.58 
Board [Th 7h 2d 2c 7d]
Seat 1: mycka86 folded on the River
Seat 4: AlKatrone folded before Flop (didn't bet)
Seat 5: matiko09 (button) folded before Flop (didn't bet)
Seat 6: deepblue0000 (small blind) collected ($12.42)
Seat 7: Peu3aHy (big blind) folded before Flop
Seat 8: Sweden_Pound folded before Flop (didn't bet)
Seat 9: UShallGimme$ folded before Flop (didn't bet)





PokerStars Hand #147753734998:  Hold'em No Limit ($0.50/$1.00 USD) - 2016/01/27 11:22:06 CET [2016/01/27 5:22:06 ET]
Table 'Pythia II' 9-max Seat #9 is the button
Seat 3: Sweden_Pound ($100 in chips) 
Seat 4: matiko09 ($100 in chips) 
Seat 6: RoadtoNepal ($210.01 in chips) 
Seat 7: deepblue0000 ($104.53 in chips) 
Seat 8: Peu3aHy ($101.50 in chips) 
Seat 9: CoolFireX ($113.12 in chips) 
Sweden_Pound: posts small blind $0.50
matiko09: posts big blind $1
*** HOLE CARDS ***
Dealt to matiko09 [Qd Ad]
RoadtoNepal: folds 
deepblue0000: folds 
Peu3aHy: folds 
CoolFireX: raises $1.50 to $2.50
Sweden_Pound: folds 
matiko09: raises $6.50 to $9
CoolFireX: folds 
Uncalled bet ($6.50) returned to matiko09
matiko09 collected $5.50 from pot
matiko09: doesn't show hand 
*** SUMMARY ***
Total pot $5.50 | Rake $0 
Seat 3: Sweden_Pound (small blind) folded before Flop
Seat 4: matiko09 (big blind) collected ($5.50)
Seat 6: RoadtoNepal folded before Flop (didn't bet)
Seat 7: deepblue0000 folded before Flop (didn't bet)
Seat 8: Peu3aHy folded before Flop (didn't bet)
Seat 9: CoolFireX (button) folded before Flop





PokerStars Hand #147753737558:  Hold'em No Limit ($0.50/$1.00 USD) - 2016/01/27 11:22:11 CET [2016/01/27 5:22:11 ET]
Table 'Henyey' 9-max Seat #3 is the button
Seat 1: BurnsyT ($115.22 in chips) 
Seat 2: pandalapa ($100 in chips) 
Seat 3: deepblue0000 ($100 in chips) 
Seat 4: sylvian31 ($100 in chips) 
Seat 5: matiko09 ($100 in chips) 
Seat 6: Venomous100% ($103.71 in chips) 
Seat 7: Sweden_Pound ($115.18 in chips) 
Seat 8: CoolFireX ($118.10 in chips) 
Seat 9: mycka86 ($132.38 in chips) 
sylvian31: posts small blind $0.50
matiko09: posts big blind $1
*** HOLE CARDS ***
Dealt to matiko09 [Ad Jh]
Venomous100%: folds 
Venomous100% leaves the table
di0d80 joins the table at seat #6 
Sweden_Pound: raises $2 to $3
CoolFireX: calls $3
mycka86: folds 
BurnsyT: folds 
pandalapa: folds 
deepblue0000: calls $3
sylvian31: folds 
matiko09: raises $12 to $15
Sweden_Pound: folds 
CoolFireX: folds 
deepblue0000: folds 
Uncalled bet ($12) returned to matiko09
matiko09 collected $12.50 from pot
matiko09: doesn't show hand 
*** SUMMARY ***
Total pot $12.50 | Rake $0 
Seat 1: BurnsyT folded before Flop (didn't bet)
Seat 2: pandalapa folded before Flop (didn't bet)
Seat 3: deepblue0000 (button) folded before Flop
Seat 4: sylvian31 (small blind) folded before Flop
Seat 5: matiko09 (big blind) collected ($12.50)
Seat 6: Venomous100% folded before Flop (didn't bet)
Seat 7: Sweden_Pound folded before Flop
Seat 8: CoolFireX folded before Flop
Seat 9: mycka86 folded before Flop (didn't bet)





PokerStars Hand #147753737555:  Hold'em No Limit ($0.50/$1.00 USD) - 2016/01/27 11:22:11 CET [2016/01/27 5:22:11 ET]
Table 'Galilea' 9-max Seat #5 is the button
Seat 1: pandalapa ($100 in chips) 
Seat 2: RUS)Timur ($100.26 in chips) 
Seat 3: Peu3aHy ($200.25 in chips) 
Seat 4: Sweden_Pound ($117.29 in chips) 
Seat 5: Saintreine ($116.17 in chips) 
Seat 6: UShallGimme$ ($142.69 in chips) 
Seat 7: mycka86 ($100 in chips) 
Seat 8: deepblue0000 ($222.93 in chips) 
Seat 9: matiko09 ($100 in chips) 
UShallGimme$: posts small blind $0.50
mycka86: posts big blind $1
*** HOLE CARDS ***
Dealt to matiko09 [Ah Ks]
deepblue0000: folds 
matiko09: raises $2 to $3
pandalapa: folds 
RUS)Timur: folds 
Peu3aHy: folds 
Sweden_Pound: folds 
Saintreine: folds 
UShallGimme$: folds 
mycka86: folds 
Uncalled bet ($2) returned to matiko09
matiko09 collected $2.50 from pot
matiko09: doesn't show hand 
*** SUMMARY ***
Total pot $2.50 | Rake $0 
Seat 1: pandalapa folded before Flop (didn't bet)
Seat 2: RUS)Timur folded before Flop (didn't bet)
Seat 3: Peu3aHy folded before Flop (didn't bet)
Seat 4: Sweden_Pound folded before Flop (didn't bet)
Seat 5: Saintreine (button) folded before Flop (didn't bet)
Seat 6: UShallGimme$ (small blind) folded before Flop
Seat 7: mycka86 (big blind) folded before Flop
Seat 8: deepblue0000 folded before Flop (didn't bet)
Seat 9: matiko09 collected ($2.50)





PokerStars Hand #147753739517:  Hold'em No Limit ($0.50/$1.00 USD) - 2016/01/27 11:22:15 CET [2016/01/27 5:22:15 ET]
Table 'Alkmene II' 9-max Seat #1 is the button
Seat 1: matiko09 ($100 in chips) 
Seat 2: deepblue0000 ($102.28 in chips) 
Seat 3: MuSaShiBuShi ($47.23 in chips) 
Seat 4: CoolFireX ($142.84 in chips) 
Seat 5: Sweden_Pound ($128.57 in chips) 
Seat 6: Peu3aHy ($100 in chips) 
Seat 7: mycka86 ($101.50 in chips) 
Seat 8: fecsok1 ($81.05 in chips) 
Seat 9: pandalapa ($100 in chips) 
deepblue0000: posts small blind $0.50
MuSaShiBuShi: posts big blind $1
*** HOLE CARDS ***
Dealt to matiko09 [5c 9c]
CoolFireX: folds 
Sweden_Pound: folds 
Peu3aHy: folds 
mycka86: folds 
fecsok1: folds 
pandalapa: folds 
matiko09: folds 
deepblue0000: raises $2 to $3
MuSaShiBuShi: folds 
Uncalled bet ($2) returned to deepblue0000
deepblue0000 collected $2 from pot
*** SUMMARY ***
Total pot $2 | Rake $0 
Seat 1: matiko09 (button) folded before Flop (didn't bet)
Seat 2: deepblue0000 (small blind) collected ($2)
Seat 3: MuSaShiBuShi (big blind) folded before Flop
Seat 4: CoolFireX folded before Flop (didn't bet)
Seat 5: Sweden_Pound folded before Flop (didn't bet)
Seat 6: Peu3aHy folded before Flop (didn't bet)
Seat 7: mycka86 folded before Flop (didn't bet)
Seat 8: fecsok1 folded before Flop (didn't bet)
Seat 9: pandalapa folded before Flop (didn't bet)





PokerStars Hand #147753740422:  Hold'em No Limit ($0.50/$1.00 USD) - 2016/01/27 11:22:17 CET [2016/01/27 5:22:17 ET]
Table 'Impala' 9-max Seat #8 is the button
Seat 1: Saintreine ($237.97 in chips) 
Seat 3: Peu3aHy ($100 in chips) 
Seat 4: matiko09 ($106 in chips) 
Seat 5: er13to ($136.09 in chips) 
Seat 6: deepblue0000 ($100 in chips) 
Seat 7: RUS)Timur ($101.73 in chips) 
Seat 8: UShallGimme$ ($103.92 in chips) 
Seat 9: Reven9er ($100 in chips) 
Reven9er: posts small blind $0.50
Saintreine: posts big blind $1
AlKatrone: sits out 
*** HOLE CARDS ***
Dealt to matiko09 [2d Qc]
Peu3aHy: folds 
matiko09: folds 
er13to: folds 
deepblue0000: folds 
RUS)Timur: folds 
UShallGimme$: raises $1 to $2
Reven9er: folds 
Saintreine: folds 
Uncalled bet ($1) returned to UShallGimme$
UShallGimme$ collected $2.50 from pot
UShallGimme$: doesn't show hand 
*** SUMMARY ***
Total pot $2.50 | Rake $0 
Seat 1: Saintreine (big blind) folded before Flop
Seat 3: Peu3aHy folded before Flop (didn't bet)
Seat 4: matiko09 folded before Flop (didn't bet)
Seat 5: er13to folded before Flop (didn't bet)
Seat 6: deepblue0000 folded before Flop (didn't bet)
Seat 7: RUS)Timur folded before Flop (didn't bet)
Seat 8: UShallGimme$ (button) collected ($2.50)
Seat 9: Reven9er (small blind) folded before Flop





PokerStars Hand #147753744720:  Hold'em No Limit ($0.50/$1.00 USD) - 2016/01/27 11:22:26 CET [2016/01/27 5:22:26 ET]
Table 'Helene III' 9-max Seat #2 is the button
Seat 1: UShallGimme$ ($100 in chips) 
Seat 2: Reven9er ($170.70 in chips) 
Seat 4: Sweden_Pound ($195.70 in chips) 
Seat 5: XMesuraX ($200.11 in chips) 
Seat 6: matiko09 ($111.82 in chips) 
Seat 8: deepblue0000 ($101.50 in chips) 
Seat 9: Peu3aHy ($100 in chips) 
tipner will be allowed to play after the button
Sweden_Pound: posts small blind $0.50
XMesuraX: posts big blind $1
di0d80: sits out 
*** HOLE CARDS ***
Dealt to matiko09 [Kh 4d]
matiko09: folds 
deepblue0000: folds 
Peu3aHy: folds 
UShallGimme$: raises $1.50 to $2.50
Reven9er: folds 
Sweden_Pound: folds 
XMesuraX: folds 
Uncalled bet ($1.50) returned to UShallGimme$
UShallGimme$ collected $2.50 from pot
UShallGimme$: doesn't show hand 
*** SUMMARY ***
Total pot $2.50 | Rake $0 
Seat 1: UShallGimme$ collected ($2.50)
Seat 2: Reven9er (button) folded before Flop (didn't bet)
Seat 4: Sweden_Pound (small blind) folded before Flop
Seat 5: XMesuraX (big blind) folded before Flop
Seat 6: matiko09 folded before Flop (didn't bet)
Seat 8: deepblue0000 folded before Flop (didn't bet)
Seat 9: Peu3aHy folded before Flop (didn't bet)





PokerStars Hand #147753747891:  Hold'em No Limit ($0.50/$1.00 USD) - 2016/01/27 11:22:33 CET [2016/01/27 5:22:33 ET]
Table 'Delphinus II' 9-max Seat #2 is the button
Seat 1: Saintreine ($148.91 in chips) 
Seat 2: AlKatrone ($107.94 in chips) 
Seat 3: deepblue0000 ($326.52 in chips) 
Seat 4: matiko09 ($100 in chips) 
Seat 5: pandalapa ($102.50 in chips) 
Seat 6: Pablo1337 ($100 in chips) 
Seat 7: er13to ($120.13 in chips) 
Seat 8: mycka86 ($100 in chips) 
Seat 9: FGL-lucky ($48.50 in chips) 
deepblue0000: posts small blind $0.50
matiko09: posts big blind $1
*** HOLE CARDS ***
Dealt to matiko09 [6d 3d]
pandalapa: folds 
Pablo1337: folds 
er13to: raises $1.50 to $2.50
mycka86: folds 
FGL-lucky: calls $2.50
Saintreine: folds 
AlKatrone: folds 
deepblue0000: folds 
matiko09: folds 
*** FLOP *** [As 7h 9h]
er13to: checks 
FGL-lucky: checks 
*** TURN *** [As 7h 9h] [Qh]
er13to: bets $4.04
FGL-lucky: raises $4.04 to $8.08
er13to: folds 
Uncalled bet ($4.04) returned to FGL-lucky
FGL-lucky collected $13.92 from pot
FGL-lucky: doesn't show hand 
*** SUMMARY ***
Total pot $14.58 | Rake $0.66 
Board [As 7h 9h Qh]
Seat 1: Saintreine folded before Flop (didn't bet)
Seat 2: AlKatrone (button) folded before Flop (didn't bet)
Seat 3: deepblue0000 (small blind) folded before Flop
Seat 4: matiko09 (big blind) folded before Flop
Seat 5: pandalapa folded before Flop (didn't bet)
Seat 6: Pablo1337 folded before Flop (didn't bet)
Seat 7: er13to folded on the Turn
Seat 8: mycka86 folded before Flop (didn't bet)
Seat 9: FGL-lucky collected ($13.92)





PokerStars Hand #147753754830:  Hold'em No Limit ($0.50/$1.00 USD) - 2016/01/27 11:22:47 CET [2016/01/27 5:22:47 ET]
Table 'Pythia II' 9-max Seat #3 is the button
Seat 3: Sweden_Pound ($100 in chips) 
Seat 4: matiko09 ($103 in chips) 
Seat 6: RoadtoNepal ($210.01 in chips) 
Seat 7: deepblue0000 ($104.53 in chips) 
Seat 8: Peu3aHy ($101.50 in chips) 
Seat 9: CoolFireX ($110.62 in chips) 
matiko09: posts small blind $0.50
RoadtoNepal: posts big blind $1
*** HOLE CARDS ***
Dealt to matiko09 [Jh Ac]
deepblue0000: folds 
Peu3aHy: raises $2 to $3
CoolFireX: folds 
Sweden_Pound: folds 
matiko09: raises $7 to $10
RoadtoNepal: folds 
Peu3aHy: folds 
Uncalled bet ($7) returned to matiko09
matiko09 collected $7 from pot
matiko09: doesn't show hand 
*** SUMMARY ***
Total pot $7 | Rake $0 
Seat 3: Sweden_Pound (button) folded before Flop (didn't bet)
Seat 4: matiko09 (small blind) collected ($7)
Seat 6: RoadtoNepal (big blind) folded before Flop
Seat 7: deepblue0000 folded before Flop (didn't bet)
Seat 8: Peu3aHy folded before Flop
Seat 9: CoolFireX folded before Flop (didn't bet)





PokerStars Hand #147753755502:  Hold'em No Limit ($0.50/$1.00 USD) - 2016/01/27 11:22:48 CET [2016/01/27 5:22:48 ET]
Table 'Galilea' 9-max Seat #6 is the button
Seat 1: pandalapa ($100 in chips) 
Seat 2: RUS)Timur ($100.26 in chips) 
Seat 3: Peu3aHy ($200.25 in chips) 
Seat 4: Sweden_Pound ($117.29 in chips) 
Seat 5: Saintreine ($116.17 in chips) 
Seat 6: UShallGimme$ ($142.19 in chips) 
Seat 7: mycka86 ($100 in chips) 
Seat 8: deepblue0000 ($222.93 in chips) 
Seat 9: matiko09 ($101.50 in chips) 
mycka86: posts small blind $0.50
deepblue0000: posts big blind $1
*** HOLE CARDS ***
Dealt to matiko09 [Jc Kh]
matiko09: folds 
pandalapa: folds 
RUS)Timur: folds 
Peu3aHy: raises $2 to $3
Sweden_Pound: calls $3
Saintreine: folds 
UShallGimme$: raises $7 to $10
mycka86: folds 
deepblue0000: folds 
Peu3aHy: folds 
Sweden_Pound: folds 
Uncalled bet ($7) returned to UShallGimme$
UShallGimme$ collected $10.50 from pot
UShallGimme$: doesn't show hand 
*** SUMMARY ***
Total pot $10.50 | Rake $0 
Seat 1: pandalapa folded before Flop (didn't bet)
Seat 2: RUS)Timur folded before Flop (didn't bet)
Seat 3: Peu3aHy folded before Flop
Seat 4: Sweden_Pound folded before Flop
Seat 5: Saintreine folded before Flop (didn't bet)
Seat 6: UShallGimme$ (button) collected ($10.50)
Seat 7: mycka86 (small blind) folded before Flop
Seat 8: deepblue0000 (big blind) folded before Flop
Seat 9: matiko09 folded before Flop (didn't bet)





PokerStars Hand #147753759329:  Hold'em No Limit ($0.50/$1.00 USD) - 2016/01/27 11:22:56 CET [2016/01/27 5:22:56 ET]
Table 'Siegena III' 9-max Seat #3 is the button
Seat 1: nnne409 ($78.50 in chips) 
Seat 2: tipner ($100 in chips) 
Seat 3: masaytoo ($95.25 in chips) 
Seat 4: Sweden_Pound ($100 in chips) 
Seat 5: matiko09 ($102.50 in chips) 
Seat 6: RUS)Timur ($106.32 in chips) 
Seat 7: sylvian31 ($100 in chips) 
Seat 8: Venomous100% ($100 in chips) 
Seat 9: di0d80 ($101 in chips) 
Sweden_Pound: posts small blind $0.50
matiko09: posts big blind $1
*** HOLE CARDS ***
Dealt to matiko09 [2c 4c]
RUS)Timur: folds 
sylvian31: folds 
Venomous100%: folds 
di0d80: folds 
nnne409: raises $1 to $2
tipner: folds 
masaytoo: calls $2
Sweden_Pound: calls $1.50
matiko09: folds 
*** FLOP *** [Qs Qd 3c]
Sweden_Pound: checks 
nnne409: bets $3.34
masaytoo: folds 
Sweden_Pound: raises $8.68 to $12.02
nnne409: folds 
Uncalled bet ($8.68) returned to Sweden_Pound
Sweden_Pound collected $13.06 from pot
Sweden_Pound: doesn't show hand 
*** SUMMARY ***
Total pot $13.68 | Rake $0.62 
Board [Qs Qd 3c]
Seat 1: nnne409 folded on the Flop
Seat 2: tipner folded before Flop (didn't bet)
Seat 3: masaytoo (button) folded on the Flop
Seat 4: Sweden_Pound (small blind) collected ($13.06)
Seat 5: matiko09 (big blind) folded before Flop
Seat 6: RUS)Timur folded before Flop (didn't bet)
Seat 7: sylvian31 folded before Flop (didn't bet)
Seat 8: Venomous100% folded before Flop (didn't bet)
Seat 9: di0d80 folded before Flop (didn't bet)





PokerStars Hand #147753759596:  Hold'em No Limit ($0.50/$1.00 USD) - 2016/01/27 11:22:57 CET [2016/01/27 5:22:57 ET]
Table 'Impala' 9-max Seat #9 is the button
Seat 1: Saintreine ($236.97 in chips) 
Seat 2: AlKatrone ($190.36 in chips) 
Seat 3: Peu3aHy ($100 in chips) 
Seat 4: matiko09 ($106 in chips) 
Seat 5: er13to ($136.09 in chips) 
Seat 6: deepblue0000 ($100 in chips) 
Seat 7: RUS)Timur ($101.73 in chips) 
Seat 8: UShallGimme$ ($105.42 in chips) 
Seat 9: Reven9er ($100 in chips) 
Saintreine: posts small blind $0.50
AlKatrone: posts big blind $1
*** HOLE CARDS ***
Dealt to matiko09 [8d Jh]
Peu3aHy: folds 
matiko09: folds 
er13to: folds 
deepblue0000: raises $2 to $3
RUS)Timur: folds 
UShallGimme$: calls $3
Reven9er: folds 
Saintreine: folds 
AlKatrone: folds 
*** FLOP *** [Kc 6s 3h]
deepblue0000: bets $4.77
UShallGimme$: calls $4.77
*** TURN *** [Kc 6s 3h] [Ac]
deepblue0000: bets $14
UShallGimme$: calls $14
*** RIVER *** [Kc 6s 3h Ac] [5c]
deepblue0000: bets $43.01
UShallGimme$: folds 
Uncalled bet ($43.01) returned to deepblue0000
deepblue0000 collected $43.01 from pot
*** SUMMARY ***
Total pot $45.04 | Rake $2.03 
Board [Kc 6s 3h Ac 5c]
Seat 1: Saintreine (small blind) folded before Flop
Seat 2: AlKatrone (big blind) folded before Flop
Seat 3: Peu3aHy folded before Flop (didn't bet)
Seat 4: matiko09 folded before Flop (didn't bet)
Seat 5: er13to folded before Flop (didn't bet)
Seat 6: deepblue0000 collected ($43.01)
Seat 7: RUS)Timur folded before Flop (didn't bet)
Seat 8: UShallGimme$ folded on the River
Seat 9: Reven9er (button) folded before Flop (didn't bet)





PokerStars Hand #147753760230:  Hold'em No Limit ($0.50/$1.00 USD) - 2016/01/27 11:22:58 CET [2016/01/27 5:22:58 ET]
Table 'Helene III' 9-max Seat #4 is the button
Seat 1: UShallGimme$ ($101.50 in chips) 
Seat 2: Reven9er ($170.70 in chips) 
Seat 4: Sweden_Pound ($195.20 in chips) 
Seat 5: XMesuraX ($199.11 in chips) 
Seat 6: matiko09 ($111.82 in chips) 
Seat 8: deepblue0000 ($101.50 in chips) 
Seat 9: Peu3aHy ($100 in chips) 
XMesuraX: posts small blind $0.50
matiko09: posts big blind $1
di0d80: sits out 
tipner: sits out 
*** HOLE CARDS ***
Dealt to matiko09 [Qh 5h]
deepblue0000: folds 
Peu3aHy: folds 
UShallGimme$: folds 
Reven9er: folds 
Sweden_Pound: folds 
XMesuraX: folds 
Uncalled bet ($0.50) returned to matiko09
matiko09 collected $1 from pot
matiko09: doesn't show hand 
*** SUMMARY ***
Total pot $1 | Rake $0 
Seat 1: UShallGimme$ folded before Flop (didn't bet)
Seat 2: Reven9er folded before Flop (didn't bet)
Seat 4: Sweden_Pound (button) folded before Flop (didn't bet)
Seat 5: XMesuraX (small blind) folded before Flop
Seat 6: matiko09 (big blind) collected ($1)
Seat 8: deepblue0000 folded before Flop (didn't bet)
Seat 9: Peu3aHy folded before Flop (didn't bet)





PokerStars Hand #147753767363:  Hold'em No Limit ($0.50/$1.00 USD) - 2016/01/27 11:23:13 CET [2016/01/27 5:23:13 ET]
Table 'Alkmene II' 9-max Seat #2 is the button
Seat 1: matiko09 ($100 in chips) 
Seat 2: deepblue0000 ($103.28 in chips) 
Seat 3: MuSaShiBuShi ($46.23 in chips) 
Seat 4: CoolFireX ($142.84 in chips) 
Seat 5: Sweden_Pound ($128.57 in chips) 
Seat 6: Peu3aHy ($100 in chips) 
Seat 7: mycka86 ($101.50 in chips) 
Seat 8: fecsok1 ($81.05 in chips) 
Seat 9: pandalapa ($100 in chips) 
MuSaShiBuShi: posts small blind $0.50
CoolFireX: posts big blind $1
*** HOLE CARDS ***
Dealt to matiko09 [Td Ac]
Sweden_Pound: raises $2 to $3
Peu3aHy: folds 
mycka86: calls $3
fecsok1: calls $3
pandalapa: folds 
matiko09: folds 
deepblue0000: folds 
MuSaShiBuShi: folds 
CoolFireX: folds 
*** FLOP *** [Kh 5c Kc]
Sweden_Pound: bets $6.52
mycka86: folds 
fecsok1: calls $6.52
*** TURN *** [Kh 5c Kc] [4c]
Sweden_Pound: checks 
fecsok1: bets $11
Sweden_Pound: folds 
Uncalled bet ($11) returned to fecsok1
fecsok1 collected $22.48 from pot
*** SUMMARY ***
Total pot $23.54 | Rake $1.06 
Board [Kh 5c Kc 4c]
Seat 1: matiko09 folded before Flop (didn't bet)
Seat 2: deepblue0000 (button) folded before Flop (didn't bet)
Seat 3: MuSaShiBuShi (small blind) folded before Flop
Seat 4: CoolFireX (big blind) folded before Flop
Seat 5: Sweden_Pound folded on the Turn
Seat 6: Peu3aHy folded before Flop (didn't bet)
Seat 7: mycka86 folded on the Flop
Seat 8: fecsok1 collected ($22.48)
Seat 9: pandalapa folded before Flop (didn't bet)





PokerStars Hand #147753770028:  Hold'em No Limit ($0.50/$1.00 USD) - 2016/01/27 11:23:18 CET [2016/01/27 5:23:18 ET]
Table 'Malzovia' 9-max Seat #6 is the button
Seat 1: mycka86 ($100 in chips) 
Seat 4: AlKatrone ($100 in chips) 
Seat 5: matiko09 ($106.07 in chips) 
Seat 6: deepblue0000 ($306.94 in chips) 
Seat 7: Peu3aHy ($153.56 in chips) 
Seat 9: UShallGimme$ ($117.82 in chips) 
Peu3aHy: posts small blind $0.50
Sweden_Pound: is sitting out 
UShallGimme$: posts big blind $1
Sweden_Pound leaves the table
Reven9er: sits out 
*** HOLE CARDS ***
Dealt to matiko09 [3h 3c]
mycka86: folds 
AlKatrone: folds 
matiko09: raises $1.50 to $2.50
deepblue0000: raises $6.50 to $9
Peu3aHy: folds 
UShallGimme$: folds 
matiko09: folds 
Uncalled bet ($6.50) returned to deepblue0000
deepblue0000 collected $6.50 from pot
*** SUMMARY ***
Total pot $6.50 | Rake $0 
Seat 1: mycka86 folded before Flop (didn't bet)
Seat 4: AlKatrone folded before Flop (didn't bet)
Seat 5: matiko09 folded before Flop
Seat 6: deepblue0000 (button) collected ($6.50)
Seat 7: Peu3aHy (small blind) folded before Flop
Seat 9: UShallGimme$ (big blind) folded before Flop





PokerStars Hand #147753770881:  Hold'em No Limit ($0.50/$1.00 USD) - 2016/01/27 11:23:20 CET [2016/01/27 5:23:20 ET]
Table 'Helene III' 9-max Seat #5 is the button
Seat 1: UShallGimme$ ($101.50 in chips) 
Seat 2: Reven9er ($170.70 in chips) 
Seat 4: Sweden_Pound ($195.20 in chips) 
Seat 5: XMesuraX ($198.61 in chips) 
Seat 6: matiko09 ($112.32 in chips) 
Seat 7: di0d80 ($100 in chips) 
Seat 8: deepblue0000 ($101.50 in chips) 
Seat 9: Peu3aHy ($100 in chips) 
matiko09: posts small blind $0.50
di0d80: posts big blind $1
tipner: sits out 
*** HOLE CARDS ***
Dealt to matiko09 [Td 5d]
deepblue0000: folds 
Peu3aHy: folds 
UShallGimme$: folds 
Reven9er: folds 
Sweden_Pound: folds 
XMesuraX: folds 
matiko09: folds 
Uncalled bet ($0.50) returned to di0d80
di0d80 collected $1 from pot
di0d80: doesn't show hand 
*** SUMMARY ***
Total pot $1 | Rake $0 
Seat 1: UShallGimme$ folded before Flop (didn't bet)
Seat 2: Reven9er folded before Flop (didn't bet)
Seat 4: Sweden_Pound folded before Flop (didn't bet)
Seat 5: XMesuraX (button) folded before Flop (didn't bet)
Seat 6: matiko09 (small blind) folded before Flop
Seat 7: di0d80 (big blind) collected ($1)
Seat 8: deepblue0000 folded before Flop (didn't bet)
Seat 9: Peu3aHy folded before Flop (didn't bet)





PokerStars Hand #147753773030:  Hold'em No Limit ($0.50/$1.00 USD) - 2016/01/27 11:23:24 CET [2016/01/27 5:23:24 ET]
Table 'Delphinus II' 9-max Seat #3 is the button
Seat 1: Saintreine ($148.91 in chips) 
Seat 2: AlKatrone ($107.94 in chips) 
Seat 3: deepblue0000 ($326.02 in chips) 
Seat 4: matiko09 ($100 in chips) 
Seat 5: pandalapa ($102.50 in chips) 
Seat 6: Pablo1337 ($100 in chips) 
Seat 7: er13to ($113.59 in chips) 
Seat 8: mycka86 ($100 in chips) 
Seat 9: FGL-lucky ($55.88 in chips) 
matiko09: posts small blind $0.50
pandalapa: posts big blind $1
*** HOLE CARDS ***
Dealt to matiko09 [Ad Ks]
Pablo1337: folds 
er13to: folds 
mycka86: folds 
FGL-lucky: folds 
Saintreine: folds 
AlKatrone: folds 
deepblue0000: folds 
matiko09: raises $1.50 to $2.50
pandalapa: folds 
Uncalled bet ($1.50) returned to matiko09
matiko09 collected $2 from pot
matiko09: doesn't show hand 
*** SUMMARY ***
Total pot $2 | Rake $0 
Seat 1: Saintreine folded before Flop (didn't bet)
Seat 2: AlKatrone folded before Flop (didn't bet)
Seat 3: deepblue0000 (button) folded before Flop (didn't bet)
Seat 4: matiko09 (small blind) collected ($2)
Seat 5: pandalapa (big blind) folded before Flop
Seat 6: Pablo1337 folded before Flop (didn't bet)
Seat 7: er13to folded before Flop (didn't bet)
Seat 8: mycka86 folded before Flop (didn't bet)
Seat 9: FGL-lucky folded before Flop (didn't bet)





PokerStars Hand #147753772863:  Hold'em No Limit ($0.50/$1.00 USD) - 2016/01/27 11:23:24 CET [2016/01/27 5:23:24 ET]
Table 'Henyey' 9-max Seat #4 is the button
Seat 1: BurnsyT ($115.22 in chips) 
Seat 2: pandalapa ($100 in chips) 
Seat 3: deepblue0000 ($100 in chips) 
Seat 4: sylvian31 ($100 in chips) 
Seat 5: matiko09 ($109.50 in chips) 
Seat 7: Sweden_Pound ($112.18 in chips) 
Seat 8: CoolFireX ($115.10 in chips) 
Seat 9: mycka86 ($132.38 in chips) 
matiko09: posts small blind $0.50
Sweden_Pound: posts big blind $1
*** HOLE CARDS ***
Dealt to matiko09 [9c 5d]
CoolFireX: folds 
mycka86: folds 
BurnsyT: folds 
pandalapa: folds 
deepblue0000: folds 
sylvian31: raises $1.50 to $2.50
matiko09: folds 
Sweden_Pound: folds 
Uncalled bet ($1.50) returned to sylvian31
sylvian31 collected $2.50 from pot
sylvian31: doesn't show hand 
*** SUMMARY ***
Total pot $2.50 | Rake $0 
Seat 1: BurnsyT folded before Flop (didn't bet)
Seat 2: pandalapa folded before Flop (didn't bet)
Seat 3: deepblue0000 folded before Flop (didn't bet)
Seat 4: sylvian31 (button) collected ($2.50)
Seat 5: matiko09 (small blind) folded before Flop
Seat 7: Sweden_Pound (big blind) folded before Flop
Seat 8: CoolFireX folded before Flop (didn't bet)
Seat 9: mycka86 folded before Flop (didn't bet)





PokerStars Hand #147753773016:  Hold'em No Limit ($0.50/$1.00 USD) - 2016/01/27 11:23:24 CET [2016/01/27 5:23:24 ET]
Table 'Pythia II' 9-max Seat #4 is the button
Seat 3: Sweden_Pound ($100 in chips) 
Seat 4: matiko09 ($107 in chips) 
Seat 6: RoadtoNepal ($209.01 in chips) 
Seat 7: deepblue0000 ($104.53 in chips) 
Seat 8: Peu3aHy ($100 in chips) 
Seat 9: CoolFireX ($110.62 in chips) 
RoadtoNepal: posts small blind $0.50
deepblue0000: posts big blind $1
*** HOLE CARDS ***
Dealt to matiko09 [Ks 9d]
Peu3aHy: folds 
CoolFireX: folds 
Sweden_Pound: raises $1.50 to $2.50
matiko09: folds 
RoadtoNepal: folds 
deepblue0000: folds 
Uncalled bet ($1.50) returned to Sweden_Pound
Sweden_Pound collected $2.50 from pot
Sweden_Pound: doesn't show hand 
*** SUMMARY ***
Total pot $2.50 | Rake $0 
Seat 3: Sweden_Pound collected ($2.50)
Seat 4: matiko09 (button) folded before Flop (didn't bet)
Seat 6: RoadtoNepal (small blind) folded before Flop
Seat 7: deepblue0000 (big blind) folded before Flop
Seat 8: Peu3aHy folded before Flop (didn't bet)
Seat 9: CoolFireX folded before Flop (didn't bet)





PokerStars Hand #147753776385:  Hold'em No Limit ($0.50/$1.00 USD) - 2016/01/27 11:23:31 CET [2016/01/27 5:23:31 ET]
Table 'Eudora III' 9-max Seat #9 is the button
Seat 1: Eberhard314 ($104.71 in chips) 
Seat 3: matiko09 ($100 in chips) 
Seat 4: Reven9er ($104.50 in chips) 
Seat 5: di0d80 ($117.36 in chips) 
Seat 6: DIMAZAYAC ($32.07 in chips) 
Seat 7: Sweden_Pound ($101.50 in chips) 
Seat 8: RUS)Timur ($100 in chips) 
Seat 9: Venomous100% ($100 in chips) 
Eberhard314: posts small blind $0.50
Pablo1337: is sitting out 
matiko09: posts big blind $1
*** HOLE CARDS ***
Dealt to matiko09 [9h Jd]
Pablo1337 leaves the table
Reven9er: folds 
GrossiM joins the table at seat #2 
di0d80: folds 
DIMAZAYAC: raises $1 to $2
Sweden_Pound: folds 
RUS)Timur: raises $2.45 to $4.45
Venomous100%: folds 
Eberhard314: folds 
matiko09: folds 
DIMAZAYAC: calls $2.45
*** FLOP *** [Ac Jc 4s]
DIMAZAYAC: checks 
RUS)Timur: bets $4.87
DIMAZAYAC: calls $4.87
*** TURN *** [Ac Jc 4s] [Jh]
DIMAZAYAC: checks 
RUS)Timur: checks 
*** RIVER *** [Ac Jc 4s Jh] [3d]
DIMAZAYAC: bets $11
RUS)Timur: folds 
Uncalled bet ($11) returned to DIMAZAYAC
DIMAZAYAC collected $19.23 from pot
*** SUMMARY ***
Total pot $20.14 | Rake $0.91 
Board [Ac Jc 4s Jh 3d]
Seat 1: Eberhard314 (small blind) folded before Flop
Seat 3: matiko09 (big blind) folded before Flop
Seat 4: Reven9er folded before Flop (didn't bet)
Seat 5: di0d80 folded before Flop (didn't bet)
Seat 6: DIMAZAYAC collected ($19.23)
Seat 7: Sweden_Pound folded before Flop (didn't bet)
Seat 8: RUS)Timur folded on the River
Seat 9: Venomous100% (button) folded before Flop (didn't bet)





PokerStars Hand #147753780817:  Hold'em No Limit ($0.50/$1.00 USD) - 2016/01/27 11:23:40 CET [2016/01/27 5:23:40 ET]
Table 'Helene III' 9-max Seat #6 is the button
Seat 1: UShallGimme$ ($101.50 in chips) 
Seat 2: Reven9er ($170.70 in chips) 
Seat 4: Sweden_Pound ($195.20 in chips) 
Seat 5: XMesuraX ($198.61 in chips) 
Seat 6: matiko09 ($111.82 in chips) 
Seat 7: di0d80 ($100.50 in chips) 
Seat 8: deepblue0000 ($101.50 in chips) 
Seat 9: Peu3aHy ($100 in chips) 
di0d80: posts small blind $0.50
deepblue0000: posts big blind $1
tipner: sits out 
*** HOLE CARDS ***
Dealt to matiko09 [6h 8d]
Peu3aHy: folds 
UShallGimme$: folds 
Reven9er: folds 
Sweden_Pound: folds 
XMesuraX: raises $2 to $3
matiko09: folds 
di0d80: folds 
deepblue0000: folds 
Uncalled bet ($2) returned to XMesuraX
XMesuraX collected $2.50 from pot
XMesuraX: doesn't show hand 
*** SUMMARY ***
Total pot $2.50 | Rake $0 
Seat 1: UShallGimme$ folded before Flop (didn't bet)
Seat 2: Reven9er folded before Flop (didn't bet)
Seat 4: Sweden_Pound folded before Flop (didn't bet)
Seat 5: XMesuraX collected ($2.50)
Seat 6: matiko09 (button) folded before Flop (didn't bet)
Seat 7: di0d80 (small blind) folded before Flop
Seat 8: deepblue0000 (big blind) folded before Flop
Seat 9: Peu3aHy folded before Flop (didn't bet)





PokerStars Hand #147753782267:  Hold'em No Limit ($0.50/$1.00 USD) - 2016/01/27 11:23:43 CET [2016/01/27 5:23:43 ET]
Table 'Palisana III' 9-max Seat #2 is the button
Seat 1: Largie1994 ($50.72 in chips) 
Seat 2: tipner ($100 in chips) 
Seat 3: Kukuryzka ($101.50 in chips) 
Seat 4: Reven9er ($100 in chips) 
Seat 5: di0d80 ($103 in chips) 
Seat 6: matiko09 ($104.73 in chips) 
Seat 7: Sweden_Pound ($100 in chips) 
Seat 8: COOLIKO\/23 ($100 in chips) 
Kukuryzka: posts small blind $0.50
Reven9er: posts big blind $1
*** HOLE CARDS ***
Dealt to matiko09 [5d Qc]
di0d80: folds 
matiko09: folds 
Sweden_Pound: folds 
COOLIKO\/23: folds 
Largie1994: folds 
tipner: folds 
Kukuryzka: folds 
Uncalled bet ($0.50) returned to Reven9er
Reven9er collected $1 from pot
Reven9er: doesn't show hand 
*** SUMMARY ***
Total pot $1 | Rake $0 
Seat 1: Largie1994 folded before Flop (didn't bet)
Seat 2: tipner (button) folded before Flop (didn't bet)
Seat 3: Kukuryzka (small blind) folded before Flop
Seat 4: Reven9er (big blind) collected ($1)
Seat 5: di0d80 folded before Flop (didn't bet)
Seat 6: matiko09 folded before Flop (didn't bet)
Seat 7: Sweden_Pound folded before Flop (didn't bet)
Seat 8: COOLIKO\/23 folded before Flop (didn't bet)





PokerStars Hand #147753784440:  Hold'em No Limit ($0.50/$1.00 USD) - 2016/01/27 11:23:47 CET [2016/01/27 5:23:47 ET]
Table 'Delphinus II' 9-max Seat #4 is the button
Seat 1: Saintreine ($148.91 in chips) 
Seat 2: AlKatrone ($107.94 in chips) 
Seat 3: deepblue0000 ($326.02 in chips) 
Seat 4: matiko09 ($101 in chips) 
Seat 5: pandalapa ($101.50 in chips) 
Seat 8: mycka86 ($100 in chips) 
Seat 9: FGL-lucky ($55.88 in chips) 
pandalapa: posts small blind $0.50
Pablo1337: is sitting out 
er13to: is sitting out 
Pablo1337 leaves the table
mycka86: posts big blind $1
*** HOLE CARDS ***
Dealt to matiko09 [5s 5d]
er13to leaves the table
FGL-lucky: folds 
di0d80 joins the table at seat #6 
Saintreine: folds 
RUS)Timur joins the table at seat #7 
di0d80 leaves the table
AlKatrone: raises $2 to $3
Sweden_Pound joins the table at seat #6 
deepblue0000: folds 
matiko09: calls $3
pandalapa: folds 
mycka86: folds 
*** FLOP *** [8s 8c 2s]
AlKatrone: bets $2.43
matiko09: calls $2.43
*** TURN *** [8s 8c 2s] [5h]
AlKatrone: bets $9.32
matiko09: calls $9.32
*** RIVER *** [8s 8c 2s 5h] [5c]
AlKatrone: checks 
matiko09: bets $21
AlKatrone: folds 
Uncalled bet ($21) returned to matiko09
matiko09 collected $29.60 from pot
matiko09: doesn't show hand 
*** SUMMARY ***
Total pot $31 | Rake $1.40 
Board [8s 8c 2s 5h 5c]
Seat 1: Saintreine folded before Flop (didn't bet)
Seat 2: AlKatrone folded on the River
Seat 3: deepblue0000 folded before Flop (didn't bet)
Seat 4: matiko09 (button) collected ($29.60)
Seat 5: pandalapa (small blind) folded before Flop
Seat 8: mycka86 (big blind) folded before Flop
Seat 9: FGL-lucky folded before Flop (didn't bet)





PokerStars Hand #147753790797:  Hold'em No Limit ($0.50/$1.00 USD) - 2016/01/27 11:24:00 CET [2016/01/27 5:24:00 ET]
Table 'Impala' 9-max Seat #1 is the button
Seat 1: Saintreine ($236.47 in chips) 
Seat 2: AlKatrone ($189.36 in chips) 
Seat 3: Peu3aHy ($100 in chips) 
Seat 4: matiko09 ($106 in chips) 
Seat 5: er13to ($136.09 in chips) 
Seat 6: deepblue0000 ($121.24 in chips) 
Seat 7: RUS)Timur ($101.73 in chips) 
Seat 8: UShallGimme$ ($100 in chips) 
Seat 9: Reven9er ($100 in chips) 
AlKatrone: posts small blind $0.50
Peu3aHy: posts big blind $1
*** HOLE CARDS ***
Dealt to matiko09 [Tc 7d]
matiko09: folds 
er13to: folds 
deepblue0000: folds 
RUS)Timur: raises $1.45 to $2.45
UShallGimme$: raises $5.55 to $8
Reven9er: folds 
Saintreine: folds 
AlKatrone: folds 
Peu3aHy: folds 
RUS)Timur: folds 
Uncalled bet ($5.55) returned to UShallGimme$
UShallGimme$ collected $6.40 from pot
UShallGimme$: doesn't show hand 
*** SUMMARY ***
Total pot $6.40 | Rake $0 
Seat 1: Saintreine (button) folded before Flop (didn't bet)
Seat 2: AlKatrone (small blind) folded before Flop
Seat 3: Peu3aHy (big blind) folded before Flop
Seat 4: matiko09 folded before Flop (didn't bet)
Seat 5: er13to folded before Flop (didn't bet)
Seat 6: deepblue0000 folded before Flop (didn't bet)
Seat 7: RUS)Timur folded before Flop
Seat 8: UShallGimme$ collected ($6.40)
Seat 9: Reven9er folded before Flop (didn't bet)





PokerStars Hand #147753793215:  Hold'em No Limit ($0.50/$1.00 USD) - 2016/01/27 11:24:05 CET [2016/01/27 5:24:05 ET]
Table 'Malzovia' 9-max Seat #7 is the button
Seat 1: mycka86 ($100 in chips) 
Seat 4: AlKatrone ($100 in chips) 
Seat 5: matiko09 ($103.57 in chips) 
Seat 6: deepblue0000 ($310.94 in chips) 
Seat 7: Peu3aHy ($153.06 in chips) 
Seat 9: UShallGimme$ ($116.82 in chips) 
UShallGimme$: posts small blind $0.50
mycka86: posts big blind $1
Reven9er: sits out 
*** HOLE CARDS ***
Dealt to matiko09 [Kd Js]
AlKatrone: folds 
matiko09: raises $2 to $3
Ysatyss joins the table at seat #8 
deepblue0000: calls $3
Peu3aHy: folds 
UShallGimme$: folds 
mycka86: folds 
*** FLOP *** [9s 7d 9d]
matiko09: checks 
deepblue0000: checks 
*** TURN *** [9s 7d 9d] [6s]
matiko09: bets $3.72
deepblue0000: calls $3.72
*** RIVER *** [9s 7d 9d 6s] [2s]
matiko09: checks 
deepblue0000: checks 
*** SHOW DOWN ***
matiko09: shows [Kd Js] (a pair of Nines)
deepblue0000: shows [Ad 5d] (a pair of Nines - Ace kicker)
deepblue0000 collected $14.27 from pot
*** SUMMARY ***
Total pot $14.94 | Rake $0.67 
Board [9s 7d 9d 6s 2s]
Seat 1: mycka86 (big blind) folded before Flop
Seat 4: AlKatrone folded before Flop (didn't bet)
Seat 5: matiko09 showed [Kd Js] and lost with a pair of Nines
Seat 6: deepblue0000 showed [Ad 5d] and won ($14.27) with a pair of Nines
Seat 7: Peu3aHy (button) folded before Flop (didn't bet)
Seat 9: UShallGimme$ (small blind) folded before Flop





PokerStars Hand #147753796041:  Hold'em No Limit ($0.50/$1.00 USD) - 2016/01/27 11:24:11 CET [2016/01/27 5:24:11 ET]
Table 'Nanking' 9-max Seat #6 is the button
Seat 5: TheGentleFox ($78 in chips) 
Seat 6: Kukuryzka ($101.50 in chips) 
Seat 7: tipner ($100.50 in chips) 
Seat 8: matiko09 ($100 in chips) 
tipner: posts small blind $0.50
matiko09: posts big blind $1
Sweden_Pound: sits out 
RoadtoNepal: sits out 
Dachish: sits out 
florent502: sits out 
COOLIKO\/23: sits out 
*** HOLE CARDS ***
Dealt to matiko09 [3h 5d]
TheGentleFox: folds 
Kukuryzka: raises $1 to $2
TheGentleFox said, "2day?"
tipner: folds 
matiko09: folds 
Uncalled bet ($1) returned to Kukuryzka
Kukuryzka collected $2.50 from pot
Kukuryzka: doesn't show hand 
*** SUMMARY ***
Total pot $2.50 | Rake $0 
Seat 5: TheGentleFox folded before Flop (didn't bet)
Seat 6: Kukuryzka (button) collected ($2.50)
Seat 7: tipner (small blind) folded before Flop
Seat 8: matiko09 (big blind) folded before Flop





PokerStars Hand #147753796755:  Hold'em No Limit ($0.50/$1.00 USD) - 2016/01/27 11:24:12 CET [2016/01/27 5:24:12 ET]
Table 'Fragaria II' 9-max Seat #7 is the button
Seat 1: deepblue0000 ($108.38 in chips) 
Seat 2: GG-NoR34D. ($71.37 in chips) 
Seat 3: Sweden_Pound ($115.44 in chips) 
Seat 4: AlKatrone ($101.50 in chips) 
Seat 5: Venomous100% ($109.62 in chips) 
Seat 6: UShallGimme$ ($193.86 in chips) 
Seat 7: Hobby-.-AK ($36.71 in chips) 
Seat 8: mycka86 ($111.21 in chips) 
Seat 9: matiko09 ($100 in chips) 
mycka86: posts small blind $0.50
matiko09: posts big blind $1
*** HOLE CARDS ***
Dealt to matiko09 [6c 2h]
deepblue0000: folds 
GG-NoR34D.: folds 
Sweden_Pound: folds 
AlKatrone: raises $2 to $3
Venomous100%: folds 
UShallGimme$: folds 
Hobby-.-AK: folds 
mycka86: folds 
matiko09: folds 
Uncalled bet ($2) returned to AlKatrone
AlKatrone collected $2.50 from pot
AlKatrone: doesn't show hand 
*** SUMMARY ***
Total pot $2.50 | Rake $0 
Seat 1: deepblue0000 folded before Flop (didn't bet)
Seat 2: GG-NoR34D. folded before Flop (didn't bet)
Seat 3: Sweden_Pound folded before Flop (didn't bet)
Seat 4: AlKatrone collected ($2.50)
Seat 5: Venomous100% folded before Flop (didn't bet)
Seat 6: UShallGimme$ folded before Flop (didn't bet)
Seat 7: Hobby-.-AK (button) folded before Flop (didn't bet)
Seat 8: mycka86 (small blind) folded before Flop
Seat 9: matiko09 (big blind) folded before Flop





PokerStars Hand #147753801601:  Hold'em No Limit ($0.50/$1.00 USD) - 2016/01/27 11:24:22 CET [2016/01/27 5:24:22 ET]
Table 'Henyey' 9-max Seat #5 is the button
Seat 1: BurnsyT ($115.22 in chips) 
Seat 2: pandalapa ($100 in chips) 
Seat 3: deepblue0000 ($100 in chips) 
Seat 4: sylvian31 ($101.50 in chips) 
Seat 5: matiko09 ($109 in chips) 
Seat 7: Sweden_Pound ($111.18 in chips) 
Seat 8: CoolFireX ($115.10 in chips) 
Seat 9: mycka86 ($132.38 in chips) 
Sweden_Pound: posts small blind $0.50
CoolFireX: posts big blind $1
*** HOLE CARDS ***
Dealt to matiko09 [9s 4c]
mycka86: folds 
BurnsyT has timed out
BurnsyT: folds 
pandalapa: raises $2 to $3
deepblue0000: folds 
sylvian31: folds 
matiko09: folds 
Sweden_Pound: folds 
CoolFireX: folds 
Uncalled bet ($2) returned to pandalapa
di0d80 leaves the table
pandalapa collected $2.50 from pot
pandalapa: doesn't show hand 
*** SUMMARY ***
Total pot $2.50 | Rake $0 
Seat 1: BurnsyT folded before Flop (didn't bet)
Seat 2: pandalapa collected ($2.50)
Seat 3: deepblue0000 folded before Flop (didn't bet)
Seat 4: sylvian31 folded before Flop (didn't bet)
Seat 5: matiko09 (button) folded before Flop (didn't bet)
Seat 7: Sweden_Pound (small blind) folded before Flop
Seat 8: CoolFireX (big blind) folded before Flop
Seat 9: mycka86 folded before Flop (didn't bet)





PokerStars Hand #147753803021:  Hold'em No Limit ($0.50/$1.00 USD) - 2016/01/27 11:24:25 CET [2016/01/27 5:24:25 ET]
Table 'Siegena III' 9-max Seat #4 is the button
Seat 1: nnne409 ($73.16 in chips) 
Seat 2: tipner ($100 in chips) 
Seat 3: masaytoo ($93.25 in chips) 
Seat 4: Sweden_Pound ($107.72 in chips) 
Seat 5: matiko09 ($101.50 in chips) 
Seat 6: RUS)Timur ($106.32 in chips) 
Seat 7: sylvian31 ($100 in chips) 
Seat 8: Venomous100% ($100 in chips) 
Seat 9: di0d80 ($101 in chips) 
matiko09: posts small blind $0.50
RUS)Timur: posts big blind $1
*** HOLE CARDS ***
Dealt to matiko09 [7s 9h]
sylvian31: folds 
Venomous100%: folds 
di0d80: folds 
nnne409: folds 
tipner: folds 
masaytoo: folds 
Sweden_Pound: folds 
matiko09: folds 
Uncalled bet ($0.50) returned to RUS)Timur
RUS)Timur collected $1 from pot
RUS)Timur: doesn't show hand 
*** SUMMARY ***
Total pot $1 | Rake $0 
Seat 1: nnne409 folded before Flop (didn't bet)
Seat 2: tipner folded before Flop (didn't bet)
Seat 3: masaytoo folded before Flop (didn't bet)
Seat 4: Sweden_Pound (button) folded before Flop (didn't bet)
Seat 5: matiko09 (small blind) folded before Flop
Seat 6: RUS)Timur (big blind) collected ($1)
Seat 7: sylvian31 folded before Flop (didn't bet)
Seat 8: Venomous100% folded before Flop (didn't bet)
Seat 9: di0d80 folded before Flop (didn't bet)





PokerStars Hand #147753802750:  Hold'em No Limit ($0.50/$1.00 USD) - 2016/01/27 11:24:25 CET [2016/01/27 5:24:25 ET]
Table 'Pythia II' 9-max Seat #6 is the button
Seat 3: Sweden_Pound ($101.50 in chips) 
Seat 4: matiko09 ($107 in chips) 
Seat 6: RoadtoNepal ($208.51 in chips) 
Seat 7: deepblue0000 ($103.53 in chips) 
Seat 8: Peu3aHy ($100 in chips) 
Seat 9: CoolFireX ($110.62 in chips) 
deepblue0000: posts small blind $0.50
Peu3aHy: posts big blind $1
*** HOLE CARDS ***
Dealt to matiko09 [Td 8s]
CoolFireX: folds 
Sweden_Pound: raises $2 to $3
matiko09: folds 
RoadtoNepal: folds 
deepblue0000: calls $2.50
Peu3aHy: folds 
*** FLOP *** [Qc Jc Kd]
deepblue0000: checks 
Sweden_Pound: bets $4.34
deepblue0000: folds 
Uncalled bet ($4.34) returned to Sweden_Pound
Sweden_Pound collected $6.68 from pot
Sweden_Pound: doesn't show hand 
*** SUMMARY ***
Total pot $7 | Rake $0.32 
Board [Qc Jc Kd]
Seat 3: Sweden_Pound collected ($6.68)
Seat 4: matiko09 folded before Flop (didn't bet)
Seat 6: RoadtoNepal (button) folded before Flop (didn't bet)
Seat 7: deepblue0000 (small blind) folded on the Flop
Seat 8: Peu3aHy (big blind) folded before Flop
Seat 9: CoolFireX folded before Flop (didn't bet)





PokerStars Hand #147753805555:  Hold'em No Limit ($0.50/$1.00 USD) - 2016/01/27 11:24:30 CET [2016/01/27 5:24:30 ET]
Table 'Helene III' 9-max Seat #7 is the button
Seat 1: UShallGimme$ ($101.50 in chips) 
Seat 2: Reven9er ($170.70 in chips) 
Seat 4: Sweden_Pound ($195.20 in chips) 
Seat 5: XMesuraX ($200.11 in chips) 
Seat 6: matiko09 ($111.82 in chips) 
Seat 7: di0d80 ($100 in chips) 
Seat 8: deepblue0000 ($100.50 in chips) 
Seat 9: Peu3aHy ($100 in chips) 
deepblue0000: posts small blind $0.50
Peu3aHy: posts big blind $1
tipner: sits out 
*** HOLE CARDS ***
Dealt to matiko09 [8c 2d]
UShallGimme$: folds 
Reven9er: folds 
Sweden_Pound: folds 
XMesuraX: folds 
matiko09: folds 
di0d80: raises $1 to $2
deepblue0000: raises $7 to $9
Peu3aHy: folds 
di0d80: calls $7
*** FLOP *** [2h 6d Kd]
deepblue0000: bets $11
di0d80: folds 
Uncalled bet ($11) returned to deepblue0000
deepblue0000 collected $18.14 from pot
*** SUMMARY ***
Total pot $19 | Rake $0.86 
Board [2h 6d Kd]
Seat 1: UShallGimme$ folded before Flop (didn't bet)
Seat 2: Reven9er folded before Flop (didn't bet)
Seat 4: Sweden_Pound folded before Flop (didn't bet)
Seat 5: XMesuraX folded before Flop (didn't bet)
Seat 6: matiko09 folded before Flop (didn't bet)
Seat 7: di0d80 (button) folded on the Flop
Seat 8: deepblue0000 (small blind) collected ($18.14)
Seat 9: Peu3aHy (big blind) folded before Flop





PokerStars Hand #147753808072:  Hold'em No Limit ($0.50/$1.00 USD) - 2016/01/27 11:24:36 CET [2016/01/27 5:24:36 ET]
Table 'Palisana III' 9-max Seat #3 is the button
Seat 1: Largie1994 ($50.72 in chips) 
Seat 2: tipner ($100 in chips) 
Seat 3: Kukuryzka ($101 in chips) 
Seat 4: Reven9er ($100.50 in chips) 
Seat 5: di0d80 ($103 in chips) 
Seat 6: matiko09 ($104.73 in chips) 
Seat 7: Sweden_Pound ($100 in chips) 
Seat 8: COOLIKO\/23 ($100 in chips) 
Reven9er: posts small blind $0.50
di0d80: posts big blind $1
*** HOLE CARDS ***
Dealt to matiko09 [Ks 3d]
matiko09: folds 
Sweden_Pound: folds 
COOLIKO\/23: folds 
Largie1994: raises $3 to $4
tipner: folds 
Kukuryzka: raises $97 to $101 and is all-in
Reven9er: folds 
di0d80: folds 
Largie1994: calls $46.72 and is all-in
Uncalled bet ($50.28) returned to Kukuryzka
*** FIRST FLOP *** [6h 2h 6c]
*** FIRST TURN *** [6h 2h 6c] [Qs]
*** FIRST RIVER *** [6h 2h 6c Qs] [6d]
*** SECOND FLOP *** [9s 4d 2d]
*** SECOND TURN *** [9s 4d 2d] [8s]
*** SECOND RIVER *** [9s 4d 2d 8s] [7c]
*** FIRST SHOW DOWN ***
Largie1994: shows [Tc Ts] (a full house, Sixes full of Tens)
Kukuryzka: shows [Ah Kd] (three of a kind, Sixes)
Largie1994 collected $50.07 from pot
*** SECOND SHOW DOWN ***
Largie1994: shows [Tc Ts] (a pair of Tens)
Kukuryzka: shows [Ah Kd] (high card Ace)
Largie1994 collected $50.07 from pot
*** SUMMARY ***
Total pot $102.94 | Rake $2.80 
Hand was run twice
FIRST Board [6h 2h 6c Qs 6d]
SECOND Board [9s 4d 2d 8s 7c]
Seat 1: Largie1994 showed [Tc Ts] and won ($50.07) with a full house, Sixes full of Tens, and won ($50.07) with a pair of Tens
Seat 2: tipner folded before Flop (didn't bet)
Seat 3: Kukuryzka (button) showed [Ah Kd] and lost with three of a kind, Sixes, and lost with high card Ace
Seat 4: Reven9er (small blind) folded before Flop
Seat 5: di0d80 (big blind) folded before Flop
Seat 6: matiko09 folded before Flop (didn't bet)
Seat 7: Sweden_Pound folded before Flop (didn't bet)
Seat 8: COOLIKO\/23 folded before Flop (didn't bet)





PokerStars Hand #147753808361:  Hold'em No Limit ($0.50/$1.00 USD) - 2016/01/27 11:24:36 CET [2016/01/27 5:24:36 ET]
Table 'Nanking' 9-max Seat #7 is the button
Seat 5: TheGentleFox ($78 in chips) 
Seat 6: Kukuryzka ($103 in chips) 
Seat 7: tipner ($100 in chips) 
Seat 8: matiko09 ($100 in chips) 
Seat 9: Sweden_Pound ($100 in chips) 
matiko09: posts small blind $0.50
Sweden_Pound: posts big blind $1
Dachish: sits out 
florent502: sits out 
COOLIKO\/23: sits out 
*** HOLE CARDS ***
Dealt to matiko09 [Qc 2c]
TheGentleFox: folds 
Kukuryzka: raises $1.50 to $2.50
tipner: folds 
matiko09: folds 
Sweden_Pound: calls $1.50
*** FLOP *** [Kc 7d 3s]
Sweden_Pound: checks 
Kukuryzka: bets $2.62
Sweden_Pound: calls $2.62
*** TURN *** [Kc 7d 3s] [7s]
Sweden_Pound: checks 
Kukuryzka: checks 
*** RIVER *** [Kc 7d 3s 7s] [3h]
Sweden_Pound: checks 
Kukuryzka: checks 
*** SHOW DOWN ***
Sweden_Pound: shows [8s 8c] (two pair, Eights and Sevens)
Kukuryzka: mucks hand 
Sweden_Pound collected $10.26 from pot
*** SUMMARY ***
Total pot $10.74 | Rake $0.48 
Board [Kc 7d 3s 7s 3h]
Seat 5: TheGentleFox folded before Flop (didn't bet)
Seat 6: Kukuryzka mucked [As Qd]
Seat 7: tipner (button) folded before Flop (didn't bet)
Seat 8: matiko09 (small blind) folded before Flop
Seat 9: Sweden_Pound (big blind) showed [8s 8c] and won ($10.26) with two pair, Eights and Sevens





PokerStars Hand #147753812991:  Hold'em No Limit ($0.50/$1.00 USD) - 2016/01/27 11:24:46 CET [2016/01/27 5:24:46 ET]
Table 'Fragaria II' 9-max Seat #8 is the button
Seat 1: deepblue0000 ($108.38 in chips) 
Seat 2: GG-NoR34D. ($71.37 in chips) 
Seat 3: Sweden_Pound ($115.44 in chips) 
Seat 4: AlKatrone ($103 in chips) 
Seat 5: Venomous100% ($109.62 in chips) 
Seat 6: UShallGimme$ ($193.86 in chips) 
Seat 7: Hobby-.-AK ($36.71 in chips) 
Seat 8: mycka86 ($110.71 in chips) 
Seat 9: matiko09 ($100 in chips) 
matiko09: posts small blind $0.50
deepblue0000: posts big blind $1
*** HOLE CARDS ***
Dealt to matiko09 [6h 6s]
GG-NoR34D.: folds 
Sweden_Pound: folds 
AlKatrone: folds 
Venomous100%: folds 
UShallGimme$: folds 
Hobby-.-AK: folds 
mycka86: raises $1.10 to $2.10
matiko09: folds 
deepblue0000: calls $1.10
*** FLOP *** [4c 6d 4s]
deepblue0000: checks 
mycka86: checks 
*** TURN *** [4c 6d 4s] [Td]
deepblue0000: checks 
mycka86: bets $3.10
deepblue0000: folds 
Uncalled bet ($3.10) returned to mycka86
mycka86 collected $4.49 from pot
*** SUMMARY ***
Total pot $4.70 | Rake $0.21 
Board [4c 6d 4s Td]
Seat 1: deepblue0000 (big blind) folded on the Turn
Seat 2: GG-NoR34D. folded before Flop (didn't bet)
Seat 3: Sweden_Pound folded before Flop (didn't bet)
Seat 4: AlKatrone folded before Flop (didn't bet)
Seat 5: Venomous100% folded before Flop (didn't bet)
Seat 6: UShallGimme$ folded before Flop (didn't bet)
Seat 7: Hobby-.-AK folded before Flop (didn't bet)
Seat 8: mycka86 (button) collected ($4.49)
Seat 9: matiko09 (small blind) folded before Flop





PokerStars Hand #147753814093:  Hold'em No Limit ($0.50/$1.00 USD) - 2016/01/27 11:24:48 CET [2016/01/27 5:24:48 ET]
Table 'Siegena III' 9-max Seat #5 is the button
Seat 1: nnne409 ($73.16 in chips) 
Seat 2: tipner ($100 in chips) 
Seat 3: masaytoo ($93.25 in chips) 
Seat 4: Sweden_Pound ($107.72 in chips) 
Seat 5: matiko09 ($101 in chips) 
Seat 6: RUS)Timur ($106.82 in chips) 
Seat 7: sylvian31 ($100 in chips) 
Seat 8: Venomous100% ($100 in chips) 
Seat 9: di0d80 ($101 in chips) 
RUS)Timur: posts small blind $0.50
sylvian31: posts big blind $1
*** HOLE CARDS ***
Dealt to matiko09 [3s Td]
Venomous100%: folds 
di0d80: folds 
nnne409: folds 
tipner: folds 
masaytoo: folds 
Sweden_Pound: raises $1.50 to $2.50
matiko09: folds 
RUS)Timur: raises $6.50 to $9
sylvian31: folds 
Sweden_Pound: calls $6.50
*** FLOP *** [2h 2d Th]
RUS)Timur: bets $5.80
Sweden_Pound: calls $5.80
*** TURN *** [2h 2d Th] [7d]
RUS)Timur: bets $24.25
Sweden_Pound: calls $24.25
*** RIVER *** [2h 2d Th 7d] [3c]
RUS)Timur: bets $67.77 and is all-in
Sweden_Pound: folds 
Uncalled bet ($67.77) returned to RUS)Timur
RUS)Timur collected $76.30 from pot
RUS)Timur: doesn't show hand 
*** SUMMARY ***
Total pot $79.10 | Rake $2.80 
Board [2h 2d Th 7d 3c]
Seat 1: nnne409 folded before Flop (didn't bet)
Seat 2: tipner folded before Flop (didn't bet)
Seat 3: masaytoo folded before Flop (didn't bet)
Seat 4: Sweden_Pound folded on the River
Seat 5: matiko09 (button) folded before Flop (didn't bet)
Seat 6: RUS)Timur (small blind) collected ($76.30)
Seat 7: sylvian31 (big blind) folded before Flop
Seat 8: Venomous100% folded before Flop (didn't bet)
Seat 9: di0d80 folded before Flop (didn't bet)





PokerStars Hand #147753815208:  Hold'em No Limit ($0.50/$1.00 USD) - 2016/01/27 11:24:50 CET [2016/01/27 5:24:50 ET]
Table 'Pythia II' 9-max Seat #7 is the button
Seat 3: Sweden_Pound ($105.18 in chips) 
Seat 4: matiko09 ($107 in chips) 
Seat 6: RoadtoNepal ($208.51 in chips) 
Seat 7: deepblue0000 ($100.53 in chips) 
Seat 8: Peu3aHy ($100 in chips) 
Seat 9: CoolFireX ($110.62 in chips) 
Peu3aHy: posts small blind $0.50
CoolFireX: posts big blind $1
*** HOLE CARDS ***
Dealt to matiko09 [Th 9c]
Sweden_Pound: folds 
matiko09: folds 
RoadtoNepal: raises $1.50 to $2.50
deepblue0000: folds 
Peu3aHy: folds 
CoolFireX: folds 
Uncalled bet ($1.50) returned to RoadtoNepal
RoadtoNepal collected $2.50 from pot
RoadtoNepal: doesn't show hand 
*** SUMMARY ***
Total pot $2.50 | Rake $0 
Seat 3: Sweden_Pound folded before Flop (didn't bet)
Seat 4: matiko09 folded before Flop (didn't bet)
Seat 6: RoadtoNepal collected ($2.50)
Seat 7: deepblue0000 (button) folded before Flop (didn't bet)
Seat 8: Peu3aHy (small blind) folded before Flop
Seat 9: CoolFireX (big blind) folded before Flop





PokerStars Hand #147753825142:  Hold'em No Limit ($0.50/$1.00 USD) - 2016/01/27 11:25:11 CET [2016/01/27 5:25:11 ET]
Table 'Alkmene II' 9-max Seat #3 is the button
Seat 1: matiko09 ($100 in chips) 
Seat 2: deepblue0000 ($103.28 in chips) 
Seat 3: MuSaShiBuShi ($45.73 in chips) 
Seat 4: CoolFireX ($141.84 in chips) 
Seat 5: Sweden_Pound ($119.05 in chips) 
Seat 6: Peu3aHy ($100 in chips) 
Seat 7: mycka86 ($100 in chips) 
Seat 8: fecsok1 ($94.01 in chips) 
Seat 9: pandalapa ($100 in chips) 
CoolFireX: posts small blind $0.50
Sweden_Pound: posts big blind $1
*** HOLE CARDS ***
Dealt to matiko09 [Ts Ah]
Peu3aHy: folds 
mycka86: folds 
fecsok1: raises $1 to $2
pandalapa: folds 
matiko09: folds 
deepblue0000: folds 
MuSaShiBuShi: folds 
CoolFireX: folds 
Sweden_Pound: raises $5 to $7
fecsok1: folds 
Uncalled bet ($5) returned to Sweden_Pound
Sweden_Pound collected $4.50 from pot
Sweden_Pound: doesn't show hand 
*** SUMMARY ***
Total pot $4.50 | Rake $0 
Seat 1: matiko09 folded before Flop (didn't bet)
Seat 2: deepblue0000 folded before Flop (didn't bet)
Seat 3: MuSaShiBuShi (button) folded before Flop (didn't bet)
Seat 4: CoolFireX (small blind) folded before Flop
Seat 5: Sweden_Pound (big blind) collected ($4.50)
Seat 6: Peu3aHy folded before Flop (didn't bet)
Seat 7: mycka86 folded before Flop (didn't bet)
Seat 8: fecsok1 folded before Flop
Seat 9: pandalapa folded before Flop (didn't bet)





PokerStars Hand #147753827858:  Hold'em No Limit ($0.50/$1.00 USD) - 2016/01/27 11:25:16 CET [2016/01/27 5:25:16 ET]
Table 'Henyey' 9-max Seat #7 is the button
Seat 1: BurnsyT ($115.22 in chips) 
Seat 2: pandalapa ($101.50 in chips) 
Seat 3: deepblue0000 ($100 in chips) 
Seat 4: sylvian31 ($101.50 in chips) 
Seat 5: matiko09 ($109 in chips) 
Seat 7: Sweden_Pound ($110.68 in chips) 
Seat 8: CoolFireX ($114.10 in chips) 
Seat 9: mycka86 ($132.38 in chips) 
CoolFireX: posts small blind $0.50
mycka86: posts big blind $1
*** HOLE CARDS ***
Dealt to matiko09 [Ac 7s]
BurnsyT: folds 
pandalapa: raises $2 to $3
deepblue0000: folds 
sylvian31: folds 
matiko09: folds 
Sweden_Pound: folds 
CoolFireX: folds 
mycka86: folds 
Uncalled bet ($2) returned to pandalapa
pandalapa collected $2.50 from pot
pandalapa: doesn't show hand 
*** SUMMARY ***
Total pot $2.50 | Rake $0 
Seat 1: BurnsyT folded before Flop (didn't bet)
Seat 2: pandalapa collected ($2.50)
Seat 3: deepblue0000 folded before Flop (didn't bet)
Seat 4: sylvian31 folded before Flop (didn't bet)
Seat 5: matiko09 folded before Flop (didn't bet)
Seat 7: Sweden_Pound (button) folded before Flop (didn't bet)
Seat 8: CoolFireX (small blind) folded before Flop
Seat 9: mycka86 (big blind) folded before Flop





PokerStars Hand #147753829996:  Hold'em No Limit ($0.50/$1.00 USD) - 2016/01/27 11:25:20 CET [2016/01/27 5:25:20 ET]
Table 'Malzovia' 9-max Seat #9 is the button
Seat 1: mycka86 ($100 in chips) 
Seat 3: Reven9er ($100 in chips) 
Seat 4: AlKatrone ($100 in chips) 
Seat 5: matiko09 ($100 in chips) 
Seat 6: deepblue0000 ($318.49 in chips) 
Seat 7: Peu3aHy ($153.06 in chips) 
Seat 8: Ysatyss ($45.77 in chips) 
Seat 9: UShallGimme$ ($116.32 in chips) 
mycka86: posts small blind $0.50
Reven9er: posts big blind $1
Ysatyss: posts big blind $1
*** HOLE CARDS ***
Dealt to matiko09 [7c 2c]
AlKatrone: folds 
matiko09: folds 
deepblue0000: folds 
Peu3aHy: folds 
Ysatyss: checks 
UShallGimme$: raises $3 to $4
mycka86: folds 
Reven9er: folds 
Ysatyss: folds 
Uncalled bet ($3) returned to UShallGimme$
UShallGimme$ collected $3.50 from pot
UShallGimme$: doesn't show hand 
*** SUMMARY ***
Total pot $3.50 | Rake $0 
Seat 1: mycka86 (small blind) folded before Flop
Seat 3: Reven9er (big blind) folded before Flop
Seat 4: AlKatrone folded before Flop (didn't bet)
Seat 5: matiko09 folded before Flop (didn't bet)
Seat 6: deepblue0000 folded before Flop (didn't bet)
Seat 7: Peu3aHy folded before Flop (didn't bet)
Seat 8: Ysatyss folded before Flop
Seat 9: UShallGimme$ (button) collected ($3.50)





PokerStars Hand #147753830209:  Hold'em No Limit ($0.50/$1.00 USD) - 2016/01/27 11:25:21 CET [2016/01/27 5:25:21 ET]
Table 'Eudora III' 9-max Seat #1 is the button
Seat 1: Eberhard314 ($104.21 in chips) 
Seat 3: matiko09 ($100 in chips) 
Seat 4: Reven9er ($104.50 in chips) 
Seat 5: di0d80 ($117.36 in chips) 
Seat 6: DIMAZAYAC ($64.98 in chips) 
Seat 7: Sweden_Pound ($101.50 in chips) 
Seat 8: RUS)Timur ($100 in chips) 
Seat 9: Venomous100% ($100 in chips) 
GrossiM will be allowed to play after the button
matiko09: posts small blind $0.50
Reven9er: posts big blind $1
*** HOLE CARDS ***
Dealt to matiko09 [8h 6s]
di0d80: folds 
DIMAZAYAC: folds 
Sweden_Pound: folds 
RUS)Timur: folds 
Venomous100%: folds 
Eberhard314: raises $1 to $2
matiko09: folds 
Reven9er: raises $4.50 to $6.50
Eberhard314: calls $4.50
*** FLOP *** [3s 7c 7s]
Reven9er: bets $5
Eberhard314: raises $9 to $14
Reven9er: calls $9
*** TURN *** [3s 7c 7s] [2s]
Reven9er: checks 
Eberhard314: bets $6
Reven9er: calls $6
*** RIVER *** [3s 7c 7s 2s] [3c]
Reven9er: checks 
Eberhard314: bets $19
Reven9er: folds 
Uncalled bet ($19) returned to Eberhard314
Eberhard314 collected $51.09 from pot
*** SUMMARY ***
Total pot $53.50 | Rake $2.41 
Board [3s 7c 7s 2s 3c]
Seat 1: Eberhard314 (button) collected ($51.09)
Seat 3: matiko09 (small blind) folded before Flop
Seat 4: Reven9er (big blind) folded on the River
Seat 5: di0d80 folded before Flop (didn't bet)
Seat 6: DIMAZAYAC folded before Flop (didn't bet)
Seat 7: Sweden_Pound folded before Flop (didn't bet)
Seat 8: RUS)Timur folded before Flop (didn't bet)
Seat 9: Venomous100% folded before Flop (didn't bet)





PokerStars Hand #147753841348:  Hold'em No Limit ($0.50/$1.00 USD) - 2016/01/27 11:25:44 CET [2016/01/27 5:25:44 ET]
Table 'Helene III' 9-max Seat #8 is the button
Seat 1: UShallGimme$ ($101.50 in chips) 
Seat 2: Reven9er ($170.70 in chips) 
Seat 4: Sweden_Pound ($195.20 in chips) 
Seat 5: XMesuraX ($200.11 in chips) 
Seat 6: matiko09 ($111.82 in chips) 
Seat 7: di0d80 ($100 in chips) 
Seat 8: deepblue0000 ($109.64 in chips) 
Seat 9: Peu3aHy ($100 in chips) 
Peu3aHy: posts small blind $0.50
UShallGimme$: posts big blind $1
tipner: sits out 
*** HOLE CARDS ***
Dealt to matiko09 [As 5h]
Reven9er: folds 
Sweden_Pound: folds 
XMesuraX: folds 
matiko09: folds 
di0d80: folds 
deepblue0000: folds 
Peu3aHy: folds 
Uncalled bet ($0.50) returned to UShallGimme$
UShallGimme$ collected $1 from pot
UShallGimme$: doesn't show hand 
*** SUMMARY ***
Total pot $1 | Rake $0 
Seat 1: UShallGimme$ (big blind) collected ($1)
Seat 2: Reven9er folded before Flop (didn't bet)
Seat 4: Sweden_Pound folded before Flop (didn't bet)
Seat 5: XMesuraX folded before Flop (didn't bet)
Seat 6: matiko09 folded before Flop (didn't bet)
Seat 7: di0d80 folded before Flop (didn't bet)
Seat 8: deepblue0000 (button) folded before Flop (didn't bet)
Seat 9: Peu3aHy (small blind) folded before Flop





PokerStars Hand #147753842565:  Hold'em No Limit ($0.50/$1.00 USD) - 2016/01/27 11:25:46 CET [2016/01/27 5:25:46 ET]
Table 'Palisana III' 9-max Seat #4 is the button
Seat 1: Largie1994 ($100.14 in chips) 
Seat 2: tipner ($100 in chips) 
Seat 3: Kukuryzka ($100 in chips) 
Seat 4: Reven9er ($100 in chips) 
Seat 5: di0d80 ($102 in chips) 
Seat 6: matiko09 ($104.73 in chips) 
Seat 7: Sweden_Pound ($100 in chips) 
Seat 8: COOLIKO\/23 ($100 in chips) 
Seat 9: monacomoritz ($100 in chips) 
di0d80: posts small blind $0.50
matiko09: posts big blind $1
monacomoritz: posts small & big blinds $1.50
*** HOLE CARDS ***
Dealt to matiko09 [Kc Qs]
Sweden_Pound: folds 
COOLIKO\/23: raises $3 to $4
monacomoritz: calls $3
Largie1994: folds 
tipner: folds 
Kukuryzka: folds 
Reven9er: folds 
di0d80: folds 
matiko09: raises $10 to $14
COOLIKO\/23: folds 
monacomoritz: folds 
Uncalled bet ($10) returned to matiko09
matiko09 collected $13 from pot
matiko09: doesn't show hand 
*** SUMMARY ***
Total pot $13 | Rake $0 
Seat 1: Largie1994 folded before Flop (didn't bet)
Seat 2: tipner folded before Flop (didn't bet)
Seat 3: Kukuryzka folded before Flop (didn't bet)
Seat 4: Reven9er (button) folded before Flop (didn't bet)
Seat 5: di0d80 (small blind) folded before Flop
Seat 6: matiko09 (big blind) collected ($13)
Seat 7: Sweden_Pound folded before Flop (didn't bet)
Seat 8: COOLIKO\/23 folded before Flop
Seat 9: monacomoritz folded before Flop





PokerStars Hand #147753846129:  Hold'em No Limit ($0.50/$1.00 USD) - 2016/01/27 11:25:54 CET [2016/01/27 5:25:54 ET]
Table 'Malzovia' 9-max Seat #1 is the button
Seat 1: mycka86 ($100 in chips) 
Seat 3: Reven9er ($100 in chips) 
Seat 4: AlKatrone ($100 in chips) 
Seat 5: matiko09 ($100 in chips) 
Seat 6: deepblue0000 ($318.49 in chips) 
Seat 7: Peu3aHy ($153.06 in chips) 
Seat 8: Ysatyss ($44.77 in chips) 
Seat 9: UShallGimme$ ($118.82 in chips) 
Reven9er: posts small blind $0.50
AlKatrone: posts big blind $1
*** HOLE CARDS ***
Dealt to matiko09 [6h 9h]
matiko09: folds 
deepblue0000: folds 
Peu3aHy: folds 
Ysatyss: raises $2.50 to $3.50
UShallGimme$: folds 
mycka86: folds 
Reven9er: folds 
AlKatrone: folds 
Uncalled bet ($2.50) returned to Ysatyss
Ysatyss collected $2.50 from pot
Ysatyss: doesn't show hand 
*** SUMMARY ***
Total pot $2.50 | Rake $0 
Seat 1: mycka86 (button) folded before Flop (didn't bet)
Seat 3: Reven9er (small blind) folded before Flop
Seat 4: AlKatrone (big blind) folded before Flop
Seat 5: matiko09 folded before Flop (didn't bet)
Seat 6: deepblue0000 folded before Flop (didn't bet)
Seat 7: Peu3aHy folded before Flop (didn't bet)
Seat 8: Ysatyss collected ($2.50)
Seat 9: UShallGimme$ folded before Flop (didn't bet)





PokerStars Hand #147753848223:  Hold'em No Limit ($0.50/$1.00 USD) - 2016/01/27 11:25:58 CET [2016/01/27 5:25:58 ET]
Table 'Nanking' 9-max Seat #8 is the button
Seat 2: Dachish ($92.92 in chips) 
Seat 3: florent502 ($40 in chips) 
Seat 5: TheGentleFox ($78 in chips) 
Seat 6: Kukuryzka ($100 in chips) 
Seat 7: tipner ($100 in chips) 
Seat 8: matiko09 ($100 in chips) 
Seat 9: Sweden_Pound ($105.14 in chips) 
Sweden_Pound: posts small blind $0.50
Dachish: posts big blind $1
florent502: posts big blind $1
COOLIKO\/23: sits out 
*** HOLE CARDS ***
Dealt to matiko09 [5c 2s]
florent502: checks 
TheGentleFox: folds 
Kukuryzka: folds 
tipner: folds 
matiko09: folds 
Sweden_Pound: folds 
Dachish: checks 
*** FLOP *** [Ts Qc Jh]
Dachish: checks 
florent502: checks 
*** TURN *** [Ts Qc Jh] [6s]
Dachish: checks 
florent502: bets $1
Dachish: folds 
Uncalled bet ($1) returned to florent502
florent502 collected $2.39 from pot
florent502: doesn't show hand 
*** SUMMARY ***
Total pot $2.50 | Rake $0.11 
Board [Ts Qc Jh 6s]
Seat 2: Dachish (big blind) folded on the Turn
Seat 3: florent502 collected ($2.39)
Seat 5: TheGentleFox folded before Flop (didn't bet)
Seat 6: Kukuryzka folded before Flop (didn't bet)
Seat 7: tipner folded before Flop (didn't bet)
Seat 8: matiko09 (button) folded before Flop (didn't bet)
Seat 9: Sweden_Pound (small blind) folded before Flop





PokerStars Hand #147753852615:  Hold'em No Limit ($0.50/$1.00 USD) - 2016/01/27 11:26:07 CET [2016/01/27 5:26:07 ET]
Table 'Delphinus II' 9-max Seat #5 is the button
Seat 1: Saintreine ($148.91 in chips) 
Seat 2: AlKatrone ($100 in chips) 
Seat 3: deepblue0000 ($326.02 in chips) 
Seat 4: matiko09 ($115.85 in chips) 
Seat 5: pandalapa ($101 in chips) 
Seat 8: mycka86 ($100 in chips) 
Seat 9: FGL-lucky ($55.88 in chips) 
Sweden_Pound will be allowed to play after the button
RUS)Timur will be allowed to play after the button
mycka86: posts small blind $0.50
FGL-lucky: posts big blind $1
*** HOLE CARDS ***
Dealt to matiko09 [7c 5c]
Saintreine: raises $1 to $2
AlKatrone: folds 
deepblue0000: folds 
matiko09: folds 
pandalapa: folds 
mycka86: calls $1.50
FGL-lucky: calls $1
*** FLOP *** [Ks 3c 3s]
mycka86: checks 
FGL-lucky: checks 
Saintreine: bets $3
mycka86: calls $3
FGL-lucky: folds 
*** TURN *** [Ks 3c 3s] [8h]
mycka86: bets $8
Saintreine: folds 
Uncalled bet ($8) returned to mycka86
mycka86 collected $11.46 from pot
*** SUMMARY ***
Total pot $12 | Rake $0.54 
Board [Ks 3c 3s 8h]
Seat 1: Saintreine folded on the Turn
Seat 2: AlKatrone folded before Flop (didn't bet)
Seat 3: deepblue0000 folded before Flop (didn't bet)
Seat 4: matiko09 folded before Flop (didn't bet)
Seat 5: pandalapa (button) folded before Flop (didn't bet)
Seat 8: mycka86 (small blind) collected ($11.46)
Seat 9: FGL-lucky (big blind) folded on the Flop





PokerStars Hand #147753853067:  Hold'em No Limit ($0.50/$1.00 USD) - 2016/01/27 11:26:07 CET [2016/01/27 5:26:07 ET]
Table 'Henyey' 9-max Seat #8 is the button
Seat 1: BurnsyT ($115.22 in chips) 
Seat 2: pandalapa ($103 in chips) 
Seat 3: deepblue0000 ($100 in chips) 
Seat 4: sylvian31 ($101.50 in chips) 
Seat 5: matiko09 ($109 in chips) 
Seat 7: Sweden_Pound ($110.68 in chips) 
Seat 8: CoolFireX ($113.60 in chips) 
Seat 9: mycka86 ($131.38 in chips) 
mycka86: posts small blind $0.50
BurnsyT: posts big blind $1
*** HOLE CARDS ***
Dealt to matiko09 [6d Kc]
pandalapa: folds 
deepblue0000: folds 
sylvian31: folds 
matiko09: folds 
Sweden_Pound: raises $1.50 to $2.50
CoolFireX: folds 
mycka86: calls $2
BurnsyT: folds 
*** FLOP *** [Jc 4c 3d]
mycka86: checks 
Sweden_Pound: checks 
*** TURN *** [Jc 4c 3d] [Js]
mycka86: bets $4
Sweden_Pound: folds 
Uncalled bet ($4) returned to mycka86
mycka86 collected $5.73 from pot
*** SUMMARY ***
Total pot $6 | Rake $0.27 
Board [Jc 4c 3d Js]
Seat 1: BurnsyT (big blind) folded before Flop
Seat 2: pandalapa folded before Flop (didn't bet)
Seat 3: deepblue0000 folded before Flop (didn't bet)
Seat 4: sylvian31 folded before Flop (didn't bet)
Seat 5: matiko09 folded before Flop (didn't bet)
Seat 7: Sweden_Pound folded on the Turn
Seat 8: CoolFireX (button) folded before Flop (didn't bet)
Seat 9: mycka86 (small blind) collected ($5.73)





PokerStars Hand #147753854574:  Hold'em No Limit ($0.50/$1.00 USD) - 2016/01/27 11:26:11 CET [2016/01/27 5:26:11 ET]
Table 'Helene III' 9-max Seat #9 is the button
Seat 1: UShallGimme$ ($102 in chips) 
Seat 2: Reven9er ($170.70 in chips) 
Seat 4: Sweden_Pound ($195.20 in chips) 
Seat 5: XMesuraX ($200.11 in chips) 
Seat 6: matiko09 ($111.82 in chips) 
Seat 7: di0d80 ($100 in chips) 
Seat 8: deepblue0000 ($109.64 in chips) 
Seat 9: Peu3aHy ($100 in chips) 
UShallGimme$: posts small blind $0.50
Reven9er: posts big blind $1
tipner: sits out 
*** HOLE CARDS ***
Dealt to matiko09 [6d Ks]
Sweden_Pound: folds 
XMesuraX: folds 
matiko09: folds 
di0d80: folds 
deepblue0000: folds 
Peu3aHy: folds 
UShallGimme$: folds 
Uncalled bet ($0.50) returned to Reven9er
Reven9er collected $1 from pot
Reven9er: doesn't show hand 
*** SUMMARY ***
Total pot $1 | Rake $0 
Seat 1: UShallGimme$ (small blind) folded before Flop
Seat 2: Reven9er (big blind) collected ($1)
Seat 4: Sweden_Pound folded before Flop (didn't bet)
Seat 5: XMesuraX folded before Flop (didn't bet)
Seat 6: matiko09 folded before Flop (didn't bet)
Seat 7: di0d80 folded before Flop (didn't bet)
Seat 8: deepblue0000 folded before Flop (didn't bet)
Seat 9: Peu3aHy (button) folded before Flop (didn't bet)





PokerStars Hand #147753855523:  Hold'em No Limit ($0.50/$1.00 USD) - 2016/01/27 11:26:12 CET [2016/01/27 5:26:12 ET]
Table 'Alkmene II' 9-max Seat #4 is the button
Seat 1: matiko09 ($100 in chips) 
Seat 2: deepblue0000 ($103.28 in chips) 
Seat 3: MuSaShiBuShi ($45.73 in chips) 
Seat 4: CoolFireX ($141.34 in chips) 
Seat 5: Sweden_Pound ($121.55 in chips) 
Seat 6: Peu3aHy ($100 in chips) 
Seat 7: mycka86 ($100 in chips) 
Seat 8: fecsok1 ($92.01 in chips) 
Seat 9: pandalapa ($100 in chips) 
Sweden_Pound: posts small blind $0.50
Peu3aHy: posts big blind $1
*** HOLE CARDS ***
Dealt to matiko09 [Td 2c]
mycka86: folds 
fecsok1: folds 
pandalapa: folds 
matiko09: folds 
deepblue0000: folds 
MuSaShiBuShi: folds 
CoolFireX: raises $1.50 to $2.50
Sweden_Pound: folds 
Peu3aHy: raises $4.50 to $7
CoolFireX: calls $4.50
*** FLOP *** [Qs 3d 8c]
Peu3aHy: bets $9
CoolFireX: folds 
Uncalled bet ($9) returned to Peu3aHy
Peu3aHy collected $13.85 from pot
Peu3aHy: doesn't show hand 
*** SUMMARY ***
Total pot $14.50 | Rake $0.65 
Board [Qs 3d 8c]
Seat 1: matiko09 folded before Flop (didn't bet)
Seat 2: deepblue0000 folded before Flop (didn't bet)
Seat 3: MuSaShiBuShi folded before Flop (didn't bet)
Seat 4: CoolFireX (button) folded on the Flop
Seat 5: Sweden_Pound (small blind) folded before Flop
Seat 6: Peu3aHy (big blind) collected ($13.85)
Seat 7: mycka86 folded before Flop (didn't bet)
Seat 8: fecsok1 folded before Flop (didn't bet)
Seat 9: pandalapa folded before Flop (didn't bet)





PokerStars Hand #147753856278:  Hold'em No Limit ($0.50/$1.00 USD) - 2016/01/27 11:26:14 CET [2016/01/27 5:26:14 ET]
Table 'Fragaria II' 9-max Seat #9 is the button
Seat 1: deepblue0000 ($106.28 in chips) 
Seat 2: GG-NoR34D. ($71.37 in chips) 
Seat 3: Sweden_Pound ($115.44 in chips) 
Seat 4: AlKatrone ($103 in chips) 
Seat 5: Venomous100% ($109.62 in chips) 
Seat 6: UShallGimme$ ($193.86 in chips) 
Seat 7: Hobby-.-AK ($36.71 in chips) 
Seat 8: mycka86 ($113.10 in chips) 
Seat 9: matiko09 ($100 in chips) 
deepblue0000: posts small blind $0.50
GG-NoR34D.: posts big blind $1
*** HOLE CARDS ***
Dealt to matiko09 [Jd Tc]
Sweden_Pound: folds 
AlKatrone: folds 
Venomous100%: raises $2 to $3
UShallGimme$: folds 
Hobby-.-AK: folds 
mycka86: folds 
matiko09: folds 
deepblue0000: folds 
GG-NoR34D.: folds 
Uncalled bet ($2) returned to Venomous100%
Venomous100% collected $2.50 from pot
Venomous100%: doesn't show hand 
*** SUMMARY ***
Total pot $2.50 | Rake $0 
Seat 1: deepblue0000 (small blind) folded before Flop
Seat 2: GG-NoR34D. (big blind) folded before Flop
Seat 3: Sweden_Pound folded before Flop (didn't bet)
Seat 4: AlKatrone folded before Flop (didn't bet)
Seat 5: Venomous100% collected ($2.50)
Seat 6: UShallGimme$ folded before Flop (didn't bet)
Seat 7: Hobby-.-AK folded before Flop (didn't bet)
Seat 8: mycka86 folded before Flop (didn't bet)
Seat 9: matiko09 (button) folded before Flop (didn't bet)





PokerStars Hand #147753869178:  Hold'em No Limit ($0.50/$1.00 USD) - 2016/01/27 11:26:40 CET [2016/01/27 5:26:40 ET]
Table 'Malzovia' 9-max Seat #3 is the button
Seat 1: mycka86 ($100 in chips) 
Seat 3: Reven9er ($100 in chips) 
Seat 4: AlKatrone ($100 in chips) 
Seat 5: matiko09 ($100 in chips) 
Seat 6: deepblue0000 ($318.49 in chips) 
Seat 7: Peu3aHy ($153.06 in chips) 
Seat 8: Ysatyss ($46.27 in chips) 
Seat 9: UShallGimme$ ($118.82 in chips) 
AlKatrone: posts small blind $0.50
matiko09: posts big blind $1
*** HOLE CARDS ***
Dealt to matiko09 [Qd 9d]
deepblue0000: folds 
Peu3aHy: folds 
Ysatyss: calls $1
UShallGimme$: raises $4 to $5
mycka86: folds 
Reven9er: folds 
AlKatrone: folds 
matiko09: folds 
Ysatyss: calls $4
*** FLOP *** [Ts Td 4h]
Ysatyss: checks 
UShallGimme$: checks 
*** TURN *** [Ts Td 4h] [5d]
Ysatyss: checks 
UShallGimme$: bets $3.50
Ysatyss: calls $3.50
*** RIVER *** [Ts Td 4h 5d] [Th]
Ysatyss: checks 
UShallGimme$: checks 
*** SHOW DOWN ***
Ysatyss: shows [3d 3s] (a full house, Tens full of Threes)
UShallGimme$: mucks hand 
Ysatyss collected $17.67 from pot
*** SUMMARY ***
Total pot $18.50 | Rake $0.83 
Board [Ts Td 4h 5d Th]
Seat 1: mycka86 folded before Flop (didn't bet)
Seat 3: Reven9er (button) folded before Flop (didn't bet)
Seat 4: AlKatrone (small blind) folded before Flop
Seat 5: matiko09 (big blind) folded before Flop
Seat 6: deepblue0000 folded before Flop (didn't bet)
Seat 7: Peu3aHy folded before Flop (didn't bet)
Seat 8: Ysatyss showed [3d 3s] and won ($17.67) with a full house, Tens full of Threes
Seat 9: UShallGimme$ mucked [Ad Kc]





PokerStars Hand #147753871625:  Hold'em No Limit ($0.50/$1.00 USD) - 2016/01/27 11:26:45 CET [2016/01/27 5:26:45 ET]
Table 'Helene III' 9-max Seat #1 is the button
Seat 1: UShallGimme$ ($101.50 in chips) 
Seat 2: Reven9er ($171.20 in chips) 
Seat 3: tipner ($100 in chips) 
Seat 4: Sweden_Pound ($195.20 in chips) 
Seat 5: XMesuraX ($200.11 in chips) 
Seat 6: matiko09 ($111.82 in chips) 
Seat 7: di0d80 ($100 in chips) 
Seat 8: deepblue0000 ($109.64 in chips) 
Seat 9: Peu3aHy ($100 in chips) 
Reven9er: posts small blind $0.50
tipner: posts big blind $1
*** HOLE CARDS ***
Dealt to matiko09 [4d 8s]
Sweden_Pound: raises $2 to $3
XMesuraX: calls $3
matiko09: folds 
di0d80: raises $9 to $12
deepblue0000: folds 
Peu3aHy: folds 
UShallGimme$: folds 
Reven9er: folds 
tipner: folds 
Sweden_Pound: folds 
XMesuraX: calls $9
*** FLOP *** [9h Jh 5h]
XMesuraX: checks 
di0d80: checks 
*** TURN *** [9h Jh 5h] [6h]
XMesuraX: bets $13.61
di0d80: calls $13.61
*** RIVER *** [9h Jh 5h 6h] [9c]
XMesuraX: bets $53.21
di0d80: folds 
Uncalled bet ($53.21) returned to XMesuraX
XMesuraX collected $53.21 from pot
XMesuraX: doesn't show hand 
*** SUMMARY ***
Total pot $55.72 | Rake $2.51 
Board [9h Jh 5h 6h 9c]
Seat 1: UShallGimme$ (button) folded before Flop (didn't bet)
Seat 2: Reven9er (small blind) folded before Flop
Seat 3: tipner (big blind) folded before Flop
Seat 4: Sweden_Pound folded before Flop
Seat 5: XMesuraX collected ($53.21)
Seat 6: matiko09 folded before Flop (didn't bet)
Seat 7: di0d80 folded on the River
Seat 8: deepblue0000 folded before Flop (didn't bet)
Seat 9: Peu3aHy folded before Flop (didn't bet)





PokerStars Hand #147753871963:  Hold'em No Limit ($0.50/$1.00 USD) - 2016/01/27 11:26:46 CET [2016/01/27 5:26:46 ET]
Table 'Nanking' 9-max Seat #9 is the button
Seat 2: Dachish ($91.92 in chips) 
Seat 3: florent502 ($41.39 in chips) 
Seat 5: TheGentleFox ($78 in chips) 
Seat 6: Kukuryzka ($100 in chips) 
Seat 7: tipner ($100 in chips) 
Seat 8: matiko09 ($100 in chips) 
Seat 9: Sweden_Pound ($104.64 in chips) 
Dachish: posts small blind $0.50
florent502: posts big blind $1
COOLIKO\/23: sits out 
*** HOLE CARDS ***
Dealt to matiko09 [6c Jh]
TheGentleFox: raises $1 to $2
Kukuryzka: folds 
tipner: folds 
matiko09: folds 
Sweden_Pound: folds 
Dachish: folds 
florent502: calls $1
*** FLOP *** [6d 7d 5d]
florent502: bets $1
TheGentleFox: folds 
Uncalled bet ($1) returned to florent502
florent502 collected $4.30 from pot
florent502: doesn't show hand 
*** SUMMARY ***
Total pot $4.50 | Rake $0.20 
Board [6d 7d 5d]
Seat 2: Dachish (small blind) folded before Flop
Seat 3: florent502 (big blind) collected ($4.30)
Seat 5: TheGentleFox folded on the Flop
Seat 6: Kukuryzka folded before Flop (didn't bet)
Seat 7: tipner folded before Flop (didn't bet)
Seat 8: matiko09 folded before Flop (didn't bet)
Seat 9: Sweden_Pound (button) folded before Flop (didn't bet)





PokerStars Hand #147753878308:  Hold'em No Limit ($0.50/$1.00 USD) - 2016/01/27 11:26:59 CET [2016/01/27 5:26:59 ET]
Table 'Siegena III' 9-max Seat #6 is the button
Seat 1: nnne409 ($73.16 in chips) 
Seat 2: tipner ($100 in chips) 
Seat 3: masaytoo ($93.25 in chips) 
Seat 4: Sweden_Pound ($100 in chips) 
Seat 5: matiko09 ($101 in chips) 
Seat 6: RUS)Timur ($144.07 in chips) 
Seat 7: sylvian31 ($100 in chips) 
Seat 8: Venomous100% ($100 in chips) 
Seat 9: di0d80 ($101 in chips) 
sylvian31: posts small blind $0.50
Venomous100%: posts big blind $1
*** HOLE CARDS ***
Dealt to matiko09 [Ks Jc]
di0d80: raises $1.50 to $2.50
nnne409: folds 
tipner: folds 
masaytoo: folds 
Sweden_Pound: folds 
matiko09: folds 
RUS)Timur: folds 
sylvian31: folds 
Venomous100%: folds 
Uncalled bet ($1.50) returned to di0d80
di0d80 collected $2.50 from pot
di0d80: doesn't show hand 
*** SUMMARY ***
Total pot $2.50 | Rake $0 
Seat 1: nnne409 folded before Flop (didn't bet)
Seat 2: tipner folded before Flop (didn't bet)
Seat 3: masaytoo folded before Flop (didn't bet)
Seat 4: Sweden_Pound folded before Flop (didn't bet)
Seat 5: matiko09 folded before Flop (didn't bet)
Seat 6: RUS)Timur (button) folded before Flop (didn't bet)
Seat 7: sylvian31 (small blind) folded before Flop
Seat 8: Venomous100% (big blind) folded before Flop
Seat 9: di0d80 collected ($2.50)





PokerStars Hand #147753878942:  Hold'em No Limit ($0.50/$1.00 USD) - 2016/01/27 11:27:00 CET [2016/01/27 5:27:00 ET]
Table 'Henyey' 9-max Seat #9 is the button
Seat 1: BurnsyT ($114.22 in chips) 
Seat 2: pandalapa ($103 in chips) 
Seat 3: deepblue0000 ($100 in chips) 
Seat 4: sylvian31 ($101.50 in chips) 
Seat 5: matiko09 ($109 in chips) 
Seat 7: Sweden_Pound ($108.18 in chips) 
Seat 8: CoolFireX ($113.60 in chips) 
Seat 9: mycka86 ($134.61 in chips) 
BurnsyT: posts small blind $0.50
pandalapa: posts big blind $1
*** HOLE CARDS ***
Dealt to matiko09 [4h Qc]
deepblue0000: folds 
sylvian31: raises $2 to $3
matiko09: folds 
Sweden_Pound: folds 
CoolFireX: folds 
mycka86: folds 
BurnsyT: folds 
pandalapa: folds 
Uncalled bet ($2) returned to sylvian31
sylvian31 collected $2.50 from pot
sylvian31: doesn't show hand 
*** SUMMARY ***
Total pot $2.50 | Rake $0 
Seat 1: BurnsyT (small blind) folded before Flop
Seat 2: pandalapa (big blind) folded before Flop
Seat 3: deepblue0000 folded before Flop (didn't bet)
Seat 4: sylvian31 collected ($2.50)
Seat 5: matiko09 folded before Flop (didn't bet)
Seat 7: Sweden_Pound folded before Flop (didn't bet)
Seat 8: CoolFireX folded before Flop (didn't bet)
Seat 9: mycka86 (button) folded before Flop (didn't bet)





PokerStars Hand #147753884165:  Hold'em No Limit ($0.50/$1.00 USD) - 2016/01/27 11:27:11 CET [2016/01/27 5:27:11 ET]
Table 'Eudora III' 9-max Seat #3 is the button
Seat 1: Eberhard314 ($128.80 in chips) 
Seat 3: matiko09 ($100 in chips) 
Seat 4: Reven9er ($100 in chips) 
Seat 5: di0d80 ($117.36 in chips) 
Seat 6: DIMAZAYAC ($64.98 in chips) 
Seat 7: Sweden_Pound ($101.50 in chips) 
Seat 8: RUS)Timur ($100 in chips) 
Seat 9: Venomous100% ($100 in chips) 
Reven9er: posts small blind $0.50
di0d80: posts big blind $1
GrossiM: sits out 
*** HOLE CARDS ***
Dealt to matiko09 [Kh 3d]
DIMAZAYAC: folds 
Sweden_Pound: folds 
RUS)Timur: folds 
Venomous100%: folds 
Eberhard314: folds 
Eberhard314 leaves the table
matiko09: folds 
Reven9er: raises $1.50 to $2.50
di0d80: calls $1.50
*** FLOP *** [6h As Tc]
Reven9er: bets $2.50
di0d80: folds 
Uncalled bet ($2.50) returned to Reven9er
Reven9er collected $4.78 from pot
Reven9er: doesn't show hand 
*** SUMMARY ***
Total pot $5 | Rake $0.22 
Board [6h As Tc]
Seat 1: Eberhard314 folded before Flop (didn't bet)
Seat 3: matiko09 (button) folded before Flop (didn't bet)
Seat 4: Reven9er (small blind) collected ($4.78)
Seat 5: di0d80 (big blind) folded on the Flop
Seat 6: DIMAZAYAC folded before Flop (didn't bet)
Seat 7: Sweden_Pound folded before Flop (didn't bet)
Seat 8: RUS)Timur folded before Flop (didn't bet)
Seat 9: Venomous100% folded before Flop (didn't bet)





PokerStars Hand #147753886372:  Hold'em No Limit ($0.50/$1.00 USD) - 2016/01/27 11:27:15 CET [2016/01/27 5:27:15 ET]
Table 'Palisana III' 9-max Seat #5 is the button
Seat 1: Largie1994 ($100.14 in chips) 
Seat 2: tipner ($100 in chips) 
Seat 3: Kukuryzka ($100 in chips) 
Seat 4: Reven9er ($100 in chips) 
Seat 5: di0d80 ($101.50 in chips) 
Seat 6: matiko09 ($113.73 in chips) 
Seat 7: Sweden_Pound ($100 in chips) 
Seat 8: COOLIKO\/23 ($100 in chips) 
Seat 9: monacomoritz ($95.50 in chips) 
matiko09: posts small blind $0.50
Sweden_Pound: posts big blind $1
*** HOLE CARDS ***
Dealt to matiko09 [4c 7c]
COOLIKO\/23: folds 
monacomoritz: folds 
Largie1994: folds 
tipner: raises $2 to $3
Kukuryzka: folds 
Reven9er: folds 
di0d80: folds 
matiko09: folds 
Sweden_Pound: folds 
Uncalled bet ($2) returned to tipner
tipner collected $2.50 from pot
tipner: doesn't show hand 
*** SUMMARY ***
Total pot $2.50 | Rake $0 
Seat 1: Largie1994 folded before Flop (didn't bet)
Seat 2: tipner collected ($2.50)
Seat 3: Kukuryzka folded before Flop (didn't bet)
Seat 4: Reven9er folded before Flop (didn't bet)
Seat 5: di0d80 (button) folded before Flop (didn't bet)
Seat 6: matiko09 (small blind) folded before Flop
Seat 7: Sweden_Pound (big blind) folded before Flop
Seat 8: COOLIKO\/23 folded before Flop (didn't bet)
Seat 9: monacomoritz folded before Flop (didn't bet)





PokerStars Hand #147753889216:  Hold'em No Limit ($0.50/$1.00 USD) - 2016/01/27 11:27:21 CET [2016/01/27 5:27:21 ET]
Table 'Delphinus II' 9-max Seat #8 is the button
Seat 1: Saintreine ($143.91 in chips) 
Seat 2: AlKatrone ($100 in chips) 
Seat 3: deepblue0000 ($326.02 in chips) 
Seat 4: matiko09 ($115.85 in chips) 
Seat 5: pandalapa ($101 in chips) 
Seat 8: mycka86 ($106.46 in chips) 
Seat 9: FGL-lucky ($53.88 in chips) 
FGL-lucky: posts small blind $0.50
Saintreine: posts big blind $1
Sweden_Pound: sits out 
RUS)Timur: sits out 
*** HOLE CARDS ***
Dealt to matiko09 [Qs 6d]
AlKatrone: folds 
deepblue0000: folds 
matiko09: folds 
pandalapa: raises $2 to $3
mycka86: calls $3
FGL-lucky: calls $2.50
Saintreine: folds 
*** FLOP *** [6h Kh 4s]
FGL-lucky: checks 
pandalapa: bets $5
mycka86: folds 
FGL-lucky: folds 
Uncalled bet ($5) returned to pandalapa
pandalapa collected $9.55 from pot
pandalapa: doesn't show hand 
*** SUMMARY ***
Total pot $10 | Rake $0.45 
Board [6h Kh 4s]
Seat 1: Saintreine (big blind) folded before Flop
Seat 2: AlKatrone folded before Flop (didn't bet)
Seat 3: deepblue0000 folded before Flop (didn't bet)
Seat 4: matiko09 folded before Flop (didn't bet)
Seat 5: pandalapa collected ($9.55)
Seat 8: mycka86 (button) folded on the Flop
Seat 9: FGL-lucky (small blind) folded on the Flop





PokerStars Hand #147753892927:  Hold'em No Limit ($0.50/$1.00 USD) - 2016/01/27 11:27:29 CET [2016/01/27 5:27:29 ET]
Table 'Alkmene II' 9-max Seat #5 is the button
Seat 1: matiko09 ($100 in chips) 
Seat 2: deepblue0000 ($103.28 in chips) 
Seat 3: MuSaShiBuShi ($45.73 in chips) 
Seat 4: CoolFireX ($134.34 in chips) 
Seat 5: Sweden_Pound ($121.05 in chips) 
Seat 6: Peu3aHy ($106.85 in chips) 
Seat 7: mycka86 ($100 in chips) 
Seat 8: fecsok1 ($92.01 in chips) 
Seat 9: pandalapa ($100 in chips) 
Peu3aHy: posts small blind $0.50
mycka86: posts big blind $1
*** HOLE CARDS ***
Dealt to matiko09 [5c 5h]
fecsok1: raises $1.50 to $2.50
pandalapa: folds 
matiko09: folds 
deepblue0000: folds 
MuSaShiBuShi: calls $2.50
CoolFireX: raises $10 to $12.50
Sweden_Pound: folds 
Peu3aHy: folds 
mycka86: folds 
fecsok1: folds 
MuSaShiBuShi: calls $10
*** FLOP *** [3c 6h Th]
MuSaShiBuShi: checks 
CoolFireX: bets $14.50
MuSaShiBuShi: folds 
Uncalled bet ($14.50) returned to CoolFireX
CoolFireX collected $27.70 from pot
CoolFireX: doesn't show hand 
*** SUMMARY ***
Total pot $29 | Rake $1.30 
Board [3c 6h Th]
Seat 1: matiko09 folded before Flop (didn't bet)
Seat 2: deepblue0000 folded before Flop (didn't bet)
Seat 3: MuSaShiBuShi folded on the Flop
Seat 4: CoolFireX collected ($27.70)
Seat 5: Sweden_Pound (button) folded before Flop (didn't bet)
Seat 6: Peu3aHy (small blind) folded before Flop
Seat 7: mycka86 (big blind) folded before Flop
Seat 8: fecsok1 folded before Flop
Seat 9: pandalapa folded before Flop (didn't bet)





PokerStars Hand #147753895382:  Hold'em No Limit ($0.50/$1.00 USD) - 2016/01/27 11:27:34 CET [2016/01/27 5:27:34 ET]
Table 'Nanking' 9-max Seat #2 is the button
Seat 2: Dachish ($91.42 in chips) 
Seat 3: florent502 ($43.69 in chips) 
Seat 4: COOLIKO\/23 ($100 in chips) 
Seat 5: TheGentleFox ($76 in chips) 
Seat 6: Kukuryzka ($100 in chips) 
Seat 7: tipner ($100 in chips) 
Seat 8: matiko09 ($100 in chips) 
Seat 9: Sweden_Pound ($104.64 in chips) 
florent502: posts small blind $0.50
COOLIKO\/23: posts big blind $1
*** HOLE CARDS ***
Dealt to matiko09 [6c 8s]
TheGentleFox: folds 
Kukuryzka: raises $2 to $3
tipner: folds 
matiko09: folds 
Sweden_Pound: folds 
Dachish: folds 
florent502: folds 
COOLIKO\/23: folds 
Uncalled bet ($2) returned to Kukuryzka
Kukuryzka collected $2.50 from pot
Kukuryzka: doesn't show hand 
*** SUMMARY ***
Total pot $2.50 | Rake $0 
Seat 2: Dachish (button) folded before Flop (didn't bet)
Seat 3: florent502 (small blind) folded before Flop
Seat 4: COOLIKO\/23 (big blind) folded before Flop
Seat 5: TheGentleFox folded before Flop (didn't bet)
Seat 6: Kukuryzka collected ($2.50)
Seat 7: tipner folded before Flop (didn't bet)
Seat 8: matiko09 folded before Flop (didn't bet)
Seat 9: Sweden_Pound folded before Flop (didn't bet)





PokerStars Hand #147753897474:  Hold'em No Limit ($0.50/$1.00 USD) - 2016/01/27 11:27:38 CET [2016/01/27 5:27:38 ET]
Table 'Fragaria II' 9-max Seat #1 is the button
Seat 1: deepblue0000 ($105.78 in chips) 
Seat 2: GG-NoR34D. ($70.37 in chips) 
Seat 3: Sweden_Pound ($115.44 in chips) 
Seat 4: AlKatrone ($103 in chips) 
Seat 5: Venomous100% ($111.12 in chips) 
Seat 6: UShallGimme$ ($193.86 in chips) 
Seat 7: Hobby-.-AK ($36.71 in chips) 
Seat 8: mycka86 ($113.10 in chips) 
Seat 9: matiko09 ($100 in chips) 
GG-NoR34D.: posts small blind $0.50
Sweden_Pound: posts big blind $1
*** HOLE CARDS ***
Dealt to matiko09 [Jc 5c]
AlKatrone: raises $2 to $3
Venomous100%: folds 
UShallGimme$: calls $3
Hobby-.-AK: folds 
mycka86: folds 
matiko09: folds 
deepblue0000: folds 
GG-NoR34D.: folds 
Sweden_Pound: folds 
*** FLOP *** [9d 4d 6h]
AlKatrone: checks 
UShallGimme$: bets $4.50
AlKatrone: folds 
Uncalled bet ($4.50) returned to UShallGimme$
UShallGimme$ collected $7.16 from pot
UShallGimme$: doesn't show hand 
*** SUMMARY ***
Total pot $7.50 | Rake $0.34 
Board [9d 4d 6h]
Seat 1: deepblue0000 (button) folded before Flop (didn't bet)
Seat 2: GG-NoR34D. (small blind) folded before Flop
Seat 3: Sweden_Pound (big blind) folded before Flop
Seat 4: AlKatrone folded on the Flop
Seat 5: Venomous100% folded before Flop (didn't bet)
Seat 6: UShallGimme$ collected ($7.16)
Seat 7: Hobby-.-AK folded before Flop (didn't bet)
Seat 8: mycka86 folded before Flop (didn't bet)
Seat 9: matiko09 folded before Flop (didn't bet)





PokerStars Hand #147753898847:  Hold'em No Limit ($0.50/$1.00 USD) - 2016/01/27 11:27:41 CET [2016/01/27 5:27:41 ET]
Table 'Malzovia' 9-max Seat #4 is the button
Seat 1: mycka86 ($100 in chips) 
Seat 3: Reven9er ($100 in chips) 
Seat 4: AlKatrone ($100 in chips) 
Seat 5: matiko09 ($100 in chips) 
Seat 6: deepblue0000 ($318.49 in chips) 
Seat 7: Peu3aHy ($153.06 in chips) 
Seat 8: Ysatyss ($55.44 in chips) 
Seat 9: UShallGimme$ ($110.32 in chips) 
matiko09: posts small blind $0.50
deepblue0000: posts big blind $1
*** HOLE CARDS ***
Dealt to matiko09 [6d 5d]
Peu3aHy: folds 
Ysatyss: folds 
UShallGimme$: folds 
mycka86: folds 
Reven9er: folds 
AlKatrone: raises $1 to $2
matiko09: folds 
deepblue0000: folds 
Uncalled bet ($1) returned to AlKatrone
AlKatrone collected $2.50 from pot
AlKatrone: doesn't show hand 
*** SUMMARY ***
Total pot $2.50 | Rake $0 
Seat 1: mycka86 folded before Flop (didn't bet)
Seat 3: Reven9er folded before Flop (didn't bet)
Seat 4: AlKatrone (button) collected ($2.50)
Seat 5: matiko09 (small blind) folded before Flop
Seat 6: deepblue0000 (big blind) folded before Flop
Seat 7: Peu3aHy folded before Flop (didn't bet)
Seat 8: Ysatyss folded before Flop (didn't bet)
Seat 9: UShallGimme$ folded before Flop (didn't bet)





PokerStars Hand #147753898874:  Hold'em No Limit ($0.50/$1.00 USD) - 2016/01/27 11:27:41 CET [2016/01/27 5:27:41 ET]
Table 'Siegena III' 9-max Seat #7 is the button
Seat 1: nnne409 ($73.16 in chips) 
Seat 2: tipner ($100 in chips) 
Seat 3: masaytoo ($93.25 in chips) 
Seat 4: Sweden_Pound ($100 in chips) 
Seat 5: matiko09 ($101 in chips) 
Seat 6: RUS)Timur ($144.07 in chips) 
Seat 7: sylvian31 ($100 in chips) 
Seat 8: Venomous100% ($100 in chips) 
Seat 9: di0d80 ($102.50 in chips) 
Venomous100%: posts small blind $0.50
di0d80: posts big blind $1
*** HOLE CARDS ***
Dealt to matiko09 [Th 2h]
nnne409: calls $1
tipner: folds 
masaytoo: folds 
Sweden_Pound: folds 
matiko09: folds 
RUS)Timur: folds 
sylvian31: folds 
Venomous100%: folds 
di0d80: checks 
*** FLOP *** [8s Qs Kh]
di0d80: bets $2
nnne409: calls $2
*** TURN *** [8s Qs Kh] [7c]
di0d80: bets $5
nnne409: calls $5
*** RIVER *** [8s Qs Kh 7c] [Kc]
di0d80: checks 
nnne409: bets $15.76
di0d80: raises $78.74 to $94.50 and is all-in
nnne409: folds 
Uncalled bet ($78.74) returned to di0d80
di0d80 collected $45.86 from pot
di0d80: doesn't show hand 
*** SUMMARY ***
Total pot $48.02 | Rake $2.16 
Board [8s Qs Kh 7c Kc]
Seat 1: nnne409 folded on the River
Seat 2: tipner folded before Flop (didn't bet)
Seat 3: masaytoo folded before Flop (didn't bet)
Seat 4: Sweden_Pound folded before Flop (didn't bet)
Seat 5: matiko09 folded before Flop (didn't bet)
Seat 6: RUS)Timur folded before Flop (didn't bet)
Seat 7: sylvian31 (button) folded before Flop (didn't bet)
Seat 8: Venomous100% (small blind) folded before Flop
Seat 9: di0d80 (big blind) collected ($45.86)





PokerStars Hand #147753900660:  Hold'em No Limit ($0.50/$1.00 USD) - 2016/01/27 11:27:44 CET [2016/01/27 5:27:44 ET]
Table 'Henyey' 9-max Seat #1 is the button
Seat 1: BurnsyT ($113.72 in chips) 
Seat 2: pandalapa ($102 in chips) 
Seat 3: deepblue0000 ($100 in chips) 
Seat 4: sylvian31 ($103 in chips) 
Seat 5: matiko09 ($109 in chips) 
Seat 7: Sweden_Pound ($108.18 in chips) 
Seat 8: CoolFireX ($113.60 in chips) 
Seat 9: mycka86 ($134.61 in chips) 
pandalapa: posts small blind $0.50
deepblue0000: posts big blind $1
*** HOLE CARDS ***
Dealt to matiko09 [7h Kd]
sylvian31: folds 
matiko09: folds 
Sweden_Pound: folds 
CoolFireX: folds 
mycka86: folds 
BurnsyT: calls $1
pandalapa: calls $0.50
deepblue0000: checks 
*** FLOP *** [5s 7s Ad]
pandalapa: checks 
deepblue0000: checks 
BurnsyT: checks 
*** TURN *** [5s 7s Ad] [8s]
pandalapa: checks 
deepblue0000: checks 
BurnsyT: checks 
*** RIVER *** [5s 7s Ad 8s] [Ah]
pandalapa: checks 
UShallGimme$ joins the table at seat #6 
deepblue0000: checks 
BurnsyT: checks 
*** SHOW DOWN ***
pandalapa: shows [Qd 9d] (a pair of Aces)
deepblue0000: shows [Kc 5d] (two pair, Aces and Fives)
BurnsyT: mucks hand 
deepblue0000 collected $2.86 from pot
*** SUMMARY ***
Total pot $3 | Rake $0.14 
Board [5s 7s Ad 8s Ah]
Seat 1: BurnsyT (button) mucked [Jd Kh]
Seat 2: pandalapa (small blind) showed [Qd 9d] and lost with a pair of Aces
Seat 3: deepblue0000 (big blind) showed [Kc 5d] and won ($2.86) with two pair, Aces and Fives
Seat 4: sylvian31 folded before Flop (didn't bet)
Seat 5: matiko09 folded before Flop (didn't bet)
Seat 7: Sweden_Pound folded before Flop (didn't bet)
Seat 8: CoolFireX folded before Flop (didn't bet)
Seat 9: mycka86 folded before Flop (didn't bet)





PokerStars Hand #147753908884:  Hold'em No Limit ($0.50/$1.00 USD) - 2016/01/27 11:28:01 CET [2016/01/27 5:28:01 ET]
Table 'Palisana III' 9-max Seat #6 is the button
Seat 1: Largie1994 ($100.14 in chips) 
Seat 2: tipner ($101.50 in chips) 
Seat 3: Kukuryzka ($100 in chips) 
Seat 4: Reven9er ($100 in chips) 
Seat 5: di0d80 ($101.50 in chips) 
Seat 6: matiko09 ($113.23 in chips) 
Seat 7: Sweden_Pound ($100 in chips) 
Seat 8: COOLIKO\/23 ($100 in chips) 
Seat 9: monacomoritz ($95.50 in chips) 
Sweden_Pound: posts small blind $0.50
COOLIKO\/23: posts big blind $1
*** HOLE CARDS ***
Dealt to matiko09 [5d 6c]
monacomoritz: folds 
Largie1994: folds 
tipner: folds 
Kukuryzka: folds 
Reven9er: folds 
di0d80: raises $1.50 to $2.50
matiko09: folds 
Sweden_Pound: folds 
COOLIKO\/23: folds 
Uncalled bet ($1.50) returned to di0d80
di0d80 collected $2.50 from pot
di0d80: doesn't show hand 
*** SUMMARY ***
Total pot $2.50 | Rake $0 
Seat 1: Largie1994 folded before Flop (didn't bet)
Seat 2: tipner folded before Flop (didn't bet)
Seat 3: Kukuryzka folded before Flop (didn't bet)
Seat 4: Reven9er folded before Flop (didn't bet)
Seat 5: di0d80 collected ($2.50)
Seat 6: matiko09 (button) folded before Flop (didn't bet)
Seat 7: Sweden_Pound (small blind) folded before Flop
Seat 8: COOLIKO\/23 (big blind) folded before Flop
Seat 9: monacomoritz folded before Flop (didn't bet)





PokerStars Hand #147753911759:  Hold'em No Limit ($0.50/$1.00 USD) - 2016/01/27 11:28:07 CET [2016/01/27 5:28:07 ET]
Table 'Nanking' 9-max Seat #3 is the button
Seat 2: Dachish ($91.42 in chips) 
Seat 3: florent502 ($43.19 in chips) 
Seat 4: COOLIKO\/23 ($100 in chips) 
Seat 5: TheGentleFox ($76 in chips) 
Seat 6: Kukuryzka ($101.50 in chips) 
Seat 7: tipner ($100 in chips) 
Seat 8: matiko09 ($100 in chips) 
Seat 9: Sweden_Pound ($104.64 in chips) 
COOLIKO\/23: posts small blind $0.50
TheGentleFox: posts big blind $1
*** HOLE CARDS ***
Dealt to matiko09 [Kc Js]
Kukuryzka: raises $2 to $3
tipner: folds 
matiko09: folds 
Sweden_Pound: folds 
Dachish: folds 
florent502: calls $3
COOLIKO\/23: folds 
TheGentleFox: folds 
*** FLOP *** [4c 9c 4s]
Kukuryzka: bets $3.58
florent502: calls $3.58
*** TURN *** [4c 9c 4s] [Qs]
Kukuryzka: checks 
florent502: bets $14
Kukuryzka: folds 
Uncalled bet ($14) returned to florent502
florent502 collected $14 from pot
florent502: doesn't show hand 
*** SUMMARY ***
Total pot $14.66 | Rake $0.66 
Board [4c 9c 4s Qs]
Seat 2: Dachish folded before Flop (didn't bet)
Seat 3: florent502 (button) collected ($14)
Seat 4: COOLIKO\/23 (small blind) folded before Flop
Seat 5: TheGentleFox (big blind) folded before Flop
Seat 6: Kukuryzka folded on the Turn
Seat 7: tipner folded before Flop (didn't bet)
Seat 8: matiko09 folded before Flop (didn't bet)
Seat 9: Sweden_Pound folded before Flop (didn't bet)





PokerStars Hand #147753919797:  Hold'em No Limit ($0.50/$1.00 USD) - 2016/01/27 11:28:23 CET [2016/01/27 5:28:23 ET]
Table 'Delphinus II' 9-max Seat #9 is the button
Seat 1: Saintreine ($142.91 in chips) 
Seat 2: AlKatrone ($100 in chips) 
Seat 3: deepblue0000 ($326.02 in chips) 
Seat 4: matiko09 ($115.85 in chips) 
Seat 5: pandalapa ($107.55 in chips) 
Seat 8: mycka86 ($103.46 in chips) 
Seat 9: FGL-lucky ($50.88 in chips) 
Saintreine: posts small blind $0.50
AlKatrone: posts big blind $1
Sweden_Pound: sits out 
RUS)Timur: sits out 
*** HOLE CARDS ***
Dealt to matiko09 [2h 7h]
deepblue0000: folds 
matiko09: folds 
pandalapa: folds 
mycka86: raises $1.10 to $2.10
FGL-lucky: folds 
Saintreine: raises $4.90 to $7
AlKatrone: folds 
mycka86: calls $4.90
*** FLOP *** [Td 4c 4h]
Saintreine: bets $10.16
mycka86: folds 
Uncalled bet ($10.16) returned to Saintreine
Saintreine collected $14.32 from pot
Saintreine: doesn't show hand 
*** SUMMARY ***
Total pot $15 | Rake $0.68 
Board [Td 4c 4h]
Seat 1: Saintreine (small blind) collected ($14.32)
Seat 2: AlKatrone (big blind) folded before Flop
Seat 3: deepblue0000 folded before Flop (didn't bet)
Seat 4: matiko09 folded before Flop (didn't bet)
Seat 5: pandalapa folded before Flop (didn't bet)
Seat 8: mycka86 folded on the Flop
Seat 9: FGL-lucky (button) folded before Flop (didn't bet)





PokerStars Hand #147753919667:  Hold'em No Limit ($0.50/$1.00 USD) - 2016/01/27 11:28:23 CET [2016/01/27 5:28:23 ET]
Table 'Eudora III' 9-max Seat #4 is the button
Seat 3: matiko09 ($100 in chips) 
Seat 4: Reven9er ($102.28 in chips) 
Seat 5: di0d80 ($114.86 in chips) 
Seat 6: DIMAZAYAC ($64.98 in chips) 
Seat 7: Sweden_Pound ($101.50 in chips) 
Seat 8: RUS)Timur ($100 in chips) 
Seat 9: Venomous100% ($100 in chips) 
di0d80: posts small blind $0.50
DIMAZAYAC: posts big blind $1
GrossiM: sits out 
*** HOLE CARDS ***
Dealt to matiko09 [4c Qc]
Sweden_Pound: folds 
RUS)Timur: raises $1.45 to $2.45
Venomous100%: folds 
matiko09: folds 
Reven9er: folds 
di0d80: calls $1.95
DIMAZAYAC: folds 
*** FLOP *** [4d 2s 8h]
di0d80: checks 
RUS)Timur: bets $2.76
di0d80: folds 
Uncalled bet ($2.76) returned to RUS)Timur
RUS)Timur collected $5.63 from pot
RUS)Timur: doesn't show hand 
*** SUMMARY ***
Total pot $5.90 | Rake $0.27 
Board [4d 2s 8h]
Seat 3: matiko09 folded before Flop (didn't bet)
Seat 4: Reven9er (button) folded before Flop (didn't bet)
Seat 5: di0d80 (small blind) folded on the Flop
Seat 6: DIMAZAYAC (big blind) folded before Flop
Seat 7: Sweden_Pound folded before Flop (didn't bet)
Seat 8: RUS)Timur collected ($5.63)
Seat 9: Venomous100% folded before Flop (didn't bet)





PokerStars Hand #147753919901:  Hold'em No Limit ($0.50/$1.00 USD) - 2016/01/27 11:28:24 CET [2016/01/27 5:28:24 ET]
Table 'Malzovia' 9-max Seat #5 is the button
Seat 1: mycka86 ($100 in chips) 
Seat 3: Reven9er ($100 in chips) 
Seat 4: AlKatrone ($101.50 in chips) 
Seat 5: matiko09 ($100 in chips) 
Seat 6: deepblue0000 ($317.49 in chips) 
Seat 7: Peu3aHy ($153.06 in chips) 
Seat 8: Ysatyss ($55.44 in chips) 
Seat 9: UShallGimme$ ($110.32 in chips) 
deepblue0000: posts small blind $0.50
Peu3aHy: posts big blind $1
*** HOLE CARDS ***
Dealt to matiko09 [6s 9h]
Ysatyss: raises $2 to $3
UShallGimme$: folds 
mycka86: folds 
Reven9er: folds 
AlKatrone: folds 
matiko09: folds 
deepblue0000: calls $2.50
Peu3aHy: folds 
*** FLOP *** [7h 2d Kc]
deepblue0000: checks 
Ysatyss: checks 
*** TURN *** [7h 2d Kc] [6d]
deepblue0000: checks 
Ysatyss: checks 
*** RIVER *** [7h 2d Kc 6d] [6c]
deepblue0000: bets $3.34
Ysatyss: folds 
Uncalled bet ($3.34) returned to deepblue0000
deepblue0000 collected $6.68 from pot
*** SUMMARY ***
Total pot $7 | Rake $0.32 
Board [7h 2d Kc 6d 6c]
Seat 1: mycka86 folded before Flop (didn't bet)
Seat 3: Reven9er folded before Flop (didn't bet)
Seat 4: AlKatrone folded before Flop (didn't bet)
Seat 5: matiko09 (button) folded before Flop (didn't bet)
Seat 6: deepblue0000 (small blind) collected ($6.68)
Seat 7: Peu3aHy (big blind) folded before Flop
Seat 8: Ysatyss folded on the River
Seat 9: UShallGimme$ folded before Flop (didn't bet)





PokerStars Hand #147753922637:  Hold'em No Limit ($0.50/$1.00 USD) - 2016/01/27 11:28:29 CET [2016/01/27 5:28:29 ET]
Table 'Alkmene II' 9-max Seat #6 is the button
Seat 1: matiko09 ($100 in chips) 
Seat 2: deepblue0000 ($103.28 in chips) 
Seat 3: MuSaShiBuShi ($33.23 in chips) 
Seat 4: CoolFireX ($149.54 in chips) 
Seat 5: Sweden_Pound ($121.05 in chips) 
Seat 6: Peu3aHy ($106.35 in chips) 
Seat 7: mycka86 ($100 in chips) 
Seat 8: fecsok1 ($89.51 in chips) 
Seat 9: pandalapa ($100 in chips) 
mycka86: posts small blind $0.50
fecsok1: posts big blind $1
*** HOLE CARDS ***
Dealt to matiko09 [2s Ad]
MuSaShiBuShi said, "  :@"
pandalapa: folds 
matiko09: folds 
deepblue0000: folds 
MuSaShiBuShi: raises $1.03 to $2.03
CoolFireX: raises $5.56 to $7.59
Sweden_Pound: folds 
Peu3aHy: folds 
mycka86: folds 
fecsok1: folds 
MuSaShiBuShi: folds 
Uncalled bet ($5.56) returned to CoolFireX
CoolFireX collected $5.56 from pot
CoolFireX: doesn't show hand 
*** SUMMARY ***
Total pot $5.56 | Rake $0 
Seat 1: matiko09 folded before Flop (didn't bet)
Seat 2: deepblue0000 folded before Flop (didn't bet)
Seat 3: MuSaShiBuShi folded before Flop
Seat 4: CoolFireX collected ($5.56)
Seat 5: Sweden_Pound folded before Flop (didn't bet)
Seat 6: Peu3aHy (button) folded before Flop (didn't bet)
Seat 7: mycka86 (small blind) folded before Flop
Seat 8: fecsok1 (big blind) folded before Flop
Seat 9: pandalapa folded before Flop (didn't bet)





PokerStars Hand #147753928537:  Hold'em No Limit ($0.50/$1.00 USD) - 2016/01/27 11:28:41 CET [2016/01/27 5:28:41 ET]
Table 'Palisana III' 9-max Seat #7 is the button
Seat 1: Largie1994 ($100.14 in chips) 
Seat 2: tipner ($101.50 in chips) 
Seat 3: Kukuryzka ($100 in chips) 
Seat 4: Reven9er ($100 in chips) 
Seat 5: di0d80 ($103 in chips) 
Seat 6: matiko09 ($113.23 in chips) 
Seat 7: Sweden_Pound ($100 in chips) 
Seat 8: COOLIKO\/23 ($100 in chips) 
Seat 9: monacomoritz ($95.50 in chips) 
COOLIKO\/23: posts small blind $0.50
monacomoritz: posts big blind $1
*** HOLE CARDS ***
Dealt to matiko09 [Tc Ad]
Largie1994: folds 
tipner: folds 
Kukuryzka: folds 
Reven9er: folds 
di0d80: folds 
matiko09: raises $1.50 to $2.50
Sweden_Pound: folds 
COOLIKO\/23: folds 
monacomoritz: folds 
Uncalled bet ($1.50) returned to matiko09
matiko09 collected $2.50 from pot
matiko09: doesn't show hand 
*** SUMMARY ***
Total pot $2.50 | Rake $0 
Seat 1: Largie1994 folded before Flop (didn't bet)
Seat 2: tipner folded before Flop (didn't bet)
Seat 3: Kukuryzka folded before Flop (didn't bet)
Seat 4: Reven9er folded before Flop (didn't bet)
Seat 5: di0d80 folded before Flop (didn't bet)
Seat 6: matiko09 collected ($2.50)
Seat 7: Sweden_Pound (button) folded before Flop (didn't bet)
Seat 8: COOLIKO\/23 (small blind) folded before Flop
Seat 9: monacomoritz (big blind) folded before Flop





PokerStars Hand #147753936368:  Hold'em No Limit ($0.50/$1.00 USD) - 2016/01/27 11:28:57 CET [2016/01/27 5:28:57 ET]
Table 'Alkmene II' 9-max Seat #7 is the button
Seat 1: matiko09 ($100 in chips) 
Seat 2: deepblue0000 ($103.28 in chips) 
Seat 3: MuSaShiBuShi ($31.20 in chips) 
Seat 4: CoolFireX ($153.07 in chips) 
Seat 5: Sweden_Pound ($121.05 in chips) 
Seat 6: Peu3aHy ($106.35 in chips) 
Seat 7: mycka86 ($100 in chips) 
Seat 8: fecsok1 ($88.51 in chips) 
Seat 9: pandalapa ($100 in chips) 
fecsok1: posts small blind $0.50
pandalapa: posts big blind $1
*** HOLE CARDS ***
Dealt to matiko09 [3s 2d]
matiko09: folds 
deepblue0000: folds 
MuSaShiBuShi: folds 
MuSaShiBuShi said, "NOT MY DAY"
CoolFireX: folds 
Sweden_Pound: folds 
Peu3aHy: raises $2 to $3
mycka86: folds 
fecsok1: calls $2.50
pandalapa: folds 
*** FLOP *** [5c 9d 4c]
fecsok1: checks 
Peu3aHy: bets $5
fecsok1: folds 
Uncalled bet ($5) returned to Peu3aHy
Peu3aHy collected $6.68 from pot
Peu3aHy: doesn't show hand 
*** SUMMARY ***
Total pot $7 | Rake $0.32 
Board [5c 9d 4c]
Seat 1: matiko09 folded before Flop (didn't bet)
Seat 2: deepblue0000 folded before Flop (didn't bet)
Seat 3: MuSaShiBuShi folded before Flop (didn't bet)
Seat 4: CoolFireX folded before Flop (didn't bet)
Seat 5: Sweden_Pound folded before Flop (didn't bet)
Seat 6: Peu3aHy collected ($6.68)
Seat 7: mycka86 (button) folded before Flop (didn't bet)
Seat 8: fecsok1 (small blind) folded on the Flop
Seat 9: pandalapa (big blind) folded before Flop





PokerStars Hand #147753936814:  Hold'em No Limit ($0.50/$1.00 USD) - 2016/01/27 11:28:58 CET [2016/01/27 5:28:58 ET]
Table 'Palisana III' 9-max Seat #8 is the button
Seat 1: Largie1994 ($100.14 in chips) 
Seat 2: tipner ($101.50 in chips) 
Seat 3: Kukuryzka ($100 in chips) 
Seat 4: Reven9er ($100 in chips) 
Seat 5: di0d80 ($103 in chips) 
Seat 6: matiko09 ($114.73 in chips) 
Seat 7: Sweden_Pound ($100 in chips) 
Seat 8: COOLIKO\/23 ($100 in chips) 
Seat 9: monacomoritz ($94.50 in chips) 
monacomoritz: posts small blind $0.50
Largie1994: posts big blind $1
*** HOLE CARDS ***
Dealt to matiko09 [2d 7d]
tipner: folds 
Kukuryzka: folds 
Reven9er: folds 
di0d80: folds 
matiko09: folds 
Sweden_Pound: folds 
COOLIKO\/23: folds 
monacomoritz: folds 
Uncalled bet ($0.50) returned to Largie1994
Largie1994 collected $1 from pot
*** SUMMARY ***
Total pot $1 | Rake $0 
Seat 1: Largie1994 (big blind) collected ($1)
Seat 2: tipner folded before Flop (didn't bet)
Seat 3: Kukuryzka folded before Flop (didn't bet)
Seat 4: Reven9er folded before Flop (didn't bet)
Seat 5: di0d80 folded before Flop (didn't bet)
Seat 6: matiko09 folded before Flop (didn't bet)
Seat 7: Sweden_Pound folded before Flop (didn't bet)
Seat 8: COOLIKO\/23 (button) folded before Flop (didn't bet)
Seat 9: monacomoritz (small blind) folded before Flop





PokerStars Hand #147753941587:  Hold'em No Limit ($0.50/$1.00 USD) - 2016/01/27 11:29:08 CET [2016/01/27 5:29:08 ET]
Table 'Helene III' 9-max Seat #2 is the button
Seat 1: UShallGimme$ ($101.50 in chips) 
Seat 2: Reven9er ($170.70 in chips) 
Seat 3: tipner ($100 in chips) 
Seat 4: Sweden_Pound ($192.20 in chips) 
Seat 5: XMesuraX ($227.71 in chips) 
Seat 6: matiko09 ($111.82 in chips) 
Seat 7: di0d80 ($100 in chips) 
Seat 8: deepblue0000 ($109.64 in chips) 
Seat 9: Peu3aHy ($100 in chips) 
tipner: posts small blind $0.50
Sweden_Pound: posts big blind $1
*** HOLE CARDS ***
Dealt to matiko09 [3s Jd]
XMesuraX: folds 
matiko09: folds 
di0d80: raises $1.50 to $2.50
deepblue0000: folds 
Peu3aHy: calls $2.50
UShallGimme$: raises $6.50 to $9
Reven9er: folds 
tipner: folds 
Sweden_Pound: folds 
di0d80: calls $6.50
Peu3aHy: raises $13 to $22
UShallGimme$: raises $79.50 to $101.50 and is all-in
di0d80: folds 
Peu3aHy: folds 
Uncalled bet ($79.50) returned to UShallGimme$
UShallGimme$ collected $54.50 from pot
UShallGimme$: doesn't show hand 
*** SUMMARY ***
Total pot $54.50 | Rake $0 
Seat 1: UShallGimme$ collected ($54.50)
Seat 2: Reven9er (button) folded before Flop (didn't bet)
Seat 3: tipner (small blind) folded before Flop
Seat 4: Sweden_Pound (big blind) folded before Flop
Seat 5: XMesuraX folded before Flop (didn't bet)
Seat 6: matiko09 folded before Flop (didn't bet)
Seat 7: di0d80 folded before Flop
Seat 8: deepblue0000 folded before Flop (didn't bet)
Seat 9: Peu3aHy folded before Flop





PokerStars Hand #147753941785:  Hold'em No Limit ($0.50/$1.00 USD) - 2016/01/27 11:29:08 CET [2016/01/27 5:29:08 ET]
Table 'Delphinus II' 9-max Seat #1 is the button
Seat 1: Saintreine ($150.23 in chips) 
Seat 2: AlKatrone ($100 in chips) 
Seat 3: deepblue0000 ($326.02 in chips) 
Seat 4: matiko09 ($115.85 in chips) 
Seat 5: pandalapa ($107.55 in chips) 
Seat 8: mycka86 ($100 in chips) 
Seat 9: FGL-lucky ($50.88 in chips) 
AlKatrone: posts small blind $0.50
deepblue0000: posts big blind $1
Sweden_Pound: sits out 
RUS)Timur: sits out 
*** HOLE CARDS ***
Dealt to matiko09 [5s 6s]
matiko09: folds 
pandalapa: folds 
mycka86: folds 
FGL-lucky: folds 
Saintreine: folds 
AlKatrone: folds 
Uncalled bet ($0.50) returned to deepblue0000
deepblue0000 collected $1 from pot
*** SUMMARY ***
Total pot $1 | Rake $0 
Seat 1: Saintreine (button) folded before Flop (didn't bet)
Seat 2: AlKatrone (small blind) folded before Flop
Seat 3: deepblue0000 (big blind) collected ($1)
Seat 4: matiko09 folded before Flop (didn't bet)
Seat 5: pandalapa folded before Flop (didn't bet)
Seat 8: mycka86 folded before Flop (didn't bet)
Seat 9: FGL-lucky folded before Flop (didn't bet)





PokerStars Hand #147753945377:  Hold'em No Limit ($0.50/$1.00 USD) - 2016/01/27 11:29:15 CET [2016/01/27 5:29:15 ET]
Table 'Henyey' 9-max Seat #2 is the button
Seat 1: BurnsyT ($112.72 in chips) 
Seat 2: pandalapa ($101 in chips) 
Seat 3: deepblue0000 ($101.86 in chips) 
Seat 4: sylvian31 ($103 in chips) 
Seat 5: matiko09 ($109 in chips) 
Seat 7: Sweden_Pound ($108.18 in chips) 
Seat 8: CoolFireX ($113.60 in chips) 
Seat 9: mycka86 ($134.61 in chips) 
deepblue0000: posts small blind $0.50
sylvian31: posts big blind $1
UShallGimme$: sits out 
*** HOLE CARDS ***
Dealt to matiko09 [5s 8d]
matiko09: folds 
Sweden_Pound: folds 
CoolFireX: folds 
mycka86: raises $1.50 to $2.50
BurnsyT: folds 
pandalapa: folds 
deepblue0000: folds 
sylvian31: calls $1.50
*** FLOP *** [Qd Jc Ac]
sylvian31: checks 
mycka86: checks 
*** TURN *** [Qd Jc Ac] [7s]
sylvian31: checks 
mycka86: checks 
*** RIVER *** [Qd Jc Ac 7s] [Qh]
sylvian31: checks 
mycka86: checks 
*** SHOW DOWN ***
sylvian31: shows [7c 5c] (two pair, Queens and Sevens)
mycka86: mucks hand 
sylvian31 collected $5.25 from pot
*** SUMMARY ***
Total pot $5.50 | Rake $0.25 
Board [Qd Jc Ac 7s Qh]
Seat 1: BurnsyT folded before Flop (didn't bet)
Seat 2: pandalapa (button) folded before Flop (didn't bet)
Seat 3: deepblue0000 (small blind) folded before Flop
Seat 4: sylvian31 (big blind) showed [7c 5c] and won ($5.25) with two pair, Queens and Sevens
Seat 5: matiko09 folded before Flop (didn't bet)
Seat 7: Sweden_Pound folded before Flop (didn't bet)
Seat 8: CoolFireX folded before Flop (didn't bet)
Seat 9: mycka86 mucked [4c 4h]





PokerStars Hand #147753946725:  Hold'em No Limit ($0.50/$1.00 USD) - 2016/01/27 11:29:18 CET [2016/01/27 5:29:18 ET]
Table 'Nanking' 9-max Seat #4 is the button
Seat 2: Dachish ($91.42 in chips) 
Seat 3: florent502 ($50.61 in chips) 
Seat 4: COOLIKO\/23 ($100 in chips) 
Seat 5: TheGentleFox ($75 in chips) 
Seat 6: Kukuryzka ($100 in chips) 
Seat 7: tipner ($100 in chips) 
Seat 8: matiko09 ($100 in chips) 
Seat 9: Sweden_Pound ($104.64 in chips) 
TheGentleFox: posts small blind $0.50
Kukuryzka: posts big blind $1
*** HOLE CARDS ***
Dealt to matiko09 [Qh 2s]
tipner: folds 
matiko09: folds 
Sweden_Pound: folds 
Dachish: raises $1 to $2
florent502: folds 
florent502 leaves the table
COOLIKO\/23: folds 
TheGentleFox: folds 
danuuutz joins the table at seat #3 
Kukuryzka: folds 
Uncalled bet ($1) returned to Dachish
Dachish collected $2.50 from pot
Dachish: doesn't show hand 
*** SUMMARY ***
Total pot $2.50 | Rake $0 
Seat 2: Dachish collected ($2.50)
Seat 3: florent502 folded before Flop (didn't bet)
Seat 4: COOLIKO\/23 (button) folded before Flop (didn't bet)
Seat 5: TheGentleFox (small blind) folded before Flop
Seat 6: Kukuryzka (big blind) folded before Flop
Seat 7: tipner folded before Flop (didn't bet)
Seat 8: matiko09 folded before Flop (didn't bet)
Seat 9: Sweden_Pound folded before Flop (didn't bet)





PokerStars Hand #147753948287:  Hold'em No Limit ($0.50/$1.00 USD) - 2016/01/27 11:29:21 CET [2016/01/27 5:29:21 ET]
Table 'Palisana III' 9-max Seat #9 is the button
Seat 1: Largie1994 ($100.64 in chips) 
Seat 2: tipner ($101.50 in chips) 
Seat 3: Kukuryzka ($100 in chips) 
Seat 4: Reven9er ($100 in chips) 
Seat 5: di0d80 ($103 in chips) 
Seat 6: matiko09 ($114.73 in chips) 
Seat 7: Sweden_Pound ($100 in chips) 
Seat 8: COOLIKO\/23 ($100 in chips) 
Seat 9: monacomoritz ($94 in chips) 
Largie1994: posts small blind $0.50
tipner: posts big blind $1
*** HOLE CARDS ***
Dealt to matiko09 [Ad Qd]
Kukuryzka: folds 
Reven9er: raises $1 to $2
di0d80: folds 
matiko09: calls $2
Sweden_Pound: folds 
COOLIKO\/23: folds 
monacomoritz: folds 
Largie1994: calls $1.50
tipner: folds 
*** FLOP *** [Ks 2h 9h]
Largie1994: checks 
Reven9er: bets $4
matiko09: folds 
Largie1994: folds 
Uncalled bet ($4) returned to Reven9er
Reven9er collected $6.68 from pot
Reven9er: doesn't show hand 
*** SUMMARY ***
Total pot $7 | Rake $0.32 
Board [Ks 2h 9h]
Seat 1: Largie1994 (small blind) folded on the Flop
Seat 2: tipner (big blind) folded before Flop
Seat 3: Kukuryzka folded before Flop (didn't bet)
Seat 4: Reven9er collected ($6.68)
Seat 5: di0d80 folded before Flop (didn't bet)
Seat 6: matiko09 folded on the Flop
Seat 7: Sweden_Pound folded before Flop (didn't bet)
Seat 8: COOLIKO\/23 folded before Flop (didn't bet)
Seat 9: monacomoritz (button) folded before Flop (didn't bet)





PokerStars Hand #147753949474:  Hold'em No Limit ($0.50/$1.00 USD) - 2016/01/27 11:29:24 CET [2016/01/27 5:29:24 ET]
Table 'Fragaria II' 9-max Seat #2 is the button
Seat 1: deepblue0000 ($105.78 in chips) 
Seat 2: GG-NoR34D. ($69.87 in chips) 
Seat 3: Sweden_Pound ($114.44 in chips) 
Seat 4: AlKatrone ($100 in chips) 
Seat 5: Venomous100% ($111.12 in chips) 
Seat 6: UShallGimme$ ($198.02 in chips) 
Seat 7: Hobby-.-AK ($36.71 in chips) 
Seat 8: mycka86 ($113.10 in chips) 
Seat 9: matiko09 ($100 in chips) 
Sweden_Pound: posts small blind $0.50
AlKatrone: posts big blind $1
*** HOLE CARDS ***
Dealt to matiko09 [7d 9s]
Venomous100%: raises $2 to $3
UShallGimme$: raises $6 to $9
Hobby-.-AK: folds 
mycka86: folds 
matiko09: folds 
deepblue0000: folds 
GG-NoR34D.: folds 
Sweden_Pound: folds 
AlKatrone: folds 
Venomous100%: folds 
Uncalled bet ($6) returned to UShallGimme$
UShallGimme$ collected $7.50 from pot
UShallGimme$: doesn't show hand 
*** SUMMARY ***
Total pot $7.50 | Rake $0 
Seat 1: deepblue0000 folded before Flop (didn't bet)
Seat 2: GG-NoR34D. (button) folded before Flop (didn't bet)
Seat 3: Sweden_Pound (small blind) folded before Flop
Seat 4: AlKatrone (big blind) folded before Flop
Seat 5: Venomous100% folded before Flop
Seat 6: UShallGimme$ collected ($7.50)
Seat 7: Hobby-.-AK folded before Flop (didn't bet)
Seat 8: mycka86 folded before Flop (didn't bet)
Seat 9: matiko09 folded before Flop (didn't bet)





PokerStars Hand #147753953807:  Hold'em No Limit ($0.50/$1.00 USD) - 2016/01/27 11:29:32 CET [2016/01/27 5:29:32 ET]
Table 'Alhajoth' 9-max Seat #8 is the button
Seat 1: UShallGimme$ ($108.25 in chips) 
Seat 2: matiko09 ($100 in chips) 
Seat 3: Sweden_Pound ($120.27 in chips) 
Seat 4: Venomous100% ($118.11 in chips) 
Seat 5: Kukuryzka ($100 in chips) 
Seat 6: RoadtoNepal ($192.80 in chips) 
Seat 7: Ohpeel ($116.85 in chips) 
Seat 8: deepblue0000 ($118.18 in chips) 
di0d80 will be allowed to play after the button
UShallGimme$: posts small blind $0.50
matiko09: posts big blind $1
*** HOLE CARDS ***
Dealt to matiko09 [4c 2h]
Sweden_Pound: folds 
Venomous100%: folds 
Kukuryzka: folds 
RoadtoNepal: folds 
Ohpeel: calls $1
deepblue0000: folds 
UShallGimme$: folds 
matiko09: checks 
*** FLOP *** [4d Ah Qh]
matiko09: checks 
Ohpeel: bets $2.39
matiko09: folds 
Uncalled bet ($2.39) returned to Ohpeel
Ohpeel collected $2.39 from pot
*** SUMMARY ***
Total pot $2.50 | Rake $0.11 
Board [4d Ah Qh]
Seat 1: UShallGimme$ (small blind) folded before Flop
Seat 2: matiko09 (big blind) folded on the Flop
Seat 3: Sweden_Pound folded before Flop (didn't bet)
Seat 4: Venomous100% folded before Flop (didn't bet)
Seat 5: Kukuryzka folded before Flop (didn't bet)
Seat 6: RoadtoNepal folded before Flop (didn't bet)
Seat 7: Ohpeel collected ($2.39)
Seat 8: deepblue0000 (button) folded before Flop (didn't bet)





PokerStars Hand #147753954664:  Hold'em No Limit ($0.50/$1.00 USD) - 2016/01/27 11:29:34 CET [2016/01/27 5:29:34 ET]
Table 'Delphinus II' 9-max Seat #2 is the button
Seat 1: Saintreine ($150.23 in chips) 
Seat 2: AlKatrone ($100 in chips) 
Seat 3: deepblue0000 ($326.52 in chips) 
Seat 4: matiko09 ($115.85 in chips) 
Seat 5: pandalapa ($107.55 in chips) 
Seat 8: mycka86 ($100 in chips) 
Seat 9: FGL-lucky ($50.88 in chips) 
deepblue0000: posts small blind $0.50
matiko09: posts big blind $1
Sweden_Pound: sits out 
RUS)Timur: sits out 
*** HOLE CARDS ***
Dealt to matiko09 [Tc Ah]
pandalapa: folds 
mycka86: folds 
FGL-lucky: folds 
Saintreine: folds 
AlKatrone: folds 
deepblue0000: raises $2 to $3
matiko09: calls $2
*** FLOP *** [Qc Js Kh]
deepblue0000: bets $2.86
matiko09: calls $2.86
*** TURN *** [Qc Js Kh] [9s]
deepblue0000: bets $5
matiko09: raises $10 to $15
deepblue0000: folds 
Uncalled bet ($10) returned to matiko09
matiko09 collected $20.74 from pot
matiko09: doesn't show hand 
*** SUMMARY ***
Total pot $21.72 | Rake $0.98 
Board [Qc Js Kh 9s]
Seat 1: Saintreine folded before Flop (didn't bet)
Seat 2: AlKatrone (button) folded before Flop (didn't bet)
Seat 3: deepblue0000 (small blind) folded on the Turn
Seat 4: matiko09 (big blind) collected ($20.74)
Seat 5: pandalapa folded before Flop (didn't bet)
Seat 8: mycka86 folded before Flop (didn't bet)
Seat 9: FGL-lucky folded before Flop (didn't bet)





PokerStars Hand #147753957784:  Hold'em No Limit ($0.50/$1.00 USD) - 2016/01/27 11:29:40 CET [2016/01/27 5:29:40 ET]
Table 'Malzovia' 9-max Seat #6 is the button
Seat 1: mycka86 ($100 in chips) 
Seat 3: Reven9er ($100 in chips) 
Seat 4: AlKatrone ($101.50 in chips) 
Seat 5: matiko09 ($100 in chips) 
Seat 6: deepblue0000 ($321.17 in chips) 
Seat 7: Peu3aHy ($152.06 in chips) 
Seat 8: Ysatyss ($52.44 in chips) 
Seat 9: UShallGimme$ ($110.32 in chips) 
Peu3aHy: posts small blind $0.50
Ysatyss: posts big blind $1
*** HOLE CARDS ***
Dealt to matiko09 [Ks 7d]
UShallGimme$: raises $2 to $3
mycka86: folds 
Reven9er: folds 
AlKatrone: raises $6 to $9
matiko09: folds 
deepblue0000: folds 
Peu3aHy: folds 
Ysatyss: calls $8
UShallGimme$: raises $21 to $30
AlKatrone: folds 
xJANN1x was removed from the table for failing to post
Ysatyss: raises $22.44 to $52.44 and is all-in
UShallGimme$: calls $22.44
Sweden_Pound joins the table at seat #2 
*** FLOP *** [Ts 4s 8h]
*** TURN *** [Ts 4s 8h] [9s]
*** RIVER *** [Ts 4s 8h 9s] [4d]
*** SHOW DOWN ***
Ysatyss: shows [Kc Ad] (a pair of Fours)
UShallGimme$: shows [Qd Qs] (two pair, Queens and Fours)
UShallGimme$ collected $111.58 from pot
*** SUMMARY ***
Total pot $114.38 | Rake $2.80 
Board [Ts 4s 8h 9s 4d]
Seat 1: mycka86 folded before Flop (didn't bet)
Seat 3: Reven9er folded before Flop (didn't bet)
Seat 4: AlKatrone folded before Flop
Seat 5: matiko09 folded before Flop (didn't bet)
Seat 6: deepblue0000 (button) folded before Flop (didn't bet)
Seat 7: Peu3aHy (small blind) folded before Flop
Seat 8: Ysatyss (big blind) showed [Kc Ad] and lost with a pair of Fours
Seat 9: UShallGimme$ showed [Qd Qs] and won ($111.58) with two pair, Queens and Fours





PokerStars Hand #147753959848:  Hold'em No Limit ($0.50/$1.00 USD) - 2016/01/27 11:29:44 CET [2016/01/27 5:29:44 ET]
Table 'Alkmene II' 9-max Seat #8 is the button
Seat 1: matiko09 ($100 in chips) 
Seat 2: deepblue0000 ($103.28 in chips) 
Seat 3: MuSaShiBuShi ($31.20 in chips) 
Seat 4: CoolFireX ($153.07 in chips) 
Seat 5: Sweden_Pound ($121.05 in chips) 
Seat 6: Peu3aHy ($110.03 in chips) 
Seat 7: mycka86 ($100 in chips) 
Seat 8: fecsok1 ($85.51 in chips) 
Seat 9: pandalapa ($100 in chips) 
pandalapa: posts small blind $0.50
matiko09: posts big blind $1
*** HOLE CARDS ***
Dealt to matiko09 [8h 4c]
deepblue0000: folds 
MuSaShiBuShi: folds 
CoolFireX: folds 
Sweden_Pound: folds 
Peu3aHy: folds 
mycka86: folds 
fecsok1: raises $1 to $2
pandalapa: folds 
matiko09: folds 
Uncalled bet ($1) returned to fecsok1
fecsok1 collected $2.50 from pot
*** SUMMARY ***
Total pot $2.50 | Rake $0 
Seat 1: matiko09 (big blind) folded before Flop
Seat 2: deepblue0000 folded before Flop (didn't bet)
Seat 3: MuSaShiBuShi folded before Flop (didn't bet)
Seat 4: CoolFireX folded before Flop (didn't bet)
Seat 5: Sweden_Pound folded before Flop (didn't bet)
Seat 6: Peu3aHy folded before Flop (didn't bet)
Seat 7: mycka86 folded before Flop (didn't bet)
Seat 8: fecsok1 (button) collected ($2.50)
Seat 9: pandalapa (small blind) folded before Flop





PokerStars Hand #147753959721:  Hold'em No Limit ($0.50/$1.00 USD) - 2016/01/27 11:29:44 CET [2016/01/27 5:29:44 ET]
Table 'Nanking' 9-max Seat #5 is the button
Seat 2: Dachish ($92.92 in chips) 
Seat 4: COOLIKO\/23 ($100 in chips) 
Seat 5: TheGentleFox ($74.50 in chips) 
Seat 6: Kukuryzka ($99 in chips) 
Seat 7: tipner ($100 in chips) 
Seat 8: matiko09 ($100 in chips) 
Seat 9: Sweden_Pound ($104.64 in chips) 
Kukuryzka: posts small blind $0.50
tipner: posts big blind $1
danuuutz: sits out 
*** HOLE CARDS ***
Dealt to matiko09 [9h 8c]
matiko09: folds 
Sweden_Pound: folds 
Dachish: folds 
COOLIKO\/23: raises $2 to $3
TheGentleFox: calls $3
danuuutz leaves the table
Kukuryzka: folds 
tipner: folds 
*** FLOP *** [9c 7s 4h]
COOLIKO\/23: checks 
nuaxin joins the table at seat #3 
TheGentleFox: bets $3.58
COOLIKO\/23: calls $3.58
*** TURN *** [9c 7s 4h] [Kc]
COOLIKO\/23: checks 
TheGentleFox: bets $7
COOLIKO\/23: calls $7
*** RIVER *** [9c 7s 4h Kc] [6s]
COOLIKO\/23: checks 
TheGentleFox: bets $13.68
RoadtoNepal leaves the table
COOLIKO\/23: calls $13.68
*** SHOW DOWN ***
TheGentleFox: shows [Ks Qs] (a pair of Kings)
COOLIKO\/23: shows [Kh Ad] (a pair of Kings - Ace kicker)
COOLIKO\/23 collected $53.50 from pot
*** SUMMARY ***
Total pot $56.02 | Rake $2.52 
Board [9c 7s 4h Kc 6s]
Seat 2: Dachish folded before Flop (didn't bet)
Seat 4: COOLIKO\/23 showed [Kh Ad] and won ($53.50) with a pair of Kings
Seat 5: TheGentleFox (button) showed [Ks Qs] and lost with a pair of Kings
Seat 6: Kukuryzka (small blind) folded before Flop
Seat 7: tipner (big blind) folded before Flop
Seat 8: matiko09 folded before Flop (didn't bet)
Seat 9: Sweden_Pound folded before Flop (didn't bet)





PokerStars Hand #147753961729:  Hold'em No Limit ($0.50/$1.00 USD) - 2016/01/27 11:29:48 CET [2016/01/27 5:29:48 ET]
Table 'Eudora III' 9-max Seat #5 is the button
Seat 3: matiko09 ($100 in chips) 
Seat 4: Reven9er ($102.28 in chips) 
Seat 5: di0d80 ($112.41 in chips) 
Seat 6: DIMAZAYAC ($63.98 in chips) 
Seat 7: Sweden_Pound ($101.50 in chips) 
Seat 8: RUS)Timur ($103.18 in chips) 
Seat 9: Venomous100% ($100 in chips) 
Peu3aHy joins the table at seat #1 
DIMAZAYAC: posts small blind $0.50
Sweden_Pound: posts big blind $1
GrossiM: sits out 
*** HOLE CARDS ***
Dealt to matiko09 [7s Kd]
RUS)Timur: folds 
Venomous100%: folds 
matiko09: folds 
Reven9er: raises $1 to $2
di0d80: folds 
DIMAZAYAC: folds 
Sweden_Pound: raises $5 to $7
Reven9er: raises $7 to $14
Sweden_Pound: folds 
Uncalled bet ($7) returned to Reven9er
Reven9er collected $14.50 from pot
Reven9er: doesn't show hand 
*** SUMMARY ***
Total pot $14.50 | Rake $0 
Seat 3: matiko09 folded before Flop (didn't bet)
Seat 4: Reven9er collected ($14.50)
Seat 5: di0d80 (button) folded before Flop (didn't bet)
Seat 6: DIMAZAYAC (small blind) folded before Flop
Seat 7: Sweden_Pound (big blind) folded before Flop
Seat 8: RUS)Timur folded before Flop (didn't bet)
Seat 9: Venomous100% folded before Flop (didn't bet)





PokerStars Hand #147753969358:  Hold'em No Limit ($0.50/$1.00 USD) - 2016/01/27 11:30:03 CET [2016/01/27 5:30:03 ET]
Table 'Fragaria II' 9-max Seat #3 is the button
Seat 1: deepblue0000 ($105.78 in chips) 
Seat 2: GG-NoR34D. ($69.87 in chips) 
Seat 3: Sweden_Pound ($113.94 in chips) 
Seat 4: AlKatrone ($100 in chips) 
Seat 5: Venomous100% ($108.12 in chips) 
Seat 6: UShallGimme$ ($202.52 in chips) 
Seat 7: Hobby-.-AK ($36.71 in chips) 
Seat 8: mycka86 ($113.10 in chips) 
Seat 9: matiko09 ($100 in chips) 
AlKatrone: posts small blind $0.50
Venomous100%: posts big blind $1
*** HOLE CARDS ***
Dealt to matiko09 [8d 5d]
UShallGimme$: folds 
Hobby-.-AK: folds 
mycka86: folds 
matiko09: folds 
deepblue0000: folds 
GG-NoR34D.: folds 
Sweden_Pound: folds 
AlKatrone: raises $2 to $3
Venomous100%: folds 
Uncalled bet ($2) returned to AlKatrone
AlKatrone collected $2 from pot
AlKatrone: doesn't show hand 
*** SUMMARY ***
Total pot $2 | Rake $0 
Seat 1: deepblue0000 folded before Flop (didn't bet)
Seat 2: GG-NoR34D. folded before Flop (didn't bet)
Seat 3: Sweden_Pound (button) folded before Flop (didn't bet)
Seat 4: AlKatrone (small blind) collected ($2)
Seat 5: Venomous100% (big blind) folded before Flop
Seat 6: UShallGimme$ folded before Flop (didn't bet)
Seat 7: Hobby-.-AK folded before Flop (didn't bet)
Seat 8: mycka86 folded before Flop (didn't bet)
Seat 9: matiko09 folded before Flop (didn't bet)





PokerStars Hand #147753972978:  Hold'em No Limit ($0.50/$1.00 USD) - 2016/01/27 11:30:11 CET [2016/01/27 5:30:11 ET]
Table 'Siegena III' 9-max Seat #8 is the button
Seat 1: nnne409 ($49.40 in chips) 
Seat 2: tipner ($100 in chips) 
Seat 3: masaytoo ($93.25 in chips) 
Seat 4: Sweden_Pound ($100 in chips) 
Seat 5: matiko09 ($101 in chips) 
Seat 6: RUS)Timur ($144.07 in chips) 
Seat 7: sylvian31 ($100 in chips) 
Seat 8: Venomous100% ($100 in chips) 
Seat 9: di0d80 ($124.60 in chips) 
di0d80: posts small blind $0.50
nnne409: posts big blind $1
*** HOLE CARDS ***
Dealt to matiko09 [Qc Jc]
tipner: raises $2 to $3
masaytoo: folds 
Sweden_Pound: folds 
matiko09: folds 
RUS)Timur: calls $3
sylvian31: folds 
Venomous100%: folds 
di0d80: folds 
nnne409: folds 
*** FLOP *** [7h 4s 8d]
tipner: checks 
RUS)Timur: bets $2.29
tipner: calls $2.29
*** TURN *** [7h 4s 8d] [6c]
tipner: checks 
RUS)Timur: bets $6
tipner: folds 
Uncalled bet ($6) returned to RUS)Timur
RUS)Timur collected $11.54 from pot
RUS)Timur: doesn't show hand 
*** SUMMARY ***
Total pot $12.08 | Rake $0.54 
Board [7h 4s 8d 6c]
Seat 1: nnne409 (big blind) folded before Flop
Seat 2: tipner folded on the Turn
Seat 3: masaytoo folded before Flop (didn't bet)
Seat 4: Sweden_Pound folded before Flop (didn't bet)
Seat 5: matiko09 folded before Flop (didn't bet)
Seat 6: RUS)Timur collected ($11.54)
Seat 7: sylvian31 folded before Flop (didn't bet)
Seat 8: Venomous100% (button) folded before Flop (didn't bet)
Seat 9: di0d80 (small blind) folded before Flop





PokerStars Hand #147753974041:  Hold'em No Limit ($0.50/$1.00 USD) - 2016/01/27 11:30:13 CET [2016/01/27 5:30:13 ET]
Table 'Alhajoth' 9-max Seat #1 is the button
Seat 1: UShallGimme$ ($107.75 in chips) 
Seat 2: matiko09 ($100 in chips) 
Seat 3: Sweden_Pound ($120.27 in chips) 
Seat 4: Venomous100% ($118.11 in chips) 
Seat 5: Kukuryzka ($100 in chips) 
Seat 6: RoadtoNepal ($192.80 in chips) 
Seat 7: Ohpeel ($118.24 in chips) 
Seat 8: deepblue0000 ($118.18 in chips) 
matiko09: posts small blind $0.50
Sweden_Pound: posts big blind $1
di0d80: sits out 
*** HOLE CARDS ***
Dealt to matiko09 [Td 5c]
Venomous100%: raises $2 to $3
Kukuryzka: folds 
RoadtoNepal: folds 
Ohpeel: folds 
deepblue0000: folds 
UShallGimme$: folds 
matiko09: folds 
Sweden_Pound: folds 
Uncalled bet ($2) returned to Venomous100%
Venomous100% collected $2.50 from pot
Venomous100%: doesn't show hand 
*** SUMMARY ***
Total pot $2.50 | Rake $0 
Seat 1: UShallGimme$ (button) folded before Flop (didn't bet)
Seat 2: matiko09 (small blind) folded before Flop
Seat 3: Sweden_Pound (big blind) folded before Flop
Seat 4: Venomous100% collected ($2.50)
Seat 5: Kukuryzka folded before Flop (didn't bet)
Seat 6: RoadtoNepal folded before Flop (didn't bet)
Seat 7: Ohpeel folded before Flop (didn't bet)
Seat 8: deepblue0000 folded before Flop (didn't bet)





PokerStars Hand #147753977211:  Hold'em No Limit ($0.50/$1.00 USD) - 2016/01/27 11:30:19 CET [2016/01/27 5:30:19 ET]
Table 'Henyey' 9-max Seat #3 is the button
Seat 1: BurnsyT ($112.72 in chips) 
Seat 2: pandalapa ($101 in chips) 
Seat 3: deepblue0000 ($101.36 in chips) 
Seat 4: sylvian31 ($105.75 in chips) 
Seat 5: matiko09 ($109 in chips) 
Seat 7: Sweden_Pound ($108.18 in chips) 
Seat 8: CoolFireX ($113.60 in chips) 
Seat 9: mycka86 ($132.11 in chips) 
sylvian31: posts small blind $0.50
matiko09: posts big blind $1
UShallGimme$: sits out 
*** HOLE CARDS ***
Dealt to matiko09 [Js 5h]
Sweden_Pound: folds 
CoolFireX: folds 
mycka86: folds 
BurnsyT: folds 
pandalapa: folds 
deepblue0000: folds 
sylvian31: raises $2 to $3
matiko09: folds 
Uncalled bet ($2) returned to sylvian31
sylvian31 collected $2 from pot
sylvian31: doesn't show hand 
*** SUMMARY ***
Total pot $2 | Rake $0 
Seat 1: BurnsyT folded before Flop (didn't bet)
Seat 2: pandalapa folded before Flop (didn't bet)
Seat 3: deepblue0000 (button) folded before Flop (didn't bet)
Seat 4: sylvian31 (small blind) collected ($2)
Seat 5: matiko09 (big blind) folded before Flop
Seat 7: Sweden_Pound folded before Flop (didn't bet)
Seat 8: CoolFireX folded before Flop (didn't bet)
Seat 9: mycka86 folded before Flop (didn't bet)





PokerStars Hand #147753977604:  Hold'em No Limit ($0.50/$1.00 USD) - 2016/01/27 11:30:20 CET [2016/01/27 5:30:20 ET]
Table 'Alkmene II' 9-max Seat #9 is the button
Seat 1: matiko09 ($100 in chips) 
Seat 2: deepblue0000 ($103.28 in chips) 
Seat 3: MuSaShiBuShi ($31.20 in chips) 
Seat 4: CoolFireX ($153.07 in chips) 
Seat 5: Sweden_Pound ($121.05 in chips) 
Seat 6: Peu3aHy ($110.03 in chips) 
Seat 7: mycka86 ($100 in chips) 
Seat 8: fecsok1 ($87.01 in chips) 
Seat 9: pandalapa ($100 in chips) 
matiko09: posts small blind $0.50
deepblue0000: posts big blind $1
*** HOLE CARDS ***
Dealt to matiko09 [Ks 2s]
MuSaShiBuShi: raises $1.09 to $2.09
CoolFireX: folds 
Sweden_Pound: folds 
Peu3aHy: folds 
mycka86: folds 
fecsok1: folds 
pandalapa: folds 
matiko09: folds 
deepblue0000: calls $1.09
*** FLOP *** [4c Kh 9c]
deepblue0000: checks 
MuSaShiBuShi: bets $4.47
deepblue0000: folds 
Uncalled bet ($4.47) returned to MuSaShiBuShi
MuSaShiBuShi collected $4.47 from pot
MuSaShiBuShi: doesn't show hand 
*** SUMMARY ***
Total pot $4.68 | Rake $0.21 
Board [4c Kh 9c]
Seat 1: matiko09 (small blind) folded before Flop
Seat 2: deepblue0000 (big blind) folded on the Flop
Seat 3: MuSaShiBuShi collected ($4.47)
Seat 4: CoolFireX folded before Flop (didn't bet)
Seat 5: Sweden_Pound folded before Flop (didn't bet)
Seat 6: Peu3aHy folded before Flop (didn't bet)
Seat 7: mycka86 folded before Flop (didn't bet)
Seat 8: fecsok1 folded before Flop (didn't bet)
Seat 9: pandalapa (button) folded before Flop (didn't bet)





PokerStars Hand #147753987945:  Hold'em No Limit ($0.50/$1.00 USD) - 2016/01/27 11:30:41 CET [2016/01/27 5:30:41 ET]
Table 'Eudora III' 9-max Seat #6 is the button
Seat 3: matiko09 ($100 in chips) 
Seat 4: Reven9er ($109.78 in chips) 
Seat 5: di0d80 ($112.41 in chips) 
Seat 6: DIMAZAYAC ($63.48 in chips) 
Seat 7: Sweden_Pound ($100 in chips) 
Seat 8: RUS)Timur ($103.18 in chips) 
Seat 9: Venomous100% ($100 in chips) 
Sweden_Pound: posts small blind $0.50
RUS)Timur: posts big blind $1
Peu3aHy: sits out 
GrossiM: sits out 
*** HOLE CARDS ***
Dealt to matiko09 [2c Ac]
Venomous100%: folds 
matiko09: raises $2 to $3
Reven9er: folds 
di0d80: folds 
DIMAZAYAC: folds 
Sweden_Pound: folds 
RUS)Timur: folds 
Uncalled bet ($2) returned to matiko09
matiko09 collected $2.50 from pot
matiko09: doesn't show hand 
*** SUMMARY ***
Total pot $2.50 | Rake $0 
Seat 3: matiko09 collected ($2.50)
Seat 4: Reven9er folded before Flop (didn't bet)
Seat 5: di0d80 folded before Flop (didn't bet)
Seat 6: DIMAZAYAC (button) folded before Flop (didn't bet)
Seat 7: Sweden_Pound (small blind) folded before Flop
Seat 8: RUS)Timur (big blind) folded before Flop
Seat 9: Venomous100% folded before Flop (didn't bet)





PokerStars Hand #147753987764:  Hold'em No Limit ($0.50/$1.00 USD) - 2016/01/27 11:30:41 CET [2016/01/27 5:30:41 ET]
Table 'Delphinus II' 9-max Seat #3 is the button
Seat 1: Saintreine ($150.23 in chips) 
Seat 2: AlKatrone ($100 in chips) 
Seat 3: deepblue0000 ($315.66 in chips) 
Seat 4: matiko09 ($125.73 in chips) 
Seat 5: pandalapa ($107.55 in chips) 
Seat 8: mycka86 ($100 in chips) 
Seat 9: FGL-lucky ($50.88 in chips) 
matiko09: posts small blind $0.50
pandalapa: posts big blind $1
Sweden_Pound: sits out 
RUS)Timur: sits out 
*** HOLE CARDS ***
Dealt to matiko09 [4d Ac]
mycka86: folds 
FGL-lucky: raises $2 to $3
Saintreine: folds 
AlKatrone: folds 
deepblue0000: folds 
matiko09: folds 
pandalapa: folds 
Uncalled bet ($2) returned to FGL-lucky
FGL-lucky collected $2.50 from pot
FGL-lucky: doesn't show hand 
*** SUMMARY ***
Total pot $2.50 | Rake $0 
Seat 1: Saintreine folded before Flop (didn't bet)
Seat 2: AlKatrone folded before Flop (didn't bet)
Seat 3: deepblue0000 (button) folded before Flop (didn't bet)
Seat 4: matiko09 (small blind) folded before Flop
Seat 5: pandalapa (big blind) folded before Flop
Seat 8: mycka86 folded before Flop (didn't bet)
Seat 9: FGL-lucky collected ($2.50)





PokerStars Hand #147753989309:  Hold'em No Limit ($0.50/$1.00 USD) - 2016/01/27 11:30:44 CET [2016/01/27 5:30:44 ET]
Table 'Alhajoth' 9-max Seat #2 is the button
Seat 1: UShallGimme$ ($107.75 in chips) 
Seat 2: matiko09 ($100 in chips) 
Seat 3: Sweden_Pound ($119.27 in chips) 
Seat 4: Venomous100% ($119.61 in chips) 
Seat 5: Kukuryzka ($100 in chips) 
Seat 6: RoadtoNepal ($192.80 in chips) 
Seat 7: Ohpeel ($118.24 in chips) 
Seat 8: deepblue0000 ($118.18 in chips) 
Sweden_Pound: posts small blind $0.50
Venomous100%: posts big blind $1
di0d80: sits out 
*** HOLE CARDS ***
Dealt to matiko09 [Th 5d]
Kukuryzka: raises $2 to $3
RoadtoNepal: folds 
Ohpeel: folds 
deepblue0000: folds 
UShallGimme$: calls $3
matiko09: folds 
Sweden_Pound: calls $2.50
Venomous100%: calls $2
*** FLOP *** [8s 4c 9d]
Sweden_Pound: checks 
Venomous100%: checks 
Kukuryzka: checks 
UShallGimme$: checks 
*** TURN *** [8s 4c 9d] [Qd]
Sweden_Pound: checks 
Venomous100%: bets $7.56
Kukuryzka: folds 
UShallGimme$: folds 
Sweden_Pound: folds 
Uncalled bet ($7.56) returned to Venomous100%
Venomous100% collected $11.46 from pot
Venomous100%: doesn't show hand 
*** SUMMARY ***
Total pot $12 | Rake $0.54 
Board [8s 4c 9d Qd]
Seat 1: UShallGimme$ folded on the Turn
Seat 2: matiko09 (button) folded before Flop (didn't bet)
Seat 3: Sweden_Pound (small blind) folded on the Turn
Seat 4: Venomous100% (big blind) collected ($11.46)
Seat 5: Kukuryzka folded on the Turn
Seat 6: RoadtoNepal folded before Flop (didn't bet)
Seat 7: Ohpeel folded before Flop (didn't bet)
Seat 8: deepblue0000 folded before Flop (didn't bet)





PokerStars Hand #147753989682:  Hold'em No Limit ($0.50/$1.00 USD) - 2016/01/27 11:30:44 CET [2016/01/27 5:30:44 ET]
Table 'Henyey' 9-max Seat #4 is the button
Seat 1: BurnsyT ($112.72 in chips) 
Seat 2: pandalapa ($101 in chips) 
Seat 3: deepblue0000 ($101.36 in chips) 
Seat 4: sylvian31 ($106.75 in chips) 
Seat 5: matiko09 ($108 in chips) 
Seat 6: UShallGimme$ ($100 in chips) 
Seat 7: Sweden_Pound ($108.18 in chips) 
Seat 8: CoolFireX ($113.60 in chips) 
Seat 9: mycka86 ($132.11 in chips) 
matiko09: posts small blind $0.50
UShallGimme$: posts big blind $1
*** HOLE CARDS ***
Dealt to matiko09 [4s 9d]
Sweden_Pound: raises $2 to $3
CoolFireX: folds 
mycka86: folds 
BurnsyT: calls $3
pandalapa: calls $3
deepblue0000: folds 
sylvian31: folds 
matiko09: folds 
UShallGimme$: raises $11 to $14
Sweden_Pound: folds 
BurnsyT: folds 
pandalapa: raises $87 to $101 and is all-in
UShallGimme$: calls $86 and is all-in
Uncalled bet ($1) returned to pandalapa
*** FIRST FLOP *** [Qd 6d 8d]
*** FIRST TURN *** [Qd 6d 8d] [2d]
*** FIRST RIVER *** [Qd 6d 8d 2d] [8h]
*** SECOND FLOP *** [3d Ks Ad]
*** SECOND TURN *** [3d Ks Ad] [Ts]
*** SECOND RIVER *** [3d Ks Ad Ts] [3s]
*** FIRST SHOW DOWN ***
UShallGimme$: shows [Kh Ac] (a pair of Eights)
pandalapa: shows [Kd As] (a flush, King high)
pandalapa collected $101.85 from pot
*** SECOND SHOW DOWN ***
UShallGimme$: shows [Kh Ac] (two pair, Aces and Kings)
pandalapa: shows [Kd As] (two pair, Aces and Kings)
UShallGimme$ collected $50.93 from pot
pandalapa collected $50.92 from pot
*** SUMMARY ***
Total pot $206.50 | Rake $2.80 
Hand was run twice
FIRST Board [Qd 6d 8d 2d 8h]
SECOND Board [3d Ks Ad Ts 3s]
Seat 1: BurnsyT folded before Flop
Seat 2: pandalapa showed [Kd As] and won ($101.85) with a flush, King high, and won ($50.92) with two pair, Aces and Kings
Seat 3: deepblue0000 folded before Flop (didn't bet)
Seat 4: sylvian31 (button) folded before Flop (didn't bet)
Seat 5: matiko09 (small blind) folded before Flop
Seat 6: UShallGimme$ (big blind) showed [Kh Ac] and lost with a pair of Eights, and won ($50.93) with two pair, Aces and Kings
Seat 7: Sweden_Pound folded before Flop
Seat 8: CoolFireX folded before Flop (didn't bet)
Seat 9: mycka86 folded before Flop (didn't bet)





PokerStars Hand #147753990409:  Hold'em No Limit ($0.50/$1.00 USD) - 2016/01/27 11:30:46 CET [2016/01/27 5:30:46 ET]
Table 'Palisana III' 9-max Seat #1 is the button
Seat 1: Largie1994 ($98.64 in chips) 
Seat 2: tipner ($100.50 in chips) 
Seat 3: Kukuryzka ($100 in chips) 
Seat 4: Reven9er ($104.68 in chips) 
Seat 5: di0d80 ($103 in chips) 
Seat 6: matiko09 ($112.73 in chips) 
Seat 7: Sweden_Pound ($100 in chips) 
Seat 8: COOLIKO\/23 ($100 in chips) 
Seat 9: monacomoritz ($94 in chips) 
tipner: posts small blind $0.50
Kukuryzka: posts big blind $1
*** HOLE CARDS ***
Dealt to matiko09 [As 4c]
Reven9er: folds 
di0d80: folds 
matiko09: folds 
Sweden_Pound: folds 
COOLIKO\/23: folds 
monacomoritz: calls $1
Largie1994: raises $2 to $3
tipner: folds 
Kukuryzka: folds 
monacomoritz: calls $2
*** FLOP *** [8d Qh Ac]
monacomoritz: bets $3.58
Largie1994: calls $3.58
*** TURN *** [8d Qh Ac] [Tc]
monacomoritz: bets $7
Largie1994: folds [Kh Ks]
Uncalled bet ($7) returned to monacomoritz
monacomoritz collected $14 from pot
*** SUMMARY ***
Total pot $14.66 | Rake $0.66 
Board [8d Qh Ac Tc]
Seat 1: Largie1994 (button) folded on the Turn
Seat 2: tipner (small blind) folded before Flop
Seat 3: Kukuryzka (big blind) folded before Flop
Seat 4: Reven9er folded before Flop (didn't bet)
Seat 5: di0d80 folded before Flop (didn't bet)
Seat 6: matiko09 folded before Flop (didn't bet)
Seat 7: Sweden_Pound folded before Flop (didn't bet)
Seat 8: COOLIKO\/23 folded before Flop (didn't bet)
Seat 9: monacomoritz collected ($14)





PokerStars Hand #147753993376:  Hold'em No Limit ($0.50/$1.00 USD) - 2016/01/27 11:30:52 CET [2016/01/27 5:30:52 ET]
Table 'Fragaria II' 9-max Seat #4 is the button
Seat 1: deepblue0000 ($105.78 in chips) 
Seat 2: GG-NoR34D. ($69.87 in chips) 
Seat 3: Sweden_Pound ($113.94 in chips) 
Seat 4: AlKatrone ($101 in chips) 
Seat 5: Venomous100% ($107.12 in chips) 
Seat 6: UShallGimme$ ($202.52 in chips) 
Seat 7: Hobby-.-AK ($36.71 in chips) 
Seat 8: mycka86 ($113.10 in chips) 
Seat 9: matiko09 ($100 in chips) 
Venomous100%: posts small blind $0.50
UShallGimme$: posts big blind $1
*** HOLE CARDS ***
Dealt to matiko09 [3h 4c]
Hobby-.-AK: calls $1
mycka86: folds 
matiko09: folds 
deepblue0000: folds 
GG-NoR34D.: folds 
Sweden_Pound: raises $3 to $4
AlKatrone: folds 
Venomous100%: folds 
UShallGimme$: folds 
Hobby-.-AK: calls $3
*** FLOP *** [8s Qs 9c]
Hobby-.-AK: checks 
Sweden_Pound: bets $5.90
Hobby-.-AK: folds 
Uncalled bet ($5.90) returned to Sweden_Pound
Sweden_Pound collected $9.07 from pot
Sweden_Pound: doesn't show hand 
*** SUMMARY ***
Total pot $9.50 | Rake $0.43 
Board [8s Qs 9c]
Seat 1: deepblue0000 folded before Flop (didn't bet)
Seat 2: GG-NoR34D. folded before Flop (didn't bet)
Seat 3: Sweden_Pound collected ($9.07)
Seat 4: AlKatrone (button) folded before Flop (didn't bet)
Seat 5: Venomous100% (small blind) folded before Flop
Seat 6: UShallGimme$ (big blind) folded before Flop
Seat 7: Hobby-.-AK folded on the Flop
Seat 8: mycka86 folded before Flop (didn't bet)
Seat 9: matiko09 folded before Flop (didn't bet)





PokerStars Hand #147753997454:  Hold'em No Limit ($0.50/$1.00 USD) - 2016/01/27 11:31:00 CET [2016/01/27 5:31:00 ET]
Table 'Malzovia' 9-max Seat #7 is the button
Seat 1: mycka86 ($100 in chips) 
Seat 3: Reven9er ($100 in chips) 
Seat 4: AlKatrone ($100 in chips) 
Seat 5: matiko09 ($100 in chips) 
Seat 6: deepblue0000 ($321.17 in chips) 
Seat 7: Peu3aHy ($151.56 in chips) 
Seat 9: UShallGimme$ ($169.46 in chips) 
UShallGimme$: posts small blind $0.50
mycka86: posts big blind $1
Sweden_Pound: sits out 
*** HOLE CARDS ***
Dealt to matiko09 [6d Jd]
Reven9er: folds 
Ysatyss leaves the table
AlKatrone: raises $2 to $3
matiko09: folds 
deepblue0000: calls $3
Peu3aHy: folds 
UShallGimme$: folds 
mycka86: calls $2
*** FLOP *** [5s 7d 2h]
mycka86: checks 
AlKatrone: checks 
deepblue0000: bets $4.53
mycka86: folds 
AlKatrone: folds 
Uncalled bet ($4.53) returned to deepblue0000
deepblue0000 collected $9.07 from pot
*** SUMMARY ***
Total pot $9.50 | Rake $0.43 
Board [5s 7d 2h]
Seat 1: mycka86 (big blind) folded on the Flop
Seat 3: Reven9er folded before Flop (didn't bet)
Seat 4: AlKatrone folded on the Flop
Seat 5: matiko09 folded before Flop (didn't bet)
Seat 6: deepblue0000 collected ($9.07)
Seat 7: Peu3aHy (button) folded before Flop (didn't bet)
Seat 9: UShallGimme$ (small blind) folded before Flop





PokerStars Hand #147754001440:  Hold'em No Limit ($0.50/$1.00 USD) - 2016/01/27 11:31:08 CET [2016/01/27 5:31:08 ET]
Table 'Eudora III' 9-max Seat #7 is the button
Seat 3: matiko09 ($101.50 in chips) 
Seat 4: Reven9er ($109.78 in chips) 
Seat 5: di0d80 ($112.41 in chips) 
Seat 6: DIMAZAYAC ($63.48 in chips) 
Seat 7: Sweden_Pound ($100 in chips) 
Seat 8: RUS)Timur ($102.18 in chips) 
Seat 9: Venomous100% ($100 in chips) 
RUS)Timur: posts small blind $0.50
Venomous100%: posts big blind $1
Peu3aHy: sits out 
GrossiM: sits out 
*** HOLE CARDS ***
Dealt to matiko09 [Qd Qs]
matiko09: raises $2 to $3
Reven9er: folds 
di0d80: folds 
DIMAZAYAC: folds 
Sweden_Pound: folds 
RUS)Timur: folds 
Venomous100%: folds 
Uncalled bet ($2) returned to matiko09
matiko09 collected $2.50 from pot
matiko09: doesn't show hand 
*** SUMMARY ***
Total pot $2.50 | Rake $0 
Seat 3: matiko09 collected ($2.50)
Seat 4: Reven9er folded before Flop (didn't bet)
Seat 5: di0d80 folded before Flop (didn't bet)
Seat 6: DIMAZAYAC folded before Flop (didn't bet)
Seat 7: Sweden_Pound (button) folded before Flop (didn't bet)
Seat 8: RUS)Timur (small blind) folded before Flop
Seat 9: Venomous100% (big blind) folded before Flop





PokerStars Hand #147754001672:  Hold'em No Limit ($0.50/$1.00 USD) - 2016/01/27 11:31:08 CET [2016/01/27 5:31:08 ET]
Table 'Thais' 9-max Seat #3 is the button
Seat 1: Peu3aHy ($128.53 in chips) 
Seat 2: Sweden_Pound ($102.50 in chips) 
Seat 3: RoadtoNepal ($100 in chips) 
Seat 4: aayat ($86.72 in chips) 
Seat 5: matiko09 ($100 in chips) 
Seat 6: deepblue0000 ($104.92 in chips) 
Seat 7: Venomous100% ($277.59 in chips) 
Seat 8: sylvian31 ($101.50 in chips) 
Seat 9: tipner ($117.92 in chips) 
aayat: posts small blind $0.50
matiko09: posts big blind $1
*** HOLE CARDS ***
Dealt to matiko09 [6h 3c]
deepblue0000: folds 
Venomous100%: folds 
sylvian31: folds 
tipner: folds 
Peu3aHy: folds 
Sweden_Pound: folds 
RoadtoNepal: raises $2 to $3
aayat: folds 
matiko09: folds 
Uncalled bet ($2) returned to RoadtoNepal
RoadtoNepal collected $2.50 from pot
RoadtoNepal: doesn't show hand 
*** SUMMARY ***
Total pot $2.50 | Rake $0 
Seat 1: Peu3aHy folded before Flop (didn't bet)
Seat 2: Sweden_Pound folded before Flop (didn't bet)
Seat 3: RoadtoNepal (button) collected ($2.50)
Seat 4: aayat (small blind) folded before Flop
Seat 5: matiko09 (big blind) folded before Flop
Seat 6: deepblue0000 folded before Flop (didn't bet)
Seat 7: Venomous100% folded before Flop (didn't bet)
Seat 8: sylvian31 folded before Flop (didn't bet)
Seat 9: tipner folded before Flop (didn't bet)





PokerStars Hand #147754004148:  Hold'em No Limit ($0.50/$1.00 USD) - 2016/01/27 11:31:14 CET [2016/01/27 5:31:14 ET]
Table 'Siegena III' 9-max Seat #9 is the button
Seat 1: nnne409 ($48.40 in chips) 
Seat 2: tipner ($100 in chips) 
Seat 3: masaytoo ($93.25 in chips) 
Seat 4: Sweden_Pound ($100 in chips) 
Seat 5: matiko09 ($101 in chips) 
Seat 6: RUS)Timur ($150.32 in chips) 
Seat 7: sylvian31 ($100 in chips) 
Seat 8: Venomous100% ($100 in chips) 
Seat 9: di0d80 ($124.10 in chips) 
nnne409: posts small blind $0.50
tipner: posts big blind $1
*** HOLE CARDS ***
Dealt to matiko09 [3d 3s]
masaytoo: folds 
Sweden_Pound has timed out
Sweden_Pound: folds 
matiko09: raises $2 to $3
RUS)Timur: folds 
sylvian31: folds 
Venomous100%: folds 
di0d80: folds 
nnne409: raises $2 to $5
tipner: folds 
matiko09: calls $2
*** FLOP *** [Ac Ts 3c]
nnne409: checks 
matiko09: bets $5.46
nnne409: folds 
Uncalled bet ($5.46) returned to matiko09
matiko09 collected $10.50 from pot
matiko09: doesn't show hand 
*** SUMMARY ***
Total pot $11 | Rake $0.50 
Board [Ac Ts 3c]
Seat 1: nnne409 (small blind) folded on the Flop
Seat 2: tipner (big blind) folded before Flop
Seat 3: masaytoo folded before Flop (didn't bet)
Seat 4: Sweden_Pound folded before Flop (didn't bet)
Seat 5: matiko09 collected ($10.50)
Seat 6: RUS)Timur folded before Flop (didn't bet)
Seat 7: sylvian31 folded before Flop (didn't bet)
Seat 8: Venomous100% folded before Flop (didn't bet)
Seat 9: di0d80 (button) folded before Flop (didn't bet)





PokerStars Hand #147754004586:  Hold'em No Limit ($0.50/$1.00 USD) - 2016/01/27 11:31:14 CET [2016/01/27 5:31:14 ET]
Table 'Alkmene II' 9-max Seat #1 is the button
Seat 1: matiko09 ($100 in chips) 
Seat 2: deepblue0000 ($101.19 in chips) 
Seat 3: MuSaShiBuShi ($33.58 in chips) 
Seat 4: CoolFireX ($153.07 in chips) 
Seat 5: Sweden_Pound ($121.05 in chips) 
Seat 6: Peu3aHy ($110.03 in chips) 
Seat 7: mycka86 ($100 in chips) 
Seat 8: fecsok1 ($87.01 in chips) 
Seat 9: pandalapa ($100 in chips) 
deepblue0000: posts small blind $0.50
MuSaShiBuShi: posts big blind $1
*** HOLE CARDS ***
Dealt to matiko09 [Jh 2h]
CoolFireX: folds 
Sweden_Pound has timed out
Sweden_Pound: folds 
Peu3aHy: folds 
mycka86: folds 
fecsok1: raises $1.50 to $2.50
pandalapa: folds 
matiko09: folds 
deepblue0000: folds 
MuSaShiBuShi: folds 
Uncalled bet ($1.50) returned to fecsok1
fecsok1 collected $2.50 from pot
*** SUMMARY ***
Total pot $2.50 | Rake $0 
Seat 1: matiko09 (button) folded before Flop (didn't bet)
Seat 2: deepblue0000 (small blind) folded before Flop
Seat 3: MuSaShiBuShi (big blind) folded before Flop
Seat 4: CoolFireX folded before Flop (didn't bet)
Seat 5: Sweden_Pound folded before Flop (didn't bet)
Seat 6: Peu3aHy folded before Flop (didn't bet)
Seat 7: mycka86 folded before Flop (didn't bet)
Seat 8: fecsok1 collected ($2.50)
Seat 9: pandalapa folded before Flop (didn't bet)





PokerStars Hand #147754004705:  Hold'em No Limit ($0.50/$1.00 USD) - 2016/01/27 11:31:15 CET [2016/01/27 5:31:15 ET]
Table 'Nanking' 9-max Seat #6 is the button
Seat 2: Dachish ($92.92 in chips) 
Seat 4: COOLIKO\/23 ($126.24 in chips) 
Seat 5: TheGentleFox ($47.24 in chips) 
Seat 6: Kukuryzka ($100 in chips) 
Seat 7: tipner ($100 in chips) 
Seat 8: matiko09 ($100 in chips) 
Seat 9: Sweden_Pound ($104.64 in chips) 
tipner: posts small blind $0.50
matiko09: posts big blind $1
nuaxin: sits out 
*** HOLE CARDS ***
Dealt to matiko09 [3c 8h]
Sweden_Pound has timed out
Sweden_Pound: folds 
Dachish: folds 
COOLIKO\/23: folds 
TheGentleFox: folds 
Kukuryzka: folds 
tipner: folds 
Uncalled bet ($0.50) returned to matiko09
matiko09 collected $1 from pot
matiko09: doesn't show hand 
*** SUMMARY ***
Total pot $1 | Rake $0 
Seat 2: Dachish folded before Flop (didn't bet)
Seat 4: COOLIKO\/23 folded before Flop (didn't bet)
Seat 5: TheGentleFox folded before Flop (didn't bet)
Seat 6: Kukuryzka (button) folded before Flop (didn't bet)
Seat 7: tipner (small blind) folded before Flop
Seat 8: matiko09 (big blind) collected ($1)
Seat 9: Sweden_Pound folded before Flop (didn't bet)





PokerStars Hand #147754006302:  Hold'em No Limit ($0.50/$1.00 USD) - 2016/01/27 11:31:18 CET [2016/01/27 5:31:18 ET]
Table 'Delphinus II' 9-max Seat #4 is the button
Seat 1: Saintreine ($150.23 in chips) 
Seat 2: AlKatrone ($100 in chips) 
Seat 3: deepblue0000 ($315.66 in chips) 
Seat 4: matiko09 ($125.23 in chips) 
Seat 5: pandalapa ($106.55 in chips) 
Seat 6: Sweden_Pound ($124.64 in chips) 
Seat 8: mycka86 ($100 in chips) 
Seat 9: FGL-lucky ($52.38 in chips) 
pandalapa: posts small blind $0.50
Sweden_Pound: posts big blind $1
RUS)Timur: sits out 
*** HOLE CARDS ***
Dealt to matiko09 [6h 6c]
mycka86: folds 
FGL-lucky: raises $1 to $2
Saintreine: folds 
AlKatrone: folds 
deepblue0000: calls $2
matiko09: calls $2
pandalapa: folds 
Sweden_Pound: folds 
*** FLOP *** [Kd 5d 9d]
FGL-lucky: checks 
deepblue0000: bets $3.58
matiko09: folds 
FGL-lucky: folds 
Uncalled bet ($3.58) returned to deepblue0000
deepblue0000 collected $7.16 from pot
*** SUMMARY ***
Total pot $7.50 | Rake $0.34 
Board [Kd 5d 9d]
Seat 1: Saintreine folded before Flop (didn't bet)
Seat 2: AlKatrone folded before Flop (didn't bet)
Seat 3: deepblue0000 collected ($7.16)
Seat 4: matiko09 (button) folded on the Flop
Seat 5: pandalapa (small blind) folded before Flop
Seat 6: Sweden_Pound (big blind) folded before Flop
Seat 8: mycka86 folded before Flop (didn't bet)
Seat 9: FGL-lucky folded on the Flop





PokerStars Hand #147754016169:  Hold'em No Limit ($0.50/$1.00 USD) - 2016/01/27 11:31:38 CET [2016/01/27 5:31:38 ET]
Table 'Palisana III' 9-max Seat #2 is the button
Seat 1: Largie1994 ($92.06 in chips) 
Seat 2: tipner ($100 in chips) 
Seat 3: Kukuryzka ($99 in chips) 
Seat 4: Reven9er ($104.68 in chips) 
Seat 5: di0d80 ($103 in chips) 
Seat 6: matiko09 ($112.73 in chips) 
Seat 7: Sweden_Pound ($100 in chips) 
Seat 8: COOLIKO\/23 ($100 in chips) 
Seat 9: monacomoritz ($101.42 in chips) 
Kukuryzka: posts small blind $0.50
Reven9er: posts big blind $1
*** HOLE CARDS ***
Dealt to matiko09 [5c Jd]
di0d80: folds 
matiko09: folds 
Sweden_Pound: folds 
COOLIKO\/23: folds 
monacomoritz: folds 
Largie1994: folds 
tipner: folds 
Kukuryzka: raises $1.50 to $2.50
Reven9er: calls $1.50
*** FLOP *** [7c 6s 8c]
Kukuryzka: checks 
Reven9er: checks 
*** TURN *** [7c 6s 8c] [2c]
Kukuryzka: bets $3.35
Reven9er: folds 
Uncalled bet ($3.35) returned to Kukuryzka
Kukuryzka collected $4.78 from pot
Kukuryzka: doesn't show hand 
*** SUMMARY ***
Total pot $5 | Rake $0.22 
Board [7c 6s 8c 2c]
Seat 1: Largie1994 folded before Flop (didn't bet)
Seat 2: tipner (button) folded before Flop (didn't bet)
Seat 3: Kukuryzka (small blind) collected ($4.78)
Seat 4: Reven9er (big blind) folded on the Turn
Seat 5: di0d80 folded before Flop (didn't bet)
Seat 6: matiko09 folded before Flop (didn't bet)
Seat 7: Sweden_Pound folded before Flop (didn't bet)
Seat 8: COOLIKO\/23 folded before Flop (didn't bet)
Seat 9: monacomoritz folded before Flop (didn't bet)





PokerStars Hand #147754023206:  Hold'em No Limit ($0.50/$1.00 USD) - 2016/01/27 11:31:51 CET [2016/01/27 5:31:51 ET]
Table 'Alkmene II' 9-max Seat #2 is the button
Seat 1: matiko09 ($100 in chips) 
Seat 2: deepblue0000 ($100.69 in chips) 
Seat 3: MuSaShiBuShi ($32.58 in chips) 
Seat 4: CoolFireX ($153.07 in chips) 
Seat 5: Sweden_Pound ($121.05 in chips) 
Seat 6: Peu3aHy ($110.03 in chips) 
Seat 7: mycka86 ($100 in chips) 
Seat 8: fecsok1 ($88.51 in chips) 
Seat 9: pandalapa ($100 in chips) 
MuSaShiBuShi: posts small blind $0.50
CoolFireX: posts big blind $1
*** HOLE CARDS ***
Dealt to matiko09 [8s 2h]
Sweden_Pound: folds 
Peu3aHy: folds 
mycka86: raises $1.50 to $2.50
fecsok1: folds 
pandalapa: folds 
matiko09: folds 
deepblue0000: calls $2.50
MuSaShiBuShi: folds 
CoolFireX: calls $1.50
*** FLOP *** [7c 5d Td]
CoolFireX: checks 
mycka86: bets $5.60
deepblue0000: folds 
CoolFireX: folds 
Uncalled bet ($5.60) returned to mycka86
mycka86 collected $7.64 from pot
*** SUMMARY ***
Total pot $8 | Rake $0.36 
Board [7c 5d Td]
Seat 1: matiko09 folded before Flop (didn't bet)
Seat 2: deepblue0000 (button) folded on the Flop
Seat 3: MuSaShiBuShi (small blind) folded before Flop
Seat 4: CoolFireX (big blind) folded on the Flop
Seat 5: Sweden_Pound folded before Flop (didn't bet)
Seat 6: Peu3aHy folded before Flop (didn't bet)
Seat 7: mycka86 collected ($7.64)
Seat 8: fecsok1 folded before Flop (didn't bet)
Seat 9: pandalapa folded before Flop (didn't bet)





PokerStars Hand #147754023691:  Hold'em No Limit ($0.50/$1.00 USD) - 2016/01/27 11:31:52 CET [2016/01/27 5:31:52 ET]
Table 'Malzovia' 9-max Seat #9 is the button
Seat 1: mycka86 ($100 in chips) 
Seat 2: Sweden_Pound ($114.62 in chips) 
Seat 3: Reven9er ($100 in chips) 
Seat 4: AlKatrone ($100 in chips) 
Seat 5: matiko09 ($100 in chips) 
Seat 6: deepblue0000 ($327.24 in chips) 
Seat 7: Peu3aHy ($151.56 in chips) 
Seat 9: UShallGimme$ ($168.96 in chips) 
mycka86: posts small blind $0.50
Sweden_Pound: posts big blind $1
*** HOLE CARDS ***
Dealt to matiko09 [4h 6c]
Reven9er: folds 
AlKatrone: folds 
matiko09: folds 
FreeRangtor joins the table at seat #8 
deepblue0000: folds 
Peu3aHy: raises $2 to $3
UShallGimme$: folds 
mycka86: folds 
Sweden_Pound: folds 
Uncalled bet ($2) returned to Peu3aHy
Peu3aHy collected $2.50 from pot
Peu3aHy: doesn't show hand 
*** SUMMARY ***
Total pot $2.50 | Rake $0 
Seat 1: mycka86 (small blind) folded before Flop
Seat 2: Sweden_Pound (big blind) folded before Flop
Seat 3: Reven9er folded before Flop (didn't bet)
Seat 4: AlKatrone folded before Flop (didn't bet)
Seat 5: matiko09 folded before Flop (didn't bet)
Seat 6: deepblue0000 folded before Flop (didn't bet)
Seat 7: Peu3aHy collected ($2.50)
Seat 9: UShallGimme$ (button) folded before Flop (didn't bet)





PokerStars Hand #147754024785:  Hold'em No Limit ($0.50/$1.00 USD) - 2016/01/27 11:31:55 CET [2016/01/27 5:31:55 ET]
Table 'Fragaria II' 9-max Seat #5 is the button
Seat 1: deepblue0000 ($105.78 in chips) 
Seat 2: GG-NoR34D. ($69.87 in chips) 
Seat 3: Sweden_Pound ($119.01 in chips) 
Seat 4: AlKatrone ($101 in chips) 
Seat 5: Venomous100% ($106.62 in chips) 
Seat 6: UShallGimme$ ($201.52 in chips) 
Seat 7: Hobby-.-AK ($32.71 in chips) 
Seat 8: mycka86 ($113.10 in chips) 
Seat 9: matiko09 ($100 in chips) 
UShallGimme$: posts small blind $0.50
Hobby-.-AK: posts big blind $1
*** HOLE CARDS ***
Dealt to matiko09 [5d 4d]
mycka86: raises $2 to $3
matiko09: folds 
deepblue0000: folds 
GG-NoR34D.: calls $3
Sweden_Pound: folds 
AlKatrone: folds 
Venomous100%: folds 
UShallGimme$: folds 
Hobby-.-AK: calls $2
*** FLOP *** [9d 2s 2d]
Hobby-.-AK: checks 
mycka86: checks 
GG-NoR34D.: bets $7.90
Hobby-.-AK: folds 
mycka86: folds 
Uncalled bet ($7.90) returned to GG-NoR34D.
GG-NoR34D. collected $9.07 from pot
*** SUMMARY ***
Total pot $9.50 | Rake $0.43 
Board [9d 2s 2d]
Seat 1: deepblue0000 folded before Flop (didn't bet)
Seat 2: GG-NoR34D. collected ($9.07)
Seat 3: Sweden_Pound folded before Flop (didn't bet)
Seat 4: AlKatrone folded before Flop (didn't bet)
Seat 5: Venomous100% (button) folded before Flop (didn't bet)
Seat 6: UShallGimme$ (small blind) folded before Flop
Seat 7: Hobby-.-AK (big blind) folded on the Flop
Seat 8: mycka86 folded on the Flop
Seat 9: matiko09 folded before Flop (didn't bet)





PokerStars Hand #147754025063:  Hold'em No Limit ($0.50/$1.00 USD) - 2016/01/27 11:31:55 CET [2016/01/27 5:31:55 ET]
Table 'Eudora III' 9-max Seat #8 is the button
Seat 1: Peu3aHy ($100 in chips) 
Seat 3: matiko09 ($103 in chips) 
Seat 4: Reven9er ($109.78 in chips) 
Seat 5: di0d80 ($112.41 in chips) 
Seat 6: DIMAZAYAC ($63.48 in chips) 
Seat 7: Sweden_Pound ($100 in chips) 
Seat 8: RUS)Timur ($101.68 in chips) 
Seat 9: Venomous100% ($100 in chips) 
Venomous100%: posts small blind $0.50
Peu3aHy: posts big blind $1
GrossiM: sits out 
*** HOLE CARDS ***
Dealt to matiko09 [Kh 7d]
matiko09: folds 
Reven9er: raises $1 to $2
di0d80: folds 
DIMAZAYAC: folds 
Sweden_Pound: folds 
RUS)Timur: folds 
Venomous100%: folds 
Peu3aHy: folds 
Uncalled bet ($1) returned to Reven9er
Reven9er collected $2.50 from pot
Reven9er: doesn't show hand 
*** SUMMARY ***
Total pot $2.50 | Rake $0 
Seat 1: Peu3aHy (big blind) folded before Flop
Seat 3: matiko09 folded before Flop (didn't bet)
Seat 4: Reven9er collected ($2.50)
Seat 5: di0d80 folded before Flop (didn't bet)
Seat 6: DIMAZAYAC folded before Flop (didn't bet)
Seat 7: Sweden_Pound folded before Flop (didn't bet)
Seat 8: RUS)Timur (button) folded before Flop (didn't bet)
Seat 9: Venomous100% (small blind) folded before Flop





PokerStars Hand #147754025248:  Hold'em No Limit ($0.50/$1.00 USD) - 2016/01/27 11:31:56 CET [2016/01/27 5:31:56 ET]
Table 'Thais' 9-max Seat #4 is the button
Seat 1: Peu3aHy ($128.53 in chips) 
Seat 2: Sweden_Pound ($102.50 in chips) 
Seat 3: RoadtoNepal ($101.50 in chips) 
Seat 4: aayat ($86.22 in chips) 
Seat 5: matiko09 ($100 in chips) 
Seat 6: deepblue0000 ($104.92 in chips) 
Seat 7: Venomous100% ($277.59 in chips) 
Seat 8: sylvian31 ($101.50 in chips) 
Seat 9: tipner ($117.92 in chips) 
matiko09: posts small blind $0.50
deepblue0000: posts big blind $1
*** HOLE CARDS ***
Dealt to matiko09 [9c 2s]
Venomous100%: folds 
sylvian31: folds 
tipner: folds 
Peu3aHy: folds 
Sweden_Pound: folds 
RoadtoNepal: raises $1.50 to $2.50
aayat: folds 
matiko09: folds 
deepblue0000: folds 
Uncalled bet ($1.50) returned to RoadtoNepal
RoadtoNepal collected $2.50 from pot
RoadtoNepal: doesn't show hand 
*** SUMMARY ***
Total pot $2.50 | Rake $0 
Seat 1: Peu3aHy folded before Flop (didn't bet)
Seat 2: Sweden_Pound folded before Flop (didn't bet)
Seat 3: RoadtoNepal collected ($2.50)
Seat 4: aayat (button) folded before Flop (didn't bet)
Seat 5: matiko09 (small blind) folded before Flop
Seat 6: deepblue0000 (big blind) folded before Flop
Seat 7: Venomous100% folded before Flop (didn't bet)
Seat 8: sylvian31 folded before Flop (didn't bet)
Seat 9: tipner folded before Flop (didn't bet)





PokerStars Hand #147754025781:  Hold'em No Limit ($0.50/$1.00 USD) - 2016/01/27 11:31:57 CET [2016/01/27 5:31:57 ET]
Table 'Delphinus II' 9-max Seat #5 is the button
Seat 1: Saintreine ($150.23 in chips) 
Seat 2: AlKatrone ($100 in chips) 
Seat 3: deepblue0000 ($320.82 in chips) 
Seat 4: matiko09 ($123.23 in chips) 
Seat 5: pandalapa ($106.05 in chips) 
Seat 6: Sweden_Pound ($123.64 in chips) 
Seat 7: RUS)Timur ($100 in chips) 
Seat 8: mycka86 ($100 in chips) 
Seat 9: FGL-lucky ($50.38 in chips) 
Sweden_Pound: posts small blind $0.50
RUS)Timur: posts big blind $1
*** HOLE CARDS ***
Dealt to matiko09 [2d 3s]
mycka86: folds 
FGL-lucky: folds 
Saintreine has timed out
Saintreine: folds 
AlKatrone: folds 
deepblue0000: folds 
matiko09: folds 
pandalapa: folds 
Sweden_Pound: raises $2 to $3
RUS)Timur: folds 
Uncalled bet ($2) returned to Sweden_Pound
Sweden_Pound collected $2 from pot
Sweden_Pound: doesn't show hand 
*** SUMMARY ***
Total pot $2 | Rake $0 
Seat 1: Saintreine folded before Flop (didn't bet)
Seat 2: AlKatrone folded before Flop (didn't bet)
Seat 3: deepblue0000 folded before Flop (didn't bet)
Seat 4: matiko09 folded before Flop (didn't bet)
Seat 5: pandalapa (button) folded before Flop (didn't bet)
Seat 6: Sweden_Pound (small blind) collected ($2)
Seat 7: RUS)Timur (big blind) folded before Flop
Seat 8: mycka86 folded before Flop (didn't bet)
Seat 9: FGL-lucky folded before Flop (didn't bet)





PokerStars Hand #147754030224:  Hold'em No Limit ($0.50/$1.00 USD) - 2016/01/27 11:32:06 CET [2016/01/27 5:32:06 ET]
Table 'Nanking' 9-max Seat #7 is the button
Seat 2: Dachish ($92.92 in chips) 
Seat 4: COOLIKO\/23 ($126.24 in chips) 
Seat 5: TheGentleFox ($47.24 in chips) 
Seat 6: Kukuryzka ($100 in chips) 
Seat 7: tipner ($100 in chips) 
Seat 8: matiko09 ($100.50 in chips) 
Seat 9: Sweden_Pound ($104.64 in chips) 
matiko09: posts small blind $0.50
Sweden_Pound: posts big blind $1
nuaxin: sits out 
*** HOLE CARDS ***
Dealt to matiko09 [9s 2c]
Dachish: folds 
COOLIKO\/23: folds 
TheGentleFox: folds 
Kukuryzka: folds 
tipner: folds 
matiko09: folds 
Uncalled bet ($0.50) returned to Sweden_Pound
Sweden_Pound collected $1 from pot
Sweden_Pound: doesn't show hand 
*** SUMMARY ***
Total pot $1 | Rake $0 
Seat 2: Dachish folded before Flop (didn't bet)
Seat 4: COOLIKO\/23 folded before Flop (didn't bet)
Seat 5: TheGentleFox folded before Flop (didn't bet)
Seat 6: Kukuryzka folded before Flop (didn't bet)
Seat 7: tipner (button) folded before Flop (didn't bet)
Seat 8: matiko09 (small blind) folded before Flop
Seat 9: Sweden_Pound (big blind) collected ($1)





PokerStars Hand #147754036059:  Hold'em No Limit ($0.50/$1.00 USD) - 2016/01/27 11:32:17 CET [2016/01/27 5:32:17 ET]
Table 'Henyey' 9-max Seat #5 is the button
Seat 1: BurnsyT ($109.72 in chips) 
Seat 2: pandalapa ($153.77 in chips) 
Seat 3: deepblue0000 ($101.36 in chips) 
Seat 4: sylvian31 ($106.75 in chips) 
Seat 5: matiko09 ($107.50 in chips) 
Seat 6: UShallGimme$ ($100 in chips) 
Seat 8: CoolFireX ($113.60 in chips) 
Seat 9: mycka86 ($132.11 in chips) 
UShallGimme$: posts small blind $0.50
Sweden_Pound: is sitting out 
Sweden_Pound leaves the table
CoolFireX: posts big blind $1
*** HOLE CARDS ***
Dealt to matiko09 [Jc Jd]
mycka86: folds 
BurnsyT: folds 
pandalapa: folds 
deepblue0000: folds 
sylvian31: folds 
matiko09: raises $1.27 to $2.27
UShallGimme$: folds 
CoolFireX: folds 
Uncalled bet ($1.27) returned to matiko09
matiko09 collected $2.50 from pot
matiko09: doesn't show hand 
*** SUMMARY ***
Total pot $2.50 | Rake $0 
Seat 1: BurnsyT folded before Flop (didn't bet)
Seat 2: pandalapa folded before Flop (didn't bet)
Seat 3: deepblue0000 folded before Flop (didn't bet)
Seat 4: sylvian31 folded before Flop (didn't bet)
Seat 5: matiko09 (button) collected ($2.50)
Seat 6: UShallGimme$ (small blind) folded before Flop
Seat 8: CoolFireX (big blind) folded before Flop
Seat 9: mycka86 folded before Flop (didn't bet)





PokerStars Hand #147754036299:  Hold'em No Limit ($0.50/$1.00 USD) - 2016/01/27 11:32:18 CET [2016/01/27 5:32:18 ET]
Table 'Eudora III' 9-max Seat #9 is the button
Seat 1: Peu3aHy ($100 in chips) 
Seat 2: GrossiM ($100 in chips) 
Seat 3: matiko09 ($103 in chips) 
Seat 4: Reven9er ($111.28 in chips) 
Seat 5: di0d80 ($112.41 in chips) 
Seat 6: DIMAZAYAC ($63.48 in chips) 
Seat 7: Sweden_Pound ($100 in chips) 
Seat 8: RUS)Timur ($101.68 in chips) 
Seat 9: Venomous100% ($100 in chips) 
Peu3aHy: posts small blind $0.50
GrossiM: posts big blind $1
*** HOLE CARDS ***
Dealt to matiko09 [8s Kd]
matiko09: folds 
Reven9er: folds 
di0d80: raises $1.50 to $2.50
DIMAZAYAC: calls $2.50
Sweden_Pound: folds 
RUS)Timur: folds 
Venomous100%: folds 
Peu3aHy: calls $2
GrossiM: folds 
*** FLOP *** [3d 5d Kh]
Peu3aHy: checks 
di0d80: bets $5
DIMAZAYAC: calls $5
Peu3aHy: folds 
*** TURN *** [3d 5d Kh] [7s]
di0d80: bets $10
DIMAZAYAC: calls $10
*** RIVER *** [3d 5d Kh 7s] [Ad]
di0d80: bets $9
DIMAZAYAC: folds 
Uncalled bet ($9) returned to di0d80
di0d80 collected $36.77 from pot
di0d80: doesn't show hand 
*** SUMMARY ***
Total pot $38.50 | Rake $1.73 
Board [3d 5d Kh 7s Ad]
Seat 1: Peu3aHy (small blind) folded on the Flop
Seat 2: GrossiM (big blind) folded before Flop
Seat 3: matiko09 folded before Flop (didn't bet)
Seat 4: Reven9er folded before Flop (didn't bet)
Seat 5: di0d80 collected ($36.77)
Seat 6: DIMAZAYAC folded on the River
Seat 7: Sweden_Pound folded before Flop (didn't bet)
Seat 8: RUS)Timur folded before Flop (didn't bet)
Seat 9: Venomous100% (button) folded before Flop (didn't bet)





PokerStars Hand #147754036992:  Hold'em No Limit ($0.50/$1.00 USD) - 2016/01/27 11:32:19 CET [2016/01/27 5:32:19 ET]
Table 'Thais' 9-max Seat #5 is the button
Seat 1: Peu3aHy ($128.53 in chips) 
Seat 2: Sweden_Pound ($102.50 in chips) 
Seat 3: RoadtoNepal ($103 in chips) 
Seat 4: aayat ($86.22 in chips) 
Seat 5: matiko09 ($100 in chips) 
Seat 6: deepblue0000 ($103.92 in chips) 
Seat 7: Venomous100% ($277.59 in chips) 
Seat 8: sylvian31 ($101.50 in chips) 
Seat 9: tipner ($117.92 in chips) 
deepblue0000: posts small blind $0.50
Venomous100%: posts big blind $1
*** HOLE CARDS ***
Dealt to matiko09 [2d 2h]
sylvian31: folds 
tipner: folds 
Peu3aHy: raises $2 to $3
Sweden_Pound: folds 
RoadtoNepal: folds 
aayat: folds 
matiko09: folds 
deepblue0000: folds 
Venomous100%: folds 
Uncalled bet ($2) returned to Peu3aHy
Peu3aHy collected $2.50 from pot
Peu3aHy: doesn't show hand 
*** SUMMARY ***
Total pot $2.50 | Rake $0 
Seat 1: Peu3aHy collected ($2.50)
Seat 2: Sweden_Pound folded before Flop (didn't bet)
Seat 3: RoadtoNepal folded before Flop (didn't bet)
Seat 4: aayat folded before Flop (didn't bet)
Seat 5: matiko09 (button) folded before Flop (didn't bet)
Seat 6: deepblue0000 (small blind) folded before Flop
Seat 7: Venomous100% (big blind) folded before Flop
Seat 8: sylvian31 folded before Flop (didn't bet)
Seat 9: tipner folded before Flop (didn't bet)





PokerStars Hand #147754041027:  Hold'em No Limit ($0.50/$1.00 USD) - 2016/01/27 11:32:27 CET [2016/01/27 5:32:27 ET]
Table 'Nanking' 9-max Seat #8 is the button
Seat 2: Dachish ($92.92 in chips) 
Seat 4: COOLIKO\/23 ($126.24 in chips) 
Seat 5: TheGentleFox ($87.24 in chips) 
Seat 6: Kukuryzka ($100 in chips) 
Seat 7: tipner ($100 in chips) 
Seat 8: matiko09 ($100 in chips) 
Seat 9: Sweden_Pound ($105.14 in chips) 
Sweden_Pound: posts small blind $0.50
Dachish: posts big blind $1
nuaxin: sits out 
*** HOLE CARDS ***
Dealt to matiko09 [9h 7h]
COOLIKO\/23: folds 
TheGentleFox: raises $1 to $2
Kukuryzka: folds 
tipner: folds 
Peu3aHy joins the table at seat #1 
matiko09: raises $5 to $7
Sweden_Pound: folds 
Dachish: raises $10 to $17
TheGentleFox: folds 
matiko09: folds 
Uncalled bet ($10) returned to Dachish
Dachish collected $16.50 from pot
Dachish: doesn't show hand 
*** SUMMARY ***
Total pot $16.50 | Rake $0 
Seat 2: Dachish (big blind) collected ($16.50)
Seat 4: COOLIKO\/23 folded before Flop (didn't bet)
Seat 5: TheGentleFox folded before Flop
Seat 6: Kukuryzka folded before Flop (didn't bet)
Seat 7: tipner folded before Flop (didn't bet)
Seat 8: matiko09 (button) folded before Flop
Seat 9: Sweden_Pound (small blind) folded before Flop





PokerStars Hand #147754042961:  Hold'em No Limit ($0.50/$1.00 USD) - 2016/01/27 11:32:31 CET [2016/01/27 5:32:31 ET]
Table 'Malzovia' 9-max Seat #1 is the button
Seat 1: mycka86 ($100 in chips) 
Seat 2: Sweden_Pound ($113.62 in chips) 
Seat 3: Reven9er ($100 in chips) 
Seat 4: AlKatrone ($100 in chips) 
Seat 5: matiko09 ($100 in chips) 
Seat 6: deepblue0000 ($327.24 in chips) 
Seat 7: Peu3aHy ($153.06 in chips) 
Seat 8: FreeRangtor ($100 in chips) 
Seat 9: UShallGimme$ ($168.96 in chips) 
Sweden_Pound: posts small blind $0.50
Reven9er: posts big blind $1
FreeRangtor: posts big blind $1
*** HOLE CARDS ***
Dealt to matiko09 [Qd Js]
AlKatrone: raises $3 to $4
matiko09: folds 
deepblue0000: folds 
Peu3aHy: folds 
FreeRangtor: calls $3
UShallGimme$: folds 
mycka86: folds 
Sweden_Pound: folds 
Reven9er: folds 
*** FLOP *** [Kd Ac 2c]
AlKatrone: checks 
FreeRangtor: bets $4.53
AlKatrone: raises $9.47 to $14
FreeRangtor: calls $9.47
*** TURN *** [Kd Ac 2c] [6d]
AlKatrone: bets $28.28
FreeRangtor: calls $28.28
*** RIVER *** [Kd Ac 2c 6d] [6s]
AlKatrone: bets $53.72 and is all-in
FreeRangtor: calls $53.72 and is all-in
*** SHOW DOWN ***
AlKatrone: shows [Kh Kc] (a full house, Kings full of Sixes)
FreeRangtor: shows [3h Ad] (two pair, Aces and Sixes)
AlKatrone collected $198.70 from pot
*** SUMMARY ***
Total pot $201.50 | Rake $2.80 
Board [Kd Ac 2c 6d 6s]
Seat 1: mycka86 (button) folded before Flop (didn't bet)
Seat 2: Sweden_Pound (small blind) folded before Flop
Seat 3: Reven9er (big blind) folded before Flop
Seat 4: AlKatrone showed [Kh Kc] and won ($198.70) with a full house, Kings full of Sixes
Seat 5: matiko09 folded before Flop (didn't bet)
Seat 6: deepblue0000 folded before Flop (didn't bet)
Seat 7: Peu3aHy folded before Flop (didn't bet)
Seat 8: FreeRangtor showed [3h Ad] and lost with two pair, Aces and Sixes
Seat 9: UShallGimme$ folded before Flop (didn't bet)





PokerStars Hand #147754043649:  Hold'em No Limit ($0.50/$1.00 USD) - 2016/01/27 11:32:33 CET [2016/01/27 5:32:33 ET]
Table 'Alhajoth' 9-max Seat #3 is the button
Seat 1: UShallGimme$ ($104.75 in chips) 
Seat 2: matiko09 ($100 in chips) 
Seat 3: Sweden_Pound ($116.27 in chips) 
Seat 4: Venomous100% ($128.07 in chips) 
Seat 5: Kukuryzka ($100 in chips) 
Seat 6: RoadtoNepal ($192.80 in chips) 
Seat 7: Ohpeel ($118.24 in chips) 
Seat 8: deepblue0000 ($118.18 in chips) 
Venomous100%: posts small blind $0.50
Kukuryzka: posts big blind $1
di0d80: sits out 
*** HOLE CARDS ***
Dealt to matiko09 [5h Ts]
RoadtoNepal: folds 
Ohpeel: calls $1
deepblue0000: folds 
UShallGimme$: folds 
matiko09: folds 
Sweden_Pound: folds 
Venomous100%: folds 
Kukuryzka: checks 
*** FLOP *** [Ks Js 3s]
Kukuryzka: checks 
Ohpeel: bets $2
Kukuryzka: folds 
Uncalled bet ($2) returned to Ohpeel
Ohpeel collected $2.39 from pot
*** SUMMARY ***
Total pot $2.50 | Rake $0.11 
Board [Ks Js 3s]
Seat 1: UShallGimme$ folded before Flop (didn't bet)
Seat 2: matiko09 folded before Flop (didn't bet)
Seat 3: Sweden_Pound (button) folded before Flop (didn't bet)
Seat 4: Venomous100% (small blind) folded before Flop
Seat 5: Kukuryzka (big blind) folded on the Flop
Seat 6: RoadtoNepal folded before Flop (didn't bet)
Seat 7: Ohpeel collected ($2.39)
Seat 8: deepblue0000 folded before Flop (didn't bet)





PokerStars Hand #147754045157:  Hold'em No Limit ($0.50/$1.00 USD) - 2016/01/27 11:32:36 CET [2016/01/27 5:32:36 ET]
Table 'Delphinus II' 9-max Seat #6 is the button
Seat 1: Saintreine ($150.23 in chips) 
Seat 2: AlKatrone ($100 in chips) 
Seat 3: deepblue0000 ($320.82 in chips) 
Seat 4: matiko09 ($123.23 in chips) 
Seat 5: pandalapa ($106.05 in chips) 
Seat 6: Sweden_Pound ($124.64 in chips) 
Seat 7: RUS)Timur ($100 in chips) 
Seat 8: mycka86 ($100 in chips) 
Seat 9: FGL-lucky ($50.38 in chips) 
RUS)Timur: posts small blind $0.50
mycka86: posts big blind $1
*** HOLE CARDS ***
Dealt to matiko09 [6s 5s]
FGL-lucky: folds 
Saintreine: folds 
AlKatrone: folds 
deepblue0000: folds 
matiko09: raises $2 to $3
pandalapa: folds 
Sweden_Pound: folds 
RUS)Timur: folds 
mycka86: folds 
Uncalled bet ($2) returned to matiko09
matiko09 collected $2.50 from pot
matiko09: doesn't show hand 
*** SUMMARY ***
Total pot $2.50 | Rake $0 
Seat 1: Saintreine folded before Flop (didn't bet)
Seat 2: AlKatrone folded before Flop (didn't bet)
Seat 3: deepblue0000 folded before Flop (didn't bet)
Seat 4: matiko09 collected ($2.50)
Seat 5: pandalapa folded before Flop (didn't bet)
Seat 6: Sweden_Pound (button) folded before Flop (didn't bet)
Seat 7: RUS)Timur (small blind) folded before Flop
Seat 8: mycka86 (big blind) folded before Flop
Seat 9: FGL-lucky folded before Flop (didn't bet)





PokerStars Hand #147754046746:  Hold'em No Limit ($0.50/$1.00 USD) - 2016/01/27 11:32:39 CET [2016/01/27 5:32:39 ET]
Table 'Siegena III' 9-max Seat #1 is the button
Seat 1: nnne409 ($43.40 in chips) 
Seat 2: tipner ($100 in chips) 
Seat 3: masaytoo ($93.25 in chips) 
Seat 4: Sweden_Pound ($100 in chips) 
Seat 5: matiko09 ($106.50 in chips) 
Seat 6: RUS)Timur ($150.32 in chips) 
Seat 7: sylvian31 ($100 in chips) 
Seat 8: Venomous100% ($100 in chips) 
Seat 9: di0d80 ($124.10 in chips) 
tipner: posts small blind $0.50
masaytoo: posts big blind $1
*** HOLE CARDS ***
Dealt to matiko09 [8d Kc]
Sweden_Pound: folds 
matiko09: folds 
RUS)Timur: folds 
sylvian31: folds 
Venomous100%: raises $2 to $3
di0d80: folds 
nnne409: folds 
tipner: folds 
masaytoo: folds 
Uncalled bet ($2) returned to Venomous100%
Venomous100% collected $2.50 from pot
Venomous100%: doesn't show hand 
*** SUMMARY ***
Total pot $2.50 | Rake $0 
Seat 1: nnne409 (button) folded before Flop (didn't bet)
Seat 2: tipner (small blind) folded before Flop
Seat 3: masaytoo (big blind) folded before Flop
Seat 4: Sweden_Pound folded before Flop (didn't bet)
Seat 5: matiko09 folded before Flop (didn't bet)
Seat 6: RUS)Timur folded before Flop (didn't bet)
Seat 7: sylvian31 folded before Flop (didn't bet)
Seat 8: Venomous100% collected ($2.50)
Seat 9: di0d80 folded before Flop (didn't bet)





PokerStars Hand #147754052045:  Hold'em No Limit ($0.50/$1.00 USD) - 2016/01/27 11:32:49 CET [2016/01/27 5:32:49 ET]
Table 'Alkmene II' 9-max Seat #3 is the button
Seat 1: matiko09 ($100 in chips) 
Seat 2: deepblue0000 ($100 in chips) 
Seat 3: MuSaShiBuShi ($32.08 in chips) 
Seat 4: CoolFireX ($150.57 in chips) 
Seat 5: Sweden_Pound ($121.05 in chips) 
Seat 6: Peu3aHy ($110.03 in chips) 
Seat 7: mycka86 ($105.14 in chips) 
Seat 8: fecsok1 ($88.51 in chips) 
Seat 9: pandalapa ($100 in chips) 
CoolFireX: posts small blind $0.50
Sweden_Pound: posts big blind $1
*** HOLE CARDS ***
Dealt to matiko09 [9h Td]
Peu3aHy: folds 
mycka86: raises $2 to $3
fecsok1: calls $3
pandalapa: folds 
matiko09: folds 
deepblue0000: folds 
MuSaShiBuShi: folds 
CoolFireX: folds 
Sweden_Pound: folds 
*** FLOP *** [9c Qs 2d]
mycka86: bets $5.20
fecsok1: calls $5.20
*** TURN *** [9c Qs 2d] [8s]
mycka86: bets $13
fecsok1: calls $13
*** RIVER *** [9c Qs 2d 8s] [Tc]
mycka86: checks 
fecsok1: checks 
*** SHOW DOWN ***
mycka86: shows [9s 9d] (three of a kind, Nines)
fecsok1: mucks hand 
mycka86 collected $41.92 from pot
*** SUMMARY ***
Total pot $43.90 | Rake $1.98 
Board [9c Qs 2d 8s Tc]
Seat 1: matiko09 folded before Flop (didn't bet)
Seat 2: deepblue0000 folded before Flop (didn't bet)
Seat 3: MuSaShiBuShi (button) folded before Flop (didn't bet)
Seat 4: CoolFireX (small blind) folded before Flop
Seat 5: Sweden_Pound (big blind) folded before Flop
Seat 6: Peu3aHy folded before Flop (didn't bet)
Seat 7: mycka86 showed [9s 9d] and won ($41.92) with three of a kind, Nines
Seat 8: fecsok1 mucked [Ah Qh]
Seat 9: pandalapa folded before Flop (didn't bet)





PokerStars Hand #147754055414:  Hold'em No Limit ($0.50/$1.00 USD) - 2016/01/27 11:32:56 CET [2016/01/27 5:32:56 ET]
Table 'Palisana III' 9-max Seat #3 is the button
Seat 1: Largie1994 ($92.06 in chips) 
Seat 2: tipner ($100 in chips) 
Seat 3: Kukuryzka ($101.28 in chips) 
Seat 4: Reven9er ($102.18 in chips) 
Seat 5: di0d80 ($103 in chips) 
Seat 6: matiko09 ($112.73 in chips) 
Seat 7: Sweden_Pound ($100 in chips) 
Seat 8: COOLIKO\/23 ($100 in chips) 
Seat 9: monacomoritz ($101.42 in chips) 
Reven9er: posts small blind $0.50
di0d80: posts big blind $1
*** HOLE CARDS ***
Dealt to matiko09 [3h 7d]
matiko09: folds 
Sweden_Pound: folds 
COOLIKO\/23: folds 
monacomoritz is disconnected 
monacomoritz has timed out while disconnected
monacomoritz: folds 
Largie1994: folds 
Largie1994 leaves the table
tipner: folds 
matiko09 leaves the table
Kukuryzka: raises $1 to $2
Reven9er: folds 
di0d80: folds 
Uncalled bet ($1) returned to Kukuryzka
Kukuryzka collected $2.50 from pot
Kukuryzka: doesn't show hand 
*** SUMMARY ***
Total pot $2.50 | Rake $0 
Seat 1: Largie1994 folded before Flop (didn't bet)
Seat 2: tipner folded before Flop (didn't bet)
Seat 3: Kukuryzka (button) collected ($2.50)
Seat 4: Reven9er (small blind) folded before Flop
Seat 5: di0d80 (big blind) folded before Flop
Seat 6: matiko09 folded before Flop (didn't bet)
Seat 7: Sweden_Pound folded before Flop (didn't bet)
Seat 8: COOLIKO\/23 folded before Flop (didn't bet)
Seat 9: monacomoritz folded before Flop (didn't bet)





PokerStars Hand #147754059346:  Hold'em No Limit ($0.50/$1.00 USD) - 2016/01/27 11:33:04 CET [2016/01/27 5:33:04 ET]
Table 'Henyey' 9-max Seat #6 is the button
Seat 1: BurnsyT ($109.72 in chips) 
Seat 2: pandalapa ($153.77 in chips) 
Seat 3: deepblue0000 ($101.36 in chips) 
Seat 4: sylvian31 ($106.75 in chips) 
Seat 5: matiko09 ($109 in chips) 
Seat 6: UShallGimme$ ($100 in chips) 
Seat 8: CoolFireX ($112.60 in chips) 
Seat 9: mycka86 ($132.11 in chips) 
CoolFireX: posts small blind $0.50
mycka86: posts big blind $1
*** HOLE CARDS ***
Dealt to matiko09 [8h 7h]
BurnsyT has timed out while being disconnected
BurnsyT: folds 
pandalapa: folds 
deepblue0000: folds 
sylvian31: folds 
matiko09: raises $1.50 to $2.50
UShallGimme$: folds 
BurnsyT is disconnected 
CoolFireX: folds 
BurnsyT leaves the table
mycka86: folds 
Uncalled bet ($1.50) returned to matiko09
matiko09 collected $2.50 from pot
matiko09: doesn't show hand 
*** SUMMARY ***
Total pot $2.50 | Rake $0 
Seat 1: BurnsyT folded before Flop (didn't bet)
Seat 2: pandalapa folded before Flop (didn't bet)
Seat 3: deepblue0000 folded before Flop (didn't bet)
Seat 4: sylvian31 folded before Flop (didn't bet)
Seat 5: matiko09 collected ($2.50)
Seat 6: UShallGimme$ (button) folded before Flop (didn't bet)
Seat 8: CoolFireX (small blind) folded before Flop
Seat 9: mycka86 (big blind) folded before Flop





PokerStars Hand #147754063525:  Hold'em No Limit ($0.50/$1.00 USD) - 2016/01/27 11:33:12 CET [2016/01/27 5:33:12 ET]
Table 'Thais' 9-max Seat #6 is the button
Seat 1: Peu3aHy ($130.03 in chips) 
Seat 2: Sweden_Pound ($102.50 in chips) 
Seat 3: RoadtoNepal ($103 in chips) 
Seat 4: aayat ($86.22 in chips) 
Seat 5: matiko09 ($100 in chips) 
Seat 6: deepblue0000 ($103.42 in chips) 
Seat 7: Venomous100% ($276.59 in chips) 
Seat 8: sylvian31 ($101.50 in chips) 
Seat 9: tipner ($117.92 in chips) 
Venomous100%: posts small blind $0.50
sylvian31: posts big blind $1
*** HOLE CARDS ***
Dealt to matiko09 [5s Ad]
tipner: folds 
Peu3aHy: folds 
Sweden_Pound: folds 
RoadtoNepal: raises $2 to $3
aayat: calls $3
matiko09: folds 
deepblue0000: folds 
Venomous100%: folds 
sylvian31: calls $2
*** FLOP *** [5h Ah Kc]
sylvian31: checks 
RoadtoNepal: bets $6.80
aayat: folds 
sylvian31: calls $6.80
*** TURN *** [5h Ah Kc] [2d]
sylvian31: checks 
RoadtoNepal: bets $10.50
sylvian31: folds 
Uncalled bet ($10.50) returned to RoadtoNepal
RoadtoNepal collected $22.06 from pot
RoadtoNepal: doesn't show hand 
*** SUMMARY ***
Total pot $23.10 | Rake $1.04 
Board [5h Ah Kc 2d]
Seat 1: Peu3aHy folded before Flop (didn't bet)
Seat 2: Sweden_Pound folded before Flop (didn't bet)
Seat 3: RoadtoNepal collected ($22.06)
Seat 4: aayat folded on the Flop
Seat 5: matiko09 folded before Flop (didn't bet)
Seat 6: deepblue0000 (button) folded before Flop (didn't bet)
Seat 7: Venomous100% (small blind) folded before Flop
Seat 8: sylvian31 (big blind) folded on the Turn
Seat 9: tipner folded before Flop (didn't bet)





PokerStars Hand #147754064822:  Hold'em No Limit ($0.50/$1.00 USD) - 2016/01/27 11:33:15 CET [2016/01/27 5:33:15 ET]
Table 'Alhajoth' 9-max Seat #4 is the button
Seat 1: UShallGimme$ ($104.75 in chips) 
Seat 2: matiko09 ($100 in chips) 
Seat 3: Sweden_Pound ($116.27 in chips) 
Seat 4: Venomous100% ($127.57 in chips) 
Seat 5: Kukuryzka ($99 in chips) 
Seat 6: RoadtoNepal ($192.80 in chips) 
Seat 7: Ohpeel ($119.63 in chips) 
Seat 8: deepblue0000 ($118.18 in chips) 
Kukuryzka: posts small blind $0.50
RoadtoNepal: posts big blind $1
di0d80: sits out 
*** HOLE CARDS ***
Dealt to matiko09 [5h 9h]
Ohpeel: folds 
deepblue0000: folds 
UShallGimme$: folds 
matiko09: folds 
Sweden_Pound: folds 
Venomous100%: raises $1 to $2
Kukuryzka: folds 
RoadtoNepal: calls $1
*** FLOP *** [6s 3d 6h]
RoadtoNepal: checks 
Venomous100%: bets $2.86
RoadtoNepal: folds 
Uncalled bet ($2.86) returned to Venomous100%
Venomous100% collected $4.30 from pot
Venomous100%: doesn't show hand 
*** SUMMARY ***
Total pot $4.50 | Rake $0.20 
Board [6s 3d 6h]
Seat 1: UShallGimme$ folded before Flop (didn't bet)
Seat 2: matiko09 folded before Flop (didn't bet)
Seat 3: Sweden_Pound folded before Flop (didn't bet)
Seat 4: Venomous100% (button) collected ($4.30)
Seat 5: Kukuryzka (small blind) folded before Flop
Seat 6: RoadtoNepal (big blind) folded on the Flop
Seat 7: Ohpeel folded before Flop (didn't bet)
Seat 8: deepblue0000 folded before Flop (didn't bet)





PokerStars Hand #147754065357:  Hold'em No Limit ($0.50/$1.00 USD) - 2016/01/27 11:33:16 CET [2016/01/27 5:33:16 ET]
Table 'Delphinus II' 9-max Seat #7 is the button
Seat 1: Saintreine ($150.23 in chips) 
Seat 2: AlKatrone ($100 in chips) 
Seat 3: deepblue0000 ($320.82 in chips) 
Seat 4: matiko09 ($124.73 in chips) 
Seat 5: pandalapa ($106.05 in chips) 
Seat 6: Sweden_Pound ($124.64 in chips) 
Seat 7: RUS)Timur ($100 in chips) 
Seat 8: mycka86 ($100 in chips) 
Seat 9: FGL-lucky ($50.38 in chips) 
mycka86: posts small blind $0.50
FGL-lucky: posts big blind $1
*** HOLE CARDS ***
Dealt to matiko09 [2s Kd]
Saintreine: folds 
AlKatrone: folds 
deepblue0000: folds 
matiko09: folds 
pandalapa: folds 
Sweden_Pound: folds 
RUS)Timur: raises $1.45 to $2.45
mycka86: folds 
FGL-lucky: folds 
Uncalled bet ($1.45) returned to RUS)Timur
RUS)Timur collected $2.50 from pot
RUS)Timur: doesn't show hand 
*** SUMMARY ***
Total pot $2.50 | Rake $0 
Seat 1: Saintreine folded before Flop (didn't bet)
Seat 2: AlKatrone folded before Flop (didn't bet)
Seat 3: deepblue0000 folded before Flop (didn't bet)
Seat 4: matiko09 folded before Flop (didn't bet)
Seat 5: pandalapa folded before Flop (didn't bet)
Seat 6: Sweden_Pound folded before Flop (didn't bet)
Seat 7: RUS)Timur (button) collected ($2.50)
Seat 8: mycka86 (small blind) folded before Flop
Seat 9: FGL-lucky (big blind) folded before Flop





PokerStars Hand #147754070968:  Hold'em No Limit ($0.50/$1.00 USD) - 2016/01/27 11:33:27 CET [2016/01/27 5:33:27 ET]
Table 'Nanking' 9-max Seat #9 is the button
Seat 2: Dachish ($102.42 in chips) 
Seat 3: nuaxin ($98 in chips) 
Seat 4: COOLIKO\/23 ($126.24 in chips) 
Seat 5: TheGentleFox ($85.24 in chips) 
Seat 6: Kukuryzka ($100 in chips) 
Seat 7: tipner ($100 in chips) 
Seat 8: matiko09 ($100 in chips) 
Seat 9: Sweden_Pound ($104.64 in chips) 
Peu3aHy will be allowed to play after the button
Dachish: posts small blind $0.50
nuaxin: posts big blind $1
*** HOLE CARDS ***
Dealt to matiko09 [Kh 4d]
COOLIKO\/23: raises $2 to $3
TheGentleFox: folds 
Kukuryzka: folds 
tipner: folds 
matiko09: folds 
Sweden_Pound: folds 
Dachish: folds 
nuaxin: calls $2
*** FLOP *** [As Jd 5s]
nuaxin: bets $3.10
COOLIKO\/23: calls $3.10
*** TURN *** [As Jd 5s] [3s]
nuaxin: bets $6.06
COOLIKO\/23: calls $6.06
*** RIVER *** [As Jd 5s 3s] [6d]
nuaxin: checks 
COOLIKO\/23: bets $14
nuaxin: calls $14
*** SHOW DOWN ***
COOLIKO\/23: shows [5c Ac] (two pair, Aces and Fives)
nuaxin: mucks hand 
COOLIKO\/23 collected $50.44 from pot
*** SUMMARY ***
Total pot $52.82 | Rake $2.38 
Board [As Jd 5s 3s 6d]
Seat 2: Dachish (small blind) folded before Flop
Seat 3: nuaxin (big blind) mucked [Ad Qs]
Seat 4: COOLIKO\/23 showed [5c Ac] and won ($50.44) with two pair, Aces and Fives
Seat 5: TheGentleFox folded before Flop (didn't bet)
Seat 6: Kukuryzka folded before Flop (didn't bet)
Seat 7: tipner folded before Flop (didn't bet)
Seat 8: matiko09 folded before Flop (didn't bet)
Seat 9: Sweden_Pound (button) folded before Flop (didn't bet)





PokerStars Hand #147754074780:  Hold'em No Limit ($0.50/$1.00 USD) - 2016/01/27 11:33:35 CET [2016/01/27 5:33:35 ET]
Table 'Siegena III' 9-max Seat #2 is the button
Seat 1: nnne409 ($43.40 in chips) 
Seat 2: tipner ($100 in chips) 
Seat 3: masaytoo ($92.25 in chips) 
Seat 4: Sweden_Pound ($100 in chips) 
Seat 5: matiko09 ($106.50 in chips) 
Seat 6: RUS)Timur ($150.32 in chips) 
Seat 7: sylvian31 ($100 in chips) 
Seat 8: Venomous100% ($101.50 in chips) 
Seat 9: di0d80 ($124.10 in chips) 
masaytoo: posts small blind $0.50
Sweden_Pound: posts big blind $1
*** HOLE CARDS ***
Dealt to matiko09 [4d 4s]
matiko09: folds 
RUS)Timur: raises $1.45 to $2.45
sylvian31: folds 
Venomous100%: folds 
di0d80: folds 
nnne409: folds 
tipner: folds 
masaytoo: folds 
Sweden_Pound: folds 
Uncalled bet ($1.45) returned to RUS)Timur
RUS)Timur collected $2.50 from pot
RUS)Timur: doesn't show hand 
*** SUMMARY ***
Total pot $2.50 | Rake $0 
Seat 1: nnne409 folded before Flop (didn't bet)
Seat 2: tipner (button) folded before Flop (didn't bet)
Seat 3: masaytoo (small blind) folded before Flop
Seat 4: Sweden_Pound (big blind) folded before Flop
Seat 5: matiko09 folded before Flop (didn't bet)
Seat 6: RUS)Timur collected ($2.50)
Seat 7: sylvian31 folded before Flop (didn't bet)
Seat 8: Venomous100% folded before Flop (didn't bet)
Seat 9: di0d80 folded before Flop (didn't bet)





PokerStars Hand #147754083833:  Hold'em No Limit ($0.50/$1.00 USD) - 2016/01/27 11:33:53 CET [2016/01/27 5:33:53 ET]
Table 'Delphinus II' 9-max Seat #8 is the button
Seat 1: Saintreine ($150.23 in chips) 
Seat 2: AlKatrone ($100 in chips) 
Seat 3: deepblue0000 ($320.82 in chips) 
Seat 4: matiko09 ($124.73 in chips) 
Seat 5: pandalapa ($106.05 in chips) 
Seat 6: Sweden_Pound ($124.64 in chips) 
Seat 7: RUS)Timur ($101.50 in chips) 
Seat 8: mycka86 ($100 in chips) 
Seat 9: FGL-lucky ($49.38 in chips) 
FGL-lucky: posts small blind $0.50
Saintreine: posts big blind $1
*** HOLE CARDS ***
Dealt to matiko09 [Qc 7c]
AlKatrone: folds 
deepblue0000: raises $2 to $3
matiko09: folds 
pandalapa: folds 
Sweden_Pound: folds 
RUS)Timur: folds 
mycka86: folds 
FGL-lucky: calls $2.50
Saintreine: calls $2
*** FLOP *** [3h Qs 3d]
FGL-lucky: checks 
Saintreine: bets $4.47
deepblue0000: raises $11.69 to $16.16
FGL-lucky: folds 
Saintreine: folds 
Uncalled bet ($11.69) returned to deepblue0000
deepblue0000 collected $17.13 from pot
*** SUMMARY ***
Total pot $17.94 | Rake $0.81 
Board [3h Qs 3d]
Seat 1: Saintreine (big blind) folded on the Flop
Seat 2: AlKatrone folded before Flop (didn't bet)
Seat 3: deepblue0000 collected ($17.13)
Seat 4: matiko09 folded before Flop (didn't bet)
Seat 5: pandalapa folded before Flop (didn't bet)
Seat 6: Sweden_Pound folded before Flop (didn't bet)
Seat 7: RUS)Timur folded before Flop (didn't bet)
Seat 8: mycka86 (button) folded before Flop (didn't bet)
Seat 9: FGL-lucky (small blind) folded on the Flop





PokerStars Hand #147754089204:  Hold'em No Limit ($0.50/$1.00 USD) - 2016/01/27 11:34:03 CET [2016/01/27 5:34:03 ET]
Table 'Fragaria II' 9-max Seat #6 is the button
Seat 1: deepblue0000 ($105.78 in chips) 
Seat 2: GG-NoR34D. ($75.94 in chips) 
Seat 3: Sweden_Pound ($119.01 in chips) 
Seat 4: AlKatrone ($101 in chips) 
Seat 5: Venomous100% ($106.62 in chips) 
Seat 6: UShallGimme$ ($201.02 in chips) 
Seat 7: Hobby-.-AK ($29.71 in chips) 
Seat 8: mycka86 ($110.10 in chips) 
Seat 9: matiko09 ($100 in chips) 
Hobby-.-AK: posts small blind $0.50
mycka86: posts big blind $1
*** HOLE CARDS ***
Dealt to matiko09 [Ts Qh]
matiko09: folds 
deepblue0000: folds 
GG-NoR34D.: calls $1
Sweden_Pound: folds 
AlKatrone: folds 
Venomous100%: folds 
UShallGimme$: raises $3 to $4
Hobby-.-AK: folds 
mycka86: folds 
GG-NoR34D.: calls $3
*** FLOP *** [3d 4s Ac]
GG-NoR34D.: checks 
UShallGimme$: checks 
*** TURN *** [3d 4s Ac] [Th]
GG-NoR34D.: bets $4.53
UShallGimme$: calls $4.53
*** RIVER *** [3d 4s Ac Th] [5c]
GG-NoR34D.: bets $12.06
UShallGimme$: folds 
Uncalled bet ($12.06) returned to GG-NoR34D.
GG-NoR34D. collected $17.72 from pot
*** SUMMARY ***
Total pot $18.56 | Rake $0.84 
Board [3d 4s Ac Th 5c]
Seat 1: deepblue0000 folded before Flop (didn't bet)
Seat 2: GG-NoR34D. collected ($17.72)
Seat 3: Sweden_Pound folded before Flop (didn't bet)
Seat 4: AlKatrone folded before Flop (didn't bet)
Seat 5: Venomous100% folded before Flop (didn't bet)
Seat 6: UShallGimme$ (button) folded on the River
Seat 7: Hobby-.-AK (small blind) folded before Flop
Seat 8: mycka86 (big blind) folded before Flop
Seat 9: matiko09 folded before Flop (didn't bet)





PokerStars Hand #147754090150:  Hold'em No Limit ($0.50/$1.00 USD) - 2016/01/27 11:34:05 CET [2016/01/27 5:34:05 ET]
Table 'Alhajoth' 9-max Seat #5 is the button
Seat 1: UShallGimme$ ($104.75 in chips) 
Seat 2: matiko09 ($100 in chips) 
Seat 3: Sweden_Pound ($116.27 in chips) 
Seat 4: Venomous100% ($129.87 in chips) 
Seat 5: Kukuryzka ($100 in chips) 
Seat 6: RoadtoNepal ($190.80 in chips) 
Seat 7: Ohpeel ($119.63 in chips) 
Seat 8: deepblue0000 ($118.18 in chips) 
RoadtoNepal: posts small blind $0.50
Ohpeel: posts big blind $1
di0d80: sits out 
*** HOLE CARDS ***
Dealt to matiko09 [6s Ad]
deepblue0000: folds 
UShallGimme$: folds 
matiko09: folds 
Sweden_Pound: folds 
Venomous100%: folds 
Kukuryzka: folds 
RoadtoNepal: raises $2 to $3
Ohpeel: folds 
Uncalled bet ($2) returned to RoadtoNepal
RoadtoNepal collected $2 from pot
RoadtoNepal: doesn't show hand 
*** SUMMARY ***
Total pot $2 | Rake $0 
Seat 1: UShallGimme$ folded before Flop (didn't bet)
Seat 2: matiko09 folded before Flop (didn't bet)
Seat 3: Sweden_Pound folded before Flop (didn't bet)
Seat 4: Venomous100% folded before Flop (didn't bet)
Seat 5: Kukuryzka (button) folded before Flop (didn't bet)
Seat 6: RoadtoNepal (small blind) collected ($2)
Seat 7: Ohpeel (big blind) folded before Flop
Seat 8: deepblue0000 folded before Flop (didn't bet)





PokerStars Hand #147754091599:  Hold'em No Limit ($0.50/$1.00 USD) - 2016/01/27 11:34:08 CET [2016/01/27 5:34:08 ET]
Table 'Henyey' 9-max Seat #8 is the button
Seat 2: pandalapa ($153.77 in chips) 
Seat 3: deepblue0000 ($101.36 in chips) 
Seat 4: sylvian31 ($106.75 in chips) 
Seat 5: matiko09 ($110.50 in chips) 
Seat 6: UShallGimme$ ($100 in chips) 
Seat 8: CoolFireX ($112.10 in chips) 
Seat 9: mycka86 ($131.11 in chips) 
mycka86: posts small blind $0.50
pandalapa: posts big blind $1
*** HOLE CARDS ***
Dealt to matiko09 [5d 3d]
deepblue0000: calls $1
sylvian31: folds 
matiko09: folds 
UShallGimme$: folds 
CoolFireX: folds 
mycka86: calls $0.50
pandalapa: checks 
*** FLOP *** [2h 9d 6s]
mycka86: checks 
pandalapa: checks 
deepblue0000: checks 
*** TURN *** [2h 9d 6s] [Qh]
mycka86: bets $3.80
pandalapa: folds 
deepblue0000: folds 
Uncalled bet ($3.80) returned to mycka86
mycka86 collected $2.86 from pot
*** SUMMARY ***
Total pot $3 | Rake $0.14 
Board [2h 9d 6s Qh]
Seat 2: pandalapa (big blind) folded on the Turn
Seat 3: deepblue0000 folded on the Turn
Seat 4: sylvian31 folded before Flop (didn't bet)
Seat 5: matiko09 folded before Flop (didn't bet)
Seat 6: UShallGimme$ folded before Flop (didn't bet)
Seat 8: CoolFireX (button) folded before Flop (didn't bet)
Seat 9: mycka86 (small blind) collected ($2.86)





PokerStars Hand #147754091501:  Hold'em No Limit ($0.50/$1.00 USD) - 2016/01/27 11:34:08 CET [2016/01/27 5:34:08 ET]
Table 'Eudora III' 9-max Seat #1 is the button
Seat 1: Peu3aHy ($100 in chips) 
Seat 2: GrossiM ($100 in chips) 
Seat 3: matiko09 ($103 in chips) 
Seat 4: Reven9er ($111.28 in chips) 
Seat 5: di0d80 ($131.68 in chips) 
Seat 6: DIMAZAYAC ($45.98 in chips) 
Seat 7: Sweden_Pound ($100 in chips) 
Seat 8: RUS)Timur ($101.68 in chips) 
Seat 9: Venomous100% ($100 in chips) 
GrossiM: posts small blind $0.50
matiko09: posts big blind $1
*** HOLE CARDS ***
Dealt to matiko09 [Qc 7c]
Reven9er: folds 
di0d80: folds 
DIMAZAYAC: folds 
Sweden_Pound: folds 
RUS)Timur: folds 
Venomous100%: folds 
Peu3aHy: raises $2 to $3
GrossiM: folds 
matiko09: calls $2
*** FLOP *** [Ts 9s 4c]
matiko09: checks 
Peu3aHy: bets $4
matiko09: calls $4
*** TURN *** [Ts 9s 4c] [Ah]
matiko09: checks 
Peu3aHy: bets $10
matiko09: folds 
Uncalled bet ($10) returned to Peu3aHy
Peu3aHy collected $13.85 from pot
Peu3aHy: doesn't show hand 
*** SUMMARY ***
Total pot $14.50 | Rake $0.65 
Board [Ts 9s 4c Ah]
Seat 1: Peu3aHy (button) collected ($13.85)
Seat 2: GrossiM (small blind) folded before Flop
Seat 3: matiko09 (big blind) folded on the Turn
Seat 4: Reven9er folded before Flop (didn't bet)
Seat 5: di0d80 folded before Flop (didn't bet)
Seat 6: DIMAZAYAC folded before Flop (didn't bet)
Seat 7: Sweden_Pound folded before Flop (didn't bet)
Seat 8: RUS)Timur folded before Flop (didn't bet)
Seat 9: Venomous100% folded before Flop (didn't bet)





PokerStars Hand #147754093799:  Hold'em No Limit ($0.50/$1.00 USD) - 2016/01/27 11:34:13 CET [2016/01/27 5:34:13 ET]
Table 'Siegena III' 9-max Seat #3 is the button
Seat 1: nnne409 ($83.40 in chips) 
Seat 2: tipner ($100 in chips) 
Seat 3: masaytoo ($91.75 in chips) 
Seat 4: Sweden_Pound ($100 in chips) 
Seat 5: matiko09 ($106.50 in chips) 
Seat 6: RUS)Timur ($151.82 in chips) 
Seat 7: sylvian31 ($100 in chips) 
Seat 8: Venomous100% ($101.50 in chips) 
Seat 9: di0d80 ($124.10 in chips) 
Sweden_Pound: posts small blind $0.50
matiko09: posts big blind $1
*** HOLE CARDS ***
Dealt to matiko09 [7h 6d]
RUS)Timur: folds 
sylvian31: folds 
Venomous100%: folds 
di0d80: folds 
nnne409: folds 
tipner: raises $2 to $3
masaytoo: folds 
Sweden_Pound: folds 
matiko09: folds 
Uncalled bet ($2) returned to tipner
tipner collected $2.50 from pot
tipner: doesn't show hand 
*** SUMMARY ***
Total pot $2.50 | Rake $0 
Seat 1: nnne409 folded before Flop (didn't bet)
Seat 2: tipner collected ($2.50)
Seat 3: masaytoo (button) folded before Flop (didn't bet)
Seat 4: Sweden_Pound (small blind) folded before Flop
Seat 5: matiko09 (big blind) folded before Flop
Seat 6: RUS)Timur folded before Flop (didn't bet)
Seat 7: sylvian31 folded before Flop (didn't bet)
Seat 8: Venomous100% folded before Flop (didn't bet)
Seat 9: di0d80 folded before Flop (didn't bet)





PokerStars Hand #147754095736:  Hold'em No Limit ($0.50/$1.00 USD) - 2016/01/27 11:34:17 CET [2016/01/27 5:34:17 ET]
Table 'Malzovia' 9-max Seat #2 is the button
Seat 1: mycka86 ($100 in chips) 
Seat 2: Sweden_Pound ($113.12 in chips) 
Seat 3: Reven9er ($100 in chips) 
Seat 4: AlKatrone ($198.70 in chips) 
Seat 5: matiko09 ($100 in chips) 
Seat 6: deepblue0000 ($327.24 in chips) 
Seat 7: Peu3aHy ($153.06 in chips) 
Seat 9: UShallGimme$ ($168.96 in chips) 
Reven9er: posts small blind $0.50
AlKatrone: posts big blind $1
*** HOLE CARDS ***
Dealt to matiko09 [3c 9s]
matiko09: folds 
deepblue0000: folds 
Peu3aHy: folds 
UShallGimme$: folds 
mycka86: folds 
Sweden_Pound: folds 
Reven9er: raises $1.50 to $2.50
AlKatrone: calls $1.50
*** FLOP *** [4h Ad 3d]
Reven9er: checks 
AlKatrone: bets $1.62
Reven9er: calls $1.62
*** TURN *** [4h Ad 3d] [5c]
Reven9er: checks 
AlKatrone: bets $5.90
Reven9er: folds 
Uncalled bet ($5.90) returned to AlKatrone
AlKatrone collected $7.87 from pot
AlKatrone: doesn't show hand 
*** SUMMARY ***
Total pot $8.24 | Rake $0.37 
Board [4h Ad 3d 5c]
Seat 1: mycka86 folded before Flop (didn't bet)
Seat 2: Sweden_Pound (button) folded before Flop (didn't bet)
Seat 3: Reven9er (small blind) folded on the Turn
Seat 4: AlKatrone (big blind) collected ($7.87)
Seat 5: matiko09 folded before Flop (didn't bet)
Seat 6: deepblue0000 folded before Flop (didn't bet)
Seat 7: Peu3aHy folded before Flop (didn't bet)
Seat 9: UShallGimme$ folded before Flop (didn't bet)





PokerStars Hand #147754104761:  Hold'em No Limit ($0.50/$1.00 USD) - 2016/01/27 11:34:35 CET [2016/01/27 5:34:35 ET]
Table 'Alkmene II' 9-max Seat #4 is the button
Seat 1: matiko09 ($100 in chips) 
Seat 2: deepblue0000 ($100 in chips) 
Seat 3: MuSaShiBuShi ($32.08 in chips) 
Seat 4: CoolFireX ($150.07 in chips) 
Seat 5: Sweden_Pound ($120.05 in chips) 
Seat 6: Peu3aHy ($110.03 in chips) 
Seat 7: mycka86 ($125.86 in chips) 
Seat 8: fecsok1 ($67.31 in chips) 
Seat 9: pandalapa ($100 in chips) 
Sweden_Pound: posts small blind $0.50
Peu3aHy: posts big blind $1
*** HOLE CARDS ***
Dealt to matiko09 [Tc 2d]
mycka86: folds 
fecsok1: raises $1.50 to $2.50
pandalapa: folds 
matiko09: folds 
deepblue0000: folds 
MuSaShiBuShi: folds 
CoolFireX: folds 
Sweden_Pound: folds 
Peu3aHy: folds 
Uncalled bet ($1.50) returned to fecsok1
fecsok1 collected $2.50 from pot
*** SUMMARY ***
Total pot $2.50 | Rake $0 
Seat 1: matiko09 folded before Flop (didn't bet)
Seat 2: deepblue0000 folded before Flop (didn't bet)
Seat 3: MuSaShiBuShi folded before Flop (didn't bet)
Seat 4: CoolFireX (button) folded before Flop (didn't bet)
Seat 5: Sweden_Pound (small blind) folded before Flop
Seat 6: Peu3aHy (big blind) folded before Flop
Seat 7: mycka86 folded before Flop (didn't bet)
Seat 8: fecsok1 collected ($2.50)
Seat 9: pandalapa folded before Flop (didn't bet)





PokerStars Hand #147754105375:  Hold'em No Limit ($0.50/$1.00 USD) - 2016/01/27 11:34:36 CET [2016/01/27 5:34:36 ET]
Table 'Nanking' 9-max Seat #2 is the button
Seat 2: Dachish ($101.92 in chips) 
Seat 3: nuaxin ($71.84 in chips) 
Seat 4: COOLIKO\/23 ($150.52 in chips) 
Seat 5: TheGentleFox ($85.24 in chips) 
Seat 6: Kukuryzka ($100 in chips) 
Seat 7: tipner ($100 in chips) 
Seat 8: matiko09 ($100 in chips) 
Seat 9: Sweden_Pound ($104.64 in chips) 
nuaxin: posts small blind $0.50
COOLIKO\/23: posts big blind $1
Peu3aHy: sits out 
*** HOLE CARDS ***
Dealt to matiko09 [3c Qc]
TheGentleFox: folds 
Kukuryzka: folds 
tipner: folds 
matiko09: folds 
Sweden_Pound: folds 
Dachish: folds 
nuaxin: calls $0.50
COOLIKO\/23: raises $3 to $4
nuaxin: calls $3
*** FLOP *** [Ah 8c 5s]
nuaxin: checks 
COOLIKO\/23: bets $3.82
nuaxin: folds 
Uncalled bet ($3.82) returned to COOLIKO\/23
COOLIKO\/23 collected $7.64 from pot
COOLIKO\/23: doesn't show hand 
*** SUMMARY ***
Total pot $8 | Rake $0.36 
Board [Ah 8c 5s]
Seat 2: Dachish (button) folded before Flop (didn't bet)
Seat 3: nuaxin (small blind) folded on the Flop
Seat 4: COOLIKO\/23 (big blind) collected ($7.64)
Seat 5: TheGentleFox folded before Flop (didn't bet)
Seat 6: Kukuryzka folded before Flop (didn't bet)
Seat 7: tipner folded before Flop (didn't bet)
Seat 8: matiko09 folded before Flop (didn't bet)
Seat 9: Sweden_Pound folded before Flop (didn't bet)





PokerStars Hand #147754106284:  Hold'em No Limit ($0.50/$1.00 USD) - 2016/01/27 11:34:38 CET [2016/01/27 5:34:38 ET]
Table 'Alhajoth' 9-max Seat #6 is the button
Seat 1: UShallGimme$ ($104.75 in chips) 
Seat 2: matiko09 ($100 in chips) 
Seat 3: Sweden_Pound ($116.27 in chips) 
Seat 4: Venomous100% ($129.87 in chips) 
Seat 5: Kukuryzka ($100 in chips) 
Seat 6: RoadtoNepal ($191.80 in chips) 
Seat 7: Ohpeel ($118.63 in chips) 
Seat 8: deepblue0000 ($118.18 in chips) 
Ohpeel: posts small blind $0.50
deepblue0000: posts big blind $1
di0d80: sits out 
*** HOLE CARDS ***
Dealt to matiko09 [9c 7h]
UShallGimme$: folds 
matiko09: folds 
Sweden_Pound: raises $2 to $3
Venomous100%: folds 
Kukuryzka: folds 
RoadtoNepal: folds 
Ohpeel: folds 
deepblue0000: folds 
Uncalled bet ($2) returned to Sweden_Pound
Sweden_Pound collected $2.50 from pot
Sweden_Pound: doesn't show hand 
*** SUMMARY ***
Total pot $2.50 | Rake $0 
Seat 1: UShallGimme$ folded before Flop (didn't bet)
Seat 2: matiko09 folded before Flop (didn't bet)
Seat 3: Sweden_Pound collected ($2.50)
Seat 4: Venomous100% folded before Flop (didn't bet)
Seat 5: Kukuryzka folded before Flop (didn't bet)
Seat 6: RoadtoNepal (button) folded before Flop (didn't bet)
Seat 7: Ohpeel (small blind) folded before Flop
Seat 8: deepblue0000 (big blind) folded before Flop





PokerStars Hand #147754111625:  Hold'em No Limit ($0.50/$1.00 USD) - 2016/01/27 11:34:49 CET [2016/01/27 5:34:49 ET]
Table 'Thais' 9-max Seat #7 is the button
Seat 1: Peu3aHy ($130.03 in chips) 
Seat 2: Sweden_Pound ($102.50 in chips) 
Seat 3: RoadtoNepal ($115.26 in chips) 
Seat 4: aayat ($83.22 in chips) 
Seat 5: matiko09 ($100 in chips) 
Seat 6: deepblue0000 ($103.42 in chips) 
Seat 7: Venomous100% ($276.09 in chips) 
Seat 8: sylvian31 ($100 in chips) 
Seat 9: tipner ($117.92 in chips) 
sylvian31: posts small blind $0.50
tipner: posts big blind $1
*** HOLE CARDS ***
Dealt to matiko09 [Qd 9h]
Peu3aHy: folds 
Sweden_Pound: folds 
RoadtoNepal: folds 
aayat: folds 
matiko09: folds 
deepblue0000: raises $1.50 to $2.50
Venomous100%: folds 
sylvian31: folds 
tipner: folds 
Uncalled bet ($1.50) returned to deepblue0000
deepblue0000 collected $2.50 from pot
*** SUMMARY ***
Total pot $2.50 | Rake $0 
Seat 1: Peu3aHy folded before Flop (didn't bet)
Seat 2: Sweden_Pound folded before Flop (didn't bet)
Seat 3: RoadtoNepal folded before Flop (didn't bet)
Seat 4: aayat folded before Flop (didn't bet)
Seat 5: matiko09 folded before Flop (didn't bet)
Seat 6: deepblue0000 collected ($2.50)
Seat 7: Venomous100% (button) folded before Flop (didn't bet)
Seat 8: sylvian31 (small blind) folded before Flop
Seat 9: tipner (big blind) folded before Flop





PokerStars Hand #147754112610:  Hold'em No Limit ($0.50/$1.00 USD) - 2016/01/27 11:34:51 CET [2016/01/27 5:34:51 ET]
Table 'Siegena III' 9-max Seat #4 is the button
Seat 1: nnne409 ($83.40 in chips) 
Seat 2: tipner ($101.50 in chips) 
Seat 3: masaytoo ($91.75 in chips) 
Seat 4: Sweden_Pound ($100 in chips) 
Seat 5: matiko09 ($105.50 in chips) 
Seat 6: RUS)Timur ($151.82 in chips) 
Seat 7: sylvian31 ($100 in chips) 
Seat 8: Venomous100% ($101.50 in chips) 
Seat 9: di0d80 ($124.10 in chips) 
matiko09: posts small blind $0.50
RUS)Timur: posts big blind $1
*** HOLE CARDS ***
Dealt to matiko09 [Td Jd]
sylvian31: raises $2 to $3
Venomous100%: folds 
di0d80: calls $3
nnne409: folds 
tipner: folds 
masaytoo: folds 
Sweden_Pound: folds 
matiko09: folds 
RUS)Timur: folds 
*** FLOP *** [3c 2d 6c]
sylvian31: checks 
di0d80: bets $5
sylvian31: calls $5
*** TURN *** [3c 2d 6c] [2h]
sylvian31: checks 
di0d80: bets $12
sylvian31: calls $12
*** RIVER *** [3c 2d 6c 2h] [As]
sylvian31: checks 
di0d80: bets $19
sylvian31: calls $19
*** SHOW DOWN ***
di0d80: shows [Ks Kh] (two pair, Kings and Deuces)
sylvian31: shows [Ac Qc] (two pair, Aces and Deuces)
sylvian31 collected $76.70 from pot
*** SUMMARY ***
Total pot $79.50 | Rake $2.80 
Board [3c 2d 6c 2h As]
Seat 1: nnne409 folded before Flop (didn't bet)
Seat 2: tipner folded before Flop (didn't bet)
Seat 3: masaytoo folded before Flop (didn't bet)
Seat 4: Sweden_Pound (button) folded before Flop (didn't bet)
Seat 5: matiko09 (small blind) folded before Flop
Seat 6: RUS)Timur (big blind) folded before Flop
Seat 7: sylvian31 showed [Ac Qc] and won ($76.70) with two pair, Aces and Deuces
Seat 8: Venomous100% folded before Flop (didn't bet)
Seat 9: di0d80 showed [Ks Kh] and lost with two pair, Kings and Deuces





PokerStars Hand #147754115824:  Hold'em No Limit ($0.50/$1.00 USD) - 2016/01/27 11:34:57 CET [2016/01/27 5:34:57 ET]
Table 'Eudora III' 9-max Seat #2 is the button
Seat 1: Peu3aHy ($106.85 in chips) 
Seat 2: GrossiM ($100 in chips) 
Seat 3: matiko09 ($100 in chips) 
Seat 4: Reven9er ($111.28 in chips) 
Seat 5: di0d80 ($131.68 in chips) 
Seat 6: DIMAZAYAC ($45.98 in chips) 
Seat 7: Sweden_Pound ($100 in chips) 
Seat 8: RUS)Timur ($101.68 in chips) 
Seat 9: Venomous100% ($100 in chips) 
matiko09: posts small blind $0.50
Reven9er: posts big blind $1
*** HOLE CARDS ***
Dealt to matiko09 [Th 3d]
di0d80: folds 
DIMAZAYAC: raises $1 to $2
Sweden_Pound: folds 
RUS)Timur: folds 
Venomous100%: folds 
Peu3aHy: folds 
GrossiM: folds 
matiko09: folds 
Reven9er: folds 
Uncalled bet ($1) returned to DIMAZAYAC
DIMAZAYAC collected $2.50 from pot
*** SUMMARY ***
Total pot $2.50 | Rake $0 
Seat 1: Peu3aHy folded before Flop (didn't bet)
Seat 2: GrossiM (button) folded before Flop (didn't bet)
Seat 3: matiko09 (small blind) folded before Flop
Seat 4: Reven9er (big blind) folded before Flop
Seat 5: di0d80 folded before Flop (didn't bet)
Seat 6: DIMAZAYAC collected ($2.50)
Seat 7: Sweden_Pound folded before Flop (didn't bet)
Seat 8: RUS)Timur folded before Flop (didn't bet)
Seat 9: Venomous100% folded before Flop (didn't bet)





PokerStars Hand #147754122126:  Hold'em No Limit ($0.50/$1.00 USD) - 2016/01/27 11:35:10 CET [2016/01/27 5:35:10 ET]
Table 'Alkmene II' 9-max Seat #5 is the button
Seat 1: matiko09 ($100 in chips) 
Seat 2: deepblue0000 ($100 in chips) 
Seat 3: MuSaShiBuShi ($32.08 in chips) 
Seat 4: CoolFireX ($150.07 in chips) 
Seat 5: Sweden_Pound ($119.55 in chips) 
Seat 6: Peu3aHy ($109.03 in chips) 
Seat 7: mycka86 ($125.86 in chips) 
Seat 8: fecsok1 ($68.81 in chips) 
Seat 9: pandalapa ($100 in chips) 
Peu3aHy: posts small blind $0.50
mycka86: posts big blind $1
*** HOLE CARDS ***
Dealt to matiko09 [Qs 9d]
fecsok1: folds 
pandalapa: raises $2 to $3
matiko09: folds 
deepblue0000: folds 
MuSaShiBuShi: folds 
CoolFireX: folds 
Sweden_Pound: folds 
Peu3aHy: folds 
mycka86: folds 
Uncalled bet ($2) returned to pandalapa
pandalapa collected $2.50 from pot
pandalapa: doesn't show hand 
*** SUMMARY ***
Total pot $2.50 | Rake $0 
Seat 1: matiko09 folded before Flop (didn't bet)
Seat 2: deepblue0000 folded before Flop (didn't bet)
Seat 3: MuSaShiBuShi folded before Flop (didn't bet)
Seat 4: CoolFireX folded before Flop (didn't bet)
Seat 5: Sweden_Pound (button) folded before Flop (didn't bet)
Seat 6: Peu3aHy (small blind) folded before Flop
Seat 7: mycka86 (big blind) folded before Flop
Seat 8: fecsok1 folded before Flop (didn't bet)
Seat 9: pandalapa collected ($2.50)





PokerStars Hand #147754122618:  Hold'em No Limit ($0.50/$1.00 USD) - 2016/01/27 11:35:11 CET [2016/01/27 5:35:11 ET]
Table 'Alhajoth' 9-max Seat #7 is the button
Seat 1: UShallGimme$ ($104.75 in chips) 
Seat 2: matiko09 ($100 in chips) 
Seat 3: Sweden_Pound ($117.77 in chips) 
Seat 4: Venomous100% ($129.87 in chips) 
Seat 5: Kukuryzka ($100 in chips) 
Seat 6: RoadtoNepal ($191.80 in chips) 
Seat 7: Ohpeel ($118.13 in chips) 
Seat 8: deepblue0000 ($117.18 in chips) 
Seat 9: di0d80 ($100 in chips) 
deepblue0000: posts small blind $0.50
di0d80: posts big blind $1
*** HOLE CARDS ***
Dealt to matiko09 [9c 2s]
UShallGimme$: raises $2 to $3
matiko09: folds 
Sweden_Pound: folds 
Venomous100%: folds 
Kukuryzka: folds 
RoadtoNepal: folds 
Ohpeel: calls $3
deepblue0000: folds 
di0d80: raises $9 to $12
UShallGimme$: calls $9
Ohpeel: folds 
*** FLOP *** [7h 3h Tc]
di0d80: bets $12
UShallGimme$: calls $12
*** TURN *** [7h 3h Tc] [6d]
di0d80: bets $22
UShallGimme$: calls $22
*** RIVER *** [7h 3h Tc 6d] [Ts]
di0d80: checks 
UShallGimme$: checks 
*** SHOW DOWN ***
di0d80: shows [Ad Qh] (a pair of Tens)
UShallGimme$: shows [8s 8c] (two pair, Tens and Eights)
UShallGimme$ collected $92.70 from pot
*** SUMMARY ***
Total pot $95.50 | Rake $2.80 
Board [7h 3h Tc 6d Ts]
Seat 1: UShallGimme$ showed [8s 8c] and won ($92.70) with two pair, Tens and Eights
Seat 2: matiko09 folded before Flop (didn't bet)
Seat 3: Sweden_Pound folded before Flop (didn't bet)
Seat 4: Venomous100% folded before Flop (didn't bet)
Seat 5: Kukuryzka folded before Flop (didn't bet)
Seat 6: RoadtoNepal folded before Flop (didn't bet)
Seat 7: Ohpeel (button) folded before Flop
Seat 8: deepblue0000 (small blind) folded before Flop
Seat 9: di0d80 (big blind) showed [Ad Qh] and lost with a pair of Tens





PokerStars Hand #147754125412:  Hold'em No Limit ($0.50/$1.00 USD) - 2016/01/27 11:35:16 CET [2016/01/27 5:35:16 ET]
Table 'Thais' 9-max Seat #8 is the button
Seat 1: Peu3aHy ($130.03 in chips) 
Seat 2: Sweden_Pound ($102.50 in chips) 
Seat 3: RoadtoNepal ($115.26 in chips) 
Seat 4: aayat ($83.22 in chips) 
Seat 5: matiko09 ($100 in chips) 
Seat 6: deepblue0000 ($104.92 in chips) 
Seat 7: Venomous100% ($276.09 in chips) 
Seat 8: sylvian31 ($100 in chips) 
Seat 9: tipner ($116.92 in chips) 
tipner: posts small blind $0.50
Peu3aHy: posts big blind $1
*** HOLE CARDS ***
Dealt to matiko09 [2h 5h]
Sweden_Pound: folds 
RoadtoNepal: raises $2 to $3
aayat: calls $3
matiko09: folds 
deepblue0000: folds 
Venomous100%: folds 
sylvian31: folds 
tipner: folds 
Peu3aHy: folds 
*** FLOP *** [Ks Jh 6d]
RoadtoNepal: checks 
aayat: bets $3.58
RoadtoNepal: calls $3.58
*** TURN *** [Ks Jh 6d] [As]
RoadtoNepal: bets $9.50
aayat: calls $9.50
*** RIVER *** [Ks Jh 6d As] [Kd]
RoadtoNepal: checks 
aayat: bets $19
RoadtoNepal: folds 
Uncalled bet ($19) returned to aayat
aayat collected $32.15 from pot
aayat: doesn't show hand 
*** SUMMARY ***
Total pot $33.66 | Rake $1.51 
Board [Ks Jh 6d As Kd]
Seat 1: Peu3aHy (big blind) folded before Flop
Seat 2: Sweden_Pound folded before Flop (didn't bet)
Seat 3: RoadtoNepal folded on the River
Seat 4: aayat collected ($32.15)
Seat 5: matiko09 folded before Flop (didn't bet)
Seat 6: deepblue0000 folded before Flop (didn't bet)
Seat 7: Venomous100% folded before Flop (didn't bet)
Seat 8: sylvian31 (button) folded before Flop (didn't bet)
Seat 9: tipner (small blind) folded before Flop





PokerStars Hand #147754126990:  Hold'em No Limit ($0.50/$1.00 USD) - 2016/01/27 11:35:20 CET [2016/01/27 5:35:20 ET]
Table 'Nanking' 9-max Seat #3 is the button
Seat 2: Dachish ($101.92 in chips) 
Seat 3: nuaxin ($67.84 in chips) 
Seat 4: COOLIKO\/23 ($154.16 in chips) 
Seat 5: TheGentleFox ($85.24 in chips) 
Seat 6: Kukuryzka ($100 in chips) 
Seat 7: tipner ($100 in chips) 
Seat 8: matiko09 ($100 in chips) 
Seat 9: Sweden_Pound ($104.64 in chips) 
COOLIKO\/23: posts small blind $0.50
TheGentleFox: posts big blind $1
Peu3aHy: sits out 
*** HOLE CARDS ***
Dealt to matiko09 [Qs 8d]
Kukuryzka: folds 
tipner: folds 
matiko09: folds 
Sweden_Pound: raises $2 to $3
Dachish: folds 
nuaxin: folds 
COOLIKO\/23: folds 
TheGentleFox: calls $2
*** FLOP *** [4h As 9s]
TheGentleFox: checks 
Sweden_Pound: bets $4.04
TheGentleFox: folds 
Uncalled bet ($4.04) returned to Sweden_Pound
Sweden_Pound collected $6.21 from pot
Sweden_Pound: doesn't show hand 
*** SUMMARY ***
Total pot $6.50 | Rake $0.29 
Board [4h As 9s]
Seat 2: Dachish folded before Flop (didn't bet)
Seat 3: nuaxin (button) folded before Flop (didn't bet)
Seat 4: COOLIKO\/23 (small blind) folded before Flop
Seat 5: TheGentleFox (big blind) folded on the Flop
Seat 6: Kukuryzka folded before Flop (didn't bet)
Seat 7: tipner folded before Flop (didn't bet)
Seat 8: matiko09 folded before Flop (didn't bet)
Seat 9: Sweden_Pound collected ($6.21)





PokerStars Hand #147754127780:  Hold'em No Limit ($0.50/$1.00 USD) - 2016/01/27 11:35:21 CET [2016/01/27 5:35:21 ET]
Table 'Fragaria II' 9-max Seat #7 is the button
Seat 1: deepblue0000 ($105.78 in chips) 
Seat 2: GG-NoR34D. ($85.13 in chips) 
Seat 3: Sweden_Pound ($119.01 in chips) 
Seat 4: AlKatrone ($101 in chips) 
Seat 5: Venomous100% ($106.62 in chips) 
Seat 6: UShallGimme$ ($192.49 in chips) 
Seat 7: Hobby-.-AK ($29.21 in chips) 
Seat 8: mycka86 ($109.10 in chips) 
Seat 9: matiko09 ($100 in chips) 
mycka86: posts small blind $0.50
matiko09: posts big blind $1
*** HOLE CARDS ***
Dealt to matiko09 [9c 9h]
deepblue0000: folds 
GG-NoR34D.: folds 
Sweden_Pound: folds 
AlKatrone: folds 
Venomous100%: folds 
UShallGimme$: folds 
Hobby-.-AK: raises $1 to $2
mycka86: folds 
matiko09: raises $6 to $8
Hobby-.-AK: folds 
Uncalled bet ($6) returned to matiko09
matiko09 collected $4.50 from pot
matiko09: doesn't show hand 
*** SUMMARY ***
Total pot $4.50 | Rake $0 
Seat 1: deepblue0000 folded before Flop (didn't bet)
Seat 2: GG-NoR34D. folded before Flop (didn't bet)
Seat 3: Sweden_Pound folded before Flop (didn't bet)
Seat 4: AlKatrone folded before Flop (didn't bet)
Seat 5: Venomous100% folded before Flop (didn't bet)
Seat 6: UShallGimme$ folded before Flop (didn't bet)
Seat 7: Hobby-.-AK (button) folded before Flop
Seat 8: mycka86 (small blind) folded before Flop
Seat 9: matiko09 (big blind) collected ($4.50)





PokerStars Hand #147754128708:  Hold'em No Limit ($0.50/$1.00 USD) - 2016/01/27 11:35:23 CET [2016/01/27 5:35:23 ET]
Table 'Delphinus II' 9-max Seat #9 is the button
Seat 1: Saintreine ($142.76 in chips) 
Seat 2: AlKatrone ($100 in chips) 
Seat 3: deepblue0000 ($330.48 in chips) 
Seat 4: matiko09 ($124.73 in chips) 
Seat 5: pandalapa ($106.05 in chips) 
Seat 6: Sweden_Pound ($124.64 in chips) 
Seat 7: RUS)Timur ($101.50 in chips) 
Seat 8: mycka86 ($100 in chips) 
Seat 9: FGL-lucky ($46.38 in chips) 
Saintreine: posts small blind $0.50
AlKatrone: posts big blind $1
*** HOLE CARDS ***
Dealt to matiko09 [8d Ts]
deepblue0000: folds 
matiko09: folds 
pandalapa: folds 
Sweden_Pound: folds 
RUS)Timur: raises $1.45 to $2.45
mycka86: folds 
FGL-lucky: folds 
Saintreine: calls $1.95
AlKatrone: raises $9.13 to $11.58
RUS)Timur: calls $9.13
Saintreine: folds 
*** FLOP *** [4d 9h 2d]
AlKatrone: bets $19.32
RUS)Timur: calls $19.32
*** TURN *** [4d 9h 2d] [4c]
AlKatrone: bets $69.10 and is all-in
RUS)Timur: calls $69.10
*** FIRST RIVER *** [4d 9h 2d 4c] [Kh]
*** SECOND RIVER *** [4d 9h 2d 4c] [Qs]
*** FIRST SHOW DOWN ***
AlKatrone: shows [As Ac] (two pair, Aces and Fours)
RUS)Timur: mucks hand 
AlKatrone collected $99.83 from pot
*** SECOND SHOW DOWN ***
AlKatrone: shows [As Ac] (two pair, Aces and Fours)
RUS)Timur: mucks hand 
AlKatrone collected $99.82 from pot
*** SUMMARY ***
Total pot $202.45 | Rake $2.80 
Hand was run twice
FIRST Board [4d 9h 2d 4c Kh]
SECOND Board [4d 9h 2d 4c Qs]
Seat 1: Saintreine (small blind) folded before Flop
Seat 2: AlKatrone (big blind) showed [As Ac] and won ($99.83) with two pair, Aces and Fours, and won ($99.82) with two pair, Aces and Fours
Seat 3: deepblue0000 folded before Flop (didn't bet)
Seat 4: matiko09 folded before Flop (didn't bet)
Seat 5: pandalapa folded before Flop (didn't bet)
Seat 6: Sweden_Pound folded before Flop (didn't bet)
Seat 7: RUS)Timur mucked [Th Td]
Seat 8: mycka86 folded before Flop (didn't bet)
Seat 9: FGL-lucky (button) folded before Flop (didn't bet)





PokerStars Hand #147754134778:  Hold'em No Limit ($0.50/$1.00 USD) - 2016/01/27 11:35:35 CET [2016/01/27 5:35:35 ET]
Table 'Eudora III' 9-max Seat #3 is the button
Seat 1: Peu3aHy ($106.85 in chips) 
Seat 2: GrossiM ($100 in chips) 
Seat 3: matiko09 ($100 in chips) 
Seat 4: Reven9er ($110.28 in chips) 
Seat 6: DIMAZAYAC ($47.48 in chips) 
Seat 7: Sweden_Pound ($100 in chips) 
Seat 8: RUS)Timur ($101.68 in chips) 
Seat 9: Venomous100% ($100 in chips) 
Reven9er: posts small blind $0.50
di0d80: is sitting out 
DIMAZAYAC: posts big blind $1
*** HOLE CARDS ***
Dealt to matiko09 [7h Tc]
Sweden_Pound: folds 
RUS)Timur: raises $1.45 to $2.45
Venomous100%: calls $2.45
Peu3aHy: folds 
di0d80 leaves the table
AlKatrone joins the table at seat #5 
AlKatrone leaves the table
GrossiM: folds 
COOLIKO\/23 joins the table at seat #5 
matiko09: folds 
Reven9er: folds 
DIMAZAYAC: folds 
*** FLOP *** [Td 4c 5c]
RUS)Timur: checks 
Venomous100%: checks 
*** TURN *** [Td 4c 5c] [Jd]
RUS)Timur: checks 
Venomous100%: checks 
*** RIVER *** [Td 4c 5c Jd] [3s]
RUS)Timur: checks 
Venomous100%: checks 
*** SHOW DOWN ***
RUS)Timur: shows [Qd Ac] (high card Ace)
Venomous100%: shows [6s 6c] (a pair of Sixes)
Venomous100% collected $6.11 from pot
*** SUMMARY ***
Total pot $6.40 | Rake $0.29 
Board [Td 4c 5c Jd 3s]
Seat 1: Peu3aHy folded before Flop (didn't bet)
Seat 2: GrossiM folded before Flop (didn't bet)
Seat 3: matiko09 (button) folded before Flop (didn't bet)
Seat 4: Reven9er (small blind) folded before Flop
Seat 6: DIMAZAYAC (big blind) folded before Flop
Seat 7: Sweden_Pound folded before Flop (didn't bet)
Seat 8: RUS)Timur showed [Qd Ac] and lost with high card Ace
Seat 9: Venomous100% showed [6s 6c] and won ($6.11) with a pair of Sixes





PokerStars Hand #147754142743:  Hold'em No Limit ($0.50/$1.00 USD) - 2016/01/27 11:35:51 CET [2016/01/27 5:35:51 ET]
Table 'Henyey' 9-max Seat #9 is the button
Seat 2: pandalapa ($152.77 in chips) 
Seat 3: deepblue0000 ($100.36 in chips) 
Seat 4: sylvian31 ($106.75 in chips) 
Seat 5: matiko09 ($110.50 in chips) 
Seat 6: UShallGimme$ ($100 in chips) 
Seat 8: CoolFireX ($112.10 in chips) 
Seat 9: mycka86 ($132.97 in chips) 
pandalapa: posts small blind $0.50
deepblue0000: posts big blind $1
*** HOLE CARDS ***
Dealt to matiko09 [Ah 5h]
sylvian31: raises $2 to $3
matiko09: raises $6.50 to $9.50
UShallGimme$: folds 
CoolFireX: folds 
mycka86: folds 
pandalapa: folds 
deepblue0000: folds 
sylvian31: calls $6.50
*** FLOP *** [9s 2d 4c]
sylvian31: checks 
matiko09: checks 
*** TURN *** [9s 2d 4c] [Ad]
sylvian31: checks 
vinniej15 joins the table at seat #7 
matiko09: bets $10
sylvian31: folds 
Uncalled bet ($10) returned to matiko09
matiko09 collected $19.58 from pot
matiko09: doesn't show hand 
*** SUMMARY ***
Total pot $20.50 | Rake $0.92 
Board [9s 2d 4c Ad]
Seat 2: pandalapa (small blind) folded before Flop
Seat 3: deepblue0000 (big blind) folded before Flop
Seat 4: sylvian31 folded on the Turn
Seat 5: matiko09 collected ($19.58)
Seat 6: UShallGimme$ folded before Flop (didn't bet)
Seat 8: CoolFireX folded before Flop (didn't bet)
Seat 9: mycka86 (button) folded before Flop (didn't bet)





PokerStars Hand #147754145856:  Hold'em No Limit ($0.50/$1.00 USD) - 2016/01/27 11:35:57 CET [2016/01/27 5:35:57 ET]
Table 'Nanking' 9-max Seat #4 is the button
Seat 2: Dachish ($101.92 in chips) 
Seat 3: nuaxin ($67.84 in chips) 
Seat 4: COOLIKO\/23 ($153.66 in chips) 
Seat 5: TheGentleFox ($82.24 in chips) 
Seat 6: Kukuryzka ($100 in chips) 
Seat 7: tipner ($100 in chips) 
Seat 8: matiko09 ($100 in chips) 
Seat 9: Sweden_Pound ($107.85 in chips) 
TheGentleFox: posts small blind $0.50
Kukuryzka: posts big blind $1
Peu3aHy: sits out 
*** HOLE CARDS ***
Dealt to matiko09 [2d 8c]
tipner: folds 
matiko09: folds 
Sweden_Pound: folds 
Dachish: folds 
nuaxin: folds 
COOLIKO\/23: raises $1.50 to $2.50
TheGentleFox: folds 
Kukuryzka: folds 
Uncalled bet ($1.50) returned to COOLIKO\/23
COOLIKO\/23 collected $2.50 from pot
COOLIKO\/23: doesn't show hand 
*** SUMMARY ***
Total pot $2.50 | Rake $0 
Seat 2: Dachish folded before Flop (didn't bet)
Seat 3: nuaxin folded before Flop (didn't bet)
Seat 4: COOLIKO\/23 (button) collected ($2.50)
Seat 5: TheGentleFox (small blind) folded before Flop
Seat 6: Kukuryzka (big blind) folded before Flop
Seat 7: tipner folded before Flop (didn't bet)
Seat 8: matiko09 folded before Flop (didn't bet)
Seat 9: Sweden_Pound folded before Flop (didn't bet)





PokerStars Hand #147754147059:  Hold'em No Limit ($0.50/$1.00 USD) - 2016/01/27 11:36:00 CET [2016/01/27 5:36:00 ET]
Table 'Fragaria II' 9-max Seat #8 is the button
Seat 1: deepblue0000 ($105.78 in chips) 
Seat 2: GG-NoR34D. ($85.13 in chips) 
Seat 3: Sweden_Pound ($119.01 in chips) 
Seat 4: AlKatrone ($101 in chips) 
Seat 5: Venomous100% ($106.62 in chips) 
Seat 6: UShallGimme$ ($192.49 in chips) 
Seat 7: Hobby-.-AK ($27.21 in chips) 
Seat 8: mycka86 ($108.60 in chips) 
Seat 9: matiko09 ($102.50 in chips) 
matiko09: posts small blind $0.50
deepblue0000: posts big blind $1
*** HOLE CARDS ***
Dealt to matiko09 [Ah 4d]
GG-NoR34D.: calls $1
Sweden_Pound has timed out
Sweden_Pound: folds 
AlKatrone: folds 
Venomous100%: folds 
UShallGimme$: folds 
Hobby-.-AK: raises $1 to $2
mycka86: folds 
matiko09: folds 
deepblue0000: folds 
GG-NoR34D.: calls $1
*** FLOP *** [6c 5s 2d]
GG-NoR34D.: checks 
Hobby-.-AK: bets $2
GG-NoR34D.: calls $2
*** TURN *** [6c 5s 2d] [Kd]
GG-NoR34D.: bets $3
Hobby-.-AK: calls $3
*** RIVER *** [6c 5s 2d Kd] [Kc]
GG-NoR34D.: bets $5.50
Hobby-.-AK: calls $5.50
*** SHOW DOWN ***
GG-NoR34D.: shows [Tc Ad] (a pair of Kings)
Hobby-.-AK: shows [6d 8d] (two pair, Kings and Sixes)
Hobby-.-AK collected $25.31 from pot
*** SUMMARY ***
Total pot $26.50 | Rake $1.19 
Board [6c 5s 2d Kd Kc]
Seat 1: deepblue0000 (big blind) folded before Flop
Seat 2: GG-NoR34D. showed [Tc Ad] and lost with a pair of Kings
Seat 3: Sweden_Pound folded before Flop (didn't bet)
Seat 4: AlKatrone folded before Flop (didn't bet)
Seat 5: Venomous100% folded before Flop (didn't bet)
Seat 6: UShallGimme$ folded before Flop (didn't bet)
Seat 7: Hobby-.-AK showed [6d 8d] and won ($25.31) with two pair, Kings and Sixes
Seat 8: mycka86 (button) folded before Flop (didn't bet)
Seat 9: matiko09 (small blind) folded before Flop





PokerStars Hand #147754148627:  Hold'em No Limit ($0.50/$1.00 USD) - 2016/01/27 11:36:03 CET [2016/01/27 5:36:03 ET]
Table 'Alkmene II' 9-max Seat #6 is the button
Seat 1: matiko09 ($100 in chips) 
Seat 2: deepblue0000 ($100 in chips) 
Seat 3: MuSaShiBuShi ($32.08 in chips) 
Seat 4: CoolFireX ($150.07 in chips) 
Seat 5: Sweden_Pound ($119.55 in chips) 
Seat 6: Peu3aHy ($108.53 in chips) 
Seat 7: mycka86 ($124.86 in chips) 
Seat 8: fecsok1 ($68.81 in chips) 
Seat 9: pandalapa ($101.50 in chips) 
mycka86: posts small blind $0.50
fecsok1: posts big blind $1
*** HOLE CARDS ***
Dealt to matiko09 [Ad 7d]
pandalapa: folds 
matiko09: folds 
deepblue0000: folds 
MuSaShiBuShi: raises $1.09 to $2.09
CoolFireX: folds 
Sweden_Pound: folds 
Peu3aHy: folds 
mycka86: folds 
fecsok1: calls $1.09
*** FLOP *** [4h 3c 2h]
fecsok1: checks 
MuSaShiBuShi: checks 
*** TURN *** [4h 3c 2h] [Jh]
fecsok1: checks 
MuSaShiBuShi: bets $2.23
fecsok1: calls $2.23
*** RIVER *** [4h 3c 2h Jh] [7s]
fecsok1: checks 
MuSaShiBuShi: bets $3.80
fecsok1: calls $3.80
*** SHOW DOWN ***
MuSaShiBuShi: shows [9c Jc] (a pair of Jacks)
fecsok1: shows [Th Js] (a pair of Jacks - Ten kicker)
fecsok1 collected $15.99 from pot
*** SUMMARY ***
Total pot $16.74 | Rake $0.75 
Board [4h 3c 2h Jh 7s]
Seat 1: matiko09 folded before Flop (didn't bet)
Seat 2: deepblue0000 folded before Flop (didn't bet)
Seat 3: MuSaShiBuShi showed [9c Jc] and lost with a pair of Jacks
Seat 4: CoolFireX folded before Flop (didn't bet)
Seat 5: Sweden_Pound folded before Flop (didn't bet)
Seat 6: Peu3aHy (button) folded before Flop (didn't bet)
Seat 7: mycka86 (small blind) folded before Flop
Seat 8: fecsok1 (big blind) showed [Th Js] and won ($15.99) with a pair of Jacks
Seat 9: pandalapa folded before Flop (didn't bet)





PokerStars Hand #147754159171:  Hold'em No Limit ($0.50/$1.00 USD) - 2016/01/27 11:36:24 CET [2016/01/27 5:36:24 ET]
Table 'Nanking' 9-max Seat #5 is the button
Seat 2: Dachish ($101.92 in chips) 
Seat 3: nuaxin ($67.84 in chips) 
Seat 4: COOLIKO\/23 ($155.16 in chips) 
Seat 5: TheGentleFox ($81.74 in chips) 
Seat 6: Kukuryzka ($99 in chips) 
Seat 7: tipner ($100 in chips) 
Seat 8: matiko09 ($100 in chips) 
Seat 9: Sweden_Pound ($107.85 in chips) 
Kukuryzka: posts small blind $0.50
tipner: posts big blind $1
Peu3aHy: sits out 
*** HOLE CARDS ***
Dealt to matiko09 [Jc Ah]
matiko09: raises $2 to $3
Sweden_Pound: folds 
Dachish: folds 
nuaxin: folds 
COOLIKO\/23: folds 
TheGentleFox: calls $3
Kukuryzka: folds 
tipner: folds 
*** FLOP *** [Ks Qc 2h]
matiko09: bets $4.65
TheGentleFox: folds 
Uncalled bet ($4.65) returned to matiko09
matiko09 collected $7.16 from pot
matiko09: doesn't show hand 
*** SUMMARY ***
Total pot $7.50 | Rake $0.34 
Board [Ks Qc 2h]
Seat 2: Dachish folded before Flop (didn't bet)
Seat 3: nuaxin folded before Flop (didn't bet)
Seat 4: COOLIKO\/23 folded before Flop (didn't bet)
Seat 5: TheGentleFox (button) folded on the Flop
Seat 6: Kukuryzka (small blind) folded before Flop
Seat 7: tipner (big blind) folded before Flop
Seat 8: matiko09 collected ($7.16)
Seat 9: Sweden_Pound folded before Flop (didn't bet)





PokerStars Hand #147754170000:  Hold'em No Limit ($0.50/$1.00 USD) - 2016/01/27 11:36:46 CET [2016/01/27 5:36:46 ET]
Table 'Henyey' 9-max Seat #2 is the button
Seat 2: pandalapa ($152.27 in chips) 
Seat 3: deepblue0000 ($100 in chips) 
Seat 5: matiko09 ($120.58 in chips) 
Seat 6: UShallGimme$ ($100 in chips) 
Seat 7: vinniej15 ($40 in chips) 
Seat 8: CoolFireX ($112.10 in chips) 
Seat 9: mycka86 ($132.97 in chips) 
deepblue0000: posts small blind $0.50
sylvian31: is sitting out 
matiko09: posts big blind $1
vinniej15: posts big blind $1
*** HOLE CARDS ***
Dealt to matiko09 [7c Kd]
UShallGimme$: raises $2.50 to $3.50
vinniej15: calls $2.50
CoolFireX: folds 
mycka86: folds 
pandalapa: folds 
deepblue0000: folds 
matiko09: folds 
*** FLOP *** [3h Jc 8s]
UShallGimme$: bets $5.50
vinniej15: folds 
Uncalled bet ($5.50) returned to UShallGimme$
UShallGimme$ collected $8.12 from pot
UShallGimme$: doesn't show hand 
*** SUMMARY ***
Total pot $8.50 | Rake $0.38 
Board [3h Jc 8s]
Seat 2: pandalapa (button) folded before Flop (didn't bet)
Seat 3: deepblue0000 (small blind) folded before Flop
Seat 5: matiko09 (big blind) folded before Flop
Seat 6: UShallGimme$ collected ($8.12)
Seat 7: vinniej15 folded on the Flop
Seat 8: CoolFireX folded before Flop (didn't bet)
Seat 9: mycka86 folded before Flop (didn't bet)





PokerStars Hand #147754172724:  Hold'em No Limit ($0.50/$1.00 USD) - 2016/01/27 11:36:52 CET [2016/01/27 5:36:52 ET]
Table 'Eudora III' 9-max Seat #4 is the button
Seat 1: Peu3aHy ($106.85 in chips) 
Seat 2: GrossiM ($100 in chips) 
Seat 3: matiko09 ($100 in chips) 
Seat 4: Reven9er ($109.78 in chips) 
Seat 6: DIMAZAYAC ($46.48 in chips) 
Seat 7: Sweden_Pound ($100 in chips) 
Seat 8: RUS)Timur ($100 in chips) 
Seat 9: Venomous100% ($103.66 in chips) 
COOLIKO\/23 will be allowed to play after the button
DIMAZAYAC: posts small blind $0.50
Sweden_Pound: posts big blind $1
*** HOLE CARDS ***
Dealt to matiko09 [Jd 3c]
RUS)Timur: folds 
Venomous100%: folds 
Peu3aHy: folds 
GrossiM: folds 
matiko09: folds 
Reven9er: folds 
DIMAZAYAC: folds 
Uncalled bet ($0.50) returned to Sweden_Pound
Sweden_Pound collected $1 from pot
Sweden_Pound: doesn't show hand 
DIMAZAYAC leaves the table
*** SUMMARY ***
Total pot $1 | Rake $0 
Seat 1: Peu3aHy folded before Flop (didn't bet)
Seat 2: GrossiM folded before Flop (didn't bet)
Seat 3: matiko09 folded before Flop (didn't bet)
Seat 4: Reven9er (button) folded before Flop (didn't bet)
Seat 6: DIMAZAYAC (small blind) folded before Flop
Seat 7: Sweden_Pound (big blind) collected ($1)
Seat 8: RUS)Timur folded before Flop (didn't bet)
Seat 9: Venomous100% folded before Flop (didn't bet)





PokerStars Hand #147754173206:  Hold'em No Limit ($0.50/$1.00 USD) - 2016/01/27 11:36:53 CET [2016/01/27 5:36:53 ET]
Table 'Alhajoth' 9-max Seat #8 is the button
Seat 1: UShallGimme$ ($151.45 in chips) 
Seat 2: matiko09 ($100 in chips) 
Seat 3: Sweden_Pound ($117.77 in chips) 
Seat 4: Venomous100% ($129.87 in chips) 
Seat 5: Kukuryzka ($100 in chips) 
Seat 6: RoadtoNepal ($191.80 in chips) 
Seat 7: Ohpeel ($115.13 in chips) 
Seat 8: deepblue0000 ($116.68 in chips) 
Seat 9: di0d80 ($100 in chips) 
di0d80: posts small blind $0.50
UShallGimme$: posts big blind $1
*** HOLE CARDS ***
Dealt to matiko09 [2d Qh]
di0d80 said, "nh"
matiko09: folds 
Sweden_Pound: folds 
Venomous100%: folds 
Kukuryzka: folds 
RoadtoNepal: folds 
Ohpeel: calls $1
deepblue0000: raises $3.50 to $4.50
di0d80: folds 
UShallGimme$: folds 
Ohpeel: folds 
Uncalled bet ($3.50) returned to deepblue0000
deepblue0000 collected $3.50 from pot
*** SUMMARY ***
Total pot $3.50 | Rake $0 
Seat 1: UShallGimme$ (big blind) folded before Flop
Seat 2: matiko09 folded before Flop (didn't bet)
Seat 3: Sweden_Pound folded before Flop (didn't bet)
Seat 4: Venomous100% folded before Flop (didn't bet)
Seat 5: Kukuryzka folded before Flop (didn't bet)
Seat 6: RoadtoNepal folded before Flop (didn't bet)
Seat 7: Ohpeel folded before Flop
Seat 8: deepblue0000 (button) collected ($3.50)
Seat 9: di0d80 (small blind) folded before Flop





PokerStars Hand #147754176237:  Hold'em No Limit ($0.50/$1.00 USD) - 2016/01/27 11:36:59 CET [2016/01/27 5:36:59 ET]
Table 'Alkmene II' 9-max Seat #7 is the button
Seat 1: matiko09 ($100 in chips) 
Seat 2: deepblue0000 ($100 in chips) 
Seat 3: MuSaShiBuShi ($23.96 in chips) 
Seat 4: CoolFireX ($150.07 in chips) 
Seat 5: Sweden_Pound ($119.55 in chips) 
Seat 6: Peu3aHy ($108.53 in chips) 
Seat 7: mycka86 ($124.36 in chips) 
Seat 8: fecsok1 ($76.68 in chips) 
Seat 9: pandalapa ($101.50 in chips) 
fecsok1: posts small blind $0.50
pandalapa: posts big blind $1
*** HOLE CARDS ***
Dealt to matiko09 [Th 9h]
matiko09: raises $2 to $3
deepblue0000: folds 
MuSaShiBuShi: folds 
MuSaShiBuShi leaves the table
CoolFireX: folds 
Sweden_Pound: folds 
Peu3aHy: calls $3
mycka86: folds 
fecsok1: folds 
pandalapa: folds 
*** FLOP *** [Jc 6h 3s]
matiko09: bets $4.65
Peu3aHy: calls $4.65
*** TURN *** [Jc 6h 3s] [2c]
matiko09: checks 
Peu3aHy: bets $14
matiko09: folds 
Uncalled bet ($14) returned to Peu3aHy
Peu3aHy collected $16.04 from pot
Peu3aHy: doesn't show hand 
blef1992 joins the table at seat #3 
*** SUMMARY ***
Total pot $16.80 | Rake $0.76 
Board [Jc 6h 3s 2c]
Seat 1: matiko09 folded on the Turn
Seat 2: deepblue0000 folded before Flop (didn't bet)
Seat 3: MuSaShiBuShi folded before Flop (didn't bet)
Seat 4: CoolFireX folded before Flop (didn't bet)
Seat 5: Sweden_Pound folded before Flop (didn't bet)
Seat 6: Peu3aHy collected ($16.04)
Seat 7: mycka86 (button) folded before Flop (didn't bet)
Seat 8: fecsok1 (small blind) folded before Flop
Seat 9: pandalapa (big blind) folded before Flop





PokerStars Hand #147754177811:  Hold'em No Limit ($0.50/$1.00 USD) - 2016/01/27 11:37:02 CET [2016/01/27 5:37:02 ET]
Table 'Thais' 9-max Seat #9 is the button
Seat 1: Peu3aHy ($129.03 in chips) 
Seat 2: Sweden_Pound ($102.50 in chips) 
Seat 3: RoadtoNepal ($100 in chips) 
Seat 4: aayat ($99.29 in chips) 
Seat 5: matiko09 ($100 in chips) 
Seat 6: deepblue0000 ($104.92 in chips) 
Seat 7: Venomous100% ($276.09 in chips) 
Seat 8: sylvian31 ($100 in chips) 
Seat 9: tipner ($116.42 in chips) 
Peu3aHy: posts small blind $0.50
Sweden_Pound: posts big blind $1
*** HOLE CARDS ***
Dealt to matiko09 [7d Td]
RoadtoNepal: folds 
aayat: calls $1
matiko09: raises $3 to $4
deepblue0000: calls $4
Venomous100%: folds 
sylvian31: folds 
tipner: folds 
Peu3aHy: folds 
Sweden_Pound: folds 
aayat: calls $3
*** FLOP *** [Jc 2s 4d]
aayat: checks 
matiko09: checks 
deepblue0000: bets $6.44
aayat: calls $6.44
matiko09: folds 
*** TURN *** [Jc 2s 4d] [2c]
aayat: checks 
deepblue0000: bets $12.59
aayat: calls $12.59
*** RIVER *** [Jc 2s 4d 2c] [Qh]
aayat: bets $24.62
deepblue0000: calls $24.62
*** SHOW DOWN ***
aayat: shows [9c 9h] (two pair, Nines and Deuces)
deepblue0000: shows [Ad Jd] (two pair, Jacks and Deuces)
deepblue0000 collected $98 from pot
*** SUMMARY ***
Total pot $100.80 | Rake $2.80 
Board [Jc 2s 4d 2c Qh]
Seat 1: Peu3aHy (small blind) folded before Flop
Seat 2: Sweden_Pound (big blind) folded before Flop
Seat 3: RoadtoNepal folded before Flop (didn't bet)
Seat 4: aayat showed [9c 9h] and lost with two pair, Nines and Deuces
Seat 5: matiko09 folded on the Flop
Seat 6: deepblue0000 showed [Ad Jd] and won ($98) with two pair, Jacks and Deuces
Seat 7: Venomous100% folded before Flop (didn't bet)
Seat 8: sylvian31 folded before Flop (didn't bet)
Seat 9: tipner (button) folded before Flop (didn't bet)





PokerStars Hand #147754182335:  Hold'em No Limit ($0.50/$1.00 USD) - 2016/01/27 11:37:12 CET [2016/01/27 5:37:12 ET]
Table 'Delphinus II' 9-max Seat #1 is the button
Seat 1: Saintreine ($140.31 in chips) 
Seat 2: AlKatrone ($199.65 in chips) 
Seat 3: deepblue0000 ($330.48 in chips) 
Seat 4: matiko09 ($124.73 in chips) 
Seat 5: pandalapa ($106.05 in chips) 
Seat 6: Sweden_Pound ($124.64 in chips) 
Seat 7: RUS)Timur ($100 in chips) 
Seat 8: mycka86 ($100 in chips) 
Seat 9: FGL-lucky ($46.38 in chips) 
AlKatrone: posts small blind $0.50
deepblue0000: posts big blind $1
*** HOLE CARDS ***
Dealt to matiko09 [Kc 4h]
matiko09: folds 
pandalapa: folds 
Sweden_Pound: folds 
RUS)Timur: folds 
mycka86: folds 
FGL-lucky: raises $1 to $2
Saintreine: folds 
AlKatrone: folds 
deepblue0000: folds 
Uncalled bet ($1) returned to FGL-lucky
FGL-lucky collected $2.50 from pot
FGL-lucky: doesn't show hand 
*** SUMMARY ***
Total pot $2.50 | Rake $0 
Seat 1: Saintreine (button) folded before Flop (didn't bet)
Seat 2: AlKatrone (small blind) folded before Flop
Seat 3: deepblue0000 (big blind) folded before Flop
Seat 4: matiko09 folded before Flop (didn't bet)
Seat 5: pandalapa folded before Flop (didn't bet)
Seat 6: Sweden_Pound folded before Flop (didn't bet)
Seat 7: RUS)Timur folded before Flop (didn't bet)
Seat 8: mycka86 folded before Flop (didn't bet)
Seat 9: FGL-lucky collected ($2.50)





PokerStars Hand #147754186049:  Hold'em No Limit ($0.50/$1.00 USD) - 2016/01/27 11:37:19 CET [2016/01/27 5:37:19 ET]
Table 'Nanking' 9-max Seat #6 is the button
Seat 2: Dachish ($101.92 in chips) 
Seat 3: nuaxin ($67.84 in chips) 
Seat 4: COOLIKO\/23 ($155.16 in chips) 
Seat 5: TheGentleFox ($78.74 in chips) 
Seat 6: Kukuryzka ($100 in chips) 
Seat 7: tipner ($100 in chips) 
Seat 8: matiko09 ($104.16 in chips) 
Seat 9: Sweden_Pound ($107.85 in chips) 
tipner: posts small blind $0.50
matiko09: posts big blind $1
Peu3aHy: sits out 
*** HOLE CARDS ***
Dealt to matiko09 [3h 9h]
Sweden_Pound: folds 
Dachish: raises $1 to $2
nuaxin: folds 
COOLIKO\/23: folds 
TheGentleFox: calls $2
Kukuryzka: folds 
tipner: folds 
matiko09: folds 
*** FLOP *** [6d As 3s]
Dachish: checks 
TheGentleFox: checks 
*** TURN *** [6d As 3s] [Kd]
Dachish: checks 
TheGentleFox: checks 
*** RIVER *** [6d As 3s Kd] [Ac]
Dachish: checks 
TheGentleFox: checks 
*** SHOW DOWN ***
Dachish: shows [8d 8s] (two pair, Aces and Eights)
TheGentleFox: mucks hand 
Dachish collected $5.25 from pot
*** SUMMARY ***
Total pot $5.50 | Rake $0.25 
Board [6d As 3s Kd Ac]
Seat 2: Dachish showed [8d 8s] and won ($5.25) with two pair, Aces and Eights
Seat 3: nuaxin folded before Flop (didn't bet)
Seat 4: COOLIKO\/23 folded before Flop (didn't bet)
Seat 5: TheGentleFox mucked [Qh Tc]
Seat 6: Kukuryzka (button) folded before Flop (didn't bet)
Seat 7: tipner (small blind) folded before Flop
Seat 8: matiko09 (big blind) folded before Flop
Seat 9: Sweden_Pound folded before Flop (didn't bet)





PokerStars Hand #147754187476:  Hold'em No Limit ($0.50/$1.00 USD) - 2016/01/27 11:37:22 CET [2016/01/27 5:37:22 ET]
Table 'Henyey' 9-max Seat #3 is the button
Seat 2: pandalapa ($152.27 in chips) 
Seat 3: deepblue0000 ($100 in chips) 
Seat 5: matiko09 ($119.58 in chips) 
Seat 6: UShallGimme$ ($104.62 in chips) 
Seat 7: vinniej15 ($36.50 in chips) 
Seat 8: CoolFireX ($112.10 in chips) 
Seat 9: mycka86 ($132.97 in chips) 
matiko09: posts small blind $0.50
UShallGimme$: posts big blind $1
*** HOLE CARDS ***
Dealt to matiko09 [Ad 9h]
vinniej15: folds 
CoolFireX: raises $2 to $3
mycka86: folds 
COOLIKO\/23 joins the table at seat #1 
pandalapa: folds 
deepblue0000: folds 
matiko09: folds 
UShallGimme$: folds 
Uncalled bet ($2) returned to CoolFireX
CoolFireX collected $2.50 from pot
CoolFireX: doesn't show hand 
*** SUMMARY ***
Total pot $2.50 | Rake $0 
Seat 2: pandalapa folded before Flop (didn't bet)
Seat 3: deepblue0000 (button) folded before Flop (didn't bet)
Seat 5: matiko09 (small blind) folded before Flop
Seat 6: UShallGimme$ (big blind) folded before Flop
Seat 7: vinniej15 folded before Flop (didn't bet)
Seat 8: CoolFireX collected ($2.50)
Seat 9: mycka86 folded before Flop (didn't bet)





PokerStars Hand #147754188932:  Hold'em No Limit ($0.50/$1.00 USD) - 2016/01/27 11:37:25 CET [2016/01/27 5:37:25 ET]
Table 'Eudora III' 9-max Seat #7 is the button
Seat 1: Peu3aHy ($106.85 in chips) 
Seat 2: GrossiM ($100 in chips) 
Seat 3: matiko09 ($100 in chips) 
Seat 4: Reven9er ($109.78 in chips) 
Seat 7: Sweden_Pound ($100.50 in chips) 
Seat 8: RUS)Timur ($100 in chips) 
Seat 9: Venomous100% ($103.66 in chips) 
RUS)Timur: posts small blind $0.50
Venomous100%: posts big blind $1
COOLIKO\/23: sits out 
*** HOLE CARDS ***
Dealt to matiko09 [3s Ah]
AlKatrone joins the table at seat #6 
AlKatrone leaves the table
Peu3aHy: folds 
GrossiM: folds 
matiko09: folds 
Reven9er: folds 
Sweden_Pound: folds 
RUS)Timur: folds 
Uncalled bet ($0.50) returned to Venomous100%
Venomous100% collected $1 from pot
Venomous100%: doesn't show hand 
*** SUMMARY ***
Total pot $1 | Rake $0 
Seat 1: Peu3aHy folded before Flop (didn't bet)
Seat 2: GrossiM folded before Flop (didn't bet)
Seat 3: matiko09 folded before Flop (didn't bet)
Seat 4: Reven9er folded before Flop (didn't bet)
Seat 7: Sweden_Pound (button) folded before Flop (didn't bet)
Seat 8: RUS)Timur (small blind) folded before Flop
Seat 9: Venomous100% (big blind) collected ($1)





PokerStars Hand #147754195898:  Hold'em No Limit ($0.50/$1.00 USD) - 2016/01/27 11:37:39 CET [2016/01/27 5:37:39 ET]
Table 'Siegena III' 9-max Seat #5 is the button
Seat 1: nnne409 ($100 in chips) 
Seat 2: tipner ($101.50 in chips) 
Seat 3: masaytoo ($91.75 in chips) 
Seat 4: Sweden_Pound ($100 in chips) 
Seat 5: matiko09 ($105 in chips) 
Seat 6: RUS)Timur ($150.82 in chips) 
Seat 9: di0d80 ($100 in chips) 
RUS)Timur: posts small blind $0.50
sylvian31: is sitting out 
Venomous100%: is sitting out 
di0d80: posts big blind $1
*** HOLE CARDS ***
Dealt to matiko09 [9s 4h]
Venomous100% leaves the table
nnne409: folds 
tipner: folds 
masaytoo: folds 
Sweden_Pound: folds 
matiko09: folds 
RUS)Timur: folds 
Uncalled bet ($0.50) returned to di0d80
di0d80 collected $1 from pot
di0d80: doesn't show hand 
*** SUMMARY ***
Total pot $1 | Rake $0 
Seat 1: nnne409 folded before Flop (didn't bet)
Seat 2: tipner folded before Flop (didn't bet)
Seat 3: masaytoo folded before Flop (didn't bet)
Seat 4: Sweden_Pound folded before Flop (didn't bet)
Seat 5: matiko09 (button) folded before Flop (didn't bet)
Seat 6: RUS)Timur (small blind) folded before Flop
Seat 9: di0d80 (big blind) collected ($1)





PokerStars Hand #147754197163:  Hold'em No Limit ($0.50/$1.00 USD) - 2016/01/27 11:37:41 CET [2016/01/27 5:37:41 ET]
Table 'Alhajoth' 9-max Seat #9 is the button
Seat 1: UShallGimme$ ($150.45 in chips) 
Seat 2: matiko09 ($100 in chips) 
Seat 3: Sweden_Pound ($117.77 in chips) 
Seat 4: Venomous100% ($129.87 in chips) 
Seat 5: Kukuryzka ($100 in chips) 
Seat 6: RoadtoNepal ($191.80 in chips) 
Seat 7: Ohpeel ($114.13 in chips) 
Seat 8: deepblue0000 ($119.18 in chips) 
Seat 9: di0d80 ($100 in chips) 
UShallGimme$: posts small blind $0.50
matiko09: posts big blind $1
*** HOLE CARDS ***
Dealt to matiko09 [Tc Jd]
Sweden_Pound: folds 
Venomous100%: folds 
Kukuryzka: folds 
RoadtoNepal: raises $2 to $3
Ohpeel: folds 
deepblue0000: folds 
di0d80: folds 
UShallGimme$: raises $7 to $10
matiko09: folds 
RoadtoNepal: folds 
Uncalled bet ($7) returned to UShallGimme$
UShallGimme$ collected $7 from pot
UShallGimme$: doesn't show hand 
*** SUMMARY ***
Total pot $7 | Rake $0 
Seat 1: UShallGimme$ (small blind) collected ($7)
Seat 2: matiko09 (big blind) folded before Flop
Seat 3: Sweden_Pound folded before Flop (didn't bet)
Seat 4: Venomous100% folded before Flop (didn't bet)
Seat 5: Kukuryzka folded before Flop (didn't bet)
Seat 6: RoadtoNepal folded before Flop
Seat 7: Ohpeel folded before Flop (didn't bet)
Seat 8: deepblue0000 folded before Flop (didn't bet)
Seat 9: di0d80 (button) folded before Flop (didn't bet)





PokerStars Hand #147754199620:  Hold'em No Limit ($0.50/$1.00 USD) - 2016/01/27 11:37:46 CET [2016/01/27 5:37:46 ET]
Table 'Delphinus II' 9-max Seat #2 is the button
Seat 1: Saintreine ($140.31 in chips) 
Seat 2: AlKatrone ($199.15 in chips) 
Seat 3: deepblue0000 ($329.48 in chips) 
Seat 4: matiko09 ($124.73 in chips) 
Seat 5: pandalapa ($106.05 in chips) 
Seat 6: Sweden_Pound ($124.64 in chips) 
Seat 7: RUS)Timur ($100 in chips) 
Seat 8: mycka86 ($100 in chips) 
Seat 9: FGL-lucky ($47.88 in chips) 
deepblue0000: posts small blind $0.50
matiko09: posts big blind $1
*** HOLE CARDS ***
Dealt to matiko09 [4d 5c]
pandalapa: folds 
Sweden_Pound: folds 
RUS)Timur: folds 
mycka86: raises $1.50 to $2.50
FGL-lucky: calls $2.50
Saintreine: calls $2.50
AlKatrone: folds 
deepblue0000: folds 
matiko09: folds 
*** FLOP *** [5d 7c 2c]
mycka86: bets $6.30
FGL-lucky: folds 
Saintreine: folds 
Uncalled bet ($6.30) returned to mycka86
mycka86 collected $8.60 from pot
*** SUMMARY ***
Total pot $9 | Rake $0.40 
Board [5d 7c 2c]
Seat 1: Saintreine folded on the Flop
Seat 2: AlKatrone (button) folded before Flop (didn't bet)
Seat 3: deepblue0000 (small blind) folded before Flop
Seat 4: matiko09 (big blind) folded before Flop
Seat 5: pandalapa folded before Flop (didn't bet)
Seat 6: Sweden_Pound folded before Flop (didn't bet)
Seat 7: RUS)Timur folded before Flop (didn't bet)
Seat 8: mycka86 collected ($8.60)
Seat 9: FGL-lucky folded on the Flop





PokerStars Hand #147754200625:  Hold'em No Limit ($0.50/$1.00 USD) - 2016/01/27 11:37:49 CET [2016/01/27 5:37:49 ET]
Table 'Henyey' 9-max Seat #5 is the button
Seat 2: pandalapa ($152.27 in chips) 
Seat 3: deepblue0000 ($100 in chips) 
Seat 5: matiko09 ($119.08 in chips) 
Seat 6: UShallGimme$ ($103.62 in chips) 
Seat 7: vinniej15 ($36.50 in chips) 
Seat 8: CoolFireX ($113.60 in chips) 
Seat 9: mycka86 ($132.97 in chips) 
UShallGimme$: posts small blind $0.50
vinniej15: posts big blind $1
COOLIKO\/23: sits out 
*** HOLE CARDS ***
Dealt to matiko09 [2h 2d]
CoolFireX: folds 
mycka86: raises $2 to $3
pandalapa: folds 
deepblue0000: folds 
matiko09: calls $3
UShallGimme$: folds 
vinniej15: folds 
*** FLOP *** [3s 6d 7s]
mycka86: bets $5.20
matiko09: folds 
Uncalled bet ($5.20) returned to mycka86
mycka86 collected $7.16 from pot
*** SUMMARY ***
Total pot $7.50 | Rake $0.34 
Board [3s 6d 7s]
Seat 2: pandalapa folded before Flop (didn't bet)
Seat 3: deepblue0000 folded before Flop (didn't bet)
Seat 5: matiko09 (button) folded on the Flop
Seat 6: UShallGimme$ (small blind) folded before Flop
Seat 7: vinniej15 (big blind) folded before Flop
Seat 8: CoolFireX folded before Flop (didn't bet)
Seat 9: mycka86 collected ($7.16)





PokerStars Hand #147754204873:  Hold'em No Limit ($0.50/$1.00 USD) - 2016/01/27 11:37:57 CET [2016/01/27 5:37:57 ET]
Table 'Nanking' 9-max Seat #7 is the button
Seat 2: Dachish ($105.17 in chips) 
Seat 3: nuaxin ($67.84 in chips) 
Seat 4: COOLIKO\/23 ($155.16 in chips) 
Seat 5: TheGentleFox ($76.74 in chips) 
Seat 6: Kukuryzka ($100 in chips) 
Seat 7: tipner ($100 in chips) 
Seat 8: matiko09 ($103.16 in chips) 
Seat 9: Sweden_Pound ($107.85 in chips) 
matiko09: posts small blind $0.50
Sweden_Pound: posts big blind $1
Peu3aHy: sits out 
*** HOLE CARDS ***
Dealt to matiko09 [Qs 3c]
Dachish: folds 
nuaxin: folds 
COOLIKO\/23: folds 
TheGentleFox: folds 
Kukuryzka: folds 
tipner: folds 
matiko09: folds 
Uncalled bet ($0.50) returned to Sweden_Pound
Sweden_Pound collected $1 from pot
Sweden_Pound: doesn't show hand 
*** SUMMARY ***
Total pot $1 | Rake $0 
Seat 2: Dachish folded before Flop (didn't bet)
Seat 3: nuaxin folded before Flop (didn't bet)
Seat 4: COOLIKO\/23 folded before Flop (didn't bet)
Seat 5: TheGentleFox folded before Flop (didn't bet)
Seat 6: Kukuryzka folded before Flop (didn't bet)
Seat 7: tipner (button) folded before Flop (didn't bet)
Seat 8: matiko09 (small blind) folded before Flop
Seat 9: Sweden_Pound (big blind) collected ($1)





PokerStars Hand #147754210285:  Hold'em No Limit ($0.50/$1.00 USD) - 2016/01/27 11:38:08 CET [2016/01/27 5:38:08 ET]
Table 'Fragaria II' 9-max Seat #9 is the button
Seat 1: deepblue0000 ($104.78 in chips) 
Seat 2: GG-NoR34D. ($72.63 in chips) 
Seat 3: Sweden_Pound ($119.01 in chips) 
Seat 4: AlKatrone ($101 in chips) 
Seat 5: Venomous100% ($106.62 in chips) 
Seat 6: UShallGimme$ ($192.49 in chips) 
Seat 7: Hobby-.-AK ($40.02 in chips) 
Seat 8: mycka86 ($108.60 in chips) 
Seat 9: matiko09 ($102 in chips) 
deepblue0000: posts small blind $0.50
GG-NoR34D.: posts big blind $1
*** HOLE CARDS ***
Dealt to matiko09 [Tc 7d]
Sweden_Pound: folds 
AlKatrone: folds 
Venomous100%: folds 
UShallGimme$: folds 
Hobby-.-AK: calls $1
mycka86: raises $3.50 to $4.50
matiko09: folds 
deepblue0000: folds 
GG-NoR34D.: folds 
Hobby-.-AK: folds 
Uncalled bet ($3.50) returned to mycka86
mycka86 collected $3.50 from pot
*** SUMMARY ***
Total pot $3.50 | Rake $0 
Seat 1: deepblue0000 (small blind) folded before Flop
Seat 2: GG-NoR34D. (big blind) folded before Flop
Seat 3: Sweden_Pound folded before Flop (didn't bet)
Seat 4: AlKatrone folded before Flop (didn't bet)
Seat 5: Venomous100% folded before Flop (didn't bet)
Seat 6: UShallGimme$ folded before Flop (didn't bet)
Seat 7: Hobby-.-AK folded before Flop
Seat 8: mycka86 collected ($3.50)
Seat 9: matiko09 (button) folded before Flop (didn't bet)





PokerStars Hand #147754210504:  Hold'em No Limit ($0.50/$1.00 USD) - 2016/01/27 11:38:09 CET [2016/01/27 5:38:09 ET]
Table 'Eudora III' 9-max Seat #8 is the button
Seat 1: Peu3aHy ($106.85 in chips) 
Seat 2: GrossiM ($100 in chips) 
Seat 3: matiko09 ($100 in chips) 
Seat 4: Reven9er ($109.78 in chips) 
Seat 7: Sweden_Pound ($100.50 in chips) 
Seat 8: RUS)Timur ($100 in chips) 
Seat 9: Venomous100% ($104.16 in chips) 
Venomous100%: posts small blind $0.50
Peu3aHy: posts big blind $1
COOLIKO\/23: sits out 
*** HOLE CARDS ***
Dealt to matiko09 [2s Th]
GrossiM: folds 
matiko09: folds 
Reven9er: folds 
Sweden_Pound: raises $1.50 to $2.50
RUS)Timur: folds 
Venomous100%: folds 
Peu3aHy: folds 
Uncalled bet ($1.50) returned to Sweden_Pound
Sweden_Pound collected $2.50 from pot
Sweden_Pound: doesn't show hand 
*** SUMMARY ***
Total pot $2.50 | Rake $0 
Seat 1: Peu3aHy (big blind) folded before Flop
Seat 2: GrossiM folded before Flop (didn't bet)
Seat 3: matiko09 folded before Flop (didn't bet)
Seat 4: Reven9er folded before Flop (didn't bet)
Seat 7: Sweden_Pound collected ($2.50)
Seat 8: RUS)Timur (button) folded before Flop (didn't bet)
Seat 9: Venomous100% (small blind) folded before Flop





PokerStars Hand #147754211471:  Hold'em No Limit ($0.50/$1.00 USD) - 2016/01/27 11:38:11 CET [2016/01/27 5:38:11 ET]
Table 'Siegena III' 9-max Seat #6 is the button
Seat 1: nnne409 ($100 in chips) 
Seat 2: tipner ($101.50 in chips) 
Seat 3: masaytoo ($91.75 in chips) 
Seat 4: Sweden_Pound ($100 in chips) 
Seat 5: matiko09 ($105 in chips) 
Seat 6: RUS)Timur ($150.32 in chips) 
Seat 9: di0d80 ($100.50 in chips) 
di0d80: posts small blind $0.50
nnne409: posts big blind $1
*** HOLE CARDS ***
Dealt to matiko09 [2h As]
tipner: folds 
masaytoo: folds 
Sweden_Pound: folds 
matiko09: folds 
RUS)Timur: folds 
di0d80: folds 
Uncalled bet ($0.50) returned to nnne409
nnne409 collected $1 from pot
nnne409: doesn't show hand 
*** SUMMARY ***
Total pot $1 | Rake $0 
Seat 1: nnne409 (big blind) collected ($1)
Seat 2: tipner folded before Flop (didn't bet)
Seat 3: masaytoo folded before Flop (didn't bet)
Seat 4: Sweden_Pound folded before Flop (didn't bet)
Seat 5: matiko09 folded before Flop (didn't bet)
Seat 6: RUS)Timur (button) folded before Flop (didn't bet)
Seat 9: di0d80 (small blind) folded before Flop





PokerStars Hand #147754213755:  Hold'em No Limit ($0.50/$1.00 USD) - 2016/01/27 11:38:15 CET [2016/01/27 5:38:15 ET]
Table 'Alkmene II' 9-max Seat #8 is the button
Seat 1: matiko09 ($100 in chips) 
Seat 2: deepblue0000 ($100 in chips) 
Seat 4: CoolFireX ($150.07 in chips) 
Seat 5: Sweden_Pound ($119.55 in chips) 
Seat 6: Peu3aHy ($116.92 in chips) 
Seat 7: mycka86 ($124.36 in chips) 
Seat 8: fecsok1 ($76.18 in chips) 
Seat 9: pandalapa ($100.50 in chips) 
pandalapa: posts small blind $0.50
matiko09: posts big blind $1
blef1992: sits out 
*** HOLE CARDS ***
Dealt to matiko09 [4s 5s]
deepblue0000: folds 
CoolFireX: raises $2 to $3
Sweden_Pound: folds 
Peu3aHy: folds 
mycka86: folds 
fecsok1: folds 
pandalapa: folds 
matiko09: folds 
Uncalled bet ($2) returned to CoolFireX
CoolFireX collected $2.50 from pot
CoolFireX: doesn't show hand 
*** SUMMARY ***
Total pot $2.50 | Rake $0 
Seat 1: matiko09 (big blind) folded before Flop
Seat 2: deepblue0000 folded before Flop (didn't bet)
Seat 4: CoolFireX collected ($2.50)
Seat 5: Sweden_Pound folded before Flop (didn't bet)
Seat 6: Peu3aHy folded before Flop (didn't bet)
Seat 7: mycka86 folded before Flop (didn't bet)
Seat 8: fecsok1 (button) folded before Flop (didn't bet)
Seat 9: pandalapa (small blind) folded before Flop





PokerStars Hand #147754214942:  Hold'em No Limit ($0.50/$1.00 USD) - 2016/01/27 11:38:18 CET [2016/01/27 5:38:18 ET]
Table 'Thais' 9-max Seat #1 is the button
Seat 1: Peu3aHy ($128.53 in chips) 
Seat 2: Sweden_Pound ($101.50 in chips) 
Seat 3: RoadtoNepal ($100 in chips) 
Seat 4: aayat ($51.64 in chips) 
Seat 5: matiko09 ($100 in chips) 
Seat 6: deepblue0000 ($155.27 in chips) 
Seat 7: Venomous100% ($276.09 in chips) 
Seat 8: sylvian31 ($100 in chips) 
Seat 9: tipner ($116.42 in chips) 
Sweden_Pound: posts small blind $0.50
RoadtoNepal: posts big blind $1
*** HOLE CARDS ***
Dealt to matiko09 [2d 3h]
aayat: calls $1
matiko09: folds 
deepblue0000: folds 
Venomous100%: folds 
sylvian31: folds 
tipner: folds 
Peu3aHy: calls $1
Sweden_Pound: folds 
RoadtoNepal: checks 
*** FLOP *** [7d 8c 5s]
RoadtoNepal: checks 
aayat: bets $3.34
Peu3aHy: calls $3.34
RoadtoNepal: folds 
*** TURN *** [7d 8c 5s] [Ac]
aayat: checks 
Peu3aHy: bets $6
aayat: calls $6
*** RIVER *** [7d 8c 5s Ac] [Qd]
aayat: checks 
Peu3aHy: checks 
*** SHOW DOWN ***
aayat: shows [Ad Js] (a pair of Aces)
Peu3aHy: mucks hand 
aayat collected $21.18 from pot
*** SUMMARY ***
Total pot $22.18 | Rake $1 
Board [7d 8c 5s Ac Qd]
Seat 1: Peu3aHy (button) mucked [9c Kh]
Seat 2: Sweden_Pound (small blind) folded before Flop
Seat 3: RoadtoNepal (big blind) folded on the Flop
Seat 4: aayat showed [Ad Js] and won ($21.18) with a pair of Aces
Seat 5: matiko09 folded before Flop (didn't bet)
Seat 6: deepblue0000 folded before Flop (didn't bet)
Seat 7: Venomous100% folded before Flop (didn't bet)
Seat 8: sylvian31 folded before Flop (didn't bet)
Seat 9: tipner folded before Flop (didn't bet)





PokerStars Hand #147754218279:  Hold'em No Limit ($0.50/$1.00 USD) - 2016/01/27 11:38:24 CET [2016/01/27 5:38:24 ET]
Table 'Alhajoth' 9-max Seat #1 is the button
Seat 1: UShallGimme$ ($154.45 in chips) 
Seat 2: matiko09 ($100 in chips) 
Seat 3: Sweden_Pound ($117.77 in chips) 
Seat 4: Venomous100% ($129.87 in chips) 
Seat 5: Kukuryzka ($100 in chips) 
Seat 6: RoadtoNepal ($188.80 in chips) 
Seat 7: Ohpeel ($114.13 in chips) 
Seat 8: deepblue0000 ($119.18 in chips) 
Seat 9: di0d80 ($100 in chips) 
matiko09: posts small blind $0.50
Sweden_Pound: posts big blind $1
*** HOLE CARDS ***
Dealt to matiko09 [Qh Kd]
Venomous100%: folds 
Kukuryzka: raises $2 to $3
RoadtoNepal: folds 
Ohpeel: folds 
deepblue0000: calls $3
di0d80: folds 
UShallGimme$: folds 
matiko09: folds 
Sweden_Pound: folds 
*** FLOP *** [3s 4s 6c]
Kukuryzka: bets $5.37
deepblue0000: folds 
Uncalled bet ($5.37) returned to Kukuryzka
Kukuryzka collected $7.16 from pot
Kukuryzka: doesn't show hand 
*** SUMMARY ***
Total pot $7.50 | Rake $0.34 
Board [3s 4s 6c]
Seat 1: UShallGimme$ (button) folded before Flop (didn't bet)
Seat 2: matiko09 (small blind) folded before Flop
Seat 3: Sweden_Pound (big blind) folded before Flop
Seat 4: Venomous100% folded before Flop (didn't bet)
Seat 5: Kukuryzka collected ($7.16)
Seat 6: RoadtoNepal folded before Flop (didn't bet)
Seat 7: Ohpeel folded before Flop (didn't bet)
Seat 8: deepblue0000 folded on the Flop
Seat 9: di0d80 folded before Flop (didn't bet)





PokerStars Hand #147754223061:  Hold'em No Limit ($0.50/$1.00 USD) - 2016/01/27 11:38:34 CET [2016/01/27 5:38:34 ET]
Table 'Nanking' 9-max Seat #8 is the button
Seat 1: Peu3aHy ($100 in chips) 
Seat 2: Dachish ($105.17 in chips) 
Seat 3: nuaxin ($67.84 in chips) 
Seat 4: COOLIKO\/23 ($155.16 in chips) 
Seat 5: TheGentleFox ($76.74 in chips) 
Seat 6: Kukuryzka ($100 in chips) 
Seat 7: tipner ($100 in chips) 
Seat 8: matiko09 ($102.66 in chips) 
Seat 9: Sweden_Pound ($108.35 in chips) 
Sweden_Pound: posts small blind $0.50
Peu3aHy: posts big blind $1
*** HOLE CARDS ***
Dealt to matiko09 [6d 3h]
Dachish: folds 
nuaxin: calls $1
COOLIKO\/23: folds 
TheGentleFox: folds 
Kukuryzka: folds 
tipner: folds 
matiko09: folds 
Sweden_Pound: raises $4 to $5
Peu3aHy: folds 
nuaxin: calls $4
*** FLOP *** [3s 9d 6c]
Sweden_Pound: bets $6.82
nuaxin: calls $6.82
*** TURN *** [3s 9d 6c] [2d]
Sweden_Pound: bets $15
nuaxin: calls $15
*** RIVER *** [3s 9d 6c 2d] [7h]
Sweden_Pound: checks 
nuaxin: bets $10
Sweden_Pound: calls $10
*** SHOW DOWN ***
nuaxin: shows [Jh As] (high card Ace)
Sweden_Pound: shows [9s Ks] (a pair of Nines)
Sweden_Pound collected $71.84 from pot
*** SUMMARY ***
Total pot $74.64 | Rake $2.80 
Board [3s 9d 6c 2d 7h]
Seat 1: Peu3aHy (big blind) folded before Flop
Seat 2: Dachish folded before Flop (didn't bet)
Seat 3: nuaxin showed [Jh As] and lost with high card Ace
Seat 4: COOLIKO\/23 folded before Flop (didn't bet)
Seat 5: TheGentleFox folded before Flop (didn't bet)
Seat 6: Kukuryzka folded before Flop (didn't bet)
Seat 7: tipner folded before Flop (didn't bet)
Seat 8: matiko09 (button) folded before Flop (didn't bet)
Seat 9: Sweden_Pound (small blind) showed [9s Ks] and won ($71.84) with a pair of Nines





PokerStars Hand #147754224908:  Hold'em No Limit ($0.50/$1.00 USD) - 2016/01/27 11:38:38 CET [2016/01/27 5:38:38 ET]
Table 'Siegena III' 9-max Seat #9 is the button
Seat 1: nnne409 ($100.50 in chips) 
Seat 2: tipner ($101.50 in chips) 
Seat 3: masaytoo ($91.75 in chips) 
Seat 4: Sweden_Pound ($100 in chips) 
Seat 5: matiko09 ($105 in chips) 
Seat 6: RUS)Timur ($150.32 in chips) 
Seat 9: di0d80 ($100 in chips) 
nnne409: posts small blind $0.50
tipner: posts big blind $1
*** HOLE CARDS ***
Dealt to matiko09 [8h Ad]
masaytoo: folds 
Sweden_Pound: folds 
matiko09: folds 
RUS)Timur: folds 
di0d80: raises $1 to $2
nnne409: folds 
tipner: folds 
Uncalled bet ($1) returned to di0d80
di0d80 collected $2.50 from pot
di0d80: doesn't show hand 
*** SUMMARY ***
Total pot $2.50 | Rake $0 
Seat 1: nnne409 (small blind) folded before Flop
Seat 2: tipner (big blind) folded before Flop
Seat 3: masaytoo folded before Flop (didn't bet)
Seat 4: Sweden_Pound folded before Flop (didn't bet)
Seat 5: matiko09 folded before Flop (didn't bet)
Seat 6: RUS)Timur folded before Flop (didn't bet)
Seat 9: di0d80 (button) collected ($2.50)





PokerStars Hand #147754225766:  Hold'em No Limit ($0.50/$1.00 USD) - 2016/01/27 11:38:39 CET [2016/01/27 5:38:39 ET]
Table 'Delphinus II' 9-max Seat #3 is the button
Seat 1: Saintreine ($137.81 in chips) 
Seat 2: AlKatrone ($199.15 in chips) 
Seat 3: deepblue0000 ($328.98 in chips) 
Seat 4: matiko09 ($123.73 in chips) 
Seat 5: pandalapa ($106.05 in chips) 
Seat 6: Sweden_Pound ($124.64 in chips) 
Seat 7: RUS)Timur ($100 in chips) 
Seat 8: mycka86 ($106.10 in chips) 
Seat 9: FGL-lucky ($45.38 in chips) 
matiko09: posts small blind $0.50
pandalapa: posts big blind $1
*** HOLE CARDS ***
Dealt to matiko09 [2c 9c]
Sweden_Pound: folds 
RUS)Timur: folds 
mycka86: folds 
FGL-lucky: folds 
Saintreine: raises $1.50 to $2.50
AlKatrone: folds 
deepblue0000: folds 
matiko09: folds 
pandalapa: calls $1.50
*** FLOP *** [Ah 7h 4h]
pandalapa: checks 
Saintreine: checks 
*** TURN *** [Ah 7h 4h] [Qh]
pandalapa: checks 
Saintreine: bets $5
pandalapa: calls $5
*** RIVER *** [Ah 7h 4h Qh] [3c]
pandalapa: checks 
Saintreine: bets $25
pandalapa: folds 
Uncalled bet ($25) returned to Saintreine
Saintreine collected $14.80 from pot
Saintreine: doesn't show hand 
*** SUMMARY ***
Total pot $15.50 | Rake $0.70 
Board [Ah 7h 4h Qh 3c]
Seat 1: Saintreine collected ($14.80)
Seat 2: AlKatrone folded before Flop (didn't bet)
Seat 3: deepblue0000 (button) folded before Flop (didn't bet)
Seat 4: matiko09 (small blind) folded before Flop
Seat 5: pandalapa (big blind) folded on the River
Seat 6: Sweden_Pound folded before Flop (didn't bet)
Seat 7: RUS)Timur folded before Flop (didn't bet)
Seat 8: mycka86 folded before Flop (didn't bet)
Seat 9: FGL-lucky folded before Flop (didn't bet)





PokerStars Hand #147754228051:  Hold'em No Limit ($0.50/$1.00 USD) - 2016/01/27 11:38:44 CET [2016/01/27 5:38:44 ET]
Table 'Henyey' 9-max Seat #6 is the button
Seat 2: pandalapa ($152.27 in chips) 
Seat 3: deepblue0000 ($100 in chips) 
Seat 5: matiko09 ($116.08 in chips) 
Seat 6: UShallGimme$ ($103.12 in chips) 
Seat 7: vinniej15 ($35.50 in chips) 
Seat 8: CoolFireX ($113.60 in chips) 
Seat 9: mycka86 ($137.13 in chips) 
vinniej15: posts small blind $0.50
CoolFireX: posts big blind $1
COOLIKO\/23: sits out 
*** HOLE CARDS ***
Dealt to matiko09 [Ks 9h]
mycka86: folds 
pandalapa: folds 
deepblue0000: raises $2 to $3
matiko09: folds 
UShallGimme$: folds 
vinniej15: folds 
CoolFireX: folds 
Uncalled bet ($2) returned to deepblue0000
deepblue0000 collected $2.50 from pot
*** SUMMARY ***
Total pot $2.50 | Rake $0 
Seat 2: pandalapa folded before Flop (didn't bet)
Seat 3: deepblue0000 collected ($2.50)
Seat 5: matiko09 folded before Flop (didn't bet)
Seat 6: UShallGimme$ (button) folded before Flop (didn't bet)
Seat 7: vinniej15 (small blind) folded before Flop
Seat 8: CoolFireX (big blind) folded before Flop
Seat 9: mycka86 folded before Flop (didn't bet)





PokerStars Hand #147754235269:  Hold'em No Limit ($0.50/$1.00 USD) - 2016/01/27 11:38:58 CET [2016/01/27 5:38:58 ET]
Table 'Fragaria II' 9-max Seat #1 is the button
Seat 1: deepblue0000 ($104.28 in chips) 
Seat 2: GG-NoR34D. ($71.63 in chips) 
Seat 3: Sweden_Pound ($119.01 in chips) 
Seat 4: AlKatrone ($101 in chips) 
Seat 5: Venomous100% ($106.62 in chips) 
Seat 6: UShallGimme$ ($192.49 in chips) 
Seat 7: Hobby-.-AK ($39.02 in chips) 
Seat 8: mycka86 ($111.10 in chips) 
Seat 9: matiko09 ($102 in chips) 
GG-NoR34D.: posts small blind $0.50
Sweden_Pound: posts big blind $1
*** HOLE CARDS ***
Dealt to matiko09 [Kh 8h]
AlKatrone: folds 
Venomous100%: folds 
UShallGimme$: folds 
Hobby-.-AK: folds 
mycka86: folds 
matiko09: raises $1.50 to $2.50
deepblue0000: folds 
GG-NoR34D.: folds 
Sweden_Pound: folds 
Uncalled bet ($1.50) returned to matiko09
matiko09 collected $2.50 from pot
matiko09: doesn't show hand 
*** SUMMARY ***
Total pot $2.50 | Rake $0 
Seat 1: deepblue0000 (button) folded before Flop (didn't bet)
Seat 2: GG-NoR34D. (small blind) folded before Flop
Seat 3: Sweden_Pound (big blind) folded before Flop
Seat 4: AlKatrone folded before Flop (didn't bet)
Seat 5: Venomous100% folded before Flop (didn't bet)
Seat 6: UShallGimme$ folded before Flop (didn't bet)
Seat 7: Hobby-.-AK folded before Flop (didn't bet)
Seat 8: mycka86 folded before Flop (didn't bet)
Seat 9: matiko09 collected ($2.50)





PokerStars Hand #147754235538:  Hold'em No Limit ($0.50/$1.00 USD) - 2016/01/27 11:38:59 CET [2016/01/27 5:38:59 ET]
Table 'Alkmene II' 9-max Seat #9 is the button
Seat 1: matiko09 ($100 in chips) 
Seat 2: deepblue0000 ($100 in chips) 
Seat 3: blef1992 ($80 in chips) 
Seat 4: CoolFireX ($151.57 in chips) 
Seat 5: Sweden_Pound ($119.55 in chips) 
Seat 6: Peu3aHy ($116.92 in chips) 
Seat 7: mycka86 ($124.36 in chips) 
Seat 8: fecsok1 ($76.18 in chips) 
Seat 9: pandalapa ($100 in chips) 
matiko09: posts small blind $0.50
deepblue0000: posts big blind $1
blef1992: posts big blind $1
*** HOLE CARDS ***
Dealt to matiko09 [Ks 2s]
blef1992: raises $2 to $3
CoolFireX: folds 
Sweden_Pound: folds 
Peu3aHy: folds 
mycka86: folds 
fecsok1: folds 
pandalapa: folds 
matiko09: folds 
deepblue0000: folds 
Uncalled bet ($2) returned to blef1992
blef1992 collected $2.50 from pot
blef1992: doesn't show hand 
*** SUMMARY ***
Total pot $2.50 | Rake $0 
Seat 1: matiko09 (small blind) folded before Flop
Seat 2: deepblue0000 (big blind) folded before Flop
Seat 3: blef1992 collected ($2.50)
Seat 4: CoolFireX folded before Flop (didn't bet)
Seat 5: Sweden_Pound folded before Flop (didn't bet)
Seat 6: Peu3aHy folded before Flop (didn't bet)
Seat 7: mycka86 folded before Flop (didn't bet)
Seat 8: fecsok1 folded before Flop (didn't bet)
Seat 9: pandalapa (button) folded before Flop (didn't bet)





PokerStars Hand #147754236569:  Hold'em No Limit ($0.50/$1.00 USD) - 2016/01/27 11:39:01 CET [2016/01/27 5:39:01 ET]
Table 'Alhajoth' 9-max Seat #2 is the button
Seat 1: UShallGimme$ ($154.45 in chips) 
Seat 2: matiko09 ($100 in chips) 
Seat 3: Sweden_Pound ($116.77 in chips) 
Seat 4: Venomous100% ($129.87 in chips) 
Seat 5: Kukuryzka ($104.16 in chips) 
Seat 6: RoadtoNepal ($188.80 in chips) 
Seat 7: Ohpeel ($114.13 in chips) 
Seat 8: deepblue0000 ($116.18 in chips) 
Seat 9: di0d80 ($100 in chips) 
Sweden_Pound: posts small blind $0.50
Venomous100%: posts big blind $1
*** HOLE CARDS ***
Dealt to matiko09 [Jh 6h]
Kukuryzka: folds 
RoadtoNepal: folds 
Ohpeel: folds 
deepblue0000: folds 
di0d80: folds 
UShallGimme$: folds 
matiko09: folds 
Sweden_Pound: raises $2 to $3
Venomous100%: folds 
Uncalled bet ($2) returned to Sweden_Pound
Sweden_Pound collected $2 from pot
Sweden_Pound: doesn't show hand 
*** SUMMARY ***
Total pot $2 | Rake $0 
Seat 1: UShallGimme$ folded before Flop (didn't bet)
Seat 2: matiko09 (button) folded before Flop (didn't bet)
Seat 3: Sweden_Pound (small blind) collected ($2)
Seat 4: Venomous100% (big blind) folded before Flop
Seat 5: Kukuryzka folded before Flop (didn't bet)
Seat 6: RoadtoNepal folded before Flop (didn't bet)
Seat 7: Ohpeel folded before Flop (didn't bet)
Seat 8: deepblue0000 folded before Flop (didn't bet)
Seat 9: di0d80 folded before Flop (didn't bet)





PokerStars Hand #147754239709:  Hold'em No Limit ($0.50/$1.00 USD) - 2016/01/27 11:39:07 CET [2016/01/27 5:39:07 ET]
Table 'Henyey' 9-max Seat #7 is the button
Seat 2: pandalapa ($152.27 in chips) 
Seat 3: deepblue0000 ($101.50 in chips) 
Seat 5: matiko09 ($116.08 in chips) 
Seat 6: UShallGimme$ ($103.12 in chips) 
Seat 7: vinniej15 ($35 in chips) 
Seat 8: CoolFireX ($112.60 in chips) 
Seat 9: mycka86 ($137.13 in chips) 
CoolFireX: posts small blind $0.50
mycka86: posts big blind $1
COOLIKO\/23: sits out 
*** HOLE CARDS ***
Dealt to matiko09 [Ks 6c]
pandalapa: folds 
deepblue0000: raises $1 to $2
matiko09: folds 
UShallGimme$: raises $5 to $7
vinniej15: folds 
CoolFireX: folds 
mycka86: folds 
deepblue0000: calls $5
*** FLOP *** [7d 3s Kd]
deepblue0000: checks 
UShallGimme$: bets $8
deepblue0000: calls $8
*** TURN *** [7d 3s Kd] [Qc]
deepblue0000: checks 
UShallGimme$: checks 
*** RIVER *** [7d 3s Kd Qc] [2d]
deepblue0000: bets $20.05
UShallGimme$: folds 
Uncalled bet ($20.05) returned to deepblue0000
deepblue0000 collected $30.08 from pot
*** SUMMARY ***
Total pot $31.50 | Rake $1.42 
Board [7d 3s Kd Qc 2d]
Seat 2: pandalapa folded before Flop (didn't bet)
Seat 3: deepblue0000 collected ($30.08)
Seat 5: matiko09 folded before Flop (didn't bet)
Seat 6: UShallGimme$ folded on the River
Seat 7: vinniej15 (button) folded before Flop (didn't bet)
Seat 8: CoolFireX (small blind) folded before Flop
Seat 9: mycka86 (big blind) folded before Flop





PokerStars Hand #147754239814:  Hold'em No Limit ($0.50/$1.00 USD) - 2016/01/27 11:39:07 CET [2016/01/27 5:39:07 ET]
Table 'Siegena III' 9-max Seat #1 is the button
Seat 1: nnne409 ($100 in chips) 
Seat 2: tipner ($100.50 in chips) 
Seat 3: masaytoo ($91.75 in chips) 
Seat 4: Sweden_Pound ($100 in chips) 
Seat 5: matiko09 ($105 in chips) 
Seat 6: RUS)Timur ($150.32 in chips) 
Seat 9: di0d80 ($101.50 in chips) 
tipner: posts small blind $0.50
masaytoo: posts big blind $1
*** HOLE CARDS ***
Dealt to matiko09 [9s Ad]
Sweden_Pound: folds 
matiko09: folds 
RUS)Timur: folds 
di0d80: folds 
nnne409: raises $1 to $2
tipner: folds 
masaytoo: folds 
Uncalled bet ($1) returned to nnne409
nnne409 collected $2.50 from pot
nnne409: doesn't show hand 
*** SUMMARY ***
Total pot $2.50 | Rake $0 
Seat 1: nnne409 (button) collected ($2.50)
Seat 2: tipner (small blind) folded before Flop
Seat 3: masaytoo (big blind) folded before Flop
Seat 4: Sweden_Pound folded before Flop (didn't bet)
Seat 5: matiko09 folded before Flop (didn't bet)
Seat 6: RUS)Timur folded before Flop (didn't bet)
Seat 9: di0d80 folded before Flop (didn't bet)





PokerStars Hand #147754248792:  Hold'em No Limit ($0.50/$1.00 USD) - 2016/01/27 11:39:25 CET [2016/01/27 5:39:25 ET]
Table 'Fragaria II' 9-max Seat #2 is the button
Seat 1: deepblue0000 ($104.28 in chips) 
Seat 2: GG-NoR34D. ($71.13 in chips) 
Seat 3: Sweden_Pound ($118.01 in chips) 
Seat 4: AlKatrone ($101 in chips) 
Seat 5: Venomous100% ($106.62 in chips) 
Seat 6: UShallGimme$ ($192.49 in chips) 
Seat 7: Hobby-.-AK ($70.54 in chips) 
Seat 8: mycka86 ($111.10 in chips) 
Seat 9: matiko09 ($103.50 in chips) 
Sweden_Pound: posts small blind $0.50
AlKatrone: posts big blind $1
*** HOLE CARDS ***
Dealt to matiko09 [Kd 9h]
Venomous100%: folds 
UShallGimme$: folds 
Hobby-.-AK: folds 
mycka86: folds 
matiko09: folds 
deepblue0000: folds 
GG-NoR34D.: folds 
Sweden_Pound: folds 
Uncalled bet ($0.50) returned to AlKatrone
AlKatrone collected $1 from pot
AlKatrone: doesn't show hand 
*** SUMMARY ***
Total pot $1 | Rake $0 
Seat 1: deepblue0000 folded before Flop (didn't bet)
Seat 2: GG-NoR34D. (button) folded before Flop (didn't bet)
Seat 3: Sweden_Pound (small blind) folded before Flop
Seat 4: AlKatrone (big blind) collected ($1)
Seat 5: Venomous100% folded before Flop (didn't bet)
Seat 6: UShallGimme$ folded before Flop (didn't bet)
Seat 7: Hobby-.-AK folded before Flop (didn't bet)
Seat 8: mycka86 folded before Flop (didn't bet)
Seat 9: matiko09 folded before Flop (didn't bet)





PokerStars Hand #147754252309:  Hold'em No Limit ($0.50/$1.00 USD) - 2016/01/27 11:39:32 CET [2016/01/27 5:39:32 ET]
Table 'Alkmene II' 9-max Seat #1 is the button
Seat 1: matiko09 ($100 in chips) 
Seat 2: deepblue0000 ($100 in chips) 
Seat 3: blef1992 ($81.50 in chips) 
Seat 4: CoolFireX ($151.57 in chips) 
Seat 5: Sweden_Pound ($119.55 in chips) 
Seat 6: Peu3aHy ($116.92 in chips) 
Seat 7: mycka86 ($124.36 in chips) 
Seat 8: fecsok1 ($76.18 in chips) 
Seat 9: pandalapa ($100 in chips) 
deepblue0000: posts small blind $0.50
blef1992: posts big blind $1
*** HOLE CARDS ***
Dealt to matiko09 [Qs As]
CoolFireX: folds 
Sweden_Pound: folds 
Peu3aHy: raises $2 to $3
mycka86: folds 
fecsok1: folds 
pandalapa: folds 
matiko09: calls $3
deepblue0000: folds 
blef1992: calls $2
*** FLOP *** [8h Td 6h]
blef1992: bets $7
Peu3aHy: folds 
matiko09: folds 
Uncalled bet ($7) returned to blef1992
blef1992 collected $9.07 from pot
blef1992: doesn't show hand 
*** SUMMARY ***
Total pot $9.50 | Rake $0.43 
Board [8h Td 6h]
Seat 1: matiko09 (button) folded on the Flop
Seat 2: deepblue0000 (small blind) folded before Flop
Seat 3: blef1992 (big blind) collected ($9.07)
Seat 4: CoolFireX folded before Flop (didn't bet)
Seat 5: Sweden_Pound folded before Flop (didn't bet)
Seat 6: Peu3aHy folded on the Flop
Seat 7: mycka86 folded before Flop (didn't bet)
Seat 8: fecsok1 folded before Flop (didn't bet)
Seat 9: pandalapa folded before Flop (didn't bet)





PokerStars Hand #147754254439:  Hold'em No Limit ($0.50/$1.00 USD) - 2016/01/27 11:39:37 CET [2016/01/27 5:39:37 ET]
Table 'Thais' 9-max Seat #2 is the button
Seat 1: Peu3aHy ($118.19 in chips) 
Seat 2: Sweden_Pound ($101 in chips) 
Seat 3: RoadtoNepal ($100 in chips) 
Seat 5: matiko09 ($100 in chips) 
Seat 6: deepblue0000 ($155.27 in chips) 
Seat 7: Venomous100% ($276.09 in chips) 
Seat 8: sylvian31 ($100 in chips) 
Seat 9: tipner ($116.42 in chips) 
RoadtoNepal: posts small blind $0.50
aayat: is sitting out 
matiko09: posts big blind $1
*** HOLE CARDS ***
Dealt to matiko09 [Qd 9s]
deepblue0000: folds 
aayat leaves the table
Venomous100%: folds 
di0d80 joins the table at seat #4 
sylvian31: folds 
di0d80 leaves the table
COOLIKO\/23 joins the table at seat #4 
tipner: folds 
Peu3aHy: folds 
Sweden_Pound: folds 
RoadtoNepal: folds 
Uncalled bet ($0.50) returned to matiko09
matiko09 collected $1 from pot
matiko09: doesn't show hand 
COOLIKO\/23 leaves the table
*** SUMMARY ***
Total pot $1 | Rake $0 
Seat 1: Peu3aHy folded before Flop (didn't bet)
Seat 2: Sweden_Pound (button) folded before Flop (didn't bet)
Seat 3: RoadtoNepal (small blind) folded before Flop
Seat 5: matiko09 (big blind) collected ($1)
Seat 6: deepblue0000 folded before Flop (didn't bet)
Seat 7: Venomous100% folded before Flop (didn't bet)
Seat 8: sylvian31 folded before Flop (didn't bet)
Seat 9: tipner folded before Flop (didn't bet)





PokerStars Hand #147754256714:  Hold'em No Limit ($0.50/$1.00 USD) - 2016/01/27 11:39:41 CET [2016/01/27 5:39:41 ET]
Table 'Delphinus II' 9-max Seat #4 is the button
Seat 1: Saintreine ($145.11 in chips) 
Seat 2: AlKatrone ($199.15 in chips) 
Seat 3: deepblue0000 ($328.98 in chips) 
Seat 4: matiko09 ($123.23 in chips) 
Seat 5: pandalapa ($100 in chips) 
Seat 6: Sweden_Pound ($124.64 in chips) 
Seat 7: RUS)Timur ($100 in chips) 
Seat 8: mycka86 ($106.10 in chips) 
Seat 9: FGL-lucky ($45.38 in chips) 
pandalapa: posts small blind $0.50
Sweden_Pound: posts big blind $1
*** HOLE CARDS ***
Dealt to matiko09 [5h 7s]
RUS)Timur: folds 
mycka86: folds 
FGL-lucky: raises $1 to $2
Saintreine: folds 
AlKatrone: raises $5 to $7
deepblue0000: folds 
matiko09: folds 
pandalapa: folds 
Sweden_Pound: folds 
FGL-lucky: raises $10 to $17
AlKatrone: folds 
Uncalled bet ($10) returned to FGL-lucky
FGL-lucky collected $15.50 from pot
FGL-lucky: doesn't show hand 
*** SUMMARY ***
Total pot $15.50 | Rake $0 
Seat 1: Saintreine folded before Flop (didn't bet)
Seat 2: AlKatrone folded before Flop
Seat 3: deepblue0000 folded before Flop (didn't bet)
Seat 4: matiko09 (button) folded before Flop (didn't bet)
Seat 5: pandalapa (small blind) folded before Flop
Seat 6: Sweden_Pound (big blind) folded before Flop
Seat 7: RUS)Timur folded before Flop (didn't bet)
Seat 8: mycka86 folded before Flop (didn't bet)
Seat 9: FGL-lucky collected ($15.50)





PokerStars Hand #147754257478:  Hold'em No Limit ($0.50/$1.00 USD) - 2016/01/27 11:39:43 CET [2016/01/27 5:39:43 ET]
Table 'Alhajoth' 9-max Seat #3 is the button
Seat 1: UShallGimme$ ($154.45 in chips) 
Seat 2: matiko09 ($100 in chips) 
Seat 3: Sweden_Pound ($117.77 in chips) 
Seat 4: Venomous100% ($128.87 in chips) 
Seat 5: Kukuryzka ($104.16 in chips) 
Seat 6: RoadtoNepal ($188.80 in chips) 
Seat 7: Ohpeel ($114.13 in chips) 
Seat 8: deepblue0000 ($116.18 in chips) 
Seat 9: di0d80 ($100 in chips) 
Venomous100%: posts small blind $0.50
Kukuryzka: posts big blind $1
*** HOLE CARDS ***
Dealt to matiko09 [4c 6h]
RoadtoNepal: raises $2 to $3
Ohpeel: folds 
deepblue0000: folds 
di0d80: calls $3
UShallGimme$: folds 
matiko09: folds 
Sweden_Pound: folds 
Venomous100%: folds 
Kukuryzka: folds 
*** FLOP *** [8s Qh 8d]
RoadtoNepal: checks 
di0d80: checks 
*** TURN *** [8s Qh 8d] [3d]
RoadtoNepal: checks 
di0d80: checks 
*** RIVER *** [8s Qh 8d 3d] [Th]
RoadtoNepal: checks 
di0d80: checks 
*** SHOW DOWN ***
RoadtoNepal: shows [As Kc] (a pair of Eights)
di0d80: shows [9s 9d] (two pair, Nines and Eights)
di0d80 collected $7.16 from pot
*** SUMMARY ***
Total pot $7.50 | Rake $0.34 
Board [8s Qh 8d 3d Th]
Seat 1: UShallGimme$ folded before Flop (didn't bet)
Seat 2: matiko09 folded before Flop (didn't bet)
Seat 3: Sweden_Pound (button) folded before Flop (didn't bet)
Seat 4: Venomous100% (small blind) folded before Flop
Seat 5: Kukuryzka (big blind) folded before Flop
Seat 6: RoadtoNepal showed [As Kc] and lost with a pair of Eights
Seat 7: Ohpeel folded before Flop (didn't bet)
Seat 8: deepblue0000 folded before Flop (didn't bet)
Seat 9: di0d80 showed [9s 9d] and won ($7.16) with two pair, Nines and Eights





PokerStars Hand #147754271924:  Hold'em No Limit ($0.50/$1.00 USD) - 2016/01/27 11:40:12 CET [2016/01/27 5:40:12 ET]
Table 'Nanking' 9-max Seat #9 is the button
Seat 1: Peu3aHy ($100 in chips) 
Seat 2: Dachish ($105.17 in chips) 
Seat 3: nuaxin ($31.02 in chips) 
Seat 4: COOLIKO\/23 ($155.16 in chips) 
Seat 5: TheGentleFox ($76.74 in chips) 
Seat 6: Kukuryzka ($100 in chips) 
Seat 7: tipner ($100 in chips) 
Seat 8: matiko09 ($102.66 in chips) 
Seat 9: Sweden_Pound ($143.37 in chips) 
Peu3aHy: posts small blind $0.50
Dachish: posts big blind $1
*** HOLE CARDS ***
Dealt to matiko09 [Qc 2h]
nuaxin: calls $1
COOLIKO\/23: folds 
TheGentleFox: raises $1 to $2
Kukuryzka: folds 
tipner: folds 
matiko09: folds 
Sweden_Pound: folds 
Peu3aHy: folds 
Dachish: folds 
nuaxin: raises $1 to $3
TheGentleFox: calls $1
*** FLOP *** [Ad 3d 6s]
nuaxin: bets $3.58
TheGentleFox: folds 
Uncalled bet ($3.58) returned to nuaxin
nuaxin collected $7.16 from pot
nuaxin: doesn't show hand 
*** SUMMARY ***
Total pot $7.50 | Rake $0.34 
Board [Ad 3d 6s]
Seat 1: Peu3aHy (small blind) folded before Flop
Seat 2: Dachish (big blind) folded before Flop
Seat 3: nuaxin collected ($7.16)
Seat 4: COOLIKO\/23 folded before Flop (didn't bet)
Seat 5: TheGentleFox folded on the Flop
Seat 6: Kukuryzka folded before Flop (didn't bet)
Seat 7: tipner folded before Flop (didn't bet)
Seat 8: matiko09 folded before Flop (didn't bet)
Seat 9: Sweden_Pound (button) folded before Flop (didn't bet)





PokerStars Hand #147754271798:  Hold'em No Limit ($0.50/$1.00 USD) - 2016/01/27 11:40:12 CET [2016/01/27 5:40:12 ET]
Table 'Henyey' 9-max Seat #8 is the button
Seat 1: COOLIKO\/23 ($100 in chips) 
Seat 2: pandalapa ($152.27 in chips) 
Seat 3: deepblue0000 ($116.58 in chips) 
Seat 5: matiko09 ($116.08 in chips) 
Seat 6: UShallGimme$ ($100 in chips) 
Seat 7: vinniej15 ($35 in chips) 
Seat 8: CoolFireX ($112.10 in chips) 
Seat 9: mycka86 ($136.13 in chips) 
mycka86: posts small blind $0.50
COOLIKO\/23: posts big blind $1
*** HOLE CARDS ***
Dealt to matiko09 [Jc 5h]
pandalapa: folds 
deepblue0000: raises $2 to $3
matiko09: folds 
UShallGimme$: calls $3
vinniej15: calls $3
CoolFireX: folds 
mycka86: folds 
COOLIKO\/23: folds 
*** FLOP *** [3c Js 4s]
deepblue0000: bets $6.68
UShallGimme$: folds 
vinniej15: folds 
Uncalled bet ($6.68) returned to deepblue0000
deepblue0000 collected $10.03 from pot
*** SUMMARY ***
Total pot $10.50 | Rake $0.47 
Board [3c Js 4s]
Seat 1: COOLIKO\/23 (big blind) folded before Flop
Seat 2: pandalapa folded before Flop (didn't bet)
Seat 3: deepblue0000 collected ($10.03)
Seat 5: matiko09 folded before Flop (didn't bet)
Seat 6: UShallGimme$ folded on the Flop
Seat 7: vinniej15 folded on the Flop
Seat 8: CoolFireX (button) folded before Flop (didn't bet)
Seat 9: mycka86 (small blind) folded before Flop





PokerStars Hand #147754273493:  Hold'em No Limit ($0.50/$1.00 USD) - 2016/01/27 11:40:15 CET [2016/01/27 5:40:15 ET]
Table 'Fragaria II' 9-max Seat #3 is the button
Seat 1: deepblue0000 ($104.28 in chips) 
Seat 2: GG-NoR34D. ($72.29 in chips) 
Seat 3: Sweden_Pound ($117.51 in chips) 
Seat 4: AlKatrone ($101.50 in chips) 
Seat 5: Venomous100% ($106.62 in chips) 
Seat 6: UShallGimme$ ($192.49 in chips) 
Seat 7: Hobby-.-AK ($70.54 in chips) 
Seat 8: mycka86 ($111.10 in chips) 
Seat 9: matiko09 ($103.50 in chips) 
AlKatrone: posts small blind $0.50
Venomous100%: posts big blind $1
*** HOLE CARDS ***
Dealt to matiko09 [2h Qc]
UShallGimme$: folds 
Hobby-.-AK: raises $1 to $2
mycka86: folds 
matiko09: folds 
deepblue0000: folds 
GG-NoR34D.: folds 
Sweden_Pound: folds 
AlKatrone: folds 
Venomous100%: folds 
Uncalled bet ($1) returned to Hobby-.-AK
Hobby-.-AK collected $2.50 from pot
*** SUMMARY ***
Total pot $2.50 | Rake $0 
Seat 1: deepblue0000 folded before Flop (didn't bet)
Seat 2: GG-NoR34D. folded before Flop (didn't bet)
Seat 3: Sweden_Pound (button) folded before Flop (didn't bet)
Seat 4: AlKatrone (small blind) folded before Flop
Seat 5: Venomous100% (big blind) folded before Flop
Seat 6: UShallGimme$ folded before Flop (didn't bet)
Seat 7: Hobby-.-AK collected ($2.50)
Seat 8: mycka86 folded before Flop (didn't bet)
Seat 9: matiko09 folded before Flop (didn't bet)





PokerStars Hand #147754273951:  Hold'em No Limit ($0.50/$1.00 USD) - 2016/01/27 11:40:16 CET [2016/01/27 5:40:16 ET]
Table 'Thais' 9-max Seat #3 is the button
Seat 1: Peu3aHy ($118.19 in chips) 
Seat 2: Sweden_Pound ($101 in chips) 
Seat 3: RoadtoNepal ($100 in chips) 
Seat 5: matiko09 ($100.50 in chips) 
Seat 6: deepblue0000 ($155.27 in chips) 
Seat 7: Venomous100% ($276.09 in chips) 
Seat 8: sylvian31 ($100 in chips) 
Seat 9: tipner ($116.42 in chips) 
matiko09: posts small blind $0.50
deepblue0000: posts big blind $1
*** HOLE CARDS ***
Dealt to matiko09 [Ac Ad]
Venomous100%: folds 
sylvian31: folds 
tipner: folds 
Peu3aHy: folds 
Sweden_Pound: raises $1.50 to $2.50
RoadtoNepal: folds 
matiko09: raises $6.50 to $9
deepblue0000: folds 
Sweden_Pound: folds 
Uncalled bet ($6.50) returned to matiko09
matiko09 collected $6 from pot
matiko09: doesn't show hand 
*** SUMMARY ***
Total pot $6 | Rake $0 
Seat 1: Peu3aHy folded before Flop (didn't bet)
Seat 2: Sweden_Pound folded before Flop
Seat 3: RoadtoNepal (button) folded before Flop (didn't bet)
Seat 5: matiko09 (small blind) collected ($6)
Seat 6: deepblue0000 (big blind) folded before Flop
Seat 7: Venomous100% folded before Flop (didn't bet)
Seat 8: sylvian31 folded before Flop (didn't bet)
Seat 9: tipner folded before Flop (didn't bet)





PokerStars Hand #147754282162:  Hold'em No Limit ($0.50/$1.00 USD) - 2016/01/27 11:40:33 CET [2016/01/27 5:40:33 ET]
Table 'Alkmene II' 9-max Seat #2 is the button
Seat 1: matiko09 ($100 in chips) 
Seat 2: deepblue0000 ($100 in chips) 
Seat 3: blef1992 ($87.57 in chips) 
Seat 4: CoolFireX ($151.57 in chips) 
Seat 5: Sweden_Pound ($119.55 in chips) 
Seat 6: Peu3aHy ($113.92 in chips) 
Seat 7: mycka86 ($124.36 in chips) 
Seat 8: fecsok1 ($76.18 in chips) 
Seat 9: pandalapa ($100 in chips) 
blef1992: posts small blind $0.50
CoolFireX: posts big blind $1
*** HOLE CARDS ***
Dealt to matiko09 [6s 5d]
Sweden_Pound: folds 
Peu3aHy: folds 
mycka86: raises $1.50 to $2.50
fecsok1: folds 
pandalapa: folds 
matiko09: folds 
deepblue0000: folds 
blef1992: raises $2.50 to $5
CoolFireX: folds 
mycka86: calls $2.50
*** FLOP *** [Jh 4h 9d]
blef1992: bets $5
mycka86: raises $9 to $14
blef1992: calls $9
*** TURN *** [Jh 4h 9d] [6c]
blef1992: checks 
mycka86: checks 
*** RIVER *** [Jh 4h 9d 6c] [Jd]
blef1992: bets $21
mycka86: folds 
Uncalled bet ($21) returned to blef1992
blef1992 collected $37.24 from pot
blef1992: doesn't show hand 
*** SUMMARY ***
Total pot $39 | Rake $1.76 
Board [Jh 4h 9d 6c Jd]
Seat 1: matiko09 folded before Flop (didn't bet)
Seat 2: deepblue0000 (button) folded before Flop (didn't bet)
Seat 3: blef1992 (small blind) collected ($37.24)
Seat 4: CoolFireX (big blind) folded before Flop
Seat 5: Sweden_Pound folded before Flop (didn't bet)
Seat 6: Peu3aHy folded before Flop (didn't bet)
Seat 7: mycka86 folded on the River
Seat 8: fecsok1 folded before Flop (didn't bet)
Seat 9: pandalapa folded before Flop (didn't bet)





PokerStars Hand #147754290677:  Hold'em No Limit ($0.50/$1.00 USD) - 2016/01/27 11:40:50 CET [2016/01/27 5:40:50 ET]
Table 'Fragaria II' 9-max Seat #4 is the button
Seat 1: deepblue0000 ($104.28 in chips) 
Seat 2: GG-NoR34D. ($72.29 in chips) 
Seat 3: Sweden_Pound ($117.51 in chips) 
Seat 4: AlKatrone ($101 in chips) 
Seat 5: Venomous100% ($105.62 in chips) 
Seat 6: UShallGimme$ ($192.49 in chips) 
Seat 7: Hobby-.-AK ($72.04 in chips) 
Seat 8: mycka86 ($111.10 in chips) 
Seat 9: matiko09 ($103.50 in chips) 
Venomous100%: posts small blind $0.50
UShallGimme$: posts big blind $1
*** HOLE CARDS ***
Dealt to matiko09 [4d Qs]
Hobby-.-AK: calls $1
mycka86: folds 
matiko09: folds 
deepblue0000: raises $3.50 to $4.50
GG-NoR34D.: folds 
Sweden_Pound: folds 
AlKatrone: folds 
Venomous100%: folds 
UShallGimme$: folds 
Hobby-.-AK: calls $3.50
*** FLOP *** [6s 8c 7c]
Hobby-.-AK: checks 
deepblue0000: checks 
*** TURN *** [6s 8c 7c] [9h]
Hobby-.-AK: checks 
deepblue0000: bets $5.01
Hobby-.-AK: calls $5.01
*** RIVER *** [6s 8c 7c 9h] [3d]
Hobby-.-AK: checks 
deepblue0000: bets $9.80
Hobby-.-AK: calls $9.80
*** SHOW DOWN ***
deepblue0000: shows [Td Th] (a straight, Six to Ten)
Hobby-.-AK: mucks hand 
deepblue0000 collected $38.31 from pot
*** SUMMARY ***
Total pot $40.12 | Rake $1.81 
Board [6s 8c 7c 9h 3d]
Seat 1: deepblue0000 showed [Td Th] and won ($38.31) with a straight, Six to Ten
Seat 2: GG-NoR34D. folded before Flop (didn't bet)
Seat 3: Sweden_Pound folded before Flop (didn't bet)
Seat 4: AlKatrone (button) folded before Flop (didn't bet)
Seat 5: Venomous100% (small blind) folded before Flop
Seat 6: UShallGimme$ (big blind) folded before Flop
Seat 7: Hobby-.-AK mucked [7s 7h]
Seat 8: mycka86 folded before Flop (didn't bet)
Seat 9: matiko09 folded before Flop (didn't bet)





PokerStars Hand #147754291005:  Hold'em No Limit ($0.50/$1.00 USD) - 2016/01/27 11:40:50 CET [2016/01/27 5:40:50 ET]
Table 'Nanking' 9-max Seat #1 is the button
Seat 1: Peu3aHy ($100 in chips) 
Seat 2: Dachish ($104.17 in chips) 
Seat 3: nuaxin ($35.18 in chips) 
Seat 4: COOLIKO\/23 ($155.16 in chips) 
Seat 5: TheGentleFox ($73.74 in chips) 
Seat 6: Kukuryzka ($100 in chips) 
Seat 7: tipner ($100 in chips) 
Seat 8: matiko09 ($102.66 in chips) 
Seat 9: Sweden_Pound ($143.37 in chips) 
Dachish: posts small blind $0.50
nuaxin: posts big blind $1
*** HOLE CARDS ***
Dealt to matiko09 [2h 6c]
COOLIKO\/23: folds 
TheGentleFox: raises $2 to $3
Kukuryzka: raises $7 to $10
tipner: folds 
matiko09: folds 
Sweden_Pound: folds 
Peu3aHy: folds 
Dachish: folds 
nuaxin: folds 
TheGentleFox: calls $7
*** FLOP *** [Js 5d Kd]
TheGentleFox: checks 
Kukuryzka: bets $15.40
TheGentleFox: folds 
Uncalled bet ($15.40) returned to Kukuryzka
Kukuryzka collected $20.53 from pot
Kukuryzka: doesn't show hand 
*** SUMMARY ***
Total pot $21.50 | Rake $0.97 
Board [Js 5d Kd]
Seat 1: Peu3aHy (button) folded before Flop (didn't bet)
Seat 2: Dachish (small blind) folded before Flop
Seat 3: nuaxin (big blind) folded before Flop
Seat 4: COOLIKO\/23 folded before Flop (didn't bet)
Seat 5: TheGentleFox folded on the Flop
Seat 6: Kukuryzka collected ($20.53)
Seat 7: tipner folded before Flop (didn't bet)
Seat 8: matiko09 folded before Flop (didn't bet)
Seat 9: Sweden_Pound folded before Flop (didn't bet)





PokerStars Hand #147754295176:  Hold'em No Limit ($0.50/$1.00 USD) - 2016/01/27 11:40:59 CET [2016/01/27 5:40:59 ET]
Table 'Thais' 9-max Seat #5 is the button
Seat 1: Peu3aHy ($118.19 in chips) 
Seat 2: Sweden_Pound ($100 in chips) 
Seat 3: RoadtoNepal ($100 in chips) 
Seat 5: matiko09 ($104 in chips) 
Seat 6: deepblue0000 ($154.27 in chips) 
Seat 7: Venomous100% ($276.09 in chips) 
Seat 8: sylvian31 ($100 in chips) 
Seat 9: tipner ($116.42 in chips) 
deepblue0000: posts small blind $0.50
Venomous100%: posts big blind $1
*** HOLE CARDS ***
Dealt to matiko09 [Kd 3c]
sylvian31: folds 
tipner: raises $2 to $3
Peu3aHy: folds 
Sweden_Pound: folds 
RoadtoNepal: folds 
matiko09: folds 
deepblue0000: folds 
Venomous100%: folds 
Uncalled bet ($2) returned to tipner
tipner collected $2.50 from pot
tipner: doesn't show hand 
*** SUMMARY ***
Total pot $2.50 | Rake $0 
Seat 1: Peu3aHy folded before Flop (didn't bet)
Seat 2: Sweden_Pound folded before Flop (didn't bet)
Seat 3: RoadtoNepal folded before Flop (didn't bet)
Seat 5: matiko09 (button) folded before Flop (didn't bet)
Seat 6: deepblue0000 (small blind) folded before Flop
Seat 7: Venomous100% (big blind) folded before Flop
Seat 8: sylvian31 folded before Flop (didn't bet)
Seat 9: tipner collected ($2.50)





PokerStars Hand #147754295803:  Hold'em No Limit ($0.50/$1.00 USD) - 2016/01/27 11:41:00 CET [2016/01/27 5:41:00 ET]
Table 'Delphinus II' 9-max Seat #5 is the button
Seat 1: Saintreine ($145.11 in chips) 
Seat 2: AlKatrone ($192.15 in chips) 
Seat 3: deepblue0000 ($328.98 in chips) 
Seat 4: matiko09 ($123.23 in chips) 
Seat 5: pandalapa ($100 in chips) 
Seat 6: Sweden_Pound ($123.64 in chips) 
Seat 7: RUS)Timur ($100 in chips) 
Seat 8: mycka86 ($106.10 in chips) 
Seat 9: FGL-lucky ($53.88 in chips) 
Sweden_Pound: posts small blind $0.50
RUS)Timur: posts big blind $1
*** HOLE CARDS ***
Dealt to matiko09 [Ts Ad]
mycka86: folds 
FGL-lucky: raises $1 to $2
Saintreine: folds 
AlKatrone: folds 
deepblue0000: raises $7 to $9
matiko09: folds 
pandalapa: folds 
Sweden_Pound: folds 
RUS)Timur: folds 
FGL-lucky: folds 
Uncalled bet ($7) returned to deepblue0000
deepblue0000 collected $5.50 from pot
*** SUMMARY ***
Total pot $5.50 | Rake $0 
Seat 1: Saintreine folded before Flop (didn't bet)
Seat 2: AlKatrone folded before Flop (didn't bet)
Seat 3: deepblue0000 collected ($5.50)
Seat 4: matiko09 folded before Flop (didn't bet)
Seat 5: pandalapa (button) folded before Flop (didn't bet)
Seat 6: Sweden_Pound (small blind) folded before Flop
Seat 7: RUS)Timur (big blind) folded before Flop
Seat 8: mycka86 folded before Flop (didn't bet)
Seat 9: FGL-lucky folded before Flop





PokerStars Hand #147754295609:  Hold'em No Limit ($0.50/$1.00 USD) - 2016/01/27 11:41:00 CET [2016/01/27 5:41:00 ET]
Table 'Henyey' 9-max Seat #9 is the button
Seat 1: COOLIKO\/23 ($100 in chips) 
Seat 2: pandalapa ($152.27 in chips) 
Seat 3: deepblue0000 ($123.61 in chips) 
Seat 5: matiko09 ($116.08 in chips) 
Seat 6: UShallGimme$ ($100 in chips) 
Seat 7: vinniej15 ($32 in chips) 
Seat 8: CoolFireX ($112.10 in chips) 
Seat 9: mycka86 ($135.63 in chips) 
COOLIKO\/23: posts small blind $0.50
pandalapa: posts big blind $1
*** HOLE CARDS ***
Dealt to matiko09 [9h Js]
deepblue0000: raises $1 to $2
matiko09: folds 
UShallGimme$: folds 
vinniej15: calls $2
CoolFireX: raises $8 to $10
mycka86: folds 
COOLIKO\/23: folds 
pandalapa: folds 
deepblue0000: folds 
vinniej15: folds 
Uncalled bet ($8) returned to CoolFireX
CoolFireX collected $7.50 from pot
CoolFireX: doesn't show hand 
*** SUMMARY ***
Total pot $7.50 | Rake $0 
Seat 1: COOLIKO\/23 (small blind) folded before Flop
Seat 2: pandalapa (big blind) folded before Flop
Seat 3: deepblue0000 folded before Flop
Seat 5: matiko09 folded before Flop (didn't bet)
Seat 6: UShallGimme$ folded before Flop (didn't bet)
Seat 7: vinniej15 folded before Flop
Seat 8: CoolFireX collected ($7.50)
Seat 9: mycka86 (button) folded before Flop (didn't bet)





PokerStars Hand #147754312499:  Hold'em No Limit ($0.50/$1.00 USD) - 2016/01/27 11:41:33 CET [2016/01/27 5:41:33 ET]
Table 'Delphinus II' 9-max Seat #6 is the button
Seat 1: Saintreine ($145.11 in chips) 
Seat 2: AlKatrone ($192.15 in chips) 
Seat 3: deepblue0000 ($332.48 in chips) 
Seat 4: matiko09 ($123.23 in chips) 
Seat 5: pandalapa ($100 in chips) 
Seat 6: Sweden_Pound ($123.14 in chips) 
Seat 7: RUS)Timur ($100 in chips) 
Seat 8: mycka86 ($106.10 in chips) 
Seat 9: FGL-lucky ($51.88 in chips) 
RUS)Timur: posts small blind $0.50
mycka86: posts big blind $1
*** HOLE CARDS ***
Dealt to matiko09 [Qs 9c]
FGL-lucky: folds 
Saintreine: folds 
AlKatrone: folds 
deepblue0000: folds 
matiko09: folds 
pandalapa: folds 
Sweden_Pound: folds 
RUS)Timur: folds 
Uncalled bet ($0.50) returned to mycka86
mycka86 collected $1 from pot
*** SUMMARY ***
Total pot $1 | Rake $0 
Seat 1: Saintreine folded before Flop (didn't bet)
Seat 2: AlKatrone folded before Flop (didn't bet)
Seat 3: deepblue0000 folded before Flop (didn't bet)
Seat 4: matiko09 folded before Flop (didn't bet)
Seat 5: pandalapa folded before Flop (didn't bet)
Seat 6: Sweden_Pound (button) folded before Flop (didn't bet)
Seat 7: RUS)Timur (small blind) folded before Flop
Seat 8: mycka86 (big blind) collected ($1)
Seat 9: FGL-lucky folded before Flop (didn't bet)





PokerStars Hand #147754314927:  Hold'em No Limit ($0.50/$1.00 USD) - 2016/01/27 11:41:38 CET [2016/01/27 5:41:38 ET]
Table 'Henyey' 9-max Seat #1 is the button
Seat 1: COOLIKO\/23 ($100 in chips) 
Seat 2: pandalapa ($151.27 in chips) 
Seat 3: deepblue0000 ($121.61 in chips) 
Seat 5: matiko09 ($116.08 in chips) 
Seat 6: UShallGimme$ ($100 in chips) 
Seat 7: vinniej15 ($30 in chips) 
Seat 8: CoolFireX ($117.60 in chips) 
Seat 9: mycka86 ($135.63 in chips) 
pandalapa: posts small blind $0.50
deepblue0000: posts big blind $1
*** HOLE CARDS ***
Dealt to matiko09 [4c Jc]
matiko09: folds 
UShallGimme$: folds 
vinniej15: calls $1
CoolFireX: raises $2.50 to $3.50
mycka86: folds 
COOLIKO\/23: folds 
pandalapa: folds 
deepblue0000: folds 
vinniej15: calls $2.50
*** FLOP *** [Js Jh 8c]
vinniej15: bets $4.06
CoolFireX: calls $4.06
*** TURN *** [Js Jh 8c] [Qd]
vinniej15: bets $22.44 and is all-in
CoolFireX: folds 
Uncalled bet ($22.44) returned to vinniej15
vinniej15 collected $15.87 from pot
*** SUMMARY ***
Total pot $16.62 | Rake $0.75 
Board [Js Jh 8c Qd]
Seat 1: COOLIKO\/23 (button) folded before Flop (didn't bet)
Seat 2: pandalapa (small blind) folded before Flop
Seat 3: deepblue0000 (big blind) folded before Flop
Seat 5: matiko09 folded before Flop (didn't bet)
Seat 6: UShallGimme$ folded before Flop (didn't bet)
Seat 7: vinniej15 collected ($15.87)
Seat 8: CoolFireX folded on the Turn
Seat 9: mycka86 folded before Flop (didn't bet)





PokerStars Hand #147754317020:  Hold'em No Limit ($0.50/$1.00 USD) - 2016/01/27 11:41:43 CET [2016/01/27 5:41:43 ET]
Table 'Alhajoth' 9-max Seat #4 is the button
Seat 1: UShallGimme$ ($154.45 in chips) 
Seat 2: matiko09 ($100 in chips) 
Seat 3: Sweden_Pound ($117.77 in chips) 
Seat 4: Venomous100% ($128.37 in chips) 
Seat 5: Kukuryzka ($103.16 in chips) 
Seat 6: RoadtoNepal ($185.80 in chips) 
Seat 7: Ohpeel ($114.13 in chips) 
Seat 8: deepblue0000 ($116.18 in chips) 
Seat 9: di0d80 ($104.16 in chips) 
Kukuryzka: posts small blind $0.50
RoadtoNepal: posts big blind $1
*** HOLE CARDS ***
Dealt to matiko09 [7s Jd]
Ohpeel: folds 
deepblue0000: folds 
di0d80: folds 
UShallGimme$: folds 
matiko09: folds 
Sweden_Pound: folds 
Venomous100%: folds 
Kukuryzka: folds 
Uncalled bet ($0.50) returned to RoadtoNepal
RoadtoNepal collected $1 from pot
RoadtoNepal: doesn't show hand 
*** SUMMARY ***
Total pot $1 | Rake $0 
Seat 1: UShallGimme$ folded before Flop (didn't bet)
Seat 2: matiko09 folded before Flop (didn't bet)
Seat 3: Sweden_Pound folded before Flop (didn't bet)
Seat 4: Venomous100% (button) folded before Flop (didn't bet)
Seat 5: Kukuryzka (small blind) folded before Flop
Seat 6: RoadtoNepal (big blind) collected ($1)
Seat 7: Ohpeel folded before Flop (didn't bet)
Seat 8: deepblue0000 folded before Flop (didn't bet)
Seat 9: di0d80 folded before Flop (didn't bet)





PokerStars Hand #147754321635:  Hold'em No Limit ($0.50/$1.00 USD) - 2016/01/27 11:41:52 CET [2016/01/27 5:41:52 ET]
Table 'Nanking' 9-max Seat #2 is the button
Seat 1: Peu3aHy ($100 in chips) 
Seat 2: Dachish ($103.67 in chips) 
Seat 3: nuaxin ($34.18 in chips) 
Seat 4: COOLIKO\/23 ($155.16 in chips) 
Seat 5: TheGentleFox ($63.74 in chips) 
Seat 6: Kukuryzka ($110.53 in chips) 
Seat 7: tipner ($100 in chips) 
Seat 8: matiko09 ($102.66 in chips) 
Seat 9: Sweden_Pound ($143.37 in chips) 
nuaxin: posts small blind $0.50
COOLIKO\/23: posts big blind $1
*** HOLE CARDS ***
Dealt to matiko09 [Jd Kh]
TheGentleFox: folds 
Kukuryzka: folds 
tipner: folds 
matiko09: raises $2 to $3
Sweden_Pound: folds 
Peu3aHy: folds 
Dachish: folds 
nuaxin: folds 
COOLIKO\/23: calls $2
*** FLOP *** [9d Js 5h]
COOLIKO\/23: checks 
matiko09: bets $4.04
COOLIKO\/23: calls $4.04
*** TURN *** [9d Js 5h] [8s]
COOLIKO\/23: checks 
matiko09: checks 
*** RIVER *** [9d Js 5h 8s] [6c]
COOLIKO\/23: bets $8
matiko09: folds 
Uncalled bet ($8) returned to COOLIKO\/23
COOLIKO\/23 collected $13.92 from pot
COOLIKO\/23: doesn't show hand 
*** SUMMARY ***
Total pot $14.58 | Rake $0.66 
Board [9d Js 5h 8s 6c]
Seat 1: Peu3aHy folded before Flop (didn't bet)
Seat 2: Dachish (button) folded before Flop (didn't bet)
Seat 3: nuaxin (small blind) folded before Flop
Seat 4: COOLIKO\/23 (big blind) collected ($13.92)
Seat 5: TheGentleFox folded before Flop (didn't bet)
Seat 6: Kukuryzka folded before Flop (didn't bet)
Seat 7: tipner folded before Flop (didn't bet)
Seat 8: matiko09 folded on the River
Seat 9: Sweden_Pound folded before Flop (didn't bet)





PokerStars Hand #147754325837:  Hold'em No Limit ($0.50/$1.00 USD) - 2016/01/27 11:42:00 CET [2016/01/27 5:42:00 ET]
Table 'Delphinus II' 9-max Seat #7 is the button
Seat 1: Saintreine ($145.11 in chips) 
Seat 2: AlKatrone ($192.15 in chips) 
Seat 3: deepblue0000 ($332.48 in chips) 
Seat 4: matiko09 ($123.23 in chips) 
Seat 5: pandalapa ($100 in chips) 
Seat 6: Sweden_Pound ($123.14 in chips) 
Seat 7: RUS)Timur ($100 in chips) 
Seat 8: mycka86 ($106.60 in chips) 
Seat 9: FGL-lucky ($51.88 in chips) 
mycka86: posts small blind $0.50
FGL-lucky: posts big blind $1
*** HOLE CARDS ***
Dealt to matiko09 [7d Kc]
Saintreine: folds 
AlKatrone: folds 
deepblue0000: folds 
matiko09: folds 
pandalapa: folds 
Sweden_Pound: folds 
RUS)Timur: folds 
mycka86: folds 
Uncalled bet ($0.50) returned to FGL-lucky
FGL-lucky collected $1 from pot
FGL-lucky: doesn't show hand 
*** SUMMARY ***
Total pot $1 | Rake $0 
Seat 1: Saintreine folded before Flop (didn't bet)
Seat 2: AlKatrone folded before Flop (didn't bet)
Seat 3: deepblue0000 folded before Flop (didn't bet)
Seat 4: matiko09 folded before Flop (didn't bet)
Seat 5: pandalapa folded before Flop (didn't bet)
Seat 6: Sweden_Pound folded before Flop (didn't bet)
Seat 7: RUS)Timur (button) folded before Flop (didn't bet)
Seat 8: mycka86 (small blind) folded before Flop
Seat 9: FGL-lucky (big blind) collected ($1)





PokerStars Hand #147754327298:  Hold'em No Limit ($0.50/$1.00 USD) - 2016/01/27 11:42:03 CET [2016/01/27 5:42:03 ET]
Table 'Thais' 9-max Seat #6 is the button
Seat 1: Peu3aHy ($118.19 in chips) 
Seat 2: Sweden_Pound ($100 in chips) 
Seat 3: RoadtoNepal ($100 in chips) 
Seat 5: matiko09 ($104 in chips) 
Seat 6: deepblue0000 ($153.77 in chips) 
Seat 7: Venomous100% ($275.09 in chips) 
Seat 9: tipner ($117.92 in chips) 
Venomous100%: posts small blind $0.50
sylvian31: is sitting out 
tipner: posts big blind $1
*** HOLE CARDS ***
Dealt to matiko09 [6c Td]
Peu3aHy: folds 
Sweden_Pound: folds 
RoadtoNepal: folds 
matiko09: folds 
deepblue0000: folds 
Venomous100%: folds 
Uncalled bet ($0.50) returned to tipner
tipner collected $1 from pot
tipner: doesn't show hand 
*** SUMMARY ***
Total pot $1 | Rake $0 
Seat 1: Peu3aHy folded before Flop (didn't bet)
Seat 2: Sweden_Pound folded before Flop (didn't bet)
Seat 3: RoadtoNepal folded before Flop (didn't bet)
Seat 5: matiko09 folded before Flop (didn't bet)
Seat 6: deepblue0000 (button) folded before Flop (didn't bet)
Seat 7: Venomous100% (small blind) folded before Flop
Seat 9: tipner (big blind) collected ($1)





PokerStars Hand #147754336565:  Hold'em No Limit ($0.50/$1.00 USD) - 2016/01/27 11:42:21 CET [2016/01/27 5:42:21 ET]
Table 'Delphinus II' 9-max Seat #8 is the button
Seat 1: Saintreine ($145.11 in chips) 
Seat 2: AlKatrone ($192.15 in chips) 
Seat 3: deepblue0000 ($332.48 in chips) 
Seat 4: matiko09 ($123.23 in chips) 
Seat 5: pandalapa ($100 in chips) 
Seat 6: Sweden_Pound ($123.14 in chips) 
Seat 7: RUS)Timur ($100 in chips) 
Seat 8: mycka86 ($106.10 in chips) 
Seat 9: FGL-lucky ($52.38 in chips) 
FGL-lucky: posts small blind $0.50
Saintreine: posts big blind $1
*** HOLE CARDS ***
Dealt to matiko09 [Ac 3s]
AlKatrone: folds 
deepblue0000: folds 
matiko09: folds 
pandalapa: folds 
Sweden_Pound: folds 
RUS)Timur: folds 
mycka86: raises $1.10 to $2.10
FGL-lucky: folds 
Saintreine: folds 
Uncalled bet ($1.10) returned to mycka86
mycka86 collected $2.50 from pot
*** SUMMARY ***
Total pot $2.50 | Rake $0 
Seat 1: Saintreine (big blind) folded before Flop
Seat 2: AlKatrone folded before Flop (didn't bet)
Seat 3: deepblue0000 folded before Flop (didn't bet)
Seat 4: matiko09 folded before Flop (didn't bet)
Seat 5: pandalapa folded before Flop (didn't bet)
Seat 6: Sweden_Pound folded before Flop (didn't bet)
Seat 7: RUS)Timur folded before Flop (didn't bet)
Seat 8: mycka86 (button) collected ($2.50)
Seat 9: FGL-lucky (small blind) folded before Flop





PokerStars Hand #147754337316:  Hold'em No Limit ($0.50/$1.00 USD) - 2016/01/27 11:42:23 CET [2016/01/27 5:42:23 ET]
Table 'Alkmene II' 9-max Seat #3 is the button
Seat 1: matiko09 ($100 in chips) 
Seat 2: deepblue0000 ($100 in chips) 
Seat 3: blef1992 ($105.81 in chips) 
Seat 4: CoolFireX ($150.57 in chips) 
Seat 5: Sweden_Pound ($119.55 in chips) 
Seat 6: Peu3aHy ($113.92 in chips) 
Seat 7: mycka86 ($105.36 in chips) 
Seat 8: fecsok1 ($76.18 in chips) 
Seat 9: pandalapa ($100 in chips) 
CoolFireX: posts small blind $0.50
Sweden_Pound: posts big blind $1
*** HOLE CARDS ***
Dealt to matiko09 [8h 8c]
Peu3aHy: folds 
mycka86: raises $2 to $3
fecsok1: calls $3
pandalapa: folds 
matiko09: calls $3
deepblue0000: folds 
blef1992: folds 
CoolFireX: calls $2.50
Sweden_Pound: calls $2
*** FLOP *** [3c 3s 2h]
CoolFireX: checks 
Sweden_Pound: checks 
mycka86: bets $9
fecsok1: calls $9
matiko09: calls $9
CoolFireX: folds 
Sweden_Pound: folds 
*** TURN *** [3c 3s 2h] [2d]
mycka86: checks 
fecsok1: bets $18
matiko09: calls $18
mycka86: folds 
*** RIVER *** [3c 3s 2h 2d] [Kh]
blef1992 leaves the table
di0d80 joins the table at seat #3 
fecsok1: bets $46.18 and is all-in
matiko09: folds 
Uncalled bet ($46.18) returned to fecsok1
fecsok1 collected $75.20 from pot
*** SUMMARY ***
Total pot $78 | Rake $2.80 
Board [3c 3s 2h 2d Kh]
Seat 1: matiko09 folded on the River
Seat 2: deepblue0000 folded before Flop (didn't bet)
Seat 3: blef1992 (button) folded before Flop (didn't bet)
Seat 4: CoolFireX (small blind) folded on the Flop
Seat 5: Sweden_Pound (big blind) folded on the Flop
Seat 6: Peu3aHy folded before Flop (didn't bet)
Seat 7: mycka86 folded on the Turn
Seat 8: fecsok1 collected ($75.20)
Seat 9: pandalapa folded before Flop (didn't bet)





PokerStars Hand #147754341472:  Hold'em No Limit ($0.50/$1.00 USD) - 2016/01/27 11:42:31 CET [2016/01/27 5:42:31 ET]
Table 'Henyey' 9-max Seat #2 is the button
Seat 1: COOLIKO\/23 ($100 in chips) 
Seat 2: pandalapa ($150.77 in chips) 
Seat 3: deepblue0000 ($120.61 in chips) 
Seat 5: matiko09 ($116.08 in chips) 
Seat 6: UShallGimme$ ($100 in chips) 
Seat 7: vinniej15 ($38.31 in chips) 
Seat 8: CoolFireX ($110.04 in chips) 
Seat 9: mycka86 ($135.63 in chips) 
deepblue0000: posts small blind $0.50
matiko09: posts big blind $1
*** HOLE CARDS ***
Dealt to matiko09 [7d Qs]
UShallGimme$: folds 
vinniej15: calls $1
CoolFireX: folds 
mycka86: folds 
COOLIKO\/23: raises $3 to $4
pandalapa: folds 
deepblue0000: folds 
matiko09: folds 
vinniej15: calls $3
*** FLOP *** [2h Ts 6c]
vinniej15: checks 
COOLIKO\/23: bets $5
vinniej15: raises $5 to $10
COOLIKO\/23: calls $5
*** TURN *** [2h Ts 6c] [8d]
vinniej15: bets $24.31 and is all-in
COOLIKO\/23: folds 
Uncalled bet ($24.31) returned to vinniej15
vinniej15 collected $28.17 from pot
*** SUMMARY ***
Total pot $29.50 | Rake $1.33 
Board [2h Ts 6c 8d]
Seat 1: COOLIKO\/23 folded on the Turn
Seat 2: pandalapa (button) folded before Flop (didn't bet)
Seat 3: deepblue0000 (small blind) folded before Flop
Seat 5: matiko09 (big blind) folded before Flop
Seat 6: UShallGimme$ folded before Flop (didn't bet)
Seat 7: vinniej15 collected ($28.17)
Seat 8: CoolFireX folded before Flop (didn't bet)
Seat 9: mycka86 folded before Flop (didn't bet)





PokerStars Hand #147754341909:  Hold'em No Limit ($0.50/$1.00 USD) - 2016/01/27 11:42:32 CET [2016/01/27 5:42:32 ET]
Table 'Alhajoth' 9-max Seat #5 is the button
Seat 1: UShallGimme$ ($154.45 in chips) 
Seat 2: matiko09 ($100 in chips) 
Seat 3: Sweden_Pound ($117.77 in chips) 
Seat 4: Venomous100% ($128.37 in chips) 
Seat 5: Kukuryzka ($102.66 in chips) 
Seat 6: RoadtoNepal ($186.30 in chips) 
Seat 7: Ohpeel ($114.13 in chips) 
Seat 8: deepblue0000 ($116.18 in chips) 
Seat 9: di0d80 ($104.16 in chips) 
RoadtoNepal: posts small blind $0.50
Ohpeel: posts big blind $1
*** HOLE CARDS ***
Dealt to matiko09 [4s 6h]
deepblue0000: folds 
di0d80: raises $1.50 to $2.50
UShallGimme$: folds 
matiko09: folds 
Sweden_Pound: folds 
Venomous100%: calls $2.50
Kukuryzka: folds 
RoadtoNepal: folds 
Ohpeel: calls $1.50
*** FLOP *** [Ad 8h Jd]
Ohpeel: checks 
di0d80: bets $5
Venomous100%: folds 
Ohpeel: calls $5
*** TURN *** [Ad 8h Jd] [3d]
Ohpeel: checks 
di0d80: checks 
*** RIVER *** [Ad 8h Jd 3d] [5h]
Ohpeel: bets $6
di0d80: folds 
Uncalled bet ($6) returned to Ohpeel
Ohpeel collected $17.19 from pot
Ohpeel: doesn't show hand 
*** SUMMARY ***
Total pot $18 | Rake $0.81 
Board [Ad 8h Jd 3d 5h]
Seat 1: UShallGimme$ folded before Flop (didn't bet)
Seat 2: matiko09 folded before Flop (didn't bet)
Seat 3: Sweden_Pound folded before Flop (didn't bet)
Seat 4: Venomous100% folded on the Flop
Seat 5: Kukuryzka (button) folded before Flop (didn't bet)
Seat 6: RoadtoNepal (small blind) folded before Flop
Seat 7: Ohpeel (big blind) collected ($17.19)
Seat 8: deepblue0000 folded before Flop (didn't bet)
Seat 9: di0d80 folded on the River





PokerStars Hand #147754341745:  Hold'em No Limit ($0.50/$1.00 USD) - 2016/01/27 11:42:32 CET [2016/01/27 5:42:32 ET]
Table 'Thais' 9-max Seat #7 is the button
Seat 1: Peu3aHy ($118.19 in chips) 
Seat 2: Sweden_Pound ($100 in chips) 
Seat 3: RoadtoNepal ($100 in chips) 
Seat 5: matiko09 ($104 in chips) 
Seat 6: deepblue0000 ($153.77 in chips) 
Seat 7: Venomous100% ($274.59 in chips) 
Seat 9: tipner ($118.42 in chips) 
tipner: posts small blind $0.50
Peu3aHy: posts big blind $1
*** HOLE CARDS ***
Dealt to matiko09 [Qd As]
Sweden_Pound: folds 
RoadtoNepal: folds 
matiko09: raises $2 to $3
deepblue0000: folds 
Venomous100%: calls $3
tipner: folds 
Peu3aHy: folds 
*** FLOP *** [4d 5s 8c]
sylvian31 leaves the table
matiko09: checks 
Venomous100%: bets $4.73
matiko09: folds 
Uncalled bet ($4.73) returned to Venomous100%
Venomous100% collected $7.16 from pot
Venomous100%: doesn't show hand 
*** SUMMARY ***
Total pot $7.50 | Rake $0.34 
Board [4d 5s 8c]
Seat 1: Peu3aHy (big blind) folded before Flop
Seat 2: Sweden_Pound folded before Flop (didn't bet)
Seat 3: RoadtoNepal folded before Flop (didn't bet)
Seat 5: matiko09 folded on the Flop
Seat 6: deepblue0000 folded before Flop (didn't bet)
Seat 7: Venomous100% (button) collected ($7.16)
Seat 9: tipner (small blind) folded before Flop





PokerStars Hand #147754342294:  Hold'em No Limit ($0.50/$1.00 USD) - 2016/01/27 11:42:33 CET [2016/01/27 5:42:33 ET]
Table 'Dollfus' 9-max Seat #2 is the button
Seat 1: masaytoo ($109.92 in chips) 
Seat 2: nosoant ($105.81 in chips) 
Seat 3: UShallGimme$ ($108.19 in chips) 
Seat 4: matiko09 ($100 in chips) 
Seat 5: pandalapa ($217.73 in chips) 
Seat 6: deepblue0000 ($126.51 in chips) 
Seat 7: Dödi123 ($173.43 in chips) 
Seat 9: COOLIKO\/23 ($101 in chips) 
UShallGimme$: posts small blind $0.50
matiko09: posts big blind $1
Venomous100%: sits out 
*** HOLE CARDS ***
Dealt to matiko09 [7h Ks]
pandalapa: folds 
deepblue0000: folds 
Dödi123: folds 
COOLIKO\/23: folds 
masaytoo: raises $1.50 to $2.50
nosoant: folds 
UShallGimme$: folds 
matiko09: folds 
Uncalled bet ($1.50) returned to masaytoo
masaytoo collected $2.50 from pot
masaytoo: doesn't show hand 
*** SUMMARY ***
Total pot $2.50 | Rake $0 
Seat 1: masaytoo collected ($2.50)
Seat 2: nosoant (button) folded before Flop (didn't bet)
Seat 3: UShallGimme$ (small blind) folded before Flop
Seat 4: matiko09 (big blind) folded before Flop
Seat 5: pandalapa folded before Flop (didn't bet)
Seat 6: deepblue0000 folded before Flop (didn't bet)
Seat 7: Dödi123 folded before Flop (didn't bet)
Seat 9: COOLIKO\/23 folded before Flop (didn't bet)





PokerStars Hand #147754343055:  Hold'em No Limit ($0.50/$1.00 USD) - 2016/01/27 11:42:34 CET [2016/01/27 5:42:34 ET]
Table 'Fragaria II' 9-max Seat #5 is the button
Seat 1: deepblue0000 ($123.28 in chips) 
Seat 2: GG-NoR34D. ($72.29 in chips) 
Seat 3: Sweden_Pound ($117.51 in chips) 
Seat 4: AlKatrone ($101 in chips) 
Seat 5: Venomous100% ($105.12 in chips) 
Seat 6: UShallGimme$ ($191.49 in chips) 
Seat 7: Hobby-.-AK ($52.73 in chips) 
Seat 8: mycka86 ($111.10 in chips) 
Seat 9: matiko09 ($103.50 in chips) 
UShallGimme$: posts small blind $0.50
Hobby-.-AK: posts big blind $1
*** HOLE CARDS ***
Dealt to matiko09 [7s 5s]
mycka86: folds 
matiko09: folds 
deepblue0000: raises $1.50 to $2.50
GG-NoR34D.: folds 
Sweden_Pound: folds 
AlKatrone: folds 
Venomous100%: folds 
UShallGimme$: folds 
Hobby-.-AK: folds 
Uncalled bet ($1.50) returned to deepblue0000
deepblue0000 collected $2.50 from pot
*** SUMMARY ***
Total pot $2.50 | Rake $0 
Seat 1: deepblue0000 collected ($2.50)
Seat 2: GG-NoR34D. folded before Flop (didn't bet)
Seat 3: Sweden_Pound folded before Flop (didn't bet)
Seat 4: AlKatrone folded before Flop (didn't bet)
Seat 5: Venomous100% (button) folded before Flop (didn't bet)
Seat 6: UShallGimme$ (small blind) folded before Flop
Seat 7: Hobby-.-AK (big blind) folded before Flop
Seat 8: mycka86 folded before Flop (didn't bet)
Seat 9: matiko09 folded before Flop (didn't bet)





PokerStars Hand #147754355665:  Hold'em No Limit ($0.50/$1.00 USD) - 2016/01/27 11:42:59 CET [2016/01/27 5:42:59 ET]
Table 'Delphinus II' 9-max Seat #9 is the button
Seat 1: Saintreine ($144.11 in chips) 
Seat 2: AlKatrone ($192.15 in chips) 
Seat 3: deepblue0000 ($332.48 in chips) 
Seat 4: matiko09 ($123.23 in chips) 
Seat 5: pandalapa ($100 in chips) 
Seat 6: Sweden_Pound ($123.14 in chips) 
Seat 7: RUS)Timur ($100 in chips) 
Seat 8: mycka86 ($107.60 in chips) 
Seat 9: FGL-lucky ($51.88 in chips) 
Saintreine: posts small blind $0.50
AlKatrone: posts big blind $1
*** HOLE CARDS ***
Dealt to matiko09 [5h 9c]
deepblue0000: folds 
matiko09: folds 
pandalapa: folds 
Sweden_Pound: folds 
RUS)Timur: folds 
mycka86: raises $1.10 to $2.10
FGL-lucky: folds 
Saintreine: folds 
AlKatrone: folds 
Uncalled bet ($1.10) returned to mycka86
mycka86 collected $2.50 from pot
*** SUMMARY ***
Total pot $2.50 | Rake $0 
Seat 1: Saintreine (small blind) folded before Flop
Seat 2: AlKatrone (big blind) folded before Flop
Seat 3: deepblue0000 folded before Flop (didn't bet)
Seat 4: matiko09 folded before Flop (didn't bet)
Seat 5: pandalapa folded before Flop (didn't bet)
Seat 6: Sweden_Pound folded before Flop (didn't bet)
Seat 7: RUS)Timur folded before Flop (didn't bet)
Seat 8: mycka86 collected ($2.50)
Seat 9: FGL-lucky (button) folded before Flop (didn't bet)





PokerStars Hand #147754356951:  Hold'em No Limit ($1/$2 USD) - 2016/01/27 11:43:01 CET [2016/01/27 5:43:01 ET]
Table 'Phobos II' 9-max Seat #4 is the button
Seat 1: LRV21 ($379.12 in chips) 
Seat 2: di0d80 ($246.22 in chips) 
Seat 4: flk.Dasas ($328.18 in chips) 
Seat 5: tipner ($200 in chips) 
Seat 6: matiko09 ($200 in chips) 
Seat 7: Venomous100% ($280.31 in chips) 
Seat 8: RoadtoNepal ($235.94 in chips) 
Seat 9: Kukuryzka ($378.03 in chips) 
tipner: posts small blind $1
matiko09: posts big blind $2
*** HOLE CARDS ***
Dealt to matiko09 [Kc 2s]
Venomous100%: folds 
RoadtoNepal: folds 
Kukuryzka: folds 
LRV21: raises $3 to $5
di0d80: folds 
flk.Dasas: folds 
tipner: folds 
matiko09: folds 
Uncalled bet ($3) returned to LRV21
LRV21 collected $5 from pot
LRV21: doesn't show hand 
*** SUMMARY ***
Total pot $5 | Rake $0 
Seat 1: LRV21 collected ($5)
Seat 2: di0d80 folded before Flop (didn't bet)
Seat 4: flk.Dasas (button) folded before Flop (didn't bet)
Seat 5: tipner (small blind) folded before Flop
Seat 6: matiko09 (big blind) folded before Flop
Seat 7: Venomous100% folded before Flop (didn't bet)
Seat 8: RoadtoNepal folded before Flop (didn't bet)
Seat 9: Kukuryzka folded before Flop (didn't bet)





PokerStars Hand #147754363248:  Hold'em No Limit ($0.50/$1.00 USD) - 2016/01/27 11:43:14 CET [2016/01/27 5:43:14 ET]
Table 'Nanking' 9-max Seat #3 is the button
Seat 1: Peu3aHy ($100 in chips) 
Seat 2: Dachish ($103.67 in chips) 
Seat 3: nuaxin ($33.68 in chips) 
Seat 4: COOLIKO\/23 ($162.04 in chips) 
Seat 5: TheGentleFox ($63.74 in chips) 
Seat 6: Kukuryzka ($110.53 in chips) 
Seat 7: tipner ($100 in chips) 
Seat 8: matiko09 ($100 in chips) 
Seat 9: Sweden_Pound ($143.37 in chips) 
COOLIKO\/23: posts small blind $0.50
TheGentleFox: posts big blind $1
*** HOLE CARDS ***
Dealt to matiko09 [Jd Th]
Kukuryzka: folds 
tipner: folds 
matiko09: folds 
Sweden_Pound: folds 
Peu3aHy: folds 
Dachish: raises $2 to $3
nuaxin: calls $3
COOLIKO\/23: folds 
TheGentleFox: calls $2
*** FLOP *** [2d 9c 3d]
TheGentleFox: checks 
Dachish: checks 
nuaxin: bets $4.53
TheGentleFox: calls $4.53
Dachish: folds 
*** TURN *** [2d 9c 3d] [Jc]
TheGentleFox: checks 
nuaxin: checks 
*** RIVER *** [2d 9c 3d Jc] [6c]
TheGentleFox: bets $8.86
nuaxin: calls $8.86
*** SHOW DOWN ***
TheGentleFox: shows [7d Kd] (high card King)
nuaxin: shows [7s 7c] (a pair of Sevens)
nuaxin collected $34.65 from pot
*** SUMMARY ***
Total pot $36.28 | Rake $1.63 
Board [2d 9c 3d Jc 6c]
Seat 1: Peu3aHy folded before Flop (didn't bet)
Seat 2: Dachish folded on the Flop
Seat 3: nuaxin (button) showed [7s 7c] and won ($34.65) with a pair of Sevens
Seat 4: COOLIKO\/23 (small blind) folded before Flop
Seat 5: TheGentleFox (big blind) showed [7d Kd] and lost with high card King
Seat 6: Kukuryzka folded before Flop (didn't bet)
Seat 7: tipner folded before Flop (didn't bet)
Seat 8: matiko09 folded before Flop (didn't bet)
Seat 9: Sweden_Pound folded before Flop (didn't bet)





PokerStars Hand #147754363916:  Hold'em No Limit ($0.50/$1.00 USD) - 2016/01/27 11:43:15 CET [2016/01/27 5:43:15 ET]
Table 'Dollfus' 9-max Seat #3 is the button
Seat 1: masaytoo ($111.42 in chips) 
Seat 2: nosoant ($105.81 in chips) 
Seat 3: UShallGimme$ ($107.69 in chips) 
Seat 4: matiko09 ($100 in chips) 
Seat 5: pandalapa ($217.73 in chips) 
Seat 6: deepblue0000 ($126.51 in chips) 
Seat 7: Dödi123 ($173.43 in chips) 
Seat 9: COOLIKO\/23 ($101 in chips) 
matiko09: posts small blind $0.50
pandalapa: posts big blind $1
Venomous100%: sits out 
*** HOLE CARDS ***
Dealt to matiko09 [Kh 7s]
deepblue0000: folds 
Dödi123: folds 
COOLIKO\/23: folds 
masaytoo: folds 
nosoant: calls $1
UShallGimme$: calls $1
matiko09: folds 
pandalapa: checks 
*** FLOP *** [3h 9s As]
pandalapa: checks 
nosoant: bets $1
UShallGimme$: folds 
pandalapa: calls $1
*** TURN *** [3h 9s As] [8c]
pandalapa: checks 
nosoant: checks 
*** RIVER *** [3h 9s As 8c] [9d]
pandalapa: checks 
nosoant: checks 
*** SHOW DOWN ***
pandalapa: shows [2h Ah] (two pair, Aces and Nines)
nosoant: mucks hand 
pandalapa collected $5.25 from pot
*** SUMMARY ***
Total pot $5.50 | Rake $0.25 
Board [3h 9s As 8c 9d]
Seat 1: masaytoo folded before Flop (didn't bet)
Seat 2: nosoant mucked [Js 5s]
Seat 3: UShallGimme$ (button) folded on the Flop
Seat 4: matiko09 (small blind) folded before Flop
Seat 5: pandalapa (big blind) showed [2h Ah] and won ($5.25) with two pair, Aces and Nines
Seat 6: deepblue0000 folded before Flop (didn't bet)
Seat 7: Dödi123 folded before Flop (didn't bet)
Seat 9: COOLIKO\/23 folded before Flop (didn't bet)





PokerStars Hand #147754364671:  Hold'em No Limit ($0.50/$1.00 USD) - 2016/01/27 11:43:17 CET [2016/01/27 5:43:17 ET]
Table 'Fragaria II' 9-max Seat #6 is the button
Seat 1: deepblue0000 ($124.78 in chips) 
Seat 2: GG-NoR34D. ($72.29 in chips) 
Seat 3: Sweden_Pound ($117.51 in chips) 
Seat 4: AlKatrone ($101 in chips) 
Seat 5: Venomous100% ($105.12 in chips) 
Seat 6: UShallGimme$ ($190.99 in chips) 
Seat 7: Hobby-.-AK ($51.73 in chips) 
Seat 8: mycka86 ($111.10 in chips) 
Seat 9: matiko09 ($103.50 in chips) 
Hobby-.-AK: posts small blind $0.50
mycka86: posts big blind $1
*** HOLE CARDS ***
Dealt to matiko09 [7s 9s]
matiko09: folds 
deepblue0000: folds 
GG-NoR34D.: calls $1
Sweden_Pound: folds 
AlKatrone: folds 
Venomous100%: folds 
UShallGimme$: raises $3 to $4
Hobby-.-AK: folds 
mycka86: folds 
GG-NoR34D.: calls $3
*** FLOP *** [5c 5h Ad]
GG-NoR34D.: checks 
UShallGimme$: bets $5.50
GG-NoR34D.: raises $5.75 to $11.25
UShallGimme$: folds 
Uncalled bet ($5.75) returned to GG-NoR34D.
GG-NoR34D. collected $19.58 from pot
*** SUMMARY ***
Total pot $20.50 | Rake $0.92 
Board [5c 5h Ad]
Seat 1: deepblue0000 folded before Flop (didn't bet)
Seat 2: GG-NoR34D. collected ($19.58)
Seat 3: Sweden_Pound folded before Flop (didn't bet)
Seat 4: AlKatrone folded before Flop (didn't bet)
Seat 5: Venomous100% folded before Flop (didn't bet)
Seat 6: UShallGimme$ (button) folded on the Flop
Seat 7: Hobby-.-AK (small blind) folded before Flop
Seat 8: mycka86 (big blind) folded before Flop
Seat 9: matiko09 folded before Flop (didn't bet)





PokerStars Hand #147754368921:  Hold'em No Limit ($0.50/$1.00 USD) - 2016/01/27 11:43:25 CET [2016/01/27 5:43:25 ET]
Table 'Thais' 9-max Seat #9 is the button
Seat 1: Peu3aHy ($117.19 in chips) 
Seat 2: Sweden_Pound ($100 in chips) 
Seat 3: RoadtoNepal ($100 in chips) 
Seat 5: matiko09 ($101 in chips) 
Seat 6: deepblue0000 ($153.77 in chips) 
Seat 7: Venomous100% ($278.75 in chips) 
Seat 9: tipner ($117.92 in chips) 
Peu3aHy: posts small blind $0.50
Sweden_Pound: posts big blind $1
*** HOLE CARDS ***
Dealt to matiko09 [9d Ts]
RoadtoNepal: folds 
matiko09: folds 
deepblue0000: folds 
Venomous100%: raises $1.50 to $2.50
tipner: raises $4.50 to $7
Peu3aHy: raises $8 to $15
Sweden_Pound: folds 
Venomous100%: folds 
tipner: folds 
Uncalled bet ($8) returned to Peu3aHy
Peu3aHy collected $17.50 from pot
Peu3aHy: doesn't show hand 
*** SUMMARY ***
Total pot $17.50 | Rake $0 
Seat 1: Peu3aHy (small blind) collected ($17.50)
Seat 2: Sweden_Pound (big blind) folded before Flop
Seat 3: RoadtoNepal folded before Flop (didn't bet)
Seat 5: matiko09 folded before Flop (didn't bet)
Seat 6: deepblue0000 folded before Flop (didn't bet)
Seat 7: Venomous100% folded before Flop
Seat 9: tipner (button) folded before Flop





PokerStars Hand #147754368737:  Hold'em No Limit ($0.50/$1.00 USD) - 2016/01/27 11:43:25 CET [2016/01/27 5:43:25 ET]
Table 'Delphinus II' 9-max Seat #1 is the button
Seat 1: Saintreine ($143.61 in chips) 
Seat 2: AlKatrone ($191.15 in chips) 
Seat 3: deepblue0000 ($332.48 in chips) 
Seat 4: matiko09 ($123.23 in chips) 
Seat 5: pandalapa ($100 in chips) 
Seat 6: Sweden_Pound ($123.14 in chips) 
Seat 7: RUS)Timur ($100 in chips) 
Seat 8: mycka86 ($109.10 in chips) 
Seat 9: FGL-lucky ($51.88 in chips) 
AlKatrone: posts small blind $0.50
deepblue0000: posts big blind $1
*** HOLE CARDS ***
Dealt to matiko09 [8d 3s]
matiko09: folds 
pandalapa: folds 
Sweden_Pound: folds 
RUS)Timur: folds 
mycka86: folds 
FGL-lucky: raises $1 to $2
Saintreine: folds 
AlKatrone: folds 
deepblue0000: folds 
Uncalled bet ($1) returned to FGL-lucky
FGL-lucky collected $2.50 from pot
FGL-lucky: doesn't show hand 
*** SUMMARY ***
Total pot $2.50 | Rake $0 
Seat 1: Saintreine (button) folded before Flop (didn't bet)
Seat 2: AlKatrone (small blind) folded before Flop
Seat 3: deepblue0000 (big blind) folded before Flop
Seat 4: matiko09 folded before Flop (didn't bet)
Seat 5: pandalapa folded before Flop (didn't bet)
Seat 6: Sweden_Pound folded before Flop (didn't bet)
Seat 7: RUS)Timur folded before Flop (didn't bet)
Seat 8: mycka86 folded before Flop (didn't bet)
Seat 9: FGL-lucky collected ($2.50)





PokerStars Hand #147754372316:  Hold'em No Limit ($1/$2 USD) - 2016/01/27 11:43:32 CET [2016/01/27 5:43:32 ET]
Table 'Phobos II' 9-max Seat #5 is the button
Seat 1: LRV21 ($382.12 in chips) 
Seat 2: di0d80 ($246.22 in chips) 
Seat 4: flk.Dasas ($328.18 in chips) 
Seat 5: tipner ($200 in chips) 
Seat 6: matiko09 ($200 in chips) 
Seat 7: Venomous100% ($280.31 in chips) 
Seat 8: RoadtoNepal ($235.94 in chips) 
Seat 9: Kukuryzka ($378.03 in chips) 
matiko09: posts small blind $1
Venomous100%: posts big blind $2
sylvian31: sits out 
*** HOLE CARDS ***
Dealt to matiko09 [Qc 3c]
RoadtoNepal: raises $4 to $6
Kukuryzka: folds 
LRV21: folds 
di0d80: folds 
flk.Dasas: calls $6
tipner: folds 
matiko09: folds 
Venomous100%: folds 
*** FLOP *** [9s 5c Kd]
RoadtoNepal: checks 
flk.Dasas: checks 
*** TURN *** [9s 5c Kd] [5s]
RoadtoNepal: bets $8
flk.Dasas: calls $8
*** RIVER *** [9s 5c Kd 5s] [Jd]
RoadtoNepal: bets $14
flk.Dasas: folds 
Uncalled bet ($14) returned to RoadtoNepal
RoadtoNepal collected $29.60 from pot
RoadtoNepal: doesn't show hand 
*** SUMMARY ***
Total pot $31 | Rake $1.40 
Board [9s 5c Kd 5s Jd]
Seat 1: LRV21 folded before Flop (didn't bet)
Seat 2: di0d80 folded before Flop (didn't bet)
Seat 4: flk.Dasas folded on the River
Seat 5: tipner (button) folded before Flop (didn't bet)
Seat 6: matiko09 (small blind) folded before Flop
Seat 7: Venomous100% (big blind) folded before Flop
Seat 8: RoadtoNepal collected ($29.60)
Seat 9: Kukuryzka folded before Flop (didn't bet)





PokerStars Hand #147754379800:  Hold'em No Limit ($0.50/$1.00 USD) - 2016/01/27 11:43:47 CET [2016/01/27 5:43:47 ET]
Table 'Delphinus II' 9-max Seat #2 is the button
Seat 1: Saintreine ($143.61 in chips) 
Seat 2: AlKatrone ($190.65 in chips) 
Seat 3: deepblue0000 ($331.48 in chips) 
Seat 4: matiko09 ($123.23 in chips) 
Seat 5: pandalapa ($100 in chips) 
Seat 6: Sweden_Pound ($123.14 in chips) 
Seat 7: RUS)Timur ($100 in chips) 
Seat 8: mycka86 ($109.10 in chips) 
Seat 9: FGL-lucky ($53.38 in chips) 
deepblue0000: posts small blind $0.50
matiko09: posts big blind $1
*** HOLE CARDS ***
Dealt to matiko09 [3d 6s]
pandalapa: folds 
Sweden_Pound: folds 
RUS)Timur: folds 
mycka86: folds 
FGL-lucky: raises $1 to $2
Saintreine: folds 
AlKatrone: raises $5 to $7
deepblue0000: folds 
matiko09: folds 
FGL-lucky: folds 
Uncalled bet ($5) returned to AlKatrone
AlKatrone collected $5.50 from pot
AlKatrone: doesn't show hand 
*** SUMMARY ***
Total pot $5.50 | Rake $0 
Seat 1: Saintreine folded before Flop (didn't bet)
Seat 2: AlKatrone (button) collected ($5.50)
Seat 3: deepblue0000 (small blind) folded before Flop
Seat 4: matiko09 (big blind) folded before Flop
Seat 5: pandalapa folded before Flop (didn't bet)
Seat 6: Sweden_Pound folded before Flop (didn't bet)
Seat 7: RUS)Timur folded before Flop (didn't bet)
Seat 8: mycka86 folded before Flop (didn't bet)
Seat 9: FGL-lucky folded before Flop





PokerStars Hand #147754383110:  Hold'em No Limit ($0.50/$1.00 USD) - 2016/01/27 11:43:53 CET [2016/01/27 5:43:53 ET]
Table 'Henyey' 9-max Seat #3 is the button
Seat 1: COOLIKO\/23 ($100 in chips) 
Seat 2: pandalapa ($150.77 in chips) 
Seat 3: deepblue0000 ($120.11 in chips) 
Seat 5: matiko09 ($115.08 in chips) 
Seat 6: UShallGimme$ ($100 in chips) 
Seat 7: vinniej15 ($52.48 in chips) 
Seat 8: CoolFireX ($110.04 in chips) 
Seat 9: mycka86 ($135.63 in chips) 
sylvian31 will be allowed to play after the button
matiko09: posts small blind $0.50
UShallGimme$: posts big blind $1
*** HOLE CARDS ***
Dealt to matiko09 [8s 8c]
vinniej15: folds 
CoolFireX: folds 
mycka86: folds 
COOLIKO\/23: folds 
pandalapa: folds 
deepblue0000: folds 
matiko09: raises $1.50 to $2.50
UShallGimme$: calls $1.50
*** FLOP *** [Ac Qd 7d]
matiko09: checks 
UShallGimme$: bets $4
matiko09: folds 
Uncalled bet ($4) returned to UShallGimme$
UShallGimme$ collected $4.78 from pot
UShallGimme$: doesn't show hand 
*** SUMMARY ***
Total pot $5 | Rake $0.22 
Board [Ac Qd 7d]
Seat 1: COOLIKO\/23 folded before Flop (didn't bet)
Seat 2: pandalapa folded before Flop (didn't bet)
Seat 3: deepblue0000 (button) folded before Flop (didn't bet)
Seat 5: matiko09 (small blind) folded on the Flop
Seat 6: UShallGimme$ (big blind) collected ($4.78)
Seat 7: vinniej15 folded before Flop (didn't bet)
Seat 8: CoolFireX folded before Flop (didn't bet)
Seat 9: mycka86 folded before Flop (didn't bet)





PokerStars Hand #147754393581:  Hold'em No Limit ($0.50/$1.00 USD) - 2016/01/27 11:44:14 CET [2016/01/27 5:44:14 ET]
Table 'Nanking' 9-max Seat #4 is the button
Seat 1: Peu3aHy ($100 in chips) 
Seat 2: Dachish ($100.67 in chips) 
Seat 3: nuaxin ($51.94 in chips) 
Seat 4: COOLIKO\/23 ($161.54 in chips) 
Seat 5: TheGentleFox ($47.35 in chips) 
Seat 6: Kukuryzka ($110.53 in chips) 
Seat 7: tipner ($100 in chips) 
Seat 8: matiko09 ($100 in chips) 
Seat 9: Sweden_Pound ($143.37 in chips) 
TheGentleFox: posts small blind $0.50
Kukuryzka: posts big blind $1
*** HOLE CARDS ***
Dealt to matiko09 [6c Kc]
tipner: folds 
matiko09: folds 
Sweden_Pound: folds 
Peu3aHy: folds 
Dachish: folds 
nuaxin: folds 
COOLIKO\/23: folds 
TheGentleFox: raises $1 to $2
Kukuryzka: calls $1
*** FLOP *** [Kh 9d Td]
TheGentleFox: checks 
Kukuryzka: checks 
*** TURN *** [Kh 9d Td] [Qc]
TheGentleFox: checks 
Kukuryzka: checks 
*** RIVER *** [Kh 9d Td Qc] [6h]
TheGentleFox: checks 
Kukuryzka: checks 
*** SHOW DOWN ***
TheGentleFox: shows [6d 8d] (a pair of Sixes)
Kukuryzka: mucks hand 
TheGentleFox collected $3.82 from pot
*** SUMMARY ***
Total pot $4 | Rake $0.18 
Board [Kh 9d Td Qc 6h]
Seat 1: Peu3aHy folded before Flop (didn't bet)
Seat 2: Dachish folded before Flop (didn't bet)
Seat 3: nuaxin folded before Flop (didn't bet)
Seat 4: COOLIKO\/23 (button) folded before Flop (didn't bet)
Seat 5: TheGentleFox (small blind) showed [6d 8d] and won ($3.82) with a pair of Sixes
Seat 6: Kukuryzka (big blind) mucked [7c Ah]
Seat 7: tipner folded before Flop (didn't bet)
Seat 8: matiko09 folded before Flop (didn't bet)
Seat 9: Sweden_Pound folded before Flop (didn't bet)





PokerStars Hand #147754394176:  Hold'em No Limit ($0.50/$1.00 USD) - 2016/01/27 11:44:15 CET [2016/01/27 5:44:15 ET]
Table 'Dollfus' 9-max Seat #4 is the button
Seat 1: masaytoo ($111.42 in chips) 
Seat 2: nosoant ($103.81 in chips) 
Seat 3: UShallGimme$ ($106.69 in chips) 
Seat 4: matiko09 ($100 in chips) 
Seat 5: pandalapa ($220.98 in chips) 
Seat 6: deepblue0000 ($126.51 in chips) 
Seat 7: Dödi123 ($173.43 in chips) 
Seat 9: COOLIKO\/23 ($101 in chips) 
pandalapa: posts small blind $0.50
deepblue0000: posts big blind $1
Venomous100%: sits out 
*** HOLE CARDS ***
Dealt to matiko09 [Th Ts]
Dödi123: folds 
COOLIKO\/23: folds 
masaytoo: folds 
nosoant: raises $2 to $3
UShallGimme$: raises $6 to $9
matiko09: raises $10 to $19
pandalapa: folds 
deepblue0000: folds 
nosoant: folds 
UShallGimme$: folds 
Uncalled bet ($10) returned to matiko09
matiko09 collected $22.50 from pot
matiko09: doesn't show hand 
*** SUMMARY ***
Total pot $22.50 | Rake $0 
Seat 1: masaytoo folded before Flop (didn't bet)
Seat 2: nosoant folded before Flop
Seat 3: UShallGimme$ folded before Flop
Seat 4: matiko09 (button) collected ($22.50)
Seat 5: pandalapa (small blind) folded before Flop
Seat 6: deepblue0000 (big blind) folded before Flop
Seat 7: Dödi123 folded before Flop (didn't bet)
Seat 9: COOLIKO\/23 folded before Flop (didn't bet)





PokerStars Hand #147754404204:  Hold'em No Limit ($0.50/$1.00 USD) - 2016/01/27 11:44:35 CET [2016/01/27 5:44:35 ET]
Table 'Fragaria II' 9-max Seat #7 is the button
Seat 1: deepblue0000 ($124.78 in chips) 
Seat 2: GG-NoR34D. ($82.37 in chips) 
Seat 3: Sweden_Pound ($117.51 in chips) 
Seat 4: AlKatrone ($101 in chips) 
Seat 5: Venomous100% ($105.12 in chips) 
Seat 6: UShallGimme$ ($181.49 in chips) 
Seat 7: Hobby-.-AK ($51.23 in chips) 
Seat 8: mycka86 ($110.10 in chips) 
Seat 9: matiko09 ($103.50 in chips) 
mycka86: posts small blind $0.50
matiko09: posts big blind $1
*** HOLE CARDS ***
Dealt to matiko09 [4s Kh]
deepblue0000: folds 
GG-NoR34D.: folds 
Sweden_Pound: raises $2 to $3
AlKatrone: folds 
Venomous100%: folds 
UShallGimme$: folds 
Hobby-.-AK: folds 
mycka86: folds 
matiko09: folds 
Uncalled bet ($2) returned to Sweden_Pound
Sweden_Pound collected $2.50 from pot
Sweden_Pound: doesn't show hand 
*** SUMMARY ***
Total pot $2.50 | Rake $0 
Seat 1: deepblue0000 folded before Flop (didn't bet)
Seat 2: GG-NoR34D. folded before Flop (didn't bet)
Seat 3: Sweden_Pound collected ($2.50)
Seat 4: AlKatrone folded before Flop (didn't bet)
Seat 5: Venomous100% folded before Flop (didn't bet)
Seat 6: UShallGimme$ folded before Flop (didn't bet)
Seat 7: Hobby-.-AK (button) folded before Flop (didn't bet)
Seat 8: mycka86 (small blind) folded before Flop
Seat 9: matiko09 (big blind) folded before Flop





PokerStars Hand #147754411144:  Hold'em No Limit ($0.50/$1.00 USD) - 2016/01/27 11:44:48 CET [2016/01/27 5:44:48 ET]
Table 'Alhajoth' 9-max Seat #6 is the button
Seat 1: UShallGimme$ ($154.45 in chips) 
Seat 2: matiko09 ($100 in chips) 
Seat 3: Sweden_Pound ($117.77 in chips) 
Seat 4: Venomous100% ($125.87 in chips) 
Seat 5: Kukuryzka ($102.66 in chips) 
Seat 6: RoadtoNepal ($185.80 in chips) 
Seat 7: Ohpeel ($123.82 in chips) 
Seat 8: deepblue0000 ($116.18 in chips) 
Seat 9: di0d80 ($100 in chips) 
Ohpeel: posts small blind $0.50
deepblue0000: posts big blind $1
*** HOLE CARDS ***
Dealt to matiko09 [9c 2d]
di0d80: folds 
UShallGimme$: folds 
matiko09: folds 
Sweden_Pound: folds 
Venomous100%: folds 
Kukuryzka: raises $1.50 to $2.50
RoadtoNepal: folds 
Ohpeel: folds 
deepblue0000: folds 
Uncalled bet ($1.50) returned to Kukuryzka
Kukuryzka collected $2.50 from pot
Kukuryzka: doesn't show hand 
*** SUMMARY ***
Total pot $2.50 | Rake $0 
Seat 1: UShallGimme$ folded before Flop (didn't bet)
Seat 2: matiko09 folded before Flop (didn't bet)
Seat 3: Sweden_Pound folded before Flop (didn't bet)
Seat 4: Venomous100% folded before Flop (didn't bet)
Seat 5: Kukuryzka collected ($2.50)
Seat 6: RoadtoNepal (button) folded before Flop (didn't bet)
Seat 7: Ohpeel (small blind) folded before Flop
Seat 8: deepblue0000 (big blind) folded before Flop
Seat 9: di0d80 folded before Flop (didn't bet)





PokerStars Hand #147754417783:  Hold'em No Limit ($0.50/$1.00 USD) - 2016/01/27 11:45:01 CET [2016/01/27 5:45:01 ET]
Table 'Delphinus II' 9-max Seat #3 is the button
Seat 1: Saintreine ($143.61 in chips) 
Seat 2: AlKatrone ($194.15 in chips) 
Seat 3: deepblue0000 ($330.98 in chips) 
Seat 4: matiko09 ($122.23 in chips) 
Seat 5: pandalapa ($100 in chips) 
Seat 6: Sweden_Pound ($123.14 in chips) 
Seat 7: RUS)Timur ($100 in chips) 
Seat 8: mycka86 ($109.10 in chips) 
Seat 9: FGL-lucky ($51.38 in chips) 
matiko09: posts small blind $0.50
pandalapa: posts big blind $1
*** HOLE CARDS ***
Dealt to matiko09 [Th 5h]
Sweden_Pound: folds 
RUS)Timur: folds 
mycka86: folds 
FGL-lucky: folds 
Saintreine: folds 
AlKatrone: raises $1.50 to $2.50
deepblue0000: folds 
matiko09: folds 
pandalapa: calls $1.50
*** FLOP *** [Ad Qc 5d]
pandalapa: checks 
AlKatrone: bets $1.78
pandalapa: calls $1.78
*** TURN *** [Ad Qc 5d] [Kd]
pandalapa: checks 
AlKatrone: checks 
*** RIVER *** [Ad Qc 5d Kd] [Ks]
pandalapa: checks 
AlKatrone: bets $11.15
pandalapa: folds 
Uncalled bet ($11.15) returned to AlKatrone
AlKatrone collected $8.65 from pot
AlKatrone: doesn't show hand 
*** SUMMARY ***
Total pot $9.06 | Rake $0.41 
Board [Ad Qc 5d Kd Ks]
Seat 1: Saintreine folded before Flop (didn't bet)
Seat 2: AlKatrone collected ($8.65)
Seat 3: deepblue0000 (button) folded before Flop (didn't bet)
Seat 4: matiko09 (small blind) folded before Flop
Seat 5: pandalapa (big blind) folded on the River
Seat 6: Sweden_Pound folded before Flop (didn't bet)
Seat 7: RUS)Timur folded before Flop (didn't bet)
Seat 8: mycka86 folded before Flop (didn't bet)
Seat 9: FGL-lucky folded before Flop (didn't bet)





PokerStars Hand #147754421394:  Hold'em No Limit ($0.50/$1.00 USD) - 2016/01/27 11:45:09 CET [2016/01/27 5:45:09 ET]
Table 'Nanking' 9-max Seat #5 is the button
Seat 1: Peu3aHy ($100 in chips) 
Seat 2: Dachish ($100.67 in chips) 
Seat 3: nuaxin ($51.94 in chips) 
Seat 4: COOLIKO\/23 ($161.54 in chips) 
Seat 5: TheGentleFox ($89.17 in chips) 
Seat 6: Kukuryzka ($108.53 in chips) 
Seat 7: tipner ($100 in chips) 
Seat 8: matiko09 ($100 in chips) 
Seat 9: Sweden_Pound ($143.37 in chips) 
Kukuryzka: posts small blind $0.50
tipner: posts big blind $1
*** HOLE CARDS ***
Dealt to matiko09 [3d 6c]
matiko09: folds 
Sweden_Pound: raises $2 to $3
Peu3aHy: folds 
Dachish: folds 
nuaxin: folds 
COOLIKO\/23: folds 
TheGentleFox: calls $3
Kukuryzka: folds 
tipner: folds 
*** FLOP *** [5s Td Qc]
Sweden_Pound: bets $4.65
TheGentleFox: calls $4.65
*** TURN *** [5s Td Qc] [5d]
Sweden_Pound: checks 
TheGentleFox: checks 
*** RIVER *** [5s Td Qc 5d] [2h]
Sweden_Pound: checks 
TheGentleFox: bets $8.02
Sweden_Pound: folds 
Uncalled bet ($8.02) returned to TheGentleFox
TheGentleFox collected $16.04 from pot
TheGentleFox: doesn't show hand 
*** SUMMARY ***
Total pot $16.80 | Rake $0.76 
Board [5s Td Qc 5d 2h]
Seat 1: Peu3aHy folded before Flop (didn't bet)
Seat 2: Dachish folded before Flop (didn't bet)
Seat 3: nuaxin folded before Flop (didn't bet)
Seat 4: COOLIKO\/23 folded before Flop (didn't bet)
Seat 5: TheGentleFox (button) collected ($16.04)
Seat 6: Kukuryzka (small blind) folded before Flop
Seat 7: tipner (big blind) folded before Flop
Seat 8: matiko09 folded before Flop (didn't bet)
Seat 9: Sweden_Pound folded on the River





PokerStars Hand #147754429400:  Hold'em No Limit ($0.50/$1.00 USD) - 2016/01/27 11:45:24 CET [2016/01/27 5:45:24 ET]
Table 'Henyey' 9-max Seat #5 is the button
Seat 1: COOLIKO\/23 ($100 in chips) 
Seat 2: pandalapa ($150.77 in chips) 
Seat 3: deepblue0000 ($120.11 in chips) 
Seat 5: matiko09 ($112.58 in chips) 
Seat 6: UShallGimme$ ($102.28 in chips) 
Seat 7: vinniej15 ($52.48 in chips) 
Seat 8: CoolFireX ($110.04 in chips) 
Seat 9: mycka86 ($135.63 in chips) 
UShallGimme$: posts small blind $0.50
vinniej15: posts big blind $1
sylvian31: sits out 
*** HOLE CARDS ***
Dealt to matiko09 [Ah 5s]
CoolFireX: folds 
mycka86: folds 
COOLIKO\/23: folds 
pandalapa: folds 
deepblue0000: folds 
matiko09: raises $1.27 to $2.27
UShallGimme$: folds 
vinniej15: calls $1.27
*** FLOP *** [Th 4d 8s]
vinniej15: checks 
matiko09: bets $3.13
vinniej15: folds 
Uncalled bet ($3.13) returned to matiko09
matiko09 collected $4.81 from pot
matiko09: doesn't show hand 
*** SUMMARY ***
Total pot $5.04 | Rake $0.23 
Board [Th 4d 8s]
Seat 1: COOLIKO\/23 folded before Flop (didn't bet)
Seat 2: pandalapa folded before Flop (didn't bet)
Seat 3: deepblue0000 folded before Flop (didn't bet)
Seat 5: matiko09 (button) collected ($4.81)
Seat 6: UShallGimme$ (small blind) folded before Flop
Seat 7: vinniej15 (big blind) folded on the Flop
Seat 8: CoolFireX folded before Flop (didn't bet)
Seat 9: mycka86 folded before Flop (didn't bet)





PokerStars Hand #147754430033:  Hold'em No Limit ($0.50/$1.00 USD) - 2016/01/27 11:45:26 CET [2016/01/27 5:45:26 ET]
Table 'Fragaria II' 9-max Seat #8 is the button
Seat 1: deepblue0000 ($124.78 in chips) 
Seat 2: GG-NoR34D. ($82.37 in chips) 
Seat 3: Sweden_Pound ($119.01 in chips) 
Seat 4: AlKatrone ($101 in chips) 
Seat 5: Venomous100% ($105.12 in chips) 
Seat 6: UShallGimme$ ($181.49 in chips) 
Seat 7: Hobby-.-AK ($51.23 in chips) 
Seat 8: mycka86 ($109.60 in chips) 
Seat 9: matiko09 ($102.50 in chips) 
matiko09: posts small blind $0.50
deepblue0000: posts big blind $1
*** HOLE CARDS ***
Dealt to matiko09 [5h Qc]
GG-NoR34D.: folds 
Sweden_Pound: raises $2 to $3
AlKatrone: folds 
Venomous100%: folds 
UShallGimme$: folds 
Hobby-.-AK: folds 
mycka86: folds 
matiko09: folds 
deepblue0000: folds 
Uncalled bet ($2) returned to Sweden_Pound
Sweden_Pound collected $2.50 from pot
Sweden_Pound: doesn't show hand 
*** SUMMARY ***
Total pot $2.50 | Rake $0 
Seat 1: deepblue0000 (big blind) folded before Flop
Seat 2: GG-NoR34D. folded before Flop (didn't bet)
Seat 3: Sweden_Pound collected ($2.50)
Seat 4: AlKatrone folded before Flop (didn't bet)
Seat 5: Venomous100% folded before Flop (didn't bet)
Seat 6: UShallGimme$ folded before Flop (didn't bet)
Seat 7: Hobby-.-AK folded before Flop (didn't bet)
Seat 8: mycka86 (button) folded before Flop (didn't bet)
Seat 9: matiko09 (small blind) folded before Flop





PokerStars Hand #147754430947:  Hold'em No Limit ($0.50/$1.00 USD) - 2016/01/27 11:45:27 CET [2016/01/27 5:45:27 ET]
Table 'Dollfus' 9-max Seat #5 is the button
Seat 1: masaytoo ($111.42 in chips) 
Seat 2: nosoant ($100.81 in chips) 
Seat 3: UShallGimme$ ($100 in chips) 
Seat 4: matiko09 ($113.50 in chips) 
Seat 5: pandalapa ($220.48 in chips) 
Seat 6: deepblue0000 ($125.51 in chips) 
Seat 7: Dödi123 ($173.43 in chips) 
Seat 9: COOLIKO\/23 ($101 in chips) 
deepblue0000: posts small blind $0.50
Dödi123: posts big blind $1
Venomous100%: sits out 
*** HOLE CARDS ***
Dealt to matiko09 [7d 4s]
COOLIKO\/23: folds 
masaytoo: folds 
nosoant: folds 
UShallGimme$: folds 
matiko09: folds 
pandalapa: raises $1.20 to $2.20
deepblue0000: folds 
Dödi123: folds 
Uncalled bet ($1.20) returned to pandalapa
pandalapa collected $2.50 from pot
pandalapa: doesn't show hand 
*** SUMMARY ***
Total pot $2.50 | Rake $0 
Seat 1: masaytoo folded before Flop (didn't bet)
Seat 2: nosoant folded before Flop (didn't bet)
Seat 3: UShallGimme$ folded before Flop (didn't bet)
Seat 4: matiko09 folded before Flop (didn't bet)
Seat 5: pandalapa (button) collected ($2.50)
Seat 6: deepblue0000 (small blind) folded before Flop
Seat 7: Dödi123 (big blind) folded before Flop
Seat 9: COOLIKO\/23 folded before Flop (didn't bet)





PokerStars Hand #147754431623:  Hold'em No Limit ($0.50/$1.00 USD) - 2016/01/27 11:45:29 CET [2016/01/27 5:45:29 ET]
Table 'Alkmene II' 9-max Seat #4 is the button
Seat 1: matiko09 ($100 in chips) 
Seat 2: deepblue0000 ($100 in chips) 
Seat 4: CoolFireX ($147.57 in chips) 
Seat 5: Sweden_Pound ($116.55 in chips) 
Seat 6: Peu3aHy ($113.92 in chips) 
Seat 7: mycka86 ($100 in chips) 
Seat 8: fecsok1 ($121.38 in chips) 
Seat 9: pandalapa ($100 in chips) 
Sweden_Pound: posts small blind $0.50
Peu3aHy: posts big blind $1
di0d80: sits out 
*** HOLE CARDS ***
Dealt to matiko09 [7h 8c]
mycka86: folds 
fecsok1: folds 
pandalapa: folds 
matiko09: folds 
deepblue0000: folds 
CoolFireX: folds 
Sweden_Pound: raises $2 to $3
Peu3aHy: folds 
Uncalled bet ($2) returned to Sweden_Pound
Sweden_Pound collected $2 from pot
Sweden_Pound: doesn't show hand 
*** SUMMARY ***
Total pot $2 | Rake $0 
Seat 1: matiko09 folded before Flop (didn't bet)
Seat 2: deepblue0000 folded before Flop (didn't bet)
Seat 4: CoolFireX (button) folded before Flop (didn't bet)
Seat 5: Sweden_Pound (small blind) collected ($2)
Seat 6: Peu3aHy (big blind) folded before Flop
Seat 7: mycka86 folded before Flop (didn't bet)
Seat 8: fecsok1 folded before Flop (didn't bet)
Seat 9: pandalapa folded before Flop (didn't bet)





PokerStars Hand #147754436810:  Hold'em No Limit ($0.50/$1.00 USD) - 2016/01/27 11:45:39 CET [2016/01/27 5:45:39 ET]
Table 'Alhajoth' 9-max Seat #7 is the button
Seat 1: UShallGimme$ ($154.45 in chips) 
Seat 2: matiko09 ($100 in chips) 
Seat 3: Sweden_Pound ($117.77 in chips) 
Seat 4: Venomous100% ($125.87 in chips) 
Seat 5: Kukuryzka ($104.16 in chips) 
Seat 6: RoadtoNepal ($185.80 in chips) 
Seat 7: Ohpeel ($123.32 in chips) 
Seat 8: deepblue0000 ($115.18 in chips) 
Seat 9: di0d80 ($100 in chips) 
deepblue0000: posts small blind $0.50
di0d80: posts big blind $1
*** HOLE CARDS ***
Dealt to matiko09 [Qh Jc]
UShallGimme$: folds 
matiko09: folds 
Sweden_Pound: folds 
Venomous100%: folds 
Kukuryzka: folds 
RoadtoNepal: raises $2 to $3
Ohpeel: folds 
deepblue0000: raises $6 to $9
di0d80: folds 
RoadtoNepal: folds 
Uncalled bet ($6) returned to deepblue0000
deepblue0000 collected $7 from pot
*** SUMMARY ***
Total pot $7 | Rake $0 
Seat 1: UShallGimme$ folded before Flop (didn't bet)
Seat 2: matiko09 folded before Flop (didn't bet)
Seat 3: Sweden_Pound folded before Flop (didn't bet)
Seat 4: Venomous100% folded before Flop (didn't bet)
Seat 5: Kukuryzka folded before Flop (didn't bet)
Seat 6: RoadtoNepal folded before Flop
Seat 7: Ohpeel (button) folded before Flop (didn't bet)
Seat 8: deepblue0000 (small blind) collected ($7)
Seat 9: di0d80 (big blind) folded before Flop





PokerStars Hand #147754437226:  Hold'em No Limit ($1/$2 USD) - 2016/01/27 11:45:40 CET [2016/01/27 5:45:40 ET]
Table 'Phobos II' 9-max Seat #6 is the button
Seat 1: LRV21 ($382.12 in chips) 
Seat 2: di0d80 ($246.22 in chips) 
Seat 4: flk.Dasas ($314.18 in chips) 
Seat 5: tipner ($200 in chips) 
Seat 6: matiko09 ($200 in chips) 
Seat 7: Venomous100% ($278.31 in chips) 
Seat 8: RoadtoNepal ($251.54 in chips) 
Seat 9: Kukuryzka ($378.03 in chips) 
Venomous100%: posts small blind $1
RoadtoNepal: posts big blind $2
sylvian31: sits out 
*** HOLE CARDS ***
Dealt to matiko09 [3h 9d]
Kukuryzka: folds 
LRV21: folds 
di0d80: folds 
flk.Dasas: folds 
tipner: raises $4 to $6
matiko09: folds 
Venomous100%: raises $8 to $14
RoadtoNepal: folds 
tipner: calls $8
*** FLOP *** [5h Ks 6d]
Venomous100%: bets $18.91
tipner: calls $18.91
*** TURN *** [5h Ks 6d] [As]
Venomous100%: checks 
tipner: checks 
*** RIVER *** [5h Ks 6d As] [3c]
Venomous100%: checks 
tipner: checks 
*** SHOW DOWN ***
Venomous100%: shows [Jd Ac] (a pair of Aces)
tipner: mucks hand 
Venomous100% collected $65.02 from pot
*** SUMMARY ***
Total pot $67.82 | Rake $2.80 
Board [5h Ks 6d As 3c]
Seat 1: LRV21 folded before Flop (didn't bet)
Seat 2: di0d80 folded before Flop (didn't bet)
Seat 4: flk.Dasas folded before Flop (didn't bet)
Seat 5: tipner mucked [Kd Td]
Seat 6: matiko09 (button) folded before Flop (didn't bet)
Seat 7: Venomous100% (small blind) showed [Jd Ac] and won ($65.02) with a pair of Aces
Seat 8: RoadtoNepal (big blind) folded before Flop
Seat 9: Kukuryzka folded before Flop (didn't bet)





PokerStars Hand #147754445717:  Hold'em No Limit ($0.50/$1.00 USD) - 2016/01/27 11:45:56 CET [2016/01/27 5:45:56 ET]
Table 'Fragaria II' 9-max Seat #9 is the button
Seat 1: deepblue0000 ($123.78 in chips) 
Seat 2: GG-NoR34D. ($82.37 in chips) 
Seat 3: Sweden_Pound ($120.51 in chips) 
Seat 4: AlKatrone ($101 in chips) 
Seat 5: Venomous100% ($105.12 in chips) 
Seat 6: UShallGimme$ ($181.49 in chips) 
Seat 7: Hobby-.-AK ($51.23 in chips) 
Seat 8: mycka86 ($109.60 in chips) 
Seat 9: matiko09 ($102 in chips) 
deepblue0000: posts small blind $0.50
GG-NoR34D.: posts big blind $1
*** HOLE CARDS ***
Dealt to matiko09 [4h 5c]
Sweden_Pound: folds 
AlKatrone: folds 
Venomous100%: folds 
UShallGimme$: folds 
Hobby-.-AK: folds 
mycka86: folds 
matiko09: folds 
deepblue0000: folds 
Uncalled bet ($0.50) returned to GG-NoR34D.
GG-NoR34D. collected $1 from pot
*** SUMMARY ***
Total pot $1 | Rake $0 
Seat 1: deepblue0000 (small blind) folded before Flop
Seat 2: GG-NoR34D. (big blind) collected ($1)
Seat 3: Sweden_Pound folded before Flop (didn't bet)
Seat 4: AlKatrone folded before Flop (didn't bet)
Seat 5: Venomous100% folded before Flop (didn't bet)
Seat 6: UShallGimme$ folded before Flop (didn't bet)
Seat 7: Hobby-.-AK folded before Flop (didn't bet)
Seat 8: mycka86 folded before Flop (didn't bet)
Seat 9: matiko09 (button) folded before Flop (didn't bet)





PokerStars Hand #147754447798:  Hold'em No Limit ($0.50/$1.00 USD) - 2016/01/27 11:46:01 CET [2016/01/27 5:46:01 ET]
Table 'Dollfus' 9-max Seat #6 is the button
Seat 1: masaytoo ($111.42 in chips) 
Seat 2: nosoant ($100.81 in chips) 
Seat 3: UShallGimme$ ($100 in chips) 
Seat 4: matiko09 ($113.50 in chips) 
Seat 5: pandalapa ($221.98 in chips) 
Seat 6: deepblue0000 ($125.01 in chips) 
Seat 7: Dödi123 ($172.43 in chips) 
Seat 8: Venomous100% ($119.75 in chips) 
Seat 9: COOLIKO\/23 ($101 in chips) 
Dödi123: posts small blind $0.50
Venomous100%: posts big blind $1
*** HOLE CARDS ***
Dealt to matiko09 [7d Kh]
COOLIKO\/23: folds 
masaytoo: folds 
nosoant: folds 
UShallGimme$: folds 
matiko09: folds 
pandalapa: folds 
deepblue0000: raises $2 to $3
Dödi123: raises $6 to $9
Venomous100%: folds 
deepblue0000: calls $6
*** FLOP *** [7c 3h Tc]
Dödi123: checks 
deepblue0000: checks 
*** TURN *** [7c 3h Tc] [Qh]
Dödi123: checks 
deepblue0000: bets $12.09
Dödi123: calls $12.09
*** RIVER *** [7c 3h Tc Qh] [4h]
Dödi123: checks 
deepblue0000: bets $18
Dödi123: calls $18
*** SHOW DOWN ***
deepblue0000: shows [Qc 9c] (a pair of Queens)
Dödi123: shows [Qs Ah] (a pair of Queens - Ace kicker)
Dödi123 collected $76.38 from pot
*** SUMMARY ***
Total pot $79.18 | Rake $2.80 
Board [7c 3h Tc Qh 4h]
Seat 1: masaytoo folded before Flop (didn't bet)
Seat 2: nosoant folded before Flop (didn't bet)
Seat 3: UShallGimme$ folded before Flop (didn't bet)
Seat 4: matiko09 folded before Flop (didn't bet)
Seat 5: pandalapa folded before Flop (didn't bet)
Seat 6: deepblue0000 (button) showed [Qc 9c] and lost with a pair of Queens
Seat 7: Dödi123 (small blind) showed [Qs Ah] and won ($76.38) with a pair of Queens
Seat 8: Venomous100% (big blind) folded before Flop
Seat 9: COOLIKO\/23 folded before Flop (didn't bet)





PokerStars Hand #147754449468:  Hold'em No Limit (€0.50/€1.00 EUR) - 2016/01/27 11:46:04 CET [2016/01/27 5:46:04 ET]
Table 'Carol' 9-max Seat #6 is the button
Seat 2: sylvian31 (€100 in chips) 
Seat 4: Flemishduck (€79 in chips) 
Seat 5: Proandi (€43.48 in chips) 
Seat 6: Kukuryzka (€100 in chips) 
Seat 7: tipner (€111.44 in chips) 
Seat 8: matiko09 (€100 in chips) 
tipner: posts small blind €0.50
matiko09: posts big blind €1
Venomous100%: sits out 
RoadtoNepal: sits out 
noname076: sits out 
*** HOLE CARDS ***
Dealt to matiko09 [Qs 6c]
sylvian31: raises €2 to €3
Flemishduck: folds 
Proandi: folds 
Kukuryzka: folds 
tipner: folds 
matiko09: folds 
Uncalled bet (€2) returned to sylvian31
sylvian31 collected €2.50 from pot
sylvian31: doesn't show hand 
*** SUMMARY ***
Total pot €2.50 | Rake €0 
Seat 2: sylvian31 collected (€2.50)
Seat 4: Flemishduck folded before Flop (didn't bet)
Seat 5: Proandi folded before Flop (didn't bet)
Seat 6: Kukuryzka (button) folded before Flop (didn't bet)
Seat 7: tipner (small blind) folded before Flop
Seat 8: matiko09 (big blind) folded before Flop





PokerStars Hand #147754450900:  Hold'em No Limit ($0.50/$1.00 USD) - 2016/01/27 11:46:07 CET [2016/01/27 5:46:07 ET]
Table 'Alkmene II' 9-max Seat #5 is the button
Seat 1: matiko09 ($100 in chips) 
Seat 2: deepblue0000 ($100 in chips) 
Seat 4: CoolFireX ($147.57 in chips) 
Seat 5: Sweden_Pound ($117.55 in chips) 
Seat 6: Peu3aHy ($112.92 in chips) 
Seat 7: mycka86 ($100 in chips) 
Seat 8: fecsok1 ($121.38 in chips) 
Seat 9: pandalapa ($100 in chips) 
Peu3aHy: posts small blind $0.50
mycka86: posts big blind $1
di0d80: sits out 
*** HOLE CARDS ***
Dealt to matiko09 [4c Ks]
fecsok1: folds 
pandalapa: folds 
matiko09: folds 
deepblue0000: folds 
CoolFireX: folds 
Sweden_Pound: raises $1 to $2
Peu3aHy: folds 
mycka86: raises $6 to $8
Sweden_Pound: folds 
Uncalled bet ($6) returned to mycka86
mycka86 collected $4.50 from pot
*** SUMMARY ***
Total pot $4.50 | Rake $0 
Seat 1: matiko09 folded before Flop (didn't bet)
Seat 2: deepblue0000 folded before Flop (didn't bet)
Seat 4: CoolFireX folded before Flop (didn't bet)
Seat 5: Sweden_Pound (button) folded before Flop
Seat 6: Peu3aHy (small blind) folded before Flop
Seat 7: mycka86 (big blind) collected ($4.50)
Seat 8: fecsok1 folded before Flop (didn't bet)
Seat 9: pandalapa folded before Flop (didn't bet)





PokerStars Hand #147754453857:  Hold'em No Limit ($0.50/$1.00 USD) - 2016/01/27 11:46:13 CET [2016/01/27 5:46:13 ET]
Table 'Henyey' 9-max Seat #6 is the button
Seat 1: COOLIKO\/23 ($100 in chips) 
Seat 2: pandalapa ($150.77 in chips) 
Seat 3: deepblue0000 ($120.11 in chips) 
Seat 5: matiko09 ($115.12 in chips) 
Seat 6: UShallGimme$ ($101.78 in chips) 
Seat 7: vinniej15 ($50.21 in chips) 
Seat 8: CoolFireX ($110.04 in chips) 
Seat 9: mycka86 ($135.63 in chips) 
vinniej15: posts small blind $0.50
CoolFireX: posts big blind $1
sylvian31: sits out 
*** HOLE CARDS ***
Dealt to matiko09 [6h Kd]
mycka86: folds 
COOLIKO\/23: folds 
pandalapa: folds 
deepblue0000: folds 
matiko09: folds 
UShallGimme$: folds 
vinniej15: calls $0.50
CoolFireX: checks 
*** FLOP *** [3s 7d 3c]
vinniej15: checks 
CoolFireX: bets $1.43
vinniej15: calls $1.43
*** TURN *** [3s 7d 3c] [5d]
vinniej15: bets $5
CoolFireX: calls $5
*** RIVER *** [3s 7d 3c 5d] [Kc]
vinniej15: bets $10
CoolFireX: calls $10
*** SHOW DOWN ***
vinniej15: shows [3d 4c] (three of a kind, Threes)
CoolFireX: mucks hand 
vinniej15 collected $33.29 from pot
*** SUMMARY ***
Total pot $34.86 | Rake $1.57 
Board [3s 7d 3c 5d Kc]
Seat 1: COOLIKO\/23 folded before Flop (didn't bet)
Seat 2: pandalapa folded before Flop (didn't bet)
Seat 3: deepblue0000 folded before Flop (didn't bet)
Seat 5: matiko09 folded before Flop (didn't bet)
Seat 6: UShallGimme$ (button) folded before Flop (didn't bet)
Seat 7: vinniej15 (small blind) showed [3d 4c] and won ($33.29) with three of a kind, Threes
Seat 8: CoolFireX (big blind) mucked [Qc 7h]
Seat 9: mycka86 folded before Flop (didn't bet)





PokerStars Hand #147754459072:  Hold'em No Limit (€0.50/€1.00 EUR) - 2016/01/27 11:46:23 CET [2016/01/27 5:46:23 ET]
Table 'Carol' 9-max Seat #7 is the button
Seat 2: sylvian31 (€101.50 in chips) 
Seat 3: noname076 (€50 in chips) 
Seat 4: Flemishduck (€79 in chips) 
Seat 5: Proandi (€43.48 in chips) 
Seat 6: Kukuryzka (€100 in chips) 
Seat 7: tipner (€110.94 in chips) 
Seat 8: matiko09 (€100 in chips) 
Seat 9: Venomous100% (€100 in chips) 
matiko09: posts small blind €0.50
Venomous100%: posts big blind €1
RoadtoNepal: sits out 
noname076: posts big blind €1
*** HOLE CARDS ***
Dealt to matiko09 [9c Kc]
sylvian31: folds 
noname076: checks 
Flemishduck: folds 
Proandi: folds 
Kukuryzka: folds 
tipner: folds 
matiko09: calls €0.50
Venomous100%: raises €4 to €5
noname076: folds 
matiko09: folds 
Uncalled bet (€4) returned to Venomous100%
Venomous100% collected €3 from pot
Venomous100%: doesn't show hand 
*** SUMMARY ***
Total pot €3 | Rake €0 
Seat 2: sylvian31 folded before Flop (didn't bet)
Seat 3: noname076 folded before Flop
Seat 4: Flemishduck folded before Flop (didn't bet)
Seat 5: Proandi folded before Flop (didn't bet)
Seat 6: Kukuryzka folded before Flop (didn't bet)
Seat 7: tipner (button) folded before Flop (didn't bet)
Seat 8: matiko09 (small blind) folded before Flop
Seat 9: Venomous100% (big blind) collected (€3)





PokerStars Hand #147754461253:  Hold'em No Limit ($0.50/$1.00 USD) - 2016/01/27 11:46:27 CET [2016/01/27 5:46:27 ET]
Table 'Fragaria II' 9-max Seat #1 is the button
Seat 1: deepblue0000 ($123.28 in chips) 
Seat 2: GG-NoR34D. ($82.87 in chips) 
Seat 3: Sweden_Pound ($120.51 in chips) 
Seat 4: AlKatrone ($101 in chips) 
Seat 5: Venomous100% ($105.12 in chips) 
Seat 6: UShallGimme$ ($181.49 in chips) 
Seat 7: Hobby-.-AK ($51.23 in chips) 
Seat 8: mycka86 ($109.60 in chips) 
Seat 9: matiko09 ($102 in chips) 
GG-NoR34D.: posts small blind $0.50
Sweden_Pound: posts big blind $1
*** HOLE CARDS ***
Dealt to matiko09 [Jc 2s]
AlKatrone: raises $2 to $3
Venomous100%: folds 
UShallGimme$: folds 
Hobby-.-AK: folds 
mycka86: folds 
matiko09: folds 
deepblue0000: folds 
GG-NoR34D.: folds 
Sweden_Pound: folds 
Uncalled bet ($2) returned to AlKatrone
AlKatrone collected $2.50 from pot
AlKatrone: doesn't show hand 
*** SUMMARY ***
Total pot $2.50 | Rake $0 
Seat 1: deepblue0000 (button) folded before Flop (didn't bet)
Seat 2: GG-NoR34D. (small blind) folded before Flop
Seat 3: Sweden_Pound (big blind) folded before Flop
Seat 4: AlKatrone collected ($2.50)
Seat 5: Venomous100% folded before Flop (didn't bet)
Seat 6: UShallGimme$ folded before Flop (didn't bet)
Seat 7: Hobby-.-AK folded before Flop (didn't bet)
Seat 8: mycka86 folded before Flop (didn't bet)
Seat 9: matiko09 folded before Flop (didn't bet)





PokerStars Hand #147754464107:  Hold'em No Limit ($0.50/$1.00 USD) - 2016/01/27 11:46:33 CET [2016/01/27 5:46:33 ET]
Table 'Alhajoth' 9-max Seat #8 is the button
Seat 1: UShallGimme$ ($154.45 in chips) 
Seat 2: matiko09 ($100 in chips) 
Seat 3: Sweden_Pound ($117.77 in chips) 
Seat 4: Venomous100% ($125.87 in chips) 
Seat 5: Kukuryzka ($104.16 in chips) 
Seat 6: RoadtoNepal ($182.80 in chips) 
Seat 7: Ohpeel ($123.32 in chips) 
Seat 8: deepblue0000 ($119.18 in chips) 
Seat 9: di0d80 ($100 in chips) 
di0d80: posts small blind $0.50
UShallGimme$: posts big blind $1
*** HOLE CARDS ***
Dealt to matiko09 [4d 6s]
matiko09: folds 
Sweden_Pound: folds 
Venomous100%: folds 
Kukuryzka: folds 
RoadtoNepal: folds 
Ohpeel: calls $1
deepblue0000: raises $3.50 to $4.50
di0d80: folds 
UShallGimme$: folds 
Ohpeel: folds 
Uncalled bet ($3.50) returned to deepblue0000
deepblue0000 collected $3.50 from pot
*** SUMMARY ***
Total pot $3.50 | Rake $0 
Seat 1: UShallGimme$ (big blind) folded before Flop
Seat 2: matiko09 folded before Flop (didn't bet)
Seat 3: Sweden_Pound folded before Flop (didn't bet)
Seat 4: Venomous100% folded before Flop (didn't bet)
Seat 5: Kukuryzka folded before Flop (didn't bet)
Seat 6: RoadtoNepal folded before Flop (didn't bet)
Seat 7: Ohpeel folded before Flop
Seat 8: deepblue0000 (button) collected ($3.50)
Seat 9: di0d80 (small blind) folded before Flop





PokerStars Hand #147754469740:  Hold'em No Limit ($0.50/$1.00 USD) - 2016/01/27 11:46:44 CET [2016/01/27 5:46:44 ET]
Table 'Alkmene II' 9-max Seat #6 is the button
Seat 1: matiko09 ($100 in chips) 
Seat 2: deepblue0000 ($100 in chips) 
Seat 4: CoolFireX ($147.57 in chips) 
Seat 5: Sweden_Pound ($115.55 in chips) 
Seat 6: Peu3aHy ($112.42 in chips) 
Seat 7: mycka86 ($102.50 in chips) 
Seat 8: fecsok1 ($121.38 in chips) 
Seat 9: pandalapa ($100 in chips) 
mycka86: posts small blind $0.50
fecsok1: posts big blind $1
di0d80: sits out 
*** HOLE CARDS ***
Dealt to matiko09 [6h Td]
pandalapa: folds 
matiko09: folds 
deepblue0000: folds 
CoolFireX: raises $2 to $3
Sweden_Pound: folds 
Peu3aHy: folds 
mycka86: folds 
fecsok1: folds 
Uncalled bet ($2) returned to CoolFireX
CoolFireX collected $2.50 from pot
CoolFireX: doesn't show hand 
*** SUMMARY ***
Total pot $2.50 | Rake $0 
Seat 1: matiko09 folded before Flop (didn't bet)
Seat 2: deepblue0000 folded before Flop (didn't bet)
Seat 4: CoolFireX collected ($2.50)
Seat 5: Sweden_Pound folded before Flop (didn't bet)
Seat 6: Peu3aHy (button) folded before Flop (didn't bet)
Seat 7: mycka86 (small blind) folded before Flop
Seat 8: fecsok1 (big blind) folded before Flop
Seat 9: pandalapa folded before Flop (didn't bet)





PokerStars Hand #147754476451:  Hold'em No Limit ($0.50/$1.00 USD) - 2016/01/27 11:46:57 CET [2016/01/27 5:46:57 ET]
Table 'Nanking' 9-max Seat #6 is the button
Seat 1: Peu3aHy ($100 in chips) 
Seat 2: Dachish ($100.67 in chips) 
Seat 3: nuaxin ($51.94 in chips) 
Seat 4: COOLIKO\/23 ($161.54 in chips) 
Seat 5: TheGentleFox ($97.56 in chips) 
Seat 6: Kukuryzka ($108.03 in chips) 
Seat 7: tipner ($100 in chips) 
Seat 8: matiko09 ($100 in chips) 
Seat 9: Sweden_Pound ($135.72 in chips) 
tipner: posts small blind $0.50
matiko09: posts big blind $1
*** HOLE CARDS ***
Dealt to matiko09 [2c 9s]
Sweden_Pound: folds 
Peu3aHy: raises $2 to $3
Dachish: folds 
nuaxin: folds 
COOLIKO\/23: folds 
TheGentleFox: calls $3
Kukuryzka: folds 
tipner: calls $2.50
matiko09: folds 
*** FLOP *** [Kd 8d 2d]
tipner: checks 
Peu3aHy: bets $6
TheGentleFox: calls $6
tipner: folds 
*** TURN *** [Kd 8d 2d] [8c]
Peu3aHy: checks 
TheGentleFox: checks 
*** RIVER *** [Kd 8d 2d 8c] [Ks]
Peu3aHy: checks 
TheGentleFox: bets $10.50
Peu3aHy: folds 
Uncalled bet ($10.50) returned to TheGentleFox
TheGentleFox collected $21.01 from pot
TheGentleFox: doesn't show hand 
*** SUMMARY ***
Total pot $22 | Rake $0.99 
Board [Kd 8d 2d 8c Ks]
Seat 1: Peu3aHy folded on the River
Seat 2: Dachish folded before Flop (didn't bet)
Seat 3: nuaxin folded before Flop (didn't bet)
Seat 4: COOLIKO\/23 folded before Flop (didn't bet)
Seat 5: TheGentleFox collected ($21.01)
Seat 6: Kukuryzka (button) folded before Flop (didn't bet)
Seat 7: tipner (small blind) folded on the Flop
Seat 8: matiko09 (big blind) folded before Flop
Seat 9: Sweden_Pound folded before Flop (didn't bet)





PokerStars Hand #147754478150:  Hold'em No Limit ($0.50/$1.00 USD) - 2016/01/27 11:47:00 CET [2016/01/27 5:47:00 ET]
Table 'Delphinus II' 9-max Seat #4 is the button
Seat 1: Saintreine ($143.61 in chips) 
Seat 2: AlKatrone ($198.52 in chips) 
Seat 3: deepblue0000 ($330.98 in chips) 
Seat 4: matiko09 ($121.73 in chips) 
Seat 5: pandalapa ($100 in chips) 
Seat 6: Sweden_Pound ($123.14 in chips) 
Seat 7: RUS)Timur ($100 in chips) 
Seat 8: mycka86 ($109.10 in chips) 
Seat 9: FGL-lucky ($51.38 in chips) 
pandalapa: posts small blind $0.50
Sweden_Pound: posts big blind $1
*** HOLE CARDS ***
Dealt to matiko09 [3c Qs]
RUS)Timur: folds 
mycka86: raises $2 to $3
FGL-lucky: folds 
Saintreine: folds 
AlKatrone: folds 
deepblue0000: folds 
matiko09: folds 
pandalapa: calls $2.50
Sweden_Pound: folds 
*** FLOP *** [8s Th 4c]
pandalapa: checks 
mycka86: bets $4.90
pandalapa: raises $9.10 to $14
mycka86: folds 
Uncalled bet ($9.10) returned to pandalapa
pandalapa collected $16.04 from pot
pandalapa: doesn't show hand 
*** SUMMARY ***
Total pot $16.80 | Rake $0.76 
Board [8s Th 4c]
Seat 1: Saintreine folded before Flop (didn't bet)
Seat 2: AlKatrone folded before Flop (didn't bet)
Seat 3: deepblue0000 folded before Flop (didn't bet)
Seat 4: matiko09 (button) folded before Flop (didn't bet)
Seat 5: pandalapa (small blind) collected ($16.04)
Seat 6: Sweden_Pound (big blind) folded before Flop
Seat 7: RUS)Timur folded before Flop (didn't bet)
Seat 8: mycka86 folded on the Flop
Seat 9: FGL-lucky folded before Flop (didn't bet)





PokerStars Hand #147754481952:  Hold'em No Limit (€0.50/€1.00 EUR) - 2016/01/27 11:47:08 CET [2016/01/27 5:47:08 ET]
Table 'Carol' 9-max Seat #8 is the button
Seat 1: RoadtoNepal (€100 in chips) 
Seat 2: sylvian31 (€101.50 in chips) 
Seat 3: noname076 (€49 in chips) 
Seat 4: Flemishduck (€79 in chips) 
Seat 5: Proandi (€43.48 in chips) 
Seat 6: Kukuryzka (€100 in chips) 
Seat 7: tipner (€110.94 in chips) 
Seat 8: matiko09 (€100 in chips) 
Seat 9: Venomous100% (€102 in chips) 
Venomous100%: posts small blind €0.50
RoadtoNepal: posts big blind €1
*** HOLE CARDS ***
Dealt to matiko09 [6s 3c]
sylvian31: folds 
noname076: calls €1
Flemishduck: folds 
Proandi: folds 
Kukuryzka: raises €3.50 to €4.50
tipner: folds 
matiko09: folds 
Venomous100%: folds 
RoadtoNepal: folds 
noname076: calls €3.50
*** FLOP *** [4d 2d Ac]
noname076: checks 
Kukuryzka: checks 
*** TURN *** [4d 2d Ac] [7h]
noname076: bets €10.03
Kukuryzka: folds 
Uncalled bet (€10.03) returned to noname076
noname076 collected €10.03 from pot
noname076: doesn't show hand 
*** SUMMARY ***
Total pot €10.50 | Rake €0.47 
Board [4d 2d Ac 7h]
Seat 1: RoadtoNepal (big blind) folded before Flop
Seat 2: sylvian31 folded before Flop (didn't bet)
Seat 3: noname076 collected (€10.03)
Seat 4: Flemishduck folded before Flop (didn't bet)
Seat 5: Proandi folded before Flop (didn't bet)
Seat 6: Kukuryzka folded on the Turn
Seat 7: tipner folded before Flop (didn't bet)
Seat 8: matiko09 (button) folded before Flop (didn't bet)
Seat 9: Venomous100% (small blind) folded before Flop





PokerStars Hand #147754485315:  Hold'em No Limit ($1/$2 USD) - 2016/01/27 11:47:15 CET [2016/01/27 5:47:15 ET]
Table 'Phobos II' 9-max Seat #7 is the button
Seat 1: LRV21 ($382.12 in chips) 
Seat 2: di0d80 ($246.22 in chips) 
Seat 4: flk.Dasas ($314.18 in chips) 
Seat 5: tipner ($200 in chips) 
Seat 6: matiko09 ($200 in chips) 
Seat 7: Venomous100% ($310.42 in chips) 
Seat 8: RoadtoNepal ($249.54 in chips) 
Seat 9: Kukuryzka ($378.03 in chips) 
RoadtoNepal: posts small blind $1
Kukuryzka: posts big blind $2
sylvian31: sits out 
*** HOLE CARDS ***
Dealt to matiko09 [Kd 6d]
LRV21: folds 
di0d80: folds 
flk.Dasas: folds 
tipner: folds 
matiko09: raises $3 to $5
Venomous100%: folds 
RoadtoNepal: folds 
Kukuryzka: folds 
Uncalled bet ($3) returned to matiko09
matiko09 collected $5 from pot
matiko09: doesn't show hand 
*** SUMMARY ***
Total pot $5 | Rake $0 
Seat 1: LRV21 folded before Flop (didn't bet)
Seat 2: di0d80 folded before Flop (didn't bet)
Seat 4: flk.Dasas folded before Flop (didn't bet)
Seat 5: tipner folded before Flop (didn't bet)
Seat 6: matiko09 collected ($5)
Seat 7: Venomous100% (button) folded before Flop (didn't bet)
Seat 8: RoadtoNepal (small blind) folded before Flop
Seat 9: Kukuryzka (big blind) folded before Flop





PokerStars Hand #147754487013:  Hold'em No Limit ($0.50/$1.00 USD) - 2016/01/27 11:47:18 CET [2016/01/27 5:47:18 ET]
Table 'Alhajoth' 9-max Seat #9 is the button
Seat 1: UShallGimme$ ($153.45 in chips) 
Seat 2: matiko09 ($100 in chips) 
Seat 3: Sweden_Pound ($117.77 in chips) 
Seat 4: Venomous100% ($125.87 in chips) 
Seat 5: Kukuryzka ($104.16 in chips) 
Seat 6: RoadtoNepal ($182.80 in chips) 
Seat 7: Ohpeel ($122.32 in chips) 
Seat 8: deepblue0000 ($121.68 in chips) 
Seat 9: di0d80 ($100 in chips) 
UShallGimme$: posts small blind $0.50
matiko09: posts big blind $1
*** HOLE CARDS ***
Dealt to matiko09 [2d 4d]
Sweden_Pound: folds 
Venomous100%: folds 
Kukuryzka: raises $2 to $3
RoadtoNepal: folds 
Ohpeel: folds 
deepblue0000: folds 
di0d80: folds 
UShallGimme$: folds 
matiko09: folds 
Uncalled bet ($2) returned to Kukuryzka
Kukuryzka collected $2.50 from pot
Kukuryzka: doesn't show hand 
*** SUMMARY ***
Total pot $2.50 | Rake $0 
Seat 1: UShallGimme$ (small blind) folded before Flop
Seat 2: matiko09 (big blind) folded before Flop
Seat 3: Sweden_Pound folded before Flop (didn't bet)
Seat 4: Venomous100% folded before Flop (didn't bet)
Seat 5: Kukuryzka collected ($2.50)
Seat 6: RoadtoNepal folded before Flop (didn't bet)
Seat 7: Ohpeel folded before Flop (didn't bet)
Seat 8: deepblue0000 folded before Flop (didn't bet)
Seat 9: di0d80 (button) folded before Flop (didn't bet)





PokerStars Hand #147754489716:  Hold'em No Limit ($0.50/$1.00 USD) - 2016/01/27 11:47:23 CET [2016/01/27 5:47:23 ET]
Table 'Fragaria II' 9-max Seat #2 is the button
Seat 1: deepblue0000 ($123.28 in chips) 
Seat 2: GG-NoR34D. ($82.37 in chips) 
Seat 3: Sweden_Pound ($119.51 in chips) 
Seat 4: AlKatrone ($102.50 in chips) 
Seat 5: Venomous100% ($105.12 in chips) 
Seat 6: UShallGimme$ ($181.49 in chips) 
Seat 7: Hobby-.-AK ($51.23 in chips) 
Seat 8: mycka86 ($109.60 in chips) 
Seat 9: matiko09 ($102 in chips) 
Sweden_Pound: posts small blind $0.50
AlKatrone: posts big blind $1
*** HOLE CARDS ***
Dealt to matiko09 [5s 2h]
Venomous100%: folds 
UShallGimme$: folds 
Hobby-.-AK: folds 
mycka86: folds 
matiko09: folds 
deepblue0000: folds 
GG-NoR34D.: folds 
Sweden_Pound: raises $2 to $3
AlKatrone: calls $2
*** FLOP *** [Th 2d 4s]
Sweden_Pound: bets $3.72
AlKatrone: folds 
Uncalled bet ($3.72) returned to Sweden_Pound
Sweden_Pound collected $5.73 from pot
Sweden_Pound: doesn't show hand 
*** SUMMARY ***
Total pot $6 | Rake $0.27 
Board [Th 2d 4s]
Seat 1: deepblue0000 folded before Flop (didn't bet)
Seat 2: GG-NoR34D. (button) folded before Flop (didn't bet)
Seat 3: Sweden_Pound (small blind) collected ($5.73)
Seat 4: AlKatrone (big blind) folded on the Flop
Seat 5: Venomous100% folded before Flop (didn't bet)
Seat 6: UShallGimme$ folded before Flop (didn't bet)
Seat 7: Hobby-.-AK folded before Flop (didn't bet)
Seat 8: mycka86 folded before Flop (didn't bet)
Seat 9: matiko09 folded before Flop (didn't bet)





PokerStars Hand #147754496197:  Hold'em No Limit ($0.50/$1.00 USD) - 2016/01/27 11:47:36 CET [2016/01/27 5:47:36 ET]
Table 'Henyey' 9-max Seat #7 is the button
Seat 1: COOLIKO\/23 ($100 in chips) 
Seat 2: pandalapa ($150.77 in chips) 
Seat 3: deepblue0000 ($120.11 in chips) 
Seat 5: matiko09 ($115.12 in chips) 
Seat 6: UShallGimme$ ($101.78 in chips) 
Seat 7: vinniej15 ($66.07 in chips) 
Seat 8: CoolFireX ($100 in chips) 
Seat 9: mycka86 ($135.63 in chips) 
CoolFireX: posts small blind $0.50
mycka86: posts big blind $1
sylvian31: sits out 
*** HOLE CARDS ***
Dealt to matiko09 [6c Jh]
COOLIKO\/23: folds 
pandalapa: folds 
deepblue0000: folds 
matiko09: folds 
UShallGimme$: folds 
vinniej15: folds 
CoolFireX: folds 
Uncalled bet ($0.50) returned to mycka86
mycka86 collected $1 from pot
*** SUMMARY ***
Total pot $1 | Rake $0 
Seat 1: COOLIKO\/23 folded before Flop (didn't bet)
Seat 2: pandalapa folded before Flop (didn't bet)
Seat 3: deepblue0000 folded before Flop (didn't bet)
Seat 5: matiko09 folded before Flop (didn't bet)
Seat 6: UShallGimme$ folded before Flop (didn't bet)
Seat 7: vinniej15 (button) folded before Flop (didn't bet)
Seat 8: CoolFireX (small blind) folded before Flop
Seat 9: mycka86 (big blind) collected ($1)





PokerStars Hand #147754496666:  Hold'em No Limit ($0.50/$1.00 USD) - 2016/01/27 11:47:37 CET [2016/01/27 5:47:37 ET]
Table 'Alkmene II' 9-max Seat #7 is the button
Seat 1: matiko09 ($100 in chips) 
Seat 2: deepblue0000 ($100 in chips) 
Seat 4: CoolFireX ($149.07 in chips) 
Seat 5: Sweden_Pound ($115.55 in chips) 
Seat 6: Peu3aHy ($112.42 in chips) 
Seat 7: mycka86 ($102 in chips) 
Seat 8: fecsok1 ($120.38 in chips) 
Seat 9: pandalapa ($100 in chips) 
fecsok1: posts small blind $0.50
pandalapa: posts big blind $1
di0d80: sits out 
*** HOLE CARDS ***
Dealt to matiko09 [9s 5d]
matiko09: folds 
deepblue0000: folds 
CoolFireX: folds 
Sweden_Pound: folds 
Peu3aHy: raises $2 to $3
mycka86: raises $6.50 to $9.50
fecsok1: folds 
pandalapa: folds 
Peu3aHy: folds 
Uncalled bet ($6.50) returned to mycka86
mycka86 collected $7.50 from pot
*** SUMMARY ***
Total pot $7.50 | Rake $0 
Seat 1: matiko09 folded before Flop (didn't bet)
Seat 2: deepblue0000 folded before Flop (didn't bet)
Seat 4: CoolFireX folded before Flop (didn't bet)
Seat 5: Sweden_Pound folded before Flop (didn't bet)
Seat 6: Peu3aHy folded before Flop
Seat 7: mycka86 (button) collected ($7.50)
Seat 8: fecsok1 (small blind) folded before Flop
Seat 9: pandalapa (big blind) folded before Flop





PokerStars Hand #147754499289:  Hold'em No Limit ($0.50/$1.00 USD) - 2016/01/27 11:47:42 CET [2016/01/27 5:47:42 ET]
Table 'Dollfus' 9-max Seat #7 is the button
Seat 1: masaytoo ($111.42 in chips) 
Seat 2: nosoant ($100.81 in chips) 
Seat 3: UShallGimme$ ($100 in chips) 
Seat 4: matiko09 ($113.50 in chips) 
Seat 5: pandalapa ($221.98 in chips) 
Seat 6: deepblue0000 ($100 in chips) 
Seat 7: Dödi123 ($209.72 in chips) 
Seat 8: Venomous100% ($118.75 in chips) 
Seat 9: COOLIKO\/23 ($101 in chips) 
Venomous100%: posts small blind $0.50
COOLIKO\/23: posts big blind $1
*** HOLE CARDS ***
Dealt to matiko09 [Qh Ts]
masaytoo has timed out
masaytoo: folds 
nosoant: calls $1
UShallGimme$: folds 
matiko09: raises $3 to $4
pandalapa: folds 
deepblue0000: folds 
Dödi123: folds 
Venomous100%: calls $3.50
COOLIKO\/23: folds 
nosoant: folds 
*** FLOP *** [5s Qd 3s]
Venomous100%: checks 
matiko09: bets $6.21
Venomous100%: folds 
Uncalled bet ($6.21) returned to matiko09
matiko09 collected $9.55 from pot
matiko09: doesn't show hand 
*** SUMMARY ***
Total pot $10 | Rake $0.45 
Board [5s Qd 3s]
Seat 1: masaytoo folded before Flop (didn't bet)
Seat 2: nosoant folded before Flop
Seat 3: UShallGimme$ folded before Flop (didn't bet)
Seat 4: matiko09 collected ($9.55)
Seat 5: pandalapa folded before Flop (didn't bet)
Seat 6: deepblue0000 folded before Flop (didn't bet)
Seat 7: Dödi123 (button) folded before Flop (didn't bet)
Seat 8: Venomous100% (small blind) folded on the Flop
Seat 9: COOLIKO\/23 (big blind) folded before Flop





PokerStars Hand #147754504447:  Hold'em No Limit ($1/$2 USD) - 2016/01/27 11:47:52 CET [2016/01/27 5:47:52 ET]
Table 'Phobos II' 9-max Seat #8 is the button
Seat 1: LRV21 ($382.12 in chips) 
Seat 2: di0d80 ($246.22 in chips) 
Seat 4: flk.Dasas ($314.18 in chips) 
Seat 5: tipner ($200 in chips) 
Seat 6: matiko09 ($203 in chips) 
Seat 7: Venomous100% ($310.42 in chips) 
Seat 8: RoadtoNepal ($248.54 in chips) 
Seat 9: Kukuryzka ($376.03 in chips) 
Kukuryzka: posts small blind $1
LRV21: posts big blind $2
sylvian31: sits out 
*** HOLE CARDS ***
Dealt to matiko09 [8h Ac]
di0d80: folds 
flk.Dasas: folds 
tipner: folds 
matiko09: folds 
Venomous100%: raises $4 to $6
RoadtoNepal: folds 
Kukuryzka: calls $5
LRV21: calls $4
*** FLOP *** [Kc 6h Ts]
Kukuryzka: checks 
LRV21: bets $13
Venomous100%: calls $13
Kukuryzka: folds 
*** TURN *** [Kc 6h Ts] [Jc]
LRV21: bets $38
Venomous100%: folds 
Uncalled bet ($38) returned to LRV21
LRV21 collected $42.02 from pot
LRV21: doesn't show hand 
*** SUMMARY ***
Total pot $44 | Rake $1.98 
Board [Kc 6h Ts Jc]
Seat 1: LRV21 (big blind) collected ($42.02)
Seat 2: di0d80 folded before Flop (didn't bet)
Seat 4: flk.Dasas folded before Flop (didn't bet)
Seat 5: tipner folded before Flop (didn't bet)
Seat 6: matiko09 folded before Flop (didn't bet)
Seat 7: Venomous100% folded on the Turn
Seat 8: RoadtoNepal (button) folded before Flop (didn't bet)
Seat 9: Kukuryzka (small blind) folded on the Flop





PokerStars Hand #147754504653:  Hold'em No Limit ($0.50/$1.00 USD) - 2016/01/27 11:47:53 CET [2016/01/27 5:47:53 ET]
Table 'Alhajoth' 9-max Seat #1 is the button
Seat 1: UShallGimme$ ($152.95 in chips) 
Seat 2: matiko09 ($100 in chips) 
Seat 3: Sweden_Pound ($117.77 in chips) 
Seat 4: Venomous100% ($125.87 in chips) 
Seat 5: Kukuryzka ($105.66 in chips) 
Seat 6: RoadtoNepal ($182.80 in chips) 
Seat 7: Ohpeel ($122.32 in chips) 
Seat 8: deepblue0000 ($121.68 in chips) 
Seat 9: di0d80 ($100 in chips) 
matiko09: posts small blind $0.50
Sweden_Pound: posts big blind $1
*** HOLE CARDS ***
Dealt to matiko09 [Ks Qh]
Venomous100%: raises $2 to $3
Kukuryzka: folds 
RoadtoNepal: folds 
Ohpeel: folds 
deepblue0000: folds 
di0d80: folds 
UShallGimme$: folds 
matiko09: folds 
Sweden_Pound: folds 
Uncalled bet ($2) returned to Venomous100%
Venomous100% collected $2.50 from pot
Venomous100%: doesn't show hand 
*** SUMMARY ***
Total pot $2.50 | Rake $0 
Seat 1: UShallGimme$ (button) folded before Flop (didn't bet)
Seat 2: matiko09 (small blind) folded before Flop
Seat 3: Sweden_Pound (big blind) folded before Flop
Seat 4: Venomous100% collected ($2.50)
Seat 5: Kukuryzka folded before Flop (didn't bet)
Seat 6: RoadtoNepal folded before Flop (didn't bet)
Seat 7: Ohpeel folded before Flop (didn't bet)
Seat 8: deepblue0000 folded before Flop (didn't bet)
Seat 9: di0d80 folded before Flop (didn't bet)





PokerStars Hand #147754508707:  Hold'em No Limit ($0.50/$1.00 USD) - 2016/01/27 11:48:01 CET [2016/01/27 5:48:01 ET]
Table 'Nanking' 9-max Seat #7 is the button
Seat 1: Peu3aHy ($100 in chips) 
Seat 2: Dachish ($100.67 in chips) 
Seat 3: nuaxin ($51.94 in chips) 
Seat 4: COOLIKO\/23 ($161.54 in chips) 
Seat 5: TheGentleFox ($109.57 in chips) 
Seat 6: Kukuryzka ($108.03 in chips) 
Seat 7: tipner ($100 in chips) 
Seat 8: matiko09 ($100 in chips) 
Seat 9: Sweden_Pound ($135.72 in chips) 
matiko09: posts small blind $0.50
Sweden_Pound: posts big blind $1
*** HOLE CARDS ***
Dealt to matiko09 [4c 2d]
Peu3aHy: folds 
Dachish: folds 
nuaxin: raises $2 to $3
COOLIKO\/23: folds 
TheGentleFox: folds 
Kukuryzka: folds 
tipner: folds 
matiko09: folds 
Sweden_Pound: folds 
Uncalled bet ($2) returned to nuaxin
nuaxin collected $2.50 from pot
nuaxin: doesn't show hand 
*** SUMMARY ***
Total pot $2.50 | Rake $0 
Seat 1: Peu3aHy folded before Flop (didn't bet)
Seat 2: Dachish folded before Flop (didn't bet)
Seat 3: nuaxin collected ($2.50)
Seat 4: COOLIKO\/23 folded before Flop (didn't bet)
Seat 5: TheGentleFox folded before Flop (didn't bet)
Seat 6: Kukuryzka folded before Flop (didn't bet)
Seat 7: tipner (button) folded before Flop (didn't bet)
Seat 8: matiko09 (small blind) folded before Flop
Seat 9: Sweden_Pound (big blind) folded before Flop





PokerStars Hand #147754511037:  Hold'em No Limit ($0.50/$1.00 USD) - 2016/01/27 11:48:05 CET [2016/01/27 5:48:05 ET]
Table 'Henyey' 9-max Seat #8 is the button
Seat 1: COOLIKO\/23 ($100 in chips) 
Seat 2: pandalapa ($150.77 in chips) 
Seat 3: deepblue0000 ($120.11 in chips) 
Seat 5: matiko09 ($115.12 in chips) 
Seat 6: UShallGimme$ ($101.78 in chips) 
Seat 7: vinniej15 ($66.07 in chips) 
Seat 8: CoolFireX ($100 in chips) 
Seat 9: mycka86 ($136.13 in chips) 
mycka86: posts small blind $0.50
COOLIKO\/23: posts big blind $1
sylvian31: sits out 
*** HOLE CARDS ***
Dealt to matiko09 [Jc 9s]
pandalapa: folds 
deepblue0000: folds 
matiko09: folds 
UShallGimme$: folds 
vinniej15: calls $1
CoolFireX: folds 
mycka86: calls $0.50
COOLIKO\/23: checks 
*** FLOP *** [3c 9d 5d]
mycka86: checks 
COOLIKO\/23: checks 
vinniej15: checks 
*** TURN *** [3c 9d 5d] [7d]
mycka86: checks 
COOLIKO\/23: bets $2
vinniej15: folds 
mycka86: folds 
Uncalled bet ($2) returned to COOLIKO\/23
COOLIKO\/23 collected $2.86 from pot
COOLIKO\/23: doesn't show hand 
*** SUMMARY ***
Total pot $3 | Rake $0.14 
Board [3c 9d 5d 7d]
Seat 1: COOLIKO\/23 (big blind) collected ($2.86)
Seat 2: pandalapa folded before Flop (didn't bet)
Seat 3: deepblue0000 folded before Flop (didn't bet)
Seat 5: matiko09 folded before Flop (didn't bet)
Seat 6: UShallGimme$ folded before Flop (didn't bet)
Seat 7: vinniej15 folded on the Turn
Seat 8: CoolFireX (button) folded before Flop (didn't bet)
Seat 9: mycka86 (small blind) folded on the Turn





PokerStars Hand #147754511648:  Hold'em No Limit (€0.50/€1.00 EUR) - 2016/01/27 11:48:06 CET [2016/01/27 5:48:06 ET]
Table 'Carol' 9-max Seat #9 is the button
Seat 1: RoadtoNepal (€100 in chips) 
Seat 2: sylvian31 (€101.50 in chips) 
Seat 3: noname076 (€54.53 in chips) 
Seat 4: Flemishduck (€79 in chips) 
Seat 5: Proandi (€43.48 in chips) 
Seat 6: Kukuryzka (€100 in chips) 
Seat 7: tipner (€110.94 in chips) 
Seat 8: matiko09 (€100 in chips) 
Seat 9: Venomous100% (€101.50 in chips) 
RoadtoNepal: posts small blind €0.50
sylvian31: posts big blind €1
*** HOLE CARDS ***
Dealt to matiko09 [6c Th]
noname076: calls €1
Flemishduck: folds 
Proandi: raises €3 to €4
Kukuryzka: raises €18.50 to €22.50
tipner: folds 
matiko09: folds 
Venomous100%: folds 
RoadtoNepal: folds 
sylvian31: folds 
noname076: folds 
Proandi: raises €20.98 to €43.48 and is all-in
Kukuryzka: calls €20.98
*** FIRST FLOP *** [Kh Ts 8d]
*** FIRST TURN *** [Kh Ts 8d] [Qs]
*** FIRST RIVER *** [Kh Ts 8d Qs] [6s]
*** SECOND FLOP *** [6h 9h 4d]
*** SECOND TURN *** [6h 9h 4d] [Kd]
*** SECOND RIVER *** [6h 9h 4d Kd] [3h]
*** FIRST SHOW DOWN ***
Proandi: shows [Jc Jd] (a pair of Jacks)
Kukuryzka: shows [Qc As] (a pair of Queens)
Kukuryzka collected €43.66 from pot
*** SECOND SHOW DOWN ***
Proandi: shows [Jc Jd] (a pair of Jacks)
Kukuryzka: shows [Qc As] (high card Ace)
Proandi collected €43.65 from pot
*** SUMMARY ***
Total pot €89.46 | Rake €2.15 
Hand was run twice
FIRST Board [Kh Ts 8d Qs 6s]
SECOND Board [6h 9h 4d Kd 3h]
Seat 1: RoadtoNepal (small blind) folded before Flop
Seat 2: sylvian31 (big blind) folded before Flop
Seat 3: noname076 folded before Flop
Seat 4: Flemishduck folded before Flop (didn't bet)
Seat 5: Proandi showed [Jc Jd] and lost with a pair of Jacks, and won (€43.65) with a pair of Jacks
Seat 6: Kukuryzka showed [Qc As] and won (€43.66) with a pair of Queens, and lost with high card Ace
Seat 7: tipner folded before Flop (didn't bet)
Seat 8: matiko09 folded before Flop (didn't bet)
Seat 9: Venomous100% (button) folded before Flop (didn't bet)





PokerStars Hand #147754514435:  Hold'em No Limit ($0.50/$1.00 USD) - 2016/01/27 11:48:12 CET [2016/01/27 5:48:12 ET]
Table 'Alkmene II' 9-max Seat #8 is the button
Seat 1: matiko09 ($100 in chips) 
Seat 2: deepblue0000 ($100 in chips) 
Seat 4: CoolFireX ($149.07 in chips) 
Seat 5: Sweden_Pound ($115.55 in chips) 
Seat 6: Peu3aHy ($109.42 in chips) 
Seat 7: mycka86 ($106.50 in chips) 
Seat 8: fecsok1 ($119.88 in chips) 
Seat 9: pandalapa ($100 in chips) 
pandalapa: posts small blind $0.50
matiko09: posts big blind $1
di0d80: sits out 
*** HOLE CARDS ***
Dealt to matiko09 [3c Ad]
deepblue0000: folds 
CoolFireX: folds 
Sweden_Pound: folds 
Peu3aHy: folds 
mycka86: folds 
fecsok1: folds 
pandalapa: raises $1.20 to $2.20
matiko09: calls $1.20
*** FLOP *** [Ac Td 5d]
pandalapa: bets $2.79
matiko09: calls $2.79
*** TURN *** [Ac Td 5d] [9c]
pandalapa: bets $6.35
matiko09: calls $6.35
*** RIVER *** [Ac Td 5d 9c] [8d]
pandalapa: checks 
matiko09: checks 
*** SHOW DOWN ***
pandalapa: shows [5s As] (two pair, Aces and Fives)
matiko09: mucks hand 
pandalapa collected $21.66 from pot
*** SUMMARY ***
Total pot $22.68 | Rake $1.02 
Board [Ac Td 5d 9c 8d]
Seat 1: matiko09 (big blind) mucked [3c Ad]
Seat 2: deepblue0000 folded before Flop (didn't bet)
Seat 4: CoolFireX folded before Flop (didn't bet)
Seat 5: Sweden_Pound folded before Flop (didn't bet)
Seat 6: Peu3aHy folded before Flop (didn't bet)
Seat 7: mycka86 folded before Flop (didn't bet)
Seat 8: fecsok1 (button) folded before Flop (didn't bet)
Seat 9: pandalapa (small blind) showed [5s As] and won ($21.66) with two pair, Aces and Fives





PokerStars Hand #147754517399:  Hold'em No Limit ($0.50/$1.00 USD) - 2016/01/27 11:48:18 CET [2016/01/27 5:48:18 ET]
Table 'Fragaria II' 9-max Seat #3 is the button
Seat 1: deepblue0000 ($123.28 in chips) 
Seat 2: GG-NoR34D. ($82.37 in chips) 
Seat 3: Sweden_Pound ($122.24 in chips) 
Seat 4: AlKatrone ($100 in chips) 
Seat 5: Venomous100% ($105.12 in chips) 
Seat 6: UShallGimme$ ($181.49 in chips) 
Seat 7: Hobby-.-AK ($51.23 in chips) 
Seat 8: mycka86 ($109.60 in chips) 
Seat 9: matiko09 ($102 in chips) 
AlKatrone: posts small blind $0.50
Venomous100%: posts big blind $1
*** HOLE CARDS ***
Dealt to matiko09 [4h Ad]
UShallGimme$: folds 
Hobby-.-AK: folds 
mycka86: folds 
matiko09: folds 
deepblue0000: folds 
GG-NoR34D.: folds 
Sweden_Pound: raises $1 to $2
AlKatrone: raises $6 to $8
Venomous100%: folds 
Sweden_Pound: folds 
Uncalled bet ($6) returned to AlKatrone
AlKatrone collected $5 from pot
AlKatrone: doesn't show hand 
*** SUMMARY ***
Total pot $5 | Rake $0 
Seat 1: deepblue0000 folded before Flop (didn't bet)
Seat 2: GG-NoR34D. folded before Flop (didn't bet)
Seat 3: Sweden_Pound (button) folded before Flop
Seat 4: AlKatrone (small blind) collected ($5)
Seat 5: Venomous100% (big blind) folded before Flop
Seat 6: UShallGimme$ folded before Flop (didn't bet)
Seat 7: Hobby-.-AK folded before Flop (didn't bet)
Seat 8: mycka86 folded before Flop (didn't bet)
Seat 9: matiko09 folded before Flop (didn't bet)





PokerStars Hand #147754526196:  Hold'em No Limit ($0.50/$1.00 USD) - 2016/01/27 11:48:35 CET [2016/01/27 5:48:35 ET]
Table 'Nanking' 9-max Seat #8 is the button
Seat 1: Peu3aHy ($100 in chips) 
Seat 2: Dachish ($100.67 in chips) 
Seat 3: nuaxin ($53.44 in chips) 
Seat 4: COOLIKO\/23 ($161.54 in chips) 
Seat 5: TheGentleFox ($109.57 in chips) 
Seat 6: Kukuryzka ($108.03 in chips) 
Seat 7: tipner ($100 in chips) 
Seat 8: matiko09 ($100 in chips) 
Seat 9: Sweden_Pound ($134.72 in chips) 
Sweden_Pound: posts small blind $0.50
Peu3aHy: posts big blind $1
*** HOLE CARDS ***
Dealt to matiko09 [5c 7c]
Dachish: folds 
nuaxin: folds 
COOLIKO\/23: folds 
TheGentleFox: raises $1 to $2
Kukuryzka: folds 
tipner: folds 
matiko09: folds 
Sweden_Pound: raises $4 to $6
Peu3aHy: folds 
TheGentleFox: folds 
Uncalled bet ($4) returned to Sweden_Pound
Sweden_Pound collected $5 from pot
Sweden_Pound: doesn't show hand 
*** SUMMARY ***
Total pot $5 | Rake $0 
Seat 1: Peu3aHy (big blind) folded before Flop
Seat 2: Dachish folded before Flop (didn't bet)
Seat 3: nuaxin folded before Flop (didn't bet)
Seat 4: COOLIKO\/23 folded before Flop (didn't bet)
Seat 5: TheGentleFox folded before Flop
Seat 6: Kukuryzka folded before Flop (didn't bet)
Seat 7: tipner folded before Flop (didn't bet)
Seat 8: matiko09 (button) folded before Flop (didn't bet)
Seat 9: Sweden_Pound (small blind) collected ($5)





PokerStars Hand #147754528982:  Hold'em No Limit ($0.50/$1.00 USD) - 2016/01/27 11:48:41 CET [2016/01/27 5:48:41 ET]
Table 'Alhajoth' 9-max Seat #2 is the button
Seat 1: UShallGimme$ ($152.95 in chips) 
Seat 2: matiko09 ($100 in chips) 
Seat 3: Sweden_Pound ($116.77 in chips) 
Seat 4: Venomous100% ($127.37 in chips) 
Seat 5: Kukuryzka ($105.66 in chips) 
Seat 6: RoadtoNepal ($182.80 in chips) 
Seat 7: Ohpeel ($122.32 in chips) 
Seat 8: deepblue0000 ($121.68 in chips) 
Seat 9: di0d80 ($100 in chips) 
Sweden_Pound: posts small blind $0.50
Venomous100%: posts big blind $1
*** HOLE CARDS ***
Dealt to matiko09 [6c 2h]
Kukuryzka: folds 
RoadtoNepal: raises $2 to $3
Ohpeel: folds 
deepblue0000: folds 
di0d80: folds 
UShallGimme$: folds 
matiko09: folds 
Sweden_Pound: folds 
Venomous100%: folds 
Uncalled bet ($2) returned to RoadtoNepal
RoadtoNepal collected $2.50 from pot
RoadtoNepal: doesn't show hand 
*** SUMMARY ***
Total pot $2.50 | Rake $0 
Seat 1: UShallGimme$ folded before Flop (didn't bet)
Seat 2: matiko09 (button) folded before Flop (didn't bet)
Seat 3: Sweden_Pound (small blind) folded before Flop
Seat 4: Venomous100% (big blind) folded before Flop
Seat 5: Kukuryzka folded before Flop (didn't bet)
Seat 6: RoadtoNepal collected ($2.50)
Seat 7: Ohpeel folded before Flop (didn't bet)
Seat 8: deepblue0000 folded before Flop (didn't bet)
Seat 9: di0d80 folded before Flop (didn't bet)





PokerStars Hand #147754535937:  Hold'em No Limit ($0.50/$1.00 USD) - 2016/01/27 11:48:54 CET [2016/01/27 5:48:54 ET]
Table 'Delphinus II' 9-max Seat #5 is the button
Seat 1: Saintreine ($143.61 in chips) 
Seat 2: AlKatrone ($198.52 in chips) 
Seat 3: deepblue0000 ($330.98 in chips) 
Seat 4: matiko09 ($121.73 in chips) 
Seat 5: pandalapa ($108.14 in chips) 
Seat 6: Sweden_Pound ($122.14 in chips) 
Seat 7: RUS)Timur ($100 in chips) 
Seat 8: mycka86 ($101.20 in chips) 
Seat 9: FGL-lucky ($51.38 in chips) 
Sweden_Pound: posts small blind $0.50
RUS)Timur: posts big blind $1
*** HOLE CARDS ***
Dealt to matiko09 [4h 8c]
mycka86: folds 
FGL-lucky: folds 
Saintreine: folds 
AlKatrone: folds 
deepblue0000: folds 
matiko09: folds 
pandalapa: folds 
Sweden_Pound: raises $2 to $3
RUS)Timur: folds 
Uncalled bet ($2) returned to Sweden_Pound
Sweden_Pound collected $2 from pot
Sweden_Pound: doesn't show hand 
*** SUMMARY ***
Total pot $2 | Rake $0 
Seat 1: Saintreine folded before Flop (didn't bet)
Seat 2: AlKatrone folded before Flop (didn't bet)
Seat 3: deepblue0000 folded before Flop (didn't bet)
Seat 4: matiko09 folded before Flop (didn't bet)
Seat 5: pandalapa (button) folded before Flop (didn't bet)
Seat 6: Sweden_Pound (small blind) collected ($2)
Seat 7: RUS)Timur (big blind) folded before Flop
Seat 8: mycka86 folded before Flop (didn't bet)
Seat 9: FGL-lucky folded before Flop (didn't bet)





PokerStars Hand #147754540872:  Hold'em No Limit (€0.50/€1.00 EUR) - 2016/01/27 11:49:04 CET [2016/01/27 5:49:04 ET]
Table 'Carol' 9-max Seat #1 is the button
Seat 1: RoadtoNepal (€100 in chips) 
Seat 2: sylvian31 (€100.50 in chips) 
Seat 3: noname076 (€53.53 in chips) 
Seat 4: Flemishduck (€79 in chips) 
Seat 5: Proandi (€43.65 in chips) 
Seat 6: Kukuryzka (€100.18 in chips) 
Seat 7: tipner (€110.94 in chips) 
Seat 8: matiko09 (€100 in chips) 
Seat 9: Venomous100% (€101.50 in chips) 
sylvian31: posts small blind €0.50
noname076: posts big blind €1
*** HOLE CARDS ***
Dealt to matiko09 [Jd 8d]
Flemishduck: raises €1 to €2
Proandi: folds 
Kukuryzka: raises €5 to €7
tipner: folds 
matiko09: folds 
Venomous100%: folds 
RoadtoNepal: folds 
sylvian31: folds 
noname076: folds 
Flemishduck: calls €5
*** FLOP *** [Td Ah 4h]
Flemishduck: checks 
Kukuryzka: bets €11.10
Flemishduck: raises €60.90 to €72 and is all-in
Kukuryzka: calls €60.90
*** TURN *** [Td Ah 4h] [Qd]
*** RIVER *** [Td Ah 4h Qd] [2c]
*** SHOW DOWN ***
Flemishduck: shows [Jh Ad] (a pair of Aces)
Kukuryzka: shows [Qc As] (two pair, Aces and Queens)
Kukuryzka collected €157.35 from pot
*** SUMMARY ***
Total pot €159.50 | Rake €2.15 
Board [Td Ah 4h Qd 2c]
Seat 1: RoadtoNepal (button) folded before Flop (didn't bet)
Seat 2: sylvian31 (small blind) folded before Flop
Seat 3: noname076 (big blind) folded before Flop
Seat 4: Flemishduck showed [Jh Ad] and lost with a pair of Aces
Seat 5: Proandi folded before Flop (didn't bet)
Seat 6: Kukuryzka showed [Qc As] and won (€157.35) with two pair, Aces and Queens
Seat 7: tipner folded before Flop (didn't bet)
Seat 8: matiko09 folded before Flop (didn't bet)
Seat 9: Venomous100% folded before Flop (didn't bet)





PokerStars Hand #147754542823:  Hold'em No Limit ($0.50/$1.00 USD) - 2016/01/27 11:49:08 CET [2016/01/27 5:49:08 ET]
Table 'Fragaria II' 9-max Seat #4 is the button
Seat 1: deepblue0000 ($123.28 in chips) 
Seat 2: GG-NoR34D. ($82.37 in chips) 
Seat 3: Sweden_Pound ($120.24 in chips) 
Seat 4: AlKatrone ($103 in chips) 
Seat 5: Venomous100% ($104.12 in chips) 
Seat 6: UShallGimme$ ($181.49 in chips) 
Seat 7: Hobby-.-AK ($51.23 in chips) 
Seat 8: mycka86 ($109.60 in chips) 
Seat 9: matiko09 ($102 in chips) 
Venomous100%: posts small blind $0.50
UShallGimme$: posts big blind $1
*** HOLE CARDS ***
Dealt to matiko09 [7c 6s]
Hobby-.-AK: folds 
mycka86: folds 
matiko09: folds 
deepblue0000: folds 
GG-NoR34D.: calls $1
Sweden_Pound: raises $3 to $4
AlKatrone: folds 
Venomous100%: raises $3 to $7
UShallGimme$: folds 
GG-NoR34D.: folds 
Sweden_Pound: calls $3
*** FLOP *** [Kc 9c 3d]
Venomous100%: bets $10.08
Sweden_Pound: calls $10.08
*** TURN *** [Kc 9c 3d] [Jc]
Venomous100%: bets $17.26
Sweden_Pound: raises $85.90 to $103.16 and is all-in
Venomous100%: calls $69.78 and is all-in
Uncalled bet ($16.12) returned to Sweden_Pound
*** FIRST RIVER *** [Kc 9c 3d Jc] [Ts]
*** SECOND RIVER *** [Kc 9c 3d Jc] [Jh]
*** FIRST SHOW DOWN ***
Venomous100%: shows [9s 9d] (three of a kind, Nines)
Sweden_Pound: shows [Kh Js] (two pair, Kings and Jacks)
Venomous100% collected $103.72 from pot
*** SECOND SHOW DOWN ***
Venomous100%: shows [9s 9d] (a full house, Nines full of Jacks)
Sweden_Pound: shows [Kh Js] (a full house, Jacks full of Kings)
Sweden_Pound collected $103.72 from pot
*** SUMMARY ***
Total pot $210.24 | Rake $2.80 
Hand was run twice
FIRST Board [Kc 9c 3d Jc Ts]
SECOND Board [Kc 9c 3d Jc Jh]
Seat 1: deepblue0000 folded before Flop (didn't bet)
Seat 2: GG-NoR34D. folded before Flop
Seat 3: Sweden_Pound showed [Kh Js] and lost with two pair, Kings and Jacks, and won ($103.72) with a full house, Jacks full of Kings
Seat 4: AlKatrone (button) folded before Flop (didn't bet)
Seat 5: Venomous100% (small blind) showed [9s 9d] and won ($103.72) with three of a kind, Nines, and lost with a full house, Nines full of Jacks
Seat 6: UShallGimme$ (big blind) folded before Flop
Seat 7: Hobby-.-AK folded before Flop (didn't bet)
Seat 8: mycka86 folded before Flop (didn't bet)
Seat 9: matiko09 folded before Flop (didn't bet)





PokerStars Hand #147754546682:  Hold'em No Limit ($0.50/$1.00 USD) - 2016/01/27 11:49:16 CET [2016/01/27 5:49:16 ET]
Table 'Nanking' 9-max Seat #9 is the button
Seat 1: Peu3aHy ($100 in chips) 
Seat 2: Dachish ($100.67 in chips) 
Seat 3: nuaxin ($53.44 in chips) 
Seat 4: COOLIKO\/23 ($161.54 in chips) 
Seat 5: TheGentleFox ($107.57 in chips) 
Seat 6: Kukuryzka ($108.03 in chips) 
Seat 7: tipner ($100 in chips) 
Seat 8: matiko09 ($100 in chips) 
Seat 9: Sweden_Pound ($137.72 in chips) 
Peu3aHy: posts small blind $0.50
Dachish: posts big blind $1
*** HOLE CARDS ***
Dealt to matiko09 [6c 8h]
nuaxin: folds 
COOLIKO\/23: folds 
TheGentleFox: folds 
Kukuryzka: folds 
tipner: folds 
matiko09: folds 
Sweden_Pound: raises $1 to $2
Peu3aHy: folds 
Dachish: folds 
Uncalled bet ($1) returned to Sweden_Pound
Sweden_Pound collected $2.50 from pot
Sweden_Pound: doesn't show hand 
*** SUMMARY ***
Total pot $2.50 | Rake $0 
Seat 1: Peu3aHy (small blind) folded before Flop
Seat 2: Dachish (big blind) folded before Flop
Seat 3: nuaxin folded before Flop (didn't bet)
Seat 4: COOLIKO\/23 folded before Flop (didn't bet)
Seat 5: TheGentleFox folded before Flop (didn't bet)
Seat 6: Kukuryzka folded before Flop (didn't bet)
Seat 7: tipner folded before Flop (didn't bet)
Seat 8: matiko09 folded before Flop (didn't bet)
Seat 9: Sweden_Pound (button) collected ($2.50)





PokerStars Hand #147754549391:  Hold'em No Limit ($1/$2 USD) - 2016/01/27 11:49:21 CET [2016/01/27 5:49:21 ET]
Table 'Phobos II' 9-max Seat #9 is the button
Seat 1: LRV21 ($405.14 in chips) 
Seat 2: di0d80 ($246.22 in chips) 
Seat 4: flk.Dasas ($314.18 in chips) 
Seat 5: tipner ($200 in chips) 
Seat 6: matiko09 ($203 in chips) 
Seat 7: Venomous100% ($291.42 in chips) 
Seat 8: RoadtoNepal ($248.54 in chips) 
Seat 9: Kukuryzka ($370.03 in chips) 
LRV21: posts small blind $1
di0d80: posts big blind $2
sylvian31: sits out 
*** HOLE CARDS ***
Dealt to matiko09 [As Qd]
flk.Dasas: folds 
tipner: folds 
matiko09: raises $4 to $6
Venomous100%: calls $6
RoadtoNepal: calls $6
Kukuryzka: folds 
LRV21: calls $5
di0d80: folds 
*** FLOP *** [3s Js Qs]
LRV21: checks 
matiko09: bets $16.13
Venomous100%: folds 
RoadtoNepal: folds 
LRV21: folds 
Uncalled bet ($16.13) returned to matiko09
matiko09 collected $24.83 from pot
matiko09: doesn't show hand 
*** SUMMARY ***
Total pot $26 | Rake $1.17 
Board [3s Js Qs]
Seat 1: LRV21 (small blind) folded on the Flop
Seat 2: di0d80 (big blind) folded before Flop
Seat 4: flk.Dasas folded before Flop (didn't bet)
Seat 5: tipner folded before Flop (didn't bet)
Seat 6: matiko09 collected ($24.83)
Seat 7: Venomous100% folded on the Flop
Seat 8: RoadtoNepal folded on the Flop
Seat 9: Kukuryzka (button) folded before Flop (didn't bet)





PokerStars Hand #147754548978:  Hold'em No Limit ($0.50/$1.00 USD) - 2016/01/27 11:49:21 CET [2016/01/27 5:49:21 ET]
Table 'Dollfus' 9-max Seat #8 is the button
Seat 2: nosoant ($99.81 in chips) 
Seat 3: UShallGimme$ ($100 in chips) 
Seat 4: matiko09 ($119.05 in chips) 
Seat 5: pandalapa ($221.98 in chips) 
Seat 6: deepblue0000 ($100 in chips) 
Seat 7: Dödi123 ($209.72 in chips) 
Seat 8: Venomous100% ($114.75 in chips) 
Seat 9: COOLIKO\/23 ($100 in chips) 
COOLIKO\/23: posts small blind $0.50
nosoant: posts big blind $1
*** HOLE CARDS ***
Dealt to matiko09 [4d Th]
UShallGimme$: folds 
matiko09: folds 
pandalapa: folds 
deepblue0000: folds 
Dödi123: folds 
Venomous100%: raises $1 to $2
COOLIKO\/23: folds 
nosoant: calls $1
*** FLOP *** [7h 2h 7s]
nosoant: checks 
Venomous100%: bets $2.84
nosoant: calls $2.84
*** TURN *** [7h 2h 7s] [8c]
nosoant: checks 
Venomous100%: bets $7.29
nosoant: calls $7.29
*** RIVER *** [7h 2h 7s 8c] [5d]
nosoant: checks 
Venomous100%: bets $17.73
nosoant: folds 
Uncalled bet ($17.73) returned to Venomous100%
Venomous100% collected $23.65 from pot
Venomous100%: doesn't show hand 
*** SUMMARY ***
Total pot $24.76 | Rake $1.11 
Board [7h 2h 7s 8c 5d]
Seat 2: nosoant (big blind) folded on the River
Seat 3: UShallGimme$ folded before Flop (didn't bet)
Seat 4: matiko09 folded before Flop (didn't bet)
Seat 5: pandalapa folded before Flop (didn't bet)
Seat 6: deepblue0000 folded before Flop (didn't bet)
Seat 7: Dödi123 folded before Flop (didn't bet)
Seat 8: Venomous100% (button) collected ($23.65)
Seat 9: COOLIKO\/23 (small blind) folded before Flop





PokerStars Hand #147754550041:  Hold'em No Limit ($0.50/$1.00 USD) - 2016/01/27 11:49:23 CET [2016/01/27 5:49:23 ET]
Table 'Alhajoth' 9-max Seat #3 is the button
Seat 1: UShallGimme$ ($152.95 in chips) 
Seat 2: matiko09 ($100 in chips) 
Seat 3: Sweden_Pound ($116.27 in chips) 
Seat 4: Venomous100% ($126.37 in chips) 
Seat 5: Kukuryzka ($105.66 in chips) 
Seat 6: RoadtoNepal ($184.30 in chips) 
Seat 7: Ohpeel ($122.32 in chips) 
Seat 8: deepblue0000 ($121.68 in chips) 
Seat 9: di0d80 ($100 in chips) 
Venomous100%: posts small blind $0.50
Kukuryzka: posts big blind $1
*** HOLE CARDS ***
Dealt to matiko09 [4d 3h]
RoadtoNepal: folds 
Ohpeel: calls $1
deepblue0000: folds 
di0d80: folds 
UShallGimme$: raises $3 to $4
matiko09: folds 
Sweden_Pound: folds 
Venomous100%: folds 
Kukuryzka: folds 
Ohpeel: calls $3
*** FLOP *** [8c 7s 6s]
Ohpeel: checks 
UShallGimme$: bets $6
Ohpeel: raises $6 to $12
UShallGimme$: calls $6
*** TURN *** [8c 7s 6s] [Qd]
Ohpeel: bets $20
UShallGimme$: folds 
Uncalled bet ($20) returned to Ohpeel
Ohpeel collected $31.99 from pot
Ohpeel: doesn't show hand 
*** SUMMARY ***
Total pot $33.50 | Rake $1.51 
Board [8c 7s 6s Qd]
Seat 1: UShallGimme$ folded on the Turn
Seat 2: matiko09 folded before Flop (didn't bet)
Seat 3: Sweden_Pound (button) folded before Flop (didn't bet)
Seat 4: Venomous100% (small blind) folded before Flop
Seat 5: Kukuryzka (big blind) folded before Flop
Seat 6: RoadtoNepal folded before Flop (didn't bet)
Seat 7: Ohpeel collected ($31.99)
Seat 8: deepblue0000 folded before Flop (didn't bet)
Seat 9: di0d80 folded before Flop (didn't bet)





PokerStars Hand #147754551340:  Hold'em No Limit ($0.50/$1.00 USD) - 2016/01/27 11:49:25 CET [2016/01/27 5:49:25 ET]
Table 'Delphinus II' 9-max Seat #6 is the button
Seat 1: Saintreine ($143.61 in chips) 
Seat 2: AlKatrone ($198.52 in chips) 
Seat 3: deepblue0000 ($330.98 in chips) 
Seat 4: matiko09 ($121.73 in chips) 
Seat 5: pandalapa ($108.14 in chips) 
Seat 6: Sweden_Pound ($123.14 in chips) 
Seat 7: RUS)Timur ($100 in chips) 
Seat 8: mycka86 ($101.20 in chips) 
Seat 9: FGL-lucky ($51.38 in chips) 
RUS)Timur: posts small blind $0.50
mycka86: posts big blind $1
*** HOLE CARDS ***
Dealt to matiko09 [9h 4d]
FGL-lucky: folds 
Saintreine: folds 
AlKatrone: folds 
deepblue0000: folds 
matiko09: folds 
pandalapa: folds 
Sweden_Pound: raises $1 to $2
RUS)Timur: folds 
mycka86: folds 
Uncalled bet ($1) returned to Sweden_Pound
Sweden_Pound collected $2.50 from pot
Sweden_Pound: doesn't show hand 
*** SUMMARY ***
Total pot $2.50 | Rake $0 
Seat 1: Saintreine folded before Flop (didn't bet)
Seat 2: AlKatrone folded before Flop (didn't bet)
Seat 3: deepblue0000 folded before Flop (didn't bet)
Seat 4: matiko09 folded before Flop (didn't bet)
Seat 5: pandalapa folded before Flop (didn't bet)
Seat 6: Sweden_Pound (button) collected ($2.50)
Seat 7: RUS)Timur (small blind) folded before Flop
Seat 8: mycka86 (big blind) folded before Flop
Seat 9: FGL-lucky folded before Flop (didn't bet)





PokerStars Hand #147754555068:  Hold'em No Limit ($0.50/$1.00 USD) - 2016/01/27 11:49:33 CET [2016/01/27 5:49:33 ET]
Table 'Alkmene II' 9-max Seat #9 is the button
Seat 1: matiko09 ($100 in chips) 
Seat 2: deepblue0000 ($100 in chips) 
Seat 4: CoolFireX ($149.07 in chips) 
Seat 5: Sweden_Pound ($115.55 in chips) 
Seat 6: Peu3aHy ($109.42 in chips) 
Seat 7: mycka86 ($106.50 in chips) 
Seat 8: fecsok1 ($119.88 in chips) 
Seat 9: pandalapa ($110.32 in chips) 
matiko09: posts small blind $0.50
deepblue0000: posts big blind $1
di0d80: sits out 
*** HOLE CARDS ***
Dealt to matiko09 [5s Ad]
CoolFireX: raises $2 to $3
Sweden_Pound: folds 
Peu3aHy: folds 
mycka86: folds 
fecsok1: folds 
pandalapa: folds 
matiko09: folds 
deepblue0000: folds 
Uncalled bet ($2) returned to CoolFireX
CoolFireX collected $2.50 from pot
CoolFireX: doesn't show hand 
*** SUMMARY ***
Total pot $2.50 | Rake $0 
Seat 1: matiko09 (small blind) folded before Flop
Seat 2: deepblue0000 (big blind) folded before Flop
Seat 4: CoolFireX collected ($2.50)
Seat 5: Sweden_Pound folded before Flop (didn't bet)
Seat 6: Peu3aHy folded before Flop (didn't bet)
Seat 7: mycka86 folded before Flop (didn't bet)
Seat 8: fecsok1 folded before Flop (didn't bet)
Seat 9: pandalapa (button) folded before Flop (didn't bet)





PokerStars Hand #147754563604:  Hold'em No Limit ($0.50/$1.00 USD) - 2016/01/27 11:49:50 CET [2016/01/27 5:49:50 ET]
Table 'Nanking' 9-max Seat #1 is the button
Seat 1: Peu3aHy ($100 in chips) 
Seat 2: Dachish ($99.67 in chips) 
Seat 3: nuaxin ($53.44 in chips) 
Seat 4: COOLIKO\/23 ($161.54 in chips) 
Seat 5: TheGentleFox ($107.57 in chips) 
Seat 6: Kukuryzka ($108.03 in chips) 
Seat 7: tipner ($100 in chips) 
Seat 8: matiko09 ($100 in chips) 
Seat 9: Sweden_Pound ($139.22 in chips) 
Dachish: posts small blind $0.50
nuaxin: posts big blind $1
*** HOLE CARDS ***
Dealt to matiko09 [Qd 3s]
COOLIKO\/23: folds 
TheGentleFox: folds 
Kukuryzka: folds 
tipner: folds 
matiko09: folds 
Sweden_Pound: folds 
Peu3aHy: raises $2 to $3
Dachish: folds 
nuaxin: folds 
Uncalled bet ($2) returned to Peu3aHy
Peu3aHy collected $2.50 from pot
Peu3aHy: doesn't show hand 
*** SUMMARY ***
Total pot $2.50 | Rake $0 
Seat 1: Peu3aHy (button) collected ($2.50)
Seat 2: Dachish (small blind) folded before Flop
Seat 3: nuaxin (big blind) folded before Flop
Seat 4: COOLIKO\/23 folded before Flop (didn't bet)
Seat 5: TheGentleFox folded before Flop (didn't bet)
Seat 6: Kukuryzka folded before Flop (didn't bet)
Seat 7: tipner folded before Flop (didn't bet)
Seat 8: matiko09 folded before Flop (didn't bet)
Seat 9: Sweden_Pound folded before Flop (didn't bet)





PokerStars Hand #147754566936:  Hold'em No Limit ($0.50/$1.00 USD) - 2016/01/27 11:49:56 CET [2016/01/27 5:49:56 ET]
Table 'Henyey' 9-max Seat #9 is the button
Seat 1: COOLIKO\/23 ($101.86 in chips) 
Seat 2: pandalapa ($150.77 in chips) 
Seat 3: deepblue0000 ($120.11 in chips) 
Seat 5: matiko09 ($115.12 in chips) 
Seat 6: UShallGimme$ ($101.78 in chips) 
Seat 7: vinniej15 ($65.07 in chips) 
Seat 8: CoolFireX ($100 in chips) 
Seat 9: mycka86 ($135.13 in chips) 
COOLIKO\/23: posts small blind $0.50
pandalapa: posts big blind $1
sylvian31: sits out 
*** HOLE CARDS ***
Dealt to matiko09 [9h 7h]
deepblue0000: raises $2 to $3
matiko09: folds 
UShallGimme$: folds 
vinniej15: folds 
CoolFireX: folds 
mycka86: folds 
COOLIKO\/23: raises $7 to $10
pandalapa: folds 
deepblue0000: calls $7
*** FLOP *** [Qh 9s Ks]
COOLIKO\/23: bets $15
deepblue0000: calls $15
*** TURN *** [Qh 9s Ks] [8h]
COOLIKO\/23: bets $32
deepblue0000: folds 
Uncalled bet ($32) returned to COOLIKO\/23
COOLIKO\/23 collected $48.70 from pot
COOLIKO\/23: doesn't show hand 
*** SUMMARY ***
Total pot $51 | Rake $2.30 
Board [Qh 9s Ks 8h]
Seat 1: COOLIKO\/23 (small blind) collected ($48.70)
Seat 2: pandalapa (big blind) folded before Flop
Seat 3: deepblue0000 folded on the Turn
Seat 5: matiko09 folded before Flop (didn't bet)
Seat 6: UShallGimme$ folded before Flop (didn't bet)
Seat 7: vinniej15 folded before Flop (didn't bet)
Seat 8: CoolFireX folded before Flop (didn't bet)
Seat 9: mycka86 (button) folded before Flop (didn't bet)





PokerStars Hand #147754571719:  Hold'em No Limit ($0.50/$1.00 USD) - 2016/01/27 11:50:05 CET [2016/01/27 5:50:05 ET]
Table 'Delphinus II' 9-max Seat #7 is the button
Seat 1: Saintreine ($143.61 in chips) 
Seat 2: AlKatrone ($198.52 in chips) 
Seat 3: deepblue0000 ($330.98 in chips) 
Seat 4: matiko09 ($121.73 in chips) 
Seat 5: pandalapa ($108.14 in chips) 
Seat 6: Sweden_Pound ($124.64 in chips) 
Seat 7: RUS)Timur ($100 in chips) 
Seat 8: mycka86 ($100.20 in chips) 
Seat 9: FGL-lucky ($51.38 in chips) 
mycka86: posts small blind $0.50
FGL-lucky: posts big blind $1
*** HOLE CARDS ***
Dealt to matiko09 [9d 7d]
Saintreine: folds 
AlKatrone: folds 
deepblue0000: raises $2 to $3
matiko09: folds 
pandalapa: folds 
Sweden_Pound: folds 
RUS)Timur: folds 
mycka86: folds 
FGL-lucky: folds 
Uncalled bet ($2) returned to deepblue0000
deepblue0000 collected $2.50 from pot
*** SUMMARY ***
Total pot $2.50 | Rake $0 
Seat 1: Saintreine folded before Flop (didn't bet)
Seat 2: AlKatrone folded before Flop (didn't bet)
Seat 3: deepblue0000 collected ($2.50)
Seat 4: matiko09 folded before Flop (didn't bet)
Seat 5: pandalapa folded before Flop (didn't bet)
Seat 6: Sweden_Pound folded before Flop (didn't bet)
Seat 7: RUS)Timur (button) folded before Flop (didn't bet)
Seat 8: mycka86 (small blind) folded before Flop
Seat 9: FGL-lucky (big blind) folded before Flop





PokerStars Hand #147754574703:  Hold'em No Limit ($1/$2 USD) - 2016/01/27 11:50:11 CET [2016/01/27 5:50:11 ET]
Table 'Phobos II' 9-max Seat #1 is the button
Seat 1: LRV21 ($399.14 in chips) 
Seat 2: di0d80 ($244.22 in chips) 
Seat 3: sylvian31 ($202.44 in chips) 
Seat 4: flk.Dasas ($314.18 in chips) 
Seat 5: tipner ($200 in chips) 
Seat 6: matiko09 ($221.83 in chips) 
Seat 7: Venomous100% ($285.42 in chips) 
Seat 8: RoadtoNepal ($242.54 in chips) 
Seat 9: Kukuryzka ($370.03 in chips) 
di0d80: posts small blind $1
sylvian31: posts big blind $2
*** HOLE CARDS ***
Dealt to matiko09 [Ah Ks]
flk.Dasas: folds 
tipner: folds 
matiko09: raises $4 to $6
Venomous100%: folds 
RoadtoNepal: folds 
Kukuryzka: folds 
LRV21: calls $6
di0d80: folds 
sylvian31: folds 
*** FLOP *** [Td Qs 3s]
matiko09: bets $8.21
LRV21: folds 
Uncalled bet ($8.21) returned to matiko09
matiko09 collected $14.32 from pot
matiko09: doesn't show hand 
*** SUMMARY ***
Total pot $15 | Rake $0.68 
Board [Td Qs 3s]
Seat 1: LRV21 (button) folded on the Flop
Seat 2: di0d80 (small blind) folded before Flop
Seat 3: sylvian31 (big blind) folded before Flop
Seat 4: flk.Dasas folded before Flop (didn't bet)
Seat 5: tipner folded before Flop (didn't bet)
Seat 6: matiko09 collected ($14.32)
Seat 7: Venomous100% folded before Flop (didn't bet)
Seat 8: RoadtoNepal folded before Flop (didn't bet)
Seat 9: Kukuryzka folded before Flop (didn't bet)





PokerStars Hand #147754577366:  Hold'em No Limit ($0.50/$1.00 USD) - 2016/01/27 11:50:17 CET [2016/01/27 5:50:17 ET]
Table 'Alkmene II' 9-max Seat #1 is the button
Seat 1: matiko09 ($100 in chips) 
Seat 2: deepblue0000 ($100 in chips) 
Seat 3: di0d80 ($100 in chips) 
Seat 4: CoolFireX ($150.57 in chips) 
Seat 5: Sweden_Pound ($115.55 in chips) 
Seat 6: Peu3aHy ($109.42 in chips) 
Seat 7: mycka86 ($106.50 in chips) 
Seat 8: fecsok1 ($119.88 in chips) 
Seat 9: pandalapa ($110.32 in chips) 
deepblue0000: posts small blind $0.50
di0d80: posts big blind $1
*** HOLE CARDS ***
Dealt to matiko09 [Th Qd]
CoolFireX: folds 
Sweden_Pound: folds 
Peu3aHy: raises $2 to $3
mycka86: calls $3
fecsok1: folds 
pandalapa: folds 
matiko09: folds 
deepblue0000: folds 
di0d80: folds 
*** FLOP *** [Kc 6d Kh]
Peu3aHy: checks 
mycka86: checks 
*** TURN *** [Kc 6d Kh] [2c]
Peu3aHy: bets $4
mycka86: calls $4
*** RIVER *** [Kc 6d Kh 2c] [Js]
Peu3aHy: checks 
mycka86: checks 
*** SHOW DOWN ***
Peu3aHy: shows [8c 8d] (two pair, Kings and Eights)
mycka86: mucks hand 
Peu3aHy collected $14.80 from pot
*** SUMMARY ***
Total pot $15.50 | Rake $0.70 
Board [Kc 6d Kh 2c Js]
Seat 1: matiko09 (button) folded before Flop (didn't bet)
Seat 2: deepblue0000 (small blind) folded before Flop
Seat 3: di0d80 (big blind) folded before Flop
Seat 4: CoolFireX folded before Flop (didn't bet)
Seat 5: Sweden_Pound folded before Flop (didn't bet)
Seat 6: Peu3aHy showed [8c 8d] and won ($14.80) with two pair, Kings and Eights
Seat 7: mycka86 mucked [Qc Ad]
Seat 8: fecsok1 folded before Flop (didn't bet)
Seat 9: pandalapa folded before Flop (didn't bet)





PokerStars Hand #147754578099:  Hold'em No Limit (€0.50/€1.00 EUR) - 2016/01/27 11:50:18 CET [2016/01/27 5:50:18 ET]
Table 'Carol' 9-max Seat #2 is the button
Seat 1: RoadtoNepal (€100 in chips) 
Seat 2: sylvian31 (€100 in chips) 
Seat 3: noname076 (€52.53 in chips) 
Seat 5: Proandi (€43.65 in chips) 
Seat 6: Kukuryzka (€178.53 in chips) 
Seat 7: tipner (€110.94 in chips) 
Seat 8: matiko09 (€100 in chips) 
Seat 9: Venomous100% (€101.50 in chips) 
noname076: posts small blind €0.50
Proandi: posts big blind €1
*** HOLE CARDS ***
Dealt to matiko09 [4h Ks]
Flemishduck leaves the table
Kukuryzka: folds 
tipner: folds 
Sweden_Pound joins the table at seat #4 
matiko09: folds 
Venomous100%: folds 
RoadtoNepal: folds 
sylvian31: raises €1.50 to €2.50
noname076: folds 
Proandi: folds 
Uncalled bet (€1.50) returned to sylvian31
sylvian31 collected €2.50 from pot
sylvian31: doesn't show hand 
*** SUMMARY ***
Total pot €2.50 | Rake €0 
Seat 1: RoadtoNepal folded before Flop (didn't bet)
Seat 2: sylvian31 (button) collected (€2.50)
Seat 3: noname076 (small blind) folded before Flop
Seat 5: Proandi (big blind) folded before Flop
Seat 6: Kukuryzka folded before Flop (didn't bet)
Seat 7: tipner folded before Flop (didn't bet)
Seat 8: matiko09 folded before Flop (didn't bet)
Seat 9: Venomous100% folded before Flop (didn't bet)





PokerStars Hand #147754580372:  Hold'em No Limit ($0.50/$1.00 USD) - 2016/01/27 11:50:23 CET [2016/01/27 5:50:23 ET]
Table 'Nanking' 9-max Seat #2 is the button
Seat 1: Peu3aHy ($101.50 in chips) 
Seat 2: Dachish ($99.17 in chips) 
Seat 3: nuaxin ($52.44 in chips) 
Seat 4: COOLIKO\/23 ($161.54 in chips) 
Seat 5: TheGentleFox ($107.57 in chips) 
Seat 6: Kukuryzka ($108.03 in chips) 
Seat 7: tipner ($100 in chips) 
Seat 8: matiko09 ($100 in chips) 
Seat 9: Sweden_Pound ($139.22 in chips) 
nuaxin: posts small blind $0.50
COOLIKO\/23: posts big blind $1
*** HOLE CARDS ***
Dealt to matiko09 [Qc Jc]
TheGentleFox: folds 
Kukuryzka: folds 
tipner: raises $2 to $3
matiko09: folds 
Sweden_Pound: folds 
Peu3aHy: calls $3
Dachish: folds 
nuaxin: folds 
COOLIKO\/23: folds 
*** FLOP *** [Tc 5c 4h]
tipner: checks 
Peu3aHy: bets $4
tipner: calls $4
*** TURN *** [Tc 5c 4h] [Kd]
tipner: bets $5
Peu3aHy: folds 
Uncalled bet ($5) returned to tipner
tipner collected $14.80 from pot
tipner: doesn't show hand 
*** SUMMARY ***
Total pot $15.50 | Rake $0.70 
Board [Tc 5c 4h Kd]
Seat 1: Peu3aHy folded on the Turn
Seat 2: Dachish (button) folded before Flop (didn't bet)
Seat 3: nuaxin (small blind) folded before Flop
Seat 4: COOLIKO\/23 (big blind) folded before Flop
Seat 5: TheGentleFox folded before Flop (didn't bet)
Seat 6: Kukuryzka folded before Flop (didn't bet)
Seat 7: tipner collected ($14.80)
Seat 8: matiko09 folded before Flop (didn't bet)
Seat 9: Sweden_Pound folded before Flop (didn't bet)





PokerStars Hand #147754583889:  Hold'em No Limit ($0.50/$1.00 USD) - 2016/01/27 11:50:29 CET [2016/01/27 5:50:29 ET]
Table 'Delphinus II' 9-max Seat #8 is the button
Seat 1: Saintreine ($143.61 in chips) 
Seat 2: AlKatrone ($198.52 in chips) 
Seat 3: deepblue0000 ($332.48 in chips) 
Seat 4: matiko09 ($121.73 in chips) 
Seat 5: pandalapa ($108.14 in chips) 
Seat 6: Sweden_Pound ($124.64 in chips) 
Seat 7: RUS)Timur ($100 in chips) 
Seat 8: mycka86 ($100 in chips) 
Seat 9: FGL-lucky ($50.38 in chips) 
FGL-lucky: posts small blind $0.50
Saintreine: posts big blind $1
*** HOLE CARDS ***
Dealt to matiko09 [9s Qs]
AlKatrone: folds 
deepblue0000: folds 
matiko09: folds 
pandalapa: folds 
Sweden_Pound: folds 
RUS)Timur: folds 
mycka86: folds 
FGL-lucky: calls $0.50
Saintreine: raises $3 to $4
FGL-lucky: calls $3
*** FLOP *** [8d Js 4d]
FGL-lucky: checks 
Saintreine: bets $3.97
FGL-lucky: folds 
Uncalled bet ($3.97) returned to Saintreine
Saintreine collected $7.64 from pot
Saintreine: doesn't show hand 
*** SUMMARY ***
Total pot $8 | Rake $0.36 
Board [8d Js 4d]
Seat 1: Saintreine (big blind) collected ($7.64)
Seat 2: AlKatrone folded before Flop (didn't bet)
Seat 3: deepblue0000 folded before Flop (didn't bet)
Seat 4: matiko09 folded before Flop (didn't bet)
Seat 5: pandalapa folded before Flop (didn't bet)
Seat 6: Sweden_Pound folded before Flop (didn't bet)
Seat 7: RUS)Timur folded before Flop (didn't bet)
Seat 8: mycka86 (button) folded before Flop (didn't bet)
Seat 9: FGL-lucky (small blind) folded on the Flop





PokerStars Hand #147754584676:  Hold'em No Limit ($0.50/$1.00 USD) - 2016/01/27 11:50:31 CET [2016/01/27 5:50:31 ET]
Table 'Alhajoth' 9-max Seat #4 is the button
Seat 1: UShallGimme$ ($136.95 in chips) 
Seat 2: matiko09 ($100 in chips) 
Seat 3: Sweden_Pound ($116.27 in chips) 
Seat 4: Venomous100% ($125.87 in chips) 
Seat 5: Kukuryzka ($104.66 in chips) 
Seat 6: RoadtoNepal ($184.30 in chips) 
Seat 7: Ohpeel ($138.31 in chips) 
Seat 8: deepblue0000 ($121.68 in chips) 
Seat 9: di0d80 ($100 in chips) 
Kukuryzka: posts small blind $0.50
RoadtoNepal: posts big blind $1
*** HOLE CARDS ***
Dealt to matiko09 [9h Qd]
Ohpeel: folds 
deepblue0000: folds 
di0d80: folds 
UShallGimme$: raises $2 to $3
matiko09: folds 
Sweden_Pound: calls $3
Venomous100%: raises $9 to $12
Kukuryzka: folds 
RoadtoNepal: folds 
UShallGimme$: raises $16 to $28
Sweden_Pound: folds 
Venomous100%: calls $16
*** FLOP *** [6c Jc As]
UShallGimme$: checks 
Venomous100%: bets $24
UShallGimme$: folds 
Uncalled bet ($24) returned to Venomous100%
Venomous100% collected $57.78 from pot
Venomous100%: doesn't show hand 
*** SUMMARY ***
Total pot $60.50 | Rake $2.72 
Board [6c Jc As]
Seat 1: UShallGimme$ folded on the Flop
Seat 2: matiko09 folded before Flop (didn't bet)
Seat 3: Sweden_Pound folded before Flop
Seat 4: Venomous100% (button) collected ($57.78)
Seat 5: Kukuryzka (small blind) folded before Flop
Seat 6: RoadtoNepal (big blind) folded before Flop
Seat 7: Ohpeel folded before Flop (didn't bet)
Seat 8: deepblue0000 folded before Flop (didn't bet)
Seat 9: di0d80 folded before Flop (didn't bet)





PokerStars Hand #147754585142:  Hold'em No Limit ($0.50/$1.00 USD) - 2016/01/27 11:50:32 CET [2016/01/27 5:50:32 ET]
Table 'Dollfus' 9-max Seat #9 is the button
Seat 2: nosoant ($87.68 in chips) 
Seat 3: UShallGimme$ ($100 in chips) 
Seat 4: matiko09 ($119.05 in chips) 
Seat 5: pandalapa ($221.98 in chips) 
Seat 6: deepblue0000 ($100 in chips) 
Seat 7: Dödi123 ($209.72 in chips) 
Seat 8: Venomous100% ($126.27 in chips) 
Seat 9: COOLIKO\/23 ($100 in chips) 
nosoant: posts small blind $0.50
UShallGimme$: posts big blind $1
*** HOLE CARDS ***
Dealt to matiko09 [6d 2s]
matiko09: folds 
pandalapa: folds 
deepblue0000: folds 
Dödi123: folds 
Venomous100%: folds 
COOLIKO\/23: folds 
nosoant: raises $1 to $2
UShallGimme$: calls $1
*** FLOP *** [Qs 6c Ad]
nosoant: bets $2
UShallGimme$: folds 
Uncalled bet ($2) returned to nosoant
nosoant collected $3.82 from pot
nosoant: doesn't show hand 
*** SUMMARY ***
Total pot $4 | Rake $0.18 
Board [Qs 6c Ad]
Seat 2: nosoant (small blind) collected ($3.82)
Seat 3: UShallGimme$ (big blind) folded on the Flop
Seat 4: matiko09 folded before Flop (didn't bet)
Seat 5: pandalapa folded before Flop (didn't bet)
Seat 6: deepblue0000 folded before Flop (didn't bet)
Seat 7: Dödi123 folded before Flop (didn't bet)
Seat 8: Venomous100% folded before Flop (didn't bet)
Seat 9: COOLIKO\/23 (button) folded before Flop (didn't bet)





PokerStars Hand #147754597532:  Hold'em No Limit (€0.50/€1.00 EUR) - 2016/01/27 11:50:56 CET [2016/01/27 5:50:56 ET]
Table 'Carol' 9-max Seat #3 is the button
Seat 1: RoadtoNepal (€100 in chips) 
Seat 2: sylvian31 (€101.50 in chips) 
Seat 3: noname076 (€52.03 in chips) 
Seat 5: Proandi (€42.65 in chips) 
Seat 6: Kukuryzka (€178.53 in chips) 
Seat 7: tipner (€110.94 in chips) 
Seat 8: matiko09 (€100 in chips) 
Seat 9: Venomous100% (€101.50 in chips) 
Sweden_Pound will be allowed to play after the button
Proandi: posts small blind €0.50
Kukuryzka: posts big blind €1
*** HOLE CARDS ***
Dealt to matiko09 [Ad 4d]
tipner: folds 
matiko09: raises €2 to €3
Venomous100%: folds 
RoadtoNepal: folds 
sylvian31: folds 
noname076: folds 
Proandi: calls €2.50
Kukuryzka: folds 
*** FLOP *** [2c Kh 8c]
Proandi: checks 
matiko09: checks 
*** TURN *** [2c Kh 8c] [Ah]
Proandi: checks 
matiko09: bets €4.34
Proandi: calls €4.34
*** RIVER *** [2c Kh 8c Ah] [2h]
Proandi: checks 
matiko09: checks 
*** SHOW DOWN ***
Proandi: shows [Js As] (two pair, Aces and Deuces)
matiko09: shows [Ad 4d] (two pair, Aces and Deuces)
Proandi collected €7.49 from pot
matiko09 collected €7.48 from pot
*** SUMMARY ***
Total pot €15.68 | Rake €0.71 
Board [2c Kh 8c Ah 2h]
Seat 1: RoadtoNepal folded before Flop (didn't bet)
Seat 2: sylvian31 folded before Flop (didn't bet)
Seat 3: noname076 (button) folded before Flop (didn't bet)
Seat 5: Proandi (small blind) showed [Js As] and won (€7.49) with two pair, Aces and Deuces
Seat 6: Kukuryzka (big blind) folded before Flop
Seat 7: tipner folded before Flop (didn't bet)
Seat 8: matiko09 showed [Ad 4d] and won (€7.48) with two pair, Aces and Deuces
Seat 9: Venomous100% folded before Flop (didn't bet)





PokerStars Hand #147754601431:  Hold'em No Limit ($1/$2 USD) - 2016/01/27 11:51:04 CET [2016/01/27 5:51:04 ET]
Table 'Phobos II' 9-max Seat #2 is the button
Seat 1: LRV21 ($393.14 in chips) 
Seat 2: di0d80 ($243.22 in chips) 
Seat 3: sylvian31 ($200.44 in chips) 
Seat 4: flk.Dasas ($314.18 in chips) 
Seat 5: tipner ($200 in chips) 
Seat 6: matiko09 ($230.15 in chips) 
Seat 7: Venomous100% ($285.42 in chips) 
Seat 8: RoadtoNepal ($242.54 in chips) 
Seat 9: Kukuryzka ($370.03 in chips) 
sylvian31: posts small blind $1
flk.Dasas: posts big blind $2
*** HOLE CARDS ***
Dealt to matiko09 [4d Ts]
tipner: folds 
matiko09: folds 
Venomous100%: folds 
RoadtoNepal: raises $4 to $6
Kukuryzka: folds 
LRV21: folds 
di0d80: raises $12 to $18
sylvian31: folds 
flk.Dasas: folds 
RoadtoNepal: folds 
Uncalled bet ($12) returned to di0d80
di0d80 collected $15 from pot
di0d80: doesn't show hand 
*** SUMMARY ***
Total pot $15 | Rake $0 
Seat 1: LRV21 folded before Flop (didn't bet)
Seat 2: di0d80 (button) collected ($15)
Seat 3: sylvian31 (small blind) folded before Flop
Seat 4: flk.Dasas (big blind) folded before Flop
Seat 5: tipner folded before Flop (didn't bet)
Seat 6: matiko09 folded before Flop (didn't bet)
Seat 7: Venomous100% folded before Flop (didn't bet)
Seat 8: RoadtoNepal folded before Flop
Seat 9: Kukuryzka folded before Flop (didn't bet)





PokerStars Hand #147754606183:  Hold'em No Limit ($0.50/$1.00 USD) - 2016/01/27 11:51:13 CET [2016/01/27 5:51:13 ET]
Table 'Fragaria II' 9-max Seat #5 is the button
Seat 1: deepblue0000 ($123.28 in chips) 
Seat 2: GG-NoR34D. ($81.37 in chips) 
Seat 3: Sweden_Pound ($119.84 in chips) 
Seat 4: AlKatrone ($103 in chips) 
Seat 5: Venomous100% ($103.72 in chips) 
Seat 6: UShallGimme$ ($180.49 in chips) 
Seat 7: Hobby-.-AK ($51.23 in chips) 
Seat 8: mycka86 ($109.60 in chips) 
Seat 9: matiko09 ($102 in chips) 
UShallGimme$: posts small blind $0.50
Hobby-.-AK: posts big blind $1
*** HOLE CARDS ***
Dealt to matiko09 [Th 8h]
mycka86: folds 
matiko09: folds 
deepblue0000: folds 
GG-NoR34D.: folds 
Sweden_Pound: folds 
AlKatrone: raises $1.50 to $2.50
Venomous100%: calls $2.50
UShallGimme$: folds 
Hobby-.-AK: calls $1.50
*** FLOP *** [4s Js Jc]
Hobby-.-AK: checks 
AlKatrone: checks 
Venomous100%: bets $5.04
Hobby-.-AK: folds 
AlKatrone: folds 
Uncalled bet ($5.04) returned to Venomous100%
Venomous100% collected $7.64 from pot
Venomous100%: doesn't show hand 
*** SUMMARY ***
Total pot $8 | Rake $0.36 
Board [4s Js Jc]
Seat 1: deepblue0000 folded before Flop (didn't bet)
Seat 2: GG-NoR34D. folded before Flop (didn't bet)
Seat 3: Sweden_Pound folded before Flop (didn't bet)
Seat 4: AlKatrone folded on the Flop
Seat 5: Venomous100% (button) collected ($7.64)
Seat 6: UShallGimme$ (small blind) folded before Flop
Seat 7: Hobby-.-AK (big blind) folded on the Flop
Seat 8: mycka86 folded before Flop (didn't bet)
Seat 9: matiko09 folded before Flop (didn't bet)





PokerStars Hand #147754608233:  Hold'em No Limit ($0.50/$1.00 USD) - 2016/01/27 11:51:17 CET [2016/01/27 5:51:17 ET]
Table 'Dollfus' 9-max Seat #2 is the button
Seat 2: nosoant ($89.50 in chips) 
Seat 3: UShallGimme$ ($100 in chips) 
Seat 4: matiko09 ($119.05 in chips) 
Seat 5: pandalapa ($221.98 in chips) 
Seat 6: deepblue0000 ($100 in chips) 
Seat 7: Dödi123 ($209.72 in chips) 
Seat 8: Venomous100% ($126.27 in chips) 
Seat 9: COOLIKO\/23 ($100 in chips) 
UShallGimme$: posts small blind $0.50
matiko09: posts big blind $1
masaytoo: sits out 
*** HOLE CARDS ***
Dealt to matiko09 [Th 4s]
pandalapa: folds 
deepblue0000: folds 
Dödi123: folds 
Venomous100%: folds 
COOLIKO\/23: raises $2 to $3
nosoant: folds 
UShallGimme$: folds 
matiko09: folds 
Uncalled bet ($2) returned to COOLIKO\/23
COOLIKO\/23 collected $2.50 from pot
COOLIKO\/23: doesn't show hand 
*** SUMMARY ***
Total pot $2.50 | Rake $0 
Seat 2: nosoant (button) folded before Flop (didn't bet)
Seat 3: UShallGimme$ (small blind) folded before Flop
Seat 4: matiko09 (big blind) folded before Flop
Seat 5: pandalapa folded before Flop (didn't bet)
Seat 6: deepblue0000 folded before Flop (didn't bet)
Seat 7: Dödi123 folded before Flop (didn't bet)
Seat 8: Venomous100% folded before Flop (didn't bet)
Seat 9: COOLIKO\/23 collected ($2.50)





PokerStars Hand #147754616061:  Hold'em No Limit ($0.50/$1.00 USD) - 2016/01/27 11:51:33 CET [2016/01/27 5:51:33 ET]
Table 'Nanking' 9-max Seat #3 is the button
Seat 1: Peu3aHy ($100 in chips) 
Seat 2: Dachish ($99.17 in chips) 
Seat 3: nuaxin ($51.94 in chips) 
Seat 4: COOLIKO\/23 ($160.54 in chips) 
Seat 5: TheGentleFox ($107.57 in chips) 
Seat 6: Kukuryzka ($108.03 in chips) 
Seat 7: tipner ($107.80 in chips) 
Seat 8: matiko09 ($100 in chips) 
Seat 9: Sweden_Pound ($139.22 in chips) 
COOLIKO\/23: posts small blind $0.50
TheGentleFox: posts big blind $1
*** HOLE CARDS ***
Dealt to matiko09 [Qs 4c]
Kukuryzka: folds 
tipner: folds 
matiko09: folds 
Sweden_Pound: folds 
Peu3aHy: folds 
Dachish: folds 
nuaxin: raises $2 to $3
COOLIKO\/23: folds 
TheGentleFox: calls $2
*** FLOP *** [Ks 6s 3h]
TheGentleFox: checks 
nuaxin: bets $3.10
TheGentleFox: folds 
Uncalled bet ($3.10) returned to nuaxin
nuaxin collected $6.21 from pot
nuaxin: doesn't show hand 
*** SUMMARY ***
Total pot $6.50 | Rake $0.29 
Board [Ks 6s 3h]
Seat 1: Peu3aHy folded before Flop (didn't bet)
Seat 2: Dachish folded before Flop (didn't bet)
Seat 3: nuaxin (button) collected ($6.21)
Seat 4: COOLIKO\/23 (small blind) folded before Flop
Seat 5: TheGentleFox (big blind) folded on the Flop
Seat 6: Kukuryzka folded before Flop (didn't bet)
Seat 7: tipner folded before Flop (didn't bet)
Seat 8: matiko09 folded before Flop (didn't bet)
Seat 9: Sweden_Pound folded before Flop (didn't bet)





PokerStars Hand #147754616616:  Hold'em No Limit ($0.50/$1.00 USD) - 2016/01/27 11:51:34 CET [2016/01/27 5:51:34 ET]
Table 'Delphinus II' 9-max Seat #9 is the button
Seat 1: Saintreine ($147.25 in chips) 
Seat 2: AlKatrone ($198.52 in chips) 
Seat 3: deepblue0000 ($332.48 in chips) 
Seat 4: matiko09 ($121.73 in chips) 
Seat 5: pandalapa ($108.14 in chips) 
Seat 6: Sweden_Pound ($124.64 in chips) 
Seat 7: RUS)Timur ($100 in chips) 
Seat 8: mycka86 ($100 in chips) 
Seat 9: FGL-lucky ($46.38 in chips) 
Saintreine: posts small blind $0.50
AlKatrone: posts big blind $1
*** HOLE CARDS ***
Dealt to matiko09 [Qc 6c]
deepblue0000: folds 
matiko09: folds 
pandalapa: folds 
Sweden_Pound: folds 
RUS)Timur: folds 
mycka86: raises $1.10 to $2.10
FGL-lucky: folds 
Saintreine: calls $1.60
AlKatrone: folds 
*** FLOP *** [Ah Js 5s]
Saintreine: bets $1
mycka86: calls $1
*** TURN *** [Ah Js 5s] [Tc]
Saintreine: bets $3.57
mycka86: raises $8.43 to $12
Saintreine: folds 
Uncalled bet ($8.43) returned to mycka86
mycka86 collected $13.69 from pot
*** SUMMARY ***
Total pot $14.34 | Rake $0.65 
Board [Ah Js 5s Tc]
Seat 1: Saintreine (small blind) folded on the Turn
Seat 2: AlKatrone (big blind) folded before Flop
Seat 3: deepblue0000 folded before Flop (didn't bet)
Seat 4: matiko09 folded before Flop (didn't bet)
Seat 5: pandalapa folded before Flop (didn't bet)
Seat 6: Sweden_Pound folded before Flop (didn't bet)
Seat 7: RUS)Timur folded before Flop (didn't bet)
Seat 8: mycka86 collected ($13.69)
Seat 9: FGL-lucky (button) folded before Flop (didn't bet)





PokerStars Hand #147754618873:  Hold'em No Limit ($0.50/$1.00 USD) - 2016/01/27 11:51:38 CET [2016/01/27 5:51:38 ET]
Table 'Alkmene II' 9-max Seat #2 is the button
Seat 1: matiko09 ($100 in chips) 
Seat 2: deepblue0000 ($100 in chips) 
Seat 3: di0d80 ($100 in chips) 
Seat 4: CoolFireX ($150.57 in chips) 
Seat 5: Sweden_Pound ($115.55 in chips) 
Seat 6: Peu3aHy ($117.22 in chips) 
Seat 7: mycka86 ($100 in chips) 
Seat 8: fecsok1 ($119.88 in chips) 
Seat 9: pandalapa ($110.32 in chips) 
di0d80: posts small blind $0.50
CoolFireX: posts big blind $1
*** HOLE CARDS ***
Dealt to matiko09 [Js 9c]
Sweden_Pound: folds 
Peu3aHy: folds 
mycka86: raises $2 to $3
fecsok1: folds 
pandalapa: folds 
matiko09: folds 
deepblue0000: folds 
di0d80: folds 
CoolFireX: folds 
Uncalled bet ($2) returned to mycka86
mycka86 collected $2.50 from pot
*** SUMMARY ***
Total pot $2.50 | Rake $0 
Seat 1: matiko09 folded before Flop (didn't bet)
Seat 2: deepblue0000 (button) folded before Flop (didn't bet)
Seat 3: di0d80 (small blind) folded before Flop
Seat 4: CoolFireX (big blind) folded before Flop
Seat 5: Sweden_Pound folded before Flop (didn't bet)
Seat 6: Peu3aHy folded before Flop (didn't bet)
Seat 7: mycka86 collected ($2.50)
Seat 8: fecsok1 folded before Flop (didn't bet)
Seat 9: pandalapa folded before Flop (didn't bet)





PokerStars Hand #147754624289:  Hold'em No Limit ($0.50/$1.00 USD) - 2016/01/27 11:51:49 CET [2016/01/27 5:51:49 ET]
Table 'Henyey' 9-max Seat #1 is the button
Seat 1: COOLIKO\/23 ($125.56 in chips) 
Seat 2: pandalapa ($149.77 in chips) 
Seat 3: deepblue0000 ($100 in chips) 
Seat 5: matiko09 ($115.12 in chips) 
Seat 6: UShallGimme$ ($101.78 in chips) 
Seat 7: vinniej15 ($65.07 in chips) 
Seat 8: CoolFireX ($100 in chips) 
Seat 9: mycka86 ($135.13 in chips) 
pandalapa: posts small blind $0.50
deepblue0000: posts big blind $1
sylvian31: sits out 
*** HOLE CARDS ***
Dealt to matiko09 [Td 6s]
matiko09: folds 
UShallGimme$: folds 
vinniej15: calls $1
CoolFireX: raises $2.50 to $3.50
mycka86: folds 
COOLIKO\/23: folds 
pandalapa: folds 
deepblue0000: folds 
vinniej15: calls $2.50
*** FLOP *** [Jd Ac 3c]
vinniej15: checks 
CoolFireX: bets $5.41
vinniej15: calls $5.41
*** TURN *** [Jd Ac 3c] [8d]
vinniej15: checks 
CoolFireX: bets $13.83
vinniej15: folds 
Uncalled bet ($13.83) returned to CoolFireX
CoolFireX collected $18.45 from pot
CoolFireX: doesn't show hand 
*** SUMMARY ***
Total pot $19.32 | Rake $0.87 
Board [Jd Ac 3c 8d]
Seat 1: COOLIKO\/23 (button) folded before Flop (didn't bet)
Seat 2: pandalapa (small blind) folded before Flop
Seat 3: deepblue0000 (big blind) folded before Flop
Seat 5: matiko09 folded before Flop (didn't bet)
Seat 6: UShallGimme$ folded before Flop (didn't bet)
Seat 7: vinniej15 folded on the Turn
Seat 8: CoolFireX collected ($18.45)
Seat 9: mycka86 folded before Flop (didn't bet)





PokerStars Hand #147754625494:  Hold'em No Limit ($1/$2 USD) - 2016/01/27 11:51:51 CET [2016/01/27 5:51:51 ET]
Table 'Phobos II' 9-max Seat #3 is the button
Seat 1: LRV21 ($393.14 in chips) 
Seat 2: di0d80 ($252.22 in chips) 
Seat 3: sylvian31 ($200 in chips) 
Seat 4: flk.Dasas ($312.18 in chips) 
Seat 5: tipner ($200 in chips) 
Seat 6: matiko09 ($230.15 in chips) 
Seat 7: Venomous100% ($285.42 in chips) 
Seat 8: RoadtoNepal ($236.54 in chips) 
Seat 9: Kukuryzka ($370.03 in chips) 
flk.Dasas: posts small blind $1
tipner: posts big blind $2
*** HOLE CARDS ***
Dealt to matiko09 [Kh Jc]
matiko09: folds 
Venomous100%: folds 
RoadtoNepal: folds 
Kukuryzka: folds 
LRV21: folds 
di0d80: raises $3 to $5
sylvian31: folds 
flk.Dasas: calls $4
tipner: folds 
*** FLOP *** [Qs Tc 7d]
flk.Dasas: checks 
di0d80: bets $8
flk.Dasas: folds 
Uncalled bet ($8) returned to di0d80
di0d80 collected $11.46 from pot
di0d80: doesn't show hand 
*** SUMMARY ***
Total pot $12 | Rake $0.54 
Board [Qs Tc 7d]
Seat 1: LRV21 folded before Flop (didn't bet)
Seat 2: di0d80 collected ($11.46)
Seat 3: sylvian31 (button) folded before Flop (didn't bet)
Seat 4: flk.Dasas (small blind) folded on the Flop
Seat 5: tipner (big blind) folded before Flop
Seat 6: matiko09 folded before Flop (didn't bet)
Seat 7: Venomous100% folded before Flop (didn't bet)
Seat 8: RoadtoNepal folded before Flop (didn't bet)
Seat 9: Kukuryzka folded before Flop (didn't bet)





PokerStars Hand #147754628065:  Hold'em No Limit (€0.50/€1.00 EUR) - 2016/01/27 11:51:56 CET [2016/01/27 5:51:56 ET]
Table 'Carol' 9-max Seat #5 is the button
Seat 1: RoadtoNepal (€100 in chips) 
Seat 2: sylvian31 (€101.50 in chips) 
Seat 3: noname076 (€52.03 in chips) 
Seat 5: Proandi (€42.80 in chips) 
Seat 6: Kukuryzka (€177.53 in chips) 
Seat 7: tipner (€110.94 in chips) 
Seat 8: matiko09 (€100.14 in chips) 
Seat 9: Venomous100% (€101.50 in chips) 
Kukuryzka: posts small blind €0.50
tipner: posts big blind €1
Sweden_Pound: sits out 
*** HOLE CARDS ***
Dealt to matiko09 [Ts Jd]
matiko09: folds 
Venomous100% has timed out
Venomous100%: folds 
RoadtoNepal: folds 
sylvian31: raises €2 to €3
noname076: folds 
Proandi: raises €39.80 to €42.80 and is all-in
Kukuryzka: folds 
tipner: folds 
sylvian31: folds 
Uncalled bet (€39.80) returned to Proandi
Proandi collected €7.50 from pot
Proandi: doesn't show hand 
*** SUMMARY ***
Total pot €7.50 | Rake €0 
Seat 1: RoadtoNepal folded before Flop (didn't bet)
Seat 2: sylvian31 folded before Flop
Seat 3: noname076 folded before Flop (didn't bet)
Seat 5: Proandi (button) collected (€7.50)
Seat 6: Kukuryzka (small blind) folded before Flop
Seat 7: tipner (big blind) folded before Flop
Seat 8: matiko09 folded before Flop (didn't bet)
Seat 9: Venomous100% folded before Flop (didn't bet)





PokerStars Hand #147754629025:  Hold'em No Limit ($0.50/$1.00 USD) - 2016/01/27 11:51:58 CET [2016/01/27 5:51:58 ET]
Table 'Dollfus' 9-max Seat #3 is the button
Seat 2: nosoant ($89.50 in chips) 
Seat 3: UShallGimme$ ($100 in chips) 
Seat 4: matiko09 ($118.05 in chips) 
Seat 5: pandalapa ($221.98 in chips) 
Seat 6: deepblue0000 ($100 in chips) 
Seat 7: Dödi123 ($209.72 in chips) 
Seat 8: Venomous100% ($126.27 in chips) 
Seat 9: COOLIKO\/23 ($101.50 in chips) 
matiko09: posts small blind $0.50
pandalapa: posts big blind $1
masaytoo: sits out 
*** HOLE CARDS ***
Dealt to matiko09 [4s 4d]
deepblue0000: folds 
Dödi123: folds 
Venomous100%: folds 
COOLIKO\/23: folds 
nosoant: calls $1
UShallGimme$: raises $3 to $4
matiko09: calls $3.50
pandalapa: folds 
nosoant: calls $3
*** FLOP *** [3c 8d 3d]
matiko09: bets $7.21
nosoant: folds 
UShallGimme$: folds 
Uncalled bet ($7.21) returned to matiko09
matiko09 collected $12.42 from pot
matiko09: doesn't show hand 
*** SUMMARY ***
Total pot $13 | Rake $0.58 
Board [3c 8d 3d]
Seat 2: nosoant folded on the Flop
Seat 3: UShallGimme$ (button) folded on the Flop
Seat 4: matiko09 (small blind) collected ($12.42)
Seat 5: pandalapa (big blind) folded before Flop
Seat 6: deepblue0000 folded before Flop (didn't bet)
Seat 7: Dödi123 folded before Flop (didn't bet)
Seat 8: Venomous100% folded before Flop (didn't bet)
Seat 9: COOLIKO\/23 folded before Flop (didn't bet)





PokerStars Hand #147754640810:  Hold'em No Limit ($0.50/$1.00 USD) - 2016/01/27 11:52:21 CET [2016/01/27 5:52:21 ET]
Table 'Delphinus II' 9-max Seat #1 is the button
Seat 1: Saintreine ($140.58 in chips) 
Seat 2: AlKatrone ($197.52 in chips) 
Seat 3: deepblue0000 ($332.48 in chips) 
Seat 4: matiko09 ($121.73 in chips) 
Seat 5: pandalapa ($108.14 in chips) 
Seat 6: Sweden_Pound ($124.64 in chips) 
Seat 7: RUS)Timur ($100 in chips) 
Seat 8: mycka86 ($107.02 in chips) 
Seat 9: FGL-lucky ($46.38 in chips) 
AlKatrone: posts small blind $0.50
deepblue0000: posts big blind $1
*** HOLE CARDS ***
Dealt to matiko09 [Kd 6s]
matiko09: folds 
pandalapa: folds 
Sweden_Pound: folds 
RUS)Timur: folds 
mycka86: folds 
FGL-lucky: folds 
Saintreine: folds 
AlKatrone: raises $2 to $3
deepblue0000: calls $2
*** FLOP *** [2c 3d Th]
AlKatrone: bets $4
deepblue0000: folds 
Uncalled bet ($4) returned to AlKatrone
AlKatrone collected $5.73 from pot
AlKatrone: doesn't show hand 
*** SUMMARY ***
Total pot $6 | Rake $0.27 
Board [2c 3d Th]
Seat 1: Saintreine (button) folded before Flop (didn't bet)
Seat 2: AlKatrone (small blind) collected ($5.73)
Seat 3: deepblue0000 (big blind) folded on the Flop
Seat 4: matiko09 folded before Flop (didn't bet)
Seat 5: pandalapa folded before Flop (didn't bet)
Seat 6: Sweden_Pound folded before Flop (didn't bet)
Seat 7: RUS)Timur folded before Flop (didn't bet)
Seat 8: mycka86 folded before Flop (didn't bet)
Seat 9: FGL-lucky folded before Flop (didn't bet)





PokerStars Hand #147754641819:  Hold'em No Limit ($0.50/$1.00 USD) - 2016/01/27 11:52:23 CET [2016/01/27 5:52:23 ET]
Table 'Alhajoth' 9-max Seat #5 is the button
Seat 1: UShallGimme$ ($108.95 in chips) 
Seat 2: matiko09 ($100 in chips) 
Seat 3: Sweden_Pound ($113.27 in chips) 
Seat 4: Venomous100% ($155.65 in chips) 
Seat 5: Kukuryzka ($104.16 in chips) 
Seat 6: RoadtoNepal ($183.30 in chips) 
Seat 7: Ohpeel ($138.31 in chips) 
Seat 8: deepblue0000 ($121.68 in chips) 
Seat 9: di0d80 ($100 in chips) 
RoadtoNepal: posts small blind $0.50
Ohpeel: posts big blind $1
*** HOLE CARDS ***
Dealt to matiko09 [3h Th]
deepblue0000: folds 
di0d80: folds 
UShallGimme$: folds 
matiko09: folds 
Sweden_Pound: raises $2 to $3
Venomous100%: folds 
Kukuryzka: raises $6 to $9
RoadtoNepal: folds 
Ohpeel: folds 
Sweden_Pound: folds 
Uncalled bet ($6) returned to Kukuryzka
Kukuryzka collected $7.50 from pot
Kukuryzka: doesn't show hand 
*** SUMMARY ***
Total pot $7.50 | Rake $0 
Seat 1: UShallGimme$ folded before Flop (didn't bet)
Seat 2: matiko09 folded before Flop (didn't bet)
Seat 3: Sweden_Pound folded before Flop
Seat 4: Venomous100% folded before Flop (didn't bet)
Seat 5: Kukuryzka (button) collected ($7.50)
Seat 6: RoadtoNepal (small blind) folded before Flop
Seat 7: Ohpeel (big blind) folded before Flop
Seat 8: deepblue0000 folded before Flop (didn't bet)
Seat 9: di0d80 folded before Flop (didn't bet)





PokerStars Hand #147754642952:  Hold'em No Limit ($0.50/$1.00 USD) - 2016/01/27 11:52:25 CET [2016/01/27 5:52:25 ET]
Table 'Nanking' 9-max Seat #4 is the button
Seat 1: Peu3aHy ($100 in chips) 
Seat 2: Dachish ($99.17 in chips) 
Seat 3: nuaxin ($55.15 in chips) 
Seat 4: COOLIKO\/23 ($160.04 in chips) 
Seat 5: TheGentleFox ($104.57 in chips) 
Seat 6: Kukuryzka ($108.03 in chips) 
Seat 7: tipner ($107.80 in chips) 
Seat 8: matiko09 ($100 in chips) 
Seat 9: Sweden_Pound ($139.22 in chips) 
TheGentleFox: posts small blind $0.50
Kukuryzka: posts big blind $1
*** HOLE CARDS ***
Dealt to matiko09 [Kd Th]
tipner: folds 
matiko09: folds 
Sweden_Pound: folds 
Peu3aHy: folds 
Dachish: folds 
nuaxin: folds 
COOLIKO\/23: raises $1.50 to $2.50
TheGentleFox: folds 
Kukuryzka: folds 
Uncalled bet ($1.50) returned to COOLIKO\/23
COOLIKO\/23 collected $2.50 from pot
COOLIKO\/23: doesn't show hand 
*** SUMMARY ***
Total pot $2.50 | Rake $0 
Seat 1: Peu3aHy folded before Flop (didn't bet)
Seat 2: Dachish folded before Flop (didn't bet)
Seat 3: nuaxin folded before Flop (didn't bet)
Seat 4: COOLIKO\/23 (button) collected ($2.50)
Seat 5: TheGentleFox (small blind) folded before Flop
Seat 6: Kukuryzka (big blind) folded before Flop
Seat 7: tipner folded before Flop (didn't bet)
Seat 8: matiko09 folded before Flop (didn't bet)
Seat 9: Sweden_Pound folded before Flop (didn't bet)





PokerStars Hand #147754645579:  Hold'em No Limit ($0.50/$1.00 USD) - 2016/01/27 11:52:31 CET [2016/01/27 5:52:31 ET]
Table 'Fragaria II' 9-max Seat #6 is the button
Seat 1: deepblue0000 ($123.28 in chips) 
Seat 2: GG-NoR34D. ($81.37 in chips) 
Seat 3: Sweden_Pound ($119.84 in chips) 
Seat 4: AlKatrone ($100.50 in chips) 
Seat 5: Venomous100% ($108.86 in chips) 
Seat 6: UShallGimme$ ($179.99 in chips) 
Seat 7: Hobby-.-AK ($48.73 in chips) 
Seat 8: mycka86 ($109.60 in chips) 
Seat 9: matiko09 ($102 in chips) 
Hobby-.-AK: posts small blind $0.50
mycka86: posts big blind $1
*** HOLE CARDS ***
Dealt to matiko09 [9h 3h]
matiko09: folds 
deepblue0000: raises $2 to $3
GG-NoR34D.: calls $3
Sweden_Pound: folds 
AlKatrone: folds 
Venomous100%: folds 
UShallGimme$: folds 
Hobby-.-AK: folds 
mycka86: calls $2
*** FLOP *** [4d Qc Jc]
mycka86: checks 
deepblue0000: bets $6.04
GG-NoR34D.: calls $6.04
mycka86: calls $6.04
*** TURN *** [4d Qc Jc] [2s]
mycka86: checks 
deepblue0000: bets $16
GG-NoR34D.: folds 
mycka86: folds 
Uncalled bet ($16) returned to deepblue0000
deepblue0000 collected $26.38 from pot
*** SUMMARY ***
Total pot $27.62 | Rake $1.24 
Board [4d Qc Jc 2s]
Seat 1: deepblue0000 collected ($26.38)
Seat 2: GG-NoR34D. folded on the Turn
Seat 3: Sweden_Pound folded before Flop (didn't bet)
Seat 4: AlKatrone folded before Flop (didn't bet)
Seat 5: Venomous100% folded before Flop (didn't bet)
Seat 6: UShallGimme$ (button) folded before Flop (didn't bet)
Seat 7: Hobby-.-AK (small blind) folded before Flop
Seat 8: mycka86 (big blind) folded on the Turn
Seat 9: matiko09 folded before Flop (didn't bet)





PokerStars Hand #147754655988:  Hold'em No Limit (€0.50/€1.00 EUR) - 2016/01/27 11:52:51 CET [2016/01/27 5:52:51 ET]
Table 'Carol' 9-max Seat #6 is the button
Seat 1: RoadtoNepal (€100 in chips) 
Seat 2: sylvian31 (€100 in chips) 
Seat 3: noname076 (€52.03 in chips) 
Seat 5: Proandi (€47.30 in chips) 
Seat 6: Kukuryzka (€177.03 in chips) 
Seat 7: tipner (€109.94 in chips) 
Seat 8: matiko09 (€100.14 in chips) 
Seat 9: Venomous100% (€101.50 in chips) 
tipner: posts small blind €0.50
matiko09: posts big blind €1
Sweden_Pound: sits out 
*** HOLE CARDS ***
Dealt to matiko09 [5d Tc]
Venomous100%: folds 
RoadtoNepal: raises €2 to €3
sylvian31: folds 
noname076: calls €3
Proandi: folds 
Kukuryzka: folds 
tipner: folds 
matiko09: folds 
*** FLOP *** [9c Ks Kc]
RoadtoNepal: checks 
noname076: bets €7.16
RoadtoNepal: calls €7.16
*** TURN *** [9c Ks Kc] [Jd]
RoadtoNepal: checks 
noname076: bets €20.84
RoadtoNepal: raises €63.66 to €84.50
noname076: calls €21.03 and is all-in
Uncalled bet (€42.63) returned to RoadtoNepal
*** RIVER *** [9c Ks Kc Jd] [Jc]
*** SHOW DOWN ***
RoadtoNepal: shows [Ad As] (two pair, Aces and Kings)
noname076: shows [Ts Qs] (a straight, Nine to King)
noname076 collected €103.41 from pot
*** SUMMARY ***
Total pot €105.56 | Rake €2.15 
Board [9c Ks Kc Jd Jc]
Seat 1: RoadtoNepal showed [Ad As] and lost with two pair, Aces and Kings
Seat 2: sylvian31 folded before Flop (didn't bet)
Seat 3: noname076 showed [Ts Qs] and won (€103.41) with a straight, Nine to King
Seat 5: Proandi folded before Flop (didn't bet)
Seat 6: Kukuryzka (button) folded before Flop (didn't bet)
Seat 7: tipner (small blind) folded before Flop
Seat 8: matiko09 (big blind) folded before Flop
Seat 9: Venomous100% folded before Flop (didn't bet)





PokerStars Hand #147754657592:  Hold'em No Limit ($0.50/$1.00 USD) - 2016/01/27 11:52:54 CET [2016/01/27 5:52:54 ET]
Table 'Alkmene II' 9-max Seat #3 is the button
Seat 1: matiko09 ($100 in chips) 
Seat 2: deepblue0000 ($100 in chips) 
Seat 3: di0d80 ($100 in chips) 
Seat 4: CoolFireX ($149.57 in chips) 
Seat 5: Sweden_Pound ($115.55 in chips) 
Seat 6: Peu3aHy ($117.22 in chips) 
Seat 7: mycka86 ($101.50 in chips) 
Seat 8: fecsok1 ($119.88 in chips) 
Seat 9: pandalapa ($110.32 in chips) 
CoolFireX: posts small blind $0.50
Sweden_Pound: posts big blind $1
*** HOLE CARDS ***
Dealt to matiko09 [4s 4h]
Peu3aHy: folds 
mycka86: folds 
fecsok1: folds 
pandalapa: folds 
matiko09: raises $2 to $3
deepblue0000: folds 
di0d80: folds 
CoolFireX: folds 
Sweden_Pound: folds 
Uncalled bet ($2) returned to matiko09
matiko09 collected $2.50 from pot
matiko09: doesn't show hand 
*** SUMMARY ***
Total pot $2.50 | Rake $0 
Seat 1: matiko09 collected ($2.50)
Seat 2: deepblue0000 folded before Flop (didn't bet)
Seat 3: di0d80 (button) folded before Flop (didn't bet)
Seat 4: CoolFireX (small blind) folded before Flop
Seat 5: Sweden_Pound (big blind) folded before Flop
Seat 6: Peu3aHy folded before Flop (didn't bet)
Seat 7: mycka86 folded before Flop (didn't bet)
Seat 8: fecsok1 folded before Flop (didn't bet)
Seat 9: pandalapa folded before Flop (didn't bet)





PokerStars Hand #147754661931:  Hold'em No Limit ($0.50/$1.00 USD) - 2016/01/27 11:53:03 CET [2016/01/27 5:53:03 ET]
Table 'Nanking' 9-max Seat #5 is the button
Seat 1: Peu3aHy ($100 in chips) 
Seat 2: Dachish ($99.17 in chips) 
Seat 3: nuaxin ($55.15 in chips) 
Seat 4: COOLIKO\/23 ($161.54 in chips) 
Seat 5: TheGentleFox ($104.07 in chips) 
Seat 6: Kukuryzka ($107.03 in chips) 
Seat 7: tipner ($107.80 in chips) 
Seat 8: matiko09 ($100 in chips) 
Seat 9: Sweden_Pound ($139.22 in chips) 
Kukuryzka: posts small blind $0.50
tipner: posts big blind $1
*** HOLE CARDS ***
Dealt to matiko09 [6d 9c]
matiko09: folds 
Sweden_Pound: folds 
Peu3aHy: raises $2 to $3
Dachish: folds 
nuaxin: folds 
COOLIKO\/23: folds 
TheGentleFox: calls $3
Kukuryzka: folds 
tipner: folds 
*** FLOP *** [Kh Jc Jd]
Peu3aHy: bets $5
TheGentleFox: folds 
Uncalled bet ($5) returned to Peu3aHy
Peu3aHy collected $7.16 from pot
Peu3aHy: doesn't show hand 
*** SUMMARY ***
Total pot $7.50 | Rake $0.34 
Board [Kh Jc Jd]
Seat 1: Peu3aHy collected ($7.16)
Seat 2: Dachish folded before Flop (didn't bet)
Seat 3: nuaxin folded before Flop (didn't bet)
Seat 4: COOLIKO\/23 folded before Flop (didn't bet)
Seat 5: TheGentleFox (button) folded on the Flop
Seat 6: Kukuryzka (small blind) folded before Flop
Seat 7: tipner (big blind) folded before Flop
Seat 8: matiko09 folded before Flop (didn't bet)
Seat 9: Sweden_Pound folded before Flop (didn't bet)





PokerStars Hand #147754663303:  Hold'em No Limit ($0.50/$1.00 USD) - 2016/01/27 11:53:06 CET [2016/01/27 5:53:06 ET]
Table 'Alhajoth' 9-max Seat #6 is the button
Seat 1: UShallGimme$ ($108.95 in chips) 
Seat 2: matiko09 ($100 in chips) 
Seat 3: Sweden_Pound ($110.27 in chips) 
Seat 4: Venomous100% ($155.65 in chips) 
Seat 5: Kukuryzka ($108.66 in chips) 
Seat 6: RoadtoNepal ($182.80 in chips) 
Seat 7: Ohpeel ($137.31 in chips) 
Seat 8: deepblue0000 ($121.68 in chips) 
Seat 9: di0d80 ($100 in chips) 
Ohpeel: posts small blind $0.50
deepblue0000: posts big blind $1
*** HOLE CARDS ***
Dealt to matiko09 [2d 6d]
di0d80: folds 
UShallGimme$: folds 
matiko09: folds 
Sweden_Pound: folds 
Venomous100%: folds 
Kukuryzka: folds 
RoadtoNepal: raises $1.25 to $2.25
Ohpeel: calls $1.75
deepblue0000: folds 
*** FLOP *** [Th 7c 7d]
Ohpeel: checks 
RoadtoNepal: bets $3.49
Ohpeel: folds 
Uncalled bet ($3.49) returned to RoadtoNepal
RoadtoNepal collected $5.25 from pot
RoadtoNepal: doesn't show hand 
*** SUMMARY ***
Total pot $5.50 | Rake $0.25 
Board [Th 7c 7d]
Seat 1: UShallGimme$ folded before Flop (didn't bet)
Seat 2: matiko09 folded before Flop (didn't bet)
Seat 3: Sweden_Pound folded before Flop (didn't bet)
Seat 4: Venomous100% folded before Flop (didn't bet)
Seat 5: Kukuryzka folded before Flop (didn't bet)
Seat 6: RoadtoNepal (button) collected ($5.25)
Seat 7: Ohpeel (small blind) folded on the Flop
Seat 8: deepblue0000 (big blind) folded before Flop
Seat 9: di0d80 folded before Flop (didn't bet)





PokerStars Hand #147754663748:  Hold'em No Limit ($0.50/$1.00 USD) - 2016/01/27 11:53:07 CET [2016/01/27 5:53:07 ET]
Table 'Dollfus' 9-max Seat #4 is the button
Seat 2: nosoant ($85.50 in chips) 
Seat 3: UShallGimme$ ($100 in chips) 
Seat 4: matiko09 ($126.47 in chips) 
Seat 5: pandalapa ($220.98 in chips) 
Seat 6: deepblue0000 ($100 in chips) 
Seat 7: Dödi123 ($209.72 in chips) 
Seat 8: Venomous100% ($126.27 in chips) 
Seat 9: COOLIKO\/23 ($101.50 in chips) 
pandalapa: posts small blind $0.50
deepblue0000: posts big blind $1
masaytoo: sits out 
*** HOLE CARDS ***
Dealt to matiko09 [Qs Kd]
Dödi123: folds 
Venomous100%: folds 
COOLIKO\/23: raises $2 to $3
nosoant: folds 
UShallGimme$: folds 
matiko09: raises $6.50 to $9.50
pandalapa: folds 
deepblue0000: folds 
COOLIKO\/23: raises $10.50 to $20
matiko09: folds 
Uncalled bet ($10.50) returned to COOLIKO\/23
COOLIKO\/23 collected $20.50 from pot
COOLIKO\/23: doesn't show hand 
*** SUMMARY ***
Total pot $20.50 | Rake $0 
Seat 2: nosoant folded before Flop (didn't bet)
Seat 3: UShallGimme$ folded before Flop (didn't bet)
Seat 4: matiko09 (button) folded before Flop
Seat 5: pandalapa (small blind) folded before Flop
Seat 6: deepblue0000 (big blind) folded before Flop
Seat 7: Dödi123 folded before Flop (didn't bet)
Seat 8: Venomous100% folded before Flop (didn't bet)
Seat 9: COOLIKO\/23 collected ($20.50)





PokerStars Hand #147754664571:  Hold'em No Limit ($0.50/$1.00 USD) - 2016/01/27 11:53:08 CET [2016/01/27 5:53:08 ET]
Table 'Delphinus II' 9-max Seat #2 is the button
Seat 1: Saintreine ($140.58 in chips) 
Seat 2: AlKatrone ($200.25 in chips) 
Seat 3: deepblue0000 ($329.48 in chips) 
Seat 4: matiko09 ($121.73 in chips) 
Seat 5: pandalapa ($108.14 in chips) 
Seat 6: Sweden_Pound ($124.64 in chips) 
Seat 7: RUS)Timur ($100 in chips) 
Seat 8: mycka86 ($107.02 in chips) 
Seat 9: FGL-lucky ($46.38 in chips) 
deepblue0000: posts small blind $0.50
matiko09: posts big blind $1
*** HOLE CARDS ***
Dealt to matiko09 [Ac 3c]
pandalapa: folds 
Sweden_Pound: folds 
RUS)Timur: raises $1.50 to $2.50
mycka86: folds 
FGL-lucky: calls $2.50
Saintreine: folds 
AlKatrone: folds 
deepblue0000: calls $2
matiko09: calls $1.50
*** FLOP *** [5c 4h 8c]
deepblue0000: checks 
matiko09: checks 
RUS)Timur: bets $7.50
FGL-lucky: calls $7.50
deepblue0000: raises $16.02 to $23.52
RUS)Timur is disconnected 
matiko09: raises $30.48 to $54
RUS)Timur: folds 
FGL-lucky: folds 
deepblue0000: raises $132.55 to $186.55
matiko09: calls $65.23 and is all-in
Uncalled bet ($67.32) returned to deepblue0000
*** TURN *** [5c 4h 8c] [4d]
*** RIVER *** [5c 4h 8c 4d] [Ks]
*** SHOW DOWN ***
deepblue0000: shows [7c 4c] (three of a kind, Fours)
matiko09: mucks hand 
deepblue0000 collected $260.66 from pot
*** SUMMARY ***
Total pot $263.46 | Rake $2.80 
Board [5c 4h 8c 4d Ks]
Seat 1: Saintreine folded before Flop (didn't bet)
Seat 2: AlKatrone (button) folded before Flop (didn't bet)
Seat 3: deepblue0000 (small blind) showed [7c 4c] and won ($260.66) with three of a kind, Fours
Seat 4: matiko09 (big blind) mucked [Ac 3c]
Seat 5: pandalapa folded before Flop (didn't bet)
Seat 6: Sweden_Pound folded before Flop (didn't bet)
Seat 7: RUS)Timur folded on the Flop
Seat 8: mycka86 folded before Flop (didn't bet)
Seat 9: FGL-lucky folded on the Flop





PokerStars Hand #147754674161:  Hold'em No Limit ($0.50/$1.00 USD) - 2016/01/27 11:53:28 CET [2016/01/27 5:53:28 ET]
Table 'Alkmene II' 9-max Seat #4 is the button
Seat 1: matiko09 ($101.50 in chips) 
Seat 2: deepblue0000 ($100 in chips) 
Seat 3: di0d80 ($100 in chips) 
Seat 4: CoolFireX ($149.07 in chips) 
Seat 5: Sweden_Pound ($114.55 in chips) 
Seat 6: Peu3aHy ($117.22 in chips) 
Seat 7: mycka86 ($101.50 in chips) 
Seat 8: fecsok1 ($119.88 in chips) 
Seat 9: pandalapa ($110.32 in chips) 
Sweden_Pound: posts small blind $0.50
Peu3aHy: posts big blind $1
*** HOLE CARDS ***
Dealt to matiko09 [4c 7c]
mycka86: folds 
fecsok1: folds 
pandalapa: folds 
matiko09: folds 
deepblue0000: folds 
di0d80: folds 
CoolFireX: folds 
Sweden_Pound: folds 
Uncalled bet ($0.50) returned to Peu3aHy
Peu3aHy collected $1 from pot
Peu3aHy: doesn't show hand 
*** SUMMARY ***
Total pot $1 | Rake $0 
Seat 1: matiko09 folded before Flop (didn't bet)
Seat 2: deepblue0000 folded before Flop (didn't bet)
Seat 3: di0d80 folded before Flop (didn't bet)
Seat 4: CoolFireX (button) folded before Flop (didn't bet)
Seat 5: Sweden_Pound (small blind) folded before Flop
Seat 6: Peu3aHy (big blind) collected ($1)
Seat 7: mycka86 folded before Flop (didn't bet)
Seat 8: fecsok1 folded before Flop (didn't bet)
Seat 9: pandalapa folded before Flop (didn't bet)





PokerStars Hand #147754683128:  Hold'em No Limit ($0.50/$1.00 USD) - 2016/01/27 11:53:45 CET [2016/01/27 5:53:45 ET]
Table 'Henyey' 9-max Seat #2 is the button
Seat 1: COOLIKO\/23 ($125.56 in chips) 
Seat 2: pandalapa ($149.27 in chips) 
Seat 3: deepblue0000 ($100 in chips) 
Seat 4: sylvian31 ($100 in chips) 
Seat 5: matiko09 ($115.12 in chips) 
Seat 6: UShallGimme$ ($101.78 in chips) 
Seat 7: vinniej15 ($56.16 in chips) 
Seat 8: CoolFireX ($109.54 in chips) 
Seat 9: mycka86 ($135.13 in chips) 
deepblue0000: posts small blind $0.50
sylvian31: posts big blind $1
*** HOLE CARDS ***
Dealt to matiko09 [6h 7h]
matiko09: folds 
UShallGimme$: raises $2 to $3
vinniej15: folds 
CoolFireX: folds 
mycka86: calls $3
COOLIKO\/23: folds 
pandalapa: folds 
deepblue0000: folds 
sylvian31: folds 
*** FLOP *** [3h Jh Qs]
UShallGimme$: checks 
mycka86: checks 
*** TURN *** [3h Jh Qs] [Qd]
UShallGimme$: bets $4.50
mycka86: folds 
Uncalled bet ($4.50) returned to UShallGimme$
UShallGimme$ collected $7.16 from pot
UShallGimme$: doesn't show hand 
*** SUMMARY ***
Total pot $7.50 | Rake $0.34 
Board [3h Jh Qs Qd]
Seat 1: COOLIKO\/23 folded before Flop (didn't bet)
Seat 2: pandalapa (button) folded before Flop (didn't bet)
Seat 3: deepblue0000 (small blind) folded before Flop
Seat 4: sylvian31 (big blind) folded before Flop
Seat 5: matiko09 folded before Flop (didn't bet)
Seat 6: UShallGimme$ collected ($7.16)
Seat 7: vinniej15 folded before Flop (didn't bet)
Seat 8: CoolFireX folded before Flop (didn't bet)
Seat 9: mycka86 folded on the Turn





PokerStars Hand #147754683208:  Hold'em No Limit ($1/$2 USD) - 2016/01/27 11:53:45 CET [2016/01/27 5:53:45 ET]
Table 'Phobos II' 9-max Seat #4 is the button
Seat 1: LRV21 ($393.14 in chips) 
Seat 2: di0d80 ($258.68 in chips) 
Seat 3: sylvian31 ($200 in chips) 
Seat 4: flk.Dasas ($307.18 in chips) 
Seat 5: tipner ($200 in chips) 
Seat 6: matiko09 ($230.15 in chips) 
Seat 7: Venomous100% ($285.42 in chips) 
Seat 8: RoadtoNepal ($236.54 in chips) 
Seat 9: Kukuryzka ($370.03 in chips) 
tipner: posts small blind $1
matiko09: posts big blind $2
*** HOLE CARDS ***
Dealt to matiko09 [8d Kh]
Venomous100%: folds 
RoadtoNepal: folds 
Kukuryzka: folds 
LRV21: raises $4 to $6
di0d80: folds 
sylvian31: folds 
flk.Dasas: folds 
tipner: folds 
matiko09: folds 
Uncalled bet ($4) returned to LRV21
LRV21 collected $5 from pot
LRV21: doesn't show hand 
*** SUMMARY ***
Total pot $5 | Rake $0 
Seat 1: LRV21 collected ($5)
Seat 2: di0d80 folded before Flop (didn't bet)
Seat 3: sylvian31 folded before Flop (didn't bet)
Seat 4: flk.Dasas (button) folded before Flop (didn't bet)
Seat 5: tipner (small blind) folded before Flop
Seat 6: matiko09 (big blind) folded before Flop
Seat 7: Venomous100% folded before Flop (didn't bet)
Seat 8: RoadtoNepal folded before Flop (didn't bet)
Seat 9: Kukuryzka folded before Flop (didn't bet)





PokerStars Hand #147754685159:  Hold'em No Limit (€0.50/€1.00 EUR) - 2016/01/27 11:53:49 CET [2016/01/27 5:53:49 ET]
Table 'Carol' 9-max Seat #7 is the button
Seat 1: RoadtoNepal (€100 in chips) 
Seat 2: sylvian31 (€100 in chips) 
Seat 3: noname076 (€103.41 in chips) 
Seat 5: Proandi (€47.30 in chips) 
Seat 6: Kukuryzka (€177.03 in chips) 
Seat 7: tipner (€109.44 in chips) 
Seat 8: matiko09 (€100 in chips) 
Seat 9: Venomous100% (€101.50 in chips) 
matiko09: posts small blind €0.50
Venomous100%: posts big blind €1
Sweden_Pound: sits out 
*** HOLE CARDS ***
Dealt to matiko09 [Th Jh]
RoadtoNepal: folds 
sylvian31: folds 
noname076: calls €1
Proandi: folds 
Kukuryzka: folds 
tipner: folds 
matiko09: calls €0.50
Venomous100%: checks 
*** FLOP *** [Ac Jd Ks]
matiko09: checks 
Venomous100%: checks 
noname076: bets €2.86
matiko09: folds 
Venomous100%: folds 
Uncalled bet (€2.86) returned to noname076
noname076 collected €2.86 from pot
noname076: doesn't show hand 
*** SUMMARY ***
Total pot €3 | Rake €0.14 
Board [Ac Jd Ks]
Seat 1: RoadtoNepal folded before Flop (didn't bet)
Seat 2: sylvian31 folded before Flop (didn't bet)
Seat 3: noname076 collected (€2.86)
Seat 5: Proandi folded before Flop (didn't bet)
Seat 6: Kukuryzka folded before Flop (didn't bet)
Seat 7: tipner (button) folded before Flop (didn't bet)
Seat 8: matiko09 (small blind) folded on the Flop
Seat 9: Venomous100% (big blind) folded on the Flop





PokerStars Hand #147754685557:  Hold'em No Limit ($0.50/$1.00 USD) - 2016/01/27 11:53:50 CET [2016/01/27 5:53:50 ET]
Table 'Nanking' 9-max Seat #6 is the button
Seat 1: Peu3aHy ($104.16 in chips) 
Seat 2: Dachish ($99.17 in chips) 
Seat 3: nuaxin ($55.15 in chips) 
Seat 4: COOLIKO\/23 ($161.54 in chips) 
Seat 5: TheGentleFox ($101.07 in chips) 
Seat 6: Kukuryzka ($106.53 in chips) 
Seat 7: tipner ($106.80 in chips) 
Seat 8: matiko09 ($100 in chips) 
Seat 9: Sweden_Pound ($139.22 in chips) 
tipner: posts small blind $0.50
matiko09: posts big blind $1
*** HOLE CARDS ***
Dealt to matiko09 [8d Js]
Sweden_Pound: folds 
Peu3aHy: folds 
Dachish: folds 
nuaxin: raises $2 to $3
COOLIKO\/23: folds 
TheGentleFox: calls $3
Kukuryzka: folds 
tipner: folds 
matiko09: folds 
*** FLOP *** [8h 7c Kh]
nuaxin: checks 
TheGentleFox: bets $3.58
nuaxin: folds 
Uncalled bet ($3.58) returned to TheGentleFox
TheGentleFox collected $7.16 from pot
TheGentleFox: doesn't show hand 
*** SUMMARY ***
Total pot $7.50 | Rake $0.34 
Board [8h 7c Kh]
Seat 1: Peu3aHy folded before Flop (didn't bet)
Seat 2: Dachish folded before Flop (didn't bet)
Seat 3: nuaxin folded on the Flop
Seat 4: COOLIKO\/23 folded before Flop (didn't bet)
Seat 5: TheGentleFox collected ($7.16)
Seat 6: Kukuryzka (button) folded before Flop (didn't bet)
Seat 7: tipner (small blind) folded before Flop
Seat 8: matiko09 (big blind) folded before Flop
Seat 9: Sweden_Pound folded before Flop (didn't bet)





PokerStars Hand #147754687195:  Hold'em No Limit ($0.50/$1.00 USD) - 2016/01/27 11:53:53 CET [2016/01/27 5:53:53 ET]
Table 'Dollfus' 9-max Seat #5 is the button
Seat 2: nosoant ($85.50 in chips) 
Seat 3: UShallGimme$ ($100 in chips) 
Seat 4: matiko09 ($116.97 in chips) 
Seat 5: pandalapa ($220.48 in chips) 
Seat 6: deepblue0000 ($100 in chips) 
Seat 7: Dödi123 ($209.72 in chips) 
Seat 8: Venomous100% ($126.27 in chips) 
Seat 9: COOLIKO\/23 ($112.50 in chips) 
deepblue0000: posts small blind $0.50
Dödi123: posts big blind $1
masaytoo: sits out 
*** HOLE CARDS ***
Dealt to matiko09 [Kh 6c]
Venomous100%: folds 
COOLIKO\/23: raises $2 to $3
nosoant: folds 
UShallGimme$: folds 
matiko09: folds 
pandalapa: folds 
deepblue0000: calls $2.50
Dödi123: folds 
*** FLOP *** [4h 3c 9s]
deepblue0000: checks 
COOLIKO\/23: bets $4.34
deepblue0000: folds 
Uncalled bet ($4.34) returned to COOLIKO\/23
COOLIKO\/23 collected $6.68 from pot
COOLIKO\/23: doesn't show hand 
*** SUMMARY ***
Total pot $7 | Rake $0.32 
Board [4h 3c 9s]
Seat 2: nosoant folded before Flop (didn't bet)
Seat 3: UShallGimme$ folded before Flop (didn't bet)
Seat 4: matiko09 folded before Flop (didn't bet)
Seat 5: pandalapa (button) folded before Flop (didn't bet)
Seat 6: deepblue0000 (small blind) folded on the Flop
Seat 7: Dödi123 (big blind) folded before Flop
Seat 8: Venomous100% folded before Flop (didn't bet)
Seat 9: COOLIKO\/23 collected ($6.68)





PokerStars Hand #147754690926:  Hold'em No Limit ($0.50/$1.00 USD) - 2016/01/27 11:54:01 CET [2016/01/27 5:54:01 ET]
Table 'Alhajoth' 9-max Seat #7 is the button
Seat 1: UShallGimme$ ($108.95 in chips) 
Seat 2: matiko09 ($100 in chips) 
Seat 3: Sweden_Pound ($110.27 in chips) 
Seat 4: Venomous100% ($155.65 in chips) 
Seat 5: Kukuryzka ($108.66 in chips) 
Seat 6: RoadtoNepal ($185.80 in chips) 
Seat 7: Ohpeel ($135.06 in chips) 
Seat 8: deepblue0000 ($120.68 in chips) 
Seat 9: di0d80 ($100 in chips) 
deepblue0000: posts small blind $0.50
di0d80: posts big blind $1
*** HOLE CARDS ***
Dealt to matiko09 [2d Kc]
UShallGimme$: folds 
matiko09: folds 
Sweden_Pound: folds 
Venomous100%: folds 
Kukuryzka: folds 
RoadtoNepal: raises $2 to $3
Ohpeel: calls $3
deepblue0000: folds 
di0d80: folds 
*** FLOP *** [2h 4s 9c]
RoadtoNepal: bets $4.77
Ohpeel: folds 
Uncalled bet ($4.77) returned to RoadtoNepal
RoadtoNepal collected $7.16 from pot
RoadtoNepal: doesn't show hand 
*** SUMMARY ***
Total pot $7.50 | Rake $0.34 
Board [2h 4s 9c]
Seat 1: UShallGimme$ folded before Flop (didn't bet)
Seat 2: matiko09 folded before Flop (didn't bet)
Seat 3: Sweden_Pound folded before Flop (didn't bet)
Seat 4: Venomous100% folded before Flop (didn't bet)
Seat 5: Kukuryzka folded before Flop (didn't bet)
Seat 6: RoadtoNepal collected ($7.16)
Seat 7: Ohpeel (button) folded on the Flop
Seat 8: deepblue0000 (small blind) folded before Flop
Seat 9: di0d80 (big blind) folded before Flop





PokerStars Hand #147754696747:  Hold'em No Limit ($0.50/$1.00 USD) - 2016/01/27 11:54:12 CET [2016/01/27 5:54:12 ET]
Table 'Alkmene II' 9-max Seat #5 is the button
Seat 1: matiko09 ($101.50 in chips) 
Seat 2: deepblue0000 ($100 in chips) 
Seat 3: di0d80 ($100 in chips) 
Seat 4: CoolFireX ($149.07 in chips) 
Seat 5: Sweden_Pound ($114.05 in chips) 
Seat 6: Peu3aHy ($117.72 in chips) 
Seat 7: mycka86 ($101.50 in chips) 
Seat 8: fecsok1 ($119.88 in chips) 
Seat 9: pandalapa ($110.32 in chips) 
Peu3aHy: posts small blind $0.50
mycka86: posts big blind $1
*** HOLE CARDS ***
Dealt to matiko09 [8h Js]
fecsok1: folds 
pandalapa: folds 
matiko09: folds 
deepblue0000: folds 
di0d80: folds 
CoolFireX: raises $1.50 to $2.50
Sweden_Pound: folds 
Peu3aHy: folds 
mycka86: calls $1.50
*** FLOP *** [Tc 4d 4h]
mycka86: checks 
CoolFireX: bets $3.49
mycka86: folds 
Uncalled bet ($3.49) returned to CoolFireX
CoolFireX collected $5.25 from pot
CoolFireX: doesn't show hand 
*** SUMMARY ***
Total pot $5.50 | Rake $0.25 
Board [Tc 4d 4h]
Seat 1: matiko09 folded before Flop (didn't bet)
Seat 2: deepblue0000 folded before Flop (didn't bet)
Seat 3: di0d80 folded before Flop (didn't bet)
Seat 4: CoolFireX collected ($5.25)
Seat 5: Sweden_Pound (button) folded before Flop (didn't bet)
Seat 6: Peu3aHy (small blind) folded before Flop
Seat 7: mycka86 (big blind) folded on the Flop
Seat 8: fecsok1 folded before Flop (didn't bet)
Seat 9: pandalapa folded before Flop (didn't bet)





PokerStars Hand #147754699183:  Hold'em No Limit ($1/$2 USD) - 2016/01/27 11:54:17 CET [2016/01/27 5:54:17 ET]
Table 'Phobos II' 9-max Seat #5 is the button
Seat 1: LRV21 ($396.14 in chips) 
Seat 2: di0d80 ($258.68 in chips) 
Seat 3: sylvian31 ($200 in chips) 
Seat 4: flk.Dasas ($307.18 in chips) 
Seat 5: tipner ($200 in chips) 
Seat 6: matiko09 ($228.15 in chips) 
Seat 7: Venomous100% ($285.42 in chips) 
Seat 8: RoadtoNepal ($236.54 in chips) 
Seat 9: Kukuryzka ($370.03 in chips) 
matiko09: posts small blind $1
Venomous100%: posts big blind $2
*** HOLE CARDS ***
Dealt to matiko09 [6c 3h]
RoadtoNepal: raises $4 to $6
Kukuryzka: folds 
LRV21: folds 
di0d80: folds 
sylvian31: folds 
flk.Dasas: folds 
tipner: folds 
matiko09: folds 
Venomous100%: folds 
Uncalled bet ($4) returned to RoadtoNepal
RoadtoNepal collected $5 from pot
RoadtoNepal: doesn't show hand 
*** SUMMARY ***
Total pot $5 | Rake $0 
Seat 1: LRV21 folded before Flop (didn't bet)
Seat 2: di0d80 folded before Flop (didn't bet)
Seat 3: sylvian31 folded before Flop (didn't bet)
Seat 4: flk.Dasas folded before Flop (didn't bet)
Seat 5: tipner (button) folded before Flop (didn't bet)
Seat 6: matiko09 (small blind) folded before Flop
Seat 7: Venomous100% (big blind) folded before Flop
Seat 8: RoadtoNepal collected ($5)
Seat 9: Kukuryzka folded before Flop (didn't bet)





PokerStars Hand #147754703346:  Hold'em No Limit ($0.50/$1.00 USD) - 2016/01/27 11:54:25 CET [2016/01/27 5:54:25 ET]
Table 'Fragaria II' 9-max Seat #7 is the button
Seat 1: deepblue0000 ($140.62 in chips) 
Seat 2: GG-NoR34D. ($72.33 in chips) 
Seat 3: Sweden_Pound ($119.84 in chips) 
Seat 4: AlKatrone ($100.50 in chips) 
Seat 5: Venomous100% ($108.86 in chips) 
Seat 6: UShallGimme$ ($179.99 in chips) 
Seat 7: Hobby-.-AK ($48.23 in chips) 
Seat 8: mycka86 ($100.56 in chips) 
Seat 9: matiko09 ($102 in chips) 
mycka86: posts small blind $0.50
matiko09: posts big blind $1
*** HOLE CARDS ***
Dealt to matiko09 [8c 7h]
deepblue0000: folds 
GG-NoR34D.: folds 
Sweden_Pound: folds 
AlKatrone: folds 
Venomous100%: folds 
UShallGimme$: raises $1.50 to $2.50
Hobby-.-AK: folds 
mycka86: folds 
matiko09: folds 
Uncalled bet ($1.50) returned to UShallGimme$
UShallGimme$ collected $2.50 from pot
UShallGimme$: doesn't show hand 
*** SUMMARY ***
Total pot $2.50 | Rake $0 
Seat 1: deepblue0000 folded before Flop (didn't bet)
Seat 2: GG-NoR34D. folded before Flop (didn't bet)
Seat 3: Sweden_Pound folded before Flop (didn't bet)
Seat 4: AlKatrone folded before Flop (didn't bet)
Seat 5: Venomous100% folded before Flop (didn't bet)
Seat 6: UShallGimme$ collected ($2.50)
Seat 7: Hobby-.-AK (button) folded before Flop (didn't bet)
Seat 8: mycka86 (small blind) folded before Flop
Seat 9: matiko09 (big blind) folded before Flop





PokerStars Hand #147754705705:  Hold'em No Limit ($0.50/$1.00 USD) - 2016/01/27 11:54:30 CET [2016/01/27 5:54:30 ET]
Table 'Dollfus' 9-max Seat #6 is the button
Seat 2: nosoant ($85.50 in chips) 
Seat 3: UShallGimme$ ($100 in chips) 
Seat 4: matiko09 ($116.97 in chips) 
Seat 5: pandalapa ($220.48 in chips) 
Seat 6: deepblue0000 ($100 in chips) 
Seat 7: Dödi123 ($208.72 in chips) 
Seat 8: Venomous100% ($126.27 in chips) 
Seat 9: COOLIKO\/23 ($116.18 in chips) 
Dödi123: posts small blind $0.50
Venomous100%: posts big blind $1
masaytoo: sits out 
*** HOLE CARDS ***
Dealt to matiko09 [Ts Jh]
COOLIKO\/23: raises $2 to $3
nosoant: calls $3
UShallGimme$: folds 
matiko09: folds 
pandalapa: folds 
deepblue0000: calls $3
Dödi123: folds 
Venomous100%: folds 
*** FLOP *** [4c Js As]
COOLIKO\/23: checks 
nosoant: checks 
deepblue0000: checks 
*** TURN *** [4c Js As] [8s]
COOLIKO\/23: bets $7
nosoant: folds 
deepblue0000: folds 
Uncalled bet ($7) returned to COOLIKO\/23
COOLIKO\/23 collected $10.03 from pot
COOLIKO\/23: doesn't show hand 
*** SUMMARY ***
Total pot $10.50 | Rake $0.47 
Board [4c Js As 8s]
Seat 2: nosoant folded on the Turn
Seat 3: UShallGimme$ folded before Flop (didn't bet)
Seat 4: matiko09 folded before Flop (didn't bet)
Seat 5: pandalapa folded before Flop (didn't bet)
Seat 6: deepblue0000 (button) folded on the Turn
Seat 7: Dödi123 (small blind) folded before Flop
Seat 8: Venomous100% (big blind) folded before Flop
Seat 9: COOLIKO\/23 collected ($10.03)





PokerStars Hand #147754708980:  Hold'em No Limit ($0.50/$1.00 USD) - 2016/01/27 11:54:37 CET [2016/01/27 5:54:37 ET]
Table 'Nanking' 9-max Seat #7 is the button
Seat 1: Peu3aHy ($104.16 in chips) 
Seat 2: Dachish ($99.17 in chips) 
Seat 3: nuaxin ($52.15 in chips) 
Seat 4: COOLIKO\/23 ($161.54 in chips) 
Seat 5: TheGentleFox ($105.23 in chips) 
Seat 6: Kukuryzka ($106.53 in chips) 
Seat 7: tipner ($106.30 in chips) 
Seat 8: matiko09 ($100 in chips) 
Seat 9: Sweden_Pound ($139.22 in chips) 
matiko09: posts small blind $0.50
Sweden_Pound: posts big blind $1
*** HOLE CARDS ***
Dealt to matiko09 [Tc 8d]
Peu3aHy: folds 
Dachish: raises $2 to $3
nuaxin: folds 
COOLIKO\/23: calls $3
TheGentleFox: folds 
Kukuryzka: folds 
tipner: folds 
matiko09: folds 
Sweden_Pound: folds 
*** FLOP *** [3c 4h Kh]
Dachish: bets $5
COOLIKO\/23: folds 
Uncalled bet ($5) returned to Dachish
Dachish collected $7.16 from pot
Dachish: doesn't show hand 
*** SUMMARY ***
Total pot $7.50 | Rake $0.34 
Board [3c 4h Kh]
Seat 1: Peu3aHy folded before Flop (didn't bet)
Seat 2: Dachish collected ($7.16)
Seat 3: nuaxin folded before Flop (didn't bet)
Seat 4: COOLIKO\/23 folded on the Flop
Seat 5: TheGentleFox folded before Flop (didn't bet)
Seat 6: Kukuryzka folded before Flop (didn't bet)
Seat 7: tipner (button) folded before Flop (didn't bet)
Seat 8: matiko09 (small blind) folded before Flop
Seat 9: Sweden_Pound (big blind) folded before Flop





PokerStars Hand #147754712898:  Hold'em No Limit ($0.50/$1.00 USD) - 2016/01/27 11:54:44 CET [2016/01/27 5:54:44 ET]
Table 'Alhajoth' 9-max Seat #8 is the button
Seat 1: UShallGimme$ ($108.95 in chips) 
Seat 2: matiko09 ($100 in chips) 
Seat 3: Sweden_Pound ($110.27 in chips) 
Seat 4: Venomous100% ($155.65 in chips) 
Seat 5: Kukuryzka ($108.66 in chips) 
Seat 6: RoadtoNepal ($189.96 in chips) 
Seat 7: Ohpeel ($132.06 in chips) 
Seat 8: deepblue0000 ($120.18 in chips) 
Seat 9: di0d80 ($100 in chips) 
di0d80: posts small blind $0.50
UShallGimme$: posts big blind $1
*** HOLE CARDS ***
Dealt to matiko09 [Kh 9c]
matiko09: folds 
Sweden_Pound: folds 
Venomous100%: folds 
Kukuryzka: folds 
RoadtoNepal: folds 
Ohpeel: folds 
deepblue0000: folds 
di0d80: folds 
Uncalled bet ($0.50) returned to UShallGimme$
UShallGimme$ collected $1 from pot
UShallGimme$: doesn't show hand 
*** SUMMARY ***
Total pot $1 | Rake $0 
Seat 1: UShallGimme$ (big blind) collected ($1)
Seat 2: matiko09 folded before Flop (didn't bet)
Seat 3: Sweden_Pound folded before Flop (didn't bet)
Seat 4: Venomous100% folded before Flop (didn't bet)
Seat 5: Kukuryzka folded before Flop (didn't bet)
Seat 6: RoadtoNepal folded before Flop (didn't bet)
Seat 7: Ohpeel folded before Flop (didn't bet)
Seat 8: deepblue0000 (button) folded before Flop (didn't bet)
Seat 9: di0d80 (small blind) folded before Flop





PokerStars Hand #147754714378:  Hold'em No Limit (€0.50/€1.00 EUR) - 2016/01/27 11:54:47 CET [2016/01/27 5:54:47 ET]
Table 'Carol' 9-max Seat #8 is the button
Seat 1: RoadtoNepal (€100 in chips) 
Seat 2: sylvian31 (€100 in chips) 
Seat 3: noname076 (€105.27 in chips) 
Seat 5: Proandi (€47.30 in chips) 
Seat 6: Kukuryzka (€177.03 in chips) 
Seat 7: tipner (€109.44 in chips) 
Seat 8: matiko09 (€100 in chips) 
Seat 9: Venomous100% (€100.50 in chips) 
Venomous100%: posts small blind €0.50
RoadtoNepal: posts big blind €1
Sweden_Pound: sits out 
*** HOLE CARDS ***
Dealt to matiko09 [9h 8c]
sylvian31: folds 
noname076: raises €1 to €2
Proandi: calls €2
Kukuryzka: folds 
tipner: raises €9 to €11
matiko09: folds 
Venomous100%: folds 
RoadtoNepal: folds 
noname076: calls €9
Proandi: calls €9
*** FLOP *** [7c 3c Ad]
noname076: bets €5
Proandi: folds 
tipner: raises €10 to €15
noname076: calls €10
*** TURN *** [7c 3c Ad] [3s]
noname076: checks 
tipner: bets €26
noname076: calls €26
*** RIVER *** [7c 3c Ad 3s] [2d]
noname076: bets €10
tipner: raises €47.44 to €57.44 and is all-in
noname076: folds 
Uncalled bet (€47.44) returned to tipner
tipner collected €134.35 from pot
tipner: doesn't show hand 
*** SUMMARY ***
Total pot €136.50 | Rake €2.15 
Board [7c 3c Ad 3s 2d]
Seat 1: RoadtoNepal (big blind) folded before Flop
Seat 2: sylvian31 folded before Flop (didn't bet)
Seat 3: noname076 folded on the River
Seat 5: Proandi folded on the Flop
Seat 6: Kukuryzka folded before Flop (didn't bet)
Seat 7: tipner collected (€134.35)
Seat 8: matiko09 (button) folded before Flop (didn't bet)
Seat 9: Venomous100% (small blind) folded before Flop





PokerStars Hand #147754719807:  Hold'em No Limit ($0.50/$1.00 USD) - 2016/01/27 11:54:58 CET [2016/01/27 5:54:58 ET]
Table 'Henyey' 9-max Seat #3 is the button
Seat 1: COOLIKO\/23 ($125.56 in chips) 
Seat 2: pandalapa ($149.27 in chips) 
Seat 3: deepblue0000 ($100 in chips) 
Seat 4: sylvian31 ($100 in chips) 
Seat 5: matiko09 ($115.12 in chips) 
Seat 6: UShallGimme$ ($105.94 in chips) 
Seat 7: vinniej15 ($56.16 in chips) 
Seat 8: CoolFireX ($109.54 in chips) 
Seat 9: mycka86 ($132.13 in chips) 
sylvian31: posts small blind $0.50
matiko09: posts big blind $1
*** HOLE CARDS ***
Dealt to matiko09 [5d 5s]
UShallGimme$: folds 
vinniej15: calls $1
CoolFireX: folds 
mycka86: folds 
COOLIKO\/23: raises $4 to $5
pandalapa: folds 
deepblue0000: folds 
sylvian31: folds 
matiko09: calls $4
vinniej15: calls $4
*** FLOP *** [7h 4s 7d]
matiko09: bets $8.01
vinniej15: folds 
COOLIKO\/23: calls $8.01
*** TURN *** [7h 4s 7d] [5c]
matiko09: bets $15
COOLIKO\/23: calls $15
*** RIVER *** [7h 4s 7d 5c] [8h]
matiko09: bets $30
COOLIKO\/23: calls $30
*** SHOW DOWN ***
matiko09: shows [5d 5s] (a full house, Fives full of Sevens)
COOLIKO\/23: mucks hand 
matiko09 collected $118.72 from pot
*** SUMMARY ***
Total pot $121.52 | Rake $2.80 
Board [7h 4s 7d 5c 8h]
Seat 1: COOLIKO\/23 mucked [Qh Qd]
Seat 2: pandalapa folded before Flop (didn't bet)
Seat 3: deepblue0000 (button) folded before Flop (didn't bet)
Seat 4: sylvian31 (small blind) folded before Flop
Seat 5: matiko09 (big blind) showed [5d 5s] and won ($118.72) with a full house, Fives full of Sevens
Seat 6: UShallGimme$ folded before Flop (didn't bet)
Seat 7: vinniej15 folded on the Flop
Seat 8: CoolFireX folded before Flop (didn't bet)
Seat 9: mycka86 folded before Flop (didn't bet)





PokerStars Hand #147754723603:  Hold'em No Limit ($1/$2 USD) - 2016/01/27 11:55:05 CET [2016/01/27 5:55:05 ET]
Table 'Phobos II' 9-max Seat #6 is the button
Seat 1: LRV21 ($396.14 in chips) 
Seat 2: di0d80 ($258.68 in chips) 
Seat 3: sylvian31 ($200 in chips) 
Seat 4: flk.Dasas ($307.18 in chips) 
Seat 5: tipner ($200 in chips) 
Seat 6: matiko09 ($227.15 in chips) 
Seat 7: Venomous100% ($283.42 in chips) 
Seat 8: RoadtoNepal ($239.54 in chips) 
Seat 9: Kukuryzka ($370.03 in chips) 
Venomous100%: posts small blind $1
RoadtoNepal: posts big blind $2
*** HOLE CARDS ***
Dealt to matiko09 [3h 7h]
Kukuryzka: folds 
LRV21: raises $4 to $6
di0d80: folds 
sylvian31: folds 
flk.Dasas: calls $6
tipner: folds 
matiko09: folds 
Venomous100%: folds 
RoadtoNepal: folds 
*** FLOP *** [8s 4s Jd]
LRV21: bets $11
flk.Dasas: calls $11
*** TURN *** [8s 4s Jd] [8c]
LRV21: bets $35.34
flk.Dasas: calls $35.34
*** RIVER *** [8s 4s Jd 8c] [3c]
LRV21: bets $104.88
flk.Dasas: calls $104.88
*** SHOW DOWN ***
LRV21: shows [Ks Js] (two pair, Jacks and Eights)
flk.Dasas: mucks hand 
LRV21 collected $314.64 from pot
*** SUMMARY ***
Total pot $317.44 | Rake $2.80 
Board [8s 4s Jd 8c 3c]
Seat 1: LRV21 showed [Ks Js] and won ($314.64) with two pair, Jacks and Eights
Seat 2: di0d80 folded before Flop (didn't bet)
Seat 3: sylvian31 folded before Flop (didn't bet)
Seat 4: flk.Dasas mucked [9s 9h]
Seat 5: tipner folded before Flop (didn't bet)
Seat 6: matiko09 (button) folded before Flop (didn't bet)
Seat 7: Venomous100% (small blind) folded before Flop
Seat 8: RoadtoNepal (big blind) folded before Flop
Seat 9: Kukuryzka folded before Flop (didn't bet)





PokerStars Hand #147754727323:  Hold'em No Limit ($0.50/$1.00 USD) - 2016/01/27 11:55:14 CET [2016/01/27 5:55:14 ET]
Table 'Fragaria II' 9-max Seat #8 is the button
Seat 1: deepblue0000 ($140.62 in chips) 
Seat 2: GG-NoR34D. ($72.33 in chips) 
Seat 3: Sweden_Pound ($119.84 in chips) 
Seat 4: AlKatrone ($100.50 in chips) 
Seat 5: Venomous100% ($108.86 in chips) 
Seat 6: UShallGimme$ ($181.49 in chips) 
Seat 7: Hobby-.-AK ($48.23 in chips) 
Seat 8: mycka86 ($100.06 in chips) 
Seat 9: matiko09 ($101 in chips) 
matiko09: posts small blind $0.50
deepblue0000: posts big blind $1
*** HOLE CARDS ***
Dealt to matiko09 [Th 7c]
GG-NoR34D.: calls $1
Sweden_Pound: folds 
AlKatrone: raises $3 to $4
Venomous100%: calls $4
UShallGimme$: folds 
Hobby-.-AK: folds 
mycka86: folds 
matiko09: folds 
deepblue0000: folds 
GG-NoR34D.: calls $3
*** FLOP *** [2h 6h 8c]
GG-NoR34D.: checks 
AlKatrone: checks 
Venomous100%: bets $8.51
GG-NoR34D.: folds 
AlKatrone: folds 
Uncalled bet ($8.51) returned to Venomous100%
Venomous100% collected $12.89 from pot
Venomous100%: doesn't show hand 
*** SUMMARY ***
Total pot $13.50 | Rake $0.61 
Board [2h 6h 8c]
Seat 1: deepblue0000 (big blind) folded before Flop
Seat 2: GG-NoR34D. folded on the Flop
Seat 3: Sweden_Pound folded before Flop (didn't bet)
Seat 4: AlKatrone folded on the Flop
Seat 5: Venomous100% collected ($12.89)
Seat 6: UShallGimme$ folded before Flop (didn't bet)
Seat 7: Hobby-.-AK folded before Flop (didn't bet)
Seat 8: mycka86 (button) folded before Flop (didn't bet)
Seat 9: matiko09 (small blind) folded before Flop





PokerStars Hand #147754729037:  Hold'em No Limit ($0.50/$1.00 USD) - 2016/01/27 11:55:18 CET [2016/01/27 5:55:18 ET]
Table 'Alhajoth' 9-max Seat #9 is the button
Seat 1: UShallGimme$ ($109.45 in chips) 
Seat 2: matiko09 ($100 in chips) 
Seat 3: Sweden_Pound ($110.27 in chips) 
Seat 4: Venomous100% ($155.65 in chips) 
Seat 5: Kukuryzka ($108.66 in chips) 
Seat 6: RoadtoNepal ($189.96 in chips) 
Seat 7: Ohpeel ($132.06 in chips) 
Seat 8: deepblue0000 ($120.18 in chips) 
Seat 9: di0d80 ($100 in chips) 
UShallGimme$: posts small blind $0.50
matiko09: posts big blind $1
*** HOLE CARDS ***
Dealt to matiko09 [6s Kh]
Sweden_Pound: folds 
Venomous100%: raises $2 to $3
Kukuryzka: folds 
RoadtoNepal: folds 
Ohpeel: folds 
deepblue0000: folds 
di0d80: folds 
UShallGimme$: raises $7 to $10
matiko09: folds 
Venomous100%: folds 
Uncalled bet ($7) returned to UShallGimme$
UShallGimme$ collected $7 from pot
UShallGimme$: doesn't show hand 
*** SUMMARY ***
Total pot $7 | Rake $0 
Seat 1: UShallGimme$ (small blind) collected ($7)
Seat 2: matiko09 (big blind) folded before Flop
Seat 3: Sweden_Pound folded before Flop (didn't bet)
Seat 4: Venomous100% folded before Flop
Seat 5: Kukuryzka folded before Flop (didn't bet)
Seat 6: RoadtoNepal folded before Flop (didn't bet)
Seat 7: Ohpeel folded before Flop (didn't bet)
Seat 8: deepblue0000 folded before Flop (didn't bet)
Seat 9: di0d80 (button) folded before Flop (didn't bet)





PokerStars Hand #147754734745:  Hold'em No Limit ($0.50/$1.00 USD) - 2016/01/27 11:55:31 CET [2016/01/27 5:55:31 ET]
Table 'Delphinus II' 9-max Seat #3 is the button
Seat 1: Saintreine ($140.58 in chips) 
Seat 2: AlKatrone ($200.25 in chips) 
Seat 3: deepblue0000 ($468.41 in chips) 
Seat 4: matiko09 ($100 in chips) 
Seat 5: pandalapa ($108.14 in chips) 
Seat 6: Sweden_Pound ($124.64 in chips) 
Seat 7: RUS)Timur ($100 in chips) 
Seat 8: mycka86 ($107.02 in chips) 
Seat 9: FGL-lucky ($36.38 in chips) 
matiko09: posts small blind $0.50
pandalapa: posts big blind $1
*** HOLE CARDS ***
Dealt to matiko09 [7d 2c]
Sweden_Pound: folds 
RUS)Timur: folds 
mycka86: folds 
FGL-lucky: folds 
Saintreine: raises $1.50 to $2.50
AlKatrone: folds 
deepblue0000: folds 
matiko09: folds 
pandalapa: calls $1.50
*** FLOP *** [3s 9h 7c]
pandalapa: checks 
Saintreine: bets $2.73
pandalapa: folds 
Uncalled bet ($2.73) returned to Saintreine
Saintreine collected $5.25 from pot
Saintreine: doesn't show hand 
*** SUMMARY ***
Total pot $5.50 | Rake $0.25 
Board [3s 9h 7c]
Seat 1: Saintreine collected ($5.25)
Seat 2: AlKatrone folded before Flop (didn't bet)
Seat 3: deepblue0000 (button) folded before Flop (didn't bet)
Seat 4: matiko09 (small blind) folded before Flop
Seat 5: pandalapa (big blind) folded on the Flop
Seat 6: Sweden_Pound folded before Flop (didn't bet)
Seat 7: RUS)Timur folded before Flop (didn't bet)
Seat 8: mycka86 folded before Flop (didn't bet)
Seat 9: FGL-lucky folded before Flop (didn't bet)





PokerStars Hand #147754741523:  Hold'em No Limit ($0.50/$1.00 USD) - 2016/01/27 11:55:47 CET [2016/01/27 5:55:47 ET]
Table 'Alkmene II' 9-max Seat #6 is the button
Seat 1: matiko09 ($101.50 in chips) 
Seat 2: deepblue0000 ($100 in chips) 
Seat 3: di0d80 ($100 in chips) 
Seat 4: CoolFireX ($151.82 in chips) 
Seat 5: Sweden_Pound ($114.05 in chips) 
Seat 6: Peu3aHy ($117.22 in chips) 
Seat 7: mycka86 ($100 in chips) 
Seat 8: fecsok1 ($119.88 in chips) 
Seat 9: pandalapa ($110.32 in chips) 
mycka86: posts small blind $0.50
fecsok1: posts big blind $1
*** HOLE CARDS ***
Dealt to matiko09 [3s 9s]
pandalapa: folds 
matiko09: folds 
deepblue0000: folds 
di0d80: folds 
CoolFireX: raises $2 to $3
Sweden_Pound: folds 
Peu3aHy: raises $9 to $12
mycka86: folds 
fecsok1: folds 
CoolFireX: folds 
Uncalled bet ($9) returned to Peu3aHy
Peu3aHy collected $7.50 from pot
Peu3aHy: doesn't show hand 
*** SUMMARY ***
Total pot $7.50 | Rake $0 
Seat 1: matiko09 folded before Flop (didn't bet)
Seat 2: deepblue0000 folded before Flop (didn't bet)
Seat 3: di0d80 folded before Flop (didn't bet)
Seat 4: CoolFireX folded before Flop
Seat 5: Sweden_Pound folded before Flop (didn't bet)
Seat 6: Peu3aHy (button) collected ($7.50)
Seat 7: mycka86 (small blind) folded before Flop
Seat 8: fecsok1 (big blind) folded before Flop
Seat 9: pandalapa folded before Flop (didn't bet)





PokerStars Hand #147754743397:  Hold'em No Limit ($0.50/$1.00 USD) - 2016/01/27 11:55:51 CET [2016/01/27 5:55:51 ET]
Table 'Dollfus' 9-max Seat #7 is the button
Seat 2: nosoant ($82.50 in chips) 
Seat 3: UShallGimme$ ($100 in chips) 
Seat 4: matiko09 ($116.97 in chips) 
Seat 5: pandalapa ($220.48 in chips) 
Seat 6: deepblue0000 ($100 in chips) 
Seat 7: Dödi123 ($208.22 in chips) 
Seat 8: Venomous100% ($125.27 in chips) 
Seat 9: COOLIKO\/23 ($123.21 in chips) 
Venomous100%: posts small blind $0.50
COOLIKO\/23: posts big blind $1
masaytoo: sits out 
*** HOLE CARDS ***
Dealt to matiko09 [5c Th]
nosoant: calls $1
UShallGimme$: folds 
matiko09: folds 
pandalapa: folds 
deepblue0000: calls $1
Dödi123: folds 
Venomous100%: raises $4 to $5
COOLIKO\/23: folds 
nosoant: folds 
deepblue0000: calls $4
*** FLOP *** [4s 7s 2d]
Venomous100%: checks 
deepblue0000: bets $5.73
Venomous100%: folds 
Uncalled bet ($5.73) returned to deepblue0000
deepblue0000 collected $11.46 from pot
*** SUMMARY ***
Total pot $12 | Rake $0.54 
Board [4s 7s 2d]
Seat 2: nosoant folded before Flop
Seat 3: UShallGimme$ folded before Flop (didn't bet)
Seat 4: matiko09 folded before Flop (didn't bet)
Seat 5: pandalapa folded before Flop (didn't bet)
Seat 6: deepblue0000 collected ($11.46)
Seat 7: Dödi123 (button) folded before Flop (didn't bet)
Seat 8: Venomous100% (small blind) folded on the Flop
Seat 9: COOLIKO\/23 (big blind) folded before Flop





PokerStars Hand #147754743995:  Hold'em No Limit ($0.50/$1.00 USD) - 2016/01/27 11:55:52 CET [2016/01/27 5:55:52 ET]
Table 'Nanking' 9-max Seat #8 is the button
Seat 1: Peu3aHy ($104.16 in chips) 
Seat 2: Dachish ($103.33 in chips) 
Seat 3: nuaxin ($52.15 in chips) 
Seat 4: COOLIKO\/23 ($158.54 in chips) 
Seat 5: TheGentleFox ($105.23 in chips) 
Seat 6: Kukuryzka ($106.53 in chips) 
Seat 7: tipner ($106.30 in chips) 
Seat 8: matiko09 ($100 in chips) 
Seat 9: Sweden_Pound ($138.22 in chips) 
Sweden_Pound: posts small blind $0.50
Peu3aHy: posts big blind $1
*** HOLE CARDS ***
Dealt to matiko09 [7s 9d]
Dachish: folds 
nuaxin: calls $1
COOLIKO\/23: folds 
TheGentleFox: folds 
Kukuryzka: raises $3 to $4
tipner: folds 
matiko09: folds 
Sweden_Pound: folds 
Peu3aHy: folds 
nuaxin: raises $3 to $7
Kukuryzka: raises $99.53 to $106.53 and is all-in
nuaxin: calls $45.15 and is all-in
Uncalled bet ($54.38) returned to Kukuryzka
*** FLOP *** [4s Qs 6c]
*** TURN *** [4s Qs 6c] [5c]
*** RIVER *** [4s Qs 6c 5c] [2h]
*** SHOW DOWN ***
nuaxin: shows [Qd Qh] (three of a kind, Queens)
Kukuryzka: shows [Ts Tc] (a pair of Tens)
nuaxin collected $103 from pot
*** SUMMARY ***
Total pot $105.80 | Rake $2.80 
Board [4s Qs 6c 5c 2h]
Seat 1: Peu3aHy (big blind) folded before Flop
Seat 2: Dachish folded before Flop (didn't bet)
Seat 3: nuaxin showed [Qd Qh] and won ($103) with three of a kind, Queens
Seat 4: COOLIKO\/23 folded before Flop (didn't bet)
Seat 5: TheGentleFox folded before Flop (didn't bet)
Seat 6: Kukuryzka showed [Ts Tc] and lost with a pair of Tens
Seat 7: tipner folded before Flop (didn't bet)
Seat 8: matiko09 (button) folded before Flop (didn't bet)
Seat 9: Sweden_Pound (small blind) folded before Flop





PokerStars Hand #147754745249:  Hold'em No Limit ($0.50/$1.00 USD) - 2016/01/27 11:55:55 CET [2016/01/27 5:55:55 ET]
Table 'Alhajoth' 9-max Seat #1 is the button
Seat 1: UShallGimme$ ($113.45 in chips) 
Seat 2: matiko09 ($100 in chips) 
Seat 3: Sweden_Pound ($110.27 in chips) 
Seat 4: Venomous100% ($152.65 in chips) 
Seat 5: Kukuryzka ($108.66 in chips) 
Seat 6: RoadtoNepal ($189.96 in chips) 
Seat 7: Ohpeel ($132.06 in chips) 
Seat 8: deepblue0000 ($120.18 in chips) 
Seat 9: di0d80 ($100 in chips) 
matiko09: posts small blind $0.50
Sweden_Pound: posts big blind $1
*** HOLE CARDS ***
Dealt to matiko09 [Qh 2d]
Venomous100%: folds 
Kukuryzka: folds 
RoadtoNepal: folds 
Ohpeel: folds 
deepblue0000: folds 
di0d80: folds 
UShallGimme$: raises $1 to $2
matiko09: folds 
Sweden_Pound: folds 
Uncalled bet ($1) returned to UShallGimme$
UShallGimme$ collected $2.50 from pot
UShallGimme$: doesn't show hand 
*** SUMMARY ***
Total pot $2.50 | Rake $0 
Seat 1: UShallGimme$ (button) collected ($2.50)
Seat 2: matiko09 (small blind) folded before Flop
Seat 3: Sweden_Pound (big blind) folded before Flop
Seat 4: Venomous100% folded before Flop (didn't bet)
Seat 5: Kukuryzka folded before Flop (didn't bet)
Seat 6: RoadtoNepal folded before Flop (didn't bet)
Seat 7: Ohpeel folded before Flop (didn't bet)
Seat 8: deepblue0000 folded before Flop (didn't bet)
Seat 9: di0d80 folded before Flop (didn't bet)





PokerStars Hand #147754762514:  Hold'em No Limit ($0.50/$1.00 USD) - 2016/01/27 11:56:34 CET [2016/01/27 5:56:34 ET]
Table 'Fragaria II' 9-max Seat #9 is the button
Seat 1: deepblue0000 ($139.62 in chips) 
Seat 2: GG-NoR34D. ($68.33 in chips) 
Seat 3: Sweden_Pound ($119.84 in chips) 
Seat 4: AlKatrone ($100 in chips) 
Seat 5: Venomous100% ($117.75 in chips) 
Seat 6: UShallGimme$ ($181.49 in chips) 
Seat 7: Hobby-.-AK ($48.23 in chips) 
Seat 8: mycka86 ($100.06 in chips) 
Seat 9: matiko09 ($100.50 in chips) 
deepblue0000: posts small blind $0.50
GG-NoR34D.: posts big blind $1
*** HOLE CARDS ***
Dealt to matiko09 [Ks 3d]
Sweden_Pound: folds 
AlKatrone has timed out
AlKatrone: folds 
Venomous100%: folds 
UShallGimme$: folds 
Hobby-.-AK: folds 
mycka86: raises $1.10 to $2.10
matiko09: folds 
deepblue0000: raises $7.90 to $10
GG-NoR34D.: folds 
mycka86: folds 
Uncalled bet ($7.90) returned to deepblue0000
deepblue0000 collected $5.20 from pot
*** SUMMARY ***
Total pot $5.20 | Rake $0 
Seat 1: deepblue0000 (small blind) collected ($5.20)
Seat 2: GG-NoR34D. (big blind) folded before Flop
Seat 3: Sweden_Pound folded before Flop (didn't bet)
Seat 4: AlKatrone folded before Flop (didn't bet)
Seat 5: Venomous100% folded before Flop (didn't bet)
Seat 6: UShallGimme$ folded before Flop (didn't bet)
Seat 7: Hobby-.-AK folded before Flop (didn't bet)
Seat 8: mycka86 folded before Flop
Seat 9: matiko09 (button) folded before Flop (didn't bet)





PokerStars Hand #147754763157:  Hold'em No Limit ($0.50/$1.00 USD) - 2016/01/27 11:56:36 CET [2016/01/27 5:56:36 ET]
Table 'Delphinus II' 9-max Seat #4 is the button
Seat 1: Saintreine ($143.33 in chips) 
Seat 2: AlKatrone ($200.25 in chips) 
Seat 3: deepblue0000 ($468.41 in chips) 
Seat 4: matiko09 ($100 in chips) 
Seat 5: pandalapa ($105.64 in chips) 
Seat 6: Sweden_Pound ($124.64 in chips) 
Seat 7: RUS)Timur ($100 in chips) 
Seat 8: mycka86 ($107.02 in chips) 
Seat 9: FGL-lucky ($36.38 in chips) 
pandalapa: posts small blind $0.50
Sweden_Pound: posts big blind $1
*** HOLE CARDS ***
Dealt to matiko09 [8c 7c]
RUS)Timur: raises $1.50 to $2.50
mycka86: folds 
FGL-lucky: folds 
Saintreine: calls $2.50
AlKatrone: calls $2.50
deepblue0000: calls $2.50
matiko09: calls $2.50
pandalapa: folds 
Sweden_Pound: folds 
*** FLOP *** [5c 5h Ac]
RUS)Timur: bets $4.27
Saintreine: calls $4.27
AlKatrone: folds 
deepblue0000: folds 
matiko09: calls $4.27
*** TURN *** [5c 5h Ac] [5s]
RUS)Timur: checks 
Saintreine: bets $9
matiko09: folds 
RUS)Timur: calls $9
*** RIVER *** [5c 5h Ac 5s] [3s]
RUS)Timur: checks 
Saintreine: bets $5
RUS)Timur: calls $5
*** SHOW DOWN ***
Saintreine: shows [Ah 9h] (a full house, Fives full of Aces)
RUS)Timur: shows [Jh As] (a full house, Fives full of Aces)
RUS)Timur collected $26.17 from pot
Saintreine collected $26.17 from pot
*** SUMMARY ***
Total pot $54.81 | Rake $2.47 
Board [5c 5h Ac 5s 3s]
Seat 1: Saintreine showed [Ah 9h] and won ($26.17) with a full house, Fives full of Aces
Seat 2: AlKatrone folded on the Flop
Seat 3: deepblue0000 folded on the Flop
Seat 4: matiko09 (button) folded on the Turn
Seat 5: pandalapa (small blind) folded before Flop
Seat 6: Sweden_Pound (big blind) folded before Flop
Seat 7: RUS)Timur showed [Jh As] and won ($26.17) with a full house, Fives full of Aces
Seat 8: mycka86 folded before Flop (didn't bet)
Seat 9: FGL-lucky folded before Flop (didn't bet)





PokerStars Hand #147754764493:  Hold'em No Limit ($0.50/$1.00 USD) - 2016/01/27 11:56:39 CET [2016/01/27 5:56:39 ET]
Table 'Alhajoth' 9-max Seat #2 is the button
Seat 1: UShallGimme$ ($114.95 in chips) 
Seat 2: matiko09 ($100 in chips) 
Seat 3: Sweden_Pound ($109.27 in chips) 
Seat 4: Venomous100% ($152.65 in chips) 
Seat 5: Kukuryzka ($108.66 in chips) 
Seat 6: RoadtoNepal ($189.96 in chips) 
Seat 7: Ohpeel ($132.06 in chips) 
Seat 8: deepblue0000 ($120.18 in chips) 
Seat 9: di0d80 ($100 in chips) 
Sweden_Pound: posts small blind $0.50
Venomous100%: posts big blind $1
*** HOLE CARDS ***
Dealt to matiko09 [9s Jd]
Kukuryzka: folds 
RoadtoNepal: folds 
Ohpeel: raises $3.50 to $4.50
deepblue0000: calls $4.50
di0d80: folds 
UShallGimme$: folds 
matiko09: folds 
Sweden_Pound: folds 
Venomous100%: folds 
*** FLOP *** [Th 7s Kd]
Ohpeel: bets $6
deepblue0000: folds 
Uncalled bet ($6) returned to Ohpeel
Ohpeel collected $10.03 from pot
*** SUMMARY ***
Total pot $10.50 | Rake $0.47 
Board [Th 7s Kd]
Seat 1: UShallGimme$ folded before Flop (didn't bet)
Seat 2: matiko09 (button) folded before Flop (didn't bet)
Seat 3: Sweden_Pound (small blind) folded before Flop
Seat 4: Venomous100% (big blind) folded before Flop
Seat 5: Kukuryzka folded before Flop (didn't bet)
Seat 6: RoadtoNepal folded before Flop (didn't bet)
Seat 7: Ohpeel collected ($10.03)
Seat 8: deepblue0000 folded on the Flop
Seat 9: di0d80 folded before Flop (didn't bet)





PokerStars Hand #147754767907:  Hold'em No Limit ($0.50/$1.00 USD) - 2016/01/27 11:56:46 CET [2016/01/27 5:56:46 ET]
Table 'Alkmene II' 9-max Seat #7 is the button
Seat 1: matiko09 ($101.50 in chips) 
Seat 2: deepblue0000 ($100 in chips) 
Seat 3: di0d80 ($100 in chips) 
Seat 4: CoolFireX ($148.82 in chips) 
Seat 5: Sweden_Pound ($114.05 in chips) 
Seat 6: Peu3aHy ($121.72 in chips) 
Seat 7: mycka86 ($100 in chips) 
Seat 8: fecsok1 ($118.88 in chips) 
Seat 9: pandalapa ($110.32 in chips) 
fecsok1: posts small blind $0.50
pandalapa: posts big blind $1
*** HOLE CARDS ***
Dealt to matiko09 [Qh 8c]
matiko09: folds 
deepblue0000: folds 
di0d80: folds 
CoolFireX: folds 
Sweden_Pound: folds 
Peu3aHy: folds 
mycka86: raises $1.10 to $2.10
fecsok1: raises $4.40 to $6.50
pandalapa: folds 
mycka86: calls $4.40
*** FLOP *** [2c 8h 8d]
fecsok1: bets $7.50
mycka86: folds 
Uncalled bet ($7.50) returned to fecsok1
fecsok1 collected $13.37 from pot
*** SUMMARY ***
Total pot $14 | Rake $0.63 
Board [2c 8h 8d]
Seat 1: matiko09 folded before Flop (didn't bet)
Seat 2: deepblue0000 folded before Flop (didn't bet)
Seat 3: di0d80 folded before Flop (didn't bet)
Seat 4: CoolFireX folded before Flop (didn't bet)
Seat 5: Sweden_Pound folded before Flop (didn't bet)
Seat 6: Peu3aHy folded before Flop (didn't bet)
Seat 7: mycka86 (button) folded on the Flop
Seat 8: fecsok1 (small blind) collected ($13.37)
Seat 9: pandalapa (big blind) folded before Flop





PokerStars Hand #147754774984:  Hold'em No Limit (€0.50/€1.00 EUR) - 2016/01/27 11:57:02 CET [2016/01/27 5:57:02 ET]
Table 'Carol' 9-max Seat #9 is the button
Seat 1: RoadtoNepal (€100 in chips) 
Seat 2: sylvian31 (€100 in chips) 
Seat 3: noname076 (€43.27 in chips) 
Seat 5: Proandi (€36.30 in chips) 
Seat 6: Kukuryzka (€177.03 in chips) 
Seat 7: tipner (€181.79 in chips) 
Seat 8: matiko09 (€100 in chips) 
Seat 9: Venomous100% (€100 in chips) 
RoadtoNepal: posts small blind €0.50
sylvian31: posts big blind €1
Sweden_Pound: sits out 
*** HOLE CARDS ***
Dealt to matiko09 [6s 2h]
noname076: calls €1
Proandi: folds 
Kukuryzka: folds 
tipner: folds 
matiko09: folds 
Venomous100%: folds 
RoadtoNepal: folds 
sylvian31: checks 
*** FLOP *** [3d Kh Th]
sylvian31: bets €1.33
noname076: calls €1.33
*** TURN *** [3d Kh Th] [4s]
sylvian31: bets €3.30
noname076: calls €3.30
*** RIVER *** [3d Kh Th 4s] [9h]
sylvian31: checks 
noname076: bets €11.23
sylvian31: folds 
Uncalled bet (€11.23) returned to noname076
noname076 collected €11.23 from pot
noname076: doesn't show hand 
*** SUMMARY ***
Total pot €11.76 | Rake €0.53 
Board [3d Kh Th 4s 9h]
Seat 1: RoadtoNepal (small blind) folded before Flop
Seat 2: sylvian31 (big blind) folded on the River
Seat 3: noname076 collected (€11.23)
Seat 5: Proandi folded before Flop (didn't bet)
Seat 6: Kukuryzka folded before Flop (didn't bet)
Seat 7: tipner folded before Flop (didn't bet)
Seat 8: matiko09 folded before Flop (didn't bet)
Seat 9: Venomous100% (button) folded before Flop (didn't bet)





PokerStars Hand #147754775399:  Hold'em No Limit ($1/$2 USD) - 2016/01/27 11:57:03 CET [2016/01/27 5:57:03 ET]
Table 'Phobos II' 9-max Seat #7 is the button
Seat 1: LRV21 ($553.56 in chips) 
Seat 2: di0d80 ($258.68 in chips) 
Seat 3: sylvian31 ($200 in chips) 
Seat 4: flk.Dasas ($200 in chips) 
Seat 5: tipner ($200 in chips) 
Seat 6: matiko09 ($227.15 in chips) 
Seat 7: Venomous100% ($282.42 in chips) 
Seat 8: RoadtoNepal ($237.54 in chips) 
Seat 9: Kukuryzka ($370.03 in chips) 
RoadtoNepal: posts small blind $1
Kukuryzka: posts big blind $2
*** HOLE CARDS ***
Dealt to matiko09 [2d 5s]
LRV21: folds 
di0d80: folds 
sylvian31: folds 
flk.Dasas: folds 
tipner has timed out
tipner: folds 
matiko09: folds 
Venomous100%: raises $2 to $4
RoadtoNepal: raises $12 to $16
Kukuryzka: folds 
Venomous100%: raises $26 to $42
RoadtoNepal: calls $26
*** FLOP *** [2s 9h Jh]
RoadtoNepal: checks 
Venomous100%: bets $41.60
RoadtoNepal: calls $41.60
*** TURN *** [2s 9h Jh] [6s]
RoadtoNepal: checks 
Venomous100%: bets $166.40
RoadtoNepal: folds 
Uncalled bet ($166.40) returned to Venomous100%
Venomous100% collected $166.40 from pot
Venomous100%: doesn't show hand 
*** SUMMARY ***
Total pot $169.20 | Rake $2.80 
Board [2s 9h Jh 6s]
Seat 1: LRV21 folded before Flop (didn't bet)
Seat 2: di0d80 folded before Flop (didn't bet)
Seat 3: sylvian31 folded before Flop (didn't bet)
Seat 4: flk.Dasas folded before Flop (didn't bet)
Seat 5: tipner folded before Flop (didn't bet)
Seat 6: matiko09 folded before Flop (didn't bet)
Seat 7: Venomous100% (button) collected ($166.40)
Seat 8: RoadtoNepal (small blind) folded on the Turn
Seat 9: Kukuryzka (big blind) folded before Flop





PokerStars Hand #147754787578:  Hold'em No Limit ($0.50/$1.00 USD) - 2016/01/27 11:57:31 CET [2016/01/27 5:57:31 ET]
Table 'Alhajoth' 9-max Seat #3 is the button
Seat 1: UShallGimme$ ($114.95 in chips) 
Seat 2: matiko09 ($100 in chips) 
Seat 3: Sweden_Pound ($108.77 in chips) 
Seat 4: Venomous100% ($151.65 in chips) 
Seat 5: Kukuryzka ($108.66 in chips) 
Seat 6: RoadtoNepal ($189.96 in chips) 
Seat 7: Ohpeel ($137.59 in chips) 
Seat 8: deepblue0000 ($115.68 in chips) 
Seat 9: di0d80 ($100 in chips) 
Venomous100%: posts small blind $0.50
Kukuryzka: posts big blind $1
*** HOLE CARDS ***
Dealt to matiko09 [Ac 9c]
RoadtoNepal: folds 
Ohpeel: folds 
deepblue0000: raises $2 to $3
di0d80: calls $3
UShallGimme$: folds 
matiko09: folds 
Sweden_Pound: folds 
Venomous100%: folds 
Kukuryzka: folds 
*** FLOP *** [3c Jh 5s]
deepblue0000: checks 
di0d80: bets $5
deepblue0000: calls $5
*** TURN *** [3c Jh 5s] [2d]
deepblue0000: checks 
di0d80: bets $10
deepblue0000: raises $18.35 to $28.35
di0d80: folds 
Uncalled bet ($18.35) returned to deepblue0000
deepblue0000 collected $35.81 from pot
*** SUMMARY ***
Total pot $37.50 | Rake $1.69 
Board [3c Jh 5s 2d]
Seat 1: UShallGimme$ folded before Flop (didn't bet)
Seat 2: matiko09 folded before Flop (didn't bet)
Seat 3: Sweden_Pound (button) folded before Flop (didn't bet)
Seat 4: Venomous100% (small blind) folded before Flop
Seat 5: Kukuryzka (big blind) folded before Flop
Seat 6: RoadtoNepal folded before Flop (didn't bet)
Seat 7: Ohpeel folded before Flop (didn't bet)
Seat 8: deepblue0000 collected ($35.81)
Seat 9: di0d80 folded on the Turn





PokerStars Hand #147754790179:  Hold'em No Limit ($0.50/$1.00 USD) - 2016/01/27 11:57:37 CET [2016/01/27 5:57:37 ET]
Table 'Nanking' 9-max Seat #9 is the button
Seat 1: Peu3aHy ($103.16 in chips) 
Seat 2: Dachish ($103.33 in chips) 
Seat 3: nuaxin ($103 in chips) 
Seat 4: COOLIKO\/23 ($158.54 in chips) 
Seat 5: TheGentleFox ($105.23 in chips) 
Seat 6: Kukuryzka ($100 in chips) 
Seat 7: tipner ($106.30 in chips) 
Seat 8: matiko09 ($100 in chips) 
Seat 9: Sweden_Pound ($137.72 in chips) 
Peu3aHy: posts small blind $0.50
Dachish: posts big blind $1
*** HOLE CARDS ***
Dealt to matiko09 [9h Jh]
nuaxin: folds 
COOLIKO\/23: folds 
TheGentleFox: folds 
Kukuryzka: folds 
tipner: folds 
matiko09: raises $1.50 to $2.50
Sweden_Pound: folds 
Peu3aHy: folds 
Dachish: folds 
Uncalled bet ($1.50) returned to matiko09
matiko09 collected $2.50 from pot
matiko09: doesn't show hand 
*** SUMMARY ***
Total pot $2.50 | Rake $0 
Seat 1: Peu3aHy (small blind) folded before Flop
Seat 2: Dachish (big blind) folded before Flop
Seat 3: nuaxin folded before Flop (didn't bet)
Seat 4: COOLIKO\/23 folded before Flop (didn't bet)
Seat 5: TheGentleFox folded before Flop (didn't bet)
Seat 6: Kukuryzka folded before Flop (didn't bet)
Seat 7: tipner folded before Flop (didn't bet)
Seat 8: matiko09 collected ($2.50)
Seat 9: Sweden_Pound (button) folded before Flop (didn't bet)





PokerStars Hand #147754791780:  Hold'em No Limit ($0.50/$1.00 USD) - 2016/01/27 11:57:40 CET [2016/01/27 5:57:40 ET]
Table 'Henyey' 9-max Seat #4 is the button
Seat 1: COOLIKO\/23 ($100 in chips) 
Seat 2: pandalapa ($149.27 in chips) 
Seat 3: deepblue0000 ($100 in chips) 
Seat 4: sylvian31 ($100 in chips) 
Seat 5: matiko09 ($175.83 in chips) 
Seat 6: UShallGimme$ ($105.94 in chips) 
Seat 7: vinniej15 ($51.16 in chips) 
Seat 8: CoolFireX ($109.54 in chips) 
Seat 9: mycka86 ($132.13 in chips) 
matiko09: posts small blind $0.50
UShallGimme$: posts big blind $1
*** HOLE CARDS ***
Dealt to matiko09 [9h 5h]
vinniej15: calls $1
CoolFireX: folds 
mycka86: folds 
COOLIKO\/23: folds 
pandalapa: folds 
deepblue0000: raises $3.50 to $4.50
sylvian31: folds 
matiko09: folds 
UShallGimme$: folds 
vinniej15: calls $3.50
*** FLOP *** [Ks Qs 8s]
vinniej15: bets $5.01
deepblue0000: folds 
Uncalled bet ($5.01) returned to vinniej15
vinniej15 collected $10.03 from pot
*** SUMMARY ***
Total pot $10.50 | Rake $0.47 
Board [Ks Qs 8s]
Seat 1: COOLIKO\/23 folded before Flop (didn't bet)
Seat 2: pandalapa folded before Flop (didn't bet)
Seat 3: deepblue0000 folded on the Flop
Seat 4: sylvian31 (button) folded before Flop (didn't bet)
Seat 5: matiko09 (small blind) folded before Flop
Seat 6: UShallGimme$ (big blind) folded before Flop
Seat 7: vinniej15 collected ($10.03)
Seat 8: CoolFireX folded before Flop (didn't bet)
Seat 9: mycka86 folded before Flop (didn't bet)





PokerStars Hand #147754791554:  Hold'em No Limit ($0.50/$1.00 USD) - 2016/01/27 11:57:40 CET [2016/01/27 5:57:40 ET]
Table 'Dollfus' 9-max Seat #8 is the button
Seat 1: masaytoo ($111.42 in chips) 
Seat 2: nosoant ($81.50 in chips) 
Seat 3: UShallGimme$ ($100 in chips) 
Seat 4: matiko09 ($116.97 in chips) 
Seat 5: pandalapa ($220.48 in chips) 
Seat 6: deepblue0000 ($106.46 in chips) 
Seat 7: Dödi123 ($208.22 in chips) 
Seat 8: Venomous100% ($120.27 in chips) 
Seat 9: COOLIKO\/23 ($122.21 in chips) 
COOLIKO\/23: posts small blind $0.50
masaytoo: posts big blind $1
*** HOLE CARDS ***
Dealt to matiko09 [Ks 9d]
nosoant: folds 
UShallGimme$: folds 
matiko09: folds 
pandalapa: folds 
deepblue0000: folds 
Dödi123: folds 
Venomous100%: folds 
COOLIKO\/23: raises $1.50 to $2.50
masaytoo: folds 
Uncalled bet ($1.50) returned to COOLIKO\/23
COOLIKO\/23 collected $2 from pot
COOLIKO\/23: doesn't show hand 
*** SUMMARY ***
Total pot $2 | Rake $0 
Seat 1: masaytoo (big blind) folded before Flop
Seat 2: nosoant folded before Flop (didn't bet)
Seat 3: UShallGimme$ folded before Flop (didn't bet)
Seat 4: matiko09 folded before Flop (didn't bet)
Seat 5: pandalapa folded before Flop (didn't bet)
Seat 6: deepblue0000 folded before Flop (didn't bet)
Seat 7: Dödi123 folded before Flop (didn't bet)
Seat 8: Venomous100% (button) folded before Flop (didn't bet)
Seat 9: COOLIKO\/23 (small blind) collected ($2)





PokerStars Hand #147754793681:  Hold'em No Limit ($0.50/$1.00 USD) - 2016/01/27 11:57:44 CET [2016/01/27 5:57:44 ET]
Table 'Fragaria II' 9-max Seat #1 is the button
Seat 1: deepblue0000 ($142.72 in chips) 
Seat 2: GG-NoR34D. ($67.33 in chips) 
Seat 3: Sweden_Pound ($119.84 in chips) 
Seat 4: AlKatrone ($100 in chips) 
Seat 5: Venomous100% ($117.75 in chips) 
Seat 6: UShallGimme$ ($181.49 in chips) 
Seat 7: Hobby-.-AK ($48.23 in chips) 
Seat 8: mycka86 ($100 in chips) 
Seat 9: matiko09 ($100.50 in chips) 
GG-NoR34D.: posts small blind $0.50
Sweden_Pound: posts big blind $1
*** HOLE CARDS ***
Dealt to matiko09 [4h 2c]
AlKatrone: folds 
Venomous100%: folds 
UShallGimme$: folds 
Hobby-.-AK: folds 
mycka86: raises $1.50 to $2.50
matiko09: folds 
deepblue0000: folds 
GG-NoR34D.: folds 
Sweden_Pound: folds 
Uncalled bet ($1.50) returned to mycka86
mycka86 collected $2.50 from pot
*** SUMMARY ***
Total pot $2.50 | Rake $0 
Seat 1: deepblue0000 (button) folded before Flop (didn't bet)
Seat 2: GG-NoR34D. (small blind) folded before Flop
Seat 3: Sweden_Pound (big blind) folded before Flop
Seat 4: AlKatrone folded before Flop (didn't bet)
Seat 5: Venomous100% folded before Flop (didn't bet)
Seat 6: UShallGimme$ folded before Flop (didn't bet)
Seat 7: Hobby-.-AK folded before Flop (didn't bet)
Seat 8: mycka86 collected ($2.50)
Seat 9: matiko09 folded before Flop (didn't bet)





PokerStars Hand #147754798826:  Hold'em No Limit ($0.50/$1.00 USD) - 2016/01/27 11:57:56 CET [2016/01/27 5:57:56 ET]
Table 'Dollfus' 9-max Seat #9 is the button
Seat 1: masaytoo ($110.42 in chips) 
Seat 2: nosoant ($81.50 in chips) 
Seat 3: UShallGimme$ ($100 in chips) 
Seat 4: matiko09 ($116.97 in chips) 
Seat 5: pandalapa ($220.48 in chips) 
Seat 6: deepblue0000 ($106.46 in chips) 
Seat 7: Dödi123 ($208.22 in chips) 
Seat 8: Venomous100% ($120.27 in chips) 
Seat 9: COOLIKO\/23 ($123.21 in chips) 
masaytoo: posts small blind $0.50
nosoant: posts big blind $1
*** HOLE CARDS ***
Dealt to matiko09 [Ad Qh]
UShallGimme$: folds 
matiko09: raises $2 to $3
pandalapa: folds 
deepblue0000: calls $3
Dödi123: folds 
Venomous100%: folds 
COOLIKO\/23: folds 
masaytoo: folds 
nosoant: calls $2
*** FLOP *** [3h 9d 4c]
nosoant: checks 
matiko09: checks 
deepblue0000: checks 
*** TURN *** [3h 9d 4c] [Ah]
nosoant: checks 
matiko09: bets $7.34
deepblue0000: folds 
nosoant: folds 
Uncalled bet ($7.34) returned to matiko09
matiko09 collected $9.07 from pot
matiko09: doesn't show hand 
*** SUMMARY ***
Total pot $9.50 | Rake $0.43 
Board [3h 9d 4c Ah]
Seat 1: masaytoo (small blind) folded before Flop
Seat 2: nosoant (big blind) folded on the Turn
Seat 3: UShallGimme$ folded before Flop (didn't bet)
Seat 4: matiko09 collected ($9.07)
Seat 5: pandalapa folded before Flop (didn't bet)
Seat 6: deepblue0000 folded on the Turn
Seat 7: Dödi123 folded before Flop (didn't bet)
Seat 8: Venomous100% folded before Flop (didn't bet)
Seat 9: COOLIKO\/23 (button) folded before Flop (didn't bet)





PokerStars Hand #147754806486:  Hold'em No Limit (€0.50/€1.00 EUR) - 2016/01/27 11:58:04 CET [2016/01/27 5:58:04 ET]
Table 'Carol' 9-max Seat #1 is the button
Seat 1: RoadtoNepal (€100 in chips) 
Seat 2: sylvian31 (€100 in chips) 
Seat 3: noname076 (€48.87 in chips) 
Seat 5: Proandi (€36.30 in chips) 
Seat 6: Kukuryzka (€177.03 in chips) 
Seat 7: tipner (€181.79 in chips) 
Seat 8: matiko09 (€100 in chips) 
Seat 9: Venomous100% (€100 in chips) 
sylvian31: posts small blind €0.50
noname076: posts big blind €1
Sweden_Pound: sits out 
*** HOLE CARDS ***
Dealt to matiko09 [Qd 8h]
Proandi: raises €2 to €3
Kukuryzka: folds 
tipner: folds 
matiko09: folds 
Venomous100%: folds 
RoadtoNepal: folds 
sylvian31: folds 
noname076: calls €2
*** FLOP *** [Th 4c 3c]
noname076: checks 
Proandi: bets €3
noname076: calls €3
*** TURN *** [Th 4c 3c] [5h]
noname076: bets €11.94
Proandi: folds 
Uncalled bet (€11.94) returned to noname076
noname076 collected €11.94 from pot
noname076: doesn't show hand 
*** SUMMARY ***
Total pot €12.50 | Rake €0.56 
Board [Th 4c 3c 5h]
Seat 1: RoadtoNepal (button) folded before Flop (didn't bet)
Seat 2: sylvian31 (small blind) folded before Flop
Seat 3: noname076 (big blind) collected (€11.94)
Seat 5: Proandi folded on the Turn
Seat 6: Kukuryzka folded before Flop (didn't bet)
Seat 7: tipner folded before Flop (didn't bet)
Seat 8: matiko09 folded before Flop (didn't bet)
Seat 9: Venomous100% folded before Flop (didn't bet)





PokerStars Hand #147754808288:  Hold'em No Limit ($0.50/$1.00 USD) - 2016/01/27 11:58:08 CET [2016/01/27 5:58:08 ET]
Table 'Alkmene II' 9-max Seat #8 is the button
Seat 1: matiko09 ($101.50 in chips) 
Seat 2: deepblue0000 ($100 in chips) 
Seat 3: di0d80 ($100 in chips) 
Seat 4: CoolFireX ($148.82 in chips) 
Seat 5: Sweden_Pound ($114.05 in chips) 
Seat 6: Peu3aHy ($121.72 in chips) 
Seat 7: mycka86 ($100 in chips) 
Seat 8: fecsok1 ($125.75 in chips) 
Seat 9: pandalapa ($109.32 in chips) 
pandalapa: posts small blind $0.50
matiko09: posts big blind $1
*** HOLE CARDS ***
Dealt to matiko09 [Qd 8d]
deepblue0000: folds 
di0d80 has timed out
di0d80: folds 
CoolFireX: folds 
Sweden_Pound: folds 
Peu3aHy: folds 
mycka86: folds 
fecsok1: folds 
pandalapa: raises $1.20 to $2.20
matiko09: calls $1.20
*** FLOP *** [3h Kc 6d]
pandalapa: checks 
matiko09: bets $2.73
pandalapa: folds 
Uncalled bet ($2.73) returned to matiko09
matiko09 collected $4.20 from pot
matiko09: doesn't show hand 
*** SUMMARY ***
Total pot $4.40 | Rake $0.20 
Board [3h Kc 6d]
Seat 1: matiko09 (big blind) collected ($4.20)
Seat 2: deepblue0000 folded before Flop (didn't bet)
Seat 3: di0d80 folded before Flop (didn't bet)
Seat 4: CoolFireX folded before Flop (didn't bet)
Seat 5: Sweden_Pound folded before Flop (didn't bet)
Seat 6: Peu3aHy folded before Flop (didn't bet)
Seat 7: mycka86 folded before Flop (didn't bet)
Seat 8: fecsok1 (button) folded before Flop (didn't bet)
Seat 9: pandalapa (small blind) folded on the Flop





PokerStars Hand #147754809939:  Hold'em No Limit ($0.50/$1.00 USD) - 2016/01/27 11:58:12 CET [2016/01/27 5:58:12 ET]
Table 'Fragaria II' 9-max Seat #2 is the button
Seat 1: deepblue0000 ($142.72 in chips) 
Seat 2: GG-NoR34D. ($66.83 in chips) 
Seat 3: Sweden_Pound ($118.84 in chips) 
Seat 5: Venomous100% ($117.75 in chips) 
Seat 6: UShallGimme$ ($181.49 in chips) 
Seat 7: Hobby-.-AK ($48.23 in chips) 
Seat 8: mycka86 ($101.50 in chips) 
Seat 9: matiko09 ($100.50 in chips) 
Sweden_Pound: posts small blind $0.50
AlKatrone: is sitting out 
AlKatrone leaves the table
Venomous100%: posts big blind $1
*** HOLE CARDS ***
Dealt to matiko09 [8h 4h]
di0d80 joins the table at seat #4 
UShallGimme$: folds 
Hobby-.-AK: folds 
mycka86: folds 
matiko09: folds 
deepblue0000: folds 
GG-NoR34D.: raises $1.50 to $2.50
Sweden_Pound: folds 
Venomous100%: folds 
Uncalled bet ($1.50) returned to GG-NoR34D.
GG-NoR34D. collected $2.50 from pot
*** SUMMARY ***
Total pot $2.50 | Rake $0 
Seat 1: deepblue0000 folded before Flop (didn't bet)
Seat 2: GG-NoR34D. (button) collected ($2.50)
Seat 3: Sweden_Pound (small blind) folded before Flop
Seat 5: Venomous100% (big blind) folded before Flop
Seat 6: UShallGimme$ folded before Flop (didn't bet)
Seat 7: Hobby-.-AK folded before Flop (didn't bet)
Seat 8: mycka86 folded before Flop (didn't bet)
Seat 9: matiko09 folded before Flop (didn't bet)





PokerStars Hand #147754810173:  Hold'em No Limit ($0.50/$1.00 USD) - 2016/01/27 11:58:13 CET [2016/01/27 5:58:13 ET]
Table 'Delphinus II' 9-max Seat #5 is the button
Seat 1: Saintreine ($148.73 in chips) 
Seat 2: AlKatrone ($197.75 in chips) 
Seat 3: deepblue0000 ($465.91 in chips) 
Seat 4: matiko09 ($100 in chips) 
Seat 5: pandalapa ($105.14 in chips) 
Seat 6: Sweden_Pound ($123.64 in chips) 
Seat 7: RUS)Timur ($105.40 in chips) 
Seat 8: mycka86 ($107.02 in chips) 
Seat 9: FGL-lucky ($36.38 in chips) 
Sweden_Pound: posts small blind $0.50
RUS)Timur: posts big blind $1
*** HOLE CARDS ***
Dealt to matiko09 [3h 6s]
mycka86: folds 
FGL-lucky: folds 
Saintreine: calls $1
AlKatrone: folds 
deepblue0000: folds 
matiko09: folds 
pandalapa: folds 
Sweden_Pound: calls $0.50
RUS)Timur: checks 
*** FLOP *** [9d Tc As]
Sweden_Pound: checks 
RUS)Timur: checks 
Saintreine: bets $2
Sweden_Pound: folds 
RUS)Timur: calls $2
*** TURN *** [9d Tc As] [3d]
RUS)Timur: checks 
Saintreine: bets $9
RUS)Timur: folds 
Uncalled bet ($9) returned to Saintreine
Saintreine collected $6.68 from pot
Saintreine: doesn't show hand 
*** SUMMARY ***
Total pot $7 | Rake $0.32 
Board [9d Tc As 3d]
Seat 1: Saintreine collected ($6.68)
Seat 2: AlKatrone folded before Flop (didn't bet)
Seat 3: deepblue0000 folded before Flop (didn't bet)
Seat 4: matiko09 folded before Flop (didn't bet)
Seat 5: pandalapa (button) folded before Flop (didn't bet)
Seat 6: Sweden_Pound (small blind) folded on the Flop
Seat 7: RUS)Timur (big blind) folded on the Turn
Seat 8: mycka86 folded before Flop (didn't bet)
Seat 9: FGL-lucky folded before Flop (didn't bet)





PokerStars Hand #147754824137:  Hold'em No Limit ($0.50/$1.00 USD) - 2016/01/27 11:58:30 CET [2016/01/27 5:58:30 ET]
Table 'Nanking' 9-max Seat #1 is the button
Seat 1: Peu3aHy ($102.66 in chips) 
Seat 2: Dachish ($102.33 in chips) 
Seat 3: nuaxin ($103 in chips) 
Seat 4: COOLIKO\/23 ($158.54 in chips) 
Seat 5: TheGentleFox ($105.23 in chips) 
Seat 6: Kukuryzka ($100 in chips) 
Seat 7: tipner ($106.30 in chips) 
Seat 8: matiko09 ($101.50 in chips) 
Seat 9: Sweden_Pound ($137.72 in chips) 
Dachish: posts small blind $0.50
nuaxin: posts big blind $1
*** HOLE CARDS ***
Dealt to matiko09 [Kc 6c]
COOLIKO\/23: raises $2 to $3
TheGentleFox: folds 
Kukuryzka: raises $6 to $9
tipner: folds 
matiko09: folds 
Sweden_Pound: folds 
Peu3aHy: folds 
Dachish: folds 
nuaxin: folds 
COOLIKO\/23: folds 
Uncalled bet ($6) returned to Kukuryzka
Kukuryzka collected $7.50 from pot
Kukuryzka: doesn't show hand 
*** SUMMARY ***
Total pot $7.50 | Rake $0 
Seat 1: Peu3aHy (button) folded before Flop (didn't bet)
Seat 2: Dachish (small blind) folded before Flop
Seat 3: nuaxin (big blind) folded before Flop
Seat 4: COOLIKO\/23 folded before Flop
Seat 5: TheGentleFox folded before Flop (didn't bet)
Seat 6: Kukuryzka collected ($7.50)
Seat 7: tipner folded before Flop (didn't bet)
Seat 8: matiko09 folded before Flop (didn't bet)
Seat 9: Sweden_Pound folded before Flop (didn't bet)





PokerStars Hand #147754827642:  Hold'em No Limit ($0.50/$1.00 USD) - 2016/01/27 11:58:36 CET [2016/01/27 5:58:36 ET]
Table 'Henyey' 9-max Seat #5 is the button
Seat 1: COOLIKO\/23 ($100 in chips) 
Seat 2: pandalapa ($149.27 in chips) 
Seat 3: deepblue0000 ($100 in chips) 
Seat 4: sylvian31 ($100 in chips) 
Seat 5: matiko09 ($175.33 in chips) 
Seat 6: UShallGimme$ ($104.94 in chips) 
Seat 7: vinniej15 ($56.69 in chips) 
Seat 8: CoolFireX ($109.54 in chips) 
Seat 9: mycka86 ($132.13 in chips) 
UShallGimme$: posts small blind $0.50
vinniej15: posts big blind $1
*** HOLE CARDS ***
Dealt to matiko09 [Ks 6d]
CoolFireX: folds 
mycka86: folds 
COOLIKO\/23: folds 
pandalapa: folds 
deepblue0000: folds 
sylvian31: raises $1.50 to $2.50
matiko09: folds 
UShallGimme$: folds 
vinniej15: calls $1.50
*** FLOP *** [7s 3s 7c]
vinniej15: checks 
sylvian31: checks 
*** TURN *** [7s 3s 7c] [Kd]
vinniej15: checks 
sylvian31: bets $3.51
vinniej15: folds 
Uncalled bet ($3.51) returned to sylvian31
sylvian31 collected $5.25 from pot
sylvian31: doesn't show hand 
*** SUMMARY ***
Total pot $5.50 | Rake $0.25 
Board [7s 3s 7c Kd]
Seat 1: COOLIKO\/23 folded before Flop (didn't bet)
Seat 2: pandalapa folded before Flop (didn't bet)
Seat 3: deepblue0000 folded before Flop (didn't bet)
Seat 4: sylvian31 collected ($5.25)
Seat 5: matiko09 (button) folded before Flop (didn't bet)
Seat 6: UShallGimme$ (small blind) folded before Flop
Seat 7: vinniej15 (big blind) folded on the Turn
Seat 8: CoolFireX folded before Flop (didn't bet)
Seat 9: mycka86 folded before Flop (didn't bet)





PokerStars Hand #147754845143:  Hold'em No Limit ($0.50/$1.00 USD) - 2016/01/27 11:59:12 CET [2016/01/27 5:59:12 ET]
Table 'Fragaria II' 9-max Seat #3 is the button
Seat 1: deepblue0000 ($142.72 in chips) 
Seat 2: GG-NoR34D. ($68.33 in chips) 
Seat 3: Sweden_Pound ($118.34 in chips) 
Seat 5: Venomous100% ($116.75 in chips) 
Seat 6: UShallGimme$ ($181.49 in chips) 
Seat 7: Hobby-.-AK ($48.23 in chips) 
Seat 8: mycka86 ($101.50 in chips) 
Seat 9: matiko09 ($100.50 in chips) 
Venomous100%: posts small blind $0.50
UShallGimme$: posts big blind $1
*** HOLE CARDS ***
Dealt to matiko09 [3h 8c]
Hobby-.-AK: folds 
mycka86: folds 
matiko09: folds 
deepblue0000 has timed out
deepblue0000: folds 
GG-NoR34D.: calls $1
Sweden_Pound: raises $3 to $4
Venomous100%: folds 
UShallGimme$: folds 
GG-NoR34D.: calls $3
*** FLOP *** [8h Td 7h]
GG-NoR34D.: checks 
Sweden_Pound: checks 
*** TURN *** [8h Td 7h] [6s]
di0d80 is disconnected 
GG-NoR34D.: bets $5.25
Sweden_Pound: folds 
Uncalled bet ($5.25) returned to GG-NoR34D.
GG-NoR34D. collected $9.07 from pot
*** SUMMARY ***
Total pot $9.50 | Rake $0.43 
Board [8h Td 7h 6s]
Seat 1: deepblue0000 folded before Flop (didn't bet)
Seat 2: GG-NoR34D. collected ($9.07)
Seat 3: Sweden_Pound (button) folded on the Turn
Seat 5: Venomous100% (small blind) folded before Flop
Seat 6: UShallGimme$ (big blind) folded before Flop
Seat 7: Hobby-.-AK folded before Flop (didn't bet)
Seat 8: mycka86 folded before Flop (didn't bet)
Seat 9: matiko09 folded before Flop (didn't bet)





PokerStars Hand #147754845600:  Hold'em No Limit ($1/$2 USD) - 2016/01/27 11:59:13 CET [2016/01/27 5:59:13 ET]
Table 'Phobos II' 9-max Seat #8 is the button
Seat 1: LRV21 ($553.56 in chips) 
Seat 2: di0d80 ($258.68 in chips) 
Seat 3: sylvian31 ($200 in chips) 
Seat 4: flk.Dasas ($200 in chips) 
Seat 6: matiko09 ($227.15 in chips) 
Seat 7: Venomous100% ($365.22 in chips) 
Seat 8: RoadtoNepal ($200 in chips) 
Seat 9: Kukuryzka ($368.03 in chips) 
Kukuryzka: posts small blind $1
LRV21: posts big blind $2
*** HOLE CARDS ***
Dealt to matiko09 [2d 6d]
di0d80: folds 
sylvian31: folds 
flk.Dasas: folds 
matiko09: folds 
Venomous100%: folds 
RoadtoNepal: folds 
Kukuryzka: folds 
Uncalled bet ($1) returned to LRV21
LRV21 collected $2 from pot
*** SUMMARY ***
Total pot $2 | Rake $0 
Seat 1: LRV21 (big blind) collected ($2)
Seat 2: di0d80 folded before Flop (didn't bet)
Seat 3: sylvian31 folded before Flop (didn't bet)
Seat 4: flk.Dasas folded before Flop (didn't bet)
Seat 6: matiko09 folded before Flop (didn't bet)
Seat 7: Venomous100% folded before Flop (didn't bet)
Seat 8: RoadtoNepal (button) folded before Flop (didn't bet)
Seat 9: Kukuryzka (small blind) folded before Flop





PokerStars Hand #147754847518:  Hold'em No Limit ($0.50/$1.00 USD) - 2016/01/27 11:59:17 CET [2016/01/27 5:59:17 ET]
Table 'Dollfus' 9-max Seat #1 is the button
Seat 1: masaytoo ($109.92 in chips) 
Seat 2: nosoant ($78.50 in chips) 
Seat 3: UShallGimme$ ($100 in chips) 
Seat 4: matiko09 ($123.04 in chips) 
Seat 5: pandalapa ($220.48 in chips) 
Seat 6: deepblue0000 ($103.46 in chips) 
Seat 7: Dödi123 ($208.22 in chips) 
Seat 8: Venomous100% ($120.27 in chips) 
Seat 9: COOLIKO\/23 ($123.21 in chips) 
nosoant: posts small blind $0.50
UShallGimme$: posts big blind $1
*** HOLE CARDS ***
Dealt to matiko09 [Kc 8h]
matiko09: folds 
pandalapa: folds 
deepblue0000: folds 
Dödi123: raises $1.50 to $2.50
Venomous100%: folds 
COOLIKO\/23: folds 
masaytoo: raises $7.50 to $10
nosoant: calls $9.50
UShallGimme$: folds 
Dödi123: folds 
*** FLOP *** [6c 4h 2d]
nosoant: checks 
masaytoo: bets $12
nosoant: folds 
Uncalled bet ($12) returned to masaytoo
masaytoo collected $22.44 from pot
masaytoo: doesn't show hand 
*** SUMMARY ***
Total pot $23.50 | Rake $1.06 
Board [6c 4h 2d]
Seat 1: masaytoo (button) collected ($22.44)
Seat 2: nosoant (small blind) folded on the Flop
Seat 3: UShallGimme$ (big blind) folded before Flop
Seat 4: matiko09 folded before Flop (didn't bet)
Seat 5: pandalapa folded before Flop (didn't bet)
Seat 6: deepblue0000 folded before Flop (didn't bet)
Seat 7: Dödi123 folded before Flop
Seat 8: Venomous100% folded before Flop (didn't bet)
Seat 9: COOLIKO\/23 folded before Flop (didn't bet)





PokerStars Hand #147754847425:  Hold'em No Limit ($0.50/$1.00 USD) - 2016/01/27 11:59:17 CET [2016/01/27 5:59:17 ET]
Table 'Alhajoth' 9-max Seat #4 is the button
Seat 1: UShallGimme$ ($114.95 in chips) 
Seat 2: matiko09 ($100 in chips) 
Seat 3: Sweden_Pound ($108.77 in chips) 
Seat 4: Venomous100% ($151.15 in chips) 
Seat 5: Kukuryzka ($107.66 in chips) 
Seat 6: RoadtoNepal ($189.96 in chips) 
Seat 7: Ohpeel ($137.59 in chips) 
Seat 8: deepblue0000 ($133.49 in chips) 
Seat 9: di0d80 ($100 in chips) 
Kukuryzka: posts small blind $0.50
RoadtoNepal: posts big blind $1
*** HOLE CARDS ***
Dealt to matiko09 [6d 4c]
Ohpeel: folds 
deepblue0000: folds 
di0d80: folds 
UShallGimme$: folds 
matiko09: folds 
Sweden_Pound: folds 
Venomous100%: raises $1 to $2
Kukuryzka: folds 
RoadtoNepal: folds 
Uncalled bet ($1) returned to Venomous100%
Venomous100% collected $2.50 from pot
Venomous100%: doesn't show hand 
*** SUMMARY ***
Total pot $2.50 | Rake $0 
Seat 1: UShallGimme$ folded before Flop (didn't bet)
Seat 2: matiko09 folded before Flop (didn't bet)
Seat 3: Sweden_Pound folded before Flop (didn't bet)
Seat 4: Venomous100% (button) collected ($2.50)
Seat 5: Kukuryzka (small blind) folded before Flop
Seat 6: RoadtoNepal (big blind) folded before Flop
Seat 7: Ohpeel folded before Flop (didn't bet)
Seat 8: deepblue0000 folded before Flop (didn't bet)
Seat 9: di0d80 folded before Flop (didn't bet)





PokerStars Hand #147754847881:  Hold'em No Limit (€0.50/€1.00 EUR) - 2016/01/27 11:59:18 CET [2016/01/27 5:59:18 ET]
Table 'Carol' 9-max Seat #2 is the button
Seat 1: RoadtoNepal (€100 in chips) 
Seat 2: sylvian31 (€100 in chips) 
Seat 3: noname076 (€54.81 in chips) 
Seat 4: Sweden_Pound (€100 in chips) 
Seat 5: Proandi (€30.30 in chips) 
Seat 6: Kukuryzka (€177.03 in chips) 
Seat 7: tipner (€181.79 in chips) 
Seat 8: matiko09 (€100 in chips) 
Seat 9: Venomous100% (€100 in chips) 
noname076: posts small blind €0.50
Sweden_Pound: posts big blind €1
*** HOLE CARDS ***
Dealt to matiko09 [Ts 5s]
Proandi: raises €2 to €3
Kukuryzka: folds 
tipner: folds 
matiko09: folds 
Venomous100%: folds 
RoadtoNepal: calls €3
sylvian31: raises €8 to €11
noname076: calls €10.50
Sweden_Pound: folds 
Proandi: raises €19.30 to €30.30 and is all-in
RoadtoNepal: folds 
sylvian31: raises €68.20 to €98.50
noname076: folds 
Uncalled bet (€68.20) returned to sylvian31
*** FIRST FLOP *** [Qc 3s 7s]
*** FIRST TURN *** [Qc 3s 7s] [6s]
*** FIRST RIVER *** [Qc 3s 7s 6s] [9h]
*** SECOND FLOP *** [5h Ac Jd]
*** SECOND TURN *** [5h Ac Jd] [2h]
*** SECOND RIVER *** [5h Ac Jd 2h] [Js]
*** FIRST SHOW DOWN ***
Proandi: shows [Kh Ad] (high card Ace)
sylvian31: shows [Qh Jh] (a pair of Queens)
sylvian31 collected €36.73 from pot
*** SECOND SHOW DOWN ***
Proandi: shows [Kh Ad] (two pair, Aces and Jacks)
sylvian31: shows [Qh Jh] (three of a kind, Jacks)
sylvian31 collected €36.72 from pot
*** SUMMARY ***
Total pot €75.60 | Rake €2.15 
Hand was run twice
FIRST Board [Qc 3s 7s 6s 9h]
SECOND Board [5h Ac Jd 2h Js]
Seat 1: RoadtoNepal folded before Flop
Seat 2: sylvian31 (button) showed [Qh Jh] and won (€36.73) with a pair of Queens, and won (€36.72) with three of a kind, Jacks
Seat 3: noname076 (small blind) folded before Flop
Seat 4: Sweden_Pound (big blind) folded before Flop
Seat 5: Proandi showed [Kh Ad] and lost with high card Ace, and lost with two pair, Aces and Jacks
Seat 6: Kukuryzka folded before Flop (didn't bet)
Seat 7: tipner folded before Flop (didn't bet)
Seat 8: matiko09 folded before Flop (didn't bet)
Seat 9: Venomous100% folded before Flop (didn't bet)





PokerStars Hand #147754848881:  Hold'em No Limit ($0.50/$1.00 USD) - 2016/01/27 11:59:21 CET [2016/01/27 5:59:21 ET]
Table 'Nanking' 9-max Seat #2 is the button
Seat 1: Peu3aHy ($102.66 in chips) 
Seat 2: Dachish ($101.83 in chips) 
Seat 3: nuaxin ($102 in chips) 
Seat 4: COOLIKO\/23 ($155.54 in chips) 
Seat 5: TheGentleFox ($105.23 in chips) 
Seat 6: Kukuryzka ($104.50 in chips) 
Seat 7: tipner ($106.30 in chips) 
Seat 8: matiko09 ($101.50 in chips) 
Seat 9: Sweden_Pound ($137.72 in chips) 
nuaxin: posts small blind $0.50
COOLIKO\/23: posts big blind $1
*** HOLE CARDS ***
Dealt to matiko09 [2d 4s]
TheGentleFox: folds 
Kukuryzka: folds 
tipner: folds 
matiko09: folds 
Sweden_Pound: folds 
Peu3aHy: folds 
Dachish: folds 
nuaxin: folds 
Uncalled bet ($0.50) returned to COOLIKO\/23
COOLIKO\/23 collected $1 from pot
COOLIKO\/23: doesn't show hand 
*** SUMMARY ***
Total pot $1 | Rake $0 
Seat 1: Peu3aHy folded before Flop (didn't bet)
Seat 2: Dachish (button) folded before Flop (didn't bet)
Seat 3: nuaxin (small blind) folded before Flop
Seat 4: COOLIKO\/23 (big blind) collected ($1)
Seat 5: TheGentleFox folded before Flop (didn't bet)
Seat 6: Kukuryzka folded before Flop (didn't bet)
Seat 7: tipner folded before Flop (didn't bet)
Seat 8: matiko09 folded before Flop (didn't bet)
Seat 9: Sweden_Pound folded before Flop (didn't bet)





PokerStars Hand #147754850484:  Hold'em No Limit ($0.50/$1.00 USD) - 2016/01/27 11:59:24 CET [2016/01/27 5:59:24 ET]
Table 'Henyey' 9-max Seat #6 is the button
Seat 1: COOLIKO\/23 ($100 in chips) 
Seat 2: pandalapa ($149.27 in chips) 
Seat 3: deepblue0000 ($100 in chips) 
Seat 4: sylvian31 ($102.75 in chips) 
Seat 5: matiko09 ($175.33 in chips) 
Seat 6: UShallGimme$ ($104.44 in chips) 
Seat 7: vinniej15 ($54.19 in chips) 
Seat 8: CoolFireX ($109.54 in chips) 
Seat 9: mycka86 ($132.13 in chips) 
vinniej15: posts small blind $0.50
CoolFireX: posts big blind $1
*** HOLE CARDS ***
Dealt to matiko09 [5c Ks]
mycka86: folds 
COOLIKO\/23: folds 
pandalapa: folds 
deepblue0000 has timed out
deepblue0000: folds 
sylvian31: folds 
matiko09: folds 
UShallGimme$: folds 
vinniej15: calls $0.50
CoolFireX: raises $3 to $4
vinniej15: calls $3
*** FLOP *** [Js 4d 9d]
vinniej15: bets $4
CoolFireX: calls $4
*** TURN *** [Js 4d 9d] [7s]
vinniej15: checks 
CoolFireX: checks 
*** RIVER *** [Js 4d 9d 7s] [8d]
vinniej15: checks 
CoolFireX: checks 
*** SHOW DOWN ***
vinniej15: shows [As 5h] (high card Ace)
CoolFireX: shows [Kc Ad] (high card Ace - King kicker)
CoolFireX collected $15.28 from pot
*** SUMMARY ***
Total pot $16 | Rake $0.72 
Board [Js 4d 9d 7s 8d]
Seat 1: COOLIKO\/23 folded before Flop (didn't bet)
Seat 2: pandalapa folded before Flop (didn't bet)
Seat 3: deepblue0000 folded before Flop (didn't bet)
Seat 4: sylvian31 folded before Flop (didn't bet)
Seat 5: matiko09 folded before Flop (didn't bet)
Seat 6: UShallGimme$ (button) folded before Flop (didn't bet)
Seat 7: vinniej15 (small blind) showed [As 5h] and lost with high card Ace
Seat 8: CoolFireX (big blind) showed [Kc Ad] and won ($15.28) with high card Ace
Seat 9: mycka86 folded before Flop (didn't bet)





PokerStars Hand #147754858015:  Hold'em No Limit ($0.50/$1.00 USD) - 2016/01/27 11:59:41 CET [2016/01/27 5:59:41 ET]
Table 'Delphinus II' 9-max Seat #6 is the button
Seat 1: Saintreine ($152.41 in chips) 
Seat 2: AlKatrone ($197.75 in chips) 
Seat 3: deepblue0000 ($465.91 in chips) 
Seat 4: matiko09 ($100 in chips) 
Seat 5: pandalapa ($105.14 in chips) 
Seat 6: Sweden_Pound ($122.64 in chips) 
Seat 7: RUS)Timur ($102.40 in chips) 
Seat 8: mycka86 ($107.02 in chips) 
Seat 9: FGL-lucky ($36.38 in chips) 
RUS)Timur: posts small blind $0.50
mycka86: posts big blind $1
*** HOLE CARDS ***
Dealt to matiko09 [4h 8s]
FGL-lucky: raises $2 to $3
Saintreine: folds 
AlKatrone: raises $6 to $9
deepblue0000: folds 
matiko09: folds 
pandalapa: folds 
Sweden_Pound: folds 
RUS)Timur: folds 
mycka86: folds 
FGL-lucky: calls $6
*** FLOP *** [Td 3s Qd]
FGL-lucky: checks 
AlKatrone: bets $28
FGL-lucky: folds 
Uncalled bet ($28) returned to AlKatrone
AlKatrone collected $18.62 from pot
AlKatrone: doesn't show hand 
*** SUMMARY ***
Total pot $19.50 | Rake $0.88 
Board [Td 3s Qd]
Seat 1: Saintreine folded before Flop (didn't bet)
Seat 2: AlKatrone collected ($18.62)
Seat 3: deepblue0000 folded before Flop (didn't bet)
Seat 4: matiko09 folded before Flop (didn't bet)
Seat 5: pandalapa folded before Flop (didn't bet)
Seat 6: Sweden_Pound (button) folded before Flop (didn't bet)
Seat 7: RUS)Timur (small blind) folded before Flop
Seat 8: mycka86 (big blind) folded before Flop
Seat 9: FGL-lucky folded on the Flop





PokerStars Hand #147754861333:  Hold'em No Limit ($0.50/$1.00 USD) - 2016/01/27 11:59:48 CET [2016/01/27 5:59:48 ET]
Table 'Alkmene II' 9-max Seat #9 is the button
Seat 1: matiko09 ($103.50 in chips) 
Seat 2: deepblue0000 ($100 in chips) 
Seat 3: di0d80 ($100 in chips) 
Seat 4: CoolFireX ($148.82 in chips) 
Seat 5: Sweden_Pound ($114.05 in chips) 
Seat 6: Peu3aHy ($121.72 in chips) 
Seat 7: mycka86 ($100 in chips) 
Seat 8: fecsok1 ($125.75 in chips) 
Seat 9: pandalapa ($107.12 in chips) 
matiko09: posts small blind $0.50
deepblue0000: posts big blind $1
*** HOLE CARDS ***
Dealt to matiko09 [As Th]
di0d80: folds 
CoolFireX: folds 
Sweden_Pound: folds 
Peu3aHy: folds 
mycka86: folds 
fecsok1: folds 
pandalapa: folds 
matiko09: raises $1.50 to $2.50
deepblue0000: calls $1.50
*** FLOP *** [9s 3c 6d]
di0d80 is disconnected 
matiko09: bets $3.11
deepblue0000: calls $3.11
*** TURN *** [9s 3c 6d] [Ts]
matiko09: bets $6.97
deepblue0000: folds 
Uncalled bet ($6.97) returned to matiko09
matiko09 collected $10.72 from pot
matiko09: doesn't show hand 
*** SUMMARY ***
Total pot $11.22 | Rake $0.50 
Board [9s 3c 6d Ts]
Seat 1: matiko09 (small blind) collected ($10.72)
Seat 2: deepblue0000 (big blind) folded on the Turn
Seat 3: di0d80 folded before Flop (didn't bet)
Seat 4: CoolFireX folded before Flop (didn't bet)
Seat 5: Sweden_Pound folded before Flop (didn't bet)
Seat 6: Peu3aHy folded before Flop (didn't bet)
Seat 7: mycka86 folded before Flop (didn't bet)
Seat 8: fecsok1 folded before Flop (didn't bet)
Seat 9: pandalapa (button) folded before Flop (didn't bet)





PokerStars Hand #147754866509:  Hold'em No Limit ($1/$2 USD) - 2016/01/27 12:00:00 CET [2016/01/27 6:00:00 ET]
Table 'Phobos II' 9-max Seat #9 is the button
Seat 1: LRV21 ($554.56 in chips) 
Seat 3: sylvian31 ($200 in chips) 
Seat 4: flk.Dasas ($200 in chips) 
Seat 5: tipner ($200 in chips) 
Seat 6: matiko09 ($227.15 in chips) 
Seat 7: Venomous100% ($365.22 in chips) 
Seat 8: RoadtoNepal ($200 in chips) 
Seat 9: Kukuryzka ($367.03 in chips) 
LRV21: posts small blind $1
di0d80: is sitting out 
sylvian31: posts big blind $2
*** HOLE CARDS ***
Dealt to matiko09 [6s 9h]
flk.Dasas: folds 
tipner: folds 
matiko09: folds 
Venomous100%: folds 
RoadtoNepal: folds 
Kukuryzka: folds 
LRV21: folds 
Uncalled bet ($1) returned to sylvian31
sylvian31 collected $2 from pot
sylvian31: doesn't show hand 
*** SUMMARY ***
Total pot $2 | Rake $0 
Seat 1: LRV21 (small blind) folded before Flop
Seat 3: sylvian31 (big blind) collected ($2)
Seat 4: flk.Dasas folded before Flop (didn't bet)
Seat 5: tipner folded before Flop (didn't bet)
Seat 6: matiko09 folded before Flop (didn't bet)
Seat 7: Venomous100% folded before Flop (didn't bet)
Seat 8: RoadtoNepal folded before Flop (didn't bet)
Seat 9: Kukuryzka (button) folded before Flop (didn't bet)





PokerStars Hand #147754868112:  Hold'em No Limit ($0.50/$1.00 USD) - 2016/01/27 12:00:04 CET [2016/01/27 6:00:04 ET]
Table 'Alhajoth' 9-max Seat #5 is the button
Seat 1: UShallGimme$ ($114.95 in chips) 
Seat 2: matiko09 ($100 in chips) 
Seat 3: Sweden_Pound ($108.77 in chips) 
Seat 4: Venomous100% ($152.65 in chips) 
Seat 5: Kukuryzka ($107.16 in chips) 
Seat 6: RoadtoNepal ($188.96 in chips) 
Seat 7: Ohpeel ($137.59 in chips) 
Seat 8: deepblue0000 ($133.49 in chips) 
Seat 9: di0d80 ($100 in chips) 
RoadtoNepal: posts small blind $0.50
Ohpeel: posts big blind $1
*** HOLE CARDS ***
Dealt to matiko09 [Kd 4c]
deepblue0000: folds 
di0d80: folds 
UShallGimme$: folds 
matiko09: folds 
Sweden_Pound: folds 
Venomous100%: folds 
Kukuryzka: folds 
RoadtoNepal: folds 
Uncalled bet ($0.50) returned to Ohpeel
di0d80 is disconnected 
Ohpeel collected $1 from pot
*** SUMMARY ***
Total pot $1 | Rake $0 
Seat 1: UShallGimme$ folded before Flop (didn't bet)
Seat 2: matiko09 folded before Flop (didn't bet)
Seat 3: Sweden_Pound folded before Flop (didn't bet)
Seat 4: Venomous100% folded before Flop (didn't bet)
Seat 5: Kukuryzka (button) folded before Flop (didn't bet)
Seat 6: RoadtoNepal (small blind) folded before Flop
Seat 7: Ohpeel (big blind) collected ($1)
Seat 8: deepblue0000 folded before Flop (didn't bet)
Seat 9: di0d80 folded before Flop (didn't bet)





PokerStars Hand #147754875801:  Hold'em No Limit ($0.50/$1.00 USD) - 2016/01/27 12:00:20 CET [2016/01/27 6:00:20 ET]
Table 'Nanking' 9-max Seat #3 is the button
Seat 1: Peu3aHy ($102.66 in chips) 
Seat 2: Dachish ($101.83 in chips) 
Seat 3: nuaxin ($101.50 in chips) 
Seat 4: COOLIKO\/23 ($156.04 in chips) 
Seat 5: TheGentleFox ($105.23 in chips) 
Seat 6: Kukuryzka ($104.50 in chips) 
Seat 7: tipner ($106.30 in chips) 
Seat 8: matiko09 ($101.50 in chips) 
Seat 9: Sweden_Pound ($137.72 in chips) 
COOLIKO\/23: posts small blind $0.50
TheGentleFox: posts big blind $1
*** HOLE CARDS ***
Dealt to matiko09 [2d 6s]
Kukuryzka: folds 
tipner: folds 
matiko09: folds 
Sweden_Pound: raises $2 to $3
Peu3aHy: folds 
Dachish: folds 
nuaxin: folds 
COOLIKO\/23: folds 
TheGentleFox: calls $2
*** FLOP *** [6h Tc Jh]
TheGentleFox: checks 
Sweden_Pound: checks 
*** TURN *** [6h Tc Jh] [8s]
TheGentleFox: checks 
Sweden_Pound: checks 
*** RIVER *** [6h Tc Jh 8s] [Ah]
TheGentleFox: checks 
Sweden_Pound: checks 
*** SHOW DOWN ***
TheGentleFox: shows [Kc Ts] (a pair of Tens)
Sweden_Pound: mucks hand 
TheGentleFox collected $6.21 from pot
*** SUMMARY ***
Total pot $6.50 | Rake $0.29 
Board [6h Tc Jh 8s Ah]
Seat 1: Peu3aHy folded before Flop (didn't bet)
Seat 2: Dachish folded before Flop (didn't bet)
Seat 3: nuaxin (button) folded before Flop (didn't bet)
Seat 4: COOLIKO\/23 (small blind) folded before Flop
Seat 5: TheGentleFox (big blind) showed [Kc Ts] and won ($6.21) with a pair of Tens
Seat 6: Kukuryzka folded before Flop (didn't bet)
Seat 7: tipner folded before Flop (didn't bet)
Seat 8: matiko09 folded before Flop (didn't bet)
Seat 9: Sweden_Pound mucked [9d 9s]





PokerStars Hand #147754879311:  Hold'em No Limit ($0.50/$1.00 USD) - 2016/01/27 12:00:28 CET [2016/01/27 6:00:28 ET]
Table 'Dollfus' 9-max Seat #2 is the button
Seat 1: masaytoo ($122.36 in chips) 
Seat 2: nosoant ($68.50 in chips) 
Seat 3: UShallGimme$ ($100 in chips) 
Seat 4: matiko09 ($123.04 in chips) 
Seat 5: pandalapa ($220.48 in chips) 
Seat 6: deepblue0000 ($103.46 in chips) 
Seat 7: Dödi123 ($205.72 in chips) 
Seat 8: Venomous100% ($120.27 in chips) 
Seat 9: COOLIKO\/23 ($123.21 in chips) 
UShallGimme$: posts small blind $0.50
matiko09: posts big blind $1
*** HOLE CARDS ***
Dealt to matiko09 [Qc 8d]
pandalapa: folds 
deepblue0000: folds 
Dödi123: folds 
Venomous100%: folds 
COOLIKO\/23: folds 
masaytoo: folds 
nosoant: folds 
UShallGimme$: raises $2 to $3
matiko09: folds 
Uncalled bet ($2) returned to UShallGimme$
UShallGimme$ collected $2 from pot
UShallGimme$: doesn't show hand 
*** SUMMARY ***
Total pot $2 | Rake $0 
Seat 1: masaytoo folded before Flop (didn't bet)
Seat 2: nosoant (button) folded before Flop (didn't bet)
Seat 3: UShallGimme$ (small blind) collected ($2)
Seat 4: matiko09 (big blind) folded before Flop
Seat 5: pandalapa folded before Flop (didn't bet)
Seat 6: deepblue0000 folded before Flop (didn't bet)
Seat 7: Dödi123 folded before Flop (didn't bet)
Seat 8: Venomous100% folded before Flop (didn't bet)
Seat 9: COOLIKO\/23 folded before Flop (didn't bet)





PokerStars Hand #147754879255:  Hold'em No Limit (€0.50/€1.00 EUR) - 2016/01/27 12:00:28 CET [2016/01/27 6:00:28 ET]
Table 'Carol' 9-max Seat #3 is the button
Seat 1: RoadtoNepal (€100 in chips) 
Seat 2: sylvian31 (€143.15 in chips) 
Seat 3: noname076 (€43.81 in chips) 
Seat 4: Sweden_Pound (€100 in chips) 
Seat 6: Kukuryzka (€177.03 in chips) 
Seat 7: tipner (€181.79 in chips) 
Seat 8: matiko09 (€100 in chips) 
Seat 9: Venomous100% (€100 in chips) 
Sweden_Pound: posts small blind €0.50
Kukuryzka: posts big blind €1
*** HOLE CARDS ***
Dealt to matiko09 [3d Qs]
Proandi leaves the table
tipner: folds 
di0d80 joins the table at seat #5 
di0d80 is disconnected 
matiko09: folds 
Venomous100%: folds 
RoadtoNepal: folds 
sylvian31: raises €1.50 to €2.50
noname076: calls €2.50
Sweden_Pound: folds 
Kukuryzka: folds 
*** FLOP *** [5s 3h 2s]
sylvian31: bets €4.50
noname076: calls €4.50
*** TURN *** [5s 3h 2s] [6c]
sylvian31: bets €9.91
noname076: calls €9.91
*** RIVER *** [5s 3h 2s 6c] [Td]
sylvian31: checks 
noname076: bets €16.86
sylvian31: calls €16.86
*** SHOW DOWN ***
noname076: shows [9d Kc] (high card King)
sylvian31: shows [Jh Js] (a pair of Jacks)
sylvian31 collected €66.89 from pot
*** SUMMARY ***
Total pot €69.04 | Rake €2.15 
Board [5s 3h 2s 6c Td]
Seat 1: RoadtoNepal folded before Flop (didn't bet)
Seat 2: sylvian31 showed [Jh Js] and won (€66.89) with a pair of Jacks
Seat 3: noname076 (button) showed [9d Kc] and lost with high card King
Seat 4: Sweden_Pound (small blind) folded before Flop
Seat 6: Kukuryzka (big blind) folded before Flop
Seat 7: tipner folded before Flop (didn't bet)
Seat 8: matiko09 folded before Flop (didn't bet)
Seat 9: Venomous100% folded before Flop (didn't bet)





PokerStars Hand #147754880798:  Hold'em No Limit ($1/$2 USD) - 2016/01/27 12:00:31 CET [2016/01/27 6:00:31 ET]
Table 'Phobos II' 9-max Seat #1 is the button
Seat 1: LRV21 ($553.56 in chips) 
Seat 3: sylvian31 ($201 in chips) 
Seat 4: flk.Dasas ($200 in chips) 
Seat 5: tipner ($200 in chips) 
Seat 6: matiko09 ($227.15 in chips) 
Seat 7: Venomous100% ($365.22 in chips) 
Seat 8: RoadtoNepal ($200 in chips) 
Seat 9: Kukuryzka ($367.03 in chips) 
sylvian31: posts small blind $1
flk.Dasas: posts big blind $2
*** HOLE CARDS ***
Dealt to matiko09 [Kh Ks]
tipner: raises $4 to $6
di0d80 is disconnected 
matiko09: calls $6
Venomous100%: folds 
RoadtoNepal: folds 
Kukuryzka: folds 
LRV21: raises $21 to $27
sylvian31: folds 
flk.Dasas: folds 
tipner: folds 
matiko09: raises $39 to $66
LRV21: calls $39
*** FLOP *** [Ad 5c 4d]
matiko09: bets $35
LRV21: calls $35
*** TURN *** [Ad 5c 4d] [2s]
matiko09: checks 
LRV21: bets $48
matiko09: folds 
Uncalled bet ($48) returned to LRV21
LRV21 collected $208.20 from pot
LRV21: doesn't show hand 
*** SUMMARY ***
Total pot $211 | Rake $2.80 
Board [Ad 5c 4d 2s]
Seat 1: LRV21 (button) collected ($208.20)
Seat 3: sylvian31 (small blind) folded before Flop
Seat 4: flk.Dasas (big blind) folded before Flop
Seat 5: tipner folded before Flop
Seat 6: matiko09 folded on the Turn
Seat 7: Venomous100% folded before Flop (didn't bet)
Seat 8: RoadtoNepal folded before Flop (didn't bet)
Seat 9: Kukuryzka folded before Flop (didn't bet)





PokerStars Hand #147754885997:  Hold'em No Limit ($0.50/$1.00 USD) - 2016/01/27 12:00:42 CET [2016/01/27 6:00:42 ET]
Table 'Alhajoth' 9-max Seat #6 is the button
Seat 1: UShallGimme$ ($114.95 in chips) 
Seat 2: matiko09 ($100 in chips) 
Seat 3: Sweden_Pound ($108.77 in chips) 
Seat 4: Venomous100% ($152.65 in chips) 
Seat 5: Kukuryzka ($107.16 in chips) 
Seat 6: RoadtoNepal ($188.46 in chips) 
Seat 7: Ohpeel ($138.09 in chips) 
Seat 8: deepblue0000 ($133.49 in chips) 
Seat 9: di0d80 ($100 in chips) 
Ohpeel: posts small blind $0.50
deepblue0000: posts big blind $1
*** HOLE CARDS ***
Dealt to matiko09 [Qh 7d]
di0d80 is connected 
di0d80: folds 
UShallGimme$: folds 
matiko09: folds 
Sweden_Pound: folds 
Venomous100%: folds 
Kukuryzka: raises $1.50 to $2.50
RoadtoNepal: folds 
Ohpeel: raises $2.50 to $5
deepblue0000: folds 
Kukuryzka: calls $2.50
*** FLOP *** [8s Qs Qd]
Ohpeel: checks 
Kukuryzka: checks 
*** TURN *** [8s Qs Qd] [6c]
Ohpeel: bets $5
Kukuryzka: folds 
Uncalled bet ($5) returned to Ohpeel
Ohpeel collected $10.50 from pot
Ohpeel: doesn't show hand 
*** SUMMARY ***
Total pot $11 | Rake $0.50 
Board [8s Qs Qd 6c]
Seat 1: UShallGimme$ folded before Flop (didn't bet)
Seat 2: matiko09 folded before Flop (didn't bet)
Seat 3: Sweden_Pound folded before Flop (didn't bet)
Seat 4: Venomous100% folded before Flop (didn't bet)
Seat 5: Kukuryzka folded on the Turn
Seat 6: RoadtoNepal (button) folded before Flop (didn't bet)
Seat 7: Ohpeel (small blind) collected ($10.50)
Seat 8: deepblue0000 (big blind) folded before Flop
Seat 9: di0d80 folded before Flop (didn't bet)





PokerStars Hand #147754888901:  Hold'em No Limit ($0.50/$1.00 USD) - 2016/01/27 12:00:49 CET [2016/01/27 6:00:49 ET]
Table 'Delphinus II' 9-max Seat #7 is the button
Seat 1: Saintreine ($152.41 in chips) 
Seat 2: AlKatrone ($207.37 in chips) 
Seat 3: deepblue0000 ($465.91 in chips) 
Seat 4: matiko09 ($100 in chips) 
Seat 5: pandalapa ($105.14 in chips) 
Seat 6: Sweden_Pound ($122.64 in chips) 
Seat 7: RUS)Timur ($101.90 in chips) 
Seat 8: mycka86 ($106.02 in chips) 
Seat 9: FGL-lucky ($27.38 in chips) 
mycka86: posts small blind $0.50
FGL-lucky: posts big blind $1
*** HOLE CARDS ***
Dealt to matiko09 [8h Kh]
Saintreine: folds 
AlKatrone: folds 
deepblue0000: folds 
matiko09: folds 
pandalapa: folds 
Sweden_Pound: folds 
RUS)Timur: raises $1.50 to $2.50
mycka86: folds 
FGL-lucky: raises $3.50 to $6
RUS)Timur: raises $95.90 to $101.90 and is all-in
FGL-lucky: calls $21.38 and is all-in
Uncalled bet ($74.52) returned to RUS)Timur
*** FLOP *** [2d 9c 8d]
*** TURN *** [2d 9c 8d] [Qs]
*** RIVER *** [2d 9c 8d Qs] [Ah]
*** SHOW DOWN ***
FGL-lucky: shows [3h 3d] (a pair of Threes)
RUS)Timur: shows [Qh As] (two pair, Aces and Queens)
RUS)Timur collected $52.77 from pot
*** SUMMARY ***
Total pot $55.26 | Rake $2.49 
Board [2d 9c 8d Qs Ah]
Seat 1: Saintreine folded before Flop (didn't bet)
Seat 2: AlKatrone folded before Flop (didn't bet)
Seat 3: deepblue0000 folded before Flop (didn't bet)
Seat 4: matiko09 folded before Flop (didn't bet)
Seat 5: pandalapa folded before Flop (didn't bet)
Seat 6: Sweden_Pound folded before Flop (didn't bet)
Seat 7: RUS)Timur (button) showed [Qh As] and won ($52.77) with two pair, Aces and Queens
Seat 8: mycka86 (small blind) folded before Flop
Seat 9: FGL-lucky (big blind) showed [3h 3d] and lost with a pair of Threes





PokerStars Hand #147754889451:  Hold'em No Limit ($0.50/$1.00 USD) - 2016/01/27 12:00:50 CET [2016/01/27 6:00:50 ET]
Table 'Fragaria II' 9-max Seat #5 is the button
Seat 1: deepblue0000 ($142.72 in chips) 
Seat 2: GG-NoR34D. ($73.40 in chips) 
Seat 3: Sweden_Pound ($114.34 in chips) 
Seat 5: Venomous100% ($116.25 in chips) 
Seat 6: UShallGimme$ ($180.49 in chips) 
Seat 7: Hobby-.-AK ($48.23 in chips) 
Seat 8: mycka86 ($101.50 in chips) 
Seat 9: matiko09 ($100.50 in chips) 
UShallGimme$: posts small blind $0.50
Hobby-.-AK: posts big blind $1
*** HOLE CARDS ***
Dealt to matiko09 [2s Ac]
mycka86: folds 
matiko09: folds 
deepblue0000: raises $2 to $3
GG-NoR34D.: folds 
Sweden_Pound: folds 
Venomous100%: calls $3
UShallGimme$: calls $2.50
Hobby-.-AK: folds 
*** FLOP *** [5c 8s Kh]
UShallGimme$: checks 
deepblue0000: bets $4.77
Venomous100%: calls $4.77
UShallGimme$: folds 
*** TURN *** [5c 8s Kh] [Tc]
deepblue0000: checks 
Venomous100%: bets $12.32
deepblue0000: calls $12.32
*** RIVER *** [5c 8s Kh Tc] [As]
deepblue0000: checks 
Venomous100%: bets $25
deepblue0000: calls $25
*** SHOW DOWN ***
Venomous100%: shows [Ad Ks] (two pair, Aces and Kings)
deepblue0000: mucks hand 
Venomous100% collected $91.38 from pot
*** SUMMARY ***
Total pot $94.18 | Rake $2.80 
Board [5c 8s Kh Tc As]
Seat 1: deepblue0000 mucked [Qh Kc]
Seat 2: GG-NoR34D. folded before Flop (didn't bet)
Seat 3: Sweden_Pound folded before Flop (didn't bet)
Seat 5: Venomous100% (button) showed [Ad Ks] and won ($91.38) with two pair, Aces and Kings
Seat 6: UShallGimme$ (small blind) folded on the Flop
Seat 7: Hobby-.-AK (big blind) folded before Flop
Seat 8: mycka86 folded before Flop (didn't bet)
Seat 9: matiko09 folded before Flop (didn't bet)





PokerStars Hand #147754892945:  Hold'em No Limit ($0.50/$1.00 USD) - 2016/01/27 12:00:57 CET [2016/01/27 6:00:57 ET]
Table 'Alkmene II' 9-max Seat #1 is the button
Seat 1: matiko09 ($108.61 in chips) 
Seat 2: deepblue0000 ($100 in chips) 
Seat 3: di0d80 ($100 in chips) 
Seat 4: CoolFireX ($148.82 in chips) 
Seat 5: Sweden_Pound ($114.05 in chips) 
Seat 6: Peu3aHy ($121.72 in chips) 
Seat 7: mycka86 ($100 in chips) 
Seat 8: fecsok1 ($125.75 in chips) 
Seat 9: pandalapa ($107.12 in chips) 
deepblue0000: posts small blind $0.50
di0d80 is connected 
di0d80: posts big blind $1
*** HOLE CARDS ***
Dealt to matiko09 [3h 3s]
CoolFireX: folds 
Sweden_Pound: folds 
Peu3aHy: folds 
mycka86: folds 
fecsok1: folds 
pandalapa: folds 
matiko09: raises $1.27 to $2.27
deepblue0000: folds 
di0d80: folds 
Uncalled bet ($1.27) returned to matiko09
matiko09 collected $2.50 from pot
matiko09: doesn't show hand 
*** SUMMARY ***
Total pot $2.50 | Rake $0 
Seat 1: matiko09 (button) collected ($2.50)
Seat 2: deepblue0000 (small blind) folded before Flop
Seat 3: di0d80 (big blind) folded before Flop
Seat 4: CoolFireX folded before Flop (didn't bet)
Seat 5: Sweden_Pound folded before Flop (didn't bet)
Seat 6: Peu3aHy folded before Flop (didn't bet)
Seat 7: mycka86 folded before Flop (didn't bet)
Seat 8: fecsok1 folded before Flop (didn't bet)
Seat 9: pandalapa folded before Flop (didn't bet)





PokerStars Hand #147754893393:  Hold'em No Limit ($0.50/$1.00 USD) - 2016/01/27 12:00:58 CET [2016/01/27 6:00:58 ET]
Table 'Henyey' 9-max Seat #7 is the button
Seat 1: COOLIKO\/23 ($100 in chips) 
Seat 2: pandalapa ($149.27 in chips) 
Seat 3: deepblue0000 ($100 in chips) 
Seat 4: sylvian31 ($102.75 in chips) 
Seat 5: matiko09 ($175.33 in chips) 
Seat 6: UShallGimme$ ($104.44 in chips) 
Seat 7: vinniej15 ($46.19 in chips) 
Seat 8: CoolFireX ($116.82 in chips) 
Seat 9: mycka86 ($132.13 in chips) 
CoolFireX: posts small blind $0.50
mycka86: posts big blind $1
*** HOLE CARDS ***
Dealt to matiko09 [2c 7d]
COOLIKO\/23: folds 
pandalapa: folds 
deepblue0000: folds 
sylvian31: folds 
matiko09: folds 
UShallGimme$: folds 
vinniej15: calls $1
CoolFireX: raises $3.50 to $4.50
mycka86: folds 
vinniej15: raises $10 to $14.50
CoolFireX: folds 
Uncalled bet ($10) returned to vinniej15
vinniej15 collected $10 from pot
*** SUMMARY ***
Total pot $10 | Rake $0 
Seat 1: COOLIKO\/23 folded before Flop (didn't bet)
Seat 2: pandalapa folded before Flop (didn't bet)
Seat 3: deepblue0000 folded before Flop (didn't bet)
Seat 4: sylvian31 folded before Flop (didn't bet)
Seat 5: matiko09 folded before Flop (didn't bet)
Seat 6: UShallGimme$ folded before Flop (didn't bet)
Seat 7: vinniej15 (button) collected ($10)
Seat 8: CoolFireX (small blind) folded before Flop
Seat 9: mycka86 (big blind) folded before Flop





PokerStars Hand #147754896209:  Hold'em No Limit ($0.50/$1.00 USD) - 2016/01/27 12:01:03 CET [2016/01/27 6:01:03 ET]
Table 'Dollfus' 9-max Seat #3 is the button
Seat 1: masaytoo ($122.36 in chips) 
Seat 2: nosoant ($68.50 in chips) 
Seat 3: UShallGimme$ ($101 in chips) 
Seat 4: matiko09 ($122.04 in chips) 
Seat 5: pandalapa ($220.48 in chips) 
Seat 6: deepblue0000 ($103.46 in chips) 
Seat 7: Dödi123 ($205.72 in chips) 
Seat 8: Venomous100% ($120.27 in chips) 
Seat 9: COOLIKO\/23 ($123.21 in chips) 
matiko09: posts small blind $0.50
pandalapa: posts big blind $1
*** HOLE CARDS ***
Dealt to matiko09 [Ts 9h]
deepblue0000: folds 
Dödi123: folds 
Venomous100%: folds 
COOLIKO\/23: folds 
masaytoo: raises $1.50 to $2.50
nosoant: calls $2.50
UShallGimme$: folds 
matiko09: folds 
pandalapa: folds 
*** FLOP *** [6s 5h 4s]
masaytoo: bets $4
nosoant has timed out
nosoant: folds 
Uncalled bet ($4) returned to masaytoo
masaytoo collected $6.21 from pot
masaytoo: doesn't show hand 
*** SUMMARY ***
Total pot $6.50 | Rake $0.29 
Board [6s 5h 4s]
Seat 1: masaytoo collected ($6.21)
Seat 2: nosoant folded on the Flop
Seat 3: UShallGimme$ (button) folded before Flop (didn't bet)
Seat 4: matiko09 (small blind) folded before Flop
Seat 5: pandalapa (big blind) folded before Flop
Seat 6: deepblue0000 folded before Flop (didn't bet)
Seat 7: Dödi123 folded before Flop (didn't bet)
Seat 8: Venomous100% folded before Flop (didn't bet)
Seat 9: COOLIKO\/23 folded before Flop (didn't bet)





PokerStars Hand #147754906443:  Hold'em No Limit ($0.50/$1.00 USD) - 2016/01/27 12:01:24 CET [2016/01/27 6:01:24 ET]
Table 'Marlu II' 9-max Seat #9 is the button
Seat 1: Kukuryzka ($100 in chips) 
Seat 2: matiko09 ($100 in chips) 
Seat 9: platinium1 ($53.43 in chips) 
Kukuryzka: posts small blind $0.50
matiko09: posts big blind $1
Peu3aHy: sits out 
*** HOLE CARDS ***
Dealt to matiko09 [3d 7h]
platinium1: calls $1
COOLIKO\/23 joins the table at seat #3 
Kukuryzka: folds 
tipner joins the table at seat #4 
matiko09: checks 
*** FLOP *** [2d Ks 4c]
matiko09: checks 
platinium1: bets $1
matiko09: folds 
Uncalled bet ($1) returned to platinium1
platinium1 collected $2.39 from pot
platinium1: doesn't show hand 
*** SUMMARY ***
Total pot $2.50 | Rake $0.11 
Board [2d Ks 4c]
Seat 1: Kukuryzka (small blind) folded before Flop
Seat 2: matiko09 (big blind) folded on the Flop
Seat 9: platinium1 (button) collected ($2.39)





PokerStars Hand #147754916848:  Hold'em No Limit ($0.50/$1.00 USD) - 2016/01/27 12:01:46 CET [2016/01/27 6:01:46 ET]
Table 'Delphinus II' 9-max Seat #8 is the button
Seat 2: AlKatrone ($207.37 in chips) 
Seat 3: deepblue0000 ($465.91 in chips) 
Seat 4: matiko09 ($100 in chips) 
Seat 5: pandalapa ($105.14 in chips) 
Seat 6: Sweden_Pound ($122.64 in chips) 
Seat 7: RUS)Timur ($127.29 in chips) 
Seat 8: mycka86 ($105.52 in chips) 
Saintreine is disconnected 
Saintreine has timed out while disconnected
Saintreine: is sitting out 
AlKatrone: posts small blind $0.50
deepblue0000: posts big blind $1
*** HOLE CARDS ***
Dealt to matiko09 [7h 7c]
matiko09: raises $2 to $3
pandalapa: folds 
Sweden_Pound: folds 
RUS)Timur: folds 
mycka86: folds 
AlKatrone: folds 
deepblue0000: folds 
Uncalled bet ($2) returned to matiko09
matiko09 collected $2.50 from pot
matiko09: doesn't show hand 
*** SUMMARY ***
Total pot $2.50 | Rake $0 
Seat 2: AlKatrone (small blind) folded before Flop
Seat 3: deepblue0000 (big blind) folded before Flop
Seat 4: matiko09 collected ($2.50)
Seat 5: pandalapa folded before Flop (didn't bet)
Seat 6: Sweden_Pound folded before Flop (didn't bet)
Seat 7: RUS)Timur folded before Flop (didn't bet)
Seat 8: mycka86 (button) folded before Flop (didn't bet)





PokerStars Hand #147754917415:  Hold'em No Limit ($0.50/$1.00 USD) - 2016/01/27 12:01:47 CET [2016/01/27 6:01:47 ET]
Table 'Nanking' 9-max Seat #4 is the button
Seat 1: Peu3aHy ($102.66 in chips) 
Seat 2: Dachish ($101.83 in chips) 
Seat 3: nuaxin ($101.50 in chips) 
Seat 4: COOLIKO\/23 ($155.54 in chips) 
Seat 5: TheGentleFox ($108.44 in chips) 
Seat 6: Kukuryzka ($104.50 in chips) 
Seat 7: tipner ($106.30 in chips) 
Seat 8: matiko09 ($101.50 in chips) 
Seat 9: Sweden_Pound ($134.72 in chips) 
TheGentleFox: posts small blind $0.50
Kukuryzka: posts big blind $1
*** HOLE CARDS ***
Dealt to matiko09 [7d 9h]
tipner: folds 
matiko09: folds 
Sweden_Pound: raises $2 to $3
Peu3aHy: folds 
Dachish: folds 
nuaxin: folds 
COOLIKO\/23: folds 
TheGentleFox: calls $2.50
Kukuryzka: folds 
*** FLOP *** [8c Ad 8d]
TheGentleFox: bets $3.34
Sweden_Pound: folds 
Uncalled bet ($3.34) returned to TheGentleFox
TheGentleFox collected $6.68 from pot
TheGentleFox: doesn't show hand 
*** SUMMARY ***
Total pot $7 | Rake $0.32 
Board [8c Ad 8d]
Seat 1: Peu3aHy folded before Flop (didn't bet)
Seat 2: Dachish folded before Flop (didn't bet)
Seat 3: nuaxin folded before Flop (didn't bet)
Seat 4: COOLIKO\/23 (button) folded before Flop (didn't bet)
Seat 5: TheGentleFox (small blind) collected ($6.68)
Seat 6: Kukuryzka (big blind) folded before Flop
Seat 7: tipner folded before Flop (didn't bet)
Seat 8: matiko09 folded before Flop (didn't bet)
Seat 9: Sweden_Pound folded on the Flop





PokerStars Hand #147754917229:  Hold'em No Limit ($0.50/$1.00 USD) - 2016/01/27 12:01:47 CET [2016/01/27 6:01:47 ET]
Table 'Alkmene II' 9-max Seat #2 is the button
Seat 1: matiko09 ($110.11 in chips) 
Seat 2: deepblue0000 ($100 in chips) 
Seat 3: di0d80 ($100 in chips) 
Seat 4: CoolFireX ($148.82 in chips) 
Seat 5: Sweden_Pound ($114.05 in chips) 
Seat 6: Peu3aHy ($121.72 in chips) 
Seat 7: mycka86 ($100 in chips) 
Seat 8: fecsok1 ($125.75 in chips) 
Seat 9: pandalapa ($107.12 in chips) 
di0d80: posts small blind $0.50
CoolFireX: posts big blind $1
*** HOLE CARDS ***
Dealt to matiko09 [9s Ac]
Sweden_Pound: folds 
Peu3aHy: folds 
mycka86: folds 
fecsok1: folds 
pandalapa: folds 
matiko09: folds 
deepblue0000: folds 
di0d80: raises $2 to $3
CoolFireX: folds 
Uncalled bet ($2) returned to di0d80
di0d80 collected $2 from pot
di0d80: doesn't show hand 
*** SUMMARY ***
Total pot $2 | Rake $0 
Seat 1: matiko09 folded before Flop (didn't bet)
Seat 2: deepblue0000 (button) folded before Flop (didn't bet)
Seat 3: di0d80 (small blind) collected ($2)
Seat 4: CoolFireX (big blind) folded before Flop
Seat 5: Sweden_Pound folded before Flop (didn't bet)
Seat 6: Peu3aHy folded before Flop (didn't bet)
Seat 7: mycka86 folded before Flop (didn't bet)
Seat 8: fecsok1 folded before Flop (didn't bet)
Seat 9: pandalapa folded before Flop (didn't bet)





PokerStars Hand #147754923549:  Hold'em No Limit (€0.50/€1.00 EUR) - 2016/01/27 12:02:00 CET [2016/01/27 6:02:00 ET]
Table 'Carol' 9-max Seat #4 is the button
Seat 1: RoadtoNepal (€100 in chips) 
Seat 2: sylvian31 (€176.27 in chips) 
Seat 3: noname076 (€10.04 in chips) 
Seat 4: Sweden_Pound (€100 in chips) 
Seat 6: Kukuryzka (€176.03 in chips) 
Seat 7: tipner (€181.79 in chips) 
Seat 8: matiko09 (€100 in chips) 
Seat 9: Venomous100% (€100 in chips) 
Kukuryzka: posts small blind €0.50
tipner: posts big blind €1
*** HOLE CARDS ***
Dealt to matiko09 [7d Kh]
matiko09: folds 
Venomous100%: folds 
RoadtoNepal: raises €2 to €3
sylvian31: folds 
noname076: calls €3
Sweden_Pound: raises €8 to €11
Kukuryzka: folds 
tipner: folds 
RoadtoNepal: folds 
noname076: calls €7.04 and is all-in
Uncalled bet (€0.96) returned to Sweden_Pound
*** FLOP *** [5s Tc 9c]
*** TURN *** [5s Tc 9c] [As]
*** RIVER *** [5s Tc 9c As] [Js]
*** SHOW DOWN ***
noname076: shows [3h Kc] (high card Ace)
Sweden_Pound: shows [Ts Ah] (two pair, Aces and Tens)
Sweden_Pound collected €23.47 from pot
*** SUMMARY ***
Total pot €24.58 | Rake €1.11 
Board [5s Tc 9c As Js]
Seat 1: RoadtoNepal folded before Flop
Seat 2: sylvian31 folded before Flop (didn't bet)
Seat 3: noname076 showed [3h Kc] and lost with high card Ace
Seat 4: Sweden_Pound (button) showed [Ts Ah] and won (€23.47) with two pair, Aces and Tens
Seat 6: Kukuryzka (small blind) folded before Flop
Seat 7: tipner (big blind) folded before Flop
Seat 8: matiko09 folded before Flop (didn't bet)
Seat 9: Venomous100% folded before Flop (didn't bet)





PokerStars Hand #147754924545:  Hold'em No Limit ($0.50/$1.00 USD) - 2016/01/27 12:02:01 CET [2016/01/27 6:02:01 ET]
Table 'Grassias III' 9-max Seat #2 is the button
Seat 1: deepblue0000 ($133.71 in chips) 
Seat 2: pandalapa ($151.30 in chips) 
Seat 3: UShallGimme$ ($100 in chips) 
Seat 7: matiko09 ($100 in chips) 
Seat 8: RoadtoNepal ($105.03 in chips) 
Seat 9: Sweden_Pound ($101.50 in chips) 
UShallGimme$: posts small blind $0.50
CoolFireX: is sitting out 
matiko09: posts big blind $1
*** HOLE CARDS ***
Dealt to matiko09 [6d Tc]
CoolFireX leaves the table
RoadtoNepal: folds 
Sweden_Pound: folds 
deepblue0000: folds 
pandalapa: folds 
UShallGimme$: raises $2 to $3
matiko09: folds 
Uncalled bet ($2) returned to UShallGimme$
UShallGimme$ collected $2 from pot
UShallGimme$: doesn't show hand 
*** SUMMARY ***
Total pot $2 | Rake $0 
Seat 1: deepblue0000 folded before Flop (didn't bet)
Seat 2: pandalapa (button) folded before Flop (didn't bet)
Seat 3: UShallGimme$ (small blind) collected ($2)
Seat 7: matiko09 (big blind) folded before Flop
Seat 8: RoadtoNepal folded before Flop (didn't bet)
Seat 9: Sweden_Pound folded before Flop (didn't bet)





PokerStars Hand #147754932349:  Hold'em No Limit ($0.50/$1.00 USD) - 2016/01/27 12:02:16 CET [2016/01/27 6:02:16 ET]
Table 'Marlu II' 9-max Seat #1 is the button
Seat 1: Kukuryzka ($99.50 in chips) 
Seat 2: matiko09 ($100 in chips) 
Seat 3: COOLIKO\/23 ($100 in chips) 
Seat 9: platinium1 ($54.82 in chips) 
matiko09: posts small blind $0.50
COOLIKO\/23: posts big blind $1
tipner: sits out 
Peu3aHy: sits out 
*** HOLE CARDS ***
Dealt to matiko09 [2d Js]
platinium1: calls $1
Kukuryzka: folds 
matiko09: folds 
COOLIKO\/23: checks 
*** FLOP *** [Ks 2h As]
COOLIKO\/23: checks 
platinium1: bets $2
COOLIKO\/23: folds 
Uncalled bet ($2) returned to platinium1
platinium1 collected $2.39 from pot
platinium1: doesn't show hand 
*** SUMMARY ***
Total pot $2.50 | Rake $0.11 
Board [Ks 2h As]
Seat 1: Kukuryzka (button) folded before Flop (didn't bet)
Seat 2: matiko09 (small blind) folded before Flop
Seat 3: COOLIKO\/23 (big blind) folded on the Flop
Seat 9: platinium1 collected ($2.39)





PokerStars Hand #147754932909:  Hold'em No Limit ($0.50/$1.00 USD) - 2016/01/27 12:02:17 CET [2016/01/27 6:02:17 ET]
Table 'Grassias III' 9-max Seat #3 is the button
Seat 1: deepblue0000 ($133.71 in chips) 
Seat 2: pandalapa ($151.30 in chips) 
Seat 3: UShallGimme$ ($101 in chips) 
Seat 7: matiko09 ($100 in chips) 
matiko09: posts small blind $0.50
RoadtoNepal: is sitting out 
Sweden_Pound: is sitting out 
Sweden_Pound leaves the table
deepblue0000: posts big blind $1
*** HOLE CARDS ***
Dealt to matiko09 [Ts 8c]
pandalapa: folds 
UShallGimme$: raises $1 to $2
matiko09: folds 
deepblue0000: folds 
Uncalled bet ($1) returned to UShallGimme$
UShallGimme$ collected $2.50 from pot
UShallGimme$: doesn't show hand 
*** SUMMARY ***
Total pot $2.50 | Rake $0 
Seat 1: deepblue0000 (big blind) folded before Flop
Seat 2: pandalapa folded before Flop (didn't bet)
Seat 3: UShallGimme$ (button) collected ($2.50)
Seat 7: matiko09 (small blind) folded before Flop





PokerStars Hand #147754933918:  Hold'em No Limit ($0.50/$1.00 USD) - 2016/01/27 12:02:19 CET [2016/01/27 6:02:19 ET]
Table 'Alhajoth' 9-max Seat #7 is the button
Seat 1: UShallGimme$ ($114.95 in chips) 
Seat 2: matiko09 ($100 in chips) 
Seat 3: Sweden_Pound ($108.77 in chips) 
Seat 4: Venomous100% ($152.65 in chips) 
Seat 5: Kukuryzka ($102.16 in chips) 
Seat 6: RoadtoNepal ($188.46 in chips) 
Seat 7: Ohpeel ($143.59 in chips) 
Seat 8: deepblue0000 ($132.49 in chips) 
deepblue0000: posts small blind $0.50
di0d80: is sitting out 
UShallGimme$: posts big blind $1
*** HOLE CARDS ***
Dealt to matiko09 [Qd 6s]
matiko09: folds 
Sweden_Pound: folds 
Venomous100%: folds 
Kukuryzka: folds 
RoadtoNepal: folds 
Ohpeel: raises $2 to $3
deepblue0000: folds 
UShallGimme$: folds 
Uncalled bet ($2) returned to Ohpeel
Ohpeel collected $2.50 from pot
Ohpeel: doesn't show hand 
*** SUMMARY ***
Total pot $2.50 | Rake $0 
Seat 1: UShallGimme$ (big blind) folded before Flop
Seat 2: matiko09 folded before Flop (didn't bet)
Seat 3: Sweden_Pound folded before Flop (didn't bet)
Seat 4: Venomous100% folded before Flop (didn't bet)
Seat 5: Kukuryzka folded before Flop (didn't bet)
Seat 6: RoadtoNepal folded before Flop (didn't bet)
Seat 7: Ohpeel (button) collected ($2.50)
Seat 8: deepblue0000 (small blind) folded before Flop





PokerStars Hand #147754935557:  Hold'em No Limit ($0.50/$1.00 USD) - 2016/01/27 12:02:22 CET [2016/01/27 6:02:22 ET]
Table 'Henyey' 9-max Seat #8 is the button
Seat 1: COOLIKO\/23 ($100 in chips) 
Seat 2: pandalapa ($149.27 in chips) 
Seat 3: deepblue0000 ($100 in chips) 
Seat 4: sylvian31 ($102.75 in chips) 
Seat 5: matiko09 ($175.33 in chips) 
Seat 6: UShallGimme$ ($104.44 in chips) 
Seat 7: vinniej15 ($51.69 in chips) 
Seat 8: CoolFireX ($112.32 in chips) 
Seat 9: mycka86 ($131.13 in chips) 
mycka86: posts small blind $0.50
COOLIKO\/23: posts big blind $1
*** HOLE CARDS ***
Dealt to matiko09 [Td 5d]
pandalapa: folds 
deepblue0000: raises $2 to $3
sylvian31: folds 
matiko09: folds 
UShallGimme$: calls $3
vinniej15: folds 
CoolFireX: folds 
mycka86: folds 
COOLIKO\/23: folds 
*** FLOP *** [Ah Ac 2c]
deepblue0000: bets $3
UShallGimme$: calls $3
*** TURN *** [Ah Ac 2c] [Kh]
deepblue0000: checks 
UShallGimme$: checks 
*** RIVER *** [Ah Ac 2c Kh] [3c]
deepblue0000: checks 
UShallGimme$: bets $8
deepblue0000: folds 
Uncalled bet ($8) returned to UShallGimme$
UShallGimme$ collected $12.89 from pot
UShallGimme$: doesn't show hand 
*** SUMMARY ***
Total pot $13.50 | Rake $0.61 
Board [Ah Ac 2c Kh 3c]
Seat 1: COOLIKO\/23 (big blind) folded before Flop
Seat 2: pandalapa folded before Flop (didn't bet)
Seat 3: deepblue0000 folded on the River
Seat 4: sylvian31 folded before Flop (didn't bet)
Seat 5: matiko09 folded before Flop (didn't bet)
Seat 6: UShallGimme$ collected ($12.89)
Seat 7: vinniej15 folded before Flop (didn't bet)
Seat 8: CoolFireX (button) folded before Flop (didn't bet)
Seat 9: mycka86 (small blind) folded before Flop





PokerStars Hand #147754940422:  Hold'em No Limit ($0.50/$1.00 USD) - 2016/01/27 12:02:32 CET [2016/01/27 6:02:32 ET]
Table 'Alkmene II' 9-max Seat #3 is the button
Seat 1: matiko09 ($110.11 in chips) 
Seat 2: deepblue0000 ($100 in chips) 
Seat 3: di0d80 ($101 in chips) 
Seat 4: CoolFireX ($147.82 in chips) 
Seat 5: Sweden_Pound ($114.05 in chips) 
Seat 6: Peu3aHy ($121.72 in chips) 
Seat 7: mycka86 ($100 in chips) 
Seat 8: fecsok1 ($125.75 in chips) 
Seat 9: pandalapa ($107.12 in chips) 
CoolFireX: posts small blind $0.50
Sweden_Pound: posts big blind $1
*** HOLE CARDS ***
Dealt to matiko09 [9c 7s]
Peu3aHy: folds 
mycka86: folds 
fecsok1: folds 
pandalapa has timed out
pandalapa: folds 
matiko09: folds 
deepblue0000: folds 
di0d80: raises $1 to $2
CoolFireX: calls $1.50
Sweden_Pound: folds 
*** FLOP *** [Th 6h Qc]
CoolFireX: checks 
di0d80: bets $3
CoolFireX: folds 
Uncalled bet ($3) returned to di0d80
di0d80 collected $4.78 from pot
di0d80: doesn't show hand 
*** SUMMARY ***
Total pot $5 | Rake $0.22 
Board [Th 6h Qc]
Seat 1: matiko09 folded before Flop (didn't bet)
Seat 2: deepblue0000 folded before Flop (didn't bet)
Seat 3: di0d80 (button) collected ($4.78)
Seat 4: CoolFireX (small blind) folded on the Flop
Seat 5: Sweden_Pound (big blind) folded before Flop
Seat 6: Peu3aHy folded before Flop (didn't bet)
Seat 7: mycka86 folded before Flop (didn't bet)
Seat 8: fecsok1 folded before Flop (didn't bet)
Seat 9: pandalapa folded before Flop (didn't bet)





PokerStars Hand #147754941875:  Hold'em No Limit ($0.50/$1.00 USD) - 2016/01/27 12:02:35 CET [2016/01/27 6:02:35 ET]
Table 'Delphinus II' 9-max Seat #2 is the button
Seat 2: AlKatrone ($206.87 in chips) 
Seat 3: deepblue0000 ($464.91 in chips) 
Seat 4: matiko09 ($101.50 in chips) 
Seat 5: pandalapa ($105.14 in chips) 
Seat 6: Sweden_Pound ($122.64 in chips) 
Seat 7: RUS)Timur ($127.29 in chips) 
Seat 8: mycka86 ($105.52 in chips) 
deepblue0000: posts small blind $0.50
matiko09: posts big blind $1
*** HOLE CARDS ***
Dealt to matiko09 [9h 6d]
pandalapa: folds 
Sweden_Pound: folds 
FGL-lucky is disconnected 
RUS)Timur: folds 
mycka86: folds 
AlKatrone: folds 
deepblue0000: raises $2 to $3
matiko09: folds 
Uncalled bet ($2) returned to deepblue0000
deepblue0000 collected $2 from pot
*** SUMMARY ***
Total pot $2 | Rake $0 
Seat 2: AlKatrone (button) folded before Flop (didn't bet)
Seat 3: deepblue0000 (small blind) collected ($2)
Seat 4: matiko09 (big blind) folded before Flop
Seat 5: pandalapa folded before Flop (didn't bet)
Seat 6: Sweden_Pound folded before Flop (didn't bet)
Seat 7: RUS)Timur folded before Flop (didn't bet)
Seat 8: mycka86 folded before Flop (didn't bet)





PokerStars Hand #147754944967:  Hold'em No Limit ($0.50/$1.00 USD) - 2016/01/27 12:02:41 CET [2016/01/27 6:02:41 ET]
Table 'Nanking' 9-max Seat #5 is the button
Seat 1: Peu3aHy ($102.66 in chips) 
Seat 2: Dachish ($101.83 in chips) 
Seat 3: nuaxin ($101.50 in chips) 
Seat 4: COOLIKO\/23 ($155.54 in chips) 
Seat 5: TheGentleFox ($112.12 in chips) 
Seat 6: Kukuryzka ($103.50 in chips) 
Seat 7: tipner ($106.30 in chips) 
Seat 8: matiko09 ($101.50 in chips) 
Seat 9: Sweden_Pound ($131.72 in chips) 
Kukuryzka: posts small blind $0.50
tipner: posts big blind $1
*** HOLE CARDS ***
Dealt to matiko09 [7d 5h]
matiko09: folds 
Sweden_Pound: folds 
Peu3aHy: folds 
Dachish: raises $1 to $2
nuaxin: raises $3 to $5
COOLIKO\/23: folds 
TheGentleFox: folds 
Kukuryzka: folds 
tipner: folds 
Dachish: calls $3
*** FLOP *** [5c 3d 4c]
Dachish: checks 
nuaxin: bets $1
Dachish: calls $1
*** TURN *** [5c 3d 4c] [6h]
Dachish: checks 
nuaxin: bets $1
Dachish: calls $1
*** RIVER *** [5c 3d 4c 6h] [Kd]
Dachish: checks 
nuaxin: bets $1
Dachish: calls $1
*** SHOW DOWN ***
nuaxin: shows [Kh As] (a pair of Kings)
Dachish: mucks hand 
nuaxin collected $16.71 from pot
*** SUMMARY ***
Total pot $17.50 | Rake $0.79 
Board [5c 3d 4c 6h Kd]
Seat 1: Peu3aHy folded before Flop (didn't bet)
Seat 2: Dachish mucked [Ah 3h]
Seat 3: nuaxin showed [Kh As] and won ($16.71) with a pair of Kings
Seat 4: COOLIKO\/23 folded before Flop (didn't bet)
Seat 5: TheGentleFox (button) folded before Flop (didn't bet)
Seat 6: Kukuryzka (small blind) folded before Flop
Seat 7: tipner (big blind) folded before Flop
Seat 8: matiko09 folded before Flop (didn't bet)
Seat 9: Sweden_Pound folded before Flop (didn't bet)





PokerStars Hand #147754946710:  Hold'em No Limit ($0.50/$1.00 USD) - 2016/01/27 12:02:44 CET [2016/01/27 6:02:44 ET]
Table 'Alhajoth' 9-max Seat #8 is the button
Seat 1: UShallGimme$ ($113.95 in chips) 
Seat 2: matiko09 ($100 in chips) 
Seat 3: Sweden_Pound ($108.77 in chips) 
Seat 4: Venomous100% ($152.65 in chips) 
Seat 5: Kukuryzka ($102.16 in chips) 
Seat 6: RoadtoNepal ($188.46 in chips) 
Seat 7: Ohpeel ($145.09 in chips) 
Seat 8: deepblue0000 ($131.99 in chips) 
UShallGimme$: posts small blind $0.50
matiko09: posts big blind $1
*** HOLE CARDS ***
Dealt to matiko09 [Kc Qh]
Sweden_Pound: folds 
Venomous100%: folds 
Kukuryzka: folds 
RoadtoNepal: raises $2 to $3
Ohpeel: folds 
deepblue0000: folds 
UShallGimme$: folds 
matiko09: raises $7 to $10
RoadtoNepal: folds 
Uncalled bet ($7) returned to matiko09
matiko09 collected $6.50 from pot
matiko09: doesn't show hand 
*** SUMMARY ***
Total pot $6.50 | Rake $0 
Seat 1: UShallGimme$ (small blind) folded before Flop
Seat 2: matiko09 (big blind) collected ($6.50)
Seat 3: Sweden_Pound folded before Flop (didn't bet)
Seat 4: Venomous100% folded before Flop (didn't bet)
Seat 5: Kukuryzka folded before Flop (didn't bet)
Seat 6: RoadtoNepal folded before Flop
Seat 7: Ohpeel folded before Flop (didn't bet)
Seat 8: deepblue0000 (button) folded before Flop (didn't bet)





PokerStars Hand #147754948657:  Hold'em No Limit ($0.50/$1.00 USD) - 2016/01/27 12:02:48 CET [2016/01/27 6:02:48 ET]
Table 'Dollfus' 9-max Seat #4 is the button
Seat 1: masaytoo ($126.07 in chips) 
Seat 3: UShallGimme$ ($101 in chips) 
Seat 4: matiko09 ($121.54 in chips) 
Seat 5: pandalapa ($219.48 in chips) 
Seat 6: deepblue0000 ($103.46 in chips) 
Seat 7: Dödi123 ($205.72 in chips) 
Seat 8: Venomous100% ($120.27 in chips) 
Seat 9: COOLIKO\/23 ($123.21 in chips) 
pandalapa: posts small blind $0.50
deepblue0000: posts big blind $1
*** HOLE CARDS ***
Dealt to matiko09 [9h 5c]
Dödi123: folds 
Venomous100%: folds 
COOLIKO\/23: folds 
masaytoo: folds 
UShallGimme$: raises $1.50 to $2.50
matiko09: folds 
pandalapa: folds 
deepblue0000: folds 
Uncalled bet ($1.50) returned to UShallGimme$
UShallGimme$ collected $2.50 from pot
UShallGimme$: doesn't show hand 
*** SUMMARY ***
Total pot $2.50 | Rake $0 
Seat 1: masaytoo folded before Flop (didn't bet)
Seat 3: UShallGimme$ collected ($2.50)
Seat 4: matiko09 (button) folded before Flop (didn't bet)
Seat 5: pandalapa (small blind) folded before Flop
Seat 6: deepblue0000 (big blind) folded before Flop
Seat 7: Dödi123 folded before Flop (didn't bet)
Seat 8: Venomous100% folded before Flop (didn't bet)
Seat 9: COOLIKO\/23 folded before Flop (didn't bet)





PokerStars Hand #147754949286:  Hold'em No Limit (€0.50/€1.00 EUR) - 2016/01/27 12:02:49 CET [2016/01/27 6:02:49 ET]
Table 'Carol' 9-max Seat #6 is the button
Seat 1: RoadtoNepal (€100 in chips) 
Seat 2: sylvian31 (€176.27 in chips) 
Seat 4: Sweden_Pound (€113.43 in chips) 
Seat 6: Kukuryzka (€175.53 in chips) 
Seat 7: tipner (€180.79 in chips) 
Seat 8: matiko09 (€100 in chips) 
Seat 9: Venomous100% (€100 in chips) 
tipner: posts small blind €0.50
matiko09: posts big blind €1
*** HOLE CARDS ***
Dealt to matiko09 [Ts 4s]
Venomous100%: folds 
RoadtoNepal: folds 
noname076 leaves the table
sylvian31: raises €2 to €3
Sweden_Pound: folds 
Kukuryzka: folds 
tipner: folds 
matiko09: folds 
Uncalled bet (€2) returned to sylvian31
sylvian31 collected €2.50 from pot
sylvian31: doesn't show hand 
*** SUMMARY ***
Total pot €2.50 | Rake €0 
Seat 1: RoadtoNepal folded before Flop (didn't bet)
Seat 2: sylvian31 collected (€2.50)
Seat 4: Sweden_Pound folded before Flop (didn't bet)
Seat 6: Kukuryzka (button) folded before Flop (didn't bet)
Seat 7: tipner (small blind) folded before Flop
Seat 8: matiko09 (big blind) folded before Flop
Seat 9: Venomous100% folded before Flop (didn't bet)





PokerStars Hand #147754952934:  Hold'em No Limit ($0.50/$1.00 USD) - 2016/01/27 12:02:56 CET [2016/01/27 6:02:56 ET]
Table 'Delphinus II' 9-max Seat #3 is the button
Seat 2: AlKatrone ($206.87 in chips) 
Seat 3: deepblue0000 ($465.91 in chips) 
Seat 4: matiko09 ($100.50 in chips) 
Seat 5: pandalapa ($105.14 in chips) 
Seat 6: Sweden_Pound ($122.64 in chips) 
Seat 7: RUS)Timur ($127.29 in chips) 
Seat 8: mycka86 ($105.52 in chips) 
matiko09: posts small blind $0.50
pandalapa: posts big blind $1
*** HOLE CARDS ***
Dealt to matiko09 [Ah Jc]
Sweden_Pound: folds 
RUS)Timur: folds 
mycka86: folds 
AlKatrone: folds 
deepblue0000: folds 
matiko09: raises $1.50 to $2.50
pandalapa: calls $1.50
*** FLOP *** [8h Qs 8s]
matiko09: checks 
pandalapa: checks 
*** TURN *** [8h Qs 8s] [Jd]
matiko09: bets $3.11
pandalapa: calls $3.11
*** RIVER *** [8h Qs 8s Jd] [9s]
matiko09: checks 
pandalapa: checks 
*** SHOW DOWN ***
matiko09: shows [Ah Jc] (two pair, Jacks and Eights)
pandalapa: shows [Kh Qc] (two pair, Queens and Eights)
pandalapa collected $10.72 from pot
*** SUMMARY ***
Total pot $11.22 | Rake $0.50 
Board [8h Qs 8s Jd 9s]
Seat 2: AlKatrone folded before Flop (didn't bet)
Seat 3: deepblue0000 (button) folded before Flop (didn't bet)
Seat 4: matiko09 (small blind) showed [Ah Jc] and lost with two pair, Jacks and Eights
Seat 5: pandalapa (big blind) showed [Kh Qc] and won ($10.72) with two pair, Queens and Eights
Seat 6: Sweden_Pound folded before Flop (didn't bet)
Seat 7: RUS)Timur folded before Flop (didn't bet)
Seat 8: mycka86 folded before Flop (didn't bet)





PokerStars Hand #147754955561:  Hold'em No Limit ($0.50/$1.00 USD) - 2016/01/27 12:03:02 CET [2016/01/27 6:03:02 ET]
Table 'Fragaria II' 9-max Seat #6 is the button
Seat 1: deepblue0000 ($100 in chips) 
Seat 2: GG-NoR34D. ($73.40 in chips) 
Seat 3: Sweden_Pound ($114.34 in chips) 
Seat 5: Venomous100% ($162.54 in chips) 
Seat 6: UShallGimme$ ($177.49 in chips) 
Seat 7: Hobby-.-AK ($47.23 in chips) 
Seat 8: mycka86 ($101.50 in chips) 
Seat 9: matiko09 ($100.50 in chips) 
Hobby-.-AK: posts small blind $0.50
mycka86: posts big blind $1
*** HOLE CARDS ***
Dealt to matiko09 [2s As]
matiko09: folds 
deepblue0000: folds 
GG-NoR34D.: folds 
Sweden_Pound: raises $2 to $3
Venomous100%: folds 
UShallGimme$: folds 
Hobby-.-AK: folds 
mycka86: folds 
Uncalled bet ($2) returned to Sweden_Pound
Sweden_Pound collected $2.50 from pot
Sweden_Pound: doesn't show hand 
*** SUMMARY ***
Total pot $2.50 | Rake $0 
Seat 1: deepblue0000 folded before Flop (didn't bet)
Seat 2: GG-NoR34D. folded before Flop (didn't bet)
Seat 3: Sweden_Pound collected ($2.50)
Seat 5: Venomous100% folded before Flop (didn't bet)
Seat 6: UShallGimme$ (button) folded before Flop (didn't bet)
Seat 7: Hobby-.-AK (small blind) folded before Flop
Seat 8: mycka86 (big blind) folded before Flop
Seat 9: matiko09 folded before Flop (didn't bet)





PokerStars Hand #147754961642:  Hold'em No Limit ($0.50/$1.00 USD) - 2016/01/27 12:03:14 CET [2016/01/27 6:03:14 ET]
Table 'Marlu II' 9-max Seat #2 is the button
Seat 1: Kukuryzka ($99.50 in chips) 
Seat 2: matiko09 ($100 in chips) 
Seat 3: COOLIKO\/23 ($100 in chips) 
Seat 4: tipner ($100 in chips) 
Seat 9: platinium1 ($56.21 in chips) 
COOLIKO\/23: posts small blind $0.50
tipner: posts big blind $1
Peu3aHy: sits out 
*** HOLE CARDS ***
Dealt to matiko09 [Kd Qh]
platinium1: folds 
Kukuryzka: raises $1.50 to $2.50
Sweden_Pound joins the table at seat #5 
matiko09: calls $2.50
LIGOPSIXIS78 joins the table at seat #6 
COOLIKO\/23: folds 
tipner: folds 
*** FLOP *** [9s 4d Jh]
Kukuryzka: bets $4.66
matiko09: calls $4.66
*** TURN *** [9s 4d Jh] [6h]
UShallGimme$ joins the table at seat #7 
Kukuryzka: bets $11
matiko09: folds 
Uncalled bet ($11) returned to Kukuryzka
Kukuryzka collected $15.11 from pot
Kukuryzka: doesn't show hand 
*** SUMMARY ***
Total pot $15.82 | Rake $0.71 
Board [9s 4d Jh 6h]
Seat 1: Kukuryzka collected ($15.11)
Seat 2: matiko09 (button) folded on the Turn
Seat 3: COOLIKO\/23 (small blind) folded before Flop
Seat 4: tipner (big blind) folded before Flop
Seat 9: platinium1 folded before Flop (didn't bet)





PokerStars Hand #147754962254:  Hold'em No Limit ($1/$2 USD) - 2016/01/27 12:03:15 CET [2016/01/27 6:03:15 ET]
Table 'Phobos II' 9-max Seat #3 is the button
Seat 1: LRV21 ($660.76 in chips) 
Seat 3: sylvian31 ($200 in chips) 
Seat 4: flk.Dasas ($200 in chips) 
Seat 5: tipner ($200 in chips) 
Seat 6: matiko09 ($200 in chips) 
Seat 7: Venomous100% ($365.22 in chips) 
Seat 8: RoadtoNepal ($200 in chips) 
Seat 9: Kukuryzka ($367.03 in chips) 
flk.Dasas: posts small blind $1
tipner: posts big blind $2
*** HOLE CARDS ***
Dealt to matiko09 [3d 9d]
matiko09: folds 
Venomous100%: folds 
RoadtoNepal: raises $4 to $6
Kukuryzka: folds 
LRV21: folds 
sylvian31: folds 
flk.Dasas: folds 
tipner: folds 
Uncalled bet ($4) returned to RoadtoNepal
RoadtoNepal collected $5 from pot
RoadtoNepal: doesn't show hand 
*** SUMMARY ***
Total pot $5 | Rake $0 
Seat 1: LRV21 folded before Flop (didn't bet)
Seat 3: sylvian31 (button) folded before Flop (didn't bet)
Seat 4: flk.Dasas (small blind) folded before Flop
Seat 5: tipner (big blind) folded before Flop
Seat 6: matiko09 folded before Flop (didn't bet)
Seat 7: Venomous100% folded before Flop (didn't bet)
Seat 8: RoadtoNepal collected ($5)
Seat 9: Kukuryzka folded before Flop (didn't bet)





PokerStars Hand #147754962170:  Hold'em No Limit ($0.50/$1.00 USD) - 2016/01/27 12:03:15 CET [2016/01/27 6:03:15 ET]
Table 'Alhajoth' 9-max Seat #1 is the button
Seat 1: UShallGimme$ ($113.45 in chips) 
Seat 2: matiko09 ($103.50 in chips) 
Seat 3: Sweden_Pound ($108.77 in chips) 
Seat 4: Venomous100% ($152.65 in chips) 
Seat 5: Kukuryzka ($102.16 in chips) 
Seat 6: RoadtoNepal ($185.46 in chips) 
Seat 7: Ohpeel ($145.09 in chips) 
Seat 8: deepblue0000 ($131.99 in chips) 
matiko09: posts small blind $0.50
Sweden_Pound: posts big blind $1
*** HOLE CARDS ***
Dealt to matiko09 [6s 4h]
Venomous100%: folds 
Kukuryzka: raises $2 to $3
RoadtoNepal: folds 
Ohpeel: folds 
deepblue0000: folds 
UShallGimme$: folds 
matiko09: folds 
Sweden_Pound: calls $2
*** FLOP *** [Jd 5d Ks]
Sweden_Pound: checks 
Kukuryzka: checks 
*** TURN *** [Jd 5d Ks] [Qd]
Sweden_Pound: checks 
Kukuryzka: checks 
*** RIVER *** [Jd 5d Ks Qd] [2h]
Sweden_Pound: checks 
Kukuryzka: checks 
*** SHOW DOWN ***
Sweden_Pound: shows [7d 7h] (a pair of Sevens)
Kukuryzka: shows [Jc Ac] (a pair of Jacks)
Kukuryzka collected $6.21 from pot
*** SUMMARY ***
Total pot $6.50 | Rake $0.29 
Board [Jd 5d Ks Qd 2h]
Seat 1: UShallGimme$ (button) folded before Flop (didn't bet)
Seat 2: matiko09 (small blind) folded before Flop
Seat 3: Sweden_Pound (big blind) showed [7d 7h] and lost with a pair of Sevens
Seat 4: Venomous100% folded before Flop (didn't bet)
Seat 5: Kukuryzka showed [Jc Ac] and won ($6.21) with a pair of Jacks
Seat 6: RoadtoNepal folded before Flop (didn't bet)
Seat 7: Ohpeel folded before Flop (didn't bet)
Seat 8: deepblue0000 folded before Flop (didn't bet)





PokerStars Hand #147754964321:  Hold'em No Limit (€0.50/€1.00 EUR) - 2016/01/27 12:03:19 CET [2016/01/27 6:03:19 ET]
Table 'Carol' 9-max Seat #7 is the button
Seat 1: RoadtoNepal (€100 in chips) 
Seat 2: sylvian31 (€177.77 in chips) 
Seat 4: Sweden_Pound (€113.43 in chips) 
Seat 6: Kukuryzka (€175.53 in chips) 
Seat 7: tipner (€180.29 in chips) 
Seat 8: matiko09 (€100 in chips) 
Seat 9: Venomous100% (€100 in chips) 
matiko09: posts small blind €0.50
Venomous100%: posts big blind €1
*** HOLE CARDS ***
Dealt to matiko09 [4s 3c]
RoadtoNepal: folds 
sylvian31: raises €2 to €3
Sweden_Pound: folds 
Kukuryzka: folds 
tipner: folds 
matiko09: folds 
Venomous100%: folds 
Uncalled bet (€2) returned to sylvian31
sylvian31 collected €2.50 from pot
sylvian31: doesn't show hand 
*** SUMMARY ***
Total pot €2.50 | Rake €0 
Seat 1: RoadtoNepal folded before Flop (didn't bet)
Seat 2: sylvian31 collected (€2.50)
Seat 4: Sweden_Pound folded before Flop (didn't bet)
Seat 6: Kukuryzka folded before Flop (didn't bet)
Seat 7: tipner (button) folded before Flop (didn't bet)
Seat 8: matiko09 (small blind) folded before Flop
Seat 9: Venomous100% (big blind) folded before Flop





PokerStars Hand #147754973918:  Hold'em No Limit ($0.50/$1.00 USD) - 2016/01/27 12:03:37 CET [2016/01/27 6:03:37 ET]
Table 'Fragaria II' 9-max Seat #7 is the button
Seat 1: deepblue0000 ($100 in chips) 
Seat 2: GG-NoR34D. ($73.40 in chips) 
Seat 3: Sweden_Pound ($115.84 in chips) 
Seat 5: Venomous100% ($162.54 in chips) 
Seat 6: UShallGimme$ ($177.49 in chips) 
Seat 7: Hobby-.-AK ($46.73 in chips) 
Seat 8: mycka86 ($100.50 in chips) 
Seat 9: matiko09 ($100.50 in chips) 
mycka86: posts small blind $0.50
matiko09: posts big blind $1
*** HOLE CARDS ***
Dealt to matiko09 [5h 2s]
deepblue0000: folds 
GG-NoR34D.: folds 
Sweden_Pound: raises $2 to $3
Venomous100%: folds 
UShallGimme$: folds 
Hobby-.-AK: calls $3
mycka86: folds 
matiko09: folds 
*** FLOP *** [Kc 9s Jc]
Sweden_Pound: bets $4.65
Hobby-.-AK: calls $4.65
*** TURN *** [Kc 9s Jc] [9c]
Sweden_Pound: checks 
Hobby-.-AK: checks 
*** RIVER *** [Kc 9s Jc 9c] [Ah]
Sweden_Pound: checks 
Hobby-.-AK: bets $7
Sweden_Pound: calls $7
*** SHOW DOWN ***
Hobby-.-AK: shows [Js Jh] (a full house, Jacks full of Nines)
Sweden_Pound: mucks hand 
Hobby-.-AK collected $29.41 from pot
*** SUMMARY ***
Total pot $30.80 | Rake $1.39 
Board [Kc 9s Jc 9c Ah]
Seat 1: deepblue0000 folded before Flop (didn't bet)
Seat 2: GG-NoR34D. folded before Flop (didn't bet)
Seat 3: Sweden_Pound mucked [Ad Qs]
Seat 5: Venomous100% folded before Flop (didn't bet)
Seat 6: UShallGimme$ folded before Flop (didn't bet)
Seat 7: Hobby-.-AK (button) showed [Js Jh] and won ($29.41) with a full house, Jacks full of Nines
Seat 8: mycka86 (small blind) folded before Flop
Seat 9: matiko09 (big blind) folded before Flop





PokerStars Hand #147754978064:  Hold'em No Limit ($1/$2 USD) - 2016/01/27 12:03:46 CET [2016/01/27 6:03:46 ET]
Table 'Phobos II' 9-max Seat #4 is the button
Seat 1: LRV21 ($660.76 in chips) 
Seat 3: sylvian31 ($200 in chips) 
Seat 4: flk.Dasas ($200 in chips) 
Seat 5: tipner ($200 in chips) 
Seat 6: matiko09 ($200 in chips) 
Seat 7: Venomous100% ($365.22 in chips) 
Seat 8: RoadtoNepal ($203 in chips) 
Seat 9: Kukuryzka ($367.03 in chips) 
tipner: posts small blind $1
matiko09: posts big blind $2
*** HOLE CARDS ***
Dealt to matiko09 [7c Jh]
Venomous100%: folds 
RoadtoNepal: raises $4 to $6
Kukuryzka: folds 
LRV21: calls $6
sylvian31: raises $18 to $24
flk.Dasas: folds 
tipner: folds 
matiko09: folds 
RoadtoNepal: calls $18
LRV21: calls $18
*** FLOP *** [2d 9d Tc]
RoadtoNepal: checks 
LRV21: checks 
sylvian31: bets $33
RoadtoNepal: folds 
LRV21: folds 
Uncalled bet ($33) returned to sylvian31
sylvian31 collected $72.20 from pot
sylvian31: doesn't show hand 
*** SUMMARY ***
Total pot $75 | Rake $2.80 
Board [2d 9d Tc]
Seat 1: LRV21 folded on the Flop
Seat 3: sylvian31 collected ($72.20)
Seat 4: flk.Dasas (button) folded before Flop (didn't bet)
Seat 5: tipner (small blind) folded before Flop
Seat 6: matiko09 (big blind) folded before Flop
Seat 7: Venomous100% folded before Flop (didn't bet)
Seat 8: RoadtoNepal folded on the Flop
Seat 9: Kukuryzka folded before Flop (didn't bet)





PokerStars Hand #147754979576:  Hold'em No Limit ($0.50/$1.00 USD) - 2016/01/27 12:03:49 CET [2016/01/27 6:03:49 ET]
Table 'Dollfus' 9-max Seat #5 is the button
Seat 1: masaytoo ($126.07 in chips) 
Seat 2: nosoant ($66 in chips) 
Seat 3: UShallGimme$ ($102.50 in chips) 
Seat 4: matiko09 ($121.54 in chips) 
Seat 5: pandalapa ($218.98 in chips) 
Seat 6: deepblue0000 ($102.46 in chips) 
Seat 7: Dödi123 ($205.72 in chips) 
Seat 8: Venomous100% ($120.27 in chips) 
Seat 9: COOLIKO\/23 ($123.21 in chips) 
deepblue0000: posts small blind $0.50
Dödi123: posts big blind $1
*** HOLE CARDS ***
Dealt to matiko09 [8d Js]
Venomous100%: folds 
COOLIKO\/23: folds 
masaytoo: folds 
nosoant: calls $1
UShallGimme$: folds 
matiko09: folds 
pandalapa: folds 
deepblue0000: folds 
Dödi123: checks 
*** FLOP *** [5d 8h As]
Dödi123: checks 
nosoant: checks 
*** TURN *** [5d 8h As] [2h]
Dödi123: bets $2
nosoant: folds 
Uncalled bet ($2) returned to Dödi123
Dödi123 collected $2.39 from pot
Dödi123: doesn't show hand 
*** SUMMARY ***
Total pot $2.50 | Rake $0.11 
Board [5d 8h As 2h]
Seat 1: masaytoo folded before Flop (didn't bet)
Seat 2: nosoant folded on the Turn
Seat 3: UShallGimme$ folded before Flop (didn't bet)
Seat 4: matiko09 folded before Flop (didn't bet)
Seat 5: pandalapa (button) folded before Flop (didn't bet)
Seat 6: deepblue0000 (small blind) folded before Flop
Seat 7: Dödi123 (big blind) collected ($2.39)
Seat 8: Venomous100% folded before Flop (didn't bet)
Seat 9: COOLIKO\/23 folded before Flop (didn't bet)





PokerStars Hand #147754981574:  Hold'em No Limit ($0.50/$1.00 USD) - 2016/01/27 12:03:52 CET [2016/01/27 6:03:52 ET]
Table 'Delphinus II' 9-max Seat #4 is the button
Seat 2: AlKatrone ($206.87 in chips) 
Seat 3: deepblue0000 ($465.91 in chips) 
Seat 4: matiko09 ($100 in chips) 
Seat 5: pandalapa ($110.25 in chips) 
Seat 6: Sweden_Pound ($122.64 in chips) 
Seat 7: RUS)Timur ($127.29 in chips) 
Seat 8: mycka86 ($105.52 in chips) 
pandalapa: posts small blind $0.50
Sweden_Pound: posts big blind $1
*** HOLE CARDS ***
Dealt to matiko09 [2d Js]
RUS)Timur: folds 
mycka86: folds 
AlKatrone: folds 
deepblue0000: folds 
matiko09: folds 
pandalapa: raises $1.55 to $2.55
Sweden_Pound: folds 
Uncalled bet ($1.55) returned to pandalapa
pandalapa collected $2 from pot
pandalapa: doesn't show hand 
*** SUMMARY ***
Total pot $2 | Rake $0 
Seat 2: AlKatrone folded before Flop (didn't bet)
Seat 3: deepblue0000 folded before Flop (didn't bet)
Seat 4: matiko09 (button) folded before Flop (didn't bet)
Seat 5: pandalapa (small blind) collected ($2)
Seat 6: Sweden_Pound (big blind) folded before Flop
Seat 7: RUS)Timur folded before Flop (didn't bet)
Seat 8: mycka86 folded before Flop (didn't bet)





PokerStars Hand #147754982051:  Hold'em No Limit ($0.50/$1.00 USD) - 2016/01/27 12:03:53 CET [2016/01/27 6:03:53 ET]
Table 'Alkmene II' 9-max Seat #4 is the button
Seat 1: matiko09 ($110.11 in chips) 
Seat 2: deepblue0000 ($100 in chips) 
Seat 3: di0d80 ($103.78 in chips) 
Seat 4: CoolFireX ($145.82 in chips) 
Seat 5: Sweden_Pound ($113.05 in chips) 
Seat 6: Peu3aHy ($121.72 in chips) 
Seat 7: mycka86 ($100 in chips) 
Seat 8: fecsok1 ($125.75 in chips) 
Seat 9: pandalapa ($107.12 in chips) 
Sweden_Pound: posts small blind $0.50
Peu3aHy: posts big blind $1
*** HOLE CARDS ***
Dealt to matiko09 [7d Qc]
mycka86: folds 
fecsok1: calls $1
pandalapa: folds 
matiko09 has timed out
matiko09: folds 
deepblue0000: folds 
di0d80: folds 
CoolFireX: raises $2.50 to $3.50
Sweden_Pound: folds 
Peu3aHy: folds 
fecsok1: calls $2.50
*** FLOP *** [2s Kh 3h]
fecsok1: checks 
CoolFireX: bets $5.41
fecsok1: calls $5.41
*** TURN *** [2s Kh 3h] [Ac]
fecsok1: checks 
CoolFireX: bets $12.29
fecsok1: folds 
Uncalled bet ($12.29) returned to CoolFireX
CoolFireX collected $18.45 from pot
CoolFireX: doesn't show hand 
*** SUMMARY ***
Total pot $19.32 | Rake $0.87 
Board [2s Kh 3h Ac]
Seat 1: matiko09 folded before Flop (didn't bet)
Seat 2: deepblue0000 folded before Flop (didn't bet)
Seat 3: di0d80 folded before Flop (didn't bet)
Seat 4: CoolFireX (button) collected ($18.45)
Seat 5: Sweden_Pound (small blind) folded before Flop
Seat 6: Peu3aHy (big blind) folded before Flop
Seat 7: mycka86 folded before Flop (didn't bet)
Seat 8: fecsok1 folded on the Turn
Seat 9: pandalapa folded before Flop (didn't bet)





PokerStars Hand #147754984471:  Hold'em No Limit (€0.50/€1.00 EUR) - 2016/01/27 12:03:58 CET [2016/01/27 6:03:58 ET]
Table 'Carol' 9-max Seat #8 is the button
Seat 1: RoadtoNepal (€100 in chips) 
Seat 2: sylvian31 (€179.27 in chips) 
Seat 4: Sweden_Pound (€113.43 in chips) 
Seat 6: Kukuryzka (€175.53 in chips) 
Seat 7: tipner (€180.29 in chips) 
Seat 8: matiko09 (€100 in chips) 
Seat 9: Venomous100% (€100 in chips) 
Venomous100%: posts small blind €0.50
RoadtoNepal: posts big blind €1
*** HOLE CARDS ***
Dealt to matiko09 [Qh Ad]
sylvian31: folds 
Sweden_Pound: raises €2 to €3
Kukuryzka: folds 
tipner: folds 
matiko09: calls €3
Venomous100%: folds 
RoadtoNepal: raises €9 to €12
Sweden_Pound: calls €9
matiko09: calls €9
*** FLOP *** [7h 9c 2h]
RoadtoNepal: checks 
Sweden_Pound: bets €20.50
matiko09: folds 
RoadtoNepal: folds 
Uncalled bet (€20.50) returned to Sweden_Pound
Sweden_Pound collected €34.86 from pot
Sweden_Pound: doesn't show hand 
*** SUMMARY ***
Total pot €36.50 | Rake €1.64 
Board [7h 9c 2h]
Seat 1: RoadtoNepal (big blind) folded on the Flop
Seat 2: sylvian31 folded before Flop (didn't bet)
Seat 4: Sweden_Pound collected (€34.86)
Seat 6: Kukuryzka folded before Flop (didn't bet)
Seat 7: tipner folded before Flop (didn't bet)
Seat 8: matiko09 (button) folded on the Flop
Seat 9: Venomous100% (small blind) folded before Flop





PokerStars Hand #147754988302:  Hold'em No Limit ($0.50/$1.00 USD) - 2016/01/27 12:04:05 CET [2016/01/27 6:04:05 ET]
Table 'Henyey' 9-max Seat #9 is the button
Seat 1: COOLIKO\/23 ($100 in chips) 
Seat 2: pandalapa ($149.27 in chips) 
Seat 3: deepblue0000 ($100 in chips) 
Seat 4: sylvian31 ($102.75 in chips) 
Seat 5: matiko09 ($175.33 in chips) 
Seat 6: UShallGimme$ ($111.33 in chips) 
Seat 7: vinniej15 ($51.69 in chips) 
Seat 8: CoolFireX ($112.32 in chips) 
Seat 9: mycka86 ($130.63 in chips) 
COOLIKO\/23: posts small blind $0.50
pandalapa: posts big blind $1
*** HOLE CARDS ***
Dealt to matiko09 [Td 2s]
deepblue0000: raises $2 to $3
sylvian31: folds 
matiko09: folds 
UShallGimme$: folds 
vinniej15: folds 
CoolFireX: folds 
mycka86: folds 
COOLIKO\/23: folds 
pandalapa: calls $2
*** FLOP *** [Qc Ah Ks]
pandalapa: checks 
deepblue0000: checks 
*** TURN *** [Qc Ah Ks] [8s]
pandalapa: checks 
deepblue0000: bets $4.14
pandalapa: calls $4.14
*** RIVER *** [Qc Ah Ks 8s] [Tc]
pandalapa: checks 
deepblue0000: bets $8
pandalapa: folds 
Uncalled bet ($8) returned to deepblue0000
deepblue0000 collected $14.11 from pot
*** SUMMARY ***
Total pot $14.78 | Rake $0.67 
Board [Qc Ah Ks 8s Tc]
Seat 1: COOLIKO\/23 (small blind) folded before Flop
Seat 2: pandalapa (big blind) folded on the River
Seat 3: deepblue0000 collected ($14.11)
Seat 4: sylvian31 folded before Flop (didn't bet)
Seat 5: matiko09 folded before Flop (didn't bet)
Seat 6: UShallGimme$ folded before Flop (didn't bet)
Seat 7: vinniej15 folded before Flop (didn't bet)
Seat 8: CoolFireX folded before Flop (didn't bet)
Seat 9: mycka86 (button) folded before Flop (didn't bet)





PokerStars Hand #147754990172:  Hold'em No Limit ($0.50/$1.00 USD) - 2016/01/27 12:04:09 CET [2016/01/27 6:04:09 ET]
Table 'Nanking' 9-max Seat #6 is the button
Seat 1: Peu3aHy ($102.66 in chips) 
Seat 2: Dachish ($93.83 in chips) 
Seat 3: nuaxin ($110.21 in chips) 
Seat 4: COOLIKO\/23 ($155.54 in chips) 
Seat 5: TheGentleFox ($112.12 in chips) 
Seat 6: Kukuryzka ($103 in chips) 
Seat 7: tipner ($105.30 in chips) 
Seat 8: matiko09 ($101.50 in chips) 
Seat 9: Sweden_Pound ($131.72 in chips) 
tipner: posts small blind $0.50
matiko09: posts big blind $1
*** HOLE CARDS ***
Dealt to matiko09 [6s 3d]
Sweden_Pound: folds 
Peu3aHy: folds 
Dachish: folds 
nuaxin: folds 
COOLIKO\/23: folds 
TheGentleFox: folds 
Kukuryzka: raises $1 to $2
tipner: raises $6 to $8
matiko09: folds 
Kukuryzka: folds 
Uncalled bet ($6) returned to tipner
tipner collected $5 from pot
tipner: doesn't show hand 
*** SUMMARY ***
Total pot $5 | Rake $0 
Seat 1: Peu3aHy folded before Flop (didn't bet)
Seat 2: Dachish folded before Flop (didn't bet)
Seat 3: nuaxin folded before Flop (didn't bet)
Seat 4: COOLIKO\/23 folded before Flop (didn't bet)
Seat 5: TheGentleFox folded before Flop (didn't bet)
Seat 6: Kukuryzka (button) folded before Flop
Seat 7: tipner (small blind) collected ($5)
Seat 8: matiko09 (big blind) folded before Flop
Seat 9: Sweden_Pound folded before Flop (didn't bet)





PokerStars Hand #147754994234:  Hold'em No Limit ($0.50/$1.00 USD) - 2016/01/27 12:04:17 CET [2016/01/27 6:04:17 ET]
Table 'Delphinus II' 9-max Seat #5 is the button
Seat 2: AlKatrone ($206.87 in chips) 
Seat 3: deepblue0000 ($465.91 in chips) 
Seat 4: matiko09 ($100 in chips) 
Seat 5: pandalapa ($111.25 in chips) 
Seat 6: Sweden_Pound ($121.64 in chips) 
Seat 7: RUS)Timur ($127.29 in chips) 
Seat 8: mycka86 ($105.52 in chips) 
Sweden_Pound: posts small blind $0.50
RUS)Timur: posts big blind $1
*** HOLE CARDS ***
Dealt to matiko09 [2c 2s]
mycka86: folds 
AlKatrone: folds 
deepblue0000: folds 
matiko09: raises $1.50 to $2.50
pandalapa: folds 
Sweden_Pound: raises $7.50 to $10
RUS)Timur: raises $12.50 to $22.50
matiko09: folds 
Sweden_Pound: raises $99.14 to $121.64 and is all-in
RUS)Timur: folds 
Uncalled bet ($99.14) returned to Sweden_Pound
Sweden_Pound collected $47.50 from pot
Sweden_Pound: doesn't show hand 
*** SUMMARY ***
Total pot $47.50 | Rake $0 
Seat 2: AlKatrone folded before Flop (didn't bet)
Seat 3: deepblue0000 folded before Flop (didn't bet)
Seat 4: matiko09 folded before Flop
Seat 5: pandalapa (button) folded before Flop (didn't bet)
Seat 6: Sweden_Pound (small blind) collected ($47.50)
Seat 7: RUS)Timur (big blind) folded before Flop
Seat 8: mycka86 folded before Flop (didn't bet)





PokerStars Hand #147755002629:  Hold'em No Limit ($0.50/$1.00 USD) - 2016/01/27 12:04:33 CET [2016/01/27 6:04:33 ET]
Table 'Marlu II' 9-max Seat #3 is the button
Seat 1: Kukuryzka ($107.45 in chips) 
Seat 2: matiko09 ($100 in chips) 
Seat 3: COOLIKO\/23 ($100 in chips) 
Seat 4: tipner ($100 in chips) 
Seat 5: Sweden_Pound ($100 in chips) 
Seat 9: platinium1 ($56.21 in chips) 
tipner: posts small blind $0.50
Sweden_Pound: posts big blind $1
LIGOPSIXIS78: sits out 
UShallGimme$: sits out 
Peu3aHy: sits out 
*** HOLE CARDS ***
Dealt to matiko09 [Qc 8d]
platinium1: raises $1 to $2
Kukuryzka: folds 
matiko09: folds 
COOLIKO\/23: folds 
tipner: folds 
Sweden_Pound: folds 
Uncalled bet ($1) returned to platinium1
platinium1 collected $2.50 from pot
platinium1: doesn't show hand 
*** SUMMARY ***
Total pot $2.50 | Rake $0 
Seat 1: Kukuryzka folded before Flop (didn't bet)
Seat 2: matiko09 folded before Flop (didn't bet)
Seat 3: COOLIKO\/23 (button) folded before Flop (didn't bet)
Seat 4: tipner (small blind) folded before Flop
Seat 5: Sweden_Pound (big blind) folded before Flop
Seat 9: platinium1 collected ($2.50)





PokerStars Hand #147755009706:  Hold'em No Limit ($0.50/$1.00 USD) - 2016/01/27 12:04:46 CET [2016/01/27 6:04:46 ET]
Table 'Nanking' 9-max Seat #7 is the button
Seat 1: Peu3aHy ($102.66 in chips) 
Seat 2: Dachish ($93.83 in chips) 
Seat 3: nuaxin ($110.21 in chips) 
Seat 4: COOLIKO\/23 ($155.54 in chips) 
Seat 5: TheGentleFox ($112.12 in chips) 
Seat 6: Kukuryzka ($101 in chips) 
Seat 7: tipner ($108.30 in chips) 
Seat 8: matiko09 ($100.50 in chips) 
Seat 9: Sweden_Pound ($131.72 in chips) 
matiko09: posts small blind $0.50
Sweden_Pound: posts big blind $1
*** HOLE CARDS ***
Dealt to matiko09 [Ah 3s]
Peu3aHy: folds 
Dachish: raises $1 to $2
nuaxin: raises $1 to $3
COOLIKO\/23: calls $3
TheGentleFox: folds 
Kukuryzka: raises $19.50 to $22.50
tipner: folds 
matiko09: folds 
Sweden_Pound: folds 
Dachish: folds 
nuaxin said, ":^):^)"
nuaxin: folds 
COOLIKO\/23: folds 
Uncalled bet ($19.50) returned to Kukuryzka
nuaxin said, "6  6"
Kukuryzka collected $12.50 from pot
Kukuryzka: doesn't show hand 
*** SUMMARY ***
Total pot $12.50 | Rake $0 
Seat 1: Peu3aHy folded before Flop (didn't bet)
Seat 2: Dachish folded before Flop
Seat 3: nuaxin folded before Flop
Seat 4: COOLIKO\/23 folded before Flop
Seat 5: TheGentleFox folded before Flop (didn't bet)
Seat 6: Kukuryzka collected ($12.50)
Seat 7: tipner (button) folded before Flop (didn't bet)
Seat 8: matiko09 (small blind) folded before Flop
Seat 9: Sweden_Pound (big blind) folded before Flop





PokerStars Hand #147755012180:  Hold'em No Limit ($0.50/$1.00 USD) - 2016/01/27 12:04:51 CET [2016/01/27 6:04:51 ET]
Table 'Dollfus' 9-max Seat #6 is the button
Seat 1: masaytoo ($126.07 in chips) 
Seat 2: nosoant ($65 in chips) 
Seat 3: UShallGimme$ ($102.50 in chips) 
Seat 4: matiko09 ($121.54 in chips) 
Seat 5: pandalapa ($218.98 in chips) 
Seat 6: deepblue0000 ($101.96 in chips) 
Seat 7: Dödi123 ($207.11 in chips) 
Seat 8: Venomous100% ($120.27 in chips) 
Seat 9: COOLIKO\/23 ($123.21 in chips) 
Dödi123: posts small blind $0.50
Venomous100%: posts big blind $1
*** HOLE CARDS ***
Dealt to matiko09 [Ts 7c]
COOLIKO\/23: folds 
masaytoo: folds 
nosoant: raises $3 to $4
UShallGimme$: folds 
matiko09: folds 
pandalapa: folds 
deepblue0000: folds 
Dödi123: folds 
Venomous100%: raises $6 to $10
nosoant: calls $6
*** FLOP *** [Qc 9h Td]
Venomous100%: checks 
nosoant: bets $10
Venomous100%: folds 
Uncalled bet ($10) returned to nosoant
nosoant collected $19.58 from pot
nosoant: doesn't show hand 
*** SUMMARY ***
Total pot $20.50 | Rake $0.92 
Board [Qc 9h Td]
Seat 1: masaytoo folded before Flop (didn't bet)
Seat 2: nosoant collected ($19.58)
Seat 3: UShallGimme$ folded before Flop (didn't bet)
Seat 4: matiko09 folded before Flop (didn't bet)
Seat 5: pandalapa folded before Flop (didn't bet)
Seat 6: deepblue0000 (button) folded before Flop (didn't bet)
Seat 7: Dödi123 (small blind) folded before Flop
Seat 8: Venomous100% (big blind) folded on the Flop
Seat 9: COOLIKO\/23 folded before Flop (didn't bet)





PokerStars Hand #147755013726:  Hold'em No Limit ($0.50/$1.00 USD) - 2016/01/27 12:04:54 CET [2016/01/27 6:04:54 ET]
Table 'Alhajoth' 9-max Seat #2 is the button
Seat 1: UShallGimme$ ($113.45 in chips) 
Seat 2: matiko09 ($103 in chips) 
Seat 3: Sweden_Pound ($105.77 in chips) 
Seat 4: Venomous100% ($152.65 in chips) 
Seat 5: Kukuryzka ($105.37 in chips) 
Seat 6: RoadtoNepal ($185.46 in chips) 
Seat 7: Ohpeel ($145.09 in chips) 
Seat 8: deepblue0000 ($131.99 in chips) 
Sweden_Pound: posts small blind $0.50
Venomous100%: posts big blind $1
*** HOLE CARDS ***
Dealt to matiko09 [8h Kh]
Kukuryzka: folds 
RoadtoNepal: folds 
Ohpeel: folds 
deepblue0000: raises $2 to $3
UShallGimme$: folds 
matiko09: folds 
Sweden_Pound: folds 
Venomous100%: folds 
Uncalled bet ($2) returned to deepblue0000
deepblue0000 collected $2.50 from pot
*** SUMMARY ***
Total pot $2.50 | Rake $0 
Seat 1: UShallGimme$ folded before Flop (didn't bet)
Seat 2: matiko09 (button) folded before Flop (didn't bet)
Seat 3: Sweden_Pound (small blind) folded before Flop
Seat 4: Venomous100% (big blind) folded before Flop
Seat 5: Kukuryzka folded before Flop (didn't bet)
Seat 6: RoadtoNepal folded before Flop (didn't bet)
Seat 7: Ohpeel folded before Flop (didn't bet)
Seat 8: deepblue0000 collected ($2.50)





PokerStars Hand #147755017995:  Hold'em No Limit ($0.50/$1.00 USD) - 2016/01/27 12:05:02 CET [2016/01/27 6:05:02 ET]
Table 'Fragaria II' 9-max Seat #8 is the button
Seat 1: deepblue0000 ($100 in chips) 
Seat 2: GG-NoR34D. ($73.40 in chips) 
Seat 3: Sweden_Pound ($101.19 in chips) 
Seat 5: Venomous100% ($162.54 in chips) 
Seat 6: UShallGimme$ ($177.49 in chips) 
Seat 7: Hobby-.-AK ($61.49 in chips) 
Seat 8: mycka86 ($100 in chips) 
Seat 9: matiko09 ($100 in chips) 
matiko09: posts small blind $0.50
deepblue0000: posts big blind $1
*** HOLE CARDS ***
Dealt to matiko09 [Qc 3h]
GG-NoR34D.: folds 
Sweden_Pound: folds 
Venomous100%: folds 
UShallGimme$: folds 
Hobby-.-AK: raises $1 to $2
mycka86: raises $5.50 to $7.50
matiko09: folds 
deepblue0000: folds 
Hobby-.-AK: folds 
Uncalled bet ($5.50) returned to mycka86
mycka86 collected $5.50 from pot
*** SUMMARY ***
Total pot $5.50 | Rake $0 
Seat 1: deepblue0000 (big blind) folded before Flop
Seat 2: GG-NoR34D. folded before Flop (didn't bet)
Seat 3: Sweden_Pound folded before Flop (didn't bet)
Seat 5: Venomous100% folded before Flop (didn't bet)
Seat 6: UShallGimme$ folded before Flop (didn't bet)
Seat 7: Hobby-.-AK folded before Flop
Seat 8: mycka86 (button) collected ($5.50)
Seat 9: matiko09 (small blind) folded before Flop





PokerStars Hand #147755017867:  Hold'em No Limit ($1/$2 USD) - 2016/01/27 12:05:02 CET [2016/01/27 6:05:02 ET]
Table 'Phobos II' 9-max Seat #5 is the button
Seat 1: LRV21 ($636.76 in chips) 
Seat 3: sylvian31 ($248.20 in chips) 
Seat 4: flk.Dasas ($200 in chips) 
Seat 5: tipner ($200 in chips) 
Seat 6: matiko09 ($200 in chips) 
Seat 7: Venomous100% ($365.22 in chips) 
Seat 8: RoadtoNepal ($200 in chips) 
Seat 9: Kukuryzka ($367.03 in chips) 
matiko09: posts small blind $1
Venomous100%: posts big blind $2
*** HOLE CARDS ***
Dealt to matiko09 [9c 5s]
RoadtoNepal: folds 
Kukuryzka: folds 
LRV21: folds 
sylvian31: folds 
flk.Dasas: folds 
tipner: folds 
matiko09: folds 
Uncalled bet ($1) returned to Venomous100%
Venomous100% collected $2 from pot
Venomous100%: doesn't show hand 
*** SUMMARY ***
Total pot $2 | Rake $0 
Seat 1: LRV21 folded before Flop (didn't bet)
Seat 3: sylvian31 folded before Flop (didn't bet)
Seat 4: flk.Dasas folded before Flop (didn't bet)
Seat 5: tipner (button) folded before Flop (didn't bet)
Seat 6: matiko09 (small blind) folded before Flop
Seat 7: Venomous100% (big blind) collected ($2)
Seat 8: RoadtoNepal folded before Flop (didn't bet)
Seat 9: Kukuryzka folded before Flop (didn't bet)





PokerStars Hand #147755025088:  Hold'em No Limit ($0.50/$1.00 USD) - 2016/01/27 12:05:16 CET [2016/01/27 6:05:16 ET]
Table 'Marlu II' 9-max Seat #4 is the button
Seat 1: Kukuryzka ($107.45 in chips) 
Seat 2: matiko09 ($100 in chips) 
Seat 3: COOLIKO\/23 ($100 in chips) 
Seat 4: tipner ($100 in chips) 
Seat 5: Sweden_Pound ($100 in chips) 
Seat 6: LIGOPSIXIS78 ($60 in chips) 
Seat 9: platinium1 ($57.71 in chips) 
Sweden_Pound: posts small blind $0.50
LIGOPSIXIS78: posts big blind $1
UShallGimme$: sits out 
Peu3aHy: sits out 
*** HOLE CARDS ***
Dealt to matiko09 [6c Tc]
platinium1: calls $1
Kukuryzka: folds 
matiko09: folds 
COOLIKO\/23: folds 
tipner: folds 
Sweden_Pound: folds 
LIGOPSIXIS78: checks 
*** FLOP *** [Ks 6h 9c]
LIGOPSIXIS78: checks 
platinium1: checks 
*** TURN *** [Ks 6h 9c] [Td]
LIGOPSIXIS78: bets $1
platinium1: calls $1
*** RIVER *** [Ks 6h 9c Td] [Qc]
LIGOPSIXIS78: checks 
platinium1: bets $7
LIGOPSIXIS78: folds 
Uncalled bet ($7) returned to platinium1
platinium1 collected $4.30 from pot
platinium1: doesn't show hand 
*** SUMMARY ***
Total pot $4.50 | Rake $0.20 
Board [Ks 6h 9c Td Qc]
Seat 1: Kukuryzka folded before Flop (didn't bet)
Seat 2: matiko09 folded before Flop (didn't bet)
Seat 3: COOLIKO\/23 folded before Flop (didn't bet)
Seat 4: tipner (button) folded before Flop (didn't bet)
Seat 5: Sweden_Pound (small blind) folded before Flop
Seat 6: LIGOPSIXIS78 (big blind) folded on the River
Seat 9: platinium1 collected ($4.30)





PokerStars Hand #147755026243:  Hold'em No Limit (€0.50/€1.00 EUR) - 2016/01/27 12:05:18 CET [2016/01/27 6:05:18 ET]
Table 'Carol' 9-max Seat #9 is the button
Seat 1: RoadtoNepal (€100 in chips) 
Seat 8: matiko09 (€100 in chips) 
Seat 9: Venomous100% (€100 in chips) 
RoadtoNepal: posts small blind €0.50
sylvian31: is sitting out 
Sweden_Pound: is sitting out 
Kukuryzka: is sitting out 
tipner: is sitting out 
matiko09: posts big blind €1
*** HOLE CARDS ***
Dealt to matiko09 [4s Ac]
Sweden_Pound leaves the table
Kukuryzka leaves the table
tipner leaves the table
Venomous100%: folds 
RoadtoNepal: raises €2 to €3
Venomous100% leaves the table
matiko09: folds 
Uncalled bet (€2) returned to RoadtoNepal
RoadtoNepal collected €2 from pot
RoadtoNepal: doesn't show hand 
*** SUMMARY ***
Total pot €2 | Rake €0 
Seat 1: RoadtoNepal (small blind) collected (€2)
Seat 8: matiko09 (big blind) folded before Flop
Seat 9: Venomous100% (button) folded before Flop (didn't bet)





PokerStars Hand #147755032285:  Hold'em No Limit ($0.50/$1.00 USD) - 2016/01/27 12:05:29 CET [2016/01/27 6:05:29 ET]
Table 'Alhajoth' 9-max Seat #3 is the button
Seat 1: UShallGimme$ ($113.45 in chips) 
Seat 2: matiko09 ($103 in chips) 
Seat 3: Sweden_Pound ($105.27 in chips) 
Seat 4: Venomous100% ($151.65 in chips) 
Seat 5: Kukuryzka ($105.37 in chips) 
Seat 6: RoadtoNepal ($185.46 in chips) 
Seat 7: Ohpeel ($145.09 in chips) 
Seat 8: deepblue0000 ($133.49 in chips) 
Venomous100%: posts small blind $0.50
Kukuryzka: posts big blind $1
*** HOLE CARDS ***
Dealt to matiko09 [As Td]
RoadtoNepal: folds 
Ohpeel: calls $1
deepblue0000: folds 
UShallGimme$: folds 
matiko09: raises $3 to $4
Sweden_Pound: folds 
Venomous100%: folds 
Kukuryzka: folds 
Ohpeel: folds 
Uncalled bet ($3) returned to matiko09
matiko09 collected $3.50 from pot
matiko09: doesn't show hand 
*** SUMMARY ***
Total pot $3.50 | Rake $0 
Seat 1: UShallGimme$ folded before Flop (didn't bet)
Seat 2: matiko09 collected ($3.50)
Seat 3: Sweden_Pound (button) folded before Flop (didn't bet)
Seat 4: Venomous100% (small blind) folded before Flop
Seat 5: Kukuryzka (big blind) folded before Flop
Seat 6: RoadtoNepal folded before Flop (didn't bet)
Seat 7: Ohpeel folded before Flop
Seat 8: deepblue0000 folded before Flop (didn't bet)





PokerStars Hand #147755032801:  Hold'em No Limit ($1/$2 USD) - 2016/01/27 12:05:30 CET [2016/01/27 6:05:30 ET]
Table 'Phobos II' 9-max Seat #6 is the button
Seat 1: LRV21 ($636.76 in chips) 
Seat 3: sylvian31 ($248.20 in chips) 
Seat 4: flk.Dasas ($200 in chips) 
Seat 5: tipner ($200 in chips) 
Seat 6: matiko09 ($200 in chips) 
Seat 7: Venomous100% ($366.22 in chips) 
Seat 8: RoadtoNepal ($200 in chips) 
Seat 9: Kukuryzka ($367.03 in chips) 
Venomous100%: posts small blind $1
RoadtoNepal: posts big blind $2
*** HOLE CARDS ***
Dealt to matiko09 [Ac 4s]
Kukuryzka: folds 
LRV21: raises $3 to $5
sylvian31: folds 
flk.Dasas: folds 
tipner: folds 
matiko09: folds 
Venomous100%: raises $15 to $20
RoadtoNepal: folds 
LRV21: calls $15
*** FLOP *** [8c 3s Th]
Venomous100%: bets $24
LRV21: folds 
Uncalled bet ($24) returned to Venomous100%
Venomous100% collected $40.11 from pot
Venomous100%: doesn't show hand 
*** SUMMARY ***
Total pot $42 | Rake $1.89 
Board [8c 3s Th]
Seat 1: LRV21 folded on the Flop
Seat 3: sylvian31 folded before Flop (didn't bet)
Seat 4: flk.Dasas folded before Flop (didn't bet)
Seat 5: tipner folded before Flop (didn't bet)
Seat 6: matiko09 (button) folded before Flop (didn't bet)
Seat 7: Venomous100% (small blind) collected ($40.11)
Seat 8: RoadtoNepal (big blind) folded before Flop
Seat 9: Kukuryzka folded before Flop (didn't bet)





PokerStars Hand #147755032985:  Hold'em No Limit ($0.50/$1.00 USD) - 2016/01/27 12:05:31 CET [2016/01/27 6:05:31 ET]
Table 'Henyey' 9-max Seat #1 is the button
Seat 1: COOLIKO\/23 ($100 in chips) 
Seat 2: pandalapa ($142.13 in chips) 
Seat 3: deepblue0000 ($106.97 in chips) 
Seat 4: sylvian31 ($102.75 in chips) 
Seat 5: matiko09 ($175.33 in chips) 
Seat 6: UShallGimme$ ($111.33 in chips) 
Seat 7: vinniej15 ($51.69 in chips) 
Seat 8: CoolFireX ($112.32 in chips) 
Seat 9: mycka86 ($130.63 in chips) 
pandalapa: posts small blind $0.50
deepblue0000: posts big blind $1
*** HOLE CARDS ***
Dealt to matiko09 [Qd 2c]
sylvian31: folds 
matiko09: folds 
UShallGimme$: folds 
vinniej15: raises $1 to $2
CoolFireX: folds 
mycka86: folds 
COOLIKO\/23: folds 
pandalapa: folds 
deepblue0000: calls $1
*** FLOP *** [8c 3h 9s]
deepblue0000: checks 
vinniej15: bets $5
deepblue0000: folds 
Uncalled bet ($5) returned to vinniej15
vinniej15 collected $4.30 from pot
*** SUMMARY ***
Total pot $4.50 | Rake $0.20 
Board [8c 3h 9s]
Seat 1: COOLIKO\/23 (button) folded before Flop (didn't bet)
Seat 2: pandalapa (small blind) folded before Flop
Seat 3: deepblue0000 (big blind) folded on the Flop
Seat 4: sylvian31 folded before Flop (didn't bet)
Seat 5: matiko09 folded before Flop (didn't bet)
Seat 6: UShallGimme$ folded before Flop (didn't bet)
Seat 7: vinniej15 collected ($4.30)
Seat 8: CoolFireX folded before Flop (didn't bet)
Seat 9: mycka86 folded before Flop (didn't bet)





PokerStars Hand #147755036019:  Hold'em No Limit ($0.50/$1.00 USD) - 2016/01/27 12:05:37 CET [2016/01/27 6:05:37 ET]
Table 'Alkmene II' 9-max Seat #5 is the button
Seat 1: matiko09 ($110.11 in chips) 
Seat 2: deepblue0000 ($100 in chips) 
Seat 4: CoolFireX ($155.36 in chips) 
Seat 5: Sweden_Pound ($112.55 in chips) 
Seat 6: Peu3aHy ($120.72 in chips) 
Seat 7: mycka86 ($100 in chips) 
Seat 8: fecsok1 ($116.84 in chips) 
Seat 9: pandalapa ($107.12 in chips) 
Peu3aHy: posts small blind $0.50
mycka86: posts big blind $1
*** HOLE CARDS ***
Dealt to matiko09 [Td 5c]
fecsok1: folds 
pandalapa: folds 
matiko09: folds 
deepblue0000: raises $2 to $3
CoolFireX: folds 
Sweden_Pound: folds 
Peu3aHy: folds 
mycka86: folds 
Uncalled bet ($2) returned to deepblue0000
deepblue0000 collected $2.50 from pot
*** SUMMARY ***
Total pot $2.50 | Rake $0 
Seat 1: matiko09 folded before Flop (didn't bet)
Seat 2: deepblue0000 collected ($2.50)
Seat 4: CoolFireX folded before Flop (didn't bet)
Seat 5: Sweden_Pound (button) folded before Flop (didn't bet)
Seat 6: Peu3aHy (small blind) folded before Flop
Seat 7: mycka86 (big blind) folded before Flop
Seat 8: fecsok1 folded before Flop (didn't bet)
Seat 9: pandalapa folded before Flop (didn't bet)





PokerStars Hand #147755036687:  Hold'em No Limit ($0.50/$1.00 USD) - 2016/01/27 12:05:38 CET [2016/01/27 6:05:38 ET]
Table 'Delphinus II' 9-max Seat #6 is the button
Seat 2: AlKatrone ($206.87 in chips) 
Seat 3: deepblue0000 ($465.91 in chips) 
Seat 4: matiko09 ($100 in chips) 
Seat 5: pandalapa ($111.25 in chips) 
Seat 6: Sweden_Pound ($146.64 in chips) 
Seat 7: RUS)Timur ($104.79 in chips) 
Seat 8: mycka86 ($105.52 in chips) 
RUS)Timur: posts small blind $0.50
mycka86: posts big blind $1
*** HOLE CARDS ***
Dealt to matiko09 [Jh 6s]
AlKatrone: folds 
deepblue0000: folds 
matiko09: folds 
pandalapa: folds 
Sweden_Pound: raises $1 to $2
RUS)Timur: folds 
mycka86: raises $6.50 to $8.50
Sweden_Pound: folds 
Uncalled bet ($6.50) returned to mycka86
mycka86 collected $4.50 from pot
*** SUMMARY ***
Total pot $4.50 | Rake $0 
Seat 2: AlKatrone folded before Flop (didn't bet)
Seat 3: deepblue0000 folded before Flop (didn't bet)
Seat 4: matiko09 folded before Flop (didn't bet)
Seat 5: pandalapa folded before Flop (didn't bet)
Seat 6: Sweden_Pound (button) folded before Flop
Seat 7: RUS)Timur (small blind) folded before Flop
Seat 8: mycka86 (big blind) collected ($4.50)





PokerStars Hand #147755046117:  Hold'em No Limit ($0.50/$1.00 USD) - 2016/01/27 12:05:56 CET [2016/01/27 6:05:56 ET]
Table 'Fragaria II' 9-max Seat #9 is the button
Seat 1: deepblue0000 ($100 in chips) 
Seat 2: GG-NoR34D. ($73.40 in chips) 
Seat 3: Sweden_Pound ($101.19 in chips) 
Seat 5: Venomous100% ($162.54 in chips) 
Seat 6: UShallGimme$ ($177.49 in chips) 
Seat 7: Hobby-.-AK ($59.49 in chips) 
Seat 8: mycka86 ($103.50 in chips) 
Seat 9: matiko09 ($100 in chips) 
deepblue0000: posts small blind $0.50
GG-NoR34D.: posts big blind $1
*** HOLE CARDS ***
Dealt to matiko09 [7h Th]
Sweden_Pound: folds 
Venomous100%: folds 
UShallGimme$: folds 
Hobby-.-AK: folds 
mycka86: raises $1.10 to $2.10
matiko09: folds 
deepblue0000: folds 
GG-NoR34D.: calls $1.10
*** FLOP *** [2s 3s Td]
GG-NoR34D.: checks 
mycka86: bets $3.30
GG-NoR34D.: folds 
Uncalled bet ($3.30) returned to mycka86
mycka86 collected $4.49 from pot
*** SUMMARY ***
Total pot $4.70 | Rake $0.21 
Board [2s 3s Td]
Seat 1: deepblue0000 (small blind) folded before Flop
Seat 2: GG-NoR34D. (big blind) folded on the Flop
Seat 3: Sweden_Pound folded before Flop (didn't bet)
Seat 5: Venomous100% folded before Flop (didn't bet)
Seat 6: UShallGimme$ folded before Flop (didn't bet)
Seat 7: Hobby-.-AK folded before Flop (didn't bet)
Seat 8: mycka86 collected ($4.49)
Seat 9: matiko09 (button) folded before Flop (didn't bet)





PokerStars Hand #147755047461:  Hold'em No Limit ($0.50/$1.00 USD) - 2016/01/27 12:05:58 CET [2016/01/27 6:05:58 ET]
Table 'Klemola' 9-max Seat #5 is the button
Seat 4: RWasin17 ($100 in chips) 
Seat 5: tipner ($100 in chips) 
Seat 6: sylvian31 ($100.50 in chips) 
Seat 7: matiko09 ($100 in chips) 
sylvian31: posts small blind $0.50
matiko09: posts big blind $1
*** HOLE CARDS ***
Dealt to matiko09 [6c 2d]
RWasin17: folds 
tipner: folds 
sylvian31: calls $0.50
matiko09: checks 
*** FLOP *** [3d 9h Ac]
Sweden_Pound joins the table at seat #8 
sylvian31: checks 
matiko09: checks 
*** TURN *** [3d 9h Ac] [9c]
sylvian31: checks 
matiko09: checks 
*** RIVER *** [3d 9h Ac 9c] [6d]
sylvian31: checks 
matiko09: checks 
*** SHOW DOWN ***
sylvian31: shows [4h 4s] (two pair, Nines and Fours)
matiko09: shows [6c 2d] (two pair, Nines and Sixes)
matiko09 collected $1.91 from pot
*** SUMMARY ***
Total pot $2 | Rake $0.09 
Board [3d 9h Ac 9c 6d]
Seat 4: RWasin17 folded before Flop (didn't bet)
Seat 5: tipner (button) folded before Flop (didn't bet)
Seat 6: sylvian31 (small blind) showed [4h 4s] and lost with two pair, Nines and Fours
Seat 7: matiko09 (big blind) showed [6c 2d] and won ($1.91) with two pair, Nines and Sixes





PokerStars Hand #147755048348:  Hold'em No Limit ($0.50/$1.00 USD) - 2016/01/27 12:06:00 CET [2016/01/27 6:06:00 ET]
Table 'Dollfus' 9-max Seat #7 is the button
Seat 1: masaytoo ($126.07 in chips) 
Seat 2: nosoant ($74.58 in chips) 
Seat 3: UShallGimme$ ($102.50 in chips) 
Seat 4: matiko09 ($121.54 in chips) 
Seat 5: pandalapa ($218.98 in chips) 
Seat 6: deepblue0000 ($101.96 in chips) 
Seat 7: Dödi123 ($206.61 in chips) 
Seat 8: Venomous100% ($110.27 in chips) 
Seat 9: COOLIKO\/23 ($123.21 in chips) 
Venomous100%: posts small blind $0.50
COOLIKO\/23: posts big blind $1
*** HOLE CARDS ***
Dealt to matiko09 [9h 9c]
masaytoo: folds 
nosoant: calls $1
UShallGimme$: raises $4 to $5
matiko09: calls $5
pandalapa: folds 
deepblue0000: folds 
Dödi123: folds 
Venomous100%: folds 
COOLIKO\/23: folds 
nosoant: calls $4
*** FLOP *** [3s 8h 4d]
nosoant: checks 
UShallGimme$: bets $10
matiko09: calls $10
nosoant: folds 
*** TURN *** [3s 8h 4d] [6s]
UShallGimme$: bets $25
matiko09: folds 
Uncalled bet ($25) returned to UShallGimme$
UShallGimme$ collected $34.86 from pot
UShallGimme$: doesn't show hand 
*** SUMMARY ***
Total pot $36.50 | Rake $1.64 
Board [3s 8h 4d 6s]
Seat 1: masaytoo folded before Flop (didn't bet)
Seat 2: nosoant folded on the Flop
Seat 3: UShallGimme$ collected ($34.86)
Seat 4: matiko09 folded on the Turn
Seat 5: pandalapa folded before Flop (didn't bet)
Seat 6: deepblue0000 folded before Flop (didn't bet)
Seat 7: Dödi123 (button) folded before Flop (didn't bet)
Seat 8: Venomous100% (small blind) folded before Flop
Seat 9: COOLIKO\/23 (big blind) folded before Flop





PokerStars Hand #147755052414:  Hold'em No Limit ($0.50/$1.00 USD) - 2016/01/27 12:06:08 CET [2016/01/27 6:06:08 ET]
Table 'Delphinus II' 9-max Seat #7 is the button
Seat 3: deepblue0000 ($465.91 in chips) 
Seat 4: matiko09 ($100 in chips) 
Seat 5: pandalapa ($111.25 in chips) 
Seat 6: Sweden_Pound ($144.64 in chips) 
Seat 7: RUS)Timur ($104.29 in chips) 
Seat 8: mycka86 ($108.02 in chips) 
mycka86: posts small blind $0.50
AlKatrone: is sitting out 
AlKatrone leaves the table
deepblue0000: posts big blind $1
*** HOLE CARDS ***
Dealt to matiko09 [9h Qh]
Kukuryzka joins the table at seat #2 
matiko09: folds 
pandalapa: folds 
Sweden_Pound: raises $1.50 to $2.50
RUS)Timur: folds 
mycka86: folds 
deepblue0000: folds 
Uncalled bet ($1.50) returned to Sweden_Pound
Sweden_Pound collected $2.50 from pot
Sweden_Pound: doesn't show hand 
*** SUMMARY ***
Total pot $2.50 | Rake $0 
Seat 3: deepblue0000 (big blind) folded before Flop
Seat 4: matiko09 folded before Flop (didn't bet)
Seat 5: pandalapa folded before Flop (didn't bet)
Seat 6: Sweden_Pound collected ($2.50)
Seat 7: RUS)Timur (button) folded before Flop (didn't bet)
Seat 8: mycka86 (small blind) folded before Flop





PokerStars Hand #147755056232:  Hold'em No Limit ($0.50/$1.00 USD) - 2016/01/27 12:06:15 CET [2016/01/27 6:06:15 ET]
Table 'Henyey' 9-max Seat #2 is the button
Seat 1: COOLIKO\/23 ($100 in chips) 
Seat 2: pandalapa ($141.63 in chips) 
Seat 3: deepblue0000 ($104.97 in chips) 
Seat 4: sylvian31 ($102.75 in chips) 
Seat 5: matiko09 ($175.33 in chips) 
Seat 6: UShallGimme$ ($111.33 in chips) 
Seat 7: vinniej15 ($53.99 in chips) 
Seat 8: CoolFireX ($112.32 in chips) 
Seat 9: mycka86 ($130.63 in chips) 
deepblue0000: posts small blind $0.50
sylvian31: posts big blind $1
*** HOLE CARDS ***
Dealt to matiko09 [Ks 3c]
matiko09: folds 
UShallGimme$: folds 
vinniej15: folds 
CoolFireX: folds 
mycka86: folds 
COOLIKO\/23: raises $1.50 to $2.50
pandalapa: folds 
deepblue0000: folds 
sylvian31: folds 
Uncalled bet ($1.50) returned to COOLIKO\/23
COOLIKO\/23 collected $2.50 from pot
COOLIKO\/23: doesn't show hand 
*** SUMMARY ***
Total pot $2.50 | Rake $0 
Seat 1: COOLIKO\/23 collected ($2.50)
Seat 2: pandalapa (button) folded before Flop (didn't bet)
Seat 3: deepblue0000 (small blind) folded before Flop
Seat 4: sylvian31 (big blind) folded before Flop
Seat 5: matiko09 folded before Flop (didn't bet)
Seat 6: UShallGimme$ folded before Flop (didn't bet)
Seat 7: vinniej15 folded before Flop (didn't bet)
Seat 8: CoolFireX folded before Flop (didn't bet)
Seat 9: mycka86 folded before Flop (didn't bet)





PokerStars Hand #147755057151:  Hold'em No Limit ($0.50/$1.00 USD) - 2016/01/27 12:06:16 CET [2016/01/27 6:06:16 ET]
Table 'Alkmene II' 9-max Seat #6 is the button
Seat 1: matiko09 ($110.11 in chips) 
Seat 2: deepblue0000 ($101.50 in chips) 
Seat 4: CoolFireX ($155.36 in chips) 
Seat 5: Sweden_Pound ($112.55 in chips) 
Seat 6: Peu3aHy ($120.22 in chips) 
Seat 7: mycka86 ($100 in chips) 
Seat 8: fecsok1 ($116.84 in chips) 
Seat 9: pandalapa ($107.12 in chips) 
mycka86: posts small blind $0.50
fecsok1: posts big blind $1
*** HOLE CARDS ***
Dealt to matiko09 [3s 9d]
pandalapa: folds 
matiko09: folds 
deepblue0000: folds 
CoolFireX: folds 
Sweden_Pound: folds 
Peu3aHy: raises $2 to $3
mycka86: folds 
fecsok1: folds 
Uncalled bet ($2) returned to Peu3aHy
Peu3aHy collected $2.50 from pot
Peu3aHy: doesn't show hand 
*** SUMMARY ***
Total pot $2.50 | Rake $0 
Seat 1: matiko09 folded before Flop (didn't bet)
Seat 2: deepblue0000 folded before Flop (didn't bet)
Seat 4: CoolFireX folded before Flop (didn't bet)
Seat 5: Sweden_Pound folded before Flop (didn't bet)
Seat 6: Peu3aHy (button) collected ($2.50)
Seat 7: mycka86 (small blind) folded before Flop
Seat 8: fecsok1 (big blind) folded before Flop
Seat 9: pandalapa folded before Flop (didn't bet)





PokerStars Hand #147755061040:  Hold'em No Limit ($0.50/$1.00 USD) - 2016/01/27 12:06:24 CET [2016/01/27 6:06:24 ET]
Table 'Nanking' 9-max Seat #8 is the button
Seat 1: Peu3aHy ($102.66 in chips) 
Seat 2: Dachish ($91.83 in chips) 
Seat 3: nuaxin ($107.21 in chips) 
Seat 4: COOLIKO\/23 ($152.54 in chips) 
Seat 5: TheGentleFox ($112.12 in chips) 
Seat 6: Kukuryzka ($110.50 in chips) 
Seat 7: tipner ($108.30 in chips) 
Seat 8: matiko09 ($100 in chips) 
Seat 9: Sweden_Pound ($130.72 in chips) 
Sweden_Pound: posts small blind $0.50
Peu3aHy: posts big blind $1
*** HOLE CARDS ***
Dealt to matiko09 [8h 4h]
Dachish: folds 
nuaxin: folds 
COOLIKO\/23: folds 
TheGentleFox: raises $1 to $2
Kukuryzka: folds 
tipner: folds 
matiko09: folds 
Sweden_Pound: folds 
Peu3aHy: folds 
Uncalled bet ($1) returned to TheGentleFox
TheGentleFox collected $2.50 from pot
TheGentleFox: doesn't show hand 
*** SUMMARY ***
Total pot $2.50 | Rake $0 
Seat 1: Peu3aHy (big blind) folded before Flop
Seat 2: Dachish folded before Flop (didn't bet)
Seat 3: nuaxin folded before Flop (didn't bet)
Seat 4: COOLIKO\/23 folded before Flop (didn't bet)
Seat 5: TheGentleFox collected ($2.50)
Seat 6: Kukuryzka folded before Flop (didn't bet)
Seat 7: tipner folded before Flop (didn't bet)
Seat 8: matiko09 (button) folded before Flop (didn't bet)
Seat 9: Sweden_Pound (small blind) folded before Flop





PokerStars Hand #147755061742:  Hold'em No Limit ($0.50/$1.00 USD) - 2016/01/27 12:06:25 CET [2016/01/27 6:06:25 ET]
Table 'Marlu II' 9-max Seat #5 is the button
Seat 1: Kukuryzka ($107.45 in chips) 
Seat 2: matiko09 ($100 in chips) 
Seat 3: COOLIKO\/23 ($100 in chips) 
Seat 4: tipner ($100 in chips) 
Seat 5: Sweden_Pound ($100 in chips) 
Seat 6: LIGOPSIXIS78 ($58 in chips) 
Seat 7: UShallGimme$ ($100 in chips) 
Seat 9: platinium1 ($60.01 in chips) 
LIGOPSIXIS78: posts small blind $0.50
UShallGimme$: posts big blind $1
Peu3aHy: sits out 
*** HOLE CARDS ***
Dealt to matiko09 [5c 2h]
platinium1: folds 
Kukuryzka: folds 
matiko09: folds 
COOLIKO\/23: folds 
tipner: folds 
Sweden_Pound: folds 
LIGOPSIXIS78: raises $2 to $3
UShallGimme$: calls $2
*** FLOP *** [9d Ts Qs]
LIGOPSIXIS78: bets $2.86
UShallGimme$: calls $2.86
*** TURN *** [9d Ts Qs] [8c]
LIGOPSIXIS78: checks 
UShallGimme$: checks 
*** RIVER *** [9d Ts Qs 8c] [2d]
LIGOPSIXIS78: bets $5.59
UShallGimme$: folds 
Uncalled bet ($5.59) returned to LIGOPSIXIS78
LIGOPSIXIS78 collected $11.19 from pot
LIGOPSIXIS78: doesn't show hand 
*** SUMMARY ***
Total pot $11.72 | Rake $0.53 
Board [9d Ts Qs 8c 2d]
Seat 1: Kukuryzka folded before Flop (didn't bet)
Seat 2: matiko09 folded before Flop (didn't bet)
Seat 3: COOLIKO\/23 folded before Flop (didn't bet)
Seat 4: tipner folded before Flop (didn't bet)
Seat 5: Sweden_Pound (button) folded before Flop (didn't bet)
Seat 6: LIGOPSIXIS78 (small blind) collected ($11.19)
Seat 7: UShallGimme$ (big blind) folded on the River
Seat 9: platinium1 folded before Flop (didn't bet)





PokerStars Hand #147755064147:  Hold'em No Limit ($0.50/$1.00 USD) - 2016/01/27 12:06:30 CET [2016/01/27 6:06:30 ET]
Table 'Delphinus II' 9-max Seat #8 is the button
Seat 3: deepblue0000 ($464.91 in chips) 
Seat 4: matiko09 ($100 in chips) 
Seat 5: pandalapa ($111.25 in chips) 
Seat 6: Sweden_Pound ($146.14 in chips) 
Seat 7: RUS)Timur ($104.29 in chips) 
Seat 8: mycka86 ($107.52 in chips) 
deepblue0000: posts small blind $0.50
matiko09: posts big blind $1
*** HOLE CARDS ***
Dealt to matiko09 [5d 2h]
pandalapa: folds 
Sweden_Pound: folds 
RUS)Timur: folds 
mycka86: folds 
deepblue0000: folds 
Uncalled bet ($0.50) returned to matiko09
matiko09 collected $1 from pot
matiko09: doesn't show hand 
*** SUMMARY ***
Total pot $1 | Rake $0 
Seat 3: deepblue0000 (small blind) folded before Flop
Seat 4: matiko09 (big blind) collected ($1)
Seat 5: pandalapa folded before Flop (didn't bet)
Seat 6: Sweden_Pound folded before Flop (didn't bet)
Seat 7: RUS)Timur folded before Flop (didn't bet)
Seat 8: mycka86 (button) folded before Flop (didn't bet)





PokerStars Hand #147755064652:  Hold'em No Limit ($0.50/$1.00 USD) - 2016/01/27 12:06:31 CET [2016/01/27 6:06:31 ET]
Table 'Alhajoth' 9-max Seat #4 is the button
Seat 1: UShallGimme$ ($113.45 in chips) 
Seat 2: matiko09 ($105.50 in chips) 
Seat 3: Sweden_Pound ($105.27 in chips) 
Seat 4: Venomous100% ($151.15 in chips) 
Seat 5: Kukuryzka ($104.37 in chips) 
Seat 6: RoadtoNepal ($185.46 in chips) 
Seat 7: Ohpeel ($144.09 in chips) 
Seat 8: deepblue0000 ($133.49 in chips) 
Kukuryzka: posts small blind $0.50
RoadtoNepal: posts big blind $1
*** HOLE CARDS ***
Dealt to matiko09 [Qh 8c]
Ohpeel: raises $2 to $3
deepblue0000: folds 
UShallGimme$: folds 
matiko09: folds 
Sweden_Pound: folds 
Venomous100%: folds 
Kukuryzka: folds 
RoadtoNepal: folds 
Uncalled bet ($2) returned to Ohpeel
Ohpeel collected $2.50 from pot
Ohpeel: doesn't show hand 
*** SUMMARY ***
Total pot $2.50 | Rake $0 
Seat 1: UShallGimme$ folded before Flop (didn't bet)
Seat 2: matiko09 folded before Flop (didn't bet)
Seat 3: Sweden_Pound folded before Flop (didn't bet)
Seat 4: Venomous100% (button) folded before Flop (didn't bet)
Seat 5: Kukuryzka (small blind) folded before Flop
Seat 6: RoadtoNepal (big blind) folded before Flop
Seat 7: Ohpeel collected ($2.50)
Seat 8: deepblue0000 folded before Flop (didn't bet)





PokerStars Hand #147755064793:  Hold'em No Limit ($1/$2 USD) - 2016/01/27 12:06:31 CET [2016/01/27 6:06:31 ET]
Table 'Phobos II' 9-max Seat #7 is the button
Seat 1: LRV21 ($616.76 in chips) 
Seat 3: sylvian31 ($248.20 in chips) 
Seat 4: flk.Dasas ($200 in chips) 
Seat 5: tipner ($200 in chips) 
Seat 6: matiko09 ($200 in chips) 
Seat 7: Venomous100% ($386.33 in chips) 
Seat 8: RoadtoNepal ($200 in chips) 
Seat 9: Kukuryzka ($367.03 in chips) 
RoadtoNepal: posts small blind $1
Kukuryzka: posts big blind $2
*** HOLE CARDS ***
Dealt to matiko09 [Jd Qd]
LRV21: folds 
sylvian31: folds 
flk.Dasas: folds 
tipner: folds 
matiko09: raises $3 to $5
Venomous100%: folds 
RoadtoNepal: folds 
Kukuryzka: raises $13 to $18
matiko09: calls $13
*** FLOP *** [Ts 2d 9d]
Kukuryzka: bets $17.67
matiko09: calls $17.67
*** TURN *** [Ts 2d 9d] [9c]
Kukuryzka: checks 
matiko09: checks 
*** RIVER *** [Ts 2d 9d 9c] [6d]
Kukuryzka: bets $43
matiko09: raises $67 to $110
Kukuryzka: folds 
Uncalled bet ($67) returned to matiko09
matiko09 collected $155.54 from pot
matiko09: doesn't show hand 
*** SUMMARY ***
Total pot $158.34 | Rake $2.80 
Board [Ts 2d 9d 9c 6d]
Seat 1: LRV21 folded before Flop (didn't bet)
Seat 3: sylvian31 folded before Flop (didn't bet)
Seat 4: flk.Dasas folded before Flop (didn't bet)
Seat 5: tipner folded before Flop (didn't bet)
Seat 6: matiko09 collected ($155.54)
Seat 7: Venomous100% (button) folded before Flop (didn't bet)
Seat 8: RoadtoNepal (small blind) folded before Flop
Seat 9: Kukuryzka (big blind) folded on the River





PokerStars Hand #147755071395:  Hold'em No Limit ($0.50/$1.00 USD) - 2016/01/27 12:06:43 CET [2016/01/27 6:06:43 ET]
Table 'Klemola' 9-max Seat #6 is the button
Seat 4: RWasin17 ($100 in chips) 
Seat 5: tipner ($100 in chips) 
Seat 6: sylvian31 ($100 in chips) 
Seat 7: matiko09 ($100.91 in chips) 
Seat 8: Sweden_Pound ($100 in chips) 
matiko09: posts small blind $0.50
Sweden_Pound: posts big blind $1
COOLIKO\/23: sits out 
*** HOLE CARDS ***
Dealt to matiko09 [Kc 4s]
RWasin17: raises $1 to $2
tipner: folds 
blef1992 joins the table at seat #9 
sylvian31: folds 
matiko09: folds 
Sweden_Pound: raises $5 to $7
RWasin17: folds 
Uncalled bet ($5) returned to Sweden_Pound
Sweden_Pound collected $4.50 from pot
Sweden_Pound: doesn't show hand 
*** SUMMARY ***
Total pot $4.50 | Rake $0 
Seat 4: RWasin17 folded before Flop
Seat 5: tipner folded before Flop (didn't bet)
Seat 6: sylvian31 (button) folded before Flop (didn't bet)
Seat 7: matiko09 (small blind) folded before Flop
Seat 8: Sweden_Pound (big blind) collected ($4.50)





PokerStars Hand #147755073502:  Hold'em No Limit ($0.50/$1.00 USD) - 2016/01/27 12:06:47 CET [2016/01/27 6:06:47 ET]
Table 'Delphinus II' 9-max Seat #3 is the button
Seat 3: deepblue0000 ($464.41 in chips) 
Seat 4: matiko09 ($100.50 in chips) 
Seat 5: pandalapa ($111.25 in chips) 
Seat 6: Sweden_Pound ($146.14 in chips) 
Seat 7: RUS)Timur ($104.29 in chips) 
Seat 8: mycka86 ($107.52 in chips) 
matiko09: posts small blind $0.50
pandalapa: posts big blind $1
*** HOLE CARDS ***
Dealt to matiko09 [6h Th]
Sweden_Pound: folds 
RUS)Timur: raises $1.50 to $2.50
mycka86: folds 
deepblue0000: calls $2.50
matiko09: folds 
pandalapa: folds 
*** FLOP *** [Ah 5h Qh]
RUS)Timur: bets $3.97
deepblue0000: calls $3.97
*** TURN *** [Ah 5h Qh] [8s]
RUS)Timur: bets $11.91
deepblue0000: calls $11.91
*** RIVER *** [Ah 5h Qh 8s] [7h]
RUS)Timur: checks 
deepblue0000: checks 
*** SHOW DOWN ***
RUS)Timur: shows [5d 5s] (three of a kind, Fives)
deepblue0000: mucks hand 
RUS)Timur collected $36.54 from pot
*** SUMMARY ***
Total pot $38.26 | Rake $1.72 
Board [Ah 5h Qh 8s 7h]
Seat 3: deepblue0000 (button) mucked [Kc Ad]
Seat 4: matiko09 (small blind) folded before Flop
Seat 5: pandalapa (big blind) folded before Flop
Seat 6: Sweden_Pound folded before Flop (didn't bet)
Seat 7: RUS)Timur showed [5d 5s] and won ($36.54) with three of a kind, Fives
Seat 8: mycka86 folded before Flop (didn't bet)





PokerStars Hand #147755073610:  Hold'em No Limit ($0.50/$1.00 USD) - 2016/01/27 12:06:47 CET [2016/01/27 6:06:47 ET]
Table 'Henyey' 9-max Seat #3 is the button
Seat 1: COOLIKO\/23 ($101.50 in chips) 
Seat 2: pandalapa ($141.63 in chips) 
Seat 3: deepblue0000 ($104.47 in chips) 
Seat 4: sylvian31 ($101.75 in chips) 
Seat 5: matiko09 ($175.33 in chips) 
Seat 6: UShallGimme$ ($111.33 in chips) 
Seat 7: vinniej15 ($53.99 in chips) 
Seat 8: CoolFireX ($112.32 in chips) 
Seat 9: mycka86 ($130.63 in chips) 
sylvian31: posts small blind $0.50
matiko09: posts big blind $1
*** HOLE CARDS ***
Dealt to matiko09 [8h Ks]
UShallGimme$: folds 
vinniej15: folds 
CoolFireX: folds 
mycka86: folds 
COOLIKO\/23: folds 
pandalapa: folds 
deepblue0000: folds 
sylvian31: folds 
Uncalled bet ($0.50) returned to matiko09
matiko09 collected $1 from pot
matiko09: doesn't show hand 
*** SUMMARY ***
Total pot $1 | Rake $0 
Seat 1: COOLIKO\/23 folded before Flop (didn't bet)
Seat 2: pandalapa folded before Flop (didn't bet)
Seat 3: deepblue0000 (button) folded before Flop (didn't bet)
Seat 4: sylvian31 (small blind) folded before Flop
Seat 5: matiko09 (big blind) collected ($1)
Seat 6: UShallGimme$ folded before Flop (didn't bet)
Seat 7: vinniej15 folded before Flop (didn't bet)
Seat 8: CoolFireX folded before Flop (didn't bet)
Seat 9: mycka86 folded before Flop (didn't bet)





PokerStars Hand #147755077789:  Hold'em No Limit ($0.50/$1.00 USD) - 2016/01/27 12:06:55 CET [2016/01/27 6:06:55 ET]
Table 'Nanking' 9-max Seat #9 is the button
Seat 1: Peu3aHy ($101.66 in chips) 
Seat 2: Dachish ($91.83 in chips) 
Seat 3: nuaxin ($107.21 in chips) 
Seat 4: COOLIKO\/23 ($152.54 in chips) 
Seat 5: TheGentleFox ($113.62 in chips) 
Seat 6: Kukuryzka ($110.50 in chips) 
Seat 7: tipner ($108.30 in chips) 
Seat 8: matiko09 ($100 in chips) 
Seat 9: Sweden_Pound ($130.22 in chips) 
Peu3aHy: posts small blind $0.50
Dachish: posts big blind $1
*** HOLE CARDS ***
Dealt to matiko09 [9c 9d]
nuaxin: folds 
COOLIKO\/23: folds 
TheGentleFox: folds 
Kukuryzka: folds 
tipner: folds 
matiko09: raises $1.50 to $2.50
Sweden_Pound: folds 
Peu3aHy: folds 
Dachish: folds 
Uncalled bet ($1.50) returned to matiko09
matiko09 collected $2.50 from pot
matiko09: doesn't show hand 
*** SUMMARY ***
Total pot $2.50 | Rake $0 
Seat 1: Peu3aHy (small blind) folded before Flop
Seat 2: Dachish (big blind) folded before Flop
Seat 3: nuaxin folded before Flop (didn't bet)
Seat 4: COOLIKO\/23 folded before Flop (didn't bet)
Seat 5: TheGentleFox folded before Flop (didn't bet)
Seat 6: Kukuryzka folded before Flop (didn't bet)
Seat 7: tipner folded before Flop (didn't bet)
Seat 8: matiko09 collected ($2.50)
Seat 9: Sweden_Pound (button) folded before Flop (didn't bet)





PokerStars Hand #147755081133:  Hold'em No Limit ($0.50/$1.00 USD) - 2016/01/27 12:07:02 CET [2016/01/27 6:07:02 ET]
Table 'Alkmene II' 9-max Seat #7 is the button
Seat 1: matiko09 ($110.11 in chips) 
Seat 2: deepblue0000 ($101.50 in chips) 
Seat 4: CoolFireX ($155.36 in chips) 
Seat 5: Sweden_Pound ($112.55 in chips) 
Seat 6: Peu3aHy ($121.72 in chips) 
Seat 7: mycka86 ($100 in chips) 
Seat 8: fecsok1 ($115.84 in chips) 
Seat 9: pandalapa ($107.12 in chips) 
fecsok1: posts small blind $0.50
pandalapa: posts big blind $1
*** HOLE CARDS ***
Dealt to matiko09 [Tc 8h]
matiko09 has timed out
matiko09: folds 
deepblue0000: raises $2 to $3
CoolFireX: folds 
Sweden_Pound: folds 
Peu3aHy: folds 
mycka86: folds 
fecsok1: calls $2.50
pandalapa: folds 
*** FLOP *** [Ts 6h Jc]
fecsok1: checks 
deepblue0000: bets $4.45
fecsok1: folds 
Uncalled bet ($4.45) returned to deepblue0000
deepblue0000 collected $6.68 from pot
*** SUMMARY ***
Total pot $7 | Rake $0.32 
Board [Ts 6h Jc]
Seat 1: matiko09 folded before Flop (didn't bet)
Seat 2: deepblue0000 collected ($6.68)
Seat 4: CoolFireX folded before Flop (didn't bet)
Seat 5: Sweden_Pound folded before Flop (didn't bet)
Seat 6: Peu3aHy folded before Flop (didn't bet)
Seat 7: mycka86 (button) folded before Flop (didn't bet)
Seat 8: fecsok1 (small blind) folded on the Flop
Seat 9: pandalapa (big blind) folded before Flop





PokerStars Hand #147755081544:  Hold'em No Limit ($0.50/$1.00 USD) - 2016/01/27 12:07:03 CET [2016/01/27 6:07:03 ET]
Table 'Alhajoth' 9-max Seat #5 is the button
Seat 1: UShallGimme$ ($113.45 in chips) 
Seat 2: matiko09 ($105.50 in chips) 
Seat 3: Sweden_Pound ($105.27 in chips) 
Seat 4: Venomous100% ($151.15 in chips) 
Seat 5: Kukuryzka ($103.87 in chips) 
Seat 6: RoadtoNepal ($184.46 in chips) 
Seat 7: Ohpeel ($145.59 in chips) 
Seat 8: deepblue0000 ($133.49 in chips) 
RoadtoNepal: posts small blind $0.50
Ohpeel: posts big blind $1
*** HOLE CARDS ***
Dealt to matiko09 [9h 5c]
deepblue0000: folds 
UShallGimme$: folds 
matiko09: folds 
Sweden_Pound: folds 
Venomous100%: folds 
Kukuryzka: raises $1 to $2
RoadtoNepal: folds 
Ohpeel: calls $1
*** FLOP *** [3c 2h 6d]
Ohpeel: checks 
Kukuryzka: checks 
*** TURN *** [3c 2h 6d] [2s]
Ohpeel: checks 
Kukuryzka: checks 
*** RIVER *** [3c 2h 6d 2s] [Qh]
Ohpeel: bets $3.50
Kukuryzka: calls $3.50
*** SHOW DOWN ***
Ohpeel: shows [8s 7s] (a pair of Deuces)
Kukuryzka: shows [Qd 8h] (two pair, Queens and Deuces)
Kukuryzka collected $10.98 from pot
*** SUMMARY ***
Total pot $11.50 | Rake $0.52 
Board [3c 2h 6d 2s Qh]
Seat 1: UShallGimme$ folded before Flop (didn't bet)
Seat 2: matiko09 folded before Flop (didn't bet)
Seat 3: Sweden_Pound folded before Flop (didn't bet)
Seat 4: Venomous100% folded before Flop (didn't bet)
Seat 5: Kukuryzka (button) showed [Qd 8h] and won ($10.98) with two pair, Queens and Deuces
Seat 6: RoadtoNepal (small blind) folded before Flop
Seat 7: Ohpeel (big blind) showed [8s 7s] and lost with a pair of Deuces
Seat 8: deepblue0000 folded before Flop (didn't bet)





PokerStars Hand #147755083732:  Hold'em No Limit ($0.50/$1.00 USD) - 2016/01/27 12:07:07 CET [2016/01/27 6:07:07 ET]
Table 'Fragaria II' 9-max Seat #1 is the button
Seat 1: deepblue0000 ($100 in chips) 
Seat 2: GG-NoR34D. ($71.30 in chips) 
Seat 3: Sweden_Pound ($101.19 in chips) 
Seat 5: Venomous100% ($162.54 in chips) 
Seat 6: UShallGimme$ ($177.49 in chips) 
Seat 7: Hobby-.-AK ($59.49 in chips) 
Seat 8: mycka86 ($105.89 in chips) 
Seat 9: matiko09 ($100 in chips) 
GG-NoR34D.: posts small blind $0.50
Sweden_Pound: posts big blind $1
*** HOLE CARDS ***
Dealt to matiko09 [Js 3s]
Venomous100%: folds 
UShallGimme$: raises $2 to $3
Hobby-.-AK: folds 
mycka86: folds 
matiko09: folds 
deepblue0000: folds 
GG-NoR34D.: folds 
Sweden_Pound: folds 
Uncalled bet ($2) returned to UShallGimme$
UShallGimme$ collected $2.50 from pot
UShallGimme$: doesn't show hand 
*** SUMMARY ***
Total pot $2.50 | Rake $0 
Seat 1: deepblue0000 (button) folded before Flop (didn't bet)
Seat 2: GG-NoR34D. (small blind) folded before Flop
Seat 3: Sweden_Pound (big blind) folded before Flop
Seat 5: Venomous100% folded before Flop (didn't bet)
Seat 6: UShallGimme$ collected ($2.50)
Seat 7: Hobby-.-AK folded before Flop (didn't bet)
Seat 8: mycka86 folded before Flop (didn't bet)
Seat 9: matiko09 folded before Flop (didn't bet)





PokerStars Hand #147755084672:  Hold'em No Limit ($0.50/$1.00 USD) - 2016/01/27 12:07:09 CET [2016/01/27 6:07:09 ET]
Table 'Klemola' 9-max Seat #7 is the button
Seat 4: RWasin17 ($98 in chips) 
Seat 5: tipner ($100 in chips) 
Seat 6: sylvian31 ($100 in chips) 
Seat 7: matiko09 ($100.41 in chips) 
Seat 8: Sweden_Pound ($102.50 in chips) 
Seat 9: blef1992 ($80 in chips) 
Sweden_Pound: posts small blind $0.50
blef1992: posts big blind $1
COOLIKO\/23: sits out 
*** HOLE CARDS ***
Dealt to matiko09 [Kh 3h]
RWasin17: folds 
tipner: folds 
Kukuryzka joins the table at seat #2 
sylvian31: folds 
matiko09: raises $2 to $3
Sweden_Pound: raises $8 to $11
blef1992: calls $10
matiko09: folds 
*** FLOP *** [Qh 4s Jc]
Sweden_Pound: bets $15
greyman571 joins the table at seat #3 
blef1992: calls $15
*** TURN *** [Qh 4s Jc] [4c]
Sweden_Pound: checks 
blef1992: bets $26
Sweden_Pound: folds 
Uncalled bet ($26) returned to blef1992
blef1992 collected $52.52 from pot
blef1992: doesn't show hand 
*** SUMMARY ***
Total pot $55 | Rake $2.48 
Board [Qh 4s Jc 4c]
Seat 4: RWasin17 folded before Flop (didn't bet)
Seat 5: tipner folded before Flop (didn't bet)
Seat 6: sylvian31 folded before Flop (didn't bet)
Seat 7: matiko09 (button) folded before Flop
Seat 8: Sweden_Pound (small blind) folded on the Turn
Seat 9: blef1992 (big blind) collected ($52.52)





PokerStars Hand #147755091004:  Hold'em No Limit ($0.50/$1.00 USD) - 2016/01/27 12:07:21 CET [2016/01/27 6:07:21 ET]
Table 'Dollfus' 9-max Seat #8 is the button
Seat 1: masaytoo ($126.07 in chips) 
Seat 2: nosoant ($69.58 in chips) 
Seat 3: UShallGimme$ ($122.36 in chips) 
Seat 4: matiko09 ($106.54 in chips) 
Seat 5: pandalapa ($218.98 in chips) 
Seat 6: deepblue0000 ($101.96 in chips) 
Seat 7: Dödi123 ($206.61 in chips) 
Seat 8: Venomous100% ($109.77 in chips) 
Seat 9: COOLIKO\/23 ($122.21 in chips) 
COOLIKO\/23: posts small blind $0.50
masaytoo: posts big blind $1
*** HOLE CARDS ***
Dealt to matiko09 [Ad Qs]
nosoant: folds 
UShallGimme$: folds 
matiko09: raises $2 to $3
pandalapa: folds 
deepblue0000: folds 
Dödi123: folds 
Venomous100%: folds 
COOLIKO\/23: folds 
masaytoo: folds 
Uncalled bet ($2) returned to matiko09
matiko09 collected $2.50 from pot
matiko09: doesn't show hand 
*** SUMMARY ***
Total pot $2.50 | Rake $0 
Seat 1: masaytoo (big blind) folded before Flop
Seat 2: nosoant folded before Flop (didn't bet)
Seat 3: UShallGimme$ folded before Flop (didn't bet)
Seat 4: matiko09 collected ($2.50)
Seat 5: pandalapa folded before Flop (didn't bet)
Seat 6: deepblue0000 folded before Flop (didn't bet)
Seat 7: Dödi123 folded before Flop (didn't bet)
Seat 8: Venomous100% (button) folded before Flop (didn't bet)
Seat 9: COOLIKO\/23 (small blind) folded before Flop





PokerStars Hand #147755092409:  Hold'em No Limit ($0.50/$1.00 USD) - 2016/01/27 12:07:23 CET [2016/01/27 6:07:23 ET]
Table 'Henyey' 9-max Seat #4 is the button
Seat 1: COOLIKO\/23 ($101.50 in chips) 
Seat 2: pandalapa ($141.63 in chips) 
Seat 3: deepblue0000 ($104.47 in chips) 
Seat 4: sylvian31 ($101.25 in chips) 
Seat 5: matiko09 ($175.83 in chips) 
Seat 6: UShallGimme$ ($111.33 in chips) 
Seat 7: vinniej15 ($53.99 in chips) 
Seat 8: CoolFireX ($112.32 in chips) 
Seat 9: mycka86 ($130.63 in chips) 
matiko09: posts small blind $0.50
UShallGimme$: posts big blind $1
*** HOLE CARDS ***
Dealt to matiko09 [3d Kh]
vinniej15: folds 
CoolFireX: folds 
mycka86: folds 
COOLIKO\/23: folds 
pandalapa: folds 
deepblue0000: raises $1.50 to $2.50
sylvian31: folds 
matiko09: folds 
UShallGimme$: folds 
Uncalled bet ($1.50) returned to deepblue0000
deepblue0000 collected $2.50 from pot
*** SUMMARY ***
Total pot $2.50 | Rake $0 
Seat 1: COOLIKO\/23 folded before Flop (didn't bet)
Seat 2: pandalapa folded before Flop (didn't bet)
Seat 3: deepblue0000 collected ($2.50)
Seat 4: sylvian31 (button) folded before Flop (didn't bet)
Seat 5: matiko09 (small blind) folded before Flop
Seat 6: UShallGimme$ (big blind) folded before Flop
Seat 7: vinniej15 folded before Flop (didn't bet)
Seat 8: CoolFireX folded before Flop (didn't bet)
Seat 9: mycka86 folded before Flop (didn't bet)





PokerStars Hand #147755095946:  Hold'em No Limit ($0.50/$1.00 USD) - 2016/01/27 12:07:30 CET [2016/01/27 6:07:30 ET]
Table 'Marlu II' 9-max Seat #6 is the button
Seat 1: Kukuryzka ($107.45 in chips) 
Seat 2: matiko09 ($100 in chips) 
Seat 3: COOLIKO\/23 ($100 in chips) 
Seat 4: tipner ($100 in chips) 
Seat 5: Sweden_Pound ($100 in chips) 
Seat 6: LIGOPSIXIS78 ($63.33 in chips) 
Seat 7: UShallGimme$ ($100 in chips) 
Seat 8: Peu3aHy ($100 in chips) 
Seat 9: platinium1 ($60.01 in chips) 
UShallGimme$: posts small blind $0.50
Peu3aHy: posts big blind $1
*** HOLE CARDS ***
Dealt to matiko09 [6h 9s]
platinium1: folds 
Kukuryzka: folds 
matiko09: folds 
COOLIKO\/23: folds 
tipner: raises $2 to $3
Sweden_Pound: folds 
LIGOPSIXIS78: folds 
UShallGimme$: folds 
Peu3aHy: folds 
Uncalled bet ($2) returned to tipner
tipner collected $2.50 from pot
tipner: doesn't show hand 
*** SUMMARY ***
Total pot $2.50 | Rake $0 
Seat 1: Kukuryzka folded before Flop (didn't bet)
Seat 2: matiko09 folded before Flop (didn't bet)
Seat 3: COOLIKO\/23 folded before Flop (didn't bet)
Seat 4: tipner collected ($2.50)
Seat 5: Sweden_Pound folded before Flop (didn't bet)
Seat 6: LIGOPSIXIS78 (button) folded before Flop (didn't bet)
Seat 7: UShallGimme$ (small blind) folded before Flop
Seat 8: Peu3aHy (big blind) folded before Flop
Seat 9: platinium1 folded before Flop (didn't bet)





PokerStars Hand #147755102049:  Hold'em No Limit ($0.50/$1.00 USD) - 2016/01/27 12:07:42 CET [2016/01/27 6:07:42 ET]
Table 'Fragaria II' 9-max Seat #2 is the button
Seat 1: deepblue0000 ($100 in chips) 
Seat 2: GG-NoR34D. ($70.80 in chips) 
Seat 3: Sweden_Pound ($100.19 in chips) 
Seat 5: Venomous100% ($162.54 in chips) 
Seat 6: UShallGimme$ ($178.99 in chips) 
Seat 7: Hobby-.-AK ($59.49 in chips) 
Seat 8: mycka86 ($105.89 in chips) 
Seat 9: matiko09 ($100 in chips) 
Sweden_Pound: posts small blind $0.50
Venomous100%: posts big blind $1
*** HOLE CARDS ***
Dealt to matiko09 [9c Jh]
UShallGimme$: folds 
Hobby-.-AK: folds 
mycka86: folds 
matiko09: folds 
deepblue0000: folds 
GG-NoR34D.: folds 
Sweden_Pound: folds 
Uncalled bet ($0.50) returned to Venomous100%
Venomous100% collected $1 from pot
Venomous100%: doesn't show hand 
*** SUMMARY ***
Total pot $1 | Rake $0 
Seat 1: deepblue0000 folded before Flop (didn't bet)
Seat 2: GG-NoR34D. (button) folded before Flop (didn't bet)
Seat 3: Sweden_Pound (small blind) folded before Flop
Seat 5: Venomous100% (big blind) collected ($1)
Seat 6: UShallGimme$ folded before Flop (didn't bet)
Seat 7: Hobby-.-AK folded before Flop (didn't bet)
Seat 8: mycka86 folded before Flop (didn't bet)
Seat 9: matiko09 folded before Flop (didn't bet)





PokerStars Hand #147755108029:  Hold'em No Limit ($0.50/$1.00 USD) - 2016/01/27 12:07:53 CET [2016/01/27 6:07:53 ET]
Table 'Henyey' 9-max Seat #5 is the button
Seat 1: COOLIKO\/23 ($101.50 in chips) 
Seat 2: pandalapa ($141.63 in chips) 
Seat 3: deepblue0000 ($105.97 in chips) 
Seat 4: sylvian31 ($101.25 in chips) 
Seat 5: matiko09 ($175.33 in chips) 
Seat 6: UShallGimme$ ($110.33 in chips) 
Seat 7: vinniej15 ($53.99 in chips) 
Seat 8: CoolFireX ($112.32 in chips) 
Seat 9: mycka86 ($130.63 in chips) 
UShallGimme$: posts small blind $0.50
vinniej15: posts big blind $1
*** HOLE CARDS ***
Dealt to matiko09 [7h 8c]
CoolFireX: folds 
mycka86: folds 
COOLIKO\/23: folds 
pandalapa: folds 
deepblue0000: folds 
sylvian31: folds 
matiko09: folds 
UShallGimme$: folds 
Uncalled bet ($0.50) returned to vinniej15
vinniej15 collected $1 from pot
*** SUMMARY ***
Total pot $1 | Rake $0 
Seat 1: COOLIKO\/23 folded before Flop (didn't bet)
Seat 2: pandalapa folded before Flop (didn't bet)
Seat 3: deepblue0000 folded before Flop (didn't bet)
Seat 4: sylvian31 folded before Flop (didn't bet)
Seat 5: matiko09 (button) folded before Flop (didn't bet)
Seat 6: UShallGimme$ (small blind) folded before Flop
Seat 7: vinniej15 (big blind) collected ($1)
Seat 8: CoolFireX folded before Flop (didn't bet)
Seat 9: mycka86 folded before Flop (didn't bet)





PokerStars Hand #147755108892:  Hold'em No Limit ($0.50/$1.00 USD) - 2016/01/27 12:07:55 CET [2016/01/27 6:07:55 ET]
Table 'Nanking' 9-max Seat #1 is the button
Seat 1: Peu3aHy ($101.16 in chips) 
Seat 2: Dachish ($90.83 in chips) 
Seat 3: nuaxin ($107.21 in chips) 
Seat 4: COOLIKO\/23 ($152.54 in chips) 
Seat 5: TheGentleFox ($113.62 in chips) 
Seat 6: Kukuryzka ($110.50 in chips) 
Seat 7: tipner ($108.30 in chips) 
Seat 8: matiko09 ($101.50 in chips) 
Seat 9: Sweden_Pound ($130.22 in chips) 
Dachish: posts small blind $0.50
nuaxin: posts big blind $1
*** HOLE CARDS ***
Dealt to matiko09 [3h 9d]
COOLIKO\/23: folds 
TheGentleFox: folds 
Kukuryzka: folds 
tipner: folds 
matiko09: folds 
Sweden_Pound: raises $1.50 to $2.50
Peu3aHy: calls $2.50
Dachish: folds 
nuaxin: folds 
*** FLOP *** [Ac Js 9c]
Sweden_Pound: bets $4.04
Peu3aHy: calls $4.04
*** TURN *** [Ac Js 9c] [Ah]
Sweden_Pound: checks 
Peu3aHy: bets $5
Sweden_Pound: folds 
Uncalled bet ($5) returned to Peu3aHy
Peu3aHy collected $13.92 from pot
Peu3aHy: doesn't show hand 
*** SUMMARY ***
Total pot $14.58 | Rake $0.66 
Board [Ac Js 9c Ah]
Seat 1: Peu3aHy (button) collected ($13.92)
Seat 2: Dachish (small blind) folded before Flop
Seat 3: nuaxin (big blind) folded before Flop
Seat 4: COOLIKO\/23 folded before Flop (didn't bet)
Seat 5: TheGentleFox folded before Flop (didn't bet)
Seat 6: Kukuryzka folded before Flop (didn't bet)
Seat 7: tipner folded before Flop (didn't bet)
Seat 8: matiko09 folded before Flop (didn't bet)
Seat 9: Sweden_Pound folded on the Turn





PokerStars Hand #147755108895:  Hold'em No Limit ($0.50/$1.00 USD) - 2016/01/27 12:07:55 CET [2016/01/27 6:07:55 ET]
Table 'Dollfus' 9-max Seat #9 is the button
Seat 1: masaytoo ($125.07 in chips) 
Seat 2: nosoant ($69.58 in chips) 
Seat 3: UShallGimme$ ($122.36 in chips) 
Seat 4: matiko09 ($108.04 in chips) 
Seat 5: pandalapa ($218.98 in chips) 
Seat 6: deepblue0000 ($101.96 in chips) 
Seat 7: Dödi123 ($206.61 in chips) 
Seat 8: Venomous100% ($109.77 in chips) 
Seat 9: COOLIKO\/23 ($121.71 in chips) 
masaytoo: posts small blind $0.50
nosoant: posts big blind $1
*** HOLE CARDS ***
Dealt to matiko09 [9c 3h]
UShallGimme$: folds 
matiko09: folds 
pandalapa: folds 
deepblue0000: folds 
Dödi123: folds 
Venomous100%: folds 
COOLIKO\/23: raises $1.50 to $2.50
masaytoo: folds 
nosoant: folds 
Uncalled bet ($1.50) returned to COOLIKO\/23
COOLIKO\/23 collected $2.50 from pot
COOLIKO\/23: doesn't show hand 
*** SUMMARY ***
Total pot $2.50 | Rake $0 
Seat 1: masaytoo (small blind) folded before Flop
Seat 2: nosoant (big blind) folded before Flop
Seat 3: UShallGimme$ folded before Flop (didn't bet)
Seat 4: matiko09 folded before Flop (didn't bet)
Seat 5: pandalapa folded before Flop (didn't bet)
Seat 6: deepblue0000 folded before Flop (didn't bet)
Seat 7: Dödi123 folded before Flop (didn't bet)
Seat 8: Venomous100% folded before Flop (didn't bet)
Seat 9: COOLIKO\/23 (button) collected ($2.50)





PokerStars Hand #147755111039:  Hold'em No Limit ($0.50/$1.00 USD) - 2016/01/27 12:07:59 CET [2016/01/27 6:07:59 ET]
Table 'Delphinus II' 9-max Seat #4 is the button
Seat 3: deepblue0000 ($446.03 in chips) 
Seat 4: matiko09 ($100 in chips) 
Seat 5: pandalapa ($110.25 in chips) 
Seat 6: Sweden_Pound ($146.14 in chips) 
Seat 7: RUS)Timur ($122.45 in chips) 
Seat 8: mycka86 ($107.52 in chips) 
pandalapa: posts small blind $0.50
Sweden_Pound: posts big blind $1
Saintreine: sits out 
*** HOLE CARDS ***
Dealt to matiko09 [6c 9d]
RUS)Timur: folds 
mycka86: folds 
deepblue0000: folds 
matiko09: folds 
pandalapa: folds 
Uncalled bet ($0.50) returned to Sweden_Pound
Sweden_Pound collected $1 from pot
Sweden_Pound: doesn't show hand 
*** SUMMARY ***
Total pot $1 | Rake $0 
Seat 3: deepblue0000 folded before Flop (didn't bet)
Seat 4: matiko09 (button) folded before Flop (didn't bet)
Seat 5: pandalapa (small blind) folded before Flop
Seat 6: Sweden_Pound (big blind) collected ($1)
Seat 7: RUS)Timur folded before Flop (didn't bet)
Seat 8: mycka86 folded before Flop (didn't bet)





PokerStars Hand #147755113202:  Hold'em No Limit ($0.50/$1.00 USD) - 2016/01/27 12:08:03 CET [2016/01/27 6:08:03 ET]
Table 'Alkmene II' 9-max Seat #8 is the button
Seat 1: matiko09 ($110.11 in chips) 
Seat 2: deepblue0000 ($105.18 in chips) 
Seat 4: CoolFireX ($155.36 in chips) 
Seat 5: Sweden_Pound ($112.55 in chips) 
Seat 6: Peu3aHy ($121.72 in chips) 
Seat 7: mycka86 ($100 in chips) 
Seat 8: fecsok1 ($112.84 in chips) 
Seat 9: pandalapa ($106.12 in chips) 
pandalapa: posts small blind $0.50
matiko09: posts big blind $1
*** HOLE CARDS ***
Dealt to matiko09 [6d Js]
deepblue0000: folds 
CoolFireX: folds 
Sweden_Pound: folds 
Peu3aHy: raises $2 to $3
mycka86: folds 
fecsok1: folds 
pandalapa: folds 
matiko09: folds 
Uncalled bet ($2) returned to Peu3aHy
Peu3aHy collected $2.50 from pot
Peu3aHy: doesn't show hand 
*** SUMMARY ***
Total pot $2.50 | Rake $0 
Seat 1: matiko09 (big blind) folded before Flop
Seat 2: deepblue0000 folded before Flop (didn't bet)
Seat 4: CoolFireX folded before Flop (didn't bet)
Seat 5: Sweden_Pound folded before Flop (didn't bet)
Seat 6: Peu3aHy collected ($2.50)
Seat 7: mycka86 folded before Flop (didn't bet)
Seat 8: fecsok1 (button) folded before Flop (didn't bet)
Seat 9: pandalapa (small blind) folded before Flop





PokerStars Hand #147755115470:  Hold'em No Limit ($0.50/$1.00 USD) - 2016/01/27 12:08:07 CET [2016/01/27 6:08:07 ET]
Table 'Fragaria II' 9-max Seat #3 is the button
Seat 1: deepblue0000 ($100 in chips) 
Seat 2: GG-NoR34D. ($70.80 in chips) 
Seat 3: Sweden_Pound ($100 in chips) 
Seat 5: Venomous100% ($163.04 in chips) 
Seat 6: UShallGimme$ ($178.99 in chips) 
Seat 7: Hobby-.-AK ($59.49 in chips) 
Seat 8: mycka86 ($105.89 in chips) 
Seat 9: matiko09 ($100 in chips) 
Venomous100%: posts small blind $0.50
UShallGimme$: posts big blind $1
*** HOLE CARDS ***
Dealt to matiko09 [Ac 6d]
Hobby-.-AK: folds 
mycka86: folds 
matiko09: folds 
deepblue0000: raises $2 to $3
GG-NoR34D.: folds 
Sweden_Pound: folds 
Venomous100%: folds 
UShallGimme$: raises $7 to $10
deepblue0000: folds 
Uncalled bet ($7) returned to UShallGimme$
UShallGimme$ collected $6.50 from pot
UShallGimme$: doesn't show hand 
*** SUMMARY ***
Total pot $6.50 | Rake $0 
Seat 1: deepblue0000 folded before Flop
Seat 2: GG-NoR34D. folded before Flop (didn't bet)
Seat 3: Sweden_Pound (button) folded before Flop (didn't bet)
Seat 5: Venomous100% (small blind) folded before Flop
Seat 6: UShallGimme$ (big blind) collected ($6.50)
Seat 7: Hobby-.-AK folded before Flop (didn't bet)
Seat 8: mycka86 folded before Flop (didn't bet)
Seat 9: matiko09 folded before Flop (didn't bet)





PokerStars Hand #147755117485:  Hold'em No Limit ($0.50/$1.00 USD) - 2016/01/27 12:08:11 CET [2016/01/27 6:08:11 ET]
Table 'Marlu II' 9-max Seat #7 is the button
Seat 1: Kukuryzka ($107.45 in chips) 
Seat 2: matiko09 ($100 in chips) 
Seat 3: COOLIKO\/23 ($100 in chips) 
Seat 4: tipner ($101.50 in chips) 
Seat 5: Sweden_Pound ($100 in chips) 
Seat 6: LIGOPSIXIS78 ($63.33 in chips) 
Seat 7: UShallGimme$ ($100 in chips) 
Seat 8: Peu3aHy ($100 in chips) 
Seat 9: platinium1 ($60.01 in chips) 
Peu3aHy: posts small blind $0.50
platinium1: posts big blind $1
*** HOLE CARDS ***
Dealt to matiko09 [8h Jh]
Kukuryzka: raises $2 to $3
matiko09: folds 
COOLIKO\/23: folds 
tipner: folds 
Sweden_Pound: folds 
LIGOPSIXIS78: folds 
UShallGimme$: folds 
Peu3aHy: folds 
platinium1: folds 
Uncalled bet ($2) returned to Kukuryzka
Kukuryzka collected $2.50 from pot
Kukuryzka: doesn't show hand 
*** SUMMARY ***
Total pot $2.50 | Rake $0 
Seat 1: Kukuryzka collected ($2.50)
Seat 2: matiko09 folded before Flop (didn't bet)
Seat 3: COOLIKO\/23 folded before Flop (didn't bet)
Seat 4: tipner folded before Flop (didn't bet)
Seat 5: Sweden_Pound folded before Flop (didn't bet)
Seat 6: LIGOPSIXIS78 folded before Flop (didn't bet)
Seat 7: UShallGimme$ (button) folded before Flop (didn't bet)
Seat 8: Peu3aHy (small blind) folded before Flop
Seat 9: platinium1 (big blind) folded before Flop





PokerStars Hand #147755119412:  Hold'em No Limit ($0.50/$1.00 USD) - 2016/01/27 12:08:15 CET [2016/01/27 6:08:15 ET]
Table 'Delphinus II' 9-max Seat #5 is the button
Seat 3: deepblue0000 ($446.03 in chips) 
Seat 4: matiko09 ($100 in chips) 
Seat 5: pandalapa ($109.75 in chips) 
Seat 6: Sweden_Pound ($146.64 in chips) 
Seat 7: RUS)Timur ($122.45 in chips) 
Seat 8: mycka86 ($107.52 in chips) 
Sweden_Pound: posts small blind $0.50
RUS)Timur: posts big blind $1
Saintreine: sits out 
*** HOLE CARDS ***
Dealt to matiko09 [3s Qc]
mycka86: folds 
deepblue0000: folds 
matiko09: folds 
pandalapa: raises $1 to $2
Sweden_Pound: folds 
RUS)Timur: calls $1
*** FLOP *** [8s 7c 7d]
RUS)Timur: checks 
pandalapa: bets $2.86
RUS)Timur: calls $2.86
*** TURN *** [8s 7c 7d] [4h]
RUS)Timur: checks 
pandalapa: checks 
*** RIVER *** [8s 7c 7d 4h] [Kh]
RUS)Timur: checks 
pandalapa: checks 
*** SHOW DOWN ***
RUS)Timur: shows [4d 8d] (two pair, Eights and Sevens)
pandalapa: mucks hand 
RUS)Timur collected $9.76 from pot
*** SUMMARY ***
Total pot $10.22 | Rake $0.46 
Board [8s 7c 7d 4h Kh]
Seat 3: deepblue0000 folded before Flop (didn't bet)
Seat 4: matiko09 folded before Flop (didn't bet)
Seat 5: pandalapa (button) mucked [5d Ad]
Seat 6: Sweden_Pound (small blind) folded before Flop
Seat 7: RUS)Timur (big blind) showed [4d 8d] and won ($9.76) with two pair, Eights and Sevens
Seat 8: mycka86 folded before Flop (didn't bet)





PokerStars Hand #147755123090:  Hold'em No Limit ($0.50/$1.00 USD) - 2016/01/27 12:08:21 CET [2016/01/27 6:08:21 ET]
Table 'Henyey' 9-max Seat #6 is the button
Seat 1: COOLIKO\/23 ($101.50 in chips) 
Seat 2: pandalapa ($141.63 in chips) 
Seat 3: deepblue0000 ($105.97 in chips) 
Seat 4: sylvian31 ($101.25 in chips) 
Seat 5: matiko09 ($175.33 in chips) 
Seat 6: UShallGimme$ ($109.83 in chips) 
Seat 7: vinniej15 ($54.49 in chips) 
Seat 8: CoolFireX ($112.32 in chips) 
Seat 9: mycka86 ($130.63 in chips) 
vinniej15: posts small blind $0.50
CoolFireX: posts big blind $1
*** HOLE CARDS ***
Dealt to matiko09 [2d 9s]
mycka86: raises $2 to $3
COOLIKO\/23: folds 
pandalapa: folds 
deepblue0000: folds 
sylvian31: folds 
matiko09: folds 
UShallGimme$: folds 
vinniej15: folds 
CoolFireX: folds 
Uncalled bet ($2) returned to mycka86
mycka86 collected $2.50 from pot
*** SUMMARY ***
Total pot $2.50 | Rake $0 
Seat 1: COOLIKO\/23 folded before Flop (didn't bet)
Seat 2: pandalapa folded before Flop (didn't bet)
Seat 3: deepblue0000 folded before Flop (didn't bet)
Seat 4: sylvian31 folded before Flop (didn't bet)
Seat 5: matiko09 folded before Flop (didn't bet)
Seat 6: UShallGimme$ (button) folded before Flop (didn't bet)
Seat 7: vinniej15 (small blind) folded before Flop
Seat 8: CoolFireX (big blind) folded before Flop
Seat 9: mycka86 collected ($2.50)





PokerStars Hand #147755123425:  Hold'em No Limit ($0.50/$1.00 USD) - 2016/01/27 12:08:22 CET [2016/01/27 6:08:22 ET]
Table 'Klemola' 9-max Seat #8 is the button
Seat 1: COOLIKO\/23 ($100 in chips) 
Seat 4: RWasin17 ($98 in chips) 
Seat 5: tipner ($100 in chips) 
Seat 6: sylvian31 ($100 in chips) 
Seat 7: matiko09 ($100 in chips) 
Seat 8: Sweden_Pound ($100 in chips) 
Seat 9: blef1992 ($106.52 in chips) 
blef1992: posts small blind $0.50
COOLIKO\/23: posts big blind $1
Kukuryzka: sits out 
greyman571: sits out 
*** HOLE CARDS ***
Dealt to matiko09 [2d 3h]
RWasin17: folds 
tipner: folds 
sylvian31: raises $2 to $3
matiko09: folds 
Sweden_Pound: folds 
blef1992: raises $4 to $7
COOLIKO\/23: folds 
sylvian31: calls $4
*** FLOP *** [Ad 7c Qc]
blef1992: checks 
sylvian31: checks 
*** TURN *** [Ad 7c Qc] [Jd]
blef1992: bets $8
sylvian31: calls $8
*** RIVER *** [Ad 7c Qc Jd] [4c]
blef1992: bets $17
sylvian31: folds 
Uncalled bet ($17) returned to blef1992
blef1992 collected $29.60 from pot
blef1992: doesn't show hand 
*** SUMMARY ***
Total pot $31 | Rake $1.40 
Board [Ad 7c Qc Jd 4c]
Seat 1: COOLIKO\/23 (big blind) folded before Flop
Seat 4: RWasin17 folded before Flop (didn't bet)
Seat 5: tipner folded before Flop (didn't bet)
Seat 6: sylvian31 folded on the River
Seat 7: matiko09 folded before Flop (didn't bet)
Seat 8: Sweden_Pound (button) folded before Flop (didn't bet)
Seat 9: blef1992 (small blind) collected ($29.60)





PokerStars Hand #147755129252:  Hold'em No Limit ($0.50/$1.00 USD) - 2016/01/27 12:08:33 CET [2016/01/27 6:08:33 ET]
Table 'Dollfus' 9-max Seat #1 is the button
Seat 1: masaytoo ($124.57 in chips) 
Seat 2: nosoant ($68.58 in chips) 
Seat 3: UShallGimme$ ($122.36 in chips) 
Seat 4: matiko09 ($108.04 in chips) 
Seat 5: pandalapa ($218.98 in chips) 
Seat 6: deepblue0000 ($101.96 in chips) 
Seat 7: Dödi123 ($206.61 in chips) 
Seat 8: Venomous100% ($109.77 in chips) 
Seat 9: COOLIKO\/23 ($123.21 in chips) 
nosoant: posts small blind $0.50
UShallGimme$: posts big blind $1
*** HOLE CARDS ***
Dealt to matiko09 [Th Js]
matiko09: folds 
pandalapa: raises $2 to $3
deepblue0000: folds 
Dödi123: folds 
Venomous100%: folds 
COOLIKO\/23: folds 
masaytoo: folds 
nosoant: folds 
UShallGimme$: folds 
Uncalled bet ($2) returned to pandalapa
pandalapa collected $2.50 from pot
pandalapa: doesn't show hand 
*** SUMMARY ***
Total pot $2.50 | Rake $0 
Seat 1: masaytoo (button) folded before Flop (didn't bet)
Seat 2: nosoant (small blind) folded before Flop
Seat 3: UShallGimme$ (big blind) folded before Flop
Seat 4: matiko09 folded before Flop (didn't bet)
Seat 5: pandalapa collected ($2.50)
Seat 6: deepblue0000 folded before Flop (didn't bet)
Seat 7: Dödi123 folded before Flop (didn't bet)
Seat 8: Venomous100% folded before Flop (didn't bet)
Seat 9: COOLIKO\/23 folded before Flop (didn't bet)





PokerStars Hand #147755132968:  Hold'em No Limit ($0.50/$1.00 USD) - 2016/01/27 12:08:40 CET [2016/01/27 6:08:40 ET]
Table 'Marlu II' 9-max Seat #8 is the button
Seat 1: Kukuryzka ($108.95 in chips) 
Seat 2: matiko09 ($100 in chips) 
Seat 3: COOLIKO\/23 ($100 in chips) 
Seat 4: tipner ($101.50 in chips) 
Seat 5: Sweden_Pound ($100 in chips) 
Seat 6: LIGOPSIXIS78 ($63.33 in chips) 
Seat 7: UShallGimme$ ($100 in chips) 
Seat 8: Peu3aHy ($100 in chips) 
Seat 9: platinium1 ($59.01 in chips) 
platinium1: posts small blind $0.50
Kukuryzka: posts big blind $1
*** HOLE CARDS ***
Dealt to matiko09 [4d 8h]
matiko09: folds 
COOLIKO\/23: folds 
tipner: folds 
Sweden_Pound: folds 
LIGOPSIXIS78: folds 
UShallGimme$: folds 
Peu3aHy: folds 
platinium1: calls $0.50
Kukuryzka: checks 
*** FLOP *** [7d Ad 6c]
platinium1: bets $1
Kukuryzka: folds 
Uncalled bet ($1) returned to platinium1
platinium1 collected $1.91 from pot
platinium1: doesn't show hand 
*** SUMMARY ***
Total pot $2 | Rake $0.09 
Board [7d Ad 6c]
Seat 1: Kukuryzka (big blind) folded on the Flop
Seat 2: matiko09 folded before Flop (didn't bet)
Seat 3: COOLIKO\/23 folded before Flop (didn't bet)
Seat 4: tipner folded before Flop (didn't bet)
Seat 5: Sweden_Pound folded before Flop (didn't bet)
Seat 6: LIGOPSIXIS78 folded before Flop (didn't bet)
Seat 7: UShallGimme$ folded before Flop (didn't bet)
Seat 8: Peu3aHy (button) folded before Flop (didn't bet)
Seat 9: platinium1 (small blind) collected ($1.91)





PokerStars Hand #147755133320:  Hold'em No Limit ($0.50/$1.00 USD) - 2016/01/27 12:08:41 CET [2016/01/27 6:08:41 ET]
Table 'Alkmene II' 9-max Seat #9 is the button
Seat 1: matiko09 ($109.11 in chips) 
Seat 2: deepblue0000 ($105.18 in chips) 
Seat 4: CoolFireX ($155.36 in chips) 
Seat 5: Sweden_Pound ($112.55 in chips) 
Seat 6: Peu3aHy ($123.22 in chips) 
Seat 7: mycka86 ($100 in chips) 
Seat 8: fecsok1 ($112.84 in chips) 
Seat 9: pandalapa ($105.62 in chips) 
matiko09: posts small blind $0.50
deepblue0000: posts big blind $1
*** HOLE CARDS ***
Dealt to matiko09 [Ad 6s]
CoolFireX: folds 
Sweden_Pound: folds 
Peu3aHy: folds 
mycka86: folds 
fecsok1: raises $1.50 to $2.50
pandalapa: folds 
matiko09: folds 
deepblue0000: folds 
Uncalled bet ($1.50) returned to fecsok1
fecsok1 collected $2.50 from pot
*** SUMMARY ***
Total pot $2.50 | Rake $0 
Seat 1: matiko09 (small blind) folded before Flop
Seat 2: deepblue0000 (big blind) folded before Flop
Seat 4: CoolFireX folded before Flop (didn't bet)
Seat 5: Sweden_Pound folded before Flop (didn't bet)
Seat 6: Peu3aHy folded before Flop (didn't bet)
Seat 7: mycka86 folded before Flop (didn't bet)
Seat 8: fecsok1 collected ($2.50)
Seat 9: pandalapa (button) folded before Flop (didn't bet)





PokerStars Hand #147755133858:  Hold'em No Limit ($0.50/$1.00 USD) - 2016/01/27 12:08:42 CET [2016/01/27 6:08:42 ET]
Table 'Fragaria II' 9-max Seat #5 is the button
Seat 1: deepblue0000 ($100 in chips) 
Seat 2: GG-NoR34D. ($70.80 in chips) 
Seat 3: Sweden_Pound ($100 in chips) 
Seat 5: Venomous100% ($162.54 in chips) 
Seat 6: UShallGimme$ ($182.49 in chips) 
Seat 7: Hobby-.-AK ($59.49 in chips) 
Seat 8: mycka86 ($105.89 in chips) 
Seat 9: matiko09 ($100 in chips) 
UShallGimme$: posts small blind $0.50
Hobby-.-AK: posts big blind $1
*** HOLE CARDS ***
Dealt to matiko09 [6c Tc]
mycka86: folds 
matiko09: folds 
deepblue0000: folds 
GG-NoR34D.: folds 
Sweden_Pound: folds 
Venomous100%: raises $2 to $3
UShallGimme$: folds 
Hobby-.-AK: raises $3 to $6
Venomous100%: raises $15 to $21
Hobby-.-AK: folds 
Uncalled bet ($15) returned to Venomous100%
Venomous100% collected $12.50 from pot
Venomous100%: doesn't show hand 
*** SUMMARY ***
Total pot $12.50 | Rake $0 
Seat 1: deepblue0000 folded before Flop (didn't bet)
Seat 2: GG-NoR34D. folded before Flop (didn't bet)
Seat 3: Sweden_Pound folded before Flop (didn't bet)
Seat 5: Venomous100% (button) collected ($12.50)
Seat 6: UShallGimme$ (small blind) folded before Flop
Seat 7: Hobby-.-AK (big blind) folded before Flop
Seat 8: mycka86 folded before Flop (didn't bet)
Seat 9: matiko09 folded before Flop (didn't bet)





PokerStars Hand #147755137185:  Hold'em No Limit ($0.50/$1.00 USD) - 2016/01/27 12:08:48 CET [2016/01/27 6:08:48 ET]
Table 'Alhajoth' 9-max Seat #6 is the button
Seat 1: UShallGimme$ ($113.45 in chips) 
Seat 2: matiko09 ($105.50 in chips) 
Seat 3: Sweden_Pound ($105.27 in chips) 
Seat 4: Venomous100% ($151.15 in chips) 
Seat 5: Kukuryzka ($109.35 in chips) 
Seat 6: RoadtoNepal ($183.96 in chips) 
Seat 7: Ohpeel ($140.09 in chips) 
Seat 8: deepblue0000 ($133.49 in chips) 
Ohpeel: posts small blind $0.50
deepblue0000: posts big blind $1
*** HOLE CARDS ***
Dealt to matiko09 [3h 3d]
UShallGimme$: raises $2 to $3
matiko09: folds 
Sweden_Pound: folds 
Venomous100%: raises $6 to $9
Kukuryzka: folds 
RoadtoNepal: folds 
Ohpeel: calls $8.50
deepblue0000: folds 
UShallGimme$: folds 
*** FLOP *** [8s 7h 5h]
Ohpeel: bets $10
Venomous100%: raises $21 to $31
Ohpeel: folds 
Uncalled bet ($21) returned to Venomous100%
Venomous100% collected $40.11 from pot
Venomous100%: doesn't show hand 
*** SUMMARY ***
Total pot $42 | Rake $1.89 
Board [8s 7h 5h]
Seat 1: UShallGimme$ folded before Flop
Seat 2: matiko09 folded before Flop (didn't bet)
Seat 3: Sweden_Pound folded before Flop (didn't bet)
Seat 4: Venomous100% collected ($40.11)
Seat 5: Kukuryzka folded before Flop (didn't bet)
Seat 6: RoadtoNepal (button) folded before Flop (didn't bet)
Seat 7: Ohpeel (small blind) folded on the Flop
Seat 8: deepblue0000 (big blind) folded before Flop





PokerStars Hand #147755137809:  Hold'em No Limit ($0.50/$1.00 USD) - 2016/01/27 12:08:49 CET [2016/01/27 6:08:49 ET]
Table 'Henyey' 9-max Seat #7 is the button
Seat 1: COOLIKO\/23 ($101.50 in chips) 
Seat 2: pandalapa ($141.63 in chips) 
Seat 3: deepblue0000 ($105.97 in chips) 
Seat 4: sylvian31 ($101.25 in chips) 
Seat 5: matiko09 ($175.33 in chips) 
Seat 6: UShallGimme$ ($109.83 in chips) 
Seat 7: vinniej15 ($53.99 in chips) 
Seat 8: CoolFireX ($111.32 in chips) 
Seat 9: mycka86 ($132.13 in chips) 
CoolFireX: posts small blind $0.50
mycka86: posts big blind $1
*** HOLE CARDS ***
Dealt to matiko09 [Ks Kh]
COOLIKO\/23: folds 
pandalapa: folds 
deepblue0000: folds 
sylvian31: raises $2 to $3
matiko09: raises $6.50 to $9.50
UShallGimme$: folds 
vinniej15: raises $44.49 to $53.99 and is all-in
CoolFireX: folds 
mycka86: folds 
sylvian31: folds 
matiko09: calls $44.49
*** FLOP *** [9s 2d 3h]
*** TURN *** [9s 2d 3h] [3c]
*** RIVER *** [9s 2d 3h 3c] [Ad]
*** SHOW DOWN ***
matiko09: shows [Ks Kh] (two pair, Kings and Threes)
vinniej15: mucks hand 
matiko09 collected $109.68 from pot
*** SUMMARY ***
Total pot $112.48 | Rake $2.80 
Board [9s 2d 3h 3c Ad]
Seat 1: COOLIKO\/23 folded before Flop (didn't bet)
Seat 2: pandalapa folded before Flop (didn't bet)
Seat 3: deepblue0000 folded before Flop (didn't bet)
Seat 4: sylvian31 folded before Flop
Seat 5: matiko09 showed [Ks Kh] and won ($109.68) with two pair, Kings and Threes
Seat 6: UShallGimme$ folded before Flop (didn't bet)
Seat 7: vinniej15 (button) mucked [Th Jc]
Seat 8: CoolFireX (small blind) folded before Flop
Seat 9: mycka86 (big blind) folded before Flop





PokerStars Hand #147755140794:  Hold'em No Limit ($0.50/$1.00 USD) - 2016/01/27 12:08:55 CET [2016/01/27 6:08:55 ET]
Table 'Dollfus' 9-max Seat #2 is the button
Seat 1: masaytoo ($124.57 in chips) 
Seat 2: nosoant ($68.08 in chips) 
Seat 3: UShallGimme$ ($121.36 in chips) 
Seat 4: matiko09 ($108.04 in chips) 
Seat 5: pandalapa ($220.48 in chips) 
Seat 6: deepblue0000 ($101.96 in chips) 
Seat 7: Dödi123 ($206.61 in chips) 
Seat 8: Venomous100% ($109.77 in chips) 
Seat 9: COOLIKO\/23 ($123.21 in chips) 
UShallGimme$: posts small blind $0.50
matiko09: posts big blind $1
*** HOLE CARDS ***
Dealt to matiko09 [4s 9d]
pandalapa: folds 
deepblue0000: folds 
Dödi123: folds 
Venomous100%: folds 
COOLIKO\/23: folds 
masaytoo: raises $1.50 to $2.50
nosoant: calls $2.50
UShallGimme$: calls $2
matiko09: folds 
*** FLOP *** [Qd 6c 4d]
UShallGimme$: bets $5
masaytoo: folds 
nosoant: folds 
Uncalled bet ($5) returned to UShallGimme$
UShallGimme$ collected $8.12 from pot
UShallGimme$: doesn't show hand 
*** SUMMARY ***
Total pot $8.50 | Rake $0.38 
Board [Qd 6c 4d]
Seat 1: masaytoo folded on the Flop
Seat 2: nosoant (button) folded on the Flop
Seat 3: UShallGimme$ (small blind) collected ($8.12)
Seat 4: matiko09 (big blind) folded before Flop
Seat 5: pandalapa folded before Flop (didn't bet)
Seat 6: deepblue0000 folded before Flop (didn't bet)
Seat 7: Dödi123 folded before Flop (didn't bet)
Seat 8: Venomous100% folded before Flop (didn't bet)
Seat 9: COOLIKO\/23 folded before Flop (didn't bet)





PokerStars Hand #147755146123:  Hold'em No Limit ($0.50/$1.00 USD) - 2016/01/27 12:09:05 CET [2016/01/27 6:09:05 ET]
Table 'Delphinus II' 9-max Seat #6 is the button
Seat 3: deepblue0000 ($446.03 in chips) 
Seat 4: matiko09 ($100 in chips) 
Seat 5: pandalapa ($104.89 in chips) 
Seat 6: Sweden_Pound ($146.14 in chips) 
Seat 7: RUS)Timur ($127.35 in chips) 
Seat 8: mycka86 ($107.52 in chips) 
RUS)Timur: posts small blind $0.50
mycka86: posts big blind $1
Saintreine: sits out 
*** HOLE CARDS ***
Dealt to matiko09 [Jh 7s]
deepblue0000: folds 
matiko09: folds 
pandalapa: folds 
Sweden_Pound: folds 
RUS)Timur: raises $2 to $3
mycka86: folds 
Uncalled bet ($2) returned to RUS)Timur
RUS)Timur collected $2 from pot
RUS)Timur: doesn't show hand 
*** SUMMARY ***
Total pot $2 | Rake $0 
Seat 3: deepblue0000 folded before Flop (didn't bet)
Seat 4: matiko09 folded before Flop (didn't bet)
Seat 5: pandalapa folded before Flop (didn't bet)
Seat 6: Sweden_Pound (button) folded before Flop (didn't bet)
Seat 7: RUS)Timur (small blind) collected ($2)
Seat 8: mycka86 (big blind) folded before Flop





PokerStars Hand #147755148903:  Hold'em No Limit ($1/$2 USD) - 2016/01/27 12:09:10 CET [2016/01/27 6:09:10 ET]
Table 'Phobos II' 9-max Seat #8 is the button
Seat 1: LRV21 ($616.76 in chips) 
Seat 3: sylvian31 ($248.20 in chips) 
Seat 4: flk.Dasas ($200 in chips) 
Seat 5: tipner ($200 in chips) 
Seat 6: matiko09 ($276.87 in chips) 
Seat 7: Venomous100% ($386.33 in chips) 
Seat 8: RoadtoNepal ($200 in chips) 
Seat 9: Kukuryzka ($288.36 in chips) 
Kukuryzka: posts small blind $1
LRV21: posts big blind $2
*** HOLE CARDS ***
Dealt to matiko09 [2c 6s]
sylvian31: folds 
flk.Dasas: folds 
tipner: raises $4 to $6
matiko09: folds 
Venomous100%: calls $6
RoadtoNepal: folds 
Kukuryzka: folds 
LRV21: folds 
*** FLOP *** [7h 7s 9h]
tipner: bets $5
Venomous100%: raises $8 to $13
tipner: calls $8
*** TURN *** [7h 7s 9h] [Kd]
tipner: checks 
Venomous100%: bets $25.85
tipner: calls $25.85
*** RIVER *** [7h 7s 9h Kd] [5c]
tipner: checks 
Venomous100%: bets $60
tipner: folds 
Uncalled bet ($60) returned to Venomous100%
Venomous100% collected $89.90 from pot
Venomous100%: doesn't show hand 
*** SUMMARY ***
Total pot $92.70 | Rake $2.80 
Board [7h 7s 9h Kd 5c]
Seat 1: LRV21 (big blind) folded before Flop
Seat 3: sylvian31 folded before Flop (didn't bet)
Seat 4: flk.Dasas folded before Flop (didn't bet)
Seat 5: tipner folded on the River
Seat 6: matiko09 folded before Flop (didn't bet)
Seat 7: Venomous100% collected ($89.90)
Seat 8: RoadtoNepal (button) folded before Flop (didn't bet)
Seat 9: Kukuryzka (small blind) folded before Flop





PokerStars Hand #147755152405:  Hold'em No Limit ($0.50/$1.00 USD) - 2016/01/27 12:09:17 CET [2016/01/27 6:09:17 ET]
Table 'Nanking' 9-max Seat #2 is the button
Seat 1: Peu3aHy ($108.54 in chips) 
Seat 2: Dachish ($90.33 in chips) 
Seat 3: nuaxin ($106.21 in chips) 
Seat 4: COOLIKO\/23 ($152.54 in chips) 
Seat 5: TheGentleFox ($113.62 in chips) 
Seat 6: Kukuryzka ($110.50 in chips) 
Seat 7: tipner ($108.30 in chips) 
Seat 8: matiko09 ($101.50 in chips) 
Seat 9: Sweden_Pound ($123.68 in chips) 
nuaxin: posts small blind $0.50
COOLIKO\/23: posts big blind $1
*** HOLE CARDS ***
Dealt to matiko09 [Js 9s]
TheGentleFox: raises $1 to $2
Kukuryzka: folds 
tipner: folds 
matiko09: raises $5 to $7
Sweden_Pound: folds 
Peu3aHy: folds 
Dachish: folds 
nuaxin: folds 
COOLIKO\/23: raises $9 to $16
TheGentleFox: folds 
matiko09: calls $9
*** FLOP *** [5h 2c 4s]
COOLIKO\/23: bets $14
matiko09: folds 
Uncalled bet ($14) returned to COOLIKO\/23
COOLIKO\/23 collected $32.95 from pot
COOLIKO\/23: doesn't show hand 
*** SUMMARY ***
Total pot $34.50 | Rake $1.55 
Board [5h 2c 4s]
Seat 1: Peu3aHy folded before Flop (didn't bet)
Seat 2: Dachish (button) folded before Flop (didn't bet)
Seat 3: nuaxin (small blind) folded before Flop
Seat 4: COOLIKO\/23 (big blind) collected ($32.95)
Seat 5: TheGentleFox folded before Flop
Seat 6: Kukuryzka folded before Flop (didn't bet)
Seat 7: tipner folded before Flop (didn't bet)
Seat 8: matiko09 folded on the Flop
Seat 9: Sweden_Pound folded before Flop (didn't bet)





PokerStars Hand #147755159663:  Hold'em No Limit ($0.50/$1.00 USD) - 2016/01/27 12:09:31 CET [2016/01/27 6:09:31 ET]
Table 'Alkmene II' 9-max Seat #1 is the button
Seat 1: matiko09 ($108.61 in chips) 
Seat 2: deepblue0000 ($104.18 in chips) 
Seat 4: CoolFireX ($155.36 in chips) 
Seat 5: Sweden_Pound ($112.55 in chips) 
Seat 6: Peu3aHy ($123.22 in chips) 
Seat 7: mycka86 ($100 in chips) 
Seat 8: fecsok1 ($114.34 in chips) 
Seat 9: pandalapa ($105.62 in chips) 
deepblue0000: posts small blind $0.50
CoolFireX: posts big blind $1
*** HOLE CARDS ***
Dealt to matiko09 [Ah Kh]
Sweden_Pound: raises $2 to $3
Peu3aHy: raises $4 to $7
mycka86: folds 
fecsok1: folds 
pandalapa: folds 
matiko09: raises $9 to $16
deepblue0000: folds 
CoolFireX: folds 
Sweden_Pound: folds 
Peu3aHy: folds 
Uncalled bet ($9) returned to matiko09
matiko09 collected $18.50 from pot
matiko09: doesn't show hand 
*** SUMMARY ***
Total pot $18.50 | Rake $0 
Seat 1: matiko09 (button) collected ($18.50)
Seat 2: deepblue0000 (small blind) folded before Flop
Seat 4: CoolFireX (big blind) folded before Flop
Seat 5: Sweden_Pound folded before Flop
Seat 6: Peu3aHy folded before Flop
Seat 7: mycka86 folded before Flop (didn't bet)
Seat 8: fecsok1 folded before Flop (didn't bet)
Seat 9: pandalapa folded before Flop (didn't bet)





PokerStars Hand #147755160842:  Hold'em No Limit ($0.50/$1.00 USD) - 2016/01/27 12:09:33 CET [2016/01/27 6:09:33 ET]
Table 'Marlu II' 9-max Seat #9 is the button
Seat 1: Kukuryzka ($107.95 in chips) 
Seat 2: matiko09 ($100 in chips) 
Seat 3: COOLIKO\/23 ($100 in chips) 
Seat 4: tipner ($101.50 in chips) 
Seat 5: Sweden_Pound ($100 in chips) 
Seat 6: LIGOPSIXIS78 ($63.33 in chips) 
Seat 7: UShallGimme$ ($100 in chips) 
Seat 8: Peu3aHy ($100 in chips) 
Seat 9: platinium1 ($59.92 in chips) 
Kukuryzka: posts small blind $0.50
matiko09: posts big blind $1
*** HOLE CARDS ***
Dealt to matiko09 [9c 7c]
COOLIKO\/23: folds 
tipner: raises $2 to $3
Sweden_Pound: folds 
LIGOPSIXIS78: folds 
UShallGimme$: folds 
Peu3aHy: folds 
platinium1: calls $3
Kukuryzka: folds 
matiko09: folds 
*** FLOP *** [5c Kh 2d]
tipner: checks 
platinium1: bets $4
tipner: calls $4
*** TURN *** [5c Kh 2d] [Th]
tipner: checks 
platinium1: checks 
*** RIVER *** [5c Kh 2d Th] [3c]
tipner: bets $5
platinium1: calls $5
*** SHOW DOWN ***
tipner: shows [9h 9s] (a pair of Nines)
platinium1: shows [Jc Kd] (a pair of Kings)
platinium1 collected $24.35 from pot
*** SUMMARY ***
Total pot $25.50 | Rake $1.15 
Board [5c Kh 2d Th 3c]
Seat 1: Kukuryzka (small blind) folded before Flop
Seat 2: matiko09 (big blind) folded before Flop
Seat 3: COOLIKO\/23 folded before Flop (didn't bet)
Seat 4: tipner showed [9h 9s] and lost with a pair of Nines
Seat 5: Sweden_Pound folded before Flop (didn't bet)
Seat 6: LIGOPSIXIS78 folded before Flop (didn't bet)
Seat 7: UShallGimme$ folded before Flop (didn't bet)
Seat 8: Peu3aHy folded before Flop (didn't bet)
Seat 9: platinium1 (button) showed [Jc Kd] and won ($24.35) with a pair of Kings





PokerStars Hand #147755160763:  Hold'em No Limit ($0.50/$1.00 USD) - 2016/01/27 12:09:33 CET [2016/01/27 6:09:33 ET]
Table 'Delphinus II' 9-max Seat #7 is the button
Seat 1: Saintreine ($152.41 in chips) 
Seat 3: deepblue0000 ($446.03 in chips) 
Seat 4: matiko09 ($100 in chips) 
Seat 5: pandalapa ($104.89 in chips) 
Seat 6: Sweden_Pound ($146.14 in chips) 
Seat 7: RUS)Timur ($128.35 in chips) 
Seat 8: mycka86 ($106.52 in chips) 
mycka86: posts small blind $0.50
Saintreine: posts big blind $1
*** HOLE CARDS ***
Dealt to matiko09 [Jd Kc]
deepblue0000: folds 
matiko09: raises $2 to $3
pandalapa: folds 
Sweden_Pound: folds 
RUS)Timur: folds 
mycka86: folds 
Saintreine: folds 
Uncalled bet ($2) returned to matiko09
matiko09 collected $2.50 from pot
matiko09: doesn't show hand 
*** SUMMARY ***
Total pot $2.50 | Rake $0 
Seat 1: Saintreine (big blind) folded before Flop
Seat 3: deepblue0000 folded before Flop (didn't bet)
Seat 4: matiko09 collected ($2.50)
Seat 5: pandalapa folded before Flop (didn't bet)
Seat 6: Sweden_Pound folded before Flop (didn't bet)
Seat 7: RUS)Timur (button) folded before Flop (didn't bet)
Seat 8: mycka86 (small blind) folded before Flop





PokerStars Hand #147755162466:  Hold'em No Limit ($0.50/$1.00 USD) - 2016/01/27 12:09:36 CET [2016/01/27 6:09:36 ET]
Table 'Henyey' 9-max Seat #8 is the button
Seat 1: COOLIKO\/23 ($101.50 in chips) 
Seat 2: pandalapa ($141.63 in chips) 
Seat 3: deepblue0000 ($105.97 in chips) 
Seat 4: sylvian31 ($100 in chips) 
Seat 5: matiko09 ($231.02 in chips) 
Seat 6: UShallGimme$ ($109.83 in chips) 
Seat 8: CoolFireX ($110.82 in chips) 
Seat 9: mycka86 ($131.13 in chips) 
mycka86: posts small blind $0.50
COOLIKO\/23: posts big blind $1
*** HOLE CARDS ***
Dealt to matiko09 [8d 6s]
pandalapa: folds 
vinniej15 leaves the table
deepblue0000: folds 
Kukuryzka joins the table at seat #7 
Kukuryzka leaves the table
sylvian31: folds 
Sweden_Pound joins the table at seat #7 
matiko09: folds 
UShallGimme$: folds 
CoolFireX: raises $1.50 to $2.50
mycka86: folds 
COOLIKO\/23: folds 
Uncalled bet ($1.50) returned to CoolFireX
CoolFireX collected $2.50 from pot
CoolFireX: doesn't show hand 
*** SUMMARY ***
Total pot $2.50 | Rake $0 
Seat 1: COOLIKO\/23 (big blind) folded before Flop
Seat 2: pandalapa folded before Flop (didn't bet)
Seat 3: deepblue0000 folded before Flop (didn't bet)
Seat 4: sylvian31 folded before Flop (didn't bet)
Seat 5: matiko09 folded before Flop (didn't bet)
Seat 6: UShallGimme$ folded before Flop (didn't bet)
Seat 8: CoolFireX (button) collected ($2.50)
Seat 9: mycka86 (small blind) folded before Flop





PokerStars Hand #147755163224:  Hold'em No Limit ($0.50/$1.00 USD) - 2016/01/27 12:09:38 CET [2016/01/27 6:09:38 ET]
Table 'Dollfus' 9-max Seat #3 is the button
Seat 1: masaytoo ($122.07 in chips) 
Seat 2: nosoant ($65.58 in chips) 
Seat 3: UShallGimme$ ($126.98 in chips) 
Seat 4: matiko09 ($107.04 in chips) 
Seat 5: pandalapa ($220.48 in chips) 
Seat 6: deepblue0000 ($101.96 in chips) 
Seat 7: Dödi123 ($206.61 in chips) 
Seat 8: Venomous100% ($109.77 in chips) 
Seat 9: COOLIKO\/23 ($123.21 in chips) 
matiko09: posts small blind $0.50
pandalapa: posts big blind $1
*** HOLE CARDS ***
Dealt to matiko09 [5d Ad]
deepblue0000: folds 
Dödi123: folds 
Venomous100%: folds 
COOLIKO\/23: folds 
masaytoo: folds 
nosoant: folds 
UShallGimme$: raises $1 to $2
matiko09: raises $6 to $8
pandalapa: folds 
UShallGimme$: folds 
Uncalled bet ($6) returned to matiko09
matiko09 collected $5 from pot
matiko09: doesn't show hand 
*** SUMMARY ***
Total pot $5 | Rake $0 
Seat 1: masaytoo folded before Flop (didn't bet)
Seat 2: nosoant folded before Flop (didn't bet)
Seat 3: UShallGimme$ (button) folded before Flop
Seat 4: matiko09 (small blind) collected ($5)
Seat 5: pandalapa (big blind) folded before Flop
Seat 6: deepblue0000 folded before Flop (didn't bet)
Seat 7: Dödi123 folded before Flop (didn't bet)
Seat 8: Venomous100% folded before Flop (didn't bet)
Seat 9: COOLIKO\/23 folded before Flop (didn't bet)





PokerStars Hand #147755172404:  Hold'em No Limit ($0.50/$1.00 USD) - 2016/01/27 12:09:55 CET [2016/01/27 6:09:55 ET]
Table 'Klemola' 9-max Seat #9 is the button
Seat 1: COOLIKO\/23 ($100 in chips) 
Seat 2: Kukuryzka ($100 in chips) 
Seat 4: RWasin17 ($98 in chips) 
Seat 5: tipner ($100 in chips) 
Seat 6: sylvian31 ($100 in chips) 
Seat 7: matiko09 ($100 in chips) 
Seat 8: Sweden_Pound ($100 in chips) 
Seat 9: blef1992 ($121.12 in chips) 
COOLIKO\/23: posts small blind $0.50
Kukuryzka: posts big blind $1
greyman571: sits out 
*** HOLE CARDS ***
Dealt to matiko09 [3h 2c]
RWasin17: folds 
tipner: folds 
sylvian31: raises $2 to $3
matiko09: folds 
Sweden_Pound: folds 
blef1992: calls $3
COOLIKO\/23: folds 
Kukuryzka: folds 
*** FLOP *** [Th Qh 7c]
sylvian31: checks 
blef1992: checks 
*** TURN *** [Th Qh 7c] [Kc]
sylvian31: checks 
blef1992: checks 
*** RIVER *** [Th Qh 7c Kc] [8h]
sylvian31: checks 
blef1992: bets $7
sylvian31: folds 
Uncalled bet ($7) returned to blef1992
blef1992 collected $7.16 from pot
blef1992: doesn't show hand 
*** SUMMARY ***
Total pot $7.50 | Rake $0.34 
Board [Th Qh 7c Kc 8h]
Seat 1: COOLIKO\/23 (small blind) folded before Flop
Seat 2: Kukuryzka (big blind) folded before Flop
Seat 4: RWasin17 folded before Flop (didn't bet)
Seat 5: tipner folded before Flop (didn't bet)
Seat 6: sylvian31 folded on the River
Seat 7: matiko09 folded before Flop (didn't bet)
Seat 8: Sweden_Pound folded before Flop (didn't bet)
Seat 9: blef1992 (button) collected ($7.16)





PokerStars Hand #147755176874:  Hold'em No Limit ($0.50/$1.00 USD) - 2016/01/27 12:10:04 CET [2016/01/27 6:10:04 ET]
Table 'Alhajoth' 9-max Seat #7 is the button
Seat 1: UShallGimme$ ($110.45 in chips) 
Seat 2: matiko09 ($105.50 in chips) 
Seat 3: Sweden_Pound ($105.27 in chips) 
Seat 4: Venomous100% ($172.26 in chips) 
Seat 5: Kukuryzka ($109.35 in chips) 
Seat 6: RoadtoNepal ($183.96 in chips) 
Seat 7: Ohpeel ($121.09 in chips) 
Seat 8: deepblue0000 ($132.49 in chips) 
deepblue0000: posts small blind $0.50
UShallGimme$: posts big blind $1
*** HOLE CARDS ***
Dealt to matiko09 [Kd 2c]
matiko09: folds 
Sweden_Pound: folds 
Venomous100%: folds 
Kukuryzka: folds 
RoadtoNepal: folds 
Ohpeel: raises $2 to $3
deepblue0000: folds 
UShallGimme$: folds 
Uncalled bet ($2) returned to Ohpeel
Ohpeel collected $2.50 from pot
Ohpeel: doesn't show hand 
*** SUMMARY ***
Total pot $2.50 | Rake $0 
Seat 1: UShallGimme$ (big blind) folded before Flop
Seat 2: matiko09 folded before Flop (didn't bet)
Seat 3: Sweden_Pound folded before Flop (didn't bet)
Seat 4: Venomous100% folded before Flop (didn't bet)
Seat 5: Kukuryzka folded before Flop (didn't bet)
Seat 6: RoadtoNepal folded before Flop (didn't bet)
Seat 7: Ohpeel (button) collected ($2.50)
Seat 8: deepblue0000 (small blind) folded before Flop





PokerStars Hand #147755180792:  Hold'em No Limit ($0.50/$1.00 USD) - 2016/01/27 12:10:11 CET [2016/01/27 6:10:11 ET]
Table 'Dollfus' 9-max Seat #4 is the button
Seat 1: masaytoo ($122.07 in chips) 
Seat 2: nosoant ($65.58 in chips) 
Seat 3: UShallGimme$ ($124.98 in chips) 
Seat 4: matiko09 ($110.04 in chips) 
Seat 5: pandalapa ($219.48 in chips) 
Seat 6: deepblue0000 ($101.96 in chips) 
Seat 7: Dödi123 ($206.61 in chips) 
Seat 8: Venomous100% ($109.77 in chips) 
Seat 9: COOLIKO\/23 ($123.21 in chips) 
pandalapa: posts small blind $0.50
deepblue0000: posts big blind $1
*** HOLE CARDS ***
Dealt to matiko09 [4c 3h]
Dödi123: folds 
Venomous100%: folds 
COOLIKO\/23: raises $2 to $3
masaytoo: folds 
nosoant: calls $3
UShallGimme$: folds 
matiko09: folds 
pandalapa: folds 
deepblue0000: folds 
*** FLOP *** [Jc 6d 5d]
COOLIKO\/23: bets $4
nosoant: folds 
Uncalled bet ($4) returned to COOLIKO\/23
COOLIKO\/23 collected $7.16 from pot
COOLIKO\/23: doesn't show hand 
*** SUMMARY ***
Total pot $7.50 | Rake $0.34 
Board [Jc 6d 5d]
Seat 1: masaytoo folded before Flop (didn't bet)
Seat 2: nosoant folded on the Flop
Seat 3: UShallGimme$ folded before Flop (didn't bet)
Seat 4: matiko09 (button) folded before Flop (didn't bet)
Seat 5: pandalapa (small blind) folded before Flop
Seat 6: deepblue0000 (big blind) folded before Flop
Seat 7: Dödi123 folded before Flop (didn't bet)
Seat 8: Venomous100% folded before Flop (didn't bet)
Seat 9: COOLIKO\/23 collected ($7.16)





PokerStars Hand #147755181707:  Hold'em No Limit ($0.50/$1.00 USD) - 2016/01/27 12:10:13 CET [2016/01/27 6:10:13 ET]
Table 'Delphinus II' 9-max Seat #8 is the button
Seat 1: Saintreine ($151.41 in chips) 
Seat 3: deepblue0000 ($446.03 in chips) 
Seat 4: matiko09 ($101.50 in chips) 
Seat 5: pandalapa ($104.89 in chips) 
Seat 6: Sweden_Pound ($146.14 in chips) 
Seat 7: RUS)Timur ($128.35 in chips) 
Seat 8: mycka86 ($106.02 in chips) 
Saintreine: posts small blind $0.50
deepblue0000: posts big blind $1
*** HOLE CARDS ***
Dealt to matiko09 [Jc Tc]
matiko09: raises $2 to $3
pandalapa: folds 
Sweden_Pound: folds 
RUS)Timur: folds 
mycka86: raises $6.50 to $9.50
Saintreine: folds 
deepblue0000: folds 
matiko09: folds 
Uncalled bet ($6.50) returned to mycka86
mycka86 collected $7.50 from pot
*** SUMMARY ***
Total pot $7.50 | Rake $0 
Seat 1: Saintreine (small blind) folded before Flop
Seat 3: deepblue0000 (big blind) folded before Flop
Seat 4: matiko09 folded before Flop
Seat 5: pandalapa folded before Flop (didn't bet)
Seat 6: Sweden_Pound folded before Flop (didn't bet)
Seat 7: RUS)Timur folded before Flop (didn't bet)
Seat 8: mycka86 (button) collected ($7.50)





PokerStars Hand #147755182202:  Hold'em No Limit ($0.50/$1.00 USD) - 2016/01/27 12:10:14 CET [2016/01/27 6:10:14 ET]
Table 'Henyey' 9-max Seat #9 is the button
Seat 1: COOLIKO\/23 ($100.50 in chips) 
Seat 2: pandalapa ($141.63 in chips) 
Seat 3: deepblue0000 ($105.97 in chips) 
Seat 4: sylvian31 ($100 in chips) 
Seat 5: matiko09 ($231.02 in chips) 
Seat 6: UShallGimme$ ($109.83 in chips) 
Seat 8: CoolFireX ($112.32 in chips) 
Seat 9: mycka86 ($130.63 in chips) 
COOLIKO\/23: posts small blind $0.50
pandalapa: posts big blind $1
Sweden_Pound: sits out 
*** HOLE CARDS ***
Dealt to matiko09 [Ts 5s]
deepblue0000: folds 
sylvian31: folds 
matiko09: folds 
UShallGimme$: folds 
CoolFireX: folds 
mycka86: raises $1.10 to $2.10
COOLIKO\/23: folds 
pandalapa: calls $1.10
*** FLOP *** [2c 4s 3c]
pandalapa: checks 
mycka86: bets $3.30
pandalapa: calls $3.30
*** TURN *** [2c 4s 3c] [5c]
pandalapa: checks 
mycka86: checks 
*** RIVER *** [2c 4s 3c 5c] [6h]
pandalapa: checks 
mycka86: checks 
*** SHOW DOWN ***
pandalapa: shows [Tc Ad] (a straight, Deuce to Six)
mycka86: shows [2s As] (a straight, Deuce to Six)
pandalapa collected $5.40 from pot
mycka86 collected $5.39 from pot
*** SUMMARY ***
Total pot $11.30 | Rake $0.51 
Board [2c 4s 3c 5c 6h]
Seat 1: COOLIKO\/23 (small blind) folded before Flop
Seat 2: pandalapa (big blind) showed [Tc Ad] and won ($5.40) with a straight, Deuce to Six
Seat 3: deepblue0000 folded before Flop (didn't bet)
Seat 4: sylvian31 folded before Flop (didn't bet)
Seat 5: matiko09 folded before Flop (didn't bet)
Seat 6: UShallGimme$ folded before Flop (didn't bet)
Seat 8: CoolFireX folded before Flop (didn't bet)
Seat 9: mycka86 (button) showed [2s As] and won ($5.39) with a straight, Deuce to Six





PokerStars Hand #147755184250:  Hold'em No Limit ($0.50/$1.00 USD) - 2016/01/27 12:10:18 CET [2016/01/27 6:10:18 ET]
Table 'Alkmene II' 9-max Seat #2 is the button
Seat 1: matiko09 ($120.11 in chips) 
Seat 2: deepblue0000 ($103.68 in chips) 
Seat 4: CoolFireX ($154.36 in chips) 
Seat 5: Sweden_Pound ($109.55 in chips) 
Seat 6: Peu3aHy ($116.22 in chips) 
Seat 7: mycka86 ($100 in chips) 
Seat 8: fecsok1 ($114.34 in chips) 
Seat 9: pandalapa ($105.62 in chips) 
CoolFireX: posts small blind $0.50
Sweden_Pound: posts big blind $1
*** HOLE CARDS ***
Dealt to matiko09 [6h Jd]
Peu3aHy: raises $2 to $3
mycka86: folds 
fecsok1: folds 
pandalapa: folds 
matiko09: folds 
deepblue0000: folds 
CoolFireX: folds 
Sweden_Pound: folds 
Uncalled bet ($2) returned to Peu3aHy
Peu3aHy collected $2.50 from pot
Peu3aHy: doesn't show hand 
*** SUMMARY ***
Total pot $2.50 | Rake $0 
Seat 1: matiko09 folded before Flop (didn't bet)
Seat 2: deepblue0000 (button) folded before Flop (didn't bet)
Seat 4: CoolFireX (small blind) folded before Flop
Seat 5: Sweden_Pound (big blind) folded before Flop
Seat 6: Peu3aHy collected ($2.50)
Seat 7: mycka86 folded before Flop (didn't bet)
Seat 8: fecsok1 folded before Flop (didn't bet)
Seat 9: pandalapa folded before Flop (didn't bet)





PokerStars Hand #147755187251:  Hold'em No Limit ($0.50/$1.00 USD) - 2016/01/27 12:10:23 CET [2016/01/27 6:10:23 ET]
Table 'Nanking' 9-max Seat #3 is the button
Seat 1: Peu3aHy ($108.54 in chips) 
Seat 2: Dachish ($90.33 in chips) 
Seat 3: nuaxin ($105.71 in chips) 
Seat 4: COOLIKO\/23 ($169.49 in chips) 
Seat 5: TheGentleFox ($111.62 in chips) 
Seat 6: Kukuryzka ($110.50 in chips) 
Seat 7: tipner ($108.30 in chips) 
Seat 8: matiko09 ($100 in chips) 
Seat 9: Sweden_Pound ($123.68 in chips) 
COOLIKO\/23: posts small blind $0.50
TheGentleFox: posts big blind $1
*** HOLE CARDS ***
Dealt to matiko09 [6h 3c]
Kukuryzka: folds 
tipner: raises $2 to $3
matiko09: folds 
Sweden_Pound: folds 
Peu3aHy: folds 
Dachish: folds 
nuaxin: raises $2 to $5
COOLIKO\/23: folds 
TheGentleFox: folds 
tipner: calls $2
*** FLOP *** [Ac 7h 5s]
tipner: checks 
nuaxin: bets $5.49
tipner: folds 
Uncalled bet ($5.49) returned to nuaxin
nuaxin collected $10.98 from pot
nuaxin: doesn't show hand 
*** SUMMARY ***
Total pot $11.50 | Rake $0.52 
Board [Ac 7h 5s]
Seat 1: Peu3aHy folded before Flop (didn't bet)
Seat 2: Dachish folded before Flop (didn't bet)
Seat 3: nuaxin (button) collected ($10.98)
Seat 4: COOLIKO\/23 (small blind) folded before Flop
Seat 5: TheGentleFox (big blind) folded before Flop
Seat 6: Kukuryzka folded before Flop (didn't bet)
Seat 7: tipner folded on the Flop
Seat 8: matiko09 folded before Flop (didn't bet)
Seat 9: Sweden_Pound folded before Flop (didn't bet)





PokerStars Hand #147755187659:  Hold'em No Limit ($0.50/$1.00 USD) - 2016/01/27 12:10:24 CET [2016/01/27 6:10:24 ET]
Table 'Fragaria II' 9-max Seat #6 is the button
Seat 1: deepblue0000 ($100 in chips) 
Seat 2: GG-NoR34D. ($70.80 in chips) 
Seat 3: Sweden_Pound ($100 in chips) 
Seat 5: Venomous100% ($169.04 in chips) 
Seat 6: UShallGimme$ ($181.99 in chips) 
Seat 7: Hobby-.-AK ($53.49 in chips) 
Seat 8: mycka86 ($105.89 in chips) 
Seat 9: matiko09 ($100 in chips) 
Hobby-.-AK: posts small blind $0.50
mycka86: posts big blind $1
*** HOLE CARDS ***
Dealt to matiko09 [4c 4h]
matiko09: raises $2 to $3
deepblue0000: folds 
GG-NoR34D.: calls $3
Sweden_Pound: folds 
Venomous100%: calls $3
UShallGimme$: folds 
Hobby-.-AK: folds 
mycka86: folds 
*** FLOP *** [3c 9d Ad]
matiko09: checks 
GG-NoR34D.: bets $3
Venomous100%: calls $3
matiko09: folds 
*** TURN *** [3c 9d Ad] [Js]
GG-NoR34D.: bets $7.83
Venomous100%: folds 
Uncalled bet ($7.83) returned to GG-NoR34D.
GG-NoR34D. collected $15.76 from pot
*** SUMMARY ***
Total pot $16.50 | Rake $0.74 
Board [3c 9d Ad Js]
Seat 1: deepblue0000 folded before Flop (didn't bet)
Seat 2: GG-NoR34D. collected ($15.76)
Seat 3: Sweden_Pound folded before Flop (didn't bet)
Seat 5: Venomous100% folded on the Turn
Seat 6: UShallGimme$ (button) folded before Flop (didn't bet)
Seat 7: Hobby-.-AK (small blind) folded before Flop
Seat 8: mycka86 (big blind) folded before Flop
Seat 9: matiko09 folded on the Flop





PokerStars Hand #147755196540:  Hold'em No Limit ($0.50/$1.00 USD) - 2016/01/27 12:10:41 CET [2016/01/27 6:10:41 ET]
Table 'Alhajoth' 9-max Seat #8 is the button
Seat 1: UShallGimme$ ($109.45 in chips) 
Seat 2: matiko09 ($105.50 in chips) 
Seat 3: Sweden_Pound ($105.27 in chips) 
Seat 4: Venomous100% ($172.26 in chips) 
Seat 5: Kukuryzka ($109.35 in chips) 
Seat 6: RoadtoNepal ($183.96 in chips) 
Seat 7: Ohpeel ($122.59 in chips) 
Seat 8: deepblue0000 ($131.99 in chips) 
UShallGimme$: posts small blind $0.50
matiko09: posts big blind $1
*** HOLE CARDS ***
Dealt to matiko09 [7h 4s]
Sweden_Pound: folds 
Venomous100%: folds 
Kukuryzka: folds 
RoadtoNepal: folds 
Ohpeel: raises $2 to $3
deepblue0000: calls $3
UShallGimme$: raises $12 to $15
matiko09: folds 
Ohpeel: folds 
deepblue0000: folds 
Uncalled bet ($12) returned to UShallGimme$
UShallGimme$ collected $10 from pot
UShallGimme$: doesn't show hand 
*** SUMMARY ***
Total pot $10 | Rake $0 
Seat 1: UShallGimme$ (small blind) collected ($10)
Seat 2: matiko09 (big blind) folded before Flop
Seat 3: Sweden_Pound folded before Flop (didn't bet)
Seat 4: Venomous100% folded before Flop (didn't bet)
Seat 5: Kukuryzka folded before Flop (didn't bet)
Seat 6: RoadtoNepal folded before Flop (didn't bet)
Seat 7: Ohpeel folded before Flop
Seat 8: deepblue0000 (button) folded before Flop





PokerStars Hand #147755198826:  Hold'em No Limit ($0.50/$1.00 USD) - 2016/01/27 12:10:46 CET [2016/01/27 6:10:46 ET]
Table 'Dollfus' 9-max Seat #5 is the button
Seat 1: masaytoo ($122.07 in chips) 
Seat 2: nosoant ($62.58 in chips) 
Seat 3: UShallGimme$ ($124.98 in chips) 
Seat 4: matiko09 ($110.04 in chips) 
Seat 5: pandalapa ($218.98 in chips) 
Seat 6: deepblue0000 ($100.96 in chips) 
Seat 7: Dödi123 ($206.61 in chips) 
Seat 8: Venomous100% ($109.77 in chips) 
Seat 9: COOLIKO\/23 ($127.37 in chips) 
deepblue0000: posts small blind $0.50
Dödi123: posts big blind $1
*** HOLE CARDS ***
Dealt to matiko09 [Qs 8c]
Venomous100%: folds 
COOLIKO\/23: folds 
masaytoo: folds 
nosoant: folds 
UShallGimme$: folds 
matiko09: folds 
pandalapa: folds 
deepblue0000: folds 
Uncalled bet ($0.50) returned to Dödi123
Dödi123 collected $1 from pot
Dödi123: doesn't show hand 
*** SUMMARY ***
Total pot $1 | Rake $0 
Seat 1: masaytoo folded before Flop (didn't bet)
Seat 2: nosoant folded before Flop (didn't bet)
Seat 3: UShallGimme$ folded before Flop (didn't bet)
Seat 4: matiko09 folded before Flop (didn't bet)
Seat 5: pandalapa (button) folded before Flop (didn't bet)
Seat 6: deepblue0000 (small blind) folded before Flop
Seat 7: Dödi123 (big blind) collected ($1)
Seat 8: Venomous100% folded before Flop (didn't bet)
Seat 9: COOLIKO\/23 folded before Flop (didn't bet)





PokerStars Hand #147755201907:  Hold'em No Limit ($0.50/$1.00 USD) - 2016/01/27 12:10:51 CET [2016/01/27 6:10:51 ET]
Table 'Alkmene II' 9-max Seat #4 is the button
Seat 1: matiko09 ($120.11 in chips) 
Seat 2: deepblue0000 ($103.68 in chips) 
Seat 4: CoolFireX ($153.86 in chips) 
Seat 5: Sweden_Pound ($108.55 in chips) 
Seat 6: Peu3aHy ($117.72 in chips) 
Seat 7: mycka86 ($100 in chips) 
Seat 8: fecsok1 ($114.34 in chips) 
Seat 9: pandalapa ($105.62 in chips) 
Sweden_Pound: posts small blind $0.50
Peu3aHy: posts big blind $1
*** HOLE CARDS ***
Dealt to matiko09 [Qd 3s]
mycka86: folds 
fecsok1: folds 
pandalapa: raises $2 to $3
matiko09: folds 
deepblue0000: folds 
CoolFireX: calls $3
Sweden_Pound: folds 
Peu3aHy: folds 
*** FLOP *** [2d Ad 9c]
pandalapa: checks 
CoolFireX: checks 
*** TURN *** [2d Ad 9c] [5d]
pandalapa: bets $5
CoolFireX: calls $5
*** RIVER *** [2d Ad 9c 5d] [Qc]
pandalapa: checks 
CoolFireX: bets $12.53
pandalapa: calls $12.53
*** SHOW DOWN ***
CoolFireX: shows [5h 5c] (three of a kind, Fives)
pandalapa: mucks hand 
CoolFireX collected $40.64 from pot
*** SUMMARY ***
Total pot $42.56 | Rake $1.92 
Board [2d Ad 9c 5d Qc]
Seat 1: matiko09 folded before Flop (didn't bet)
Seat 2: deepblue0000 folded before Flop (didn't bet)
Seat 4: CoolFireX (button) showed [5h 5c] and won ($40.64) with three of a kind, Fives
Seat 5: Sweden_Pound (small blind) folded before Flop
Seat 6: Peu3aHy (big blind) folded before Flop
Seat 7: mycka86 folded before Flop (didn't bet)
Seat 8: fecsok1 folded before Flop (didn't bet)
Seat 9: pandalapa mucked [Qh Ac]





PokerStars Hand #147755204363:  Hold'em No Limit ($0.50/$1.00 USD) - 2016/01/27 12:10:56 CET [2016/01/27 6:10:56 ET]
Table 'Delphinus II' 9-max Seat #1 is the button
Seat 1: Saintreine ($150.91 in chips) 
Seat 3: deepblue0000 ($445.03 in chips) 
Seat 4: matiko09 ($100 in chips) 
Seat 5: pandalapa ($104.89 in chips) 
Seat 6: Sweden_Pound ($146.14 in chips) 
Seat 7: RUS)Timur ($128.35 in chips) 
Seat 8: mycka86 ($110.52 in chips) 
deepblue0000: posts small blind $0.50
matiko09: posts big blind $1
*** HOLE CARDS ***
Dealt to matiko09 [8h 6d]
pandalapa: folds 
Sweden_Pound: folds 
RUS)Timur: folds 
mycka86: folds 
Saintreine: folds 
deepblue0000: folds 
Uncalled bet ($0.50) returned to matiko09
matiko09 collected $1 from pot
matiko09: doesn't show hand 
*** SUMMARY ***
Total pot $1 | Rake $0 
Seat 1: Saintreine (button) folded before Flop (didn't bet)
Seat 3: deepblue0000 (small blind) folded before Flop
Seat 4: matiko09 (big blind) collected ($1)
Seat 5: pandalapa folded before Flop (didn't bet)
Seat 6: Sweden_Pound folded before Flop (didn't bet)
Seat 7: RUS)Timur folded before Flop (didn't bet)
Seat 8: mycka86 folded before Flop (didn't bet)





PokerStars Hand #147755207005:  Hold'em No Limit ($0.50/$1.00 USD) - 2016/01/27 12:11:01 CET [2016/01/27 6:11:01 ET]
Table 'Dollfus' 9-max Seat #6 is the button
Seat 1: masaytoo ($122.07 in chips) 
Seat 2: nosoant ($62.58 in chips) 
Seat 3: UShallGimme$ ($124.98 in chips) 
Seat 4: matiko09 ($110.04 in chips) 
Seat 5: pandalapa ($218.98 in chips) 
Seat 6: deepblue0000 ($100.46 in chips) 
Seat 7: Dödi123 ($207.11 in chips) 
Seat 8: Venomous100% ($109.77 in chips) 
Seat 9: COOLIKO\/23 ($127.37 in chips) 
Dödi123: posts small blind $0.50
Venomous100%: posts big blind $1
*** HOLE CARDS ***
Dealt to matiko09 [5c Kd]
COOLIKO\/23: folds 
masaytoo: folds 
nosoant: folds 
UShallGimme$: folds 
matiko09: folds 
pandalapa: folds 
deepblue0000: raises $1.50 to $2.50
Dödi123: folds 
Venomous100%: calls $1.50
*** FLOP *** [Th 8s 9s]
Venomous100%: checks 
deepblue0000: checks 
*** TURN *** [Th 8s 9s] [Kc]
Venomous100%: bets $5.25
deepblue0000: calls $5.25
*** RIVER *** [Th 8s 9s Kc] [Tc]
Venomous100%: checks 
deepblue0000: bets $9
Venomous100%: folds 
Uncalled bet ($9) returned to deepblue0000
deepblue0000 collected $15.28 from pot
*** SUMMARY ***
Total pot $16 | Rake $0.72 
Board [Th 8s 9s Kc Tc]
Seat 1: masaytoo folded before Flop (didn't bet)
Seat 2: nosoant folded before Flop (didn't bet)
Seat 3: UShallGimme$ folded before Flop (didn't bet)
Seat 4: matiko09 folded before Flop (didn't bet)
Seat 5: pandalapa folded before Flop (didn't bet)
Seat 6: deepblue0000 (button) collected ($15.28)
Seat 7: Dödi123 (small blind) folded before Flop
Seat 8: Venomous100% (big blind) folded on the River
Seat 9: COOLIKO\/23 folded before Flop (didn't bet)





PokerStars Hand #147755212649:  Hold'em No Limit ($0.50/$1.00 USD) - 2016/01/27 12:11:12 CET [2016/01/27 6:11:12 ET]
Table 'Klemola' 9-max Seat #1 is the button
Seat 1: COOLIKO\/23 ($100 in chips) 
Seat 2: Kukuryzka ($99 in chips) 
Seat 3: greyman571 ($52 in chips) 
Seat 4: RWasin17 ($98 in chips) 
Seat 5: tipner ($100 in chips) 
Seat 6: sylvian31 ($100 in chips) 
Seat 7: matiko09 ($100 in chips) 
Seat 8: Sweden_Pound ($100 in chips) 
Seat 9: blef1992 ($125.28 in chips) 
Kukuryzka: posts small blind $0.50
greyman571: posts big blind $1
*** HOLE CARDS ***
Dealt to matiko09 [Ah Qh]
RWasin17: folds 
tipner: folds 
sylvian31: folds 
matiko09: raises $2 to $3
Sweden_Pound: folds 
blef1992: folds 
COOLIKO\/23: folds 
Kukuryzka: folds 
greyman571: calls $2
*** FLOP *** [2s Qs 3s]
greyman571: checks 
matiko09: bets $4.04
greyman571: calls $4.04
*** TURN *** [2s Qs 3s] [8c]
greyman571: checks 
matiko09: bets $9.05
greyman571: folds 
Uncalled bet ($9.05) returned to matiko09
matiko09 collected $13.92 from pot
matiko09: doesn't show hand 
*** SUMMARY ***
Total pot $14.58 | Rake $0.66 
Board [2s Qs 3s 8c]
Seat 1: COOLIKO\/23 (button) folded before Flop (didn't bet)
Seat 2: Kukuryzka (small blind) folded before Flop
Seat 3: greyman571 (big blind) folded on the Turn
Seat 4: RWasin17 folded before Flop (didn't bet)
Seat 5: tipner folded before Flop (didn't bet)
Seat 6: sylvian31 folded before Flop (didn't bet)
Seat 7: matiko09 collected ($13.92)
Seat 8: Sweden_Pound folded before Flop (didn't bet)
Seat 9: blef1992 folded before Flop (didn't bet)





PokerStars Hand #147755215446:  Hold'em No Limit ($0.50/$1.00 USD) - 2016/01/27 12:11:17 CET [2016/01/27 6:11:17 ET]
Table 'Marlu II' 9-max Seat #1 is the button
Seat 1: Kukuryzka ($107.45 in chips) 
Seat 2: matiko09 ($100 in chips) 
Seat 3: COOLIKO\/23 ($100 in chips) 
Seat 4: tipner ($100 in chips) 
Seat 5: Sweden_Pound ($100 in chips) 
Seat 6: LIGOPSIXIS78 ($63.33 in chips) 
Seat 7: UShallGimme$ ($100 in chips) 
Seat 8: Peu3aHy ($100 in chips) 
Seat 9: platinium1 ($72.27 in chips) 
matiko09: posts small blind $0.50
COOLIKO\/23: posts big blind $1
*** HOLE CARDS ***
Dealt to matiko09 [Qs Js]
tipner: folds 
Sweden_Pound: folds 
LIGOPSIXIS78: folds 
UShallGimme$: folds 
Peu3aHy: raises $2 to $3
platinium1: folds 
Kukuryzka: folds 
matiko09: raises $7 to $10
COOLIKO\/23: folds 
Peu3aHy: folds 
Uncalled bet ($7) returned to matiko09
matiko09 collected $7 from pot
matiko09: doesn't show hand 
*** SUMMARY ***
Total pot $7 | Rake $0 
Seat 1: Kukuryzka (button) folded before Flop (didn't bet)
Seat 2: matiko09 (small blind) collected ($7)
Seat 3: COOLIKO\/23 (big blind) folded before Flop
Seat 4: tipner folded before Flop (didn't bet)
Seat 5: Sweden_Pound folded before Flop (didn't bet)
Seat 6: LIGOPSIXIS78 folded before Flop (didn't bet)
Seat 7: UShallGimme$ folded before Flop (didn't bet)
Seat 8: Peu3aHy folded before Flop
Seat 9: platinium1 folded before Flop (didn't bet)





PokerStars Hand #147755215617:  Hold'em No Limit ($1/$2 USD) - 2016/01/27 12:11:18 CET [2016/01/27 6:11:18 ET]
Table 'Phobos II' 9-max Seat #9 is the button
Seat 1: LRV21 ($614.76 in chips) 
Seat 3: sylvian31 ($248.20 in chips) 
Seat 4: flk.Dasas ($200 in chips) 
Seat 5: tipner ($200 in chips) 
Seat 6: matiko09 ($276.87 in chips) 
Seat 7: Venomous100% ($431.38 in chips) 
Seat 8: RoadtoNepal ($200 in chips) 
Seat 9: Kukuryzka ($287.36 in chips) 
LRV21: posts small blind $1
sylvian31: posts big blind $2
*** HOLE CARDS ***
Dealt to matiko09 [3d 5c]
flk.Dasas: folds 
tipner: folds 
matiko09: folds 
Venomous100%: folds 
RoadtoNepal: folds 
Kukuryzka: raises $2 to $4
LRV21: calls $3
sylvian31: folds 
*** FLOP *** [9s 5d Kh]
LRV21: bets $8
Kukuryzka: calls $8
*** TURN *** [9s 5d Kh] [7s]
LRV21: bets $24.83
Kukuryzka: folds 
Uncalled bet ($24.83) returned to LRV21
LRV21 collected $24.83 from pot
LRV21: doesn't show hand 
*** SUMMARY ***
Total pot $26 | Rake $1.17 
Board [9s 5d Kh 7s]
Seat 1: LRV21 (small blind) collected ($24.83)
Seat 3: sylvian31 (big blind) folded before Flop
Seat 4: flk.Dasas folded before Flop (didn't bet)
Seat 5: tipner folded before Flop (didn't bet)
Seat 6: matiko09 folded before Flop (didn't bet)
Seat 7: Venomous100% folded before Flop (didn't bet)
Seat 8: RoadtoNepal folded before Flop (didn't bet)
Seat 9: Kukuryzka (button) folded on the Turn





PokerStars Hand #147755219120:  Hold'em No Limit ($0.50/$1.00 USD) - 2016/01/27 12:11:24 CET [2016/01/27 6:11:24 ET]
Table 'Delphinus II' 9-max Seat #3 is the button
Seat 1: Saintreine ($150.91 in chips) 
Seat 3: deepblue0000 ($444.53 in chips) 
Seat 4: matiko09 ($100.50 in chips) 
Seat 5: pandalapa ($104.89 in chips) 
Seat 6: Sweden_Pound ($146.14 in chips) 
Seat 7: RUS)Timur ($128.35 in chips) 
Seat 8: mycka86 ($110.52 in chips) 
matiko09: posts small blind $0.50
pandalapa: posts big blind $1
*** HOLE CARDS ***
Dealt to matiko09 [9h Th]
Sweden_Pound: folds 
RUS)Timur: raises $1.50 to $2.50
mycka86: folds 
Saintreine: folds 
deepblue0000: folds 
matiko09: folds 
pandalapa: folds 
Uncalled bet ($1.50) returned to RUS)Timur
RUS)Timur collected $2.50 from pot
RUS)Timur: doesn't show hand 
*** SUMMARY ***
Total pot $2.50 | Rake $0 
Seat 1: Saintreine folded before Flop (didn't bet)
Seat 3: deepblue0000 (button) folded before Flop (didn't bet)
Seat 4: matiko09 (small blind) folded before Flop
Seat 5: pandalapa (big blind) folded before Flop
Seat 6: Sweden_Pound folded before Flop (didn't bet)
Seat 7: RUS)Timur collected ($2.50)
Seat 8: mycka86 folded before Flop (didn't bet)





PokerStars Hand #147755225670:  Hold'em No Limit ($0.50/$1.00 USD) - 2016/01/27 12:11:37 CET [2016/01/27 6:11:37 ET]
Table 'Nanking' 9-max Seat #4 is the button
Seat 1: Peu3aHy ($108.54 in chips) 
Seat 2: Dachish ($90.33 in chips) 
Seat 3: nuaxin ($111.69 in chips) 
Seat 4: COOLIKO\/23 ($168.99 in chips) 
Seat 5: TheGentleFox ($110.62 in chips) 
Seat 6: Kukuryzka ($110.50 in chips) 
Seat 7: tipner ($103.30 in chips) 
Seat 8: matiko09 ($100 in chips) 
Seat 9: Sweden_Pound ($123.68 in chips) 
TheGentleFox: posts small blind $0.50
Kukuryzka: posts big blind $1
*** HOLE CARDS ***
Dealt to matiko09 [5c 7h]
tipner: folds 
matiko09: folds 
Sweden_Pound: folds 
Peu3aHy: folds 
Dachish: raises $1 to $2
nuaxin: folds 
COOLIKO\/23: folds 
TheGentleFox: folds 
Kukuryzka: folds 
Uncalled bet ($1) returned to Dachish
Dachish collected $2.50 from pot
Dachish: doesn't show hand 
*** SUMMARY ***
Total pot $2.50 | Rake $0 
Seat 1: Peu3aHy folded before Flop (didn't bet)
Seat 2: Dachish collected ($2.50)
Seat 3: nuaxin folded before Flop (didn't bet)
Seat 4: COOLIKO\/23 (button) folded before Flop (didn't bet)
Seat 5: TheGentleFox (small blind) folded before Flop
Seat 6: Kukuryzka (big blind) folded before Flop
Seat 7: tipner folded before Flop (didn't bet)
Seat 8: matiko09 folded before Flop (didn't bet)
Seat 9: Sweden_Pound folded before Flop (didn't bet)





PokerStars Hand #147755230314:  Hold'em No Limit ($0.50/$1.00 USD) - 2016/01/27 12:11:46 CET [2016/01/27 6:11:46 ET]
Table 'Alhajoth' 9-max Seat #1 is the button
Seat 1: UShallGimme$ ($116.45 in chips) 
Seat 2: matiko09 ($104.50 in chips) 
Seat 3: Sweden_Pound ($105.27 in chips) 
Seat 4: Venomous100% ($172.26 in chips) 
Seat 5: Kukuryzka ($109.35 in chips) 
Seat 6: RoadtoNepal ($183.96 in chips) 
Seat 7: Ohpeel ($119.59 in chips) 
Seat 8: deepblue0000 ($128.99 in chips) 
matiko09: posts small blind $0.50
Sweden_Pound: posts big blind $1
*** HOLE CARDS ***
Dealt to matiko09 [8s Kd]
Venomous100%: folds 
Kukuryzka: folds 
RoadtoNepal: folds 
Ohpeel: raises $3.50 to $4.50
deepblue0000: folds 
UShallGimme$: folds 
matiko09: folds 
Sweden_Pound: folds 
Uncalled bet ($3.50) returned to Ohpeel
Ohpeel collected $2.50 from pot
Ohpeel: doesn't show hand 
*** SUMMARY ***
Total pot $2.50 | Rake $0 
Seat 1: UShallGimme$ (button) folded before Flop (didn't bet)
Seat 2: matiko09 (small blind) folded before Flop
Seat 3: Sweden_Pound (big blind) folded before Flop
Seat 4: Venomous100% folded before Flop (didn't bet)
Seat 5: Kukuryzka folded before Flop (didn't bet)
Seat 6: RoadtoNepal folded before Flop (didn't bet)
Seat 7: Ohpeel collected ($2.50)
Seat 8: deepblue0000 folded before Flop (didn't bet)





PokerStars Hand #147755233712:  Hold'em No Limit ($0.50/$1.00 USD) - 2016/01/27 12:11:52 CET [2016/01/27 6:11:52 ET]
Table 'Fragaria II' 9-max Seat #7 is the button
Seat 1: deepblue0000 ($100 in chips) 
Seat 2: GG-NoR34D. ($80.56 in chips) 
Seat 3: Sweden_Pound ($100 in chips) 
Seat 5: Venomous100% ($163.04 in chips) 
Seat 6: UShallGimme$ ($181.99 in chips) 
Seat 7: Hobby-.-AK ($52.99 in chips) 
Seat 8: mycka86 ($104.89 in chips) 
Seat 9: matiko09 ($100 in chips) 
mycka86: posts small blind $0.50
matiko09: posts big blind $1
*** HOLE CARDS ***
Dealt to matiko09 [3s 2d]
deepblue0000: folds 
GG-NoR34D.: folds 
Sweden_Pound: folds 
Venomous100%: folds 
UShallGimme$: folds 
Hobby-.-AK: raises $1.50 to $2.50
mycka86: folds 
matiko09: folds 
Uncalled bet ($1.50) returned to Hobby-.-AK
Hobby-.-AK collected $2.50 from pot
*** SUMMARY ***
Total pot $2.50 | Rake $0 
Seat 1: deepblue0000 folded before Flop (didn't bet)
Seat 2: GG-NoR34D. folded before Flop (didn't bet)
Seat 3: Sweden_Pound folded before Flop (didn't bet)
Seat 5: Venomous100% folded before Flop (didn't bet)
Seat 6: UShallGimme$ folded before Flop (didn't bet)
Seat 7: Hobby-.-AK (button) collected ($2.50)
Seat 8: mycka86 (small blind) folded before Flop
Seat 9: matiko09 (big blind) folded before Flop





PokerStars Hand #147755235141:  Hold'em No Limit ($0.50/$1.00 USD) - 2016/01/27 12:11:55 CET [2016/01/27 6:11:55 ET]
Table 'Delphinus II' 9-max Seat #4 is the button
Seat 1: Saintreine ($150.91 in chips) 
Seat 3: deepblue0000 ($444.53 in chips) 
Seat 4: matiko09 ($100 in chips) 
Seat 5: pandalapa ($103.89 in chips) 
Seat 6: Sweden_Pound ($146.14 in chips) 
Seat 7: RUS)Timur ($129.85 in chips) 
Seat 8: mycka86 ($110.52 in chips) 
pandalapa: posts small blind $0.50
Sweden_Pound: posts big blind $1
*** HOLE CARDS ***
Dealt to matiko09 [7s 2c]
RUS)Timur: folds 
mycka86: folds 
Saintreine: folds 
deepblue0000: raises $1.50 to $2.50
matiko09: folds 
pandalapa: folds 
Sweden_Pound: folds 
Uncalled bet ($1.50) returned to deepblue0000
deepblue0000 collected $2.50 from pot
*** SUMMARY ***
Total pot $2.50 | Rake $0 
Seat 1: Saintreine folded before Flop (didn't bet)
Seat 3: deepblue0000 collected ($2.50)
Seat 4: matiko09 (button) folded before Flop (didn't bet)
Seat 5: pandalapa (small blind) folded before Flop
Seat 6: Sweden_Pound (big blind) folded before Flop
Seat 7: RUS)Timur folded before Flop (didn't bet)
Seat 8: mycka86 folded before Flop (didn't bet)





PokerStars Hand #147755239427:  Hold'em No Limit ($0.50/$1.00 USD) - 2016/01/27 12:12:03 CET [2016/01/27 6:12:03 ET]
Table 'Klemola' 9-max Seat #2 is the button
Seat 1: COOLIKO\/23 ($100 in chips) 
Seat 2: Kukuryzka ($100 in chips) 
Seat 3: greyman571 ($44.96 in chips) 
Seat 4: RWasin17 ($98 in chips) 
Seat 5: tipner ($100 in chips) 
Seat 6: sylvian31 ($100 in chips) 
Seat 7: matiko09 ($106.88 in chips) 
Seat 8: Sweden_Pound ($100 in chips) 
Seat 9: blef1992 ($125.28 in chips) 
greyman571: posts small blind $0.50
RWasin17: posts big blind $1
*** HOLE CARDS ***
Dealt to matiko09 [6d Kc]
tipner: folds 
sylvian31: folds 
matiko09: folds 
Sweden_Pound: folds 
blef1992: folds 
COOLIKO\/23: folds 
Kukuryzka: folds 
greyman571: folds 
Uncalled bet ($0.50) returned to RWasin17
RWasin17 collected $1 from pot
RWasin17: doesn't show hand 
*** SUMMARY ***
Total pot $1 | Rake $0 
Seat 1: COOLIKO\/23 folded before Flop (didn't bet)
Seat 2: Kukuryzka (button) folded before Flop (didn't bet)
Seat 3: greyman571 (small blind) folded before Flop
Seat 4: RWasin17 (big blind) collected ($1)
Seat 5: tipner folded before Flop (didn't bet)
Seat 6: sylvian31 folded before Flop (didn't bet)
Seat 7: matiko09 folded before Flop (didn't bet)
Seat 8: Sweden_Pound folded before Flop (didn't bet)
Seat 9: blef1992 folded before Flop (didn't bet)





PokerStars Hand #147755243617:  Hold'em No Limit ($0.50/$1.00 USD) - 2016/01/27 12:12:11 CET [2016/01/27 6:12:11 ET]
Table 'Dollfus' 9-max Seat #7 is the button
Seat 1: masaytoo ($122.07 in chips) 
Seat 2: nosoant ($62.58 in chips) 
Seat 3: UShallGimme$ ($124.98 in chips) 
Seat 4: matiko09 ($110.04 in chips) 
Seat 5: pandalapa ($218.98 in chips) 
Seat 6: deepblue0000 ($107.99 in chips) 
Seat 7: Dödi123 ($206.61 in chips) 
Seat 8: Venomous100% ($102.02 in chips) 
Seat 9: COOLIKO\/23 ($127.37 in chips) 
Venomous100%: posts small blind $0.50
COOLIKO\/23: posts big blind $1
*** HOLE CARDS ***
Dealt to matiko09 [Ah Ts]
masaytoo: folds 
nosoant: calls $1
UShallGimme$: folds 
matiko09: raises $3 to $4
pandalapa: folds 
deepblue0000: folds 
Dödi123: folds 
Venomous100%: folds 
COOLIKO\/23: folds 
nosoant: calls $3
*** FLOP *** [2d Th 4c]
nosoant: checks 
matiko09: bets $6
nosoant: folds 
Uncalled bet ($6) returned to matiko09
matiko09 collected $9.07 from pot
matiko09: doesn't show hand 
*** SUMMARY ***
Total pot $9.50 | Rake $0.43 
Board [2d Th 4c]
Seat 1: masaytoo folded before Flop (didn't bet)
Seat 2: nosoant folded on the Flop
Seat 3: UShallGimme$ folded before Flop (didn't bet)
Seat 4: matiko09 collected ($9.07)
Seat 5: pandalapa folded before Flop (didn't bet)
Seat 6: deepblue0000 folded before Flop (didn't bet)
Seat 7: Dödi123 (button) folded before Flop (didn't bet)
Seat 8: Venomous100% (small blind) folded before Flop
Seat 9: COOLIKO\/23 (big blind) folded before Flop





PokerStars Hand #147755247591:  Hold'em No Limit ($0.50/$1.00 USD) - 2016/01/27 12:12:19 CET [2016/01/27 6:12:19 ET]
Table 'Nanking' 9-max Seat #5 is the button
Seat 1: Peu3aHy ($108.54 in chips) 
Seat 2: Dachish ($91.83 in chips) 
Seat 3: nuaxin ($111.69 in chips) 
Seat 4: COOLIKO\/23 ($168.99 in chips) 
Seat 5: TheGentleFox ($110.12 in chips) 
Seat 6: Kukuryzka ($109.50 in chips) 
Seat 7: tipner ($103.30 in chips) 
Seat 8: matiko09 ($100 in chips) 
Seat 9: Sweden_Pound ($123.68 in chips) 
Kukuryzka: posts small blind $0.50
tipner: posts big blind $1
*** HOLE CARDS ***
Dealt to matiko09 [Ad Ac]
matiko09: raises $2 to $3
Sweden_Pound: folds 
Peu3aHy: folds 
Dachish: folds 
nuaxin: folds 
COOLIKO\/23: folds 
TheGentleFox: folds 
Kukuryzka: folds 
tipner: folds 
Uncalled bet ($2) returned to matiko09
matiko09 collected $2.50 from pot
matiko09: doesn't show hand 
*** SUMMARY ***
Total pot $2.50 | Rake $0 
Seat 1: Peu3aHy folded before Flop (didn't bet)
Seat 2: Dachish folded before Flop (didn't bet)
Seat 3: nuaxin folded before Flop (didn't bet)
Seat 4: COOLIKO\/23 folded before Flop (didn't bet)
Seat 5: TheGentleFox (button) folded before Flop (didn't bet)
Seat 6: Kukuryzka (small blind) folded before Flop
Seat 7: tipner (big blind) folded before Flop
Seat 8: matiko09 collected ($2.50)
Seat 9: Sweden_Pound folded before Flop (didn't bet)





PokerStars Hand #147755248121:  Hold'em No Limit ($0.50/$1.00 USD) - 2016/01/27 12:12:20 CET [2016/01/27 6:12:20 ET]
Table 'Marlu II' 9-max Seat #2 is the button
Seat 1: Kukuryzka ($107.45 in chips) 
Seat 2: matiko09 ($104 in chips) 
Seat 3: COOLIKO\/23 ($100 in chips) 
Seat 4: tipner ($100 in chips) 
Seat 5: Sweden_Pound ($100 in chips) 
Seat 6: LIGOPSIXIS78 ($63.33 in chips) 
Seat 7: UShallGimme$ ($100 in chips) 
Seat 8: Peu3aHy ($100 in chips) 
Seat 9: platinium1 ($72.27 in chips) 
COOLIKO\/23: posts small blind $0.50
tipner: posts big blind $1
*** HOLE CARDS ***
Dealt to matiko09 [7s 3d]
Sweden_Pound: raises $2 to $3
LIGOPSIXIS78: calls $3
UShallGimme$: folds 
Peu3aHy: folds 
platinium1: folds 
Kukuryzka: folds 
matiko09: folds 
COOLIKO\/23: folds 
tipner: calls $2
*** FLOP *** [4s Js 6d]
tipner: checks 
Sweden_Pound: bets $5.90
LIGOPSIXIS78: calls $5.90
tipner: folds 
*** TURN *** [4s Js 6d] [4h]
Sweden_Pound: bets $13.50
LIGOPSIXIS78: calls $13.50
*** RIVER *** [4s Js 6d 4h] [Jh]
Sweden_Pound: checks 
LIGOPSIXIS78: bets $23.06
Sweden_Pound: calls $23.06
*** SHOW DOWN ***
LIGOPSIXIS78: shows [Qc Qs] (two pair, Queens and Jacks)
Sweden_Pound: shows [Kd Kc] (two pair, Kings and Jacks)
Sweden_Pound collected $91.62 from pot
*** SUMMARY ***
Total pot $94.42 | Rake $2.80 
Board [4s Js 6d 4h Jh]
Seat 1: Kukuryzka folded before Flop (didn't bet)
Seat 2: matiko09 (button) folded before Flop (didn't bet)
Seat 3: COOLIKO\/23 (small blind) folded before Flop
Seat 4: tipner (big blind) folded on the Flop
Seat 5: Sweden_Pound showed [Kd Kc] and won ($91.62) with two pair, Kings and Jacks
Seat 6: LIGOPSIXIS78 showed [Qc Qs] and lost with two pair, Queens and Jacks
Seat 7: UShallGimme$ folded before Flop (didn't bet)
Seat 8: Peu3aHy folded before Flop (didn't bet)
Seat 9: platinium1 folded before Flop (didn't bet)





PokerStars Hand #147755248049:  Hold'em No Limit ($0.50/$1.00 USD) - 2016/01/27 12:12:20 CET [2016/01/27 6:12:20 ET]
Table 'Alhajoth' 9-max Seat #2 is the button
Seat 1: UShallGimme$ ($116.45 in chips) 
Seat 2: matiko09 ($104 in chips) 
Seat 3: Sweden_Pound ($104.27 in chips) 
Seat 4: Venomous100% ($172.26 in chips) 
Seat 5: Kukuryzka ($109.35 in chips) 
Seat 6: RoadtoNepal ($183.96 in chips) 
Seat 7: Ohpeel ($121.09 in chips) 
Seat 8: deepblue0000 ($128.99 in chips) 
Sweden_Pound: posts small blind $0.50
Venomous100%: posts big blind $1
*** HOLE CARDS ***
Dealt to matiko09 [5h Th]
Kukuryzka: folds 
RoadtoNepal: folds 
Ohpeel: folds 
deepblue0000: raises $2 to $3
UShallGimme$: folds 
matiko09: folds 
Sweden_Pound: folds 
Venomous100%: folds 
Uncalled bet ($2) returned to deepblue0000
deepblue0000 collected $2.50 from pot
*** SUMMARY ***
Total pot $2.50 | Rake $0 
Seat 1: UShallGimme$ folded before Flop (didn't bet)
Seat 2: matiko09 (button) folded before Flop (didn't bet)
Seat 3: Sweden_Pound (small blind) folded before Flop
Seat 4: Venomous100% (big blind) folded before Flop
Seat 5: Kukuryzka folded before Flop (didn't bet)
Seat 6: RoadtoNepal folded before Flop (didn't bet)
Seat 7: Ohpeel folded before Flop (didn't bet)
Seat 8: deepblue0000 collected ($2.50)





PokerStars Hand #147755248727:  Hold'em No Limit ($0.50/$1.00 USD) - 2016/01/27 12:12:21 CET [2016/01/27 6:12:21 ET]
Table 'Alkmene II' 9-max Seat #5 is the button
Seat 1: matiko09 ($120.11 in chips) 
Seat 2: deepblue0000 ($103.68 in chips) 
Seat 4: CoolFireX ($173.97 in chips) 
Seat 5: Sweden_Pound ($108.05 in chips) 
Seat 6: Peu3aHy ($116.72 in chips) 
Seat 7: mycka86 ($100 in chips) 
Seat 8: fecsok1 ($114.34 in chips) 
Seat 9: pandalapa ($100 in chips) 
Peu3aHy: posts small blind $0.50
mycka86: posts big blind $1
*** HOLE CARDS ***
Dealt to matiko09 [Qd 3h]
fecsok1: folds 
pandalapa: folds 
matiko09: folds 
deepblue0000: folds 
CoolFireX: raises $1.50 to $2.50
Sweden_Pound: folds 
Peu3aHy: folds 
mycka86: calls $1.50
*** FLOP *** [9c Js As]
mycka86: checks 
CoolFireX: checks 
*** TURN *** [9c Js As] [Ah]
mycka86: checks 
CoolFireX: checks 
*** RIVER *** [9c Js As Ah] [7s]
mycka86: bets $6.98
CoolFireX: folds 
Uncalled bet ($6.98) returned to mycka86
mycka86 collected $5.25 from pot
*** SUMMARY ***
Total pot $5.50 | Rake $0.25 
Board [9c Js As Ah 7s]
Seat 1: matiko09 folded before Flop (didn't bet)
Seat 2: deepblue0000 folded before Flop (didn't bet)
Seat 4: CoolFireX folded on the River
Seat 5: Sweden_Pound (button) folded before Flop (didn't bet)
Seat 6: Peu3aHy (small blind) folded before Flop
Seat 7: mycka86 (big blind) collected ($5.25)
Seat 8: fecsok1 folded before Flop (didn't bet)
Seat 9: pandalapa folded before Flop (didn't bet)





PokerStars Hand #147755253571:  Hold'em No Limit ($0.50/$1.00 USD) - 2016/01/27 12:12:30 CET [2016/01/27 6:12:30 ET]
Table 'Fragaria II' 9-max Seat #8 is the button
Seat 1: deepblue0000 ($100 in chips) 
Seat 2: GG-NoR34D. ($80.56 in chips) 
Seat 3: Sweden_Pound ($100 in chips) 
Seat 5: Venomous100% ($163.04 in chips) 
Seat 6: UShallGimme$ ($181.99 in chips) 
Seat 7: Hobby-.-AK ($54.49 in chips) 
Seat 8: mycka86 ($104.39 in chips) 
Seat 9: matiko09 ($100 in chips) 
matiko09: posts small blind $0.50
deepblue0000: posts big blind $1
*** HOLE CARDS ***
Dealt to matiko09 [7s 6c]
GG-NoR34D.: folds 
Sweden_Pound: folds 
Venomous100%: raises $2 to $3
UShallGimme$: folds 
Hobby-.-AK: folds 
mycka86: folds 
matiko09: folds 
deepblue0000: folds 
Uncalled bet ($2) returned to Venomous100%
Venomous100% collected $2.50 from pot
Venomous100%: doesn't show hand 
*** SUMMARY ***
Total pot $2.50 | Rake $0 
Seat 1: deepblue0000 (big blind) folded before Flop
Seat 2: GG-NoR34D. folded before Flop (didn't bet)
Seat 3: Sweden_Pound folded before Flop (didn't bet)
Seat 5: Venomous100% collected ($2.50)
Seat 6: UShallGimme$ folded before Flop (didn't bet)
Seat 7: Hobby-.-AK folded before Flop (didn't bet)
Seat 8: mycka86 (button) folded before Flop (didn't bet)
Seat 9: matiko09 (small blind) folded before Flop





PokerStars Hand #147755255810:  Hold'em No Limit ($0.50/$1.00 USD) - 2016/01/27 12:12:35 CET [2016/01/27 6:12:35 ET]
Table 'Delphinus II' 9-max Seat #5 is the button
Seat 1: Saintreine ($150.91 in chips) 
Seat 3: deepblue0000 ($446.03 in chips) 
Seat 4: matiko09 ($100 in chips) 
Seat 5: pandalapa ($103.39 in chips) 
Seat 6: Sweden_Pound ($145.14 in chips) 
Seat 7: RUS)Timur ($129.85 in chips) 
Seat 8: mycka86 ($110.52 in chips) 
Sweden_Pound: posts small blind $0.50
RUS)Timur: posts big blind $1
*** HOLE CARDS ***
Dealt to matiko09 [8h Ac]
mycka86: folds 
Saintreine: folds 
deepblue0000: folds 
FGL-lucky was removed from the table for failing to post
matiko09: folds 
pandalapa: folds 
Kukuryzka leaves the table
Sweden_Pound: folds 
Uncalled bet ($0.50) returned to RUS)Timur
RUS)Timur collected $1 from pot
RUS)Timur: doesn't show hand 
*** SUMMARY ***
Total pot $1 | Rake $0 
Seat 1: Saintreine folded before Flop (didn't bet)
Seat 3: deepblue0000 folded before Flop (didn't bet)
Seat 4: matiko09 folded before Flop (didn't bet)
Seat 5: pandalapa (button) folded before Flop (didn't bet)
Seat 6: Sweden_Pound (small blind) folded before Flop
Seat 7: RUS)Timur (big blind) collected ($1)
Seat 8: mycka86 folded before Flop (didn't bet)





PokerStars Hand #147755257978:  Hold'em No Limit ($1/$2 USD) - 2016/01/27 12:12:39 CET [2016/01/27 6:12:39 ET]
Table 'Phobos II' 9-max Seat #1 is the button
Seat 1: LRV21 ($627.59 in chips) 
Seat 3: sylvian31 ($246.20 in chips) 
Seat 4: flk.Dasas ($200 in chips) 
Seat 5: tipner ($200 in chips) 
Seat 6: matiko09 ($276.87 in chips) 
Seat 7: Venomous100% ($431.38 in chips) 
Seat 8: RoadtoNepal ($200 in chips) 
Seat 9: Kukuryzka ($275.36 in chips) 
sylvian31: posts small blind $1
flk.Dasas: posts big blind $2
*** HOLE CARDS ***
Dealt to matiko09 [3s 5s]
tipner: folds 
matiko09: folds 
Venomous100%: folds 
RoadtoNepal: folds 
Kukuryzka: folds 
LRV21: raises $4 to $6
sylvian31: folds 
flk.Dasas: folds 
Uncalled bet ($4) returned to LRV21
LRV21 collected $5 from pot
LRV21: doesn't show hand 
*** SUMMARY ***
Total pot $5 | Rake $0 
Seat 1: LRV21 (button) collected ($5)
Seat 3: sylvian31 (small blind) folded before Flop
Seat 4: flk.Dasas (big blind) folded before Flop
Seat 5: tipner folded before Flop (didn't bet)
Seat 6: matiko09 folded before Flop (didn't bet)
Seat 7: Venomous100% folded before Flop (didn't bet)
Seat 8: RoadtoNepal folded before Flop (didn't bet)
Seat 9: Kukuryzka folded before Flop (didn't bet)





PokerStars Hand #147755260699:  Hold'em No Limit ($0.50/$1.00 USD) - 2016/01/27 12:12:44 CET [2016/01/27 6:12:44 ET]
Table 'Klemola' 9-max Seat #3 is the button
Seat 1: COOLIKO\/23 ($100 in chips) 
Seat 2: Kukuryzka ($100 in chips) 
Seat 3: greyman571 ($44.46 in chips) 
Seat 4: RWasin17 ($98.50 in chips) 
Seat 5: tipner ($100 in chips) 
Seat 6: sylvian31 ($100 in chips) 
Seat 7: matiko09 ($106.88 in chips) 
Seat 8: Sweden_Pound ($100 in chips) 
Seat 9: blef1992 ($125.28 in chips) 
RWasin17: posts small blind $0.50
tipner: posts big blind $1
*** HOLE CARDS ***
Dealt to matiko09 [5h Kd]
sylvian31: folds 
matiko09: folds 
Sweden_Pound: raises $2 to $3
blef1992: folds 
COOLIKO\/23: raises $6 to $9
Kukuryzka: folds 
greyman571: folds 
RWasin17: folds 
blef1992 is disconnected 
tipner: folds 
Sweden_Pound: folds 
Uncalled bet ($6) returned to COOLIKO\/23
COOLIKO\/23 collected $7.50 from pot
COOLIKO\/23: doesn't show hand 
*** SUMMARY ***
Total pot $7.50 | Rake $0 
Seat 1: COOLIKO\/23 collected ($7.50)
Seat 2: Kukuryzka folded before Flop (didn't bet)
Seat 3: greyman571 (button) folded before Flop (didn't bet)
Seat 4: RWasin17 (small blind) folded before Flop
Seat 5: tipner (big blind) folded before Flop
Seat 6: sylvian31 folded before Flop (didn't bet)
Seat 7: matiko09 folded before Flop (didn't bet)
Seat 8: Sweden_Pound folded before Flop
Seat 9: blef1992 folded before Flop (didn't bet)





PokerStars Hand #147755261787:  Hold'em No Limit ($0.50/$1.00 USD) - 2016/01/27 12:12:46 CET [2016/01/27 6:12:46 ET]
Table 'Nanking' 9-max Seat #6 is the button
Seat 1: Peu3aHy ($108.54 in chips) 
Seat 2: Dachish ($91.83 in chips) 
Seat 3: nuaxin ($111.69 in chips) 
Seat 4: COOLIKO\/23 ($168.99 in chips) 
Seat 5: TheGentleFox ($110.12 in chips) 
Seat 6: Kukuryzka ($109 in chips) 
Seat 7: tipner ($102.30 in chips) 
Seat 8: matiko09 ($101.50 in chips) 
Seat 9: Sweden_Pound ($123.68 in chips) 
tipner: posts small blind $0.50
matiko09: posts big blind $1
*** HOLE CARDS ***
Dealt to matiko09 [Qd 3s]
Sweden_Pound: folds 
Peu3aHy: folds 
Dachish: folds 
nuaxin: folds 
COOLIKO\/23: folds 
TheGentleFox: raises $1 to $2
Kukuryzka: folds 
tipner: folds 
matiko09: folds 
Uncalled bet ($1) returned to TheGentleFox
TheGentleFox collected $2.50 from pot
TheGentleFox: doesn't show hand 
*** SUMMARY ***
Total pot $2.50 | Rake $0 
Seat 1: Peu3aHy folded before Flop (didn't bet)
Seat 2: Dachish folded before Flop (didn't bet)
Seat 3: nuaxin folded before Flop (didn't bet)
Seat 4: COOLIKO\/23 folded before Flop (didn't bet)
Seat 5: TheGentleFox collected ($2.50)
Seat 6: Kukuryzka (button) folded before Flop (didn't bet)
Seat 7: tipner (small blind) folded before Flop
Seat 8: matiko09 (big blind) folded before Flop
Seat 9: Sweden_Pound folded before Flop (didn't bet)





PokerStars Hand #147755262589:  Hold'em No Limit ($0.50/$1.00 USD) - 2016/01/27 12:12:48 CET [2016/01/27 6:12:48 ET]
Table 'Dollfus' 9-max Seat #8 is the button
Seat 1: masaytoo ($122.07 in chips) 
Seat 2: nosoant ($58.58 in chips) 
Seat 3: UShallGimme$ ($124.98 in chips) 
Seat 4: matiko09 ($115.11 in chips) 
Seat 5: pandalapa ($218.98 in chips) 
Seat 6: deepblue0000 ($107.99 in chips) 
Seat 7: Dödi123 ($206.61 in chips) 
Seat 8: Venomous100% ($101.52 in chips) 
Seat 9: COOLIKO\/23 ($126.37 in chips) 
COOLIKO\/23: posts small blind $0.50
masaytoo: posts big blind $1
*** HOLE CARDS ***
Dealt to matiko09 [6c Td]
nosoant: calls $1
UShallGimme$: folds 
matiko09: folds 
pandalapa: folds 
deepblue0000: folds 
Dödi123: folds 
Venomous100%: folds 
COOLIKO\/23: folds 
masaytoo: checks 
*** FLOP *** [8h Qc Qs]
masaytoo: checks 
nosoant: bets $2
masaytoo: folds 
Uncalled bet ($2) returned to nosoant
nosoant collected $2.39 from pot
nosoant: doesn't show hand 
*** SUMMARY ***
Total pot $2.50 | Rake $0.11 
Board [8h Qc Qs]
Seat 1: masaytoo (big blind) folded on the Flop
Seat 2: nosoant collected ($2.39)
Seat 3: UShallGimme$ folded before Flop (didn't bet)
Seat 4: matiko09 folded before Flop (didn't bet)
Seat 5: pandalapa folded before Flop (didn't bet)
Seat 6: deepblue0000 folded before Flop (didn't bet)
Seat 7: Dödi123 folded before Flop (didn't bet)
Seat 8: Venomous100% (button) folded before Flop (didn't bet)
Seat 9: COOLIKO\/23 (small blind) folded before Flop





PokerStars Hand #147755265328:  Hold'em No Limit ($0.50/$1.00 USD) - 2016/01/27 12:12:53 CET [2016/01/27 6:12:53 ET]
Table 'Delphinus II' 9-max Seat #6 is the button
Seat 1: Saintreine ($150.91 in chips) 
Seat 3: deepblue0000 ($446.03 in chips) 
Seat 4: matiko09 ($100 in chips) 
Seat 5: pandalapa ($103.39 in chips) 
Seat 6: Sweden_Pound ($144.64 in chips) 
Seat 7: RUS)Timur ($130.35 in chips) 
Seat 8: mycka86 ($110.52 in chips) 
RUS)Timur: posts small blind $0.50
mycka86: posts big blind $1
*** HOLE CARDS ***
Dealt to matiko09 [Qh 9s]
Saintreine: raises $1.50 to $2.50
deepblue0000: folds 
matiko09: folds 
pandalapa: folds 
Sweden_Pound: folds 
RUS)Timur: folds 
mycka86: calls $1.50
*** FLOP *** [Jd Qd 3c]
mycka86: checks 
di0d80 joins the table at seat #9 
di0d80 leaves the table
Saintreine: bets $3.72
mycka86: folds 
Uncalled bet ($3.72) returned to Saintreine
Saintreine collected $5.25 from pot
Saintreine: doesn't show hand 
*** SUMMARY ***
Total pot $5.50 | Rake $0.25 
Board [Jd Qd 3c]
Seat 1: Saintreine collected ($5.25)
Seat 3: deepblue0000 folded before Flop (didn't bet)
Seat 4: matiko09 folded before Flop (didn't bet)
Seat 5: pandalapa folded before Flop (didn't bet)
Seat 6: Sweden_Pound (button) folded before Flop (didn't bet)
Seat 7: RUS)Timur (small blind) folded before Flop
Seat 8: mycka86 (big blind) folded on the Flop





PokerStars Hand #147755265447:  Hold'em No Limit ($0.50/$1.00 USD) - 2016/01/27 12:12:53 CET [2016/01/27 6:12:53 ET]
Table 'Fragaria II' 9-max Seat #9 is the button
Seat 1: deepblue0000 ($100 in chips) 
Seat 2: GG-NoR34D. ($80.56 in chips) 
Seat 3: Sweden_Pound ($100 in chips) 
Seat 5: Venomous100% ($164.54 in chips) 
Seat 6: UShallGimme$ ($181.99 in chips) 
Seat 7: Hobby-.-AK ($54.49 in chips) 
Seat 8: mycka86 ($104.39 in chips) 
Seat 9: matiko09 ($100 in chips) 
deepblue0000: posts small blind $0.50
GG-NoR34D.: posts big blind $1
*** HOLE CARDS ***
Dealt to matiko09 [Td 2h]
Sweden_Pound: raises $2 to $3
Venomous100%: folds 
UShallGimme$: folds 
Hobby-.-AK: folds 
mycka86: folds 
matiko09: folds 
deepblue0000: folds 
GG-NoR34D.: folds 
Uncalled bet ($2) returned to Sweden_Pound
Sweden_Pound collected $2.50 from pot
Sweden_Pound: doesn't show hand 
*** SUMMARY ***
Total pot $2.50 | Rake $0 
Seat 1: deepblue0000 (small blind) folded before Flop
Seat 2: GG-NoR34D. (big blind) folded before Flop
Seat 3: Sweden_Pound collected ($2.50)
Seat 5: Venomous100% folded before Flop (didn't bet)
Seat 6: UShallGimme$ folded before Flop (didn't bet)
Seat 7: Hobby-.-AK folded before Flop (didn't bet)
Seat 8: mycka86 folded before Flop (didn't bet)
Seat 9: matiko09 (button) folded before Flop (didn't bet)





PokerStars Hand #147755268097:  Hold'em No Limit ($0.50/$1.00 USD) - 2016/01/27 12:12:58 CET [2016/01/27 6:12:58 ET]
Table 'Alhajoth' 9-max Seat #3 is the button
Seat 1: UShallGimme$ ($116.45 in chips) 
Seat 2: matiko09 ($104 in chips) 
Seat 3: Sweden_Pound ($103.77 in chips) 
Seat 4: Venomous100% ($171.26 in chips) 
Seat 5: Kukuryzka ($109.35 in chips) 
Seat 6: RoadtoNepal ($183.96 in chips) 
Seat 7: Ohpeel ($121.09 in chips) 
Seat 8: deepblue0000 ($130.49 in chips) 
Venomous100%: posts small blind $0.50
Kukuryzka: posts big blind $1
*** HOLE CARDS ***
Dealt to matiko09 [5h 2c]
RoadtoNepal: folds 
Ohpeel: folds 
deepblue0000: folds 
UShallGimme$: folds 
matiko09: folds 
Sweden_Pound: folds 
Venomous100%: folds 
Uncalled bet ($0.50) returned to Kukuryzka
Kukuryzka collected $1 from pot
Kukuryzka: doesn't show hand 
*** SUMMARY ***
Total pot $1 | Rake $0 
Seat 1: UShallGimme$ folded before Flop (didn't bet)
Seat 2: matiko09 folded before Flop (didn't bet)
Seat 3: Sweden_Pound (button) folded before Flop (didn't bet)
Seat 4: Venomous100% (small blind) folded before Flop
Seat 5: Kukuryzka (big blind) collected ($1)
Seat 6: RoadtoNepal folded before Flop (didn't bet)
Seat 7: Ohpeel folded before Flop (didn't bet)
Seat 8: deepblue0000 folded before Flop (didn't bet)





PokerStars Hand #147755276513:  Hold'em No Limit ($0.50/$1.00 USD) - 2016/01/27 12:13:14 CET [2016/01/27 6:13:14 ET]
Table 'Fragaria II' 9-max Seat #1 is the button
Seat 1: deepblue0000 ($100 in chips) 
Seat 2: GG-NoR34D. ($79.56 in chips) 
Seat 3: Sweden_Pound ($101.50 in chips) 
Seat 5: Venomous100% ($164.54 in chips) 
Seat 6: UShallGimme$ ($181.99 in chips) 
Seat 7: Hobby-.-AK ($54.49 in chips) 
Seat 8: mycka86 ($104.39 in chips) 
Seat 9: matiko09 ($100 in chips) 
GG-NoR34D.: posts small blind $0.50
Sweden_Pound: posts big blind $1
*** HOLE CARDS ***
Dealt to matiko09 [3s As]
Venomous100%: folds 
UShallGimme$: raises $2 to $3
Hobby-.-AK: folds 
mycka86: folds 
matiko09: raises $6.50 to $9.50
deepblue0000: folds 
GG-NoR34D.: folds 
Sweden_Pound: folds 
UShallGimme$: folds 
Uncalled bet ($6.50) returned to matiko09
matiko09 collected $7.50 from pot
matiko09: doesn't show hand 
*** SUMMARY ***
Total pot $7.50 | Rake $0 
Seat 1: deepblue0000 (button) folded before Flop (didn't bet)
Seat 2: GG-NoR34D. (small blind) folded before Flop
Seat 3: Sweden_Pound (big blind) folded before Flop
Seat 5: Venomous100% folded before Flop (didn't bet)
Seat 6: UShallGimme$ folded before Flop
Seat 7: Hobby-.-AK folded before Flop (didn't bet)
Seat 8: mycka86 folded before Flop (didn't bet)
Seat 9: matiko09 collected ($7.50)





PokerStars Hand #147755277495:  Hold'em No Limit ($1/$2 USD) - 2016/01/27 12:13:16 CET [2016/01/27 6:13:16 ET]
Table 'Phobos II' 9-max Seat #3 is the button
Seat 1: LRV21 ($630.59 in chips) 
Seat 3: sylvian31 ($245.20 in chips) 
Seat 4: flk.Dasas ($200 in chips) 
Seat 5: tipner ($200 in chips) 
Seat 6: matiko09 ($276.87 in chips) 
Seat 7: Venomous100% ($431.38 in chips) 
Seat 8: RoadtoNepal ($200 in chips) 
Seat 9: Kukuryzka ($275.36 in chips) 
flk.Dasas: posts small blind $1
tipner: posts big blind $2
*** HOLE CARDS ***
Dealt to matiko09 [6s 2d]
matiko09: folds 
Venomous100%: folds 
RoadtoNepal: folds 
Kukuryzka: folds 
LRV21: raises $4 to $6
sylvian31: folds 
flk.Dasas: folds 
tipner: folds 
Uncalled bet ($4) returned to LRV21
LRV21 collected $5 from pot
LRV21: doesn't show hand 
*** SUMMARY ***
Total pot $5 | Rake $0 
Seat 1: LRV21 collected ($5)
Seat 3: sylvian31 (button) folded before Flop (didn't bet)
Seat 4: flk.Dasas (small blind) folded before Flop
Seat 5: tipner (big blind) folded before Flop
Seat 6: matiko09 folded before Flop (didn't bet)
Seat 7: Venomous100% folded before Flop (didn't bet)
Seat 8: RoadtoNepal folded before Flop (didn't bet)
Seat 9: Kukuryzka folded before Flop (didn't bet)





PokerStars Hand #147755278244:  Hold'em No Limit ($0.50/$1.00 USD) - 2016/01/27 12:13:17 CET [2016/01/27 6:13:17 ET]
Table 'Alhajoth' 9-max Seat #4 is the button
Seat 1: UShallGimme$ ($116.45 in chips) 
Seat 2: matiko09 ($104 in chips) 
Seat 3: Sweden_Pound ($103.77 in chips) 
Seat 4: Venomous100% ($170.76 in chips) 
Seat 5: Kukuryzka ($109.85 in chips) 
Seat 6: RoadtoNepal ($183.96 in chips) 
Seat 7: Ohpeel ($121.09 in chips) 
Seat 8: deepblue0000 ($130.49 in chips) 
Kukuryzka: posts small blind $0.50
RoadtoNepal: posts big blind $1
*** HOLE CARDS ***
Dealt to matiko09 [5s Jc]
Ohpeel: folds 
deepblue0000: folds 
UShallGimme$: folds 
matiko09: folds 
Sweden_Pound: raises $1.50 to $2.50
Venomous100%: calls $2.50
Kukuryzka: folds 
RoadtoNepal: folds 
*** FLOP *** [3s 7s 9d]
Sweden_Pound: bets $4.04
Venomous100%: raises $7.96 to $12
Sweden_Pound: calls $7.96
*** TURN *** [3s 7s 9d] [8h]
Sweden_Pound: checks 
Venomous100%: checks 
*** RIVER *** [3s 7s 9d 8h] [Kh]
Sweden_Pound: checks 
Venomous100%: bets $20
Sweden_Pound: calls $20
*** SHOW DOWN ***
Venomous100%: shows [7d 7h] (three of a kind, Sevens)
Sweden_Pound: mucks hand 
Venomous100% collected $67.70 from pot
*** SUMMARY ***
Total pot $70.50 | Rake $2.80 
Board [3s 7s 9d 8h Kh]
Seat 1: UShallGimme$ folded before Flop (didn't bet)
Seat 2: matiko09 folded before Flop (didn't bet)
Seat 3: Sweden_Pound mucked [9h As]
Seat 4: Venomous100% (button) showed [7d 7h] and won ($67.70) with three of a kind, Sevens
Seat 5: Kukuryzka (small blind) folded before Flop
Seat 6: RoadtoNepal (big blind) folded before Flop
Seat 7: Ohpeel folded before Flop (didn't bet)
Seat 8: deepblue0000 folded before Flop (didn't bet)





PokerStars Hand #147755285182:  Hold'em No Limit ($0.50/$1.00 USD) - 2016/01/27 12:13:30 CET [2016/01/27 6:13:30 ET]
Table 'Delphinus II' 9-max Seat #7 is the button
Seat 1: Saintreine ($153.66 in chips) 
Seat 3: deepblue0000 ($446.03 in chips) 
Seat 4: matiko09 ($100 in chips) 
Seat 5: pandalapa ($103.39 in chips) 
Seat 6: Sweden_Pound ($144.64 in chips) 
Seat 7: RUS)Timur ($129.85 in chips) 
Seat 8: mycka86 ($108.02 in chips) 
mycka86: posts small blind $0.50
Saintreine: posts big blind $1
*** HOLE CARDS ***
Dealt to matiko09 [4d 2d]
deepblue0000: folds 
matiko09: folds 
pandalapa: folds 
Sweden_Pound: folds 
RUS)Timur: folds 
UShallGimme$ joins the table at seat #2 
mycka86: folds 
Uncalled bet ($0.50) returned to Saintreine
Saintreine collected $1 from pot
Saintreine: doesn't show hand 
*** SUMMARY ***
Total pot $1 | Rake $0 
Seat 1: Saintreine (big blind) collected ($1)
Seat 3: deepblue0000 folded before Flop (didn't bet)
Seat 4: matiko09 folded before Flop (didn't bet)
Seat 5: pandalapa folded before Flop (didn't bet)
Seat 6: Sweden_Pound folded before Flop (didn't bet)
Seat 7: RUS)Timur (button) folded before Flop (didn't bet)
Seat 8: mycka86 (small blind) folded before Flop





PokerStars Hand #147755287121:  Hold'em No Limit ($0.50/$1.00 USD) - 2016/01/27 12:13:34 CET [2016/01/27 6:13:34 ET]
Table 'Klemola' 9-max Seat #4 is the button
Seat 1: COOLIKO\/23 ($104.50 in chips) 
Seat 2: Kukuryzka ($100 in chips) 
Seat 3: greyman571 ($44.46 in chips) 
Seat 4: RWasin17 ($98 in chips) 
Seat 5: tipner ($100 in chips) 
Seat 6: sylvian31 ($100 in chips) 
Seat 7: matiko09 ($106.88 in chips) 
Seat 8: Sweden_Pound ($100 in chips) 
Seat 9: blef1992 ($125.28 in chips) 
tipner: posts small blind $0.50
sylvian31: posts big blind $1
*** HOLE CARDS ***
Dealt to matiko09 [4c Th]
matiko09: folds 
Sweden_Pound: folds 
blef1992 has timed out while disconnected
blef1992: folds 
COOLIKO\/23: folds 
Kukuryzka: folds 
greyman571: folds 
RWasin17: folds 
RWasin17 leaves the table
tipner: folds 
Uncalled bet ($0.50) returned to sylvian31
sylvian31 collected $1 from pot
sylvian31: doesn't show hand 
*** SUMMARY ***
Total pot $1 | Rake $0 
Seat 1: COOLIKO\/23 folded before Flop (didn't bet)
Seat 2: Kukuryzka folded before Flop (didn't bet)
Seat 3: greyman571 folded before Flop (didn't bet)
Seat 4: RWasin17 (button) folded before Flop (didn't bet)
Seat 5: tipner (small blind) folded before Flop
Seat 6: sylvian31 (big blind) collected ($1)
Seat 7: matiko09 folded before Flop (didn't bet)
Seat 8: Sweden_Pound folded before Flop (didn't bet)
Seat 9: blef1992 folded before Flop (didn't bet)





PokerStars Hand #147755291826:  Hold'em No Limit ($0.50/$1.00 USD) - 2016/01/27 12:13:43 CET [2016/01/27 6:13:43 ET]
Table 'Dollfus' 9-max Seat #9 is the button
Seat 1: masaytoo ($121.07 in chips) 
Seat 2: nosoant ($59.97 in chips) 
Seat 3: UShallGimme$ ($124.98 in chips) 
Seat 4: matiko09 ($115.11 in chips) 
Seat 5: pandalapa ($218.98 in chips) 
Seat 6: deepblue0000 ($107.99 in chips) 
Seat 7: Dödi123 ($206.61 in chips) 
Seat 8: Venomous100% ($101.52 in chips) 
Seat 9: COOLIKO\/23 ($125.87 in chips) 
masaytoo: posts small blind $0.50
nosoant: posts big blind $1
*** HOLE CARDS ***
Dealt to matiko09 [8c 3c]
UShallGimme$: folds 
matiko09: folds 
pandalapa: folds 
deepblue0000: raises $2 to $3
Dödi123: calls $3
Venomous100%: folds 
COOLIKO\/23: folds 
masaytoo: folds 
nosoant: calls $2
*** FLOP *** [Js Tc Ad]
nosoant: checks 
deepblue0000: checks 
Dödi123: bets $3
nosoant: calls $3
masaytoo leaves the table
deepblue0000: calls $3
*** TURN *** [Js Tc Ad] [Qc]
Kukuryzka joins the table at seat #1 
nosoant: checks 
deepblue0000: bets $11.77
Dödi123: folds 
nosoant: folds 
Uncalled bet ($11.77) returned to deepblue0000
deepblue0000 collected $17.67 from pot
*** SUMMARY ***
Total pot $18.50 | Rake $0.83 
Board [Js Tc Ad Qc]
Seat 1: masaytoo (small blind) folded before Flop
Seat 2: nosoant (big blind) folded on the Turn
Seat 3: UShallGimme$ folded before Flop (didn't bet)
Seat 4: matiko09 folded before Flop (didn't bet)
Seat 5: pandalapa folded before Flop (didn't bet)
Seat 6: deepblue0000 collected ($17.67)
Seat 7: Dödi123 folded on the Turn
Seat 8: Venomous100% folded before Flop (didn't bet)
Seat 9: COOLIKO\/23 (button) folded before Flop (didn't bet)





PokerStars Hand #147755292489:  Hold'em No Limit ($1/$2 USD) - 2016/01/27 12:13:44 CET [2016/01/27 6:13:44 ET]
Table 'Phobos II' 9-max Seat #4 is the button
Seat 1: LRV21 ($633.59 in chips) 
Seat 3: sylvian31 ($245.20 in chips) 
Seat 4: flk.Dasas ($200 in chips) 
Seat 5: tipner ($200 in chips) 
Seat 6: matiko09 ($276.87 in chips) 
Seat 7: Venomous100% ($431.38 in chips) 
Seat 8: RoadtoNepal ($200 in chips) 
Seat 9: Kukuryzka ($275.36 in chips) 
tipner: posts small blind $1
matiko09: posts big blind $2
*** HOLE CARDS ***
Dealt to matiko09 [2s As]
Venomous100%: folds 
RoadtoNepal: folds 
Kukuryzka: raises $4 to $6
LRV21: folds 
sylvian31: folds 
flk.Dasas: folds 
tipner: folds 
matiko09: folds 
Uncalled bet ($4) returned to Kukuryzka
Kukuryzka collected $5 from pot
Kukuryzka: doesn't show hand 
*** SUMMARY ***
Total pot $5 | Rake $0 
Seat 1: LRV21 folded before Flop (didn't bet)
Seat 3: sylvian31 folded before Flop (didn't bet)
Seat 4: flk.Dasas (button) folded before Flop (didn't bet)
Seat 5: tipner (small blind) folded before Flop
Seat 6: matiko09 (big blind) folded before Flop
Seat 7: Venomous100% folded before Flop (didn't bet)
Seat 8: RoadtoNepal folded before Flop (didn't bet)
Seat 9: Kukuryzka collected ($5)





PokerStars Hand #147755292224:  Hold'em No Limit ($0.50/$1.00 USD) - 2016/01/27 12:13:44 CET [2016/01/27 6:13:44 ET]
Table 'Alkmene II' 9-max Seat #6 is the button
Seat 1: matiko09 ($120.11 in chips) 
Seat 2: deepblue0000 ($103.68 in chips) 
Seat 4: CoolFireX ($171.47 in chips) 
Seat 5: Sweden_Pound ($108.05 in chips) 
Seat 6: Peu3aHy ($116.22 in chips) 
Seat 7: mycka86 ($102.75 in chips) 
Seat 8: fecsok1 ($114.34 in chips) 
Seat 9: pandalapa ($100 in chips) 
mycka86: posts small blind $0.50
fecsok1: posts big blind $1
*** HOLE CARDS ***
Dealt to matiko09 [3h Ks]
pandalapa: folds 
matiko09: folds 
deepblue0000: folds 
CoolFireX: folds 
Sweden_Pound: raises $1.50 to $2.50
Peu3aHy: raises $4.50 to $7
mycka86: raises $9.50 to $16.50
fecsok1: folds 
Sweden_Pound: raises $91.55 to $108.05 and is all-in
Peu3aHy: folds 
mycka86: folds 
Uncalled bet ($91.55) returned to Sweden_Pound
Sweden_Pound collected $41 from pot
Sweden_Pound: doesn't show hand 
*** SUMMARY ***
Total pot $41 | Rake $0 
Seat 1: matiko09 folded before Flop (didn't bet)
Seat 2: deepblue0000 folded before Flop (didn't bet)
Seat 4: CoolFireX folded before Flop (didn't bet)
Seat 5: Sweden_Pound collected ($41)
Seat 6: Peu3aHy (button) folded before Flop
Seat 7: mycka86 (small blind) folded before Flop
Seat 8: fecsok1 (big blind) folded before Flop
Seat 9: pandalapa folded before Flop (didn't bet)





PokerStars Hand #147755293983:  Hold'em No Limit ($0.50/$1.00 USD) - 2016/01/27 12:13:47 CET [2016/01/27 6:13:47 ET]
Table 'Nanking' 9-max Seat #7 is the button
Seat 1: Peu3aHy ($108.54 in chips) 
Seat 2: Dachish ($91.83 in chips) 
Seat 3: nuaxin ($111.69 in chips) 
Seat 4: COOLIKO\/23 ($168.99 in chips) 
Seat 5: TheGentleFox ($111.62 in chips) 
Seat 6: Kukuryzka ($109 in chips) 
Seat 7: tipner ($101.80 in chips) 
Seat 8: matiko09 ($100.50 in chips) 
Seat 9: Sweden_Pound ($123.68 in chips) 
matiko09: posts small blind $0.50
Sweden_Pound: posts big blind $1
*** HOLE CARDS ***
Dealt to matiko09 [Kd 3s]
Peu3aHy: folds 
Dachish: raises $1 to $2
nuaxin: folds 
COOLIKO\/23: folds 
TheGentleFox: folds 
Kukuryzka: folds 
tipner: raises $6 to $8
matiko09: folds 
Sweden_Pound: folds 
Dachish: folds 
Uncalled bet ($6) returned to tipner
tipner collected $5.50 from pot
tipner: doesn't show hand 
*** SUMMARY ***
Total pot $5.50 | Rake $0 
Seat 1: Peu3aHy folded before Flop (didn't bet)
Seat 2: Dachish folded before Flop
Seat 3: nuaxin folded before Flop (didn't bet)
Seat 4: COOLIKO\/23 folded before Flop (didn't bet)
Seat 5: TheGentleFox folded before Flop (didn't bet)
Seat 6: Kukuryzka folded before Flop (didn't bet)
Seat 7: tipner (button) collected ($5.50)
Seat 8: matiko09 (small blind) folded before Flop
Seat 9: Sweden_Pound (big blind) folded before Flop





PokerStars Hand #147755295588:  Hold'em No Limit ($0.50/$1.00 USD) - 2016/01/27 12:13:50 CET [2016/01/27 6:13:50 ET]
Table 'Delphinus II' 9-max Seat #8 is the button
Seat 1: Saintreine ($154.16 in chips) 
Seat 2: UShallGimme$ ($100 in chips) 
Seat 3: deepblue0000 ($446.03 in chips) 
Seat 4: matiko09 ($100 in chips) 
Seat 5: pandalapa ($103.39 in chips) 
Seat 6: Sweden_Pound ($144.64 in chips) 
Seat 7: RUS)Timur ($129.85 in chips) 
Seat 8: mycka86 ($107.52 in chips) 
Saintreine: posts small blind $0.50
UShallGimme$: posts big blind $1
*** HOLE CARDS ***
Dealt to matiko09 [Ah 2s]
deepblue0000: folds 
matiko09: folds 
pandalapa: folds 
Sweden_Pound: folds 
RUS)Timur: folds 
mycka86: raises $1.10 to $2.10
Saintreine: folds 
UShallGimme$: folds 
Uncalled bet ($1.10) returned to mycka86
mycka86 collected $2.50 from pot
*** SUMMARY ***
Total pot $2.50 | Rake $0 
Seat 1: Saintreine (small blind) folded before Flop
Seat 2: UShallGimme$ (big blind) folded before Flop
Seat 3: deepblue0000 folded before Flop (didn't bet)
Seat 4: matiko09 folded before Flop (didn't bet)
Seat 5: pandalapa folded before Flop (didn't bet)
Seat 6: Sweden_Pound folded before Flop (didn't bet)
Seat 7: RUS)Timur folded before Flop (didn't bet)
Seat 8: mycka86 (button) collected ($2.50)





PokerStars Hand #147755297715:  Hold'em No Limit ($0.50/$1.00 USD) - 2016/01/27 12:13:54 CET [2016/01/27 6:13:54 ET]
Table 'Fragaria II' 9-max Seat #2 is the button
Seat 1: deepblue0000 ($100 in chips) 
Seat 2: GG-NoR34D. ($79.06 in chips) 
Seat 3: Sweden_Pound ($100.50 in chips) 
Seat 5: Venomous100% ($164.54 in chips) 
Seat 6: UShallGimme$ ($178.99 in chips) 
Seat 7: Hobby-.-AK ($54.49 in chips) 
Seat 8: mycka86 ($104.39 in chips) 
Seat 9: matiko09 ($104.50 in chips) 
Sweden_Pound: posts small blind $0.50
Venomous100%: posts big blind $1
*** HOLE CARDS ***
Dealt to matiko09 [6c 4h]
UShallGimme$: folds 
Hobby-.-AK: folds 
mycka86: folds 
matiko09: folds 
deepblue0000: raises $2 to $3
GG-NoR34D.: folds 
Sweden_Pound: folds 
Venomous100%: folds 
Uncalled bet ($2) returned to deepblue0000
deepblue0000 collected $2.50 from pot
*** SUMMARY ***
Total pot $2.50 | Rake $0 
Seat 1: deepblue0000 collected ($2.50)
Seat 2: GG-NoR34D. (button) folded before Flop (didn't bet)
Seat 3: Sweden_Pound (small blind) folded before Flop
Seat 5: Venomous100% (big blind) folded before Flop
Seat 6: UShallGimme$ folded before Flop (didn't bet)
Seat 7: Hobby-.-AK folded before Flop (didn't bet)
Seat 8: mycka86 folded before Flop (didn't bet)
Seat 9: matiko09 folded before Flop (didn't bet)





PokerStars Hand #147755309361:  Hold'em No Limit ($1/$2 USD) - 2016/01/27 12:14:16 CET [2016/01/27 6:14:16 ET]
Table 'Phobos II' 9-max Seat #5 is the button
Seat 1: LRV21 ($633.59 in chips) 
Seat 3: sylvian31 ($245.20 in chips) 
Seat 4: flk.Dasas ($200 in chips) 
Seat 5: tipner ($200 in chips) 
Seat 6: matiko09 ($274.87 in chips) 
Seat 7: Venomous100% ($431.38 in chips) 
Seat 8: RoadtoNepal ($200 in chips) 
Seat 9: Kukuryzka ($278.36 in chips) 
matiko09: posts small blind $1
Venomous100%: posts big blind $2
*** HOLE CARDS ***
Dealt to matiko09 [3d 2d]
RoadtoNepal: folds 
Kukuryzka: folds 
LRV21: raises $3 to $5
sylvian31: folds 
flk.Dasas: folds 
tipner: folds 
matiko09: folds 
Venomous100%: raises $15 to $20
LRV21: calls $15
*** FLOP *** [Kc 2h 7h]
Venomous100%: bets $24
LRV21: calls $24
*** TURN *** [Kc 2h 7h] [6h]
Venomous100%: checks 
LRV21: bets $50
Venomous100%: calls $50
*** RIVER *** [Kc 2h 7h 6h] [8c]
Venomous100%: checks 
LRV21: bets $93.10
Venomous100%: folds 
Uncalled bet ($93.10) returned to LRV21
LRV21 collected $186.20 from pot
LRV21: doesn't show hand 
*** SUMMARY ***
Total pot $189 | Rake $2.80 
Board [Kc 2h 7h 6h 8c]
Seat 1: LRV21 collected ($186.20)
Seat 3: sylvian31 folded before Flop (didn't bet)
Seat 4: flk.Dasas folded before Flop (didn't bet)
Seat 5: tipner (button) folded before Flop (didn't bet)
Seat 6: matiko09 (small blind) folded before Flop
Seat 7: Venomous100% (big blind) folded on the River
Seat 8: RoadtoNepal folded before Flop (didn't bet)
Seat 9: Kukuryzka folded before Flop (didn't bet)





PokerStars Hand #147755314326:  Hold'em No Limit ($0.50/$1.00 USD) - 2016/01/27 12:14:25 CET [2016/01/27 6:14:25 ET]
Table 'Klemola' 9-max Seat #5 is the button
Seat 1: COOLIKO\/23 ($104.50 in chips) 
Seat 2: Kukuryzka ($100 in chips) 
Seat 3: greyman571 ($44.46 in chips) 
Seat 5: tipner ($100 in chips) 
Seat 6: sylvian31 ($100.50 in chips) 
Seat 7: matiko09 ($106.88 in chips) 
Seat 8: Sweden_Pound ($100 in chips) 
Seat 9: blef1992 ($125.28 in chips) 
sylvian31: posts small blind $0.50
matiko09: posts big blind $1
*** HOLE CARDS ***
Dealt to matiko09 [Td Jd]
torkkdnm joins the table at seat #4 
Sweden_Pound: folds 
blef1992: raises $3 to $4
COOLIKO\/23: folds 
Kukuryzka: folds 
greyman571: folds 
tipner: folds 
sylvian31: folds 
matiko09: calls $3
*** FLOP *** [2c Jc 4d]
matiko09: checks 
blef1992: bets $4
matiko09: calls $4
*** TURN *** [2c Jc 4d] [Jh]
matiko09: checks 
blef1992: checks 
*** RIVER *** [2c Jc 4d Jh] [Qc]
matiko09: bets $10
blef1992: calls $10
*** SHOW DOWN ***
matiko09: shows [Td Jd] (three of a kind, Jacks)
blef1992: mucks hand 
matiko09 collected $34.86 from pot
*** SUMMARY ***
Total pot $36.50 | Rake $1.64 
Board [2c Jc 4d Jh Qc]
Seat 1: COOLIKO\/23 folded before Flop (didn't bet)
Seat 2: Kukuryzka folded before Flop (didn't bet)
Seat 3: greyman571 folded before Flop (didn't bet)
Seat 5: tipner (button) folded before Flop (didn't bet)
Seat 6: sylvian31 (small blind) folded before Flop
Seat 7: matiko09 (big blind) showed [Td Jd] and won ($34.86) with three of a kind, Jacks
Seat 8: Sweden_Pound folded before Flop (didn't bet)
Seat 9: blef1992 mucked [Qh Kc]





PokerStars Hand #147755314447:  Hold'em No Limit ($0.50/$1.00 USD) - 2016/01/27 12:14:26 CET [2016/01/27 6:14:26 ET]
Table 'Delphinus II' 9-max Seat #1 is the button
Seat 1: Saintreine ($153.66 in chips) 
Seat 2: UShallGimme$ ($100 in chips) 
Seat 3: deepblue0000 ($446.03 in chips) 
Seat 4: matiko09 ($100 in chips) 
Seat 5: pandalapa ($103.39 in chips) 
Seat 6: Sweden_Pound ($144.64 in chips) 
Seat 7: RUS)Timur ($129.85 in chips) 
Seat 8: mycka86 ($109.02 in chips) 
FreeRangtor joins the table at seat #9 
UShallGimme$: posts small blind $0.50
deepblue0000: posts big blind $1
*** HOLE CARDS ***
Dealt to matiko09 [7c As]
matiko09: folds 
pandalapa: folds 
Sweden_Pound: folds 
RUS)Timur: folds 
mycka86: raises $1.10 to $2.10
Saintreine: calls $2.10
UShallGimme$: calls $1.60
deepblue0000: calls $1.10
*** FLOP *** [8c Ks 2d]
UShallGimme$: bets $4.50
deepblue0000: folds 
mycka86: calls $4.50
Saintreine: folds 
*** TURN *** [8c Ks 2d] [7s]
UShallGimme$: checks 
mycka86: checks 
*** RIVER *** [8c Ks 2d 7s] [3s]
UShallGimme$: checks 
mycka86: checks 
*** SHOW DOWN ***
UShallGimme$: shows [Qs 8d] (a pair of Eights)
mycka86: shows [Js Kc] (a pair of Kings)
mycka86 collected $16.62 from pot
*** SUMMARY ***
Total pot $17.40 | Rake $0.78 
Board [8c Ks 2d 7s 3s]
Seat 1: Saintreine (button) folded on the Flop
Seat 2: UShallGimme$ (small blind) showed [Qs 8d] and lost with a pair of Eights
Seat 3: deepblue0000 (big blind) folded on the Flop
Seat 4: matiko09 folded before Flop (didn't bet)
Seat 5: pandalapa folded before Flop (didn't bet)
Seat 6: Sweden_Pound folded before Flop (didn't bet)
Seat 7: RUS)Timur folded before Flop (didn't bet)
Seat 8: mycka86 showed [Js Kc] and won ($16.62) with a pair of Kings





PokerStars Hand #147755315192:  Hold'em No Limit ($0.50/$1.00 USD) - 2016/01/27 12:14:27 CET [2016/01/27 6:14:27 ET]
Table 'Fragaria II' 9-max Seat #3 is the button
Seat 1: deepblue0000 ($101.50 in chips) 
Seat 2: GG-NoR34D. ($79.06 in chips) 
Seat 3: Sweden_Pound ($100 in chips) 
Seat 5: Venomous100% ($163.54 in chips) 
Seat 6: UShallGimme$ ($178.99 in chips) 
Seat 7: Hobby-.-AK ($54.49 in chips) 
Seat 8: mycka86 ($104.39 in chips) 
Seat 9: matiko09 ($104.50 in chips) 
Venomous100%: posts small blind $0.50
UShallGimme$: posts big blind $1
*** HOLE CARDS ***
Dealt to matiko09 [4s Jh]
Hobby-.-AK: folds 
mycka86: folds 
matiko09: folds 
deepblue0000: folds 
GG-NoR34D.: folds 
Sweden_Pound: raises $1 to $2
Venomous100%: folds 
UShallGimme$: folds 
Uncalled bet ($1) returned to Sweden_Pound
Sweden_Pound collected $2.50 from pot
Sweden_Pound: doesn't show hand 
*** SUMMARY ***
Total pot $2.50 | Rake $0 
Seat 1: deepblue0000 folded before Flop (didn't bet)
Seat 2: GG-NoR34D. folded before Flop (didn't bet)
Seat 3: Sweden_Pound (button) collected ($2.50)
Seat 5: Venomous100% (small blind) folded before Flop
Seat 6: UShallGimme$ (big blind) folded before Flop
Seat 7: Hobby-.-AK folded before Flop (didn't bet)
Seat 8: mycka86 folded before Flop (didn't bet)
Seat 9: matiko09 folded before Flop (didn't bet)





PokerStars Hand #147755315406:  Hold'em No Limit ($0.50/$1.00 USD) - 2016/01/27 12:14:28 CET [2016/01/27 6:14:28 ET]
Table 'Nanking' 9-max Seat #8 is the button
Seat 1: Peu3aHy ($108.54 in chips) 
Seat 2: Dachish ($89.83 in chips) 
Seat 3: nuaxin ($111.69 in chips) 
Seat 4: COOLIKO\/23 ($168.99 in chips) 
Seat 5: TheGentleFox ($111.62 in chips) 
Seat 6: Kukuryzka ($109 in chips) 
Seat 7: tipner ($105.30 in chips) 
Seat 8: matiko09 ($100 in chips) 
Seat 9: Sweden_Pound ($122.68 in chips) 
Sweden_Pound: posts small blind $0.50
Peu3aHy: posts big blind $1
*** HOLE CARDS ***
Dealt to matiko09 [Qs Jc]
Dachish: folds 
nuaxin: folds 
COOLIKO\/23: raises $2 to $3
TheGentleFox: calls $3
Kukuryzka: calls $3
tipner: calls $3
matiko09: calls $3
Sweden_Pound: calls $2.50
Peu3aHy: folds 
*** FLOP *** [6c 5s 8s]
Sweden_Pound: checks 
COOLIKO\/23: checks 
TheGentleFox: checks 
Kukuryzka: checks 
tipner: bets $9
matiko09: folds 
Sweden_Pound: folds 
COOLIKO\/23: folds 
TheGentleFox: calls $9
Kukuryzka: calls $9
*** TURN *** [6c 5s 8s] [7s]
TheGentleFox: bets $21.96
Kukuryzka: raises $43.92 to $65.88
tipner: folds 
TheGentleFox: raises $33.74 to $99.62 and is all-in
Kukuryzka: calls $31.12 and is all-in
Uncalled bet ($2.62) returned to TheGentleFox
*** RIVER *** [6c 5s 8s 7s] [Qd]
*** SHOW DOWN ***
TheGentleFox: shows [Ks 6s] (a flush, King high)
Kukuryzka: shows [As 3s] (a flush, Ace high)
Kukuryzka collected $237.20 from pot
*** SUMMARY ***
Total pot $240 | Rake $2.80 
Board [6c 5s 8s 7s Qd]
Seat 1: Peu3aHy (big blind) folded before Flop
Seat 2: Dachish folded before Flop (didn't bet)
Seat 3: nuaxin folded before Flop (didn't bet)
Seat 4: COOLIKO\/23 folded on the Flop
Seat 5: TheGentleFox showed [Ks 6s] and lost with a flush, King high
Seat 6: Kukuryzka showed [As 3s] and won ($237.20) with a flush, Ace high
Seat 7: tipner folded on the Turn
Seat 8: matiko09 (button) folded on the Flop
Seat 9: Sweden_Pound (small blind) folded on the Flop





PokerStars Hand #147755317535:  Hold'em No Limit ($0.50/$1.00 USD) - 2016/01/27 12:14:32 CET [2016/01/27 6:14:32 ET]
Table 'Marlu II' 9-max Seat #3 is the button
Seat 1: Kukuryzka ($107.45 in chips) 
Seat 2: matiko09 ($104 in chips) 
Seat 3: COOLIKO\/23 ($100 in chips) 
Seat 4: tipner ($100 in chips) 
Seat 5: Sweden_Pound ($146.16 in chips) 
Seat 6: LIGOPSIXIS78 ($17.87 in chips) 
Seat 7: UShallGimme$ ($100 in chips) 
Seat 8: Peu3aHy ($100 in chips) 
Seat 9: platinium1 ($72.27 in chips) 
tipner: posts small blind $0.50
Sweden_Pound: posts big blind $1
*** HOLE CARDS ***
Dealt to matiko09 [As Tc]
LIGOPSIXIS78: raises $2 to $3
UShallGimme$: raises $6 to $9
Peu3aHy: folds 
platinium1: folds 
Kukuryzka: folds 
matiko09: folds 
COOLIKO\/23: folds 
tipner: raises $10 to $19
Sweden_Pound: folds 
LIGOPSIXIS78: folds 
UShallGimme$: folds 
Uncalled bet ($10) returned to tipner
tipner collected $22 from pot
tipner: doesn't show hand 
*** SUMMARY ***
Total pot $22 | Rake $0 
Seat 1: Kukuryzka folded before Flop (didn't bet)
Seat 2: matiko09 folded before Flop (didn't bet)
Seat 3: COOLIKO\/23 (button) folded before Flop (didn't bet)
Seat 4: tipner (small blind) collected ($22)
Seat 5: Sweden_Pound (big blind) folded before Flop
Seat 6: LIGOPSIXIS78 folded before Flop
Seat 7: UShallGimme$ folded before Flop
Seat 8: Peu3aHy folded before Flop (didn't bet)
Seat 9: platinium1 folded before Flop (didn't bet)





PokerStars Hand #147755336598:  Hold'em No Limit ($0.50/$1.00 USD) - 2016/01/27 12:15:08 CET [2016/01/27 6:15:08 ET]
Table 'Dollfus' 9-max Seat #2 is the button
Seat 2: nosoant ($53.97 in chips) 
Seat 3: UShallGimme$ ($124.98 in chips) 
Seat 4: matiko09 ($115.11 in chips) 
Seat 5: pandalapa ($218.98 in chips) 
Seat 6: deepblue0000 ($119.66 in chips) 
Seat 7: Dödi123 ($200.61 in chips) 
Seat 8: Venomous100% ($101.52 in chips) 
Seat 9: COOLIKO\/23 ($125.87 in chips) 
UShallGimme$: posts small blind $0.50
matiko09: posts big blind $1
Kukuryzka: sits out 
*** HOLE CARDS ***
Dealt to matiko09 [7d 8d]
pandalapa: folds 
deepblue0000: folds 
Dödi123: raises $1.50 to $2.50
Venomous100%: folds 
COOLIKO\/23: folds 
nosoant: calls $2.50
UShallGimme$: folds 
matiko09: calls $1.50
*** FLOP *** [Tc 5d Qs]
matiko09: checks 
Dödi123: checks 
nosoant: checks 
*** TURN *** [Tc 5d Qs] [6h]
matiko09: bets $4.97
Dödi123: folds 
nosoant: calls $4.97
*** RIVER *** [Tc 5d Qs 6h] [3h]
matiko09: checks 
nosoant: checks 
*** SHOW DOWN ***
matiko09: shows [7d 8d] (high card Queen)
nosoant: shows [Ah Th] (a pair of Tens)
nosoant collected $17.13 from pot
*** SUMMARY ***
Total pot $17.94 | Rake $0.81 
Board [Tc 5d Qs 6h 3h]
Seat 2: nosoant (button) showed [Ah Th] and won ($17.13) with a pair of Tens
Seat 3: UShallGimme$ (small blind) folded before Flop
Seat 4: matiko09 (big blind) showed [7d 8d] and lost with high card Queen
Seat 5: pandalapa folded before Flop (didn't bet)
Seat 6: deepblue0000 folded before Flop (didn't bet)
Seat 7: Dödi123 folded on the Turn
Seat 8: Venomous100% folded before Flop (didn't bet)
Seat 9: COOLIKO\/23 folded before Flop (didn't bet)





PokerStars Hand #147755338824:  Hold'em No Limit ($0.50/$1.00 USD) - 2016/01/27 12:15:12 CET [2016/01/27 6:15:12 ET]
Table 'Fragaria II' 9-max Seat #5 is the button
Seat 1: deepblue0000 ($101.50 in chips) 
Seat 2: GG-NoR34D. ($79.06 in chips) 
Seat 3: Sweden_Pound ($101.50 in chips) 
Seat 5: Venomous100% ($163.04 in chips) 
Seat 6: UShallGimme$ ($177.99 in chips) 
Seat 7: Hobby-.-AK ($54.49 in chips) 
Seat 8: mycka86 ($104.39 in chips) 
Seat 9: matiko09 ($104.50 in chips) 
UShallGimme$: posts small blind $0.50
Hobby-.-AK: posts big blind $1
di0d80: sits out 
*** HOLE CARDS ***
Dealt to matiko09 [2s 9h]
mycka86: folds 
matiko09: folds 
deepblue0000: folds 
GG-NoR34D.: calls $1
Sweden_Pound: raises $3 to $4
Venomous100%: folds 
UShallGimme$: folds 
Hobby-.-AK: folds 
GG-NoR34D.: calls $3
*** FLOP *** [9d Kc 4c]
GG-NoR34D.: checks 
Sweden_Pound: bets $5.90
GG-NoR34D.: folds 
Uncalled bet ($5.90) returned to Sweden_Pound
Sweden_Pound collected $9.07 from pot
Sweden_Pound: doesn't show hand 
*** SUMMARY ***
Total pot $9.50 | Rake $0.43 
Board [9d Kc 4c]
Seat 1: deepblue0000 folded before Flop (didn't bet)
Seat 2: GG-NoR34D. folded on the Flop
Seat 3: Sweden_Pound collected ($9.07)
Seat 5: Venomous100% (button) folded before Flop (didn't bet)
Seat 6: UShallGimme$ (small blind) folded before Flop
Seat 7: Hobby-.-AK (big blind) folded before Flop
Seat 8: mycka86 folded before Flop (didn't bet)
Seat 9: matiko09 folded before Flop (didn't bet)





PokerStars Hand #147755341967:  Hold'em No Limit ($0.50/$1.00 USD) - 2016/01/27 12:15:18 CET [2016/01/27 6:15:18 ET]
Table 'Marlu II' 9-max Seat #4 is the button
Seat 1: Kukuryzka ($107.45 in chips) 
Seat 2: matiko09 ($104 in chips) 
Seat 3: COOLIKO\/23 ($100 in chips) 
Seat 4: tipner ($113 in chips) 
Seat 5: Sweden_Pound ($145.16 in chips) 
Seat 6: LIGOPSIXIS78 ($14.87 in chips) 
Seat 7: UShallGimme$ ($100 in chips) 
Seat 8: Peu3aHy ($100 in chips) 
Seat 9: platinium1 ($72.27 in chips) 
Sweden_Pound: posts small blind $0.50
LIGOPSIXIS78: posts big blind $1
*** HOLE CARDS ***
Dealt to matiko09 [Ks Jd]
UShallGimme$: folds 
Peu3aHy: folds 
platinium1: folds 
Kukuryzka: folds 
matiko09: raises $2 to $3
COOLIKO\/23: folds 
tipner: folds 
Sweden_Pound: folds 
LIGOPSIXIS78: raises $11.87 to $14.87 and is all-in
matiko09: calls $11.87
*** FLOP *** [Qd 5h Jc]
*** TURN *** [Qd 5h Jc] [As]
*** RIVER *** [Qd 5h Jc As] [Qs]
*** SHOW DOWN ***
LIGOPSIXIS78: shows [Kd Ad] (two pair, Aces and Queens)
matiko09: mucks hand 
LIGOPSIXIS78 collected $28.88 from pot
*** SUMMARY ***
Total pot $30.24 | Rake $1.36 
Board [Qd 5h Jc As Qs]
Seat 1: Kukuryzka folded before Flop (didn't bet)
Seat 2: matiko09 mucked [Ks Jd]
Seat 3: COOLIKO\/23 folded before Flop (didn't bet)
Seat 4: tipner (button) folded before Flop (didn't bet)
Seat 5: Sweden_Pound (small blind) folded before Flop
Seat 6: LIGOPSIXIS78 (big blind) showed [Kd Ad] and won ($28.88) with two pair, Aces and Queens
Seat 7: UShallGimme$ folded before Flop (didn't bet)
Seat 8: Peu3aHy folded before Flop (didn't bet)
Seat 9: platinium1 folded before Flop (didn't bet)





PokerStars Hand #147755342752:  Hold'em No Limit ($0.50/$1.00 USD) - 2016/01/27 12:15:19 CET [2016/01/27 6:15:19 ET]
Table 'Klemola' 9-max Seat #6 is the button
Seat 1: COOLIKO\/23 ($104.50 in chips) 
Seat 2: Kukuryzka ($100 in chips) 
Seat 3: greyman571 ($44.46 in chips) 
Seat 5: tipner ($100 in chips) 
Seat 6: sylvian31 ($100 in chips) 
Seat 7: matiko09 ($123.74 in chips) 
Seat 8: Sweden_Pound ($100 in chips) 
Seat 9: blef1992 ($107.28 in chips) 
matiko09: posts small blind $0.50
Sweden_Pound: posts big blind $1
torkkdnm: sits out 
*** HOLE CARDS ***
Dealt to matiko09 [4s 2s]
blef1992: folds 
COOLIKO\/23: folds 
Kukuryzka: folds 
greyman571: raises $2 to $3
tipner: folds 
sylvian31: folds 
matiko09: folds 
Sweden_Pound: folds 
Uncalled bet ($2) returned to greyman571
greyman571 collected $2.50 from pot
greyman571: doesn't show hand 
*** SUMMARY ***
Total pot $2.50 | Rake $0 
Seat 1: COOLIKO\/23 folded before Flop (didn't bet)
Seat 2: Kukuryzka folded before Flop (didn't bet)
Seat 3: greyman571 collected ($2.50)
Seat 5: tipner folded before Flop (didn't bet)
Seat 6: sylvian31 (button) folded before Flop (didn't bet)
Seat 7: matiko09 (small blind) folded before Flop
Seat 8: Sweden_Pound (big blind) folded before Flop
Seat 9: blef1992 folded before Flop (didn't bet)





PokerStars Hand #147755348177:  Hold'em No Limit ($0.50/$1.00 USD) - 2016/01/27 12:15:29 CET [2016/01/27 6:15:29 ET]
Table 'Alhajoth' 9-max Seat #5 is the button
Seat 1: UShallGimme$ ($116.45 in chips) 
Seat 2: matiko09 ($104 in chips) 
Seat 3: Sweden_Pound ($100 in chips) 
Seat 4: Venomous100% ($203.96 in chips) 
Seat 5: Kukuryzka ($109.35 in chips) 
Seat 6: RoadtoNepal ($182.96 in chips) 
Seat 7: Ohpeel ($121.09 in chips) 
Seat 8: deepblue0000 ($130.49 in chips) 
RoadtoNepal: posts small blind $0.50
Ohpeel: posts big blind $1
di0d80: sits out 
*** HOLE CARDS ***
Dealt to matiko09 [8c 5d]
deepblue0000: folds 
UShallGimme$: folds 
matiko09: folds 
Sweden_Pound: raises $2 to $3
Venomous100%: folds 
Kukuryzka: folds 
RoadtoNepal: folds 
Ohpeel: calls $2
*** FLOP *** [6d 7d 4c]
Ohpeel: checks 
Sweden_Pound: checks 
*** TURN *** [6d 7d 4c] [Th]
Ohpeel: bets $4
Sweden_Pound: folds 
Uncalled bet ($4) returned to Ohpeel
Ohpeel collected $6.21 from pot
*** SUMMARY ***
Total pot $6.50 | Rake $0.29 
Board [6d 7d 4c Th]
Seat 1: UShallGimme$ folded before Flop (didn't bet)
Seat 2: matiko09 folded before Flop (didn't bet)
Seat 3: Sweden_Pound folded on the Turn
Seat 4: Venomous100% folded before Flop (didn't bet)
Seat 5: Kukuryzka (button) folded before Flop (didn't bet)
Seat 6: RoadtoNepal (small blind) folded before Flop
Seat 7: Ohpeel (big blind) collected ($6.21)
Seat 8: deepblue0000 folded before Flop (didn't bet)





PokerStars Hand #147755350350:  Hold'em No Limit ($0.50/$1.00 USD) - 2016/01/27 12:15:33 CET [2016/01/27 6:15:33 ET]
Table 'Alkmene II' 9-max Seat #7 is the button
Seat 1: matiko09 ($120.11 in chips) 
Seat 2: deepblue0000 ($103.68 in chips) 
Seat 4: CoolFireX ($171.47 in chips) 
Seat 5: Sweden_Pound ($132.55 in chips) 
Seat 6: Peu3aHy ($109.22 in chips) 
Seat 7: mycka86 ($100 in chips) 
Seat 8: fecsok1 ($113.34 in chips) 
Seat 9: pandalapa ($100 in chips) 
fecsok1: posts small blind $0.50
pandalapa: posts big blind $1
di0d80: sits out 
*** HOLE CARDS ***
Dealt to matiko09 [8d Ks]
matiko09: folds 
deepblue0000: folds 
CoolFireX: raises $2 to $3
Sweden_Pound: folds 
Peu3aHy: folds 
mycka86: calls $3
fecsok1: folds 
pandalapa: folds 
*** FLOP *** [2d 2h Qh]
CoolFireX: bets $4.77
mycka86: calls $4.77
*** TURN *** [2d 2h Qh] [7c]
CoolFireX: bets $10.84
mycka86: folds 
Uncalled bet ($10.84) returned to CoolFireX
CoolFireX collected $16.27 from pot
CoolFireX: doesn't show hand 
*** SUMMARY ***
Total pot $17.04 | Rake $0.77 
Board [2d 2h Qh 7c]
Seat 1: matiko09 folded before Flop (didn't bet)
Seat 2: deepblue0000 folded before Flop (didn't bet)
Seat 4: CoolFireX collected ($16.27)
Seat 5: Sweden_Pound folded before Flop (didn't bet)
Seat 6: Peu3aHy folded before Flop (didn't bet)
Seat 7: mycka86 (button) folded on the Turn
Seat 8: fecsok1 (small blind) folded before Flop
Seat 9: pandalapa (big blind) folded before Flop





PokerStars Hand #147755355068:  Hold'em No Limit ($0.50/$1.00 USD) - 2016/01/27 12:15:42 CET [2016/01/27 6:15:42 ET]
Table 'Delphinus II' 9-max Seat #2 is the button
Seat 1: Saintreine ($151.56 in chips) 
Seat 2: UShallGimme$ ($100 in chips) 
Seat 3: deepblue0000 ($443.93 in chips) 
Seat 4: matiko09 ($100 in chips) 
Seat 5: pandalapa ($103.39 in chips) 
Seat 6: Sweden_Pound ($144.64 in chips) 
Seat 7: RUS)Timur ($129.85 in chips) 
Seat 8: mycka86 ($119.04 in chips) 
Seat 9: FreeRangtor ($100 in chips) 
deepblue0000: posts small blind $0.50
matiko09: posts big blind $1
FreeRangtor: posts big blind $1
*** HOLE CARDS ***
Dealt to matiko09 [2h 4c]
pandalapa: folds 
Sweden_Pound: folds 
RUS)Timur: folds 
mycka86: raises $2.50 to $3.50
FreeRangtor: folds 
Saintreine: folds 
UShallGimme$: folds 
deepblue0000: folds 
matiko09: folds 
Uncalled bet ($2.50) returned to mycka86
mycka86 collected $3.50 from pot
*** SUMMARY ***
Total pot $3.50 | Rake $0 
Seat 1: Saintreine folded before Flop (didn't bet)
Seat 2: UShallGimme$ (button) folded before Flop (didn't bet)
Seat 3: deepblue0000 (small blind) folded before Flop
Seat 4: matiko09 (big blind) folded before Flop
Seat 5: pandalapa folded before Flop (didn't bet)
Seat 6: Sweden_Pound folded before Flop (didn't bet)
Seat 7: RUS)Timur folded before Flop (didn't bet)
Seat 8: mycka86 collected ($3.50)
Seat 9: FreeRangtor folded before Flop





PokerStars Hand #147755355445:  Hold'em No Limit ($1/$2 USD) - 2016/01/27 12:15:43 CET [2016/01/27 6:15:43 ET]
Table 'Phobos II' 9-max Seat #6 is the button
Seat 1: LRV21 ($725.79 in chips) 
Seat 3: sylvian31 ($245.20 in chips) 
Seat 4: flk.Dasas ($200 in chips) 
Seat 5: tipner ($200 in chips) 
Seat 6: matiko09 ($273.87 in chips) 
Seat 7: Venomous100% ($337.38 in chips) 
Seat 8: RoadtoNepal ($200 in chips) 
Seat 9: Kukuryzka ($278.36 in chips) 
Venomous100%: posts small blind $1
RoadtoNepal: posts big blind $2
di0d80: sits out 
*** HOLE CARDS ***
Dealt to matiko09 [Kd 8s]
Kukuryzka: folds 
LRV21: folds 
sylvian31: folds 
flk.Dasas: folds 
tipner: folds 
matiko09: folds 
Venomous100%: folds 
Uncalled bet ($1) returned to RoadtoNepal
RoadtoNepal collected $2 from pot
RoadtoNepal: doesn't show hand 
*** SUMMARY ***
Total pot $2 | Rake $0 
Seat 1: LRV21 folded before Flop (didn't bet)
Seat 3: sylvian31 folded before Flop (didn't bet)
Seat 4: flk.Dasas folded before Flop (didn't bet)
Seat 5: tipner folded before Flop (didn't bet)
Seat 6: matiko09 (button) folded before Flop (didn't bet)
Seat 7: Venomous100% (small blind) folded before Flop
Seat 8: RoadtoNepal (big blind) collected ($2)
Seat 9: Kukuryzka folded before Flop (didn't bet)





PokerStars Hand #147755356217:  Hold'em No Limit ($0.50/$1.00 USD) - 2016/01/27 12:15:44 CET [2016/01/27 6:15:44 ET]
Table 'Klemola' 9-max Seat #7 is the button
Seat 1: COOLIKO\/23 ($104.50 in chips) 
Seat 2: Kukuryzka ($100 in chips) 
Seat 3: greyman571 ($45.96 in chips) 
Seat 5: tipner ($100 in chips) 
Seat 6: sylvian31 ($100 in chips) 
Seat 7: matiko09 ($123.24 in chips) 
Seat 8: Sweden_Pound ($100 in chips) 
Seat 9: blef1992 ($107.28 in chips) 
Sweden_Pound: posts small blind $0.50
blef1992: posts big blind $1
torkkdnm: sits out 
*** HOLE CARDS ***
Dealt to matiko09 [As 2c]
COOLIKO\/23: folds 
Kukuryzka: folds 
greyman571: folds 
tipner: folds 
sylvian31: raises $1.50 to $2.50
matiko09: folds 
Sweden_Pound: folds 
blef1992: raises $6.50 to $9
sylvian31: folds 
Uncalled bet ($6.50) returned to blef1992
blef1992 collected $5.50 from pot
blef1992: doesn't show hand 
*** SUMMARY ***
Total pot $5.50 | Rake $0 
Seat 1: COOLIKO\/23 folded before Flop (didn't bet)
Seat 2: Kukuryzka folded before Flop (didn't bet)
Seat 3: greyman571 folded before Flop (didn't bet)
Seat 5: tipner folded before Flop (didn't bet)
Seat 6: sylvian31 folded before Flop
Seat 7: matiko09 (button) folded before Flop (didn't bet)
Seat 8: Sweden_Pound (small blind) folded before Flop
Seat 9: blef1992 (big blind) collected ($5.50)





PokerStars Hand #147755362898:  Hold'em No Limit ($0.50/$1.00 USD) - 2016/01/27 12:15:57 CET [2016/01/27 6:15:57 ET]
Table 'Marlu II' 9-max Seat #5 is the button
Seat 1: Kukuryzka ($107.45 in chips) 
Seat 2: matiko09 ($100 in chips) 
Seat 3: COOLIKO\/23 ($100 in chips) 
Seat 4: tipner ($113 in chips) 
Seat 5: Sweden_Pound ($144.66 in chips) 
Seat 6: LIGOPSIXIS78 ($28.88 in chips) 
Seat 7: UShallGimme$ ($100 in chips) 
Seat 8: Peu3aHy ($100 in chips) 
Seat 9: platinium1 ($72.27 in chips) 
LIGOPSIXIS78: posts small blind $0.50
UShallGimme$: posts big blind $1
*** HOLE CARDS ***
Dealt to matiko09 [As 3d]
Peu3aHy: folds 
platinium1: calls $1
Kukuryzka: folds 
matiko09: folds 
COOLIKO\/23: folds 
tipner: folds 
Sweden_Pound: folds 
LIGOPSIXIS78: folds 
UShallGimme$: checks 
*** FLOP *** [6h Kh Ac]
UShallGimme$: checks 
platinium1: checks 
*** TURN *** [6h Kh Ac] [9c]
UShallGimme$: checks 
platinium1: checks 
*** RIVER *** [6h Kh Ac 9c] [Js]
UShallGimme$: checks 
platinium1: bets $6
UShallGimme$: folds 
Uncalled bet ($6) returned to platinium1
platinium1 collected $2.39 from pot
platinium1: doesn't show hand 
*** SUMMARY ***
Total pot $2.50 | Rake $0.11 
Board [6h Kh Ac 9c Js]
Seat 1: Kukuryzka folded before Flop (didn't bet)
Seat 2: matiko09 folded before Flop (didn't bet)
Seat 3: COOLIKO\/23 folded before Flop (didn't bet)
Seat 4: tipner folded before Flop (didn't bet)
Seat 5: Sweden_Pound (button) folded before Flop (didn't bet)
Seat 6: LIGOPSIXIS78 (small blind) folded before Flop
Seat 7: UShallGimme$ (big blind) folded on the River
Seat 8: Peu3aHy folded before Flop (didn't bet)
Seat 9: platinium1 collected ($2.39)





PokerStars Hand #147755367391:  Hold'em No Limit ($1/$2 USD) - 2016/01/27 12:16:05 CET [2016/01/27 6:16:05 ET]
Table 'Phobos II' 9-max Seat #7 is the button
Seat 1: LRV21 ($725.79 in chips) 
Seat 3: sylvian31 ($245.20 in chips) 
Seat 4: flk.Dasas ($200 in chips) 
Seat 5: tipner ($200 in chips) 
Seat 6: matiko09 ($273.87 in chips) 
Seat 7: Venomous100% ($336.38 in chips) 
Seat 8: RoadtoNepal ($201 in chips) 
Seat 9: Kukuryzka ($278.36 in chips) 
RoadtoNepal: posts small blind $1
Kukuryzka: posts big blind $2
di0d80: sits out 
*** HOLE CARDS ***
Dealt to matiko09 [2s Ad]
LRV21: raises $3 to $5
sylvian31: folds 
flk.Dasas: calls $5
tipner: folds 
matiko09: folds 
Venomous100%: folds 
RoadtoNepal: folds 
Kukuryzka: folds 
*** FLOP *** [3h Jh Kc]
LRV21: bets $10
flk.Dasas: calls $10
*** TURN *** [3h Jh Kc] [6c]
LRV21: bets $31.52
flk.Dasas: calls $31.52
*** RIVER *** [3h Jh Kc 6c] [Qc]
LRV21: bets $93.24
flk.Dasas: folds 
Uncalled bet ($93.24) returned to LRV21
LRV21 collected $93.24 from pot
LRV21: doesn't show hand 
*** SUMMARY ***
Total pot $96.04 | Rake $2.80 
Board [3h Jh Kc 6c Qc]
Seat 1: LRV21 collected ($93.24)
Seat 3: sylvian31 folded before Flop (didn't bet)
Seat 4: flk.Dasas folded on the River
Seat 5: tipner folded before Flop (didn't bet)
Seat 6: matiko09 folded before Flop (didn't bet)
Seat 7: Venomous100% (button) folded before Flop (didn't bet)
Seat 8: RoadtoNepal (small blind) folded before Flop
Seat 9: Kukuryzka (big blind) folded before Flop





PokerStars Hand #147755370575:  Hold'em No Limit ($0.50/$1.00 USD) - 2016/01/27 12:16:11 CET [2016/01/27 6:16:11 ET]
Table 'Delphinus II' 9-max Seat #3 is the button
Seat 1: Saintreine ($151.56 in chips) 
Seat 2: UShallGimme$ ($100 in chips) 
Seat 3: deepblue0000 ($443.43 in chips) 
Seat 4: matiko09 ($100 in chips) 
Seat 5: pandalapa ($103.39 in chips) 
Seat 6: Sweden_Pound ($144.64 in chips) 
Seat 7: RUS)Timur ($129.85 in chips) 
Seat 8: mycka86 ($121.54 in chips) 
Seat 9: FreeRangtor ($99 in chips) 
matiko09: posts small blind $0.50
pandalapa: posts big blind $1
*** HOLE CARDS ***
Dealt to matiko09 [4s 7c]
Sweden_Pound: folds 
RUS)Timur: folds 
mycka86: folds 
FreeRangtor: folds 
Saintreine: folds 
UShallGimme$: folds 
deepblue0000: raises $2 to $3
matiko09: folds 
pandalapa: folds 
Uncalled bet ($2) returned to deepblue0000
deepblue0000 collected $2.50 from pot
*** SUMMARY ***
Total pot $2.50 | Rake $0 
Seat 1: Saintreine folded before Flop (didn't bet)
Seat 2: UShallGimme$ folded before Flop (didn't bet)
Seat 3: deepblue0000 (button) collected ($2.50)
Seat 4: matiko09 (small blind) folded before Flop
Seat 5: pandalapa (big blind) folded before Flop
Seat 6: Sweden_Pound folded before Flop (didn't bet)
Seat 7: RUS)Timur folded before Flop (didn't bet)
Seat 8: mycka86 folded before Flop (didn't bet)
Seat 9: FreeRangtor folded before Flop (didn't bet)





PokerStars Hand #147755373610:  Hold'em No Limit ($0.50/$1.00 USD) - 2016/01/27 12:16:17 CET [2016/01/27 6:16:17 ET]
Table 'Dollfus' 9-max Seat #3 is the button
Seat 2: nosoant ($63.63 in chips) 
Seat 3: UShallGimme$ ($124.48 in chips) 
Seat 4: matiko09 ($107.64 in chips) 
Seat 5: pandalapa ($218.98 in chips) 
Seat 6: deepblue0000 ($119.66 in chips) 
Seat 7: Dödi123 ($198.11 in chips) 
Seat 8: Venomous100% ($101.52 in chips) 
Seat 9: COOLIKO\/23 ($125.87 in chips) 
matiko09: posts small blind $0.50
pandalapa: posts big blind $1
Kukuryzka: sits out 
*** HOLE CARDS ***
Dealt to matiko09 [6d Qc]
deepblue0000: folds 
Dödi123: folds 
Venomous100%: folds 
COOLIKO\/23: raises $2 to $3
nosoant: folds 
UShallGimme$: folds 
matiko09: folds 
pandalapa: folds 
Uncalled bet ($2) returned to COOLIKO\/23
COOLIKO\/23 collected $2.50 from pot
COOLIKO\/23: doesn't show hand 
*** SUMMARY ***
Total pot $2.50 | Rake $0 
Seat 2: nosoant folded before Flop (didn't bet)
Seat 3: UShallGimme$ (button) folded before Flop (didn't bet)
Seat 4: matiko09 (small blind) folded before Flop
Seat 5: pandalapa (big blind) folded before Flop
Seat 6: deepblue0000 folded before Flop (didn't bet)
Seat 7: Dödi123 folded before Flop (didn't bet)
Seat 8: Venomous100% folded before Flop (didn't bet)
Seat 9: COOLIKO\/23 collected ($2.50)





PokerStars Hand #147755383462:  Hold'em No Limit ($0.50/$1.00 USD) - 2016/01/27 12:16:36 CET [2016/01/27 6:16:36 ET]
Table 'Alhajoth' 9-max Seat #6 is the button
Seat 1: UShallGimme$ ($116.45 in chips) 
Seat 2: matiko09 ($104 in chips) 
Seat 3: Sweden_Pound ($100 in chips) 
Seat 4: Venomous100% ($203.96 in chips) 
Seat 5: Kukuryzka ($109.35 in chips) 
Seat 6: RoadtoNepal ($182.46 in chips) 
Seat 7: Ohpeel ($124.30 in chips) 
Seat 8: deepblue0000 ($130.49 in chips) 
Ohpeel: posts small blind $0.50
deepblue0000: posts big blind $1
di0d80: sits out 
*** HOLE CARDS ***
Dealt to matiko09 [8s Js]
UShallGimme$: folds 
matiko09: folds 
Sweden_Pound: raises $2 to $3
Venomous100%: folds 
Kukuryzka: folds 
RoadtoNepal: folds 
Ohpeel: folds 
deepblue0000: folds 
Uncalled bet ($2) returned to Sweden_Pound
Sweden_Pound collected $2.50 from pot
Sweden_Pound: doesn't show hand 
*** SUMMARY ***
Total pot $2.50 | Rake $0 
Seat 1: UShallGimme$ folded before Flop (didn't bet)
Seat 2: matiko09 folded before Flop (didn't bet)
Seat 3: Sweden_Pound collected ($2.50)
Seat 4: Venomous100% folded before Flop (didn't bet)
Seat 5: Kukuryzka folded before Flop (didn't bet)
Seat 6: RoadtoNepal (button) folded before Flop (didn't bet)
Seat 7: Ohpeel (small blind) folded before Flop
Seat 8: deepblue0000 (big blind) folded before Flop





PokerStars Hand #147755384424:  Hold'em No Limit ($0.50/$1.00 USD) - 2016/01/27 12:16:37 CET [2016/01/27 6:16:37 ET]
Table 'Nanking' 9-max Seat #9 is the button
Seat 1: Peu3aHy ($107.54 in chips) 
Seat 2: Dachish ($89.83 in chips) 
Seat 3: nuaxin ($111.69 in chips) 
Seat 4: COOLIKO\/23 ($165.99 in chips) 
Seat 5: TheGentleFox ($2.62 in chips) 
Seat 6: Kukuryzka ($237.20 in chips) 
Seat 7: tipner ($100 in chips) 
Seat 8: matiko09 ($100 in chips) 
Seat 9: Sweden_Pound ($119.68 in chips) 
Peu3aHy: posts small blind $0.50
Dachish: posts big blind $1
*** HOLE CARDS ***
Dealt to matiko09 [8c 7c]
nuaxin: folds 
COOLIKO\/23: folds 
TheGentleFox: folds 
TheGentleFox leaves the table
Kukuryzka: folds 
tipner: raises $2 to $3
di0d80 joins the table at seat #5 
matiko09: raises $6.50 to $9.50
Sweden_Pound: folds 
Peu3aHy: folds 
Dachish: folds 
tipner: folds 
Uncalled bet ($6.50) returned to matiko09
matiko09 collected $7.50 from pot
matiko09: doesn't show hand 
*** SUMMARY ***
Total pot $7.50 | Rake $0 
Seat 1: Peu3aHy (small blind) folded before Flop
Seat 2: Dachish (big blind) folded before Flop
Seat 3: nuaxin folded before Flop (didn't bet)
Seat 4: COOLIKO\/23 folded before Flop (didn't bet)
Seat 5: TheGentleFox folded before Flop (didn't bet)
Seat 6: Kukuryzka folded before Flop (didn't bet)
Seat 7: tipner folded before Flop
Seat 8: matiko09 collected ($7.50)
Seat 9: Sweden_Pound (button) folded before Flop (didn't bet)





PokerStars Hand #147755384241:  Hold'em No Limit ($0.50/$1.00 USD) - 2016/01/27 12:16:37 CET [2016/01/27 6:16:37 ET]
Table 'Klemola' 9-max Seat #8 is the button
Seat 2: Kukuryzka ($100 in chips) 
Seat 3: greyman571 ($45.96 in chips) 
Seat 5: tipner ($100 in chips) 
Seat 6: sylvian31 ($100 in chips) 
Seat 7: matiko09 ($123.24 in chips) 
Seat 8: Sweden_Pound ($100 in chips) 
Seat 9: blef1992 ($110.28 in chips) 
blef1992: posts small blind $0.50
COOLIKO\/23: is sitting out 
Kukuryzka: posts big blind $1
torkkdnm: sits out 
*** HOLE CARDS ***
Dealt to matiko09 [6c 8c]
greyman571: folds 
tipner: folds 
sylvian31: raises $2 to $3
matiko09: folds 
Sweden_Pound: folds 
blef1992: calls $2.50
Kukuryzka: folds 
*** FLOP *** [5d 2h Qd]
blef1992: checks 
sylvian31: bets $3.74
blef1992: calls $3.74
*** TURN *** [5d 2h Qd] [7c]
blef1992: checks 
sylvian31: bets $9.26
blef1992: folds 
Uncalled bet ($9.26) returned to sylvian31
sylvian31 collected $13.83 from pot
sylvian31: doesn't show hand 
*** SUMMARY ***
Total pot $14.48 | Rake $0.65 
Board [5d 2h Qd 7c]
Seat 2: Kukuryzka (big blind) folded before Flop
Seat 3: greyman571 folded before Flop (didn't bet)
Seat 5: tipner folded before Flop (didn't bet)
Seat 6: sylvian31 collected ($13.83)
Seat 7: matiko09 folded before Flop (didn't bet)
Seat 8: Sweden_Pound (button) folded before Flop (didn't bet)
Seat 9: blef1992 (small blind) folded on the Turn





PokerStars Hand #147755384628:  Hold'em No Limit ($0.50/$1.00 USD) - 2016/01/27 12:16:38 CET [2016/01/27 6:16:38 ET]
Table 'Dollfus' 9-max Seat #4 is the button
Seat 2: nosoant ($63.63 in chips) 
Seat 3: UShallGimme$ ($124.48 in chips) 
Seat 4: matiko09 ($107.14 in chips) 
Seat 5: pandalapa ($217.98 in chips) 
Seat 6: deepblue0000 ($119.66 in chips) 
Seat 7: Dödi123 ($198.11 in chips) 
Seat 8: Venomous100% ($101.52 in chips) 
Seat 9: COOLIKO\/23 ($127.37 in chips) 
pandalapa: posts small blind $0.50
deepblue0000: posts big blind $1
Kukuryzka: sits out 
*** HOLE CARDS ***
Dealt to matiko09 [3h 9s]
Dödi123: folds 
Venomous100%: folds 
COOLIKO\/23: folds 
nosoant: raises $3 to $4
UShallGimme$: folds 
matiko09: folds 
pandalapa: folds 
deepblue0000: folds 
Uncalled bet ($3) returned to nosoant
nosoant collected $2.50 from pot
nosoant: doesn't show hand 
*** SUMMARY ***
Total pot $2.50 | Rake $0 
Seat 2: nosoant collected ($2.50)
Seat 3: UShallGimme$ folded before Flop (didn't bet)
Seat 4: matiko09 (button) folded before Flop (didn't bet)
Seat 5: pandalapa (small blind) folded before Flop
Seat 6: deepblue0000 (big blind) folded before Flop
Seat 7: Dödi123 folded before Flop (didn't bet)
Seat 8: Venomous100% folded before Flop (didn't bet)
Seat 9: COOLIKO\/23 folded before Flop (didn't bet)





PokerStars Hand #147755385750:  Hold'em No Limit ($0.50/$1.00 USD) - 2016/01/27 12:16:40 CET [2016/01/27 6:16:40 ET]
Table 'Fragaria II' 9-max Seat #6 is the button
Seat 1: deepblue0000 ($101.50 in chips) 
Seat 2: GG-NoR34D. ($75.06 in chips) 
Seat 3: Sweden_Pound ($106.57 in chips) 
Seat 5: Venomous100% ($163.04 in chips) 
Seat 6: UShallGimme$ ($177.49 in chips) 
Seat 7: Hobby-.-AK ($53.49 in chips) 
Seat 9: matiko09 ($104.50 in chips) 
Hobby-.-AK: posts small blind $0.50
mycka86: is sitting out 
matiko09: posts big blind $1
mycka86 leaves the table
di0d80: sits out 
*** HOLE CARDS ***
Dealt to matiko09 [4s Td]
tipner joins the table at seat #8 
deepblue0000: folds 
GG-NoR34D.: folds 
Sweden_Pound: folds 
Venomous100%: folds 
UShallGimme$: raises $1 to $2
Hobby-.-AK: folds 
matiko09: folds 
Uncalled bet ($1) returned to UShallGimme$
UShallGimme$ collected $2.50 from pot
UShallGimme$: doesn't show hand 
*** SUMMARY ***
Total pot $2.50 | Rake $0 
Seat 1: deepblue0000 folded before Flop (didn't bet)
Seat 2: GG-NoR34D. folded before Flop (didn't bet)
Seat 3: Sweden_Pound folded before Flop (didn't bet)
Seat 5: Venomous100% folded before Flop (didn't bet)
Seat 6: UShallGimme$ (button) collected ($2.50)
Seat 7: Hobby-.-AK (small blind) folded before Flop
Seat 9: matiko09 (big blind) folded before Flop





PokerStars Hand #147755389368:  Hold'em No Limit ($0.50/$1.00 USD) - 2016/01/27 12:16:47 CET [2016/01/27 6:16:47 ET]
Table 'Alkmene II' 9-max Seat #8 is the button
Seat 1: matiko09 ($120.11 in chips) 
Seat 2: deepblue0000 ($103.68 in chips) 
Seat 4: CoolFireX ($179.97 in chips) 
Seat 5: Sweden_Pound ($132.55 in chips) 
Seat 6: Peu3aHy ($109.22 in chips) 
Seat 7: mycka86 ($100 in chips) 
Seat 8: fecsok1 ($112.84 in chips) 
Seat 9: pandalapa ($100 in chips) 
pandalapa: posts small blind $0.50
matiko09: posts big blind $1
di0d80: sits out 
*** HOLE CARDS ***
Dealt to matiko09 [3c Qd]
deepblue0000: folds 
CoolFireX: folds 
Sweden_Pound: folds 
Peu3aHy: folds 
mycka86: raises $1.10 to $2.10
fecsok1: raises $3.40 to $5.50
pandalapa: folds 
matiko09: folds 
mycka86: calls $3.40
*** FLOP *** [Js 6d 3s]
mycka86: checks 
fecsok1: bets $6.50
mycka86: folds 
Uncalled bet ($6.50) returned to fecsok1
fecsok1 collected $11.94 from pot
*** SUMMARY ***
Total pot $12.50 | Rake $0.56 
Board [Js 6d 3s]
Seat 1: matiko09 (big blind) folded before Flop
Seat 2: deepblue0000 folded before Flop (didn't bet)
Seat 4: CoolFireX folded before Flop (didn't bet)
Seat 5: Sweden_Pound folded before Flop (didn't bet)
Seat 6: Peu3aHy folded before Flop (didn't bet)
Seat 7: mycka86 folded on the Flop
Seat 8: fecsok1 (button) collected ($11.94)
Seat 9: pandalapa (small blind) folded before Flop





PokerStars Hand #147755393221:  Hold'em No Limit ($0.50/$1.00 USD) - 2016/01/27 12:16:54 CET [2016/01/27 6:16:54 ET]
Table 'Delphinus II' 9-max Seat #4 is the button
Seat 1: Saintreine ($151.56 in chips) 
Seat 2: UShallGimme$ ($100 in chips) 
Seat 3: deepblue0000 ($444.93 in chips) 
Seat 4: matiko09 ($100 in chips) 
Seat 5: pandalapa ($102.39 in chips) 
Seat 6: Sweden_Pound ($144.64 in chips) 
Seat 7: RUS)Timur ($129.85 in chips) 
Seat 8: mycka86 ($121.54 in chips) 
Seat 9: FreeRangtor ($99 in chips) 
pandalapa: posts small blind $0.50
Sweden_Pound: posts big blind $1
*** HOLE CARDS ***
Dealt to matiko09 [Js Th]
RUS)Timur: folds 
mycka86: folds 
FreeRangtor: folds 
Saintreine: folds 
UShallGimme$: raises $2 to $3
deepblue0000: calls $3
matiko09: folds 
pandalapa: calls $2.50
Sweden_Pound: folds 
*** FLOP *** [7s 3c 8s]
pandalapa: checks 
UShallGimme$: bets $6
deepblue0000: folds 
pandalapa: folds 
Uncalled bet ($6) returned to UShallGimme$
UShallGimme$ collected $9.55 from pot
UShallGimme$: doesn't show hand 
*** SUMMARY ***
Total pot $10 | Rake $0.45 
Board [7s 3c 8s]
Seat 1: Saintreine folded before Flop (didn't bet)
Seat 2: UShallGimme$ collected ($9.55)
Seat 3: deepblue0000 folded on the Flop
Seat 4: matiko09 (button) folded before Flop (didn't bet)
Seat 5: pandalapa (small blind) folded on the Flop
Seat 6: Sweden_Pound (big blind) folded before Flop
Seat 7: RUS)Timur folded before Flop (didn't bet)
Seat 8: mycka86 folded before Flop (didn't bet)
Seat 9: FreeRangtor folded before Flop (didn't bet)





PokerStars Hand #147755397735:  Hold'em No Limit ($0.50/$1.00 USD) - 2016/01/27 12:17:02 CET [2016/01/27 6:17:02 ET]
Table 'Dollfus' 9-max Seat #5 is the button
Seat 2: nosoant ($65.13 in chips) 
Seat 3: UShallGimme$ ($124.48 in chips) 
Seat 4: matiko09 ($107.14 in chips) 
Seat 5: pandalapa ($217.48 in chips) 
Seat 6: deepblue0000 ($118.66 in chips) 
Seat 7: Dödi123 ($198.11 in chips) 
Seat 8: Venomous100% ($101.52 in chips) 
Seat 9: COOLIKO\/23 ($127.37 in chips) 
deepblue0000: posts small blind $0.50
Dödi123: posts big blind $1
Kukuryzka: sits out 
*** HOLE CARDS ***
Dealt to matiko09 [4d 6d]
Venomous100%: raises $2 to $3
COOLIKO\/23: folds 
nosoant: raises $3 to $6
UShallGimme$: folds 
matiko09: folds 
pandalapa: folds 
deepblue0000: folds 
Dödi123: folds 
Venomous100%: calls $3
*** FLOP *** [9s 4s Ts]
Venomous100%: checks 
nosoant: bets $8
Venomous100%: folds 
Uncalled bet ($8) returned to nosoant
nosoant collected $12.89 from pot
nosoant: doesn't show hand 
*** SUMMARY ***
Total pot $13.50 | Rake $0.61 
Board [9s 4s Ts]
Seat 2: nosoant collected ($12.89)
Seat 3: UShallGimme$ folded before Flop (didn't bet)
Seat 4: matiko09 folded before Flop (didn't bet)
Seat 5: pandalapa (button) folded before Flop (didn't bet)
Seat 6: deepblue0000 (small blind) folded before Flop
Seat 7: Dödi123 (big blind) folded before Flop
Seat 8: Venomous100% folded on the Flop
Seat 9: COOLIKO\/23 folded before Flop (didn't bet)





PokerStars Hand #147755399311:  Hold'em No Limit ($0.50/$1.00 USD) - 2016/01/27 12:17:05 CET [2016/01/27 6:17:05 ET]
Table 'Fragaria II' 9-max Seat #7 is the button
Seat 1: deepblue0000 ($101.50 in chips) 
Seat 2: GG-NoR34D. ($75.06 in chips) 
Seat 3: Sweden_Pound ($106.57 in chips) 
Seat 5: Venomous100% ($163.04 in chips) 
Seat 6: UShallGimme$ ($178.99 in chips) 
Seat 7: Hobby-.-AK ($52.99 in chips) 
Seat 9: matiko09 ($103.50 in chips) 
tipner will be allowed to play after the button
matiko09: posts small blind $0.50
deepblue0000: posts big blind $1
di0d80: sits out 
*** HOLE CARDS ***
Dealt to matiko09 [7h 3h]
GG-NoR34D.: folds 
Sweden_Pound: folds 
Venomous100%: folds 
UShallGimme$: raises $1.50 to $2.50
Hobby-.-AK: folds 
matiko09: folds 
deepblue0000: folds 
Uncalled bet ($1.50) returned to UShallGimme$
UShallGimme$ collected $2.50 from pot
UShallGimme$: doesn't show hand 
*** SUMMARY ***
Total pot $2.50 | Rake $0 
Seat 1: deepblue0000 (big blind) folded before Flop
Seat 2: GG-NoR34D. folded before Flop (didn't bet)
Seat 3: Sweden_Pound folded before Flop (didn't bet)
Seat 5: Venomous100% folded before Flop (didn't bet)
Seat 6: UShallGimme$ collected ($2.50)
Seat 7: Hobby-.-AK (button) folded before Flop (didn't bet)
Seat 9: matiko09 (small blind) folded before Flop





PokerStars Hand #147755400426:  Hold'em No Limit ($0.50/$1.00 USD) - 2016/01/27 12:17:08 CET [2016/01/27 6:17:08 ET]
Table 'Marlu II' 9-max Seat #6 is the button
Seat 1: Kukuryzka ($107.45 in chips) 
Seat 2: matiko09 ($100 in chips) 
Seat 3: COOLIKO\/23 ($100 in chips) 
Seat 4: tipner ($113 in chips) 
Seat 5: Sweden_Pound ($144.66 in chips) 
Seat 6: LIGOPSIXIS78 ($28.38 in chips) 
Seat 7: UShallGimme$ ($100 in chips) 
Seat 8: Peu3aHy ($100 in chips) 
Seat 9: platinium1 ($73.66 in chips) 
UShallGimme$: posts small blind $0.50
Peu3aHy: posts big blind $1
*** HOLE CARDS ***
Dealt to matiko09 [8h 4s]
platinium1: folds 
Kukuryzka: folds 
matiko09: folds 
COOLIKO\/23: folds 
tipner: folds 
Sweden_Pound: raises $1.50 to $2.50
LIGOPSIXIS78: folds 
UShallGimme$: folds 
Peu3aHy: folds 
Uncalled bet ($1.50) returned to Sweden_Pound
Sweden_Pound collected $2.50 from pot
Sweden_Pound: doesn't show hand 
*** SUMMARY ***
Total pot $2.50 | Rake $0 
Seat 1: Kukuryzka folded before Flop (didn't bet)
Seat 2: matiko09 folded before Flop (didn't bet)
Seat 3: COOLIKO\/23 folded before Flop (didn't bet)
Seat 4: tipner folded before Flop (didn't bet)
Seat 5: Sweden_Pound collected ($2.50)
Seat 6: LIGOPSIXIS78 (button) folded before Flop (didn't bet)
Seat 7: UShallGimme$ (small blind) folded before Flop
Seat 8: Peu3aHy (big blind) folded before Flop
Seat 9: platinium1 folded before Flop (didn't bet)





PokerStars Hand #147755402741:  Hold'em No Limit ($0.50/$1.00 USD) - 2016/01/27 12:17:12 CET [2016/01/27 6:17:12 ET]
Table 'Alhajoth' 9-max Seat #7 is the button
Seat 1: UShallGimme$ ($116.45 in chips) 
Seat 2: matiko09 ($104 in chips) 
Seat 3: Sweden_Pound ($101.50 in chips) 
Seat 4: Venomous100% ($203.96 in chips) 
Seat 5: Kukuryzka ($109.35 in chips) 
Seat 6: RoadtoNepal ($182.46 in chips) 
Seat 7: Ohpeel ($123.80 in chips) 
Seat 8: deepblue0000 ($129.49 in chips) 
Seat 9: di0d80 ($100 in chips) 
deepblue0000: posts small blind $0.50
di0d80: posts big blind $1
*** HOLE CARDS ***
Dealt to matiko09 [2d Ah]
UShallGimme$: folds 
matiko09: folds 
Sweden_Pound: folds 
Venomous100%: folds 
Kukuryzka: folds 
RoadtoNepal: raises $2 to $3
Ohpeel: folds 
deepblue0000: folds 
di0d80: folds 
Uncalled bet ($2) returned to RoadtoNepal
RoadtoNepal collected $2.50 from pot
RoadtoNepal: doesn't show hand 
*** SUMMARY ***
Total pot $2.50 | Rake $0 
Seat 1: UShallGimme$ folded before Flop (didn't bet)
Seat 2: matiko09 folded before Flop (didn't bet)
Seat 3: Sweden_Pound folded before Flop (didn't bet)
Seat 4: Venomous100% folded before Flop (didn't bet)
Seat 5: Kukuryzka folded before Flop (didn't bet)
Seat 6: RoadtoNepal collected ($2.50)
Seat 7: Ohpeel (button) folded before Flop (didn't bet)
Seat 8: deepblue0000 (small blind) folded before Flop
Seat 9: di0d80 (big blind) folded before Flop





PokerStars Hand #147755405581:  Hold'em No Limit ($0.50/$1.00 USD) - 2016/01/27 12:17:17 CET [2016/01/27 6:17:17 ET]
Table 'Nanking' 9-max Seat #1 is the button
Seat 1: Peu3aHy ($107.04 in chips) 
Seat 2: Dachish ($88.83 in chips) 
Seat 3: nuaxin ($111.69 in chips) 
Seat 4: COOLIKO\/23 ($165.99 in chips) 
Seat 6: Kukuryzka ($237.20 in chips) 
Seat 7: tipner ($100 in chips) 
Seat 8: matiko09 ($104.50 in chips) 
Seat 9: Sweden_Pound ($119.68 in chips) 
Dachish: posts small blind $0.50
nuaxin: posts big blind $1
di0d80: sits out 
*** HOLE CARDS ***
Dealt to matiko09 [Qs Ac]
COOLIKO\/23: folds 
Kukuryzka: folds 
tipner: folds 
matiko09: raises $2 to $3
Sweden_Pound: folds 
Peu3aHy: folds 
Dachish: folds 
nuaxin: folds 
Uncalled bet ($2) returned to matiko09
matiko09 collected $2.50 from pot
matiko09: doesn't show hand 
*** SUMMARY ***
Total pot $2.50 | Rake $0 
Seat 1: Peu3aHy (button) folded before Flop (didn't bet)
Seat 2: Dachish (small blind) folded before Flop
Seat 3: nuaxin (big blind) folded before Flop
Seat 4: COOLIKO\/23 folded before Flop (didn't bet)
Seat 6: Kukuryzka folded before Flop (didn't bet)
Seat 7: tipner folded before Flop (didn't bet)
Seat 8: matiko09 collected ($2.50)
Seat 9: Sweden_Pound folded before Flop (didn't bet)





PokerStars Hand #147755408824:  Hold'em No Limit ($0.50/$1.00 USD) - 2016/01/27 12:17:23 CET [2016/01/27 6:17:23 ET]
Table 'Fragaria II' 9-max Seat #9 is the button
Seat 1: deepblue0000 ($100.50 in chips) 
Seat 2: GG-NoR34D. ($75.06 in chips) 
Seat 3: Sweden_Pound ($106.57 in chips) 
Seat 5: Venomous100% ($163.04 in chips) 
Seat 6: UShallGimme$ ($180.49 in chips) 
Seat 7: Hobby-.-AK ($52.99 in chips) 
Seat 9: matiko09 ($103 in chips) 
deepblue0000: posts small blind $0.50
GG-NoR34D.: posts big blind $1
di0d80: sits out 
tipner: sits out 
*** HOLE CARDS ***
Dealt to matiko09 [Js Jc]
Sweden_Pound: folds 
Venomous100%: folds 
UShallGimme$: raises $2 to $3
Hobby-.-AK: folds 
matiko09: calls $3
deepblue0000: folds 
GG-NoR34D.: folds 
*** FLOP *** [3s 3h 6c]
UShallGimme$: checks 
matiko09: bets $4.65
UShallGimme$: calls $4.65
*** TURN *** [3s 3h 6c] [Kc]
UShallGimme$: checks 
matiko09: checks 
*** RIVER *** [3s 3h 6c Kc] [5d]
UShallGimme$: checks 
matiko09: bets $4.97
UShallGimme$: calls $4.97
*** SHOW DOWN ***
matiko09: shows [Js Jc] (two pair, Jacks and Threes)
UShallGimme$: mucks hand 
matiko09 collected $25.54 from pot
*** SUMMARY ***
Total pot $26.74 | Rake $1.20 
Board [3s 3h 6c Kc 5d]
Seat 1: deepblue0000 (small blind) folded before Flop
Seat 2: GG-NoR34D. (big blind) folded before Flop
Seat 3: Sweden_Pound folded before Flop (didn't bet)
Seat 5: Venomous100% folded before Flop (didn't bet)
Seat 6: UShallGimme$ mucked [8d 8c]
Seat 7: Hobby-.-AK folded before Flop (didn't bet)
Seat 9: matiko09 (button) showed [Js Jc] and won ($25.54) with two pair, Jacks and Threes





PokerStars Hand #147755416779:  Hold'em No Limit ($0.50/$1.00 USD) - 2016/01/27 12:17:38 CET [2016/01/27 6:17:38 ET]
Table 'Klemola' 9-max Seat #9 is the button
Seat 2: Kukuryzka ($99 in chips) 
Seat 3: greyman571 ($45.96 in chips) 
Seat 5: tipner ($100 in chips) 
Seat 6: sylvian31 ($107.09 in chips) 
Seat 7: matiko09 ($123.24 in chips) 
Seat 8: Sweden_Pound ($100 in chips) 
Seat 9: blef1992 ($103.54 in chips) 
Kukuryzka: posts small blind $0.50
greyman571: posts big blind $1
torkkdnm: sits out 
*** HOLE CARDS ***
Dealt to matiko09 [9d Qc]
tipner: folds 
sylvian31: folds 
matiko09: folds 
Sweden_Pound: folds 
blef1992: folds 
Kukuryzka: raises $2 to $3
greyman571: calls $2
*** FLOP *** [9c Kh Th]
Kukuryzka: bets $4.30
greyman571: calls $4.30
*** TURN *** [9c Kh Th] [2c]
Kukuryzka: bets $11
greyman571: folds 
Uncalled bet ($11) returned to Kukuryzka
Kukuryzka collected $13.94 from pot
Kukuryzka: doesn't show hand 
*** SUMMARY ***
Total pot $14.60 | Rake $0.66 
Board [9c Kh Th 2c]
Seat 2: Kukuryzka (small blind) collected ($13.94)
Seat 3: greyman571 (big blind) folded on the Turn
Seat 5: tipner folded before Flop (didn't bet)
Seat 6: sylvian31 folded before Flop (didn't bet)
Seat 7: matiko09 folded before Flop (didn't bet)
Seat 8: Sweden_Pound folded before Flop (didn't bet)
Seat 9: blef1992 (button) folded before Flop (didn't bet)





PokerStars Hand #147755417755:  Hold'em No Limit ($0.50/$1.00 USD) - 2016/01/27 12:17:40 CET [2016/01/27 6:17:40 ET]
Table 'Delphinus II' 9-max Seat #5 is the button
Seat 1: Saintreine ($151.56 in chips) 
Seat 2: UShallGimme$ ($106.55 in chips) 
Seat 3: deepblue0000 ($441.93 in chips) 
Seat 4: matiko09 ($100 in chips) 
Seat 5: pandalapa ($100 in chips) 
Seat 6: Sweden_Pound ($143.64 in chips) 
Seat 7: RUS)Timur ($129.85 in chips) 
Seat 8: mycka86 ($121.54 in chips) 
Seat 9: FreeRangtor ($99 in chips) 
Sweden_Pound: posts small blind $0.50
RUS)Timur: posts big blind $1
*** HOLE CARDS ***
Dealt to matiko09 [5s 8h]
mycka86: folds 
FreeRangtor: raises $2 to $3
Saintreine: folds 
UShallGimme$: folds 
deepblue0000: folds 
matiko09: folds 
pandalapa: folds 
Sweden_Pound: folds 
RUS)Timur: folds 
Uncalled bet ($2) returned to FreeRangtor
FreeRangtor collected $2.50 from pot
*** SUMMARY ***
Total pot $2.50 | Rake $0 
Seat 1: Saintreine folded before Flop (didn't bet)
Seat 2: UShallGimme$ folded before Flop (didn't bet)
Seat 3: deepblue0000 folded before Flop (didn't bet)
Seat 4: matiko09 folded before Flop (didn't bet)
Seat 5: pandalapa (button) folded before Flop (didn't bet)
Seat 6: Sweden_Pound (small blind) folded before Flop
Seat 7: RUS)Timur (big blind) folded before Flop
Seat 8: mycka86 folded before Flop (didn't bet)
Seat 9: FreeRangtor collected ($2.50)





PokerStars Hand #147755425877:  Hold'em No Limit ($0.50/$1.00 USD) - 2016/01/27 12:17:54 CET [2016/01/27 6:17:54 ET]
Table 'Marlu II' 9-max Seat #7 is the button
Seat 1: Kukuryzka ($107.45 in chips) 
Seat 2: matiko09 ($100 in chips) 
Seat 3: COOLIKO\/23 ($100 in chips) 
Seat 4: tipner ($113 in chips) 
Seat 5: Sweden_Pound ($146.16 in chips) 
Seat 6: LIGOPSIXIS78 ($28.38 in chips) 
Seat 7: UShallGimme$ ($100 in chips) 
Seat 8: Peu3aHy ($100 in chips) 
Seat 9: platinium1 ($73.66 in chips) 
Peu3aHy: posts small blind $0.50
platinium1: posts big blind $1
*** HOLE CARDS ***
Dealt to matiko09 [7h Td]
Kukuryzka: folds 
matiko09: folds 
COOLIKO\/23: folds 
tipner: folds 
Sweden_Pound: raises $2 to $3
LIGOPSIXIS78: folds 
UShallGimme$: folds 
Peu3aHy: folds 
platinium1: calls $2
*** FLOP *** [3d Ks Jc]
platinium1: bets $4
Sweden_Pound: folds 
Uncalled bet ($4) returned to platinium1
platinium1 collected $6.21 from pot
platinium1: doesn't show hand 
*** SUMMARY ***
Total pot $6.50 | Rake $0.29 
Board [3d Ks Jc]
Seat 1: Kukuryzka folded before Flop (didn't bet)
Seat 2: matiko09 folded before Flop (didn't bet)
Seat 3: COOLIKO\/23 folded before Flop (didn't bet)
Seat 4: tipner folded before Flop (didn't bet)
Seat 5: Sweden_Pound folded on the Flop
Seat 6: LIGOPSIXIS78 folded before Flop (didn't bet)
Seat 7: UShallGimme$ (button) folded before Flop (didn't bet)
Seat 8: Peu3aHy (small blind) folded before Flop
Seat 9: platinium1 (big blind) collected ($6.21)





PokerStars Hand #147755428343:  Hold'em No Limit ($0.50/$1.00 USD) - 2016/01/27 12:17:59 CET [2016/01/27 6:17:59 ET]
Table 'Alhajoth' 9-max Seat #8 is the button
Seat 1: UShallGimme$ ($116.45 in chips) 
Seat 2: matiko09 ($104 in chips) 
Seat 3: Sweden_Pound ($101.50 in chips) 
Seat 4: Venomous100% ($203.96 in chips) 
Seat 5: Kukuryzka ($109.35 in chips) 
Seat 6: RoadtoNepal ($183.96 in chips) 
Seat 7: Ohpeel ($123.80 in chips) 
Seat 8: deepblue0000 ($128.99 in chips) 
Seat 9: di0d80 ($100 in chips) 
di0d80: posts small blind $0.50
UShallGimme$: posts big blind $1
*** HOLE CARDS ***
Dealt to matiko09 [Kh 2s]
matiko09: folds 
Sweden_Pound: folds 
Venomous100%: folds 
Kukuryzka: folds 
RoadtoNepal: raises $2 to $3
Ohpeel: folds 
deepblue0000: folds 
di0d80: folds 
UShallGimme$: folds 
Uncalled bet ($2) returned to RoadtoNepal
RoadtoNepal collected $2.50 from pot
RoadtoNepal: doesn't show hand 
*** SUMMARY ***
Total pot $2.50 | Rake $0 
Seat 1: UShallGimme$ (big blind) folded before Flop
Seat 2: matiko09 folded before Flop (didn't bet)
Seat 3: Sweden_Pound folded before Flop (didn't bet)
Seat 4: Venomous100% folded before Flop (didn't bet)
Seat 5: Kukuryzka folded before Flop (didn't bet)
Seat 6: RoadtoNepal collected ($2.50)
Seat 7: Ohpeel folded before Flop (didn't bet)
Seat 8: deepblue0000 (button) folded before Flop (didn't bet)
Seat 9: di0d80 (small blind) folded before Flop





PokerStars Hand #147755428814:  Hold'em No Limit ($0.50/$1.00 USD) - 2016/01/27 12:18:00 CET [2016/01/27 6:18:00 ET]
Table 'Nanking' 9-max Seat #2 is the button
Seat 1: Peu3aHy ($107.04 in chips) 
Seat 2: Dachish ($88.33 in chips) 
Seat 3: nuaxin ($110.69 in chips) 
Seat 5: di0d80 ($100 in chips) 
Seat 6: Kukuryzka ($237.20 in chips) 
Seat 7: tipner ($100 in chips) 
Seat 8: matiko09 ($106 in chips) 
Seat 9: Sweden_Pound ($119.68 in chips) 
nuaxin: posts small blind $0.50
COOLIKO\/23: is sitting out 
di0d80: posts big blind $1
*** HOLE CARDS ***
Dealt to matiko09 [Js Td]
Kukuryzka: folds 
tipner: folds 
matiko09: folds 
Sweden_Pound: folds 
Peu3aHy: folds 
Dachish: raises $1 to $2
nuaxin: folds 
di0d80: calls $1
*** FLOP *** [7h Kc 2c]
di0d80: checks 
Dachish: bets $2
di0d80: folds 
Uncalled bet ($2) returned to Dachish
Dachish collected $4.30 from pot
Dachish: doesn't show hand 
*** SUMMARY ***
Total pot $4.50 | Rake $0.20 
Board [7h Kc 2c]
Seat 1: Peu3aHy folded before Flop (didn't bet)
Seat 2: Dachish (button) collected ($4.30)
Seat 3: nuaxin (small blind) folded before Flop
Seat 5: di0d80 (big blind) folded on the Flop
Seat 6: Kukuryzka folded before Flop (didn't bet)
Seat 7: tipner folded before Flop (didn't bet)
Seat 8: matiko09 folded before Flop (didn't bet)
Seat 9: Sweden_Pound folded before Flop (didn't bet)





PokerStars Hand #147755432162:  Hold'em No Limit ($0.50/$1.00 USD) - 2016/01/27 12:18:06 CET [2016/01/27 6:18:06 ET]
Table 'Delphinus II' 9-max Seat #6 is the button
Seat 1: Saintreine ($151.56 in chips) 
Seat 2: UShallGimme$ ($106.55 in chips) 
Seat 3: deepblue0000 ($441.93 in chips) 
Seat 4: matiko09 ($100 in chips) 
Seat 5: pandalapa ($100 in chips) 
Seat 6: Sweden_Pound ($143.14 in chips) 
Seat 7: RUS)Timur ($128.85 in chips) 
Seat 9: FreeRangtor ($100.50 in chips) 
RUS)Timur: posts small blind $0.50
mycka86: is sitting out 
mycka86 leaves the table
FreeRangtor: posts big blind $1
*** HOLE CARDS ***
Dealt to matiko09 [Kh 2c]
Saintreine: folds 
er13to joins the table at seat #8 
UShallGimme$: folds 
deepblue0000: folds 
matiko09: folds 
pandalapa: folds 
Sweden_Pound: folds 
RUS)Timur: raises $2 to $3
FreeRangtor: calls $2
*** FLOP *** [Qs Kc 6s]
RUS)Timur: checks 
FreeRangtor: checks 
*** TURN *** [Qs Kc 6s] [5h]
RUS)Timur: checks 
FreeRangtor: checks 
*** RIVER *** [Qs Kc 6s 5h] [As]
RUS)Timur: bets $2.98
FreeRangtor: folds 
Uncalled bet ($2.98) returned to RUS)Timur
RUS)Timur collected $5.73 from pot
RUS)Timur: doesn't show hand 
*** SUMMARY ***
Total pot $6 | Rake $0.27 
Board [Qs Kc 6s 5h As]
Seat 1: Saintreine folded before Flop (didn't bet)
Seat 2: UShallGimme$ folded before Flop (didn't bet)
Seat 3: deepblue0000 folded before Flop (didn't bet)
Seat 4: matiko09 folded before Flop (didn't bet)
Seat 5: pandalapa folded before Flop (didn't bet)
Seat 6: Sweden_Pound (button) folded before Flop (didn't bet)
Seat 7: RUS)Timur (small blind) collected ($5.73)
Seat 9: FreeRangtor (big blind) folded on the River





PokerStars Hand #147755431904:  Hold'em No Limit ($0.50/$1.00 USD) - 2016/01/27 12:18:06 CET [2016/01/27 6:18:06 ET]
Table 'Dollfus' 9-max Seat #6 is the button
Seat 2: nosoant ($72.02 in chips) 
Seat 3: UShallGimme$ ($124.48 in chips) 
Seat 4: matiko09 ($107.14 in chips) 
Seat 5: pandalapa ($217.48 in chips) 
Seat 6: deepblue0000 ($118.16 in chips) 
Seat 7: Dödi123 ($197.11 in chips) 
Seat 8: Venomous100% ($100 in chips) 
Seat 9: COOLIKO\/23 ($127.37 in chips) 
Dödi123: posts small blind $0.50
Venomous100%: posts big blind $1
Kukuryzka: sits out 
*** HOLE CARDS ***
Dealt to matiko09 [2h 2c]
COOLIKO\/23: folds 
nosoant: folds 
nosoant leaves the table
UShallGimme$: raises $2 to $3
Sweden_Pound joins the table at seat #2 
matiko09: folds 
pandalapa: folds 
deepblue0000: folds 
Dödi123: calls $2.50
Venomous100%: folds 
*** FLOP *** [Ts Qd 4h]
Dödi123: checks 
UShallGimme$: checks 
*** TURN *** [Ts Qd 4h] [Jc]
Dödi123: checks 
UShallGimme$: checks 
*** RIVER *** [Ts Qd 4h Jc] [Jd]
Dödi123: checks 
Kukuryzka leaves the table
UShallGimme$: checks 
*** SHOW DOWN ***
Dödi123: shows [6h 6c] (two pair, Jacks and Sixes)
UShallGimme$: shows [Td 9d] (two pair, Jacks and Tens)
UShallGimme$ collected $6.68 from pot
*** SUMMARY ***
Total pot $7 | Rake $0.32 
Board [Ts Qd 4h Jc Jd]
Seat 2: nosoant folded before Flop (didn't bet)
Seat 3: UShallGimme$ showed [Td 9d] and won ($6.68) with two pair, Jacks and Tens
Seat 4: matiko09 folded before Flop (didn't bet)
Seat 5: pandalapa folded before Flop (didn't bet)
Seat 6: deepblue0000 (button) folded before Flop (didn't bet)
Seat 7: Dödi123 (small blind) showed [6h 6c] and lost with two pair, Jacks and Sixes
Seat 8: Venomous100% (big blind) folded before Flop
Seat 9: COOLIKO\/23 folded before Flop (didn't bet)





PokerStars Hand #147755432303:  Hold'em No Limit ($0.50/$1.00 USD) - 2016/01/27 12:18:06 CET [2016/01/27 6:18:06 ET]
Table 'Alkmene II' 9-max Seat #9 is the button
Seat 1: matiko09 ($119.11 in chips) 
Seat 2: deepblue0000 ($103.68 in chips) 
Seat 4: CoolFireX ($179.97 in chips) 
Seat 5: Sweden_Pound ($132.55 in chips) 
Seat 6: Peu3aHy ($109.22 in chips) 
Seat 7: mycka86 ($100 in chips) 
Seat 8: fecsok1 ($119.28 in chips) 
Seat 9: pandalapa ($100 in chips) 
matiko09: posts small blind $0.50
deepblue0000: posts big blind $1
di0d80: sits out 
*** HOLE CARDS ***
Dealt to matiko09 [Ts 9h]
CoolFireX: folds 
Sweden_Pound: folds 
Peu3aHy: folds 
mycka86: raises $1.50 to $2.50
fecsok1: folds 
pandalapa: folds 
matiko09: folds 
deepblue0000: folds 
Uncalled bet ($1.50) returned to mycka86
mycka86 collected $2.50 from pot
*** SUMMARY ***
Total pot $2.50 | Rake $0 
Seat 1: matiko09 (small blind) folded before Flop
Seat 2: deepblue0000 (big blind) folded before Flop
Seat 4: CoolFireX folded before Flop (didn't bet)
Seat 5: Sweden_Pound folded before Flop (didn't bet)
Seat 6: Peu3aHy folded before Flop (didn't bet)
Seat 7: mycka86 collected ($2.50)
Seat 8: fecsok1 folded before Flop (didn't bet)
Seat 9: pandalapa (button) folded before Flop (didn't bet)





PokerStars Hand #147755436183:  Hold'em No Limit ($1/$2 USD) - 2016/01/27 12:18:13 CET [2016/01/27 6:18:13 ET]
Table 'Phobos II' 9-max Seat #8 is the button
Seat 1: LRV21 ($772.51 in chips) 
Seat 3: sylvian31 ($245.20 in chips) 
Seat 4: flk.Dasas ($200 in chips) 
Seat 5: tipner ($200 in chips) 
Seat 6: matiko09 ($273.87 in chips) 
Seat 7: Venomous100% ($336.38 in chips) 
Seat 8: RoadtoNepal ($200 in chips) 
Seat 9: Kukuryzka ($276.36 in chips) 
Kukuryzka: posts small blind $1
LRV21: posts big blind $2
di0d80: sits out 
*** HOLE CARDS ***
Dealt to matiko09 [Ac Ks]
sylvian31: folds 
flk.Dasas: folds 
tipner: folds 
matiko09: raises $4 to $6
Venomous100%: folds 
RoadtoNepal: folds 
Kukuryzka: folds 
LRV21: calls $4
*** FLOP *** [Js Qs 7c]
LRV21: bets $12.42
matiko09: calls $12.42
*** TURN *** [Js Qs 7c] [3c]
LRV21: bets $36.14
matiko09: folds 
Uncalled bet ($36.14) returned to LRV21
LRV21 collected $36.14 from pot
LRV21: doesn't show hand 
*** SUMMARY ***
Total pot $37.84 | Rake $1.70 
Board [Js Qs 7c 3c]
Seat 1: LRV21 (big blind) collected ($36.14)
Seat 3: sylvian31 folded before Flop (didn't bet)
Seat 4: flk.Dasas folded before Flop (didn't bet)
Seat 5: tipner folded before Flop (didn't bet)
Seat 6: matiko09 folded on the Turn
Seat 7: Venomous100% folded before Flop (didn't bet)
Seat 8: RoadtoNepal (button) folded before Flop (didn't bet)
Seat 9: Kukuryzka (small blind) folded before Flop





PokerStars Hand #147755437808:  Hold'em No Limit ($0.50/$1.00 USD) - 2016/01/27 12:18:16 CET [2016/01/27 6:18:16 ET]
Table 'Klemola' 9-max Seat #2 is the button
Seat 2: Kukuryzka ($105.64 in chips) 
Seat 3: greyman571 ($38.66 in chips) 
Seat 4: torkkdnm ($100 in chips) 
Seat 5: tipner ($100 in chips) 
Seat 6: sylvian31 ($107.09 in chips) 
Seat 7: matiko09 ($123.24 in chips) 
Seat 8: Sweden_Pound ($100 in chips) 
Seat 9: blef1992 ($103.54 in chips) 
greyman571: posts small blind $0.50
torkkdnm: posts big blind $1
*** HOLE CARDS ***
Dealt to matiko09 [8c Qh]
tipner: folds 
sylvian31: folds 
matiko09: folds 
blef1992 is disconnected 
Sweden_Pound: folds 
blef1992 has timed out while disconnected
blef1992: folds 
Kukuryzka: folds 
greyman571: folds 
Uncalled bet ($0.50) returned to torkkdnm
torkkdnm collected $1 from pot
*** SUMMARY ***
Total pot $1 | Rake $0 
Seat 2: Kukuryzka (button) folded before Flop (didn't bet)
Seat 3: greyman571 (small blind) folded before Flop
Seat 4: torkkdnm (big blind) collected ($1)
Seat 5: tipner folded before Flop (didn't bet)
Seat 6: sylvian31 folded before Flop (didn't bet)
Seat 7: matiko09 folded before Flop (didn't bet)
Seat 8: Sweden_Pound folded before Flop (didn't bet)
Seat 9: blef1992 folded before Flop (didn't bet)





PokerStars Hand #147755446522:  Hold'em No Limit ($0.50/$1.00 USD) - 2016/01/27 12:18:32 CET [2016/01/27 6:18:32 ET]
Table 'Alhajoth' 9-max Seat #9 is the button
Seat 1: UShallGimme$ ($115.45 in chips) 
Seat 2: matiko09 ($104 in chips) 
Seat 3: Sweden_Pound ($101.50 in chips) 
Seat 4: Venomous100% ($203.96 in chips) 
Seat 5: Kukuryzka ($109.35 in chips) 
Seat 6: RoadtoNepal ($185.46 in chips) 
Seat 7: Ohpeel ($123.80 in chips) 
Seat 8: deepblue0000 ($128.99 in chips) 
Seat 9: di0d80 ($100 in chips) 
UShallGimme$: posts small blind $0.50
matiko09: posts big blind $1
*** HOLE CARDS ***
Dealt to matiko09 [Jh 7h]
Sweden_Pound: folds 
Venomous100%: folds 
Kukuryzka: folds 
RoadtoNepal: raises $2 to $3
Ohpeel: folds 
deepblue0000: folds 
di0d80: folds 
UShallGimme$: folds 
matiko09: folds 
Uncalled bet ($2) returned to RoadtoNepal
RoadtoNepal collected $2.50 from pot
RoadtoNepal: doesn't show hand 
*** SUMMARY ***
Total pot $2.50 | Rake $0 
Seat 1: UShallGimme$ (small blind) folded before Flop
Seat 2: matiko09 (big blind) folded before Flop
Seat 3: Sweden_Pound folded before Flop (didn't bet)
Seat 4: Venomous100% folded before Flop (didn't bet)
Seat 5: Kukuryzka folded before Flop (didn't bet)
Seat 6: RoadtoNepal collected ($2.50)
Seat 7: Ohpeel folded before Flop (didn't bet)
Seat 8: deepblue0000 folded before Flop (didn't bet)
Seat 9: di0d80 (button) folded before Flop (didn't bet)





PokerStars Hand #147755450881:  Hold'em No Limit ($0.50/$1.00 USD) - 2016/01/27 12:18:40 CET [2016/01/27 6:18:40 ET]
Table 'Nanking' 9-max Seat #3 is the button
Seat 1: Peu3aHy ($107.04 in chips) 
Seat 2: Dachish ($90.63 in chips) 
Seat 3: nuaxin ($110.19 in chips) 
Seat 5: di0d80 ($100 in chips) 
Seat 7: tipner ($100 in chips) 
Seat 8: matiko09 ($106 in chips) 
Seat 9: Sweden_Pound ($119.68 in chips) 
di0d80: posts small blind $0.50
Kukuryzka: is sitting out 
tipner: posts big blind $1
*** HOLE CARDS ***
Dealt to matiko09 [Jc 9h]
matiko09: folds 
Sweden_Pound: folds 
Kukuryzka leaves the table
Peu3aHy: folds 
Dachish: folds 
nuaxin: raises $2 to $3
torkkdnm joins the table at seat #6 
di0d80: folds 
tipner: folds 
Uncalled bet ($2) returned to nuaxin
nuaxin collected $2.50 from pot
nuaxin: doesn't show hand 
*** SUMMARY ***
Total pot $2.50 | Rake $0 
Seat 1: Peu3aHy folded before Flop (didn't bet)
Seat 2: Dachish folded before Flop (didn't bet)
Seat 3: nuaxin (button) collected ($2.50)
Seat 5: di0d80 (small blind) folded before Flop
Seat 7: tipner (big blind) folded before Flop
Seat 8: matiko09 folded before Flop (didn't bet)
Seat 9: Sweden_Pound folded before Flop (didn't bet)





PokerStars Hand #147755451400:  Hold'em No Limit ($0.50/$1.00 USD) - 2016/01/27 12:18:41 CET [2016/01/27 6:18:41 ET]
Table 'Fragaria II' 9-max Seat #1 is the button
Seat 1: deepblue0000 ($100 in chips) 
Seat 2: GG-NoR34D. ($74.06 in chips) 
Seat 3: Sweden_Pound ($106.57 in chips) 
Seat 5: Venomous100% ($163.04 in chips) 
Seat 6: UShallGimme$ ($167.87 in chips) 
Seat 7: Hobby-.-AK ($52.99 in chips) 
Seat 9: matiko09 ($115.92 in chips) 
GG-NoR34D.: posts small blind $0.50
Sweden_Pound: posts big blind $1
di0d80: sits out 
tipner: sits out 
*** HOLE CARDS ***
Dealt to matiko09 [2h Kc]
Venomous100%: raises $2 to $3
UShallGimme$: folds 
Hobby-.-AK: folds 
matiko09: folds 
deepblue0000: calls $3
GG-NoR34D.: folds 
Sweden_Pound: folds 
*** FLOP *** [6d Td 8h]
Venomous100%: bets $4.73
deepblue0000: calls $4.73
*** TURN *** [6d Td 8h] [3h]
Venomous100%: checks 
deepblue0000: bets $8.10
Venomous100%: raises $10.90 to $19
deepblue0000: calls $10.90
*** RIVER *** [6d Td 8h 3h] [7h]
Venomous100%: checks 
deepblue0000: bets $26.24
Venomous100%: raises $104.97 to $131.21
deepblue0000: calls $47.03 and is all-in
Uncalled bet ($57.94) returned to Venomous100%
*** SHOW DOWN ***
Venomous100%: shows [Qh Kh] (a flush, King high)
deepblue0000: mucks hand 
Venomous100% collected $198.70 from pot
*** SUMMARY ***
Total pot $201.50 | Rake $2.80 
Board [6d Td 8h 3h 7h]
Seat 1: deepblue0000 (button) mucked [Th Jh]
Seat 2: GG-NoR34D. (small blind) folded before Flop
Seat 3: Sweden_Pound (big blind) folded before Flop
Seat 5: Venomous100% showed [Qh Kh] and won ($198.70) with a flush, King high
Seat 6: UShallGimme$ folded before Flop (didn't bet)
Seat 7: Hobby-.-AK folded before Flop (didn't bet)
Seat 9: matiko09 folded before Flop (didn't bet)





PokerStars Hand #147755452829:  Hold'em No Limit ($0.50/$1.00 USD) - 2016/01/27 12:18:44 CET [2016/01/27 6:18:44 ET]
Table 'Marlu II' 9-max Seat #8 is the button
Seat 1: Kukuryzka ($107.45 in chips) 
Seat 2: matiko09 ($100 in chips) 
Seat 3: COOLIKO\/23 ($100 in chips) 
Seat 4: tipner ($113 in chips) 
Seat 5: Sweden_Pound ($143.16 in chips) 
Seat 6: LIGOPSIXIS78 ($28.38 in chips) 
Seat 7: UShallGimme$ ($100 in chips) 
Seat 8: Peu3aHy ($100 in chips) 
Seat 9: platinium1 ($76.87 in chips) 
platinium1: posts small blind $0.50
Kukuryzka: posts big blind $1
*** HOLE CARDS ***
Dealt to matiko09 [9h 8c]
matiko09: folds 
COOLIKO\/23: folds 
tipner: folds 
Sweden_Pound: raises $2 to $3
LIGOPSIXIS78: folds 
UShallGimme$: folds 
Peu3aHy: folds 
platinium1: calls $2.50
Kukuryzka: raises $9 to $12
Sweden_Pound: folds 
platinium1: folds 
Uncalled bet ($9) returned to Kukuryzka
Kukuryzka collected $9 from pot
Kukuryzka: doesn't show hand 
*** SUMMARY ***
Total pot $9 | Rake $0 
Seat 1: Kukuryzka (big blind) collected ($9)
Seat 2: matiko09 folded before Flop (didn't bet)
Seat 3: COOLIKO\/23 folded before Flop (didn't bet)
Seat 4: tipner folded before Flop (didn't bet)
Seat 5: Sweden_Pound folded before Flop
Seat 6: LIGOPSIXIS78 folded before Flop (didn't bet)
Seat 7: UShallGimme$ folded before Flop (didn't bet)
Seat 8: Peu3aHy (button) folded before Flop (didn't bet)
Seat 9: platinium1 (small blind) folded before Flop





PokerStars Hand #147755454923:  Hold'em No Limit ($0.50/$1.00 USD) - 2016/01/27 12:18:48 CET [2016/01/27 6:18:48 ET]
Table 'Alkmene II' 9-max Seat #1 is the button
Seat 1: matiko09 ($118.61 in chips) 
Seat 2: deepblue0000 ($102.68 in chips) 
Seat 3: di0d80 ($103.78 in chips) 
Seat 4: CoolFireX ($179.97 in chips) 
Seat 5: Sweden_Pound ($132.55 in chips) 
Seat 6: Peu3aHy ($109.22 in chips) 
Seat 7: mycka86 ($101.50 in chips) 
Seat 8: fecsok1 ($119.28 in chips) 
Seat 9: pandalapa ($100 in chips) 
deepblue0000: posts small blind $0.50
di0d80: posts big blind $1
*** HOLE CARDS ***
Dealt to matiko09 [7d Ad]
CoolFireX: folds 
Sweden_Pound: folds 
Peu3aHy: raises $2 to $3
mycka86: folds 
fecsok1: folds 
pandalapa: folds 
matiko09: folds 
deepblue0000: calls $2.50
di0d80: folds 
*** FLOP *** [9d 8h 4d]
deepblue0000: checks 
Peu3aHy: bets $5
deepblue0000: calls $5
*** TURN *** [9d 8h 4d] [5d]
deepblue0000: checks 
Peu3aHy: checks 
*** RIVER *** [9d 8h 4d 5d] [Kc]
deepblue0000: checks 
Peu3aHy: bets $8
deepblue0000: calls $8
*** SHOW DOWN ***
Peu3aHy: shows [Jc Qc] (high card King)
deepblue0000: shows [6d 6h] (a pair of Sixes)
deepblue0000 collected $31.52 from pot
*** SUMMARY ***
Total pot $33 | Rake $1.48 
Board [9d 8h 4d 5d Kc]
Seat 1: matiko09 (button) folded before Flop (didn't bet)
Seat 2: deepblue0000 (small blind) showed [6d 6h] and won ($31.52) with a pair of Sixes
Seat 3: di0d80 (big blind) folded before Flop
Seat 4: CoolFireX folded before Flop (didn't bet)
Seat 5: Sweden_Pound folded before Flop (didn't bet)
Seat 6: Peu3aHy showed [Jc Qc] and lost with high card King
Seat 7: mycka86 folded before Flop (didn't bet)
Seat 8: fecsok1 folded before Flop (didn't bet)
Seat 9: pandalapa folded before Flop (didn't bet)





PokerStars Hand #147755460073:  Hold'em No Limit ($0.50/$1.00 USD) - 2016/01/27 12:18:57 CET [2016/01/27 6:18:57 ET]
Table 'Klemola' 9-max Seat #3 is the button
Seat 2: Kukuryzka ($105.64 in chips) 
Seat 3: greyman571 ($38.16 in chips) 
Seat 4: torkkdnm ($100.50 in chips) 
Seat 5: tipner ($100 in chips) 
Seat 6: sylvian31 ($107.09 in chips) 
Seat 7: matiko09 ($123.24 in chips) 
Seat 8: Sweden_Pound ($100 in chips) 
torkkdnm: posts small blind $0.50
tipner: posts big blind $1
*** HOLE CARDS ***
Dealt to matiko09 [2c 6s]
sylvian31: raises $2 to $3
matiko09: folds 
Sweden_Pound: folds 
Kukuryzka: folds 
greyman571: calls $3
torkkdnm: folds 
tipner: raises $9 to $12
sylvian31: folds 
greyman571: calls $9
*** FLOP *** [Jc Qc 7h]
tipner: bets $7
greyman571: calls $7
*** TURN *** [Jc Qc 7h] [9d]
tipner: bets $20
greyman571: folds 
Uncalled bet ($20) returned to tipner
tipner collected $39.63 from pot
tipner: doesn't show hand 
*** SUMMARY ***
Total pot $41.50 | Rake $1.87 
Board [Jc Qc 7h 9d]
Seat 2: Kukuryzka folded before Flop (didn't bet)
Seat 3: greyman571 (button) folded on the Turn
Seat 4: torkkdnm (small blind) folded before Flop
Seat 5: tipner (big blind) collected ($39.63)
Seat 6: sylvian31 folded before Flop
Seat 7: matiko09 folded before Flop (didn't bet)
Seat 8: Sweden_Pound folded before Flop (didn't bet)





PokerStars Hand #147755460706:  Hold'em No Limit ($0.50/$1.00 USD) - 2016/01/27 12:18:59 CET [2016/01/27 6:18:59 ET]
Table 'Delphinus II' 9-max Seat #7 is the button
Seat 1: Saintreine ($151.56 in chips) 
Seat 2: UShallGimme$ ($106.55 in chips) 
Seat 3: deepblue0000 ($441.93 in chips) 
Seat 4: matiko09 ($100 in chips) 
Seat 5: pandalapa ($100 in chips) 
Seat 6: Sweden_Pound ($143.14 in chips) 
Seat 7: RUS)Timur ($131.58 in chips) 
Seat 9: FreeRangtor ($97.50 in chips) 
er13to will be allowed to play after the button
FreeRangtor: posts small blind $0.50
Saintreine: posts big blind $1
*** HOLE CARDS ***
Dealt to matiko09 [Ts Kd]
UShallGimme$: folds 
deepblue0000: folds 
matiko09: folds 
pandalapa: raises $2 to $3
Sweden_Pound: calls $3
RUS)Timur: folds 
FreeRangtor: folds 
Saintreine: folds 
*** FLOP *** [7c 3c Ks]
pandalapa: bets $4.77
Sweden_Pound: calls $4.77
*** TURN *** [7c 3c Ks] [4c]
pandalapa: checks 
Sweden_Pound: bets $10.58
pandalapa: folds 
Uncalled bet ($10.58) returned to Sweden_Pound
Sweden_Pound collected $16.27 from pot
Sweden_Pound: doesn't show hand 
*** SUMMARY ***
Total pot $17.04 | Rake $0.77 
Board [7c 3c Ks 4c]
Seat 1: Saintreine (big blind) folded before Flop
Seat 2: UShallGimme$ folded before Flop (didn't bet)
Seat 3: deepblue0000 folded before Flop (didn't bet)
Seat 4: matiko09 folded before Flop (didn't bet)
Seat 5: pandalapa folded on the Turn
Seat 6: Sweden_Pound collected ($16.27)
Seat 7: RUS)Timur (button) folded before Flop (didn't bet)
Seat 9: FreeRangtor (small blind) folded before Flop





PokerStars Hand #147755466435:  Hold'em No Limit ($0.50/$1.00 USD) - 2016/01/27 12:19:09 CET [2016/01/27 6:19:09 ET]
Table 'Dollfus' 9-max Seat #7 is the button
Seat 2: Sweden_Pound ($100 in chips) 
Seat 3: UShallGimme$ ($128.16 in chips) 
Seat 4: matiko09 ($107.14 in chips) 
Seat 5: pandalapa ($217.48 in chips) 
Seat 6: deepblue0000 ($118.16 in chips) 
Seat 7: Dödi123 ($194.11 in chips) 
Seat 8: Venomous100% ($100 in chips) 
Venomous100%: posts small blind $0.50
COOLIKO\/23: is sitting out 
Sweden_Pound: posts big blind $1
*** HOLE CARDS ***
Dealt to matiko09 [Qh 3d]
UShallGimme$: folds 
matiko09: folds 
pandalapa: raises $2 to $3
deepblue0000: folds 
Dödi123: folds 
Venomous100%: folds 
Sweden_Pound: folds 
Uncalled bet ($2) returned to pandalapa
pandalapa collected $2.50 from pot
pandalapa: doesn't show hand 
*** SUMMARY ***
Total pot $2.50 | Rake $0 
Seat 2: Sweden_Pound (big blind) folded before Flop
Seat 3: UShallGimme$ folded before Flop (didn't bet)
Seat 4: matiko09 folded before Flop (didn't bet)
Seat 5: pandalapa collected ($2.50)
Seat 6: deepblue0000 folded before Flop (didn't bet)
Seat 7: Dödi123 (button) folded before Flop (didn't bet)
Seat 8: Venomous100% (small blind) folded before Flop





PokerStars Hand #147755467295:  Hold'em No Limit ($0.50/$1.00 USD) - 2016/01/27 12:19:11 CET [2016/01/27 6:19:11 ET]
Table 'Nanking' 9-max Seat #5 is the button
Seat 1: Peu3aHy ($107.04 in chips) 
Seat 2: Dachish ($90.63 in chips) 
Seat 3: nuaxin ($111.69 in chips) 
Seat 5: di0d80 ($100 in chips) 
Seat 7: tipner ($100 in chips) 
Seat 8: matiko09 ($106 in chips) 
Seat 9: Sweden_Pound ($119.68 in chips) 
torkkdnm will be allowed to play after the button
tipner: posts small blind $0.50
matiko09: posts big blind $1
*** HOLE CARDS ***
Dealt to matiko09 [9s Ks]
Sweden_Pound: folds 
Peu3aHy: folds 
Dachish: folds 
nuaxin: folds 
di0d80: folds 
tipner: folds 
Uncalled bet ($0.50) returned to matiko09
matiko09 collected $1 from pot
matiko09: doesn't show hand 
*** SUMMARY ***
Total pot $1 | Rake $0 
Seat 1: Peu3aHy folded before Flop (didn't bet)
Seat 2: Dachish folded before Flop (didn't bet)
Seat 3: nuaxin folded before Flop (didn't bet)
Seat 5: di0d80 (button) folded before Flop (didn't bet)
Seat 7: tipner (small blind) folded before Flop
Seat 8: matiko09 (big blind) collected ($1)
Seat 9: Sweden_Pound folded before Flop (didn't bet)





PokerStars Hand #147755469163:  Hold'em No Limit ($0.50/$1.00 USD) - 2016/01/27 12:19:14 CET [2016/01/27 6:19:14 ET]
Table 'Alhajoth' 9-max Seat #1 is the button
Seat 1: UShallGimme$ ($114.95 in chips) 
Seat 2: matiko09 ($103 in chips) 
Seat 3: Sweden_Pound ($101.50 in chips) 
Seat 4: Venomous100% ($203.96 in chips) 
Seat 5: Kukuryzka ($109.35 in chips) 
Seat 6: RoadtoNepal ($186.96 in chips) 
Seat 7: Ohpeel ($123.80 in chips) 
Seat 8: deepblue0000 ($128.99 in chips) 
Seat 9: di0d80 ($100 in chips) 
matiko09: posts small blind $0.50
Sweden_Pound: posts big blind $1
*** HOLE CARDS ***
Dealt to matiko09 [9c 7h]
Venomous100%: folds 
Kukuryzka: raises $2 to $3
RoadtoNepal: folds 
Ohpeel: calls $3
deepblue0000: folds 
di0d80: raises $9 to $12
UShallGimme$: folds 
matiko09: folds 
Sweden_Pound: folds 
Kukuryzka: raises $12.50 to $24.50
Ohpeel: folds 
di0d80: calls $12.50
*** FLOP *** [2s 8d 4s]
Kukuryzka: bets $20
di0d80: folds 
Uncalled bet ($20) returned to Kukuryzka
Kukuryzka collected $51.09 from pot
Kukuryzka: doesn't show hand 
*** SUMMARY ***
Total pot $53.50 | Rake $2.41 
Board [2s 8d 4s]
Seat 1: UShallGimme$ (button) folded before Flop (didn't bet)
Seat 2: matiko09 (small blind) folded before Flop
Seat 3: Sweden_Pound (big blind) folded before Flop
Seat 4: Venomous100% folded before Flop (didn't bet)
Seat 5: Kukuryzka collected ($51.09)
Seat 6: RoadtoNepal folded before Flop (didn't bet)
Seat 7: Ohpeel folded before Flop
Seat 8: deepblue0000 folded before Flop (didn't bet)
Seat 9: di0d80 folded on the Flop





PokerStars Hand #147755471495:  Hold'em No Limit ($1/$2 USD) - 2016/01/27 12:19:18 CET [2016/01/27 6:19:18 ET]
Table 'Phobos II' 9-max Seat #9 is the button
Seat 1: LRV21 ($790.23 in chips) 
Seat 2: di0d80 ($258.68 in chips) 
Seat 3: sylvian31 ($245.20 in chips) 
Seat 4: flk.Dasas ($200 in chips) 
Seat 5: tipner ($200 in chips) 
Seat 6: matiko09 ($255.45 in chips) 
Seat 7: Venomous100% ($336.38 in chips) 
Seat 8: RoadtoNepal ($200 in chips) 
Seat 9: Kukuryzka ($275.36 in chips) 
LRV21: posts small blind $1
di0d80: posts big blind $2
*** HOLE CARDS ***
Dealt to matiko09 [3s Jc]
sylvian31: folds 
flk.Dasas: folds 
tipner: raises $4 to $6
matiko09: folds 
Venomous100%: raises $12 to $18
RoadtoNepal: folds 
Kukuryzka: folds 
LRV21: folds 
di0d80: folds 
tipner: folds 
Uncalled bet ($12) returned to Venomous100%
Venomous100% collected $15 from pot
Venomous100%: doesn't show hand 
*** SUMMARY ***
Total pot $15 | Rake $0 
Seat 1: LRV21 (small blind) folded before Flop
Seat 2: di0d80 (big blind) folded before Flop
Seat 3: sylvian31 folded before Flop (didn't bet)
Seat 4: flk.Dasas folded before Flop (didn't bet)
Seat 5: tipner folded before Flop
Seat 6: matiko09 folded before Flop (didn't bet)
Seat 7: Venomous100% collected ($15)
Seat 8: RoadtoNepal folded before Flop (didn't bet)
Seat 9: Kukuryzka (button) folded before Flop (didn't bet)





PokerStars Hand #147755480992:  Hold'em No Limit ($0.50/$1.00 USD) - 2016/01/27 12:19:36 CET [2016/01/27 6:19:36 ET]
Table 'Nanking' 9-max Seat #7 is the button
Seat 1: Peu3aHy ($107.04 in chips) 
Seat 2: Dachish ($90.63 in chips) 
Seat 3: nuaxin ($111.69 in chips) 
Seat 5: di0d80 ($100 in chips) 
Seat 7: tipner ($100 in chips) 
Seat 8: matiko09 ($106.50 in chips) 
Seat 9: Sweden_Pound ($119.68 in chips) 
matiko09: posts small blind $0.50
Sweden_Pound: posts big blind $1
torkkdnm: sits out 
*** HOLE CARDS ***
Dealt to matiko09 [Ah 9c]
Peu3aHy: folds 
Dachish: raises $1 to $2
nuaxin: folds 
di0d80: folds 
tipner: folds 
matiko09: folds 
Sweden_Pound: folds 
Uncalled bet ($1) returned to Dachish
Dachish collected $2.50 from pot
Dachish: doesn't show hand 
*** SUMMARY ***
Total pot $2.50 | Rake $0 
Seat 1: Peu3aHy folded before Flop (didn't bet)
Seat 2: Dachish collected ($2.50)
Seat 3: nuaxin folded before Flop (didn't bet)
Seat 5: di0d80 folded before Flop (didn't bet)
Seat 7: tipner (button) folded before Flop (didn't bet)
Seat 8: matiko09 (small blind) folded before Flop
Seat 9: Sweden_Pound (big blind) folded before Flop





PokerStars Hand #147755485758:  Hold'em No Limit ($0.50/$1.00 USD) - 2016/01/27 12:19:45 CET [2016/01/27 6:19:45 ET]
Table 'Marlu II' 9-max Seat #9 is the button
Seat 1: Kukuryzka ($113.45 in chips) 
Seat 2: matiko09 ($100 in chips) 
Seat 3: COOLIKO\/23 ($100 in chips) 
Seat 4: tipner ($113 in chips) 
Seat 5: Sweden_Pound ($140.16 in chips) 
Seat 6: LIGOPSIXIS78 ($28.38 in chips) 
Seat 7: UShallGimme$ ($100 in chips) 
Seat 8: Peu3aHy ($100 in chips) 
Seat 9: platinium1 ($73.87 in chips) 
Kukuryzka: posts small blind $0.50
matiko09: posts big blind $1
*** HOLE CARDS ***
Dealt to matiko09 [2d As]
COOLIKO\/23: folds 
tipner: folds 
Sweden_Pound: folds 
LIGOPSIXIS78: folds 
UShallGimme$: folds 
Peu3aHy: folds 
platinium1: calls $1
Kukuryzka: folds 
matiko09: checks 
*** FLOP *** [Jd Ad 8d]
matiko09: checks 
platinium1: folds 
matiko09 collected $2.39 from pot
matiko09: doesn't show hand 
*** SUMMARY ***
Total pot $2.50 | Rake $0.11 
Board [Jd Ad 8d]
Seat 1: Kukuryzka (small blind) folded before Flop
Seat 2: matiko09 (big blind) collected ($2.39)
Seat 3: COOLIKO\/23 folded before Flop (didn't bet)
Seat 4: tipner folded before Flop (didn't bet)
Seat 5: Sweden_Pound folded before Flop (didn't bet)
Seat 6: LIGOPSIXIS78 folded before Flop (didn't bet)
Seat 7: UShallGimme$ folded before Flop (didn't bet)
Seat 8: Peu3aHy folded before Flop (didn't bet)
Seat 9: platinium1 (button) folded on the Flop





PokerStars Hand #147755487105:  Hold'em No Limit ($0.50/$1.00 USD) - 2016/01/27 12:19:47 CET [2016/01/27 6:19:47 ET]
Table 'Dollfus' 9-max Seat #8 is the button
Seat 2: Sweden_Pound ($100 in chips) 
Seat 3: UShallGimme$ ($128.16 in chips) 
Seat 4: matiko09 ($107.14 in chips) 
Seat 5: pandalapa ($218.98 in chips) 
Seat 6: deepblue0000 ($118.16 in chips) 
Seat 7: Dödi123 ($194.11 in chips) 
Seat 8: Venomous100% ($100 in chips) 
Sweden_Pound: posts small blind $0.50
UShallGimme$: posts big blind $1
*** HOLE CARDS ***
Dealt to matiko09 [Jd 3c]
matiko09: folds 
pandalapa: folds 
deepblue0000: folds 
Dödi123: folds 
Venomous100%: raises $1 to $2
Sweden_Pound: folds 
UShallGimme$: calls $1
*** FLOP *** [Kc 3d 7d]
UShallGimme$: checks 
er13to joins the table at seat #1 
Venomous100%: bets $2.84
UShallGimme$: folds 
Uncalled bet ($2.84) returned to Venomous100%
Venomous100% collected $4.30 from pot
Venomous100%: doesn't show hand 
*** SUMMARY ***
Total pot $4.50 | Rake $0.20 
Board [Kc 3d 7d]
Seat 2: Sweden_Pound (small blind) folded before Flop
Seat 3: UShallGimme$ (big blind) folded on the Flop
Seat 4: matiko09 folded before Flop (didn't bet)
Seat 5: pandalapa folded before Flop (didn't bet)
Seat 6: deepblue0000 folded before Flop (didn't bet)
Seat 7: Dödi123 folded before Flop (didn't bet)
Seat 8: Venomous100% (button) collected ($4.30)





PokerStars Hand #147755493453:  Hold'em No Limit ($0.50/$1.00 USD) - 2016/01/27 12:19:59 CET [2016/01/27 6:19:59 ET]
Table 'Nanking' 9-max Seat #8 is the button
Seat 1: Peu3aHy ($107.04 in chips) 
Seat 2: Dachish ($92.13 in chips) 
Seat 3: nuaxin ($111.69 in chips) 
Seat 5: di0d80 ($100 in chips) 
Seat 7: tipner ($100 in chips) 
Seat 8: matiko09 ($106 in chips) 
Seat 9: Sweden_Pound ($118.68 in chips) 
Sweden_Pound: posts small blind $0.50
Peu3aHy: posts big blind $1
torkkdnm: sits out 
*** HOLE CARDS ***
Dealt to matiko09 [5h 4h]
Dachish: folds 
nuaxin: folds 
di0d80: folds 
Dachish leaves the table
tipner: raises $2 to $3
matiko09: folds 
Sweden_Pound: folds 
Peu3aHy: folds 
Uncalled bet ($2) returned to tipner
tipner collected $2.50 from pot
tipner: doesn't show hand 
*** SUMMARY ***
Total pot $2.50 | Rake $0 
Seat 1: Peu3aHy (big blind) folded before Flop
Seat 2: Dachish folded before Flop (didn't bet)
Seat 3: nuaxin folded before Flop (didn't bet)
Seat 5: di0d80 folded before Flop (didn't bet)
Seat 7: tipner collected ($2.50)
Seat 8: matiko09 (button) folded before Flop (didn't bet)
Seat 9: Sweden_Pound (small blind) folded before Flop





PokerStars Hand #147755500093:  Hold'em No Limit ($0.50/$1.00 USD) - 2016/01/27 12:20:11 CET [2016/01/27 6:20:11 ET]
Table 'Delphinus II' 9-max Seat #9 is the button
Seat 1: Saintreine ($150.56 in chips) 
Seat 2: UShallGimme$ ($106.55 in chips) 
Seat 3: deepblue0000 ($441.93 in chips) 
Seat 4: matiko09 ($100 in chips) 
Seat 5: pandalapa ($100 in chips) 
Seat 6: Sweden_Pound ($151.64 in chips) 
Seat 7: RUS)Timur ($131.58 in chips) 
Seat 9: FreeRangtor ($97 in chips) 
Saintreine: posts small blind $0.50
UShallGimme$: posts big blind $1
er13to: sits out 
*** HOLE CARDS ***
Dealt to matiko09 [Kd 2h]
deepblue0000: folds 
matiko09: folds 
pandalapa: folds 
Sweden_Pound: raises $2 to $3
RUS)Timur: folds 
FreeRangtor: folds 
Saintreine: folds 
UShallGimme$: folds 
Uncalled bet ($2) returned to Sweden_Pound
Sweden_Pound collected $2.50 from pot
Sweden_Pound: doesn't show hand 
*** SUMMARY ***
Total pot $2.50 | Rake $0 
Seat 1: Saintreine (small blind) folded before Flop
Seat 2: UShallGimme$ (big blind) folded before Flop
Seat 3: deepblue0000 folded before Flop (didn't bet)
Seat 4: matiko09 folded before Flop (didn't bet)
Seat 5: pandalapa folded before Flop (didn't bet)
Seat 6: Sweden_Pound collected ($2.50)
Seat 7: RUS)Timur folded before Flop (didn't bet)
Seat 9: FreeRangtor (button) folded before Flop (didn't bet)





PokerStars Hand #147755501239:  Hold'em No Limit ($0.50/$1.00 USD) - 2016/01/27 12:20:14 CET [2016/01/27 6:20:14 ET]
Table 'Fragaria II' 9-max Seat #2 is the button
Seat 1: deepblue0000 ($100 in chips) 
Seat 2: GG-NoR34D. ($73.56 in chips) 
Seat 3: Sweden_Pound ($105.57 in chips) 
Seat 4: di0d80 ($100 in chips) 
Seat 5: Venomous100% ($261.74 in chips) 
Seat 6: UShallGimme$ ($167.87 in chips) 
Seat 7: Hobby-.-AK ($52.99 in chips) 
Seat 9: matiko09 ($115.92 in chips) 
Sweden_Pound: posts small blind $0.50
di0d80: posts big blind $1
tipner: sits out 
*** HOLE CARDS ***
Dealt to matiko09 [2d Jc]
Venomous100%: folds 
UShallGimme$: folds 
Hobby-.-AK: folds 
Venomous100% leaves the table
matiko09: folds 
deepblue0000: folds 
GG-NoR34D.: folds 
Sweden_Pound: folds 
Uncalled bet ($0.50) returned to di0d80
di0d80 collected $1 from pot
di0d80: doesn't show hand 
*** SUMMARY ***
Total pot $1 | Rake $0 
Seat 1: deepblue0000 folded before Flop (didn't bet)
Seat 2: GG-NoR34D. (button) folded before Flop (didn't bet)
Seat 3: Sweden_Pound (small blind) folded before Flop
Seat 4: di0d80 (big blind) collected ($1)
Seat 5: Venomous100% folded before Flop (didn't bet)
Seat 6: UShallGimme$ folded before Flop (didn't bet)
Seat 7: Hobby-.-AK folded before Flop (didn't bet)
Seat 9: matiko09 folded before Flop (didn't bet)





PokerStars Hand #147755505176:  Hold'em No Limit ($0.50/$1.00 USD) - 2016/01/27 12:20:21 CET [2016/01/27 6:20:21 ET]
Table 'Klemola' 9-max Seat #4 is the button
Seat 2: Kukuryzka ($105.64 in chips) 
Seat 3: greyman571 ($19.16 in chips) 
Seat 4: torkkdnm ($100 in chips) 
Seat 5: tipner ($120.63 in chips) 
Seat 7: matiko09 ($123.24 in chips) 
Seat 8: Sweden_Pound ($100 in chips) 
tipner: posts small blind $0.50
sylvian31: is sitting out 
matiko09: posts big blind $1
*** HOLE CARDS ***
Dealt to matiko09 [2c 2d]
Sweden_Pound: folds 
Kukuryzka: folds 
greyman571: folds 
torkkdnm: raises $1 to $2
tipner: folds 
matiko09: calls $1
*** FLOP *** [Ad Js Jc]
matiko09: checks 
torkkdnm: bets $3
matiko09: folds 
Uncalled bet ($3) returned to torkkdnm
torkkdnm collected $4.30 from pot
*** SUMMARY ***
Total pot $4.50 | Rake $0.20 
Board [Ad Js Jc]
Seat 2: Kukuryzka folded before Flop (didn't bet)
Seat 3: greyman571 folded before Flop (didn't bet)
Seat 4: torkkdnm (button) collected ($4.30)
Seat 5: tipner (small blind) folded before Flop
Seat 7: matiko09 (big blind) folded on the Flop
Seat 8: Sweden_Pound folded before Flop (didn't bet)





PokerStars Hand #147755505988:  Hold'em No Limit ($1/$2 USD) - 2016/01/27 12:20:22 CET [2016/01/27 6:20:22 ET]
Table 'Phobos II' 9-max Seat #1 is the button
Seat 1: LRV21 ($789.23 in chips) 
Seat 2: di0d80 ($256.68 in chips) 
Seat 3: sylvian31 ($245.20 in chips) 
Seat 4: flk.Dasas ($200 in chips) 
Seat 5: tipner ($200 in chips) 
Seat 6: matiko09 ($255.45 in chips) 
Seat 7: Venomous100% ($345.38 in chips) 
Seat 8: RoadtoNepal ($200 in chips) 
Seat 9: Kukuryzka ($275.36 in chips) 
di0d80: posts small blind $1
sylvian31: posts big blind $2
*** HOLE CARDS ***
Dealt to matiko09 [Ac 9d]
flk.Dasas: folds 
tipner: folds 
matiko09: folds 
Venomous100%: folds 
RoadtoNepal: folds 
flk.Dasas leaves the table
Kukuryzka: folds 
chaps1988 joins the table at seat #4 
LRV21: raises $4 to $6
di0d80: folds 
sylvian31: folds 
Uncalled bet ($4) returned to LRV21
LRV21 collected $5 from pot
LRV21: doesn't show hand 
*** SUMMARY ***
Total pot $5 | Rake $0 
Seat 1: LRV21 (button) collected ($5)
Seat 2: di0d80 (small blind) folded before Flop
Seat 3: sylvian31 (big blind) folded before Flop
Seat 4: flk.Dasas folded before Flop (didn't bet)
Seat 5: tipner folded before Flop (didn't bet)
Seat 6: matiko09 folded before Flop (didn't bet)
Seat 7: Venomous100% folded before Flop (didn't bet)
Seat 8: RoadtoNepal folded before Flop (didn't bet)
Seat 9: Kukuryzka folded before Flop (didn't bet)





PokerStars Hand #147755506116:  Hold'em No Limit ($0.50/$1.00 USD) - 2016/01/27 12:20:23 CET [2016/01/27 6:20:23 ET]
Table 'Alkmene II' 9-max Seat #2 is the button
Seat 1: matiko09 ($118.61 in chips) 
Seat 2: deepblue0000 ($118.20 in chips) 
Seat 3: di0d80 ($102.78 in chips) 
Seat 4: CoolFireX ($179.97 in chips) 
Seat 5: Sweden_Pound ($132.55 in chips) 
Seat 6: Peu3aHy ($100 in chips) 
Seat 7: mycka86 ($101.50 in chips) 
Seat 8: fecsok1 ($119.28 in chips) 
Seat 9: pandalapa ($100 in chips) 
di0d80: posts small blind $0.50
CoolFireX: posts big blind $1
*** HOLE CARDS ***
Dealt to matiko09 [8h 4d]
Sweden_Pound: folds 
Peu3aHy: folds 
mycka86: folds 
fecsok1: folds 
pandalapa: folds 
matiko09: folds 
deepblue0000: folds 
di0d80: raises $2 to $3
CoolFireX: folds 
Uncalled bet ($2) returned to di0d80
di0d80 collected $2 from pot
di0d80: doesn't show hand 
*** SUMMARY ***
Total pot $2 | Rake $0 
Seat 1: matiko09 folded before Flop (didn't bet)
Seat 2: deepblue0000 (button) folded before Flop (didn't bet)
Seat 3: di0d80 (small blind) collected ($2)
Seat 4: CoolFireX (big blind) folded before Flop
Seat 5: Sweden_Pound folded before Flop (didn't bet)
Seat 6: Peu3aHy folded before Flop (didn't bet)
Seat 7: mycka86 folded before Flop (didn't bet)
Seat 8: fecsok1 folded before Flop (didn't bet)
Seat 9: pandalapa folded before Flop (didn't bet)





PokerStars Hand #147755512908:  Hold'em No Limit ($0.50/$1.00 USD) - 2016/01/27 12:20:35 CET [2016/01/27 6:20:35 ET]
Table 'Marlu II' 9-max Seat #1 is the button
Seat 1: Kukuryzka ($112.95 in chips) 
Seat 2: matiko09 ($101.39 in chips) 
Seat 4: tipner ($113 in chips) 
Seat 5: Sweden_Pound ($140.16 in chips) 
Seat 6: LIGOPSIXIS78 ($28.38 in chips) 
Seat 7: UShallGimme$ ($100 in chips) 
Seat 8: Peu3aHy ($100 in chips) 
Seat 9: platinium1 ($72.87 in chips) 
matiko09: posts small blind $0.50
tipner: posts big blind $1
*** HOLE CARDS ***
Dealt to matiko09 [7s 3s]
Sweden_Pound: folds 
LIGOPSIXIS78: folds 
UShallGimme$: folds 
Peu3aHy: folds 
platinium1: folds 
Kukuryzka: folds 
matiko09: folds 
Uncalled bet ($0.50) returned to tipner
tipner collected $1 from pot
tipner: doesn't show hand 
*** SUMMARY ***
Total pot $1 | Rake $0 
Seat 1: Kukuryzka (button) folded before Flop (didn't bet)
Seat 2: matiko09 (small blind) folded before Flop
Seat 4: tipner (big blind) collected ($1)
Seat 5: Sweden_Pound folded before Flop (didn't bet)
Seat 6: LIGOPSIXIS78 folded before Flop (didn't bet)
Seat 7: UShallGimme$ folded before Flop (didn't bet)
Seat 8: Peu3aHy folded before Flop (didn't bet)
Seat 9: platinium1 folded before Flop (didn't bet)





PokerStars Hand #147755513005:  Hold'em No Limit ($0.50/$1.00 USD) - 2016/01/27 12:20:36 CET [2016/01/27 6:20:36 ET]
Table 'Delphinus II' 9-max Seat #1 is the button
Seat 1: Saintreine ($150.06 in chips) 
Seat 2: UShallGimme$ ($105.55 in chips) 
Seat 3: deepblue0000 ($441.93 in chips) 
Seat 4: matiko09 ($100 in chips) 
Seat 5: pandalapa ($100 in chips) 
Seat 6: Sweden_Pound ($153.14 in chips) 
Seat 7: RUS)Timur ($131.58 in chips) 
Seat 9: FreeRangtor ($97 in chips) 
UShallGimme$: posts small blind $0.50
deepblue0000: posts big blind $1
er13to: sits out 
*** HOLE CARDS ***
Dealt to matiko09 [3h 3d]
matiko09: folds 
pandalapa: folds 
Sweden_Pound: raises $2 to $3
RUS)Timur: folds 
FreeRangtor: folds 
Saintreine: folds 
UShallGimme$: folds 
deepblue0000: folds 
Uncalled bet ($2) returned to Sweden_Pound
Sweden_Pound collected $2.50 from pot
Sweden_Pound: doesn't show hand 
*** SUMMARY ***
Total pot $2.50 | Rake $0 
Seat 1: Saintreine (button) folded before Flop (didn't bet)
Seat 2: UShallGimme$ (small blind) folded before Flop
Seat 3: deepblue0000 (big blind) folded before Flop
Seat 4: matiko09 folded before Flop (didn't bet)
Seat 5: pandalapa folded before Flop (didn't bet)
Seat 6: Sweden_Pound collected ($2.50)
Seat 7: RUS)Timur folded before Flop (didn't bet)
Seat 9: FreeRangtor folded before Flop (didn't bet)





PokerStars Hand #147755514224:  Hold'em No Limit ($0.50/$1.00 USD) - 2016/01/27 12:20:38 CET [2016/01/27 6:20:38 ET]
Table 'Fragaria II' 9-max Seat #3 is the button
Seat 1: deepblue0000 ($100 in chips) 
Seat 2: GG-NoR34D. ($73.56 in chips) 
Seat 3: Sweden_Pound ($105.07 in chips) 
Seat 4: di0d80 ($100.50 in chips) 
Seat 6: UShallGimme$ ($167.87 in chips) 
Seat 7: Hobby-.-AK ($52.99 in chips) 
Seat 9: matiko09 ($115.92 in chips) 
di0d80: posts small blind $0.50
UShallGimme$: posts big blind $1
tipner: sits out 
*** HOLE CARDS ***
Dealt to matiko09 [4d 7d]
Hobby-.-AK: folds 
sylvian31 joins the table at seat #5 
matiko09: folds 
deepblue0000: folds 
GG-NoR34D.: folds 
Sweden_Pound: raises $1 to $2
di0d80: folds 
UShallGimme$: calls $1
*** FLOP *** [3s Js 8d]
UShallGimme$: checks 
Sweden_Pound: bets $2.80
UShallGimme$: folds 
Uncalled bet ($2.80) returned to Sweden_Pound
Sweden_Pound collected $4.30 from pot
Sweden_Pound: doesn't show hand 
*** SUMMARY ***
Total pot $4.50 | Rake $0.20 
Board [3s Js 8d]
Seat 1: deepblue0000 folded before Flop (didn't bet)
Seat 2: GG-NoR34D. folded before Flop (didn't bet)
Seat 3: Sweden_Pound (button) collected ($4.30)
Seat 4: di0d80 (small blind) folded before Flop
Seat 6: UShallGimme$ (big blind) folded on the Flop
Seat 7: Hobby-.-AK folded before Flop (didn't bet)
Seat 9: matiko09 folded before Flop (didn't bet)





PokerStars Hand #147755514597:  Hold'em No Limit ($0.50/$1.00 USD) - 2016/01/27 12:20:39 CET [2016/01/27 6:20:39 ET]
Table 'Nanking' 9-max Seat #9 is the button
Seat 1: Peu3aHy ($106.04 in chips) 
Seat 3: nuaxin ($111.69 in chips) 
Seat 5: di0d80 ($100 in chips) 
Seat 7: tipner ($101.50 in chips) 
Seat 8: matiko09 ($106 in chips) 
Seat 9: Sweden_Pound ($118.18 in chips) 
Peu3aHy: posts small blind $0.50
nuaxin: posts big blind $1
torkkdnm: sits out 
*** HOLE CARDS ***
Dealt to matiko09 [6d Tc]
di0d80: folds 
tipner: raises $2 to $3
matiko09: folds 
Sweden_Pound: folds 
Peu3aHy: folds 
deepblue0000 joins the table at seat #2 
nuaxin: folds 
Uncalled bet ($2) returned to tipner
tipner collected $2.50 from pot
tipner: doesn't show hand 
*** SUMMARY ***
Total pot $2.50 | Rake $0 
Seat 1: Peu3aHy (small blind) folded before Flop
Seat 3: nuaxin (big blind) folded before Flop
Seat 5: di0d80 folded before Flop (didn't bet)
Seat 7: tipner collected ($2.50)
Seat 8: matiko09 folded before Flop (didn't bet)
Seat 9: Sweden_Pound (button) folded before Flop (didn't bet)





PokerStars Hand #147755520190:  Hold'em No Limit ($0.50/$1.00 USD) - 2016/01/27 12:20:49 CET [2016/01/27 6:20:49 ET]
Table 'Alhajoth' 9-max Seat #2 is the button
Seat 1: UShallGimme$ ($114.95 in chips) 
Seat 2: matiko09 ($102.50 in chips) 
Seat 3: Sweden_Pound ($100.50 in chips) 
Seat 5: Kukuryzka ($135.94 in chips) 
Seat 6: RoadtoNepal ($186.96 in chips) 
Seat 7: Ohpeel ($120.80 in chips) 
Seat 8: deepblue0000 ($128.99 in chips) 
Seat 9: di0d80 ($100 in chips) 
Sweden_Pound: posts small blind $0.50
Venomous100%: is sitting out 
Kukuryzka: posts big blind $1
*** HOLE CARDS ***
Dealt to matiko09 [Jh 2d]
Venomous100% leaves the table
RoadtoNepal: folds 
pandalapa joins the table at seat #4 
Ohpeel: folds 
deepblue0000: folds 
di0d80: folds 
UShallGimme$: folds 
matiko09: folds 
Sweden_Pound: folds 
Uncalled bet ($0.50) returned to Kukuryzka
Kukuryzka collected $1 from pot
Kukuryzka: doesn't show hand 
*** SUMMARY ***
Total pot $1 | Rake $0 
Seat 1: UShallGimme$ folded before Flop (didn't bet)
Seat 2: matiko09 (button) folded before Flop (didn't bet)
Seat 3: Sweden_Pound (small blind) folded before Flop
Seat 5: Kukuryzka (big blind) collected ($1)
Seat 6: RoadtoNepal folded before Flop (didn't bet)
Seat 7: Ohpeel folded before Flop (didn't bet)
Seat 8: deepblue0000 folded before Flop (didn't bet)
Seat 9: di0d80 folded before Flop (didn't bet)





PokerStars Hand #147755522891:  Hold'em No Limit ($0.50/$1.00 USD) - 2016/01/27 12:20:54 CET [2016/01/27 6:20:54 ET]
Table 'Delphinus II' 9-max Seat #2 is the button
Seat 1: Saintreine ($150.06 in chips) 
Seat 2: UShallGimme$ ($105.05 in chips) 
Seat 3: deepblue0000 ($440.93 in chips) 
Seat 4: matiko09 ($100 in chips) 
Seat 5: pandalapa ($100 in chips) 
Seat 6: Sweden_Pound ($154.64 in chips) 
Seat 7: RUS)Timur ($131.58 in chips) 
Seat 9: FreeRangtor ($97 in chips) 
deepblue0000: posts small blind $0.50
matiko09: posts big blind $1
er13to: sits out 
*** HOLE CARDS ***
Dealt to matiko09 [4c Ad]
pandalapa: folds 
Sweden_Pound: raises $2 to $3
RUS)Timur: folds 
FreeRangtor: calls $3
Saintreine: folds 
UShallGimme$: folds 
deepblue0000: calls $2.50
matiko09: folds 
*** FLOP *** [8h 6d 2c]
deepblue0000: checks 
Sweden_Pound: bets $6.21
FreeRangtor: calls $6.21
deepblue0000: folds 
*** TURN *** [8h 6d 2c] [6h]
Sweden_Pound: checks 
FreeRangtor: bets $10.70
Sweden_Pound: folds 
Uncalled bet ($10.70) returned to FreeRangtor
FreeRangtor collected $21.41 from pot
FreeRangtor: doesn't show hand 
*** SUMMARY ***
Total pot $22.42 | Rake $1.01 
Board [8h 6d 2c 6h]
Seat 1: Saintreine folded before Flop (didn't bet)
Seat 2: UShallGimme$ (button) folded before Flop (didn't bet)
Seat 3: deepblue0000 (small blind) folded on the Flop
Seat 4: matiko09 (big blind) folded before Flop
Seat 5: pandalapa folded before Flop (didn't bet)
Seat 6: Sweden_Pound folded on the Turn
Seat 7: RUS)Timur folded before Flop (didn't bet)
Seat 9: FreeRangtor collected ($21.41)





PokerStars Hand #147755525078:  Hold'em No Limit ($0.50/$1.00 USD) - 2016/01/27 12:20:58 CET [2016/01/27 6:20:58 ET]
Table 'Klemola' 9-max Seat #5 is the button
Seat 2: Kukuryzka ($105.64 in chips) 
Seat 3: greyman571 ($19.16 in chips) 
Seat 4: torkkdnm ($102.30 in chips) 
Seat 5: tipner ($120.13 in chips) 
Seat 7: matiko09 ($121.24 in chips) 
Seat 8: Sweden_Pound ($100 in chips) 
matiko09: posts small blind $0.50
Sweden_Pound: posts big blind $1
*** HOLE CARDS ***
Dealt to matiko09 [Ts Tc]
Kukuryzka: raises $2 to $3
greyman571: folds 
torkkdnm: folds 
tipner: folds 
matiko09: calls $2.50
Sweden_Pound: folds 
*** FLOP *** [7h Qs 3d]
matiko09: checks 
sylvian31 leaves the table
Kukuryzka: checks 
*** TURN *** [7h Qs 3d] [Kc]
nairolf24 joins the table at seat #6 
nairolf24 leaves the table
matiko09: checks 
deepblue0000 joins the table at seat #6 
Kukuryzka: checks 
*** RIVER *** [7h Qs 3d Kc] [Qh]
matiko09: bets $4.34
Kukuryzka: folds 
Uncalled bet ($4.34) returned to matiko09
matiko09 collected $6.68 from pot
matiko09: doesn't show hand 
*** SUMMARY ***
Total pot $7 | Rake $0.32 
Board [7h Qs 3d Kc Qh]
Seat 2: Kukuryzka folded on the River
Seat 3: greyman571 folded before Flop (didn't bet)
Seat 4: torkkdnm folded before Flop (didn't bet)
Seat 5: tipner (button) folded before Flop (didn't bet)
Seat 7: matiko09 (small blind) collected ($6.68)
Seat 8: Sweden_Pound (big blind) folded before Flop





PokerStars Hand #147755526601:  Hold'em No Limit ($0.50/$1.00 USD) - 2016/01/27 12:21:01 CET [2016/01/27 6:21:01 ET]
Table 'Alkmene II' 9-max Seat #3 is the button
Seat 1: matiko09 ($118.61 in chips) 
Seat 2: deepblue0000 ($118.20 in chips) 
Seat 3: di0d80 ($103.78 in chips) 
Seat 4: CoolFireX ($178.97 in chips) 
Seat 5: Sweden_Pound ($132.55 in chips) 
Seat 6: Peu3aHy ($100 in chips) 
Seat 7: mycka86 ($101.50 in chips) 
Seat 8: fecsok1 ($119.28 in chips) 
Seat 9: pandalapa ($100 in chips) 
CoolFireX: posts small blind $0.50
Sweden_Pound: posts big blind $1
*** HOLE CARDS ***
Dealt to matiko09 [Ah 6c]
Peu3aHy: folds 
mycka86: folds 
fecsok1: folds 
pandalapa: folds 
matiko09: folds 
deepblue0000: raises $1.50 to $2.50
di0d80: raises $5 to $7.50
CoolFireX: folds 
Sweden_Pound: folds 
deepblue0000: calls $5
*** FLOP *** [5d Th 3h]
deepblue0000: checks 
di0d80: bets $10
deepblue0000: calls $10
*** TURN *** [5d Th 3h] [7s]
deepblue0000: checks 
di0d80: bets $21
deepblue0000: calls $21
*** RIVER *** [5d Th 3h 7s] [Qh]
deepblue0000: checks 
di0d80: bets $65.28 and is all-in
deepblue0000: folds 
Uncalled bet ($65.28) returned to di0d80
di0d80 collected $75.70 from pot
di0d80: doesn't show hand 
*** SUMMARY ***
Total pot $78.50 | Rake $2.80 
Board [5d Th 3h 7s Qh]
Seat 1: matiko09 folded before Flop (didn't bet)
Seat 2: deepblue0000 folded on the River
Seat 3: di0d80 (button) collected ($75.70)
Seat 4: CoolFireX (small blind) folded before Flop
Seat 5: Sweden_Pound (big blind) folded before Flop
Seat 6: Peu3aHy folded before Flop (didn't bet)
Seat 7: mycka86 folded before Flop (didn't bet)
Seat 8: fecsok1 folded before Flop (didn't bet)
Seat 9: pandalapa folded before Flop (didn't bet)





PokerStars Hand #147755528921:  Hold'em No Limit ($1/$2 USD) - 2016/01/27 12:21:05 CET [2016/01/27 6:21:05 ET]
Table 'Phobos II' 9-max Seat #2 is the button
Seat 1: LRV21 ($792.23 in chips) 
Seat 2: di0d80 ($255.68 in chips) 
Seat 3: sylvian31 ($243.20 in chips) 
Seat 4: chaps1988 ($200 in chips) 
Seat 5: tipner ($200 in chips) 
Seat 6: matiko09 ($255.45 in chips) 
Seat 7: Venomous100% ($345.38 in chips) 
Seat 8: RoadtoNepal ($200 in chips) 
Seat 9: Kukuryzka ($275.36 in chips) 
sylvian31: posts small blind $1
chaps1988: posts big blind $2
*** HOLE CARDS ***
Dealt to matiko09 [7h 7d]
tipner: folds 
matiko09: raises $4 to $6
Venomous100%: folds 
RoadtoNepal: folds 
Kukuryzka: folds 
LRV21: folds 
di0d80: folds 
sylvian31: folds 
chaps1988: folds 
Uncalled bet ($4) returned to matiko09
matiko09 collected $5 from pot
matiko09: doesn't show hand 
*** SUMMARY ***
Total pot $5 | Rake $0 
Seat 1: LRV21 folded before Flop (didn't bet)
Seat 2: di0d80 (button) folded before Flop (didn't bet)
Seat 3: sylvian31 (small blind) folded before Flop
Seat 4: chaps1988 (big blind) folded before Flop
Seat 5: tipner folded before Flop (didn't bet)
Seat 6: matiko09 collected ($5)
Seat 7: Venomous100% folded before Flop (didn't bet)
Seat 8: RoadtoNepal folded before Flop (didn't bet)
Seat 9: Kukuryzka folded before Flop (didn't bet)





PokerStars Hand #147755528939:  Hold'em No Limit ($0.50/$1.00 USD) - 2016/01/27 12:21:05 CET [2016/01/27 6:21:05 ET]
Table 'Marlu II' 9-max Seat #2 is the button
Seat 1: Kukuryzka ($112.95 in chips) 
Seat 2: matiko09 ($100.89 in chips) 
Seat 4: tipner ($113.50 in chips) 
Seat 5: Sweden_Pound ($140.16 in chips) 
Seat 6: LIGOPSIXIS78 ($28.38 in chips) 
Seat 7: UShallGimme$ ($100 in chips) 
Seat 8: Peu3aHy ($100 in chips) 
Seat 9: platinium1 ($72.87 in chips) 
tipner: posts small blind $0.50
Sweden_Pound: posts big blind $1
*** HOLE CARDS ***
Dealt to matiko09 [Kd 5s]
LIGOPSIXIS78: folds 
UShallGimme$: folds 
Peu3aHy: folds 
platinium1: calls $1
Kukuryzka: folds 
matiko09: folds 
tipner: folds 
Sweden_Pound: checks 
*** FLOP *** [Jc Qc Th]
Sweden_Pound: bets $2
platinium1: folds 
Uncalled bet ($2) returned to Sweden_Pound
Sweden_Pound collected $2.39 from pot
Sweden_Pound: doesn't show hand 
*** SUMMARY ***
Total pot $2.50 | Rake $0.11 
Board [Jc Qc Th]
Seat 1: Kukuryzka folded before Flop (didn't bet)
Seat 2: matiko09 (button) folded before Flop (didn't bet)
Seat 4: tipner (small blind) folded before Flop
Seat 5: Sweden_Pound (big blind) collected ($2.39)
Seat 6: LIGOPSIXIS78 folded before Flop (didn't bet)
Seat 7: UShallGimme$ folded before Flop (didn't bet)
Seat 8: Peu3aHy folded before Flop (didn't bet)
Seat 9: platinium1 folded on the Flop





